name,realm,rating,cls,spec,play,win,lose
Bloodzin,frostwhisper,1720,deathknight,blood,105,58,47
Rahbekius,kazzak,1619,deathknight,blood,246,117,129
Goochtickler,kazzak,1554,deathknight,blood,114,59,55
Rahbekies,kazzak,1550,deathknight,blood,81,47,34
Эваер,blackscar,1445,deathknight,blood,136,65,71
Hoggster,kazzak,1372,deathknight,blood,111,45,66
Maylined,antonidas,1334,deathknight,blood,72,34,38
Horrorda,defias-brotherhood,1242,deathknight,blood,73,38,35
Wickedgray,outland,1170,deathknight,blood,54,15,39
Arthaslegend,magtheridon,1161,deathknight,blood,54,24,30
Schwuischädl,eredar,1155,deathknight,blood,40,21,19
Nîghtmáre,ravencrest,1124,deathknight,blood,47,24,23
Кмамехочу,howling-fjord,997,deathknight,blood,66,23,43
Oxcidium,archimonde,980,deathknight,blood,42,22,20
Ducados,forscherliga,952,deathknight,blood,24,12,12
Mosesishere,blackmoore,947,deathknight,blood,30,10,20
Dreodis,der-mithrilorden,923,deathknight,blood,60,16,44
Minoporc,archimonde,863,deathknight,blood,69,27,42
Truehero,magtheridon,852,deathknight,blood,24,9,15
Pechugona,zuljin,834,deathknight,blood,48,11,37
Rakia,defias-brotherhood,757,deathknight,blood,51,17,34
Hjertesalat,ravencrest,747,deathknight,blood,26,10,16
Schiva,eredar,745,deathknight,blood,35,12,23
Helixnc,silvermoon,576,deathknight,blood,18,6,12
Smalldk,silvermoon,574,deathknight,blood,18,6,12
Оосака,gordunni,573,deathknight,blood,24,6,18
Downtoclown,argent-dawn,480,deathknight,blood,12,5,7
Zdan,sylvanas,476,deathknight,blood,12,5,7
Dàreals,draenor,384,deathknight,blood,6,4,2
Akamechân,frostmourne,382,deathknight,blood,6,4,2
Hellcrosser,blackrock,381,deathknight,blood,12,4,8
Airok,proudmoore,381,deathknight,blood,12,4,8
Naxmet,dun-modr,381,deathknight,blood,30,4,26
Pinkish,argent-dawn,379,deathknight,blood,12,4,8
Барагган,thermaplugg,288,deathknight,blood,6,3,3
Buklow,argent-dawn,287,deathknight,blood,9,3,6
Dromadeus,sylvanas,286,deathknight,blood,12,3,9
Маккриманс,gordunni,192,deathknight,blood,6,2,4
Aurelianus,arygos,192,deathknight,blood,6,2,4
Kirimvose,tarren-mill,192,deathknight,blood,6,2,4
Cyphîllyth,auchindoun,192,deathknight,blood,6,2,4
Mouledk,hyjal,192,deathknight,blood,6,2,4
Ciørkîng,archimonde,192,deathknight,blood,6,2,4
Mámmôn,malygos,192,deathknight,blood,12,2,10
Глэмнутый,howling-fjord,96,deathknight,blood,6,1,5
Maradk,drakthul,96,deathknight,blood,6,1,5
Fixmybones,frostmane,96,deathknight,blood,6,1,5
Drruiel,twisting-nether,96,deathknight,blood,6,1,5
Ilopango,blackmoore,96,deathknight,blood,6,1,5
Geraltbg,twisting-nether,96,deathknight,blood,6,1,5
Livanto,ahnqiraj,96,deathknight,blood,6,1,5
Intrih,arathor,48,deathknight,blood,9,1,8
Calculated,spinebreaker,42,deathknight,blood,11,5,6
Хайвейтухэлл,soulflayer,2188,deathknight,unholy,114,60,54
Страхолит,soulflayer,2160,deathknight,unholy,224,113,111
Кромгона,soulflayer,2154,deathknight,unholy,178,109,69
Lilshiet,stormreaver,2121,deathknight,unholy,102,51,51
Bóby,ravencrest,2103,deathknight,unholy,444,221,223
Нишимба,soulflayer,2060,deathknight,unholy,442,219,223
Aryash,silvermoon,2035,deathknight,unholy,90,46,44
Bíllÿ,kazzak,2003,deathknight,unholy,104,56,48
Валькейн,blackscar,1997,deathknight,unholy,72,38,34
Conqueròr,tarren-mill,1994,deathknight,unholy,261,125,136
Rottenpete,grim-batol,1971,deathknight,unholy,84,45,39
Annabolik,ravencrest,1964,deathknight,unholy,53,29,24
Leónid,kazzak,1962,deathknight,unholy,72,36,36
Elite,xavius,1955,deathknight,unholy,508,255,253
Марактус,gordunni,1952,deathknight,unholy,124,75,49
Enzy,drakthul,1936,deathknight,unholy,53,30,23
Bigdickdk,ragnaros,1935,deathknight,unholy,70,34,36
Zd,ghostlands,1933,deathknight,unholy,106,50,56
Worlviuz,argent-dawn,1932,deathknight,unholy,153,77,76
Amnésyx,ysondre,1929,deathknight,unholy,94,50,44
Smallbaboon,stormreaver,1926,deathknight,unholy,72,33,39
Лордпафос,blackscar,1925,deathknight,unholy,97,55,42
Кромгон,soulflayer,1917,deathknight,unholy,127,64,63
Шадоудез,gordunni,1914,deathknight,unholy,57,31,26
Shadowdeathj,kazzak,1913,deathknight,unholy,54,27,27
Péterpain,antonidas,1912,deathknight,unholy,138,72,66
Ðavy,silvermoon,1910,deathknight,unholy,72,36,36
Zdi,tarren-mill,1905,deathknight,unholy,81,40,41
Èvíl,stormscale,1904,deathknight,unholy,66,33,33
Itreachesout,ravencrest,1903,deathknight,unholy,275,141,134
Hotcherryx,dun-modr,1901,deathknight,unholy,325,162,163
Bedstemoor,ravencrest,1899,deathknight,unholy,144,72,72
Лордэскорт,gordunni,1898,deathknight,unholy,212,107,105
Storhøf,sanguino,1897,deathknight,unholy,120,64,56
Bøby,kul-tiras,1894,deathknight,unholy,72,36,36
Azüla,ysondre,1892,deathknight,unholy,72,33,39
Évìl,stormscale,1884,deathknight,unholy,69,34,35
Akaliz,die-aldor,1876,deathknight,unholy,66,35,31
Ipanic,argent-dawn,1875,deathknight,unholy,228,120,108
Frege,tarren-mill,1875,deathknight,unholy,138,71,67
Eyyoo,blackmoore,1875,deathknight,unholy,70,35,35
Necrølyte,sylvanas,1874,deathknight,unholy,120,64,56
Yazga,blackmoore,1863,deathknight,unholy,77,33,44
Шайбовёрт,gordunni,1861,deathknight,unholy,151,76,75
Narali,argent-dawn,1859,deathknight,unholy,72,34,38
Fxckingmad,ravencrest,1857,deathknight,unholy,108,54,54
Sélyne,dalaran,1857,deathknight,unholy,72,33,39
Väkü,silvermoon,1855,deathknight,unholy,135,71,64
Aeneriah,tarren-mill,1854,deathknight,unholy,194,110,84
Rahbekius,kazzak,1854,deathknight,unholy,156,75,81
Азуэла,gordunni,1853,deathknight,unholy,60,45,15
Fabricius,blackrock,1847,deathknight,unholy,66,36,30
Аронас,blackscar,1846,deathknight,unholy,92,47,45
Cässius,dun-modr,1846,deathknight,unholy,54,23,31
Меланндрис,gordunni,1845,deathknight,unholy,60,44,16
Øtherànóther,stormscale,1843,deathknight,unholy,54,30,24
Ezlyy,ravencrest,1843,deathknight,unholy,114,60,54
Crenshawx,twisting-nether,1842,deathknight,unholy,294,148,146
Vallenhal,twisting-nether,1840,deathknight,unholy,78,36,42
Nómòre,ravencrest,1839,deathknight,unholy,60,30,30
Ampdk,ravencrest,1838,deathknight,unholy,78,44,34
Happsor,eredar,1837,deathknight,unholy,95,47,48
Mockingbirdo,sanguino,1836,deathknight,unholy,36,24,12
Fennro,ysondre,1836,deathknight,unholy,300,147,153
Bephomet,onyxia,1835,deathknight,unholy,213,101,112
Thezftw,kazzak,1834,deathknight,unholy,142,72,70
Дайтоолгоун,gordunni,1834,deathknight,unholy,187,90,97
Butthurtx,stormscale,1831,deathknight,unholy,52,31,21
Sprangers,ravencrest,1831,deathknight,unholy,58,28,30
Namzera,draenor,1827,deathknight,unholy,114,70,44
Рыжаяпедаль,soulflayer,1826,deathknight,unholy,60,36,24
Undeadcell,ravencrest,1826,deathknight,unholy,60,34,26
Leanâdle,hyjal,1826,deathknight,unholy,179,95,84
Radan,stormscale,1821,deathknight,unholy,48,26,22
Zokko,blackrock,1820,deathknight,unholy,59,31,28
Sang,deathwing,1820,deathknight,unholy,214,112,102
Cealdris,blackmoore,1819,deathknight,unholy,30,20,10
Обледенение,gordunni,1819,deathknight,unholy,36,19,17
Lutcher,hellfire,1818,deathknight,unholy,36,20,16
Vakü,burning-legion,1818,deathknight,unholy,802,394,408
Charlytango,archimonde,1818,deathknight,unholy,60,29,31
Бургер,soulflayer,1816,deathknight,unholy,90,39,51
Catloaf,silvermoon,1815,deathknight,unholy,48,21,27
Savra,stormscale,1814,deathknight,unholy,46,27,19
Glower,burning-blade,1814,deathknight,unholy,76,44,32
Змейняша,soulflayer,1814,deathknight,unholy,121,62,59
Murky,kazzak,1814,deathknight,unholy,493,238,255
Holîx,kazzak,1814,deathknight,unholy,95,43,52
Andreàs,silvermoon,1813,deathknight,unholy,60,30,30
Necrofear,grim-batol,1813,deathknight,unholy,144,71,73
Брексиен,gordunni,1813,deathknight,unholy,54,20,34
Аоепупс,gordunni,1811,deathknight,unholy,91,43,48
Wôrgenator,kazzak,1810,deathknight,unholy,64,25,39
Ayra,nethersturm,1809,deathknight,unholy,115,65,50
Акамахи,ashenvale,1809,deathknight,unholy,119,64,55
Amenokoim,blackrock,1809,deathknight,unholy,102,52,50
Râke,teldrassil,1809,deathknight,unholy,126,55,71
Allmawt,argent-dawn,1808,deathknight,unholy,89,51,38
Dräpârn,sylvanas,1808,deathknight,unholy,117,67,50
Смердонос,grom,1808,deathknight,unholy,333,184,149
Qtxi,nozdormu,1808,deathknight,unholy,493,261,232
Stely,alonsus,1805,deathknight,unholy,57,32,25
Køley,draenor,1804,deathknight,unholy,53,30,23
Zdlol,ghostlands,1804,deathknight,unholy,114,59,55
Ronsôn,terrordar,1803,deathknight,unholy,66,36,30
Icegrin,silvermoon,1803,deathknight,unholy,150,81,69
Dk,tarren-mill,1802,deathknight,unholy,102,46,56
Exoflake,kazzak,1801,deathknight,unholy,64,36,28
Maylined,blackrock,1801,deathknight,unholy,48,19,29
Кромгак,soulflayer,1800,deathknight,unholy,86,46,40
Grepetta,argent-dawn,1800,deathknight,unholy,243,121,122
Бешенсство,soulflayer,1799,deathknight,unholy,74,37,37
Zerachy,blackmoore,1795,deathknight,unholy,66,38,28
Verminosis,stormscale,1791,deathknight,unholy,78,31,47
Oweiowei,blackrock,1790,deathknight,unholy,108,59,49
Shanariel,khaz-modan,1788,deathknight,unholy,198,108,90
Jesûsx,ravencrest,1787,deathknight,unholy,130,69,61
Rankor,grim-batol,1786,deathknight,unholy,78,41,37
Дайтоолгоун,deathguard,1785,deathknight,unholy,135,71,64
Gladiadk,ysondre,1783,deathknight,unholy,104,44,60
Nazgül,drakthul,1781,deathknight,unholy,157,88,69
Likewise,twisting-nether,1780,deathknight,unholy,173,80,93
Вирко,eversong,1778,deathknight,unholy,238,125,113
Дэхон,gordunni,1777,deathknight,unholy,85,45,40
Hólix,kazzak,1773,deathknight,unholy,122,68,54
Féarless,archimonde,1773,deathknight,unholy,75,40,35
Aifam,twisting-nether,1772,deathknight,unholy,372,188,184
Táli,tarren-mill,1770,deathknight,unholy,50,24,26
Олинфия,soulflayer,1768,deathknight,unholy,96,45,51
Amyntasz,twisting-nether,1761,deathknight,unholy,60,24,36
Argonat,silvermoon,1759,deathknight,unholy,192,103,89
Inâste,thrall,1759,deathknight,unholy,78,38,40
Apacstanya,ragnaros,1758,deathknight,unholy,120,55,65
Фростинг,gordunni,1757,deathknight,unholy,42,23,19
Некросморк,soulflayer,1755,deathknight,unholy,52,31,21
Unhóly,tarren-mill,1755,deathknight,unholy,151,82,69
Disæse,blackrock,1753,deathknight,unholy,60,34,26
Тхиро,gordunni,1751,deathknight,unholy,125,54,71
Адэлина,soulflayer,1748,deathknight,unholy,165,88,77
Sanlex,twisting-nether,1747,deathknight,unholy,157,74,83
Castlevanía,ravencrest,1744,deathknight,unholy,279,144,135
Inflex,silvermoon,1744,deathknight,unholy,147,72,75
Nødder,ragnaros,1742,deathknight,unholy,337,180,157
Маххес,howling-fjord,1742,deathknight,unholy,145,75,70
Deathmonsta,auchindoun,1741,deathknight,unholy,128,61,67
Verminosis,argent-dawn,1739,deathknight,unholy,75,39,36
Кларенси,soulflayer,1739,deathknight,unholy,78,32,46
Mirídiuss,silvermoon,1738,deathknight,unholy,88,44,44
Oj,darkspear,1735,deathknight,unholy,253,130,123
Фалькра,soulflayer,1734,deathknight,unholy,54,29,25
Dämos,blackmoore,1734,deathknight,unholy,132,66,66
Krisigaped,blackhand,1731,deathknight,unholy,48,25,23
Nèrfx,ragnaros,1725,deathknight,unholy,90,45,45
Darkertimes,ragnaros,1724,deathknight,unholy,405,200,205
Zagoôo,outland,1723,deathknight,unholy,60,25,35
Vexxed,magtheridon,1722,deathknight,unholy,159,90,69
Elyth,kazzak,1722,deathknight,unholy,189,99,90
Quizon,tarren-mill,1721,deathknight,unholy,132,60,72
Merekx,emerald-dream,1720,deathknight,unholy,60,32,28
Synthwave,tarren-mill,1720,deathknight,unholy,159,78,81
Oscman,silvermoon,1719,deathknight,unholy,183,92,91
Zugzugdecay,kazzak,1718,deathknight,unholy,48,27,21
Кулькулегал,ashenvale,1717,deathknight,unholy,66,34,32
Geraltbg,twisting-nether,1716,deathknight,unholy,48,22,26
Sangíus,blackmoore,1715,deathknight,unholy,473,233,240
Garrinchá,stormscale,1715,deathknight,unholy,54,25,29
Darkarthás,aegwynn,1714,deathknight,unholy,36,18,18
Koranderx,argent-dawn,1713,deathknight,unholy,30,18,12
Athanatøs,archimonde,1709,deathknight,unholy,275,139,136
Тыпидо,howling-fjord,1707,deathknight,unholy,78,46,32
Мионеелол,goldrinn,1704,deathknight,unholy,96,45,51
Oßitø,ravencrest,1703,deathknight,unholy,127,70,57
Ктунец,blackscar,1703,deathknight,unholy,87,44,43
Garasu,eredar,1702,deathknight,unholy,89,38,51
Mammacitaa,argent-dawn,1701,deathknight,unholy,95,52,43
Ràiven,blackmoore,1701,deathknight,unholy,65,31,34
Prebi,silvermoon,1700,deathknight,unholy,54,23,31
Tharassian,chamber-of-aspects,1699,deathknight,unholy,78,38,40
Slade,blackrock,1699,deathknight,unholy,160,71,89
Enzÿ,drakthul,1698,deathknight,unholy,54,29,25
Сацкэх,howling-fjord,1698,deathknight,unholy,164,86,78
Maëra,ysondre,1698,deathknight,unholy,78,32,46
Zff,hyjal,1697,deathknight,unholy,102,63,39
Unholyspîrît,outland,1697,deathknight,unholy,66,38,28
Alti,blackmoore,1697,deathknight,unholy,148,80,68
Motvinden,stormscale,1697,deathknight,unholy,112,59,53
Эриданс,gordunni,1696,deathknight,unholy,142,79,63
Fraeya,sunstrider,1695,deathknight,unholy,213,107,106
Qhew,kazzak,1693,deathknight,unholy,48,18,30
Гронташ,howling-fjord,1692,deathknight,unholy,159,82,77
Smörj,aggramar,1692,deathknight,unholy,130,63,67
Arizon,drakthul,1691,deathknight,unholy,98,40,58
Necrotic,blackrock,1690,deathknight,unholy,53,30,23
Deathlog,silvermoon,1690,deathknight,unholy,138,71,67
Impey,kazzak,1689,deathknight,unholy,30,18,12
Reidemorte,minahonda,1689,deathknight,unholy,140,81,59
Darkknights,archimonde,1687,deathknight,unholy,163,85,78
Psychopathz,tarren-mill,1686,deathknight,unholy,60,32,28
Sendurd,ragnaros,1686,deathknight,unholy,167,75,92
Sarconis,quelthalas,1685,deathknight,unholy,46,24,22
Leonis,arthas,1685,deathknight,unholy,84,41,43
Raizhen,ragnaros,1684,deathknight,unholy,60,31,29
Олинф,deathguard,1684,deathknight,unholy,158,75,83
Hellguy,draenor,1683,deathknight,unholy,436,216,220
Ûñhølýðéåthj,tarren-mill,1683,deathknight,unholy,59,28,31
Альдафьод,howling-fjord,1682,deathknight,unholy,41,24,17
ßankoedno,stormscale,1681,deathknight,unholy,120,62,58
Råyzen,draenor,1679,deathknight,unholy,60,31,29
Deathgrab,twisting-nether,1679,deathknight,unholy,256,128,128
Äyrenn,draenor,1677,deathknight,unholy,125,68,57
Nommad,archimonde,1677,deathknight,unholy,275,139,136
Yusehz,kazzak,1677,deathknight,unholy,69,32,37
Lovroo,silvermoon,1677,deathknight,unholy,93,43,50
Sanuky,blackrock,1677,deathknight,unholy,42,18,24
Kharôn,stormscale,1676,deathknight,unholy,114,55,59
Vatø,tarren-mill,1676,deathknight,unholy,60,27,33
Doozz,draenor,1675,deathknight,unholy,193,87,106
Zehahaha,defias-brotherhood,1674,deathknight,unholy,119,51,68
Greymarker,kirin-tor,1673,deathknight,unholy,164,91,73
Джонаджеймсн,soulflayer,1673,deathknight,unholy,196,100,96
Faznik,twisting-nether,1673,deathknight,unholy,297,148,149
Ghostreign,tarren-mill,1673,deathknight,unholy,125,59,66
Økah,outland,1672,deathknight,unholy,106,50,56
Femilista,dun-modr,1671,deathknight,unholy,42,23,19
Dasvidania,ragnaros,1670,deathknight,unholy,42,22,20
Ghaloob,draenor,1667,deathknight,unholy,96,49,47
Sakiko,thrall,1667,deathknight,unholy,54,26,28
Derfitt,sanguino,1666,deathknight,unholy,135,70,65
Feasant,outland,1664,deathknight,unholy,72,43,29
Слендер,howling-fjord,1664,deathknight,unholy,193,98,95
Drachnor,kazzak,1664,deathknight,unholy,89,43,46
Lurkkiss,ravencrest,1664,deathknight,unholy,66,30,36
Vidofnir,argent-dawn,1662,deathknight,unholy,84,46,38
Tenzøftw,archimonde,1662,deathknight,unholy,168,86,82
Blazeberg,blackrock,1661,deathknight,unholy,70,39,31
Моровой,blackscar,1661,deathknight,unholy,136,67,69
Кидер,blackscar,1657,deathknight,unholy,101,53,48
Seal,lightnings-blade,1657,deathknight,unholy,50,25,25
Вовчан,howling-fjord,1657,deathknight,unholy,222,105,117
Jäätynyt,zenedar,1656,deathknight,unholy,726,360,366
Средозавр,howling-fjord,1655,deathknight,unholy,48,31,17
Дарргг,ashenvale,1655,deathknight,unholy,118,63,55
Babsyknight,wildhammer,1655,deathknight,unholy,294,148,146
Kwc,kazzak,1655,deathknight,unholy,204,99,105
Heyä,ysondre,1655,deathknight,unholy,54,25,29
Ilovememes,terenas,1651,deathknight,unholy,71,47,24
Judin,kazzak,1651,deathknight,unholy,68,32,36
Vainajala,die-aldor,1650,deathknight,unholy,94,53,41
Сантамо,soulflayer,1650,deathknight,unholy,194,98,96
Panorboy,tarren-mill,1650,deathknight,unholy,54,23,31
Zoree,draenor,1647,deathknight,unholy,233,124,109
Руин,blackscar,1645,deathknight,unholy,142,77,65
Skulm,twisting-nether,1645,deathknight,unholy,72,30,42
Cheethdoom,ragnaros,1644,deathknight,unholy,70,37,33
Alessia,alonsus,1644,deathknight,unholy,90,46,44
Hordak,stormscale,1642,deathknight,unholy,123,56,67
Pawcio,argent-dawn,1640,deathknight,unholy,224,124,100
Spom,elune,1639,deathknight,unholy,48,21,27
Çruél,silvermoon,1638,deathknight,unholy,48,21,27
Xawias,ulduar,1637,deathknight,unholy,84,43,41
Apolyio,outland,1637,deathknight,unholy,212,106,106
Dejkå,silvermoon,1637,deathknight,unholy,80,38,42
Изуалу,blackscar,1637,deathknight,unholy,54,24,30
Арцевус,gordunni,1636,deathknight,unholy,203,107,96
Skórm,burning-legion,1633,deathknight,unholy,42,21,21
Olriklol,dentarg,1632,deathknight,unholy,35,21,14
Шуршаня,blackscar,1631,deathknight,unholy,110,51,59
Leomordf,doomhammer,1630,deathknight,unholy,394,201,193
Uvros,bloodhoof,1630,deathknight,unholy,48,23,25
Лапочки,gordunni,1628,deathknight,unholy,84,49,35
Herumor,nerzhul,1627,deathknight,unholy,60,32,28
Wallenschøld,kazzak,1627,deathknight,unholy,66,30,36
Рамкар,howling-fjord,1626,deathknight,unholy,134,60,74
Aladonreith,zenedar,1626,deathknight,unholy,52,23,29
Deadlyorca,tarren-mill,1625,deathknight,unholy,42,18,24
Wombo,dentarg,1624,deathknight,unholy,137,69,68
Puzikovatr,tarren-mill,1624,deathknight,unholy,42,17,25
Senkingodx,ravencrest,1624,deathknight,unholy,90,33,57
Сгеатог,gordunni,1623,deathknight,unholy,36,17,19
Jollíe,tarren-mill,1622,deathknight,unholy,134,73,61
Karisteur,azuremyst,1622,deathknight,unholy,60,26,34
Deathboost,archimonde,1622,deathknight,unholy,54,20,34
Apacsom,ragnaros,1621,deathknight,unholy,30,17,13
Quetza,twisting-nether,1621,deathknight,unholy,36,17,19
Giandam,draenor,1621,deathknight,unholy,76,31,45
Шинратенсеи,howling-fjord,1620,deathknight,unholy,95,58,37
Ластофас,gordunni,1620,deathknight,unholy,180,87,93
Armanelo,stormscale,1620,deathknight,unholy,71,33,38
Неондк,eversong,1619,deathknight,unholy,236,112,124
Ipanicfart,argent-dawn,1619,deathknight,unholy,36,17,19
Prekliatylad,burning-blade,1619,deathknight,unholy,83,39,44
Скизм,howling-fjord,1618,deathknight,unholy,156,78,78
Xenfos,tarren-mill,1618,deathknight,unholy,54,23,31
Pandahapci,ragnaros,1617,deathknight,unholy,54,23,31
Maxto,outland,1617,deathknight,unholy,48,20,28
Preddktwo,twisting-nether,1616,deathknight,unholy,24,17,7
Apoikia,argent-dawn,1616,deathknight,unholy,90,47,43
Goùlag,culte-de-la-rive-noire,1616,deathknight,unholy,145,67,78
Taylorswiftz,tarren-mill,1614,deathknight,unholy,36,17,19
Fringles,twisting-nether,1614,deathknight,unholy,36,17,19
Линфео,galakrond,1614,deathknight,unholy,54,22,32
Промештейн,gordunni,1613,deathknight,unholy,141,72,69
Lichbørn,ragnaros,1613,deathknight,unholy,132,65,67
Pellizquitas,sanguino,1612,deathknight,unholy,30,17,13
Cayliadk,tarren-mill,1612,deathknight,unholy,170,91,79
Nasxsy,blackmoore,1612,deathknight,unholy,78,38,40
Snowlegend,der-mithrilorden,1611,deathknight,unholy,66,36,30
Ðaserka,blackrock,1611,deathknight,unholy,39,19,20
Инлакеш,howling-fjord,1611,deathknight,unholy,57,25,32
Drogba,burning-blade,1610,deathknight,unholy,76,39,37
Elliipirelli,doomhammer,1609,deathknight,unholy,136,71,65
Deathcaller,dun-modr,1609,deathknight,unholy,56,29,27
Apoikos,argent-dawn,1609,deathknight,unholy,78,40,38
Hycecream,archimonde,1608,deathknight,unholy,120,51,69
Blízna,kazzak,1607,deathknight,unholy,238,121,117
Bijb,kragjin,1607,deathknight,unholy,48,17,31
Stinglelz,chogall,1606,deathknight,unholy,47,26,21
Вурдулакх,gordunni,1606,deathknight,unholy,212,109,103
Spøøk,defias-brotherhood,1606,deathknight,unholy,54,26,28
Вондум,howling-fjord,1606,deathknight,unholy,42,18,24
Khalifamia,alonsus,1604,deathknight,unholy,66,32,34
Blueironjr,kazzak,1603,deathknight,unholy,36,23,13
Gøretterog,ysondre,1603,deathknight,unholy,30,18,12
Sølîta,archimonde,1603,deathknight,unholy,89,47,42
Bølvar,zuljin,1602,deathknight,unholy,44,25,19
Trialist,dun-modr,1602,deathknight,unholy,54,30,24
Bloodraynee,twisting-nether,1602,deathknight,unholy,114,58,56
Nurekindk,argent-dawn,1602,deathknight,unholy,179,89,90
Alameda,nathrezim,1602,deathknight,unholy,54,23,31
Reann,argent-dawn,1601,deathknight,unholy,61,33,28
Ðiesel,stormscale,1601,deathknight,unholy,266,130,136
Mercdk,ravencrest,1601,deathknight,unholy,90,41,49
Aceléss,drakthul,1600,deathknight,unholy,42,20,22
Ecormcpz,eredar,1600,deathknight,unholy,48,22,26
Mojodango,outland,1597,deathknight,unholy,32,19,13
Тумм,howling-fjord,1597,deathknight,unholy,48,24,24
Judythegreat,silvermoon,1596,deathknight,unholy,309,160,149
Ghoulish,outland,1594,deathknight,unholy,209,102,107
Shabiri,twisting-nether,1593,deathknight,unholy,180,99,81
Turboface,kazzak,1591,deathknight,unholy,124,68,56
Кокосоус,gordunni,1591,deathknight,unholy,89,41,48
Ashgôrath,defias-brotherhood,1591,deathknight,unholy,74,29,45
Cremefresh,ragnaros,1590,deathknight,unholy,45,24,21
Creatar,kazzak,1588,deathknight,unholy,93,50,43
Feministi,stormreaver,1588,deathknight,unholy,162,79,83
Моорта,soulflayer,1586,deathknight,unholy,397,206,191
Larrydk,tarren-mill,1585,deathknight,unholy,36,21,15
Swavsgothgf,ravencrest,1585,deathknight,unholy,30,17,13
Thairq,drakthul,1584,deathknight,unholy,66,40,26
Bredox,ravencrest,1582,deathknight,unholy,63,27,36
Halez,antonidas,1581,deathknight,unholy,198,101,97
Yagoora,silvermoon,1581,deathknight,unholy,88,35,53
Linuzbunny,zenedar,1580,deathknight,unholy,30,18,12
Ezlar,silvermoon,1579,deathknight,unholy,79,47,32
Jiodythyy,archimonde,1578,deathknight,unholy,66,28,38
Abomination,emeriss,1577,deathknight,unholy,334,160,174
Diabeticus,the-maelstrom,1577,deathknight,unholy,42,18,24
Orktra,stormscale,1576,deathknight,unholy,72,36,36
Excaliuz,silvermoon,1575,deathknight,unholy,41,19,22
Торедх,howling-fjord,1575,deathknight,unholy,90,41,49
Винерас,soulflayer,1574,deathknight,unholy,159,79,80
Triffdich,blackrock,1574,deathknight,unholy,256,126,130
Deathvid,ravencrest,1573,deathknight,unholy,126,66,60
Abcdk,sargeras,1572,deathknight,unholy,68,39,29
Inudworf,outland,1571,deathknight,unholy,81,41,40
Raziee,twisting-nether,1571,deathknight,unholy,125,60,65
Zektal,thrall,1571,deathknight,unholy,139,62,77
Ahilus,bladefist,1570,deathknight,unholy,110,55,55
Ilovebigass,ravencrest,1569,deathknight,unholy,60,30,30
Reapocalypse,blackhand,1566,deathknight,unholy,399,202,197
Аркёт,howling-fjord,1566,deathknight,unholy,125,59,66
Lorvetis,malorne,1565,deathknight,unholy,104,56,48
Branchë,stormscale,1565,deathknight,unholy,281,140,141
Apatheia,stormscale,1565,deathknight,unholy,86,41,45
Sythuss,argent-dawn,1565,deathknight,unholy,72,30,42
Pangen,ravencrest,1564,deathknight,unholy,137,63,74
Körthazz,hyjal,1563,deathknight,unholy,55,27,28
Slawtér,arathor,1562,deathknight,unholy,56,30,26
Söttguetsi,blackrock,1560,deathknight,unholy,53,29,24
Apolloälf,blackrock,1560,deathknight,unholy,40,19,21
Nysaia,blackmoore,1559,deathknight,unholy,84,39,45
Inmau,sanguino,1557,deathknight,unholy,45,18,27
Хассандра,galakrond,1554,deathknight,unholy,117,58,59
Sugarcakedk,blackrock,1554,deathknight,unholy,155,74,81
Aleejha,draenor,1551,deathknight,unholy,70,39,31
Yamisukehiro,drakthul,1551,deathknight,unholy,60,28,32
Arkaris,blackmoore,1550,deathknight,unholy,86,52,34
Emphendk,twisting-nether,1550,deathknight,unholy,120,55,65
Tölp,ravencrest,1549,deathknight,unholy,192,97,95
Høpes,chogall,1549,deathknight,unholy,54,26,28
Rebeast,blackhand,1549,deathknight,unholy,47,19,28
Енваки,gordunni,1548,deathknight,unholy,114,59,55
Gargalon,drakthul,1547,deathknight,unholy,102,52,50
Yandeäth,chants-éternels,1547,deathknight,unholy,412,207,205
Спавни,blackscar,1547,deathknight,unholy,229,114,115
Micaiah,dun-modr,1547,deathknight,unholy,72,33,39
Rûnâr,proudmoore,1545,deathknight,unholy,45,28,17
Нарилуне,blackscar,1545,deathknight,unholy,667,338,329
Canesexxo,pozzo-delleternità,1543,deathknight,unholy,84,47,37
Элекна,deepholm,1541,deathknight,unholy,48,24,24
Bokrak,norgannon,1539,deathknight,unholy,165,92,73
Asakim,tarren-mill,1538,deathknight,unholy,41,17,24
Валерамопс,soulflayer,1537,deathknight,unholy,41,19,22
Дерайв,gordunni,1536,deathknight,unholy,138,68,70
Leyir,shendralar,1535,deathknight,unholy,54,29,25
Gûuts,archimonde,1535,deathknight,unholy,325,173,152
Sxyd,silvermoon,1535,deathknight,unholy,155,70,85
Gushik,twisting-nether,1534,deathknight,unholy,126,71,55
Руариди,gordunni,1534,deathknight,unholy,48,25,23
Pängei,frostwolf,1534,deathknight,unholy,41,19,22
Хорссэ,soulflayer,1532,deathknight,unholy,91,48,43
Necrotickiss,frostwolf,1531,deathknight,unholy,32,18,14
Дрогдош,howling-fjord,1531,deathknight,unholy,72,38,34
Baltersa,blackhand,1531,deathknight,unholy,72,28,44
Рэндрей,gordunni,1529,deathknight,unholy,93,51,42
Lockhead,stormscale,1529,deathknight,unholy,205,104,101
Израф,fordragon,1528,deathknight,unholy,50,21,29
Exanex,ragnaros,1527,deathknight,unholy,42,24,18
Диджейфрау,deathguard,1527,deathknight,unholy,30,16,14
Dzemoo,drakthul,1525,deathknight,unholy,83,43,40
Frags,arathor,1524,deathknight,unholy,120,60,60
Мёрдерфэйсх,soulflayer,1522,deathknight,unholy,292,150,142
Noizt,ravencrest,1522,deathknight,unholy,42,18,24
Dörfl,antonidas,1521,deathknight,unholy,87,42,45
Gripbroblem,nemesis,1521,deathknight,unholy,42,16,26
Ittei,ahnqiraj,1520,deathknight,unholy,30,22,8
Woddey,blackrock,1520,deathknight,unholy,72,39,33
Misazabanshi,blackrock,1519,deathknight,unholy,108,59,49
Yousaindk,blackrock,1519,deathknight,unholy,60,29,31
Ахелекус,blackscar,1518,deathknight,unholy,106,54,52
Erodevil,kazzak,1518,deathknight,unholy,111,52,59
Deathcaller,zuljin,1517,deathknight,unholy,107,51,56
Alroc,blackrock,1516,deathknight,unholy,56,25,31
Ilius,kelthuzad,1513,deathknight,unholy,153,80,73
Kalenjii,burning-legion,1513,deathknight,unholy,58,30,28
Gruzzaghkull,azuremyst,1513,deathknight,unholy,48,18,30
Ехтрим,howling-fjord,1512,deathknight,unholy,65,30,35
Manego,eredar,1511,deathknight,unholy,30,18,12
Zariia,twisting-nether,1511,deathknight,unholy,150,80,70
Unglück,die-aldor,1511,deathknight,unholy,168,87,81
Grendul,blackmoore,1510,deathknight,unholy,60,26,34
Cleverb,silvermoon,1509,deathknight,unholy,83,43,40
Saerus,kazzak,1508,deathknight,unholy,233,124,109
Ínví,aegwynn,1508,deathknight,unholy,169,88,81
Dklékata,archimonde,1508,deathknight,unholy,141,69,72
Anathela,dalaran,1508,deathknight,unholy,85,40,45
Трибунальщик,gordunni,1508,deathknight,unholy,60,27,33
Bigblackgrip,hyjal,1508,deathknight,unholy,42,16,26
Barnalord,dentarg,1506,deathknight,unholy,54,27,27
Darhma,archimonde,1506,deathknight,unholy,104,47,57
Агереро,howling-fjord,1505,deathknight,unholy,88,46,42
Nîghtmáre,ravencrest,1505,deathknight,unholy,94,47,47
Lavonobatas,kazzak,1503,deathknight,unholy,60,30,30
Глэмнутый,howling-fjord,1503,deathknight,unholy,125,60,65
Deathcam,emerald-dream,1502,deathknight,unholy,95,45,50
Goblinslayer,zuljin,1501,deathknight,unholy,118,61,57
Amelia,ambossar,1500,deathknight,unholy,38,21,17
Unchaindk,outland,1500,deathknight,unholy,136,68,68
Bertonilo,burning-legion,1500,deathknight,unholy,84,39,45
Hemopathy,tarren-mill,1499,deathknight,unholy,30,16,14
Барагган,thermaplugg,1499,deathknight,unholy,144,73,71
Thánátós,hyjal,1499,deathknight,unholy,60,27,33
Serelis,argent-dawn,1497,deathknight,unholy,60,27,33
Teljujad,sanguino,1496,deathknight,unholy,163,82,81
Анзорини,gordunni,1496,deathknight,unholy,84,31,53
Mávé,tarren-mill,1495,deathknight,unholy,69,32,37
Segrim,drakthul,1493,deathknight,unholy,173,89,84
Gharzhul,xavius,1493,deathknight,unholy,50,24,26
Борнтудай,borean-tundra,1492,deathknight,unholy,72,30,42
Кланки,soulflayer,1491,deathknight,unholy,142,71,71
Recoil,blackrock,1490,deathknight,unholy,26,17,9
Exoduss,dunemaul,1490,deathknight,unholy,141,72,69
Metalmanethé,tarren-mill,1489,deathknight,unholy,284,140,144
Rizzlerdk,blackhand,1489,deathknight,unholy,114,49,65
Neorteriona,argent-dawn,1488,deathknight,unholy,159,88,71
Crazyanimal,silvermoon,1488,deathknight,unholy,163,78,85
Nuadar,outland,1488,deathknight,unholy,42,16,26
Анихиме,howling-fjord,1487,deathknight,unholy,98,51,47
Кадавров,gordunni,1486,deathknight,unholy,140,76,64
Dekayo,blackrock,1484,deathknight,unholy,68,34,34
Nolíferx,outland,1483,deathknight,unholy,78,40,38
Riceeater,kazzak,1483,deathknight,unholy,59,29,30
Veçh,turalyon,1483,deathknight,unholy,167,80,87
Катаринья,howling-fjord,1483,deathknight,unholy,59,26,33
Xirra,tarren-mill,1481,deathknight,unholy,245,126,119
Дкшрёдингера,gordunni,1481,deathknight,unholy,126,63,63
Calina,frostwolf,1480,deathknight,unholy,72,26,46
Полонит,gordunni,1479,deathknight,unholy,113,54,59
Кристер,lich-king,1479,deathknight,unholy,66,30,36
Leipä,scarshield-legion,1478,deathknight,unholy,42,19,23
Vrark,forscherliga,1477,deathknight,unholy,34,19,15
Rektsohard,ravencrest,1477,deathknight,unholy,96,49,47
Вирзерагна,howling-fjord,1476,deathknight,unholy,126,71,55
Лекъса,gordunni,1476,deathknight,unholy,328,164,164
Протосеня,soulflayer,1476,deathknight,unholy,167,80,87
Necromedes,kazzak,1475,deathknight,unholy,82,46,36
Polimeh,draenor,1473,deathknight,unholy,84,45,39
Walkeni,defias-brotherhood,1473,deathknight,unholy,134,66,68
Шмуркич,gordunni,1473,deathknight,unholy,98,48,50
Notsyndra,nemesis,1473,deathknight,unholy,55,26,29
Deathkanta,antonidas,1472,deathknight,unholy,36,17,19
Ymirzo,outland,1471,deathknight,unholy,30,16,14
Knoxhult,kazzak,1471,deathknight,unholy,54,22,32
Ardros,eredar,1470,deathknight,unholy,108,52,56
Homunculas,twisting-nether,1470,deathknight,unholy,76,35,41
Ihatenames,twisting-nether,1469,deathknight,unholy,125,60,65
Ультерис,deathguard,1468,deathknight,unholy,24,17,7
Sorostew,twisting-nether,1468,deathknight,unholy,86,45,41
Utyr,ragnaros,1468,deathknight,unholy,196,97,99
Gødofredo,dun-modr,1467,deathknight,unholy,144,79,65
Arxelas,sylvanas,1467,deathknight,unholy,115,60,55
Moko,defias-brotherhood,1467,deathknight,unholy,54,25,29
Mongopogger,defias-brotherhood,1466,deathknight,unholy,92,52,40
Zóur,rajaxx,1466,deathknight,unholy,119,66,53
Freakabiceps,draenor,1466,deathknight,unholy,84,39,45
Kérmít,tarren-mill,1465,deathknight,unholy,160,88,72
Балаар,galakrond,1465,deathknight,unholy,98,49,49
Thanatus,aggra-português,1465,deathknight,unholy,48,23,25
Lifetakergr,sylvanas,1465,deathknight,unholy,40,16,24
Дискодансер,ashenvale,1463,deathknight,unholy,42,22,20
Емтвоюкиску,soulflayer,1462,deathknight,unholy,52,24,28
Zeghor,ragnaros,1462,deathknight,unholy,114,51,63
Turkknight,outland,1462,deathknight,unholy,36,16,20
Bärdk,forscherliga,1461,deathknight,unholy,95,47,48
Drãka,twisting-nether,1460,deathknight,unholy,88,49,39
Шифычдк,howling-fjord,1460,deathknight,unholy,60,27,33
Nospets,kazzak,1459,deathknight,unholy,54,25,29
Gethunts,drakthul,1457,deathknight,unholy,42,25,17
Holaroris,drakthul,1457,deathknight,unholy,54,31,23
Hêalz,ungoro,1456,deathknight,unholy,120,63,57
Rimewraith,argent-dawn,1456,deathknight,unholy,87,43,44
Bígzoran,kazzak,1456,deathknight,unholy,60,29,31
Hawkthuglife,dun-modr,1455,deathknight,unholy,143,69,74
Сванхильда,grom,1454,deathknight,unholy,299,146,153
Petardodupy,burning-legion,1453,deathknight,unholy,72,38,34
Yeamaon,ravencrest,1453,deathknight,unholy,48,17,31
Wtfisthisdmg,blackmoore,1452,deathknight,unholy,58,29,29
Bonethugg,burning-legion,1452,deathknight,unholy,60,29,31
Skèltòn,rexxar,1451,deathknight,unholy,73,47,26
Megdeath,silvermoon,1451,deathknight,unholy,138,65,73
Hokdk,voljin,1451,deathknight,unholy,119,48,71
Ceranto,frostwolf,1450,deathknight,unholy,90,52,38
Ceedrik,nemesis,1450,deathknight,unholy,34,16,18
Thecurator,ragnaros,1450,deathknight,unholy,111,52,59
Dharniman,sylvanas,1450,deathknight,unholy,52,23,29
Icep,archimonde,1449,deathknight,unholy,78,38,40
Sathmayla,silvermoon,1448,deathknight,unholy,53,32,21
Ссагарисс,galakrond,1448,deathknight,unholy,42,16,26
Demrior,hellfire,1447,deathknight,unholy,66,27,39
Âlîce,culte-de-la-rive-noire,1446,deathknight,unholy,72,43,29
Fuzzyofc,draenor,1446,deathknight,unholy,102,42,60
Darksalezian,drakthul,1445,deathknight,unholy,113,60,53
Quantumshift,ravencrest,1444,deathknight,unholy,36,23,13
Unholy,ragnaros,1444,deathknight,unholy,38,20,18
Majlus,outland,1444,deathknight,unholy,74,35,39
Rabbijacob,ysondre,1444,deathknight,unholy,209,94,115
Sîck,bladefist,1444,deathknight,unholy,78,29,49
Grubbins,kul-tiras,1442,deathknight,unholy,82,43,39
Insanïac,draenor,1440,deathknight,unholy,39,18,21
Morinosei,twisting-nether,1438,deathknight,unholy,125,69,56
Lothqgar,burning-legion,1438,deathknight,unholy,134,69,65
Fýhr,silvermoon,1437,deathknight,unholy,114,59,55
Капустас,gordunni,1437,deathknight,unholy,108,50,58
Tilixdk,draenor,1437,deathknight,unholy,48,22,26
Касуляпвнз,gordunni,1436,deathknight,unholy,60,29,31
Demonicaltar,dalaran,1436,deathknight,unholy,42,16,26
Mîîkkaa,blackhand,1435,deathknight,unholy,42,15,27
Mennal,the-maelstrom,1434,deathknight,unholy,55,32,23
Дедхо,soulflayer,1434,deathknight,unholy,62,28,34
Таможникс,soulflayer,1433,deathknight,unholy,65,36,29
Ridire,saurfang,1433,deathknight,unholy,69,38,31
Gegham,ravencrest,1433,deathknight,unholy,58,30,28
Chrispbacøn,ragnaros,1433,deathknight,unholy,40,19,21
Katatönias,archimonde,1432,deathknight,unholy,76,34,42
Deusmort,ravencrest,1432,deathknight,unholy,135,60,75
Elcapìtan,silvermoon,1431,deathknight,unholy,24,15,9
Numnuts,alakir,1430,deathknight,unholy,42,21,21
Valanaari,argent-dawn,1430,deathknight,unholy,61,29,32
Форнителли,howling-fjord,1430,deathknight,unholy,120,54,66
Westdx,hyjal,1429,deathknight,unholy,78,41,37
Deadkilla,stormreaver,1429,deathknight,unholy,72,33,39
Dariusgrip,kazzak,1429,deathknight,unholy,36,15,21
Empiu,blackhand,1427,deathknight,unholy,102,57,45
Goreshovel,stormscale,1426,deathknight,unholy,144,72,72
Дядьдим,soulflayer,1426,deathknight,unholy,99,49,50
Бреч,gordunni,1426,deathknight,unholy,81,34,47
Шейзо,soulflayer,1424,deathknight,unholy,39,22,17
Draforce,quelthalas,1424,deathknight,unholy,75,42,33
Assgripper,hyjal,1423,deathknight,unholy,71,41,30
Späwn,ysondre,1422,deathknight,unholy,64,24,40
Микелон,gordunni,1421,deathknight,unholy,34,21,13
Elmyo,argent-dawn,1421,deathknight,unholy,54,24,30
Discochoppa,blackmoore,1421,deathknight,unholy,36,15,21
Wlcrealworld,ravencrest,1419,deathknight,unholy,56,30,26
Ohsevèn,ravencrest,1419,deathknight,unholy,71,38,33
Алсидис,gordunni,1419,deathknight,unholy,114,46,68
Logoz,dun-modr,1418,deathknight,unholy,36,18,18
Pavkata,outland,1417,deathknight,unholy,248,122,126
Kebabpizza,argent-dawn,1417,deathknight,unholy,109,53,56
Lastprophet,drakthul,1417,deathknight,unholy,70,25,45
Аирфрост,howling-fjord,1416,deathknight,unholy,54,25,29
Arxelas,stormscale,1416,deathknight,unholy,72,30,42
Jihm,silvermoon,1415,deathknight,unholy,173,93,80
Styxdk,blackhand,1415,deathknight,unholy,30,15,15
Juliean,blackmoore,1415,deathknight,unholy,106,49,57
Wolfyy,antonidas,1415,deathknight,unholy,78,36,42
Pestilerous,draenor,1415,deathknight,unholy,48,17,31
Darknemesis,nemesis,1413,deathknight,unholy,62,26,36
Сенкрул,gordunni,1412,deathknight,unholy,78,50,28
Bàdtank,hyjal,1411,deathknight,unholy,103,57,46
Dkbladet,ravencrest,1411,deathknight,unholy,132,68,64
Juicyjayho,stormscale,1411,deathknight,unholy,60,27,33
Сивкабурка,fordragon,1411,deathknight,unholy,78,35,43
Fenixflexin,ravencrest,1410,deathknight,unholy,48,15,33
Terren,ravencrest,1409,deathknight,unholy,52,29,23
Unholycard,argent-dawn,1409,deathknight,unholy,108,56,52
Ðeadghøul,silvermoon,1409,deathknight,unholy,42,20,22
Jalapeñofan,tarren-mill,1407,deathknight,unholy,117,58,59
Dhampir,tarren-mill,1407,deathknight,unholy,67,27,40
Demonium,twisting-nether,1407,deathknight,unholy,69,26,43
Krinoe,dalaran,1406,deathknight,unholy,53,28,25
Zandruq,twisting-nether,1404,deathknight,unholy,189,97,92
Chillstreak,twisting-nether,1404,deathknight,unholy,78,33,45
Flinsen,blackmoore,1403,deathknight,unholy,260,141,119
Grezak,defias-brotherhood,1403,deathknight,unholy,43,20,23
Eddrich,aegwynn,1402,deathknight,unholy,92,47,45
Iluzis,kazzak,1400,deathknight,unholy,60,30,30
Shewoman,stormreaver,1400,deathknight,unholy,42,17,25
Zracul,nordrassil,1399,deathknight,unholy,141,74,67
Calhoun,teldrassil,1398,deathknight,unholy,35,15,20
Sictir,stormscale,1397,deathknight,unholy,401,200,201
Maradk,drakthul,1396,deathknight,unholy,305,150,155
Субботин,soulflayer,1395,deathknight,unholy,35,20,15
Darkeron,dun-modr,1395,deathknight,unholy,56,31,25
Ganessha,sanguino,1395,deathknight,unholy,121,60,61
Héroe,zuljin,1395,deathknight,unholy,54,15,39
Kekebas,twisting-nether,1394,deathknight,unholy,96,54,42
Gaurk,aggra-português,1393,deathknight,unholy,94,51,43
Ryäñ,silvermoon,1393,deathknight,unholy,51,22,29
Dizin,ravencrest,1393,deathknight,unholy,68,28,40
Анфалагон,gordunni,1392,deathknight,unholy,114,56,58
Civilredevil,ravencrest,1391,deathknight,unholy,42,18,24
Lilyxtulle,tarren-mill,1390,deathknight,unholy,298,153,145
Dzwiadke,burning-legion,1390,deathknight,unholy,154,72,82
Estoico,ragnaros,1388,deathknight,unholy,107,52,55
Десхоб,soulflayer,1385,deathknight,unholy,175,71,104
Axram,ravencrest,1384,deathknight,unholy,108,50,58
Tuggis,outland,1384,deathknight,unholy,60,25,35
Beherith,sunstrider,1383,deathknight,unholy,47,31,16
Akelæ,draenor,1383,deathknight,unholy,130,68,62
Epoch,azjolnerub,1383,deathknight,unholy,115,52,63
Bloodkatana,drakthul,1382,deathknight,unholy,84,37,47
Nellath,kazzak,1382,deathknight,unholy,125,53,72
Naimuakovaa,ravencrest,1380,deathknight,unholy,18,15,3
Zarad,scarshield-legion,1379,deathknight,unholy,82,41,41
Gengàr,tarren-mill,1379,deathknight,unholy,30,15,15
Nødæd,sanguino,1379,deathknight,unholy,112,52,60
Reezeer,stormscale,1379,deathknight,unholy,41,18,23
Sorcc,burning-legion,1378,deathknight,unholy,156,75,81
Luzifear,bloodscalp,1378,deathknight,unholy,60,21,39
Nauser,kazzak,1377,deathknight,unholy,101,47,54
Шарабум,howling-fjord,1377,deathknight,unholy,65,29,36
Xado,frostwolf,1376,deathknight,unholy,138,72,66
Ullefuz,silvermoon,1375,deathknight,unholy,81,41,40
Fizzdk,pozzo-delleternità,1375,deathknight,unholy,60,28,32
Puppétmastér,kazzak,1374,deathknight,unholy,96,47,49
Flawstmourne,kazzak,1374,deathknight,unholy,35,15,20
Frostplague,aegwynn,1374,deathknight,unholy,66,27,39
Pëstîléñcè,ravencrest,1372,deathknight,unholy,27,18,9
Sevatar,zuljin,1372,deathknight,unholy,24,16,8
Manovar,archimonde,1372,deathknight,unholy,371,179,192
Anaralien,ravencrest,1371,deathknight,unholy,188,87,101
Mayaya,malganis,1370,deathknight,unholy,52,28,24
Roaredrick,draenor,1370,deathknight,unholy,109,52,57
Jöndas,drakthul,1369,deathknight,unholy,71,38,33
Aesthaetik,draenor,1369,deathknight,unholy,70,36,34
Venexia,kazzak,1369,deathknight,unholy,64,31,33
Fosswire,stormscale,1369,deathknight,unholy,54,26,28
Vrez,argent-dawn,1369,deathknight,unholy,42,16,26
Tyvra,blackhand,1369,deathknight,unholy,47,17,30
Wintersir,tarren-mill,1368,deathknight,unholy,59,31,28
Huekun,draenor,1366,deathknight,unholy,86,39,47
Defeated,thrall,1365,deathknight,unholy,285,141,144
Tobtób,antonidas,1365,deathknight,unholy,72,28,44
Энвилион,howling-fjord,1362,deathknight,unholy,191,91,100
Mìa,kragjin,1362,deathknight,unholy,109,49,60
Skøurge,silvermoon,1361,deathknight,unholy,284,141,143
Mellowqt,aegwynn,1358,deathknight,unholy,121,67,54
Deadroses,tarren-mill,1357,deathknight,unholy,156,83,73
Мурмадонище,soulflayer,1356,deathknight,unholy,50,29,21
Dorkmoal,blackmoore,1355,deathknight,unholy,114,55,59
Зибак,soulflayer,1353,deathknight,unholy,87,43,44
Ithis,zuljin,1351,deathknight,unholy,281,135,146
Xênôrr,archimonde,1350,deathknight,unholy,84,41,43
Bitdead,doomhammer,1349,deathknight,unholy,60,35,25
Gorruk,malorne,1348,deathknight,unholy,182,88,94
Booneuh,kazzak,1346,deathknight,unholy,84,42,42
Mcrune,ravencrest,1345,deathknight,unholy,78,35,43
Msvine,kazzak,1344,deathknight,unholy,169,89,80
Mamanica,sanguino,1344,deathknight,unholy,48,23,25
Vezthel,stormscale,1344,deathknight,unholy,97,38,59
Nextyi,blackmoore,1343,deathknight,unholy,30,14,16
Twardobaba,burning-legion,1342,deathknight,unholy,54,27,27
Julezer,malganis,1342,deathknight,unholy,30,14,16
Хейткрю,howling-fjord,1342,deathknight,unholy,48,21,27
Кромгондк,soulflayer,1342,deathknight,unholy,42,14,28
Dunkàn,silvermoon,1341,deathknight,unholy,124,71,53
Diseasecow,tarren-mill,1341,deathknight,unholy,72,34,38
Chocopeanut,ravencrest,1339,deathknight,unholy,54,32,22
Envious,archimonde,1339,deathknight,unholy,30,14,16
Анкара,ashenvale,1338,deathknight,unholy,145,71,74
Frostich,ragnaros,1338,deathknight,unholy,35,15,20
Lividity,blackhand,1337,deathknight,unholy,48,28,20
Prænklý,blackrock,1336,deathknight,unholy,90,44,46
Züg,draenor,1336,deathknight,unholy,120,56,64
Blorin,sylvanas,1335,deathknight,unholy,115,51,64
Darkhallow,thrall,1334,deathknight,unholy,219,115,104
Блодскал,howling-fjord,1334,deathknight,unholy,111,52,59
Boreghar,drakthul,1333,deathknight,unholy,30,14,16
Raust,xavius,1333,deathknight,unholy,144,62,82
Arthrex,twisting-nether,1332,deathknight,unholy,54,29,25
Bloodbane,burning-blade,1332,deathknight,unholy,96,43,53
Хенстор,gordunni,1332,deathknight,unholy,101,44,57
Mawdrym,twisting-nether,1332,deathknight,unholy,35,15,20
Alamo,doomhammer,1331,deathknight,unholy,24,14,10
Варделон,gordunni,1331,deathknight,unholy,66,36,30
Scotty,ravencrest,1330,deathknight,unholy,30,14,16
Armax,stormscale,1329,deathknight,unholy,30,14,16
Sonofalích,aerie-peak,1328,deathknight,unholy,73,37,36
Ravencraft,azjolnerub,1328,deathknight,unholy,30,14,16
Планус,booty-bay,1327,deathknight,unholy,39,24,15
Джайвана,soulflayer,1325,deathknight,unholy,391,198,193
Nekote,silvermoon,1325,deathknight,unholy,51,24,27
Crostrike,kazzak,1324,deathknight,unholy,41,23,18
Астартэс,deathguard,1322,deathknight,unholy,77,39,38
Ârtjom,aegwynn,1322,deathknight,unholy,99,46,53
Persefal,nemesis,1322,deathknight,unholy,91,41,50
Darkniightt,outland,1322,deathknight,unholy,41,18,23
Deathj,ravencrest,1321,deathknight,unholy,24,15,9
Потный,soulflayer,1321,deathknight,unholy,45,18,27
Teflonphobos,stormreaver,1320,deathknight,unholy,18,14,4
Bloodykushin,burning-legion,1320,deathknight,unholy,42,22,20
Тряпьё,galakrond,1319,deathknight,unholy,23,15,8
Drayvinn,twisting-nether,1319,deathknight,unholy,60,25,35
Deathuss,silvermoon,1318,deathknight,unholy,115,53,62
Ziuziu,twisting-nether,1318,deathknight,unholy,54,15,39
Deathlïght,nemesis,1317,deathknight,unholy,119,59,60
Jujudk,tarren-mill,1317,deathknight,unholy,207,100,107
Detrah,argent-dawn,1315,deathknight,unholy,52,27,25
Еххел,soulflayer,1315,deathknight,unholy,54,28,26
Veyrøn,kazzak,1314,deathknight,unholy,96,49,47
Fineral,argent-dawn,1314,deathknight,unholy,68,33,35
Metalist,ravencrest,1313,deathknight,unholy,137,65,72
Feugen,hyjal,1309,deathknight,unholy,54,28,26
Galayn,burning-legion,1309,deathknight,unholy,104,43,61
Riannoc,argent-dawn,1308,deathknight,unholy,30,17,13
Ecoya,blackrock,1308,deathknight,unholy,89,40,49
Nevmyrayka,silvermoon,1305,deathknight,unholy,34,18,16
Grubyr,burning-legion,1302,deathknight,unholy,78,38,40
Triqué,antonidas,1302,deathknight,unholy,54,25,29
Алкеокол,soulflayer,1301,deathknight,unholy,51,24,27
Ahlat,blackmoore,1300,deathknight,unholy,113,65,48
Syncros,blackrock,1300,deathknight,unholy,42,19,23
Deathpaladin,blackmoore,1298,deathknight,unholy,36,15,21
Крикед,soulflayer,1297,deathknight,unholy,102,55,47
Дэбон,howling-fjord,1297,deathknight,unholy,156,74,82
Plagueherald,ravencrest,1296,deathknight,unholy,30,14,16
Izanagii,exodar,1296,deathknight,unholy,36,16,20
Sveinnhran,kazzak,1295,deathknight,unholy,303,147,156
Zeolingk,tarren-mill,1294,deathknight,unholy,86,34,52
Mêlian,blackmoore,1294,deathknight,unholy,36,14,22
Альмон,howling-fjord,1293,deathknight,unholy,72,34,38
Mediul,magtheridon,1292,deathknight,unholy,120,57,63
Zegaan,kazzak,1291,deathknight,unholy,132,61,71
Ничер,thermaplugg,1289,deathknight,unholy,24,14,10
Pjthedk,lightbringer,1289,deathknight,unholy,95,47,48
Kazildark,ravencrest,1288,deathknight,unholy,42,21,21
Azrìal,agamaggan,1287,deathknight,unholy,83,39,44
Tyranus,quelthalas,1287,deathknight,unholy,216,101,115
Fixmybones,frostmane,1286,deathknight,unholy,78,30,48
Morssal,outland,1284,deathknight,unholy,35,17,18
Айос,ashenvale,1280,deathknight,unholy,78,37,41
Constantyn,blackrock,1280,deathknight,unholy,42,19,23
Endlesspain,burning-legion,1280,deathknight,unholy,58,24,34
Diatriss,argent-dawn,1279,deathknight,unholy,75,36,39
Брюшина,gordunni,1279,deathknight,unholy,90,36,54
Laobeef,twisting-nether,1278,deathknight,unholy,53,23,30
Elíta,draenor,1278,deathknight,unholy,42,18,24
Feekus,deathwing,1273,deathknight,unholy,54,32,22
Роземайер,ashenvale,1273,deathknight,unholy,132,63,69
Hðsh,ysondre,1270,deathknight,unholy,28,14,14
Reportmeplz,ragnaros,1270,deathknight,unholy,48,22,26
Skalbjörn,arathor,1270,deathknight,unholy,54,24,30
Necrozy,aggra-português,1269,deathknight,unholy,84,43,41
Katakurî,blackmoore,1269,deathknight,unholy,74,29,45
Dunklerlord,malfurion,1267,deathknight,unholy,48,20,28
Crudelias,aegwynn,1266,deathknight,unholy,42,22,20
Rimda,twisting-nether,1265,deathknight,unholy,26,14,12
Undtot,azshara,1264,deathknight,unholy,36,16,20
Ммиднайтт,blackscar,1264,deathknight,unholy,36,15,21
Rammsteïn,ravencrest,1264,deathknight,unholy,68,28,40
Heyabigail,wildhammer,1263,deathknight,unholy,139,63,76
Кмамехочу,howling-fjord,1262,deathknight,unholy,36,22,14
Drenodur,amanthul,1261,deathknight,unholy,24,14,10
Superere,hyjal,1261,deathknight,unholy,36,17,19
Obstwald,blackrock,1260,deathknight,unholy,193,99,94
Sound,shadowsong,1260,deathknight,unholy,124,59,65
Tenofas,nemesis,1258,deathknight,unholy,33,16,17
Томиганн,grom,1257,deathknight,unholy,155,74,81
Бенечках,gordunni,1257,deathknight,unholy,40,16,24
Kratagon,thrall,1257,deathknight,unholy,90,34,56
Авагон,howling-fjord,1256,deathknight,unholy,69,34,35
Plagueknight,ravencrest,1256,deathknight,unholy,90,37,53
Tesasd,silvermoon,1255,deathknight,unholy,58,26,32
Orcborg,zuljin,1254,deathknight,unholy,49,24,25
Roykoopa,hyjal,1249,deathknight,unholy,90,47,43
Goochtickler,kazzak,1247,deathknight,unholy,24,13,11
Kaletorn,ragnaros,1247,deathknight,unholy,106,53,53
Дуонза,blackscar,1244,deathknight,unholy,36,20,16
Halohuntress,outland,1243,deathknight,unholy,60,28,32
Schweezlord,tarren-mill,1241,deathknight,unholy,24,13,11
Патриаррх,gordunni,1240,deathknight,unholy,47,25,22
Zúrg,stormscale,1240,deathknight,unholy,30,14,16
Kéréos,hyjal,1238,deathknight,unholy,24,13,11
Kalantii,draenor,1237,deathknight,unholy,53,24,29
Khorag,lordaeron,1235,deathknight,unholy,30,13,17
Клиссанг,razuvious,1234,deathknight,unholy,48,13,35
Ogomegee,ravencrest,1231,deathknight,unholy,28,15,13
Funds,kazzak,1230,deathknight,unholy,30,13,17
Аданаэль,howling-fjord,1228,deathknight,unholy,47,21,26
Evelys,kazzak,1228,deathknight,unholy,70,31,39
Breakstuff,twisting-nether,1227,deathknight,unholy,61,29,32
Крус,blackscar,1227,deathknight,unholy,89,39,50
Близзбай,soulflayer,1227,deathknight,unholy,84,30,54
Falballâ,ysondre,1226,deathknight,unholy,54,26,28
Negzul,blackmoore,1225,deathknight,unholy,109,50,59
Mãshi,hyjal,1223,deathknight,unholy,71,35,36
Necrocancerr,twisting-nether,1220,deathknight,unholy,161,76,85
Nilodk,nemesis,1219,deathknight,unholy,445,222,223
Sigarå,twisting-nether,1219,deathknight,unholy,42,19,23
Zelamar,burning-legion,1219,deathknight,unholy,42,14,28
Tarfu,kazzak,1218,deathknight,unholy,120,61,59
Vadamee,ravencrest,1218,deathknight,unholy,124,57,67
Bämbämpewpew,ravencrest,1218,deathknight,unholy,30,13,17
Razzvy,darkspear,1217,deathknight,unholy,123,55,68
Jixcore,draenor,1217,deathknight,unholy,48,16,32
Sarkasm,malganis,1216,deathknight,unholy,102,48,54
Appdeath,azjolnerub,1214,deathknight,unholy,30,19,11
Kazagul,blackrock,1214,deathknight,unholy,45,22,23
Tanenoss,kazzak,1213,deathknight,unholy,54,21,33
Thedx,blades-edge,1208,deathknight,unholy,52,20,32
Баривуль,howling-fjord,1207,deathknight,unholy,37,19,18
Деркхаус,soulflayer,1206,deathknight,unholy,30,18,12
Gravetitan,shattrath,1203,deathknight,unholy,178,89,89
Scareanger,argent-dawn,1203,deathknight,unholy,75,36,39
Жупело,gordunni,1200,deathknight,unholy,60,33,27
Zpartan,ragnaros,1197,deathknight,unholy,66,25,41
Kazagoth,draenor,1196,deathknight,unholy,30,16,14
Squeeze,drakthul,1196,deathknight,unholy,42,17,25
Zelbørk,medivh,1194,deathknight,unholy,54,26,28
Funnboon,alleria,1193,deathknight,unholy,60,30,30
Fluffínator,kazzak,1190,deathknight,unholy,126,60,66
Dezzi,azuremyst,1189,deathknight,unholy,68,35,33
Fishtruction,tarren-mill,1189,deathknight,unholy,390,195,195
Vegz,archimonde,1187,deathknight,unholy,37,20,17
Deathmìnd,ravencrest,1186,deathknight,unholy,23,13,10
Asakurai,grim-batol,1184,deathknight,unholy,54,30,24
Vahllas,blackhand,1183,deathknight,unholy,54,19,35
Шэйп,fordragon,1181,deathknight,unholy,42,15,27
Øbito,sylvanas,1179,deathknight,unholy,36,14,22
Homoforsluts,silvermoon,1178,deathknight,unholy,24,15,9
Фиджибро,soulflayer,1175,deathknight,unholy,91,45,46
Lobotomia,burning-blade,1171,deathknight,unholy,97,45,52
Gothenburger,darksorrow,1170,deathknight,unholy,66,32,34
Fentanil,elune,1170,deathknight,unholy,258,125,133
Ezreo,neptulon,1167,deathknight,unholy,31,14,17
Eltorro,ravencrest,1165,deathknight,unholy,42,14,28
Mupak,drakthul,1164,deathknight,unholy,29,17,12
Ennigmá,stormscale,1162,deathknight,unholy,36,21,15
Инкреасесх,blackscar,1162,deathknight,unholy,56,25,31
Дэдушка,gordunni,1159,deathknight,unholy,23,13,10
Dmaarr,drakthul,1159,deathknight,unholy,32,14,18
Zaouros,silvermoon,1157,deathknight,unholy,36,16,20
Smalldk,silvermoon,1156,deathknight,unholy,36,18,18
Grisig,twisting-nether,1152,deathknight,unholy,100,56,44
Fyrkadk,aegwynn,1151,deathknight,unholy,24,12,12
Dklol,dun-morogh,1150,deathknight,unholy,36,14,22
Numnutz,alakir,1149,deathknight,unholy,25,13,12
Usbdock,stormscale,1149,deathknight,unholy,24,12,12
Auru,tarren-mill,1149,deathknight,unholy,132,65,67
Màlthael,zuljin,1147,deathknight,unholy,30,12,18
Larvalîs,blackmoore,1145,deathknight,unholy,78,43,35
Nefertitï,kazzak,1145,deathknight,unholy,132,51,81
Adria,jaedenar,1143,deathknight,unholy,36,18,18
Euphorius,azuremyst,1142,deathknight,unholy,52,29,23
Morvain,silvermoon,1138,deathknight,unholy,185,85,100
Maagbloeding,sylvanas,1138,deathknight,unholy,60,27,33
Qmy,outland,1138,deathknight,unholy,70,29,41
Thanagor,auchindoun,1138,deathknight,unholy,30,12,18
Abnormus,tarren-mill,1137,deathknight,unholy,114,52,62
Skeggjold,drakthul,1135,deathknight,unholy,30,14,16
Coldkase,ghostlands,1134,deathknight,unholy,18,12,6
Kailara,draenor,1133,deathknight,unholy,29,12,17
Niex,destromath,1133,deathknight,unholy,30,12,18
Mailasse,dalaran,1131,deathknight,unholy,36,20,16
Jowân,blackmoore,1131,deathknight,unholy,24,13,11
Dêku,aegwynn,1130,deathknight,unholy,79,44,35
Beinlausi,dalaran,1130,deathknight,unholy,55,30,25
Артушадк,soulflayer,1127,deathknight,unholy,78,41,37
Омадесала,thermaplugg,1126,deathknight,unholy,30,12,18
Волграл,howling-fjord,1125,deathknight,unholy,73,38,35
Bexly,defias-brotherhood,1123,deathknight,unholy,73,36,37
Hqxdd,twisting-nether,1123,deathknight,unholy,174,85,89
Cervä,kazzak,1120,deathknight,unholy,28,13,15
Rades,sanguino,1120,deathknight,unholy,36,15,21
Spometteqt,archimonde,1119,deathknight,unholy,23,12,11
Kazay,madmortem,1117,deathknight,unholy,42,18,24
Nenadvs,ravencrest,1116,deathknight,unholy,29,12,17
Híruzen,blackrock,1115,deathknight,unholy,30,15,15
Freezerker,ragnaros,1111,deathknight,unholy,30,13,17
Karalun,nagrand,1106,deathknight,unholy,120,62,58
Sénta,tarren-mill,1105,deathknight,unholy,53,21,32
Stepknìght,draenor,1104,deathknight,unholy,29,12,17
Жекабыкует,borean-tundra,1102,deathknight,unholy,44,17,27
Saromón,ravencrest,1101,deathknight,unholy,30,18,12
Nestia,emerald-dream,1097,deathknight,unholy,112,52,60
Cykeljävel,stormreaver,1097,deathknight,unholy,35,12,23
Moartèa,blackhand,1095,deathknight,unholy,29,12,17
Frostmommy,argent-dawn,1092,deathknight,unholy,89,37,52
Schopenhauer,turalyon,1091,deathknight,unholy,75,35,40
Slayrr,blackrock,1090,deathknight,unholy,83,36,47
Dalenn,kazzak,1089,deathknight,unholy,39,13,26
Zathron,blackmoore,1088,deathknight,unholy,96,46,50
Olm,guldan,1087,deathknight,unholy,84,42,42
Younix,silvermoon,1086,deathknight,unholy,90,32,58
Kaldhan,nemesis,1085,deathknight,unholy,46,23,23
Darkqüeen,sanguino,1085,deathknight,unholy,48,18,30
Narrua,die-aldor,1082,deathknight,unholy,47,17,30
Orochimaruo,stormscale,1080,deathknight,unholy,36,15,21
Deadpòól,twisting-nether,1079,deathknight,unholy,45,13,32
Рэкставр,soulflayer,1073,deathknight,unholy,88,47,41
Highmelli,ambossar,1071,deathknight,unholy,84,30,54
Gùra,sanguino,1071,deathknight,unholy,54,17,37
Badbrian,draenor,1061,deathknight,unholy,22,13,9
Zdan,sylvanas,1060,deathknight,unholy,96,45,51
Tyrannus,earthen-ring,1059,deathknight,unholy,34,19,15
Critycal,draenor,1056,deathknight,unholy,18,11,7
Pamplemouse,burning-blade,1056,deathknight,unholy,121,58,63
Elendren,blackrock,1056,deathknight,unholy,24,11,13
Goshakutsen,ravencrest,1055,deathknight,unholy,18,11,7
Тидог,ashenvale,1055,deathknight,unholy,24,11,13
Stipemiocic,nemesis,1055,deathknight,unholy,24,11,13
Yötãrîn,dalaran,1054,deathknight,unholy,18,11,7
Atakan,nemesis,1054,deathknight,unholy,68,36,32
Karvaturare,ravencrest,1054,deathknight,unholy,98,33,65
Ураан,gordunni,1053,deathknight,unholy,22,12,10
Synchronic,stormscale,1053,deathknight,unholy,24,11,13
Feelmyfuri,mazrigos,1053,deathknight,unholy,24,11,13
Painrune,nordrassil,1052,deathknight,unholy,24,11,13
Regniér,frostwolf,1050,deathknight,unholy,18,11,7
Derimathras,stormscale,1050,deathknight,unholy,24,11,13
Adlatus,malganis,1049,deathknight,unholy,42,25,17
Hacknorris,aegwynn,1049,deathknight,unholy,33,17,16
Mefhesto,tarren-mill,1049,deathknight,unholy,30,11,19
Gothral,doomhammer,1046,deathknight,unholy,64,33,31
Нуурргл,howling-fjord,1046,deathknight,unholy,48,19,29
Авнас,fordragon,1045,deathknight,unholy,76,40,36
Auggee,ravencrest,1045,deathknight,unholy,24,11,13
Shakour,argent-dawn,1044,deathknight,unholy,18,11,7
Zyknight,silvermoon,1044,deathknight,unholy,30,11,19
Дезентирия,soulflayer,1043,deathknight,unholy,27,11,16
Ilovegouàng,khaz-modan,1041,deathknight,unholy,36,15,21
Gigazord,ysondre,1039,deathknight,unholy,29,13,16
Eibon,drakthul,1037,deathknight,unholy,18,11,7
Порнпанда,gordunni,1037,deathknight,unholy,24,11,13
Некронн,grom,1036,deathknight,unholy,270,137,133
Jarhèad,grim-batol,1036,deathknight,unholy,46,21,25
Valeriania,burning-legion,1035,deathknight,unholy,46,25,21
Draigó,thrall,1033,deathknight,unholy,36,16,20
Teldä,archimonde,1031,deathknight,unholy,30,12,18
Мокраявода,soulflayer,1030,deathknight,unholy,100,53,47
Macdoom,throkferoth,1027,deathknight,unholy,44,14,30
Anùbïs,kaelthas,1026,deathknight,unholy,41,13,28
Ослаад,gordunni,1025,deathknight,unholy,24,13,11
Gowther,blackmoore,1024,deathknight,unholy,212,108,104
Taylorswiift,tarren-mill,1023,deathknight,unholy,17,11,6
Ðeucaly,nemesis,1022,deathknight,unholy,23,11,12
Akuji,dragonmaw,1022,deathknight,unholy,36,14,22
Охъламон,soulflayer,1021,deathknight,unholy,282,137,145
Braastad,sylvanas,1020,deathknight,unholy,72,39,33
Kahp,tarren-mill,1019,deathknight,unholy,49,23,26
Icyplague,ravencrest,1018,deathknight,unholy,20,12,8
Малп,gordunni,1018,deathknight,unholy,42,24,18
Assasínator,tarren-mill,1017,deathknight,unholy,205,105,100
Luciferyan,twisting-nether,1017,deathknight,unholy,36,15,21
Трибублика,howling-fjord,1016,deathknight,unholy,30,11,19
Scorbion,kilrogg,1015,deathknight,unholy,24,11,13
Ereboss,eredar,1014,deathknight,unholy,36,17,19
Keenda,kirin-tor,1009,deathknight,unholy,31,14,17
Jimundo,ravencrest,1005,deathknight,unholy,32,15,17
Kachie,stormscale,1004,deathknight,unholy,23,11,12
Takåtry,archimonde,1004,deathknight,unholy,30,14,16
Kirkster,terokkar,987,deathknight,unholy,39,17,22
Kolman,drakthul,986,deathknight,unholy,24,16,8
Myeltior,kazzak,983,deathknight,unholy,28,11,17
Jodure,silvermoon,982,deathknight,unholy,33,13,20
Gathalion,the-maelstrom,980,deathknight,unholy,48,28,20
Trigárdon,antonidas,976,deathknight,unholy,91,46,45
Арчибальд,soulflayer,975,deathknight,unholy,30,12,18
Soix,sanguino,974,deathknight,unholy,19,11,8
Kenwae,silvermoon,973,deathknight,unholy,58,12,46
Kixx,bloodfeather,971,deathknight,unholy,94,38,56
Хуаролуксс,gordunni,970,deathknight,unholy,230,104,126
Flytomoon,argent-dawn,962,deathknight,unholy,96,43,53
Kaliro,sylvanas,960,deathknight,unholy,18,10,8
Wórzzag,arygos,960,deathknight,unholy,18,10,8
Cervâ,twisting-nether,960,deathknight,unholy,24,10,14
Julezi,blackmoore,960,deathknight,unholy,30,10,20
Ebonsword,kazzak,959,deathknight,unholy,18,10,8
Barnëylord,argent-dawn,959,deathknight,unholy,18,10,8
Akronux,grim-batol,959,deathknight,unholy,36,18,18
Silvergreed,kazzak,959,deathknight,unholy,24,10,14
Fatøumatata,archimonde,959,deathknight,unholy,24,10,14
Виндрукс,soulflayer,958,deathknight,unholy,24,10,14
Valkion,nemesis,958,deathknight,unholy,30,10,20
Xisaark,blackrock,958,deathknight,unholy,30,10,20
Cyphîllyth,auchindoun,957,deathknight,unholy,18,10,8
Nightsong,tarren-mill,957,deathknight,unholy,18,10,8
Тоши,fordragon,957,deathknight,unholy,30,10,20
Smightydk,kazzak,956,deathknight,unholy,18,10,8
Kàrásu,eredar,956,deathknight,unholy,30,10,20
Rognvald,les-sentinelles,954,deathknight,unholy,125,64,61
Корольбич,soulflayer,954,deathknight,unholy,24,10,14
Unzul,twisting-nether,953,deathknight,unholy,36,20,16
Nickolass,skullcrusher,953,deathknight,unholy,48,22,26
Sarunâs,antonidas,953,deathknight,unholy,36,10,26
Финдекс,soulflayer,952,deathknight,unholy,24,10,14
Khoragän,hyjal,948,deathknight,unholy,18,10,8
Ashlëy,kaelthas,948,deathknight,unholy,179,84,95
Neden,blackmoore,946,deathknight,unholy,89,45,44
Fpsrvg,minahonda,946,deathknight,unholy,83,37,46
Ahin,antonidas,940,deathknight,unholy,70,34,36
Leiyo,arathor,938,deathknight,unholy,30,10,20
Aguroh,khaz-modan,937,deathknight,unholy,36,16,20
Etlam,antonidas,936,deathknight,unholy,35,14,21
Deathanos,kazzak,934,deathknight,unholy,18,10,8
Mangemicro,archimonde,931,deathknight,unholy,22,11,11
Fidaii,sylvanas,924,deathknight,unholy,48,22,26
Jess,blackhand,923,deathknight,unholy,79,40,39
Keltòr,antonidas,920,deathknight,unholy,41,15,26
Kisenth,doomhammer,919,deathknight,unholy,72,37,35
Darkarnø,chants-éternels,904,deathknight,unholy,127,59,68
Квашонка,howling-fjord,898,deathknight,unholy,118,43,75
Hailandher,nemesis,896,deathknight,unholy,47,25,22
Erector,norgannon,895,deathknight,unholy,36,19,17
Джагат,gordunni,893,deathknight,unholy,42,19,23
Rayliegh,silvermoon,891,deathknight,unholy,17,10,7
Deathorchide,pozzo-delleternità,891,deathknight,unholy,56,13,43
Лордэнергон,gordunni,888,deathknight,unholy,16,10,6
Restodrowd,tarren-mill,875,deathknight,unholy,93,44,49
Punctilio,argent-dawn,864,deathknight,unholy,12,9,3
Fabricios,blackrock,864,deathknight,unholy,12,9,3
Gáïà,blackmoore,864,deathknight,unholy,12,9,3
Duriel,stormscale,864,deathknight,unholy,18,9,9
Dakyforfun,ravencrest,864,deathknight,unholy,18,9,9
Mateusz,lightbringer,863,deathknight,unholy,12,9,3
Dromor,echsenkessel,863,deathknight,unholy,12,9,3
Prêstij,stormscale,863,deathknight,unholy,18,9,9
Gosuhat,kazzak,863,deathknight,unholy,18,9,9
Kyusuke,blackhand,863,deathknight,unholy,18,9,9
Çrtz,eredar,863,deathknight,unholy,18,9,9
Toshiroo,draenor,863,deathknight,unholy,18,9,9
Oxxöw,draenor,863,deathknight,unholy,24,9,15
Soulrime,garrosh,863,deathknight,unholy,24,9,15
Dimania,the-maelstrom,863,deathknight,unholy,30,9,21
Vinczergripz,silvermoon,862,deathknight,unholy,12,9,3
Велиций,gordunni,862,deathknight,unholy,18,9,9
Blácklíght,silvermoon,862,deathknight,unholy,24,9,15
Kaeyz,blackmoore,861,deathknight,unholy,30,9,21
Dreamgirl,sylvanas,860,deathknight,unholy,30,14,16
Payat,aegwynn,859,deathknight,unholy,18,9,9
Тзинч,soulflayer,859,deathknight,unholy,18,9,9
Dzahnecro,archimonde,858,deathknight,unholy,18,9,9
Данарион,howling-fjord,858,deathknight,unholy,24,9,15
Shadowevil,silvermoon,857,deathknight,unholy,18,9,9
Aczheron,argent-dawn,857,deathknight,unholy,18,9,9
Pierun,dunemaul,857,deathknight,unholy,18,9,9
Zathy,twisting-nether,857,deathknight,unholy,18,9,9
Vielzudícht,blackmoore,856,deathknight,unholy,12,9,3
Riseofpovver,twisting-nether,856,deathknight,unholy,18,9,9
Arâsk,blackmoore,856,deathknight,unholy,24,9,15
Sulf,burning-legion,856,deathknight,unholy,24,9,15
Бланки,deathweaver,855,deathknight,unholy,24,9,15
Oldu,haomarush,853,deathknight,unholy,117,56,61
Luxeridon,pozzo-delleternità,851,deathknight,unholy,18,9,9
Marcianorock,dalaran,850,deathknight,unholy,18,9,9
Hukana,confrérie-du-thorium,850,deathknight,unholy,36,10,26
Deathcleave,burning-legion,845,deathknight,unholy,23,9,14
Zoomieh,bloodfeather,844,deathknight,unholy,18,9,9
Dànté,eitrigg,844,deathknight,unholy,46,22,24
Iscali,kazzak,843,deathknight,unholy,13,9,4
Lastdragon,dun-modr,840,deathknight,unholy,42,16,26
Arthursq,stormscale,832,deathknight,unholy,345,151,194
Cryistyx,draenor,828,deathknight,unholy,14,10,4
Zot,twisting-nether,814,deathknight,unholy,18,10,8
Ballum,frostmane,812,deathknight,unholy,66,31,35
Arrakìs,nemesis,811,deathknight,unholy,21,10,11
Alielib,eredar,804,deathknight,unholy,82,29,53
Shackles,ravencrest,803,deathknight,unholy,17,9,8
Flúrrý,ravencrest,799,deathknight,unholy,17,9,8
Angalor,argent-dawn,798,deathknight,unholy,17,9,8
Edochian,sanguino,796,deathknight,unholy,20,9,11
Thyrandre,khaz-modan,793,deathknight,unholy,106,41,65
Aldramil,gorgonnash,786,deathknight,unholy,30,12,18
Schiva,eredar,784,deathknight,unholy,28,9,19
Sidious,auchindoun,781,deathknight,unholy,77,27,50
Силдэус,galakrond,768,deathknight,unholy,12,8,4
Dìscus,nemesis,768,deathknight,unholy,12,8,4
Amesz,tarren-mill,768,deathknight,unholy,18,8,10
Wpízdu,aegwynn,768,deathknight,unholy,18,8,10
Спамлюоковы,gordunni,768,deathknight,unholy,18,8,10
Bubbledeath,tarren-mill,768,deathknight,unholy,24,8,16
Dreshtarg,draenor,768,deathknight,unholy,24,8,16
Plaguecloud,kazzak,768,deathknight,unholy,24,8,16
Zatrina,blackrock,768,deathknight,unholy,24,8,16
Terenes,darksorrow,768,deathknight,unholy,24,8,16
Quazy,draenor,768,deathknight,unholy,30,8,22
Soulrender,kirin-tor,767,deathknight,unholy,12,8,4
Mcbc,silvermoon,767,deathknight,unholy,12,8,4
Menstruelle,chants-éternels,767,deathknight,unholy,12,8,4
Híld,hyjal,767,deathknight,unholy,12,8,4
Tenzøjr,archimonde,767,deathknight,unholy,18,8,10
Apocalypse,ravencrest,767,deathknight,unholy,18,8,10
Mauor,argent-dawn,767,deathknight,unholy,18,8,10
Chains,sanguino,767,deathknight,unholy,18,8,10
Cyliandra,silvermoon,767,deathknight,unholy,27,9,18
Brogard,tarren-mill,766,deathknight,unholy,12,8,4
Bloodflayer,argent-dawn,766,deathknight,unholy,16,9,7
Zombienatíon,silvermoon,766,deathknight,unholy,24,8,16
Prethor,drakthul,765,deathknight,unholy,24,8,16
Shiryú,ravencrest,765,deathknight,unholy,30,8,22
Xiddy,quelthalas,764,deathknight,unholy,12,8,4
Zanretxd,outland,764,deathknight,unholy,20,8,12
Mjölnir,sanguino,764,deathknight,unholy,24,8,16
Семиран,gordunni,764,deathknight,unholy,30,8,22
Vexinux,outland,763,deathknight,unholy,24,8,16
Latindvergur,sylvanas,762,deathknight,unholy,18,8,10
Cødæx,blackrock,762,deathknight,unholy,24,8,16
Unsuspected,kazzak,758,deathknight,unholy,24,8,16
Fortinateur,suramar,757,deathknight,unholy,18,8,10
Milfgrabber,archimonde,751,deathknight,unholy,23,8,15
Bhishma,blades-edge,749,deathknight,unholy,12,8,4
Ricardiob,argent-dawn,748,deathknight,unholy,16,9,7
Kavour,tarren-mill,735,deathknight,unholy,14,9,5
Hyperflexz,blackrock,714,deathknight,unholy,23,9,14
Xenomorphs,kazzak,713,deathknight,unholy,19,9,10
Eli,dalaran,709,deathknight,unholy,29,8,21
Lulubadgirl,perenolde,689,deathknight,unholy,72,20,52
Roundoné,kazzak,672,deathknight,unholy,12,7,5
Moonpoxdk,nerathor,672,deathknight,unholy,12,7,5
Bericks,silvermoon,672,deathknight,unholy,12,7,5
Døddrukken,ragnaros,672,deathknight,unholy,12,7,5
Cortessá,rexxar,672,deathknight,unholy,12,7,5
Vaalur,dalaran,672,deathknight,unholy,12,7,5
Deathfrqst,ysondre,672,deathknight,unholy,12,7,5
Vorrén,tarren-mill,672,deathknight,unholy,12,7,5
Хухухуху,soulflayer,672,deathknight,unholy,12,7,5
Skylerblack,kazzak,672,deathknight,unholy,18,7,11
Unholykebab,defias-brotherhood,672,deathknight,unholy,18,7,11
Soulchaos,ravencrest,672,deathknight,unholy,18,7,11
Deadduchess,argent-dawn,672,deathknight,unholy,18,7,11
Gadres,aegwynn,672,deathknight,unholy,18,7,11
Trashboat,outland,672,deathknight,unholy,18,7,11
Чумазная,howling-fjord,672,deathknight,unholy,18,7,11
Никнейм,gordunni,672,deathknight,unholy,18,7,11
Adlian,twisting-nether,672,deathknight,unholy,18,7,11
Persês,blackmoore,672,deathknight,unholy,18,7,11
Clérora,argent-dawn,672,deathknight,unholy,18,7,11
Spliddy,ravencrest,672,deathknight,unholy,18,7,11
Wttdmg,kazzak,672,deathknight,unholy,18,7,11
Alinee,shadowsong,672,deathknight,unholy,18,7,11
Hoar,blackrock,672,deathknight,unholy,18,7,11
Moccababe,argent-dawn,672,deathknight,unholy,18,7,11
Phrek,outland,672,deathknight,unholy,18,7,11
Dextroyersx,sanguino,672,deathknight,unholy,18,7,11
Keet,turalyon,672,deathknight,unholy,21,8,13
Elisaron,silvermoon,672,deathknight,unholy,24,7,17
Depleterus,blackrock,672,deathknight,unholy,24,7,17
Madseason,burning-legion,672,deathknight,unholy,30,7,23
Darkéi,outland,671,deathknight,unholy,12,7,5
Ardulin,burning-legion,671,deathknight,unholy,12,7,5
Моргаррок,soulflayer,671,deathknight,unholy,12,7,5
Theamine,silvermoon,671,deathknight,unholy,12,7,5
Падшийрыцарь,gordunni,671,deathknight,unholy,12,7,5
Cmonbruvv,outland,671,deathknight,unholy,12,7,5
Rotbone,drakthul,671,deathknight,unholy,12,7,5
Absoot,dun-morogh,671,deathknight,unholy,12,7,5
Lùrtzz,frostwolf,671,deathknight,unholy,12,7,5
Creepzor,tarren-mill,671,deathknight,unholy,18,7,11
Zariha,malfurion,671,deathknight,unholy,18,7,11
Lìlïth,kazzak,671,deathknight,unholy,18,7,11
Беларам,gordunni,671,deathknight,unholy,18,7,11
Сурендернау,blackscar,671,deathknight,unholy,18,7,11
Badnew,tarren-mill,671,deathknight,unholy,18,7,11
Ráisy,outland,671,deathknight,unholy,24,7,17
Uridk,sanguino,670,deathknight,unholy,12,7,5
Думсдэйи,gordunni,670,deathknight,unholy,12,7,5
Amencore,kazzak,670,deathknight,unholy,14,7,7
Rubbad,draenor,670,deathknight,unholy,18,7,11
Deathclapp,twisting-nether,670,deathknight,unholy,18,7,11
Kranker,thrall,670,deathknight,unholy,18,7,11
Darkboss,minahonda,670,deathknight,unholy,18,7,11
Ertzuo,blackrock,670,deathknight,unholy,24,7,17
Furyáns,arathor,670,deathknight,unholy,30,7,23
Tréfoo,blackrock,668,deathknight,unholy,12,7,5
Heresjohny,stormrage,666,deathknight,unholy,18,7,11
Naerys,ysondre,662,deathknight,unholy,18,7,11
Хемелия,azuregos,662,deathknight,unholy,30,7,23
Müldgren,ysondre,658,deathknight,unholy,24,7,17
Redzone,ravencrest,639,deathknight,unholy,23,7,16
Darkarthâs,ravencrest,624,deathknight,unholy,15,8,7
Дкмонт,deathguard,623,deathknight,unholy,17,7,10
Gigadk,ragnaros,616,deathknight,unholy,19,8,11
Aradiel,archimonde,606,deathknight,unholy,26,7,19
Vargass,darksorrow,598,deathknight,unholy,14,7,7
Randomdkxd,ravencrest,592,deathknight,unholy,19,7,12
Nirna,argent-dawn,587,deathknight,unholy,45,7,38
Nerinth,burning-legion,576,deathknight,unholy,12,6,6
Quarkd,archimonde,576,deathknight,unholy,12,6,6
Petergrippin,dragonblight,576,deathknight,unholy,12,6,6
Uqrdk,twisting-nether,576,deathknight,unholy,12,6,6
Ketnissq,blackrock,576,deathknight,unholy,12,6,6
Sfintter,uldum,576,deathknight,unholy,12,6,6
Huxleeyys,draenor,576,deathknight,unholy,12,6,6
Янатащи,gordunni,576,deathknight,unholy,12,6,6
Nephalêm,thrall,576,deathknight,unholy,12,6,6
Grithala,draenor,576,deathknight,unholy,12,6,6
Scorpiuzx,ravencrest,576,deathknight,unholy,12,6,6
Джинтос,howling-fjord,576,deathknight,unholy,12,6,6
Babs,sylvanas,576,deathknight,unholy,12,6,6
Tombkeeper,silvermoon,576,deathknight,unholy,12,6,6
Kurían,burning-legion,576,deathknight,unholy,12,6,6
Swordkill,drakthul,576,deathknight,unholy,12,6,6
Lemain,drakthul,576,deathknight,unholy,12,6,6
Kane,destromath,576,deathknight,unholy,13,6,7
Critgødx,draenor,576,deathknight,unholy,13,6,7
Sephirus,kazzak,576,deathknight,unholy,18,6,12
Nelzébal,kirin-tor,576,deathknight,unholy,18,6,12
Exult,twisting-nether,576,deathknight,unholy,18,6,12
Menethill,darkspear,576,deathknight,unholy,18,6,12
Pestikus,thrall,576,deathknight,unholy,18,6,12
Asarth,silvermoon,576,deathknight,unholy,18,6,12
Morgianà,argent-dawn,576,deathknight,unholy,18,6,12
Itokawa,tarren-mill,576,deathknight,unholy,18,6,12
Iseetouch,draenor,576,deathknight,unholy,18,6,12
Spaace,tarren-mill,576,deathknight,unholy,24,6,18
Tyranuse,kazzak,576,deathknight,unholy,24,6,18
Majkântês,drakthul,576,deathknight,unholy,24,6,18
Helixsdk,outland,576,deathknight,unholy,26,6,20
Havi,thunderhorn,575,deathknight,unholy,12,6,6
Dekatos,twisting-nether,575,deathknight,unholy,12,6,6
Ququ,twisting-nether,575,deathknight,unholy,12,6,6
Mosscraciun,kazzak,575,deathknight,unholy,12,6,6
Асенвел,soulflayer,575,deathknight,unholy,12,6,6
Oldiseas,grim-batol,575,deathknight,unholy,12,6,6
Archdemonio,wildhammer,575,deathknight,unholy,12,6,6
Kärringandré,silvermoon,575,deathknight,unholy,12,6,6
Zegò,silvermoon,575,deathknight,unholy,12,6,6
Deathmaiden,outland,575,deathknight,unholy,12,6,6
Aliostar,sylvanas,575,deathknight,unholy,14,6,8
Брейвз,gordunni,575,deathknight,unholy,18,6,12
Nøult,sanguino,575,deathknight,unholy,18,6,12
Хлопайпопой,howling-fjord,575,deathknight,unholy,24,6,18
Namfuuh,blackrock,575,deathknight,unholy,24,6,18
Thryndiel,ravencrest,574,deathknight,unholy,12,6,6
Nephenty,der-rat-von-dalaran,574,deathknight,unholy,12,6,6
Ideath,executus,572,deathknight,unholy,12,6,6
Cervanteso,uldum,571,deathknight,unholy,12,6,6
Daquy,blackhand,570,deathknight,unholy,12,6,6
Narancha,haomarush,566,deathknight,unholy,24,6,18
Minitehnicus,stormscale,558,deathknight,unholy,18,6,12
Darkangelina,aggra-português,553,deathknight,unholy,18,6,12
Приаадк,gordunni,543,deathknight,unholy,20,7,13
Darklotus,chamber-of-aspects,543,deathknight,unholy,22,6,16
ßabas,hyjal,542,deathknight,unholy,15,7,8
Каурдак,soulflayer,528,deathknight,unholy,21,6,15
Даркслэш,howling-fjord,522,deathknight,unholy,23,8,15
Roids,twisting-nether,480,deathknight,unholy,6,5,1
Darthlenin,dentarg,480,deathknight,unholy,6,5,1
Náthrakh,argent-dawn,480,deathknight,unholy,6,5,1
Cbalife,ragnaros,480,deathknight,unholy,12,5,7
Salzalara,draenor,480,deathknight,unholy,12,5,7
Blurek,lordaeron,480,deathknight,unholy,12,5,7
Cipisza,drakthul,480,deathknight,unholy,12,5,7
Дэспэр,gordunni,480,deathknight,unholy,12,5,7
Миракл,howling-fjord,480,deathknight,unholy,12,5,7
Gigacow,outland,480,deathknight,unholy,12,5,7
Kelebglin,silvermoon,480,deathknight,unholy,12,5,7
Galsi,silvermoon,480,deathknight,unholy,12,5,7
Rêxaks,dun-modr,480,deathknight,unholy,12,5,7
Teshel,silvermoon,480,deathknight,unholy,12,5,7
Aest,blackhand,480,deathknight,unholy,12,5,7
Azcrown,azjolnerub,480,deathknight,unholy,12,5,7
Unholybezerk,darkspear,480,deathknight,unholy,12,5,7
Ироним,gordunni,480,deathknight,unholy,12,5,7
Dktyro,ravencrest,480,deathknight,unholy,12,5,7
Zhugzug,ragnaros,480,deathknight,unholy,12,5,7
Chocobanana,blackhand,480,deathknight,unholy,12,5,7
Hyomi,ravencrest,480,deathknight,unholy,12,5,7
Urkanis,hyjal,480,deathknight,unholy,12,5,7
Nëcrøzys,archimonde,480,deathknight,unholy,12,5,7
Dêeath,madmortem,480,deathknight,unholy,12,5,7
Fenn,dentarg,480,deathknight,unholy,12,5,7
Kaenor,sporeggar,480,deathknight,unholy,12,5,7
Sipsip,tarren-mill,480,deathknight,unholy,12,5,7
Healrstealr,antonidas,480,deathknight,unholy,12,5,7
Zaxrel,burning-legion,480,deathknight,unholy,12,5,7
Torbille,archimonde,480,deathknight,unholy,12,5,7
Christldeath,blackrock,480,deathknight,unholy,12,5,7
Gripshiftr,kazzak,480,deathknight,unholy,12,5,7
Necroslap,blackhand,480,deathknight,unholy,18,5,13
Frostbone,ravencrest,480,deathknight,unholy,18,5,13
Luciferon,zenedar,480,deathknight,unholy,18,5,13
Xad,blackrock,480,deathknight,unholy,18,5,13
Bytedk,aggra-português,480,deathknight,unholy,18,5,13
Maxïmus,argent-dawn,480,deathknight,unholy,24,5,19
Omegasquall,nemesis,479,deathknight,unholy,6,5,1
Rafuki,stormscale,479,deathknight,unholy,12,6,6
Darioo,magtheridon,479,deathknight,unholy,12,5,7
Мордаворот,gordunni,479,deathknight,unholy,12,5,7
Chyppy,dalaran,479,deathknight,unholy,12,5,7
Kratas,varimathras,479,deathknight,unholy,13,5,8
Kraken,aerie-peak,479,deathknight,unholy,18,5,13
Jonyo,silvermoon,479,deathknight,unholy,24,5,19
Mÿv,archimonde,478,deathknight,unholy,18,5,13
Toderus,forscherliga,477,deathknight,unholy,6,5,1
Droughun,drakthul,477,deathknight,unholy,21,6,15
Superpotatoh,silvermoon,463,deathknight,unholy,17,5,12
Boyanmaga,stormscale,447,deathknight,unholy,16,5,11
Shadowgohst,dun-morogh,440,deathknight,unholy,14,6,8
Difestia,silvermoon,429,deathknight,unholy,11,5,6
Zaldraxus,stormscale,415,deathknight,unholy,16,5,11
Серинокс,howling-fjord,414,deathknight,unholy,14,5,9
Runeburst,draenor,399,deathknight,unholy,13,5,8
Tigros,burning-legion,384,deathknight,unholy,6,4,2
Радиосмерти,gordunni,384,deathknight,unholy,6,4,2
Кобихохо,gordunni,384,deathknight,unholy,6,4,2
Copium,hyjal,384,deathknight,unholy,6,4,2
Runeblade,shattered-hand,384,deathknight,unholy,6,4,2
Söckli,mugthol,384,deathknight,unholy,6,4,2
Glacenoir,hyjal,384,deathknight,unholy,6,4,2
Redduck,silvermoon,384,deathknight,unholy,6,4,2
Атскийсатана,goldrinn,384,deathknight,unholy,6,4,2
Dragamanca,shendralar,384,deathknight,unholy,6,4,2
Basedzog,silvermoon,384,deathknight,unholy,6,4,2
Zyôs,blackmoore,384,deathknight,unholy,6,4,2
Lichkunt,stormscale,384,deathknight,unholy,6,4,2
Mängo,onyxia,384,deathknight,unholy,6,4,2
Neph,sanguino,384,deathknight,unholy,6,4,2
Kalhyst,archimonde,384,deathknight,unholy,6,4,2
Kãzan,archimonde,384,deathknight,unholy,6,4,2
Cówboylayla,stormscale,384,deathknight,unholy,6,4,2
Cyrean,ravencrest,384,deathknight,unholy,6,4,2
Shlongripper,silvermoon,384,deathknight,unholy,6,4,2
Velindara,argent-dawn,384,deathknight,unholy,6,4,2
Nietzschean,tarren-mill,384,deathknight,unholy,6,4,2
Ruppix,stormscale,384,deathknight,unholy,6,4,2
Тунелин,howling-fjord,384,deathknight,unholy,6,4,2
Haximusprime,kazzak,384,deathknight,unholy,6,4,2
Buldog,laughing-skull,384,deathknight,unholy,6,4,2
Yggrauthr,argent-dawn,384,deathknight,unholy,6,4,2
Budgetarthas,arthas,384,deathknight,unholy,6,4,2
Viseria,wrathbringer,384,deathknight,unholy,6,4,2
Amdeath,kazzak,384,deathknight,unholy,6,4,2
Helmich,frostmane,384,deathknight,unholy,6,4,2
Vendes,outland,384,deathknight,unholy,6,4,2
Yerssinia,sylvanas,384,deathknight,unholy,6,4,2
Kjötbiti,tarren-mill,384,deathknight,unholy,12,4,8
Глээм,howling-fjord,384,deathknight,unholy,12,4,8
Колхозник,howling-fjord,384,deathknight,unholy,12,4,8
Raspad,tarren-mill,384,deathknight,unholy,12,4,8
Razdig,dun-modr,384,deathknight,unholy,12,4,8
Лордтемар,howling-fjord,384,deathknight,unholy,12,4,8
Taylorswifts,tarren-mill,384,deathknight,unholy,12,4,8
Sovietonions,marécage-de-zangar,384,deathknight,unholy,12,4,8
Sekkah,tarren-mill,384,deathknight,unholy,12,4,8
Intrigo,blackmoore,384,deathknight,unholy,12,4,8
Szayestra,draenor,384,deathknight,unholy,12,4,8
Skypowerxx,darkspear,384,deathknight,unholy,12,4,8
Binknight,argent-dawn,384,deathknight,unholy,12,4,8
Dëmise,ravencrest,384,deathknight,unholy,12,4,8
Fatuglyrat,kazzak,384,deathknight,unholy,12,4,8
Пикачухха,soulflayer,384,deathknight,unholy,12,4,8
Fait,blackrock,384,deathknight,unholy,12,4,8
Volkovitch,archimonde,384,deathknight,unholy,12,4,8
Tixoz,archimonde,384,deathknight,unholy,12,4,8
Morgued,ravencrest,384,deathknight,unholy,12,4,8
Thoir,ahnqiraj,384,deathknight,unholy,12,4,8
Mustapha,kazzak,384,deathknight,unholy,12,4,8
Äbäddon,twisting-nether,384,deathknight,unholy,12,4,8
Mustakäsi,ravencrest,384,deathknight,unholy,12,4,8
Nathriel,stormscale,384,deathknight,unholy,12,4,8
Bayur,antonidas,384,deathknight,unholy,12,4,8
Dreadmind,blackrock,384,deathknight,unholy,12,4,8
Rouskkoff,hyjal,384,deathknight,unholy,12,4,8
Trashdk,blackrock,384,deathknight,unholy,12,4,8
Servein,stormscale,384,deathknight,unholy,12,4,8
Rædbull,ravencrest,384,deathknight,unholy,16,5,11
Jugglez,thrall,384,deathknight,unholy,17,4,13
Spratz,kazzak,384,deathknight,unholy,17,4,13
Pottifar,tarren-mill,384,deathknight,unholy,18,4,14
Brurf,ysondre,384,deathknight,unholy,18,4,14
Pändörä,uldum,384,deathknight,unholy,18,4,14
Blòópy,silvermoon,384,deathknight,unholy,18,4,14
Geilespferd,blackhand,384,deathknight,unholy,18,4,14
ßambøøzle,draenor,384,deathknight,unholy,25,5,20
Zoombie,draenor,383,deathknight,unholy,6,4,2
Bargane,twilights-hammer,383,deathknight,unholy,6,4,2
Flippmo,argent-dawn,383,deathknight,unholy,9,5,4
Unhory,argent-dawn,383,deathknight,unholy,9,5,4
Украшение,galakrond,383,deathknight,unholy,12,4,8
Antrinian,turalyon,383,deathknight,unholy,12,4,8
Karatedomi,blackmoore,383,deathknight,unholy,12,4,8
Эъя,howling-fjord,383,deathknight,unholy,12,4,8
Хворной,howling-fjord,383,deathknight,unholy,12,4,8
Andreaxx,drakthul,382,deathknight,unholy,6,4,2
Àragørn,blackrock,379,deathknight,unholy,12,4,8
Варрлнишнс,soulflayer,367,deathknight,unholy,11,4,7
Millknight,norgannon,341,deathknight,unholy,15,6,9
Fearax,terenas,335,deathknight,unholy,11,4,7
Fooji,stormscale,330,deathknight,unholy,19,5,14
Shining,blackrock,330,deathknight,unholy,25,6,19
Ikarack,twisting-nether,319,deathknight,unholy,8,4,4
Makisnk,archimonde,319,deathknight,unholy,8,4,4
Melleril,sylvanas,319,deathknight,unholy,14,4,10
Saryn,burning-steppes,304,deathknight,unholy,13,4,9
Darkeolos,twisting-nether,303,deathknight,unholy,7,4,3
Amentet,anetheron,288,deathknight,unholy,10,5,5
Frezer,madmortem,288,deathknight,unholy,6,3,3
Darkrolexx,blackhand,288,deathknight,unholy,6,3,3
Gbdk,xavius,288,deathknight,unholy,6,3,3
Hugerr,azshara,288,deathknight,unholy,6,3,3
Shadies,drakthul,288,deathknight,unholy,6,3,3
Mocca,aegwynn,288,deathknight,unholy,6,3,3
Карвалан,eversong,288,deathknight,unholy,6,3,3
Fredriksend,argent-dawn,288,deathknight,unholy,6,3,3
Ватачка,gordunni,288,deathknight,unholy,6,3,3
Luñatic,sylvanas,288,deathknight,unholy,6,3,3
Payd,blackhand,288,deathknight,unholy,6,3,3
Azslan,skullcrusher,288,deathknight,unholy,6,3,3
Небишоп,howling-fjord,288,deathknight,unholy,6,3,3
Zfeuda,azshara,288,deathknight,unholy,6,3,3
Бьюрабов,gordunni,288,deathknight,unholy,6,3,3
Çhïñêséðk,defias-brotherhood,288,deathknight,unholy,6,3,3
Ahzee,alleria,288,deathknight,unholy,6,3,3
Filmsyz,ravencrest,288,deathknight,unholy,6,3,3
Míscodé,twisting-nether,288,deathknight,unholy,6,3,3
Deucalyqt,nemesis,288,deathknight,unholy,6,3,3
Oldmerle,blackmoore,288,deathknight,unholy,6,3,3
Deãth,archimonde,288,deathknight,unholy,6,3,3
Soloqueuedk,ravencrest,288,deathknight,unholy,6,3,3
Hurubur,ravencrest,288,deathknight,unholy,6,3,3
Iceludwig,nemesis,288,deathknight,unholy,6,3,3
Bigbaboon,stormreaver,288,deathknight,unholy,6,3,3
Badock,eredar,288,deathknight,unholy,6,3,3
Krookidk,archimonde,288,deathknight,unholy,6,3,3
Masakryczny,burning-legion,288,deathknight,unholy,6,3,3
Budd,stormscale,288,deathknight,unholy,6,3,3
Horrorda,defias-brotherhood,288,deathknight,unholy,6,3,3
Hasbullagødx,blackrock,288,deathknight,unholy,6,3,3
Rävjakt,twisting-nether,288,deathknight,unholy,6,3,3
Argelthal,draenor,288,deathknight,unholy,6,3,3
Израф,soulflayer,288,deathknight,unholy,6,3,3
Êyé,blackmoore,288,deathknight,unholy,6,3,3
Píz,ravencrest,288,deathknight,unholy,6,3,3
Jénga,ghostlands,288,deathknight,unholy,6,3,3
Bubblerumm,eonar,288,deathknight,unholy,6,3,3
Kalenis,nemesis,288,deathknight,unholy,6,3,3
Küseng,frostwolf,288,deathknight,unholy,6,3,3
Рончикк,gordunni,288,deathknight,unholy,6,3,3
Hurz,archimonde,288,deathknight,unholy,6,3,3
Galgalí,blackmoore,288,deathknight,unholy,6,3,3
Пашина,gordunni,288,deathknight,unholy,6,3,3
Grippyb,tarren-mill,288,deathknight,unholy,6,3,3
Vip,argent-dawn,288,deathknight,unholy,6,3,3
Krozzytwo,draenor,288,deathknight,unholy,6,3,3
Seldreas,silvermoon,288,deathknight,unholy,6,3,3
Izagolt,dun-modr,288,deathknight,unholy,6,3,3
Joyt,argent-dawn,288,deathknight,unholy,6,3,3
Løz,kazzak,288,deathknight,unholy,6,3,3
Legixd,outland,288,deathknight,unholy,6,3,3
Hêñtåìfänx,hyjal,288,deathknight,unholy,6,3,3
Tabano,onyxia,288,deathknight,unholy,6,3,3
Zêlëph,archimonde,288,deathknight,unholy,6,3,3
Sonervous,hyjal,288,deathknight,unholy,6,3,3
Grabbinass,silvermoon,288,deathknight,unholy,6,3,3
Soseiuchi,sargeras,288,deathknight,unholy,6,3,3
Chillfyre,argent-dawn,288,deathknight,unholy,8,3,5
Nmedk,grim-batol,288,deathknight,unholy,15,4,11
Semeris,twisting-nether,288,deathknight,unholy,12,3,9
Úñçháíñéd,kazzak,288,deathknight,unholy,12,3,9
Smurm,stormscale,288,deathknight,unholy,12,3,9
Shinetop,silvermoon,288,deathknight,unholy,12,3,9
Kptayn,culte-de-la-rive-noire,288,deathknight,unholy,12,3,9
Hexenköníg,frostmourne,288,deathknight,unholy,12,3,9
Lair,shendralar,288,deathknight,unholy,12,3,9
Whiskine,aggramar,288,deathknight,unholy,12,3,9
Sélyne,ysondre,288,deathknight,unholy,12,3,9
Oxcidium,archimonde,288,deathknight,unholy,12,3,9
Эвессом,goldrinn,288,deathknight,unholy,12,3,9
Cryoknight,doomhammer,288,deathknight,unholy,12,3,9
Benetleilax,bronzebeard,288,deathknight,unholy,12,3,9
Plaguebones,ravencrest,288,deathknight,unholy,12,3,9
Drraugrinn,tarren-mill,288,deathknight,unholy,12,3,9
Zixcommixx,hyjal,288,deathknight,unholy,12,3,9
Mizrael,burning-blade,288,deathknight,unholy,12,3,9
Letudra,outland,288,deathknight,unholy,12,3,9
Worldwiynd,ravencrest,288,deathknight,unholy,12,3,9
Seay,malorne,288,deathknight,unholy,12,3,9
Nooxi,sanguino,288,deathknight,unholy,12,3,9
Ecatholicus,silvermoon,288,deathknight,unholy,12,3,9
Dagë,twisting-nether,288,deathknight,unholy,12,3,9
Gongroosh,blackrock,288,deathknight,unholy,12,3,9
Ste,tarren-mill,288,deathknight,unholy,12,3,9
Infamousmobb,archimonde,288,deathknight,unholy,12,3,9
Re,stormrage,288,deathknight,unholy,12,3,9
Морталес,azuregos,288,deathknight,unholy,12,3,9
Alakiah,khaz-modan,288,deathknight,unholy,12,3,9
Lewro,drakthul,288,deathknight,unholy,12,3,9
Hoggster,kazzak,288,deathknight,unholy,12,3,9
Акерисса,gordunni,288,deathknight,unholy,12,3,9
Spiritomb,eonar,287,deathknight,unholy,6,3,3
Badameco,twisting-nether,287,deathknight,unholy,6,3,3
Zandul,terenas,287,deathknight,unholy,6,3,3
Каскадёрка,howling-fjord,287,deathknight,unholy,12,3,9
Mámmôn,malygos,287,deathknight,unholy,13,3,10
Xyasw,rashgarroth,286,deathknight,unholy,12,3,9
Abyad,dalaran,285,deathknight,unholy,12,3,9
Bestiaccia,nemesis,284,deathknight,unholy,12,3,9
Ghary,blackhand,256,deathknight,unholy,10,3,7
Отвян,gordunni,256,deathknight,unholy,10,3,7
Hateem,sylvanas,255,deathknight,unholy,11,3,8
Miruvar,tarren-mill,240,deathknight,unholy,9,3,6
Gogeta,zirkel-des-cenarius,239,deathknight,unholy,5,3,2
Dkreator,stormscale,234,deathknight,unholy,6,4,2
Charai,blackhand,234,deathknight,unholy,14,4,10
Xerone,turalyon,223,deathknight,unholy,8,3,5
Vîrus,kazzak,208,deathknight,unholy,13,3,10
Nexium,outland,192,deathknight,unholy,4,3,1
Zeldêrx,tarren-mill,192,deathknight,unholy,4,3,1
Shamytron,frostwolf,192,deathknight,unholy,6,3,3
Буризан,blackscar,192,deathknight,unholy,6,2,4
Bestkhalifä,ravencrest,192,deathknight,unholy,6,2,4
Ивитил,gordunni,192,deathknight,unholy,6,2,4
Woltorme,archimonde,192,deathknight,unholy,6,2,4
Савамура,gordunni,192,deathknight,unholy,6,2,4
Feldøøm,nemesis,192,deathknight,unholy,6,2,4
Сидлэй,gordunni,192,deathknight,unholy,6,2,4
Ironded,pozzo-delleternità,192,deathknight,unholy,6,2,4
Pandagodx,archimonde,192,deathknight,unholy,6,2,4
Горосов,gordunni,192,deathknight,unholy,6,2,4
Xartukî,dun-modr,192,deathknight,unholy,6,2,4
Iziqroi,archimonde,192,deathknight,unholy,6,2,4
Nokti,ravencrest,192,deathknight,unholy,6,2,4
Mcdreamy,grim-batol,192,deathknight,unholy,6,2,4
Seleniele,draenor,192,deathknight,unholy,6,2,4
Tinyfever,kazzak,192,deathknight,unholy,6,2,4
Hasoyro,burning-legion,192,deathknight,unholy,6,2,4
Suksiboksi,shattered-hand,192,deathknight,unholy,6,2,4
Clipe,sanguino,192,deathknight,unholy,6,2,4
Акимур,gordunni,192,deathknight,unholy,6,2,4
Karnatron,draenor,192,deathknight,unholy,6,2,4
Homelándér,blackmoore,192,deathknight,unholy,6,2,4
Kacpèr,burning-legion,192,deathknight,unholy,6,2,4
Yaxa,sylvanas,192,deathknight,unholy,6,2,4
Fdkgotbuffed,tarren-mill,192,deathknight,unholy,6,2,4
Firebladesa,ravencrest,192,deathknight,unholy,6,2,4
Bladertz,tarren-mill,192,deathknight,unholy,6,2,4
Brávéhéart,silvermoon,192,deathknight,unholy,6,2,4
Аэрит,howling-fjord,192,deathknight,unholy,6,2,4
Màzii,burning-legion,192,deathknight,unholy,6,2,4
Имбазомбарь,howling-fjord,192,deathknight,unholy,6,2,4
Lén,malygos,192,deathknight,unholy,6,2,4
Penumbris,silvermoon,192,deathknight,unholy,6,2,4
Xvlane,silvermoon,192,deathknight,unholy,6,2,4
Sjöstedt,twisting-nether,192,deathknight,unholy,6,2,4
Unholyysteel,silvermoon,192,deathknight,unholy,6,2,4
Necrosiss,sunstrider,192,deathknight,unholy,6,2,4
Haeydez,draenor,192,deathknight,unholy,6,2,4
Lithics,blades-edge,192,deathknight,unholy,6,2,4
Гнилец,soulflayer,192,deathknight,unholy,6,2,4
Norux,alonsus,192,deathknight,unholy,6,2,4
Kyppz,gorgonnash,192,deathknight,unholy,6,2,4
Cursed,guldan,192,deathknight,unholy,6,2,4
Engelinä,ysondre,192,deathknight,unholy,6,2,4
Seldrick,silvermoon,192,deathknight,unholy,6,2,4
Szendeffy,ragnaros,192,deathknight,unholy,6,2,4
Draghonis,argent-dawn,192,deathknight,unholy,6,2,4
Kromas,silvermoon,192,deathknight,unholy,6,2,4
Kapitandk,sanguino,192,deathknight,unholy,6,2,4
Njor,twisting-nether,192,deathknight,unholy,6,2,4
Tirno,dun-modr,192,deathknight,unholy,6,2,4
Yoinkw,tarren-mill,192,deathknight,unholy,6,2,4
Eigrin,argent-dawn,192,deathknight,unholy,6,2,4
Urukaye,silvermoon,192,deathknight,unholy,6,2,4
Dk,earthen-ring,192,deathknight,unholy,6,2,4
Frøzendeadz,blackhand,192,deathknight,unholy,6,2,4
Mangalitsa,twisting-nether,192,deathknight,unholy,6,2,4
Varogo,drakthul,192,deathknight,unholy,6,2,4
Nihilistyx,blackrock,192,deathknight,unholy,6,2,4
Postura,kazzak,192,deathknight,unholy,6,2,4
Doubledead,the-maelstrom,192,deathknight,unholy,6,2,4
Jizzburga,blackhand,192,deathknight,unholy,6,2,4
Dilbil,tarren-mill,192,deathknight,unholy,6,2,4
Bårêlýgød,blackmoore,192,deathknight,unholy,6,2,4
Kaysto,blackrock,192,deathknight,unholy,6,2,4
Highblood,tarren-mill,192,deathknight,unholy,6,2,4
Arthaslegend,magtheridon,192,deathknight,unholy,12,2,10
Niilø,antonidas,192,deathknight,unholy,12,2,10
Lumerix,drakthul,192,deathknight,unholy,12,2,10
Ротвхалве,deathweaver,192,deathknight,unholy,12,2,10
Холбункойл,gordunni,192,deathknight,unholy,12,2,10
Snøsamannen,ravencrest,192,deathknight,unholy,12,2,10
Goldins,doomhammer,192,deathknight,unholy,12,2,10
Deathdayben,kazzak,192,deathknight,unholy,12,2,10
Carnificis,nefarian,192,deathknight,unholy,12,2,10
Foíegras,stormscale,192,deathknight,unholy,12,2,10
Azrail,alonsus,192,deathknight,unholy,12,2,10
Скромасакс,gordunni,192,deathknight,unholy,12,2,10
Гадиния,soulflayer,191,deathknight,unholy,4,3,1
Sangreloco,voljin,191,deathknight,unholy,6,2,4
Tygootjuh,nagrand,191,deathknight,unholy,6,2,4
Whitedead,destromath,191,deathknight,unholy,7,2,5
Strigoih,argent-dawn,190,deathknight,unholy,12,2,10
Gaisham,confrérie-du-thorium,190,deathknight,unholy,12,2,10
Ândi,alleria,190,deathknight,unholy,12,2,10
Scalina,naxxramas,159,deathknight,unholy,5,2,3
Xolaani,outland,159,deathknight,unholy,5,2,3
Feätures,ragnaros,159,deathknight,unholy,5,2,3
Dødsmanna,twisting-nether,144,deathknight,unholy,9,2,7
Дралкс,gordunni,138,deathknight,unholy,10,3,7
Sämäël,outland,137,deathknight,unholy,8,3,5
Auto,hyjal,128,deathknight,unholy,4,2,2
Justaniceguy,silvermoon,96,deathknight,unholy,3,2,1
Árnèr,tyrande,96,deathknight,unholy,3,2,1
Deekee,kazzak,96,deathknight,unholy,6,1,5
Cameltôe,frostwolf,96,deathknight,unholy,6,1,5
Routasydän,outland,96,deathknight,unholy,6,1,5
Tributus,perenolde,96,deathknight,unholy,6,1,5
Искрос,gordunni,96,deathknight,unholy,6,1,5
Eívór,garrosh,96,deathknight,unholy,6,1,5
Имерсий,gordunni,96,deathknight,unholy,6,1,5
Victura,outland,96,deathknight,unholy,6,1,5
Arthasuk,dun-modr,96,deathknight,unholy,6,1,5
Apraxia,ravencrest,96,deathknight,unholy,6,1,5
Sìrmooalot,twisting-nether,96,deathknight,unholy,6,1,5
Grimgôr,kazzak,96,deathknight,unholy,6,1,5
Drfatnuts,kazzak,96,deathknight,unholy,6,1,5
Melicia,anubarak,96,deathknight,unholy,6,1,5
Dextèr,stormreaver,96,deathknight,unholy,6,1,5
Veleran,blackrock,96,deathknight,unholy,6,1,5
Seuchensturz,zirkel-des-cenarius,96,deathknight,unholy,6,1,5
Twistednut,argent-dawn,96,deathknight,unholy,6,1,5
Гачимучий,soulflayer,96,deathknight,unholy,6,1,5
Rongos,norgannon,96,deathknight,unholy,6,1,5
Apokalipx,ragnaros,96,deathknight,unholy,6,1,5
Scourgebane,kazzak,96,deathknight,unholy,6,1,5
Rakeschnake,teldrassil,96,deathknight,unholy,6,1,5
Nyzak,stormscale,96,deathknight,unholy,6,1,5
Хеллхэйм,soulflayer,96,deathknight,unholy,6,1,5
Ballie,tarren-mill,96,deathknight,unholy,6,1,5
Orrengo,blackrock,96,deathknight,unholy,6,1,5
Коилкоилкоил,blackscar,96,deathknight,unholy,6,1,5
Ravages,durotan,96,deathknight,unholy,6,1,5
Êroô,azjolnerub,96,deathknight,unholy,6,1,5
Saurøn,chogall,96,deathknight,unholy,6,1,5
Ôcb,marécage-de-zangar,96,deathknight,unholy,6,1,5
Кернесса,blackscar,96,deathknight,unholy,6,1,5
Oghul,blackmoore,96,deathknight,unholy,6,1,5
Диманекротик,blackscar,96,deathknight,unholy,6,1,5
Ashgen,ravencrest,96,deathknight,unholy,6,1,5
Инфлюминс,soulflayer,96,deathknight,unholy,6,1,5
Gdubet,kazzak,96,deathknight,unholy,6,1,5
Beliall,draenor,96,deathknight,unholy,6,1,5
Skrati,das-syndikat,96,deathknight,unholy,6,1,5
Erbores,destromath,96,deathknight,unholy,6,1,5
Wavemaker,kazzak,96,deathknight,unholy,6,1,5
Fefefasza,ragnaros,96,deathknight,unholy,6,1,5
Antexdk,drakthul,96,deathknight,unholy,6,1,5
Ohris,silvermoon,96,deathknight,unholy,6,1,5
Dumbclass,wildhammer,96,deathknight,unholy,6,1,5
Vlaakith,thunderhorn,96,deathknight,unholy,6,1,5
Axemastery,draenor,96,deathknight,unholy,6,1,5
Джеттар,howling-fjord,96,deathknight,unholy,6,1,5
Unholygunnds,ravencrest,96,deathknight,unholy,6,1,5
Yagashi,stormscale,96,deathknight,unholy,6,1,5
Brotén,grim-batol,96,deathknight,unholy,6,1,5
Darkcøbra,culte-de-la-rive-noire,96,deathknight,unholy,6,1,5
Гроскот,howling-fjord,96,deathknight,unholy,6,1,5
Муунрок,howling-fjord,96,deathknight,unholy,6,1,5
Itrailblazer,turalyon,96,deathknight,unholy,6,1,5
Chøsen,sargeras,96,deathknight,unholy,6,1,5
Madsgrip,tarren-mill,96,deathknight,unholy,6,1,5
Lionello,stormscale,96,deathknight,unholy,6,1,5
Tsoupunisher,ravencrest,96,deathknight,unholy,6,1,5
Cowsoup,stormscale,96,deathknight,unholy,6,1,5
Blackpeper,silvermoon,96,deathknight,unholy,6,1,5
Hemki,archimonde,96,deathknight,unholy,6,1,5
Lieven,tarren-mill,96,deathknight,unholy,6,1,5
Såphirå,doomhammer,96,deathknight,unholy,6,1,5
Abusedk,archimonde,96,deathknight,unholy,6,1,5
Natanio,area-52,96,deathknight,unholy,6,1,5
Verssatus,archimonde,96,deathknight,unholy,6,1,5
Blackterrør,hyjal,96,deathknight,unholy,12,1,11
Peiie,ravencrest,96,deathknight,unholy,12,1,11
Buzknight,twisting-nether,96,deathknight,unholy,12,1,11
Hathriel,blackmoore,96,deathknight,unholy,12,1,11
Rhmoseli,twisting-nether,96,deathknight,unholy,12,1,11
Brasith,outland,96,deathknight,unholy,12,1,11
Gärrøsh,cthun,96,deathknight,unholy,12,1,11
Erezar,burning-legion,96,deathknight,unholy,12,1,11
Yøkai,ysondre,96,deathknight,unholy,12,1,11
Gosting,kirin-tor,96,deathknight,unholy,12,1,11
Cynthiia,sylvanas,96,deathknight,unholy,18,1,17
Gangman,kazzak,95,deathknight,unholy,9,3,6
Bäverpung,ragnaros,95,deathknight,unholy,6,1,5
Beurkbeurk,la-croisade-écarlate,95,deathknight,unholy,15,1,14
Шалелая,soulflayer,79,deathknight,unholy,5,1,4
Tørbåk,ysondre,79,deathknight,unholy,5,1,4
Bonthejovi,tarren-mill,79,deathknight,unholy,5,1,4
Custardo,grim-batol,63,deathknight,unholy,8,2,6
Kevsdk,arthas,48,deathknight,unholy,3,1,2
Talithakum,burning-legion,31,deathknight,unholy,2,1,1
Врейтфул,ashenvale,31,deathknight,unholy,2,1,1
Errøar,aegwynn,31,deathknight,unholy,2,1,1
Intrih,arathor,16,deathknight,unholy,7,1,6
Nellion,kazzak,2146,deathknight,frost,102,50,52
Skylerblack,kazzak,2139,deathknight,frost,113,72,41
Имерсий,gordunni,2104,deathknight,frost,72,43,29
Fdkgotbuffed,tarren-mill,2072,deathknight,frost,90,45,45
Leónid,kazzak,2071,deathknight,frost,75,38,37
Garrinchá,stormscale,2053,deathknight,frost,66,39,27
Никнейм,gordunni,2041,deathknight,frost,221,111,110
Anotherdkx,ravencrest,2002,deathknight,frost,66,39,27
Igetmount,draenor,2001,deathknight,frost,191,99,92
Arrestedx,aegwynn,1975,deathknight,frost,81,43,38
Diogenisis,arthas,1973,deathknight,frost,183,92,91
Viuff,kazzak,1932,deathknight,frost,48,25,23
Jeanice,blackhand,1905,deathknight,frost,127,67,60
Малтель,howling-fjord,1900,deathknight,frost,66,33,33
Murbastic,draenor,1897,deathknight,frost,344,171,173
Justaniceguy,silvermoon,1895,deathknight,frost,90,50,40
Bedstemoor,ravencrest,1849,deathknight,frost,47,28,19
Frostlux,archimonde,1837,deathknight,frost,799,397,402
Ayro,aegwynn,1824,deathknight,frost,112,60,52
Шадоудез,gordunni,1820,deathknight,frost,60,29,31
Zektal,thrall,1819,deathknight,frost,138,70,68
Moreau,eredar,1818,deathknight,frost,235,123,112
Maxto,outland,1812,deathknight,frost,54,32,22
Narali,argent-dawn,1811,deathknight,frost,78,34,44
Эриданс,gordunni,1806,deathknight,frost,48,32,16
Dktroll,blackmoore,1806,deathknight,frost,235,123,112
Vidofnir,argent-dawn,1804,deathknight,frost,128,74,54
Картафилиус,soulflayer,1804,deathknight,frost,66,28,38
Geunieve,ysondre,1792,deathknight,frost,107,48,59
Zdi,tarren-mill,1787,deathknight,frost,82,42,40
Drkok,blackmoore,1771,deathknight,frost,131,77,54
Leonis,arthas,1771,deathknight,frost,83,45,38
Lylíth,archimonde,1762,deathknight,frost,105,66,39
Ronsôn,terrordar,1756,deathknight,frost,36,21,15
Nèrfx,ragnaros,1755,deathknight,frost,48,26,22
Murky,kazzak,1752,deathknight,frost,114,61,53
Джонаджеймсн,soulflayer,1739,deathknight,frost,122,60,62
Oßitø,ravencrest,1733,deathknight,frost,64,36,28
Mkom,ravencrest,1728,deathknight,frost,84,44,40
Verssatus,archimonde,1723,deathknight,frost,54,26,28
Re,stormrage,1718,deathknight,frost,54,28,26
Sonnedeath,tarren-mill,1715,deathknight,frost,82,40,42
Brawlerbabe,stormscale,1706,deathknight,frost,226,114,112
Kisyhrâ,aegwynn,1703,deathknight,frost,64,35,29
Synthwave,tarren-mill,1697,deathknight,frost,30,18,12
Zulthos,argent-dawn,1694,deathknight,frost,132,77,55
Aceléss,drakthul,1684,deathknight,frost,42,24,18
Frege,tarren-mill,1684,deathknight,frost,42,23,19
Duriel,stormscale,1681,deathknight,frost,276,142,134
Импостик,blackscar,1670,deathknight,frost,48,24,24
Indrette,archimonde,1667,deathknight,frost,40,20,20
Arxelas,stormscale,1663,deathknight,frost,80,50,30
Mikagoddess,argent-dawn,1663,deathknight,frost,130,65,65
Eynoway,blackmoore,1662,deathknight,frost,36,20,16
Rêxaks,dun-modr,1662,deathknight,frost,66,31,35
Frostymel,ravencrest,1654,deathknight,frost,168,86,82
Maryø,drakthul,1641,deathknight,frost,77,39,38
Neitoperho,frostmane,1641,deathknight,frost,63,28,35
Arxelas,sylvanas,1637,deathknight,frost,196,103,93
Энвилион,howling-fjord,1634,deathknight,frost,120,66,54
Neorteriona,argent-dawn,1632,deathknight,frost,197,108,89
Nîghtmáre,ravencrest,1630,deathknight,frost,182,88,94
Ниффер,deathguard,1627,deathknight,frost,34,18,16
Køley,draenor,1619,deathknight,frost,30,17,13
Xolaani,outland,1619,deathknight,frost,114,53,61
Frace,tyrande,1619,deathknight,frost,84,38,46
Frostfoxx,archimonde,1617,deathknight,frost,156,83,73
Кулькулегал,ashenvale,1617,deathknight,frost,84,44,40
Oldmerle,blackmoore,1617,deathknight,frost,45,23,22
Ärkhas,ragnaros,1616,deathknight,frost,47,26,21
Cyliandra,silvermoon,1615,deathknight,frost,48,27,21
Silvergreed,kazzak,1615,deathknight,frost,64,34,30
Banishabomb,ragnaros,1615,deathknight,frost,78,39,39
Frostzanlar,archimonde,1613,deathknight,frost,44,23,21
Дарргг,ashenvale,1612,deathknight,frost,167,79,88
Dakyforfun,ravencrest,1611,deathknight,frost,30,20,10
Veneera,emeriss,1610,deathknight,frost,24,17,7
Raylenx,uldaman,1609,deathknight,frost,75,39,36
Fallenjaina,kazzak,1608,deathknight,frost,290,149,141
Obliterate,frostmourne,1604,deathknight,frost,140,77,63
Gorobijec,drakthul,1604,deathknight,frost,238,116,122
Chakko,ravencrest,1601,deathknight,frost,141,69,72
Espatula,ravencrest,1597,deathknight,frost,66,31,35
Клиссанг,razuvious,1594,deathknight,frost,42,22,20
Decayz,thrall,1593,deathknight,frost,58,30,28
Даркслэш,howling-fjord,1592,deathknight,frost,51,24,27
Rektsohard,ravencrest,1590,deathknight,frost,75,44,31
Deucàlyqt,nemesis,1589,deathknight,frost,64,28,36
Selena,blackmoore,1587,deathknight,frost,30,17,13
Worlviuz,argent-dawn,1584,deathknight,frost,60,29,31
Dexterlul,blackmoore,1579,deathknight,frost,60,28,32
Спамлюоковы,gordunni,1577,deathknight,frost,29,18,11
Dktyro,ravencrest,1576,deathknight,frost,48,27,21
Nazgül,drakthul,1572,deathknight,frost,71,40,31
Diatriss,argent-dawn,1572,deathknight,frost,139,78,61
Tørbåk,ysondre,1572,deathknight,frost,48,21,27
Wuurzaag,twisting-nether,1571,deathknight,frost,42,21,21
Руянгрубиян,howling-fjord,1568,deathknight,frost,64,28,36
Винкис,gordunni,1567,deathknight,frost,188,99,89
Kooklynn,aggra-português,1562,deathknight,frost,95,53,42
Deathvarg,argent-dawn,1558,deathknight,frost,90,41,49
Festerblight,grim-batol,1556,deathknight,frost,36,22,14
Jumbogrip,tarren-mill,1554,deathknight,frost,88,49,39
Apocallyptic,auchindoun,1549,deathknight,frost,79,48,31
Sipsip,tarren-mill,1548,deathknight,frost,201,106,95
Dzengiskhan,draenor,1546,deathknight,frost,198,103,95
Ithêrius,blackmoore,1544,deathknight,frost,41,21,20
Kailara,draenor,1544,deathknight,frost,209,107,102
Gauloupin,lightnings-blade,1540,deathknight,frost,87,44,43
Deucalyqt,nemesis,1538,deathknight,frost,66,31,35
Halez,antonidas,1531,deathknight,frost,78,46,32
Лордтемар,howling-fjord,1530,deathknight,frost,54,25,29
Darlyn,grim-batol,1529,deathknight,frost,48,31,17
Dripgrip,ravencrest,1529,deathknight,frost,77,36,41
Blendamed,outland,1529,deathknight,frost,60,25,35
Tenzøftw,archimonde,1527,deathknight,frost,31,17,14
Селес,ashenvale,1526,deathknight,frost,30,16,14
Anasûrimbor,tarren-mill,1526,deathknight,frost,36,18,18
Hatriox,outland,1525,deathknight,frost,201,107,94
Маклайкнайт,gordunni,1521,deathknight,frost,382,193,189
Adär,kazzak,1512,deathknight,frost,78,39,39
Nymfo,tirion,1510,deathknight,frost,76,44,32
Phrek,outland,1509,deathknight,frost,24,16,8
Leahthemad,sylvanas,1505,deathknight,frost,63,33,30
Thiccsnack,ragnaros,1505,deathknight,frost,41,21,20
Akril,tarren-mill,1505,deathknight,frost,114,58,56
Геннош,howling-fjord,1503,deathknight,frost,96,49,47
Morgued,ravencrest,1502,deathknight,frost,60,30,30
Cleverb,silvermoon,1501,deathknight,frost,36,18,18
Erbugul,uldum,1501,deathknight,frost,169,81,88
Blácked,draenor,1500,deathknight,frost,138,73,65
Ullefuz,silvermoon,1496,deathknight,frost,107,55,52
Prokszii,turalyon,1492,deathknight,frost,75,42,33
Balrot,burning-legion,1492,deathknight,frost,66,30,36
Krauss,argent-dawn,1489,deathknight,frost,42,18,24
Abadonn,archimonde,1489,deathknight,frost,66,28,38
Empar,nethersturm,1486,deathknight,frost,81,44,37
Orcborg,zuljin,1485,deathknight,frost,127,72,55
Regniér,frostwolf,1482,deathknight,frost,333,163,170
Axram,ravencrest,1477,deathknight,frost,43,26,17
Leyc,argent-dawn,1476,deathknight,frost,41,19,22
Grendul,blackmoore,1475,deathknight,frost,84,44,40
Teldä,archimonde,1472,deathknight,frost,79,39,40
Флаттершайдк,booty-bay,1466,deathknight,frost,49,23,26
Enizul,kazzak,1441,deathknight,frost,77,41,36
Vainie,argent-dawn,1439,deathknight,frost,51,30,21
Солист,soulflayer,1439,deathknight,frost,163,89,74
Myzouth,silvermoon,1438,deathknight,frost,24,15,9
Madseason,burning-legion,1438,deathknight,frost,72,35,37
Катаринья,howling-fjord,1432,deathknight,frost,140,67,73
Сенкрул,gordunni,1432,deathknight,frost,51,24,27
Средозавр,howling-fjord,1429,deathknight,frost,50,27,23
Arthasuk,dun-modr,1429,deathknight,frost,308,165,143
Leahthebad,sylvanas,1428,deathknight,frost,61,31,30
Меланндрис,gordunni,1427,deathknight,frost,63,40,23
Wildsword,sylvanas,1427,deathknight,frost,75,38,37
Nasxsy,blackmoore,1425,deathknight,frost,24,15,9
Wrathlich,tyrande,1425,deathknight,frost,124,59,65
Десигнатор,gordunni,1424,deathknight,frost,86,42,44
Sinabre,uldaman,1424,deathknight,frost,91,44,47
Desolatiøn,ravencrest,1422,deathknight,frost,102,50,52
Бронерэй,gordunni,1421,deathknight,frost,24,15,9
Trashboat,outland,1419,deathknight,frost,42,21,21
Chillfyre,argent-dawn,1419,deathknight,frost,42,20,22
Stevensdk,darkspear,1414,deathknight,frost,69,33,36
Ðeucaly,nemesis,1411,deathknight,frost,96,47,49
Furleyc,argent-dawn,1410,deathknight,frost,66,37,29
Bàbarus,dun-morogh,1407,deathknight,frost,66,42,24
Интерио,howling-fjord,1404,deathknight,frost,30,15,15
Zhigan,ravencrest,1404,deathknight,frost,36,16,20
Scørn,thrall,1401,deathknight,frost,234,117,117
Фростмаран,soulflayer,1401,deathknight,frost,120,58,62
Angalor,argent-dawn,1399,deathknight,frost,44,18,26
Вирко,eversong,1397,deathknight,frost,37,19,18
Истинна,grom,1394,deathknight,frost,36,20,16
Dreadnight,sanguino,1394,deathknight,frost,38,18,20
Асаала,soulflayer,1393,deathknight,frost,33,21,12
Ккма,gordunni,1391,deathknight,frost,90,54,36
Rubbann,ravencrest,1391,deathknight,frost,30,15,15
Gorefiend,kazzak,1391,deathknight,frost,49,22,27
Cdp,ragnaros,1390,deathknight,frost,174,93,81
Skorice,dalaran,1389,deathknight,frost,48,19,29
Cedex,tarren-mill,1388,deathknight,frost,36,16,20
Düksito,dun-modr,1387,deathknight,frost,99,50,49
Jizzburga,blackhand,1387,deathknight,frost,128,60,68
Mocca,aegwynn,1385,deathknight,frost,58,25,33
Spøøk,defias-brotherhood,1383,deathknight,frost,229,114,115
Вурдулакх,gordunni,1380,deathknight,frost,79,40,39
Отвян,gordunni,1377,deathknight,frost,48,17,31
Reapocalypse,blackhand,1376,deathknight,frost,36,16,20
Arthaslegend,magtheridon,1376,deathknight,frost,84,35,49
Iaccidens,stormscale,1374,deathknight,frost,222,112,110
Gøtrek,archimonde,1371,deathknight,frost,78,35,43
Dükss,dun-modr,1366,deathknight,frost,65,38,27
Keronaterol,blackhand,1363,deathknight,frost,84,46,38
Xyrosa,argent-dawn,1360,deathknight,frost,45,18,27
Kãra,ysondre,1358,deathknight,frost,220,111,109
Primø,malganis,1357,deathknight,frost,34,17,17
Yeamaon,ravencrest,1353,deathknight,frost,79,38,41
Tzunâ,blackmoore,1350,deathknight,frost,58,27,31
Dextroyersx,sanguino,1348,deathknight,frost,65,33,32
Karax,draenor,1338,deathknight,frost,44,20,24
Darkdémn,eldrethalas,1336,deathknight,frost,48,20,28
Nifllheimr,outland,1335,deathknight,frost,48,24,24
Фэйлстрайк,azuregos,1334,deathknight,frost,41,20,21
Cayliadk,tarren-mill,1332,deathknight,frost,203,96,107
Ubiystvo,kazzak,1328,deathknight,frost,102,54,48
Buldog,laughing-skull,1328,deathknight,frost,136,65,71
Superere,hyjal,1326,deathknight,frost,150,80,70
Касуляпвнз,gordunni,1326,deathknight,frost,77,41,36
Vincestaples,mannoroth,1326,deathknight,frost,88,44,44
Mâxî,hyjal,1323,deathknight,frost,48,18,30
Comehere,norgannon,1321,deathknight,frost,30,19,11
Tofin,dunemaul,1320,deathknight,frost,44,21,23
Sindó,blackrock,1319,deathknight,frost,57,31,26
Sound,shadowsong,1319,deathknight,frost,84,38,46
Morbidx,ravencrest,1315,deathknight,frost,64,25,39
Wardrickxdd,ravencrest,1314,deathknight,frost,30,16,14
Døuffy,hyjal,1313,deathknight,frost,236,119,117
Ihatelife,frostwolf,1309,deathknight,frost,182,90,92
Kiraxen,draenor,1308,deathknight,frost,36,20,16
Mcrune,ravencrest,1306,deathknight,frost,50,23,27
Zoree,draenor,1306,deathknight,frost,54,19,35
Deathknight,spinebreaker,1303,deathknight,frost,96,45,51
Wlcrealworld,ravencrest,1302,deathknight,frost,108,51,57
Deucalygodx,nemesis,1301,deathknight,frost,60,22,38
Orkishblack,tarren-mill,1298,deathknight,frost,47,25,22
Âlîce,culte-de-la-rive-noire,1297,deathknight,frost,54,26,28
Reezeer,stormscale,1293,deathknight,frost,80,35,45
Папичдк,gordunni,1291,deathknight,frost,29,16,13
Vîrus,kazzak,1290,deathknight,frost,36,17,19
Wintersons,tarren-mill,1285,deathknight,frost,66,31,35
Odaijini,archimonde,1284,deathknight,frost,29,14,15
Soulrender,kirin-tor,1283,deathknight,frost,36,15,21
Barathéøn,les-sentinelles,1282,deathknight,frost,53,19,34
Inaëlys,medivh,1281,deathknight,frost,67,37,30
Нифер,deathguard,1274,deathknight,frost,26,14,12
Zúrg,stormscale,1273,deathknight,frost,96,54,42
Dämäger,proudmoore,1272,deathknight,frost,167,87,80
Piri,defias-brotherhood,1272,deathknight,frost,94,46,48
Satyriasis,twisting-nether,1270,deathknight,frost,61,34,27
Torbrand,ravencrest,1270,deathknight,frost,57,29,28
Annecanos,ravencrest,1269,deathknight,frost,30,20,10
Ilovebigass,ravencrest,1267,deathknight,frost,30,14,16
Sukadino,ragnaros,1264,deathknight,frost,60,31,29
Morgouse,kazzak,1262,deathknight,frost,209,102,107
Twardobaba,burning-legion,1261,deathknight,frost,74,37,37
Môrgøth,nemesis,1256,deathknight,frost,72,32,40
Exodiuss,dalaran,1255,deathknight,frost,52,28,24
Mikese,silvermoon,1252,deathknight,frost,87,45,42
Moosbirne,blackhand,1251,deathknight,frost,54,24,30
Trogkhar,blackrock,1249,deathknight,frost,47,26,21
Elendren,blackrock,1247,deathknight,frost,24,13,11
Thenrys,culte-de-la-rive-noire,1246,deathknight,frost,222,107,115
Ваатерло,soulflayer,1246,deathknight,frost,66,28,38
Kàrásu,eredar,1245,deathknight,frost,36,14,22
Feelmyfuri,mazrigos,1243,deathknight,frost,30,13,17
Tayuyu,sylvanas,1241,deathknight,frost,32,14,18
Slexor,kargath,1241,deathknight,frost,42,18,24
Darxiera,drakthul,1240,deathknight,frost,79,35,44
Йохан,greymane,1240,deathknight,frost,40,15,25
Pandahapci,ragnaros,1239,deathknight,frost,24,13,11
Rakhash,antonidas,1238,deathknight,frost,72,42,30
Bêllør,archimonde,1234,deathknight,frost,24,13,11
Raihor,outland,1231,deathknight,frost,32,13,19
Униорк,howling-fjord,1229,deathknight,frost,24,13,11
Merdraut,alakir,1228,deathknight,frost,46,25,21
Aracnys,dalaran,1227,deathknight,frost,42,17,25
Unchaindk,outland,1226,deathknight,frost,66,32,34
Кроуфрост,gordunni,1220,deathknight,frost,120,57,63
Molgoth,outland,1218,deathknight,frost,46,16,30
Разлажение,gordunni,1216,deathknight,frost,78,41,37
Kaeyz,blackmoore,1216,deathknight,frost,30,13,17
Frostmommy,argent-dawn,1214,deathknight,frost,41,16,25
Zuggandk,tarren-mill,1209,deathknight,frost,48,26,22
Winterberger,silvermoon,1200,deathknight,frost,29,13,16
Nôsferatú,amanthul,1196,deathknight,frost,160,81,79
Grumpykathi,blackmoore,1188,deathknight,frost,36,20,16
Krasny,hyjal,1185,deathknight,frost,156,81,75
Hî,malganis,1181,deathknight,frost,141,69,72
Íbossit,doomhammer,1180,deathknight,frost,28,17,11
Gageth,shadowsong,1180,deathknight,frost,45,15,30
Ziuziu,twisting-nether,1177,deathknight,frost,135,67,68
Vampire,ahnqiraj,1172,deathknight,frost,33,14,19
Predatormkdd,ravencrest,1171,deathknight,frost,41,26,15
Azrador,frostwolf,1171,deathknight,frost,202,95,107
Clàymax,kazzak,1171,deathknight,frost,51,21,30
Fróst,dun-modr,1170,deathknight,frost,73,41,32
Düks,dun-modr,1166,deathknight,frost,124,55,69
Collinná,aegwynn,1162,deathknight,frost,60,25,35
Zandruq,twisting-nether,1162,deathknight,frost,58,24,34
Rogerwaterz,twisting-nether,1159,deathknight,frost,43,24,19
Darkride,shattrath,1153,deathknight,frost,43,22,21
Mellion,ragnaros,1152,deathknight,frost,18,12,6
Alastoras,nemesis,1152,deathknight,frost,43,23,20
Necrølyte,sylvanas,1149,deathknight,frost,18,12,6
Zanretxd,outland,1149,deathknight,frost,102,55,47
Belía,blackmoore,1146,deathknight,frost,62,27,35
Qus,twisting-nether,1145,deathknight,frost,30,12,18
Stely,alonsus,1144,deathknight,frost,18,12,6
Darkchas,silvermoon,1144,deathknight,frost,24,12,12
Monkeydclaus,arathor,1144,deathknight,frost,96,47,49
Zioan,jaedenar,1143,deathknight,frost,117,63,54
Zerodude,silvermoon,1142,deathknight,frost,60,30,30
Goring,confrérie-du-thorium,1137,deathknight,frost,24,12,12
Rilledred,stormscale,1136,deathknight,frost,57,29,28
Polimeh,draenor,1132,deathknight,frost,66,38,28
Posinkautta,silvermoon,1131,deathknight,frost,24,17,7
Mattesøs,drakthul,1130,deathknight,frost,36,13,23
Abnormus,tarren-mill,1129,deathknight,frost,143,72,71
Тайберзанн,grom,1127,deathknight,frost,30,12,18
Fixmybones,frostmane,1123,deathknight,frost,78,37,41
Ilopango,blackmoore,1123,deathknight,frost,47,17,30
Dkruffos,draenor,1115,deathknight,frost,66,27,39
Khelthalas,teldrassil,1114,deathknight,frost,37,26,11
Triddion,sylvanas,1113,deathknight,frost,24,12,12
Ivik,the-maelstrom,1112,deathknight,frost,79,46,33
Nathriel,stormscale,1110,deathknight,frost,41,17,24
Akantras,blackmoore,1106,deathknight,frost,59,28,31
Archa,shendralar,1105,deathknight,frost,95,43,52
Woddey,blackrock,1101,deathknight,frost,60,29,31
Nelahh,the-maelstrom,1100,deathknight,frost,59,30,29
Sêmelia,blackrock,1095,deathknight,frost,33,15,18
Regys,argent-dawn,1080,deathknight,frost,28,12,16
Вафельнаяфея,blackscar,1073,deathknight,frost,43,17,26
Zaouros,silvermoon,1070,deathknight,frost,48,12,36
Greiz,aggramar,1058,deathknight,frost,43,17,26
Elcapìtan,silvermoon,1054,deathknight,frost,18,11,7
Icebitten,argent-dawn,1053,deathknight,frost,27,18,9
Unaxito,sanguino,1052,deathknight,frost,24,11,13
Некробасс,deathguard,1052,deathknight,frost,24,11,13
Khagra,ravencrest,1051,deathknight,frost,24,11,13
Fallén,stormrage,1050,deathknight,frost,24,11,13
Gravehammer,sylvanas,1044,deathknight,frost,40,23,17
Jugglez,thrall,1043,deathknight,frost,24,11,13
Dødsgud,khaz-modan,1042,deathknight,frost,86,45,41
Feekus,deathwing,1039,deathknight,frost,18,11,7
Endavor,ragnaros,1037,deathknight,frost,42,20,22
Arond,arygos,1035,deathknight,frost,30,12,18
Deathcardos,die-aldor,1035,deathknight,frost,60,23,37
Këus,hyjal,1033,deathknight,frost,24,17,7
Thrigoth,ravencrest,1033,deathknight,frost,48,18,30
Блодскал,howling-fjord,1031,deathknight,frost,30,11,19
Êbøla,sanguino,1030,deathknight,frost,102,40,62
Slayrr,blackrock,1028,deathknight,frost,29,13,16
Мертвячино,deathguard,1026,deathknight,frost,18,12,6
Sunwrath,magtheridon,1025,deathknight,frost,63,31,32
Moiret,drakthul,1025,deathknight,frost,59,15,44
Krylow,draenor,1020,deathknight,frost,42,17,25
Sjöstedt,twisting-nether,1019,deathknight,frost,29,11,18
Холбункойл,gordunni,1016,deathknight,frost,48,17,31
Kalenjii,burning-legion,1006,deathknight,frost,23,11,12
Quantumshift,ravencrest,1004,deathknight,frost,17,11,6
Alameda,nathrezim,1004,deathknight,frost,34,15,19
Kixx,bloodfeather,1003,deathknight,frost,125,53,72
Zerdon,frostmane,1001,deathknight,frost,61,32,29
Nachtschwarz,amanthul,1001,deathknight,frost,33,16,17
Bari,the-venture-co,1001,deathknight,frost,158,68,90
Akmens,aggramar,998,deathknight,frost,30,14,16
Sooran,blackhand,994,deathknight,frost,24,16,8
Порция,greymane,993,deathknight,frost,107,57,50
Dursall,thrall,992,deathknight,frost,290,145,145
Whooz,dun-morogh,977,deathknight,frost,47,11,36
Angôs,sanguino,973,deathknight,frost,120,57,63
Flúrrý,kazzak,960,deathknight,frost,24,10,14
Apacstanya,ragnaros,960,deathknight,frost,24,10,14
Shicheria,blackrock,959,deathknight,frost,18,10,8
Zsozsodk,ragnaros,958,deathknight,frost,18,10,8
Residenta,dun-modr,958,deathknight,frost,30,10,20
Asphyxias,alleria,957,deathknight,frost,24,10,14
Kerastrell,doomhammer,957,deathknight,frost,24,10,14
Eívór,garrosh,957,deathknight,frost,24,10,14
Söttguetsi,blackrock,956,deathknight,frost,18,10,8
Gegham,ravencrest,954,deathknight,frost,24,10,14
Hatcherb,sylvanas,953,deathknight,frost,30,16,14
Urzza,ysondre,953,deathknight,frost,30,10,20
Shadowsëek,hyjal,952,deathknight,frost,24,10,14
Ларкусдк,howling-fjord,952,deathknight,frost,30,10,20
Sawishere,sanguino,948,deathknight,frost,72,30,42
Scorbion,kilrogg,947,deathknight,frost,33,16,17
Fullbusterr,hyjal,938,deathknight,frost,53,23,30
Кунимэнгус,soulflayer,938,deathknight,frost,66,27,39
Bäy,archimonde,938,deathknight,frost,72,24,48
Assølid,arathor,928,deathknight,frost,51,22,29
Dreodis,der-mithrilorden,915,deathknight,frost,119,45,74
Peachvajz,turalyon,913,deathknight,frost,177,90,87
Aegwynnêr,blackmoore,910,deathknight,frost,38,20,18
Dípps,outland,908,deathknight,frost,24,11,13
Morvain,silvermoon,903,deathknight,frost,172,75,97
Liija,blackrock,900,deathknight,frost,29,11,18
Garandyr,hyjal,890,deathknight,frost,49,16,33
Dànté,eitrigg,889,deathknight,frost,48,24,24
Карвалан,eversong,886,deathknight,frost,42,21,21
Emielf,silvermoon,876,deathknight,frost,26,10,16
Mahfel,twisting-nether,875,deathknight,frost,24,12,12
Darklich,blackmoore,872,deathknight,frost,95,47,48
Assasínator,tarren-mill,872,deathknight,frost,49,24,25
Хуаролуксс,gordunni,871,deathknight,frost,77,24,53
Mauryr,drakthul,869,deathknight,frost,100,40,60
Некросморк,soulflayer,864,deathknight,frost,18,9,9
ßambøøzle,draenor,864,deathknight,frost,18,9,9
Løz,kazzak,864,deathknight,frost,18,9,9
Ñogg,kazzak,864,deathknight,frost,24,9,15
Kane,destromath,863,deathknight,frost,18,9,9
Nathaniall,drakthul,863,deathknight,frost,18,9,9
Oscman,silvermoon,863,deathknight,frost,18,9,9
Sephirus,kazzak,863,deathknight,frost,24,9,15
Борелис,soulflayer,862,deathknight,frost,18,9,9
Gringly,tarren-mill,862,deathknight,frost,18,9,9
Nerinth,burning-legion,860,deathknight,frost,25,9,16
Dkinta,colinas-pardas,857,deathknight,frost,18,9,9
Soulwalker,sylvanas,854,deathknight,frost,19,9,10
Deadkilla,stormreaver,851,deathknight,frost,18,9,9
Pavkata,outland,851,deathknight,frost,24,9,15
Qooqooq,ravencrest,848,deathknight,frost,18,9,9
Bruttox,kazzak,847,deathknight,frost,24,9,15
Guillemet,turalyon,830,deathknight,frost,16,10,6
Fentanil,elune,814,deathknight,frost,23,9,14
Ilaenu,ravencrest,810,deathknight,frost,26,10,16
Elbaqwan,the-shatar,801,deathknight,frost,54,24,30
Aeneriah,tarren-mill,798,deathknight,frost,20,9,11
Fuzzyofc,draenor,796,deathknight,frost,17,9,8
Fareast,nerathor,783,deathknight,frost,114,52,62
Craftmaker,eonar,778,deathknight,frost,53,21,32
Tenzøjr,archimonde,768,deathknight,frost,12,8,4
Letumnex,tarren-mill,768,deathknight,frost,12,8,4
Wpízdu,aegwynn,768,deathknight,frost,12,8,4
Salaahadin,darkspear,768,deathknight,frost,18,8,10
Äbäddon,twisting-nether,767,deathknight,frost,12,8,4
Ualar,silvermoon,767,deathknight,frost,18,8,10
Miruvar,tarren-mill,767,deathknight,frost,18,8,10
Sødax,sanguino,767,deathknight,frost,24,8,16
Amerant,kazzak,767,deathknight,frost,24,8,16
Jollíe,tarren-mill,767,deathknight,frost,24,8,16
Stetch,darkspear,767,deathknight,frost,30,8,22
Desulól,tarren-mill,766,deathknight,frost,15,9,6
Æew,kazzak,766,deathknight,frost,18,8,10
Flaii,hyjal,766,deathknight,frost,18,8,10
Zombíe,laughing-skull,765,deathknight,frost,12,8,4
Ballie,tarren-mill,765,deathknight,frost,24,8,16
Дрогдош,howling-fjord,765,deathknight,frost,24,8,16
Арнорос,lich-king,764,deathknight,frost,12,8,4
Goretex,pozzo-delleternità,763,deathknight,frost,18,8,10
Dkmonster,blackhand,763,deathknight,frost,24,8,16
Blurek,lordaeron,762,deathknight,frost,18,8,10
Xtream,blackmoore,762,deathknight,frost,18,8,10
Горгамель,howling-fjord,759,deathknight,frost,24,8,16
Bigspider,aggramar,759,deathknight,frost,36,8,28
Lichfils,chogall,745,deathknight,frost,27,8,19
Afadk,kazzak,744,deathknight,frost,150,61,89
Lenexia,ravencrest,743,deathknight,frost,18,8,10
Брейвз,gordunni,731,deathknight,frost,17,8,9
Gadres,aegwynn,687,deathknight,frost,25,8,17
Oweiowei,blackrock,672,deathknight,frost,12,7,5
Likewise,twisting-nether,672,deathknight,frost,12,7,5
Дедвбане,gordunni,672,deathknight,frost,14,7,7
Fault,burning-legion,672,deathknight,frost,18,7,11
Darkarthás,aegwynn,672,deathknight,frost,18,7,11
Doping,eredar,672,deathknight,frost,18,7,11
Haximusprime,kazzak,671,deathknight,frost,12,7,5
Iceludwig,nemesis,671,deathknight,frost,12,7,5
Ischozâr,blackmoore,671,deathknight,frost,18,7,11
Halohuntress,outland,671,deathknight,frost,18,7,11
Varrazdk,blackrock,671,deathknight,frost,24,7,17
Holîx,kazzak,671,deathknight,frost,30,7,23
Lycowrath,doomhammer,670,deathknight,frost,12,7,5
Karthor,teldrassil,670,deathknight,frost,12,7,5
Kazanski,silvermoon,670,deathknight,frost,12,7,5
Uthn,outland,670,deathknight,frost,24,7,17
Blackjaxn,thrall,668,deathknight,frost,18,7,11
Merà,antonidas,668,deathknight,frost,24,7,17
Яшамару,borean-tundra,667,deathknight,frost,12,7,5
Menacê,ravencrest,662,deathknight,frost,18,7,11
Aczheron,argent-dawn,660,deathknight,frost,24,7,17
Antîlâ,antonidas,658,deathknight,frost,12,7,5
Савамура,gordunni,655,deathknight,frost,17,7,10
Dekagramcz,drakthul,653,deathknight,frost,27,7,20
Kleophatra,drakthul,637,deathknight,frost,11,7,4
Arthursq,stormscale,630,deathknight,frost,30,8,22
Xeevdk,kazzak,623,deathknight,frost,21,7,14
Кромгонище,soulflayer,618,deathknight,frost,17,9,8
Ставраас,gordunni,605,deathknight,frost,20,7,13
Innerfrigus,tarren-mill,576,deathknight,frost,12,6,6
Garùn,sylvanas,576,deathknight,frost,12,6,6
Flúrry,ravencrest,576,deathknight,frost,12,6,6
Orangatang,dalaran,576,deathknight,frost,12,6,6
Critycal,draenor,576,deathknight,frost,12,6,6
Планус,booty-bay,576,deathknight,frost,12,6,6
Azslan,skullcrusher,576,deathknight,frost,12,6,6
Volestral,emeriss,576,deathknight,frost,12,6,6
Xeliora,ragnaros,576,deathknight,frost,15,7,8
Deathmike,steamwheedle-cartel,576,deathknight,frost,18,6,12
Parayysite,eredar,576,deathknight,frost,18,6,12
Bíllÿ,kazzak,576,deathknight,frost,18,6,12
Leomordf,doomhammer,576,deathknight,frost,18,6,12
Rompå,ravencrest,576,deathknight,frost,18,6,12
Westdx,hyjal,576,deathknight,frost,18,6,12
Oj,darkspear,576,deathknight,frost,18,6,12
Chaosbane,terokkar,575,deathknight,frost,12,6,6
Bloodbane,burning-blade,575,deathknight,frost,12,6,6
Dunkàn,silvermoon,575,deathknight,frost,12,6,6
Coldstrike,sunstrider,575,deathknight,frost,12,6,6
Fatbutdead,malganis,575,deathknight,frost,12,6,6
Gärrøsh,cthun,575,deathknight,frost,12,6,6
Moko,defias-brotherhood,575,deathknight,frost,12,6,6
Marcellinus,hellfire,575,deathknight,frost,12,6,6
Gotendk,draenor,575,deathknight,frost,12,6,6
Xenake,kazzak,575,deathknight,frost,18,6,12
Tugarinzmey,tarren-mill,575,deathknight,frost,18,6,12
Killerazog,rexxar,575,deathknight,frost,18,6,12
Ahnuk,aggra-português,574,deathknight,frost,12,6,6
Grithala,draenor,574,deathknight,frost,12,6,6
Роземайер,ashenvale,574,deathknight,frost,12,6,6
Angrist,terokkar,573,deathknight,frost,12,6,6
Фламмивир,gordunni,572,deathknight,frost,12,6,6
Izanagii,exodar,572,deathknight,frost,12,6,6
Сааттана,soulflayer,570,deathknight,frost,12,6,6
Pandòrà,dun-modr,559,deathknight,frost,11,6,5
Pestilerous,draenor,559,deathknight,frost,23,6,17
Tyranuse,kazzak,527,deathknight,frost,17,6,11
Deckbulle,blackhand,480,deathknight,frost,6,5,1
Semeris,twisting-nether,480,deathknight,frost,6,5,1
Grimmoth,argent-dawn,480,deathknight,frost,6,5,1
Thebangman,ravencrest,480,deathknight,frost,9,6,3
Keridíin,twisting-nether,480,deathknight,frost,12,5,7
Брюшина,gordunni,480,deathknight,frost,12,5,7
Руин,blackscar,480,deathknight,frost,12,5,7
Khnïshou,silvermoon,480,deathknight,frost,12,5,7
Smardacus,silvermoon,480,deathknight,frost,12,5,7
Аирфрост,howling-fjord,480,deathknight,frost,12,5,7
Cptneverdie,stormscale,480,deathknight,frost,12,5,7
Necrozy,aggra-português,480,deathknight,frost,12,5,7
Ûñhølýðéåthj,tarren-mill,480,deathknight,frost,12,5,7
Микелон,gordunni,480,deathknight,frost,12,5,7
Toshiroo,draenor,480,deathknight,frost,12,5,7
Nommad,archimonde,480,deathknight,frost,12,5,7
Runepride,argent-dawn,480,deathknight,frost,12,5,7
Dukoo,emerald-dream,480,deathknight,frost,12,5,7
Goochtickler,kazzak,480,deathknight,frost,12,5,7
Dödeek,twilights-hammer,480,deathknight,frost,12,5,7
Smellysock,tarren-mill,480,deathknight,frost,12,5,7
Hemopathy,tarren-mill,480,deathknight,frost,12,5,7
Дэвайна,gordunni,480,deathknight,frost,12,5,7
Xoqu,tarren-mill,480,deathknight,frost,12,5,7
Alinee,shadowsong,480,deathknight,frost,12,5,7
Stteff,sylvanas,480,deathknight,frost,15,6,9
Freeks,die-aldor,480,deathknight,frost,18,5,13
Nightglade,kilrogg,480,deathknight,frost,18,5,13
Xiddy,quelthalas,479,deathknight,frost,6,5,1
Берсан,soulflayer,479,deathknight,frost,6,5,1
Jowân,blackmoore,479,deathknight,frost,12,5,7
Ostridz,grim-batol,479,deathknight,frost,12,5,7
Сивкабурка,fordragon,479,deathknight,frost,12,5,7
Чёбышек,gordunni,479,deathknight,frost,12,5,7
Ricardiob,argent-dawn,479,deathknight,frost,12,5,7
Talge,defias-brotherhood,479,deathknight,frost,12,5,7
Смердонос,grom,479,deathknight,frost,12,5,7
Hellcrosser,blackrock,479,deathknight,frost,12,5,7
Breakstuff,twisting-nether,479,deathknight,frost,18,5,13
Roids,twisting-nether,479,deathknight,frost,18,5,13
Deadpòól,twisting-nether,479,deathknight,frost,18,5,13
Семиран,gordunni,479,deathknight,frost,18,5,13
Appdeath,azjolnerub,478,deathknight,frost,12,5,7
Scárebear,outland,478,deathknight,frost,18,5,13
Copium,hyjal,477,deathknight,frost,12,5,7
Fishtruction,tarren-mill,476,deathknight,frost,12,5,7
Eisentorte,nerathor,476,deathknight,frost,26,5,21
Kejpo,drakthul,473,deathknight,frost,12,5,7
Докторктан,eversong,468,deathknight,frost,18,5,13
Husarz,kazzak,447,deathknight,frost,11,5,6
Альянсобой,deathguard,447,deathknight,frost,11,5,6
Malahide,khadgar,447,deathknight,frost,17,5,12
Niunialesbo,draenor,416,deathknight,frost,10,5,5
Reann,argent-dawn,384,deathknight,frost,6,4,2
Squicki,hyjal,384,deathknight,frost,6,4,2
Lucyloverx,lightbringer,384,deathknight,frost,6,4,2
Воргтень,borean-tundra,384,deathknight,frost,6,4,2
Enzy,drakthul,384,deathknight,frost,6,4,2
Lemmegetuuh,chogall,384,deathknight,frost,6,4,2
Unholyysteel,silvermoon,384,deathknight,frost,6,4,2
Namzera,draenor,384,deathknight,frost,6,4,2
Близзбай,soulflayer,384,deathknight,frost,6,4,2
Kamisaber,eredar,384,deathknight,frost,6,4,2
Rexin,outland,384,deathknight,frost,6,4,2
Blinksg,frostmane,384,deathknight,frost,6,4,2
Oldiseas,grim-batol,384,deathknight,frost,6,4,2
Gozuryu,kazzak,384,deathknight,frost,6,4,2
Servein,stormscale,384,deathknight,frost,6,4,2
Негинд,fordragon,384,deathknight,frost,15,5,10
Rakeschnake,teldrassil,384,deathknight,frost,12,4,8
Hydross,archimonde,384,deathknight,frost,12,4,8
Doodcraft,tarren-mill,384,deathknight,frost,12,4,8
Джайвана,soulflayer,384,deathknight,frost,12,4,8
Pawnzqtie,stormscale,384,deathknight,frost,12,4,8
Maxmo,twilights-hammer,384,deathknight,frost,12,4,8
Apraxia,ravencrest,384,deathknight,frost,12,4,8
Primesnow,twisting-nether,384,deathknight,frost,12,4,8
Глэмнутый,howling-fjord,384,deathknight,frost,12,4,8
Zeldahell,dalaran,384,deathknight,frost,12,4,8
Спиддоз,fordragon,384,deathknight,frost,12,4,8
Крозох,howling-fjord,384,deathknight,frost,12,4,8
Mohna,blackrock,384,deathknight,frost,12,4,8
Pappadeath,doomhammer,384,deathknight,frost,13,4,9
Кокосоус,gordunni,384,deathknight,frost,17,4,13
Hordak,stormscale,384,deathknight,frost,18,4,14
Beherith,sunstrider,383,deathknight,frost,6,4,2
Tÿnak,der-mithrilorden,383,deathknight,frost,9,4,5
Breeze,xavius,383,deathknight,frost,12,4,8
Гадиния,soulflayer,383,deathknight,frost,12,4,8
Dkdiz,kazzak,383,deathknight,frost,12,4,8
Kivo,marécage-de-zangar,383,deathknight,frost,12,4,8
Eckodk,aggra-português,383,deathknight,frost,12,4,8
Бранс,gordunni,383,deathknight,frost,12,4,8
Reyu,ambossar,383,deathknight,frost,16,4,12
Rades,sanguino,383,deathknight,frost,18,4,14
Axilleas,magtheridon,383,deathknight,frost,18,4,14
Belâam,archimonde,383,deathknight,frost,24,4,20
Группер,gordunni,382,deathknight,frost,6,4,2
Wtftauren,drakthul,382,deathknight,frost,6,4,2
Дневнои,howling-fjord,382,deathknight,frost,12,4,8
Vicoperian,stormscale,382,deathknight,frost,12,4,8
Poaka,outland,380,deathknight,frost,12,4,8
Itzdarklord,blackhand,379,deathknight,frost,12,4,8
Iikarus,eredar,376,deathknight,frost,18,4,14
Saurøn,chogall,349,deathknight,frost,11,4,7
Душанерзула,howling-fjord,330,deathknight,frost,18,6,12
Macskye,malfurion,320,deathknight,frost,10,4,6
Vín,silvermoon,319,deathknight,frost,10,4,6
Isone,silvermoon,288,deathknight,frost,6,3,3
Трибунальщик,gordunni,288,deathknight,frost,6,3,3
Charlytango,archimonde,288,deathknight,frost,6,3,3
Mëzmêrïze,archimonde,288,deathknight,frost,6,3,3
Субботин,soulflayer,288,deathknight,frost,6,3,3
Винерас,soulflayer,288,deathknight,frost,6,3,3
Hailay,ysondre,288,deathknight,frost,6,3,3
Neptunium,archimonde,288,deathknight,frost,6,3,3
Axalon,nordrassil,288,deathknight,frost,6,3,3
Jjayker,kazzak,288,deathknight,frost,6,3,3
Thundawrath,silvermoon,288,deathknight,frost,6,3,3
Vexxed,magtheridon,288,deathknight,frost,6,3,3
Loorda,kazzak,288,deathknight,frost,6,3,3
Джеттар,howling-fjord,288,deathknight,frost,6,3,3
Cyphîllyth,auchindoun,288,deathknight,frost,6,3,3
Anaralien,ravencrest,288,deathknight,frost,6,3,3
Гурий,ashenvale,288,deathknight,frost,6,3,3
Skulm,twisting-nether,288,deathknight,frost,6,3,3
Vaanor,draenor,288,deathknight,frost,6,3,3
Dêeath,madmortem,288,deathknight,frost,6,3,3
Leijzen,azjolnerub,288,deathknight,frost,6,3,3
Modelo,twisting-nether,288,deathknight,frost,6,3,3
Xanthic,ravencrest,288,deathknight,frost,6,3,3
Lair,shendralar,288,deathknight,frost,6,3,3
Zathy,twisting-nether,288,deathknight,frost,6,3,3
Vainajala,die-aldor,288,deathknight,frost,6,3,3
Lukus,sanguino,288,deathknight,frost,6,3,3
Ogomegee,ravencrest,288,deathknight,frost,6,3,3
Kèén,kazzak,288,deathknight,frost,6,3,3
Шэйп,fordragon,288,deathknight,frost,6,3,3
Дуонза,blackscar,288,deathknight,frost,6,3,3
Bóby,ravencrest,288,deathknight,frost,6,3,3
Castlevanía,ravencrest,288,deathknight,frost,6,3,3
Ideath,executus,288,deathknight,frost,6,3,3
Gaurk,aggra-português,288,deathknight,frost,6,3,3
Tÿttyka,hyjal,288,deathknight,frost,6,3,3
Hellcrusher,kazzak,288,deathknight,frost,6,3,3
Nÿr,dalaran,288,deathknight,frost,6,3,3
Petardodupy,burning-legion,288,deathknight,frost,6,3,3
Sandør,conseil-des-ombres,288,deathknight,frost,6,3,3
Whippy,ravencrest,288,deathknight,frost,6,3,3
Huruguru,ravencrest,288,deathknight,frost,6,3,3
Ghu,stormscale,288,deathknight,frost,6,3,3
Somaliandoge,outland,288,deathknight,frost,6,3,3
Persefal,nemesis,288,deathknight,frost,6,3,3
Tómér,outland,288,deathknight,frost,6,3,3
Elliipirelli,doomhammer,288,deathknight,frost,6,3,3
Mirídiuss,silvermoon,288,deathknight,frost,6,3,3
Dudik,sylvanas,288,deathknight,frost,6,3,3
Mauor,argent-dawn,288,deathknight,frost,6,3,3
Madsgrip,tarren-mill,288,deathknight,frost,6,3,3
Deathlïght,nemesis,288,deathknight,frost,11,5,6
Merdenhall,argent-dawn,288,deathknight,frost,7,3,4
Nexxel,blackhand,288,deathknight,frost,11,3,8
Obstwald,blackrock,288,deathknight,frost,12,3,9
Ximopo,sanguino,288,deathknight,frost,12,3,9
Edochian,sanguino,288,deathknight,frost,12,3,9
Moohammood,argent-dawn,288,deathknight,frost,12,3,9
Thilior,silvermoon,288,deathknight,frost,12,3,9
Никсиомий,gordunni,288,deathknight,frost,12,3,9
Discochoppa,blackmoore,288,deathknight,frost,12,3,9
Prekliatylad,burning-blade,288,deathknight,frost,12,3,9
Миреанда,eversong,288,deathknight,frost,12,3,9
Thedk,voljin,288,deathknight,frost,12,3,9
Регроуз,ashenvale,288,deathknight,frost,12,3,9
Ezlar,silvermoon,288,deathknight,frost,12,3,9
Powerlifting,los-errantes,288,deathknight,frost,12,3,9
Unholz,kazzak,288,deathknight,frost,12,3,9
Yäägöö,tarren-mill,288,deathknight,frost,12,3,9
Chifuyu,azjolnerub,288,deathknight,frost,12,3,9
Тенелла,gordunni,288,deathknight,frost,12,3,9
Râke,teldrassil,288,deathknight,frost,12,3,9
Scourgebane,kazzak,288,deathknight,frost,12,3,9
Gorruk,malorne,288,deathknight,frost,12,3,9
Milchimhaus,dun-morogh,288,deathknight,frost,12,3,9
Корольбич,soulflayer,288,deathknight,frost,13,3,10
Brontolein,ungoro,288,deathknight,frost,14,3,11
Balekouille,eldrethalas,287,deathknight,frost,6,3,3
Brantiss,defias-brotherhood,287,deathknight,frost,6,3,3
Ilumëo,quelthalas,287,deathknight,frost,6,3,3
Whitedead,destromath,286,deathknight,frost,6,3,3
Housemeyster,antonidas,286,deathknight,frost,12,3,9
Tiunping,silvermoon,286,deathknight,frost,12,3,9
Deadorcy,kazzak,285,deathknight,frost,9,4,5
Venthyrgwa,kazzak,284,deathknight,frost,7,5,2
Rubyblood,aggra-português,271,deathknight,frost,11,3,8
Bwonsámdí,twisting-nether,254,deathknight,frost,6,5,1
Blueironjr,kazzak,239,deathknight,frost,5,3,2
ßæst,archimonde,208,deathknight,frost,7,3,4
Dimania,the-maelstrom,192,deathknight,frost,4,3,1
Deadchad,draenor,192,deathknight,frost,9,3,6
Металистикс,howling-fjord,192,deathknight,frost,6,2,4
Doubledead,the-maelstrom,192,deathknight,frost,6,2,4
Toffy,anetheron,192,deathknight,frost,6,2,4
Brewknight,silvermoon,192,deathknight,frost,6,2,4
Dysnomiya,antonidas,192,deathknight,frost,6,2,4
Expiredsauce,silvermoon,192,deathknight,frost,6,2,4
Tobtób,antonidas,192,deathknight,frost,6,2,4
Seasonfive,arathor,192,deathknight,frost,6,2,4
Constantyn,blackrock,192,deathknight,frost,6,2,4
Dreadmind,blackrock,192,deathknight,frost,6,2,4
Sugarcakedk,blackrock,192,deathknight,frost,6,2,4
Ghaloob,draenor,192,deathknight,frost,6,2,4
Tyró,ravencrest,192,deathknight,frost,6,2,4
Deathuss,silvermoon,192,deathknight,frost,6,2,4
Chillstreak,twisting-nether,192,deathknight,frost,6,2,4
Эвессом,goldrinn,192,deathknight,frost,6,2,4
Капустас,gordunni,192,deathknight,frost,6,2,4
Karaliuss,draenor,192,deathknight,frost,6,2,4
Doozz,draenor,192,deathknight,frost,6,2,4
Zackryder,ravenholdt,192,deathknight,frost,6,2,4
Likell,argent-dawn,192,deathknight,frost,6,2,4
Rømnie,la-croisade-écarlate,192,deathknight,frost,6,2,4
Julezi,blackmoore,192,deathknight,frost,6,2,4
Deathdayben,kazzak,192,deathknight,frost,6,2,4
Arjaden,doomhammer,192,deathknight,frost,6,2,4
Сванский,soulflayer,192,deathknight,frost,6,2,4
Darksoulk,frostmane,192,deathknight,frost,6,2,4
Vadamee,ravencrest,192,deathknight,frost,6,2,4
Ratge,hyjal,192,deathknight,frost,6,2,4
Notstacy,dragonblight,192,deathknight,frost,6,2,4
Dklol,dun-morogh,192,deathknight,frost,6,2,4
Bytedk,aggra-português,192,deathknight,frost,6,2,4
Lemonhazebg,stormscale,192,deathknight,frost,6,2,4
Royalcrown,stormscale,192,deathknight,frost,6,2,4
Ilovegouàng,khaz-modan,192,deathknight,frost,6,2,4
Larum,burning-legion,192,deathknight,frost,6,2,4
Necrossis,stormscale,192,deathknight,frost,6,2,4
Mennal,the-maelstrom,192,deathknight,frost,6,2,4
Pandahapcii,ragnaros,192,deathknight,frost,6,2,4
Arthrosis,tarren-mill,192,deathknight,frost,6,2,4
Ashguol,twisting-nether,192,deathknight,frost,6,2,4
Highblood,tarren-mill,192,deathknight,frost,6,2,4
Маккриманс,gordunni,192,deathknight,frost,6,2,4
Ðeathceptiøn,dun-modr,192,deathknight,frost,6,2,4
Necrotopx,aegwynn,192,deathknight,frost,6,2,4
Frostplague,aegwynn,192,deathknight,frost,6,2,4
Wantobewarri,blackhand,192,deathknight,frost,6,2,4
Archdemonio,wildhammer,192,deathknight,frost,6,2,4
Babsyknight,wildhammer,192,deathknight,frost,6,2,4
Ikarack,twisting-nether,192,deathknight,frost,6,2,4
Vaffe,tarren-mill,192,deathknight,frost,6,2,4
Olexeshh,blackhand,192,deathknight,frost,6,2,4
Nergål,sanguino,192,deathknight,frost,6,2,4
Nathoel,zuljin,192,deathknight,frost,6,2,4
Windieselx,ragnaros,192,deathknight,frost,6,2,4
Силдэус,galakrond,192,deathknight,frost,6,2,4
Abomination,emeriss,192,deathknight,frost,6,2,4
Lillekas,outland,192,deathknight,frost,12,2,10
Narrua,die-aldor,192,deathknight,frost,12,2,10
Бахлыщ,soulflayer,192,deathknight,frost,12,2,10
Deadlygnome,silvermoon,192,deathknight,frost,12,2,10
Adreak,defias-brotherhood,192,deathknight,frost,12,2,10
Dklékata,archimonde,192,deathknight,frost,12,2,10
Erilisa,malorne,192,deathknight,frost,12,2,10
Menethill,darkspear,192,deathknight,frost,12,2,10
Kenseisan,kazzak,192,deathknight,frost,12,2,10
Tüsa,exodar,192,deathknight,frost,18,2,16
Pachecodk,aggra-português,191,deathknight,frost,6,2,4
Moograine,anachronos,191,deathknight,frost,6,2,4
Ренкус,grom,191,deathknight,frost,6,2,4
Lithirion,ysondre,191,deathknight,frost,12,2,10
Bloodywife,die-ewige-wacht,159,deathknight,frost,5,2,3
Endlesspain,burning-legion,138,deathknight,frost,8,3,5
Xøry,blackrock,138,deathknight,frost,10,3,7
Maradk,drakthul,127,deathknight,frost,8,2,6
Spunka,azjolnerub,96,deathknight,frost,9,2,7
Mizrael,burning-blade,96,deathknight,frost,6,1,5
Thínkk,ysondre,96,deathknight,frost,6,1,5
Джинтос,howling-fjord,96,deathknight,frost,6,1,5
Lilliith,sanguino,96,deathknight,frost,6,1,5
Mârlák,blackhand,96,deathknight,frost,6,1,5
Дкшрёдингера,gordunni,96,deathknight,frost,6,1,5
Zpartan,ragnaros,96,deathknight,frost,6,1,5
Zagoôo,outland,96,deathknight,frost,6,1,5
Gigadk,ragnaros,96,deathknight,frost,6,1,5
Umadßroh,sanguino,96,deathknight,frost,6,1,5
Conqueròr,tarren-mill,96,deathknight,frost,6,1,5
Greatgrips,argent-dawn,96,deathknight,frost,6,1,5
Lusankyaa,argent-dawn,96,deathknight,frost,6,1,5
ßlink,dun-modr,96,deathknight,frost,6,1,5
Thirtyfour,aegwynn,96,deathknight,frost,6,1,5
Thyrandre,khaz-modan,96,deathknight,frost,6,1,5
Escaflowno,outland,96,deathknight,frost,6,1,5
Jenkk,drakthul,96,deathknight,frost,6,1,5
Идзанаги,blackscar,96,deathknight,frost,6,1,5
Буризан,blackscar,96,deathknight,frost,6,1,5
Feddk,stormscale,96,deathknight,frost,6,1,5
Lîçhkîng,kazzak,96,deathknight,frost,6,1,5
Yoroh,magtheridon,96,deathknight,frost,6,1,5
Bwonsamdiez,kazzak,96,deathknight,frost,6,1,5
Gotbaked,outland,96,deathknight,frost,6,1,5
Filmsyz,ravencrest,96,deathknight,frost,6,1,5
Veçh,turalyon,96,deathknight,frost,6,1,5
Kptayn,culte-de-la-rive-noire,96,deathknight,frost,6,1,5
Rognvald,les-sentinelles,96,deathknight,frost,6,1,5
Pokkel,silvermoon,96,deathknight,frost,6,1,5
Iseetouch,draenor,96,deathknight,frost,6,1,5
Todevcha,draenor,96,deathknight,frost,6,1,5
Thryndiel,ravencrest,96,deathknight,frost,6,1,5
Rodimus,arathor,96,deathknight,frost,6,1,5
Skalbjörn,arathor,96,deathknight,frost,6,1,5
Veleran,blackrock,96,deathknight,frost,6,1,5
Mptak,kazzak,96,deathknight,frost,6,1,5
Sarunâs,antonidas,96,deathknight,frost,6,1,5
Triqué,antonidas,96,deathknight,frost,6,1,5
Jacksc,aggramar,96,deathknight,frost,6,1,5
Brurf,ysondre,96,deathknight,frost,6,1,5
Syncros,blackrock,96,deathknight,frost,6,1,5
Hurz,archimonde,96,deathknight,frost,6,1,5
Slimez,magtheridon,96,deathknight,frost,6,1,5
Rudysek,dunemaul,96,deathknight,frost,6,1,5
Pierun,dunemaul,96,deathknight,frost,6,1,5
Dïkcite,archimonde,96,deathknight,frost,6,1,5
Wântted,archimonde,96,deathknight,frost,6,1,5
Armanelo,stormscale,96,deathknight,frost,6,1,5
Urukaye,silvermoon,96,deathknight,frost,6,1,5
Sokkara,silvermoon,96,deathknight,frost,6,1,5
Ódar,silvermoon,96,deathknight,frost,6,1,5
Промештейн,gordunni,96,deathknight,frost,9,1,8
Shaturi,antonidas,96,deathknight,frost,12,1,11
Burebistà,eonar,96,deathknight,frost,12,1,11
Лятеха,gordunni,96,deathknight,frost,12,1,11
Müldgren,ysondre,96,deathknight,frost,12,1,11
Хенстор,gordunni,96,deathknight,frost,12,1,11
Nirna,argent-dawn,96,deathknight,frost,24,1,23
Arzuriel,arygos,95,deathknight,frost,6,1,5
Infamousmobb,archimonde,79,deathknight,frost,5,1,4
Zýnês,thrall,79,deathknight,frost,5,1,4
Tamatus,ulduar,79,deathknight,frost,11,1,10
Lathspelli,zenedar,64,deathknight,frost,4,1,3
Grubyr,burning-legion,31,deathknight,frost,2,1,1
Norgan,die-aldor,2339,demonhunter,havoc,153,85,68
Íllìðåñgøðx,twisting-nether,2329,demonhunter,havoc,340,175,165
Norgàn,die-aldor,2307,demonhunter,havoc,161,89,72
Mips,ghostlands,2306,demonhunter,havoc,144,78,66
Glìmpsêgøðx,twisting-nether,2304,demonhunter,havoc,333,179,154
Dripcatchér,ravencrest,2303,demonhunter,havoc,176,98,78
Siuli,minahonda,2277,demonhunter,havoc,221,115,106
Razzagall,elune,2258,demonhunter,havoc,83,45,38
Elswavé,kazzak,2231,demonhunter,havoc,168,95,73
Guësswho,twisting-nether,2201,demonhunter,havoc,117,60,57
Zslebaans,dun-modr,2173,demonhunter,havoc,266,134,132
Milanto,antonidas,2160,demonhunter,havoc,177,94,83
Ðesz,sanguino,2153,demonhunter,havoc,95,52,43
Itsdampbaby,kazzak,2151,demonhunter,havoc,121,63,58
Majînßûü,ravencrest,2147,demonhunter,havoc,77,42,35
Rùkîbazùkï,ravencrest,2146,demonhunter,havoc,83,51,32
Zuklio,ysondre,2133,demonhunter,havoc,206,103,103
Brolafsen,ravencrest,2131,demonhunter,havoc,126,66,60
Ewynadh,die-aldor,2127,demonhunter,havoc,241,124,117
Enysia,twisting-nether,2127,demonhunter,havoc,122,62,60
Bxdh,argent-dawn,2126,demonhunter,havoc,168,87,81
Lelaniae,blackhand,2126,demonhunter,havoc,107,55,52
Natosyywaor,dun-modr,2124,demonhunter,havoc,77,40,37
Hellwynne,archimonde,2117,demonhunter,havoc,134,78,56
Antrix,ravencrest,2116,demonhunter,havoc,77,38,39
Cuddlypeanut,argent-dawn,2115,demonhunter,havoc,291,147,144
Antrixa,ravencrest,2110,demonhunter,havoc,92,47,45
Истребитель,blackscar,2103,demonhunter,havoc,378,210,168
Лфгхиро,soulflayer,2101,demonhunter,havoc,65,37,28
Battlebruh,ghostlands,2076,demonhunter,havoc,134,66,68
Badtime,malganis,2074,demonhunter,havoc,236,124,112
Melan,sanguino,2074,demonhunter,havoc,168,82,86
Моигваза,soulflayer,2070,demonhunter,havoc,98,48,50
Qk,ghostlands,2069,demonhunter,havoc,138,69,69
Drmanaburn,ravencrest,2062,demonhunter,havoc,82,45,37
Ozu,blackrock,2061,demonhunter,havoc,149,79,70
Boostbydh,archimonde,2059,demonhunter,havoc,279,143,136
Konydh,outland,2045,demonhunter,havoc,434,225,209
Évø,silvermoon,2044,demonhunter,havoc,153,74,79
Apfelbaum,die-aldor,2038,demonhunter,havoc,84,58,26
Dantert,zuljin,2032,demonhunter,havoc,102,57,45
Mavorz,blackhand,2026,demonhunter,havoc,60,38,22
Demonalpha,stormscale,2018,demonhunter,havoc,61,34,27
Gíftig,ravencrest,2016,demonhunter,havoc,246,129,117
Miscóde,twisting-nether,2014,demonhunter,havoc,108,64,44
Nèvér,silvermoon,2014,demonhunter,havoc,143,74,69
Zhadrom,ragnaros,2014,demonhunter,havoc,96,48,48
Shattre,silvermoon,2013,demonhunter,havoc,251,131,120
Heatx,ysondre,2012,demonhunter,havoc,216,115,101
Nèvér,kazzak,2011,demonhunter,havoc,133,78,55
Мортрэд,gordunni,2011,demonhunter,havoc,167,91,76
Lòsêr,ravencrest,2009,demonhunter,havoc,114,58,56
Jinwoo,area-52,2008,demonhunter,havoc,101,48,53
Neunelfturbo,ravencrest,2007,demonhunter,havoc,77,48,29
Supay,rexxar,2004,demonhunter,havoc,82,47,35
Badtimes,malganis,1998,demonhunter,havoc,307,159,148
Лфгнехиро,soulflayer,1997,demonhunter,havoc,24,21,3
Sofun,stormscale,1996,demonhunter,havoc,595,300,295
Диджейвжух,gordunni,1996,demonhunter,havoc,143,72,71
Smydi,blackmoore,1991,demonhunter,havoc,112,82,30
Veon,ravencrest,1988,demonhunter,havoc,281,136,145
Avye,tichondrius,1984,demonhunter,havoc,108,54,54
Ezrnkone,stormscale,1983,demonhunter,havoc,83,51,32
Ráiku,ravencrest,1983,demonhunter,havoc,72,37,35
Yúki,blackrock,1983,demonhunter,havoc,102,51,51
Satånist,outland,1980,demonhunter,havoc,390,204,186
Майвэйх,soulflayer,1977,demonhunter,havoc,327,165,162
Bämbøué,hyjal,1970,demonhunter,havoc,113,56,57
Deehâ,eredar,1968,demonhunter,havoc,150,86,64
Çrymemøre,dun-modr,1967,demonhunter,havoc,185,100,85
Skywålker,stormscale,1966,demonhunter,havoc,111,59,52
Betterevoker,outland,1966,demonhunter,havoc,294,154,140
Battlebruuh,ghostlands,1964,demonhunter,havoc,72,31,41
Krm,dun-modr,1963,demonhunter,havoc,100,55,45
Wibez,twisting-nether,1962,demonhunter,havoc,190,103,87
Ohseri,defias-brotherhood,1962,demonhunter,havoc,245,120,125
Finwe,outland,1959,demonhunter,havoc,75,44,31
Ледимиледи,lich-king,1959,demonhunter,havoc,89,39,50
Майотх,gordunni,1958,demonhunter,havoc,349,178,171
Írony,draenor,1958,demonhunter,havoc,198,97,101
Neiìf,blackhand,1958,demonhunter,havoc,72,31,41
Aiean,ravencrest,1945,demonhunter,havoc,342,170,172
Depure,blackrock,1945,demonhunter,havoc,135,64,71
Ææçëñ,ravencrest,1942,demonhunter,havoc,118,62,56
Wàýztøpgx,ravencrest,1941,demonhunter,havoc,160,73,87
Scubaman,tarren-mill,1940,demonhunter,havoc,198,101,97
Yerla,burning-legion,1940,demonhunter,havoc,122,58,64
Chïbrøne,archimonde,1937,demonhunter,havoc,84,38,46
Empúsa,stormscale,1936,demonhunter,havoc,164,90,74
Anabbele,kazzak,1936,demonhunter,havoc,138,72,66
Gushìñgwøuñð,blackmoore,1935,demonhunter,havoc,89,46,43
Ricedh,blackhand,1934,demonhunter,havoc,90,45,45
Læsy,antonidas,1932,demonhunter,havoc,175,87,88
Schrewneil,twisting-nether,1931,demonhunter,havoc,137,64,73
Tórstenstøck,ravencrest,1928,demonhunter,havoc,71,48,23
Máédhros,ravencrest,1926,demonhunter,havoc,94,48,46
Cydh,auchindoun,1922,demonhunter,havoc,132,66,66
Рензокукеен,gordunni,1921,demonhunter,havoc,127,62,65
Carritoscrm,outland,1920,demonhunter,havoc,90,40,50
Gøat,nemesis,1919,demonhunter,havoc,261,142,119
Pipeandy,kazzak,1919,demonhunter,havoc,125,66,59
Нэйтиси,soulflayer,1918,demonhunter,havoc,86,46,40
Ïfï,archimonde,1918,demonhunter,havoc,177,94,83
Burchulica,sylvanas,1917,demonhunter,havoc,66,39,27
Leýara,blackmoore,1915,demonhunter,havoc,117,68,49
Shyynedh,grim-batol,1914,demonhunter,havoc,144,79,65
Véin,stormscale,1912,demonhunter,havoc,95,40,55
Wibergdh,kazzak,1911,demonhunter,havoc,78,42,36
Brx,balnazzar,1910,demonhunter,havoc,54,30,24
Pulsefuzzy,burning-legion,1908,demonhunter,havoc,71,39,32
Åáäàáåàáäàáå,dun-modr,1906,demonhunter,havoc,122,61,61
Ûro,dun-modr,1906,demonhunter,havoc,132,65,67
Revérse,stormscale,1903,demonhunter,havoc,48,24,24
Icekissl,hyjal,1901,demonhunter,havoc,58,29,29
Maytherel,blackhand,1901,demonhunter,havoc,341,169,172
Ourius,blackmoore,1900,demonhunter,havoc,66,36,30
Zkrdh,kazzak,1900,demonhunter,havoc,88,43,45
Солфдх,fordragon,1900,demonhunter,havoc,120,57,63
Cyfel,auchindoun,1899,demonhunter,havoc,71,36,35
Çøððøøððøøðð,blackmoore,1898,demonhunter,havoc,444,225,219
Perna,ghostlands,1898,demonhunter,havoc,116,58,58
Юзлескласс,gordunni,1896,demonhunter,havoc,60,32,28
Delanoss,blackmoore,1896,demonhunter,havoc,181,95,86
Paschli,tarren-mill,1896,demonhunter,havoc,300,151,149
Unseenshadow,ragnaros,1894,demonhunter,havoc,117,55,62
Mojothejojo,ravencrest,1891,demonhunter,havoc,130,72,58
Yamehd,stormreaver,1890,demonhunter,havoc,90,49,41
Felthunder,twisting-nether,1888,demonhunter,havoc,66,36,30
Perojeina,draenor,1885,demonhunter,havoc,41,22,19
Dizbi,argent-dawn,1884,demonhunter,havoc,153,90,63
Illíllìllî,twisting-nether,1883,demonhunter,havoc,72,35,37
Periphere,eredar,1882,demonhunter,havoc,120,60,60
Chxpo,twisting-nether,1881,demonhunter,havoc,113,61,52
Carboen,tarren-mill,1881,demonhunter,havoc,150,80,70
Damatche,outland,1880,demonhunter,havoc,178,88,90
Monkeyddog,blackrock,1879,demonhunter,havoc,63,28,35
Brunhity,twisting-nether,1878,demonhunter,havoc,59,28,31
Boxssabanned,archimonde,1875,demonhunter,havoc,143,70,73
Jumpmeister,ragnaros,1873,demonhunter,havoc,48,30,18
Cerad,ragnaros,1872,demonhunter,havoc,30,24,6
Bogren,sylvanas,1872,demonhunter,havoc,247,122,125
Màuul,ravencrest,1870,demonhunter,havoc,223,111,112
Geauxinue,archimonde,1870,demonhunter,havoc,106,52,54
Âkazza,archimonde,1869,demonhunter,havoc,44,25,19
Chàk,marécage-de-zangar,1869,demonhunter,havoc,179,86,93
Tozpak,sylvanas,1866,demonhunter,havoc,82,38,44
Pogdh,silvermoon,1865,demonhunter,havoc,99,56,43
Minifranger,archimonde,1865,demonhunter,havoc,357,183,174
Androwdings,dalaran,1863,demonhunter,havoc,63,35,28
Mazöku,ravencrest,1863,demonhunter,havoc,182,98,84
Donkeydh,tarren-mill,1862,demonhunter,havoc,66,41,25
Mittÿ,tarren-mill,1862,demonhunter,havoc,137,66,71
Jincksdh,kazzak,1861,demonhunter,havoc,61,29,32
Dpsspec,draenor,1861,demonhunter,havoc,126,59,67
Sturmimon,arthas,1861,demonhunter,havoc,102,46,56
Блэйденрифтс,soulflayer,1859,demonhunter,havoc,88,48,40
Yukiz,ravencrest,1858,demonhunter,havoc,203,100,103
Jisoô,tarren-mill,1858,demonhunter,havoc,46,22,24
Firstwolf,twisting-nether,1856,demonhunter,havoc,89,42,47
Asukakazama,twisting-nether,1856,demonhunter,havoc,75,33,42
Billyhassan,kazzak,1855,demonhunter,havoc,102,62,40
Bloodwatcher,twisting-nether,1855,demonhunter,havoc,59,29,30
Jeannedäsh,archimonde,1854,demonhunter,havoc,115,58,57
Mädchen,blackhand,1854,demonhunter,havoc,48,23,25
Onlyfangodx,antonidas,1853,demonhunter,havoc,42,22,20
Yarakobama,blackrock,1852,demonhunter,havoc,138,71,67
Iryut,onyxia,1850,demonhunter,havoc,114,57,57
Mønkeyx,kazzak,1849,demonhunter,havoc,66,39,27
Джастх,howling-fjord,1847,demonhunter,havoc,52,28,24
Biànca,outland,1847,demonhunter,havoc,86,44,42
Нереалочка,blackscar,1847,demonhunter,havoc,48,24,24
Viced,kazzak,1847,demonhunter,havoc,90,42,48
Kebabidin,kazzak,1847,demonhunter,havoc,79,36,43
Dëëpdh,archimonde,1845,demonhunter,havoc,77,36,41
Бабкамопед,howling-fjord,1844,demonhunter,havoc,293,151,142
Grimjow,arthas,1843,demonhunter,havoc,73,34,39
Snubbeldemon,outland,1841,demonhunter,havoc,59,29,30
Evilidan,hyjal,1840,demonhunter,havoc,60,27,33
Realtrance,sanguino,1839,demonhunter,havoc,50,30,20
Rxor,eredar,1838,demonhunter,havoc,120,66,54
Fotmdehatwo,blackrock,1837,demonhunter,havoc,61,32,29
Ilovelilith,zuljin,1837,demonhunter,havoc,129,67,62
Whøo,stormscale,1835,demonhunter,havoc,26,24,2
Ðoksy,archimonde,1835,demonhunter,havoc,60,31,29
Lasaka,stormscale,1833,demonhunter,havoc,155,95,60
Haldin,kazzak,1833,demonhunter,havoc,128,70,58
Zeroques,frostmane,1831,demonhunter,havoc,66,33,33
Сасун,galakrond,1831,demonhunter,havoc,69,32,37
Ranked,drakthul,1830,demonhunter,havoc,203,98,105
Demoncyka,twisting-nether,1830,demonhunter,havoc,76,34,42
Charteryo,eredar,1829,demonhunter,havoc,60,35,25
Kardyö,archimonde,1829,demonhunter,havoc,120,57,63
Lassudan,stormreaver,1827,demonhunter,havoc,146,70,76
Sayph,hyjal,1826,demonhunter,havoc,54,30,24
Mordaer,twisting-nether,1826,demonhunter,havoc,204,103,101
Сибу,soulflayer,1825,demonhunter,havoc,48,21,27
Anerana,malganis,1824,demonhunter,havoc,172,82,90
Mürh,nordrassil,1824,demonhunter,havoc,54,25,29
Barneeéy,tarren-mill,1823,demonhunter,havoc,113,62,51
Qqski,kazzak,1822,demonhunter,havoc,54,31,23
Shtahuntna,tarren-mill,1822,demonhunter,havoc,521,280,241
Brainlessdmg,ragnaros,1821,demonhunter,havoc,48,28,20
Notlars,chamber-of-aspects,1821,demonhunter,havoc,77,42,35
Uldren,defias-brotherhood,1821,demonhunter,havoc,200,102,98
Dhhduhd,blackrock,1821,demonhunter,havoc,107,54,53
Эрнерион,soulflayer,1821,demonhunter,havoc,78,38,40
Azaeras,argent-dawn,1820,demonhunter,havoc,48,28,20
Barny,skullcrusher,1820,demonhunter,havoc,347,179,168
Клопобойка,gordunni,1820,demonhunter,havoc,121,62,59
Элизар,howling-fjord,1820,demonhunter,havoc,150,76,74
Onof,hyjal,1820,demonhunter,havoc,96,43,53
Breezzdh,twisting-nether,1819,demonhunter,havoc,99,53,46
Batik,blackmoore,1819,demonhunter,havoc,288,146,142
Luwayne,blackmoore,1818,demonhunter,havoc,47,21,26
Corvox,argent-dawn,1818,demonhunter,havoc,75,32,43
Dreamslash,tarren-mill,1817,demonhunter,havoc,52,29,23
Elipireli,doomhammer,1817,demonhunter,havoc,84,40,44
Nørðìç,nordrassil,1816,demonhunter,havoc,42,25,17
Broglaive,sylvanas,1816,demonhunter,havoc,120,66,54
Velysaría,guldan,1816,demonhunter,havoc,172,94,78
Dasein,tarren-mill,1816,demonhunter,havoc,108,54,54
Кайренсс,howling-fjord,1816,demonhunter,havoc,48,21,27
Sgit,doomhammer,1816,demonhunter,havoc,112,48,64
Dhgoddess,kazzak,1815,demonhunter,havoc,48,25,23
Eyecandy,scarshield-legion,1814,demonhunter,havoc,286,144,142
Гранкрю,blackscar,1813,demonhunter,havoc,96,54,42
Voicechat,tarren-mill,1812,demonhunter,havoc,42,26,16
Найтшифт,blackscar,1811,demonhunter,havoc,46,29,17
Vexanic,chamber-of-aspects,1811,demonhunter,havoc,93,49,44
Djratatouill,kazzak,1810,demonhunter,havoc,42,27,15
Kinstak,sanguino,1810,demonhunter,havoc,72,39,33
Khrtdh,silvermoon,1810,demonhunter,havoc,48,26,22
Хменчик,soulflayer,1809,demonhunter,havoc,97,47,50
Lemondehunta,twisting-nether,1808,demonhunter,havoc,60,33,27
Soulstacker,outland,1808,demonhunter,havoc,60,32,28
Mandariâ,blackmoore,1808,demonhunter,havoc,60,32,28
Sàskiàn,draenor,1808,demonhunter,havoc,102,50,52
Hopéless,aggra-português,1807,demonhunter,havoc,82,42,40
Xarôth,eredar,1807,demonhunter,havoc,78,37,41
Koiskdh,tarren-mill,1806,demonhunter,havoc,72,44,28
Ambudh,kazzak,1806,demonhunter,havoc,53,30,23
Felom,garona,1806,demonhunter,havoc,138,75,63
Дантеллиан,gordunni,1806,demonhunter,havoc,216,117,99
Кейтпрнстарс,howling-fjord,1806,demonhunter,havoc,206,111,95
Allosa,argent-dawn,1805,demonhunter,havoc,96,51,45
Broilerx,balnazzar,1805,demonhunter,havoc,110,56,54
Eréthrus,ravencrest,1805,demonhunter,havoc,67,32,35
Kïng,frostmane,1804,demonhunter,havoc,186,108,78
Zireáel,stormscale,1804,demonhunter,havoc,74,40,34
Nerronaxd,silvermoon,1804,demonhunter,havoc,171,91,80
Annaboliik,ravencrest,1804,demonhunter,havoc,60,28,32
Illidarisi,auchindoun,1803,demonhunter,havoc,102,58,44
Kividari,dun-modr,1803,demonhunter,havoc,101,50,51
Myuøu,hyjal,1803,demonhunter,havoc,53,25,28
Jawohunt,rexxar,1803,demonhunter,havoc,108,49,59
Mür,nordrassil,1803,demonhunter,havoc,89,40,49
Anubias,ravencrest,1802,demonhunter,havoc,132,65,67
Phesxdh,sylvanas,1801,demonhunter,havoc,122,77,45
Zakaji,blackmoore,1801,demonhunter,havoc,100,58,42
Jimfromsales,argent-dawn,1800,demonhunter,havoc,36,19,17
Kindablind,aggramar,1800,demonhunter,havoc,125,61,64
Jco,kazzak,1800,demonhunter,havoc,50,23,27
Maevê,frostmourne,1798,demonhunter,havoc,67,32,35
Simshady,stormscale,1797,demonhunter,havoc,157,88,69
Khétí,tarren-mill,1796,demonhunter,havoc,113,58,55
Fullsënd,ragnaros,1796,demonhunter,havoc,309,158,151
Oldforwow,outland,1796,demonhunter,havoc,228,116,112
Maurî,tarren-mill,1796,demonhunter,havoc,55,25,30
Smâshêd,stormscale,1794,demonhunter,havoc,203,113,90
Уполномочен,howling-fjord,1794,demonhunter,havoc,60,32,28
Daemonax,ragnaros,1794,demonhunter,havoc,116,58,58
Dadøw,dun-modr,1794,demonhunter,havoc,90,42,48
Dbolmami,twisting-nether,1793,demonhunter,havoc,43,29,14
Camtoe,ravencrest,1793,demonhunter,havoc,264,144,120
Eyasluna,twisting-nether,1793,demonhunter,havoc,118,55,63
Rvnx,archimonde,1792,demonhunter,havoc,388,204,184
Coolpizzaguy,twisting-nether,1792,demonhunter,havoc,78,36,42
Fiveyearques,sylvanas,1792,demonhunter,havoc,111,51,60
Fiduci,archimonde,1792,demonhunter,havoc,42,19,23
Alythes,stormscale,1791,demonhunter,havoc,391,205,186
Dânÿ,elune,1791,demonhunter,havoc,129,65,64
Ethína,kazzak,1791,demonhunter,havoc,78,38,40
Smoothbraiin,ravencrest,1790,demonhunter,havoc,149,80,69
Funkiller,stormscale,1790,demonhunter,havoc,82,43,39
Bojestvena,twisting-nether,1790,demonhunter,havoc,288,142,146
Riñ,twisting-nether,1790,demonhunter,havoc,193,94,99
Kostiq,kazzak,1787,demonhunter,havoc,59,30,29
Stràt,ysondre,1787,demonhunter,havoc,143,66,77
Brawngodx,draenor,1786,demonhunter,havoc,103,65,38
Slaanaesh,kazzak,1786,demonhunter,havoc,86,41,45
Trickstero,ragnaros,1784,demonhunter,havoc,176,91,85
Amatèrasú,kazzak,1784,demonhunter,havoc,58,29,29
Аркантт,soulflayer,1782,demonhunter,havoc,273,130,143
Nyalah,eredar,1781,demonhunter,havoc,60,32,28
Bigmóm,stormscale,1781,demonhunter,havoc,168,78,90
Folygale,outland,1781,demonhunter,havoc,54,25,29
Kâsúxôxô,ravencrest,1780,demonhunter,havoc,46,27,19
Malignantx,ragnaros,1780,demonhunter,havoc,200,100,100
Amnésysx,ysondre,1780,demonhunter,havoc,125,60,65
Trashcarlitô,eredar,1779,demonhunter,havoc,92,50,42
Dooj,sylvanas,1779,demonhunter,havoc,42,21,21
Гивюрхартми,gordunni,1778,demonhunter,havoc,125,59,66
Walkmyshoes,twisting-nether,1777,demonhunter,havoc,126,59,67
Врежимеэтти,soulflayer,1776,demonhunter,havoc,70,37,33
Merelini,twisting-nether,1775,demonhunter,havoc,46,25,21
Erzàuwu,silvermoon,1775,demonhunter,havoc,65,26,39
Cláw,ravencrest,1774,demonhunter,havoc,102,50,52
Radamantyz,drakthul,1774,demonhunter,havoc,42,20,22
Íamprepared,tarren-mill,1774,demonhunter,havoc,60,26,34
Yarrøck,silvermoon,1773,demonhunter,havoc,207,104,103
Ячмо,gordunni,1773,demonhunter,havoc,64,32,32
Demonzøku,ravencrest,1773,demonhunter,havoc,54,27,27
Weback,ravencrest,1773,demonhunter,havoc,90,42,48
Neverdance,ravencrest,1773,demonhunter,havoc,66,27,39
Сосочков,soulflayer,1772,demonhunter,havoc,353,180,173
Accurate,sanguino,1771,demonhunter,havoc,84,42,42
Shadyblady,nemesis,1770,demonhunter,havoc,293,148,145
Nstea,cthun,1769,demonhunter,havoc,60,26,34
Brawndow,draenor,1766,demonhunter,havoc,384,188,196
Barbarinjo,silvermoon,1765,demonhunter,havoc,64,35,29
Azzïnoth,sargeras,1765,demonhunter,havoc,108,59,49
Demonmatheo,stormscale,1764,demonhunter,havoc,62,34,28
Гвинович,blackscar,1764,demonhunter,havoc,142,71,71
Cuirnoir,ravencrest,1763,demonhunter,havoc,72,37,35
Stickidan,malganis,1763,demonhunter,havoc,96,46,50
Blæm,archimonde,1762,demonhunter,havoc,75,40,35
Aroxos,draenor,1762,demonhunter,havoc,118,61,57
Soysoyum,argent-dawn,1761,demonhunter,havoc,66,34,32
Belákor,twisting-nether,1761,demonhunter,havoc,325,166,159
Shotraklul,zuljin,1761,demonhunter,havoc,123,54,69
Jórúnn,twisting-nether,1760,demonhunter,havoc,83,45,38
Kezumå,tarren-mill,1760,demonhunter,havoc,126,65,61
Razex,kazzak,1760,demonhunter,havoc,192,99,93
Cumbayá,draenor,1759,demonhunter,havoc,36,22,14
Hunee,kazzak,1759,demonhunter,havoc,129,72,57
Felpsita,kazzak,1759,demonhunter,havoc,109,56,53
Márcin,burning-legion,1759,demonhunter,havoc,158,80,78
Reckqt,eredar,1759,demonhunter,havoc,48,23,25
Ted,frostwolf,1759,demonhunter,havoc,78,36,42
Kolísenn,drakthul,1758,demonhunter,havoc,162,87,75
Oniramqt,aegwynn,1758,demonhunter,havoc,102,45,57
Opmuch,eonar,1757,demonhunter,havoc,174,94,80
Подэхилла,galakrond,1756,demonhunter,havoc,142,75,67
Мэртольятти,soulflayer,1756,demonhunter,havoc,348,180,168
Rïmðh,haomarush,1754,demonhunter,havoc,53,28,25
Fotmøngø,argent-dawn,1754,demonhunter,havoc,53,28,25
Зарах,gordunni,1754,demonhunter,havoc,138,71,67
Shanaplow,hyjal,1754,demonhunter,havoc,72,33,39
Shyuk,sanguino,1753,demonhunter,havoc,54,30,24
Maskinegoðx,tarren-mill,1752,demonhunter,havoc,78,37,41
Primolover,outland,1751,demonhunter,havoc,66,33,33
Carablue,hyjal,1750,demonhunter,havoc,48,26,22
Ymmothep,draenor,1750,demonhunter,havoc,495,263,232
Eurobeat,dun-modr,1750,demonhunter,havoc,215,114,101
Calloww,kazzak,1750,demonhunter,havoc,37,19,18
Wyna,aggra-português,1750,demonhunter,havoc,249,124,125
Камуи,gordunni,1750,demonhunter,havoc,183,90,93
Nøbodyx,tarren-mill,1750,demonhunter,havoc,216,103,113
Dämonbumm,blackmoore,1750,demonhunter,havoc,93,44,49
Anzz,kazzak,1749,demonhunter,havoc,90,48,42
Balberith,twisting-nether,1749,demonhunter,havoc,143,76,67
Pay,twisting-nether,1749,demonhunter,havoc,87,39,48
Zy,ahnqiraj,1748,demonhunter,havoc,41,23,18
Faufilé,garona,1748,demonhunter,havoc,233,118,115
Zedxx,kazzak,1748,demonhunter,havoc,153,76,77
Itadora,antonidas,1748,demonhunter,havoc,155,76,79
Sailen,blackmoore,1748,demonhunter,havoc,59,28,31
Happýk,kazzak,1747,demonhunter,havoc,30,20,10
Necorinex,silvermoon,1746,demonhunter,havoc,48,26,22
Rasenhunt,blackmoore,1745,demonhunter,havoc,106,52,54
Gnarpump,emeriss,1745,demonhunter,havoc,60,29,31
Xotourlife,stormscale,1744,demonhunter,havoc,36,22,14
Lagseven,ravencrest,1744,demonhunter,havoc,63,31,32
Миелион,gordunni,1744,demonhunter,havoc,113,50,63
Chotzbrocke,blackhand,1743,demonhunter,havoc,42,23,19
Mongoose,drakthul,1743,demonhunter,havoc,190,94,96
Автокикер,soulflayer,1742,demonhunter,havoc,66,36,30
Illislan,darksorrow,1741,demonhunter,havoc,383,189,194
Illidiangød,sanguino,1740,demonhunter,havoc,60,34,26
Ferihokurva,outland,1740,demonhunter,havoc,88,46,42
Демонблэйдс,gordunni,1740,demonhunter,havoc,100,49,51
Культсмерти,howling-fjord,1740,demonhunter,havoc,132,59,73
Øoröra,hyjal,1739,demonhunter,havoc,100,63,37
Jotaros,ravencrest,1739,demonhunter,havoc,48,20,28
Солевыеглефы,gordunni,1738,demonhunter,havoc,68,41,27
Jaquees,stormscale,1738,demonhunter,havoc,102,55,47
Edh,dalaran,1738,demonhunter,havoc,137,71,66
Skippydemon,nozdormu,1737,demonhunter,havoc,78,35,43
Makwah,kazzak,1737,demonhunter,havoc,48,20,28
Vizh,aegwynn,1736,demonhunter,havoc,90,41,49
Susanoø,eredar,1735,demonhunter,havoc,213,116,97
Possomhd,kazzak,1734,demonhunter,havoc,201,109,92
Фавлав,ashenvale,1734,demonhunter,havoc,56,29,27
Мэйзиквин,howling-fjord,1734,demonhunter,havoc,309,156,153
Blacklidan,blackrock,1733,demonhunter,havoc,73,36,37
Dêyza,archimonde,1733,demonhunter,havoc,58,26,32
Йактон,soulflayer,1731,demonhunter,havoc,42,20,22
Zernoid,kazzak,1730,demonhunter,havoc,42,26,16
Бистлайк,soulflayer,1730,demonhunter,havoc,66,38,28
Usaïnbolts,archimonde,1730,demonhunter,havoc,66,31,35
Ewlyna,stormscale,1730,demonhunter,havoc,48,22,26
Narlà,silvermoon,1729,demonhunter,havoc,36,27,9
Turbomenak,drakthul,1728,demonhunter,havoc,54,34,20
Kanabiztwo,outland,1728,demonhunter,havoc,347,183,164
Altsta,draenor,1728,demonhunter,havoc,129,67,62
Азместь,howling-fjord,1727,demonhunter,havoc,42,20,22
Shadowjambo,twisting-nether,1725,demonhunter,havoc,81,45,36
Хэллшок,eversong,1725,demonhunter,havoc,125,63,62
Âyro,ravencrest,1724,demonhunter,havoc,102,59,43
Zerinitý,outland,1724,demonhunter,havoc,90,47,43
Blizó,tarren-mill,1724,demonhunter,havoc,36,18,18
Enjøybrah,nemesis,1723,demonhunter,havoc,157,85,72
Airelidari,tyrande,1723,demonhunter,havoc,215,106,109
Immørtaldh,tarren-mill,1723,demonhunter,havoc,48,23,25
Aarondh,ravencrest,1722,demonhunter,havoc,52,32,20
Sepdy,draenor,1722,demonhunter,havoc,146,79,67
Felski,outland,1722,demonhunter,havoc,97,47,50
Demondusk,silvermoon,1721,demonhunter,havoc,96,47,49
Gilletteabdi,argent-dawn,1721,demonhunter,havoc,295,139,156
Pvpabuser,ravencrest,1720,demonhunter,havoc,125,74,51
Ayyo,agamaggan,1720,demonhunter,havoc,51,22,29
Despèradø,archimonde,1719,demonhunter,havoc,194,105,89
Heimnar,frostmane,1719,demonhunter,havoc,42,22,20
Talisnar,nemesis,1718,demonhunter,havoc,252,123,129
Håssan,ravencrest,1717,demonhunter,havoc,48,27,21
Teinzy,stormscale,1717,demonhunter,havoc,48,25,23
Lhya,tarren-mill,1716,demonhunter,havoc,119,64,55
Xenits,kazzak,1715,demonhunter,havoc,94,47,47
Imslapping,draenor,1714,demonhunter,havoc,126,68,58
Felen,zuljin,1714,demonhunter,havoc,167,82,85
Hcsgötze,dalaran,1713,demonhunter,havoc,132,75,57
Bestro,tarren-mill,1713,demonhunter,havoc,140,70,70
Kuromiya,nemesis,1712,demonhunter,havoc,42,27,15
Indral,argent-dawn,1712,demonhunter,havoc,131,71,60
Бананчикус,gordunni,1712,demonhunter,havoc,172,88,84
Purpleturtle,blackrock,1712,demonhunter,havoc,54,26,28
Aethinos,sylvanas,1711,demonhunter,havoc,66,39,27
Bearrockx,alleria,1711,demonhunter,havoc,53,24,29
Нсэнс,soulflayer,1710,demonhunter,havoc,60,34,26
Nyalaah,eredar,1710,demonhunter,havoc,48,26,22
Demonkata,twisting-nether,1709,demonhunter,havoc,128,71,57
Paiz,grim-batol,1709,demonhunter,havoc,51,26,25
Yorxdh,eredar,1708,demonhunter,havoc,51,31,20
Лизарин,gordunni,1708,demonhunter,havoc,101,46,55
Dhqoo,blackrock,1708,demonhunter,havoc,66,27,39
Teladar,outland,1707,demonhunter,havoc,74,40,34
Ilidrax,hyjal,1707,demonhunter,havoc,60,32,28
Alundil,ravencrest,1707,demonhunter,havoc,114,58,56
Yousaindh,blackrock,1707,demonhunter,havoc,125,59,66
Lanadelbae,teldrassil,1705,demonhunter,havoc,228,117,111
Garfie,ravencrest,1705,demonhunter,havoc,36,18,18
Rabæ,blackhand,1705,demonhunter,havoc,126,62,64
Эссенденс,gordunni,1705,demonhunter,havoc,64,31,33
Yaboyferv,tarren-mill,1705,demonhunter,havoc,48,19,29
Kamoridh,blackhand,1704,demonhunter,havoc,84,48,36
Neralith,ravencrest,1703,demonhunter,havoc,119,62,57
Kryux,blackrock,1702,demonhunter,havoc,45,25,20
Авилолз,gordunni,1702,demonhunter,havoc,48,25,23
Donipwnz,blackrock,1702,demonhunter,havoc,107,46,61
Quazr,outland,1701,demonhunter,havoc,314,173,141
Aeko,silvermoon,1701,demonhunter,havoc,96,46,50
Krmâ,blackrock,1699,demonhunter,havoc,97,40,57
Zamassu,kazzak,1698,demonhunter,havoc,60,33,27
Prepared,kaelthas,1697,demonhunter,havoc,93,46,47
Tanjero,stormscale,1696,demonhunter,havoc,53,36,17
Hextechz,stormscale,1696,demonhunter,havoc,111,64,47
Dominik,the-maelstrom,1695,demonhunter,havoc,188,107,81
Guáca,draenor,1695,demonhunter,havoc,201,105,96
Blish,blackhand,1695,demonhunter,havoc,42,19,23
Скинр,soulflayer,1694,demonhunter,havoc,102,54,48
Ifeeldirty,draenor,1693,demonhunter,havoc,57,32,25
ßerdína,tarren-mill,1693,demonhunter,havoc,147,76,71
Bokajr,ragnaros,1692,demonhunter,havoc,82,43,39
Vorbis,twisting-nether,1692,demonhunter,havoc,253,130,123
Tyssra,argent-dawn,1692,demonhunter,havoc,335,161,174
Itàchì,kazzak,1691,demonhunter,havoc,60,38,22
Róxor,twisting-nether,1691,demonhunter,havoc,123,58,65
Jnfd,outland,1691,demonhunter,havoc,56,24,32
Brzzlbrzzl,malganis,1690,demonhunter,havoc,154,86,68
Elenôy,antonidas,1689,demonhunter,havoc,48,26,22
Dhhuu,kazzak,1689,demonhunter,havoc,58,30,28
Ðemøñsåy,blackrock,1689,demonhunter,havoc,372,185,187
Isito,draenor,1688,demonhunter,havoc,84,46,38
Deathe,kilrogg,1687,demonhunter,havoc,95,49,46
Tylleröwittu,grim-batol,1686,demonhunter,havoc,108,59,49
Тяннейм,deathguard,1686,demonhunter,havoc,91,49,42
Геммула,howling-fjord,1686,demonhunter,havoc,266,136,130
Kázuyá,blackrock,1686,demonhunter,havoc,36,18,18
Demobob,tarren-mill,1686,demonhunter,havoc,48,23,25
Hagana,tirion,1686,demonhunter,havoc,54,24,30
Batx,ravencrest,1686,demonhunter,havoc,64,28,36
Vênedri,eredar,1685,demonhunter,havoc,87,53,34
Nisirae,argent-dawn,1685,demonhunter,havoc,156,90,66
Höllymedx,blackmoore,1685,demonhunter,havoc,66,33,33
Турботашш,soulflayer,1685,demonhunter,havoc,162,79,83
Vaiprix,ragnaros,1685,demonhunter,havoc,93,41,52
Nuxzhell,tarren-mill,1684,demonhunter,havoc,459,228,231
Slutkitten,ravencrest,1684,demonhunter,havoc,48,21,27
Demxx,blackrock,1683,demonhunter,havoc,48,25,23
Zevsa,ravencrest,1682,demonhunter,havoc,103,56,47
Fruchtzwerg,tarren-mill,1682,demonhunter,havoc,143,76,67
Dxæn,archimonde,1682,demonhunter,havoc,95,47,48
Emurid,les-sentinelles,1682,demonhunter,havoc,54,26,28
Míàkhãlîfâýð,stormscale,1682,demonhunter,havoc,62,26,36
Tdh,sanguino,1681,demonhunter,havoc,42,23,19
Хингарский,deathguard,1680,demonhunter,havoc,92,53,39
Demonade,ravencrest,1680,demonhunter,havoc,161,90,71
Øhka,outland,1680,demonhunter,havoc,102,51,51
Schøck,blackhand,1679,demonhunter,havoc,48,29,19
Maøu,hyjal,1678,demonhunter,havoc,41,24,17
Zintu,draenor,1678,demonhunter,havoc,180,93,87
Skuz,archimonde,1677,demonhunter,havoc,36,20,16
Hialdoo,bladefist,1677,demonhunter,havoc,84,41,43
Mâdzylîa,archimonde,1677,demonhunter,havoc,81,39,42
Mîlîm,silvermoon,1677,demonhunter,havoc,78,34,44
Charleyzard,argent-dawn,1676,demonhunter,havoc,120,65,55
Trenfluencer,silvermoon,1675,demonhunter,havoc,115,71,44
Soizis,drakthul,1673,demonhunter,havoc,72,37,35
Twopumpchump,twisting-nether,1673,demonhunter,havoc,98,48,50
Malabala,grim-batol,1672,demonhunter,havoc,59,32,27
Hialdoo,sylvanas,1672,demonhunter,havoc,66,29,37
Illidankxx,sylvanas,1671,demonhunter,havoc,97,56,41
Pizjar,ravencrest,1671,demonhunter,havoc,48,27,21
Lòsâng,sanguino,1671,demonhunter,havoc,231,113,118
Omegapump,ravencrest,1670,demonhunter,havoc,42,22,20
Øctågøñ,blackrock,1670,demonhunter,havoc,246,125,121
Rhinozerg,kazzak,1670,demonhunter,havoc,45,22,23
Richielou,outland,1670,demonhunter,havoc,54,25,29
Demondulle,kazzak,1670,demonhunter,havoc,66,25,41
Ììîîííììîîíí,tarren-mill,1669,demonhunter,havoc,78,44,34
Gwoodza,archimonde,1669,demonhunter,havoc,60,25,35
Yarudh,blackrock,1667,demonhunter,havoc,152,80,72
Тугеймовер,grom,1667,demonhunter,havoc,173,91,82
Shadoss,ravencrest,1667,demonhunter,havoc,198,102,96
Demongodxx,twisting-nether,1666,demonhunter,havoc,78,39,39
Alcóhon,ravencrest,1665,demonhunter,havoc,47,23,24
Sturmovik,ravencrest,1664,demonhunter,havoc,54,33,21
Êlva,alleria,1664,demonhunter,havoc,92,49,43
Thedudex,dunemaul,1664,demonhunter,havoc,80,41,39
Найтбладия,gordunni,1664,demonhunter,havoc,133,68,65
Destinado,aggra-português,1663,demonhunter,havoc,66,38,28
Râindra,twisting-nether,1663,demonhunter,havoc,198,104,94
Hofisis,kazzak,1663,demonhunter,havoc,60,31,29
Kekburagól,kazzak,1663,demonhunter,havoc,63,30,33
Djdeathsweep,blackrock,1662,demonhunter,havoc,54,27,27
Thingawoop,tarren-mill,1662,demonhunter,havoc,97,48,49
Nepthýs,blackhand,1662,demonhunter,havoc,93,43,50
Ræko,sanguino,1661,demonhunter,havoc,144,75,69
Evildeeb,kazzak,1660,demonhunter,havoc,66,35,31
Ðêmønìnsìðê,blackmoore,1659,demonhunter,havoc,48,27,21
Nagatobimaru,tarren-mill,1659,demonhunter,havoc,109,55,54
Enfy,twisting-nether,1659,demonhunter,havoc,142,69,73
Shabalda,dun-morogh,1659,demonhunter,havoc,112,54,58
Anayihh,dun-modr,1659,demonhunter,havoc,83,38,45
Zoyle,blackrock,1659,demonhunter,havoc,60,26,34
Lilydrop,varimathras,1659,demonhunter,havoc,51,20,31
Cheetòs,blackmoore,1658,demonhunter,havoc,75,40,35
Мишаметапамп,grom,1658,demonhunter,havoc,44,23,21
Nøvillain,blackrock,1657,demonhunter,havoc,102,59,43
Инферналка,howling-fjord,1656,demonhunter,havoc,160,86,74
Séphrióth,frostwolf,1655,demonhunter,havoc,128,69,59
Vengeful,alonsus,1655,demonhunter,havoc,41,20,21
Fizzpep,eredar,1655,demonhunter,havoc,58,28,30
Vayshi,turalyon,1655,demonhunter,havoc,54,26,28
Èfiie,culte-de-la-rive-noire,1655,demonhunter,havoc,95,45,50
Picpouc,archimonde,1655,demonhunter,havoc,60,27,33
Shirra,shadowsong,1654,demonhunter,havoc,119,58,61
Faytundh,kult-der-verdammten,1654,demonhunter,havoc,72,33,39
Turkoïs,silvermoon,1653,demonhunter,havoc,33,18,15
Skîllwhat,aegwynn,1653,demonhunter,havoc,67,35,32
Эллий,blackscar,1652,demonhunter,havoc,72,33,39
Zahadius,silvermoon,1651,demonhunter,havoc,59,37,22
Турбосвинья,gordunni,1651,demonhunter,havoc,309,159,150
Aylinx,blackrock,1650,demonhunter,havoc,36,20,16
Элунн,soulflayer,1650,demonhunter,havoc,42,22,20
Шизванаденс,gordunni,1650,demonhunter,havoc,71,37,34
Dldb,dentarg,1649,demonhunter,havoc,48,32,16
Deocleo,draenor,1649,demonhunter,havoc,43,24,19
Фэсс,soulflayer,1649,demonhunter,havoc,137,72,65
Аллидариан,howling-fjord,1649,demonhunter,havoc,41,20,21
Солстрэйл,gordunni,1648,demonhunter,havoc,113,56,57
Ehrin,lightbringer,1648,demonhunter,havoc,170,80,90
Filthyape,ravencrest,1648,demonhunter,havoc,78,35,43
Felwinter,ravencrest,1647,demonhunter,havoc,216,105,111
Амбату,howling-fjord,1646,demonhunter,havoc,56,38,18
Gigasloth,outland,1645,demonhunter,havoc,48,32,16
Lilfly,twisting-nether,1645,demonhunter,havoc,36,19,17
Scarath,eredar,1645,demonhunter,havoc,66,30,36
Aofaye,aegwynn,1645,demonhunter,havoc,77,29,48
Ekaõs,les-sentinelles,1644,demonhunter,havoc,53,28,25
Nyxxeria,drakthul,1644,demonhunter,havoc,67,34,33
Рейз,howling-fjord,1644,demonhunter,havoc,144,70,74
Umbraslash,argent-dawn,1643,demonhunter,havoc,65,38,27
Baball,kazzak,1643,demonhunter,havoc,145,83,62
Spiriteru,archimonde,1643,demonhunter,havoc,54,29,25
Дэн,blackscar,1643,demonhunter,havoc,154,73,81
Drphillidan,tarren-mill,1643,demonhunter,havoc,126,59,67
Dontmashme,cthun,1643,demonhunter,havoc,54,25,29
Hauntedseoul,grim-batol,1642,demonhunter,havoc,162,95,67
Killia,lothar,1642,demonhunter,havoc,42,24,18
Solarae,silvermoon,1641,demonhunter,havoc,166,89,77
Bestboytoy,ravencrest,1641,demonhunter,havoc,53,27,26
Депрессивдед,gordunni,1641,demonhunter,havoc,72,35,37
Sekørm,ragnaros,1641,demonhunter,havoc,54,23,31
Ðârksìðê,stormscale,1640,demonhunter,havoc,96,53,43
Elsynn,dalaran,1640,demonhunter,havoc,132,62,70
Ranzerg,tarren-mill,1639,demonhunter,havoc,60,38,22
Persio,sanguino,1639,demonhunter,havoc,135,73,62
Dinastye,archimonde,1639,demonhunter,havoc,174,93,81
Khray,archimonde,1639,demonhunter,havoc,48,25,23
Ziover,zuljin,1639,demonhunter,havoc,42,21,21
Муими,soulflayer,1639,demonhunter,havoc,84,37,47
Bizl,arygos,1638,demonhunter,havoc,30,19,11
Draxie,turalyon,1638,demonhunter,havoc,143,75,68
Exoqt,blackhand,1638,demonhunter,havoc,166,80,86
Asmonsmash,twisting-nether,1638,demonhunter,havoc,64,30,34
Lawus,blackhand,1637,demonhunter,havoc,54,26,28
Папичгодх,borean-tundra,1637,demonhunter,havoc,87,36,51
Heidihauge,silvermoon,1636,demonhunter,havoc,66,30,36
Ïîï,archimonde,1636,demonhunter,havoc,215,95,120
Hatemaker,burning-legion,1635,demonhunter,havoc,146,80,66
Like,shattrath,1635,demonhunter,havoc,38,19,19
Riptos,blackhand,1635,demonhunter,havoc,46,22,24
Mollamaija,defias-brotherhood,1635,demonhunter,havoc,85,36,49
Spicysteve,tarren-mill,1634,demonhunter,havoc,117,73,44
Mårcxb,blackhand,1634,demonhunter,havoc,48,25,23
Flys,doomhammer,1634,demonhunter,havoc,176,91,85
Azraethx,ravencrest,1633,demonhunter,havoc,66,38,28
Ðêmønìç,area-52,1633,demonhunter,havoc,72,41,31
Flyingwhale,terokkar,1633,demonhunter,havoc,105,50,55
Смутсайбот,howling-fjord,1633,demonhunter,havoc,48,22,26
Moojdh,malganis,1632,demonhunter,havoc,96,57,39
Çôæ,twisting-nether,1632,demonhunter,havoc,338,165,173
Salvadx,zuljin,1632,demonhunter,havoc,51,23,28
Illiada,spinebreaker,1631,demonhunter,havoc,48,26,22
Maodh,veknilash,1630,demonhunter,havoc,60,27,33
Anero,draenor,1630,demonhunter,havoc,85,37,48
Cantseêyou,blackmoore,1629,demonhunter,havoc,158,89,69
Demonpegasus,draenor,1629,demonhunter,havoc,95,44,51
Великаямыша,blackscar,1628,demonhunter,havoc,56,33,23
Крикетчсв,soulflayer,1628,demonhunter,havoc,72,41,31
Evil,uldum,1628,demonhunter,havoc,179,94,85
Hornyhexy,stormscale,1628,demonhunter,havoc,310,160,150
Блъя,gordunni,1628,demonhunter,havoc,42,21,21
Felbannedguy,twisting-nether,1627,demonhunter,havoc,42,23,19
Azaleia,archimonde,1627,demonhunter,havoc,228,116,112
Оригамушка,gordunni,1627,demonhunter,havoc,48,23,25
Nopredh,blackrock,1627,demonhunter,havoc,133,62,71
Гадх,gordunni,1627,demonhunter,havoc,80,36,44
Крикадский,howling-fjord,1626,demonhunter,havoc,90,54,36
Sfguild,kazzak,1625,demonhunter,havoc,75,42,33
Kakashî,darksorrow,1625,demonhunter,havoc,42,22,20
Integer,tarren-mill,1625,demonhunter,havoc,163,83,80
Stazó,drakthul,1625,demonhunter,havoc,145,71,74
Клитозавр,gordunni,1625,demonhunter,havoc,42,20,22
Sonreye,kazzak,1625,demonhunter,havoc,41,18,23
Lindzor,frostmane,1624,demonhunter,havoc,47,32,15
Bruxdh,colinas-pardas,1624,demonhunter,havoc,40,21,19
Onecho,ragnaros,1623,demonhunter,havoc,30,18,12
Koomaliha,outland,1623,demonhunter,havoc,85,42,43
Soysoyum,draenor,1623,demonhunter,havoc,85,41,44
Tiktokfrida,twisting-nether,1623,demonhunter,havoc,36,17,19
Urukguy,silvermoon,1622,demonhunter,havoc,66,37,29
Бельторо,soulflayer,1622,demonhunter,havoc,123,68,55
Incanator,tarren-mill,1622,demonhunter,havoc,172,90,82
Mentalìst,blackmoore,1622,demonhunter,havoc,171,89,82
Ravael,archimonde,1622,demonhunter,havoc,54,26,28
Naïtipa,arathi,1622,demonhunter,havoc,78,37,41
Akkixy,die-aldor,1621,demonhunter,havoc,53,30,23
Länika,drakthul,1620,demonhunter,havoc,42,23,19
Darkwing,silvermoon,1619,demonhunter,havoc,91,54,37
Huntoverkill,hyjal,1619,demonhunter,havoc,66,37,29
Doomcake,emeriss,1619,demonhunter,havoc,60,33,27
Tamtheone,silvermoon,1619,demonhunter,havoc,120,63,57
Dragontwist,sylvanas,1619,demonhunter,havoc,42,22,20
Blankdh,outland,1618,demonhunter,havoc,37,22,15
Midoaa,nerathor,1618,demonhunter,havoc,42,22,20
Albdh,kazzak,1618,demonhunter,havoc,42,20,22
Keanujeeves,dentarg,1617,demonhunter,havoc,114,68,46
Пибзянка,howling-fjord,1616,demonhunter,havoc,36,20,16
Abuelodosaka,dun-modr,1616,demonhunter,havoc,36,20,16
Хирако,booty-bay,1616,demonhunter,havoc,66,35,31
Lghdtv,ravencrest,1616,demonhunter,havoc,144,74,70
Drâparn,sylvanas,1616,demonhunter,havoc,36,17,19
Morgothe,ysondre,1616,demonhunter,havoc,56,25,31
Velvetrain,ravencrest,1616,demonhunter,havoc,42,17,25
Крикетгодх,howling-fjord,1615,demonhunter,havoc,39,24,15
Abendro,twisting-nether,1615,demonhunter,havoc,140,78,62
Xalgalor,silvermoon,1615,demonhunter,havoc,72,40,32
Bohchín,zuljin,1615,demonhunter,havoc,318,167,151
Анавеллка,howling-fjord,1615,demonhunter,havoc,54,28,26
Wirsing,azshara,1615,demonhunter,havoc,191,98,93
Sikke,draenor,1615,demonhunter,havoc,42,21,21
Shaely,arthas,1615,demonhunter,havoc,36,17,19
Muyoni,eredar,1615,demonhunter,havoc,48,20,28
Leesplays,ravencrest,1614,demonhunter,havoc,60,36,24
Junkai,echsenkessel,1613,demonhunter,havoc,69,38,31
Кельдарк,soulflayer,1613,demonhunter,havoc,288,146,142
Benihimee,twisting-nether,1613,demonhunter,havoc,84,40,44
Влажныйдемон,soulflayer,1612,demonhunter,havoc,30,25,5
Paindemon,outland,1612,demonhunter,havoc,85,44,41
Kéftëmé,ravencrest,1612,demonhunter,havoc,84,43,41
Netherim,twisting-nether,1612,demonhunter,havoc,128,55,73
Sickfck,ravencrest,1611,demonhunter,havoc,117,69,48
Narkiza,tarren-mill,1611,demonhunter,havoc,30,17,13
Азелира,gordunni,1610,demonhunter,havoc,84,47,37
Kéøn,ravencrest,1610,demonhunter,havoc,108,58,50
Firebringer,silvermoon,1610,demonhunter,havoc,48,25,23
Gündüzgezen,silvermoon,1610,demonhunter,havoc,59,30,29
Demonichanta,azjolnerub,1610,demonhunter,havoc,304,153,151
Dedemøn,ysondre,1610,demonhunter,havoc,69,32,37
Ultîma,hyjal,1610,demonhunter,havoc,54,21,33
Maupau,ravencrest,1609,demonhunter,havoc,93,53,40
Чуювонь,soulflayer,1609,demonhunter,havoc,78,44,34
Ðèaðlýsins,kazzak,1609,demonhunter,havoc,102,56,46
Дайкиаомине,soulflayer,1609,demonhunter,havoc,36,19,17
Loucee,blackhand,1609,demonhunter,havoc,96,49,47
Snitchezz,blackmoore,1608,demonhunter,havoc,162,88,74
Akalàkarcher,hyjal,1608,demonhunter,havoc,130,67,63
Fishmicksh,twisting-nether,1607,demonhunter,havoc,36,22,14
Schejtan,blackmoore,1607,demonhunter,havoc,96,54,42
Gullveîg,archimonde,1607,demonhunter,havoc,125,70,55
Enthia,antonidas,1607,demonhunter,havoc,119,65,54
Coffeecount,twisting-nether,1607,demonhunter,havoc,148,76,72
Ðisgraze,argent-dawn,1607,demonhunter,havoc,301,154,147
Kanata,kazzak,1607,demonhunter,havoc,96,48,48
Nèmésîs,gorgonnash,1607,demonhunter,havoc,62,29,33
Jynizu,silvermoon,1606,demonhunter,havoc,60,41,19
Kîallz,hyjal,1606,demonhunter,havoc,30,17,13
Èstefany,stormscale,1606,demonhunter,havoc,162,85,77
Chåk,marécage-de-zangar,1606,demonhunter,havoc,48,23,25
Майкелелекек,gordunni,1606,demonhunter,havoc,36,17,19
Völkswagen,dun-modr,1605,demonhunter,havoc,30,17,13
Mamio,chogall,1605,demonhunter,havoc,88,49,39
Thawgdh,silvermoon,1605,demonhunter,havoc,83,46,37
ßerdíná,tarren-mill,1605,demonhunter,havoc,60,31,29
Darrkdemon,kazzak,1605,demonhunter,havoc,445,229,216
Demonjagge,tarren-mill,1604,demonhunter,havoc,36,24,12
Escaboyx,stormscale,1604,demonhunter,havoc,41,27,14
Gonextbg,tarren-mill,1604,demonhunter,havoc,187,100,87
Kãzïn,archimonde,1604,demonhunter,havoc,71,34,37
Nixzon,thrall,1604,demonhunter,havoc,78,31,47
Самаэльф,blackscar,1603,demonhunter,havoc,72,42,30
Ayö,draenor,1603,demonhunter,havoc,169,95,74
Trashclass,draenor,1603,demonhunter,havoc,34,18,16
Lolliance,talnivarr,1603,demonhunter,havoc,48,23,25
Jamzydemon,kazzak,1602,demonhunter,havoc,24,17,7
Coniras,dun-morogh,1602,demonhunter,havoc,54,30,24
Вскрыша,soulflayer,1602,demonhunter,havoc,36,20,16
Garoteromani,draenor,1602,demonhunter,havoc,171,94,77
Freylis,burning-legion,1602,demonhunter,havoc,62,31,31
Chosabreka,zuljin,1602,demonhunter,havoc,36,17,19
Синнэрлити,soulflayer,1602,demonhunter,havoc,54,25,29
Ðevl,blackmoore,1602,demonhunter,havoc,48,22,26
Blackfrostic,stormscale,1601,demonhunter,havoc,49,27,22
Havocer,burning-legion,1601,demonhunter,havoc,147,76,71
Cayssaelle,argent-dawn,1601,demonhunter,havoc,66,34,32
Demonsqueezy,nemesis,1600,demonhunter,havoc,111,68,43
Flaybalbooll,ragnaros,1600,demonhunter,havoc,406,214,192
Ícéìnmývèins,stormscale,1600,demonhunter,havoc,45,20,25
Torporu,tarren-mill,1599,demonhunter,havoc,60,34,26
Fazero,silvermoon,1599,demonhunter,havoc,139,67,72
Darrkmoff,sylvanas,1598,demonhunter,havoc,162,91,71
Sweetpety,tarren-mill,1598,demonhunter,havoc,159,84,75
Táti,blackrock,1598,demonhunter,havoc,42,19,23
Cappaowx,ravencrest,1597,demonhunter,havoc,30,21,9
Sandem,blackrock,1597,demonhunter,havoc,84,43,41
Wintalker,nemesis,1597,demonhunter,havoc,94,48,46
Дезлее,gordunni,1597,demonhunter,havoc,152,73,79
Davidastt,drakthul,1597,demonhunter,havoc,101,47,54
Thorno,argent-dawn,1597,demonhunter,havoc,60,22,38
Knmdemon,draenor,1596,demonhunter,havoc,36,21,15
Antidevil,kazzak,1596,demonhunter,havoc,129,73,56
Âspen,archimonde,1596,demonhunter,havoc,209,110,99
Matally,khaz-modan,1595,demonhunter,havoc,60,30,30
Tatenzex,stormscale,1594,demonhunter,havoc,51,32,19
Saisahan,archimonde,1594,demonhunter,havoc,125,70,55
Meleidar,kazzak,1594,demonhunter,havoc,36,17,19
Финдита,ashenvale,1593,demonhunter,havoc,35,17,18
Glayvie,kazzak,1593,demonhunter,havoc,69,32,37
Bhairav,silvermoon,1591,demonhunter,havoc,36,21,15
Weez,kilrogg,1590,demonhunter,havoc,254,121,133
Speedførce,antonidas,1590,demonhunter,havoc,138,63,75
Zadian,twisting-nether,1590,demonhunter,havoc,52,22,30
Ybou,archimonde,1590,demonhunter,havoc,66,24,42
Dhvyx,hyjal,1589,demonhunter,havoc,160,72,88
Gixota,silvermoon,1588,demonhunter,havoc,30,17,13
Jumboo,tarren-mill,1588,demonhunter,havoc,106,54,52
Ботология,gordunni,1588,demonhunter,havoc,108,51,57
Nowhereturun,stormscale,1587,demonhunter,havoc,60,31,29
Xenca,ravencrest,1586,demonhunter,havoc,172,95,77
Реогансина,galakrond,1586,demonhunter,havoc,68,32,36
Badreal,sylvanas,1586,demonhunter,havoc,143,64,79
Terrminator,darksorrow,1585,demonhunter,havoc,102,56,46
Palangebahar,tarren-mill,1585,demonhunter,havoc,60,31,29
Thorair,ravenholdt,1585,demonhunter,havoc,90,44,46
Luunz,argent-dawn,1585,demonhunter,havoc,279,134,145
Киттигоплей,soulflayer,1585,demonhunter,havoc,102,48,54
Eliàna,twisting-nether,1585,demonhunter,havoc,82,38,44
Venatica,twisting-nether,1584,demonhunter,havoc,120,67,53
Nillrogthedh,stormscale,1584,demonhunter,havoc,239,132,107
Kyuzo,sanguino,1584,demonhunter,havoc,51,28,23
Jolyh,nemesis,1584,demonhunter,havoc,101,54,47
Kins,dun-modr,1584,demonhunter,havoc,101,46,55
Knùbbz,ravencrest,1583,demonhunter,havoc,114,59,55
Эльгастон,howling-fjord,1583,demonhunter,havoc,131,67,64
Mìkélol,stormscale,1583,demonhunter,havoc,48,19,29
Трукейт,gordunni,1582,demonhunter,havoc,56,33,23
Kïallz,hyjal,1582,demonhunter,havoc,511,259,252
Onizukadh,archimonde,1581,demonhunter,havoc,48,20,28
Olddemon,ravencrest,1580,demonhunter,havoc,116,72,44
Кавайтити,howling-fjord,1580,demonhunter,havoc,132,68,64
Mazeeken,kazzak,1580,demonhunter,havoc,126,56,70
Sabe,ravencrest,1579,demonhunter,havoc,71,46,25
Släshes,kazzak,1579,demonhunter,havoc,104,50,54
Rezer,stormscale,1579,demonhunter,havoc,134,61,73
Badess,malfurion,1579,demonhunter,havoc,42,18,24
Ydrael,terokkar,1578,demonhunter,havoc,60,32,28
Gandzsä,ragnaros,1578,demonhunter,havoc,156,76,80
Shayanäa,les-clairvoyants,1577,demonhunter,havoc,48,25,23
Marrie,area-52,1576,demonhunter,havoc,36,21,15
Bhaz,tichondrius,1576,demonhunter,havoc,66,36,30
Innocuouss,twisting-nether,1576,demonhunter,havoc,54,22,32
Devildust,ravencrest,1576,demonhunter,havoc,54,18,36
Aenirá,tarren-mill,1575,demonhunter,havoc,124,63,61
Dhive,blackrock,1574,demonhunter,havoc,48,23,25
Цезарий,gordunni,1573,demonhunter,havoc,261,133,128
Lodjay,hyjal,1572,demonhunter,havoc,70,35,35
Rybn,eredar,1572,demonhunter,havoc,102,44,58
Xocotl,blackmoore,1572,demonhunter,havoc,60,25,35
Mottenmann,tarren-mill,1570,demonhunter,havoc,53,32,21
Demonmancer,ravencrest,1570,demonhunter,havoc,300,153,147
Shentarie,kazzak,1569,demonhunter,havoc,72,40,32
Aedilles,ravencrest,1569,demonhunter,havoc,96,53,43
Дикаяособа,howling-fjord,1569,demonhunter,havoc,141,77,64
Fumbiidhx,thrall,1569,demonhunter,havoc,117,63,54
Alervius,blackrock,1569,demonhunter,havoc,42,21,21
Verybigdps,aegwynn,1569,demonhunter,havoc,54,24,30
Сихая,howling-fjord,1568,demonhunter,havoc,42,24,18
Ayky,outland,1568,demonhunter,havoc,63,34,29
Jokidh,zuljin,1568,demonhunter,havoc,54,27,27
Ignasei,archimonde,1568,demonhunter,havoc,81,36,45
Дрэгонборн,howling-fjord,1567,demonhunter,havoc,116,60,56
Minadng,silvermoon,1565,demonhunter,havoc,36,20,16
Przemson,mazrigos,1565,demonhunter,havoc,158,79,79
Remn,archimonde,1565,demonhunter,havoc,54,22,32
Inolia,argent-dawn,1565,demonhunter,havoc,64,26,38
Jugøbænned,blackrock,1564,demonhunter,havoc,42,27,15
Liladan,sylvanas,1564,demonhunter,havoc,30,17,13
Demogon,thrall,1564,demonhunter,havoc,59,29,30
Saleny,blackrock,1564,demonhunter,havoc,63,29,34
Phudi,tarren-mill,1563,demonhunter,havoc,286,145,141
Nuitrayer,hyjal,1560,demonhunter,havoc,68,44,24
Аянамирейко,blackscar,1560,demonhunter,havoc,78,49,29
Stân,tarren-mill,1560,demonhunter,havoc,46,26,20
Demonakis,twisting-nether,1559,demonhunter,havoc,104,45,59
Лучшедк,gordunni,1559,demonhunter,havoc,118,50,68
Аитерия,gordunni,1558,demonhunter,havoc,48,31,17
Onebuttonxd,ravencrest,1558,demonhunter,havoc,105,58,47
Kabomse,eredar,1557,demonhunter,havoc,34,19,15
Авалиас,gordunni,1557,demonhunter,havoc,76,41,35
Ricmorphis,grim-batol,1557,demonhunter,havoc,65,28,37
Neomicha,blackmoore,1556,demonhunter,havoc,196,101,95
Wojtall,silvermoon,1556,demonhunter,havoc,516,262,254
Elvenfrey,kazzak,1556,demonhunter,havoc,112,54,58
Themen,ragnaros,1555,demonhunter,havoc,54,34,20
Akkita,ravencrest,1554,demonhunter,havoc,131,67,64
Thkingragnar,sanguino,1553,demonhunter,havoc,36,23,13
Illidrax,outland,1553,demonhunter,havoc,48,18,30
Suitcåséguy,ravencrest,1553,demonhunter,havoc,48,18,30
Crylater,twisting-nether,1552,demonhunter,havoc,48,27,21
Cynmatic,kargath,1552,demonhunter,havoc,80,40,40
Glímpse,ravencrest,1552,demonhunter,havoc,78,39,39
Dhzor,twisting-nether,1552,demonhunter,havoc,64,32,32
Féèlthèpåiñ,burning-legion,1552,demonhunter,havoc,48,24,24
Lyanadh,blackhand,1552,demonhunter,havoc,40,19,21
Zayláh,ravencrest,1552,demonhunter,havoc,129,61,68
Shylea,ravencrest,1551,demonhunter,havoc,126,66,60
Aranéus,archimonde,1551,demonhunter,havoc,70,36,34
Nolitara,exodar,1551,demonhunter,havoc,98,47,51
Ashcan,tarren-mill,1550,demonhunter,havoc,121,62,59
Brodor,alakir,1550,demonhunter,havoc,72,33,39
Muckan,tarren-mill,1549,demonhunter,havoc,36,19,17
Дэйзиджонсон,soulflayer,1549,demonhunter,havoc,59,30,29
Sebyk,doomhammer,1548,demonhunter,havoc,89,48,41
Самадиэль,soulflayer,1548,demonhunter,havoc,124,63,61
Деирдевил,blackscar,1548,demonhunter,havoc,42,21,21
Mooty,drekthar,1548,demonhunter,havoc,36,18,18
Ðanizâ,aegwynn,1548,demonhunter,havoc,72,35,37
Padalecki,blackmoore,1548,demonhunter,havoc,35,17,18
Pinkberry,outland,1548,demonhunter,havoc,48,22,26
Chaosstrike,twisting-nether,1547,demonhunter,havoc,66,30,36
Baddxd,ragnaros,1547,demonhunter,havoc,80,34,46
Ibeem,dentarg,1546,demonhunter,havoc,105,66,39
Szexypopsi,ragnaros,1546,demonhunter,havoc,95,51,44
Akaria,blackrock,1545,demonhunter,havoc,141,82,59
Полутемный,howling-fjord,1545,demonhunter,havoc,86,45,41
Cptncucumber,blackmoore,1545,demonhunter,havoc,252,123,129
Mikezilla,drakthul,1544,demonhunter,havoc,69,36,33
Kätarïnas,confrérie-du-thorium,1544,demonhunter,havoc,36,18,18
Ragel,grim-batol,1544,demonhunter,havoc,65,28,37
Däshgødx,stormscale,1543,demonhunter,havoc,54,31,23
Art,tarren-mill,1543,demonhunter,havoc,77,44,33
Olessias,cthun,1542,demonhunter,havoc,30,18,12
Kayzel,argent-dawn,1542,demonhunter,havoc,337,169,168
Unkqt,dalaran,1542,demonhunter,havoc,72,35,37
Valarauk,ravencrest,1541,demonhunter,havoc,261,141,120
Bichmicher,earthen-ring,1541,demonhunter,havoc,60,23,37
Rerien,blackmoore,1540,demonhunter,havoc,59,29,30
Asporos,pozzo-delleternità,1540,demonhunter,havoc,55,23,32
Alied,burning-blade,1539,demonhunter,havoc,84,39,45
Mcfitty,stormscale,1537,demonhunter,havoc,90,44,46
Aelìa,ysondre,1537,demonhunter,havoc,73,30,43
Crappyftw,ravencrest,1536,demonhunter,havoc,650,331,319
Roaf,twisting-nether,1536,demonhunter,havoc,99,48,51
Xekaul,tarren-mill,1536,demonhunter,havoc,379,182,197
Johncoffèy,ragnaros,1535,demonhunter,havoc,24,16,8
Winxclub,ravencrest,1535,demonhunter,havoc,113,62,51
Ryuwar,dun-modr,1535,demonhunter,havoc,141,72,69
Гневлуны,lich-king,1535,demonhunter,havoc,121,60,61
Sèptember,draenor,1535,demonhunter,havoc,65,29,36
Molntuss,ravencrest,1535,demonhunter,havoc,134,59,75
Qweqweasd,outland,1534,demonhunter,havoc,30,16,14
Méruème,hyjal,1534,demonhunter,havoc,43,22,21
Inflection,ravencrest,1534,demonhunter,havoc,60,22,38
Ckboo,kazzak,1533,demonhunter,havoc,65,33,32
Lovesong,the-shatar,1532,demonhunter,havoc,177,92,85
Силдеус,galakrond,1531,demonhunter,havoc,72,46,26
Lastactiondh,dun-morogh,1531,demonhunter,havoc,66,41,25
Хенноо,howling-fjord,1531,demonhunter,havoc,36,17,19
Snibsxdh,silvermoon,1531,demonhunter,havoc,60,27,33
Рэгес,howling-fjord,1527,demonhunter,havoc,60,32,28
Pibzya,ravencrest,1527,demonhunter,havoc,69,32,37
Чанпэн,soulflayer,1526,demonhunter,havoc,163,85,78
Niklâûs,ysondre,1525,demonhunter,havoc,48,33,15
Lennöx,silvermoon,1525,demonhunter,havoc,67,38,29
Alareey,antonidas,1525,demonhunter,havoc,285,139,146
Rúllio,rexxar,1525,demonhunter,havoc,54,22,32
Drilloz,ravencrest,1524,demonhunter,havoc,30,18,12
Shivarræ,stormreaver,1524,demonhunter,havoc,60,31,29
Kranta,blackmoore,1524,demonhunter,havoc,58,26,32
Геннитиро,deathguard,1523,demonhunter,havoc,34,20,14
Yeedhlol,blackmoore,1523,demonhunter,havoc,30,16,14
Shiefwiggum,aegwynn,1521,demonhunter,havoc,42,22,20
Sanfia,twisting-nether,1521,demonhunter,havoc,36,17,19
Vaimustus,outland,1521,demonhunter,havoc,59,23,36
Спииртт,blackscar,1521,demonhunter,havoc,78,29,49
Zulthealbino,tarren-mill,1520,demonhunter,havoc,68,40,28
Spacedance,silvermoon,1520,demonhunter,havoc,32,17,15
Moonhorns,deathwing,1520,demonhunter,havoc,60,30,30
Rylqt,blackmoore,1519,demonhunter,havoc,145,68,77
Mêgumi,kirin-tor,1518,demonhunter,havoc,341,170,171
Talamacus,outland,1517,demonhunter,havoc,84,45,39
Amionisiken,amanthul,1517,demonhunter,havoc,242,128,114
Кррюкс,gordunni,1517,demonhunter,havoc,55,29,26
Taÿkyn,archimonde,1517,demonhunter,havoc,78,39,39
Штормдоттэр,howling-fjord,1516,demonhunter,havoc,59,31,28
Demonicano,draenor,1516,demonhunter,havoc,271,131,140
Qtt,arthas,1516,demonhunter,havoc,42,19,23
Felledelfine,kazzak,1515,demonhunter,havoc,66,30,36
Zwizch,draenor,1515,demonhunter,havoc,82,37,45
Exceltor,sanguino,1515,demonhunter,havoc,72,28,44
Error,ravencrest,1514,demonhunter,havoc,46,24,22
Dhsheesh,draenor,1514,demonhunter,havoc,48,25,23
Shaihulud,sanguino,1514,demonhunter,havoc,455,233,222
Шахдан,howling-fjord,1514,demonhunter,havoc,179,90,89
Ноубрейндыха,gordunni,1514,demonhunter,havoc,581,292,289
Pêrfêctnôw,blackmoore,1514,demonhunter,havoc,38,18,20
Ардатйякши,borean-tundra,1514,demonhunter,havoc,110,47,63
Фумиан,soulflayer,1513,demonhunter,havoc,100,48,52
Atlizzdh,twisting-nether,1513,demonhunter,havoc,54,25,29
Mephilax,stormscale,1512,demonhunter,havoc,30,17,13
Цэрри,soulflayer,1512,demonhunter,havoc,83,42,41
Sonnefel,tarren-mill,1512,demonhunter,havoc,83,41,42
Ruíko,dun-morogh,1511,demonhunter,havoc,89,45,44
Tetedechaise,archimonde,1509,demonhunter,havoc,30,16,14
Âyoôrts,archimonde,1509,demonhunter,havoc,59,31,28
Iphanaa,frostmane,1509,demonhunter,havoc,128,64,64
Mephîsto,sylvanas,1508,demonhunter,havoc,210,108,102
Glitchx,silvermoon,1508,demonhunter,havoc,78,38,40
Felspîrît,outland,1507,demonhunter,havoc,42,28,14
Ceyye,blackrock,1507,demonhunter,havoc,54,26,28
Драксх,gordunni,1507,demonhunter,havoc,95,44,51
Mâlefiz,blackmoore,1507,demonhunter,havoc,48,22,26
Azaeel,blackhand,1507,demonhunter,havoc,42,17,25
Tenawees,blackmoore,1506,demonhunter,havoc,66,37,29
Lilitlovesme,blackmoore,1506,demonhunter,havoc,42,23,19
Exact,throkferoth,1506,demonhunter,havoc,119,60,59
Boozlike,tarren-mill,1506,demonhunter,havoc,120,60,60
Theaisbae,twisting-nether,1506,demonhunter,havoc,54,25,29
Loria,tyrande,1505,demonhunter,havoc,36,20,16
Camilysu,perenolde,1505,demonhunter,havoc,71,33,38
Änyä,ravencrest,1504,demonhunter,havoc,40,21,19
Shäck,archimonde,1504,demonhunter,havoc,161,84,77
Malami,burning-legion,1503,demonhunter,havoc,36,20,16
Sidekiq,silvermoon,1503,demonhunter,havoc,58,29,29
Duffin,doomhammer,1503,demonhunter,havoc,201,99,102
Danfurtunica,draenor,1503,demonhunter,havoc,75,32,43
Onlyw,ravencrest,1501,demonhunter,havoc,35,27,8
Felsbane,argent-dawn,1501,demonhunter,havoc,27,17,10
Jyzu,festung-der-stürme,1500,demonhunter,havoc,84,44,40
Íllìðåñgøðx,antonidas,1500,demonhunter,havoc,118,57,61
Demonetized,blackrock,1500,demonhunter,havoc,36,17,19
Kreoshimaru,archimonde,1499,demonhunter,havoc,30,20,10
Версомния,gordunni,1498,demonhunter,havoc,66,32,34
Insaneomg,blackmoore,1497,demonhunter,havoc,40,16,24
Saytana,ysondre,1496,demonhunter,havoc,65,33,32
Demonicrage,burning-legion,1495,demonhunter,havoc,32,18,14
Conte,darksorrow,1495,demonhunter,havoc,40,22,18
Агрочика,borean-tundra,1495,demonhunter,havoc,60,28,32
Shironeko,ysondre,1495,demonhunter,havoc,58,27,31
Hanuta,alleria,1495,demonhunter,havoc,48,22,26
Kiirtach,dun-modr,1494,demonhunter,havoc,27,18,9
Blizdliksk,outland,1494,demonhunter,havoc,54,30,24
Parmesano,tyrande,1493,demonhunter,havoc,96,56,40
Elfmonger,ravencrest,1493,demonhunter,havoc,36,21,15
Sofie,aerie-peak,1493,demonhunter,havoc,54,31,23
Fellespont,hellscream,1493,demonhunter,havoc,93,40,53
Drakhiel,hyjal,1491,demonhunter,havoc,36,16,20
Fckmlf,outland,1490,demonhunter,havoc,132,68,64
Эинхерия,soulflayer,1490,demonhunter,havoc,105,49,56
Khalestya,shendralar,1489,demonhunter,havoc,443,227,216
Myztiko,hellscream,1489,demonhunter,havoc,206,105,101
Exoduss,ravencrest,1489,demonhunter,havoc,69,33,36
Échô,tarren-mill,1489,demonhunter,havoc,40,18,22
Xetalar,burning-legion,1488,demonhunter,havoc,204,109,95
Enhtailo,draenor,1488,demonhunter,havoc,42,21,21
Kolrex,ragnaros,1488,demonhunter,havoc,71,35,36
Läderjoel,ravencrest,1488,demonhunter,havoc,71,34,37
Alithy,kazzak,1487,demonhunter,havoc,162,90,72
Malakbel,nemesis,1487,demonhunter,havoc,378,190,188
Xyrs,draenor,1487,demonhunter,havoc,42,21,21
Shylaría,blackhand,1487,demonhunter,havoc,78,35,43
Топдекдх,howling-fjord,1487,demonhunter,havoc,107,41,66
Кайриель,gordunni,1486,demonhunter,havoc,48,29,19
Guccibaby,silvermoon,1486,demonhunter,havoc,108,53,55
Древиал,gordunni,1485,demonhunter,havoc,62,35,27
Покахонта,soulflayer,1484,demonhunter,havoc,100,54,46
Imsickleavme,draenor,1484,demonhunter,havoc,124,62,62
Felguard,darksorrow,1484,demonhunter,havoc,131,62,69
Wârz,aegwynn,1484,demonhunter,havoc,49,23,26
Mëy,thrall,1484,demonhunter,havoc,53,21,32
Malzehar,tarren-mill,1483,demonhunter,havoc,39,22,17
Tmluu,nazjatar,1483,demonhunter,havoc,43,21,22
Grimberg,tarren-mill,1482,demonhunter,havoc,126,66,60
Apokalypsra,blackmoore,1482,demonhunter,havoc,145,73,72
Oonn,outland,1482,demonhunter,havoc,45,21,24
Axxad,ragnaros,1482,demonhunter,havoc,95,42,53
Morskivuk,draenor,1481,demonhunter,havoc,44,26,18
Carnii,ambossar,1481,demonhunter,havoc,54,25,29
Misli,stormscale,1480,demonhunter,havoc,54,29,25
Trinchensdh,blackhand,1480,demonhunter,havoc,72,36,36
Razrsolo,tarren-mill,1479,demonhunter,havoc,171,84,87
Tachala,khaz-modan,1479,demonhunter,havoc,57,24,33
Ülquiorrä,kazzak,1478,demonhunter,havoc,59,38,21
Oggidanbuu,tarren-mill,1478,demonhunter,havoc,49,22,27
Toonsdh,kazzak,1477,demonhunter,havoc,127,71,56
Ларэгар,azuregos,1477,demonhunter,havoc,106,51,55
Tapio,burning-legion,1477,demonhunter,havoc,103,48,55
Экселия,howling-fjord,1476,demonhunter,havoc,119,64,55
Teladrias,ravencrest,1476,demonhunter,havoc,46,24,22
Kanabiz,outland,1476,demonhunter,havoc,346,178,168
Lolbalanced,burning-legion,1475,demonhunter,havoc,83,40,43
Merizane,antonidas,1474,demonhunter,havoc,127,65,62
Safedaddy,silvermoon,1474,demonhunter,havoc,51,23,28
Siio,antonidas,1473,demonhunter,havoc,147,81,66
Netrisha,ravencrest,1473,demonhunter,havoc,84,35,49
Thehûnt,outland,1472,demonhunter,havoc,101,55,46
Ryänåir,ravencrest,1471,demonhunter,havoc,103,51,52
Songur,blackhand,1471,demonhunter,havoc,36,17,19
Cielis,outland,1471,demonhunter,havoc,42,19,23
Treehunter,ravencrest,1470,demonhunter,havoc,30,16,14
Piloudh,dalaran,1469,demonhunter,havoc,56,27,29
Mihaliana,argent-dawn,1468,demonhunter,havoc,69,39,30
Dibo,blackmoore,1468,demonhunter,havoc,141,70,71
Хуракаши,howling-fjord,1468,demonhunter,havoc,39,19,20
Azmodían,silvermoon,1468,demonhunter,havoc,77,36,41
Zitx,ravencrest,1467,demonhunter,havoc,138,71,67
Astartë,stormscale,1466,demonhunter,havoc,72,38,34
Kanéki,sylvanas,1465,demonhunter,havoc,47,33,14
Lydaro,malganis,1465,demonhunter,havoc,54,32,22
Сложныйдх,howling-fjord,1465,demonhunter,havoc,111,59,52
Шалдарон,howling-fjord,1465,demonhunter,havoc,58,30,28
Demonicdingo,lightnings-blade,1465,demonhunter,havoc,128,59,69
Palaurx,kazzak,1464,demonhunter,havoc,59,31,28
Hotshoxx,blackmoore,1464,demonhunter,havoc,54,22,32
Ávto,stormscale,1463,demonhunter,havoc,89,58,31
Tursal,dun-morogh,1463,demonhunter,havoc,63,35,28
Zavoc,the-maelstrom,1462,demonhunter,havoc,51,28,23
Kiwicrash,tarren-mill,1462,demonhunter,havoc,66,32,34
Asylèm,draenor,1462,demonhunter,havoc,83,40,43
Împd,ravencrest,1462,demonhunter,havoc,108,52,56
Obitum,burning-legion,1461,demonhunter,havoc,200,107,93
Yvrig,eredar,1461,demonhunter,havoc,103,55,48
Calcïum,archimonde,1461,demonhunter,havoc,138,58,80
Frevee,outland,1460,demonhunter,havoc,143,78,65
Geashy,blackrock,1460,demonhunter,havoc,82,44,38
Jedbrazander,ragnaros,1460,demonhunter,havoc,54,25,29
Rawrus,blackmoore,1459,demonhunter,havoc,30,18,12
Бичерезх,soulflayer,1459,demonhunter,havoc,73,43,30
Pettitebang,ravencrest,1459,demonhunter,havoc,94,52,42
Mëwë,hyjal,1459,demonhunter,havoc,78,43,35
Kvye,archimonde,1459,demonhunter,havoc,30,16,14
Blîndmaster,ravencrest,1459,demonhunter,havoc,130,65,65
Emmunka,drakthul,1459,demonhunter,havoc,47,23,24
Métakagoule,ysondre,1459,demonhunter,havoc,93,45,48
Kenzaii,aegwynn,1459,demonhunter,havoc,66,29,37
Styxdh,blackhand,1458,demonhunter,havoc,30,16,14
Хорбелий,deathguard,1458,demonhunter,havoc,219,110,109
Этмер,soulflayer,1458,demonhunter,havoc,90,45,45
Feluron,silvermoon,1457,demonhunter,havoc,30,24,6
Остроухйй,blackscar,1457,demonhunter,havoc,78,37,41
Actuallytrol,argent-dawn,1457,demonhunter,havoc,59,27,32
Satanmanna,twisting-nether,1457,demonhunter,havoc,108,49,59
Toddsnuggles,thrall,1456,demonhunter,havoc,60,37,23
Pyleá,malganis,1456,demonhunter,havoc,52,24,28
Aminféryadi,twisting-nether,1455,demonhunter,havoc,244,122,122
Croüp,draenor,1455,demonhunter,havoc,123,59,64
Eliyz,dalaran,1455,demonhunter,havoc,71,29,42
Dirtydoggy,dun-modr,1454,demonhunter,havoc,114,53,61
Felun,turalyon,1453,demonhunter,havoc,96,59,37
Ratho,ragnaros,1453,demonhunter,havoc,59,35,24
Kyru,frostwhisper,1453,demonhunter,havoc,111,63,48
Gïzmó,tarren-mill,1452,demonhunter,havoc,77,33,44
Chrístíe,sanguino,1452,demonhunter,havoc,58,23,35
Vvdh,ravencrest,1451,demonhunter,havoc,40,23,17
Ðhgøðx,outland,1449,demonhunter,havoc,54,30,24
Anklàr,blackrock,1449,demonhunter,havoc,60,30,30
Threathunt,outland,1449,demonhunter,havoc,44,21,23
Cptxo,tarren-mill,1449,demonhunter,havoc,145,69,76
Tenx,auchindoun,1449,demonhunter,havoc,36,16,20
Mylandea,die-aldor,1447,demonhunter,havoc,42,20,22
Munamasa,archimonde,1446,demonhunter,havoc,63,32,31
Ashiharademo,twilights-hammer,1446,demonhunter,havoc,149,75,74
Omegasyx,dun-modr,1445,demonhunter,havoc,91,45,46
Dyamo,sylvanas,1445,demonhunter,havoc,634,312,322
Tòd,silvermoon,1445,demonhunter,havoc,116,57,59
Шэдоуштормх,soulflayer,1444,demonhunter,havoc,112,62,50
Szopóvadász,ragnaros,1444,demonhunter,havoc,48,20,28
Типокрутойдх,howling-fjord,1443,demonhunter,havoc,24,19,5
Adraelia,archimonde,1443,demonhunter,havoc,119,66,53
Vexblade,silvermoon,1443,demonhunter,havoc,290,154,136
Afuwarrior,doomhammer,1443,demonhunter,havoc,118,62,56
Telarris,twisting-nether,1443,demonhunter,havoc,406,212,194
Føresight,blackmoore,1443,demonhunter,havoc,47,21,26
Malveross,argent-dawn,1442,demonhunter,havoc,53,29,24
Itheos,kazzak,1442,demonhunter,havoc,252,129,123
Balsza,burning-legion,1441,demonhunter,havoc,90,48,42
Philona,die-aldor,1441,demonhunter,havoc,174,91,83
Arconta,blackmoore,1441,demonhunter,havoc,56,26,30
Ázârìûs,draenor,1440,demonhunter,havoc,48,22,26
Luzifer,ambossar,1439,demonhunter,havoc,468,240,228
Дашажмимету,blackscar,1439,demonhunter,havoc,32,16,16
Opsidaisi,tarren-mill,1438,demonhunter,havoc,42,16,26
Nerudas,blackhand,1436,demonhunter,havoc,42,24,18
Bamßi,ragnaros,1436,demonhunter,havoc,36,16,20
Fiepsy,alexstrasza,1435,demonhunter,havoc,50,26,24
Sghemon,pozzo-delleternità,1435,demonhunter,havoc,30,15,15
Bippsy,zuljin,1434,demonhunter,havoc,79,44,35
Jïsoo,blackhand,1434,demonhunter,havoc,46,22,24
Wrakdh,archimonde,1433,demonhunter,havoc,68,43,25
Раудвейф,gordunni,1433,demonhunter,havoc,24,15,9
Isp,kazzak,1433,demonhunter,havoc,96,49,47
Shõ,twisting-nether,1433,demonhunter,havoc,42,15,27
Vèga,thrall,1432,demonhunter,havoc,27,16,11
Kélida,dun-modr,1432,demonhunter,havoc,78,33,45
Ashrena,ysondre,1431,demonhunter,havoc,48,32,16
Skyborn,tarren-mill,1431,demonhunter,havoc,93,50,43
Деструкцыя,howling-fjord,1431,demonhunter,havoc,69,37,32
Albunico,draenor,1431,demonhunter,havoc,147,77,70
Дэйнни,blackscar,1431,demonhunter,havoc,75,37,38
Кирсена,gordunni,1431,demonhunter,havoc,137,66,71
Sionar,kazzak,1430,demonhunter,havoc,54,31,23
Kaylaz,eredar,1430,demonhunter,havoc,75,41,34
Daemis,dun-modr,1430,demonhunter,havoc,59,31,28
Nvampire,draenor,1429,demonhunter,havoc,24,17,7
Coca,stormreaver,1429,demonhunter,havoc,84,46,38
Felcaller,sylvanas,1429,demonhunter,havoc,87,46,41
Rejstan,drakthul,1428,demonhunter,havoc,24,15,9
Djaskmazi,archimonde,1428,demonhunter,havoc,42,15,27
Mareen,pozzo-delleternità,1427,demonhunter,havoc,60,31,29
Øbsessiøn,kazzak,1427,demonhunter,havoc,131,65,66
Gagfordaddy,ravencrest,1427,demonhunter,havoc,36,15,21
Zopekztropek,burning-legion,1426,demonhunter,havoc,78,45,33
Stellarvore,nemesis,1426,demonhunter,havoc,215,105,110
Impatìence,tarren-mill,1426,demonhunter,havoc,54,24,30
Kîrîto,nethersturm,1426,demonhunter,havoc,47,16,31
Hyggéè,sanguino,1424,demonhunter,havoc,78,42,36
Daiten,outland,1424,demonhunter,havoc,59,31,28
Exodlia,silvermoon,1424,demonhunter,havoc,60,31,29
Fruttidimare,frostwolf,1424,demonhunter,havoc,165,85,80
Deponiajkm,dun-modr,1424,demonhunter,havoc,30,15,15
Slaanesh,xavius,1423,demonhunter,havoc,45,27,18
Satti,sargeras,1423,demonhunter,havoc,36,15,21
Scarebearz,outland,1422,demonhunter,havoc,276,151,125
Бропинг,soulflayer,1422,demonhunter,havoc,308,163,145
Luckertwo,tarren-mill,1422,demonhunter,havoc,283,147,136
Ämi,blackmoore,1422,demonhunter,havoc,142,71,71
Megrella,stormscale,1422,demonhunter,havoc,198,98,100
Stickihunt,malganis,1422,demonhunter,havoc,36,15,21
Slinks,silvermoon,1421,demonhunter,havoc,107,58,49
Icelucard,argent-dawn,1421,demonhunter,havoc,123,64,59
Chaosfist,blackrock,1421,demonhunter,havoc,79,41,38
Tayo,dun-modr,1421,demonhunter,havoc,71,35,36
Emerelle,die-aldor,1421,demonhunter,havoc,227,108,119
Zumei,stormreaver,1420,demonhunter,havoc,104,53,51
Miyabí,drakthul,1420,demonhunter,havoc,87,35,52
Лолбичьпро,blackscar,1419,demonhunter,havoc,77,46,31
Алькирена,howling-fjord,1419,demonhunter,havoc,84,45,39
Syonis,archimonde,1419,demonhunter,havoc,73,39,34
Cheethless,ragnaros,1419,demonhunter,havoc,72,38,34
Ziltush,archimonde,1419,demonhunter,havoc,191,94,97
Yeéydh,tarren-mill,1419,demonhunter,havoc,64,29,35
Karakas,drakthul,1418,demonhunter,havoc,54,29,25
Spankoproof,kazzak,1418,demonhunter,havoc,30,16,14
Wolfsøng,tarren-mill,1418,demonhunter,havoc,102,49,53
Aphulucky,kazzak,1418,demonhunter,havoc,48,21,27
Zlett,draenor,1418,demonhunter,havoc,46,19,27
Biü,tarren-mill,1418,demonhunter,havoc,42,16,26
Коньх,goldrinn,1417,demonhunter,havoc,134,63,71
Сочняга,gordunni,1417,demonhunter,havoc,42,15,27
Demogen,sylvanas,1415,demonhunter,havoc,234,123,111
Razziyel,ragnaros,1415,demonhunter,havoc,65,33,32
Mìrkø,nemesis,1415,demonhunter,havoc,58,29,29
Dvex,stormscale,1415,demonhunter,havoc,30,15,15
Мужна,grom,1415,demonhunter,havoc,106,52,54
Такетомии,gordunni,1415,demonhunter,havoc,58,25,33
Storetal,ravencrest,1414,demonhunter,havoc,36,23,13
Cassitä,chogall,1414,demonhunter,havoc,102,56,46
Alury,blackrock,1414,demonhunter,havoc,78,41,37
Дахану,soulflayer,1414,demonhunter,havoc,106,47,59
Adalya,stormrage,1412,demonhunter,havoc,116,53,63
Funclass,blackrock,1411,demonhunter,havoc,24,15,9
Havocnslash,ragnaros,1411,demonhunter,havoc,42,23,19
Demøniac,ravencrest,1411,demonhunter,havoc,190,97,93
Arnokia,kazzak,1411,demonhunter,havoc,156,75,81
Келадор,soulflayer,1411,demonhunter,havoc,155,74,81
Straizo,malganis,1411,demonhunter,havoc,38,18,20
Вирбль,gordunni,1411,demonhunter,havoc,95,39,56
Sua,outland,1408,demonhunter,havoc,166,87,79
Smoochygodx,antonidas,1408,demonhunter,havoc,180,94,86
Yäkku,drakthul,1408,demonhunter,havoc,148,71,77
Рагнос,goldrinn,1408,demonhunter,havoc,48,16,32
Jennyßright,sargeras,1407,demonhunter,havoc,24,15,9
Maddjakni,draenor,1406,demonhunter,havoc,38,22,16
Осхимс,deathguard,1406,demonhunter,havoc,239,130,109
Beörn,stormscale,1405,demonhunter,havoc,71,28,43
Харольд,deepholm,1404,demonhunter,havoc,107,54,53
Xîr,silvermoon,1404,demonhunter,havoc,30,15,15
Divnapani,drakthul,1404,demonhunter,havoc,36,17,19
Choclatballs,stormscale,1404,demonhunter,havoc,125,59,66
Ulthil,confrérie-du-thorium,1403,demonhunter,havoc,25,15,10
Gwx,draenor,1403,demonhunter,havoc,146,71,75
Glerog,ragnaros,1402,demonhunter,havoc,48,25,23
Monkeypox,twisting-nether,1402,demonhunter,havoc,196,95,101
Spheria,outland,1402,demonhunter,havoc,243,110,133
Sayee,drakthul,1401,demonhunter,havoc,36,23,13
Orenrg,dun-modr,1401,demonhunter,havoc,88,53,35
Xpllen,shadowsong,1401,demonhunter,havoc,30,16,14
Tkr,zuljin,1401,demonhunter,havoc,120,63,57
Vaynahi,grim-batol,1401,demonhunter,havoc,72,36,36
Баттлрэп,soulflayer,1401,demonhunter,havoc,92,42,50
Pówèr,ravencrest,1400,demonhunter,havoc,84,45,39
Morphiyy,tarren-mill,1400,demonhunter,havoc,54,28,26
Thugrøse,blackrock,1400,demonhunter,havoc,201,101,100
Natzú,ravencrest,1400,demonhunter,havoc,54,23,31
Archadric,ravencrest,1399,demonhunter,havoc,59,30,29
Varedisa,kazzak,1399,demonhunter,havoc,140,69,71
Tyhaxx,ravencrest,1399,demonhunter,havoc,102,48,54
Watchmepoop,stormscale,1398,demonhunter,havoc,45,27,18
Åelita,burning-legion,1398,demonhunter,havoc,50,24,26
Sakumi,azshara,1398,demonhunter,havoc,219,102,117
Wìxx,blackrock,1398,demonhunter,havoc,41,17,24
Skyzon,ravencrest,1396,demonhunter,havoc,35,19,16
Нейроуз,howling-fjord,1396,demonhunter,havoc,166,90,76
Tôryon,archimonde,1396,demonhunter,havoc,36,17,19
Demonbean,stormscale,1396,demonhunter,havoc,52,23,29
Дартарин,gordunni,1395,demonhunter,havoc,62,34,28
Dawnsbreaker,twisting-nether,1395,demonhunter,havoc,48,19,29
Sadzari,burning-legion,1394,demonhunter,havoc,30,15,15
Aååááååââåâå,arygos,1394,demonhunter,havoc,30,15,15
Нуунас,soulflayer,1394,demonhunter,havoc,201,95,106
Immune,aegwynn,1394,demonhunter,havoc,36,17,19
Morvash,nemesis,1393,demonhunter,havoc,114,59,55
Artï,ravencrest,1392,demonhunter,havoc,34,20,14
Pichkachu,sylvanas,1392,demonhunter,havoc,66,35,31
Нокаруру,gordunni,1392,demonhunter,havoc,66,32,34
Nanana,doomhammer,1392,demonhunter,havoc,198,95,103
Culywurly,silvermoon,1392,demonhunter,havoc,66,30,36
Dharuel,cthun,1392,demonhunter,havoc,60,25,35
Testôdh,blackrock,1392,demonhunter,havoc,52,18,34
Extraxtreme,ravencrest,1391,demonhunter,havoc,30,20,10
Brisingamen,outland,1390,demonhunter,havoc,94,45,49
Nørkos,ysondre,1387,demonhunter,havoc,28,16,12
Kamaz,twisting-nether,1387,demonhunter,havoc,87,45,42
Jazhz,dalaran,1386,demonhunter,havoc,66,31,35
Ihløøx,minahonda,1385,demonhunter,havoc,110,54,56
Slyblades,tarren-mill,1384,demonhunter,havoc,180,90,90
Неффкодх,howling-fjord,1384,demonhunter,havoc,97,44,53
Dzidch,silvermoon,1383,demonhunter,havoc,48,26,22
Hupon,drakthul,1383,demonhunter,havoc,63,34,29
Гарражж,howling-fjord,1383,demonhunter,havoc,30,16,14
Hatemrankone,outland,1383,demonhunter,havoc,51,23,28
Valkorion,chamber-of-aspects,1382,demonhunter,havoc,51,23,28
Эридали,gordunni,1381,demonhunter,havoc,129,67,62
Иллиферрат,blackscar,1381,demonhunter,havoc,370,185,185
Thalamis,kazzak,1381,demonhunter,havoc,142,68,74
Snøwdh,outland,1380,demonhunter,havoc,27,16,11
Imlegalblind,ragnaros,1380,demonhunter,havoc,106,48,58
Тушино,lich-king,1379,demonhunter,havoc,36,23,13
Avnanof,draenor,1379,demonhunter,havoc,30,15,15
Testorex,kazzak,1379,demonhunter,havoc,47,21,26
Súrinox,blackrock,1377,demonhunter,havoc,92,53,39
Jesana,argent-dawn,1377,demonhunter,havoc,157,78,79
Moonbeàm,kazzak,1377,demonhunter,havoc,79,35,44
Undefeatable,stormrage,1376,demonhunter,havoc,30,17,13
Kírstén,draenor,1375,demonhunter,havoc,29,15,14
Venge,la-croisade-écarlate,1375,demonhunter,havoc,69,34,35
Æä,draenor,1375,demonhunter,havoc,89,40,49
Fotmfgt,eredar,1373,demonhunter,havoc,42,19,23
Zamp,deathwing,1373,demonhunter,havoc,51,23,28
Anstict,kazzak,1371,demonhunter,havoc,48,22,26
Seedor,archimonde,1370,demonhunter,havoc,116,58,58
Bloodconte,darksorrow,1369,demonhunter,havoc,28,17,11
Baileeh,blackmoore,1369,demonhunter,havoc,42,23,19
Trekxx,ragnaros,1369,demonhunter,havoc,126,67,59
Scotcheggs,argent-dawn,1369,demonhunter,havoc,191,97,94
Strikeforce,burning-legion,1369,demonhunter,havoc,72,31,41
Kouloukas,ragnaros,1369,demonhunter,havoc,42,17,25
Ragingbladex,kazzak,1368,demonhunter,havoc,73,38,35
Никкэс,gordunni,1368,demonhunter,havoc,72,37,35
Тириола,howling-fjord,1368,demonhunter,havoc,55,28,27
Miragirl,stormscale,1368,demonhunter,havoc,74,35,39
Fulger,ghostlands,1368,demonhunter,havoc,78,34,44
Adapterinput,auchindoun,1367,demonhunter,havoc,132,69,63
Seyran,silvermoon,1367,demonhunter,havoc,30,15,15
Yugsiturath,drakthul,1367,demonhunter,havoc,122,59,63
Poutanaola,twisting-nether,1365,demonhunter,havoc,30,15,15
Иланари,gordunni,1364,demonhunter,havoc,65,39,26
Saiyanblue,tarren-mill,1364,demonhunter,havoc,32,18,14
Хайзи,gordunni,1364,demonhunter,havoc,54,29,25
Glavesong,burning-legion,1364,demonhunter,havoc,63,31,32
Pidkova,tarren-mill,1363,demonhunter,havoc,68,31,37
Nezruslfive,dun-modr,1362,demonhunter,havoc,54,27,27
Убийца,soulflayer,1362,demonhunter,havoc,76,37,39
Kerog,blackmoore,1362,demonhunter,havoc,71,29,42
Илизарнный,gordunni,1362,demonhunter,havoc,42,17,25
Jyrpä,stormscale,1361,demonhunter,havoc,77,42,35
Zephyrê,blackrock,1361,demonhunter,havoc,164,83,81
Koralentprix,twisting-nether,1361,demonhunter,havoc,56,24,32
Natazia,eredar,1360,demonhunter,havoc,105,56,49
Liondrix,sanguino,1360,demonhunter,havoc,87,46,41
Methyza,thrall,1356,demonhunter,havoc,51,31,20
Nadok,tarren-mill,1356,demonhunter,havoc,48,24,24
Beerseewälk,ragnaros,1356,demonhunter,havoc,88,41,47
Savagee,ragnaros,1355,demonhunter,havoc,128,59,69
Persiana,dun-modr,1354,demonhunter,havoc,84,36,48
Aryuna,frostwolf,1353,demonhunter,havoc,39,24,15
Fleshes,draenor,1353,demonhunter,havoc,45,22,23
Djaris,ghostlands,1352,demonhunter,havoc,24,16,8
Ðraudræm,ravencrest,1352,demonhunter,havoc,143,70,73
Fùth,ysondre,1350,demonhunter,havoc,47,18,29
Garretos,senjin,1349,demonhunter,havoc,49,29,20
Hairyjapgirl,silvermoon,1349,demonhunter,havoc,70,39,31
Lockmylips,kazzak,1348,demonhunter,havoc,110,52,58
Sokal,dun-modr,1348,demonhunter,havoc,110,48,62
Devilord,sanguino,1347,demonhunter,havoc,30,16,14
Stringsz,ragnaros,1346,demonhunter,havoc,202,115,87
Dayo,archimonde,1346,demonhunter,havoc,84,36,48
Ikari,neptulon,1345,demonhunter,havoc,92,50,42
Wauway,ragnaros,1344,demonhunter,havoc,54,27,27
Ðezs,dun-modr,1343,demonhunter,havoc,24,14,10
Bosskuw,kazzak,1343,demonhunter,havoc,24,14,10
Reckqqt,eredar,1343,demonhunter,havoc,24,14,10
Isila,alakir,1343,demonhunter,havoc,264,125,139
Flowen,stormreaver,1343,demonhunter,havoc,60,28,32
Brolafsen,tarren-mill,1342,demonhunter,havoc,24,14,10
Héy,turalyon,1342,demonhunter,havoc,30,15,15
Watnntietnn,burning-blade,1342,demonhunter,havoc,126,61,65
Koger,twisting-nether,1342,demonhunter,havoc,30,14,16
Teletubby,blackrock,1342,demonhunter,havoc,36,14,22
Kibiri,rajaxx,1341,demonhunter,havoc,36,14,22
Дхашуля,gordunni,1340,demonhunter,havoc,30,18,12
Даблкорк,soulflayer,1340,demonhunter,havoc,125,70,55
Illídana,azjolnerub,1340,demonhunter,havoc,62,32,30
Kékw,stormscale,1340,demonhunter,havoc,267,136,131
Piedonzo,nemesis,1340,demonhunter,havoc,36,14,22
Daemonai,neptulon,1339,demonhunter,havoc,120,61,59
Newgens,kazzak,1339,demonhunter,havoc,30,14,16
Lifel,nemesis,1339,demonhunter,havoc,56,26,30
Rehagen,ysondre,1339,demonhunter,havoc,36,14,22
Daekon,ahnqiraj,1337,demonhunter,havoc,72,29,43
Dhogge,emerald-dream,1337,demonhunter,havoc,36,14,22
Ðeadínside,kazzak,1336,demonhunter,havoc,24,14,10
Kaitlyyn,norgannon,1335,demonhunter,havoc,54,25,29
Kainenn,silvermoon,1335,demonhunter,havoc,60,26,34
Hawoc,chamber-of-aspects,1334,demonhunter,havoc,42,26,16
Thulânn,twisting-nether,1334,demonhunter,havoc,30,14,16
Onlytwokeys,dun-modr,1333,demonhunter,havoc,102,51,51
ßroken,ragnaros,1333,demonhunter,havoc,30,14,16
Sinninse,blackmoore,1332,demonhunter,havoc,48,27,21
Ziplar,tarren-mill,1332,demonhunter,havoc,107,52,55
Armás,stormscale,1332,demonhunter,havoc,36,14,22
Lexim,khaz-modan,1331,demonhunter,havoc,72,40,32
Kratton,silvermoon,1331,demonhunter,havoc,54,28,26
Amylia,perenolde,1331,demonhunter,havoc,58,27,31
Irenzy,twisting-nether,1331,demonhunter,havoc,36,14,22
Kurvamrusna,kazzak,1330,demonhunter,havoc,24,14,10
Мейьибейьи,howling-fjord,1330,demonhunter,havoc,30,15,15
Äzräël,dun-modr,1330,demonhunter,havoc,138,62,76
Грингекс,gordunni,1330,demonhunter,havoc,36,16,20
Notcrashy,eredar,1329,demonhunter,havoc,35,22,13
Checakore,argent-dawn,1329,demonhunter,havoc,66,34,32
Níghtwing,wildhammer,1329,demonhunter,havoc,83,39,44
Шмальнуть,gordunni,1329,demonhunter,havoc,78,34,44
Demozzer,ravencrest,1328,demonhunter,havoc,73,41,32
Батявздане,soulflayer,1328,demonhunter,havoc,58,32,26
Nxtpls,silvermoon,1327,demonhunter,havoc,99,48,51
Сильверган,soulflayer,1326,demonhunter,havoc,323,166,157
Shreddern,ragnaros,1326,demonhunter,havoc,73,37,36
Gurvan,kazzak,1325,demonhunter,havoc,96,50,46
Ghiocelulog,draenor,1325,demonhunter,havoc,103,52,51
Soca,ysondre,1325,demonhunter,havoc,72,33,39
Kintschy,ragnaros,1325,demonhunter,havoc,48,21,27
Стрепа,grom,1324,demonhunter,havoc,135,77,58
Zayl,defias-brotherhood,1324,demonhunter,havoc,97,42,55
Егордемон,soulflayer,1323,demonhunter,havoc,46,25,21
Iaml,ravencrest,1323,demonhunter,havoc,67,32,35
Ibnia,azjolnerub,1323,demonhunter,havoc,32,14,18
Muharaar,ravencrest,1322,demonhunter,havoc,28,16,12
Riema,bloodscalp,1322,demonhunter,havoc,52,29,23
Destructs,sylvanas,1321,demonhunter,havoc,67,33,34
Kâtsulol,ysondre,1321,demonhunter,havoc,30,14,16
Кельселай,soulflayer,1321,demonhunter,havoc,42,16,26
Quakes,pozzo-delleternità,1319,demonhunter,havoc,78,43,35
Bluespe,twisting-nether,1318,demonhunter,havoc,102,53,49
Ragnirok,deathwing,1318,demonhunter,havoc,138,66,72
Illyriel,antonidas,1318,demonhunter,havoc,100,45,55
Felleaf,ragnaros,1318,demonhunter,havoc,64,27,37
Medievils,silvermoon,1317,demonhunter,havoc,224,107,117
Ascanius,nemesis,1316,demonhunter,havoc,142,83,59
Dadbodxd,stormscale,1315,demonhunter,havoc,42,22,20
Lexuirca,tarren-mill,1315,demonhunter,havoc,48,23,25
Øæø,turalyon,1315,demonhunter,havoc,30,14,16
Sarissa,dun-modr,1314,demonhunter,havoc,48,29,19
Posterboy,tarren-mill,1314,demonhunter,havoc,67,34,33
Noitradh,zuljin,1313,demonhunter,havoc,27,15,12
Mâdîta,todeswache,1313,demonhunter,havoc,30,16,14
Bestdemon,tarren-mill,1313,demonhunter,havoc,57,29,28
Obey,exodar,1312,demonhunter,havoc,47,22,25
Jayhan,chamber-of-aspects,1311,demonhunter,havoc,68,37,31
Darksink,kazzak,1311,demonhunter,havoc,72,39,33
Райкан,soulflayer,1311,demonhunter,havoc,54,23,31
Дисофи,soulflayer,1310,demonhunter,havoc,96,45,51
Eviljunior,blackhand,1310,demonhunter,havoc,78,36,42
Nightglaives,twisting-nether,1309,demonhunter,havoc,30,18,12
Valendriel,archimonde,1309,demonhunter,havoc,117,60,57
Полетела,gordunni,1308,demonhunter,havoc,75,38,37
Kaizzy,twisting-nether,1307,demonhunter,havoc,142,75,67
Slowcuzclick,stormscale,1307,demonhunter,havoc,85,44,41
Порядокх,soulflayer,1306,demonhunter,havoc,36,21,15
Kalr,silvermoon,1306,demonhunter,havoc,85,45,40
Naxuitawowa,quelthalas,1306,demonhunter,havoc,42,17,25
Тарапынька,gordunni,1305,demonhunter,havoc,158,83,75
Thëos,argent-dawn,1305,demonhunter,havoc,132,66,66
Damenhunter,malganis,1305,demonhunter,havoc,42,18,24
Illidarya,dunemaul,1305,demonhunter,havoc,42,17,25
Batghoul,laughing-skull,1304,demonhunter,havoc,29,16,13
Gruusha,kazzak,1304,demonhunter,havoc,36,17,19
Headlessdh,ragnaros,1302,demonhunter,havoc,132,63,69
Каралас,soulflayer,1301,demonhunter,havoc,36,21,15
Demonpun,the-venture-co,1301,demonhunter,havoc,76,40,36
Эфемерид,howling-fjord,1301,demonhunter,havoc,36,18,18
Lucthedané,ravencrest,1300,demonhunter,havoc,36,14,22
Felni,lightbringer,1299,demonhunter,havoc,66,38,28
Picotea,argent-dawn,1298,demonhunter,havoc,30,20,10
Sephiris,argent-dawn,1298,demonhunter,havoc,37,23,14
Синяша,howling-fjord,1295,demonhunter,havoc,66,31,35
Тэлэсык,gordunni,1295,demonhunter,havoc,45,20,25
Жемчужинка,eversong,1293,demonhunter,havoc,83,41,42
Охотникн,howling-fjord,1293,demonhunter,havoc,66,27,39
Orochimaruu,kargath,1293,demonhunter,havoc,99,39,60
Unreally,tarren-mill,1292,demonhunter,havoc,39,15,24
Кейсимег,soulflayer,1290,demonhunter,havoc,326,160,166
Byakugaan,drakthul,1289,demonhunter,havoc,84,45,39
Venøøm,eldrethalas,1289,demonhunter,havoc,144,75,69
Harha,stormscale,1289,demonhunter,havoc,81,40,41
Jahannam,ysondre,1288,demonhunter,havoc,96,47,49
Bicskas,ragnaros,1288,demonhunter,havoc,51,21,30
Аликана,blackscar,1288,demonhunter,havoc,48,19,29
Száraz,ragnaros,1288,demonhunter,havoc,54,19,35
Maryjane,nordrassil,1287,demonhunter,havoc,90,53,37
Mowiemow,argent-dawn,1287,demonhunter,havoc,29,14,15
Féileacán,kazzak,1286,demonhunter,havoc,48,20,28
Ápölö,zuljin,1286,demonhunter,havoc,36,14,22
Makri,outland,1285,demonhunter,havoc,198,105,93
Луксория,soulflayer,1285,demonhunter,havoc,82,38,44
Kídazi,draenor,1285,demonhunter,havoc,41,16,25
Jëtman,ravencrest,1284,demonhunter,havoc,62,37,25
Nasghul,drakthul,1284,demonhunter,havoc,66,30,36
Sarrabulho,magtheridon,1284,demonhunter,havoc,72,32,40
Кевалат,gordunni,1283,demonhunter,havoc,42,26,16
Sangita,tarren-mill,1283,demonhunter,havoc,105,56,49
Nyach,kazzak,1282,demonhunter,havoc,60,28,32
Реалистик,deathweaver,1282,demonhunter,havoc,133,62,71
Billidan,eredar,1282,demonhunter,havoc,54,25,29
Gnaget,the-maelstrom,1282,demonhunter,havoc,42,18,24
Æroa,antonidas,1281,demonhunter,havoc,56,30,26
Wårbÿ,ravencrest,1281,demonhunter,havoc,36,15,21
Actarüs,hyjal,1281,demonhunter,havoc,48,16,32
Ozeey,draenor,1280,demonhunter,havoc,29,14,15
Lîllîv,wrathbringer,1279,demonhunter,havoc,65,30,35
Зографос,fordragon,1276,demonhunter,havoc,29,16,13
Ebache,darksorrow,1276,demonhunter,havoc,106,50,56
Saehila,kirin-tor,1276,demonhunter,havoc,149,70,79
Demonguard,draenor,1275,demonhunter,havoc,195,99,96
Shytan,tarren-mill,1275,demonhunter,havoc,104,48,56
Clexa,thrall,1275,demonhunter,havoc,36,15,21
Shinydari,kazzak,1275,demonhunter,havoc,36,14,22
Даудаев,gordunni,1274,demonhunter,havoc,78,42,36
Fikyx,draenor,1274,demonhunter,havoc,152,77,75
Calthmon,shattrath,1274,demonhunter,havoc,37,15,22
Dârhma,archimonde,1273,demonhunter,havoc,77,44,33
Эндимэн,soulflayer,1273,demonhunter,havoc,133,71,62
Нксин,howling-fjord,1273,demonhunter,havoc,42,21,21
Laholdrops,chants-éternels,1273,demonhunter,havoc,29,14,15
Apsodemon,twisting-nether,1272,demonhunter,havoc,22,15,7
Shishiro,alakir,1272,demonhunter,havoc,78,41,37
Øutsider,blackmoore,1272,demonhunter,havoc,143,71,72
Zuldekdh,sanguino,1272,demonhunter,havoc,30,14,16
Adroenz,twisting-nether,1272,demonhunter,havoc,54,23,31
Pleskdh,malganis,1272,demonhunter,havoc,54,23,31
Louloulou,aegwynn,1271,demonhunter,havoc,123,65,58
Tzigonline,silvermoon,1271,demonhunter,havoc,41,17,24
Estheris,sylvanas,1270,demonhunter,havoc,69,41,28
Konoth,kirin-tor,1269,demonhunter,havoc,111,57,54
Yamiagitosan,burning-legion,1269,demonhunter,havoc,77,39,38
Asmedios,twisting-nether,1269,demonhunter,havoc,710,356,354
Этимму,gordunni,1269,demonhunter,havoc,176,84,92
Nephylon,draenor,1268,demonhunter,havoc,30,15,15
Symbul,blackrock,1268,demonhunter,havoc,115,56,59
Tharysan,sanguino,1267,demonhunter,havoc,72,41,31
Ilyerias,twisting-nether,1267,demonhunter,havoc,131,57,74
Schonevrouw,aszune,1265,demonhunter,havoc,66,38,28
Minutte,twisting-nether,1265,demonhunter,havoc,48,27,21
Gamaö,khaz-modan,1265,demonhunter,havoc,41,16,25
Дримриэль,gordunni,1264,demonhunter,havoc,37,16,21
Grimrippa,the-maelstrom,1264,demonhunter,havoc,41,17,24
Luceafaru,draenor,1264,demonhunter,havoc,42,14,28
Goatcorpse,blackmoore,1263,demonhunter,havoc,66,33,33
Ìllídán,ravencrest,1261,demonhunter,havoc,140,73,67
Nÿnx,archimonde,1261,demonhunter,havoc,53,25,28
Anödyth,kirin-tor,1261,demonhunter,havoc,51,23,28
Coltender,drakthul,1260,demonhunter,havoc,91,42,49
Maeb,cthun,1259,demonhunter,havoc,60,25,35
Zejza,ragnaros,1257,demonhunter,havoc,85,41,44
Hirbs,silvermoon,1257,demonhunter,havoc,78,35,43
Yorkaj,kazzak,1257,demonhunter,havoc,126,52,74
Killeedan,darksorrow,1257,demonhunter,havoc,36,14,22
Милинайт,eversong,1256,demonhunter,havoc,30,17,13
Chapzi,ragnaros,1256,demonhunter,havoc,51,26,25
Gurthalak,alakir,1256,demonhunter,havoc,59,30,29
Sindweller,arathi,1256,demonhunter,havoc,40,16,24
Azkerash,draenor,1255,demonhunter,havoc,82,38,44
Bessus,aggra-português,1254,demonhunter,havoc,82,43,39
Waviel,burning-legion,1254,demonhunter,havoc,59,27,32
Vaterdenke,defias-brotherhood,1253,demonhunter,havoc,30,19,11
Azâdi,blackhand,1253,demonhunter,havoc,36,20,16
Azn,twisting-nether,1253,demonhunter,havoc,56,23,33
Zøóm,tarren-mill,1250,demonhunter,havoc,24,14,10
Bosque,ragnaros,1249,demonhunter,havoc,66,33,33
Sesrix,silvermoon,1248,demonhunter,havoc,55,29,26
Maat,anetheron,1248,demonhunter,havoc,43,18,25
Norac,silvermoon,1248,demonhunter,havoc,41,16,25
Sweåfy,outland,1247,demonhunter,havoc,18,13,5
Anwenox,argent-dawn,1247,demonhunter,havoc,18,13,5
Ironjòe,eredar,1247,demonhunter,havoc,30,14,16
Shinsen,archimonde,1247,demonhunter,havoc,36,16,20
Aleydan,shattered-hand,1247,demonhunter,havoc,48,21,27
Mentallybòóm,tarren-mill,1247,demonhunter,havoc,30,13,17
Fróstdh,ravencrest,1247,demonhunter,havoc,30,13,17
Bläckdëvïl,uldum,1246,demonhunter,havoc,58,33,25
Lögan,uldum,1246,demonhunter,havoc,60,34,26
Ittas,archimonde,1246,demonhunter,havoc,24,13,11
Izzidan,magtheridon,1246,demonhunter,havoc,27,14,13
Slinks,ragnaros,1246,demonhunter,havoc,223,104,119
Kalî,forscherliga,1245,demonhunter,havoc,30,17,13
Daweeo,the-maelstrom,1245,demonhunter,havoc,30,17,13
Valen,die-aldor,1245,demonhunter,havoc,88,40,48
Fyell,antonidas,1244,demonhunter,havoc,24,13,11
Kimberleh,doomhammer,1243,demonhunter,havoc,24,13,11
Geneset,nozdormu,1243,demonhunter,havoc,30,13,17
Ilídos,blackmoore,1243,demonhunter,havoc,92,39,53
Imvnrcvr,dalaran,1242,demonhunter,havoc,24,13,11
Maddhxo,drakthul,1242,demonhunter,havoc,24,13,11
Falanar,ysondre,1242,demonhunter,havoc,30,13,17
Lyzzra,blackmoore,1241,demonhunter,havoc,30,13,17
Vulcaan,ravencrest,1241,demonhunter,havoc,30,13,17
Verrottung,blackhand,1240,demonhunter,havoc,24,13,11
Ðarckjojo,hyjal,1240,demonhunter,havoc,94,44,50
Hakakuri,ravencrest,1240,demonhunter,havoc,30,14,16
Nidorino,aegwynn,1240,demonhunter,havoc,30,13,17
Drushii,shattrath,1240,demonhunter,havoc,30,13,17
Bignugs,ravencrest,1240,demonhunter,havoc,36,13,23
Жаркийсекс,soulflayer,1240,demonhunter,havoc,54,19,35
Leäf,drakthul,1239,demonhunter,havoc,36,18,18
Илджес,gordunni,1239,demonhunter,havoc,42,13,29
Momochi,silvermoon,1238,demonhunter,havoc,50,24,26
Illidanio,xavius,1238,demonhunter,havoc,76,33,43
Galuna,deathwing,1238,demonhunter,havoc,31,13,18
Ekhlipz,ysondre,1238,demonhunter,havoc,42,13,29
Lùcîfer,hellfire,1237,demonhunter,havoc,108,53,55
Siljima,tarren-mill,1237,demonhunter,havoc,36,13,23
Xellnaga,twisting-nether,1236,demonhunter,havoc,38,18,20
Nekkëtsu,archimonde,1235,demonhunter,havoc,24,13,11
Грешный,gordunni,1235,demonhunter,havoc,24,13,11
Aloii,kazzak,1235,demonhunter,havoc,48,24,24
Niniach,burning-legion,1235,demonhunter,havoc,30,13,17
Solrosfrön,stormscale,1234,demonhunter,havoc,28,14,14
Сумърак,grom,1234,demonhunter,havoc,212,102,110
Qvn,sylvanas,1233,demonhunter,havoc,24,13,11
Demonjay,stormscale,1233,demonhunter,havoc,28,14,14
Mirajen,dun-modr,1233,demonhunter,havoc,36,17,19
Easywaay,kazzak,1233,demonhunter,havoc,128,60,68
Titanslayyer,azjolnerub,1233,demonhunter,havoc,30,13,17
Drahîna,khaz-modan,1232,demonhunter,havoc,38,16,22
Juha,bronze-dragonflight,1231,demonhunter,havoc,69,38,31
Mamazboy,lightnings-blade,1229,demonhunter,havoc,35,20,15
Fôns,sanguino,1227,demonhunter,havoc,18,13,5
Inasyndre,argent-dawn,1226,demonhunter,havoc,30,13,17
Alfaa,outland,1225,demonhunter,havoc,32,15,17
Soo,aerie-peak,1224,demonhunter,havoc,18,13,5
Katheros,garrosh,1224,demonhunter,havoc,72,41,31
Hannipham,silvermoon,1224,demonhunter,havoc,47,25,22
Manavoid,outland,1223,demonhunter,havoc,30,15,15
Дитяхаоса,howling-fjord,1223,demonhunter,havoc,90,40,50
Brazahart,silvermoon,1223,demonhunter,havoc,102,44,58
Abhimanyu,ravencrest,1223,demonhunter,havoc,73,30,43
Hatred,argent-dawn,1223,demonhunter,havoc,36,14,22
Nikkidesaint,twisting-nether,1220,demonhunter,havoc,24,14,10
Овецловец,deathguard,1220,demonhunter,havoc,24,13,11
Defjax,argent-dawn,1220,demonhunter,havoc,24,13,11
Devilmonkey,ambossar,1219,demonhunter,havoc,93,35,58
Danedemlia,magtheridon,1218,demonhunter,havoc,73,35,38
Badgyalriri,hyjal,1218,demonhunter,havoc,33,15,18
Dmgchris,sylvanas,1218,demonhunter,havoc,36,13,23
Rtz,malfurion,1217,demonhunter,havoc,36,19,17
Tokoloshë,ragnaros,1217,demonhunter,havoc,108,56,52
Crueldo,silvermoon,1217,demonhunter,havoc,54,22,32
Demonzeus,sylvanas,1216,demonhunter,havoc,91,48,43
Tabsen,sanguino,1215,demonhunter,havoc,29,13,16
Ferndejar,draenor,1215,demonhunter,havoc,40,14,26
Demonpotatô,draenor,1214,demonhunter,havoc,78,41,37
Vänöx,dun-modr,1214,demonhunter,havoc,56,24,32
Tyvas,hyjal,1214,demonhunter,havoc,59,25,34
Petefile,kazzak,1213,demonhunter,havoc,128,68,60
Nestrae,drakthul,1213,demonhunter,havoc,30,13,17
Betråyêr,draenor,1213,demonhunter,havoc,38,15,23
Иллидал,greymane,1212,demonhunter,havoc,36,18,18
Chancelvie,outland,1211,demonhunter,havoc,123,54,69
Sîvîct,uldum,1210,demonhunter,havoc,24,13,11
Kladius,skullcrusher,1210,demonhunter,havoc,48,24,24
Cameclc,hyjal,1209,demonhunter,havoc,28,13,15
Нохелет,deepholm,1208,demonhunter,havoc,464,241,223
Schahmiran,kargath,1208,demonhunter,havoc,96,45,51
Дронкрылатый,soulflayer,1207,demonhunter,havoc,107,55,52
Áléc,outland,1206,demonhunter,havoc,36,18,18
Ludakrava,outland,1206,demonhunter,havoc,78,34,44
Marmotaa,ragnaros,1205,demonhunter,havoc,159,77,82
Dadicek,drakthul,1204,demonhunter,havoc,30,20,10
Csav,ragnaros,1204,demonhunter,havoc,42,19,23
Jimdh,quelthalas,1204,demonhunter,havoc,66,22,44
Talwen,guldan,1203,demonhunter,havoc,24,15,9
Maltok,ysondre,1203,demonhunter,havoc,73,36,37
Medom,stormreaver,1203,demonhunter,havoc,48,23,25
Kumoko,burning-legion,1203,demonhunter,havoc,39,16,23
Deadclass,tarren-mill,1202,demonhunter,havoc,24,13,11
Teoma,hyjal,1202,demonhunter,havoc,221,116,105
Эридэм,gordunni,1202,demonhunter,havoc,30,14,16
Bøøgý,silvermoon,1202,demonhunter,havoc,54,24,30
Bazzer,aegwynn,1201,demonhunter,havoc,80,40,40
Délyria,blackhand,1200,demonhunter,havoc,162,82,80
Demonk,nemesis,1198,demonhunter,havoc,163,81,82
Aûrelian,kragjin,1197,demonhunter,havoc,45,20,25
Сангвиннус,howling-fjord,1196,demonhunter,havoc,99,51,48
Vozol,stormscale,1195,demonhunter,havoc,30,20,10
Hellarious,ragnaros,1195,demonhunter,havoc,72,30,42
Demondik,aggramar,1195,demonhunter,havoc,52,20,32
Carizmma,ravencrest,1195,demonhunter,havoc,78,28,50
Nalleya,draenor,1195,demonhunter,havoc,42,14,28
Sholon,kiljaeden,1194,demonhunter,havoc,24,14,10
Талона,fordragon,1191,demonhunter,havoc,60,33,27
Claere,blackhand,1191,demonhunter,havoc,129,66,63
Spideymon,ragnaros,1191,demonhunter,havoc,56,21,35
Makkivar,terenas,1190,demonhunter,havoc,64,33,31
Manga,aegwynn,1190,demonhunter,havoc,72,28,44
Lastdemon,dun-modr,1189,demonhunter,havoc,44,24,20
Джигурдинец,gordunni,1188,demonhunter,havoc,36,21,15
Paranoiac,defias-brotherhood,1187,demonhunter,havoc,29,13,16
Buttslapper,silvermoon,1187,demonhunter,havoc,38,14,24
Khamzath,blackhand,1186,demonhunter,havoc,72,36,36
Vallaas,argent-dawn,1185,demonhunter,havoc,41,17,24
Liisza,blackhand,1184,demonhunter,havoc,22,15,7
Gotwings,sunstrider,1183,demonhunter,havoc,22,13,9
Demonligos,draenor,1183,demonhunter,havoc,72,36,36
Pumaswede,auchindoun,1183,demonhunter,havoc,35,13,22
Sharhan,sylvanas,1182,demonhunter,havoc,73,33,40
Акамамба,gordunni,1182,demonhunter,havoc,35,14,21
Artexxen,kazzak,1182,demonhunter,havoc,42,14,28
Dionyz,magtheridon,1180,demonhunter,havoc,30,18,12
Nvm,wrathbringer,1180,demonhunter,havoc,78,38,40
Ohshietwadap,twisting-nether,1180,demonhunter,havoc,34,13,21
Heàvic,outland,1179,demonhunter,havoc,69,37,32
Годиксгёрл,gordunni,1178,demonhunter,havoc,92,47,45
Kalimbä,suramar,1178,demonhunter,havoc,72,35,37
Squatrix,archimonde,1177,demonhunter,havoc,30,16,14
Õmen,ravencrest,1176,demonhunter,havoc,26,13,13
Aoeshu,wildhammer,1175,demonhunter,havoc,23,13,10
Finsterfix,blackrock,1175,demonhunter,havoc,59,26,33
Êvê,blackmoore,1174,demonhunter,havoc,52,25,27
Lozakum,draenor,1174,demonhunter,havoc,126,58,68
Kaletoq,ragnaros,1172,demonhunter,havoc,34,20,14
Aidae,sylvanas,1172,demonhunter,havoc,90,37,53
Lovzuu,draenor,1171,demonhunter,havoc,24,17,7
Brolycoly,stormscale,1169,demonhunter,havoc,34,13,21
Флеркенкот,galakrond,1167,demonhunter,havoc,371,194,177
Demonwithin,nerathor,1167,demonhunter,havoc,39,15,24
Cmi,tarren-mill,1167,demonhunter,havoc,34,13,21
Kiriall,blackmoore,1166,demonhunter,havoc,78,36,42
Winchesterxx,sanguino,1165,demonhunter,havoc,102,52,50
Oxydh,ravencrest,1165,demonhunter,havoc,28,13,15
Diabloman,stormscale,1164,demonhunter,havoc,42,18,24
Tizefik,stormscale,1163,demonhunter,havoc,57,28,29
Velgetox,blackrock,1163,demonhunter,havoc,51,24,27
Morthorr,grim-batol,1163,demonhunter,havoc,37,17,20
Lailâh,blackmoore,1162,demonhunter,havoc,30,14,16
Lagordin,aggramar,1161,demonhunter,havoc,18,14,4
Dämokröte,ambossar,1161,demonhunter,havoc,110,57,53
Dombra,kult-der-verdammten,1160,demonhunter,havoc,35,22,13
Hawek,madmortem,1160,demonhunter,havoc,76,41,35
Самуройд,gordunni,1159,demonhunter,havoc,104,47,57
Tallain,drakthul,1158,demonhunter,havoc,45,19,26
Letidyr,ravencrest,1158,demonhunter,havoc,54,17,37
Chrititia,blackmoore,1155,demonhunter,havoc,41,18,23
Wréckful,ravencrest,1155,demonhunter,havoc,48,17,31
Demonronin,the-maelstrom,1154,demonhunter,havoc,85,42,43
Nanocsika,twisting-nether,1154,demonhunter,havoc,250,122,128
Itsukix,stormscale,1153,demonhunter,havoc,36,21,15
Kalachiquezz,kazzak,1152,demonhunter,havoc,18,12,6
Demønlady,blackmoore,1152,demonhunter,havoc,26,13,13
Аоешный,howling-fjord,1152,demonhunter,havoc,24,12,12
Nairra,blackmoore,1152,demonhunter,havoc,30,13,17
Neonishh,twisting-nether,1152,demonhunter,havoc,30,12,18
Fuseton,kazzak,1152,demonhunter,havoc,30,12,18
Kímínøséí,kazzak,1151,demonhunter,havoc,18,12,6
Fatimá,stormscale,1150,demonhunter,havoc,18,12,6
Qiera,grim-batol,1150,demonhunter,havoc,24,12,12
Raïley,archimonde,1150,demonhunter,havoc,30,12,18
Seleverkauft,antonidas,1149,demonhunter,havoc,18,12,6
Evul,blackmoore,1149,demonhunter,havoc,18,12,6
Hashoks,draenor,1149,demonhunter,havoc,51,29,22
Bigboychaos,twisting-nether,1149,demonhunter,havoc,36,19,17
Notapistol,outland,1149,demonhunter,havoc,24,12,12
Rasmekul,defias-brotherhood,1149,demonhunter,havoc,24,12,12
Glowfall,draenor,1149,demonhunter,havoc,45,22,23
Shizá,burning-legion,1149,demonhunter,havoc,92,41,51
Uthinare,silvermoon,1149,demonhunter,havoc,68,30,38
Allalina,draenor,1148,demonhunter,havoc,96,51,45
Eibemme,alleria,1148,demonhunter,havoc,24,12,12
Miràá,frostwolf,1148,demonhunter,havoc,30,12,18
Mojois,ravenholdt,1147,demonhunter,havoc,150,78,72
Íhithard,drakthul,1147,demonhunter,havoc,24,12,12
Korrupt,draenor,1147,demonhunter,havoc,24,12,12
Mouz,thrall,1147,demonhunter,havoc,24,12,12
Mèlfurion,hyjal,1147,demonhunter,havoc,97,42,55
Bayerd,burning-legion,1146,demonhunter,havoc,24,12,12
Zhartax,dun-modr,1146,demonhunter,havoc,24,12,12
Ravae,burning-legion,1146,demonhunter,havoc,30,12,18
Milkeyes,ravencrest,1145,demonhunter,havoc,112,60,52
Aruzar,twisting-nether,1145,demonhunter,havoc,36,14,22
Artwar,stormscale,1145,demonhunter,havoc,42,16,26
Gouteça,la-croisade-écarlate,1145,demonhunter,havoc,36,12,24
Morow,die-ewige-wacht,1144,demonhunter,havoc,18,12,6
Тиктокденсер,gordunni,1144,demonhunter,havoc,24,12,12
Lengadanger,durotan,1144,demonhunter,havoc,30,12,18
Оксиликвит,soulflayer,1144,demonhunter,havoc,46,15,31
Puppygf,ravencrest,1143,demonhunter,havoc,18,12,6
Lilor,aegwynn,1143,demonhunter,havoc,18,12,6
Metadel,outland,1143,demonhunter,havoc,359,183,176
Joniod,stormreaver,1143,demonhunter,havoc,24,12,12
Xellidan,dun-modr,1142,demonhunter,havoc,30,14,16
Gyrospita,dun-morogh,1142,demonhunter,havoc,30,12,18
Embruixada,sanguino,1140,demonhunter,havoc,239,122,117
Lanaël,kaelthas,1140,demonhunter,havoc,24,12,12
Yuka,earthen-ring,1140,demonhunter,havoc,42,20,22
Lilithxz,blackmoore,1139,demonhunter,havoc,24,12,12
Dreggath,doomhammer,1139,demonhunter,havoc,59,29,30
Kebiz,ragnaros,1139,demonhunter,havoc,29,13,16
Betrayeð,tarren-mill,1139,demonhunter,havoc,30,12,18
Nelairia,tarren-mill,1138,demonhunter,havoc,41,24,17
Тонниданза,howling-fjord,1138,demonhunter,havoc,384,187,197
Илайора,galakrond,1137,demonhunter,havoc,79,34,45
Viridisignis,silvermoon,1136,demonhunter,havoc,235,119,116
Txullidan,twisting-nether,1136,demonhunter,havoc,92,46,46
Doccholiday,doomhammer,1136,demonhunter,havoc,53,23,30
Jânnekê,blackmoore,1136,demonhunter,havoc,30,13,17
Merelîn,eredar,1135,demonhunter,havoc,47,23,24
Grazilo,outland,1135,demonhunter,havoc,62,28,34
Сеомагистр,gordunni,1135,demonhunter,havoc,124,52,72
Biatrix,stormscale,1134,demonhunter,havoc,24,14,10
Typhoonxq,tarren-mill,1134,demonhunter,havoc,53,29,24
Yousif,stormscale,1134,demonhunter,havoc,155,78,77
Basiliskus,argent-dawn,1134,demonhunter,havoc,30,12,18
Nëmesi,ravencrest,1133,demonhunter,havoc,22,13,9
Vampirishi,frostwolf,1132,demonhunter,havoc,18,12,6
Fläsktorped,stormscale,1132,demonhunter,havoc,31,14,17
Xtrong,agamaggan,1131,demonhunter,havoc,27,14,13
Athoribos,silvermoon,1130,demonhunter,havoc,66,34,32
Iaozh,culte-de-la-rive-noire,1130,demonhunter,havoc,54,23,31
Luciferio,quelthalas,1130,demonhunter,havoc,58,22,36
Фирулия,goldrinn,1129,demonhunter,havoc,214,113,101
Tasi,dun-morogh,1128,demonhunter,havoc,70,33,37
Giboo,emerald-dream,1127,demonhunter,havoc,18,12,6
Marsterkush,malygos,1127,demonhunter,havoc,43,22,21
Zolvanith,tarren-mill,1127,demonhunter,havoc,48,18,30
Хэвдан,gordunni,1126,demonhunter,havoc,18,12,6
Accursius,blackmoore,1126,demonhunter,havoc,92,54,38
Xendrina,blackrock,1125,demonhunter,havoc,30,12,18
Maßik,terokkar,1122,demonhunter,havoc,39,22,17
Matumbojumbo,outland,1122,demonhunter,havoc,93,38,55
Dontrunaway,tarren-mill,1121,demonhunter,havoc,18,12,6
Shiqqi,blackhand,1118,demonhunter,havoc,60,31,29
Vaenil,hyjal,1118,demonhunter,havoc,41,14,27
Mcsmackface,hellfire,1117,demonhunter,havoc,69,26,43
Neepz,ravencrest,1116,demonhunter,havoc,42,18,24
Zyasea,blackmoore,1116,demonhunter,havoc,107,41,66
Unnachgiebig,antonidas,1113,demonhunter,havoc,24,12,12
Roostidh,shattered-hand,1112,demonhunter,havoc,78,42,36
Youjosenki,magtheridon,1111,demonhunter,havoc,23,15,8
Quavanity,sylvanas,1110,demonhunter,havoc,29,12,17
Zengor,twilights-hammer,1109,demonhunter,havoc,28,14,14
Мотек,howling-fjord,1109,demonhunter,havoc,120,57,63
Cerza,sanguino,1109,demonhunter,havoc,42,14,28
Tatsukiyuzu,hyjal,1107,demonhunter,havoc,54,35,19
Огнод,gordunni,1107,demonhunter,havoc,66,38,28
Karxarias,silvermoon,1107,demonhunter,havoc,42,22,20
Hellboii,kilrogg,1104,demonhunter,havoc,70,42,28
Líllíth,forscherliga,1104,demonhunter,havoc,24,12,12
Sükiküki,alexstrasza,1104,demonhunter,havoc,78,29,49
Nylaria,dethecus,1102,demonhunter,havoc,24,13,11
Napastak,blackrock,1100,demonhunter,havoc,47,17,30
Дайленрия,eversong,1097,demonhunter,havoc,54,27,27
Niika,archimonde,1096,demonhunter,havoc,60,22,38
Wingedfelcat,argent-dawn,1095,demonhunter,havoc,23,12,11
Vio,jaedenar,1094,demonhunter,havoc,96,53,43
Ilidas,frostwolf,1094,demonhunter,havoc,42,23,19
Giace,drakthul,1094,demonhunter,havoc,96,39,57
Аллилания,fordragon,1092,demonhunter,havoc,50,32,18
Téthis,uldaman,1092,demonhunter,havoc,102,44,58
Aamonath,tarren-mill,1089,demonhunter,havoc,48,27,21
Ailis,drakthul,1089,demonhunter,havoc,38,13,25
Eranduur,draenor,1088,demonhunter,havoc,24,13,11
Арат,ashenvale,1088,demonhunter,havoc,96,46,50
Моуровани,eversong,1088,demonhunter,havoc,60,28,32
Azzinoth,outland,1088,demonhunter,havoc,106,42,64
Айвэнгос,thermaplugg,1086,demonhunter,havoc,91,48,43
Anandria,blutkessel,1084,demonhunter,havoc,83,46,37
Azazelkw,ragnaros,1084,demonhunter,havoc,66,34,32
Subelsiu,alakir,1084,demonhunter,havoc,241,122,119
Thegamesucks,ravencrest,1084,demonhunter,havoc,214,104,110
Sombessat,tarren-mill,1084,demonhunter,havoc,95,46,49
Гёнке,gordunni,1083,demonhunter,havoc,34,13,21
Дэрзлорд,fordragon,1082,demonhunter,havoc,23,12,11
Аэм,deathweaver,1081,demonhunter,havoc,46,18,28
Sintoraz,amanthul,1080,demonhunter,havoc,61,37,24
Bezdna,stormrage,1080,demonhunter,havoc,27,12,15
Ðmn,silvermoon,1079,demonhunter,havoc,26,12,14
Mäxo,frostwolf,1079,demonhunter,havoc,32,12,20
Noire,zuljin,1079,demonhunter,havoc,35,12,23
Sgravo,nemesis,1076,demonhunter,havoc,30,18,12
Veldragor,blackhand,1076,demonhunter,havoc,30,14,16
Darkustos,blackrock,1076,demonhunter,havoc,44,20,24
Välhöll,kirin-tor,1076,demonhunter,havoc,65,23,42
Мицлейн,gordunni,1075,demonhunter,havoc,79,29,50
Twistyy,drakthul,1070,demonhunter,havoc,78,43,35
Leloine,trollbane,1069,demonhunter,havoc,133,67,66
Giusifreddo,zuljin,1068,demonhunter,havoc,67,28,39
Нотреди,howling-fjord,1067,demonhunter,havoc,138,74,64
Dollar,daggerspine,1066,demonhunter,havoc,78,26,52
Scurenzio,outland,1065,demonhunter,havoc,42,24,18
Ôlowain,blackmoore,1065,demonhunter,havoc,30,12,18
Каталейна,howling-fjord,1065,demonhunter,havoc,62,19,43
Alioshad,ravencrest,1064,demonhunter,havoc,76,36,40
Cirino,defias-brotherhood,1063,demonhunter,havoc,108,52,56
Zarkhyl,malygos,1062,demonhunter,havoc,35,15,20
Hvc,twisting-nether,1062,demonhunter,havoc,77,32,45
Coaxial,twisting-nether,1062,demonhunter,havoc,54,19,35
Noctilucent,executus,1061,demonhunter,havoc,90,49,41
Hernandez,sanguino,1060,demonhunter,havoc,36,18,18
Увиден,eversong,1060,demonhunter,havoc,170,84,86
Prismio,ysondre,1059,demonhunter,havoc,21,12,9
Эйфирон,blackscar,1059,demonhunter,havoc,65,33,32
Gigipletosu,ravencrest,1058,demonhunter,havoc,60,24,36
Alkann,chogall,1057,demonhunter,havoc,47,24,23
Happykx,draenor,1056,demonhunter,havoc,12,11,1
Kundán,antonidas,1056,demonhunter,havoc,48,23,25
Haýuken,kazzak,1056,demonhunter,havoc,48,22,26
Анхардх,gordunni,1056,demonhunter,havoc,24,11,13
Карнавалыч,gordunni,1056,demonhunter,havoc,189,86,103
Virkgodx,bloodscalp,1055,demonhunter,havoc,18,11,7
Hûora,stormscale,1055,demonhunter,havoc,18,11,7
Dhlee,ravencrest,1055,demonhunter,havoc,18,11,7
Joggeqt,stormreaver,1055,demonhunter,havoc,19,11,8
Caria,twisting-nether,1055,demonhunter,havoc,48,27,21
Yiùna,hyjal,1055,demonhunter,havoc,113,55,58
Draqula,ravencrest,1055,demonhunter,havoc,24,11,13
Meridah,twisting-nether,1055,demonhunter,havoc,24,11,13
Evlos,hyjal,1055,demonhunter,havoc,30,11,19
Keiral,stormscale,1055,demonhunter,havoc,30,11,19
Vrekur,sanguino,1055,demonhunter,havoc,36,11,25
Eyegamis,ravencrest,1054,demonhunter,havoc,18,11,7
Nneverx,bladefist,1054,demonhunter,havoc,18,11,7
Løum,blackrock,1054,demonhunter,havoc,18,11,7
Sîre,ravencrest,1054,demonhunter,havoc,24,11,13
Përry,archimonde,1054,demonhunter,havoc,24,11,13
Atômik,drakthul,1054,demonhunter,havoc,24,11,13
Demonicat,twisting-nether,1054,demonhunter,havoc,30,11,19
Цион,soulflayer,1053,demonhunter,havoc,47,22,25
Darktérror,silvermoon,1053,demonhunter,havoc,30,11,19
Никельдон,howling-fjord,1052,demonhunter,havoc,54,33,21
Watermelonqt,tarren-mill,1052,demonhunter,havoc,24,11,13
Valorina,stormrage,1052,demonhunter,havoc,24,11,13
Шавермье,gordunni,1052,demonhunter,havoc,36,11,25
Bud,lightnings-blade,1051,demonhunter,havoc,18,11,7
Sutures,ravencrest,1051,demonhunter,havoc,24,11,13
Aldeshabrake,antonidas,1051,demonhunter,havoc,24,11,13
Хитсхан,soulflayer,1051,demonhunter,havoc,48,20,28
Squan,blackmoore,1050,demonhunter,havoc,20,12,8
Sorowas,tichondrius,1050,demonhunter,havoc,61,34,27
Blisdon,argent-dawn,1050,demonhunter,havoc,163,79,84
Bùlkbogan,kazzak,1050,demonhunter,havoc,24,11,13
Халбренд,gordunni,1050,demonhunter,havoc,24,11,13
Vìdhar,tarren-mill,1049,demonhunter,havoc,24,11,13
Akhyra,ysondre,1049,demonhunter,havoc,24,11,13
Aeshalla,blackmoore,1049,demonhunter,havoc,30,11,19
Mjuliet,stormscale,1049,demonhunter,havoc,36,11,25
Maddificator,silvermoon,1048,demonhunter,havoc,32,22,10
Nuflin,eredar,1047,demonhunter,havoc,24,11,13
Ilidailine,kazzak,1047,demonhunter,havoc,27,12,15
Plec,alakir,1047,demonhunter,havoc,76,31,45
Nerfy,silvermoon,1046,demonhunter,havoc,18,11,7
Glaiverush,alakir,1046,demonhunter,havoc,36,19,17
Bunzi,sylvanas,1045,demonhunter,havoc,18,11,7
Joeybadass,aegwynn,1045,demonhunter,havoc,24,11,13
Музакант,gordunni,1043,demonhunter,havoc,89,46,43
Siscia,outland,1042,demonhunter,havoc,74,40,34
Dântés,silvermoon,1040,demonhunter,havoc,60,23,37
Thilanea,emeriss,1039,demonhunter,havoc,24,12,12
Roadruner,kazzak,1039,demonhunter,havoc,24,11,13
Tyranax,kirin-tor,1039,demonhunter,havoc,24,11,13
Balathor,quelthalas,1038,demonhunter,havoc,18,11,7
Estarloco,blackmoore,1038,demonhunter,havoc,36,19,17
Selénhe,silvermoon,1038,demonhunter,havoc,24,11,13
Besnik,stormscale,1038,demonhunter,havoc,68,29,39
Rebelion,dun-modr,1037,demonhunter,havoc,61,19,42
Shnshon,kazzak,1036,demonhunter,havoc,18,12,6
Blackdémon,blackrock,1036,demonhunter,havoc,96,35,61
Lightkick,archimonde,1035,demonhunter,havoc,60,35,25
Elmindundi,shendralar,1033,demonhunter,havoc,44,17,27
Даргсайд,gordunni,1032,demonhunter,havoc,233,110,123
Électrâs,archimonde,1032,demonhunter,havoc,50,21,29
Abalim,nemesis,1030,demonhunter,havoc,30,11,19
Zahif,kazzak,1030,demonhunter,havoc,42,15,27
Munja,hyjal,1028,demonhunter,havoc,284,138,146
Mdåll,chogall,1028,demonhunter,havoc,56,23,33
Thorskinius,ravencrest,1027,demonhunter,havoc,62,28,34
Starlightkid,kazzak,1027,demonhunter,havoc,30,13,17
Vanereel,thrall,1026,demonhunter,havoc,23,14,9
Silan,kiljaeden,1026,demonhunter,havoc,46,26,20
Aggerpain,draenor,1026,demonhunter,havoc,68,24,44
Séphora,confrérie-du-thorium,1025,demonhunter,havoc,18,11,7
Тэниан,gordunni,1025,demonhunter,havoc,162,67,95
Julmia,dragonblight,1025,demonhunter,havoc,47,12,35
Dèathless,pozzo-delleternità,1024,demonhunter,havoc,52,21,31
Cobayashi,der-mithrilorden,1023,demonhunter,havoc,38,21,17
Djsasan,kazzak,1022,demonhunter,havoc,18,11,7
Самфор,soulflayer,1022,demonhunter,havoc,85,41,44
Killidance,outland,1021,demonhunter,havoc,67,27,40
Гарнаш,howling-fjord,1020,demonhunter,havoc,89,46,43
Stonebanker,turalyon,1019,demonhunter,havoc,35,18,17
Ðíablo,amanthul,1019,demonhunter,havoc,26,11,15
Ragefighterr,ragnaros,1018,demonhunter,havoc,42,21,21
Heiltgalen,grim-batol,1017,demonhunter,havoc,20,12,8
Takeshy,alleria,1016,demonhunter,havoc,60,31,29
Ladj,blackmoore,1014,demonhunter,havoc,48,24,24
Thelanora,zirkel-des-cenarius,1014,demonhunter,havoc,77,34,43
Calainis,twisting-nether,1013,demonhunter,havoc,28,13,15
Цейн,azuregos,1012,demonhunter,havoc,79,36,43
Entzuu,hyjal,1012,demonhunter,havoc,28,11,17
Äcnologia,khaz-modan,1009,demonhunter,havoc,34,15,19
Mommasboi,twisting-nether,1009,demonhunter,havoc,30,11,19
Ríasgremory,los-errantes,1008,demonhunter,havoc,21,14,7
Gabquist,argent-dawn,1008,demonhunter,havoc,53,26,27
Синтвеив,soulflayer,1007,demonhunter,havoc,17,11,6
Бигбэбров,gordunni,1007,demonhunter,havoc,36,15,21
Demontripo,silvermoon,1005,demonhunter,havoc,81,43,38
Delfee,twisting-nether,1005,demonhunter,havoc,54,25,29
Wen,outland,1003,demonhunter,havoc,27,11,16
Yayayaa,kazzak,1000,demonhunter,havoc,23,13,10
Гневныймомон,soulflayer,1000,demonhunter,havoc,79,38,41
Grove,cthun,998,demonhunter,havoc,19,12,7
Vaco,la-croisade-écarlate,996,demonhunter,havoc,30,13,17
Annelf,ragnaros,994,demonhunter,havoc,30,11,19
Ànavar,twisting-nether,991,demonhunter,havoc,47,21,26
Funb,ragnaros,990,demonhunter,havoc,20,11,9
Superset,twisting-nether,989,demonhunter,havoc,22,11,11
Yuná,stormscale,989,demonhunter,havoc,28,11,17
Demonzeus,archimonde,985,demonhunter,havoc,25,12,13
Andij,frostwolf,981,demonhunter,havoc,77,36,41
Greensøul,los-errantes,981,demonhunter,havoc,78,35,43
Itzmir,nethersturm,980,demonhunter,havoc,22,11,11
Shirakava,quelthalas,978,demonhunter,havoc,215,98,117
Rijsel,dalaran,975,demonhunter,havoc,36,22,14
Sinthetyx,quelthalas,974,demonhunter,havoc,42,24,18
Vixandrion,twisting-nether,971,demonhunter,havoc,18,11,7
Sìnbad,khaz-modan,970,demonhunter,havoc,60,34,26
Ayido,xavius,970,demonhunter,havoc,52,21,31
Люцифэйль,gordunni,966,demonhunter,havoc,55,23,32
Hunterston,twisting-nether,963,demonhunter,havoc,74,40,34
Pijvijie,shattrath,961,demonhunter,havoc,55,18,37
Дианист,gordunni,960,demonhunter,havoc,16,11,5
Rockymarcia,archimonde,960,demonhunter,havoc,30,17,13
Karpandero,stormreaver,960,demonhunter,havoc,18,10,8
Fantabolous,ragnaros,960,demonhunter,havoc,18,10,8
Dhamp,kazzak,960,demonhunter,havoc,18,10,8
Zelidh,korgall,960,demonhunter,havoc,18,10,8
Keýrañe,ragnaros,960,demonhunter,havoc,18,10,8
Грязюка,howling-fjord,960,demonhunter,havoc,24,10,14
Iíïììïiíïìïï,alakir,960,demonhunter,havoc,24,10,14
Zxcjklcasdlk,sylvanas,960,demonhunter,havoc,24,10,14
Krvckhead,hyjal,960,demonhunter,havoc,24,10,14
Ghetzlel,draenor,960,demonhunter,havoc,24,10,14
Mýg,ravencrest,960,demonhunter,havoc,30,10,20
Rîasgremoryy,twisting-nether,960,demonhunter,havoc,30,10,20
Karaxd,stormscale,960,demonhunter,havoc,30,10,20
Heanondh,dentarg,959,demonhunter,havoc,18,10,8
Lucianloco,dun-morogh,959,demonhunter,havoc,18,10,8
Катякрылышки,gordunni,959,demonhunter,havoc,18,10,8
Darkshadow,turalyon,959,demonhunter,havoc,18,10,8
Judditdhx,draenor,959,demonhunter,havoc,18,10,8
Deadmaus,stormscale,959,demonhunter,havoc,18,10,8
Zmemroo,magtheridon,959,demonhunter,havoc,18,10,8
Ømêgäðmggóðx,blackrock,959,demonhunter,havoc,24,10,14
Yumhip,dun-modr,959,demonhunter,havoc,24,10,14
Metaisnice,nozdormu,959,demonhunter,havoc,27,11,16
Darnke,silvermoon,959,demonhunter,havoc,30,10,20
Тяжелыйбасс,gordunni,958,demonhunter,havoc,18,10,8
Elenôy,malganis,958,demonhunter,havoc,18,10,8
Desdh,blackmoore,958,demonhunter,havoc,24,10,14
Nocluë,shattered-halls,958,demonhunter,havoc,30,10,20
Skarvy,bronze-dragonflight,957,demonhunter,havoc,18,10,8
Dominantorka,outland,957,demonhunter,havoc,24,10,14
Däny,zuljin,957,demonhunter,havoc,30,10,20
Bobdh,twisting-nether,957,demonhunter,havoc,35,10,25
Fredhy,tarren-mill,956,demonhunter,havoc,18,10,8
Løkil,blackrock,956,demonhunter,havoc,24,10,14
Вапатикяу,gordunni,956,demonhunter,havoc,30,10,20
Tire,draenor,955,demonhunter,havoc,18,10,8
Shadowweaver,earthen-ring,955,demonhunter,havoc,18,10,8
Freddh,blackrock,955,demonhunter,havoc,24,10,14
Illidián,chamber-of-aspects,955,demonhunter,havoc,30,10,20
Дантавул,gordunni,954,demonhunter,havoc,87,41,46
Blíndgódx,ravencrest,954,demonhunter,havoc,28,11,17
Argnils,tarren-mill,953,demonhunter,havoc,12,10,2
Ravier,baelgun,953,demonhunter,havoc,75,39,36
Dajjal,eredar,953,demonhunter,havoc,24,10,14
Akaniiaa,blackmoore,953,demonhunter,havoc,24,10,14
Mhieltior,frostmane,953,demonhunter,havoc,24,10,14
Yamaarashi,earthen-ring,953,demonhunter,havoc,24,10,14
Greedsmoke,kazzak,952,demonhunter,havoc,18,10,8
Hallowdip,drakthul,952,demonhunter,havoc,18,10,8
Sinorack,sargeras,951,demonhunter,havoc,24,10,14
Enlightens,aegwynn,951,demonhunter,havoc,24,10,14
Демод,soulflayer,950,demonhunter,havoc,24,13,11
Bashara,minahonda,949,demonhunter,havoc,24,10,14
Alandrisz,argent-dawn,949,demonhunter,havoc,30,10,20
Prepared,teldrassil,947,demonhunter,havoc,12,10,2
Максаналл,soulflayer,944,demonhunter,havoc,18,10,8
Butcherr,ulduar,944,demonhunter,havoc,42,19,23
Hackstück,blackrock,943,demonhunter,havoc,28,14,14
Deathmàrk,stormscale,943,demonhunter,havoc,23,10,13
Jemoer,twisting-nether,942,demonhunter,havoc,25,15,10
Jörgböhme,blackhand,942,demonhunter,havoc,24,10,14
Spamaname,outland,942,demonhunter,havoc,24,10,14
Naem,blackrock,942,demonhunter,havoc,24,10,14
Shàdoww,hyjal,937,demonhunter,havoc,36,10,26
Pismanik,drakthul,936,demonhunter,havoc,36,19,17
Byah,kazzak,933,demonhunter,havoc,146,65,81
Yanosses,la-croisade-écarlate,931,demonhunter,havoc,24,15,9
Shadowkick,archimonde,931,demonhunter,havoc,285,137,148
Zaeros,archimonde,929,demonhunter,havoc,18,10,8
Winnztlol,chamber-of-aspects,927,demonhunter,havoc,36,17,19
Илнари,soulflayer,926,demonhunter,havoc,23,10,13
Zermut,culte-de-la-rive-noire,925,demonhunter,havoc,17,10,7
Aggrr,blackmoore,923,demonhunter,havoc,26,11,15
Nehmarath,doomhammer,923,demonhunter,havoc,42,11,31
Braserol,archimonde,922,demonhunter,havoc,50,19,31
Ёмайл,soulflayer,921,demonhunter,havoc,30,14,16
Losthunter,turalyon,920,demonhunter,havoc,75,31,44
Sjox,dalaran,919,demonhunter,havoc,72,21,51
Séleister,khaz-modan,917,demonhunter,havoc,53,23,30
Aelita,twisting-nether,916,demonhunter,havoc,132,68,64
Demonhyan,chants-éternels,916,demonhunter,havoc,97,45,52
Meliòdas,draenor,916,demonhunter,havoc,53,17,36
Mezo,outland,912,demonhunter,havoc,21,11,10
Taliaa,drakthul,911,demonhunter,havoc,21,10,11
Магнисс,fordragon,909,demonhunter,havoc,26,14,12
Skylinex,dentarg,909,demonhunter,havoc,66,33,33
Манапарда,howling-fjord,909,demonhunter,havoc,35,10,25
Guziel,kazzak,906,demonhunter,havoc,15,10,5
Hicgidik,outland,905,demonhunter,havoc,24,11,13
Herzbann,madmortem,904,demonhunter,havoc,25,11,14
Luìnìl,khaz-modan,904,demonhunter,havoc,27,10,17
Fredoo,sylvanas,903,demonhunter,havoc,21,11,10
Naltharian,drakthul,902,demonhunter,havoc,29,12,17
Beraxulus,aegwynn,902,demonhunter,havoc,28,11,17
Lufy,rexxar,896,demonhunter,havoc,60,26,34
Kroepoeks,mazrigos,894,demonhunter,havoc,30,16,14
Nuriia,arthas,894,demonhunter,havoc,72,37,35
Zsari,ravencrest,894,demonhunter,havoc,20,10,10
Innostigma,dalaran,892,demonhunter,havoc,26,10,16
Anarcky,ravencrest,890,demonhunter,havoc,25,11,14
Lillinète,archimonde,890,demonhunter,havoc,42,11,31
Jamule,dun-morogh,889,demonhunter,havoc,36,15,21
Finstergraf,blackmoore,887,demonhunter,havoc,78,40,38
Lorcanmar,draenor,887,demonhunter,havoc,99,44,55
Шоеррей,gordunni,886,demonhunter,havoc,20,10,10
Liquidtrip,kazzak,883,demonhunter,havoc,75,40,35
Dionée,silvermoon,883,demonhunter,havoc,30,16,14
Cometofloki,outland,880,demonhunter,havoc,36,17,19
Nithraim,kazzak,880,demonhunter,havoc,27,10,17
Dàrkinette,archimonde,875,demonhunter,havoc,48,22,26
Mortblede,outland,872,demonhunter,havoc,81,33,48
Legionek,burning-blade,866,demonhunter,havoc,20,11,9
Ejder,anubarak,865,demonhunter,havoc,78,31,47
Tzs,blackrock,864,demonhunter,havoc,12,9,3
Pogchamp,argent-dawn,864,demonhunter,havoc,18,9,9
Giftìg,ravencrest,864,demonhunter,havoc,18,9,9
Lrdhavemercy,kiljaeden,864,demonhunter,havoc,18,9,9
Saene,ravencrest,864,demonhunter,havoc,18,9,9
Demønjægarex,stormscale,864,demonhunter,havoc,18,9,9
Zophý,ragnaros,864,demonhunter,havoc,18,9,9
Fíendy,ravencrest,864,demonhunter,havoc,18,9,9
Эридари,blackscar,864,demonhunter,havoc,18,9,9
Tillidani,outland,864,demonhunter,havoc,18,9,9
Bruxdh,dun-modr,864,demonhunter,havoc,18,9,9
Манарифт,blackscar,864,demonhunter,havoc,18,9,9
Roxxis,mazrigos,864,demonhunter,havoc,18,9,9
Toschadh,blackmoore,864,demonhunter,havoc,18,9,9
Snäx,aggra-português,864,demonhunter,havoc,18,9,9
Lethalidan,darksorrow,864,demonhunter,havoc,18,9,9
Ayimprepared,ragnaros,864,demonhunter,havoc,24,9,15
Illidany,eredar,864,demonhunter,havoc,24,9,15
Drunkendemon,frostwolf,863,demonhunter,havoc,12,9,3
Sunestaa,kazzak,863,demonhunter,havoc,12,9,3
Aîmwârê,ravencrest,863,demonhunter,havoc,12,9,3
Деленна,azuregos,863,demonhunter,havoc,15,10,5
Hogidan,hellscream,863,demonhunter,havoc,18,9,9
Пампу,howling-fjord,863,demonhunter,havoc,18,9,9
Illidaia,ravencrest,863,demonhunter,havoc,18,9,9
Ronstoppable,ravencrest,863,demonhunter,havoc,18,9,9
Lezzo,tarren-mill,863,demonhunter,havoc,18,9,9
Djdhh,draenor,863,demonhunter,havoc,20,9,11
Tricki,kelthuzad,863,demonhunter,havoc,24,9,15
Slizer,draenor,863,demonhunter,havoc,24,9,15
Mettdaemon,ravencrest,863,demonhunter,havoc,24,9,15
Oleasdra,dragonmaw,862,demonhunter,havoc,18,9,9
Lundí,tarren-mill,862,demonhunter,havoc,18,9,9
Zackiq,ravencrest,862,demonhunter,havoc,18,9,9
Grifht,zuljin,862,demonhunter,havoc,18,9,9
Nadili,destromath,862,demonhunter,havoc,18,9,9
Wasilij,ravencrest,862,demonhunter,havoc,18,9,9
Zappikdh,silvermoon,862,demonhunter,havoc,18,9,9
Крикетх,soulflayer,862,demonhunter,havoc,24,9,15
Demonstorpix,drakthul,862,demonhunter,havoc,24,9,15
Fâng,archimonde,862,demonhunter,havoc,30,9,21
Tzklkn,sylvanas,861,demonhunter,havoc,12,9,3
Deqthstrïke,ysondre,861,demonhunter,havoc,18,9,9
Selcan,archimonde,861,demonhunter,havoc,18,9,9
Эска,razuvious,861,demonhunter,havoc,18,9,9
Mightyslayar,kazzak,861,demonhunter,havoc,18,9,9
Яестьдима,howling-fjord,861,demonhunter,havoc,30,9,21
Trenoth,drakthul,860,demonhunter,havoc,12,9,3
Loße,ragnaros,860,demonhunter,havoc,12,9,3
Nameerr,ragnaros,860,demonhunter,havoc,18,9,9
Felglaiver,outland,860,demonhunter,havoc,18,9,9
Jimlast,eredar,860,demonhunter,havoc,18,9,9
Wrathill,draenor,860,demonhunter,havoc,24,9,15
Demonsfury,ravencrest,860,demonhunter,havoc,30,9,21
Selfdestruct,tarren-mill,859,demonhunter,havoc,18,9,9
Doobregeesy,burning-legion,859,demonhunter,havoc,21,10,11
Calicó,draenor,859,demonhunter,havoc,24,9,15
Deathblades,twisting-nether,859,demonhunter,havoc,24,9,15
Approxis,archimonde,858,demonhunter,havoc,18,9,9
Styggve,ragnaros,858,demonhunter,havoc,24,9,15
Бусурманец,gordunni,858,demonhunter,havoc,27,10,17
Daeneryz,drakthul,858,demonhunter,havoc,30,9,21
Enithy,twisting-nether,857,demonhunter,havoc,18,9,9
Keiti,drakthul,856,demonhunter,havoc,36,9,27
Æsenaw,argent-dawn,855,demonhunter,havoc,18,9,9
Bhuta,aerie-peak,855,demonhunter,havoc,18,9,9
Deathsnote,marécage-de-zangar,854,demonhunter,havoc,24,9,15
Mobpsycho,draenor,852,demonhunter,havoc,12,9,3
Hummér,ravencrest,850,demonhunter,havoc,18,9,9
Axyo,doomhammer,849,demonhunter,havoc,30,9,21
Winchestera,silvermoon,849,demonhunter,havoc,36,9,27
Poliex,khaz-modan,847,demonhunter,havoc,18,9,9
Heemaglobin,ravencrest,843,demonhunter,havoc,42,18,24
Noorrd,hyjal,842,demonhunter,havoc,30,11,19
Razzum,blackhand,841,demonhunter,havoc,50,14,36
Sil,khazgoroth,838,demonhunter,havoc,30,11,19
Askaroth,blackmoore,834,demonhunter,havoc,42,9,33
Backflipgødx,uldaman,832,demonhunter,havoc,22,9,13
Elldarion,blackhand,832,demonhunter,havoc,29,9,20
Aylakesh,draenor,831,demonhunter,havoc,17,9,8
Toio,nemesis,831,demonhunter,havoc,24,9,15
Judderzz,bronze-dragonflight,830,demonhunter,havoc,42,19,23
Nystiyel,hyjal,828,demonhunter,havoc,26,10,16
Deadskill,alexstrasza,827,demonhunter,havoc,84,36,48
Ysanix,drakthul,825,demonhunter,havoc,18,9,9
Selvagg,archimonde,823,demonhunter,havoc,30,9,21
Кислотна,borean-tundra,819,demonhunter,havoc,37,16,21
Afkah,chants-éternels,815,demonhunter,havoc,12,9,3
Olaghkhan,minahonda,814,demonhunter,havoc,21,11,10
Dutchmadman,aerie-peak,814,demonhunter,havoc,110,51,59
Daimon,pozzo-delleternità,813,demonhunter,havoc,21,10,11
Тиранд,gordunni,810,demonhunter,havoc,27,9,18
Critlerman,blackmoore,807,demonhunter,havoc,18,11,7
Ultrashlozy,ravencrest,806,demonhunter,havoc,27,12,15
Гурцкой,soulflayer,802,demonhunter,havoc,33,9,24
Lazeruraz,argent-dawn,799,demonhunter,havoc,16,9,7
Illidaniellé,tarren-mill,799,demonhunter,havoc,17,9,8
Wukasin,kazzak,798,demonhunter,havoc,18,9,9
Blutox,antonidas,797,demonhunter,havoc,25,11,14
Herax,drakthul,796,demonhunter,havoc,17,9,8
Deadhuntor,daggerspine,795,demonhunter,havoc,17,9,8
Cerebro,dunemaul,794,demonhunter,havoc,30,13,17
Hollowflame,ravencrest,793,demonhunter,havoc,29,12,17
Merilidan,blackrock,791,demonhunter,havoc,20,9,11
Sinjinzoo,blackrock,789,demonhunter,havoc,14,9,5
Seaburn,bronzebeard,789,demonhunter,havoc,169,71,98
Кусьзакиску,soulflayer,781,demonhunter,havoc,22,9,13
Adexi,twisting-nether,768,demonhunter,havoc,12,8,4
Babipanggang,kazzak,768,demonhunter,havoc,12,8,4
Smallnik,tarren-mill,768,demonhunter,havoc,12,8,4
Dhanny,blackmoore,768,demonhunter,havoc,12,8,4
Traumadh,tarren-mill,768,demonhunter,havoc,12,8,4
Viodemon,blackrock,768,demonhunter,havoc,12,8,4
Elønaria,antonidas,768,demonhunter,havoc,12,8,4
Mesini,darksorrow,768,demonhunter,havoc,12,8,4
Mongraal,tichondrius,768,demonhunter,havoc,12,8,4
Wèx,tarren-mill,768,demonhunter,havoc,12,8,4
Eysndh,blackrock,768,demonhunter,havoc,12,8,4
Praisethelrd,blackrock,768,demonhunter,havoc,18,8,10
Stinkymonkey,pozzo-delleternità,768,demonhunter,havoc,18,8,10
Jellyjoker,malganis,768,demonhunter,havoc,18,8,10
Mvqdh,stormscale,768,demonhunter,havoc,18,8,10
Sydeon,burning-legion,768,demonhunter,havoc,18,8,10
Thestrength,twisting-nether,768,demonhunter,havoc,18,8,10
Dhaosh,nemesis,768,demonhunter,havoc,18,8,10
Leväna,sanguino,768,demonhunter,havoc,18,8,10
Hyprdh,blackrock,768,demonhunter,havoc,18,8,10
Konesimp,kazzak,768,demonhunter,havoc,18,8,10
Nthday,draenor,768,demonhunter,havoc,18,8,10
Tbxdh,blackrock,768,demonhunter,havoc,18,8,10
Mythisa,blackrock,768,demonhunter,havoc,21,9,12
Dzieciak,burning-legion,768,demonhunter,havoc,22,9,13
Ataddcay,outland,768,demonhunter,havoc,84,29,55
Allen,dragonblight,768,demonhunter,havoc,24,8,16
Demoan,outland,768,demonhunter,havoc,24,8,16
Rõb,magtheridon,768,demonhunter,havoc,24,8,16
Cptgmiasbria,eredar,768,demonhunter,havoc,30,8,22
Earfâlass,twisting-nether,768,demonhunter,havoc,30,8,22
Ninetzqp,tarren-mill,767,demonhunter,havoc,12,8,4
Iíïììïiíïìïï,blackmoore,767,demonhunter,havoc,12,8,4
Marmelademad,twisting-nether,767,demonhunter,havoc,12,8,4
Glevenuschii,blackmoore,767,demonhunter,havoc,18,9,9
Mayaken,ravencrest,767,demonhunter,havoc,18,8,10
Lirigizel,hellscream,767,demonhunter,havoc,18,8,10
Вафлистикус,ashenvale,767,demonhunter,havoc,18,8,10
Evandel,silvermoon,767,demonhunter,havoc,18,8,10
Kithan,zuljin,767,demonhunter,havoc,18,8,10
Zmasteez,ahnqiraj,767,demonhunter,havoc,18,8,10
Shax,hellscream,767,demonhunter,havoc,18,8,10
Kittenz,outland,767,demonhunter,havoc,18,8,10
Zedies,argent-dawn,767,demonhunter,havoc,18,8,10
Рикельме,gordunni,767,demonhunter,havoc,18,8,10
Caronte,los-errantes,767,demonhunter,havoc,18,8,10
Terrorblader,malygos,767,demonhunter,havoc,21,9,12
Calendith,arathor,767,demonhunter,havoc,21,9,12
Salamihexler,dun-morogh,767,demonhunter,havoc,23,8,15
Dìus,blackmoore,767,demonhunter,havoc,24,8,16
Shaaton,ysondre,767,demonhunter,havoc,24,8,16
Skrelarent,argent-dawn,766,demonhunter,havoc,12,8,4
Klerikerin,blackmoore,766,demonhunter,havoc,12,8,4
Trøbblete,ragnaros,766,demonhunter,havoc,12,8,4
Rfosop,chants-éternels,766,demonhunter,havoc,12,8,4
Хандза,gordunni,766,demonhunter,havoc,18,8,10
Nairu,doomhammer,766,demonhunter,havoc,18,8,10
Thrina,blackmoore,766,demonhunter,havoc,18,8,10
Klinnaa,elune,766,demonhunter,havoc,18,8,10
Varthag,antonidas,766,demonhunter,havoc,18,8,10
Neiden,deathwing,766,demonhunter,havoc,24,8,16
Granitaa,archimonde,765,demonhunter,havoc,12,8,4
Apfelkuchen,eredar,765,demonhunter,havoc,12,8,4
Akäly,hyjal,765,demonhunter,havoc,19,9,10
Karakaartaal,silvermoon,765,demonhunter,havoc,18,8,10
Sildanah,hyjal,765,demonhunter,havoc,18,8,10
Jimpanik,ravencrest,765,demonhunter,havoc,18,8,10
Nîksa,aegwynn,765,demonhunter,havoc,24,8,16
Aelzeran,stormscale,765,demonhunter,havoc,24,8,16
Zumbly,silvermoon,765,demonhunter,havoc,24,8,16
Flamme,amanthul,764,demonhunter,havoc,98,45,53
Noxxi,gorgonnash,764,demonhunter,havoc,18,8,10
Blackrdemon,azjolnerub,763,demonhunter,havoc,12,8,4
Erenyeagerr,kazzak,763,demonhunter,havoc,16,9,7
Saìras,blackhand,763,demonhunter,havoc,18,8,10
Cindras,turalyon,763,demonhunter,havoc,18,8,10
Covidian,kilrogg,762,demonhunter,havoc,12,8,4
Funálfa,sylvanas,762,demonhunter,havoc,12,8,4
Ridweng,ravenholdt,762,demonhunter,havoc,13,8,5
Zydemon,silvermoon,762,demonhunter,havoc,18,8,10
Unsainted,blackhand,762,demonhunter,havoc,24,8,16
Amaterasù,alleria,761,demonhunter,havoc,18,8,10
Норилайнн,gordunni,761,demonhunter,havoc,24,8,16
Sinrii,archimonde,760,demonhunter,havoc,16,9,7
Stàmàzza,nemesis,760,demonhunter,havoc,18,8,10
Hairebutter,kult-der-verdammten,760,demonhunter,havoc,30,8,22
Azazël,turalyon,759,demonhunter,havoc,27,9,18
Mandemz,nagrand,759,demonhunter,havoc,24,8,16
Chaordic,turalyon,758,demonhunter,havoc,24,8,16
Déstructiva,blackhand,757,demonhunter,havoc,36,8,28
Tooltip,outland,755,demonhunter,havoc,24,8,16
Alfazar,pozzo-delleternità,754,demonhunter,havoc,92,30,62
Lailat,alexstrasza,752,demonhunter,havoc,16,9,7
Deamo,stormscale,750,demonhunter,havoc,23,8,15
Shinyshuckle,stormscale,745,demonhunter,havoc,23,8,15
Zealdancer,veknilash,734,demonhunter,havoc,17,8,9
Opvoksterxx,sylvanas,733,demonhunter,havoc,22,8,14
Daedris,tarren-mill,727,demonhunter,havoc,23,8,15
Неверластх,gordunni,720,demonhunter,havoc,21,8,13
Carater,uldum,719,demonhunter,havoc,16,9,7
Hashwidow,archimonde,719,demonhunter,havoc,15,8,7
Makiu,archimonde,717,demonhunter,havoc,21,8,13
Liondam,pozzo-delleternità,707,demonhunter,havoc,42,13,29
Caøtix,blackrock,702,demonhunter,havoc,19,9,10
Stormshred,stormscale,700,demonhunter,havoc,27,8,19
Yeyote,dun-modr,695,demonhunter,havoc,15,10,5
Stixxs,archimonde,691,demonhunter,havoc,14,8,6
Itzrazor,ravencrest,683,demonhunter,havoc,25,8,17
Devendora,antonidas,681,demonhunter,havoc,23,10,13
Prouser,turalyon,678,demonhunter,havoc,27,9,18
Izior,drakthul,672,demonhunter,havoc,12,7,5
Chaosknight,outland,672,demonhunter,havoc,12,7,5
Psynotic,kazzak,672,demonhunter,havoc,12,7,5
Lemiisa,burning-blade,672,demonhunter,havoc,12,7,5
Gorinda,twisting-nether,672,demonhunter,havoc,12,7,5
Arylinn,tarren-mill,672,demonhunter,havoc,12,7,5
Джэба,gordunni,672,demonhunter,havoc,12,7,5
Bwipøo,alakir,672,demonhunter,havoc,12,7,5
Esadeáth,ravencrest,672,demonhunter,havoc,12,7,5
Rozikosi,magtheridon,672,demonhunter,havoc,12,7,5
Vlexsuave,stormscale,672,demonhunter,havoc,12,7,5
Vidagín,blackmoore,672,demonhunter,havoc,12,7,5
Víllaiin,tarren-mill,672,demonhunter,havoc,12,7,5
Lornashøre,blackmoore,672,demonhunter,havoc,12,7,5
Crispychick,stormscale,672,demonhunter,havoc,12,7,5
Fumroned,twisting-nether,672,demonhunter,havoc,12,7,5
Pepenger,kazzak,672,demonhunter,havoc,12,7,5
Eydipha,blackmoore,672,demonhunter,havoc,12,7,5
Dreamreaperx,ravencrest,672,demonhunter,havoc,12,7,5
Stonedaf,ravencrest,672,demonhunter,havoc,12,7,5
Sfigmenos,sylvanas,672,demonhunter,havoc,12,7,5
Brutodh,stormscale,672,demonhunter,havoc,12,7,5
Atrikagodx,kazzak,672,demonhunter,havoc,12,7,5
Клаес,howling-fjord,672,demonhunter,havoc,12,7,5
Damnituther,kazzak,672,demonhunter,havoc,12,7,5
Vazaí,ravencrest,672,demonhunter,havoc,12,7,5
Varkósa,sylvanas,672,demonhunter,havoc,12,7,5
Ilidansdaddy,twisting-nether,672,demonhunter,havoc,12,7,5
Remiyo,eredar,672,demonhunter,havoc,12,7,5
Lëtho,colinas-pardas,672,demonhunter,havoc,12,7,5
Amovea,draenor,672,demonhunter,havoc,15,8,7
Kayzer,hyjal,672,demonhunter,havoc,16,8,8
Itsfinee,outland,672,demonhunter,havoc,14,7,7
Størmrage,sanguino,672,demonhunter,havoc,18,7,11
Ostosbigego,ravencrest,672,demonhunter,havoc,18,7,11
Шликшлик,blackscar,672,demonhunter,havoc,18,7,11
Foltek,silvermoon,672,demonhunter,havoc,18,7,11
Veryfunhaha,ravencrest,672,demonhunter,havoc,18,7,11
Келидаррия,soulflayer,672,demonhunter,havoc,18,7,11
Wrathia,rexxar,672,demonhunter,havoc,18,7,11
Ashivari,argent-dawn,672,demonhunter,havoc,18,7,11
Grazax,lightnings-blade,672,demonhunter,havoc,18,7,11
Этотрагедия,howling-fjord,672,demonhunter,havoc,18,7,11
Reachfight,lothar,672,demonhunter,havoc,18,7,11
Nori,malganis,672,demonhunter,havoc,18,7,11
Alàstora,twisting-nether,672,demonhunter,havoc,18,7,11
Kruthor,taerar,672,demonhunter,havoc,18,7,11
Enami,kazzak,672,demonhunter,havoc,18,7,11
Jurihan,blackhand,672,demonhunter,havoc,18,7,11
Abigorien,blackmoore,672,demonhunter,havoc,18,7,11
Gorilla,korgall,672,demonhunter,havoc,18,7,11
Pelko,sanguino,672,demonhunter,havoc,18,7,11
Hatabaa,argent-dawn,672,demonhunter,havoc,18,7,11
Kiô,drakthul,672,demonhunter,havoc,21,8,13
Hârambe,stormscale,672,demonhunter,havoc,24,8,16
Darkdh,sanguino,672,demonhunter,havoc,24,7,17
Illidorie,twisting-nether,672,demonhunter,havoc,24,7,17
Iamayaqt,nemesis,672,demonhunter,havoc,24,7,17
Paîmon,hyjal,672,demonhunter,havoc,24,7,17
Jokas,archimonde,672,demonhunter,havoc,24,7,17
Zenga,kazzak,671,demonhunter,havoc,12,7,5
Meji,ravencrest,671,demonhunter,havoc,12,7,5
Ddvh,drakthul,671,demonhunter,havoc,12,7,5
Aladír,malygos,671,demonhunter,havoc,12,7,5
Kap,kazzak,671,demonhunter,havoc,12,7,5
Randydhunt,draenor,671,demonhunter,havoc,12,7,5
Marcellaa,ravencrest,671,demonhunter,havoc,12,7,5
Zhynia,blackmoore,671,demonhunter,havoc,12,7,5
Nxmpys,sanguino,671,demonhunter,havoc,12,7,5
Youngboost,blackrock,671,demonhunter,havoc,12,7,5
Phaël,ravencrest,671,demonhunter,havoc,12,7,5
Haragazu,blackrock,671,demonhunter,havoc,12,7,5
Rabischu,echsenkessel,671,demonhunter,havoc,15,8,7
Corelly,ragnaros,671,demonhunter,havoc,18,7,11
Moireananke,frostwolf,671,demonhunter,havoc,18,7,11
Takeshí,burning-legion,671,demonhunter,havoc,18,7,11
Gearuzaki,ghostlands,671,demonhunter,havoc,18,7,11
Тирандил,grom,671,demonhunter,havoc,18,7,11
Critheria,wildhammer,671,demonhunter,havoc,18,7,11
Okoral,dun-modr,671,demonhunter,havoc,18,7,11
Abrahêll,dun-modr,671,demonhunter,havoc,18,7,11
Norebb,sanguino,671,demonhunter,havoc,18,7,11
Illidarios,blackhand,671,demonhunter,havoc,18,7,11
Venkz,archimonde,671,demonhunter,havoc,18,7,11
Moððe,defias-brotherhood,671,demonhunter,havoc,18,7,11
Irenth,burning-legion,671,demonhunter,havoc,19,7,12
Pravda,terokkar,671,demonhunter,havoc,20,7,13
Donstyle,anachronos,671,demonhunter,havoc,22,7,15
Talyrîs,aegwynn,671,demonhunter,havoc,24,7,17
Lahan,twisting-nether,670,demonhunter,havoc,12,7,5
Demonglide,moonglade,670,demonhunter,havoc,12,7,5
Älger,archimonde,670,demonhunter,havoc,12,7,5
Hyunkél,kirin-tor,670,demonhunter,havoc,18,7,11
Atronäx,dun-modr,670,demonhunter,havoc,18,7,11
Ungeist,blackrock,670,demonhunter,havoc,18,7,11
Tarók,ragnaros,670,demonhunter,havoc,18,7,11
Avus,burning-legion,670,demonhunter,havoc,18,7,11
Xtrmhunter,ysondre,670,demonhunter,havoc,18,7,11
Léeroy,blackmoore,670,demonhunter,havoc,30,7,23
Nmeule,turalyon,669,demonhunter,havoc,12,7,5
Rahteri,hellfire,669,demonhunter,havoc,12,7,5
Akina,krasus,669,demonhunter,havoc,18,7,11
Kíssemurra,azjolnerub,669,demonhunter,havoc,18,7,11
Necrotyle,twisting-nether,669,demonhunter,havoc,21,8,13
Gangrazorg,garona,667,demonhunter,havoc,18,7,11
Дядяэл,fordragon,667,demonhunter,havoc,24,7,17
Farlopon,dun-modr,667,demonhunter,havoc,36,7,29
Mormefiél,twisting-nether,666,demonhunter,havoc,12,7,5
Fugma,defias-brotherhood,666,demonhunter,havoc,12,7,5
Baeblade,ragnaros,666,demonhunter,havoc,12,7,5
Seeshark,thrall,665,demonhunter,havoc,16,8,8
Ztef,outland,665,demonhunter,havoc,30,7,23
Demonyz,hyjal,664,demonhunter,havoc,18,7,11
Rúpél,thrall,664,demonhunter,havoc,24,7,17
Illidancz,thunderhorn,662,demonhunter,havoc,19,8,11
Darkleaf,sporeggar,662,demonhunter,havoc,24,7,17
Solian,ravencrest,661,demonhunter,havoc,12,7,5
Styhawk,zuljin,658,demonhunter,havoc,12,7,5
Nazzan,destromath,657,demonhunter,havoc,12,7,5
Demoncancer,kazzak,657,demonhunter,havoc,12,7,5
Anishara,die-nachtwache,653,demonhunter,havoc,19,8,11
Caesares,azjolnerub,653,demonhunter,havoc,24,7,17
Kaleyah,gorgonnash,651,demonhunter,havoc,18,7,11
Попкасиська,eversong,651,demonhunter,havoc,65,22,43
Deadali,stormscale,649,demonhunter,havoc,18,7,11
Smîrky,silvermoon,640,demonhunter,havoc,22,7,15
Tavarion,thrall,639,demonhunter,havoc,14,8,6
Летучий,howling-fjord,638,demonhunter,havoc,14,8,6
Lexxdh,blackmoore,637,demonhunter,havoc,14,8,6
Nofelings,twisting-nether,634,demonhunter,havoc,34,8,26
Vesria,stormrage,627,demonhunter,havoc,16,8,8
Snelle,outland,624,demonhunter,havoc,15,7,8
Valandyl,ysondre,623,demonhunter,havoc,11,7,4
Подкрадунзай,soulflayer,621,demonhunter,havoc,12,9,3
Юзалесщит,soulflayer,618,demonhunter,havoc,21,8,13
Makhabunda,terokkar,618,demonhunter,havoc,28,8,20
Illidrak,sylvanas,617,demonhunter,havoc,21,8,13
Hyperflex,blackrock,608,demonhunter,havoc,16,7,9
Phalekxox,ravencrest,607,demonhunter,havoc,11,7,4
Predatrix,khaz-modan,606,demonhunter,havoc,14,7,7
Линдорм,deathguard,603,demonhunter,havoc,14,7,7
Sorgnarol,dalaran,602,demonhunter,havoc,22,8,14
Samurase,kazzak,597,demonhunter,havoc,20,7,13
Nahlendris,darkmoon-faire,596,demonhunter,havoc,16,7,9
Thesasuke,tarren-mill,590,demonhunter,havoc,11,7,4
Povamateur,rexxar,576,demonhunter,havoc,6,6,0
Клиффорд,gordunni,576,demonhunter,havoc,6,6,0
Mímð,ravencrest,576,demonhunter,havoc,6,6,0
Alasune,twisting-nether,576,demonhunter,havoc,6,6,0
Chicorycofee,archimonde,576,demonhunter,havoc,9,7,2
Demoqt,ragnaros,576,demonhunter,havoc,10,7,3
Fîrstwolf,silvermoon,576,demonhunter,havoc,12,6,6
Friidaadh,lightbringer,576,demonhunter,havoc,12,6,6
Clapping,blackhand,576,demonhunter,havoc,12,6,6
Imdrevil,ravencrest,576,demonhunter,havoc,12,6,6
Noovedh,ravencrest,576,demonhunter,havoc,12,6,6
Dakydh,ravencrest,576,demonhunter,havoc,12,6,6
Maximuspizza,tarren-mill,576,demonhunter,havoc,12,6,6
Bep,defias-brotherhood,576,demonhunter,havoc,12,6,6
Swearix,twisting-nether,576,demonhunter,havoc,12,6,6
Jaace,silvermoon,576,demonhunter,havoc,12,6,6
Avadåra,stormscale,576,demonhunter,havoc,12,6,6
Nélathas,twisting-nether,576,demonhunter,havoc,12,6,6
Mendøøza,hyjal,576,demonhunter,havoc,12,6,6
Amnesiax,der-rat-von-dalaran,576,demonhunter,havoc,12,6,6
Cagirnat,tarren-mill,576,demonhunter,havoc,12,6,6
Reppz,blackmoore,576,demonhunter,havoc,12,6,6
Kazeha,tarren-mill,576,demonhunter,havoc,12,6,6
Dàrknight,azjolnerub,576,demonhunter,havoc,12,6,6
Smashine,silvermoon,576,demonhunter,havoc,12,6,6
Liädriss,tarren-mill,576,demonhunter,havoc,12,6,6
Shinrpz,archimonde,576,demonhunter,havoc,12,6,6
Brajjo,frostmane,576,demonhunter,havoc,12,6,6
Felrunner,grim-batol,576,demonhunter,havoc,12,6,6
Nitrobeevz,blackmoore,576,demonhunter,havoc,12,6,6
Bigbrain,festung-der-stürme,576,demonhunter,havoc,12,6,6
Daiax,ravencrest,576,demonhunter,havoc,12,6,6
Mårvænn,hyjal,576,demonhunter,havoc,12,6,6
Mau,blackmoore,576,demonhunter,havoc,12,6,6
Брилаброви,soulflayer,576,demonhunter,havoc,12,6,6
Bradzdh,outland,576,demonhunter,havoc,12,6,6
Peacedopice,drakthul,576,demonhunter,havoc,12,6,6
Threebuttøns,ravencrest,576,demonhunter,havoc,12,6,6
Miyxcu,aegwynn,576,demonhunter,havoc,12,6,6
Lesamaritain,ysondre,576,demonhunter,havoc,12,6,6
Zsídakabra,ragnaros,576,demonhunter,havoc,12,6,6
Adírael,cthun,576,demonhunter,havoc,12,6,6
Alrashidi,ravencrest,576,demonhunter,havoc,12,6,6
Credenzx,frostmane,576,demonhunter,havoc,12,6,6
Onkwang,twisting-nether,576,demonhunter,havoc,12,6,6
Soulmortal,draenor,576,demonhunter,havoc,12,6,6
Elsibal,dunemaul,576,demonhunter,havoc,12,6,6
Lurtéx,kazzak,576,demonhunter,havoc,12,6,6
Mitzii,nazjatar,576,demonhunter,havoc,12,6,6
Thoridin,draenor,576,demonhunter,havoc,12,6,6
Illidangr,sylvanas,576,demonhunter,havoc,12,6,6
Ferrero,guldan,576,demonhunter,havoc,12,6,6
Tëvnic,kazzak,576,demonhunter,havoc,12,6,6
Нулевыйчел,gordunni,576,demonhunter,havoc,12,6,6
Malethrienna,argent-dawn,576,demonhunter,havoc,12,6,6
Mortyb,kazzak,576,demonhunter,havoc,12,6,6
Zeyrax,ragnaros,576,demonhunter,havoc,12,6,6
Сурек,howling-fjord,576,demonhunter,havoc,12,6,6
Gzmo,tarren-mill,576,demonhunter,havoc,12,6,6
Ксен,howling-fjord,576,demonhunter,havoc,12,6,6
Sickdoci,kazzak,576,demonhunter,havoc,12,6,6
Grimner,silvermoon,576,demonhunter,havoc,12,6,6
Shreeð,blackmoore,576,demonhunter,havoc,16,7,9
Shyoxdh,twisting-nether,576,demonhunter,havoc,18,6,12
Bitex,archimonde,576,demonhunter,havoc,18,6,12
Becknárn,sylvanas,576,demonhunter,havoc,18,6,12
Gendó,twisting-nether,576,demonhunter,havoc,18,6,12
Dèsdemøna,nemesis,576,demonhunter,havoc,18,6,12
Кальнмиир,soulflayer,576,demonhunter,havoc,18,6,12
Devourr,ravencrest,576,demonhunter,havoc,18,6,12
Pinx,archimonde,576,demonhunter,havoc,18,6,12
Blueformeld,draenor,576,demonhunter,havoc,18,6,12
Mythnimue,tarren-mill,576,demonhunter,havoc,18,6,12
Dlarkyl,drakthul,576,demonhunter,havoc,18,6,12
Chíwas,outland,576,demonhunter,havoc,18,6,12
Tthic,shadowsong,576,demonhunter,havoc,18,6,12
Sorrøwblade,drakthul,576,demonhunter,havoc,18,6,12
Kukulkanx,tarren-mill,576,demonhunter,havoc,18,6,12
Nøøßønline,hyjal,576,demonhunter,havoc,18,6,12
Awawaaw,tarren-mill,576,demonhunter,havoc,18,6,12
Zomaso,kazzak,576,demonhunter,havoc,18,6,12
Rurt,sanguino,576,demonhunter,havoc,18,6,12
Филеровщик,deathguard,576,demonhunter,havoc,18,6,12
Zaÿn,antonidas,576,demonhunter,havoc,18,6,12
Pokálen,drakthul,576,demonhunter,havoc,18,6,12
Alandiel,twisting-nether,576,demonhunter,havoc,18,6,12
Lilpeepfan,hyjal,576,demonhunter,havoc,18,6,12
Thewalker,argent-dawn,576,demonhunter,havoc,24,6,18
Pèpsì,kazzak,576,demonhunter,havoc,24,6,18
Кранище,howling-fjord,576,demonhunter,havoc,24,6,18
Redgi,tarren-mill,576,demonhunter,havoc,24,6,18
Стараятварь,thermaplugg,576,demonhunter,havoc,24,6,18
Dimonhunta,tarren-mill,576,demonhunter,havoc,24,6,18
Shizuuli,outland,576,demonhunter,havoc,30,6,24
Patologia,burning-legion,575,demonhunter,havoc,9,7,2
Mendøza,hyjal,575,demonhunter,havoc,12,6,6
Thärius,silvermoon,575,demonhunter,havoc,12,6,6
Davdavdh,tarren-mill,575,demonhunter,havoc,12,6,6
Kramixx,thrall,575,demonhunter,havoc,12,6,6
Instinctivee,sylvanas,575,demonhunter,havoc,12,6,6
Plafos,sanguino,575,demonhunter,havoc,12,6,6
Tôrxy,antonidas,575,demonhunter,havoc,12,6,6
Nassou,hyjal,575,demonhunter,havoc,12,6,6
Saftad,outland,575,demonhunter,havoc,12,6,6
Rooster,malganis,575,demonhunter,havoc,12,6,6
Sûnfury,draenor,575,demonhunter,havoc,12,6,6
Firebladeza,ravencrest,575,demonhunter,havoc,12,6,6
Valshatt,sanguino,575,demonhunter,havoc,12,6,6
Куню,gordunni,575,demonhunter,havoc,12,6,6
Arløw,archimonde,575,demonhunter,havoc,16,7,9
Yundmida,antonidas,575,demonhunter,havoc,18,6,12
Generaaloo,ragnaros,575,demonhunter,havoc,18,6,12
Зедю,howling-fjord,575,demonhunter,havoc,18,6,12
Talrundir,argent-dawn,575,demonhunter,havoc,18,6,12
Joezus,draenor,575,demonhunter,havoc,18,6,12
Milleniumx,aegwynn,575,demonhunter,havoc,18,6,12
Tixe,thrall,575,demonhunter,havoc,18,6,12
Darkshadez,ravencrest,575,demonhunter,havoc,18,6,12
Candylicks,kazzak,575,demonhunter,havoc,18,6,12
Switzar,kazzak,575,demonhunter,havoc,18,6,12
Synistera,trollbane,575,demonhunter,havoc,18,6,12
Trép,draenor,575,demonhunter,havoc,18,6,12
Бтдыш,azuregos,575,demonhunter,havoc,24,6,18
Grinchdemon,nagrand,574,demonhunter,havoc,12,6,6
Lenuna,frostmourne,574,demonhunter,havoc,18,6,12
Altacer,defias-brotherhood,574,demonhunter,havoc,18,6,12
Klave,argent-dawn,573,demonhunter,havoc,18,6,12
Elindoria,dalaran,572,demonhunter,havoc,12,6,6
Dæmonhønter,draenor,572,demonhunter,havoc,26,6,20
Arxaxe,sanguino,571,demonhunter,havoc,12,6,6
Hamssterek,magtheridon,571,demonhunter,havoc,18,6,12
Bahmut,argent-dawn,569,demonhunter,havoc,12,6,6
Ðéstrøz,draenor,564,demonhunter,havoc,23,10,13
Darkraiser,blackmoore,544,demonhunter,havoc,16,7,9
Ayylmfao,sanguino,541,demonhunter,havoc,11,6,5
Tiucciah,kirin-tor,539,demonhunter,havoc,11,6,5
Foxylama,stormscale,528,demonhunter,havoc,15,7,8
Panejo,drakthul,528,demonhunter,havoc,15,6,9
Manybuttons,tarren-mill,522,demonhunter,havoc,16,7,9
Алистреель,gordunni,521,demonhunter,havoc,13,7,6
Джэкмэн,soulflayer,520,demonhunter,havoc,29,8,21
Laylay,vashj,513,demonhunter,havoc,37,7,30
Kaev,ravencrest,512,demonhunter,havoc,22,6,16
Zethraxxur,outland,511,demonhunter,havoc,11,6,5
Gnjurac,outland,511,demonhunter,havoc,14,6,8
Asperity,antonidas,511,demonhunter,havoc,18,6,12
Plagues,quelthalas,510,demonhunter,havoc,20,10,10
Morrion,blackmoore,480,demonhunter,havoc,6,5,1
Rufihuntdemo,blackmoore,480,demonhunter,havoc,6,5,1
Madator,eredar,480,demonhunter,havoc,6,5,1
Nanába,draenor,480,demonhunter,havoc,6,5,1
Sykzdh,hyjal,480,demonhunter,havoc,6,5,1
Ismelldemons,silvermoon,480,demonhunter,havoc,6,5,1
Sinarel,die-aldor,480,demonhunter,havoc,6,5,1
Katkott,kazzak,480,demonhunter,havoc,6,5,1
Gansh,draenor,480,demonhunter,havoc,6,5,1
Ybo,tarren-mill,480,demonhunter,havoc,6,5,1
Mouga,hyjal,480,demonhunter,havoc,6,5,1
Wyzedh,blackrock,480,demonhunter,havoc,6,5,1
Avavidh,blackmoore,480,demonhunter,havoc,6,5,1
Shazima,sylvanas,480,demonhunter,havoc,6,5,1
Monion,defias-brotherhood,480,demonhunter,havoc,6,5,1
Setthanol,burning-legion,480,demonhunter,havoc,6,5,1
Harpyia,azshara,480,demonhunter,havoc,6,5,1
Lîlìllíðårî,the-maelstrom,480,demonhunter,havoc,6,5,1
Fellstone,kazzak,480,demonhunter,havoc,6,5,1
Miscodedh,ravencrest,480,demonhunter,havoc,9,6,3
Jayjây,outland,480,demonhunter,havoc,12,5,7
Милифесена,gordunni,480,demonhunter,havoc,12,5,7
Блэйэмих,gordunni,480,demonhunter,havoc,12,5,7
Беатриз,soulflayer,480,demonhunter,havoc,12,5,7
Winarchiksex,tarren-mill,480,demonhunter,havoc,12,5,7
Неондх,eversong,480,demonhunter,havoc,12,5,7
Fefestyle,silvermoon,480,demonhunter,havoc,12,5,7
Hørnyßæ,drakthul,480,demonhunter,havoc,12,5,7
Demonpimpf,blackrock,480,demonhunter,havoc,12,5,7
Bigbootáy,silvermoon,480,demonhunter,havoc,12,5,7
Tomkis,ravencrest,480,demonhunter,havoc,12,5,7
Tatoos,bronze-dragonflight,480,demonhunter,havoc,12,5,7
Nagh,archimonde,480,demonhunter,havoc,12,5,7
Granite,blackrock,480,demonhunter,havoc,12,5,7
Дракомуфлон,gordunni,480,demonhunter,havoc,12,5,7
Smashdaddý,tarren-mill,480,demonhunter,havoc,12,5,7
Topg,bladefist,480,demonhunter,havoc,12,5,7
Vyers,argent-dawn,480,demonhunter,havoc,12,5,7
Véspé,naxxramas,480,demonhunter,havoc,12,5,7
Максимлолпро,howling-fjord,480,demonhunter,havoc,12,5,7
Spiiky,kazzak,480,demonhunter,havoc,12,5,7
Malvax,tarren-mill,480,demonhunter,havoc,12,5,7
Dogdeeps,silvermoon,480,demonhunter,havoc,12,5,7
Thelyan,ravencrest,480,demonhunter,havoc,12,5,7
Spitface,aegwynn,480,demonhunter,havoc,12,5,7
Шикзаль,deathguard,480,demonhunter,havoc,12,5,7
Tastyblades,blackmoore,480,demonhunter,havoc,12,5,7
Takad,twisting-nether,480,demonhunter,havoc,12,5,7
Superchocowo,sanguino,480,demonhunter,havoc,12,5,7
Zunada,ragnaros,480,demonhunter,havoc,12,5,7
Hajeva,ravencrest,480,demonhunter,havoc,12,5,7
Bloodilidari,ragnaros,480,demonhunter,havoc,12,5,7
Icurogue,kazzak,480,demonhunter,havoc,12,5,7
Éla,stormscale,480,demonhunter,havoc,12,5,7
Noether,blackrock,480,demonhunter,havoc,12,5,7
Reikuel,nemesis,480,demonhunter,havoc,12,5,7
Blind,kazzak,480,demonhunter,havoc,12,5,7
Kindred,anachronos,480,demonhunter,havoc,12,5,7
Lårxx,draenor,480,demonhunter,havoc,12,5,7
Ukumeqt,kazzak,480,demonhunter,havoc,12,5,7
Rihal,stormscale,480,demonhunter,havoc,12,5,7
Dzikalocha,burning-legion,480,demonhunter,havoc,12,5,7
Odda,los-errantes,480,demonhunter,havoc,12,5,7
Диртхамен,blackscar,480,demonhunter,havoc,12,5,7
Пупчански,howling-fjord,480,demonhunter,havoc,12,5,7
Алекзей,gordunni,480,demonhunter,havoc,12,5,7
Khenetai,silvermoon,480,demonhunter,havoc,12,5,7
Dirael,dalaran,480,demonhunter,havoc,12,5,7
Glìmpsêgøðx,antonidas,480,demonhunter,havoc,12,5,7
Иаред,gordunni,480,demonhunter,havoc,12,5,7
Âstræa,antonidas,480,demonhunter,havoc,12,5,7
Deccal,blackmoore,480,demonhunter,havoc,12,5,7
Bengleng,draenor,480,demonhunter,havoc,18,5,13
Natarásh,blackmoore,480,demonhunter,havoc,18,5,13
Crushidemon,draenor,480,demonhunter,havoc,18,5,13
Разагеш,gordunni,480,demonhunter,havoc,18,5,13
Xeiiv,lothar,480,demonhunter,havoc,18,5,13
Конглея,gordunni,480,demonhunter,havoc,18,5,13
Ascindra,kazzak,480,demonhunter,havoc,18,5,13
Dübler,gorgonnash,480,demonhunter,havoc,18,5,13
Gailiugas,kazzak,480,demonhunter,havoc,18,5,13
Камбечная,soulflayer,480,demonhunter,havoc,18,5,13
Kritflake,blackrock,480,demonhunter,havoc,18,5,13
Alleyezønme,outland,480,demonhunter,havoc,18,5,13
Wajoglaive,blackhand,480,demonhunter,havoc,18,5,13
Nefastia,pozzo-delleternità,480,demonhunter,havoc,18,5,13
Zimmerdin,blackmoore,480,demonhunter,havoc,18,5,13
Aelina,area-52,480,demonhunter,havoc,18,5,13
Imperio,tarren-mill,480,demonhunter,havoc,18,5,13
Laclé,archimonde,480,demonhunter,havoc,24,5,19
Aygael,archimonde,480,demonhunter,havoc,30,5,25
Kalodir,malygos,479,demonhunter,havoc,6,5,1
Séo,draenor,479,demonhunter,havoc,12,5,7
Escoo,blackmoore,479,demonhunter,havoc,12,5,7
Demontevz,outland,479,demonhunter,havoc,12,5,7
Gryphory,ravencrest,479,demonhunter,havoc,12,5,7
Jonasdh,antonidas,479,demonhunter,havoc,12,5,7
Dedaronnes,hyjal,479,demonhunter,havoc,12,5,7
Chàuvequipeu,dalaran,479,demonhunter,havoc,12,5,7
Mulda,dun-morogh,479,demonhunter,havoc,12,5,7
Ирилан,deepholm,479,demonhunter,havoc,12,5,7
Shekny,sanguino,479,demonhunter,havoc,12,5,7
Nagareth,uldum,479,demonhunter,havoc,12,5,7
Макай,deathguard,479,demonhunter,havoc,12,5,7
Bchj,ysondre,479,demonhunter,havoc,12,5,7
Мйрасаа,gordunni,479,demonhunter,havoc,12,5,7
Demonicus,tarren-mill,479,demonhunter,havoc,12,5,7
Asperatus,dalaran,479,demonhunter,havoc,18,5,13
Wïzzp,magtheridon,479,demonhunter,havoc,18,5,13
Arasy,los-errantes,479,demonhunter,havoc,18,5,13
Pmiguel,aggra-português,479,demonhunter,havoc,18,5,13
Shonal,defias-brotherhood,479,demonhunter,havoc,18,5,13
Deasdh,tarren-mill,478,demonhunter,havoc,12,5,7
Скудайвер,gordunni,478,demonhunter,havoc,12,5,7
Greyfel,blackhand,478,demonhunter,havoc,20,7,13
Tuffêli,turalyon,478,demonhunter,havoc,18,5,13
Мелликсин,gordunni,478,demonhunter,havoc,24,5,19
Dhakaan,silvermoon,477,demonhunter,havoc,6,5,1
Kairidemon,eredar,477,demonhunter,havoc,12,5,7
Язамясо,gordunni,477,demonhunter,havoc,18,5,13
Thefightergz,terokkar,477,demonhunter,havoc,18,5,13
Гачирабыня,lich-king,477,demonhunter,havoc,30,5,25
Vincbengt,tarren-mill,476,demonhunter,havoc,12,5,7
Satanayl,stormscale,475,demonhunter,havoc,15,5,10
Hellforce,nemesis,474,demonhunter,havoc,12,5,7
Illikan,stormscale,474,demonhunter,havoc,12,5,7
Etraidor,turalyon,473,demonhunter,havoc,12,5,7
Mayyhem,blackrock,472,demonhunter,havoc,17,7,10
Dakrey,blackmoore,467,demonhunter,havoc,18,5,13
Morathie,kazzak,462,demonhunter,havoc,11,5,6
Luferite,burning-blade,455,demonhunter,havoc,27,7,20
Brasa,pozzo-delleternità,448,demonhunter,havoc,10,5,5
Bertori,dun-modr,447,demonhunter,havoc,12,6,6
Shaundead,drakthul,447,demonhunter,havoc,11,5,6
Huntingmilfs,ravencrest,447,demonhunter,havoc,11,5,6
Habara,dun-modr,447,demonhunter,havoc,11,5,6
Káhúsz,ragnaros,447,demonhunter,havoc,17,5,12
Amatèrasu,burning-legion,435,demonhunter,havoc,38,8,30
Иллианэль,howling-fjord,432,demonhunter,havoc,9,5,4
Icantfitmyna,draenor,432,demonhunter,havoc,15,5,10
Xaro,quelthalas,431,demonhunter,havoc,11,5,6
Martøsdh,uldum,426,demonhunter,havoc,12,6,6
Ailisdmgbotx,drakthul,426,demonhunter,havoc,15,7,8
Høw,ravencrest,415,demonhunter,havoc,8,5,3
Axeldardh,draenor,415,demonhunter,havoc,11,6,5
Zyfu,antonidas,415,demonhunter,havoc,11,5,6
Lumpp,drakthul,415,demonhunter,havoc,14,5,9
Drstn,blackmoore,415,demonhunter,havoc,16,5,11
Theend,das-konsortium,384,demonhunter,havoc,6,4,2
Docos,genjuros,384,demonhunter,havoc,6,4,2
Варгаст,blackscar,384,demonhunter,havoc,6,4,2
Varonx,drakthul,384,demonhunter,havoc,6,4,2
Blizodh,tarren-mill,384,demonhunter,havoc,6,4,2
Atti,the-maelstrom,384,demonhunter,havoc,6,4,2
Raydhd,tarren-mill,384,demonhunter,havoc,6,4,2
Kriszidan,arathor,384,demonhunter,havoc,6,4,2
Wuzzabi,darksorrow,384,demonhunter,havoc,6,4,2
Iken,ragnaros,384,demonhunter,havoc,6,4,2
Kimura,the-maelstrom,384,demonhunter,havoc,6,4,2
Shavidan,antonidas,384,demonhunter,havoc,6,4,2
Valdrake,burning-legion,384,demonhunter,havoc,6,4,2
Bartoshek,auchindoun,384,demonhunter,havoc,6,4,2
Frombegin,lordaeron,384,demonhunter,havoc,6,4,2
Плэкс,howling-fjord,384,demonhunter,havoc,6,4,2
Drölfchicken,frostwolf,384,demonhunter,havoc,6,4,2
Rageglaive,ragnaros,384,demonhunter,havoc,6,4,2
Asgorth,eredar,384,demonhunter,havoc,6,4,2
Garra,chants-éternels,384,demonhunter,havoc,6,4,2
Intøxixxixx,stormscale,384,demonhunter,havoc,6,4,2
Epicelf,hyjal,384,demonhunter,havoc,6,4,2
Deriidan,garrosh,384,demonhunter,havoc,6,4,2
Caramelmou,chogall,384,demonhunter,havoc,6,4,2
Srryimretard,dun-modr,384,demonhunter,havoc,6,4,2
Séismic,outland,384,demonhunter,havoc,6,4,2
Daemonmatt,outland,384,demonhunter,havoc,6,4,2
Nelathas,twisting-nether,384,demonhunter,havoc,6,4,2
Jyraxs,archimonde,384,demonhunter,havoc,6,4,2
Rocksn,blackmoore,384,demonhunter,havoc,6,4,2
Shïca,sanguino,384,demonhunter,havoc,6,4,2
Zíkár,kazzak,384,demonhunter,havoc,6,4,2
Бестворлдд,howling-fjord,384,demonhunter,havoc,6,4,2
Вориузз,soulflayer,384,demonhunter,havoc,6,4,2
Timitär,mazrigos,384,demonhunter,havoc,6,4,2
Niellarsc,ravencrest,384,demonhunter,havoc,6,4,2
Áthos,stormscale,384,demonhunter,havoc,6,4,2
Diagonol,ragnaros,384,demonhunter,havoc,6,4,2
Betrayerboi,blackmoore,384,demonhunter,havoc,6,4,2
Bøneshades,hyjal,384,demonhunter,havoc,6,4,2
Bblock,silvermoon,384,demonhunter,havoc,6,4,2
Exerzaria,twisting-nether,384,demonhunter,havoc,6,4,2
Carre,aggramar,384,demonhunter,havoc,6,4,2
Маланаар,gordunni,384,demonhunter,havoc,6,4,2
Mymindead,ravencrest,384,demonhunter,havoc,6,4,2
Çhïñêséðëmøñ,draenor,384,demonhunter,havoc,6,4,2
Waahpah,ravencrest,384,demonhunter,havoc,6,4,2
Demoncalle,the-maelstrom,384,demonhunter,havoc,6,4,2
Pvefuljrqt,draenor,384,demonhunter,havoc,6,4,2
Memedhbtw,outland,384,demonhunter,havoc,6,4,2
Талисзора,gordunni,384,demonhunter,havoc,6,4,2
Arliden,azshara,384,demonhunter,havoc,6,4,2
Darmash,ambossar,384,demonhunter,havoc,9,5,4
Imprøve,ravencrest,384,demonhunter,havoc,9,5,4
Freakerzoid,kazzak,384,demonhunter,havoc,11,4,7
Алмантиус,gordunni,384,demonhunter,havoc,12,4,8
Arkta,kazzak,384,demonhunter,havoc,12,4,8
Skylebeam,blackrock,384,demonhunter,havoc,12,4,8
Bratti,kazzak,384,demonhunter,havoc,12,4,8
Hellbrood,kazzak,384,demonhunter,havoc,12,4,8
Ellatriel,blackrock,384,demonhunter,havoc,12,4,8
Nobrainerz,twisting-nether,384,demonhunter,havoc,12,4,8
Valravnen,ravencrest,384,demonhunter,havoc,12,4,8
Jabuzi,drakthul,384,demonhunter,havoc,12,4,8
Drædløcks,ysondre,384,demonhunter,havoc,12,4,8
Эвернесса,soulflayer,384,demonhunter,havoc,12,4,8
Лупидолх,soulflayer,384,demonhunter,havoc,12,4,8
Mempaan,magtheridon,384,demonhunter,havoc,12,4,8
Lopphaufen,onyxia,384,demonhunter,havoc,12,4,8
Crimsoncloud,burning-legion,384,demonhunter,havoc,12,4,8
Toxicbaboon,nemesis,384,demonhunter,havoc,12,4,8
Вуджория,gordunni,384,demonhunter,havoc,12,4,8
Saikamango,blackhand,384,demonhunter,havoc,12,4,8
Graffyre,eonar,384,demonhunter,havoc,12,4,8
Shakso,tarren-mill,384,demonhunter,havoc,12,4,8
Betterdk,twilights-hammer,384,demonhunter,havoc,12,4,8
Sickman,burning-legion,384,demonhunter,havoc,12,4,8
Tøñÿfûsìllí,hyjal,384,demonhunter,havoc,12,4,8
Fellektra,draenor,384,demonhunter,havoc,12,4,8
Balzhor,blackhand,384,demonhunter,havoc,12,4,8
Slashyz,argent-dawn,384,demonhunter,havoc,12,4,8
Хреньещёта,booty-bay,384,demonhunter,havoc,12,4,8
Одзангейра,blackscar,384,demonhunter,havoc,12,4,8
Топд,thermaplugg,384,demonhunter,havoc,12,4,8
Ninjantiz,antonidas,384,demonhunter,havoc,12,4,8
Deathbydeaf,terenas,384,demonhunter,havoc,12,4,8
Mythrixian,draenor,384,demonhunter,havoc,12,4,8
Factcox,magtheridon,384,demonhunter,havoc,12,4,8
Juny,turalyon,384,demonhunter,havoc,12,4,8
Кеиичи,howling-fjord,384,demonhunter,havoc,12,4,8
Rostiza,blackrock,384,demonhunter,havoc,12,4,8
Headbanger,twisting-nether,384,demonhunter,havoc,12,4,8
Rivy,magtheridon,384,demonhunter,havoc,12,4,8
Floridaboy,ravencrest,384,demonhunter,havoc,12,4,8
Ysirã,hyjal,384,demonhunter,havoc,12,4,8
Dannyp,ravencrest,384,demonhunter,havoc,12,4,8
Xilor,neptulon,384,demonhunter,havoc,12,4,8
Gigawashed,ravencrest,384,demonhunter,havoc,12,4,8
Chávi,twisting-nether,384,demonhunter,havoc,12,4,8
Kinami,hyjal,384,demonhunter,havoc,12,4,8
Ågøny,outland,384,demonhunter,havoc,12,4,8
Гагендан,fordragon,384,demonhunter,havoc,12,4,8
Maeltus,hyjal,384,demonhunter,havoc,12,4,8
Deadrawdh,aegwynn,384,demonhunter,havoc,12,4,8
Huntingmaven,blackrock,384,demonhunter,havoc,12,4,8
Buggzii,silvermoon,384,demonhunter,havoc,12,4,8
Frostidh,ysondre,384,demonhunter,havoc,12,4,8
Хокану,gordunni,384,demonhunter,havoc,12,4,8
Fbh,stormscale,384,demonhunter,havoc,12,4,8
Dhgoddess,ravencrest,384,demonhunter,havoc,12,4,8
Пвпфея,soulflayer,384,demonhunter,havoc,12,4,8
Neulgød,zuljin,384,demonhunter,havoc,12,4,8
Zaekiel,burning-legion,384,demonhunter,havoc,12,4,8
Мисъёсмит,soulflayer,384,demonhunter,havoc,12,4,8
Venøm,chromaggus,384,demonhunter,havoc,12,4,8
Leylas,nagrand,384,demonhunter,havoc,12,4,8
Mäcklepyah,tarren-mill,384,demonhunter,havoc,12,4,8
Blüëräin,draenor,384,demonhunter,havoc,12,4,8
Sevira,tarren-mill,384,demonhunter,havoc,12,4,8
Артёмблэйдх,blackscar,384,demonhunter,havoc,12,4,8
Cutforshred,zenedar,384,demonhunter,havoc,12,4,8
Zynês,draenor,384,demonhunter,havoc,18,4,14
Zarín,outland,384,demonhunter,havoc,18,4,14
Takeroids,kazzak,384,demonhunter,havoc,18,4,14
Vrazjababa,dragonmaw,384,demonhunter,havoc,18,4,14
Linea,jaedenar,384,demonhunter,havoc,18,4,14
Kalav,outland,384,demonhunter,havoc,18,4,14
Lisilis,neptulon,384,demonhunter,havoc,18,4,14
Aaryaa,archimonde,384,demonhunter,havoc,18,4,14
Sazukè,blackmoore,384,demonhunter,havoc,18,4,14
Vandazza,argent-dawn,384,demonhunter,havoc,18,4,14
Jeandh,nerzhul,384,demonhunter,havoc,18,4,14
Братилидана,gordunni,384,demonhunter,havoc,18,4,14
Skajlan,burning-legion,384,demonhunter,havoc,18,4,14
Lasthija,dun-modr,384,demonhunter,havoc,24,4,20
Yocolo,sinstralis,383,demonhunter,havoc,6,4,2
Vikraal,kazzak,383,demonhunter,havoc,6,4,2
Walidaris,tarren-mill,383,demonhunter,havoc,6,4,2
Jüdgedëad,archimonde,383,demonhunter,havoc,6,4,2
Rouzi,defias-brotherhood,383,demonhunter,havoc,6,4,2
Ræzzør,das-konsortium,383,demonhunter,havoc,6,4,2
Обходчик,soulflayer,383,demonhunter,havoc,6,4,2
Némesîs,cthun,383,demonhunter,havoc,6,4,2
Rèdtubê,outland,383,demonhunter,havoc,12,4,8
Talerias,magtheridon,383,demonhunter,havoc,12,4,8
Сязекть,goldrinn,383,demonhunter,havoc,12,4,8
Frootloop,blades-edge,383,demonhunter,havoc,12,4,8
Elenastar,kazzak,383,demonhunter,havoc,12,4,8
Vengatoria,cthun,383,demonhunter,havoc,12,4,8
Felanora,turalyon,382,demonhunter,havoc,12,4,8
Lxantimagexl,silvermoon,381,demonhunter,havoc,12,4,8
Baphumet,zuljin,380,demonhunter,havoc,18,4,14
Deathniresa,argent-dawn,379,demonhunter,havoc,12,4,8
Хисаго,gordunni,372,demonhunter,havoc,17,7,10
Lyxliraren,kazzak,366,demonhunter,havoc,23,4,19
Feløut,eredar,352,demonhunter,havoc,16,4,12
Darren,wildhammer,351,demonhunter,havoc,10,4,6
Fèll,silvermoon,336,demonhunter,havoc,15,4,11
Nrage,darkspear,336,demonhunter,havoc,15,4,11
Dexterzx,stormscale,336,demonhunter,havoc,16,4,12
Lydari,die-arguswacht,330,demonhunter,havoc,17,5,12
Tchekken,tarren-mill,329,demonhunter,havoc,8,5,3
Ironmass,chogall,319,demonhunter,havoc,5,4,1
Mbappé,archimonde,319,demonhunter,havoc,5,4,1
Çrìñgéñämê,ravencrest,319,demonhunter,havoc,5,4,1
Felwaifu,tarren-mill,319,demonhunter,havoc,8,4,4
Элледарий,soulflayer,319,demonhunter,havoc,10,4,6
Yågåpøwér,twisting-nether,319,demonhunter,havoc,14,4,10
Oskarz,ravencrest,318,demonhunter,havoc,14,4,10
Squarty,wrathbringer,316,demonhunter,havoc,8,4,4
Anestes,dalaran,304,demonhunter,havoc,13,4,9
Asalina,hyjal,301,demonhunter,havoc,7,4,3
Killaden,ravenholdt,288,demonhunter,havoc,6,3,3
Ïöï,tarren-mill,288,demonhunter,havoc,6,3,3
Cánoo,blackhand,288,demonhunter,havoc,6,3,3
Illidaclem,archimonde,288,demonhunter,havoc,6,3,3
Qiufan,eredar,288,demonhunter,havoc,6,3,3
Nephthyis,draenor,288,demonhunter,havoc,6,3,3
Шрэдэр,thermaplugg,288,demonhunter,havoc,6,3,3
Azelar,ragnaros,288,demonhunter,havoc,6,3,3
Zoøm,blackrock,288,demonhunter,havoc,6,3,3
Jak,dalvengyr,288,demonhunter,havoc,6,3,3
Xénôns,archimonde,288,demonhunter,havoc,6,3,3
Sekido,silvermoon,288,demonhunter,havoc,6,3,3
Nerfdhxd,kazzak,288,demonhunter,havoc,6,3,3
Ðémoralizing,archimonde,288,demonhunter,havoc,6,3,3
Zampred,grim-batol,288,demonhunter,havoc,6,3,3
Preddh,twisting-nether,288,demonhunter,havoc,6,3,3
Rustedchurl,draenor,288,demonhunter,havoc,6,3,3
Linshidh,grim-batol,288,demonhunter,havoc,6,3,3
Hellboi,dun-modr,288,demonhunter,havoc,6,3,3
Marilu,nathrezim,288,demonhunter,havoc,6,3,3
Mialynn,aegwynn,288,demonhunter,havoc,6,3,3
Catchmebaby,sanguino,288,demonhunter,havoc,6,3,3
Pandaqt,ragnaros,288,demonhunter,havoc,6,3,3
Lyannie,thrall,288,demonhunter,havoc,6,3,3
Vqqxx,stormreaver,288,demonhunter,havoc,6,3,3
Rehaell,burning-legion,288,demonhunter,havoc,6,3,3
Dartyydh,tarren-mill,288,demonhunter,havoc,6,3,3
Watdefack,outland,288,demonhunter,havoc,6,3,3
Dadagodx,kazzak,288,demonhunter,havoc,6,3,3
Demonirto,arathor,288,demonhunter,havoc,6,3,3
Kyoukaii,kazzak,288,demonhunter,havoc,6,3,3
Ricd,aggra-português,288,demonhunter,havoc,6,3,3
Exytûs,blackhand,288,demonhunter,havoc,6,3,3
Froog,frostmane,288,demonhunter,havoc,6,3,3
Sivix,kazzak,288,demonhunter,havoc,6,3,3
Leeloø,twisting-nether,288,demonhunter,havoc,6,3,3
Darkshegal,dun-modr,288,demonhunter,havoc,6,3,3
Nazgulla,grim-batol,288,demonhunter,havoc,6,3,3
Shaadraz,stormscale,288,demonhunter,havoc,6,3,3
Zorrø,blackmoore,288,demonhunter,havoc,6,3,3
Crasyface,kazzak,288,demonhunter,havoc,6,3,3
Skundrell,ragnaros,288,demonhunter,havoc,6,3,3
Cienlowczyni,silvermoon,288,demonhunter,havoc,6,3,3
Linîlim,ysondre,288,demonhunter,havoc,6,3,3
Бану,howling-fjord,288,demonhunter,havoc,6,3,3
Dhkolben,blackmoore,288,demonhunter,havoc,6,3,3
Tåkotsubo,archimonde,288,demonhunter,havoc,6,3,3
Hellzz,tarren-mill,288,demonhunter,havoc,6,3,3
Ккепсс,howling-fjord,288,demonhunter,havoc,6,3,3
Terraske,tyrande,288,demonhunter,havoc,6,3,3
Lonedh,sylvanas,288,demonhunter,havoc,6,3,3
Slumhunter,silvermoon,288,demonhunter,havoc,6,3,3
Raili,kazzak,288,demonhunter,havoc,6,3,3
Ortä,sanguino,288,demonhunter,havoc,6,3,3
Voñbödefeld,frostmourne,288,demonhunter,havoc,6,3,3
Mannie,twisting-nether,288,demonhunter,havoc,6,3,3
Qualron,twisting-nether,288,demonhunter,havoc,6,3,3
Андрюхадх,soulflayer,288,demonhunter,havoc,6,3,3
Askaroth,sanguino,288,demonhunter,havoc,6,3,3
Xaaero,blackrock,288,demonhunter,havoc,6,3,3
Vùkal,kazzak,288,demonhunter,havoc,6,3,3
Dragash,nemesis,288,demonhunter,havoc,6,3,3
Meserani,eredar,288,demonhunter,havoc,6,3,3
Bossmac,mugthol,288,demonhunter,havoc,6,3,3
Mortalsin,tarren-mill,288,demonhunter,havoc,6,3,3
Terboven,outland,288,demonhunter,havoc,6,3,3
Naargof,outland,288,demonhunter,havoc,6,3,3
Ìllìdank,silvermoon,288,demonhunter,havoc,6,3,3
Ашерис,deathguard,288,demonhunter,havoc,6,3,3
Unski,chamber-of-aspects,288,demonhunter,havoc,6,3,3
Резако,soulflayer,288,demonhunter,havoc,6,3,3
Trekpop,chamber-of-aspects,288,demonhunter,havoc,6,3,3
Shinnu,antonidas,288,demonhunter,havoc,6,3,3
Jinfel,outland,288,demonhunter,havoc,6,3,3
Mephedroni,kazzak,288,demonhunter,havoc,6,3,3
Yelans,twisting-nether,288,demonhunter,havoc,6,3,3
Cydonia,medivh,288,demonhunter,havoc,6,3,3
Bräxas,la-croisade-écarlate,288,demonhunter,havoc,6,3,3
Eddylòl,ravencrest,288,demonhunter,havoc,6,3,3
Demonsushi,tarren-mill,288,demonhunter,havoc,6,3,3
Jmý,twisting-nether,288,demonhunter,havoc,6,3,3
Serizhawa,tarren-mill,288,demonhunter,havoc,6,3,3
Futalicious,argent-dawn,288,demonhunter,havoc,6,3,3
Cursedblade,archimonde,288,demonhunter,havoc,6,3,3
Ледехе,gordunni,288,demonhunter,havoc,6,3,3
Felrage,tarren-mill,288,demonhunter,havoc,6,3,3
Juuliana,twisting-nether,288,demonhunter,havoc,6,3,3
Solobolo,blackhand,288,demonhunter,havoc,6,3,3
Sasuke,blackmoore,288,demonhunter,havoc,6,3,3
Youns,medivh,288,demonhunter,havoc,6,3,3
Uranoth,nemesis,288,demonhunter,havoc,6,3,3
Demonerchia,pozzo-delleternità,288,demonhunter,havoc,6,3,3
Чубрик,howling-fjord,288,demonhunter,havoc,6,3,3
Gunaknoch,outland,288,demonhunter,havoc,6,3,3
Cnbâckbb,archimonde,288,demonhunter,havoc,6,3,3
Felabatur,burning-legion,288,demonhunter,havoc,6,3,3
Vtoriavgust,silvermoon,288,demonhunter,havoc,6,3,3
Tígél,argent-dawn,288,demonhunter,havoc,6,3,3
Stòrmý,thrall,288,demonhunter,havoc,6,3,3
Voynex,blackmoore,288,demonhunter,havoc,6,3,3
Neony,blackmoore,288,demonhunter,havoc,6,3,3
Caramvp,eredar,288,demonhunter,havoc,6,3,3
Youngfelrush,blackrock,288,demonhunter,havoc,6,3,3
Leïaprincess,hyjal,288,demonhunter,havoc,6,3,3
Тлюня,grom,288,demonhunter,havoc,6,3,3
Kyart,nemesis,288,demonhunter,havoc,6,3,3
Demonkingx,twisting-nether,288,demonhunter,havoc,6,3,3
Мальвада,galakrond,288,demonhunter,havoc,6,3,3
Schwitte,tichondrius,288,demonhunter,havoc,6,3,3
Eous,nordrassil,288,demonhunter,havoc,6,3,3
Hyonzyyesh,silvermoon,288,demonhunter,havoc,6,3,3
Deschacke,eredar,288,demonhunter,havoc,6,3,3
Bludmask,silvermoon,288,demonhunter,havoc,6,3,3
Indominus,pozzo-delleternità,288,demonhunter,havoc,6,3,3
Слепойалкаш,blackscar,288,demonhunter,havoc,6,3,3
Dinyaal,alakir,288,demonhunter,havoc,6,3,3
Berlusconi,senjin,288,demonhunter,havoc,6,3,3
Nightfly,twisting-nether,288,demonhunter,havoc,6,3,3
Divia,anubarak,288,demonhunter,havoc,6,3,3
Térento,blackmoore,288,demonhunter,havoc,6,3,3
Na,conseil-des-ombres,288,demonhunter,havoc,6,3,3
Extitan,twisting-nether,288,demonhunter,havoc,6,3,3
Galuran,drakthul,288,demonhunter,havoc,6,3,3
Wubby,drakthul,288,demonhunter,havoc,6,3,3
Wildest,blackmoore,288,demonhunter,havoc,9,4,5
Trashcan,darksorrow,288,demonhunter,havoc,9,3,6
Zlna,archimonde,288,demonhunter,havoc,10,3,7
Aethilios,silvermoon,288,demonhunter,havoc,11,3,8
Mankestdeme,chamber-of-aspects,288,demonhunter,havoc,11,3,8
Vijiny,sylvanas,288,demonhunter,havoc,15,4,11
Yataganac,draenor,288,demonhunter,havoc,12,3,9
Хемах,howling-fjord,288,demonhunter,havoc,12,3,9
Lamello,nemesis,288,demonhunter,havoc,12,3,9
Felezo,bloodscalp,288,demonhunter,havoc,12,3,9
Wheelchairdh,twisting-nether,288,demonhunter,havoc,12,3,9
Tacodhx,ravencrest,288,demonhunter,havoc,12,3,9
Gpk,argent-dawn,288,demonhunter,havoc,12,3,9
Kaeldral,blackrock,288,demonhunter,havoc,12,3,9
Tødø,nemesis,288,demonhunter,havoc,12,3,9
Diminhintir,draenor,288,demonhunter,havoc,12,3,9
Ïvø,sargeras,288,demonhunter,havoc,12,3,9
Bananabritta,aegwynn,288,demonhunter,havoc,12,3,9
Nows,twisting-nether,288,demonhunter,havoc,12,3,9
Mênding,kazzak,288,demonhunter,havoc,12,3,9
Sazzox,blackrock,288,demonhunter,havoc,12,3,9
Rapp,nemesis,288,demonhunter,havoc,12,3,9
Арвулфик,eversong,288,demonhunter,havoc,12,3,9
Феяужаса,soulflayer,288,demonhunter,havoc,12,3,9
Laurana,argent-dawn,288,demonhunter,havoc,12,3,9
Ðèvìllìà,ragnaros,288,demonhunter,havoc,12,3,9
Mashaz,archimonde,288,demonhunter,havoc,12,3,9
Fullinaretta,archimonde,288,demonhunter,havoc,12,3,9
Грота,soulflayer,288,demonhunter,havoc,12,3,9
Холегдх,gordunni,288,demonhunter,havoc,12,3,9
Sýfér,grim-batol,288,demonhunter,havoc,12,3,9
Metaman,archimonde,288,demonhunter,havoc,12,3,9
Valdarîm,twisting-nether,288,demonhunter,havoc,12,3,9
ßäxy,ragnaros,288,demonhunter,havoc,12,3,9
Bernhoftdh,ravencrest,288,demonhunter,havoc,12,3,9
Dubbelnugge,ravencrest,288,demonhunter,havoc,12,3,9
Ганстапутин,howling-fjord,288,demonhunter,havoc,12,3,9
Râny,blackmoore,288,demonhunter,havoc,12,3,9
Domiinator,sylvanas,288,demonhunter,havoc,12,3,9
Nætx,ravencrest,288,demonhunter,havoc,12,3,9
Highskitten,tarren-mill,288,demonhunter,havoc,12,3,9
Silkzoom,kazzak,288,demonhunter,havoc,12,3,9
Silandara,grim-batol,288,demonhunter,havoc,12,3,9
Naturalis,die-todeskrallen,288,demonhunter,havoc,12,3,9
Donverräter,antonidas,288,demonhunter,havoc,12,3,9
Hicke,burning-legion,288,demonhunter,havoc,12,3,9
Лорберн,soulflayer,288,demonhunter,havoc,12,3,9
Shadyhunter,drakthul,288,demonhunter,havoc,12,3,9
Ambodh,thrall,288,demonhunter,havoc,12,3,9
Fellout,burning-legion,288,demonhunter,havoc,12,3,9
Gjanlemis,stormscale,288,demonhunter,havoc,12,3,9
Гелиосса,soulflayer,288,demonhunter,havoc,12,3,9
Nightwalk,blackmoore,288,demonhunter,havoc,12,3,9
Tenaebris,silvermoon,288,demonhunter,havoc,12,3,9
Were,drakthul,288,demonhunter,havoc,12,3,9
Пухшайсти,soulflayer,288,demonhunter,havoc,12,3,9
Valø,malganis,288,demonhunter,havoc,12,3,9
Elsorí,eredar,288,demonhunter,havoc,12,3,9
Blacklance,ravencrest,288,demonhunter,havoc,12,3,9
Néèdgirly,malfurion,288,demonhunter,havoc,15,3,12
Bighand,burning-legion,288,demonhunter,havoc,18,3,15
Menutzdh,tarren-mill,287,demonhunter,havoc,6,3,3
Chifra,dun-modr,287,demonhunter,havoc,6,3,3
Dethlyn,twisting-nether,287,demonhunter,havoc,6,3,3
Makev,thunderhorn,287,demonhunter,havoc,6,3,3
Saturnein,stormscale,287,demonhunter,havoc,6,3,3
Káyn,sanguino,287,demonhunter,havoc,6,3,3
Elfitoloco,sanguino,287,demonhunter,havoc,6,3,3
Бумбумер,lich-king,287,demonhunter,havoc,6,3,3
Dimonanta,grim-batol,287,demonhunter,havoc,6,3,3
Mzyonhh,draenor,287,demonhunter,havoc,12,3,9
Coryalac,archimonde,287,demonhunter,havoc,12,3,9
Дафард,ashenvale,286,demonhunter,havoc,6,3,3
Indagatrix,bladefist,271,demonhunter,havoc,12,4,8
Gêliôs,kazzak,271,demonhunter,havoc,11,3,8
Czl,silvermoon,256,demonhunter,havoc,10,3,7
Demongorgon,arathor,255,demonhunter,havoc,14,4,10
Elosèn,magtheridon,255,demonhunter,havoc,11,3,8
Nuballan,ragnaros,240,demonhunter,havoc,9,3,6
Ponn,blackmoore,239,demonhunter,havoc,5,3,2
Rexchânce,archimonde,239,demonhunter,havoc,5,3,2
Этовсехил,eversong,239,demonhunter,havoc,5,3,2
Dreamhunt,stormreaver,239,demonhunter,havoc,5,3,2
Itskarmax,outland,239,demonhunter,havoc,5,3,2
Дэйкан,borean-tundra,239,demonhunter,havoc,9,3,6
Джерегумо,howling-fjord,234,demonhunter,havoc,10,4,6
Ñítøryù,ravencrest,234,demonhunter,havoc,10,4,6
Draecis,twisting-nether,223,demonhunter,havoc,8,3,5
Лэймрисх,gordunni,223,demonhunter,havoc,14,3,11
Sìena,ravencrest,208,demonhunter,havoc,7,3,4
Пересыщение,soulflayer,208,demonhunter,havoc,7,3,4
Legoo,archimonde,208,demonhunter,havoc,7,3,4
Idontseeafck,kazzak,192,demonhunter,havoc,4,3,1
Qspeedyboi,kazzak,192,demonhunter,havoc,4,3,1
Khinn,tyrande,192,demonhunter,havoc,6,2,4
Haveadad,outland,192,demonhunter,havoc,6,2,4
Mäiskelinko,vashj,192,demonhunter,havoc,6,2,4
Аххмхх,soulflayer,192,demonhunter,havoc,6,2,4
Маскитол,soulflayer,192,demonhunter,havoc,6,2,4
Afer,eredar,192,demonhunter,havoc,6,2,4
Noxha,outland,192,demonhunter,havoc,6,2,4
Riveén,blackhand,192,demonhunter,havoc,6,2,4
Emkogødx,outland,192,demonhunter,havoc,6,2,4
Ryohìrst,stormscale,192,demonhunter,havoc,6,2,4
Disconecting,outland,192,demonhunter,havoc,6,2,4
Qixl,blackhand,192,demonhunter,havoc,6,2,4
Maddamon,malorne,192,demonhunter,havoc,6,2,4
Nïcta,sanguino,192,demonhunter,havoc,6,2,4
Chlorel,arthas,192,demonhunter,havoc,6,2,4
Williamgrant,alonsus,192,demonhunter,havoc,6,2,4
Alatharx,dun-morogh,192,demonhunter,havoc,6,2,4
Flupo,stormscale,192,demonhunter,havoc,6,2,4
Satyna,der-mithrilorden,192,demonhunter,havoc,6,2,4
Arenvald,saurfang,192,demonhunter,havoc,6,2,4
Mároon,frostmane,192,demonhunter,havoc,6,2,4
Ôdhyn,hyjal,192,demonhunter,havoc,6,2,4
Ralffeh,auchindoun,192,demonhunter,havoc,6,2,4
Bobleeglave,darkspear,192,demonhunter,havoc,6,2,4
Mharú,outland,192,demonhunter,havoc,6,2,4
Xîè,dalaran,192,demonhunter,havoc,6,2,4
Остинджейн,soulflayer,192,demonhunter,havoc,6,2,4
Nalefan,hyjal,192,demonhunter,havoc,6,2,4
Kaily,eredar,192,demonhunter,havoc,6,2,4
Kasmo,dalaran,192,demonhunter,havoc,6,2,4
Thaeraa,hyjal,192,demonhunter,havoc,6,2,4
Amythest,tarren-mill,192,demonhunter,havoc,6,2,4
Lexdh,blackrock,192,demonhunter,havoc,6,2,4
Khrum,rajaxx,192,demonhunter,havoc,6,2,4
Elyes,archimonde,192,demonhunter,havoc,6,2,4
Altrazax,hyjal,192,demonhunter,havoc,6,2,4
Diaemus,hyjal,192,demonhunter,havoc,6,2,4
Sephy,argent-dawn,192,demonhunter,havoc,6,2,4
Lucziane,blackmoore,192,demonhunter,havoc,6,2,4
Aleryx,ragnaros,192,demonhunter,havoc,6,2,4
Kuzchooh,dalaran,192,demonhunter,havoc,6,2,4
Grìzmo,garona,192,demonhunter,havoc,6,2,4
Hykoolique,arakarahm,192,demonhunter,havoc,6,2,4
Datejust,archimonde,192,demonhunter,havoc,6,2,4
Anekk,kazzak,192,demonhunter,havoc,6,2,4
Malkyor,ysondre,192,demonhunter,havoc,6,2,4
Merei,dalaran,192,demonhunter,havoc,6,2,4
Маннорохх,blackscar,192,demonhunter,havoc,6,2,4
Bâdboy,blackrock,192,demonhunter,havoc,6,2,4
Brolafsen,ragnaros,192,demonhunter,havoc,6,2,4
Jayuslol,stormrage,192,demonhunter,havoc,6,2,4
Qúkn,tarren-mill,192,demonhunter,havoc,6,2,4
Илюшанадх,gordunni,192,demonhunter,havoc,6,2,4
Neimfel,outland,192,demonhunter,havoc,6,2,4
Omegahunterx,ravencrest,192,demonhunter,havoc,6,2,4
Sälexz,ysondre,192,demonhunter,havoc,6,2,4
Итерночка,soulflayer,192,demonhunter,havoc,6,2,4
Fyxi,talnivarr,192,demonhunter,havoc,6,2,4
Saphira,laughing-skull,192,demonhunter,havoc,6,2,4
Xøxøø,blackhand,192,demonhunter,havoc,6,2,4
Gracë,outland,192,demonhunter,havoc,6,2,4
Crisperis,drakthul,192,demonhunter,havoc,6,2,4
Ориджин,grom,192,demonhunter,havoc,6,2,4
Hyype,draenor,192,demonhunter,havoc,6,2,4
Evaristoff,sanguino,192,demonhunter,havoc,6,2,4
Razzàl,sinstralis,192,demonhunter,havoc,6,2,4
Huntonez,outland,192,demonhunter,havoc,6,2,4
Шоксенсацияя,howling-fjord,192,demonhunter,havoc,6,2,4
Cøldlean,ravencrest,192,demonhunter,havoc,6,2,4
Moratrasmus,the-maelstrom,192,demonhunter,havoc,6,2,4
Аврорамур,howling-fjord,192,demonhunter,havoc,6,2,4
Milaje,tarren-mill,192,demonhunter,havoc,6,2,4
Demontoolz,outland,192,demonhunter,havoc,6,2,4
Tæyana,khaz-modan,192,demonhunter,havoc,6,2,4
Wolfex,hellfire,192,demonhunter,havoc,6,2,4
Lixxersmeta,stormscale,192,demonhunter,havoc,6,2,4
Harrah,archimonde,192,demonhunter,havoc,6,2,4
Sârgan,khaz-modan,192,demonhunter,havoc,6,2,4
Флайрин,blackscar,192,demonhunter,havoc,6,2,4
Demø,tarren-mill,192,demonhunter,havoc,6,2,4
Nörsedh,sanguino,192,demonhunter,havoc,6,2,4
Дабллди,soulflayer,192,demonhunter,havoc,6,2,4
Stifeur,archimonde,192,demonhunter,havoc,6,2,4
Sñüîîâ,kazzak,192,demonhunter,havoc,6,2,4
Lty,archimonde,192,demonhunter,havoc,6,2,4
Kryshan,burning-legion,192,demonhunter,havoc,6,2,4
Chaeeri,twisting-nether,192,demonhunter,havoc,6,2,4
Solo,auchindoun,192,demonhunter,havoc,6,2,4
Aionic,draenor,192,demonhunter,havoc,6,2,4
Schakalèn,ragnaros,192,demonhunter,havoc,6,2,4
Buffdhx,sylvanas,192,demonhunter,havoc,6,2,4
Яростьдуры,gordunni,192,demonhunter,havoc,6,2,4
Dikcitx,archimonde,192,demonhunter,havoc,6,2,4
Deadspeak,burning-legion,192,demonhunter,havoc,6,2,4
Mnnmmnmnmnmn,zuljin,192,demonhunter,havoc,6,2,4
Kyiuz,archimonde,192,demonhunter,havoc,6,2,4
Sercemdwarf,silvermoon,192,demonhunter,havoc,6,2,4
Theonlydemon,frostmane,192,demonhunter,havoc,6,2,4
Flasz,sylvanas,192,demonhunter,havoc,6,2,4
Янгфрукт,howling-fjord,192,demonhunter,havoc,6,2,4
Тэнсу,borean-tundra,192,demonhunter,havoc,6,2,4
Охина,howling-fjord,192,demonhunter,havoc,6,2,4
Fjanten,stormscale,192,demonhunter,havoc,6,2,4
Squanch,auchindoun,192,demonhunter,havoc,6,2,4
Jumanjeez,draenor,192,demonhunter,havoc,6,2,4
Kibikari,nemesis,192,demonhunter,havoc,6,2,4
Sandy,anubarak,192,demonhunter,havoc,6,2,4
Stygo,silvermoon,192,demonhunter,havoc,6,2,4
Juicyglaives,ragnaros,192,demonhunter,havoc,6,2,4
Draneka,argent-dawn,192,demonhunter,havoc,6,2,4
Andariell,sylvanas,192,demonhunter,havoc,6,2,4
Aggrodíte,antonidas,192,demonhunter,havoc,6,2,4
Кораксс,howling-fjord,192,demonhunter,havoc,6,2,4
Имфаразел,gordunni,192,demonhunter,havoc,6,2,4
Деорру,gordunni,192,demonhunter,havoc,6,2,4
Ragnarak,amanthul,192,demonhunter,havoc,6,2,4
Kakovicz,gorgonnash,192,demonhunter,havoc,6,2,4
Marluxx,stormscale,192,demonhunter,havoc,6,2,4
Trayce,antonidas,192,demonhunter,havoc,6,2,4
Ропинирол,gordunni,192,demonhunter,havoc,6,2,4
Kaprisun,turalyon,192,demonhunter,havoc,6,2,4
Linkôs,aegwynn,192,demonhunter,havoc,6,2,4
Dhslayer,magtheridon,192,demonhunter,havoc,6,2,4
Демолейшер,eversong,192,demonhunter,havoc,6,2,4
Артесдх,gordunni,192,demonhunter,havoc,6,2,4
Aerkex,kazzak,192,demonhunter,havoc,6,2,4
Facerolling,kazzak,192,demonhunter,havoc,6,2,4
Cíondra,aegwynn,192,demonhunter,havoc,6,2,4
Zenô,antonidas,192,demonhunter,havoc,6,2,4
Emowhiteboi,draenor,192,demonhunter,havoc,6,2,4
Pablino,darksorrow,192,demonhunter,havoc,6,2,4
Kyvi,blackrock,192,demonhunter,havoc,6,2,4
Grapesoda,echsenkessel,192,demonhunter,havoc,6,2,4
Dreamøn,aegwynn,192,demonhunter,havoc,6,2,4
Happyhippø,antonidas,192,demonhunter,havoc,6,2,4
Экзектикус,gordunni,192,demonhunter,havoc,6,2,4
Лилэйв,gordunni,192,demonhunter,havoc,6,2,4
Скид,gordunni,192,demonhunter,havoc,6,2,4
Malkoran,draenor,192,demonhunter,havoc,6,2,4
Мэлифсб,blackscar,192,demonhunter,havoc,6,2,4
Kaelisi,argent-dawn,192,demonhunter,havoc,6,2,4
Dondado,pozzo-delleternità,192,demonhunter,havoc,6,2,4
Barocs,antonidas,192,demonhunter,havoc,6,2,4
Alcadejas,pozzo-delleternità,192,demonhunter,havoc,6,2,4
Yldaryiss,les-sentinelles,192,demonhunter,havoc,6,2,4
Люблюмеф,gordunni,192,demonhunter,havoc,6,2,4
Amnestîa,antonidas,192,demonhunter,havoc,6,2,4
Cáválórth,blackhand,192,demonhunter,havoc,6,2,4
Raenir,twisting-nether,192,demonhunter,havoc,7,2,5
Врадость,soulflayer,192,demonhunter,havoc,8,2,6
Jäck,draenor,192,demonhunter,havoc,9,2,7
Demonbreak,nemesis,192,demonhunter,havoc,12,2,10
Nezarec,sanguino,192,demonhunter,havoc,12,2,10
Babadoc,sanguino,192,demonhunter,havoc,12,2,10
Kengoo,ravencrest,192,demonhunter,havoc,12,2,10
Dhogus,twisting-nether,192,demonhunter,havoc,12,2,10
Kandres,ragnaros,192,demonhunter,havoc,12,2,10
Парагони,gordunni,192,demonhunter,havoc,12,2,10
Sajr,twisting-nether,192,demonhunter,havoc,12,2,10
Sedorax,tarren-mill,192,demonhunter,havoc,12,2,10
Nellyy,dalaran,192,demonhunter,havoc,12,2,10
Rettoz,aszune,192,demonhunter,havoc,12,2,10
Shockzzyydh,ravencrest,192,demonhunter,havoc,12,2,10
Tbomb,ragnaros,192,demonhunter,havoc,12,2,10
Zaydra,the-maelstrom,192,demonhunter,havoc,12,2,10
Esseline,outland,192,demonhunter,havoc,12,2,10
Deehoh,twisting-nether,192,demonhunter,havoc,12,2,10
Demonkal,twisting-nether,192,demonhunter,havoc,12,2,10
Aytèè,eredar,192,demonhunter,havoc,12,2,10
Qweasda,stormscale,192,demonhunter,havoc,12,2,10
Boo,sunstrider,192,demonhunter,havoc,12,2,10
Wruzna,shattered-halls,192,demonhunter,havoc,12,2,10
Tvé,ravencrest,192,demonhunter,havoc,12,2,10
Themogar,earthen-ring,192,demonhunter,havoc,12,2,10
Djbazz,blackrock,192,demonhunter,havoc,12,2,10
Mayzhi,hyjal,192,demonhunter,havoc,12,2,10
Enygamy,frostmane,192,demonhunter,havoc,12,2,10
Aloera,blackmoore,192,demonhunter,havoc,12,2,10
Thenangel,alleria,192,demonhunter,havoc,12,2,10
Tôx,dalaran,192,demonhunter,havoc,12,2,10
Riplocksz,outland,192,demonhunter,havoc,18,2,16
Fullmutter,twisting-nether,191,demonhunter,havoc,6,2,4
Ashvius,kult-der-verdammten,191,demonhunter,havoc,6,2,4
Zinzira,blackmoore,191,demonhunter,havoc,6,2,4
Karmos,khaz-modan,191,demonhunter,havoc,6,2,4
Manjirosano,blackmoore,191,demonhunter,havoc,12,2,10
Lilarii,argent-dawn,191,demonhunter,havoc,12,2,10
Illidori,sunstrider,191,demonhunter,havoc,12,2,10
Balistar,thrall,191,demonhunter,havoc,15,2,13
Kurox,drakthul,191,demonhunter,havoc,18,2,16
Íllídãn,aegwynn,180,demonhunter,havoc,25,6,19
Mabkdh,ravencrest,175,demonhunter,havoc,11,2,9
Onorera,tarren-mill,160,demonhunter,havoc,10,2,8
Misswillydan,ravencrest,159,demonhunter,havoc,5,2,3
Kalinda,sanguino,159,demonhunter,havoc,5,2,3
Mayrelxd,blackhand,159,demonhunter,havoc,5,2,3
Лавсон,soulflayer,159,demonhunter,havoc,5,2,3
Galafel,outland,159,demonhunter,havoc,5,2,3
Gucknicht,blackrock,144,demonhunter,havoc,9,2,7
Shiroyashae,twisting-nether,143,demonhunter,havoc,3,3,0
Novacáne,silvermoon,138,demonhunter,havoc,9,4,5
Видхант,soulflayer,138,demonhunter,havoc,8,3,5
Razerøø,ysondre,138,demonhunter,havoc,9,3,6
Kantklipper,ragnaros,138,demonhunter,havoc,10,3,7
Sorondos,ravencrest,138,demonhunter,havoc,12,3,9
Nöah,burning-steppes,138,demonhunter,havoc,15,3,12
Yuui,silvermoon,128,demonhunter,havoc,4,2,2
Аззил,soulflayer,128,demonhunter,havoc,4,2,2
Valexya,pozzo-delleternità,128,demonhunter,havoc,4,2,2
Aradh,hyjal,128,demonhunter,havoc,4,2,2
Мегапташка,howling-fjord,128,demonhunter,havoc,4,2,2
Izanawi,outland,127,demonhunter,havoc,8,2,6
Antbroo,twisting-nether,96,demonhunter,havoc,3,2,1
Demoncarlios,blackhand,96,demonhunter,havoc,3,2,1
Possíble,kazzak,96,demonhunter,havoc,9,2,7
Rëdencounter,ravencrest,96,demonhunter,havoc,6,1,5
Permachill,blackmoore,96,demonhunter,havoc,6,1,5
Jimbarend,argent-dawn,96,demonhunter,havoc,6,1,5
Lílynn,antonidas,96,demonhunter,havoc,6,1,5
Demonhapo,pozzo-delleternità,96,demonhunter,havoc,6,1,5
Niqel,blackrock,96,demonhunter,havoc,6,1,5
Pkdaemon,draenor,96,demonhunter,havoc,6,1,5
Dýlän,argent-dawn,96,demonhunter,havoc,6,1,5
Ilovesabrina,dun-modr,96,demonhunter,havoc,6,1,5
Булёхинс,howling-fjord,96,demonhunter,havoc,6,1,5
Kuñkkïsh,twisting-nether,96,demonhunter,havoc,6,1,5
Cruptiq,kazzak,96,demonhunter,havoc,6,1,5
Соларт,howling-fjord,96,demonhunter,havoc,6,1,5
Pêrsephôné,blackmoore,96,demonhunter,havoc,6,1,5
Аззазэль,howling-fjord,96,demonhunter,havoc,6,1,5
Samila,azshara,96,demonhunter,havoc,6,1,5
Esthá,argent-dawn,96,demonhunter,havoc,6,1,5
Ripgodx,bronzebeard,96,demonhunter,havoc,6,1,5
Artemisîa,argent-dawn,96,demonhunter,havoc,6,1,5
Demlilith,kazzak,96,demonhunter,havoc,6,1,5
Demonlia,blackrock,96,demonhunter,havoc,6,1,5
Olaladh,blackhand,96,demonhunter,havoc,6,1,5
Valkyal,nemesis,96,demonhunter,havoc,6,1,5
Vireus,draenor,96,demonhunter,havoc,6,1,5
Loreleyy,stormscale,96,demonhunter,havoc,6,1,5
Akron,magtheridon,96,demonhunter,havoc,6,1,5
Гоорыныч,howling-fjord,96,demonhunter,havoc,6,1,5
Josedh,twisting-nether,96,demonhunter,havoc,6,1,5
Распилил,gordunni,96,demonhunter,havoc,6,1,5
Mizuri,sylvanas,96,demonhunter,havoc,6,1,5
Jiínx,kazzak,96,demonhunter,havoc,6,1,5
Танукигодх,gordunni,96,demonhunter,havoc,6,1,5
Nizano,kult-der-verdammten,96,demonhunter,havoc,6,1,5
Illigawn,grim-batol,96,demonhunter,havoc,6,1,5
Avandar,burning-legion,96,demonhunter,havoc,6,1,5
Saulhax,sylvanas,96,demonhunter,havoc,6,1,5
Locomotiv,twisting-nether,96,demonhunter,havoc,6,1,5
Bootyspread,twisting-nether,96,demonhunter,havoc,6,1,5
Stormma,kazzak,96,demonhunter,havoc,6,1,5
Тадждх,howling-fjord,96,demonhunter,havoc,6,1,5
Winchestèr,draenor,96,demonhunter,havoc,6,1,5
Cirylia,blackrock,96,demonhunter,havoc,6,1,5
Youngføtmx,blackrock,96,demonhunter,havoc,6,1,5
Nutragehonda,twisting-nether,96,demonhunter,havoc,6,1,5
Benaska,twisting-nether,96,demonhunter,havoc,6,1,5
Dhmónster,blackrock,96,demonhunter,havoc,6,1,5
Askari,lothar,96,demonhunter,havoc,6,1,5
Chronic,die-aldor,96,demonhunter,havoc,6,1,5
Romancutza,tarren-mill,96,demonhunter,havoc,6,1,5
Sohunt,twisting-nether,96,demonhunter,havoc,6,1,5
Lemmiwinks,the-maelstrom,96,demonhunter,havoc,6,1,5
Zaracky,khaz-modan,96,demonhunter,havoc,6,1,5
Kíwì,archimonde,96,demonhunter,havoc,6,1,5
Tyhop,ragnaros,96,demonhunter,havoc,6,1,5
Fertriz,arthas,96,demonhunter,havoc,6,1,5
Teimotevey,silvermoon,96,demonhunter,havoc,6,1,5
Ebachebg,darksorrow,96,demonhunter,havoc,6,1,5
Roxany,aszune,96,demonhunter,havoc,6,1,5
Speedyusus,silvermoon,96,demonhunter,havoc,6,1,5
Ellsie,archimonde,96,demonhunter,havoc,6,1,5
Zoer,kazzak,96,demonhunter,havoc,6,1,5
Grobax,uldaman,96,demonhunter,havoc,6,1,5
Fantamazing,ragnaros,96,demonhunter,havoc,6,1,5
Skyfo,khadgar,96,demonhunter,havoc,6,1,5
Найлинель,fordragon,96,demonhunter,havoc,6,1,5
Wiizzs,defias-brotherhood,96,demonhunter,havoc,6,1,5
Evangelios,ravencrest,96,demonhunter,havoc,6,1,5
Annee,eredar,96,demonhunter,havoc,6,1,5
Laethas,twisting-nether,96,demonhunter,havoc,6,1,5
Tiina,daggerspine,96,demonhunter,havoc,6,1,5
Frizzy,dethecus,96,demonhunter,havoc,6,1,5
Shaelby,archimonde,96,demonhunter,havoc,6,1,5
Maikko,los-errantes,96,demonhunter,havoc,6,1,5
Louú,blackmoore,96,demonhunter,havoc,6,1,5
Malboosted,archimonde,96,demonhunter,havoc,6,1,5
Ellare,burning-blade,96,demonhunter,havoc,6,1,5
Tyradell,darksorrow,96,demonhunter,havoc,6,1,5
Kâtsumî,archimonde,96,demonhunter,havoc,6,1,5
Bïquette,ysondre,96,demonhunter,havoc,6,1,5
Sadclownz,blackrock,96,demonhunter,havoc,6,1,5
Kinderbueno,the-maelstrom,96,demonhunter,havoc,6,1,5
ßaßayaga,blackhand,96,demonhunter,havoc,6,1,5
Remagon,thrall,96,demonhunter,havoc,6,1,5
Ergoo,blackmoore,96,demonhunter,havoc,6,1,5
Martosh,sylvanas,96,demonhunter,havoc,6,1,5
Mlecznygolem,silvermoon,96,demonhunter,havoc,6,1,5
Burritodh,tarren-mill,96,demonhunter,havoc,6,1,5
Kassin,dun-modr,96,demonhunter,havoc,6,1,5
Anät,twisting-nether,96,demonhunter,havoc,6,1,5
Zarafel,hyjal,96,demonhunter,havoc,6,1,5
Lepiredh,hyjal,96,demonhunter,havoc,6,1,5
Syldrae,hyjal,96,demonhunter,havoc,6,1,5
Áarón,der-mithrilorden,96,demonhunter,havoc,6,1,5
Camotheck,stormscale,96,demonhunter,havoc,6,1,5
Fyy,sylvanas,96,demonhunter,havoc,6,1,5
Xuruleitor,uldum,96,demonhunter,havoc,6,1,5
Vg,blackhand,96,demonhunter,havoc,6,1,5
Alaw,anachronos,96,demonhunter,havoc,6,1,5
Abere,drakthul,96,demonhunter,havoc,6,1,5
Bizchazi,outland,96,demonhunter,havoc,6,1,5
Kulls,outland,96,demonhunter,havoc,6,1,5
Illiwonka,outland,96,demonhunter,havoc,6,1,5
Satela,azjolnerub,96,demonhunter,havoc,6,1,5
Pepbimsidan,eredar,96,demonhunter,havoc,6,1,5
Tempyy,ragnaros,96,demonhunter,havoc,6,1,5
Unk,outland,96,demonhunter,havoc,6,1,5
Чесденьгамии,soulflayer,96,demonhunter,havoc,6,1,5
Штормкор,soulflayer,96,demonhunter,havoc,6,1,5
Ðévx,argent-dawn,96,demonhunter,havoc,6,1,5
Acrius,twisting-nether,96,demonhunter,havoc,6,1,5
Fisseslayer,ravencrest,96,demonhunter,havoc,6,1,5
Blulake,silvermoon,96,demonhunter,havoc,6,1,5
Soulpurge,twisting-nether,96,demonhunter,havoc,6,1,5
Спокоивич,soulflayer,96,demonhunter,havoc,6,1,5
Flasqo,eredar,96,demonhunter,havoc,6,1,5
Ryuhayabusa,stormscale,96,demonhunter,havoc,6,1,5
Tareni,frostwolf,96,demonhunter,havoc,6,1,5
Oob,ysondre,96,demonhunter,havoc,6,1,5
Bröwnye,dun-modr,96,demonhunter,havoc,6,1,5
Tønyx,dalaran,96,demonhunter,havoc,6,1,5
Рвей,howling-fjord,96,demonhunter,havoc,6,1,5
Medena,nemesis,96,demonhunter,havoc,6,1,5
Ionhet,dun-modr,96,demonhunter,havoc,6,1,5
Äzot,burning-legion,96,demonhunter,havoc,6,1,5
Nargyla,magtheridon,96,demonhunter,havoc,12,1,11
Álloces,silvermoon,96,demonhunter,havoc,12,1,11
Эрсидия,gordunni,96,demonhunter,havoc,12,1,11
Бонятяф,gordunni,96,demonhunter,havoc,12,1,11
Ecthelionn,outland,96,demonhunter,havoc,12,1,11
Cléra,blackhand,96,demonhunter,havoc,12,1,11
Jásírá,shattrath,96,demonhunter,havoc,12,1,11
Ämy,grim-batol,96,demonhunter,havoc,12,1,11
Chosenundead,blackmoore,96,demonhunter,havoc,12,1,11
Kastrelia,ravencrest,96,demonhunter,havoc,12,1,11
Shaliel,madmortem,96,demonhunter,havoc,12,1,11
Anänke,twisting-nether,96,demonhunter,havoc,12,1,11
Диэльва,eversong,96,demonhunter,havoc,12,1,11
Babyyéah,sunstrider,96,demonhunter,havoc,12,1,11
Vasudev,blades-edge,96,demonhunter,havoc,13,1,12
Sctrippi,frostwolf,96,demonhunter,havoc,18,1,17
Illemnorh,auchindoun,96,demonhunter,havoc,20,1,19
Shinarei,silvermoon,95,demonhunter,havoc,6,1,5
Hárald,sanguino,84,demonhunter,havoc,20,4,16
Виллидж,gordunni,79,demonhunter,havoc,5,2,3
Caluxe,blackmoore,79,demonhunter,havoc,5,1,4
Cocaineflyin,tarren-mill,79,demonhunter,havoc,5,1,4
Lezabel,destromath,79,demonhunter,havoc,10,1,9
Violend,blackmoore,64,demonhunter,havoc,4,1,3
Impulz,archimonde,42,demonhunter,havoc,9,2,7
Nibør,doomhammer,31,demonhunter,havoc,2,1,1
Дазвен,gordunni,31,demonhunter,havoc,2,1,1
Neednerf,draenor,31,demonhunter,havoc,2,1,1
Frozensoules,turalyon,31,demonhunter,havoc,8,1,7
Vengeancezin,frostwhisper,1908,demonhunter,vengeance,228,115,113
Yamehd,stormreaver,1569,demonhunter,vengeance,66,34,32
Thewalker,argent-dawn,1496,demonhunter,vengeance,110,49,61
Strqt,archimonde,1441,demonhunter,vengeance,108,55,53
Zarín,outland,1394,demonhunter,vengeance,78,41,37
Illislan,darksorrow,1314,demonhunter,vengeance,60,34,26
Paindemon,outland,1182,demonhunter,vengeance,144,73,71
Qvn,sylvanas,1105,demonhunter,vengeance,26,12,14
Damodex,grim-batol,1076,demonhunter,vengeance,80,31,49
Enithy,twisting-nether,1058,demonhunter,vengeance,50,25,25
Dæmyst,outland,1053,demonhunter,vengeance,66,20,46
Сумърак,grom,894,demonhunter,vengeance,35,10,25
Kubusz,ravencrest,885,demonhunter,vengeance,48,22,26
Avye,tichondrius,672,demonhunter,vengeance,18,7,11
Arussil,pozzo-delleternità,663,demonhunter,vengeance,24,7,17
Kekburagól,kazzak,575,demonhunter,vengeance,12,6,6
Jakoby,tarren-mill,480,demonhunter,vengeance,12,5,7
Камуи,gordunni,478,demonhunter,vengeance,18,5,13
Quavanity,sylvanas,384,demonhunter,vengeance,18,4,14
Gauchino,aegwynn,287,demonhunter,vengeance,12,3,9
Demonlucy,colinas-pardas,287,demonhunter,vengeance,12,3,9
Zarafel,hyjal,280,demonhunter,vengeance,24,3,21
Dharuel,cthun,192,demonhunter,vengeance,6,2,4
Camtoe,ravencrest,192,demonhunter,vengeance,6,2,4
Askari,lothar,192,demonhunter,vengeance,6,2,4
Chosenundead,blackmoore,192,demonhunter,vengeance,6,2,4
Nephthyis,draenor,192,demonhunter,vengeance,6,2,4
Tôrxy,antonidas,192,demonhunter,vengeance,6,2,4
Геммула,howling-fjord,192,demonhunter,vengeance,6,2,4
Bigmóm,stormscale,192,demonhunter,vengeance,12,2,10
Макай,deathguard,191,demonhunter,vengeance,6,2,4
Opmuch,eonar,96,demonhunter,vengeance,6,1,5
Xenits,kazzak,96,demonhunter,vengeance,6,1,5
Блъя,gordunni,96,demonhunter,vengeance,6,1,5
Myztiko,hellscream,96,demonhunter,vengeance,6,1,5
Øß,moonglade,96,demonhunter,vengeance,6,1,5
Kuzchooh,dalaran,96,demonhunter,vengeance,6,1,5
Håbibi,kazzak,2280,druid,restoration,131,74,57
Hibibi,kazzak,2278,druid,restoration,149,90,59
Kókushibò,archimonde,2273,druid,restoration,109,70,39
Vinniehacker,archimonde,2271,druid,restoration,95,57,38
Sqx,ravencrest,2263,druid,restoration,310,169,141
Lúh,kazzak,2258,druid,restoration,144,100,44
Vanostboom,kazzak,2222,druid,restoration,94,55,39
Maldrýn,stormscale,2219,druid,restoration,59,38,21
Trèes,outland,2206,druid,restoration,413,222,191
Unohanâ,archimonde,2189,druid,restoration,183,108,75
Pegasu,kelthuzad,2182,druid,restoration,114,66,48
Джелони,soulflayer,2171,druid,restoration,92,50,42
Miouzy,archimonde,2156,druid,restoration,66,36,30
Zaeli,archimonde,2147,druid,restoration,72,40,32
Thotz,kazzak,2147,druid,restoration,298,156,142
Acondris,ravencrest,2135,druid,restoration,277,140,137
Yoogy,ravencrest,2133,druid,restoration,72,45,27
Kætachy,archimonde,2129,druid,restoration,173,90,83
Surfingbirdx,ragnaros,2126,druid,restoration,66,33,33
Drjmy,silvermoon,2125,druid,restoration,107,76,31
Dokixo,kazzak,2121,druid,restoration,65,38,27
Kev,elune,2120,druid,restoration,327,175,152
Zonsy,twisting-nether,2116,druid,restoration,94,60,34
Quabo,doomhammer,2104,druid,restoration,524,286,238
Hånukkah,outland,2101,druid,restoration,129,65,64
Trèes,draenor,2096,druid,restoration,166,91,75
Syví,outland,2093,druid,restoration,124,65,59
Nesedondon,stormscale,2077,druid,restoration,142,84,58
Iloveher,ravencrest,2065,druid,restoration,176,95,81
Chas,ravencrest,2063,druid,restoration,98,57,41
Druidomedio,pozzo-delleternità,2061,druid,restoration,78,48,30
Rives,sylvanas,2061,druid,restoration,156,87,69
Píshi,silvermoon,2041,druid,restoration,90,49,41
Bananadru,stormscale,2039,druid,restoration,48,30,18
Niksidruid,grim-batol,2037,druid,restoration,70,40,30
Threesixnìne,dun-morogh,2032,druid,restoration,443,239,204
Druu,stormscale,2032,druid,restoration,90,46,44
Ishiftmyself,pozzo-delleternità,2025,druid,restoration,85,41,44
Ovérheal,ravencrest,2023,druid,restoration,124,70,54
Leyô,archimonde,2023,druid,restoration,96,49,47
Sintiq,silvermoon,2020,druid,restoration,77,42,35
Maxpojke,ravencrest,2019,druid,restoration,184,115,69
Galadronìa,aegwynn,2018,druid,restoration,77,42,35
Druidrak,eredar,2017,druid,restoration,114,57,57
Jaytiz,ravencrest,2015,druid,restoration,71,36,35
Pobrica,stormscale,2013,druid,restoration,95,51,44
Friedbrocolí,tarren-mill,2009,druid,restoration,86,43,43
Doodlez,blackrock,2008,druid,restoration,136,69,67
Yseraheal,drakthul,2003,druid,restoration,318,174,144
Bambambimbim,draenor,1998,druid,restoration,102,52,50
Renewer,argent-dawn,1996,druid,restoration,63,30,33
Nantou,stormscale,1993,druid,restoration,208,103,105
Traick,antonidas,1990,druid,restoration,71,36,35
Shinöbü,sanguino,1989,druid,restoration,105,59,46
Hyggefinger,ravencrest,1988,druid,restoration,96,48,48
Clone,aegwynn,1986,druid,restoration,322,171,151
Sasosins,ravencrest,1975,druid,restoration,141,74,67
Exzotic,ravencrest,1973,druid,restoration,72,41,31
Asgá,stormscale,1972,druid,restoration,36,26,10
Alolexx,archimonde,1971,druid,restoration,81,45,36
Thebiggest,ravencrest,1970,druid,restoration,108,61,47
Granquercia,nemesis,1969,druid,restoration,120,73,47
Shiftyshaft,tarren-mill,1969,druid,restoration,391,214,177
Joksica,draenor,1967,druid,restoration,71,36,35
Tjxaxa,ravencrest,1966,druid,restoration,78,38,40
Afky,stormreaver,1962,druid,restoration,204,103,101
Thugzie,kazzak,1962,druid,restoration,250,124,126
Shredzz,ravencrest,1962,druid,restoration,60,28,32
Druidello,stormscale,1960,druid,restoration,70,35,35
Epicskin,kazzak,1956,druid,restoration,125,75,50
Druidella,stormscale,1955,druid,restoration,60,32,28
Thysabtw,archimonde,1954,druid,restoration,99,58,41
Sheippi,stormreaver,1954,druid,restoration,120,61,59
Tommix,ravencrest,1953,druid,restoration,79,42,37
Uñsullied,kazzak,1952,druid,restoration,123,60,63
Skrood,kazzak,1946,druid,restoration,72,37,35
Theatrex,ravencrest,1945,druid,restoration,165,100,65
Angrykejton,silvermoon,1940,druid,restoration,276,138,138
Ûnsullied,kazzak,1940,druid,restoration,131,64,67
Jamuhlee,kult-der-verdammten,1937,druid,restoration,85,40,45
Heçtôr,silvermoon,1934,druid,restoration,113,54,59
Stevedru,ravencrest,1933,druid,restoration,36,22,14
Myndrá,varimathras,1933,druid,restoration,143,77,66
Dendariottvx,sunstrider,1930,druid,restoration,109,57,52
Bloomitize,ravencrest,1930,druid,restoration,114,59,55
Ralaa,guldan,1926,druid,restoration,66,33,33
Rhonir,twisting-nether,1923,druid,restoration,242,123,119
Kyomã,burning-legion,1922,druid,restoration,186,92,94
Reins,silvermoon,1918,druid,restoration,233,123,110
Cplazi,kazzak,1917,druid,restoration,60,34,26
Xkirtach,dun-modr,1917,druid,restoration,48,21,27
Sprøut,drakthul,1916,druid,restoration,118,53,65
Nediena,twisting-nether,1914,druid,restoration,120,60,60
Ltmx,ravencrest,1914,druid,restoration,113,52,61
Fantastix,silvermoon,1912,druid,restoration,138,79,59
Traickovic,antonidas,1909,druid,restoration,60,31,29
Andr,voljin,1907,druid,restoration,220,109,111
Beesoup,blackrock,1905,druid,restoration,152,82,70
Traffix,outland,1904,druid,restoration,57,29,28
Mafiasnipe,ravencrest,1899,druid,restoration,48,29,19
Buffshaman,sylvanas,1897,druid,restoration,72,34,38
Naffelle,ysondre,1896,druid,restoration,101,49,52
Solowlevel,ravencrest,1894,druid,restoration,72,33,39
Eduarda,dun-modr,1893,druid,restoration,90,40,50
Arthéas,archimonde,1892,druid,restoration,186,96,90
Åä,ravencrest,1888,druid,restoration,38,23,15
Adokai,alleria,1888,druid,restoration,96,46,50
Galoony,blackrock,1886,druid,restoration,54,33,21
Kryptonîte,twisting-nether,1881,druid,restoration,135,68,67
Rhapsodý,twisting-nether,1880,druid,restoration,60,35,25
Builtdiffy,kazzak,1879,druid,restoration,450,240,210
Lunamimi,argent-dawn,1878,druid,restoration,380,193,187
Tedel,kazzak,1877,druid,restoration,81,50,31
Asga,stormscale,1874,druid,restoration,48,28,20
Amaré,burning-legion,1873,druid,restoration,114,57,57
Matteps,outland,1873,druid,restoration,119,58,61
Spamclone,draenor,1872,druid,restoration,63,33,30
Funnyjoker,outland,1872,druid,restoration,306,160,146
Naruhot,archimonde,1870,druid,restoration,109,62,47
Georn,sylvanas,1869,druid,restoration,98,53,45
Chacopic,archimonde,1869,druid,restoration,222,117,105
Bamsemoms,sylvanas,1869,druid,restoration,72,36,36
Дикаякиара,blackscar,1867,druid,restoration,606,298,308
Wraithshape,stormscale,1865,druid,restoration,66,37,29
Ромкабикстар,gordunni,1865,druid,restoration,52,26,26
Skrrlock,ravencrest,1865,druid,restoration,114,54,60
Aesha,los-errantes,1864,druid,restoration,60,31,29
Foxyfeet,outland,1858,druid,restoration,77,43,34
Lyricx,kazzak,1856,druid,restoration,66,32,34
Asaj,argent-dawn,1855,druid,restoration,353,193,160
Pll,defias-brotherhood,1853,druid,restoration,159,90,69
Køngx,blackhand,1853,druid,restoration,137,71,66
Starsyo,twisting-nether,1851,druid,restoration,142,85,57
Naraia,aegwynn,1850,druid,restoration,221,118,103
Loleh,ragnaros,1848,druid,restoration,101,53,48
Lalalime,arthas,1848,druid,restoration,70,33,37
Jmdr,silvermoon,1848,druid,restoration,77,32,45
Афклалка,gordunni,1847,druid,restoration,48,26,22
Promethezine,tarren-mill,1843,druid,restoration,494,255,239
Habibyy,kazzak,1841,druid,restoration,55,27,28
Хлайси,gordunni,1840,druid,restoration,54,25,29
Asøri,antonidas,1839,druid,restoration,78,33,45
Skillfall,ravencrest,1837,druid,restoration,102,51,51
Ammare,burning-legion,1836,druid,restoration,120,63,57
Deretus,blackmoore,1833,druid,restoration,58,28,30
Делоникс,soulflayer,1832,druid,restoration,96,46,50
Tunling,ravencrest,1830,druid,restoration,171,108,63
Telary,baelgun,1830,druid,restoration,48,29,19
Happypeanut,blackmoore,1830,druid,restoration,75,43,32
Lhûne,twisting-nether,1829,druid,restoration,54,26,28
Tropjeune,dalaran,1828,druid,restoration,48,27,21
Gummysnake,aszune,1823,druid,restoration,42,25,17
Treliuz,twilights-hammer,1823,druid,restoration,346,190,156
Yesco,malganis,1821,druid,restoration,63,27,36
Lunglung,blutkessel,1819,druid,restoration,204,112,92
Мафио,blackscar,1819,druid,restoration,54,28,26
Jìnró,ravencrest,1819,druid,restoration,183,89,94
Stiffýz,archimonde,1819,druid,restoration,60,29,31
Panørax,archimonde,1819,druid,restoration,71,33,38
Erika,vashj,1817,druid,restoration,120,67,53
Helløkittyßß,dun-modr,1817,druid,restoration,699,361,338
Skadooshee,kazzak,1816,druid,restoration,36,19,17
Bjoernbrudn,ravencrest,1816,druid,restoration,78,39,39
Bëstwôrld,archimonde,1815,druid,restoration,130,68,62
Moondra,outland,1815,druid,restoration,179,87,92
Nastycat,magtheridon,1815,druid,restoration,263,127,136
Migami,nemesis,1815,druid,restoration,113,54,59
Xvmon,draenor,1815,druid,restoration,99,45,54
Notsikaan,blackhand,1815,druid,restoration,83,37,46
Lyalis,kazzak,1814,druid,restoration,71,37,34
Diolives,stormscale,1813,druid,restoration,446,236,210
Mentallyill,ravencrest,1813,druid,restoration,234,115,119
Metagrass,stormscale,1812,druid,restoration,147,67,80
Troc,karazhan,1811,druid,restoration,50,25,25
Demiannie,argent-dawn,1810,druid,restoration,230,128,102
Bigborst,ravencrest,1808,druid,restoration,80,55,25
Terenzyo,veklor,1808,druid,restoration,36,19,17
Celéry,silvermoon,1807,druid,restoration,45,27,18
Panigale,dun-modr,1807,druid,restoration,172,81,91
Muraglia,pozzo-delleternità,1806,druid,restoration,30,19,11
Koshai,twisting-nether,1806,druid,restoration,59,34,25
Bellatrx,darksorrow,1806,druid,restoration,98,54,44
Morkius,ravencrest,1806,druid,restoration,36,19,17
Eduthecat,dun-modr,1805,druid,restoration,114,47,67
Çãm,magtheridon,1804,druid,restoration,173,101,72
Kokanine,ravencrest,1804,druid,restoration,81,46,35
Kìttÿ,dun-modr,1803,druid,restoration,72,43,29
Shiftycents,ravencrest,1803,druid,restoration,54,31,23
Riplilpeep,grim-batol,1803,druid,restoration,54,28,26
Gaeldeth,silvermoon,1802,druid,restoration,105,63,42
Layzz,archimonde,1802,druid,restoration,35,19,16
Qjkuug,ravencrest,1802,druid,restoration,88,47,41
Clonesy,outland,1800,druid,restoration,48,26,22
Maedic,outland,1799,druid,restoration,233,118,115
Sorryblya,ravencrest,1799,druid,restoration,100,45,55
Улдрэйн,deathguard,1798,druid,restoration,231,124,107
Hadok,azjolnerub,1798,druid,restoration,167,76,91
Крашдру,gordunni,1796,druid,restoration,112,64,48
Кенкертайм,gordunni,1794,druid,restoration,84,43,41
Wømbat,ravencrest,1794,druid,restoration,66,31,35
Ðezo,stormscale,1791,druid,restoration,60,29,31
Néøu,archimonde,1790,druid,restoration,78,36,42
Asklepion,twisting-nether,1785,druid,restoration,42,19,23
Muraebbasta,pozzo-delleternità,1784,druid,restoration,48,22,26
Lindorel,khaz-modan,1782,druid,restoration,228,119,109
Dyloxe,silvermoon,1781,druid,restoration,48,24,24
Fusetòn,tarren-mill,1779,druid,restoration,60,36,24
Lexopewpew,ravencrest,1779,druid,restoration,47,22,25
Zydrux,outland,1778,druid,restoration,54,37,17
Acxaryl,ravencrest,1777,druid,restoration,41,21,20
Lamatoes,ravencrest,1777,druid,restoration,77,34,43
Amaree,burning-legion,1774,druid,restoration,131,59,72
Tj,frostmane,1773,druid,restoration,52,22,30
Slayced,blackrock,1772,druid,restoration,89,44,45
Baawz,blackmoore,1772,druid,restoration,132,56,76
Crìmz,aszune,1767,druid,restoration,105,45,60
Gøðførm,silvermoon,1765,druid,restoration,184,96,88
Shiftypenny,ragnaros,1765,druid,restoration,47,22,25
Kùrámágødx,ravencrest,1764,druid,restoration,41,19,22
Riddlerdruid,aegwynn,1763,druid,restoration,44,30,14
Велаине,gordunni,1763,druid,restoration,429,234,195
Ninadobrev,ragnaros,1762,druid,restoration,63,31,32
Wraithmoon,stormscale,1761,druid,restoration,42,21,21
Shufflebot,sylvanas,1760,druid,restoration,48,28,20
Jimpä,outland,1760,druid,restoration,84,48,36
Tooclosex,outland,1760,druid,restoration,200,111,89
Zekmvp,silvermoon,1759,druid,restoration,185,87,98
Kittyperry,tarren-mill,1758,druid,restoration,141,73,68
Hizzy,burning-legion,1758,druid,restoration,297,145,152
Wéédmâñ,ravencrest,1756,druid,restoration,45,30,15
Kanyevotèrx,ravencrest,1756,druid,restoration,102,41,61
Sangré,suramar,1753,druid,restoration,220,113,107
Isquatbrah,tarren-mill,1753,druid,restoration,57,22,35
Брэвно,gordunni,1752,druid,restoration,417,225,192
Kosebamse,sylvanas,1750,druid,restoration,57,26,31
Mòzat,stormscale,1749,druid,restoration,54,28,26
Weezíng,ysondre,1747,druid,restoration,73,40,33
Badashellm,ravencrest,1744,druid,restoration,66,37,29
Feelstreeman,twisting-nether,1740,druid,restoration,245,135,110
Soguu,thrall,1740,druid,restoration,60,32,28
Тэддибиар,gordunni,1737,druid,restoration,95,62,33
Аренатренер,gordunni,1737,druid,restoration,348,178,170
Kroghelf,tarren-mill,1737,druid,restoration,58,28,30
Monatamis,kazzak,1735,druid,restoration,126,70,56
Nasduck,ravencrest,1734,druid,restoration,322,167,155
Wörstplayêr,archimonde,1733,druid,restoration,42,21,21
Vijaja,aegwynn,1732,druid,restoration,88,51,37
Bellhooks,blackrock,1731,druid,restoration,42,28,14
Naphé,ysondre,1731,druid,restoration,60,38,22
Dóodlez,aegwynn,1731,druid,restoration,45,23,22
Lfsecondreju,ravencrest,1730,druid,restoration,30,22,8
Филавтия,gordunni,1724,druid,restoration,60,32,28
Bigmeandruid,twisting-nether,1724,druid,restoration,66,33,33
Друлихаз,gordunni,1724,druid,restoration,96,45,51
Evílz,kazzak,1723,druid,restoration,63,32,31
Plantpuzzl,silvermoon,1723,druid,restoration,309,149,160
Ystalgia,sylvanas,1722,druid,restoration,78,39,39
Drøødis,archimonde,1720,druid,restoration,108,56,52
Tommiz,silvermoon,1720,druid,restoration,36,18,18
Georn,bladefist,1719,druid,restoration,87,58,29
Wheretowrite,ravencrest,1719,druid,restoration,274,146,128
Sprøutt,drakthul,1719,druid,restoration,36,18,18
Treeførm,ravencrest,1718,druid,restoration,59,36,23
Hyggef,ravencrest,1718,druid,restoration,48,22,26
Kawèlz,archimonde,1715,druid,restoration,42,25,17
Jìnro,stormscale,1714,druid,restoration,42,29,13
Bárdiandru,blackhand,1714,druid,restoration,41,21,20
Лабирошка,blackscar,1714,druid,restoration,60,24,36
Billydruida,sanguino,1713,druid,restoration,54,25,29
Slaugh,zuljin,1713,druid,restoration,66,26,40
Shumamakan,nemesis,1712,druid,restoration,48,26,22
Хуссипусси,galakrond,1711,druid,restoration,65,36,29
Siaz,archimonde,1711,druid,restoration,59,31,28
Olaphy,elune,1711,druid,restoration,557,280,277
Isitbleedin,silvermoon,1711,druid,restoration,54,24,30
Чекхмеаскохз,gordunni,1710,druid,restoration,102,58,44
Crownydrood,hyjal,1708,druid,restoration,84,49,35
Kvalitet,outland,1708,druid,restoration,127,59,68
Rozi,draenor,1705,druid,restoration,65,38,27
Ittei,korgall,1704,druid,restoration,156,86,70
Synapes,outland,1704,druid,restoration,105,51,54
Lifelover,outland,1704,druid,restoration,60,28,32
Nevax,blackrock,1700,druid,restoration,36,18,18
Skipperd,blackmoore,1700,druid,restoration,48,22,26
Bibeed,blackmoore,1699,druid,restoration,48,22,26
Rougetreize,khaz-modan,1697,druid,restoration,76,45,31
Eyvimel,ravencrest,1697,druid,restoration,701,366,335
Qjkuug,twisting-nether,1695,druid,restoration,196,110,86
Oloreformed,ravencrest,1693,druid,restoration,47,24,23
Josedudu,twisting-nether,1692,druid,restoration,75,37,38
Øhshift,drakthul,1690,druid,restoration,71,37,34
Fryén,archimonde,1690,druid,restoration,111,52,59
Stommz,defias-brotherhood,1689,druid,restoration,82,41,41
Nuurah,silvermoon,1688,druid,restoration,36,20,16
Yö,deathwing,1688,druid,restoration,297,156,141
Chainbrake,sylvanas,1688,druid,restoration,51,24,27
Eedaza,argent-dawn,1687,druid,restoration,176,91,85
Luhmanish,thunderhorn,1683,druid,restoration,160,82,78
Weisslogia,aegwynn,1683,druid,restoration,48,24,24
Кекичан,howling-fjord,1682,druid,restoration,65,26,39
Pogoth,turalyon,1680,druid,restoration,228,118,110
Дуггизавр,howling-fjord,1680,druid,restoration,35,18,17
Jnzymiau,blackrock,1679,druid,restoration,144,85,59
Mònsterz,archimonde,1678,druid,restoration,231,125,106
Doktordudu,drakthul,1678,druid,restoration,128,49,79
Akumei,ravencrest,1676,druid,restoration,47,24,23
Praetorian,sylvanas,1674,druid,restoration,369,181,188
Woohoo,ravencrest,1673,druid,restoration,36,21,15
Унаген,howling-fjord,1673,druid,restoration,79,44,35
Zhosy,shattrath,1673,druid,restoration,79,33,46
Diriculous,kazzak,1672,druid,restoration,265,125,140
Cøwgirl,draenor,1670,druid,restoration,78,40,38
Lxstcentury,stormscale,1669,druid,restoration,36,19,17
Elviiradruid,tarren-mill,1669,druid,restoration,97,51,46
Amarerawr,burning-legion,1668,druid,restoration,30,20,10
Olympïee,archimonde,1665,druid,restoration,42,23,19
Hólo,blackrock,1665,druid,restoration,174,82,92
Zmira,outland,1665,druid,restoration,60,27,33
Elayria,blackmoore,1663,druid,restoration,36,19,17
Ксенона,gordunni,1663,druid,restoration,60,30,30
Artichte,archimonde,1662,druid,restoration,66,39,27
Tamburoo,tarren-mill,1662,druid,restoration,375,187,188
Pawful,malganis,1661,druid,restoration,406,216,190
Pavelot,runetotem,1661,druid,restoration,113,60,53
Bigorkey,blackrock,1661,druid,restoration,313,160,153
Luminøuz,outland,1659,druid,restoration,156,77,79
Heavysmoker,emeriss,1659,druid,restoration,282,137,145
Demerit,aegwynn,1657,druid,restoration,32,18,14
Sélia,sylvanas,1657,druid,restoration,116,57,59
Taurvid,outland,1657,druid,restoration,41,18,23
Bâneth,destromath,1656,druid,restoration,60,33,27
Cheçhy,aegwynn,1655,druid,restoration,135,73,62
Ilarilén,blackmoore,1655,druid,restoration,96,49,47
Bulldócer,sanguino,1654,druid,restoration,116,55,61
Dëlins,outland,1654,druid,restoration,44,19,25
Doodougie,silvermoon,1653,druid,restoration,76,37,39
Ýanux,aegwynn,1652,druid,restoration,40,25,15
Zudwa,twisting-nether,1651,druid,restoration,62,37,25
Ooktharg,turalyon,1651,druid,restoration,89,47,42
Estariol,auchindoun,1650,druid,restoration,42,18,24
Bunzor,sylvanas,1649,druid,restoration,60,32,28
Чухх,howling-fjord,1647,druid,restoration,151,77,74
Drèamer,ravencrest,1645,druid,restoration,60,26,34
Mortalnight,sinstralis,1642,druid,restoration,532,266,266
Itswoland,emeriss,1641,druid,restoration,53,33,20
Orayin,ravencrest,1641,druid,restoration,535,282,253
Toddler,twisting-nether,1641,druid,restoration,52,19,33
Kyssope,chants-éternels,1640,druid,restoration,42,25,17
Hatecrew,twisting-nether,1640,druid,restoration,101,60,41
Tarshish,outland,1639,druid,restoration,36,24,12
Mohyo,antonidas,1638,druid,restoration,146,84,62
Arogane,outland,1638,druid,restoration,150,81,69
Wallenstein,outland,1638,druid,restoration,36,19,17
Sintiq,stormscale,1638,druid,restoration,48,25,23
Kiadorn,stormreaver,1637,druid,restoration,52,30,22
Абраг,soulflayer,1637,druid,restoration,72,36,36
Tôrmêñtêd,outland,1635,druid,restoration,182,106,76
Pardus,ambossar,1635,druid,restoration,50,27,23
Bjútiful,silvermoon,1635,druid,restoration,123,64,59
Uknowwhaddup,silvermoon,1634,druid,restoration,108,51,57
Andromedda,twisting-nether,1632,druid,restoration,221,117,104
Ekexd,grim-batol,1630,druid,restoration,48,26,22
Plsbuffdruid,ravencrest,1630,druid,restoration,40,19,21
Thilethyl,aggra-português,1630,druid,restoration,48,22,26
Farashh,archimonde,1630,druid,restoration,107,45,62
Tolteked,ravencrest,1629,druid,restoration,45,23,22
Watchmebear,stormscale,1627,druid,restoration,66,35,31
Nozome,draenor,1627,druid,restoration,135,66,69
Rêvétoile,sinstralis,1627,druid,restoration,197,91,106
Peterpain,grim-batol,1626,druid,restoration,30,17,13
Ёу,soulflayer,1624,druid,restoration,161,85,76
Demdeepconvx,twisting-nether,1623,druid,restoration,60,22,38
Miyá,sylvanas,1622,druid,restoration,82,43,39
Hotsnthots,elune,1622,druid,restoration,48,24,24
Eldi,uldum,1622,druid,restoration,36,17,19
Ecological,outland,1622,druid,restoration,48,22,26
Chaboom,hyjal,1622,druid,restoration,60,25,35
Ðæððÿçhïll,ravencrest,1621,druid,restoration,97,61,36
Zevana,tarren-mill,1621,druid,restoration,42,23,19
Нубстримсс,gordunni,1621,druid,restoration,124,62,62
Maiverdr,ravencrest,1621,druid,restoration,42,20,22
Опапенелопа,blackscar,1620,druid,restoration,45,30,15
Jamieform,ravencrest,1619,druid,restoration,85,46,39
Apokalypse,stormreaver,1619,druid,restoration,198,104,94
Twerkdabooty,azjolnerub,1619,druid,restoration,60,29,31
Zaelitwo,archimonde,1618,druid,restoration,54,36,18
Frances,auchindoun,1618,druid,restoration,69,39,30
Reinulfen,blackmoore,1618,druid,restoration,462,242,220
Elu,eredar,1617,druid,restoration,48,28,20
Haszard,outland,1617,druid,restoration,134,68,66
Wernøs,archimonde,1617,druid,restoration,99,48,51
Jackyblue,silvermoon,1617,druid,restoration,48,22,26
Probablyahoe,ravencrest,1616,druid,restoration,42,21,21
Goldrax,outland,1615,druid,restoration,24,17,7
Bigdaddyshay,twisting-nether,1615,druid,restoration,42,24,18
Tåylor,laughing-skull,1615,druid,restoration,41,21,20
Buffbloom,auchindoun,1615,druid,restoration,183,93,90
Драменбейз,gordunni,1615,druid,restoration,42,20,22
Dûdûrînâ,blackrock,1614,druid,restoration,66,42,24
Nstt,dun-modr,1614,druid,restoration,32,17,15
Neluun,die-aldor,1613,druid,restoration,60,39,21
Kll,defias-brotherhood,1613,druid,restoration,54,27,27
Catgirlx,ravencrest,1612,druid,restoration,54,30,24
Búse,twisting-nether,1611,druid,restoration,48,21,27
Ånåphorå,archimonde,1609,druid,restoration,35,20,15
Xalio,ravencrest,1609,druid,restoration,161,90,71
Fatøumatä,archimonde,1608,druid,restoration,144,71,73
Malacella,marécage-de-zangar,1608,druid,restoration,54,22,32
Slimp,the-maelstrom,1608,druid,restoration,54,21,33
Místergreen,ravencrest,1607,druid,restoration,48,23,25
Kheazar,blackmoore,1606,druid,restoration,115,69,46
Nímbs,tarren-mill,1606,druid,restoration,99,52,47
Oceleaf,tarren-mill,1606,druid,restoration,46,21,25
Блицклик,gordunni,1605,druid,restoration,148,73,75
Solutionx,aegwynn,1605,druid,restoration,80,33,47
Scorlok,eredar,1604,druid,restoration,157,88,69
Cioban,stormscale,1604,druid,restoration,418,209,209
Fabsl,archimonde,1604,druid,restoration,123,61,62
Bîrke,blackrock,1604,druid,restoration,36,17,19
Alásea,kazzak,1604,druid,restoration,54,21,33
Youngdinozzo,dalaran,1603,druid,restoration,30,20,10
Tjann,darksorrow,1603,druid,restoration,48,23,25
Donaarr,stormscale,1603,druid,restoration,122,56,66
Sarxidor,defias-brotherhood,1603,druid,restoration,96,38,58
Нагетсмяу,howling-fjord,1602,druid,restoration,249,136,113
Mikeisbike,ragnaros,1601,druid,restoration,44,22,22
Viggez,outland,1601,druid,restoration,36,17,19
Ðarckness,kazzak,1600,druid,restoration,24,17,7
Möllemäck,sylvanas,1600,druid,restoration,86,54,32
Zuuhhl,ravencrest,1600,druid,restoration,54,31,23
Swifte,argent-dawn,1600,druid,restoration,48,27,21
Dwaokut,ravencrest,1600,druid,restoration,242,125,117
Akmón,tarren-mill,1600,druid,restoration,58,20,38
Dïsä,ravencrest,1599,druid,restoration,30,17,13
Moonfinder,tarren-mill,1597,druid,restoration,60,29,31
Shaelx,nethersturm,1597,druid,restoration,60,28,32
Loltree,outland,1596,druid,restoration,54,26,28
Setztes,tarren-mill,1594,druid,restoration,352,184,168
Delviri,stormreaver,1594,druid,restoration,265,135,130
Maltøx,archimonde,1593,druid,restoration,36,17,19
Миледистайпи,gordunni,1591,druid,restoration,81,39,42
Kiggstar,blackmoore,1590,druid,restoration,83,46,37
Folzenqt,archimonde,1590,druid,restoration,68,27,41
Pega,archimonde,1589,druid,restoration,189,91,98
Adjaara,ravencrest,1588,druid,restoration,157,87,70
Buklau,stormscale,1588,druid,restoration,54,22,32
Kaamirach,blackmoore,1587,druid,restoration,190,113,77
Muminoses,burning-legion,1587,druid,restoration,155,76,79
Bêvêrly,ravencrest,1586,druid,restoration,70,37,33
Гвенивар,soulflayer,1586,druid,restoration,42,20,22
Homek,eredar,1584,druid,restoration,264,138,126
Prayx,dalaran,1583,druid,restoration,89,45,44
Halyconwings,outland,1582,druid,restoration,91,52,39
Smightydr,silvermoon,1579,druid,restoration,71,32,39
Naridruidx,eredar,1578,druid,restoration,42,26,16
Ssonty,drakthul,1578,druid,restoration,93,43,50
Nyxxz,shattered-hand,1577,druid,restoration,66,38,28
Nightmoon,hellscream,1576,druid,restoration,67,29,38
Animaldoh,kazzak,1576,druid,restoration,66,27,39
Рамчег,gordunni,1575,druid,restoration,54,26,28
Solern,ravencrest,1573,druid,restoration,41,23,18
Maníx,tarren-mill,1572,druid,restoration,192,110,82
Phelessa,silvermoon,1571,druid,restoration,78,37,41
Eeivi,argent-dawn,1570,druid,restoration,303,163,140
Rawri,blackmoore,1570,druid,restoration,104,51,53
Devastras,ravencrest,1564,druid,restoration,58,29,29
Nasgra,malganis,1563,druid,restoration,59,27,32
Wagoneis,grim-batol,1560,druid,restoration,136,77,59
Miyokô,grim-batol,1560,druid,restoration,96,51,45
Deluron,malganis,1560,druid,restoration,200,104,96
Друмания,gordunni,1560,druid,restoration,282,140,142
Yzher,archimonde,1558,druid,restoration,43,25,18
Kundz,dalaran,1558,druid,restoration,160,88,72
Jagerdog,archimonde,1558,druid,restoration,39,18,21
Naturez,sylvanas,1557,druid,restoration,32,20,12
Bammedrudu,archimonde,1557,druid,restoration,54,32,22
Hashtagone,ysondre,1556,druid,restoration,111,59,52
Артекриодру,howling-fjord,1556,druid,restoration,60,31,29
Moonbee,burning-blade,1556,druid,restoration,212,105,107
Kasugia,aegwynn,1556,druid,restoration,48,20,28
Kaher,ravencrest,1555,druid,restoration,114,61,53
Crïn,ravencrest,1553,druid,restoration,36,17,19
Druncha,sunstrider,1553,druid,restoration,189,74,115
Nancey,auchindoun,1552,druid,restoration,197,97,100
Dafapa,twilights-hammer,1550,druid,restoration,72,40,32
Фатуомуэрте,razuvious,1550,druid,restoration,96,43,53
Bearform,blackhand,1548,druid,restoration,48,23,25
Ына,gordunni,1547,druid,restoration,197,105,92
Khunahype,thrall,1546,druid,restoration,88,48,40
Ráw,dun-modr,1546,druid,restoration,167,84,83
Lyvuni,blackmoore,1543,druid,restoration,66,40,26
Друлёнышь,eversong,1543,druid,restoration,218,117,101
Рамзес,gordunni,1543,druid,restoration,105,55,50
Dardargnan,throkferoth,1543,druid,restoration,142,69,73
Shiftway,stormscale,1541,druid,restoration,87,45,42
Ihatemétoo,stormscale,1541,druid,restoration,100,51,49
Fredhqt,tarren-mill,1540,druid,restoration,52,30,22
Seherbaz,ravencrest,1539,druid,restoration,76,44,32
Лэвиш,blackscar,1539,druid,restoration,96,55,41
Мекс,gordunni,1537,druid,restoration,29,17,12
Critdruid,kazzak,1536,druid,restoration,60,23,37
Уэсериктх,blackscar,1535,druid,restoration,51,28,23
Roshaga,blackrock,1535,druid,restoration,51,25,26
Hideme,tarren-mill,1534,druid,restoration,209,108,101
Reya,hyjal,1534,druid,restoration,198,102,96
Директорх,blackscar,1534,druid,restoration,47,22,25
Лабирон,soulflayer,1534,druid,restoration,36,16,20
Néllä,archimonde,1532,druid,restoration,113,65,48
Ðès,ravencrest,1532,druid,restoration,156,72,84
Styleexd,ragnaros,1530,druid,restoration,111,63,48
Icecöld,silvermoon,1529,druid,restoration,24,16,8
Eviscreator,stormscale,1529,druid,restoration,45,27,18
Fouser,shattered-hand,1528,druid,restoration,27,20,7
Kittý,terokkar,1528,druid,restoration,180,92,88
Yellow,sylvanas,1528,druid,restoration,69,30,39
Beerform,ravencrest,1528,druid,restoration,45,17,28
Ванечка,razuvious,1528,druid,restoration,84,30,54
Hasselhoof,eredar,1526,druid,restoration,63,26,37
Treedog,ravencrest,1525,druid,restoration,84,35,49
Melonmanx,outland,1523,druid,restoration,30,17,13
Felisin,ravencrest,1523,druid,restoration,41,21,20
Cuxorb,rexxar,1521,druid,restoration,710,366,344
Bullander,sylvanas,1521,druid,restoration,36,16,20
Snuffurious,ragnaros,1520,druid,restoration,54,32,22
Oøom,stormscale,1518,druid,restoration,60,23,37
Grololotte,dalaran,1517,druid,restoration,522,273,249
Baldurix,blackrock,1516,druid,restoration,71,35,36
Caldino,tarren-mill,1516,druid,restoration,41,17,24
Инкуль,gordunni,1515,druid,restoration,186,102,84
Лапыбонги,lich-king,1515,druid,restoration,123,56,67
Квирит,razuvious,1515,druid,restoration,116,47,69
Utopiah,ravencrest,1513,druid,restoration,80,45,35
Supremecat,tarren-mill,1513,druid,restoration,102,57,45
Keldraïn,hyjal,1513,druid,restoration,60,24,36
Latêralus,silvermoon,1513,druid,restoration,67,26,41
Сладуляя,gordunni,1512,druid,restoration,71,32,39
Tînkerbèll,blackmoore,1511,druid,restoration,41,22,19
Deliveru,outland,1511,druid,restoration,46,23,23
Локотьдрева,gordunni,1511,druid,restoration,48,19,29
Swisz,bronzebeard,1510,druid,restoration,113,57,56
Dartdogg,sanguino,1510,druid,restoration,125,55,70
Buckié,twisting-nether,1509,druid,restoration,97,51,46
Azchuk,blackmoore,1509,druid,restoration,53,22,31
Eaglefox,aszune,1508,druid,restoration,113,55,58
Bloomies,tarren-mill,1507,druid,restoration,100,59,41
Larlye,dun-modr,1507,druid,restoration,60,31,29
Åzjôl,magtheridon,1507,druid,restoration,42,20,22
Ríkku,sargeras,1507,druid,restoration,144,68,76
Ravenfang,dun-modr,1506,druid,restoration,223,129,94
Мостурбаза,soulflayer,1506,druid,restoration,30,16,14
Друрашка,soulflayer,1504,druid,restoration,129,67,62
Cæsífer,area-52,1504,druid,restoration,109,51,58
Cesn,vashj,1504,druid,restoration,106,49,57
Lÿter,dun-modr,1502,druid,restoration,60,27,33
Greenlips,ravencrest,1502,druid,restoration,60,23,37
Jìkkz,aegwynn,1502,druid,restoration,76,29,47
Edal,chogall,1500,druid,restoration,354,179,175
Worstdruid,sanguino,1499,druid,restoration,24,16,8
Erebear,ravencrest,1498,druid,restoration,105,61,44
Stratocaster,blackmoore,1498,druid,restoration,54,26,28
Aebí,dalaran,1496,druid,restoration,60,40,20
Groundpovx,blackmoore,1496,druid,restoration,72,37,35
Helkondr,thrall,1496,druid,restoration,48,17,31
Trayndaras,drakthul,1495,druid,restoration,35,23,12
Ccmydcv,archimonde,1495,druid,restoration,37,19,18
Kicki,outland,1494,druid,restoration,66,34,32
Djvapelordx,stormscale,1494,druid,restoration,281,144,137
Hellofresh,silvermoon,1494,druid,restoration,102,47,55
Lemicus,twisting-nether,1494,druid,restoration,78,31,47
Didi,frostwhisper,1493,druid,restoration,273,141,132
Pyctograhm,eldrethalas,1493,druid,restoration,60,26,34
Trollisha,mannoroth,1491,druid,restoration,1732,850,882
Jtepdru,ravencrest,1490,druid,restoration,132,67,65
Ldoctorl,ravencrest,1490,druid,restoration,118,55,63
Atôtheex,kazzak,1488,druid,restoration,43,21,22
Roshava,stormscale,1487,druid,restoration,64,42,22
Moonfetamine,silvermoon,1487,druid,restoration,211,108,103
Veganbtw,tarren-mill,1486,druid,restoration,97,34,63
Mnine,twisting-nether,1485,druid,restoration,42,23,19
Vashiko,tarren-mill,1485,druid,restoration,107,56,51
Mw,dun-modr,1484,druid,restoration,148,70,78
Moontriix,kazzak,1481,druid,restoration,103,54,49
Zaerox,ambossar,1481,druid,restoration,114,56,58
Flåppers,stormscale,1481,druid,restoration,64,26,38
Bearliheals,draenor,1480,druid,restoration,110,65,45
Дилайт,blackscar,1479,druid,restoration,164,87,77
Làhen,ravencrest,1479,druid,restoration,377,187,190
Bloompuf,draenor,1479,druid,restoration,337,164,173
Атмос,deathguard,1478,druid,restoration,198,109,89
Devióus,twilights-hammer,1478,druid,restoration,502,254,248
Kyjaa,eredar,1478,druid,restoration,96,43,53
Phala,outland,1478,druid,restoration,48,20,28
Nezpa,ravencrest,1477,druid,restoration,70,43,27
Lukass,drakthul,1477,druid,restoration,242,125,117
Xôárqt,aegwynn,1477,druid,restoration,72,33,39
Maqer,argent-dawn,1476,druid,restoration,56,31,25
Brorsnor,ravencrest,1476,druid,restoration,195,93,102
Høtbøt,ysera,1475,druid,restoration,81,40,41
Gvairon,silvermoon,1474,druid,restoration,36,17,19
Mischkonsum,outland,1474,druid,restoration,56,24,32
Akasuky,thrall,1473,druid,restoration,235,123,112
Drozzie,twisting-nether,1472,druid,restoration,24,16,8
Иггдрассиль,blackscar,1472,druid,restoration,54,31,23
Sandh,uldum,1472,druid,restoration,84,40,44
Taèzoth,terokkar,1471,druid,restoration,50,31,19
Thanom,auchindoun,1470,druid,restoration,324,166,158
Clovér,outland,1470,druid,restoration,131,65,66
Islandbôy,blackrock,1470,druid,restoration,42,16,26
Exilia,kragjin,1469,druid,restoration,53,25,28
Hótty,antonidas,1468,druid,restoration,83,37,46
Skoony,kazzak,1465,druid,restoration,146,78,68
Tehira,antonidas,1465,druid,restoration,118,52,66
Myxer,ravencrest,1463,druid,restoration,110,65,45
Kormakurr,silvermoon,1463,druid,restoration,87,51,36
Lolhaha,ravencrest,1463,druid,restoration,54,24,30
Feyzoude,ysondre,1461,druid,restoration,40,24,16
Drbse,silvermoon,1461,druid,restoration,56,28,28
Buckxxz,nazjatar,1460,druid,restoration,147,80,67
Фапдрим,howling-fjord,1460,druid,restoration,670,337,333
Блумха,howling-fjord,1459,druid,restoration,78,41,37
Cliftshifter,outland,1458,druid,restoration,36,25,11
Sodamncute,ravencrest,1458,druid,restoration,41,24,17
Маминапуська,soulflayer,1458,druid,restoration,57,32,25
Spliçe,draenor,1458,druid,restoration,48,24,24
Arlandia,drakthul,1458,druid,restoration,42,17,25
Davorian,frostmane,1457,druid,restoration,117,55,62
Asanaria,ravencrest,1457,druid,restoration,113,52,61
Hellcow,blackmoore,1455,druid,restoration,119,54,65
Salagkoydi,sylvanas,1453,druid,restoration,90,51,39
Csmedruid,blackrock,1453,druid,restoration,72,39,33
Ööh,outland,1453,druid,restoration,48,25,23
Elmáestró,aegwynn,1452,druid,restoration,60,28,32
Elwenyss,outland,1452,druid,restoration,77,34,43
Euskal,chogall,1451,druid,restoration,42,18,24
Dêrbombär,guldan,1451,druid,restoration,52,21,31
Будклим,blackscar,1450,druid,restoration,48,27,21
Deltalol,blackmoore,1450,druid,restoration,48,25,23
Skailzdruid,hyjal,1449,druid,restoration,291,161,130
Fangornn,outland,1448,druid,restoration,131,73,58
Estrogenlord,auchindoun,1448,druid,restoration,66,33,33
Zyndril,silvermoon,1448,druid,restoration,50,25,25
Druidelf,sylvanas,1448,druid,restoration,53,16,37
Ààlunåhlolz,azjolnerub,1447,druid,restoration,24,17,7
Cyclonebroo,blackmoore,1447,druid,restoration,64,31,33
Bigßoi,stormscale,1446,druid,restoration,164,87,77
Afret,kazzak,1444,druid,restoration,147,78,69
Ráay,blackrock,1444,druid,restoration,126,66,60
Bägira,sylvanas,1444,druid,restoration,467,239,228
Guccicken,garona,1444,druid,restoration,270,138,132
Dârkacêû,blackmoore,1444,druid,restoration,121,56,65
Pureballs,twisting-nether,1442,druid,restoration,201,109,92
Innos,azshara,1442,druid,restoration,54,22,32
Siuo,ravencrest,1442,druid,restoration,78,31,47
Alexialol,silvermoon,1441,druid,restoration,31,19,12
Kajiun,silvermoon,1441,druid,restoration,54,32,22
Evoon,emeriss,1441,druid,restoration,78,42,36
Shadowmeld,stormreaver,1441,druid,restoration,62,32,30
Dadjus,kazzak,1441,druid,restoration,81,39,42
Xoriauz,archimonde,1441,druid,restoration,227,107,120
Xyruden,kazzak,1441,druid,restoration,171,69,102
Hotlotta,aegwynn,1440,druid,restoration,31,16,15
Shlipshlap,eredar,1440,druid,restoration,78,28,50
Sùmmêrz,outland,1439,druid,restoration,59,23,36
Цукерище,gordunni,1438,druid,restoration,64,36,28
Vacuumcleanr,ravencrest,1438,druid,restoration,30,15,15
Filyina,blackrock,1438,druid,restoration,182,86,96
Champaa,aggra-português,1438,druid,restoration,87,35,52
Floka,archimonde,1437,druid,restoration,90,44,46
Emersyn,ragnaros,1437,druid,restoration,50,19,31
Síggíe,eredar,1436,druid,restoration,30,17,13
Cörelly,ravencrest,1436,druid,restoration,440,237,203
Rawillinen,kazzak,1436,druid,restoration,54,28,26
Вексиус,gordunni,1436,druid,restoration,72,36,36
Leafceld,aggra-português,1436,druid,restoration,138,68,70
Solàryx,hyjal,1434,druid,restoration,72,38,34
Febricyla,blackmoore,1434,druid,restoration,96,47,49
Druma,stormscale,1433,druid,restoration,48,25,23
Karenvolf,outland,1433,druid,restoration,30,15,15
Lhithium,kazzak,1432,druid,restoration,138,78,60
Kukisanban,stormscale,1432,druid,restoration,314,168,146
Senoka,shattrath,1432,druid,restoration,335,174,161
Buckxxz,aegwynn,1432,druid,restoration,60,31,29
Sejki,aegwynn,1431,druid,restoration,94,50,44
Lùnæxqt,hyjal,1430,druid,restoration,24,15,9
Маккаланн,soulflayer,1430,druid,restoration,105,56,49
Rensselitäti,korgall,1430,druid,restoration,182,90,92
Òniz,hyjal,1428,druid,restoration,46,30,16
Maethar,stormrage,1428,druid,restoration,111,67,44
Wenciorek,kazzak,1428,druid,restoration,165,82,83
Druchori,eredar,1428,druid,restoration,58,28,30
Cylantus,eredar,1427,druid,restoration,72,45,27
Grïmsïght,draenor,1427,druid,restoration,214,108,106
Analmonstret,shattered-hand,1427,druid,restoration,35,17,18
Märe,defias-brotherhood,1426,druid,restoration,84,45,39
Nelffie,kazzak,1425,druid,restoration,227,123,104
Mabkferal,ravencrest,1425,druid,restoration,30,15,15
Mayurí,kazzak,1423,druid,restoration,92,60,32
Smucka,ragnaros,1423,druid,restoration,42,19,23
Xoat,marécage-de-zangar,1422,druid,restoration,66,35,31
Sygko,kazzak,1422,druid,restoration,30,15,15
Knzm,dun-modr,1420,druid,restoration,198,106,92
Brosephiné,stormscale,1420,druid,restoration,74,38,36
Shiu,blackmoore,1420,druid,restoration,60,21,39
Akuda,blackrock,1419,druid,restoration,158,79,79
Sandirion,silvermoon,1419,druid,restoration,910,454,456
Tokifong,kazzak,1419,druid,restoration,36,15,21
Iqqzazagotme,hyjal,1418,druid,restoration,68,29,39
Obamos,stormscale,1416,druid,restoration,64,37,27
Althei,argent-dawn,1416,druid,restoration,116,62,54
Budspencebär,draenor,1416,druid,restoration,82,41,41
Thorns,blackrock,1416,druid,restoration,30,15,15
Âurum,silvermoon,1416,druid,restoration,56,27,29
Basilethe,hyjal,1415,druid,restoration,72,41,31
Røxhot,archimonde,1415,druid,restoration,156,88,68
Кингкиса,gordunni,1415,druid,restoration,66,26,40
Cptfalcony,outland,1413,druid,restoration,106,54,52
Stuu,nathrezim,1413,druid,restoration,78,39,39
Schwertlilie,aegwynn,1413,druid,restoration,59,26,33
Shredz,destromath,1413,druid,restoration,36,15,21
Огрызокрыбы,howling-fjord,1412,druid,restoration,47,32,15
Soný,aegwynn,1412,druid,restoration,42,25,17
Barkingdog,tarren-mill,1412,druid,restoration,57,31,26
Antheiaa,frostmane,1411,druid,restoration,72,32,40
Mortagua,kazzak,1410,druid,restoration,36,15,21
Trúdl,das-konsortium,1409,druid,restoration,48,28,20
Wooshy,kazzak,1406,druid,restoration,105,52,53
Plàntz,tarren-mill,1406,druid,restoration,79,39,40
Avemonthemus,silvermoon,1405,druid,restoration,46,21,25
Jikuni,ravencrest,1404,druid,restoration,81,39,42
Drukae,stormscale,1403,druid,restoration,97,46,51
Rytmusdudu,ragnaros,1403,druid,restoration,42,19,23
Goatd,ravencrest,1403,druid,restoration,36,16,20
Béccàbtw,draenor,1402,druid,restoration,30,16,14
Peerpope,draenor,1402,druid,restoration,311,164,147
Elysea,antonidas,1402,druid,restoration,120,63,57
Suprot,aggramar,1402,druid,restoration,106,52,54
Hotto,antonidas,1400,druid,restoration,53,38,15
Друидсимба,howling-fjord,1400,druid,restoration,206,109,97
Cevto,drakthul,1400,druid,restoration,50,22,28
Liunara,nemesis,1400,druid,restoration,67,29,38
Lavague,hyjal,1400,druid,restoration,48,20,28
Pumplt,thrall,1399,druid,restoration,84,46,38
Minipilsen,outland,1399,druid,restoration,77,38,39
Qri,ahnqiraj,1398,druid,restoration,84,46,38
Healingwoods,outland,1398,druid,restoration,30,15,15
Jcpenney,xavius,1398,druid,restoration,564,277,287
Азя,blackscar,1398,druid,restoration,80,36,44
Lycann,burning-blade,1397,druid,restoration,54,30,24
Noosh,thrall,1397,druid,restoration,86,44,42
Feinberg,stormscale,1397,druid,restoration,101,44,57
Yandris,argent-dawn,1396,druid,restoration,42,19,23
Tharteu,sanguino,1395,druid,restoration,170,85,85
Tokitoc,archimonde,1394,druid,restoration,101,59,42
Daewen,blackhand,1394,druid,restoration,112,61,51
Qekw,blackhand,1394,druid,restoration,54,28,26
Dortalon,outland,1394,druid,restoration,119,57,62
Drineh,ravencrest,1393,druid,restoration,48,21,27
Fth,dethecus,1392,druid,restoration,39,22,17
Ilyethea,earthen-ring,1392,druid,restoration,476,250,226
Legyna,ravencrest,1392,druid,restoration,112,56,56
Glückstaler,die-aldor,1392,druid,restoration,78,33,45
Saberrtooth,twisting-nether,1391,druid,restoration,105,53,52
Oceanvibes,tarren-mill,1391,druid,restoration,41,18,23
Indann,kazzak,1390,druid,restoration,48,21,27
Bearinator,aggramar,1389,druid,restoration,744,386,358
Plúx,antonidas,1388,druid,restoration,44,18,26
Sucukk,antonidas,1387,druid,restoration,71,35,36
Orinkhealer,ravencrest,1385,druid,restoration,202,97,105
Tanariel,ravencrest,1384,druid,restoration,89,50,39
Sgtdrood,archimonde,1384,druid,restoration,55,27,28
Shiftshow,ravencrest,1383,druid,restoration,46,29,17
Lestty,the-maelstrom,1383,druid,restoration,70,38,32
Nuwell,arathor,1383,druid,restoration,156,78,78
Starryraven,argent-dawn,1381,druid,restoration,235,122,113
Corroboree,archimonde,1380,druid,restoration,118,65,53
Mewiz,ravencrest,1380,druid,restoration,42,23,19
Ивантяй,gordunni,1380,druid,restoration,239,118,121
Sertris,kazzak,1380,druid,restoration,64,27,37
Gandraste,neptulon,1379,druid,restoration,24,19,5
Hanibalector,silvermoon,1379,druid,restoration,69,39,30
Maghh,ravencrest,1379,druid,restoration,124,66,58
Wwvwwvwwvwvw,burning-legion,1378,druid,restoration,145,62,83
Laserlars,blackrock,1377,druid,restoration,25,16,9
Mlvn,outland,1377,druid,restoration,53,24,29
Warami,eredar,1377,druid,restoration,83,36,47
Blacksage,dragonmaw,1376,druid,restoration,107,50,57
Tjruid,twisting-nether,1375,druid,restoration,34,20,14
Zfaf,hyjal,1375,druid,restoration,54,30,24
Whiplazh,archimonde,1375,druid,restoration,58,32,26
Spacedout,taerar,1375,druid,restoration,61,33,28
Basajáun,dun-modr,1375,druid,restoration,240,117,123
Ðaezk,archimonde,1374,druid,restoration,36,16,20
Uuni,sylvanas,1374,druid,restoration,84,37,47
Yunalaa,blackmoore,1373,druid,restoration,95,49,46
Deví,twilights-hammer,1373,druid,restoration,48,23,25
Badbloom,ravencrest,1372,druid,restoration,54,26,28
Untouchablè,outland,1371,druid,restoration,69,31,38
Вакидзами,gordunni,1369,druid,restoration,338,175,163
Saintbiose,dalaran,1368,druid,restoration,24,17,7
Lindémann,blackhand,1367,druid,restoration,42,23,19
Lynysae,blackmoore,1366,druid,restoration,57,29,28
Fondü,outland,1366,druid,restoration,48,24,24
Mudruu,blackrock,1366,druid,restoration,60,24,36
Atí,the-maelstrom,1365,druid,restoration,36,19,17
Milkmepls,balnazzar,1364,druid,restoration,30,19,11
Рефикс,gordunni,1364,druid,restoration,115,72,43
Канимэ,howling-fjord,1362,druid,restoration,45,19,26
Shelby,tirion,1360,druid,restoration,189,99,90
Diastra,silvermoon,1360,druid,restoration,354,181,173
Inkeyes,outland,1358,druid,restoration,259,128,131
Biomat,norgannon,1357,druid,restoration,131,65,66
Zwierzyniec,jaedenar,1357,druid,restoration,60,27,33
Xontpos,stormscale,1356,druid,restoration,24,15,9
Shinymoomoo,tarren-mill,1356,druid,restoration,74,38,36
Steuerung,twisting-nether,1356,druid,restoration,72,26,46
Eko,auchindoun,1355,druid,restoration,249,128,121
Stonesight,argent-dawn,1354,druid,restoration,81,39,42
Bakicadr,sylvanas,1353,druid,restoration,93,42,51
Euklid,frostwolf,1353,druid,restoration,36,15,21
Animaltucher,nemesis,1352,druid,restoration,35,15,20
Nayokô,grim-batol,1351,druid,restoration,72,36,36
Царапкатян,gordunni,1351,druid,restoration,212,101,111
Ånaðeårmas,outland,1351,druid,restoration,39,16,23
Emørtality,aegwynn,1351,druid,restoration,87,30,57
Ninø,gorgonnash,1350,druid,restoration,134,72,62
Exïlla,archimonde,1350,druid,restoration,112,56,56
Zadrood,rashgarroth,1349,druid,restoration,227,117,110
Yenwe,kazzak,1348,druid,restoration,215,111,104
Shadowcat,archimonde,1348,druid,restoration,49,22,27
Parkydru,draenor,1346,druid,restoration,30,20,10
Jinxaran,culte-de-la-rive-noire,1346,druid,restoration,30,18,12
Hotsandpot,outland,1346,druid,restoration,36,15,21
Niknoom,azjolnerub,1345,druid,restoration,314,177,137
Duharbrahud,outland,1345,druid,restoration,54,22,32
Feralgodx,quelthalas,1344,druid,restoration,27,16,11
Pøwêr,blackrock,1344,druid,restoration,36,16,20
Ipossible,kazzak,1344,druid,restoration,54,18,36
Pzqlol,outland,1343,druid,restoration,18,14,4
Zaelithree,archimonde,1343,druid,restoration,24,14,10
Кнесис,howling-fjord,1342,druid,restoration,91,52,39
Brømberry,blackrock,1342,druid,restoration,155,75,80
Antimend,draenor,1341,druid,restoration,24,14,10
Shufflê,blackmoore,1341,druid,restoration,154,69,85
Bayerant,burning-legion,1341,druid,restoration,36,15,21
Nohos,blackrock,1340,druid,restoration,24,14,10
Sariel,saurfang,1340,druid,restoration,377,189,188
Zuzam,bladefist,1340,druid,restoration,144,67,77
Лдрион,gordunni,1339,druid,restoration,57,36,21
Idect,silvermoon,1339,druid,restoration,348,177,171
Holybarkz,aegwynn,1337,druid,restoration,30,14,16
Göli,argent-dawn,1335,druid,restoration,62,29,33
Meowsovs,draenor,1335,druid,restoration,48,19,29
Mangy,xavius,1334,druid,restoration,161,83,78
Rockyfella,alexstrasza,1334,druid,restoration,55,27,28
Cdurdroød,culte-de-la-rive-noire,1334,druid,restoration,117,56,61
Shifthappénz,draenor,1334,druid,restoration,60,28,32
Mojorising,drakthul,1333,druid,restoration,36,21,15
Mchots,ragnaros,1333,druid,restoration,143,69,74
Béstfriend,uldum,1333,druid,restoration,34,15,19
Likh,das-konsortium,1332,druid,restoration,24,14,10
Phebzdrood,archimonde,1332,druid,restoration,63,34,29
Хекзкор,ashenvale,1332,druid,restoration,60,30,30
Ekaterina,dun-morogh,1331,druid,restoration,99,54,45
Forzendl,twisting-nether,1331,druid,restoration,89,46,43
Emodruid,sunstrider,1330,druid,restoration,24,14,10
Trä,zenedar,1330,druid,restoration,91,50,41
Druidorie,ravencrest,1330,druid,restoration,48,24,24
Greengolly,argent-dawn,1330,druid,restoration,48,21,27
Whatismeld,outland,1330,druid,restoration,42,14,28
Тчаёк,gordunni,1329,druid,restoration,56,32,24
Cønvoke,kazzak,1329,druid,restoration,54,23,31
Cazzette,grim-batol,1328,druid,restoration,85,52,33
Thornat,chamber-of-aspects,1328,druid,restoration,130,70,60
Versatil,uldum,1327,druid,restoration,65,28,37
Blomberg,burning-legion,1326,druid,restoration,96,52,44
Kramit,ravencrest,1326,druid,restoration,54,26,28
Hidras,tarren-mill,1326,druid,restoration,48,21,27
Søykañ,hyjal,1325,druid,restoration,116,59,57
Bennydruid,kazzak,1324,druid,restoration,144,64,80
Séifér,auchindoun,1323,druid,restoration,50,25,25
Teengirl,blackmoore,1323,druid,restoration,30,14,16
Sonyk,drakthul,1323,druid,restoration,36,14,22
Julss,archimonde,1322,druid,restoration,178,90,88
Армсдру,gordunni,1322,druid,restoration,48,23,25
Kattbjörnen,ragnaros,1321,druid,restoration,254,134,120
Rabacki,blackmoore,1320,druid,restoration,150,70,80
Нортикус,soulflayer,1320,druid,restoration,59,27,32
Akifumi,archimonde,1320,druid,restoration,58,19,39
Koemarkt,sunstrider,1319,druid,restoration,46,29,17
Endoplazmik,silvermoon,1319,druid,restoration,61,36,25
Jmaz,outland,1318,druid,restoration,132,67,65
Esmerito,tarren-mill,1318,druid,restoration,36,17,19
Mealann,drakthul,1318,druid,restoration,42,16,26
Coineagan,frostmourne,1318,druid,restoration,48,14,34
Крайсонг,soulflayer,1316,druid,restoration,42,21,21
Катяблум,gordunni,1316,druid,restoration,120,51,69
Aolynk,twisting-nether,1316,druid,restoration,41,17,24
Digestivebis,defias-brotherhood,1315,druid,restoration,186,108,78
Funkagenda,silvermoon,1315,druid,restoration,42,24,18
Varázabab,ragnaros,1315,druid,restoration,59,29,30
Hrustek,tarren-mill,1315,druid,restoration,54,25,29
Nizkul,dun-modr,1314,druid,restoration,164,81,83
Scra,anubarak,1314,druid,restoration,204,99,105
Schrödínger,culte-de-la-rive-noire,1314,druid,restoration,54,24,30
Delarion,nemesis,1312,druid,restoration,77,44,33
Leakybuttxx,kilrogg,1312,druid,restoration,28,15,13
Kladdkaka,earthen-ring,1312,druid,restoration,42,22,20
Kooglaash,kazzak,1311,druid,restoration,175,82,93
Torawara,ragnaros,1310,druid,restoration,29,16,13
Bhorumir,colinas-pardas,1310,druid,restoration,115,58,57
Wusor,blackhand,1309,druid,restoration,59,36,23
Noxlunaire,ravencrest,1309,druid,restoration,100,46,54
Yaaji,archimonde,1308,druid,restoration,152,72,80
Blacksagex,dragonmaw,1308,druid,restoration,47,15,32
Closér,stormscale,1307,druid,restoration,60,30,30
Disclaimed,twisting-nether,1307,druid,restoration,36,15,21
Scaleo,stormreaver,1306,druid,restoration,132,70,62
Ryletha,argent-dawn,1306,druid,restoration,183,92,91
Айшиш,gordunni,1306,druid,restoration,36,18,18
Devdude,blackrock,1306,druid,restoration,143,66,77
Cultivatedz,twisting-nether,1306,druid,restoration,54,24,30
Harei,archimonde,1305,druid,restoration,52,24,28
Feyzboom,ysondre,1304,druid,restoration,47,23,24
Mommymìlkers,archimonde,1302,druid,restoration,36,14,22
Boomayé,archimonde,1301,druid,restoration,56,34,22
Zeportheal,archimonde,1301,druid,restoration,50,26,24
Mindru,sylvanas,1301,druid,restoration,93,40,53
Bk,chamber-of-aspects,1300,druid,restoration,36,21,15
Roria,neptulon,1300,druid,restoration,54,31,23
ßløøm,outland,1300,druid,restoration,104,59,45
Bekkjin,todeswache,1300,druid,restoration,60,30,30
Løùise,nemesis,1300,druid,restoration,84,32,52
Sânká,ysondre,1299,druid,restoration,30,16,14
Килаф,gordunni,1299,druid,restoration,106,54,52
Tigroufou,kaelthas,1298,druid,restoration,24,15,9
Autoritär,gilneas,1298,druid,restoration,359,182,177
Entja,outland,1298,druid,restoration,61,26,35
Subslut,ravencrest,1296,druid,restoration,24,16,8
Тремакулан,gordunni,1296,druid,restoration,42,24,18
Maxekaxe,sylvanas,1296,druid,restoration,107,55,52
Memento,kazzak,1296,druid,restoration,48,24,24
Ekologiskxx,outland,1296,druid,restoration,85,40,45
Pølymorphe,ysondre,1296,druid,restoration,78,28,50
Cernacc,silvermoon,1295,druid,restoration,23,14,9
Wannabanhere,outland,1295,druid,restoration,41,16,25
Geeorge,stormscale,1294,druid,restoration,54,28,26
Delmond,sylvanas,1294,druid,restoration,296,150,146
Bronox,ragnaros,1294,druid,restoration,77,34,43
Atsumåsterx,archimonde,1294,druid,restoration,46,19,27
Benzimaax,ragnaros,1293,druid,restoration,72,36,36
Ningannel,argent-dawn,1293,druid,restoration,107,50,57
Hotsexpress,aegwynn,1293,druid,restoration,69,28,41
Ponytheone,burning-legion,1293,druid,restoration,54,21,33
Nøbødy,silvermoon,1292,druid,restoration,47,19,28
Papjin,blackhand,1291,druid,restoration,89,46,43
Weregoon,blackmoore,1291,druid,restoration,272,133,139
Elainia,emerald-dream,1291,druid,restoration,85,32,53
Sveoris,malganis,1290,druid,restoration,36,23,13
Eô,antonidas,1290,druid,restoration,81,42,39
Spacenoub,archimonde,1290,druid,restoration,48,24,24
Alberthotz,silvermoon,1290,druid,restoration,42,14,28
Flum,darksorrow,1289,druid,restoration,149,77,72
Тое,soulflayer,1289,druid,restoration,96,45,51
Jakeparkki,sylvanas,1289,druid,restoration,32,15,17
Midnightowl,stormscale,1287,druid,restoration,76,40,36
Eyetea,terokkar,1286,druid,restoration,121,64,57
Vurgyl,hyjal,1284,druid,restoration,139,83,56
Мехнакиске,howling-fjord,1284,druid,restoration,89,46,43
Kattig,grim-batol,1284,druid,restoration,44,21,23
Seikoo,defias-brotherhood,1284,druid,restoration,91,41,50
Berkalicious,frostmane,1283,druid,restoration,34,17,17
Yeats,blackmoore,1283,druid,restoration,48,20,28
Exoar,ravencrest,1282,druid,restoration,115,53,62
Lil,elune,1282,druid,restoration,55,22,33
Paawz,stormscale,1281,druid,restoration,65,33,32
Siako,sanguino,1281,druid,restoration,113,54,59
Vulcäin,ysondre,1281,druid,restoration,36,15,21
Manuka,argent-dawn,1280,druid,restoration,94,50,44
Урька,blackscar,1280,druid,restoration,93,43,50
Silvyan,silvermoon,1278,druid,restoration,75,37,38
Malbo,archimonde,1277,druid,restoration,64,26,38
Cubalitis,tarren-mill,1276,druid,restoration,39,24,15
Zaratras,arathor,1276,druid,restoration,79,39,40
Naturberserk,tarren-mill,1276,druid,restoration,75,36,39
Rrayed,kazzak,1274,druid,restoration,94,47,47
Yeroso,burning-legion,1273,druid,restoration,30,16,14
Yazari,nathrezim,1273,druid,restoration,72,35,37
Hotsy,ravencrest,1272,druid,restoration,20,14,6
Gyvunas,silvermoon,1272,druid,restoration,157,91,66
Trõn,draenor,1272,druid,restoration,164,95,69
Hordzee,blackmoore,1272,druid,restoration,286,140,146
Telaroxx,die-nachtwache,1272,druid,restoration,78,34,44
Desuslol,stormscale,1272,druid,restoration,65,28,37
Primdâhl,ravencrest,1271,druid,restoration,32,17,15
Neri,shattered-hand,1271,druid,restoration,73,37,36
Rêdx,archimonde,1271,druid,restoration,30,14,16
Випера,gordunni,1270,druid,restoration,60,32,28
Ischumekcid,anubarak,1270,druid,restoration,36,19,17
Bloomer,stormreaver,1268,druid,restoration,110,56,54
Paddyv,earthen-ring,1268,druid,restoration,33,16,17
Boxofdoom,twisting-nether,1268,druid,restoration,54,25,29
Ромамаваши,soulflayer,1267,druid,restoration,93,46,47
Walexx,kazzak,1266,druid,restoration,44,25,19
Nitro,kazzak,1266,druid,restoration,74,40,34
Кэлиборн,gordunni,1266,druid,restoration,65,33,32
Nalreaa,kazzak,1265,druid,restoration,48,27,21
Lalon,blackrock,1265,druid,restoration,48,24,24
Elainx,thrall,1264,druid,restoration,30,16,14
Badbeliø,hyjal,1264,druid,restoration,105,39,66
Дюссельдорф,blackscar,1263,druid,restoration,30,19,11
Sarkophag,blackrock,1263,druid,restoration,53,30,23
Blazoor,frostwolf,1262,druid,restoration,91,45,46
Дружез,soulflayer,1261,druid,restoration,58,32,26
Khalec,silvermoon,1261,druid,restoration,91,48,43
Обейрин,gordunni,1261,druid,restoration,78,40,38
Fåtå,archimonde,1261,druid,restoration,101,41,60
Svass,ragnaros,1260,druid,restoration,44,27,17
Lathariuss,frostwhisper,1260,druid,restoration,80,37,43
Mv,gorgonnash,1259,druid,restoration,136,69,67
Buitonix,khaz-modan,1258,druid,restoration,357,180,177
Høttýbálbøà,blackrock,1256,druid,restoration,17,14,3
Driftmaster,defias-brotherhood,1256,druid,restoration,36,17,19
Ubbeleg,kazzak,1255,druid,restoration,86,48,38
Karodoom,twisting-nether,1254,druid,restoration,86,44,42
Mexymeøw,ragnaros,1254,druid,restoration,141,70,71
Närthex,kazzak,1253,druid,restoration,24,14,10
Zelíx,bronzebeard,1253,druid,restoration,113,64,49
Jyggz,azshara,1253,druid,restoration,45,25,20
Cemiink,drakthul,1253,druid,restoration,169,89,80
Лилкрип,soulflayer,1253,druid,restoration,30,15,15
Karakarrtaal,silvermoon,1252,druid,restoration,42,26,16
Amberleaff,auchindoun,1252,druid,restoration,49,28,21
Yazzle,draenor,1252,druid,restoration,72,36,36
Avimoo,tarren-mill,1252,druid,restoration,56,27,29
Morfer,grim-batol,1250,druid,restoration,265,135,130
Shaize,dalaran,1248,druid,restoration,30,16,14
Monstret,dragonblight,1248,druid,restoration,113,53,60
Suunto,blackrock,1248,druid,restoration,48,21,27
Phatbushy,silvermoon,1248,druid,restoration,75,32,43
Hælìñgtøúçh,ysondre,1248,druid,restoration,42,14,28
Ownglow,sylvanas,1247,druid,restoration,18,13,5
Deltsur,stormscale,1247,druid,restoration,35,17,18
Racadruid,antonidas,1247,druid,restoration,66,31,35
Lucael,blackmoore,1247,druid,restoration,104,47,57
Jaesax,twisting-nether,1247,druid,restoration,30,13,17
Feralcompat,aszune,1247,druid,restoration,36,13,23
Djgírlßøssqt,argent-dawn,1246,druid,restoration,24,13,11
Norkenis,neptulon,1246,druid,restoration,55,25,30
Shegal,uldum,1246,druid,restoration,30,13,17
Gøpreña,silvermoon,1246,druid,restoration,30,13,17
Jenelin,silvermoon,1246,druid,restoration,42,16,26
Xomeboci,draenor,1246,druid,restoration,42,14,28
Catdoge,thrall,1244,druid,restoration,18,13,5
Feyzode,ysondre,1244,druid,restoration,24,13,11
Terenzlol,veklor,1243,druid,restoration,24,13,11
Varriant,kazzak,1243,druid,restoration,131,60,71
Дудумейстер,howling-fjord,1243,druid,restoration,221,101,120
Erdnuckèl,antonidas,1242,druid,restoration,33,21,12
Robutt,runetotem,1242,druid,restoration,40,25,15
Acwi,dun-morogh,1242,druid,restoration,90,46,44
Moundîr,archimonde,1242,druid,restoration,142,69,73
Autisticdog,aegwynn,1242,druid,restoration,30,13,17
Ghostpanther,outland,1241,druid,restoration,30,17,13
Гипертропик,gordunni,1241,druid,restoration,24,13,11
Theeix,silvermoon,1241,druid,restoration,202,99,103
Talyfox,outland,1241,druid,restoration,118,56,62
Dridoxx,archimonde,1241,druid,restoration,90,39,51
Merceý,ravencrest,1241,druid,restoration,34,14,20
Namenloser,azshara,1240,druid,restoration,99,55,44
Leliaen,sylvanas,1240,druid,restoration,135,68,67
Theguyandbea,draenor,1240,druid,restoration,266,128,138
Tosuncan,twisting-nether,1240,druid,restoration,54,24,30
Shapéshifter,argent-dawn,1240,druid,restoration,76,25,51
Jiujiteiro,tarren-mill,1239,druid,restoration,89,51,38
Hypnosoad,outland,1239,druid,restoration,413,208,205
Вертуос,soulflayer,1238,druid,restoration,93,47,46
Бульбион,gordunni,1238,druid,restoration,376,189,187
Громозилка,soulflayer,1238,druid,restoration,36,17,19
ßlackßåmßå,zuljin,1238,druid,restoration,53,24,29
Speegle,kazzak,1237,druid,restoration,24,13,11
Pròxy,hyjal,1237,druid,restoration,91,38,53
Arulol,aegwynn,1236,druid,restoration,102,48,54
Applestrudle,blackrock,1234,druid,restoration,24,15,9
Gotyoufam,tarren-mill,1234,druid,restoration,74,32,42
Инский,howling-fjord,1233,druid,restoration,120,66,54
Тырубльдуде,gordunni,1233,druid,restoration,96,45,51
Пивч,soulflayer,1232,druid,restoration,105,52,53
Shapeshiptur,argent-dawn,1232,druid,restoration,30,13,17
Arazorwyn,ravencrest,1231,druid,restoration,125,70,55
Ghostbustér,emeriss,1231,druid,restoration,323,171,152
Oltoker,korgall,1231,druid,restoration,228,111,117
Thatzdmg,blackmoore,1230,druid,restoration,24,13,11
Wazam,kazzak,1230,druid,restoration,202,101,101
Dreaddot,archimonde,1230,druid,restoration,30,15,15
Druiddingo,lightnings-blade,1230,druid,restoration,80,38,42
Weremyst,outland,1230,druid,restoration,44,15,29
Корнерит,gordunni,1229,druid,restoration,82,43,39
Nimbrestor,silvermoon,1229,druid,restoration,40,13,27
Octul,magtheridon,1228,druid,restoration,42,25,17
Saimdude,blackrock,1228,druid,restoration,66,38,28
Азазиона,gordunni,1227,druid,restoration,107,47,60
Rumbusxx,dun-modr,1227,druid,restoration,30,13,17
Pomjo,archimonde,1227,druid,restoration,36,13,23
Kirïllx,silvermoon,1226,druid,restoration,135,76,59
Venedría,eredar,1226,druid,restoration,54,29,25
Krizak,eredar,1226,druid,restoration,233,121,112
Vanlise,ravencrest,1226,druid,restoration,126,64,62
Thieane,blackhand,1226,druid,restoration,71,35,36
Reiss,tarren-mill,1226,druid,restoration,182,85,97
Solstrale,ravencrest,1226,druid,restoration,144,67,77
Урголяфа,gordunni,1226,druid,restoration,36,15,21
Dèxò,blackmoore,1225,druid,restoration,34,22,12
Gotika,blackrock,1225,druid,restoration,53,27,26
Spidete,sanguino,1224,druid,restoration,214,116,98
Драконы,blackscar,1224,druid,restoration,35,13,22
Drix,frostwolf,1223,druid,restoration,39,20,19
Tskilli,draenor,1223,druid,restoration,60,28,32
Dudupwwer,frostwolf,1223,druid,restoration,65,28,37
Heidepaa,tichondrius,1222,druid,restoration,36,18,18
Chiendetalus,ysondre,1221,druid,restoration,35,18,17
Chicobullz,ysondre,1220,druid,restoration,24,13,11
Randomhot,antonidas,1220,druid,restoration,91,39,52
Аммазония,gordunni,1219,druid,restoration,53,28,25
Xadidruîd,blackrock,1219,druid,restoration,72,26,46
Khyalia,ysondre,1218,druid,restoration,39,19,20
Halleyz,hyjal,1217,druid,restoration,150,79,71
Madshad,draenor,1217,druid,restoration,73,29,44
Charliebaum,antonidas,1216,druid,restoration,105,46,59
Mimisiek,burning-legion,1215,druid,restoration,48,27,21
ßïgßúll,twisting-nether,1215,druid,restoration,31,15,16
Horkz,frostmourne,1215,druid,restoration,40,19,21
Пупсики,gordunni,1215,druid,restoration,92,43,49
Tsuteymanga,veknilash,1214,druid,restoration,120,59,61
Maryz,varimathras,1214,druid,restoration,54,21,33
Kasjuz,tarren-mill,1212,druid,restoration,84,50,34
Rááy,blackrock,1212,druid,restoration,29,13,16
Hót,ravencrest,1212,druid,restoration,54,22,32
Knææl,argent-dawn,1211,druid,restoration,48,29,19
Herbiko,turalyon,1211,druid,restoration,387,198,189
Mochiløxz,tarren-mill,1211,druid,restoration,281,143,138
Дазашо,soulflayer,1211,druid,restoration,511,251,260
Кьюкамбер,gordunni,1210,druid,restoration,22,14,8
Ruberg,kazzak,1210,druid,restoration,51,26,25
Shylanna,ragnaros,1210,druid,restoration,114,55,59
Wyngx,blackrock,1209,druid,restoration,127,72,55
Séyla,blackrock,1209,druid,restoration,24,13,11
Unionpivo,doomhammer,1209,druid,restoration,126,64,62
Microw,ghostlands,1209,druid,restoration,141,69,72
Alenemor,frostmane,1209,druid,restoration,42,20,22
Weiden,twisting-nether,1209,druid,restoration,80,36,44
Tallu,das-konsortium,1209,druid,restoration,36,13,23
Imaginarý,ravencrest,1209,druid,restoration,45,13,32
Quiksx,blackrock,1208,druid,restoration,78,40,38
Chinoiserie,aszune,1208,druid,restoration,269,136,133
Nîppe,ravencrest,1208,druid,restoration,36,13,23
Ghaara,outland,1207,druid,restoration,58,32,26
Mutato,draenor,1207,druid,restoration,251,137,114
Midnightstry,alakir,1207,druid,restoration,345,179,166
Rakúsh,thrall,1207,druid,restoration,124,63,61
Bynxx,antonidas,1207,druid,restoration,208,103,105
Древнина,gordunni,1206,druid,restoration,258,134,124
Adiycrazy,outland,1206,druid,restoration,108,52,56
Kharora,hellfire,1206,druid,restoration,66,29,37
Ruhlide,anetheron,1206,druid,restoration,53,21,32
Soratess,azshara,1204,druid,restoration,81,38,43
Lethius,silvermoon,1204,druid,restoration,140,63,77
Shenandoah,hyjal,1203,druid,restoration,54,32,22
Farodiin,blackmoore,1203,druid,restoration,205,105,100
Эверих,soulflayer,1203,druid,restoration,71,34,37
Kunîbert,frostwolf,1203,druid,restoration,74,30,44
Tmsqediboo,silvermoon,1203,druid,restoration,36,13,23
Bonza,agamaggan,1202,druid,restoration,96,45,51
Jugaia,frostmourne,1202,druid,restoration,80,36,44
Ironveins,ravencrest,1201,druid,restoration,66,38,28
Glaskål,draenor,1201,druid,restoration,218,97,121
Berdix,ragnaros,1200,druid,restoration,67,35,32
Meall,blackmoore,1199,druid,restoration,30,20,10
Drøod,kazzak,1199,druid,restoration,23,15,8
Goodzychoo,silvermoon,1199,druid,restoration,36,17,19
Behemothe,dalaran,1198,druid,restoration,24,13,11
Paranoido,eredar,1198,druid,restoration,94,36,58
Karlsn,ravencrest,1197,druid,restoration,25,14,11
Lïs,the-maelstrom,1197,druid,restoration,137,75,62
Ballosh,hyjal,1197,druid,restoration,36,15,21
Julianbgnoir,archimonde,1196,druid,restoration,49,23,26
Ensanglante,twisting-nether,1196,druid,restoration,81,38,43
Vertymbras,hyjal,1195,druid,restoration,134,73,61
Shadraw,arakarahm,1195,druid,restoration,30,13,17
Släshes,stormreaver,1195,druid,restoration,50,21,29
Røxána,thunderhorn,1193,druid,restoration,18,13,5
Néilié,tarren-mill,1193,druid,restoration,49,27,22
Tsurío,thrall,1193,druid,restoration,144,78,66
Tadag,defias-brotherhood,1193,druid,restoration,63,30,33
Kattman,tarren-mill,1191,druid,restoration,42,21,21
Raïby,archimonde,1191,druid,restoration,36,15,21
Wtfck,outland,1190,druid,restoration,114,53,61
Коляскальяс,howling-fjord,1190,druid,restoration,154,63,91
Flomaster,stormscale,1190,druid,restoration,36,13,23
Tarîx,aegwynn,1188,druid,restoration,48,29,19
Друоид,howling-fjord,1188,druid,restoration,57,26,31
Zwareshag,ravencrest,1188,druid,restoration,56,24,32
Silverdice,thrall,1187,druid,restoration,30,16,14
Fotmrerollér,darksorrow,1187,druid,restoration,164,87,77
Chable,hyjal,1187,druid,restoration,60,31,29
Chæmp,blackmoore,1187,druid,restoration,35,16,19
Proxis,the-maelstrom,1187,druid,restoration,73,31,42
Elysiá,twisting-nether,1187,druid,restoration,41,16,25
Vícvega,ravencrest,1186,druid,restoration,100,51,49
Lépaw,twisting-nether,1186,druid,restoration,107,51,56
Wiyah,hyjal,1186,druid,restoration,30,14,16
Yamsha,dalaran,1186,druid,restoration,46,14,32
Fettpumpad,karazhan,1185,druid,restoration,157,85,72
Meatboi,burning-legion,1185,druid,restoration,54,28,26
Docdruid,outland,1185,druid,restoration,66,24,42
Archbloom,twisting-nether,1185,druid,restoration,42,13,29
Spacebéam,ravencrest,1184,druid,restoration,111,50,61
Quorn,pozzo-delleternità,1184,druid,restoration,42,18,24
Amakary,blackrock,1183,druid,restoration,78,37,41
Happyhoter,blackrock,1183,druid,restoration,54,24,30
Exane,ragnaros,1182,druid,restoration,44,26,18
Qvadriologic,argent-dawn,1182,druid,restoration,48,20,28
Skuhlxz,thrall,1182,druid,restoration,60,18,42
Fuzzy,the-venture-co,1181,druid,restoration,71,26,45
Benfufu,kazzak,1180,druid,restoration,37,20,17
Scotchnsoda,twisting-nether,1180,druid,restoration,35,17,18
Secondage,blackmoore,1180,druid,restoration,98,45,53
Irrlycht,blackrock,1179,druid,restoration,42,16,26
Cäsïo,khaz-modan,1178,druid,restoration,92,53,39
Spankproof,kazzak,1178,druid,restoration,32,18,14
Lisovamavka,draenor,1177,druid,restoration,169,87,82
Gargara,sanguino,1177,druid,restoration,35,13,22
Forestranger,outland,1176,druid,restoration,24,13,11
Shawtyx,argent-dawn,1176,druid,restoration,104,42,62
Hílarío,sanguino,1174,druid,restoration,38,13,25
Mirana,drakthul,1173,druid,restoration,75,44,31
Dreäms,ravencrest,1173,druid,restoration,326,170,156
Noballz,blackhand,1173,druid,restoration,38,13,25
Skeexd,argent-dawn,1172,druid,restoration,130,55,75
Irondruid,silvermoon,1170,druid,restoration,253,129,124
Ðelnôs,destromath,1170,druid,restoration,84,39,45
Testoration,twisting-nether,1170,druid,restoration,36,13,23
Bonsai,terrordar,1169,druid,restoration,55,25,30
Dobbmaster,aegwynn,1168,druid,restoration,256,128,128
Simplydrood,archimonde,1168,druid,restoration,57,20,37
Mitnik,stormscale,1167,druid,restoration,192,103,89
Xdrus,argent-dawn,1167,druid,restoration,98,50,48
Balanc,ragnaros,1167,druid,restoration,53,25,28
Rippertimmie,draenor,1166,druid,restoration,53,25,28
Collîî,aegwynn,1165,druid,restoration,98,50,48
Ridania,ravenholdt,1165,druid,restoration,78,28,50
Денчикбратиш,soulflayer,1165,druid,restoration,54,19,35
Bbc,elune,1164,druid,restoration,88,51,37
Callìa,sylvanas,1163,druid,restoration,142,66,76
Huayhey,the-maelstrom,1162,druid,restoration,82,45,37
Forzend,twisting-nether,1161,druid,restoration,20,13,7
Димитруа,howling-fjord,1161,druid,restoration,30,17,13
Фотинайдер,blackscar,1161,druid,restoration,48,23,25
Shifts,aggramar,1161,druid,restoration,60,27,33
Hallibell,frostmane,1160,druid,restoration,30,13,17
Daarty,tarren-mill,1159,druid,restoration,36,14,22
Crep,krasus,1158,druid,restoration,83,44,39
Жолудь,gordunni,1158,druid,restoration,211,105,106
Makelsi,tarren-mill,1158,druid,restoration,36,15,21
Juicy,stormreaver,1157,druid,restoration,97,49,48
Sÿlph,sylvanas,1157,druid,restoration,143,70,73
Plethi,antonidas,1156,druid,restoration,48,19,29
Zêrg,ysondre,1155,druid,restoration,48,21,27
Corias,blackmoore,1154,druid,restoration,42,14,28
Márron,blackhand,1153,druid,restoration,28,15,13
Rìften,stormscale,1153,druid,restoration,42,16,26
Luuxiå,archimonde,1152,druid,restoration,18,12,6
Nivcat,kazzak,1152,druid,restoration,24,12,12
Sllatkica,draenor,1152,druid,restoration,63,27,36
Pikkusuhnu,twisting-nether,1152,druid,restoration,30,12,18
Ÿdrassia,archimonde,1152,druid,restoration,44,17,27
Gøash,aegwynn,1151,druid,restoration,18,12,6
Sturehoof,ravencrest,1151,druid,restoration,18,12,6
Ковамедведь,borean-tundra,1151,druid,restoration,65,27,38
Hotop,draenor,1151,druid,restoration,30,12,18
Rozt,ravencrest,1150,druid,restoration,24,12,12
Dreathqt,twisting-nether,1150,druid,restoration,24,12,12
Chocofrijj,tarren-mill,1150,druid,restoration,30,12,18
Rufío,ravencrest,1150,druid,restoration,67,24,43
Ушастикэ,gordunni,1149,druid,restoration,84,53,31
Fricky,burning-blade,1149,druid,restoration,94,51,43
Flensí,stormscale,1149,druid,restoration,30,12,18
Eñzo,stormscale,1149,druid,restoration,30,12,18
Druidtar,burning-steppes,1148,druid,restoration,24,12,12
Vioboomie,blackrock,1148,druid,restoration,36,17,19
Burattino,draenor,1147,druid,restoration,12,12,0
Restopesto,silvermoon,1147,druid,restoration,44,24,20
Pzyhlol,anetheron,1147,druid,restoration,51,26,25
Haarbál,tarren-mill,1147,druid,restoration,30,15,15
Reâlity,todeswache,1147,druid,restoration,30,13,17
Dudujoker,aggra-português,1147,druid,restoration,39,13,26
Eluñeãdore,silvermoon,1146,druid,restoration,41,26,15
Mykk,ravencrest,1146,druid,restoration,33,19,14
Gladiata,tarren-mill,1146,druid,restoration,30,12,18
Ankhar,auchindoun,1145,druid,restoration,35,17,18
Djungelgrabb,twisting-nether,1144,druid,restoration,93,47,46
Mikshak,drakthul,1144,druid,restoration,24,12,12
Vaacku,stormreaver,1144,druid,restoration,24,12,12
Golddy,hyjal,1144,druid,restoration,140,66,74
Shapeshafter,twisting-nether,1144,druid,restoration,179,84,95
Enzymex,burning-blade,1144,druid,restoration,42,19,23
Holybarkzqt,aegwynn,1144,druid,restoration,30,12,18
Knocowt,ragnaros,1143,druid,restoration,45,18,27
Mcneil,wrathbringer,1142,druid,restoration,49,26,23
Ayehotx,ragnaros,1142,druid,restoration,89,43,46
Amoreah,silvermoon,1142,druid,restoration,148,61,87
Trànsformer,nemesis,1142,druid,restoration,30,12,18
Elleanarr,hyjal,1141,druid,restoration,94,52,42
Zikloe,arathor,1141,druid,restoration,24,12,12
Eithnne,ravencrest,1141,druid,restoration,27,13,14
Clownrad,tarren-mill,1141,druid,restoration,30,12,18
Ajwen,tarren-mill,1141,druid,restoration,30,12,18
Mayte,ragnaros,1140,druid,restoration,44,26,18
Pwníca,aegwynn,1140,druid,restoration,30,12,18
Relxc,outland,1139,druid,restoration,39,24,15
Baineaordur,krasus,1139,druid,restoration,54,27,27
Сваткумбрат,eversong,1139,druid,restoration,161,69,92
Fluffypaws,auchindoun,1138,druid,restoration,77,39,38
Шинедрелл,gordunni,1138,druid,restoration,48,16,32
Vickepicke,stormreaver,1137,druid,restoration,104,42,62
Fanboij,kazzak,1137,druid,restoration,30,12,18
Røsary,stormscale,1136,druid,restoration,99,51,48
Фонш,soulflayer,1136,druid,restoration,24,12,12
Symba,uldum,1136,druid,restoration,24,12,12
Hristiana,outland,1135,druid,restoration,24,12,12
Csmeferal,blackrock,1134,druid,restoration,35,22,13
Ankhenature,outland,1132,druid,restoration,106,60,46
Catbear,kazzak,1132,druid,restoration,402,209,193
Ymgrawl,zuljin,1132,druid,restoration,42,18,24
Luneriá,blackmoore,1132,druid,restoration,48,16,32
Oushen,silvermoon,1131,druid,restoration,58,23,35
Scuta,sylvanas,1131,druid,restoration,36,12,24
Bioházard,blackrock,1130,druid,restoration,36,20,16
Feroxe,kazzak,1130,druid,restoration,24,12,12
Clonecity,ravencrest,1130,druid,restoration,35,12,23
Thunderzeus,mazrigos,1129,druid,restoration,40,20,20
Mushröøms,nemesis,1128,druid,restoration,18,16,2
Imoen,hyjal,1128,druid,restoration,132,59,73
Pinkpanda,arthas,1128,druid,restoration,30,12,18
Sâty,draenor,1128,druid,restoration,60,22,38
Стенлимур,eversong,1127,druid,restoration,120,57,63
Lailaqt,arthas,1127,druid,restoration,87,41,46
Druibe,burning-legion,1127,druid,restoration,56,23,33
Kelbim,draenor,1126,druid,restoration,107,49,58
Kbåkå,ravencrest,1125,druid,restoration,42,19,23
Helpwss,outland,1125,druid,restoration,30,12,18
Sorahe,arthas,1124,druid,restoration,32,17,15
Сицилиец,galakrond,1124,druid,restoration,24,12,12
Valoryon,outland,1124,druid,restoration,24,12,12
Vâkkrï,archimonde,1124,druid,restoration,54,16,38
Ilovealex,blackmoore,1123,druid,restoration,119,64,55
Ceapamatii,sylvanas,1123,druid,restoration,100,47,53
Enggetsu,drakthul,1123,druid,restoration,90,40,50
Curoahojas,silvermoon,1123,druid,restoration,135,58,77
Yngboii,twisting-nether,1123,druid,restoration,30,12,18
Betelgues,kazzak,1122,druid,restoration,183,98,85
Papanik,tarren-mill,1122,druid,restoration,140,70,70
Orten,dun-modr,1122,druid,restoration,114,53,61
Dancingrain,ravencrest,1122,druid,restoration,30,13,17
Vextron,burning-legion,1121,druid,restoration,64,35,29
Акетчи,howling-fjord,1120,druid,restoration,26,14,12
Vranz,draenor,1120,druid,restoration,67,32,35
Psitol,silvermoon,1120,druid,restoration,30,12,18
Nightshíft,onyxia,1120,druid,restoration,58,18,40
Flintý,ravencrest,1119,druid,restoration,16,13,3
Kobrá,ravencrest,1119,druid,restoration,20,13,7
Raysa,archimonde,1119,druid,restoration,69,35,34
Лайфдруид,blackscar,1119,druid,restoration,95,40,55
Kkriss,stormscale,1118,druid,restoration,81,46,35
Thaibarian,shattered-hand,1118,druid,restoration,99,52,47
Flandersdru,ravencrest,1117,druid,restoration,23,12,11
Kikinho,argent-dawn,1117,druid,restoration,24,12,12
Whiskers,emerald-dream,1117,druid,restoration,66,27,39
Хрик,howling-fjord,1116,druid,restoration,56,28,28
Zillo,stormscale,1116,druid,restoration,92,41,51
Bubadruid,silvermoon,1116,druid,restoration,37,14,23
Mchøt,ravencrest,1115,druid,restoration,74,28,46
Celendiil,argent-dawn,1115,druid,restoration,103,30,73
Brooklynzoo,ravencrest,1114,druid,restoration,22,13,9
Багетлюбви,howling-fjord,1114,druid,restoration,86,37,49
Cigamt,kazzak,1113,druid,restoration,27,16,11
Ndnd,drakthul,1112,druid,restoration,82,42,40
Лаегмерил,gordunni,1111,druid,restoration,64,35,29
Rootmoschner,blackmoore,1111,druid,restoration,167,81,86
Mayhh,ragnaros,1111,druid,restoration,90,41,49
Legharta,ravencrest,1111,druid,restoration,84,31,53
Deboiteurr,archimonde,1111,druid,restoration,42,15,27
Ðrake,eredar,1110,druid,restoration,48,23,25
Uvøgin,ragnaros,1109,druid,restoration,18,12,6
Räysa,archimonde,1108,druid,restoration,216,107,109
Iprex,outland,1106,druid,restoration,233,124,109
Arfedan,kazzak,1106,druid,restoration,66,35,31
Klerosa,moonglade,1105,druid,restoration,56,24,32
Tyraloll,ghostlands,1104,druid,restoration,54,23,31
Thornstar,sylvanas,1103,druid,restoration,90,45,45
Аматэррасу,blackscar,1102,druid,restoration,66,34,32
Phandris,argent-dawn,1101,druid,restoration,57,34,23
Arear,frostmane,1098,druid,restoration,109,47,62
Croassant,archimonde,1097,druid,restoration,44,24,20
Xenva,blackmoore,1097,druid,restoration,66,32,34
Surinox,blackrock,1096,druid,restoration,75,44,31
Wolfeiy,ravenholdt,1096,druid,restoration,175,99,76
Leafy,sanguino,1096,druid,restoration,132,71,61
Hotmenow,antonidas,1095,druid,restoration,17,12,5
Chidorî,twisting-nether,1095,druid,restoration,41,18,23
Snowrk,hyjal,1093,druid,restoration,54,31,23
Nissemand,ravencrest,1093,druid,restoration,90,42,48
Åfk,ravencrest,1093,druid,restoration,35,14,21
Tharandrél,argent-dawn,1092,druid,restoration,72,20,52
Тианна,razuvious,1091,druid,restoration,48,24,24
Auspicer,moonglade,1090,druid,restoration,58,29,29
Ultrassick,kazzak,1090,druid,restoration,45,21,24
Hotouck,hyjal,1089,druid,restoration,38,22,16
Simouch,archimonde,1089,druid,restoration,381,194,187
Wrak,eonar,1089,druid,restoration,24,12,12
Дремлин,deathguard,1089,druid,restoration,230,110,120
Triskelion,burning-legion,1089,druid,restoration,28,13,15
Zagrem,antonidas,1088,druid,restoration,28,13,15
Ganoförd,zuljin,1087,druid,restoration,19,13,6
Worxor,hyjal,1087,druid,restoration,24,14,10
Petitchät,archimonde,1087,druid,restoration,64,33,31
Taatz,stormscale,1087,druid,restoration,85,33,52
Neyribi,blackhand,1087,druid,restoration,47,13,34
Relache,twisting-nether,1085,druid,restoration,81,42,39
Alexstraza,arthas,1085,druid,restoration,49,23,26
Escortdruid,blackmoore,1085,druid,restoration,94,40,54
Жекабиг,soulflayer,1084,druid,restoration,103,54,49
Draneis,les-sentinelles,1083,druid,restoration,117,69,48
Фераст,azuregos,1083,druid,restoration,48,21,27
Lutzmiller,eredar,1082,druid,restoration,456,225,231
Nyooxix,blackmoore,1082,druid,restoration,54,22,32
Sainthree,dalaran,1080,druid,restoration,36,15,21
Jimmorris,eredar,1079,druid,restoration,60,30,30
Làzerðjings,archimonde,1079,druid,restoration,30,12,18
Jøos,hyjal,1078,druid,restoration,24,12,12
Theridrax,twisting-nether,1078,druid,restoration,38,18,20
Thaldrenaar,argent-dawn,1078,druid,restoration,74,28,46
Gibx,ravencrest,1077,druid,restoration,62,33,29
Trikill,hyjal,1077,druid,restoration,102,51,51
Razmus,lightbringer,1076,druid,restoration,25,13,12
Zarlaac,ravencrest,1075,druid,restoration,84,36,48
Tenbe,outland,1074,druid,restoration,24,12,12
Bigbones,frostwolf,1074,druid,restoration,102,39,63
Bloomly,tarren-mill,1073,druid,restoration,36,18,18
Shäylä,sinstralis,1072,druid,restoration,30,15,15
Jàgêr,archimonde,1071,druid,restoration,43,12,31
Алунар,lich-king,1070,druid,restoration,84,39,45
Nyctala,argent-dawn,1069,druid,restoration,43,16,27
Kotkacy,silvermoon,1067,druid,restoration,22,12,10
Kelerun,blackhand,1067,druid,restoration,54,26,28
Domsz,dalaran,1067,druid,restoration,134,63,71
Zirkuszwei,aegwynn,1066,druid,restoration,107,51,56
Januzo,kazzak,1066,druid,restoration,42,16,26
Elanrya,argent-dawn,1066,druid,restoration,53,15,38
Néxct,stormscale,1065,druid,restoration,42,16,26
Nezruslfour,dun-modr,1064,druid,restoration,54,33,21
Киберужас,gordunni,1064,druid,restoration,175,90,85
Шмору,deathguard,1063,druid,restoration,76,38,38
Medvecica,twisting-nether,1062,druid,restoration,74,25,49
Îcetiger,elune,1061,druid,restoration,52,23,29
Inspiredrood,archimonde,1060,druid,restoration,195,104,91
Jambonmaster,archimonde,1060,druid,restoration,118,62,56
Maryjuanita,silvermoon,1060,druid,restoration,170,74,96
Qabusnama,nemesis,1058,druid,restoration,36,20,16
Кишкинахир,razuvious,1058,druid,restoration,66,33,33
Nrathal,doomhammer,1058,druid,restoration,54,18,36
Ölwen,sanguino,1058,druid,restoration,42,14,28
Aliani,trollbane,1058,druid,restoration,50,16,34
Syre,pozzo-delleternità,1057,druid,restoration,18,12,6
Greenhot,kult-der-verdammten,1057,druid,restoration,72,33,39
Ферний,gordunni,1057,druid,restoration,30,13,17
Justforgames,ravencrest,1056,druid,restoration,12,11,1
Degentiuso,alakir,1056,druid,restoration,30,21,9
Målukah,archimonde,1056,druid,restoration,18,11,7
Noramun,alexstrasza,1056,druid,restoration,18,11,7
Jagu,blackrock,1056,druid,restoration,49,27,22
Poporseven,archimonde,1055,druid,restoration,24,11,13
Арбузир,howling-fjord,1055,druid,restoration,54,21,33
Sharlla,burning-legion,1055,druid,restoration,36,11,25
Oschlandor,blackmoore,1054,druid,restoration,12,11,1
Светдру,blackscar,1054,druid,restoration,24,11,13
Huebbi,blackmoore,1054,druid,restoration,24,11,13
Tormentedlol,outland,1054,druid,restoration,24,11,13
Nariune,argent-dawn,1054,druid,restoration,53,23,30
Lïlja,tarren-mill,1053,druid,restoration,30,16,14
Liquis,outland,1053,druid,restoration,224,111,113
Skysrex,outland,1053,druid,restoration,24,11,13
Noskillx,auchindoun,1052,druid,restoration,12,11,1
Inet,aegwynn,1052,druid,restoration,54,25,29
Meowu,twisting-nether,1052,druid,restoration,24,11,13
Boomkïn,draenor,1052,druid,restoration,24,11,13
Luckyhell,silvermoon,1052,druid,restoration,42,18,24
Ømégäìnfëctz,argent-dawn,1052,druid,restoration,30,11,19
Eriaeda,stormscale,1051,druid,restoration,30,12,18
Higuys,the-maelstrom,1051,druid,restoration,30,11,19
Иксджа,gordunni,1051,druid,restoration,30,11,19
Hâyâbusa,antonidas,1051,druid,restoration,36,12,24
Druidenbeton,antonidas,1050,druid,restoration,24,13,11
Panøràmix,archimonde,1050,druid,restoration,41,12,29
Malleria,blackmoore,1049,druid,restoration,54,26,28
Zka,archimonde,1049,druid,restoration,24,11,13
Duduque,twisting-nether,1049,druid,restoration,68,27,41
Влажныйдру,soulflayer,1048,druid,restoration,24,11,13
Milkyheals,burning-blade,1048,druid,restoration,24,11,13
Tapex,ravencrest,1048,druid,restoration,27,12,15
Ihone,frostmane,1048,druid,restoration,32,12,20
Belucky,outland,1047,druid,restoration,34,13,21
Toacon,destromath,1047,druid,restoration,30,11,19
Borne,aggra-português,1046,druid,restoration,30,13,17
Strave,azjolnerub,1046,druid,restoration,126,48,78
Zappydudu,tarren-mill,1045,druid,restoration,18,11,7
Blòódý,ravencrest,1045,druid,restoration,25,13,12
Adawehi,ravencrest,1045,druid,restoration,236,114,122
Kamikazedk,frostmane,1045,druid,restoration,24,11,13
Santamonica,blackrock,1045,druid,restoration,48,19,29
Growiêlle,ravencrest,1044,druid,restoration,71,37,34
Shipmaster,ravencrest,1044,druid,restoration,38,16,22
Kaserion,sylvanas,1044,druid,restoration,72,26,46
Ella,kult-der-verdammten,1043,druid,restoration,311,156,155
Омгдру,gordunni,1043,druid,restoration,147,70,77
Tealy,turalyon,1043,druid,restoration,49,19,30
Baroona,kazzak,1042,druid,restoration,72,42,30
Orangee,blackmoore,1042,druid,restoration,150,67,83
Luarbak,kazzak,1041,druid,restoration,18,11,7
Walenok,thrall,1041,druid,restoration,298,146,152
Блэкфорест,gordunni,1041,druid,restoration,107,49,58
Spoco,defias-brotherhood,1040,druid,restoration,102,56,46
Ранок,fordragon,1040,druid,restoration,24,11,13
Dfjguidfg,baelgun,1040,druid,restoration,36,13,23
Tângo,eredar,1039,druid,restoration,55,28,27
Daleen,silvermoon,1038,druid,restoration,24,11,13
Берды,gordunni,1038,druid,restoration,24,11,13
Arenus,argent-dawn,1038,druid,restoration,74,31,43
Хаширожизни,gordunni,1038,druid,restoration,36,11,25
Хикобай,gordunni,1036,druid,restoration,63,29,34
Greyhøund,archimonde,1036,druid,restoration,83,35,48
Kezbaniye,silvermoon,1035,druid,restoration,18,11,7
Sfarcolacul,tarren-mill,1034,druid,restoration,193,103,90
Pakù,archimonde,1033,druid,restoration,12,11,1
Jølinaar,twisting-nether,1033,druid,restoration,104,49,55
Nortii,drakthul,1033,druid,restoration,30,12,18
Scopar,aegwynn,1033,druid,restoration,42,11,31
Avadakodavra,ravencrest,1032,druid,restoration,159,75,84
Cárnagè,stormscale,1032,druid,restoration,98,44,54
Socialphobia,draenor,1032,druid,restoration,46,18,28
Feraly,zenedar,1032,druid,restoration,30,11,19
Ilovejager,archimonde,1032,druid,restoration,38,12,26
Murmétoile,chants-éternels,1031,druid,restoration,104,36,68
Прожималодру,deathguard,1030,druid,restoration,102,48,54
Dadud,twisting-nether,1029,druid,restoration,60,29,31
Mendozä,stormscale,1029,druid,restoration,82,38,44
Corrupthz,outland,1028,druid,restoration,24,11,13
Storpboom,drakthul,1028,druid,restoration,31,13,18
Greenthûmbs,sylvanas,1027,druid,restoration,24,11,13
Drúídárn,talnivarr,1027,druid,restoration,60,27,33
Klørfem,draenor,1027,druid,restoration,36,13,23
Driiptoohard,turalyon,1026,druid,restoration,201,102,99
Davincidru,tarren-mill,1026,druid,restoration,68,32,36
Muffinjump,outland,1026,druid,restoration,30,11,19
Pelacanyes,dun-modr,1025,druid,restoration,24,11,13
Holykòw,silvermoon,1025,druid,restoration,66,30,36
Gribix,kazzak,1024,druid,restoration,30,15,15
Ванилане,ashenvale,1023,druid,restoration,116,54,62
Luaavin,madmortem,1022,druid,restoration,34,17,17
Ximenia,argent-dawn,1022,druid,restoration,30,15,15
Takuna,nemesis,1022,druid,restoration,30,12,18
Tetödrea,dun-modr,1022,druid,restoration,30,12,18
Æøøm,blackmoore,1021,druid,restoration,18,11,7
Raysien,doomhammer,1021,druid,restoration,24,13,11
Moonshîne,arygos,1021,druid,restoration,120,63,57
Shanikya,argent-dawn,1021,druid,restoration,44,20,24
Elrroir,dun-modr,1021,druid,restoration,34,12,22
Catwalk,azshara,1020,druid,restoration,42,11,31
Nøboorst,ravencrest,1019,druid,restoration,18,11,7
Celegorn,burning-legion,1019,druid,restoration,18,11,7
Yøunsa,medivh,1019,druid,restoration,54,29,25
Xlife,silvermoon,1018,druid,restoration,162,72,90
Slashndasher,frostmane,1017,druid,restoration,24,17,7
Эмканегодяйк,galakrond,1016,druid,restoration,95,50,45
Fawna,kazzak,1016,druid,restoration,42,14,28
Artracos,thrall,1016,druid,restoration,65,18,47
Hyperunknown,grim-batol,1014,druid,restoration,114,56,58
Tsihsel,ravencrest,1014,druid,restoration,24,11,13
Trolléverte,archimonde,1012,druid,restoration,141,69,72
Nyha,garrosh,1012,druid,restoration,48,15,33
Komiker,ravencrest,1011,druid,restoration,47,29,18
Dirtyhacks,blackmoore,1010,druid,restoration,36,17,19
Дендринис,gordunni,1009,druid,restoration,30,19,11
Mirreska,silvermoon,1009,druid,restoration,239,109,130
Ukri,ravencrest,1008,druid,restoration,22,11,11
Chéchédroïd,marécage-de-zangar,1008,druid,restoration,82,38,44
Pitsas,silvermoon,1007,druid,restoration,473,234,239
Crocobango,draenor,1007,druid,restoration,105,40,65
Felfran,ravencrest,1005,druid,restoration,72,29,43
Lynare,argent-dawn,1005,druid,restoration,30,12,18
Nightfáll,tarren-mill,1005,druid,restoration,70,25,45
Akindudu,twisting-nether,1003,druid,restoration,21,11,10
Магараганага,azuregos,1003,druid,restoration,37,16,21
Feedbark,stormscale,1002,druid,restoration,23,13,10
Do,alakir,1002,druid,restoration,80,42,38
Dahelire,shendralar,1002,druid,restoration,60,30,30
Noxann,archimonde,1001,druid,restoration,34,12,22
Hopê,burning-legion,1000,druid,restoration,138,76,62
Витшел,gordunni,999,druid,restoration,24,14,10
Drooed,jaedenar,997,druid,restoration,24,14,10
Creadora,ravencrest,996,druid,restoration,48,17,31
Mjutun,outland,995,druid,restoration,26,12,14
Iseron,uldum,993,druid,restoration,58,32,26
Gnaro,ragnaros,992,druid,restoration,142,61,81
Malandrin,khazgoroth,990,druid,restoration,103,46,57
Kirkey,terokkar,989,druid,restoration,118,60,58
Uwina,silvermoon,988,druid,restoration,30,16,14
Menolao,dun-morogh,988,druid,restoration,140,71,69
Nokodo,silvermoon,988,druid,restoration,39,19,20
Ревёрсс,soulflayer,988,druid,restoration,60,19,41
Sooamazing,korgall,987,druid,restoration,27,15,12
Moonfan,darkmoon-faire,986,druid,restoration,48,17,31
Zalherbata,burning-legion,986,druid,restoration,42,13,29
Snakemane,tarren-mill,985,druid,restoration,71,37,34
Yespapa,kazzak,985,druid,restoration,273,140,133
Spikill,uldaman,984,druid,restoration,40,26,14
Wolfverina,sylvanas,984,druid,restoration,87,47,40
Rbosse,aszune,983,druid,restoration,20,11,9
Leafy,twisting-nether,982,druid,restoration,52,16,36
Тевио,gordunni,981,druid,restoration,195,88,107
Madschinken,malganis,980,druid,restoration,118,45,73
Ковролин,gordunni,979,druid,restoration,37,14,23
Bartoluca,twisting-nether,979,druid,restoration,58,13,45
Maiavin,earthen-ring,978,druid,restoration,15,12,3
Ellismera,argent-dawn,978,druid,restoration,36,17,19
Kannzi,draenor,978,druid,restoration,36,16,20
Raylla,dun-modr,976,druid,restoration,36,19,17
Johndru,kazzak,976,druid,restoration,113,48,65
Aègon,ravencrest,975,druid,restoration,30,13,17
Arydan,quelthalas,974,druid,restoration,28,11,17
Амильфийка,blackscar,973,druid,restoration,27,13,14
Khânz,twisting-nether,973,druid,restoration,46,11,35
Sinthorasia,blackrock,972,druid,restoration,28,12,16
Macanbre,tarren-mill,971,druid,restoration,126,65,61
Tombenuit,tarren-mill,970,druid,restoration,30,15,15
Garzok,rashgarroth,970,druid,restoration,33,12,21
Roséa,ravencrest,969,druid,restoration,46,20,26
Zalmoxiss,ravencrest,968,druid,restoration,60,34,26
Lùmy,arygos,967,druid,restoration,42,18,24
Benjosef,blackmoore,966,druid,restoration,110,53,57
Nermax,kazzak,966,druid,restoration,30,14,16
Альбигоиц,thermaplugg,966,druid,restoration,40,17,23
Bleythia,silvermoon,966,druid,restoration,58,20,38
Nali,arthas,965,druid,restoration,55,31,24
Jehtrotull,nemesis,965,druid,restoration,46,18,28
Флиперкэт,howling-fjord,965,druid,restoration,98,38,60
Zerschmatzen,aegwynn,965,druid,restoration,75,23,52
Naturaliista,burning-legion,963,druid,restoration,64,25,39
Wegian,sylvanas,962,druid,restoration,63,36,27
Krollix,dun-morogh,962,druid,restoration,70,38,32
Alirynn,argent-dawn,962,druid,restoration,66,35,31
Blolzz,silvermoon,962,druid,restoration,48,25,23
Hushorde,twisting-nether,962,druid,restoration,120,55,65
Teranaattori,the-maelstrom,962,druid,restoration,47,14,33
Karochi,kazzak,961,druid,restoration,28,17,11
Bntyx,dun-modr,960,druid,restoration,18,10,8
Eviency,outland,960,druid,restoration,24,10,14
Bll,defias-brotherhood,959,druid,restoration,18,10,8
Dørckness,ravencrest,959,druid,restoration,18,10,8
Mysao,dalaran,959,druid,restoration,18,10,8
Sakkosækk,ravencrest,959,druid,restoration,18,10,8
Snedden,silvermoon,959,druid,restoration,30,15,15
Nýxta,kazzak,959,druid,restoration,36,15,21
Juhudy,kazzak,959,druid,restoration,24,10,14
Bäckey,silvermoon,958,druid,restoration,12,10,2
Yodox,kazzak,958,druid,restoration,36,22,14
Mancy,silvermoon,958,druid,restoration,18,10,8
Demncow,twisting-nether,958,druid,restoration,18,10,8
Rînaa,ravencrest,958,druid,restoration,18,10,8
Дела,eversong,958,druid,restoration,74,40,34
Bazilika,argent-dawn,958,druid,restoration,161,82,79
Djalexdruid,kazzak,958,druid,restoration,24,10,14
Vacaleiteira,aggra-português,958,druid,restoration,24,10,14
Krattos,outland,958,druid,restoration,24,10,14
Soraiyaqt,blackhand,958,druid,restoration,24,10,14
Iqfrags,silvermoon,957,druid,restoration,27,18,9
Shaorma,ravencrest,957,druid,restoration,42,25,17
Taylegøðx,ravencrest,957,druid,restoration,18,10,8
Cobradrood,culte-de-la-rive-noire,957,druid,restoration,91,42,49
Brindefolie,archimonde,957,druid,restoration,24,10,14
Takar,dalaran,957,druid,restoration,54,19,35
Catkayn,stormscale,957,druid,restoration,107,36,71
Testmah,silvermoon,956,druid,restoration,108,31,77
Bug,eredar,955,druid,restoration,39,21,18
Patrík,twisting-nether,955,druid,restoration,30,10,20
Lzo,silvermoon,954,druid,restoration,18,10,8
Featherball,tarren-mill,953,druid,restoration,48,27,21
Allod,stormscale,953,druid,restoration,267,136,131
Wizår,outland,952,druid,restoration,24,10,14
Энчантерес,gordunni,952,druid,restoration,30,10,20
Jenovas,argent-dawn,951,druid,restoration,24,10,14
Fackloner,zuljin,951,druid,restoration,24,10,14
Magneziie,drakthul,949,druid,restoration,18,10,8
Lightboxx,ravencrest,949,druid,restoration,100,54,46
Dstarzu,archimonde,949,druid,restoration,29,13,16
Cerius,drakthul,948,druid,restoration,18,10,8
Muju,stormscale,948,druid,restoration,94,44,50
Tílac,eredar,947,druid,restoration,18,10,8
Sinestah,ravencrest,947,druid,restoration,127,61,66
Triplej,twisting-nether,946,druid,restoration,52,26,26
Lathlas,defias-brotherhood,946,druid,restoration,24,12,12
Мирафлоресс,booty-bay,945,druid,restoration,130,60,70
Paskixoxo,ravencrest,945,druid,restoration,24,10,14
Фэйблуд,blackscar,944,druid,restoration,234,119,115
Elgallonegro,blackrock,943,druid,restoration,18,10,8
Bislait,archimonde,942,druid,restoration,117,53,64
Xaeerow,archimonde,941,druid,restoration,24,10,14
Тиктиктак,fordragon,941,druid,restoration,83,28,55
Nargaí,kargath,940,druid,restoration,66,28,38
Erinark,aegwynn,940,druid,restoration,42,10,32
Fajia,frostmane,939,druid,restoration,36,10,26
Bunnykiss,kazzak,938,druid,restoration,48,24,24
Buffspencer,ragnaros,936,druid,restoration,107,56,51
Nimèl,argent-dawn,936,druid,restoration,42,18,24
Ganjeez,kazzak,935,druid,restoration,18,10,8
Fubarmeep,outland,932,druid,restoration,42,22,20
Narawenn,ysondre,932,druid,restoration,78,36,42
Zydruid,silvermoon,932,druid,restoration,24,10,14
Kazekengan,draenor,932,druid,restoration,30,10,20
Djclonex,archimonde,931,druid,restoration,64,32,32
Gunqer,burning-legion,931,druid,restoration,42,18,24
Kaydjan,elune,929,druid,restoration,36,18,18
Revoidý,blackmoore,929,druid,restoration,72,20,52
Борзойрог,soulflayer,927,druid,restoration,66,31,35
Argbjörn,sylvanas,926,druid,restoration,102,45,57
Firwyn,antonidas,925,druid,restoration,109,35,74
Uffknatschpl,blackmoore,924,druid,restoration,24,10,14
Malfis,the-maelstrom,924,druid,restoration,30,12,18
Tranduiil,drakthul,924,druid,restoration,42,16,26
Kl,archimonde,924,druid,restoration,42,10,32
Drrood,stormscale,923,druid,restoration,14,11,3
Arminíus,die-silberne-hand,923,druid,restoration,101,39,62
Tribaldawn,ragnaros,922,druid,restoration,18,11,7
Ruap,blackmoore,922,druid,restoration,26,13,13
Knoohz,twisting-nether,921,druid,restoration,36,18,18
Lyarx,ragnaros,919,druid,restoration,48,25,23
Пачкачая,howling-fjord,916,druid,restoration,86,46,40
Visurat,tarren-mill,916,druid,restoration,100,46,54
Druidicmorr,sylvanas,915,druid,restoration,22,10,12
Spaartaa,blackhand,914,druid,restoration,78,29,49
Natyr,blackrock,913,druid,restoration,54,23,31
Rumjin,burning-blade,913,druid,restoration,46,13,33
Hairytree,outland,911,druid,restoration,26,12,14
Yam,thrall,911,druid,restoration,29,10,19
Бехеровка,grom,910,druid,restoration,58,24,34
Feanthur,drakthul,909,druid,restoration,227,112,115
Bigpopp,kazzak,909,druid,restoration,24,10,14
Woodrla,sylvanas,908,druid,restoration,54,30,24
Psychogirl,area-52,908,druid,restoration,55,26,29
Krennan,darkspear,907,druid,restoration,18,10,8
Kárél,drakthul,906,druid,restoration,24,12,12
Kroshka,sylvanas,906,druid,restoration,24,10,14
Sároman,ravencrest,906,druid,restoration,55,14,41
Drubro,ragnaros,906,druid,restoration,42,10,32
Caturday,terrordar,905,druid,restoration,42,20,22
Alligatordru,kazzak,905,druid,restoration,30,13,17
Prettysavage,blackhand,905,druid,restoration,37,11,26
Barbesco,zuljin,904,druid,restoration,223,108,115
Pudseytree,doomhammer,904,druid,restoration,156,73,83
Maylika,hyjal,904,druid,restoration,92,35,57
Minimuuh,blackhand,902,druid,restoration,36,18,18
Dablolo,ravencrest,901,druid,restoration,18,11,7
Medreas,argent-dawn,901,druid,restoration,27,13,14
Bearshift,aggra-português,900,druid,restoration,72,28,44
Retroix,nefarian,898,druid,restoration,36,14,22
Joji,la-croisade-écarlate,898,druid,restoration,45,17,28
Pussn,twisting-nether,898,druid,restoration,30,10,20
Zpredyn,dentarg,898,druid,restoration,52,15,37
Dùrban,archimonde,896,druid,restoration,28,14,14
Missfar,doomhammer,896,druid,restoration,66,28,38
Lorucka,die-nachtwache,894,druid,restoration,20,10,10
Gladyon,ravencrest,894,druid,restoration,30,13,17
Ктотоизкчр,gordunni,892,druid,restoration,14,10,4
Moonbloom,defias-brotherhood,891,druid,restoration,17,10,7
Zyska,outland,885,druid,restoration,330,149,181
Sweetanglesz,khadgar,885,druid,restoration,102,36,66
Kiwara,malganis,884,druid,restoration,24,12,12
Morphûs,kaelthas,883,druid,restoration,157,71,86
Snifa,the-venture-co,883,druid,restoration,31,13,18
Norrma,silvermoon,882,druid,restoration,30,10,20
Goingham,quelthalas,881,druid,restoration,24,12,12
Nachtelf,lightbringer,881,druid,restoration,96,36,60
Purple,draenor,880,druid,restoration,48,22,26
Coolbro,hyjal,879,druid,restoration,54,16,38
Arthoriana,thrall,878,druid,restoration,47,10,37
Yggdraasil,pozzo-delleternità,877,druid,restoration,48,23,25
Nozev,silvermoon,877,druid,restoration,153,68,85
Натурка,razuvious,874,druid,restoration,64,20,44
Skilloxus,gilneas,873,druid,restoration,239,100,139
Trol,malganis,871,druid,restoration,33,16,17
Mandy,spinebreaker,871,druid,restoration,30,10,20
Ellinaki,neptulon,870,druid,restoration,144,69,75
Arianator,culte-de-la-rive-noire,870,druid,restoration,101,47,54
Beazze,drakthul,869,druid,restoration,90,36,54
Инуараши,ashenvale,867,druid,restoration,56,23,33
Allagís,kul-tiras,865,druid,restoration,49,24,25
Isaacpewton,antonidas,864,druid,restoration,18,9,9
Nyllou,culte-de-la-rive-noire,864,druid,restoration,18,9,9
Noramun,blackmoore,864,druid,restoration,18,9,9
Иксвовски,gordunni,864,druid,restoration,18,9,9
Pissbomb,ravencrest,864,druid,restoration,18,9,9
Thorrkk,azshara,864,druid,restoration,18,9,9
Ponardo,outland,864,druid,restoration,19,9,10
Jàgër,archimonde,864,druid,restoration,24,9,15
Ночарик,blackscar,864,druid,restoration,30,9,21
Myndraa,varimathras,863,druid,restoration,12,9,3
Ëlyt,blackmoore,863,druid,restoration,15,10,5
Drblackus,draenor,863,druid,restoration,15,10,5
Svanturken,kazzak,863,druid,restoration,18,9,9
Kalihaze,silvermoon,863,druid,restoration,18,9,9
Madmanul,draenor,863,druid,restoration,18,9,9
Casic,echsenkessel,863,druid,restoration,24,9,15
Çhuucky,khaz-modan,863,druid,restoration,109,37,72
Nellro,blackrock,863,druid,restoration,30,9,21
Blblbl,ysondre,862,druid,restoration,18,9,9
Liluha,outland,862,druid,restoration,18,9,9
Lunatrixs,dun-modr,862,druid,restoration,52,23,29
Tigerroll,kazzak,862,druid,restoration,24,9,15
Bîloux,ysondre,861,druid,restoration,12,9,3
Thj,sylvanas,861,druid,restoration,30,15,15
Jugai,archimonde,861,druid,restoration,18,9,9
Ackyo,ysondre,861,druid,restoration,18,9,9
Furía,anubarak,861,druid,restoration,27,10,17
Fknmad,burning-blade,860,druid,restoration,12,9,3
Mulx,die-ewige-wacht,860,druid,restoration,14,9,5
Bâchl,antonidas,860,druid,restoration,24,12,12
Dopadruid,ravencrest,860,druid,restoration,18,9,9
Hahnvm,stormscale,860,druid,restoration,18,9,9
Thardruid,stormscale,860,druid,restoration,18,9,9
Sneedlewøødz,exodar,860,druid,restoration,24,9,15
Helguard,silvermoon,860,druid,restoration,24,9,15
Nøny,gorgonnash,859,druid,restoration,18,9,9
Shackari,ravencrest,858,druid,restoration,18,9,9
Elo,dun-morogh,858,druid,restoration,18,9,9
Gabbro,dalaran,857,druid,restoration,18,9,9
Angryfatdudu,draenor,857,druid,restoration,30,9,21
Subu,drakthul,857,druid,restoration,30,9,21
Gargasina,colinas-pardas,856,druid,restoration,28,15,13
Synoe,la-croisade-écarlate,855,druid,restoration,18,9,9
Ashiothie,argent-dawn,854,druid,restoration,12,9,3
Aivy,boulderfist,854,druid,restoration,37,17,20
Pøzy,sanguino,853,druid,restoration,48,23,25
Nious,kazzak,853,druid,restoration,24,9,15
Rexadria,blackrock,853,druid,restoration,30,9,21
Tightaníc,sylvanas,852,druid,restoration,18,9,9
Shokazu,blackmoore,852,druid,restoration,190,89,101
Egi,azshara,851,druid,restoration,26,12,14
Enføld,ravencrest,850,druid,restoration,20,9,11
Spiralout,nemesis,847,druid,restoration,854,423,431
Faelune,argent-dawn,846,druid,restoration,18,9,9
Tarneil,magtheridon,845,druid,restoration,31,11,20
Chujogrzmot,kazzak,843,druid,restoration,23,9,14
Jtsoigne,ysondre,842,druid,restoration,52,25,27
Panacée,dalaran,842,druid,restoration,102,48,54
Shakshun,draenor,842,druid,restoration,60,24,36
Laaide,blackmoore,841,druid,restoration,14,9,5
Healingelf,argent-dawn,841,druid,restoration,18,10,8
Speedlebee,malganis,841,druid,restoration,18,9,9
Seabath,kirin-tor,841,druid,restoration,24,9,15
Ганаа,howling-fjord,840,druid,restoration,58,25,33
Hootymactoot,magtheridon,838,druid,restoration,36,17,19
Drutoomight,tarren-mill,838,druid,restoration,24,9,15
Bezzel,doomhammer,838,druid,restoration,24,9,15
Zulfran,blackrock,837,druid,restoration,24,9,15
Omegaheals,scarshield-legion,836,druid,restoration,72,35,37
Liloè,onyxia,835,druid,restoration,138,64,74
Котанет,gordunni,835,druid,restoration,60,24,36
Clearwipe,thunderhorn,835,druid,restoration,24,9,15
Robeala,twisting-nether,832,druid,restoration,42,17,25
Махх,howling-fjord,832,druid,restoration,24,9,15
Элеарсия,gordunni,832,druid,restoration,84,30,54
Tuonq,sylvanas,832,druid,restoration,46,15,31
Braxxiloa,nazjatar,830,druid,restoration,18,9,9
Corrosion,outland,830,druid,restoration,118,51,67
Blacksnarl,kazzak,827,druid,restoration,678,323,355
Nube,alonsus,826,druid,restoration,66,25,41
Варсан,howling-fjord,825,druid,restoration,102,45,57
Dobradoonga,exodar,824,druid,restoration,24,10,14
Soif,rashgarroth,823,druid,restoration,58,26,32
Relay,ragnaros,821,druid,restoration,48,18,30
Oyoyo,kaelthas,819,druid,restoration,20,10,10
Mimesis,argent-dawn,819,druid,restoration,186,76,110
Metaboss,ravencrest,817,druid,restoration,71,24,47
Karvapersé,argent-dawn,816,druid,restoration,24,10,14
Tierundelfee,outland,816,druid,restoration,54,19,35
Opresse,archimonde,815,druid,restoration,21,10,11
Jamburapro,sylvanas,814,druid,restoration,174,87,87
Darkstalker,arygos,814,druid,restoration,42,9,33
Khalynn,eredar,808,druid,restoration,86,28,58
Alexifaw,voljin,807,druid,restoration,16,10,6
Ratskrone,alleria,805,druid,restoration,190,85,105
Bärførceøne,blackrock,805,druid,restoration,36,14,22
Arysae,die-aldor,805,druid,restoration,54,18,36
Thélon,antonidas,804,druid,restoration,117,56,61
Maart,twisting-nether,804,druid,restoration,116,45,71
Healbrah,burning-blade,804,druid,restoration,99,28,71
Longtool,doomhammer,803,druid,restoration,126,46,80
Bullchóps,kazzak,803,druid,restoration,39,14,25
Grude,argent-dawn,801,druid,restoration,31,9,22
Bedcarx,ravencrest,800,druid,restoration,21,9,12
Leyea,ravencrest,800,druid,restoration,41,12,29
Nastygluejjr,terokkar,797,druid,restoration,44,17,27
Trytargetme,outland,796,druid,restoration,17,9,8
Adminble,alakir,796,druid,restoration,90,37,53
Rolven,defias-brotherhood,796,druid,restoration,29,11,18
Urlef,antonidas,795,druid,restoration,30,12,18
Merakir,dun-modr,795,druid,restoration,114,42,72
Detlaff,draenor,795,druid,restoration,28,9,19
Sacmycløne,draenor,786,druid,restoration,35,10,25
Grüezi,sylvanas,785,druid,restoration,35,10,25
Rhaine,kult-der-verdammten,784,druid,restoration,17,9,8
Aglae,sylvanas,784,druid,restoration,41,11,30
Bidodici,nemesis,783,druid,restoration,135,57,78
Buufu,kazzak,780,druid,restoration,19,9,10
Fyllesvinet,azjolnerub,771,druid,restoration,18,9,9
Dokus,grim-batol,771,druid,restoration,46,19,27
Droodfist,khaz-modan,770,druid,restoration,114,48,66
Kerataas,lightnings-blade,769,druid,restoration,35,14,21
Citir,twisting-nether,769,druid,restoration,77,24,53
Jellyxdd,silvermoon,768,druid,restoration,12,8,4
Mojakravicaa,ravencrest,768,druid,restoration,12,8,4
Méné,blackhand,768,druid,restoration,12,8,4
Dablol,draenor,768,druid,restoration,12,8,4
Stinka,ravencrest,768,druid,restoration,12,8,4
Acxaryl,stormscale,768,druid,restoration,12,8,4
Kaod,outland,768,druid,restoration,35,17,18
Heilomat,kazzak,768,druid,restoration,18,8,10
Jin,the-venture-co,768,druid,restoration,18,8,10
Xanxiety,outland,768,druid,restoration,18,8,10
Tmonstr,alakir,768,druid,restoration,18,8,10
Arrvid,sylvanas,768,druid,restoration,18,8,10
Murlwywy,blackmoore,768,druid,restoration,18,8,10
Réhagen,archimonde,768,druid,restoration,18,8,10
Kopet,the-maelstrom,768,druid,restoration,18,8,10
Neverfall,aegwynn,768,druid,restoration,24,10,14
Ajaÿ,sylvanas,768,druid,restoration,24,8,16
Taylrswftmnd,twisting-nether,767,druid,restoration,12,8,4
Piggo,tarren-mill,767,druid,restoration,12,8,4
Predattor,grim-batol,767,druid,restoration,20,10,10
Theprey,tarren-mill,767,druid,restoration,18,8,10
Quasarx,ravencrest,767,druid,restoration,18,8,10
Sùmmèrz,ravencrest,767,druid,restoration,18,8,10
Spoilers,amanthul,767,druid,restoration,18,8,10
Tompax,kazzak,767,druid,restoration,18,8,10
Птицун,gordunni,767,druid,restoration,18,8,10
Hirodompa,archimonde,767,druid,restoration,18,8,10
Elyrai,drakthul,767,druid,restoration,18,8,10
Nubsi,aegwynn,767,druid,restoration,24,8,16
Efru,silvermoon,767,druid,restoration,24,8,16
Seekx,silvermoon,766,druid,restoration,12,8,4
Bearpawzz,kazzak,766,druid,restoration,12,8,4
Thespanker,aggramar,766,druid,restoration,15,9,6
Ghxsty,silvermoon,766,druid,restoration,18,8,10
Uncleruccus,outland,766,druid,restoration,24,8,16
Джунали,howling-fjord,766,druid,restoration,24,8,16
Alunjá,chamber-of-aspects,766,druid,restoration,24,8,16
Skrith,stormscale,766,druid,restoration,24,8,16
Fòggie,silvermoon,766,druid,restoration,53,17,36
Мерлинз,lich-king,765,druid,restoration,12,8,4
Tsunami,ragnaros,765,druid,restoration,12,8,4
Сокдобрый,gordunni,765,druid,restoration,12,8,4
Razudru,nerathor,765,druid,restoration,15,8,7
Crydotcom,aegwynn,765,druid,restoration,18,8,10
Biebear,sylvanas,765,druid,restoration,30,8,22
Oparegelt,eredar,765,druid,restoration,35,8,27
Wísh,stormscale,764,druid,restoration,18,8,10
Druul,frostwolf,764,druid,restoration,18,8,10
Марголав,gordunni,764,druid,restoration,18,8,10
Pewpewflap,kazzak,764,druid,restoration,18,8,10
Speeddemonx,tarren-mill,764,druid,restoration,19,8,11
Jahmandudu,ragnaros,764,druid,restoration,24,8,16
Furbyz,kazzak,763,druid,restoration,18,8,10
Daluria,malganis,763,druid,restoration,18,8,10
Aisak,burning-legion,763,druid,restoration,24,8,16
Jabizz,azjolnerub,763,druid,restoration,24,8,16
Yamashi,stormscale,762,druid,restoration,18,8,10
Jendiiss,drakthul,762,druid,restoration,47,16,31
Boompjeh,chamber-of-aspects,761,druid,restoration,12,8,4
Swiftbloom,bronze-dragonflight,759,druid,restoration,24,8,16
Зервес,gordunni,759,druid,restoration,30,8,22
Kkthanks,twisting-nether,757,druid,restoration,12,8,4
Loumpa,hyjal,757,druid,restoration,58,30,28
Avenzi,draenor,757,druid,restoration,18,8,10
Amaryllìs,twisting-nether,757,druid,restoration,24,8,16
Semiflora,silvermoon,757,druid,restoration,24,8,16
Karmacowboy,ravencrest,756,druid,restoration,24,8,16
Myos,conseil-des-ombres,756,druid,restoration,24,8,16
Мицкид,gordunni,756,druid,restoration,29,9,20
Houwalia,archimonde,754,druid,restoration,60,25,35
Vestor,ravencrest,754,druid,restoration,24,8,16
Kerelya,argent-dawn,754,druid,restoration,24,8,16
Ostara,blackmoore,751,druid,restoration,24,8,16
Nàrina,der-abyssische-rat,750,druid,restoration,18,8,10
Wildblu,nemesis,748,druid,restoration,24,8,16
Foyboy,ravencrest,747,druid,restoration,62,13,49
Arrock,malfurion,745,druid,restoration,36,13,23
Nithilana,argent-dawn,744,druid,restoration,30,8,22
Inysea,die-aldor,743,druid,restoration,84,24,60
Aelly,stormreaver,742,druid,restoration,18,8,10
Frostfox,ghostlands,741,druid,restoration,22,9,13
Haveacoffee,stormscale,741,druid,restoration,55,18,37
Skraks,ysondre,739,druid,restoration,30,8,22
Krayzz,tarren-mill,736,druid,restoration,28,8,20
Nutzlos,azshara,735,druid,restoration,165,60,105
Ivysun,auchindoun,734,druid,restoration,20,9,11
Nelfurion,twisting-nether,734,druid,restoration,20,9,11
Saxondale,aszune,729,druid,restoration,18,8,10
Широзоид,howling-fjord,728,druid,restoration,28,8,20
Soezzdrood,archimonde,727,druid,restoration,19,8,11
Kuokkanen,azuremyst,726,druid,restoration,21,9,12
Исмалат,howling-fjord,726,druid,restoration,25,9,16
Unt,emerald-dream,718,druid,restoration,17,8,9
Catman,eredar,717,druid,restoration,15,9,6
Brayyjin,kul-tiras,712,druid,restoration,21,9,12
Treehead,ravencrest,709,druid,restoration,22,9,13
Lyndruid,sylvanas,701,druid,restoration,156,57,99
Sylocin,earthen-ring,699,druid,restoration,16,8,8
Eodar,proudmoore,696,druid,restoration,23,8,15
Søfiaa,argent-dawn,685,druid,restoration,46,9,37
Найтед,gordunni,678,druid,restoration,17,10,7
Dudu,sinstralis,677,druid,restoration,26,10,16
Mojakravicaa,stormscale,672,druid,restoration,12,7,5
Krewèlla,emerald-dream,672,druid,restoration,12,7,5
Антиблэк,soulflayer,672,druid,restoration,12,7,5
Bomor,dragonblight,672,druid,restoration,12,7,5
Vertígo,ravencrest,672,druid,restoration,12,7,5
Jacksonh,blackmoore,672,druid,restoration,12,7,5
Graouphro,hyjal,672,druid,restoration,12,7,5
Jakeffsake,stormscale,672,druid,restoration,12,7,5
Сумрачнный,gordunni,672,druid,restoration,12,7,5
Zarune,sanguino,672,druid,restoration,12,7,5
Astodruid,defias-brotherhood,672,druid,restoration,12,7,5
Djdishwasher,kazzak,672,druid,restoration,12,7,5
Ohshift,drakthul,672,druid,restoration,12,7,5
Tlxrdlx,archimonde,672,druid,restoration,12,7,5
Fadâ,archimonde,672,druid,restoration,12,7,5
Zhényá,ravencrest,672,druid,restoration,16,8,8
Xanánioma,ravencrest,672,druid,restoration,18,7,11
Juhato,outland,672,druid,restoration,18,7,11
Ðon,nemesis,672,druid,restoration,18,7,11
Darkyblood,archimonde,672,druid,restoration,18,7,11
Сайнтификх,gordunni,672,druid,restoration,18,7,11
Bgwell,archimonde,672,druid,restoration,18,7,11
Buzzlîghtyea,outland,672,druid,restoration,18,7,11
Vivere,frostmane,672,druid,restoration,23,7,16
Stormendru,kazzak,672,druid,restoration,24,7,17
Neverpanic,stormscale,672,druid,restoration,24,7,17
Kluggerz,silvermoon,672,druid,restoration,24,7,17
Téddy,thrall,672,druid,restoration,24,7,17
Xbalanc,kazzak,672,druid,restoration,24,7,17
Inochi,ravencrest,672,druid,restoration,24,7,17
Стомпбр,gordunni,672,druid,restoration,24,7,17
Chir,blackrock,671,druid,restoration,12,10,2
Zatarmix,sylvanas,671,druid,restoration,12,7,5
Мамамышь,gordunni,671,druid,restoration,12,7,5
Lorya,runetotem,671,druid,restoration,12,7,5
Pomdöner,echsenkessel,671,druid,restoration,12,7,5
Darktigrou,archimonde,671,druid,restoration,12,7,5
Nicotic,kazzak,671,druid,restoration,12,7,5
Badballance,outland,671,druid,restoration,12,7,5
Гимодера,gordunni,671,druid,restoration,12,7,5
Thyana,blackrock,671,druid,restoration,12,7,5
Rosskemp,tarren-mill,671,druid,restoration,18,7,11
Zoura,ysondre,671,druid,restoration,18,7,11
Sitruu,zenedar,671,druid,restoration,18,7,11
Møonknight,ravencrest,671,druid,restoration,18,7,11
Smokahontas,kilrogg,671,druid,restoration,18,7,11
Nref,outland,671,druid,restoration,24,7,17
Crazydos,tarren-mill,671,druid,restoration,24,7,17
Trntydr,senjin,671,druid,restoration,24,7,17
Шеданна,gordunni,671,druid,restoration,24,7,17
Frequentist,ragnaros,671,druid,restoration,24,7,17
Gstahr,taerar,671,druid,restoration,24,7,17
Azumera,silvermoon,670,druid,restoration,12,7,5
Greenberry,eonar,670,druid,restoration,12,7,5
Blooming,ravencrest,670,druid,restoration,12,7,5
Alvee,ravencrest,670,druid,restoration,14,8,6
Imissclone,outland,670,druid,restoration,18,7,11
Skeolicious,hyjal,670,druid,restoration,18,7,11
Taugenîchts,blackmoore,670,druid,restoration,18,7,11
Trickortree,frostwolf,670,druid,restoration,24,7,17
Naicy,khaz-modan,670,druid,restoration,30,7,23
Тиимон,borean-tundra,669,druid,restoration,12,7,5
Derie,nazjatar,669,druid,restoration,18,7,11
Azenoir,ravencrest,669,druid,restoration,18,7,11
Mailiin,lordaeron,669,druid,restoration,18,7,11
Melcharis,frostwolf,669,druid,restoration,18,7,11
Xavoths,outland,669,druid,restoration,18,7,11
Хамулл,howling-fjord,669,druid,restoration,18,7,11
Jasof,sylvanas,669,druid,restoration,21,8,13
Chintawaz,archimonde,669,druid,restoration,22,8,14
Gailiûga,kazzak,669,druid,restoration,25,8,17
Eladhria,arakarahm,669,druid,restoration,24,7,17
Wakefields,dun-modr,669,druid,restoration,30,7,23
Druidbox,ravencrest,668,druid,restoration,12,7,5
Seasexsune,antonidas,668,druid,restoration,18,7,11
Cláire,stormscale,668,druid,restoration,18,7,11
Shadowdury,frostwolf,668,druid,restoration,18,7,11
Poweralone,ravencrest,668,druid,restoration,18,7,11
Milkniatrump,tarren-mill,668,druid,restoration,18,7,11
Alfrëd,quelthalas,668,druid,restoration,18,7,11
Coínlíp,drakthul,668,druid,restoration,24,7,17
Lùxs,silvermoon,667,druid,restoration,18,7,11
Thaeldres,argent-dawn,667,druid,restoration,18,7,11
Wardruíd,outland,667,druid,restoration,24,7,17
Tá,kazzak,667,druid,restoration,30,7,23
Zolaheuzis,argent-dawn,667,druid,restoration,42,7,35
Druidul,sylvanas,666,druid,restoration,12,7,5
Zauräk,ysondre,666,druid,restoration,12,7,5
Entler,twilights-hammer,666,druid,restoration,12,7,5
Inspira,teldrassil,666,druid,restoration,18,7,11
Acalien,ambossar,666,druid,restoration,24,7,17
Bepanten,azshara,665,druid,restoration,18,7,11
Bloomzy,outland,662,druid,restoration,18,7,11
Bothvar,terokkar,662,druid,restoration,24,7,17
Druiddamage,the-maelstrom,660,druid,restoration,18,7,11
Rukashi,die-aldor,659,druid,restoration,12,7,5
Raktav,kazzak,659,druid,restoration,12,7,5
Kinisha,dun-morogh,659,druid,restoration,18,7,11
Сутулоерыгло,howling-fjord,658,druid,restoration,20,7,13
Jooblob,guldan,658,druid,restoration,30,7,23
Бацна,gordunni,656,druid,restoration,24,7,17
Draxedin,kazzak,655,druid,restoration,11,7,4
Florizar,elune,650,druid,restoration,18,7,11
Voodoodrood,draenor,645,druid,restoration,36,7,29
Muhjini,eredar,643,druid,restoration,27,9,18
Hornykarenn,bladefist,639,druid,restoration,17,7,10
Amelosta,silvermoon,637,druid,restoration,49,9,40
Lyvaley,dun-modr,629,druid,restoration,28,7,21
Mymoms,stormscale,624,druid,restoration,21,7,14
Нюхнимедведя,blackscar,623,druid,restoration,11,7,4
Wanessa,kazzak,622,druid,restoration,11,7,4
Fatdroodz,draenor,622,druid,restoration,30,8,22
Tmhaikyu,blackhand,621,druid,restoration,21,8,13
Justdmg,ravencrest,618,druid,restoration,13,8,5
Øxxy,ravencrest,618,druid,restoration,29,9,20
Whitemaine,aggramar,615,druid,restoration,14,8,6
Kapidrooqt,suramar,615,druid,restoration,15,8,7
Grówl,kazzak,613,druid,restoration,27,9,18
Rammtarn,boulderfist,613,druid,restoration,73,20,53
Poonkin,ravencrest,610,druid,restoration,23,7,16
Vellusdruid,burning-legion,607,druid,restoration,14,7,7
Celene,zuljin,606,druid,restoration,11,7,4
Метафрея,gordunni,605,druid,restoration,11,7,4
Wolfheart,norgannon,598,druid,restoration,39,13,26
Crazywild,archimonde,596,druid,restoration,18,8,10
Moonwrath,hyjal,591,druid,restoration,19,7,12
Gobachi,emeriss,585,druid,restoration,13,7,6
Lecoq,magtheridon,576,druid,restoration,6,6,0
Gigachas,tarren-mill,576,druid,restoration,6,6,0
Abercrombx,thrall,576,druid,restoration,6,6,0
Taicoo,outland,576,druid,restoration,12,6,6
Ассканий,booty-bay,576,druid,restoration,12,6,6
Yëkténíyá,ravencrest,576,druid,restoration,12,6,6
Vindruva,ravencrest,576,druid,restoration,12,6,6
Jhiun,ragnaros,576,druid,restoration,12,6,6
Tinkérbell,blackmoore,576,druid,restoration,12,6,6
Bilmo,ragnaros,576,druid,restoration,12,6,6
Lolimadudu,silvermoon,576,druid,restoration,12,6,6
Hecatos,hyjal,576,druid,restoration,12,6,6
Freddyßear,draenor,576,druid,restoration,12,6,6
Bøømerswågxx,twisting-nether,576,druid,restoration,12,6,6
Mccarthy,archimonde,576,druid,restoration,12,6,6
Fotmheroqtxd,ravencrest,576,druid,restoration,12,6,6
Theforest,stormscale,576,druid,restoration,12,6,6
Sálty,aegwynn,576,druid,restoration,12,6,6
Jincksdru,ravencrest,576,druid,restoration,12,6,6
Tafsiri,stormscale,576,druid,restoration,12,6,6
Piñaclo,archimonde,576,druid,restoration,12,6,6
Daurex,stormreaver,576,druid,restoration,12,6,6
Outformpoly,ravencrest,576,druid,restoration,12,6,6
Cyriaan,eredar,576,druid,restoration,12,6,6
Telpha,onyxia,576,druid,restoration,12,6,6
Biggttgothgf,doomhammer,576,druid,restoration,12,6,6
Rycnd,tarren-mill,576,druid,restoration,12,6,6
Tashani,blackhand,576,druid,restoration,12,6,6
Ravnac,aegwynn,576,druid,restoration,12,6,6
Ferraribob,ravencrest,576,druid,restoration,12,6,6
Pogidruid,ragnaros,576,druid,restoration,12,6,6
Dijii,the-maelstrom,576,druid,restoration,13,6,7
Worsteux,blackrock,576,druid,restoration,14,6,8
Ãmba,blackrock,576,druid,restoration,15,6,9
Suevlaki,ragnaros,576,druid,restoration,18,6,12
Hánsolo,ravencrest,576,druid,restoration,18,6,12
Arcaníer,draenor,576,druid,restoration,18,6,12
Tjillevippen,tarren-mill,576,druid,restoration,18,6,12
Pölkky,argent-dawn,576,druid,restoration,18,6,12
Randomnup,sanguino,576,druid,restoration,18,6,12
Psychopath,sylvanas,576,druid,restoration,18,6,12
Deazydrood,blackrock,576,druid,restoration,18,6,12
Secô,sylvanas,576,druid,restoration,18,6,12
Rumbus,sanguino,576,druid,restoration,19,6,13
Cridan,ravencrest,576,druid,restoration,26,6,20
Bullwyse,malganis,575,druid,restoration,12,6,6
Mistgone,hyjal,575,druid,restoration,12,6,6
Iamsocute,silvermoon,575,druid,restoration,12,6,6
Fordirion,ravencrest,575,druid,restoration,12,6,6
Garbloom,silvermoon,575,druid,restoration,12,6,6
Thiudaish,tarren-mill,575,druid,restoration,12,6,6
Scarrymonsta,outland,575,druid,restoration,12,6,6
Lucidor,frostmane,575,druid,restoration,12,6,6
Reidens,moonglade,575,druid,restoration,12,6,6
Wykked,outland,575,druid,restoration,12,6,6
Lanmìe,malganis,575,druid,restoration,12,6,6
Greenriver,magtheridon,575,druid,restoration,12,6,6
Fiberpäls,magtheridon,575,druid,restoration,12,6,6
Nobrainopain,aegwynn,575,druid,restoration,12,6,6
Ænea,aegwynn,575,druid,restoration,15,7,8
Fiq,silvermoon,575,druid,restoration,18,6,12
Grîsh,burning-legion,575,druid,restoration,18,6,12
Dorange,stormscale,575,druid,restoration,18,6,12
Ipiridian,kargath,575,druid,restoration,18,6,12
Sóratas,blackhand,575,druid,restoration,18,6,12
Faelendris,culte-de-la-rive-noire,575,druid,restoration,18,6,12
Pouletqt,archimonde,575,druid,restoration,18,6,12
Barley,aegwynn,575,druid,restoration,18,6,12
Drbark,blackmoore,575,druid,restoration,18,6,12
Mascraxx,earthen-ring,575,druid,restoration,18,6,12
Emidrem,ravencrest,575,druid,restoration,22,7,15
Kakoje,burning-legion,575,druid,restoration,24,6,18
Bobromila,burning-blade,575,druid,restoration,24,6,18
Эскоф,gordunni,575,druid,restoration,25,6,19
Spritzer,tarren-mill,574,druid,restoration,12,6,6
Heala,malganis,574,druid,restoration,12,6,6
Оксинаген,ashenvale,574,druid,restoration,12,6,6
Tryglor,blackhand,574,druid,restoration,18,6,12
Koniny,drakthul,574,druid,restoration,24,6,18
Goatmeal,draenor,574,druid,restoration,24,6,18
Magnusson,shadowsong,574,druid,restoration,24,6,18
Oaky,alonsus,573,druid,restoration,12,6,6
Kalimdori,antonidas,573,druid,restoration,12,6,6
Ragdru,twisting-nether,573,druid,restoration,24,6,18
Swo,emeriss,573,druid,restoration,24,6,18
Ênfaktüs,silvermoon,573,druid,restoration,25,6,19
Shadówglen,defias-brotherhood,573,druid,restoration,30,6,24
Deb,uldaman,572,druid,restoration,12,6,6
Taskingoman,twisting-nether,572,druid,restoration,12,6,6
Rouvikonas,silvermoon,572,druid,restoration,12,6,6
Slange,ravencrest,572,druid,restoration,18,6,12
Bearhúg,kazzak,572,druid,restoration,18,6,12
Devilsdoll,ravencrest,572,druid,restoration,18,6,12
Aspegic,grim-batol,572,druid,restoration,30,6,24
Wildsoul,hyjal,571,druid,restoration,12,6,6
Лордсенка,eversong,571,druid,restoration,22,9,13
Sfteddy,tarren-mill,571,druid,restoration,18,6,12
Diigga,eredar,571,druid,restoration,18,6,12
Neridris,argent-dawn,570,druid,restoration,12,6,6
Эгерме24FA33,howling-fjord,569,druid,restoration,12,6,6
Barki,silvermoon,569,druid,restoration,18,6,12
Essya,earthen-ring,569,druid,restoration,31,7,24
Olekh,nemesis,568,druid,restoration,12,6,6
Frealar,trollbane,568,druid,restoration,12,6,6
Myrkálfur,sylvanas,568,druid,restoration,12,6,6
Аелин,blackscar,566,druid,restoration,16,9,7
Walkao,tarren-mill,566,druid,restoration,12,6,6
Wellsie,blackmoore,565,druid,restoration,18,6,12
Moonhenge,neptulon,565,druid,restoration,18,6,12
Jusar,hyjal,564,druid,restoration,12,6,6
Xtrakul,bloodfeather,564,druid,restoration,15,7,8
Ærîs,garona,562,druid,restoration,18,6,12
Garypowers,kazzak,559,druid,restoration,29,6,23
Alatie,sylvanas,558,druid,restoration,21,6,15
Rakhajan,twisting-nether,553,druid,restoration,35,6,29
Fanso,burning-legion,543,druid,restoration,18,7,11
Vlookup,tarren-mill,543,druid,restoration,17,6,11
Siahra,khaz-modan,534,druid,restoration,48,6,42
Arún,nazjatar,527,druid,restoration,11,6,5
Traplordgen,outland,527,druid,restoration,17,6,11
Orgazmo,archimonde,526,druid,restoration,17,6,11
Noodledru,tarren-mill,526,druid,restoration,21,6,15
Toramix,dalaran,526,druid,restoration,44,10,34
Noggerglatze,blackrock,522,druid,restoration,19,7,12
Ультраафина,gordunni,520,druid,restoration,16,7,9
Savageftw,draenor,520,druid,restoration,19,7,12
Diazepam,draenor,519,druid,restoration,21,7,14
Хуфра,greymane,514,druid,restoration,31,9,22
Sethdr,hyjal,511,druid,restoration,20,6,14
Wolig,tarren-mill,510,druid,restoration,16,6,10
Lsdpinkcandy,twisting-nether,508,druid,restoration,22,6,16
Thaiboimbyy,veknilash,507,druid,restoration,10,6,4
Жибка,howling-fjord,496,druid,restoration,19,6,13
Vinesolar,runetotem,493,druid,restoration,13,6,7
Quadpulse,ravencrest,480,druid,restoration,6,5,1
Móònlight,ravencrest,480,druid,restoration,6,5,1
Мегабамбук,soulflayer,480,druid,restoration,6,5,1
Bobthebull,ragnaros,480,druid,restoration,6,5,1
Zapx,hyjal,480,druid,restoration,6,5,1
Angelofbliss,tarren-mill,480,druid,restoration,6,5,1
Bembz,twisting-nether,480,druid,restoration,6,5,1
Neldoran,outland,480,druid,restoration,6,5,1
Celetik,archimonde,480,druid,restoration,6,5,1
Coldyxzqt,blackrock,480,druid,restoration,6,5,1
Miskydruid,kazzak,480,druid,restoration,6,5,1
Feinrippjoe,blackhand,480,druid,restoration,6,5,1
Ccbrue,ambossar,480,druid,restoration,6,5,1
Beamgødx,thrall,480,druid,restoration,6,5,1
Cheddar,tyrande,480,druid,restoration,12,5,7
Adyllon,die-aldor,480,druid,restoration,12,5,7
Agatîta,dun-modr,480,druid,restoration,12,5,7
Maelst,sanguino,480,druid,restoration,12,5,7
Crysís,sanguino,480,druid,restoration,12,5,7
Druni,blackrock,480,druid,restoration,12,5,7
Tokamon,blackrock,480,druid,restoration,12,5,7
Sucream,burning-legion,480,druid,restoration,12,5,7
Wacrafting,kargath,480,druid,restoration,12,5,7
Napsta,sylvanas,480,druid,restoration,12,5,7
Zunixboosted,lothar,480,druid,restoration,12,5,7
Druidicchi,stormscale,480,druid,restoration,12,5,7
Solonely,argent-dawn,480,druid,restoration,12,5,7
Taldrus,argent-dawn,480,druid,restoration,12,5,7
Horstyolo,blackrock,480,druid,restoration,12,5,7
Xenrakh,blackhand,480,druid,restoration,12,5,7
Woopidou,chants-éternels,480,druid,restoration,12,5,7
Skirr,kelthuzad,480,druid,restoration,12,5,7
Marmotini,the-maelstrom,480,druid,restoration,12,5,7
Trollingt,draenor,480,druid,restoration,12,5,7
Fjry,draenor,480,druid,restoration,12,5,7
Trashgamex,eredar,480,druid,restoration,12,5,7
Daisyx,eredar,480,druid,restoration,12,5,7
Bloomitizé,ravencrest,480,druid,restoration,12,5,7
Ilovekush,gilneas,480,druid,restoration,12,5,7
Bøøstèdtréè,ravencrest,480,druid,restoration,12,5,7
Ppr,stormscale,480,druid,restoration,12,5,7
Umbutsebada,ravencrest,480,druid,restoration,12,5,7
Idkmàn,ravencrest,480,druid,restoration,12,5,7
Tilikum,stormscale,480,druid,restoration,12,5,7
Hwrén,stormscale,480,druid,restoration,12,5,7
Xclonedotcom,aegwynn,480,druid,restoration,12,5,7
Ipsylön,aggra-português,480,druid,restoration,12,5,7
Druidka,grim-batol,480,druid,restoration,12,5,7
Alolexxtwo,archimonde,480,druid,restoration,12,5,7
Asude,outland,480,druid,restoration,12,5,7
Аронэл,blackscar,480,druid,restoration,12,5,7
Димадубощит,blackscar,480,druid,restoration,12,5,7
Flanagàn,hyjal,480,druid,restoration,12,5,7
Neshalry,blackhand,480,druid,restoration,13,5,8
Hottêd,sylvanas,480,druid,restoration,26,8,18
Jebaitor,tarren-mill,480,druid,restoration,18,5,13
Bigbaddream,stormscale,480,druid,restoration,18,5,13
Restaidpvs,wildhammer,480,druid,restoration,18,5,13
Wikdruid,ravencrest,480,druid,restoration,18,5,13
Zladium,laughing-skull,480,druid,restoration,18,5,13
Erelieva,silvermoon,480,druid,restoration,18,5,13
Músclébéach,silvermoon,480,druid,restoration,18,5,13
Farathey,twisting-nether,480,druid,restoration,36,5,31
Винстяша,gordunni,479,druid,restoration,6,5,1
Ñãvy,archimonde,479,druid,restoration,6,5,1
Rocknrollà,doomhammer,479,druid,restoration,6,5,1
Клиптыч,soulflayer,479,druid,restoration,6,5,1
Superdupa,burning-blade,479,druid,restoration,6,5,1
Derrion,burning-legion,479,druid,restoration,12,5,7
Sieur,archimonde,479,druid,restoration,12,5,7
Skatten,the-maelstrom,479,druid,restoration,12,5,7
Delphina,dun-modr,479,druid,restoration,12,5,7
Esøterix,malganis,479,druid,restoration,12,5,7
Datshifter,magtheridon,479,druid,restoration,12,5,7
Wozay,archimonde,479,druid,restoration,12,5,7
Epidruid,stormrage,479,druid,restoration,12,5,7
Eliame,hyjal,479,druid,restoration,12,5,7
Malfurioff,twisting-nether,479,druid,restoration,12,5,7
Мунпраид,gordunni,479,druid,restoration,12,5,7
Midrialis,sinstralis,479,druid,restoration,12,5,7
Abyssaldepth,ravencrest,479,druid,restoration,12,5,7
Dáxó,thrall,479,druid,restoration,12,5,7
Qb,blackrock,479,druid,restoration,12,5,7
Gunelak,blackmoore,479,druid,restoration,12,5,7
Rydo,turalyon,479,druid,restoration,14,5,9
Caliyo,kazzak,479,druid,restoration,14,5,9
Akínos,tarren-mill,479,druid,restoration,18,5,13
Asklepiøs,blackmoore,479,druid,restoration,18,5,13
Baracüda,draenor,479,druid,restoration,22,6,16
Jemyd,aegwynn,479,druid,restoration,24,5,19
Absolutsprit,kazzak,479,druid,restoration,30,5,25
Bloodhoofjr,blackhand,479,druid,restoration,30,5,25
Adrosus,blackrock,479,druid,restoration,30,5,25
Capacious,drakthul,478,druid,restoration,6,5,1
Multihoopsi,ysondre,478,druid,restoration,6,5,1
Шмыгадру,eversong,478,druid,restoration,12,5,7
Blackfür,sylvanas,478,druid,restoration,12,5,7
Beef,the-maelstrom,478,druid,restoration,12,5,7
Kuivea,the-maelstrom,478,druid,restoration,18,5,13
Druzroz,arathor,478,druid,restoration,23,5,18
Hurutuk,ysondre,478,druid,restoration,24,5,19
Fanofkreemax,archimonde,477,druid,restoration,6,5,1
Kodobursto,stormscale,477,druid,restoration,12,5,7
Wybsalt,dragonblight,477,druid,restoration,18,5,13
Kufcuf,eredar,475,druid,restoration,12,5,7
Sýrês,malganis,475,druid,restoration,12,5,7
Томография,howling-fjord,475,druid,restoration,12,5,7
Ластхоп,soulflayer,475,druid,restoration,12,5,7
Saltilac,ragnaros,474,druid,restoration,30,5,25
Thellma,argent-dawn,473,druid,restoration,12,5,7
Prowlinger,silvermoon,473,druid,restoration,12,5,7
Êlvis,kazzak,472,druid,restoration,12,5,7
Tajfun,burning-legion,472,druid,restoration,12,5,7
Urgrull,baelgun,472,druid,restoration,18,5,13
Thaurus,durotan,471,druid,restoration,24,5,19
Аллишана,howling-fjord,465,druid,restoration,25,8,17
Iamtheone,ragnaros,463,druid,restoration,17,5,12
Dhomaris,emerald-dream,447,druid,restoration,17,5,12
Happyhippo,arathor,447,druid,restoration,17,5,12
Ambracer,silvermoon,444,druid,restoration,8,6,2
Amindenes,ragnaros,438,druid,restoration,34,5,29
Sumecßeast,aegwynn,432,druid,restoration,15,6,9
Mozzin,frostwolf,431,druid,restoration,17,5,12
Izhusky,ravencrest,426,druid,restoration,14,6,8
Pfandmalle,blackrock,426,druid,restoration,14,6,8
Atomanna,blackmoore,426,druid,restoration,15,6,9
Nythielle,argent-dawn,426,druid,restoration,20,6,14
Sartipus,draenor,425,druid,restoration,23,7,16
Avilary,tarren-mill,425,druid,restoration,20,6,14
Storfjåset,stormscale,425,druid,restoration,21,6,15
Знаменоносец,soulflayer,414,druid,restoration,22,5,17
Jadhy,hyjal,414,druid,restoration,22,5,17
Meridus,thrall,400,druid,restoration,13,5,8
Vineguhl,thrall,399,druid,restoration,5,5,0
Xneji,sylvanas,397,druid,restoration,19,5,14
Heathen,defias-brotherhood,384,druid,restoration,6,4,2
Кискалисичка,soulflayer,384,druid,restoration,6,4,2
Bjaerntass,darksorrow,384,druid,restoration,6,4,2
Starlites,silvermoon,384,druid,restoration,6,4,2
Sinyi,arathor,384,druid,restoration,6,4,2
Notmyfriend,sylvanas,384,druid,restoration,6,4,2
Феразинария,gordunni,384,druid,restoration,6,4,2
Балаклаваа,soulflayer,384,druid,restoration,6,4,2
Gurenx,ravencrest,384,druid,restoration,6,4,2
Backtoferal,kazzak,384,druid,restoration,6,4,2
Koala,temple-noir,384,druid,restoration,6,4,2
Pinkponcho,defias-brotherhood,384,druid,restoration,6,4,2
Razzarius,draenor,384,druid,restoration,6,4,2
Neuroz,ravencrest,384,druid,restoration,6,4,2
Xanguinary,outland,384,druid,restoration,6,4,2
Cykablyaster,defias-brotherhood,384,druid,restoration,6,4,2
Hakirâ,archimonde,384,druid,restoration,6,4,2
Mentaldead,tarren-mill,384,druid,restoration,6,4,2
Tebz,ravencrest,384,druid,restoration,6,4,2
Àrkange,hyjal,384,druid,restoration,6,4,2
Bearmeister,kazzak,384,druid,restoration,6,4,2
Deeizm,ravencrest,384,druid,restoration,6,4,2
Zouzouille,ravencrest,384,druid,restoration,6,4,2
Zeroclones,the-maelstrom,384,druid,restoration,6,4,2
Divicîacøs,ysondre,384,druid,restoration,6,4,2
Jimmyjam,archimonde,384,druid,restoration,6,4,2
Lerralol,eredar,384,druid,restoration,6,4,2
Elinity,blackrock,384,druid,restoration,6,4,2
Ystøss,archimonde,384,druid,restoration,6,4,2
Milfshákez,ravencrest,384,druid,restoration,6,4,2
Tenzuk,archimonde,384,druid,restoration,6,4,2
Thëca,dun-modr,384,druid,restoration,6,4,2
Cyclonebot,kazzak,384,druid,restoration,6,4,2
Xandersito,sanguino,384,druid,restoration,6,4,2
Sensisdruid,blackmoore,384,druid,restoration,6,4,2
Brushié,kazzak,384,druid,restoration,6,4,2
Theeix,twisting-nether,384,druid,restoration,6,4,2
Claptastic,magtheridon,384,druid,restoration,6,4,2
Juicypus,ragnaros,384,druid,restoration,6,4,2
Duckiethotx,twisting-nether,384,druid,restoration,6,4,2
Bullbash,twisting-nether,384,druid,restoration,6,4,2
Híraad,blackmoore,384,druid,restoration,6,4,2
Bombiix,sanguino,384,druid,restoration,6,4,2
Zuldram,uldaman,384,druid,restoration,6,4,2
Mikba,blackrock,384,druid,restoration,10,4,6
Flauschtatze,wrathbringer,384,druid,restoration,13,5,8
Chelsealeart,frostmane,384,druid,restoration,15,5,10
Bryzix,the-maelstrom,384,druid,restoration,12,4,8
Wheezygamer,aegwynn,384,druid,restoration,12,4,8
Muushu,aegwynn,384,druid,restoration,12,4,8
Biglet,tarren-mill,384,druid,restoration,12,4,8
Farmmygold,dun-modr,384,druid,restoration,12,4,8
Зурсага,deathguard,384,druid,restoration,12,4,8
Смизм,gordunni,384,druid,restoration,12,4,8
Sqoopy,tarren-mill,384,druid,restoration,12,4,8
Pedra,zuljin,384,druid,restoration,12,4,8
Togara,kazzak,384,druid,restoration,12,4,8
Найадра,gordunni,384,druid,restoration,12,4,8
Burgergodx,tarren-mill,384,druid,restoration,12,4,8
Exilliá,twisting-nether,384,druid,restoration,12,4,8
Kobra,twilights-hammer,384,druid,restoration,12,4,8
Zivela,blackrock,384,druid,restoration,12,4,8
Curtainscall,kazzak,384,druid,restoration,12,4,8
Pharaah,stormscale,384,druid,restoration,12,4,8
Tyzme,blackrock,384,druid,restoration,12,4,8
Hûibûh,eredar,384,druid,restoration,12,4,8
Baraforet,archimonde,384,druid,restoration,12,4,8
Sìmbano,eredar,384,druid,restoration,12,4,8
Cumulisama,sylvanas,384,druid,restoration,12,4,8
Enriya,blackhand,384,druid,restoration,12,4,8
Monfroar,archimonde,384,druid,restoration,12,4,8
Dafidruid,argent-dawn,384,druid,restoration,12,4,8
Celtimi,antonidas,384,druid,restoration,12,4,8
Ravenfel,argent-dawn,384,druid,restoration,12,4,8
Flewks,silvermoon,384,druid,restoration,12,4,8
Saadxd,sanguino,384,druid,restoration,12,4,8
Аренатренер,blackscar,384,druid,restoration,12,4,8
Momine,burning-blade,384,druid,restoration,12,4,8
Сулинея,blackscar,384,druid,restoration,12,4,8
Holdmabeer,blackmoore,384,druid,restoration,12,4,8
Иная,grom,384,druid,restoration,12,4,8
Toffyfee,anetheron,384,druid,restoration,12,4,8
Thigh,blackrock,384,druid,restoration,12,4,8
Wootbeam,silvermoon,384,druid,restoration,12,4,8
Xxîn,blackrock,384,druid,restoration,12,4,8
Wurzeldor,ravencrest,384,druid,restoration,12,4,8
Northstarx,kazzak,384,druid,restoration,12,4,8
Råèkwøñ,ravencrest,384,druid,restoration,12,4,8
Astrobazooka,stormreaver,384,druid,restoration,12,4,8
Muhlí,malygos,384,druid,restoration,12,4,8
Hotundwech,blackrock,384,druid,restoration,12,4,8
Shamelêss,eredar,384,druid,restoration,12,4,8
Jöggel,perenolde,384,druid,restoration,12,4,8
Youdog,kazzak,384,druid,restoration,12,4,8
Shapees,sylvanas,384,druid,restoration,12,4,8
Totempiedzam,dalaran,384,druid,restoration,12,4,8
Restolol,outland,384,druid,restoration,12,4,8
Swiftlife,blackrock,384,druid,restoration,12,4,8
Litany,drakthul,384,druid,restoration,13,4,9
Moolß,uldaman,384,druid,restoration,18,4,14
Grunka,silvermoon,384,druid,restoration,18,4,14
Hrz,kazzak,384,druid,restoration,18,4,14
Bignunu,silvermoon,384,druid,restoration,18,4,14
Revivication,aggramar,384,druid,restoration,18,4,14
Tacobender,tarren-mill,384,druid,restoration,18,4,14
Nezara,kazzak,384,druid,restoration,18,4,14
Yøungreidzz,blackrock,384,druid,restoration,24,4,20
Ymagyne,frostmane,384,druid,restoration,24,4,20
Kyrnox,ravencrest,384,druid,restoration,24,4,20
Rainwhisper,outland,383,druid,restoration,6,4,2
Бабазарулем,fordragon,383,druid,restoration,6,4,2
Cmfg,blackrock,383,druid,restoration,6,4,2
Termadol,kazzak,383,druid,restoration,6,4,2
Yogui,zuljin,383,druid,restoration,6,4,2
Jabbah,defias-brotherhood,383,druid,restoration,6,4,2
Gaiinthewood,rexxar,383,druid,restoration,6,4,2
Ozy,emeriss,383,druid,restoration,6,4,2
Kyoshima,blackhand,383,druid,restoration,6,4,2
Rawbacon,aegwynn,383,druid,restoration,6,4,2
Santoniq,dun-morogh,383,druid,restoration,6,4,2
Elurra,archimonde,383,druid,restoration,6,4,2
Noxndruid,blackhand,383,druid,restoration,12,4,8
Lazår,tarren-mill,383,druid,restoration,12,4,8
Eoinsriaops,hyjal,383,druid,restoration,12,4,8
Xidenn,quelthalas,383,druid,restoration,12,4,8
Hefdgaharald,antonidas,383,druid,restoration,12,4,8
Gugruguuguu,eredar,383,druid,restoration,12,4,8
Prikolica,quelthalas,383,druid,restoration,12,4,8
Сигстейнхохо,blackscar,383,druid,restoration,12,4,8
Venh,forscherliga,383,druid,restoration,12,4,8
Druidguy,ghostlands,383,druid,restoration,12,4,8
Замакибо,howling-fjord,383,druid,restoration,12,4,8
Arns,kazzak,383,druid,restoration,12,4,8
Høpè,die-silberne-hand,383,druid,restoration,12,4,8
Semenisback,archimonde,383,druid,restoration,12,4,8
Itê,dun-morogh,383,druid,restoration,18,4,14
Leeonore,burning-legion,383,druid,restoration,18,4,14
Шикалат,howling-fjord,383,druid,restoration,24,4,20
Каирон,deepholm,383,druid,restoration,24,4,20
Cowabanga,shattered-hand,382,druid,restoration,6,4,2
Xele,destromath,382,druid,restoration,6,4,2
Bantha,hyjal,382,druid,restoration,6,4,2
Hauserqqt,auchindoun,382,druid,restoration,6,4,2
Mongetout,ravencrest,382,druid,restoration,6,4,2
Девочкамиши,soulflayer,382,druid,restoration,10,6,4
Murma,dalaran,382,druid,restoration,12,4,8
Pega,nazjatar,382,druid,restoration,12,4,8
Sabflordr,outland,381,druid,restoration,12,4,8
Amalou,ravencrest,381,druid,restoration,12,4,8
Dolob,ragnaros,381,druid,restoration,18,4,14
Lewy,aegwynn,381,druid,restoration,18,4,14
Boomboox,kazzak,379,druid,restoration,15,5,10
Фигоначи,soulflayer,379,druid,restoration,12,4,8
Tranquillo,outland,379,druid,restoration,12,4,8
Teix,aggra-português,370,druid,restoration,30,7,23
Nøkki,draenor,367,druid,restoration,21,8,13
Jincksdru,anachronos,367,druid,restoration,11,4,7
Opla,nethersturm,366,druid,restoration,23,8,15
Druidenee,hyjal,351,druid,restoration,8,5,3
Ríckø,ysondre,351,druid,restoration,8,5,3
Stkk,dun-modr,351,druid,restoration,11,4,7
Biegel,ysera,351,druid,restoration,11,4,7
Demerit,defias-brotherhood,351,druid,restoration,11,4,7
Ymöthep,archimonde,351,druid,restoration,11,4,7
Moderjord,stormreaver,351,druid,restoration,14,5,9
Ysu,silvermoon,351,druid,restoration,25,5,20
Fapmasterx,eredar,351,druid,restoration,23,4,19
Lyhene,outland,339,druid,restoration,32,8,24
Incheon,archimonde,335,druid,restoration,11,4,7
Querasidru,ravencrest,330,druid,restoration,16,5,11
Wuppii,blackmoore,329,druid,restoration,10,6,4
Swarmah,draenor,329,druid,restoration,18,5,13
Hubek,silvermoon,328,druid,restoration,8,6,2
Vhio,eredar,326,druid,restoration,12,5,7
Albx,archimonde,320,druid,restoration,10,4,6
Chéon,nethersturm,319,druid,restoration,10,4,6
Jirenthegrey,antonidas,318,druid,restoration,14,4,10
Mímír,frostmane,317,druid,restoration,10,4,6
Elsnorro,sylvanas,313,druid,restoration,19,5,14
Holographic,ravencrest,304,druid,restoration,7,4,3
Rëckiah,ysondre,304,druid,restoration,13,4,9
Vaspy,sylvanas,288,druid,restoration,6,3,3
Currare,aegwynn,288,druid,restoration,6,3,3
Numaresto,stormscale,288,druid,restoration,6,3,3
Pâlarïns,dalaran,288,druid,restoration,6,3,3
Kîfï,dun-modr,288,druid,restoration,6,3,3
Dharli,stormscale,288,druid,restoration,6,3,3
Owldschool,blackmoore,288,druid,restoration,6,3,3
Zaethul,draenor,288,druid,restoration,6,3,3
Madnuzzmoo,draenor,288,druid,restoration,6,3,3
Skrewu,silvermoon,288,druid,restoration,6,3,3
Gehrkehotter,silvermoon,288,druid,restoration,6,3,3
Sliffar,azshara,288,druid,restoration,6,3,3
Shyni,outland,288,druid,restoration,6,3,3
Àxilì,stormscale,288,druid,restoration,6,3,3
Karova,alleria,288,druid,restoration,6,3,3
Druidtraîner,ysera,288,druid,restoration,6,3,3
Drullenobama,silvermoon,288,druid,restoration,6,3,3
Танганэку,howling-fjord,288,druid,restoration,6,3,3
Hoofysnoopy,outland,288,druid,restoration,6,3,3
Астраджет,gordunni,288,druid,restoration,6,3,3
Bißear,archimonde,288,druid,restoration,6,3,3
Youngdipper,draenor,288,druid,restoration,6,3,3
Bigfathoe,tarren-mill,288,druid,restoration,6,3,3
Lolaven,turalyon,288,druid,restoration,6,3,3
Qwopeiqpwoid,kazzak,288,druid,restoration,6,3,3
Lèafy,silvermoon,288,druid,restoration,6,3,3
Lisunaria,silvermoon,288,druid,restoration,6,3,3
Myxa,arthas,288,druid,restoration,6,3,3
Bêlion,dun-modr,288,druid,restoration,6,3,3
Sportzdruid,argent-dawn,288,druid,restoration,6,3,3
Ærõxy,aegwynn,288,druid,restoration,6,3,3
Magiskeforme,draenor,288,druid,restoration,6,3,3
Meowmf,silvermoon,288,druid,restoration,6,3,3
Blacknarus,drakthul,288,druid,restoration,6,3,3
Houkka,doomhammer,288,druid,restoration,6,3,3
Juvencus,twisting-nether,288,druid,restoration,6,3,3
Faustîno,dun-modr,288,druid,restoration,6,3,3
Реллинг,gordunni,288,druid,restoration,6,3,3
Armënovitch,ravencrest,288,druid,restoration,6,3,3
Dimki,kazzak,288,druid,restoration,6,3,3
Belangy,exodar,288,druid,restoration,6,3,3
Fallken,burning-blade,288,druid,restoration,6,3,3
Свэпп,blackscar,288,druid,restoration,6,3,3
Мореллоо,gordunni,288,druid,restoration,6,3,3
Blownaway,outland,288,druid,restoration,6,3,3
Дробовик,soulflayer,288,druid,restoration,6,3,3
Skiplegdays,aegwynn,288,druid,restoration,6,3,3
Beere,kazzak,288,druid,restoration,6,3,3
Nøur,blackmoore,288,druid,restoration,6,3,3
Cattu,argent-dawn,288,druid,restoration,6,3,3
Närgof,outland,288,druid,restoration,6,3,3
Preda,thunderhorn,288,druid,restoration,6,3,3
Saadi,der-rat-von-dalaran,288,druid,restoration,6,3,3
Jéssíé,silvermoon,288,druid,restoration,6,3,3
Koprogatos,twilights-hammer,288,druid,restoration,6,3,3
Friyiee,stormscale,288,druid,restoration,6,3,3
Ullainho,stormscale,288,druid,restoration,6,3,3
Nominell,kazzak,288,druid,restoration,6,3,3
Ipsdray,ysondre,288,druid,restoration,6,3,3
Ñark,archimonde,288,druid,restoration,6,3,3
Hð,blackmoore,288,druid,restoration,6,3,3
Thundruid,archimonde,288,druid,restoration,6,3,3
Couleaf,stormscale,288,druid,restoration,6,3,3
Darkömwz,ysondre,288,druid,restoration,6,3,3
Vinav,burning-legion,288,druid,restoration,6,3,3
Qtdok,outland,288,druid,restoration,6,3,3
Shìinx,hyjal,288,druid,restoration,6,3,3
Treyni,outland,288,druid,restoration,6,3,3
Noobr,ravencrest,288,druid,restoration,6,3,3
Curinas,argent-dawn,288,druid,restoration,6,3,3
Dystaleon,blackrock,288,druid,restoration,6,3,3
Pigcat,twisting-nether,288,druid,restoration,6,3,3
Spielmann,ravencrest,288,druid,restoration,6,3,3
Fairdul,blackmoore,288,druid,restoration,6,3,3
Ærøßits,uldum,288,druid,restoration,6,3,3
Npel,twisting-nether,288,druid,restoration,6,3,3
Leahuwu,argent-dawn,288,druid,restoration,6,3,3
Pipima,kazzak,288,druid,restoration,6,3,3
Infernaltaxy,nemesis,288,druid,restoration,6,3,3
Ripmacmiller,grim-batol,288,druid,restoration,6,3,3
Whisk,ravencrest,288,druid,restoration,6,3,3
ßot,hyjal,288,druid,restoration,6,3,3
Mcbobb,ravencrest,288,druid,restoration,6,3,3
Thecousins,ravencrest,288,druid,restoration,6,3,3
Eftersmak,ravencrest,288,druid,restoration,6,3,3
Luphrekmeow,ravencrest,288,druid,restoration,6,3,3
Semia,archimonde,288,druid,restoration,6,3,3
Whelpss,archimonde,288,druid,restoration,6,3,3
Dezcore,hyjal,288,druid,restoration,6,3,3
Ghøstavdruid,ravencrest,288,druid,restoration,6,3,3
Hutini,magtheridon,288,druid,restoration,6,3,3
Droodyàz,hyjal,288,druid,restoration,6,3,3
Fluentgcds,ravencrest,288,druid,restoration,6,3,3
Peaches,aerie-peak,288,druid,restoration,6,3,3
Kælýx,silvermoon,288,druid,restoration,6,3,3
Fx,mazrigos,288,druid,restoration,8,3,5
Æøiæn,blackmoore,288,druid,restoration,9,3,6
Piñaclonada,archimonde,288,druid,restoration,9,3,6
Smarticle,aegwynn,288,druid,restoration,11,3,8
Draawun,burning-legion,288,druid,restoration,11,3,8
Nostigon,azshara,288,druid,restoration,12,3,9
Jonnaxø,ravencrest,288,druid,restoration,12,3,9
Skrubbarn,frostmane,288,druid,restoration,12,3,9
Còwgummi,blackhand,288,druid,restoration,12,3,9
Basedgôd,alakir,288,druid,restoration,12,3,9
Reehzx,ravencrest,288,druid,restoration,12,3,9
Megustatu,ravencrest,288,druid,restoration,12,3,9
Tinykiwi,silvermoon,288,druid,restoration,12,3,9
Karmabitz,ravencrest,288,druid,restoration,12,3,9
Footfame,kazzak,288,druid,restoration,12,3,9
Navra,ravencrest,288,druid,restoration,12,3,9
Nebrahl,silvermoon,288,druid,restoration,12,3,9
Trolthelhas,chogall,288,druid,restoration,12,3,9
Ezils,silvermoon,288,druid,restoration,12,3,9
Emeskay,ravencrest,288,druid,restoration,12,3,9
Elxa,silvermoon,288,druid,restoration,12,3,9
Ireso,kelthuzad,288,druid,restoration,12,3,9
Vregord,twisting-nether,288,druid,restoration,12,3,9
Restodruidx,ravencrest,288,druid,restoration,12,3,9
Asharah,blutkessel,288,druid,restoration,12,3,9
Xecksi,twisting-nether,288,druid,restoration,12,3,9
Coffeebean,twisting-nether,288,druid,restoration,12,3,9
Doup,alakir,288,druid,restoration,12,3,9
Areidhel,pozzo-delleternità,288,druid,restoration,12,3,9
Ajày,sylvanas,288,druid,restoration,12,3,9
Bakara,arthas,288,druid,restoration,12,3,9
Raila,pozzo-delleternità,288,druid,restoration,12,3,9
Amazed,wildhammer,288,druid,restoration,12,3,9
Rzo,blackmoore,288,druid,restoration,12,3,9
Harrasmoes,ravencrest,288,druid,restoration,12,3,9
Juicý,eredar,288,druid,restoration,12,3,9
Awienx,kazzak,288,druid,restoration,12,3,9
Lukøu,blackrock,288,druid,restoration,12,3,9
Ritualofmoon,darkmoon-faire,288,druid,restoration,12,3,9
Hérby,kazzak,288,druid,restoration,12,3,9
Xbrokeaf,eredar,288,druid,restoration,12,3,9
Wheyproteín,dun-modr,288,druid,restoration,12,3,9
Chapawee,eredar,288,druid,restoration,12,3,9
Pelpes,dun-modr,288,druid,restoration,12,3,9
Fejgi,stormreaver,288,druid,restoration,12,3,9
Teah,darkmoon-faire,288,druid,restoration,12,3,9
Xåy,der-rat-von-dalaran,288,druid,restoration,12,3,9
Snowlight,der-rat-von-dalaran,288,druid,restoration,12,3,9
Sadgeconvoke,draenor,288,druid,restoration,12,3,9
Храмульчик,blackscar,288,druid,restoration,12,3,9
Kiirsi,arygos,288,druid,restoration,12,3,9
Evølvë,burning-blade,288,druid,restoration,12,3,9
Ragingliam,emerald-dream,288,druid,restoration,12,3,9
Marryat,argent-dawn,288,druid,restoration,12,3,9
Shiotake,hyjal,288,druid,restoration,12,3,9
Bluebear,der-rat-von-dalaran,288,druid,restoration,12,3,9
Киряаниме,gordunni,288,druid,restoration,12,3,9
Sojiz,outland,288,druid,restoration,12,3,9
Cheezy,defias-brotherhood,288,druid,restoration,12,3,9
Gámóra,argent-dawn,288,druid,restoration,18,3,15
Woehaha,ravencrest,288,druid,restoration,18,3,15
Astralpandas,kazzak,288,druid,restoration,18,3,15
Квазарм,gordunni,288,druid,restoration,18,3,15
Rakuy,thrall,288,druid,restoration,18,3,15
Amstaffio,blackhand,288,druid,restoration,18,3,15
Belisw,silvermoon,288,druid,restoration,18,3,15
Boomdruud,tarren-mill,288,druid,restoration,18,3,15
Brokul,kazzak,288,druid,restoration,18,3,15
Eyune,tarren-mill,288,druid,restoration,24,3,21
Kuhlheit,der-rat-von-dalaran,287,druid,restoration,6,3,3
Lalou,saurfang,287,druid,restoration,6,3,3
Nehalem,blackrock,287,druid,restoration,6,3,3
Mgelolaf,doomhammer,287,druid,restoration,6,3,3
Youngjin,ravencrest,287,druid,restoration,6,3,3
Smittly,bloodhoof,287,druid,restoration,6,3,3
Touchpad,archimonde,287,druid,restoration,6,3,3
Dorjeè,defias-brotherhood,287,druid,restoration,6,3,3
Lundx,ravencrest,287,druid,restoration,6,3,3
Foxîo,frostmane,287,druid,restoration,6,3,3
Grimmie,frostmane,287,druid,restoration,6,3,3
Xulian,exodar,287,druid,restoration,12,3,9
Лёшациклонх,deathguard,287,druid,restoration,12,3,9
Lamsélår,ravencrest,287,druid,restoration,12,3,9
Senul,sanguino,287,druid,restoration,12,3,9
Reckóning,draenor,287,druid,restoration,12,3,9
Papalegba,kilrogg,287,druid,restoration,12,3,9
Jeepers,quelthalas,287,druid,restoration,12,3,9
Grimbear,hellfire,287,druid,restoration,18,3,15
Xtraflash,silvermoon,287,druid,restoration,18,3,15
Ìncubus,pozzo-delleternità,287,druid,restoration,24,3,21
Kebanos,ravencrest,286,druid,restoration,6,3,3
Analterorist,chamber-of-aspects,286,druid,restoration,6,3,3
Paniel,amanthul,286,druid,restoration,6,3,3
Kittenmitten,ragnaros,286,druid,restoration,12,3,9
Anniko,garona,286,druid,restoration,18,3,15
Elônea,antonidas,285,druid,restoration,12,3,9
Адаладиус,howling-fjord,285,druid,restoration,42,3,39
Charlierunkl,gorgonnash,283,druid,restoration,24,3,21
Smradzblech,drakthul,275,druid,restoration,25,6,19
Niél,sylvanas,271,druid,restoration,17,3,14
Кимоношка,gordunni,268,druid,restoration,25,12,13
Kaliyuga,dalaran,255,druid,restoration,11,3,8
Bunga,quelthalas,255,druid,restoration,11,3,8
Yopi,stormscale,240,druid,restoration,15,3,12
Потнаякиса,grom,239,druid,restoration,5,3,2
Woodbison,tarren-mill,239,druid,restoration,5,3,2
Amélor,ragnaros,239,druid,restoration,5,3,2
Foqua,twisting-nether,239,druid,restoration,8,3,5
Tyariel,die-aldor,238,druid,restoration,5,3,2
Mokokokakau,ravencrest,234,druid,restoration,7,4,3
Lxz,blackhand,234,druid,restoration,8,4,4
Hamilina,thunderhorn,234,druid,restoration,9,4,5
Noegang,hyjal,234,druid,restoration,15,5,10
Rowlet,twisting-nether,234,druid,restoration,12,4,8
Therøn,dun-modr,234,druid,restoration,17,5,12
Beerplusbeer,kazzak,234,druid,restoration,23,6,17
Bigdambitex,draenor,234,druid,restoration,16,4,12
Àlec,silvermoon,234,druid,restoration,17,4,13
Æîîs,blackrock,234,druid,restoration,35,5,30
Vénage,blackmoore,233,druid,restoration,17,6,11
Onacor,stormrage,233,druid,restoration,16,4,12
Lynaee,cthun,224,druid,restoration,10,3,7
Razorleaf,turalyon,222,druid,restoration,14,3,11
Öakenheart,kazzak,208,druid,restoration,7,3,4
Trydru,blackmoore,192,druid,restoration,9,3,6
Wolfhealer,blackmoore,192,druid,restoration,9,3,6
Náiledx,stormscale,192,druid,restoration,6,2,4
Slimsneeky,outland,192,druid,restoration,6,2,4
Sajlol,doomhammer,192,druid,restoration,6,2,4
Arijel,die-aldor,192,druid,restoration,6,2,4
Kaldon,thrall,192,druid,restoration,6,2,4
Restoboi,stormscale,192,druid,restoration,6,2,4
Deép,nazjatar,192,druid,restoration,6,2,4
Zerpent,silvermoon,192,druid,restoration,6,2,4
Brennariss,outland,192,druid,restoration,6,2,4
Devolboy,turalyon,192,druid,restoration,6,2,4
Droigan,die-aldor,192,druid,restoration,6,2,4
Zì,stormscale,192,druid,restoration,6,2,4
Вооми,gordunni,192,druid,restoration,6,2,4
Zenkillers,outland,192,druid,restoration,6,2,4
Laithie,draenor,192,druid,restoration,6,2,4
Lenays,die-aldor,192,druid,restoration,6,2,4
Cylàn,sylvanas,192,druid,restoration,6,2,4
Aionx,ravencrest,192,druid,restoration,6,2,4
Megaball,sylvanas,192,druid,restoration,6,2,4
Кенарейка,howling-fjord,192,druid,restoration,6,2,4
Reyai,ravencrest,192,druid,restoration,6,2,4
Vandalís,garrosh,192,druid,restoration,6,2,4
Оладентик,howling-fjord,192,druid,restoration,6,2,4
Чанголист,howling-fjord,192,druid,restoration,6,2,4
Nyrrh,blackmoore,192,druid,restoration,6,2,4
Gaiaa,kilrogg,192,druid,restoration,6,2,4
Palavanus,stormscale,192,druid,restoration,6,2,4
Limmiited,ravencrest,192,druid,restoration,6,2,4
Falconn,outland,192,druid,restoration,6,2,4
Rngmåchinéx,ravencrest,192,druid,restoration,6,2,4
Almuntaqim,ravencrest,192,druid,restoration,6,2,4
Baldhir,nemesis,192,druid,restoration,6,2,4
Miyukíí,ravencrest,192,druid,restoration,6,2,4
Ðarach,ravencrest,192,druid,restoration,6,2,4
Crâshley,sargeras,192,druid,restoration,6,2,4
Kÿara,khaz-modan,192,druid,restoration,6,2,4
Praythysun,khaz-modan,192,druid,restoration,6,2,4
Yourßâßygîrl,sylvanas,192,druid,restoration,6,2,4
Tàazz,sargeras,192,druid,restoration,6,2,4
Griminal,norgannon,192,druid,restoration,6,2,4
Zuta,ragnaros,192,druid,restoration,6,2,4
Zeyne,ravencrest,192,druid,restoration,6,2,4
Tandstickan,auchindoun,192,druid,restoration,6,2,4
Heejåe,archimonde,192,druid,restoration,6,2,4
Эйяфлятлайок,gordunni,192,druid,restoration,6,2,4
Disney,ragnaros,192,druid,restoration,6,2,4
Zhiwé,ravencrest,192,druid,restoration,6,2,4
Blazingmoon,twisting-nether,192,druid,restoration,6,2,4
Hydrochronic,ravencrest,192,druid,restoration,6,2,4
Trusten,nemesis,192,druid,restoration,6,2,4
Bulleyo,ysondre,192,druid,restoration,6,2,4
Drøda,aegwynn,192,druid,restoration,6,2,4
Cuzzywuzzy,ragnaros,192,druid,restoration,6,2,4
Xerrean,ravencrest,192,druid,restoration,6,2,4
Sekunden,ravencrest,192,druid,restoration,6,2,4
Tkusernamez,stormscale,192,druid,restoration,6,2,4
Ciucciotutto,nemesis,192,druid,restoration,6,2,4
Conn,ravencrest,192,druid,restoration,6,2,4
Lootmann,die-silberne-hand,192,druid,restoration,6,2,4
Faintntt,outland,192,druid,restoration,6,2,4
Tarostar,frostmane,192,druid,restoration,6,2,4
Morphael,ravencrest,192,druid,restoration,6,2,4
Märkis,minahonda,192,druid,restoration,6,2,4
Блиденг,gordunni,192,druid,restoration,6,2,4
Lynnarea,argent-dawn,192,druid,restoration,6,2,4
Moodee,kazzak,192,druid,restoration,6,2,4
Hotseîdank,blackrock,192,druid,restoration,6,2,4
Xérà,blackmoore,192,druid,restoration,6,2,4
Lefancytrash,ravencrest,192,druid,restoration,6,2,4
Yugelbaum,twisting-nether,192,druid,restoration,6,2,4
Nooz,thrall,192,druid,restoration,6,2,4
Kremhelt,outland,192,druid,restoration,6,2,4
Droodu,dun-modr,192,druid,restoration,6,2,4
Sickomodê,blackmoore,192,druid,restoration,6,2,4
Nightelvejkm,dun-modr,192,druid,restoration,6,2,4
Zandu,eredar,192,druid,restoration,6,2,4
Chrisdruid,argent-dawn,192,druid,restoration,6,2,4
Celitharion,tarren-mill,192,druid,restoration,6,2,4
Muundar,stormscale,192,druid,restoration,6,2,4
Пикаббука,gordunni,192,druid,restoration,6,2,4
Fiskmåsn,twisting-nether,192,druid,restoration,6,2,4
Luuvli,tarren-mill,192,druid,restoration,6,2,4
Uptoyou,defias-brotherhood,192,druid,restoration,6,2,4
Beluga,uldum,192,druid,restoration,6,2,4
Fumalia,sanguino,192,druid,restoration,6,2,4
Mäismz,hyjal,192,druid,restoration,6,2,4
Адорабэль,deathguard,192,druid,restoration,6,2,4
Csmo,blackmoore,192,druid,restoration,6,2,4
Rtxy,hyjal,192,druid,restoration,6,2,4
Healnau,aegwynn,192,druid,restoration,6,2,4
Treenaa,silvermoon,192,druid,restoration,6,2,4
Атитока,goldrinn,192,druid,restoration,6,2,4
Naraël,varimathras,192,druid,restoration,6,2,4
Nourishshen,silvermoon,192,druid,restoration,6,2,4
Mjáy,tarren-mill,192,druid,restoration,6,2,4
Scar,dentarg,192,druid,restoration,6,2,4
Bosco,blutkessel,192,druid,restoration,6,2,4
Harryjane,antonidas,192,druid,restoration,6,2,4
Шокоокулист,gordunni,192,druid,restoration,6,2,4
Nyrociel,pozzo-delleternità,192,druid,restoration,6,2,4
Jamley,tarren-mill,192,druid,restoration,6,2,4
Borticow,sanguino,192,druid,restoration,6,2,4
Реймика,gordunni,192,druid,restoration,6,2,4
Ekxn,archimonde,192,druid,restoration,6,2,4
Bezkin,tarren-mill,192,druid,restoration,6,2,4
Revølter,kazzak,192,druid,restoration,6,2,4
Benjiee,kazzak,192,druid,restoration,6,2,4
Luznyczeslaw,burning-legion,192,druid,restoration,6,2,4
Skavenlol,zuljin,192,druid,restoration,6,2,4
Kkona,silvermoon,192,druid,restoration,6,2,4
Imbadxx,kazzak,192,druid,restoration,6,2,4
Underdog,kazzak,192,druid,restoration,6,2,4
Príimé,kazzak,192,druid,restoration,6,2,4
Naturedork,kazzak,192,druid,restoration,6,2,4
Bärenmarke,alleria,192,druid,restoration,6,2,4
Cpt,xavius,192,druid,restoration,6,2,4
Heligakatten,twisting-nether,192,druid,restoration,10,3,7
Eusébus,ysondre,192,druid,restoration,7,2,5
Gonco,blackrock,192,druid,restoration,8,2,6
Shaggí,draenor,192,druid,restoration,11,2,9
Tayswiftmend,defias-brotherhood,192,druid,restoration,12,2,10
Qdrood,quelthalas,192,druid,restoration,12,2,10
Piper,culte-de-la-rive-noire,192,druid,restoration,12,2,10
Màf,silvermoon,192,druid,restoration,12,2,10
Sveraés,draenor,192,druid,restoration,12,2,10
Zeustriker,draenor,192,druid,restoration,12,2,10
Skorpo,blackrock,192,druid,restoration,12,2,10
Anníe,tarren-mill,192,druid,restoration,12,2,10
Lupiñ,sylvanas,192,druid,restoration,12,2,10
Ugubani,kazzak,192,druid,restoration,12,2,10
Jacksonella,dun-morogh,192,druid,restoration,12,2,10
Milfurion,emerald-dream,192,druid,restoration,12,2,10
Mahero,outland,192,druid,restoration,12,2,10
Wahahoo,la-croisade-écarlate,192,druid,restoration,12,2,10
Kenvello,ragnaros,192,druid,restoration,12,2,10
Helpthebear,twisting-nether,192,druid,restoration,12,2,10
Mejlin,drakthul,192,druid,restoration,12,2,10
Imperador,tyrande,192,druid,restoration,12,2,10
Quentalius,argent-dawn,192,druid,restoration,12,2,10
Penywiser,sylvanas,192,druid,restoration,12,2,10
Qocotte,archimonde,192,druid,restoration,12,2,10
Louisv,kazzak,192,druid,restoration,12,2,10
Jagogi,malfurion,192,druid,restoration,12,2,10
Thymesia,outland,192,druid,restoration,12,2,10
Maceyx,ravencrest,192,druid,restoration,12,2,10
Amaaja,blackmoore,192,druid,restoration,12,2,10
Keløkss,silvermoon,192,druid,restoration,12,2,10
Asteria,earthen-ring,192,druid,restoration,12,2,10
Testomake,kazzak,192,druid,restoration,12,2,10
Dadyheals,kazzak,192,druid,restoration,12,2,10
Eljinso,blackhand,192,druid,restoration,12,2,10
Rumî,blackhand,192,druid,restoration,12,2,10
Kizanimagus,magtheridon,192,druid,restoration,12,2,10
Blâckrök,blackhand,192,druid,restoration,12,2,10
Snapeshifter,blackhand,192,druid,restoration,12,2,10
Drâcâ,antonidas,192,druid,restoration,12,2,10
Салона,deathguard,192,druid,restoration,12,2,10
Vertabrain,twilights-hammer,192,druid,restoration,12,2,10
Jul,kelthuzad,192,druid,restoration,12,2,10
Álou,dalaran,192,druid,restoration,12,2,10
Nakkikastike,magtheridon,192,druid,restoration,12,2,10
Lyj,dalaran,192,druid,restoration,12,2,10
Bigstop,kazzak,192,druid,restoration,17,2,15
Luluheilt,antonidas,192,druid,restoration,18,2,16
Fadroo,tarren-mill,192,druid,restoration,18,2,16
Quza,lightbringer,192,druid,restoration,18,2,16
Madmanz,arathor,192,druid,restoration,18,2,16
Охломон,gordunni,192,druid,restoration,24,2,22
Patri,ravencrest,192,druid,restoration,25,2,23
Aütumn,twisting-nether,191,druid,restoration,9,3,6
Trolnatos,exodar,191,druid,restoration,6,2,4
Bingó,blutkessel,191,druid,restoration,6,2,4
Siyoo,thrall,191,druid,restoration,6,2,4
Morphintime,nordrassil,191,druid,restoration,6,2,4
Lodne,defias-brotherhood,191,druid,restoration,6,2,4
Зулгасилич,howling-fjord,191,druid,restoration,6,2,4
Oldghost,doomhammer,191,druid,restoration,6,2,4
Bönüs,cthun,191,druid,restoration,6,2,4
Kurúk,die-aldor,191,druid,restoration,6,2,4
Касалапый,thermaplugg,191,druid,restoration,6,2,4
Лолэтохег,soulflayer,191,druid,restoration,12,2,10
Mômmôm,aggra-português,191,druid,restoration,12,2,10
Эхосна,howling-fjord,191,druid,restoration,12,2,10
Westbeast,doomhammer,191,druid,restoration,12,2,10
Ardy,echsenkessel,191,druid,restoration,18,2,16
Bwonsamndi,frostwolf,191,druid,restoration,18,2,16
Trarus,nazjatar,191,druid,restoration,23,2,21
Lylle,doomhammer,175,druid,restoration,11,2,9
Marynlord,dalaran,175,druid,restoration,11,2,9
Knekkebrøød,ravencrest,169,druid,restoration,11,4,7
Zvyn,draenor,159,druid,restoration,5,2,3
Lyrvaz,ravencrest,159,druid,restoration,5,2,3
Zayrok,throkferoth,159,druid,restoration,8,3,5
Кукубой,deathguard,158,druid,restoration,26,3,23
Ихет,gordunni,144,druid,restoration,9,3,6
Сугрик,deathweaver,143,druid,restoration,15,2,13
Starcrash,amanthul,138,druid,restoration,6,3,3
Айтера,goldrinn,138,druid,restoration,7,3,4
Milknosugar,tarren-mill,138,druid,restoration,7,3,4
Oaksage,kazzak,138,druid,restoration,8,3,5
Ðrøøði,dun-modr,138,druid,restoration,8,3,5
Zzblaah,archimonde,138,druid,restoration,10,3,7
Chauntee,draenor,138,druid,restoration,15,3,12
Yushuliene,sanguino,137,druid,restoration,9,3,6
Preform,burning-legion,112,druid,restoration,7,2,5
Trä,earthen-ring,96,druid,restoration,3,2,1
Natåsha,argent-dawn,96,druid,restoration,6,1,5
Monopolying,dentarg,96,druid,restoration,6,1,5
Catzoro,tarren-mill,96,druid,restoration,6,1,5
Ayåshi,tarren-mill,96,druid,restoration,6,1,5
Mvpx,outland,96,druid,restoration,6,1,5
Druvian,argent-dawn,96,druid,restoration,6,1,5
Blackird,argent-dawn,96,druid,restoration,6,1,5
Craycrays,argent-dawn,96,druid,restoration,6,1,5
Druidguden,tarren-mill,96,druid,restoration,6,1,5
Druiruu,tarren-mill,96,druid,restoration,6,1,5
Kouribow,sargeras,96,druid,restoration,6,1,5
Wildsoûl,kazzak,96,druid,restoration,6,1,5
Mommonga,onyxia,96,druid,restoration,6,1,5
Dimaox,terenas,96,druid,restoration,6,1,5
Towaha,outland,96,druid,restoration,6,1,5
Bëckah,kazzak,96,druid,restoration,6,1,5
Gintoni,dun-modr,96,druid,restoration,6,1,5
Ninetyseven,outland,96,druid,restoration,6,1,5
Sylindra,argent-dawn,96,druid,restoration,6,1,5
Bazikk,kazzak,96,druid,restoration,6,1,5
Chapuk,kazzak,96,druid,restoration,6,1,5
Joppartok,outland,96,druid,restoration,6,1,5
Zulk,draenor,96,druid,restoration,6,1,5
Jordnötssmör,draenor,96,druid,restoration,6,1,5
Deezforms,kazzak,96,druid,restoration,6,1,5
Ragnahr,sanguino,96,druid,restoration,6,1,5
Moonfay,kazzak,96,druid,restoration,6,1,5
Lunarveil,draenor,96,druid,restoration,6,1,5
Sodapop,aszune,96,druid,restoration,6,1,5
Shapeer,hellscream,96,druid,restoration,6,1,5
Hélioxine,ysondre,96,druid,restoration,6,1,5
Vicedxo,kazzak,96,druid,restoration,6,1,5
Pølïna,ysondre,96,druid,restoration,6,1,5
Elzoido,kazzak,96,druid,restoration,6,1,5
Droodae,hyjal,96,druid,restoration,6,1,5
Johnybalker,hyjal,96,druid,restoration,6,1,5
Trippieboy,eredar,96,druid,restoration,6,1,5
Sozu,magtheridon,96,druid,restoration,6,1,5
Winstonka,doomhammer,96,druid,restoration,6,1,5
Trekkertt,zuljin,96,druid,restoration,6,1,5
Linkin,azshara,96,druid,restoration,6,1,5
Exist,kul-tiras,96,druid,restoration,6,1,5
Aiwendil,alakir,96,druid,restoration,6,1,5
Khaoix,draenor,96,druid,restoration,6,1,5
Valoruk,ravencrest,96,druid,restoration,6,1,5
Puraza,kazzak,96,druid,restoration,6,1,5
Durlehardu,archimonde,96,druid,restoration,6,1,5
Blanoz,ravencrest,96,druid,restoration,6,1,5
Kruwkamilka,burning-legion,96,druid,restoration,6,1,5
Dmai,burning-legion,96,druid,restoration,6,1,5
Enfy,lightbringer,96,druid,restoration,6,1,5
Ralorenz,ravencrest,96,druid,restoration,6,1,5
Phiero,ravencrest,96,druid,restoration,6,1,5
Altore,ravencrest,96,druid,restoration,6,1,5
Phatzoo,stormscale,96,druid,restoration,6,1,5
Réalmadruid,archimonde,96,druid,restoration,6,1,5
Jïng,hyjal,96,druid,restoration,6,1,5
Hotterhot,blackhand,96,druid,restoration,6,1,5
Goldencat,blackhand,96,druid,restoration,6,1,5
Ðîwø,blackhand,96,druid,restoration,6,1,5
Dízzy,malganis,96,druid,restoration,6,1,5
Teryx,blackmoore,96,druid,restoration,6,1,5
Mynilia,blackhand,96,druid,restoration,6,1,5
Тзейн,howling-fjord,96,druid,restoration,6,1,5
Nuggetspøwa,dalaran,96,druid,restoration,6,1,5
Nøunøurss,dalaran,96,druid,restoration,6,1,5
Tuzuku,frostmane,96,druid,restoration,6,1,5
Grosminouu,dalaran,96,druid,restoration,6,1,5
Misumisi,sanguino,96,druid,restoration,6,1,5
Thebartender,khaz-modan,96,druid,restoration,6,1,5
Utuabzu,grim-batol,96,druid,restoration,6,1,5
Elarc,khaz-modan,96,druid,restoration,6,1,5
Blodemoon,ragnaros,96,druid,restoration,6,1,5
Chimmi,ragnaros,96,druid,restoration,6,1,5
Cowárd,blackmoore,96,druid,restoration,6,1,5
Gløbalzx,aegwynn,96,druid,restoration,6,1,5
Seekíng,blackmoore,96,druid,restoration,6,1,5
Cryßye,ragnaros,96,druid,restoration,6,1,5
Thaïs,blackmoore,96,druid,restoration,6,1,5
Madmoss,twisting-nether,96,druid,restoration,6,1,5
Haginator,twisting-nether,96,druid,restoration,6,1,5
Meisterd,aegwynn,96,druid,restoration,6,1,5
Mokeff,twisting-nether,96,druid,restoration,6,1,5
Kisyqt,aegwynn,96,druid,restoration,6,1,5
Snorg,twisting-nether,96,druid,restoration,6,1,5
Сейтил,deathguard,96,druid,restoration,6,1,5
Tshungubuäch,eredar,96,druid,restoration,6,1,5
Ilikecaipi,eredar,96,druid,restoration,6,1,5
Ka,the-maelstrom,96,druid,restoration,6,1,5
Жарищка,soulflayer,96,druid,restoration,6,1,5
Nwal,thunderhorn,96,druid,restoration,6,1,5
Kerydwen,silvermoon,96,druid,restoration,6,1,5
Амеллида,soulflayer,96,druid,restoration,6,1,5
Пасторизсша,soulflayer,96,druid,restoration,6,1,5
Nikta,trollbane,96,druid,restoration,6,1,5
Fedelmae,nagrand,96,druid,restoration,6,1,5
Eïdendog,hyjal,96,druid,restoration,6,1,5
Clonuts,sylvanas,96,druid,restoration,6,1,5
Cumcowshot,sylvanas,96,druid,restoration,6,1,5
Sevá,sylvanas,96,druid,restoration,6,1,5
Naturaven,sylvanas,96,druid,restoration,6,1,5
Nanuu,sylvanas,96,druid,restoration,6,1,5
Винш,grom,96,druid,restoration,6,1,5
Vionia,alexstrasza,96,druid,restoration,6,1,5
Lackofexp,ravencrest,96,druid,restoration,6,1,5
Броша,gordunni,96,druid,restoration,6,1,5
Обриад,gordunni,96,druid,restoration,6,1,5
Элнут,gordunni,96,druid,restoration,6,1,5
Злодзейка,gordunni,96,druid,restoration,6,1,5
Vaizier,defias-brotherhood,96,druid,restoration,6,1,5
Дрейнсол,gordunni,96,druid,restoration,6,1,5
Effi,aggramar,96,druid,restoration,6,1,5
Horadruid,silvermoon,96,druid,restoration,6,1,5
Kaliapari,nefarian,96,druid,restoration,6,1,5
Xaralius,das-syndikat,96,druid,restoration,6,1,5
Malurith,silvermoon,96,druid,restoration,6,1,5
Kweelor,der-abyssische-rat,96,druid,restoration,6,1,5
Faladriel,zirkel-des-cenarius,96,druid,restoration,7,1,6
Doodud,twisting-nether,96,druid,restoration,7,1,6
Zanorákma,ravencrest,96,druid,restoration,8,1,7
Maaghera,silvermoon,96,druid,restoration,11,1,10
Kli,los-errantes,96,druid,restoration,12,1,11
Alfadera,kazzak,96,druid,restoration,12,1,11
Kindret,dun-modr,96,druid,restoration,12,1,11
Forbode,darkspear,96,druid,restoration,12,1,11
Athenex,azshara,96,druid,restoration,12,1,11
Radagas,malygos,96,druid,restoration,12,1,11
Kûmo,blackmoore,96,druid,restoration,12,1,11
Xilmai,darksorrow,96,druid,restoration,12,1,11
Pesza,bloodscalp,96,druid,restoration,12,1,11
Griimmjjow,kazzak,96,druid,restoration,12,1,11
Fûzzybear,ravencrest,96,druid,restoration,12,1,11
Hecaloth,drakthul,96,druid,restoration,12,1,11
Meowmeowmeow,stormscale,96,druid,restoration,12,1,11
Келиса,blackscar,96,druid,restoration,12,1,11
Feminhacked,outland,96,druid,restoration,12,1,11
Чупакамра,gordunni,96,druid,restoration,12,1,11
Лапунька,gordunni,96,druid,restoration,12,1,11
Natur,gorgonnash,96,druid,restoration,12,1,11
Andonius,confrérie-du-thorium,96,druid,restoration,12,1,11
Nevthren,aggra-português,96,druid,restoration,12,1,11
Ra,stormscale,96,druid,restoration,12,1,11
Phëys,hyjal,96,druid,restoration,12,1,11
Napukka,silvermoon,96,druid,restoration,12,1,11
Svartvit,sylvanas,96,druid,restoration,12,1,11
Tafs,stormscale,96,druid,restoration,12,1,11
Drudd,hellscream,96,druid,restoration,12,1,11
Kittycatmeow,stormscale,96,druid,restoration,12,1,11
Aeyrine,archimonde,96,druid,restoration,12,1,11
Mariss25076F,chogall,96,druid,restoration,12,1,11
Püpply,antonidas,96,druid,restoration,12,1,11
Valfreya,nemesis,96,druid,restoration,12,1,11
Blark,sylvanas,96,druid,restoration,12,1,11
Avalora,the-maelstrom,96,druid,restoration,12,1,11
Blietmachine,ravencrest,96,druid,restoration,12,1,11
Anahots,silvermoon,96,druid,restoration,18,1,17
Raveous,tarren-mill,96,druid,restoration,18,1,17
Woolee,area-52,96,druid,restoration,18,1,17
Chijara,destromath,95,druid,restoration,6,1,5
Undomíel,antonidas,95,druid,restoration,6,1,5
Bëniheal,la-croisade-écarlate,95,druid,restoration,12,1,11
Lübka,amanthul,95,druid,restoration,12,1,11
Arayura,kirin-tor,95,druid,restoration,18,1,17
Acidbrate,aegwynn,90,druid,restoration,12,3,9
Jý,die-arguswacht,84,druid,restoration,17,4,13
Watchmymoon,blackrock,84,druid,restoration,20,4,16
Дарзамат,blackscar,79,druid,restoration,5,1,4
Sealife,destromath,79,druid,restoration,5,1,4
Tuskid,hellscream,79,druid,restoration,11,1,10
Bartige,blackmoore,73,druid,restoration,19,6,13
Mooji,darksorrow,66,druid,restoration,25,7,18
Rasserdruid,runetotem,63,druid,restoration,2,2,0
Jaykerlol,kazzak,48,druid,restoration,3,1,2
Shaolinkilla,ragnaros,48,druid,restoration,9,1,8
Iloveluci,ravencrest,42,druid,restoration,8,3,5
Quizdarude,draenor,42,druid,restoration,10,3,7
Mnee,steamwheedle-cartel,42,druid,restoration,7,2,5
Lamyty,antonidas,42,druid,restoration,8,2,6
Growlithe,hellfire,42,druid,restoration,8,2,6
Zedomeld,auchindoun,42,druid,restoration,8,2,6
Merawr,ravencrest,42,druid,restoration,8,2,6
Eceria,the-maelstrom,42,druid,restoration,9,2,7
Amadi,grim-batol,42,druid,restoration,9,2,7
Вокзи,gordunni,42,druid,restoration,9,2,7
Feráx,doomhammer,42,druid,restoration,9,2,7
Rédbullz,silvermoon,42,druid,restoration,9,2,7
Pornheal,drakthul,42,druid,restoration,10,2,8
Nytaleas,naxxramas,42,druid,restoration,10,2,8
Fâucon,eitrigg,42,druid,restoration,16,3,13
Uniquz,sylvanas,42,druid,restoration,11,2,9
Jimboza,stormscale,42,druid,restoration,11,2,9
Vanarea,argent-dawn,42,druid,restoration,14,2,12
Druiden,the-maelstrom,31,druid,restoration,2,1,1
Sendä,hyjal,31,druid,restoration,3,1,2
Bulleyo,ysondre,1588,druid,guardian,148,78,70
Djemdruid,argent-dawn,1585,druid,guardian,42,18,24
Сверххищникк,soulflayer,1409,druid,guardian,172,91,81
Sleepykitty,argent-dawn,1330,druid,guardian,211,97,114
Blacksagex,dragonmaw,1251,druid,guardian,129,50,79
Laracroft,the-maelstrom,1210,druid,guardian,28,14,14
Reshifted,sunstrider,1189,druid,guardian,155,74,81
Lioky,dun-modr,1184,druid,guardian,54,25,29
Windythemilf,stormscale,1180,druid,guardian,201,99,102
Вестхем,howling-fjord,1170,druid,guardian,108,52,56
Rbgbear,blackhand,1156,druid,guardian,36,15,21
Rapatera,argent-dawn,1115,druid,guardian,24,12,12
Avior,eonar,1022,druid,guardian,273,130,143
Durlehardu,archimonde,1018,druid,guardian,59,27,32
Микайо,goldrinn,986,druid,guardian,41,17,24
Crazydudu,tarren-mill,977,druid,guardian,68,25,43
Renaissancee,silvermoon,943,druid,guardian,68,21,47
Овлай,razuvious,894,druid,guardian,36,19,17
Ластгодх,soulflayer,885,druid,guardian,24,10,14
Avisa,blackhand,840,druid,guardian,174,78,96
Bigdomas,sylvanas,757,druid,guardian,52,21,31
Ноорру,gordunni,715,druid,guardian,11,8,3
Ксидронис,eversong,687,druid,guardian,22,8,14
Critter,kargath,661,druid,guardian,24,7,17
Гибрайт,soulflayer,623,druid,guardian,15,7,8
Fatalis,zuljin,573,druid,guardian,18,6,12
Beörñ,hyjal,568,druid,guardian,18,6,12
Win,hellscream,496,druid,guardian,23,7,16
Brisemeute,kirin-tor,480,druid,guardian,6,5,1
Tibaz,sylvanas,480,druid,guardian,12,5,7
Slotheron,ravencrest,480,druid,guardian,18,5,13
Гохгерункянк,soulflayer,477,druid,guardian,12,5,7
Sheâ,nemesis,476,druid,guardian,12,5,7
Kïnjuk,archimonde,475,druid,guardian,18,5,13
Xangy,drakthul,467,druid,guardian,22,8,14
Wildsoûl,kazzak,425,druid,guardian,27,6,21
Gimlis,area-52,384,druid,guardian,6,4,2
Tigerbear,argent-dawn,384,druid,guardian,12,4,8
Pabloskyn,sanguino,383,druid,guardian,6,4,2
Horizonline,terokkar,350,druid,guardian,11,4,7
Фэк,eversong,288,druid,guardian,6,3,3
Icxigo,silvermoon,288,druid,guardian,6,3,3
Pumpick,doomhammer,285,druid,guardian,13,3,10
Skwair,garona,192,druid,guardian,6,2,4
Astralcore,stormscale,192,druid,guardian,6,2,4
Pöcä,arakarahm,192,druid,guardian,6,2,4
Deppresso,tarren-mill,192,druid,guardian,6,2,4
Jebga,thrall,192,druid,guardian,6,2,4
Druidyy,exodar,192,druid,guardian,6,2,4
Sároman,ravencrest,192,druid,guardian,6,2,4
Justtrollîng,twisting-nether,192,druid,guardian,6,2,4
Zinister,hyjal,192,druid,guardian,6,2,4
Джирас,gordunni,192,druid,guardian,6,2,4
Bulldozerkin,ragnaros,192,druid,guardian,6,2,4
Kaynine,lightnings-blade,192,druid,guardian,6,2,4
Envidius,kazzak,192,druid,guardian,6,2,4
Фдру,eversong,192,druid,guardian,6,2,4
Kárrde,balnazzar,192,druid,guardian,6,2,4
Dualipas,outland,192,druid,guardian,6,2,4
Fynvola,anubarak,192,druid,guardian,12,2,10
Naeysea,argent-dawn,192,druid,guardian,12,2,10
Nwal,thunderhorn,192,druid,guardian,12,2,10
Beteralsjij,frostwhisper,192,druid,guardian,12,2,10
Mássive,darkmoon-faire,191,druid,guardian,18,2,16
Pure,kul-tiras,190,druid,guardian,15,3,12
Bierbär,theradras,159,druid,guardian,5,2,3
Zàphiirò,archimonde,159,druid,guardian,11,2,9
Leondir,quelthalas,96,druid,guardian,6,1,5
Plandros,draenor,96,druid,guardian,6,1,5
Almightydudu,draenor,96,druid,guardian,6,1,5
Pudseytree,doomhammer,96,druid,guardian,6,1,5
Жекакотик,eversong,96,druid,guardian,6,1,5
Monsterpuppy,magtheridon,96,druid,guardian,6,1,5
Murmétoile,chants-éternels,96,druid,guardian,6,1,5
Oõ,aggra-português,96,druid,guardian,6,1,5
Kaamirach,blackmoore,96,druid,guardian,6,1,5
Дудумейстер,howling-fjord,96,druid,guardian,6,1,5
Beduin,stormscale,96,druid,guardian,6,1,5
Túrnip,aerie-peak,96,druid,guardian,6,1,5
Cleandc,blackhand,96,druid,guardian,6,1,5
Anthlas,outland,96,druid,guardian,6,1,5
Kabuul,dun-modr,96,druid,guardian,6,1,5
Locass,blackrock,96,druid,guardian,6,1,5
Waldkuh,thrall,96,druid,guardian,12,1,11
Tjoepert,azjolnerub,95,druid,guardian,3,2,1
Silver,terokkar,42,druid,guardian,16,3,13
Brutaldamage,ravencrest,2343,druid,feral,148,82,66
Verycringe,ravencrest,2329,druid,feral,266,140,126
Cåssidy,archimonde,2297,druid,feral,108,61,47
Xercas,outland,2250,druid,feral,71,44,27
Lïved,nemesis,2248,druid,feral,153,91,62
Ktx,aegwynn,2238,druid,feral,84,50,34
Twinklex,ravencrest,2237,druid,feral,293,146,147
Vârima,ravencrest,2229,druid,feral,84,56,28
Ðevilwhite,nemesis,2220,druid,feral,120,66,54
Cataferal,ravencrest,2199,druid,feral,180,97,83
Mykk,ravencrest,2176,druid,feral,154,96,58
Mabkferal,ravencrest,2146,druid,feral,133,67,66
Elîas,kazzak,2141,druid,feral,77,45,32
Tûêsdäÿblûês,ravencrest,2134,druid,feral,136,70,66
Tael,elune,2119,druid,feral,120,60,60
Jakamx,ravencrest,2115,druid,feral,509,259,250
Mutaattori,sylvanas,2115,druid,feral,163,82,81
Houmrx,ravencrest,2113,druid,feral,173,89,84
Lïndalûnå,ravencrest,2113,druid,feral,210,107,103
Bloodyredlyx,ysera,2112,druid,feral,90,46,44
Öøöøöøöøöøöø,anachronos,2110,druid,feral,72,47,25
Shizën,bladefist,2109,druid,feral,92,52,40
Ромкабикстар,gordunni,2107,druid,feral,78,40,38
Animålz,archimonde,2101,druid,feral,90,48,42
Desenlace,ravencrest,2101,druid,feral,369,191,178
Tomyn,burning-legion,2075,druid,feral,78,46,32
Rubbershark,ravencrest,2074,druid,feral,253,150,103
Mmlprox,burning-legion,2068,druid,feral,151,76,75
Nekocat,ravencrest,2061,druid,feral,110,66,44
Bleêds,dun-modr,2061,druid,feral,60,35,25
Degmond,silvermoon,2061,druid,feral,246,127,119
Nìm,outland,2057,druid,feral,124,60,64
Трэвисдог,gordunni,2053,druid,feral,77,38,39
Zøte,ravencrest,2037,druid,feral,117,58,59
Uebiwe,silvermoon,2022,druid,feral,84,48,36
Rapatera,argent-dawn,2019,druid,feral,54,30,24
Trauller,outland,2013,druid,feral,84,41,43
Норланда,gordunni,2012,druid,feral,78,39,39
Yone,blackmoore,2011,druid,feral,131,68,63
Muckì,alleria,2003,druid,feral,102,55,47
Lxve,tarren-mill,1999,druid,feral,66,34,32
Опакот,howling-fjord,1997,druid,feral,82,40,42
Эриэс,gordunni,1987,druid,feral,208,110,98
Calaftayou,ravencrest,1974,druid,feral,114,52,62
Dashfull,ravencrest,1973,druid,feral,663,335,328
Wex,darksorrow,1970,druid,feral,48,32,16
Taladruide,archimonde,1967,druid,feral,186,91,95
Desenlace,silvermoon,1966,druid,feral,233,112,121
Gurranq,argent-dawn,1964,druid,feral,60,32,28
Bigangrycatx,ravencrest,1964,druid,feral,85,43,42
Crøwnd,twisting-nether,1962,druid,feral,66,37,29
Kàraba,archimonde,1962,druid,feral,172,88,84
Noxxìe,draenor,1962,druid,feral,230,116,114
Iminz,ravencrest,1961,druid,feral,349,168,181
Trøüpäx,outland,1955,druid,feral,123,61,62
Kaÿn,tarren-mill,1952,druid,feral,89,42,47
Nîîght,ravencrest,1950,druid,feral,108,54,54
Obeseferal,outland,1945,druid,feral,132,61,71
Mortality,proudmoore,1940,druid,feral,125,63,62
Purgatxry,ravencrest,1933,druid,feral,515,258,257
Jåkeferalta,outland,1923,druid,feral,161,85,76
Vãrima,ravencrest,1922,druid,feral,48,27,21
Fyrkax,aegwynn,1911,druid,feral,54,31,23
Фейкхехе,gordunni,1908,druid,feral,54,32,22
Ethryl,ravencrest,1905,druid,feral,219,113,106
Bigscarycatx,ravencrest,1901,druid,feral,57,31,26
Råbi,ravencrest,1896,druid,feral,57,25,32
Cocomojo,outland,1889,druid,feral,156,85,71
Kaldorei,nemesis,1888,druid,feral,163,85,78
Roska,archimonde,1882,druid,feral,72,34,38
Cocaqt,nemesis,1881,druid,feral,155,86,69
Garbagemonky,amanthul,1878,druid,feral,130,83,47
Kijan,silvermoon,1877,druid,feral,70,44,26
Themartyr,tarren-mill,1874,druid,feral,47,26,21
Khunahype,thrall,1873,druid,feral,60,39,21
Yesbody,tarren-mill,1871,druid,feral,54,26,28
Symbiosa,silvermoon,1870,druid,feral,30,20,10
Møonknight,ravencrest,1866,druid,feral,54,33,21
Mysticalmoon,ravencrest,1864,druid,feral,113,51,62
Cløwnferalx,argent-dawn,1863,druid,feral,66,29,37
Kokünomajo,kazzak,1861,druid,feral,42,34,8
Лардиан,gordunni,1859,druid,feral,84,45,39
Jhiun,ragnaros,1858,druid,feral,186,99,87
Jukeboks,silvermoon,1857,druid,feral,73,34,39
Shiftydruid,thunderhorn,1856,druid,feral,224,113,111
Блюгилли,ashenvale,1854,druid,feral,149,72,77
Djgírlßøssqt,argent-dawn,1851,druid,feral,198,95,103
Злодзейка,gordunni,1850,druid,feral,305,161,144
Nevercloneqt,argent-dawn,1849,druid,feral,95,49,46
Boostedbear,ragnaros,1848,druid,feral,65,30,35
Léxiny,blackrock,1846,druid,feral,35,23,12
Dureka,tarren-mill,1845,druid,feral,82,50,32
Kattenvoer,stormscale,1842,druid,feral,36,27,9
Melsson,stormreaver,1842,druid,feral,66,31,35
Shylovez,aegwynn,1841,druid,feral,67,32,35
Sleepykitty,argent-dawn,1838,druid,feral,443,228,215
Skatch,sylvanas,1836,druid,feral,54,28,26
Nainket,ravencrest,1836,druid,feral,84,41,43
Tyranderawr,ravencrest,1833,druid,feral,108,64,44
Февти,gordunni,1828,druid,feral,59,34,25
Skytek,silvermoon,1828,druid,feral,96,48,48
Køgèr,kazzak,1827,druid,feral,54,35,19
Indann,kazzak,1827,druid,feral,78,35,43
Annksunamún,ysondre,1824,druid,feral,279,152,127
Pilaf,emerald-dream,1824,druid,feral,227,113,114
Drbeef,sanguino,1823,druid,feral,45,28,17
Zelaron,twisting-nether,1823,druid,feral,42,22,20
Fürfur,ravencrest,1822,druid,feral,72,39,33
Нимир,soulflayer,1822,druid,feral,256,123,133
Reward,ragnaros,1819,druid,feral,64,30,34
Rheasilvià,silvermoon,1818,druid,feral,54,31,23
Flåppers,stormscale,1818,druid,feral,36,19,17
Kroñm,dun-modr,1818,druid,feral,60,25,35
Итильтириэль,gordunni,1817,druid,feral,311,155,156
Fendrïl,varimathras,1814,druid,feral,90,55,35
Nøfåmïly,silvermoon,1814,druid,feral,160,83,77
Raznos,ravencrest,1813,druid,feral,124,77,47
Moonkniight,ravencrest,1810,druid,feral,30,22,8
Nfxdruid,argent-dawn,1810,druid,feral,102,60,42
Furrykruger,the-maelstrom,1810,druid,feral,102,48,54
Alexmeow,ravencrest,1809,druid,feral,62,36,26
Leylå,ravencrest,1809,druid,feral,84,41,43
Lycal,chogall,1804,druid,feral,38,22,16
Caprïsun,archimonde,1804,druid,feral,42,24,18
Ratsimulator,tarren-mill,1802,druid,feral,54,32,22
Minaervea,antonidas,1802,druid,feral,162,77,85
Moskaros,turalyon,1800,druid,feral,156,80,76
Klaerke,tarren-mill,1800,druid,feral,93,42,51
Nzmdruid,burning-legion,1795,druid,feral,48,25,23
Фейк,howling-fjord,1795,druid,feral,54,26,28
Opresse,archimonde,1793,druid,feral,177,86,91
Ddru,ravencrest,1789,druid,feral,52,28,24
Buffshred,ravencrest,1785,druid,feral,30,21,9
Nouin,twisting-nether,1785,druid,feral,244,124,120
Goodtrip,hyjal,1782,druid,feral,95,56,39
Ålleyézoffme,ravencrest,1780,druid,feral,77,43,34
Eccology,silvermoon,1778,druid,feral,156,74,82
Kikihoux,ravencrest,1775,druid,feral,45,24,21
Facerippin,proudmoore,1775,druid,feral,128,65,63
Goldrax,outland,1774,druid,feral,60,32,28
Блиденг,gordunni,1767,druid,feral,117,59,58
Noé,aegwynn,1766,druid,feral,189,115,74
Dzandel,silvermoon,1766,druid,feral,644,320,324
Jarethy,dun-modr,1766,druid,feral,117,55,62
Каергорн,soulflayer,1766,druid,feral,54,19,35
Weyztwo,hyjal,1765,druid,feral,56,30,26
Bigcrazycatx,ravencrest,1762,druid,feral,132,59,73
Aendy,tarren-mill,1757,druid,feral,69,37,32
Hässelhoof,ragnaros,1757,druid,feral,180,84,96
Селфика,gordunni,1757,druid,feral,66,21,45
Verbxp,kazzak,1756,druid,feral,101,54,47
Paranoia,outland,1756,druid,feral,160,82,78
Fallken,burning-blade,1755,druid,feral,42,26,16
Tangela,stormreaver,1746,druid,feral,84,49,35
Bigpapad,ravencrest,1741,druid,feral,48,25,23
Elfsu,ravencrest,1740,druid,feral,106,54,52
Moldrokk,ravencrest,1739,druid,feral,52,31,21
Симбиозный,howling-fjord,1739,druid,feral,90,49,41
Грязныекогти,gordunni,1737,druid,feral,89,55,34
Babynaty,ravencrest,1735,druid,feral,108,51,57
Blvckðvitchz,ravencrest,1734,druid,feral,209,103,106
Шев,blackscar,1733,druid,feral,48,23,25
Apuasaatana,stormreaver,1731,druid,feral,36,20,16
Falláx,ravencrest,1731,druid,feral,46,24,22
Алексина,fordragon,1730,druid,feral,409,223,186
Catkovic,kult-der-verdammten,1730,druid,feral,59,28,31
Coineagan,frostmourne,1725,druid,feral,70,27,43
Varø,aegwynn,1722,druid,feral,41,22,19
Zechey,stormreaver,1721,druid,feral,30,18,12
Мелталиора,soulflayer,1720,druid,feral,71,33,38
Faded,stormreaver,1719,druid,feral,102,43,59
Zaibastus,doomhammer,1718,druid,feral,72,30,42
Pänthërä,ravencrest,1711,druid,feral,36,18,18
Laguna,ravencrest,1711,druid,feral,89,41,48
Frzx,stormscale,1710,druid,feral,84,41,43
Nîghtz,ravencrest,1708,druid,feral,39,22,17
Faveyo,die-nachtwache,1707,druid,feral,42,18,24
Даркедес,gordunni,1704,druid,feral,102,54,48
Texoria,twisting-nether,1704,druid,feral,234,123,111
Jamera,stormscale,1699,druid,feral,57,28,29
Bearmantlé,outland,1699,druid,feral,58,28,30
Хэрес,gordunni,1698,druid,feral,30,19,11
Zarc,stormreaver,1698,druid,feral,79,43,36
Worgenshiftr,kazzak,1697,druid,feral,48,21,27
Bomoth,kazzak,1696,druid,feral,66,36,30
Развалустоев,blackscar,1696,druid,feral,189,102,87
Апвель,gordunni,1694,druid,feral,42,20,22
Kouda,draenor,1694,druid,feral,122,58,64
Cyborgz,archimonde,1690,druid,feral,47,21,26
Scaleo,stormreaver,1689,druid,feral,133,71,62
Fückøff,ravencrest,1689,druid,feral,65,33,32
Natakis,blades-edge,1688,druid,feral,48,25,23
Loyoq,elune,1687,druid,feral,41,21,20
Doopdroo,tarren-mill,1687,druid,feral,48,20,28
Trevorkki,korgall,1686,druid,feral,98,50,48
Kittcatx,ravencrest,1684,druid,feral,44,25,19
Ôkeanos,blackhand,1683,druid,feral,70,36,34
Arfgtdispo,hyjal,1680,druid,feral,48,23,25
Drunosio,magtheridon,1678,druid,feral,187,93,94
Heyiamdan,tarren-mill,1677,druid,feral,313,169,144
Yaddas,draenor,1676,druid,feral,90,37,53
Jellytardx,outland,1675,druid,feral,75,41,34
Retzerbil,ravencrest,1675,druid,feral,46,23,23
Zifr,dalaran,1675,druid,feral,66,22,44
Crazydos,tarren-mill,1671,druid,feral,57,27,30
Adastroeolo,sanguino,1669,druid,feral,87,49,38
Nèxtløls,twisting-nether,1668,druid,feral,110,63,47
Aedui,tarren-mill,1668,druid,feral,38,20,18
Banzeye,nordrassil,1668,druid,feral,184,96,88
Ðrüid,ravencrest,1668,druid,feral,72,34,38
Gediminas,argent-dawn,1665,druid,feral,174,80,94
Biggestnick,ravencrest,1664,druid,feral,44,24,20
Xirxy,silvermoon,1664,druid,feral,48,20,28
Silksharp,ravencrest,1663,druid,feral,60,31,29
Nédith,archimonde,1663,druid,feral,48,22,26
Snky,perenolde,1662,druid,feral,23,18,5
Mbk,kazzak,1662,druid,feral,91,44,47
Jasperqt,silvermoon,1661,druid,feral,36,23,13
Rami,sylvanas,1661,druid,feral,171,86,85
Snapzy,sylvanas,1659,druid,feral,65,48,17
Emph,ravencrest,1659,druid,feral,66,38,28
Adabsurdum,kazzak,1659,druid,feral,124,55,69
Котосапенс,howling-fjord,1658,druid,feral,60,33,27
Phenova,sargeras,1658,druid,feral,164,73,91
Anatel,ravencrest,1657,druid,feral,48,19,29
Jabbari,outland,1656,druid,feral,335,169,166
Katzovic,kult-der-verdammten,1648,druid,feral,30,18,12
Житмедветь,booty-bay,1648,druid,feral,74,43,31
Juraci,forscherliga,1648,druid,feral,41,21,20
Jgltrainer,archimonde,1646,druid,feral,89,48,41
Ckelf,ravencrest,1646,druid,feral,42,18,24
Tacodudu,ravencrest,1645,druid,feral,48,32,16
Simdruid,stormscale,1641,druid,feral,36,19,17
Wucherwurzel,eredar,1640,druid,feral,142,67,75
Weedgras,eredar,1640,druid,feral,48,21,27
ßgøðx,argent-dawn,1639,druid,feral,85,47,38
Rottweiler,doomhammer,1639,druid,feral,338,177,161
Тёмныйзверь,borean-tundra,1639,druid,feral,365,186,179
Hugepepega,ravencrest,1638,druid,feral,66,37,29
Lenyl,dun-modr,1638,druid,feral,47,22,25
Andreddi,ravencrest,1632,druid,feral,90,39,51
Bernfried,silvermoon,1631,druid,feral,76,33,43
Ñøpe,ravencrest,1630,druid,feral,30,17,13
Fzx,aegwynn,1629,druid,feral,30,17,13
Moderntalkin,aegwynn,1628,druid,feral,47,23,24
Blakkowl,drakthul,1627,druid,feral,48,24,24
Avanah,silvermoon,1626,druid,feral,72,35,37
Redlung,outland,1626,druid,feral,41,19,22
Spale,twisting-nether,1622,druid,feral,86,43,43
Unoseeme,outland,1622,druid,feral,163,77,86
Neyok,blackrock,1619,druid,feral,50,26,24
Voreli,silvermoon,1619,druid,feral,48,20,28
Milovolond,ravencrest,1618,druid,feral,30,19,11
Djmeowxd,blackrock,1616,druid,feral,69,30,39
Yamkar,blackrock,1616,druid,feral,57,24,33
Nøkki,draenor,1615,druid,feral,75,39,36
Tilikum,stormscale,1615,druid,feral,459,224,235
Rayjinn,dun-modr,1613,druid,feral,36,17,19
Freyanah,argent-dawn,1612,druid,feral,128,54,74
Unreally,drakthul,1611,druid,feral,60,36,24
Zhosy,shattrath,1609,druid,feral,69,29,40
Panthéra,ravencrest,1608,druid,feral,361,184,177
Арбузег,gordunni,1607,druid,feral,184,95,89
Feytique,aegwynn,1607,druid,feral,59,30,29
Crisspurolss,ysondre,1605,druid,feral,73,38,35
Реалаг,howling-fjord,1604,druid,feral,47,20,27
Evilshade,ravencrest,1604,druid,feral,127,53,74
Акиша,deepholm,1602,druid,feral,44,21,23
Køgér,kazzak,1601,druid,feral,30,17,13
Chronoqtxd,ravencrest,1601,druid,feral,52,24,28
Clipsy,twilights-hammer,1600,druid,feral,553,279,274
Extracssion,ysondre,1600,druid,feral,146,71,75
Razoremperor,tarren-mill,1599,druid,feral,156,76,80
Bulan,ghostlands,1595,druid,feral,130,72,58
Ajwen,tarren-mill,1593,druid,feral,30,20,10
Фекаллис,soulflayer,1593,druid,feral,84,41,43
Frighton,ravencrest,1591,druid,feral,72,30,42
Triluxa,blackmoore,1587,druid,feral,64,31,33
Спудич,eversong,1586,druid,feral,91,39,52
Bikiniwochen,antonidas,1585,druid,feral,48,24,24
Féral,hyjal,1584,druid,feral,155,76,79
Narunis,tarren-mill,1584,druid,feral,114,54,60
Mooncarnatio,burning-legion,1584,druid,feral,72,29,43
Rbgbot,ragnaros,1583,druid,feral,63,35,28
Druidry,ragnaros,1583,druid,feral,143,77,66
Zurllyn,ravencrest,1583,druid,feral,115,56,59
Tonycatmeow,ravencrest,1582,druid,feral,30,18,12
Vëgâñgøðx,ragnaros,1582,druid,feral,170,90,80
Tani,kazzak,1580,druid,feral,93,49,44
Ringthaw,silvermoon,1578,druid,feral,54,24,30
Nasukka,grim-batol,1576,druid,feral,115,57,58
Sartipus,draenor,1575,druid,feral,48,24,24
Cjparker,archimonde,1575,druid,feral,98,47,51
Màz,blackmoore,1572,druid,feral,176,86,90
Asçdruid,kazzak,1572,druid,feral,56,24,32
Thørkang,dun-modr,1570,druid,feral,173,91,82
Lorucka,die-nachtwache,1567,druid,feral,30,18,12
Pitchou,karazhan,1567,druid,feral,94,46,48
Unguis,outland,1566,druid,feral,134,73,61
Notsad,dun-modr,1566,druid,feral,42,19,23
Yongala,archimonde,1565,druid,feral,66,35,31
Stopwatching,outland,1565,druid,feral,42,18,24
Риама,blackscar,1564,druid,feral,102,50,52
Saabeq,hyjal,1560,druid,feral,54,26,28
Fangornn,outland,1560,druid,feral,89,40,49
Skypinho,blackhand,1559,druid,feral,60,26,34
Ottur,argent-dawn,1558,druid,feral,220,106,114
Drylle,argent-dawn,1555,druid,feral,93,50,43
Chiwsy,outland,1554,druid,feral,88,45,43
Christàlyst,garona,1553,druid,feral,92,50,42
Tazdino,destromath,1553,druid,feral,60,22,38
Alessathrina,argent-dawn,1552,druid,feral,223,104,119
Cubswansón,outland,1550,druid,feral,85,46,39
Thecòntról,ravencrest,1547,druid,feral,87,52,35
Smuktøs,twisting-nether,1546,druid,feral,47,28,19
Eranor,archimonde,1542,druid,feral,170,87,83
Ipunishcatz,ravencrest,1540,druid,feral,182,86,96
Goodtrip,archimonde,1535,druid,feral,146,67,79
Benyameow,ravencrest,1534,druid,feral,30,17,13
Vlcák,drakthul,1534,druid,feral,446,227,219
Shyngodx,archimonde,1533,druid,feral,41,17,24
Бабакошка,gordunni,1532,druid,feral,35,19,16
Crtx,blackhand,1531,druid,feral,204,116,88
Dubakoo,outland,1531,druid,feral,91,49,42
Зонкс,gordunni,1530,druid,feral,122,63,59
Maccín,draenor,1530,druid,feral,52,18,34
Feralwilder,turalyon,1528,druid,feral,351,161,190
Eltroncazo,sanguino,1527,druid,feral,60,32,28
Runeclaws,twisting-nether,1522,druid,feral,30,18,12
Melondru,dun-modr,1522,druid,feral,54,27,27
Kabraxis,silvermoon,1522,druid,feral,66,32,34
Mooqt,alexstrasza,1517,druid,feral,55,31,24
Бобасик,fordragon,1517,druid,feral,138,70,68
Diow,elune,1517,druid,feral,60,24,36
Одряя,soulflayer,1515,druid,feral,172,92,80
Ramoly,kazzak,1513,druid,feral,54,30,24
Xilmai,darksorrow,1510,druid,feral,79,37,42
Psychodeliya,ragnaros,1510,druid,feral,54,17,37
Furmagic,tarren-mill,1508,druid,feral,107,52,55
Lunamimi,argent-dawn,1507,druid,feral,221,122,99
Sadskia,sanguino,1507,druid,feral,91,42,49
Jerrybeans,ravencrest,1504,druid,feral,120,57,63
Madeath,stormscale,1504,druid,feral,108,50,58
Calîmerô,blackrock,1500,druid,feral,24,18,6
Sìa,frostmane,1499,druid,feral,106,42,64
Zyhm,archimonde,1498,druid,feral,60,33,27
Оудин,blackscar,1492,druid,feral,65,31,34
Soofyan,kazzak,1491,druid,feral,158,70,88
Chexdruid,silvermoon,1489,druid,feral,52,21,31
Beckett,aszune,1487,druid,feral,69,31,38
Hkwoaf,chants-éternels,1487,druid,feral,47,18,29
Samian,turalyon,1486,druid,feral,30,16,14
Kattig,grim-batol,1485,druid,feral,68,31,37
Unlit,draenor,1484,druid,feral,138,69,69
Беконайзер,howling-fjord,1483,druid,feral,98,51,47
Мунпраид,gordunni,1483,druid,feral,198,98,100
Канвус,gordunni,1482,druid,feral,113,63,50
Annksunamun,ysondre,1482,druid,feral,46,23,23
Tàlented,aggra-português,1482,druid,feral,59,29,30
Линнер,lich-king,1482,druid,feral,60,28,32
Хагисс,booty-bay,1481,druid,feral,90,43,47
Naruh,ragnaros,1479,druid,feral,72,43,29
Fluffygoon,tarren-mill,1479,druid,feral,145,67,78
Chromaticx,argent-dawn,1478,druid,feral,183,98,85
Byet,kazzak,1478,druid,feral,42,17,25
Starkeknolle,blackmoore,1474,druid,feral,75,40,35
Chouan,marécage-de-zangar,1474,druid,feral,382,200,182
Äcajou,hyjal,1472,druid,feral,132,74,58
Carridwyn,argent-dawn,1472,druid,feral,108,51,57
Бритаякиска,gordunni,1470,druid,feral,42,23,19
Aestecias,blackhand,1467,druid,feral,30,16,14
Tyldormeow,tarren-mill,1465,druid,feral,281,141,140
Взп,gordunni,1465,druid,feral,72,34,38
Тётявискас,howling-fjord,1464,druid,feral,106,53,53
Larryburns,nathrezim,1462,druid,feral,134,67,67
Ponshü,hyjal,1461,druid,feral,51,30,21
Liptonbite,blackhand,1461,druid,feral,54,17,37
Zaethul,draenor,1460,druid,feral,32,21,11
Sekunden,ravencrest,1460,druid,feral,156,76,80
Bigdaddytate,kazzak,1459,druid,feral,95,53,42
Cörelly,ravencrest,1459,druid,feral,118,62,56
Mímír,frostmane,1457,druid,feral,51,23,28
Arlina,magtheridon,1454,druid,feral,57,26,31
Lemaromewmew,draenor,1453,druid,feral,34,18,16
Blacksagex,dragonmaw,1449,druid,feral,35,16,19
Baerminatør,blackrock,1449,druid,feral,84,38,46
Savvy,arthas,1449,druid,feral,36,16,20
Tanmax,blackmoore,1449,druid,feral,45,19,26
Hordezai,outland,1448,druid,feral,77,34,43
Zhényá,ravencrest,1447,druid,feral,42,22,20
Daddyßangz,das-konsortium,1446,druid,feral,52,24,28
Smellykitten,ravencrest,1445,druid,feral,36,18,18
Rollozuu,blackrock,1444,druid,feral,210,102,108
Nariah,silvermoon,1443,druid,feral,51,17,34
Kärmä,eldrethalas,1442,druid,feral,239,119,120
Oleander,zuljin,1442,druid,feral,226,112,114
Phïl,ravencrest,1442,druid,feral,192,94,98
Муумуумуу,howling-fjord,1438,druid,feral,325,159,166
ßußßo,ravencrest,1437,druid,feral,54,39,15
Chirnaruk,ravencrest,1437,druid,feral,84,42,42
Docmedlove,aegwynn,1437,druid,feral,36,15,21
Køda,blackrock,1437,druid,feral,80,33,47
Sølaria,kazzak,1435,druid,feral,36,15,21
Mònókox,eredar,1435,druid,feral,42,17,25
Erelae,twisting-nether,1434,druid,feral,103,53,50
Crinji,ravencrest,1433,druid,feral,24,15,9
Trusten,nemesis,1433,druid,feral,232,127,105
Boomzter,frostmane,1433,druid,feral,75,36,39
Vanhelsíng,dun-modr,1431,druid,feral,76,46,30
Скагуар,blackscar,1430,druid,feral,219,113,106
Фэк,eversong,1429,druid,feral,56,29,27
Cláire,stormscale,1427,druid,feral,48,24,24
Ripgødx,outland,1426,druid,feral,152,81,71
Arilíaxo,amanthul,1424,druid,feral,28,17,11
Epicplays,sylvanas,1424,druid,feral,142,76,66
Kasualx,stormscale,1424,druid,feral,93,48,45
Эскоф,gordunni,1424,druid,feral,289,148,141
Bløødberry,ravencrest,1423,druid,feral,36,18,18
Акетчи,howling-fjord,1421,druid,feral,130,72,58
Indräkah,dun-modr,1421,druid,feral,105,52,53
Tilac,proudmoore,1421,druid,feral,53,24,29
Thaelyy,drakthul,1421,druid,feral,90,40,50
Bagheera,archimonde,1420,druid,feral,137,66,71
Mervend,tarren-mill,1420,druid,feral,41,15,26
Ephixa,burning-legion,1419,druid,feral,47,23,24
Enock,hyjal,1418,druid,feral,34,18,16
Borja,malganis,1418,druid,feral,36,17,19
Everglow,argent-dawn,1417,druid,feral,503,252,251
Wingnutz,argent-dawn,1415,druid,feral,90,43,47
Ялория,azuregos,1412,druid,feral,36,16,20
Healníx,blackrock,1411,druid,feral,86,46,40
Муунфаер,gordunni,1410,druid,feral,97,44,53
Liqoú,tarren-mill,1409,druid,feral,60,35,25
Drudonja,silvermoon,1409,druid,feral,192,99,93
Lugtedyr,draenor,1408,druid,feral,88,43,45
Degentiuso,alakir,1405,druid,feral,96,53,43
Wadles,draenor,1405,druid,feral,64,34,30
Друличч,blackscar,1400,druid,feral,120,60,60
Luigina,blackmoore,1400,druid,feral,30,15,15
Phesxd,sylvanas,1400,druid,feral,60,29,31
Kodobursto,stormscale,1398,druid,feral,159,87,72
Bâbusch,blackmoore,1398,druid,feral,135,66,69
Hottad,tarren-mill,1397,druid,feral,174,96,78
Cheddar,tyrande,1397,druid,feral,111,57,54
Mimir,la-croisade-écarlate,1397,druid,feral,60,28,32
Picatso,blackrock,1395,druid,feral,30,15,15
Vancis,ravencrest,1394,druid,feral,111,58,53
Seyyid,archimonde,1394,druid,feral,36,18,18
Беркамп,howling-fjord,1394,druid,feral,158,74,84
Sÿlph,sylvanas,1393,druid,feral,180,92,88
Neshalry,blackhand,1392,druid,feral,36,16,20
Nspirit,ravencrest,1391,druid,feral,29,15,14
Nå,outland,1390,druid,feral,191,92,99
Котфилин,gordunni,1389,druid,feral,84,47,37
Сириль,soulflayer,1389,druid,feral,64,34,30
Legitx,dentarg,1385,druid,feral,43,17,26
Kømo,draenor,1384,druid,feral,36,19,17
Elitarian,argent-dawn,1384,druid,feral,345,173,172
Микайо,goldrinn,1383,druid,feral,219,104,115
Tsopúnisher,twisting-nether,1383,druid,feral,46,20,26
Carlitto,blackmoore,1382,druid,feral,33,23,10
Léxa,sunstrider,1382,druid,feral,41,17,24
Vargall,silvermoon,1380,druid,feral,47,26,21
Мумя,howling-fjord,1380,druid,feral,193,92,101
Donoz,ravencrest,1378,druid,feral,42,26,16
Рэво,gordunni,1377,druid,feral,30,18,12
Margueriti,the-maelstrom,1377,druid,feral,166,82,84
Ferøsse,hyjal,1376,druid,feral,54,27,27
Pipima,kazzak,1374,druid,feral,48,20,28
Droodae,hyjal,1373,druid,feral,59,33,26
Vèlla,silvermoon,1373,druid,feral,102,52,50
Tayløre,ysondre,1371,druid,feral,29,16,13
Soléda,thrall,1369,druid,feral,204,102,102
Сэднхорни,howling-fjord,1369,druid,feral,49,22,27
Migah,stormscale,1368,druid,feral,140,79,61
Chepochem,stormscale,1368,druid,feral,50,20,30
Stûnßîtêðêâð,ravencrest,1367,druid,feral,54,28,26
Enjoik,drakthul,1367,druid,feral,201,99,102
Hushorde,twisting-nether,1366,druid,feral,71,31,40
Sgourakoss,twilights-hammer,1363,druid,feral,42,20,22
Blintschiki,echsenkessel,1363,druid,feral,71,32,39
Niknikola,silvermoon,1362,druid,feral,54,23,31
Медверх,gordunni,1361,druid,feral,100,49,51
Nîchtsnutz,blackmoore,1361,druid,feral,65,29,36
Cruelbunny,nemesis,1359,druid,feral,78,32,46
Monchita,ravencrest,1357,druid,feral,42,19,23
Mônchô,sanguino,1356,druid,feral,130,74,56
Crow,saurfang,1356,druid,feral,182,90,92
Sløthy,uldum,1355,druid,feral,52,26,26
Dilleydank,ravencrest,1353,druid,feral,27,15,12
Tricklou,tarren-mill,1352,druid,feral,69,42,27
Koumma,archimonde,1352,druid,feral,265,133,132
Dijem,wildhammer,1351,druid,feral,116,66,50
Loryaayroll,stormscale,1349,druid,feral,42,17,25
Chinoiserie,aszune,1348,druid,feral,60,34,26
Moonpuff,kazzak,1346,druid,feral,74,45,29
Kajhan,silvermoon,1346,druid,feral,164,85,79
Treeflogger,ravencrest,1346,druid,feral,120,61,59
Darkcon,silvermoon,1346,druid,feral,72,28,44
Inuah,veknilash,1345,druid,feral,129,62,67
Vrisanaar,bladefist,1345,druid,feral,43,19,24
Паинтер,blackscar,1345,druid,feral,139,58,81
Nalaa,festung-der-stürme,1344,druid,feral,268,129,139
Tropicqt,ravencrest,1344,druid,feral,41,19,22
Snapeshifter,blackhand,1343,druid,feral,36,19,17
Bignik,tarren-mill,1343,druid,feral,30,14,16
Darkangelus,dethecus,1340,druid,feral,48,27,21
Ефомитстерша,gordunni,1339,druid,feral,36,17,19
Элисандра,gordunni,1338,druid,feral,72,38,34
Teám,tarren-mill,1338,druid,feral,54,21,33
Snøwden,twisting-nether,1337,druid,feral,48,27,21
Starasta,magtheridon,1335,druid,feral,30,14,16
Scumx,blackmoore,1333,druid,feral,24,14,10
Броодяга,razuvious,1333,druid,feral,77,29,48
Paws,dun-modr,1332,druid,feral,96,49,47
Tîma,blackmoore,1331,druid,feral,433,219,214
Stelthee,silvermoon,1329,druid,feral,84,40,44
Gonco,blackrock,1329,druid,feral,130,61,69
Kovlian,argent-dawn,1329,druid,feral,100,45,55
Liliolivia,outland,1327,druid,feral,24,14,10
Starliner,ravencrest,1326,druid,feral,36,14,22
Каиавасе,gordunni,1326,druid,feral,49,19,30
Lorya,kazzak,1324,druid,feral,66,30,36
Quikahn,outland,1323,druid,feral,30,14,16
Basedgôd,alakir,1321,druid,feral,24,14,10
Kalan,eredar,1321,druid,feral,60,29,31
Kimpine,kirin-tor,1320,druid,feral,247,125,122
Agè,stormscale,1320,druid,feral,140,63,77
Sethread,ragnaros,1319,druid,feral,36,14,22
Baccthana,auchindoun,1318,druid,feral,115,46,69
Lukeyferalxo,argent-dawn,1317,druid,feral,168,78,90
Ayahuàzka,dalaran,1317,druid,feral,84,35,49
Балаклаваа,soulflayer,1316,druid,feral,29,18,11
Yhavi,kazzak,1315,druid,feral,68,35,33
Deehe,thrall,1315,druid,feral,156,72,84
Эверблуми,howling-fjord,1314,druid,feral,64,27,37
Kardashìan,ravencrest,1312,druid,feral,25,14,11
Dadzeus,khaz-modan,1312,druid,feral,104,54,50
Tussenfryd,draenor,1312,druid,feral,283,138,145
Nightdruidcz,turalyon,1312,druid,feral,95,46,49
Liony,aegwynn,1311,druid,feral,47,24,23
Alcik,silvermoon,1310,druid,feral,133,49,84
Yoshia,shadowsong,1309,druid,feral,72,29,43
Majokz,ravencrest,1307,druid,feral,44,23,21
Рефикс,gordunni,1307,druid,feral,31,15,16
Hiio,ravencrest,1307,druid,feral,30,14,16
Ведмедив,blackscar,1307,druid,feral,96,44,52
Rustÿ,hyjal,1305,druid,feral,39,25,14
Tøktøk,blackhand,1305,druid,feral,24,14,10
Regelè,sylvanas,1305,druid,feral,86,45,41
Sabertoon,argent-dawn,1305,druid,feral,258,116,142
Âltashamane,elune,1304,druid,feral,47,23,24
Nuashoa,argent-dawn,1302,druid,feral,37,18,19
Shádynasty,silvermoon,1301,druid,feral,36,15,21
Jenelin,silvermoon,1300,druid,feral,34,15,19
Диаболус,gordunni,1299,druid,feral,68,33,35
Shàka,ravencrest,1299,druid,feral,29,14,15
Henessi,ragnaros,1299,druid,feral,62,27,35
Лякокля,soulflayer,1298,druid,feral,102,54,48
Nøwørnever,ulduar,1298,druid,feral,140,61,79
Miracoplixx,blackrock,1297,druid,feral,51,22,29
Drupal,argent-dawn,1295,druid,feral,89,45,44
Kindermaxii,ravencrest,1295,druid,feral,78,38,40
Eprophet,stormscale,1293,druid,feral,54,20,34
Nalreaa,kazzak,1292,druid,feral,32,17,15
Liya,ravencrest,1292,druid,feral,48,15,33
Ghettoven,kazzak,1290,druid,feral,93,45,48
Golddy,hyjal,1289,druid,feral,37,18,19
Turkus,draenor,1289,druid,feral,150,69,81
Bilis,nazjatar,1289,druid,feral,48,19,29
Oblivark,draenor,1287,druid,feral,36,17,19
Druidicmorr,sylvanas,1287,druid,feral,85,36,49
Levila,defias-brotherhood,1284,druid,feral,72,41,31
Laxmînken,sylvanas,1284,druid,feral,84,43,41
Minaye,hyjal,1282,druid,feral,46,22,24
Zitusk,ragnaros,1279,druid,feral,100,46,54
Darrkseid,kazzak,1278,druid,feral,30,17,13
Symbiosîs,stormscale,1276,druid,feral,96,44,52
Storslev,stormscale,1274,druid,feral,222,100,122
Garfield,uldum,1273,druid,feral,65,35,30
Хокан,deepholm,1271,druid,feral,31,15,16
Cayía,ravencrest,1271,druid,feral,44,20,24
Manoestouro,draenor,1267,druid,feral,60,22,38
Owling,antonidas,1266,druid,feral,126,70,56
Noobbiiee,silvermoon,1266,druid,feral,60,32,28
Котпартизан,gordunni,1266,druid,feral,54,26,28
Hornet,sanguino,1264,druid,feral,48,27,21
Криашин,goldrinn,1264,druid,feral,105,47,58
Whizkazz,ravencrest,1261,druid,feral,51,28,23
Cleandc,blackhand,1260,druid,feral,40,24,16
Koffee,archimonde,1259,druid,feral,48,23,25
Iloveadriana,kiljaeden,1258,druid,feral,60,29,31
Shinshìva,twisting-nether,1255,druid,feral,211,107,104
Naturalie,silvermoon,1255,druid,feral,78,31,47
Pepeja,doomhammer,1253,druid,feral,24,15,9
Croucher,shattrath,1253,druid,feral,172,78,94
Malfyurion,ragnaros,1252,druid,feral,256,128,128
Dougi,argent-dawn,1252,druid,feral,60,28,32
Liionheart,khaz-modan,1250,druid,feral,66,34,32
Herten,tarren-mill,1249,druid,feral,36,15,21
Ferrariferal,nethersturm,1248,druid,feral,18,13,5
Aliiass,drakthul,1248,druid,feral,99,57,42
Fyrka,aegwynn,1248,druid,feral,24,13,11
Flufie,alexstrasza,1248,druid,feral,27,14,13
Bignoober,blackrock,1248,druid,feral,29,13,16
Hydorn,cthun,1248,druid,feral,92,39,53
Collnaris,ravencrest,1247,druid,feral,38,22,16
Асония,deathguard,1247,druid,feral,30,13,17
Weedum,kazzak,1246,druid,feral,36,14,22
Druiidou,dalaran,1246,druid,feral,36,13,23
Grimgoor,burning-legion,1245,druid,feral,148,76,72
Malfurryon,drakthul,1245,druid,feral,78,38,40
Shaggery,stormscale,1245,druid,feral,99,43,56
Malvakten,kazzak,1244,druid,feral,31,17,14
Shifabull,kazzak,1244,druid,feral,75,38,37
Råèkwøñ,ravencrest,1243,druid,feral,28,14,14
Shifthappens,dun-modr,1242,druid,feral,24,13,11
Shiningztar,twisting-nether,1240,druid,feral,59,33,26
Hecky,xavius,1240,druid,feral,30,15,15
Ssaaff,outland,1240,druid,feral,36,15,21
Jxst,tarren-mill,1240,druid,feral,54,21,33
Righttwix,blackrock,1239,druid,feral,24,13,11
Salseo,uldum,1239,druid,feral,33,14,19
Speedlebee,malganis,1239,druid,feral,95,40,55
Filiduttkatt,ravencrest,1235,druid,feral,24,13,11
Кеорл,gordunni,1234,druid,feral,108,46,62
Krekigaadzre,draenor,1231,druid,feral,67,36,31
Deviantdruid,tarren-mill,1231,druid,feral,39,20,19
Hàlunkè,eredar,1230,druid,feral,24,13,11
Weydjin,garona,1230,druid,feral,36,17,19
Катяблум,gordunni,1230,druid,feral,30,13,17
Bâlou,nathrezim,1229,druid,feral,42,18,24
Andros,arathor,1229,druid,feral,42,15,27
Ganjeez,kazzak,1228,druid,feral,94,39,55
Whísperclaw,ravencrest,1226,druid,feral,41,21,20
Смизм,gordunni,1225,druid,feral,50,26,24
Kintax,drakthul,1223,druid,feral,139,74,65
Dawodz,archimonde,1222,druid,feral,38,16,22
Webla,blackmoore,1221,druid,feral,59,28,31
Taigarus,aerie-peak,1220,druid,feral,84,39,45
Jdogger,tarren-mill,1219,druid,feral,24,13,11
Aøn,silvermoon,1219,druid,feral,92,42,50
Infêrno,twisting-nether,1218,druid,feral,46,19,27
Jaghut,burning-legion,1217,druid,feral,72,38,34
Лорья,azuregos,1217,druid,feral,36,13,23
Шонгу,soulflayer,1215,druid,feral,88,38,50
Noyake,ragnaros,1214,druid,feral,60,28,32
Azmerloth,antonidas,1214,druid,feral,36,13,23
Moonglade,deathwing,1214,druid,feral,39,14,25
Defløwer,aegwynn,1213,druid,feral,42,21,21
Pitý,kaelthas,1213,druid,feral,41,13,28
Putzé,blackrock,1209,druid,feral,36,22,14
Impertinent,outland,1209,druid,feral,86,42,44
Нуаду,gordunni,1208,druid,feral,205,93,112
Cøcøpøpsmøke,archimonde,1208,druid,feral,48,21,27
Naetsch,blackrock,1208,druid,feral,56,21,35
Lorcàn,argent-dawn,1204,druid,feral,121,57,64
Aniprimal,auchindoun,1202,druid,feral,34,19,15
Kirmelastas,kazzak,1201,druid,feral,128,62,66
Dirtyfantasy,alakir,1199,druid,feral,66,36,30
Xqeon,blackrock,1199,druid,feral,90,46,44
Azenoir,ravencrest,1199,druid,feral,39,14,25
Devonshira,ravencrest,1198,druid,feral,36,14,22
Biffsteak,blackhand,1196,druid,feral,422,204,218
Naheliaqt,outland,1195,druid,feral,30,14,16
Kyoshî,blackmoore,1194,druid,feral,327,165,162
Богарт,soulflayer,1193,druid,feral,24,14,10
Slaaya,ravencrest,1193,druid,feral,30,15,15
Dudeimgodly,ravencrest,1190,druid,feral,54,16,38
Womanhood,ravencrest,1188,druid,feral,42,13,29
Шэйпшифт,fordragon,1187,druid,feral,124,52,72
Icqnot,arthas,1187,druid,feral,36,13,23
Snootxt,blackmoore,1185,druid,feral,54,23,31
Класк,gordunni,1183,druid,feral,36,19,17
Nerta,outland,1180,druid,feral,42,16,26
Mérias,archimonde,1180,druid,feral,42,13,29
Millenia,darkmoon-faire,1179,druid,feral,197,99,98
Zethane,ragnaros,1178,druid,feral,66,29,37
Veggiepro,uldum,1178,druid,feral,36,13,23
Blacknight,aggramar,1176,druid,feral,69,28,41
Ildrin,ragnaros,1173,druid,feral,36,20,16
Zaltaruk,sanguino,1173,druid,feral,263,131,132
Maaghera,silvermoon,1172,druid,feral,503,252,251
Cemiink,drakthul,1170,druid,feral,28,13,15
Менстряк,howling-fjord,1165,druid,feral,58,25,33
Swagmode,draenor,1164,druid,feral,67,40,27
Tranduiil,drakthul,1164,druid,feral,150,84,66
Larkos,grim-batol,1164,druid,feral,159,82,77
Tróllinger,blackrock,1164,druid,feral,51,24,27
Yorashi,blackhand,1162,druid,feral,42,27,15
Bloodrotten,silvermoon,1161,druid,feral,78,29,49
Papan,sylvanas,1158,druid,feral,90,48,42
Йванныч,gordunni,1157,druid,feral,85,38,47
Yøløswag,naxxramas,1156,druid,feral,192,103,89
Kageioshi,kazzak,1156,druid,feral,139,72,67
Mgelolaf,doomhammer,1155,druid,feral,54,27,27
Snkyferalmov,aegwynn,1152,druid,feral,18,12,6
Rszn,ravencrest,1152,druid,feral,30,12,18
Howtonio,archimonde,1151,druid,feral,18,12,6
Zbear,kazzak,1151,druid,feral,36,16,20
Sùmmèrz,ravencrest,1150,druid,feral,30,12,18
Mistic,twisting-nether,1149,druid,feral,85,46,39
Amandial,silvermoon,1149,druid,feral,30,12,18
Kittyrawr,silvermoon,1148,druid,feral,30,12,18
Holditorsken,grim-batol,1147,druid,feral,30,15,15
Mavne,outland,1147,druid,feral,24,12,12
Frs,bladefist,1147,druid,feral,30,12,18
Tibozx,stormscale,1146,druid,feral,36,21,15
Nightfáll,tarren-mill,1146,druid,feral,107,46,61
Ra,stormscale,1145,druid,feral,24,12,12
Veryfast,blackhand,1142,druid,feral,24,12,12
Gatínho,ravencrest,1140,druid,feral,18,12,6
Xoat,marécage-de-zangar,1140,druid,feral,30,12,18
Maylon,darksorrow,1137,druid,feral,125,56,69
Reawen,drakthul,1137,druid,feral,74,29,45
Jinxaran,culte-de-la-rive-noire,1135,druid,feral,36,12,24
Ashan,kirin-tor,1134,druid,feral,124,62,62
Battleray,twisting-nether,1134,druid,feral,99,49,50
Vicendius,drakthul,1132,druid,feral,60,29,31
Jaxtn,tarren-mill,1132,druid,feral,58,25,33
Mickayøyø,khaz-modan,1132,druid,feral,48,13,35
Catbear,kazzak,1130,druid,feral,30,14,16
Progodd,silvermoon,1129,druid,feral,126,64,62
Шйшка,gordunni,1129,druid,feral,92,33,59
Skywíng,stormscale,1128,druid,feral,48,19,29
Bgam,ravencrest,1126,druid,feral,24,17,7
Carldroid,sylvanas,1126,druid,feral,40,22,18
Михася,gordunni,1125,druid,feral,29,13,16
Кыцко,soulflayer,1124,druid,feral,24,12,12
Arnwaald,kaelthas,1123,druid,feral,66,32,34
Терамин,howling-fjord,1119,druid,feral,46,20,26
Bozidarka,burning-legion,1119,druid,feral,30,12,18
Zeyne,ravencrest,1117,druid,feral,48,21,27
Dash,the-maelstrom,1116,druid,feral,30,13,17
Kidabductorx,draenor,1116,druid,feral,42,16,26
Dulidica,tarren-mill,1115,druid,feral,52,25,27
Taco,eredar,1115,druid,feral,67,22,45
Phike,blackrock,1114,druid,feral,24,12,12
Flippintwit,quelthalas,1113,druid,feral,42,15,27
Twyty,khaz-modan,1112,druid,feral,193,91,102
Sashika,shattrath,1112,druid,feral,70,31,39
Naxfae,argent-dawn,1112,druid,feral,60,23,37
Tl,archimonde,1110,druid,feral,175,83,92
Ivìs,nemesis,1110,druid,feral,140,62,78
Mordpaw,stormscale,1110,druid,feral,32,13,19
Кайтилир,blackscar,1109,druid,feral,58,29,29
Almuntaqim,ravencrest,1103,druid,feral,29,12,17
Rapuun,kult-der-verdammten,1102,druid,feral,27,13,14
Брэмблс,soulflayer,1099,druid,feral,50,26,24
Арвелл,gordunni,1099,druid,feral,30,13,17
Carakal,outland,1099,druid,feral,104,43,61
Käissi,blackmoore,1098,druid,feral,66,29,37
Leidbulle,blackrock,1098,druid,feral,48,18,30
Lemmí,frostwolf,1096,druid,feral,66,29,37
Bæghira,draenor,1095,druid,feral,100,55,45
Мукару,howling-fjord,1094,druid,feral,48,26,22
Mîyukí,ravencrest,1094,druid,feral,48,23,25
Zivertgodx,argent-dawn,1093,druid,feral,48,23,25
Niowën,ragnaros,1093,druid,feral,39,17,22
Nicos,elune,1091,druid,feral,29,13,16
Vidlna,outland,1091,druid,feral,72,32,40
Chichisosa,ysondre,1090,druid,feral,33,12,21
Йонарк,gordunni,1087,druid,feral,41,20,21
Teacherr,quelthalas,1087,druid,feral,122,50,72
Greengünter,blackmoore,1086,druid,feral,22,12,10
Rootznloots,draenor,1082,druid,feral,48,26,22
Feraligator,sanguino,1081,druid,feral,180,84,96
Hermetic,turalyon,1080,druid,feral,208,101,107
Zokix,doomhammer,1080,druid,feral,95,46,49
Emrys,teldrassil,1080,druid,feral,59,17,42
Спэкк,gordunni,1077,druid,feral,101,45,56
Clawdiá,silvermoon,1076,druid,feral,116,59,57
Derzis,eonar,1076,druid,feral,81,39,42
Lirtiasan,forscherliga,1075,druid,feral,30,15,15
Sherkàn,dalaran,1074,druid,feral,43,24,19
Domänia,onyxia,1073,druid,feral,60,22,38
Blazoor,frostwolf,1072,druid,feral,58,29,29
Tombenuit,tarren-mill,1072,druid,feral,24,12,12
Taatz,stormscale,1066,druid,feral,45,28,17
Eternas,elune,1066,druid,feral,124,60,64
Mcservietsky,chogall,1066,druid,feral,72,24,48
Lakaport,dun-modr,1064,druid,feral,84,35,49
Denadu,turalyon,1064,druid,feral,167,65,102
Herbstkind,frostmourne,1063,druid,feral,89,35,54
Isaye,archimonde,1060,druid,feral,290,134,156
Plazmo,ravencrest,1056,druid,feral,18,11,7
Sumecx,aegwynn,1056,druid,feral,18,11,7
Vahid,antonidas,1055,druid,feral,12,11,1
Harryharrt,veknilash,1055,druid,feral,54,26,28
Garoh,dalaran,1055,druid,feral,24,11,13
Salviaf,silvermoon,1055,druid,feral,94,43,51
Belsebub,ravencrest,1055,druid,feral,30,11,19
Pølymorphe,ysondre,1055,druid,feral,30,11,19
Alimona,the-venture-co,1055,druid,feral,50,14,36
Wizzlafa,ravencrest,1054,druid,feral,18,11,7
Fruit,outland,1054,druid,feral,18,11,7
Ashtral,kazzak,1054,druid,feral,24,11,13
Wildmushroom,drakthul,1054,druid,feral,41,12,29
Mudpie,stormscale,1053,druid,feral,79,34,45
Bearmeister,kazzak,1052,druid,feral,30,11,19
Lenzork,thrall,1051,druid,feral,30,11,19
Togara,kazzak,1050,druid,feral,30,11,19
Tsajj,stormreaver,1049,druid,feral,63,34,29
Laek,chogall,1047,druid,feral,36,11,25
Huginmuninn,outland,1046,druid,feral,54,28,26
Maethar,stormrage,1046,druid,feral,30,11,19
Muffinjump,outland,1044,druid,feral,98,44,54
Ilsydur,shadowsong,1044,druid,feral,47,13,34
Growshax,nerzhul,1043,druid,feral,20,13,7
Exïlla,archimonde,1043,druid,feral,24,11,13
Dracaan,boulderfist,1041,druid,feral,18,11,7
Fyralion,silvermoon,1041,druid,feral,35,15,20
Skyreapa,burning-legion,1039,druid,feral,67,27,40
Janjalism,silvermoon,1038,druid,feral,105,57,48
Jamaican,outland,1038,druid,feral,78,33,45
Bäkø,dun-modr,1038,druid,feral,36,13,23
Mauzicek,drakthul,1037,druid,feral,60,29,31
Druul,frostwolf,1037,druid,feral,30,11,19
Aggoth,drakthul,1035,druid,feral,24,11,13
Exortas,kazzak,1035,druid,feral,130,58,72
Ripndip,eredar,1033,druid,feral,112,55,57
Melfir,dun-modr,1033,druid,feral,46,17,29
Kermit,die-aldor,1032,druid,feral,81,32,49
Bomchickawah,antonidas,1031,druid,feral,30,11,19
Kynji,twisting-nether,1030,druid,feral,170,78,92
Cheeselake,blackmoore,1029,druid,feral,20,11,9
Quentalius,argent-dawn,1029,druid,feral,24,11,13
Tastyrawr,blackhand,1029,druid,feral,24,11,13
Ивантяй,gordunni,1026,druid,feral,24,11,13
Hetalia,culte-de-la-rive-noire,1025,druid,feral,24,13,11
Dooferdudu,azshara,1023,druid,feral,33,11,22
Hönör,ysondre,1021,druid,feral,189,91,98
Morfâns,ragnaros,1021,druid,feral,84,40,44
Almightydudu,draenor,1021,druid,feral,30,12,18
Amoonaa,kazzak,1020,druid,feral,54,28,26
Whiterun,pozzo-delleternità,1020,druid,feral,31,13,18
Muucat,twisting-nether,1019,druid,feral,35,11,24
Астраджет,gordunni,1017,druid,feral,18,11,7
Форресинг,gordunni,1014,druid,feral,46,15,31
Boombassador,stormscale,1012,druid,feral,36,20,16
Phanterus,chamber-of-aspects,1012,druid,feral,24,11,13
Chlambak,archimonde,1009,druid,feral,30,17,13
Loserforever,archimonde,1008,druid,feral,15,12,3
Snupy,outland,1007,druid,feral,23,11,12
Knææl,argent-dawn,1006,druid,feral,68,28,40
Cyriaan,eredar,1005,druid,feral,23,11,12
Smittly,bloodhoof,1005,druid,feral,58,23,35
Ytzù,archimonde,1004,druid,feral,17,11,6
Пивч,soulflayer,1002,druid,feral,33,12,21
Glanis,malorne,1002,druid,feral,76,27,49
Descendance,ysondre,1001,druid,feral,115,58,57
Агнотар,soulflayer,1000,druid,feral,36,15,21
Grynoth,silvermoon,1000,druid,feral,36,14,22
Poxu,eredar,998,druid,feral,59,22,37
Неваляка,gordunni,997,druid,feral,23,11,12
Ezpire,ravencrest,997,druid,feral,99,43,56
Жекакотик,eversong,995,druid,feral,198,98,100
Dohn,ravencrest,991,druid,feral,20,11,9
Nkoyi,argent-dawn,991,druid,feral,120,57,63
Trikill,hyjal,990,druid,feral,55,19,36
Snorlaxza,ravencrest,987,druid,feral,35,13,22
Kratzbeiß,blackmoore,986,druid,feral,69,25,44
Друлевой,greymane,984,druid,feral,30,15,15
Shymä,hyjal,982,druid,feral,163,69,94
Rubmyclaws,burning-legion,981,druid,feral,19,11,8
Rakuy,thrall,981,druid,feral,27,11,16
Bumsbert,teldrassil,980,druid,feral,60,32,28
Tierundelfee,outland,966,druid,feral,21,12,9
Druidou,kaelthas,964,druid,feral,88,35,53
Eljinso,blackhand,963,druid,feral,24,14,10
Tharuun,teldrassil,961,druid,feral,36,12,24
Ryseqt,nemesis,960,druid,feral,12,10,2
Tjxaxa,ravencrest,960,druid,feral,12,10,2
Aliyxo,aegwynn,960,druid,feral,15,11,4
Jincksdruid,anachronos,960,druid,feral,18,10,8
Оссава,blackscar,960,druid,feral,18,10,8
Hccl,blackhand,960,druid,feral,18,10,8
Tatabomba,archimonde,960,druid,feral,102,50,52
Fuzzylol,haomarush,960,druid,feral,24,10,14
Suggly,ysondre,959,druid,feral,18,10,8
Mikor,aegwynn,959,druid,feral,18,10,8
Beerista,tarren-mill,959,druid,feral,24,11,13
Luphrekfurry,ysondre,959,druid,feral,24,10,14
Hahafun,ravencrest,959,druid,feral,24,10,14
Колайна,gordunni,959,druid,feral,24,10,14
Cyph,shadowsong,958,druid,feral,18,10,8
Dipz,frostwolf,958,druid,feral,18,10,8
Nefertiti,baelgun,958,druid,feral,30,10,20
Трясишатай,gordunni,958,druid,feral,30,10,20
Chikiz,ghostlands,957,druid,feral,18,10,8
Sadasch,dun-morogh,956,druid,feral,66,20,46
Corrupthz,outland,955,druid,feral,24,10,14
Zjukov,ragnaros,955,druid,feral,24,10,14
Твойбарсик,gordunni,955,druid,feral,54,14,40
Pointlez,frostmane,954,druid,feral,24,10,14
Мехнакиске,howling-fjord,954,druid,feral,25,10,15
Kîñg,tarren-mill,952,druid,feral,136,68,68
Xhenon,dun-modr,951,druid,feral,24,10,14
Aubenuit,dalaran,950,druid,feral,30,10,20
Rellena,khaz-modan,948,druid,feral,69,32,37
Ультраафина,gordunni,946,druid,feral,24,10,14
Маветт,blackscar,945,druid,feral,116,56,60
Жора,borean-tundra,943,druid,feral,24,10,14
Plingan,argent-dawn,942,druid,feral,23,10,13
Реептилоид,soulflayer,942,druid,feral,24,10,14
Ðexteroth,sanguino,940,druid,feral,30,15,15
Wuzzington,outland,940,druid,feral,24,10,14
Papricat,kazzak,938,druid,feral,34,19,15
Храмнир,soulflayer,937,druid,feral,39,17,22
Blackwoodoo,kazzak,932,druid,feral,72,33,39
Hadesx,blackhand,931,druid,feral,76,37,39
Xpe,drakthul,931,druid,feral,42,12,30
Bimoon,archimonde,929,druid,feral,46,24,22
Sìíta,dun-modr,929,druid,feral,42,14,28
Беррсс,gordunni,929,druid,feral,80,24,56
Sorron,blades-edge,926,druid,feral,36,19,17
Álex,anachronos,924,druid,feral,122,49,73
Леминвинкс,eversong,920,druid,feral,30,17,13
Pawclaw,ragnaros,917,druid,feral,60,32,28
Élmunia,ravencrest,915,druid,feral,82,39,43
Teddîursa,kazzak,915,druid,feral,34,10,24
Zhabka,silvermoon,913,druid,feral,105,53,52
Ìncubus,pozzo-delleternità,912,druid,feral,26,11,15
Lutis,magtheridon,911,druid,feral,144,65,79
Zâtok,kargath,908,druid,feral,48,19,29
Verbat,cthun,906,druid,feral,52,28,24
Migalo,outland,906,druid,feral,29,12,17
Klatro,terokkar,904,druid,feral,179,90,89
Muryo,der-rat-von-dalaran,903,druid,feral,90,34,56
Gató,kazzak,899,druid,feral,32,11,21
Saltow,archimonde,899,druid,feral,64,19,45
Bislait,archimonde,896,druid,feral,66,24,42
Lohki,eredar,895,druid,feral,21,12,9
Джирас,gordunni,894,druid,feral,80,36,44
Jooriell,defias-brotherhood,893,druid,feral,42,21,21
Furryrawr,silvermoon,889,druid,feral,30,11,19
Djarda,deathwing,888,druid,feral,36,11,25
Asarune,hyjal,886,druid,feral,32,16,16
Neischa,das-konsortium,886,druid,feral,48,21,27
Muju,stormscale,885,druid,feral,89,46,43
Mpounia,twilights-hammer,884,druid,feral,131,62,69
Loafy,the-maelstrom,884,druid,feral,94,39,55
Maräanhatähr,silvermoon,881,druid,feral,48,15,33
Deathzee,kazzak,879,druid,feral,71,35,36
Эвгедент,deathguard,877,druid,feral,42,15,27
Stéely,ravencrest,876,druid,feral,45,24,21
Phandris,argent-dawn,876,druid,feral,103,51,52
Кошикк,azuregos,875,druid,feral,22,10,12
Фаллендэл,gordunni,873,druid,feral,67,31,36
Горртек,howling-fjord,873,druid,feral,69,31,38
Béar,arathor,870,druid,feral,76,28,48
Urfi,tyrande,864,druid,feral,12,9,3
Lolhaha,ravencrest,864,druid,feral,18,9,9
Paramore,outland,864,druid,feral,18,9,9
Dragonferal,tarren-mill,864,druid,feral,18,9,9
Leylajr,ravencrest,864,druid,feral,18,9,9
Sixmonthbann,ravencrest,864,druid,feral,18,9,9
Aleatório,grim-batol,864,druid,feral,18,9,9
Rímeru,blackmoore,864,druid,feral,18,9,9
Rysejr,nemesis,864,druid,feral,18,9,9
Epikeks,blackmoore,863,druid,feral,16,10,6
Nicodruid,ravencrest,863,druid,feral,18,9,9
Fíja,blackmoore,863,druid,feral,18,9,9
Borknagar,thrall,863,druid,feral,18,9,9
Rbg,dun-modr,863,druid,feral,22,10,12
Àzà,dun-modr,863,druid,feral,21,9,12
Пиггипоп,soulflayer,863,druid,feral,24,9,15
Røxxy,silvermoon,863,druid,feral,24,9,15
Druipa,sylvanas,863,druid,feral,24,9,15
Олежасутра,howling-fjord,863,druid,feral,30,9,21
Erenalby,draenor,862,druid,feral,18,9,9
Мунфайр,galakrond,862,druid,feral,18,9,9
Кецян,gordunni,862,druid,feral,19,9,10
Крофтт,goldrinn,861,druid,feral,12,9,3
Currare,aegwynn,861,druid,feral,18,9,9
Буйныйкот,gordunni,861,druid,feral,24,9,15
Jeezuschrist,archimonde,861,druid,feral,24,9,15
Dunya,kazzak,860,druid,feral,24,9,15
Caèlas,outland,859,druid,feral,18,9,9
Hadespool,sanguino,859,druid,feral,24,9,15
Harbis,silvermoon,859,druid,feral,24,9,15
Бруан,gordunni,859,druid,feral,24,9,15
Bigbear,stormrage,858,druid,feral,31,12,19
Feralzeus,sylvanas,858,druid,feral,24,9,15
Плагиат,grom,858,druid,feral,36,10,26
Cboi,aegwynn,857,druid,feral,24,9,15
Wathen,argent-dawn,857,druid,feral,34,12,22
Toaa,antonidas,857,druid,feral,30,9,21
Gámóra,argent-dawn,856,druid,feral,18,9,9
Arntooth,burning-legion,856,druid,feral,94,39,55
Nitro,kazzak,856,druid,feral,24,9,15
Мегасв,gordunni,856,druid,feral,24,9,15
Izumy,quelthalas,856,druid,feral,47,16,31
Wainl,hyjal,854,druid,feral,30,9,21
Мендея,gordunni,853,druid,feral,18,9,9
Afta,ysondre,850,druid,feral,18,9,9
Envidius,kazzak,849,druid,feral,19,9,10
Elyrasin,argent-dawn,848,druid,feral,84,32,52
Woodflower,silvermoon,847,druid,feral,30,9,21
Frökensuss,stormscale,844,druid,feral,27,12,15
Hwearingkid,ravencrest,842,druid,feral,96,40,56
Tsill,archimonde,839,druid,feral,30,9,21
Ziovris,silvermoon,839,druid,feral,33,9,24
Miukïna,archimonde,837,druid,feral,12,9,3
Catsgomeow,outland,833,druid,feral,29,9,20
Брэвно,gordunni,830,druid,feral,26,10,16
Elarya,ragnaros,829,druid,feral,20,10,10
Itzferal,durotan,820,druid,feral,20,9,11
Зенза,howling-fjord,815,druid,feral,27,9,18
Sôalôgel,blackrock,813,druid,feral,21,9,12
Eivy,frostmane,813,druid,feral,103,37,66
Zulazain,bladefist,806,druid,feral,120,47,73
Düldül,kargath,781,druid,feral,240,113,127
Shadøwdruid,silvermoon,776,druid,feral,30,10,20
Mommonga,onyxia,775,druid,feral,63,24,39
Sedzun,magtheridon,770,druid,feral,39,9,30
Kgn,blackmoore,768,druid,feral,12,8,4
Drach,ravencrest,768,druid,feral,12,8,4
Kattenover,stormscale,768,druid,feral,12,8,4
Snkxo,perenolde,768,druid,feral,12,8,4
Meverrick,aegwynn,768,druid,feral,12,8,4
Hakuchey,aegwynn,768,druid,feral,12,8,4
Gódcómplèx,argent-dawn,768,druid,feral,15,9,6
Iesei,outland,768,druid,feral,18,8,10
Iamtaladruid,archimonde,768,druid,feral,18,8,10
Iproxy,dalaran,768,druid,feral,18,8,10
Drafter,ravencrest,768,druid,feral,18,8,10
Stepsisdaky,stormreaver,768,druid,feral,18,8,10
Bullhoezerx,silvermoon,768,druid,feral,24,8,16
Notaxtin,ravencrest,768,druid,feral,24,8,16
Älênkâ,drakthul,768,druid,feral,30,8,22
Svxstarz,archimonde,768,druid,feral,30,8,22
Mapitom,stormscale,768,druid,feral,34,9,25
Ryáanz,ravencrest,767,druid,feral,12,8,4
Hanfjin,blackmoore,767,druid,feral,12,8,4
Kørnuto,nemesis,767,druid,feral,12,8,4
Firrothe,die-aldor,767,druid,feral,15,9,6
Venusinfurs,drakthul,767,druid,feral,18,8,10
Seysso,silvermoon,767,druid,feral,18,8,10
Стэлларпауэр,gordunni,767,druid,feral,18,8,10
Vlashi,twisting-nether,767,druid,feral,18,8,10
Iathem,dun-modr,767,druid,feral,18,8,10
Braindamage,aegwynn,767,druid,feral,18,8,10
Xunjeral,blackhand,767,druid,feral,24,10,14
Pneuma,xavius,767,druid,feral,24,8,16
Уахо,howling-fjord,767,druid,feral,24,8,16
Imsothorny,genjuros,767,druid,feral,24,8,16
Baummaschine,blackrock,767,druid,feral,24,8,16
Acéré,archimonde,767,druid,feral,24,8,16
Взпешка,gordunni,766,druid,feral,12,8,4
Kutjing,dun-modr,766,druid,feral,12,8,4
Hadoukan,ravencrest,766,druid,feral,12,8,4
Thielyy,blackmoore,766,druid,feral,18,8,10
Krvopito,tarren-mill,765,druid,feral,12,8,4
Plankface,ravencrest,765,druid,feral,18,8,10
Koshde,blackrock,765,druid,feral,18,8,10
Chunkeykill,alonsus,765,druid,feral,18,8,10
Шадараф,howling-fjord,765,druid,feral,21,9,12
Vorag,dalaran,765,druid,feral,24,8,16
Teknó,ragnaros,764,druid,feral,10,9,1
Lukass,drakthul,764,druid,feral,18,8,10
Djsnigel,stormscale,764,druid,feral,24,8,16
Shuffey,frostmane,763,druid,feral,12,8,4
Jimmorris,eredar,763,druid,feral,20,10,10
Valkeryu,hyjal,762,druid,feral,30,8,22
Razorleaf,turalyon,761,druid,feral,24,8,16
Kittyclâw,perenolde,761,druid,feral,36,8,28
Biorythm,draenor,760,druid,feral,18,8,10
Théó,grim-batol,759,druid,feral,47,19,28
Elbah,frostwolf,759,druid,feral,30,8,22
Fugazi,echsenkessel,759,druid,feral,30,8,22
Jupter,burning-blade,755,druid,feral,18,8,10
Имбахилка,lich-king,754,druid,feral,18,8,10
Kaycea,ragnaros,754,druid,feral,30,8,22
Деникин,thermaplugg,752,druid,feral,64,25,39
Cosiris,elune,749,druid,feral,48,17,31
Khai,argent-dawn,748,druid,feral,24,8,16
Nuada,skullcrusher,745,druid,feral,17,8,9
Greenfingerz,azjolnerub,744,druid,feral,36,9,27
Mivlang,kazzak,740,druid,feral,18,8,10
Pegert,aegwynn,736,druid,feral,16,8,8
Tibaz,sylvanas,735,druid,feral,23,8,15
Ellefina,suramar,723,druid,feral,29,8,21
Aègon,ravencrest,719,druid,feral,15,8,7
Iinfamousx,outland,719,druid,feral,15,8,7
Лорирэнд,gordunni,719,druid,feral,29,8,21
Payday,darksorrow,712,druid,feral,21,8,13
Euskal,chogall,703,druid,feral,14,8,6
Xarxius,sanguino,699,druid,feral,32,8,24
Ôpium,eldrethalas,693,druid,feral,34,12,22
Svarre,outland,690,druid,feral,16,8,8
Necorine,silvermoon,672,druid,feral,12,7,5
Erebear,ravencrest,672,druid,feral,12,7,5
Диздру,howling-fjord,672,druid,feral,12,7,5
Hrtbrkn,ravencrest,672,druid,feral,12,7,5
Tofuchan,argent-dawn,672,druid,feral,12,7,5
Zoobidu,garona,672,druid,feral,12,7,5
Pàntoffel,thrall,672,druid,feral,12,7,5
Goretterog,archimonde,672,druid,feral,12,7,5
Найтдруляха,gordunni,672,druid,feral,18,7,11
Flawkin,kazzak,672,druid,feral,18,7,11
Oni,kelthuzad,672,druid,feral,18,7,11
Luveena,kazzak,672,druid,feral,18,7,11
Coldkíng,twisting-nether,672,druid,feral,18,7,11
Sandirion,silvermoon,672,druid,feral,18,7,11
Dryáde,ravencrest,672,druid,feral,18,7,11
Marshy,kazzak,672,druid,feral,20,7,13
Zðe,la-croisade-écarlate,672,druid,feral,24,7,17
Zulucat,aegwynn,672,druid,feral,24,7,17
Ytzü,archimonde,671,druid,feral,12,7,5
Déme,twisting-nether,671,druid,feral,12,7,5
Druikraut,silvermoon,671,druid,feral,12,7,5
Sheradel,argent-dawn,671,druid,feral,18,7,11
Xroxo,hyjal,671,druid,feral,18,7,11
Rawberto,silvermoon,671,druid,feral,18,7,11
Toron,dalaran,671,druid,feral,18,7,11
Duton,stormscale,671,druid,feral,18,7,11
Falbâlas,hyjal,671,druid,feral,18,7,11
Shutupsandra,archimonde,671,druid,feral,18,7,11
Kâgera,ysondre,671,druid,feral,18,7,11
Erasil,exodar,671,druid,feral,18,7,11
Kig,ragnaros,671,druid,feral,18,7,11
Bærbell,blackrock,671,druid,feral,18,7,11
Pronkson,tarren-mill,671,druid,feral,18,7,11
Lazerbinks,blackmoore,671,druid,feral,24,7,17
Schniekers,blackmoore,671,druid,feral,24,7,17
Axiu,kazzak,671,druid,feral,24,7,17
Millya,sargeras,670,druid,feral,12,7,5
Сибирячечка,greymane,670,druid,feral,13,7,6
Rèvelyth,nemesis,670,druid,feral,18,7,11
Tepni,ragnaros,670,druid,feral,18,7,11
Docdruid,outland,670,druid,feral,30,7,23
Radime,khaz-modan,669,druid,feral,12,7,5
Thorface,kazzak,669,druid,feral,12,7,5
Toredorxy,blackrock,669,druid,feral,12,7,5
Леромейкен,fordragon,669,druid,feral,18,7,11
Kissmyson,draenor,669,druid,feral,24,7,17
Stoormrage,deathwing,668,druid,feral,12,7,5
Grassroots,ravencrest,668,druid,feral,30,7,23
Nidaalee,thrall,667,druid,feral,12,7,5
Rastinfalle,argent-dawn,667,druid,feral,18,7,11
Грэкхэк,soulflayer,666,druid,feral,15,8,7
Xicobahn,aggra-português,666,druid,feral,24,7,17
Fedas,neptulon,665,druid,feral,18,7,11
Amethistle,ravencrest,664,druid,feral,18,7,11
Fiagard,antonidas,662,druid,feral,12,7,5
Blejkv,defias-brotherhood,658,druid,feral,18,7,11
Mãui,blackhand,658,druid,feral,27,8,19
Swiftblow,argent-dawn,657,druid,feral,24,7,17
Dinopwns,silvermoon,653,druid,feral,28,7,21
Asrekar,karazhan,652,druid,feral,18,7,11
Tomalas,aggramar,644,druid,feral,36,7,29
Drujdjel,die-todeskrallen,641,druid,feral,17,7,10
Shalys,archimonde,622,druid,feral,11,7,4
Snûx,antonidas,622,druid,feral,27,7,20
Зулгасилич,howling-fjord,620,druid,feral,23,7,16
Diktus,outland,618,druid,feral,14,8,6
Хённим,howling-fjord,607,druid,feral,11,7,4
Àyóorts,archimonde,607,druid,feral,14,7,7
Halabanaha,silvermoon,606,druid,feral,11,7,4
Zink,sanguino,590,druid,feral,25,7,18
Flaiq,twisting-nether,576,druid,feral,6,6,0
Exoar,ravencrest,576,druid,feral,12,6,6
Gyome,sargeras,576,druid,feral,12,6,6
Откинсяназад,howling-fjord,576,druid,feral,12,6,6
Túskér,stormscale,576,druid,feral,12,6,6
Aslanah,hyjal,576,druid,feral,12,6,6
Swagdemonxd,outland,576,druid,feral,12,6,6
Kittý,terokkar,576,druid,feral,12,6,6
Syniixmeow,ravencrest,576,druid,feral,12,6,6
Ataxyhehe,sylvanas,576,druid,feral,12,6,6
Сиэн,ashenvale,576,druid,feral,12,6,6
Rølly,blackrock,576,druid,feral,12,6,6
Cagaboliches,sanguino,576,druid,feral,12,6,6
Migaah,stormscale,576,druid,feral,12,6,6
Mikecat,aegwynn,576,druid,feral,12,6,6
Royo,eldrethalas,576,druid,feral,12,6,6
Nyç,tarren-mill,576,druid,feral,12,6,6
Phøøn,blackrock,576,druid,feral,12,6,6
Гримах,soulflayer,576,druid,feral,12,6,6
Mdtwoxo,tarren-mill,576,druid,feral,12,6,6
Seekx,silvermoon,576,druid,feral,12,6,6
Imbadxx,kazzak,576,druid,feral,12,6,6
Мцк,deathguard,576,druid,feral,12,6,6
Druiderex,outland,576,druid,feral,12,6,6
Forrest,bronze-dragonflight,576,druid,feral,12,6,6
Seasor,argent-dawn,576,druid,feral,12,6,6
Дикарьчик,goldrinn,576,druid,feral,12,6,6
Asoli,aegwynn,576,druid,feral,12,6,6
Arlandia,drakthul,576,druid,feral,12,6,6
Snkyexpress,aegwynn,576,druid,feral,12,6,6
Sucukk,antonidas,576,druid,feral,16,7,9
Dægmondrtrd,silvermoon,576,druid,feral,17,6,11
Taurendruid,the-maelstrom,576,druid,feral,18,6,12
Gruffeline,marécage-de-zangar,576,druid,feral,18,6,12
Bamso,daggerspine,576,druid,feral,18,6,12
Hasted,kazzak,576,druid,feral,18,6,12
Rimpularaisa,grim-batol,576,druid,feral,18,6,12
Svass,ragnaros,576,druid,feral,18,6,12
Radauronny,malganis,576,druid,feral,18,6,12
Elflord,nemesis,576,druid,feral,18,6,12
Andranjr,kazzak,576,druid,feral,18,6,12
Arceuss,lothar,576,druid,feral,21,6,15
Fur,antonidas,576,druid,feral,23,6,17
Bloodyredyx,ysera,576,druid,feral,24,6,18
Cudse,aegwynn,576,druid,feral,30,6,24
Xurta,kazzak,575,druid,feral,12,6,6
Nikta,trollbane,575,druid,feral,12,6,6
Broccoliform,eredar,575,druid,feral,12,6,6
Omegaheals,scarshield-legion,575,druid,feral,12,6,6
Тое,soulflayer,575,druid,feral,12,6,6
Kime,ysondre,575,druid,feral,12,6,6
Psixx,blackhand,575,druid,feral,12,6,6
Ацкийдру,gordunni,575,druid,feral,12,6,6
Varìx,ysondre,575,druid,feral,12,6,6
Patrík,twisting-nether,575,druid,feral,12,6,6
Razah,ravencrest,575,druid,feral,12,6,6
Bigdaddykane,mannoroth,575,druid,feral,18,6,12
Chrîslol,twisting-nether,575,druid,feral,18,6,12
Скайтибрайдх,gordunni,575,druid,feral,24,6,18
Jokizy,burning-legion,575,druid,feral,24,6,18
Kkriss,stormscale,574,druid,feral,12,6,6
Окнет,grom,574,druid,feral,12,6,6
Artjin,shattered-hand,574,druid,feral,12,6,6
Ociroza,outland,574,druid,feral,18,6,12
Rakúsh,thrall,572,druid,feral,19,7,12
Iwillninjau,tarren-mill,572,druid,feral,30,6,24
Avior,eonar,571,druid,feral,12,6,6
Грегориан,galakrond,571,druid,feral,12,6,6
Annajak,bloodfeather,570,druid,feral,12,6,6
Элинна,ashenvale,570,druid,feral,18,6,12
Ваддимка,soulflayer,567,druid,feral,18,6,12
Isellia,dun-morogh,565,druid,feral,12,6,6
Altramuz,uldum,564,druid,feral,15,7,8
Wârden,twisting-nether,558,druid,feral,17,6,11
Spangle,stormscale,554,druid,feral,21,7,14
Nuktuk,blackhand,554,druid,feral,19,6,13
Nefariz,dun-modr,544,druid,feral,16,6,10
Shapeshifts,kul-tiras,543,druid,feral,11,6,5
Совулька,howling-fjord,542,druid,feral,11,6,5
Whîskeycola,tarren-mill,538,druid,feral,22,6,16
Диджейкошка,howling-fjord,527,druid,feral,11,6,5
Sároman,ravencrest,526,druid,feral,17,6,11
Glookies,dun-modr,522,druid,feral,16,8,8
Lionquokk,azjolnerub,512,druid,feral,10,6,4
Drudicious,ravencrest,512,druid,feral,10,6,4
Séifér,auchindoun,512,druid,feral,16,6,10
Belvrin,argent-dawn,512,druid,feral,17,6,11
Amuini,draenor,511,druid,feral,14,6,8
Vaalya,hyjal,509,druid,feral,16,6,10
Vanilian,burning-legion,480,druid,feral,6,5,1
Shanikya,argent-dawn,480,druid,feral,6,5,1
Ryselol,nemesis,480,druid,feral,6,5,1
Aolynk,twisting-nether,480,druid,feral,6,5,1
Demiannie,argent-dawn,480,druid,feral,9,6,3
Synzuu,turalyon,480,druid,feral,10,6,4
Банихоуп,gordunni,480,druid,feral,10,6,4
Denyssa,die-aldor,480,druid,feral,12,5,7
Акуламатата,soulflayer,480,druid,feral,12,5,7
Alstra,kaelthas,480,druid,feral,12,5,7
Noxxzar,stormscale,480,druid,feral,12,5,7
Einsfünfkcat,madmortem,480,druid,feral,12,5,7
Adileath,argent-dawn,480,druid,feral,12,5,7
Hipølita,zuljin,480,druid,feral,12,5,7
Guiltyas,turalyon,480,druid,feral,12,5,7
Jooblob,guldan,480,druid,feral,12,5,7
Bloomly,tarren-mill,480,druid,feral,12,5,7
Epidruid,stormrage,480,druid,feral,12,5,7
Hardbasior,burning-legion,480,druid,feral,12,5,7
Cptsponksa,tarren-mill,480,druid,feral,12,5,7
Bezrark,arathor,480,druid,feral,12,5,7
Jabizz,azjolnerub,480,druid,feral,12,5,7
Rapzr,argent-dawn,480,druid,feral,12,5,7
Hrabioid,burning-legion,480,druid,feral,12,5,7
Deßradator,stormscale,480,druid,feral,12,5,7
Siire,ravencrest,480,druid,feral,12,5,7
Chpochm,stormscale,480,druid,feral,12,5,7
Flum,darksorrow,480,druid,feral,12,5,7
Johnnybims,eredar,480,druid,feral,12,5,7
Ulabo,gorgonnash,480,druid,feral,12,5,7
Shreedex,blackmoore,480,druid,feral,12,5,7
Cnox,argent-dawn,480,druid,feral,12,5,7
Domturbo,blackhand,480,druid,feral,12,5,7
West,drakthul,480,druid,feral,12,5,7
Sketz,stormscale,480,druid,feral,12,5,7
Мидинваернэ,gordunni,480,druid,feral,12,5,7
Dianabigby,silvermoon,480,druid,feral,12,5,7
Жеводанский,gordunni,480,druid,feral,12,5,7
Refractory,jaedenar,480,druid,feral,12,5,7
Xoriauz,archimonde,480,druid,feral,12,5,7
Ðjkillercat,ravencrest,480,druid,feral,18,5,13
Derrezzed,stormscale,480,druid,feral,18,5,13
Yiradur,stormscale,480,druid,feral,18,5,13
Shikamarûu,blackmoore,480,druid,feral,18,5,13
Enylasi,hyjal,480,druid,feral,18,5,13
Outtanowhere,drakthul,480,druid,feral,18,5,13
Namata,archimonde,480,druid,feral,18,5,13
Wølveríne,frostmane,480,druid,feral,18,5,13
Tskilli,draenor,480,druid,feral,18,5,13
Pethebär,tarren-mill,480,druid,feral,18,5,13
Cdsxr,outland,480,druid,feral,24,5,19
Telpha,onyxia,479,druid,feral,12,5,7
Horkz,frostmourne,479,druid,feral,12,5,7
Koudru,emerald-dream,479,druid,feral,12,5,7
Poskehh,outland,479,druid,feral,12,5,7
Morsee,hellfire,479,druid,feral,12,5,7
Astlanes,ysondre,479,druid,feral,12,5,7
Miscodedru,twisting-nether,479,druid,feral,12,5,7
Zayam,archimonde,479,druid,feral,12,5,7
Mambalol,sanguino,479,druid,feral,12,5,7
Casiu,blackmoore,479,druid,feral,12,5,7
Gatojuan,dun-modr,479,druid,feral,12,5,7
Shifts,the-maelstrom,479,druid,feral,12,5,7
Dorcelvision,archimonde,479,druid,feral,12,5,7
Druidofix,marécage-de-zangar,479,druid,feral,12,5,7
Hyperunknown,grim-batol,479,druid,feral,12,5,7
Thibagon,ysondre,479,druid,feral,12,5,7
Гибрайт,soulflayer,479,druid,feral,18,5,13
Vhaegar,grim-batol,479,druid,feral,18,5,13
Plandros,draenor,479,druid,feral,24,5,19
Vapuro,blackmoore,479,druid,feral,24,5,19
Перекурю,eversong,478,druid,feral,12,5,7
Эндердру,gordunni,478,druid,feral,12,5,7
Påst,pozzo-delleternità,478,druid,feral,18,5,13
Cattastrophe,bronzebeard,477,druid,feral,12,5,7
Svek,ravencrest,477,druid,feral,24,5,19
Marceeh,blackhand,477,druid,feral,30,5,25
Mitomen,ragnaros,476,druid,feral,12,5,7
Ляшок,gordunni,476,druid,feral,18,5,13
Skylarr,alexstrasza,475,druid,feral,12,5,7
Tyrianxx,zuljin,447,druid,feral,8,6,2
Apetino,dun-modr,447,druid,feral,11,5,6
Mâjezik,twisting-nether,447,druid,feral,14,6,8
Гимодера,gordunni,431,druid,feral,11,5,6
Овналь,gordunni,431,druid,feral,11,5,6
Zynmeow,lordaeron,416,druid,feral,19,6,13
Nipply,ravencrest,415,druid,feral,15,6,9
Lybell,antonidas,414,druid,feral,14,5,9
Bingó,blutkessel,414,druid,feral,14,5,9
Reckwøød,ravencrest,414,druid,feral,20,5,15
Staness,khaz-modan,413,druid,feral,38,5,33
Аидкатв,gordunni,398,druid,feral,13,5,8
Rêdx,archimonde,384,druid,feral,6,4,2
Wallex,draenor,384,druid,feral,6,4,2
Damnuisance,blackmoore,384,druid,feral,6,4,2
Alistår,outland,384,druid,feral,6,4,2
Takamizy,ysondre,384,druid,feral,6,4,2
Naraxz,ravencrest,384,druid,feral,6,4,2
Osaviciosa,shendralar,384,druid,feral,6,4,2
Grrxd,tarren-mill,384,druid,feral,6,4,2
Vioboomie,blackrock,384,druid,feral,6,4,2
Коксвейн,ashenvale,384,druid,feral,6,4,2
Akifumi,archimonde,384,druid,feral,6,4,2
Ábomínatíon,draenor,384,druid,feral,6,4,2
Knatch,outland,384,druid,feral,6,4,2
Zunixboosted,lothar,384,druid,feral,6,4,2
Шабашиоргия,soulflayer,384,druid,feral,6,4,2
Catleyia,ravencrest,384,druid,feral,6,4,2
Tradi,defias-brotherhood,384,druid,feral,6,4,2
Furiol,darksorrow,384,druid,feral,6,4,2
Greenlips,ravencrest,384,druid,feral,6,4,2
Kantareboy,drakthul,384,druid,feral,6,4,2
Drudulicious,outland,384,druid,feral,6,4,2
Dystaleon,blackrock,384,druid,feral,6,4,2
Kralox,hyjal,384,druid,feral,6,4,2
Idraly,kirin-tor,384,druid,feral,6,4,2
Improved,hyjal,384,druid,feral,6,4,2
Jekl,ragnaros,384,druid,feral,6,4,2
Сантиго,howling-fjord,384,druid,feral,6,4,2
Høtz,dalaran,384,druid,feral,6,4,2
Cráck,nagrand,384,druid,feral,6,4,2
Dèxò,blackmoore,384,druid,feral,17,7,10
Ysomnia,tirion,384,druid,feral,12,4,8
Noxxll,gorgonnash,384,druid,feral,12,4,8
Алендор,deathguard,384,druid,feral,12,4,8
Фдру,eversong,384,druid,feral,12,4,8
Helltoothz,ragnaros,384,druid,feral,12,4,8
Bígbaddruid,blackrock,384,druid,feral,12,4,8
Турбокалясик,gordunni,384,druid,feral,12,4,8
Солнцеедка,gordunni,384,druid,feral,12,4,8
Vitaex,blackrock,384,druid,feral,12,4,8
Дикобразик,soulflayer,384,druid,feral,12,4,8
ßlackßåmßå,zuljin,384,druid,feral,12,4,8
Kittyexpress,arygos,384,druid,feral,12,4,8
Nibbl,doomhammer,384,druid,feral,12,4,8
Klayx,rexxar,384,druid,feral,12,4,8
Kúùsh,frostwolf,384,druid,feral,12,4,8
Shiotake,hyjal,384,druid,feral,12,4,8
Skinnyleg,baelgun,384,druid,feral,12,4,8
Deranion,drakthul,384,druid,feral,12,4,8
Plumitelv,outland,384,druid,feral,12,4,8
Risibisi,blackmoore,384,druid,feral,12,4,8
Wikus,kazzak,384,druid,feral,12,4,8
Giaya,turalyon,384,druid,feral,12,4,8
Cacatus,tarren-mill,384,druid,feral,12,4,8
Derni,burning-legion,384,druid,feral,12,4,8
Ðeathwatch,ravencrest,384,druid,feral,12,4,8
Goatmeal,draenor,384,druid,feral,12,4,8
Magicerzz,voljin,384,druid,feral,12,4,8
Éxy,kazzak,384,druid,feral,12,4,8
Meliodaas,outland,384,druid,feral,12,4,8
Drodiax,outland,384,druid,feral,12,4,8
Ushioxtora,outland,384,druid,feral,12,4,8
Tenader,draenor,384,druid,feral,12,4,8
Lizasha,kirin-tor,384,druid,feral,12,4,8
Dawgydawg,emerald-dream,384,druid,feral,12,4,8
Csacsikuki,ragnaros,384,druid,feral,17,4,13
Wooden,terokkar,384,druid,feral,18,4,14
Markuslanz,blackrock,384,druid,feral,18,4,14
Milkniatrump,tarren-mill,384,druid,feral,18,4,14
Туундра,howling-fjord,384,druid,feral,18,4,14
Lupa,drakthul,384,druid,feral,18,4,14
Jellybra,tarren-mill,384,druid,feral,18,4,14
Senoka,shattrath,384,druid,feral,18,4,14
Tigerroll,kazzak,384,druid,feral,30,4,26
Fendoras,argent-dawn,383,druid,feral,6,4,2
Tsukuyómi,ragnaros,383,druid,feral,6,4,2
Hartzig,blackmoore,383,druid,feral,6,4,2
Bearshift,aggra-português,383,druid,feral,6,4,2
Kôhon,blackhand,383,druid,feral,6,4,2
Kinoai,antonidas,383,druid,feral,12,4,8
Jøkëër,hyjal,383,druid,feral,12,4,8
Fòggie,silvermoon,383,druid,feral,12,4,8
Tettsu,silvermoon,383,druid,feral,12,4,8
Jingho,blackrock,383,druid,feral,12,4,8
Murraywolf,dun-modr,383,druid,feral,12,4,8
Asterya,dun-modr,383,druid,feral,16,5,11
Sheiheda,kazzak,383,druid,feral,18,4,14
Astøriøn,elune,383,druid,feral,18,4,14
Tardej,tarren-mill,383,druid,feral,18,4,14
Vanarea,argent-dawn,383,druid,feral,19,4,15
Jamaicanherb,bronzebeard,382,druid,feral,12,4,8
Hasdruida,zuljin,382,druid,feral,14,4,10
Kyth,forscherliga,382,druid,feral,18,4,14
Clawwy,kazzak,382,druid,feral,24,4,20
Rogalli,sylvanas,381,druid,feral,12,4,8
Viølin,silvermoon,381,druid,feral,12,4,8
Muntherx,twisting-nether,351,druid,feral,10,4,6
Yopi,stormscale,351,druid,feral,11,4,7
Zanorákma,ravencrest,330,druid,feral,16,5,11
Wintx,ragnaros,329,druid,feral,24,7,17
Rixdudu,silvermoon,319,druid,feral,5,4,1
Ninmah,quelthalas,303,druid,feral,25,4,21
Sylvy,dun-modr,288,druid,feral,6,3,3
Pyaw,kazzak,288,druid,feral,6,3,3
Alessathrina,tarren-mill,288,druid,feral,6,3,3
Mäffu,silvermoon,288,druid,feral,6,3,3
Døgferal,stormscale,288,druid,feral,6,3,3
Sweazx,archimonde,288,druid,feral,6,3,3
Yepnesse,khaz-modan,288,druid,feral,6,3,3
Sök,hyjal,288,druid,feral,6,3,3
Вагинн,soulflayer,288,druid,feral,6,3,3
Lyrasanna,argent-dawn,288,druid,feral,6,3,3
Muffler,ragnaros,288,druid,feral,6,3,3
Lil,elune,288,druid,feral,6,3,3
Bigbrrd,outland,288,druid,feral,6,3,3
Druidicchi,stormscale,288,druid,feral,6,3,3
Амахасла,deathweaver,288,druid,feral,6,3,3
Starryraven,argent-dawn,288,druid,feral,6,3,3
Miruush,malganis,288,druid,feral,6,3,3
Krïsu,ravencrest,288,druid,feral,6,3,3
Xercàs,outland,288,druid,feral,6,3,3
Oddform,silvermoon,288,druid,feral,6,3,3
Kikïnøu,garona,288,druid,feral,6,3,3
Zipydruid,tarren-mill,288,druid,feral,6,3,3
Жексоул,gordunni,288,druid,feral,6,3,3
Tearxd,twisting-nether,288,druid,feral,6,3,3
Павлорион,gordunni,288,druid,feral,6,3,3
Kørn,drakthul,288,druid,feral,6,3,3
Fearthecat,defias-brotherhood,288,druid,feral,6,3,3
Reservebär,blackhand,288,druid,feral,6,3,3
Ferpylul,ragnaros,288,druid,feral,6,3,3
Exjuggy,twisting-nether,288,druid,feral,6,3,3
Hundavidsad,quelthalas,288,druid,feral,6,3,3
Zusaria,azshara,288,druid,feral,6,3,3
Alkurosa,sylvanas,288,druid,feral,6,3,3
Fraptal,dalaran,288,druid,feral,6,3,3
Shirí,hyjal,288,druid,feral,6,3,3
Высерыш,galakrond,288,druid,feral,6,3,3
Urgrull,baelgun,288,druid,feral,6,3,3
Wildthing,blackmoore,288,druid,feral,6,3,3
Sneakerpimps,draenor,288,druid,feral,6,3,3
Theonlydruid,frostmane,288,druid,feral,6,3,3
Kakoje,burning-legion,288,druid,feral,6,3,3
Vigôuróuz,blackmoore,288,druid,feral,6,3,3
Boldwìck,kazzak,288,druid,feral,6,3,3
Feign,blackmoore,288,druid,feral,6,3,3
Somalí,blackmoore,288,druid,feral,6,3,3
Madgazfanboi,ravencrest,288,druid,feral,6,3,3
Gargnda,tarren-mill,288,druid,feral,6,3,3
Bigborst,ravencrest,288,druid,feral,6,3,3
Trell,defias-brotherhood,288,druid,feral,6,3,3
Lunanikuya,ravencrest,288,druid,feral,6,3,3
Мивинчик,ashenvale,288,druid,feral,6,3,3
Melither,ravencrest,288,druid,feral,6,3,3
Zantill,chamber-of-aspects,288,druid,feral,7,3,4
Shingeki,alonsus,288,druid,feral,8,3,5
Norlanda,ravencrest,288,druid,feral,12,3,9
Оленяпеченя,gordunni,288,druid,feral,12,3,9
Snoozerboy,kazzak,288,druid,feral,12,3,9
Bepipane,pozzo-delleternità,288,druid,feral,12,3,9
Hahnvm,stormscale,288,druid,feral,12,3,9
Myex,exodar,288,druid,feral,12,3,9
Tinykiwi,silvermoon,288,druid,feral,12,3,9
Papjin,blackhand,288,druid,feral,12,3,9
Føurtth,ragnaros,288,druid,feral,12,3,9
Ddggss,ragnaros,288,druid,feral,12,3,9
Avicî,ravencrest,288,druid,feral,12,3,9
Treecuddlerr,blackhand,288,druid,feral,12,3,9
Ripern,silvermoon,288,druid,feral,12,3,9
Qfrost,ragnaros,288,druid,feral,12,3,9
Teddytree,ravencrest,288,druid,feral,12,3,9
Elocat,blackmoore,288,druid,feral,12,3,9
Drocos,genjuros,288,druid,feral,12,3,9
Murzzilka,kazzak,288,druid,feral,12,3,9
Gurudru,tarren-mill,288,druid,feral,12,3,9
Käisur,doomhammer,288,druid,feral,12,3,9
Bénjî,khazgoroth,288,druid,feral,12,3,9
Phòènìx,twisting-nether,288,druid,feral,12,3,9
Healnpeel,turalyon,288,druid,feral,12,3,9
Kajirä,archimonde,288,druid,feral,12,3,9
Jimseung,drekthar,288,druid,feral,12,3,9
Wheen,dun-morogh,288,druid,feral,12,3,9
Azyol,argent-dawn,288,druid,feral,12,3,9
Шокшо,soulflayer,288,druid,feral,12,3,9
Xdrive,blackrock,288,druid,feral,12,3,9
Мунлайнер,soulflayer,288,druid,feral,12,3,9
Ferdax,outland,288,druid,feral,12,3,9
Taatz,draenor,288,druid,feral,12,3,9
Onmyass,dragonblight,288,druid,feral,12,3,9
Некрокэт,gordunni,288,druid,feral,17,3,14
Япельсин,borean-tundra,288,druid,feral,18,3,15
Khânz,twisting-nether,288,druid,feral,18,3,15
Tallbutshort,stormscale,288,druid,feral,18,3,15
Альне,howling-fjord,288,druid,feral,18,3,15
Ashamane,outland,288,druid,feral,18,3,15
Frincessa,burning-legion,288,druid,feral,18,3,15
Joshmoldr,aszune,288,druid,feral,18,3,15
Moxxim,ragnaros,287,druid,feral,6,3,3
Giosis,stormscale,287,druid,feral,6,3,3
Cemendur,bronzebeard,287,druid,feral,6,3,3
Rockymarci,dalaran,287,druid,feral,12,3,9
Vólotyr,ravencrest,287,druid,feral,12,3,9
Papírzsepi,ragnaros,287,druid,feral,18,3,15
Treébeárd,draenor,287,druid,feral,18,3,15
Thélon,antonidas,287,druid,feral,18,3,15
Alligatordru,kazzak,287,druid,feral,18,3,15
Búll,aegwynn,287,druid,feral,24,3,21
Ianachu,tarren-mill,287,druid,feral,36,3,33
Dildor,ysondre,286,druid,feral,6,3,3
Zottelmahne,blackrock,286,druid,feral,6,3,3
Bakar,ghostlands,286,druid,feral,6,3,3
Puuhalí,stormreaver,286,druid,feral,6,3,3
Creadora,ravencrest,255,druid,feral,11,3,8
Bartax,culte-de-la-rive-noire,240,druid,feral,9,3,6
Yopod,draenor,239,druid,feral,5,3,2
Hrrybo,argent-dawn,239,druid,feral,5,3,2
Ripbot,grim-batol,239,druid,feral,5,3,2
Persefal,garona,239,druid,feral,11,3,8
Anyône,dun-morogh,229,druid,feral,16,4,12
Tarmara,outland,223,druid,feral,8,3,5
Skiiter,draenor,223,druid,feral,14,3,11
Tommyferal,outland,192,druid,feral,4,3,1
Тырубльдуде,gordunni,192,druid,feral,9,3,6
Zouzouille,ravencrest,192,druid,feral,6,2,4
Druiddamage,the-maelstrom,192,druid,feral,6,2,4
Yiraz,aegwynn,192,druid,feral,6,2,4
Dwaokut,ravencrest,192,druid,feral,6,2,4
Insanexd,antonidas,192,druid,feral,6,2,4
Calimopat,draenor,192,druid,feral,6,2,4
Senjí,archimonde,192,druid,feral,6,2,4
Hairydøtter,aegwynn,192,druid,feral,6,2,4
Roronoa,antonidas,192,druid,feral,6,2,4
Brisemeute,kirin-tor,192,druid,feral,6,2,4
Yopede,medivh,192,druid,feral,6,2,4
Getsomefunny,archimonde,192,druid,feral,6,2,4
Bïscøte,archimonde,192,druid,feral,6,2,4
Narawenn,ysondre,192,druid,feral,6,2,4
Erundrood,ysondre,192,druid,feral,6,2,4
Сверххищникк,soulflayer,192,druid,feral,6,2,4
Sýlina,aegwynn,192,druid,feral,6,2,4
Treepoloski,stormscale,192,druid,feral,6,2,4
Lsdpinkcandy,twisting-nether,192,druid,feral,6,2,4
Tøpkittyg,twisting-nether,192,druid,feral,6,2,4
Retzerbil,sunstrider,192,druid,feral,6,2,4
Jænne,ysondre,192,druid,feral,6,2,4
Gibx,ravencrest,192,druid,feral,6,2,4
Badbird,thunderhorn,192,druid,feral,6,2,4
Smat,thunderhorn,192,druid,feral,6,2,4
Атиса,gordunni,192,druid,feral,6,2,4
Кентухен,gordunni,192,druid,feral,6,2,4
Kiizal,twisting-nether,192,druid,feral,6,2,4
Scotarella,nemesis,192,druid,feral,6,2,4
Luftedar,twisting-nether,192,druid,feral,6,2,4
Kisskossa,stormscale,192,druid,feral,6,2,4
Comodruid,nemesis,192,druid,feral,6,2,4
Wpierdol,aegwynn,192,druid,feral,6,2,4
Feralsaber,ghostlands,192,druid,feral,6,2,4
Womzas,blackhand,192,druid,feral,6,2,4
Zibark,nemesis,192,druid,feral,6,2,4
Buffaloh,antonidas,192,druid,feral,6,2,4
Szondykhan,ragnaros,192,druid,feral,6,2,4
Bóssít,doomhammer,192,druid,feral,6,2,4
Pöttli,blackhand,192,druid,feral,6,2,4
Вохако,howling-fjord,192,druid,feral,6,2,4
Growlithe,hellfire,192,druid,feral,6,2,4
Цветий,howling-fjord,192,druid,feral,6,2,4
Leafceld,aggra-português,192,druid,feral,6,2,4
Rabatout,eitrigg,192,druid,feral,6,2,4
Melcow,eredar,192,druid,feral,6,2,4
Likë,frostwolf,192,druid,feral,6,2,4
Каирон,deepholm,192,druid,feral,6,2,4
Cylàn,sylvanas,192,druid,feral,6,2,4
Хайпхайп,howling-fjord,192,druid,feral,6,2,4
Tylou,khaz-modan,192,druid,feral,6,2,4
Nonstérilisé,dalaran,192,druid,feral,6,2,4
Графматье,soulflayer,192,druid,feral,6,2,4
Citrus,sargeras,192,druid,feral,6,2,4
Shyasiandru,area-52,192,druid,feral,6,2,4
Вендьета,blackscar,192,druid,feral,6,2,4
Mopferal,twisting-nether,192,druid,feral,6,2,4
Melcharis,frostwolf,192,druid,feral,6,2,4
Móurningwood,hellfire,192,druid,feral,6,2,4
Savagehèals,ravencrest,192,druid,feral,6,2,4
Sàngha,frostwolf,192,druid,feral,6,2,4
Smirnó,aegwynn,192,druid,feral,6,2,4
Angrykefir,draenor,192,druid,feral,6,2,4
Jimmyxdd,kazzak,192,druid,feral,6,2,4
Forcedbeef,burning-legion,192,druid,feral,6,2,4
Hivjue,argent-dawn,192,druid,feral,6,2,4
Santamonica,blackrock,192,druid,feral,6,2,4
Voyerka,drakthul,192,druid,feral,6,2,4
Lunaarria,blackrock,192,druid,feral,6,2,4
Smallbetty,silvermoon,192,druid,feral,6,2,4
Backeye,silvermoon,192,druid,feral,6,2,4
Snuggums,argent-dawn,192,druid,feral,6,2,4
Metamø,blackrock,192,druid,feral,6,2,4
Jokiri,argent-dawn,192,druid,feral,6,2,4
Kormakurr,silvermoon,192,druid,feral,6,2,4
Pitsas,silvermoon,192,druid,feral,6,2,4
Nidra,silvermoon,192,druid,feral,6,2,4
Sasðri,argent-dawn,192,druid,feral,6,2,4
Lilkâzzam,blackrock,192,druid,feral,6,2,4
Aryitu,blackrock,192,druid,feral,6,2,4
Flewks,silvermoon,192,druid,feral,6,2,4
Glyn,earthen-ring,192,druid,feral,6,2,4
Redyogurt,outland,192,druid,feral,6,2,4
Lechaource,silvermoon,192,druid,feral,6,2,4
Rabacki,blackmoore,192,druid,feral,6,2,4
Píshi,silvermoon,192,druid,feral,6,2,4
Nelfboyuk,tarren-mill,192,druid,feral,6,2,4
Yeats,blackmoore,192,druid,feral,6,2,4
Lyvaley,dun-modr,192,druid,feral,6,2,4
Ammetåke,kazzak,192,druid,feral,6,2,4
Bettyblue,blackmoore,192,druid,feral,6,2,4
Seekíng,blackmoore,192,druid,feral,6,2,4
Catwild,blackmoore,192,druid,feral,6,2,4
Beginníng,outland,192,druid,feral,6,2,4
Shadaur,tarren-mill,192,druid,feral,6,2,4
Álvaromel,blackmoore,192,druid,feral,6,2,4
Tharae,blackmoore,192,druid,feral,6,2,4
Friidaf,lightbringer,192,druid,feral,6,2,4
Variolus,dun-modr,192,druid,feral,6,2,4
Mjáy,tarren-mill,192,druid,feral,6,2,4
Rrayed,kazzak,192,druid,feral,6,2,4
Lorya,terokkar,192,druid,feral,6,2,4
Rakuzo,kazzak,192,druid,feral,6,2,4
Zyron,sanguino,192,druid,feral,6,2,4
Duzky,kazzak,192,druid,feral,6,2,4
Routasydän,shattered-hand,192,druid,feral,6,2,4
Inchmale,darkspear,192,druid,feral,6,2,4
Spidete,sanguino,192,druid,feral,9,2,7
Frunze,sylvanas,192,druid,feral,9,2,7
Nicotex,draenor,192,druid,feral,12,2,10
Klintxweed,hyjal,192,druid,feral,12,2,10
Aaune,argent-dawn,192,druid,feral,12,2,10
Kuw,archimonde,192,druid,feral,12,2,10
Amoveo,argent-dawn,192,druid,feral,12,2,10
Touchmehere,stormscale,192,druid,feral,12,2,10
Kokotinka,drakthul,192,druid,feral,12,2,10
Ellaria,burning-legion,192,druid,feral,12,2,10
Trànsformer,nemesis,192,druid,feral,12,2,10
Samandeega,kazzak,192,druid,feral,12,2,10
Инфернох,gordunni,192,druid,feral,12,2,10
Daìs,dalaran,192,druid,feral,12,2,10
Silverriver,ragnaros,192,druid,feral,12,2,10
Кратиос,soulflayer,192,druid,feral,12,2,10
Нахильник,howling-fjord,192,druid,feral,12,2,10
Naturexbot,silvermoon,192,druid,feral,12,2,10
Legyna,ravencrest,192,druid,feral,12,2,10
Erelieva,silvermoon,192,druid,feral,12,2,10
Splatz,runetotem,192,druid,feral,12,2,10
Moundîr,archimonde,192,druid,feral,12,2,10
Drujoty,cthun,192,druid,feral,12,2,10
Speegle,kazzak,192,druid,feral,12,2,10
Rasgath,kazzak,192,druid,feral,12,2,10
Affines,the-maelstrom,192,druid,feral,12,2,10
Adawehi,ravencrest,192,druid,feral,12,2,10
Glenn,alakir,192,druid,feral,12,2,10
Seque,silvermoon,192,druid,feral,12,2,10
Busal,kazzak,192,druid,feral,12,2,10
Steakotaur,chamber-of-aspects,192,druid,feral,12,2,10
Безусловно,deathguard,192,druid,feral,12,2,10
Zooluu,ragnaros,192,druid,feral,18,2,16
Venh,forscherliga,192,druid,feral,18,2,16
Gachal,kazzak,192,druid,feral,18,2,16
Citral,balnazzar,191,druid,feral,6,2,4
Sellsarya,blackmoore,191,druid,feral,6,2,4
Jompemanfish,stormscale,191,druid,feral,6,2,4
Luhxius,khaz-modan,191,druid,feral,6,2,4
Nayato,draenor,191,druid,feral,12,2,10
Loriann,twisting-nether,191,druid,feral,18,2,16
Meuhtéki,hyjal,190,druid,feral,13,3,10
Avisa,blackhand,190,druid,feral,12,2,10
Wolfly,ravencrest,179,druid,feral,21,7,14
Smucka,ragnaros,176,druid,feral,7,3,4
Ilyethea,earthen-ring,175,druid,feral,11,2,9
Mazàr,pozzo-delleternità,160,druid,feral,10,2,8
Hiloqtdruid,blackmoore,159,druid,feral,5,2,3
Korkskruven,draenor,159,druid,feral,5,2,3
Scisan,aggra-português,159,druid,feral,5,2,3
Bregalad,twisting-nether,159,druid,feral,5,2,3
Szamoca,hellfire,159,druid,feral,11,2,9
Grawlex,silvermoon,159,druid,feral,11,2,9
Bearfôrceône,blackrock,159,druid,feral,11,2,9
Найадра,gordunni,144,druid,feral,9,2,7
Несессари,howling-fjord,144,druid,feral,15,2,13
Tjann,darksorrow,138,druid,feral,9,3,6
Chdanydrood,marécage-de-zangar,138,druid,feral,9,3,6
Trashcat,anetheron,128,druid,feral,4,2,2
Azaría,aegwynn,128,druid,feral,4,2,2
Baniaucygana,draenor,127,druid,feral,4,2,2
Wildsoul,hyjal,127,druid,feral,8,2,6
Wurnas,silvermoon,121,druid,feral,15,3,12
Wolfheart,norgannon,96,druid,feral,3,2,1
Ashleyx,antonidas,96,druid,feral,6,1,5
Chowmien,alakir,96,druid,feral,6,1,5
Cowronavirus,zuljin,96,druid,feral,6,1,5
Awán,aegwynn,96,druid,feral,6,1,5
Sodniss,aggra-português,96,druid,feral,6,1,5
Zàphiirò,archimonde,96,druid,feral,6,1,5
Kátzumoto,kazzak,96,druid,feral,6,1,5
Cegorach,xavius,96,druid,feral,6,1,5
Shaylanna,frostmane,96,druid,feral,6,1,5
Ayatola,conseil-des-ombres,96,druid,feral,6,1,5
Jãy,ravencrest,96,druid,feral,6,1,5
Benfufu,kazzak,96,druid,feral,6,1,5
Hävefunny,archimonde,96,druid,feral,6,1,5
Aahboom,draenor,96,druid,feral,6,1,5
Mafakaclones,archimonde,96,druid,feral,6,1,5
Sadete,sanguino,96,druid,feral,6,1,5
Jungamajunga,quelthalas,96,druid,feral,6,1,5
Rbgbear,blackhand,96,druid,feral,6,1,5
Haragmancs,arathor,96,druid,feral,6,1,5
Aureliañ,tarren-mill,96,druid,feral,6,1,5
Bíerling,antonidas,96,druid,feral,6,1,5
Thecousins,ravencrest,96,druid,feral,6,1,5
Hecone,los-errantes,96,druid,feral,6,1,5
Fabulous,genjuros,96,druid,feral,6,1,5
Nidrien,doomhammer,96,druid,feral,6,1,5
Saliencias,kazzak,96,druid,feral,6,1,5
Hârâohshît,blackmoore,96,druid,feral,6,1,5
Onmamama,die-aldor,96,druid,feral,6,1,5
Арбузир,howling-fjord,96,druid,feral,6,1,5
Naturepower,ulduar,96,druid,feral,6,1,5
Benduu,doomhammer,96,druid,feral,6,1,5
Yaaji,archimonde,96,druid,feral,6,1,5
Albinoape,doomhammer,96,druid,feral,6,1,5
Crocobango,draenor,96,druid,feral,6,1,5
Feyzode,ysondre,96,druid,feral,6,1,5
Yarrp,stormscale,96,druid,feral,6,1,5
Zypra,shadowsong,96,druid,feral,6,1,5
Edos,lordaeron,96,druid,feral,6,1,5
Elhezar,dun-modr,96,druid,feral,6,1,5
Eneel,malganis,96,druid,feral,6,1,5
Пикиточеные,howling-fjord,96,druid,feral,6,1,5
Venomjr,bloodhoof,96,druid,feral,6,1,5
Виена,blackscar,96,druid,feral,6,1,5
Laaide,blackmoore,96,druid,feral,6,1,5
Hefdgaharald,antonidas,96,druid,feral,6,1,5
Thaneo,blackmoore,96,druid,feral,6,1,5
Biggmac,hyjal,96,druid,feral,6,1,5
Worgren,doomhammer,96,druid,feral,6,1,5
Leslra,agamaggan,96,druid,feral,6,1,5
Хеельхеем,gordunni,96,druid,feral,6,1,5
Yamsha,dalaran,96,druid,feral,6,1,5
Catgirlx,ravencrest,96,druid,feral,6,1,5
Ãnimal,argent-dawn,96,druid,feral,6,1,5
Bitsuie,magtheridon,96,druid,feral,6,1,5
Théodên,dalaran,96,druid,feral,6,1,5
Prayshot,hyjal,96,druid,feral,6,1,5
Plàntz,tarren-mill,96,druid,feral,6,1,5
Xenrakh,blackhand,96,druid,feral,6,1,5
Tshungubuäch,eredar,96,druid,feral,6,1,5
Spoco,defias-brotherhood,96,druid,feral,6,1,5
Zinister,hyjal,96,druid,feral,6,1,5
Бьеорн,gordunni,96,druid,feral,6,1,5
Bolhás,defias-brotherhood,96,druid,feral,6,1,5
Seraxi,der-mithrilorden,96,druid,feral,6,1,5
Bakslat,draenor,96,druid,feral,6,1,5
Абапер,galakrond,96,druid,feral,6,1,5
Папакамбэк,grom,96,druid,feral,6,1,5
Sabresheep,twisting-nether,96,druid,feral,6,1,5
Опаснокрасив,soulflayer,96,druid,feral,6,1,5
Rastacow,darkmoon-faire,96,druid,feral,6,1,5
Majesty,nagrand,96,druid,feral,6,1,5
Strand,ragnaros,96,druid,feral,6,1,5
Stjärna,kult-der-verdammten,96,druid,feral,6,1,5
Tartáros,blackrock,96,druid,feral,6,1,5
Hyza,bronzebeard,96,druid,feral,6,1,5
Heav,kiljaeden,96,druid,feral,6,1,5
Dëlins,outland,96,druid,feral,6,1,5
Lucianis,drakthul,96,druid,feral,6,1,5
Мурталор,soulflayer,96,druid,feral,6,1,5
Plantz,argent-dawn,96,druid,feral,6,1,5
Cesty,silvermoon,96,druid,feral,6,1,5
Esyae,silvermoon,96,druid,feral,6,1,5
Ragnai,emerald-dream,96,druid,feral,6,1,5
Aristrea,dun-morogh,96,druid,feral,6,1,5
Escares,blackrock,96,druid,feral,6,1,5
Tael,argent-dawn,96,druid,feral,6,1,5
Toxii,argent-dawn,96,druid,feral,10,1,9
Egoistsenpai,draenor,96,druid,feral,11,1,10
Réck,chamber-of-aspects,96,druid,feral,12,1,11
Sainsy,silvermoon,96,druid,feral,12,1,11
Raferalston,nathrezim,96,druid,feral,12,1,11
Mássive,darkmoon-faire,96,druid,feral,12,1,11
Farnae,kirin-tor,96,druid,feral,12,1,11
Mäywen,ravencrest,96,druid,feral,12,1,11
Snok,twisting-nether,96,druid,feral,12,1,11
Nakkikastike,magtheridon,96,druid,feral,12,1,11
Anorixx,outland,96,druid,feral,12,1,11
Enukai,blackmoore,96,druid,feral,12,1,11
Scaramouches,ravencrest,96,druid,feral,12,1,11
Moonroxx,elune,96,druid,feral,12,1,11
Veyronn,burning-legion,96,druid,feral,12,1,11
Voraxdr,draenor,96,druid,feral,12,1,11
Druidlaba,drakthul,96,druid,feral,12,1,11
Yabooni,ravencrest,96,druid,feral,12,1,11
Sempai,hyjal,96,druid,feral,18,1,17
Randompappa,stormreaver,96,druid,feral,18,1,17
Bidodici,nemesis,95,druid,feral,6,1,5
Малориус,eversong,95,druid,feral,9,1,8
Allîyâ,archimonde,79,druid,feral,5,1,4
Прокси,gordunni,64,druid,feral,4,1,3
Forigiver,draenor,64,druid,feral,4,1,3
Beinskjørhët,silvermoon,64,druid,feral,4,1,3
Tamakie,blackmoore,64,druid,feral,4,1,3
Férônïxa,dalaran,48,druid,feral,3,1,2
Cus,tarren-mill,48,druid,feral,3,1,2
Philybo,blackrock,48,druid,feral,6,1,5
Buunchishi,archimonde,42,druid,feral,9,2,7
Methàz,stormscale,31,druid,feral,2,1,1
Гримах,gordunni,16,druid,feral,1,1,0
Fuséton,tarren-mill,2490,druid,balance,427,255,172
Kaabeedo,ravencrest,2416,druid,balance,120,74,46
Immuz,kazzak,2407,druid,balance,178,103,75
Wwboomy,kazzak,2401,druid,balance,186,102,84
Afky,stormreaver,2397,druid,balance,293,161,132
Maroxd,stormscale,2393,druid,balance,156,101,55
Melby,tarren-mill,2390,druid,balance,273,146,127
Brøkéday,kazzak,2376,druid,balance,167,103,64
Bbl,rexxar,2358,druid,balance,126,79,47
Merceý,ravencrest,2323,druid,balance,97,65,32
Antahka,archimonde,2322,druid,balance,107,63,44
Опущеныйкелх,gordunni,2310,druid,balance,209,112,97
Frapucino,ravencrest,2302,druid,balance,141,99,42
Sleepz,blackrock,2284,druid,balance,197,124,73
Shåmss,kazzak,2265,druid,balance,72,43,29
Gigacooker,ravencrest,2264,druid,balance,138,91,47
Dezarden,die-aldor,2258,druid,balance,189,112,77
Boomky,blackmoore,2246,druid,balance,84,50,34
Топу,gordunni,2243,druid,balance,78,59,19
Muhammadali,ravencrest,2228,druid,balance,84,51,33
Bd,stormscale,2225,druid,balance,83,49,34
Бубаджек,howling-fjord,2225,druid,balance,125,73,52
Senfkai,kelthuzad,2223,druid,balance,72,59,13
Jwrld,stormscale,2216,druid,balance,84,46,38
Shayia,aegwynn,2216,druid,balance,191,104,87
Wriong,ravencrest,2215,druid,balance,169,101,68
Tmeister,kazzak,2202,druid,balance,156,91,65
Yalojr,blackmoore,2198,druid,balance,68,44,24
Batboomie,zuljin,2198,druid,balance,280,156,124
Lucidz,kazzak,2196,druid,balance,86,46,40
Trungoo,blackrock,2194,druid,balance,120,81,39
Bigdambitex,draenor,2192,druid,balance,66,46,20
Zødzin,kazzak,2187,druid,balance,138,75,63
Limme,ravencrest,2182,druid,balance,192,120,72
Shayîa,nozdormu,2181,druid,balance,128,77,51
Ackiz,ravencrest,2181,druid,balance,105,61,44
Стомпбр,gordunni,2180,druid,balance,204,120,84
Celtimi,antonidas,2178,druid,balance,106,74,32
Eôxxd,blackrock,2177,druid,balance,125,80,45
Squirtdogx,drakthul,2174,druid,balance,71,43,28
Blanoz,ravencrest,2174,druid,balance,435,221,214
Norgand,die-aldor,2173,druid,balance,42,33,9
Flanagân,hyjal,2171,druid,balance,60,36,24
Bulla,culte-de-la-rive-noire,2170,druid,balance,355,198,157
Shivany,outland,2165,druid,balance,222,131,91
Handsoff,stormscale,2163,druid,balance,336,177,159
Broccoliboy,sylvanas,2162,druid,balance,234,123,111
Bakkú,ravencrest,2158,druid,balance,66,45,21
Catchmê,archimonde,2154,druid,balance,92,55,37
Výragosa,der-rat-von-dalaran,2150,druid,balance,170,98,72
Positivîty,stormscale,2150,druid,balance,224,129,95
Kabôôm,stormscale,2147,druid,balance,132,76,56
Pultsarí,tarren-mill,2146,druid,balance,168,94,74
Sleepyhallow,blackmoore,2143,druid,balance,106,61,45
Votionex,tarren-mill,2142,druid,balance,112,69,43
Mopboomkin,twisting-nether,2140,druid,balance,90,48,42
Mdrgtwo,ravencrest,2139,druid,balance,110,75,35
Sadgeconvoke,draenor,2136,druid,balance,430,244,186
Juicew,stormscale,2135,druid,balance,71,46,25
Jettad,ravencrest,2135,druid,balance,106,61,45
Ursulaboomer,blackrock,2135,druid,balance,126,71,55
Flanders,blackrock,2134,druid,balance,84,61,23
Rlwlwlwlwr,twisting-nether,2133,druid,balance,84,58,26
Moodý,aegwynn,2131,druid,balance,196,115,81
Winkler,kazzak,2130,druid,balance,56,41,15
Richandblind,ravencrest,2129,druid,balance,108,59,49
Hehehahahah,kazzak,2127,druid,balance,93,62,31
Eviscreator,stormscale,2127,druid,balance,156,96,60
Isatá,ravencrest,2127,druid,balance,90,52,38
Starbro,grim-batol,2125,druid,balance,78,42,36
Laker,stormscale,2124,druid,balance,269,148,121
Стомпбр,howling-fjord,2123,druid,balance,131,77,54
Eddiethepunk,ravencrest,2121,druid,balance,430,243,187
Даирлин,gordunni,2121,druid,balance,214,111,103
Yore,tichondrius,2120,druid,balance,102,72,30
Bumkin,bloodhoof,2120,druid,balance,72,41,31
Ööh,outland,2120,druid,balance,186,99,87
Даена,razuvious,2119,druid,balance,120,83,37
Kirexz,blackrock,2119,druid,balance,89,58,31
Stb,outland,2119,druid,balance,96,60,36
Klimakleber,ravencrest,2119,druid,balance,182,94,88
Wrathgodx,aegwynn,2118,druid,balance,72,47,25
Nàaz,stormscale,2117,druid,balance,71,44,27
Tronchetto,nemesis,2113,druid,balance,126,69,57
Okøë,marécage-de-zangar,2112,druid,balance,72,42,30
Óðinn,stormscale,2110,druid,balance,71,57,14
Méáckós,aegwynn,2110,druid,balance,194,99,95
Skivesnulle,kazzak,2110,druid,balance,369,185,184
Quadpulse,ravencrest,2109,druid,balance,75,42,33
Credenz,frostmane,2109,druid,balance,270,151,119
Muufasa,blackmoore,2109,druid,balance,338,179,159
Wrldx,twisting-nether,2107,druid,balance,334,185,149
Bompfer,blackmoore,2107,druid,balance,126,63,63
Løsër,ravencrest,2105,druid,balance,110,58,52
Pikatwo,tyrande,2104,druid,balance,68,46,22
Bambye,stormscale,2104,druid,balance,242,146,96
Øncê,durotan,2104,druid,balance,126,67,59
Zuterlø,ragnaros,2104,druid,balance,310,162,148
Cioaralba,sylvanas,2102,druid,balance,193,112,81
Connorz,blackmoore,2102,druid,balance,249,141,108
Senoxiia,antonidas,2101,druid,balance,172,95,77
Эё,howling-fjord,2094,druid,balance,178,107,71
Deép,nazjatar,2092,druid,balance,255,127,128
Feelstreeman,twisting-nether,2089,druid,balance,102,55,47
Nevermeldx,blackrock,2088,druid,balance,107,62,45
Vabore,twisting-nether,2085,druid,balance,222,110,112
Bittebads,stormscale,2079,druid,balance,72,46,26
Mooskie,draenor,2078,druid,balance,78,51,27
Ôwlnur,kult-der-verdammten,2077,druid,balance,103,59,44
Kënzo,ravencrest,2077,druid,balance,326,186,140
Saufeb,stormscale,2074,druid,balance,201,111,90
Rootzxx,ravencrest,2072,druid,balance,233,124,109
Shivany,twisting-nether,2071,druid,balance,204,104,100
Rek,sanguino,2070,druid,balance,141,76,65
Gulmi,outland,2069,druid,balance,147,84,63
Friedbrocolí,tarren-mill,2062,druid,balance,60,40,20
Zaoow,stormscale,2062,druid,balance,251,143,108
Jerrybeans,ravencrest,2061,druid,balance,114,68,46
Shakso,stormscale,2059,druid,balance,232,127,105
Tuttu,kazzak,2057,druid,balance,220,119,101
Josedudu,twisting-nether,2055,druid,balance,133,78,55
Dincks,draenor,2054,druid,balance,100,61,39
Brovis,sylvanas,2053,druid,balance,115,75,40
Mephîs,ravencrest,2053,druid,balance,94,57,37
Maijs,ravencrest,2053,druid,balance,96,46,50
Thelire,silvermoon,2047,druid,balance,533,270,263
Win,hellscream,2046,druid,balance,114,65,49
Memphiswhx,drakthul,2046,druid,balance,186,103,83
Rexonadudu,kazzak,2045,druid,balance,195,110,85
Crippaa,tarren-mill,2044,druid,balance,145,85,60
Karvajyrä,stormreaver,2044,druid,balance,431,233,198
Bum,ravencrest,2041,druid,balance,41,32,9
Didiee,kazzak,2040,druid,balance,249,135,114
Kruwkamilka,burning-legion,2040,druid,balance,355,189,166
Nutsnack,tarren-mill,2039,druid,balance,78,38,40
Carnivals,twisting-nether,2038,druid,balance,390,205,185
Øsbura,silvermoon,2037,druid,balance,90,54,36
Slaugh,zuljin,2036,druid,balance,186,100,86
Starsy,frostmane,2034,druid,balance,101,48,53
Tomyn,burning-legion,2031,druid,balance,190,101,89
Zyndril,silvermoon,2030,druid,balance,66,34,32
Høtpøket,ravencrest,2028,druid,balance,54,36,18
Anéry,ravencrest,2027,druid,balance,112,62,50
Elinaax,outland,2026,druid,balance,166,96,70
Kokslina,sylvanas,2026,druid,balance,89,42,47
Hefnerd,grim-batol,2023,druid,balance,53,39,14
Fullfatcream,stormscale,2022,druid,balance,132,76,56
Nuvemone,stormscale,2022,druid,balance,200,112,88
Secrägodx,ragnaros,2020,druid,balance,152,85,67
Melábufes,dun-modr,2020,druid,balance,144,78,66
Izhusky,ravencrest,2019,druid,balance,192,107,85
Рябчиик,blackscar,2018,druid,balance,428,230,198
Ilovestacy,outland,2016,druid,balance,114,71,43
Flanagàn,hyjal,2016,druid,balance,82,41,41
Dakotaboomer,ravencrest,2014,druid,balance,96,51,45
Dnblifestyle,zirkel-des-cenarius,2013,druid,balance,204,106,98
Citróne,blackrock,2012,druid,balance,60,38,22
Lilpumpz,outland,2009,druid,balance,113,58,55
Veganvapex,draenor,2008,druid,balance,175,103,72
Владисзади,gordunni,2008,druid,balance,149,80,69
Admeliora,ravencrest,2007,druid,balance,83,54,29
Miaszha,blackmoore,2007,druid,balance,152,95,57
Grässoppa,tarren-mill,2004,druid,balance,124,67,57
Gonyogonyo,blackmoore,2003,druid,balance,81,43,38
Gambós,kazzak,2002,druid,balance,77,41,36
Akinimod,ravencrest,2000,druid,balance,120,69,51
Boomjutzu,kazzak,2000,druid,balance,59,33,26
Tenzuk,archimonde,1996,druid,balance,48,36,12
Underrated,darksorrow,1996,druid,balance,66,46,20
Zâe,archimonde,1996,druid,balance,58,37,21
Pvekek,stormscale,1996,druid,balance,181,103,78
Kenzia,stormrage,1995,druid,balance,96,57,39
Disvikz,outland,1995,druid,balance,146,79,67
ßouncy,twisting-nether,1992,druid,balance,77,54,23
Greenful,drakthul,1991,druid,balance,126,72,54
Orangeterror,stormscale,1989,druid,balance,131,81,50
Broflovskii,tarren-mill,1989,druid,balance,96,47,49
Jstdru,ravencrest,1988,druid,balance,138,88,50
Ljóskan,kazzak,1988,druid,balance,93,49,44
Zendda,hyjal,1987,druid,balance,91,48,43
Rngmåchinéx,ravencrest,1986,druid,balance,172,112,60
Artistdubose,kazzak,1985,druid,balance,126,75,51
Kÿara,khaz-modan,1985,druid,balance,143,76,67
Låsèrpêwpéw,tarren-mill,1984,druid,balance,251,141,110
Zulucat,aegwynn,1983,druid,balance,24,21,3
Transmangodx,tarren-mill,1982,druid,balance,126,73,53
Newaccount,kazzak,1980,druid,balance,252,138,114
Trekkertt,zuljin,1980,druid,balance,77,41,36
Luphrekfurry,ysondre,1979,druid,balance,60,39,21
Knùbz,ravencrest,1979,druid,balance,137,73,64
Detü,blackrock,1978,druid,balance,161,92,69
Mønrøe,ravencrest,1978,druid,balance,89,49,40
Fattydomdom,alakir,1977,druid,balance,36,27,9
Ferraridudux,ravencrest,1977,druid,balance,36,26,10
Boomeris,ravencrest,1977,druid,balance,74,47,27
Lodikum,defias-brotherhood,1975,druid,balance,42,33,9
Sleepystacy,argent-dawn,1975,druid,balance,216,120,96
Smøkewéed,ravencrest,1974,druid,balance,66,39,27
Rbgkári,draenor,1974,druid,balance,139,82,57
Sartipus,draenor,1974,druid,balance,270,149,121
Løo,moonglade,1973,druid,balance,121,75,46
Pikamoo,kazzak,1973,druid,balance,65,39,26
Lappe,stormreaver,1973,druid,balance,41,24,17
Kankstery,stormscale,1972,druid,balance,83,56,27
Kissachtak,blackrock,1972,druid,balance,75,50,25
Metzarqq,stormscale,1971,druid,balance,96,64,32
Calê,blackrock,1971,druid,balance,361,199,162
Trntydr,senjin,1969,druid,balance,65,44,21
Twitchmoney,archimonde,1969,druid,balance,109,73,36
Anpassad,outland,1968,druid,balance,93,52,41
Millions,tarren-mill,1967,druid,balance,141,90,51
Senzuli,stormscale,1967,druid,balance,165,103,62
Linkin,azshara,1967,druid,balance,239,131,108
Bmybmybmybmy,outland,1965,druid,balance,36,30,6
Toxicclones,tarren-mill,1965,druid,balance,48,38,10
Taveirasurge,kazzak,1963,druid,balance,125,79,46
Hppsr,eredar,1963,druid,balance,131,70,61
Ciucciotutto,nemesis,1962,druid,balance,72,50,22
Lifeseed,ravencrest,1962,druid,balance,197,102,95
Turtleform,blackrock,1961,druid,balance,138,64,74
Bîjaqt,blackmoore,1960,druid,balance,48,32,16
ßa,blackmoore,1960,druid,balance,59,38,21
Uglyrasputin,blackmoore,1960,druid,balance,156,94,62
Wizzlafa,ravencrest,1960,druid,balance,82,48,34
Миртлэкшн,gordunni,1959,druid,balance,107,61,46
Исканет,gordunni,1958,druid,balance,72,46,26
Hotflora,aegwynn,1957,druid,balance,66,39,27
Superchïcken,archimonde,1955,druid,balance,78,43,35
Ethiqd,aegwynn,1952,druid,balance,66,46,20
Tobid,blackrock,1949,druid,balance,66,47,19
Navex,blackrock,1948,druid,balance,42,31,11
Cutiepain,kazzak,1948,druid,balance,98,61,37
Cmfg,blackrock,1947,druid,balance,121,71,50
Kayllie,silvermoon,1947,druid,balance,108,63,45
Néllÿ,elune,1943,druid,balance,168,84,84
Ovérheal,ravencrest,1941,druid,balance,111,69,42
Juicypus,ragnaros,1941,druid,balance,205,110,95
Justyo,archimonde,1940,druid,balance,129,80,49
Найттир,gordunni,1940,druid,balance,87,49,38
Soofiaa,ravencrest,1939,druid,balance,44,35,9
Escaa,stormscale,1939,druid,balance,110,61,49
Mmlprox,burning-legion,1938,druid,balance,42,25,17
Cassiddyy,draenor,1937,druid,balance,78,45,33
Ахахахахахх,soulflayer,1936,druid,balance,220,127,93
Nythielle,argent-dawn,1935,druid,balance,214,108,106
Ganqb,ravencrest,1934,druid,balance,573,307,266
Randomnup,sanguino,1933,druid,balance,114,64,50
Øhmygød,stormscale,1932,druid,balance,114,62,52
Rekked,alleria,1931,druid,balance,96,57,39
Gurru,xavius,1931,druid,balance,254,131,123
Lóvebeam,ravencrest,1930,druid,balance,60,36,24
Iloveher,ravencrest,1930,druid,balance,84,49,35
Светдру,blackscar,1929,druid,balance,59,36,23
Nóque,ravencrest,1929,druid,balance,130,73,57
Kabòöóm,outland,1928,druid,balance,72,49,23
Воому,soulflayer,1928,druid,balance,54,35,19
Jerie,silvermoon,1928,druid,balance,96,60,36
Näela,archimonde,1928,druid,balance,60,31,29
Knastx,ravencrest,1927,druid,balance,54,39,15
Captaïn,twisting-nether,1927,druid,balance,84,54,30
Shåmssz,kazzak,1926,druid,balance,44,31,13
Veonski,argent-dawn,1925,druid,balance,105,57,48
Аронэл,blackscar,1924,druid,balance,82,54,28
Legitx,dentarg,1924,druid,balance,109,63,46
Мариантус,greymane,1924,druid,balance,219,116,103
Emmdru,silvermoon,1923,druid,balance,167,98,69
Impmoden,blackrock,1922,druid,balance,61,40,21
ßoomin,tarren-mill,1921,druid,balance,60,29,31
Restaidpvs,wildhammer,1920,druid,balance,72,38,34
Gretathnberg,ravencrest,1919,druid,balance,62,33,29
Ледруд,gordunni,1918,druid,balance,134,67,67
Taurendruid,the-maelstrom,1917,druid,balance,195,110,85
Tommyruin,the-venture-co,1917,druid,balance,197,106,91
Вбг,soulflayer,1917,druid,balance,317,166,151
Peaches,aerie-peak,1916,druid,balance,95,61,34
Metamoo,tarren-mill,1914,druid,balance,57,43,14
Trytargetme,outland,1914,druid,balance,138,78,60
Heiden,terokkar,1912,druid,balance,71,41,30
Phobidru,thrall,1911,druid,balance,66,37,29
Malex,auchindoun,1910,druid,balance,114,63,51
Crnkie,sylvanas,1909,druid,balance,72,44,28
Björnskift,tarren-mill,1909,druid,balance,119,64,55
Mirynn,elune,1909,druid,balance,211,111,100
Oskol,tarren-mill,1909,druid,balance,160,77,83
Imbadxx,kazzak,1908,druid,balance,66,44,22
Chavinelf,twisting-nether,1908,druid,balance,60,35,25
Vermz,tarren-mill,1907,druid,balance,83,49,34
Shàal,ysondre,1907,druid,balance,211,113,98
Ïndrä,arathi,1907,druid,balance,214,112,102
Fantomasik,drakthul,1907,druid,balance,593,305,288
Maladorf,draenor,1906,druid,balance,107,67,40
Msb,the-maelstrom,1906,druid,balance,59,34,25
Øwlkin,ravencrest,1906,druid,balance,57,31,26
Siuo,ravencrest,1906,druid,balance,95,51,44
Andreud,dunemaul,1904,druid,balance,131,67,64
Sentería,sylvanas,1904,druid,balance,96,44,52
Lacÿn,twisting-nether,1903,druid,balance,30,24,6
Superdr,ragnaros,1902,druid,balance,82,56,26
Kjøttberit,moonglade,1902,druid,balance,66,42,24
Rain,kazzak,1902,druid,balance,167,96,71
Traickovic,eredar,1902,druid,balance,48,26,22
Máedhros,ravencrest,1901,druid,balance,90,60,30
Eloahdruid,blackhand,1901,druid,balance,129,72,57
Coqqbock,blackrock,1901,druid,balance,60,29,31
Reichpoulet,archimonde,1900,druid,balance,42,30,12
Drcaøs,sanguino,1900,druid,balance,188,106,82
Jenovas,argent-dawn,1900,druid,balance,147,80,67
Baerbock,kazzak,1899,druid,balance,76,49,27
Euphoríax,ravencrest,1899,druid,balance,112,70,42
Lazermonster,tarren-mill,1899,druid,balance,54,32,22
Starcowx,ragnaros,1899,druid,balance,278,146,132
Månemannen,outland,1898,druid,balance,30,20,10
Rlwlwlwrtwo,twisting-nether,1898,druid,balance,60,31,29
Interaktio,ravencrest,1896,druid,balance,34,24,10
Mqs,stormscale,1896,druid,balance,187,110,77
Suomenlorgok,stormreaver,1895,druid,balance,109,67,42
Bobobobobobo,blackrock,1895,druid,balance,344,188,156
Ezeke,eredar,1895,druid,balance,206,104,102
Boomdruud,tarren-mill,1894,druid,balance,36,22,14
Klappskaft,outland,1894,druid,balance,47,28,19
Thcpositiv,aegwynn,1894,druid,balance,303,155,148
Gnrio,twisting-nether,1893,druid,balance,143,85,58
Meowcry,outland,1893,druid,balance,138,78,60
Mîrxy,outland,1892,druid,balance,66,42,24
Notsikaan,blackhand,1892,druid,balance,73,38,35
Рейзакх,howling-fjord,1892,druid,balance,306,154,152
Xqzmybleedz,onyxia,1891,druid,balance,158,99,59
Thràralith,silvermoon,1891,druid,balance,155,90,65
Dràkàn,dethecus,1890,druid,balance,120,64,56
Fredhqt,tarren-mill,1889,druid,balance,71,41,30
Vamix,aegwynn,1888,druid,balance,30,25,5
Aggroasian,tarren-mill,1888,druid,balance,315,168,147
Когтелёт,soulflayer,1886,druid,balance,66,44,22
Vainzxdr,ravencrest,1886,druid,balance,73,48,25
Ayouftcala,ravencrest,1886,druid,balance,45,27,18
Jeaylqt,archimonde,1886,druid,balance,57,32,25
Небесныйхант,soulflayer,1886,druid,balance,211,109,102
Madhatterr,kazzak,1884,druid,balance,114,79,35
Raykk,culte-de-la-rive-noire,1883,druid,balance,45,31,14
Hirmo,ragnaros,1882,druid,balance,81,54,27
Narq,sylvanas,1881,druid,balance,90,53,37
Blopstar,stormscale,1879,druid,balance,54,34,20
Luphrekmeow,ravencrest,1879,druid,balance,51,32,19
Valijan,blackrock,1879,druid,balance,64,31,33
Druvex,blackrock,1876,druid,balance,35,25,10
Shakeme,zuljin,1876,druid,balance,102,56,46
Eñzo,stormscale,1875,druid,balance,143,83,60
Gabedru,agamaggan,1874,druid,balance,48,34,14
Yosimoo,draenor,1874,druid,balance,118,75,43
Triskelion,burning-legion,1874,druid,balance,166,90,76
Mopferal,twisting-nether,1873,druid,balance,87,63,24
Bolaballen,stormscale,1873,druid,balance,99,63,36
Shroomdoom,ravencrest,1873,druid,balance,59,29,30
Mikhaili,stormreaver,1872,druid,balance,54,33,21
Sifferx,stormscale,1872,druid,balance,123,68,55
Æøøm,blackmoore,1871,druid,balance,321,172,149
Punxybear,ravencrest,1870,druid,balance,795,401,394
Èøèøèøèøè,stormscale,1867,druid,balance,36,28,8
Shyoxdr,twisting-nether,1867,druid,balance,107,73,34
Hyperbêast,blackrock,1866,druid,balance,41,31,10
Xerlog,thrall,1866,druid,balance,60,39,21
Tjillevippen,tarren-mill,1866,druid,balance,42,27,15
Bångebål,the-maelstrom,1863,druid,balance,42,30,12
Rudabaebey,draenor,1863,druid,balance,42,28,14
Gipi,ravencrest,1863,druid,balance,72,37,35
Mahrèz,archimonde,1862,druid,balance,55,33,22
Hornykarenn,bladefist,1861,druid,balance,83,49,34
Slahnesh,aegwynn,1859,druid,balance,72,41,31
Contrnahruk,kazzak,1857,druid,balance,53,35,18
Vregord,twisting-nether,1857,druid,balance,54,35,19
Balanc,ragnaros,1857,druid,balance,198,111,87
Laserchicken,malganis,1857,druid,balance,343,169,174
Pyaw,kazzak,1856,druid,balance,114,69,45
Hymìr,silvermoon,1856,druid,balance,159,88,71
Euphørie,twisting-nether,1856,druid,balance,384,207,177
Сосисосочка,gordunni,1856,druid,balance,114,59,55
Bastodonte,skullcrusher,1855,druid,balance,361,185,176
Embrangle,silvermoon,1854,druid,balance,78,45,33
Dreamdoll,ravencrest,1854,druid,balance,101,55,46
Deadmeøw,outland,1854,druid,balance,70,38,32
Valijaelf,blackrock,1854,druid,balance,74,39,35
Kribie,aegwynn,1853,druid,balance,90,56,34
Starfallkey,dun-modr,1853,druid,balance,177,100,77
Vulkayn,ysondre,1853,druid,balance,84,47,37
Bearpawzz,kazzak,1852,druid,balance,88,50,38
Commonsense,kazzak,1852,druid,balance,36,20,16
Xalio,ravencrest,1851,druid,balance,71,43,28
Likwidator,stormscale,1851,druid,balance,256,148,108
Boomco,stormscale,1850,druid,balance,42,28,14
Мурдермашин,deathguard,1850,druid,balance,305,164,141
Divref,tarren-mill,1848,druid,balance,30,24,6
Аласторвов,deathweaver,1848,druid,balance,236,124,112
Crywingz,antonidas,1848,druid,balance,223,114,109
Tzeeni,stormscale,1847,druid,balance,35,28,7
Lumi,culte-de-la-rive-noire,1847,druid,balance,48,30,18
Hollymedx,blackmoore,1847,druid,balance,132,82,50
Zømßie,outland,1847,druid,balance,162,95,67
Shamerika,tarren-mill,1847,druid,balance,238,129,109
Sænxx,blackrock,1846,druid,balance,42,30,12
Xtràza,archimonde,1846,druid,balance,48,33,15
Друлякич,gordunni,1846,druid,balance,49,30,19
Айрокси,blackscar,1846,druid,balance,90,49,41
Elissian,silvermoon,1846,druid,balance,357,190,167
Howgh,destromath,1846,druid,balance,278,143,135
Teebeidl,tarren-mill,1845,druid,balance,174,101,73
Мягкийвисп,howling-fjord,1845,druid,balance,138,78,60
Xora,kazzak,1845,druid,balance,197,106,91
Yggdru,ragnaros,1844,druid,balance,36,24,12
Иггдрасиль,gordunni,1844,druid,balance,181,109,72
Sylindra,argent-dawn,1844,druid,balance,148,88,60
Amazed,wildhammer,1843,druid,balance,102,61,41
Hackamore,archimonde,1843,druid,balance,343,186,157
Füllxtrap,hyjal,1842,druid,balance,36,26,10
Synexi,sylvanas,1842,druid,balance,144,85,59
Mudruu,blackrock,1842,druid,balance,66,37,29
Chacopic,archimonde,1841,druid,balance,37,27,10
Byjiblznuk,kazzak,1841,druid,balance,52,34,18
Kl,archimonde,1841,druid,balance,246,127,119
Угощаюх,howling-fjord,1840,druid,balance,95,57,38
Hammd,kazzak,1840,druid,balance,196,104,92
Duridlol,nemesis,1839,druid,balance,35,24,11
Celtixthrash,tarren-mill,1839,druid,balance,30,20,10
Hrz,kazzak,1839,druid,balance,79,50,29
Феориз,howling-fjord,1839,druid,balance,171,97,74
Bàrathrum,blackrock,1839,druid,balance,163,91,72
Mochiløxz,tarren-mill,1839,druid,balance,268,149,119
Alphadrúid,stormscale,1838,druid,balance,60,37,23
Kalthazar,twisting-nether,1838,druid,balance,60,37,23
Tykè,outland,1838,druid,balance,54,33,21
Skirr,kelthuzad,1838,druid,balance,42,23,19
Replicusowl,doomhammer,1838,druid,balance,60,31,29
Stinkyicky,sylvanas,1837,druid,balance,113,74,39
Nassii,antonidas,1836,druid,balance,168,102,66
Connydor,stormscale,1836,druid,balance,48,29,19
Флаффер,soulflayer,1836,druid,balance,90,51,39
Qtkitty,outland,1836,druid,balance,416,219,197
Atrosity,ravencrest,1835,druid,balance,66,40,26
Муромлянка,blackscar,1835,druid,balance,148,84,64
Adizero,blackrock,1834,druid,balance,61,40,21
Sylvy,dun-modr,1834,druid,balance,142,79,63
Styggtryne,outland,1834,druid,balance,353,191,162
Gehrkehotter,silvermoon,1833,druid,balance,102,65,37
Elandreth,twisting-nether,1833,druid,balance,49,31,18
Kabuul,dun-modr,1833,druid,balance,163,100,63
Brittmagi,sylvanas,1833,druid,balance,112,68,44
Ipsdray,ysondre,1833,druid,balance,157,93,64
Jøkèr,outland,1833,druid,balance,53,30,23
Хальтенис,gordunni,1833,druid,balance,144,74,70
Кирукхэ,gordunni,1832,druid,balance,36,28,8
Suitti,ravencrest,1832,druid,balance,71,47,24
Ghostpaws,ravencrest,1832,druid,balance,165,83,82
Jrdleto,blackrock,1831,druid,balance,209,111,98
Cörelly,ravencrest,1830,druid,balance,315,182,133
Kubzii,archimonde,1830,druid,balance,183,102,81
Uglybettylol,drakthul,1829,druid,balance,48,28,20
Zapx,hyjal,1829,druid,balance,212,118,94
Tummus,blackrock,1829,druid,balance,60,32,28
Lushe,kazzak,1828,druid,balance,38,24,14
Moksy,outland,1828,druid,balance,120,69,51
Лёхалепеха,gordunni,1827,druid,balance,84,52,32
Malfurien,magtheridon,1827,druid,balance,65,40,25
Barneycatz,tarren-mill,1826,druid,balance,93,50,43
Aliyxd,aegwynn,1825,druid,balance,42,28,14
Храш,gordunni,1825,druid,balance,65,39,26
Stepgødx,twisting-nether,1825,druid,balance,75,35,40
Güccïmane,twisting-nether,1824,druid,balance,116,80,36
Pluginbaby,stormscale,1824,druid,balance,82,49,33
Valgo,twisting-nether,1824,druid,balance,96,56,40
Jungleghost,sylvanas,1824,druid,balance,175,99,76
Melyssea,argent-dawn,1823,druid,balance,59,35,24
Restromide,ravencrest,1823,druid,balance,36,20,16
Pine,aggramar,1822,druid,balance,28,23,5
Faxotium,argent-dawn,1822,druid,balance,30,21,9
Djemdruid,argent-dawn,1822,druid,balance,42,27,15
Kaalil,argent-dawn,1822,druid,balance,72,40,32
Ohpfo,outland,1821,druid,balance,41,28,13
Neverpanic,stormscale,1821,druid,balance,78,48,30
Alxzdru,auchindoun,1821,druid,balance,147,89,58
Shìinx,hyjal,1821,druid,balance,60,36,24
Drøøkîé,antonidas,1821,druid,balance,239,139,100
Phucme,the-maelstrom,1821,druid,balance,144,75,69
Unohanâ,archimonde,1820,druid,balance,82,53,29
Khiree,archimonde,1820,druid,balance,56,32,24
Gallokiriko,zuljin,1820,druid,balance,171,87,84
Hyac,the-maelstrom,1819,druid,balance,42,29,13
Takemanstwix,ragnaros,1818,druid,balance,102,62,40
Totemdrood,blackmoore,1818,druid,balance,52,30,22
Isuckdruid,aegwynn,1818,druid,balance,163,91,72
Naturez,sylvanas,1818,druid,balance,104,55,49
Dyroxs,twisting-nether,1818,druid,balance,334,168,166
Sunshinex,silvermoon,1818,druid,balance,96,47,49
Рейтэн,gordunni,1817,druid,balance,54,37,17
Nerem,blackrock,1817,druid,balance,84,44,40
Ventrìx,alleria,1817,druid,balance,102,53,49
Bákhar,ravencrest,1817,druid,balance,148,71,77
Treesus,blackrock,1816,druid,balance,42,25,17
Lunahu,argent-dawn,1816,druid,balance,72,42,30
Bigpûmp,elune,1816,druid,balance,95,53,42
Чупакабра,goldrinn,1816,druid,balance,235,130,105
Shiftcaster,ravencrest,1816,druid,balance,72,35,37
Astrobazooka,stormreaver,1815,druid,balance,77,48,29
Teaser,dun-modr,1815,druid,balance,114,66,48
Neirdá,hyjal,1815,druid,balance,197,107,90
Durkdriven,kazzak,1814,druid,balance,87,54,33
Meowmf,silvermoon,1814,druid,balance,101,62,39
Afret,kazzak,1814,druid,balance,419,212,207
Mazalot,kazzak,1813,druid,balance,79,52,27
Kivimon,dun-modr,1813,druid,balance,66,41,25
Ånaðeårmas,outland,1813,druid,balance,83,51,32
Eysnd,blackrock,1813,druid,balance,90,53,37
Мунстрайк,borean-tundra,1813,druid,balance,145,82,63
Ravneskrig,ravencrest,1813,druid,balance,116,64,52
Pouletqt,archimonde,1813,druid,balance,48,26,22
Betobalance,blackmoore,1812,druid,balance,30,23,7
Bashmac,mugthol,1811,druid,balance,72,49,23
Feralenjoyer,drakthul,1811,druid,balance,42,25,17
Yarinai,blackmoore,1811,druid,balance,102,59,43
Крейзикет,eversong,1810,druid,balance,36,25,11
Лунорун,blackscar,1810,druid,balance,54,36,18
Owlbum,grim-batol,1810,druid,balance,48,31,17
Solariah,garona,1810,druid,balance,166,96,70
Scaleo,stormreaver,1810,druid,balance,96,51,45
Frenkoz,outland,1809,druid,balance,120,70,50
Pneuma,xavius,1809,druid,balance,135,78,57
Núri,lordaeron,1809,druid,balance,80,46,34
Imaginarý,ravencrest,1809,druid,balance,47,26,21
Ashtral,kazzak,1808,druid,balance,33,24,9
Adelåide,silvermoon,1808,druid,balance,60,41,19
Lashketchum,aszune,1808,druid,balance,106,71,35
Clâwdîte,blackrock,1808,druid,balance,59,36,23
Awisura,outland,1808,druid,balance,54,32,22
Ferawri,draenor,1808,druid,balance,42,24,18
Vaacku,stormreaver,1808,druid,balance,190,105,85
Djsnigel,stormscale,1808,druid,balance,145,79,66
Izzual,tarren-mill,1808,druid,balance,54,28,26
Rasgath,kazzak,1807,druid,balance,333,188,145
Cøntrol,argent-dawn,1807,druid,balance,72,40,32
Câtchmê,archimonde,1806,druid,balance,24,19,5
Icek,outland,1806,druid,balance,54,33,21
Beanery,aegwynn,1806,druid,balance,78,47,31
Калинках,soulflayer,1806,druid,balance,54,32,22
Leletmedie,ravencrest,1806,druid,balance,54,31,23
Moonleaf,burning-steppes,1806,druid,balance,54,29,25
Págánxø,kazzak,1805,druid,balance,65,42,23
Otpboomie,dun-modr,1805,druid,balance,37,23,14
Siajin,frostwolf,1805,druid,balance,108,61,47
Damagebot,tarren-mill,1805,druid,balance,117,66,51
Crunchtime,ragnaros,1805,druid,balance,133,72,61
Âlhajillo,dun-modr,1805,druid,balance,91,48,43
Akiíra,twisting-nether,1804,druid,balance,54,38,16
Loethen,argent-dawn,1804,druid,balance,110,74,36
Belvrin,argent-dawn,1804,druid,balance,100,66,34
Randyxo,blackhand,1804,druid,balance,48,30,18
Svp,ravencrest,1804,druid,balance,54,33,21
Néxct,stormscale,1804,druid,balance,54,31,23
Elunælle,les-sentinelles,1804,druid,balance,168,93,75
Ashidx,ragnaros,1803,druid,balance,48,30,18
Grafíx,blackrock,1803,druid,balance,48,28,20
Rnkx,sanguino,1803,druid,balance,57,33,24
Delmond,sylvanas,1803,druid,balance,390,210,180
Rozi,draenor,1802,druid,balance,42,25,17
Ampdru,ravencrest,1802,druid,balance,76,44,32
Narkiza,blackhand,1802,druid,balance,90,51,39
Tøyz,stormscale,1801,druid,balance,29,23,6
Alessàsavage,nemesis,1801,druid,balance,66,38,28
Geîl,blackrock,1801,druid,balance,42,24,18
Goagain,silvermoon,1801,druid,balance,196,107,89
Batmòn,stormscale,1801,druid,balance,129,69,60
Nctmé,tarren-mill,1801,druid,balance,118,56,62
Bignoober,blackrock,1800,druid,balance,35,25,10
Eselhirte,blackhand,1800,druid,balance,45,27,18
Cønvokê,tarren-mill,1800,druid,balance,121,69,52
Kartaorange,stormscale,1800,druid,balance,151,85,66
Htxo,kazzak,1798,druid,balance,54,30,24
Cuteteengirl,ravencrest,1798,druid,balance,110,60,50
Zì,stormscale,1797,druid,balance,113,67,46
Saqartvelo,tarren-mill,1797,druid,balance,108,64,44
Swagattori,sylvanas,1797,druid,balance,56,30,26
Онличикен,gordunni,1797,druid,balance,150,78,72
Whøðìspélmé,twisting-nether,1796,druid,balance,54,37,17
Vitaex,blackrock,1795,druid,balance,51,35,16
Ахаххаха,howling-fjord,1795,druid,balance,84,54,30
Zhof,ravencrest,1795,druid,balance,303,159,144
Dudukid,nemesis,1795,druid,balance,208,103,105
Abyssaldepth,ravencrest,1794,druid,balance,126,80,46
Owenwilson,twisting-nether,1794,druid,balance,90,54,36
Rexadria,blackrock,1794,druid,balance,83,48,35
Imperiusx,ravencrest,1794,druid,balance,255,141,114
Ðevilwhite,nemesis,1794,druid,balance,80,36,44
Deepak,nemesis,1793,druid,balance,78,46,32
Dizay,xavius,1792,druid,balance,72,45,27
Травкер,howling-fjord,1792,druid,balance,455,225,230
Nitsou,hyjal,1791,druid,balance,42,28,14
Aionx,ravencrest,1791,druid,balance,70,38,32
Snøø,frostwolf,1790,druid,balance,156,82,74
Bearygrylls,sylvanas,1789,druid,balance,50,33,17
Moonhusky,blackrock,1789,druid,balance,60,36,24
Yinx,darksorrow,1788,druid,balance,72,42,30
Cryspie,hyjal,1788,druid,balance,48,27,21
Ноунэймбич,blackscar,1788,druid,balance,62,31,31
Tetdru,blackhand,1786,druid,balance,24,19,5
Лсдспайсы,soulflayer,1785,druid,balance,75,47,28
Alethorn,twisting-nether,1785,druid,balance,142,86,56
Aleza,tarren-mill,1785,druid,balance,123,66,57
Drooshy,ravencrest,1784,druid,balance,57,35,22
Longhornjohn,ragnaros,1784,druid,balance,58,33,25
Druidxburst,malganis,1782,druid,balance,36,22,14
Калкалыч,lich-king,1782,druid,balance,53,30,23
Gelubaboom,ravencrest,1781,druid,balance,42,25,17
Diezzou,ysondre,1780,druid,balance,30,20,10
Owolu,kelthuzad,1779,druid,balance,30,19,11
Gudñ,tarren-mill,1779,druid,balance,83,48,35
Kót,kazzak,1779,druid,balance,125,70,55
Rosskemp,tarren-mill,1778,druid,balance,36,25,11
Jûggerslut,ysondre,1778,druid,balance,93,50,43
Hunkex,frostmane,1778,druid,balance,129,65,64
Nerfmemaybe,blackmoore,1777,druid,balance,38,27,11
Morlán,blackmoore,1777,druid,balance,30,19,11
Klørfem,draenor,1777,druid,balance,91,51,40
Doublesunday,thrall,1777,druid,balance,69,37,32
Яммаккаасии,grom,1777,druid,balance,97,49,48
Trinket,frostmane,1776,druid,balance,108,68,40
Подпивасникх,gordunni,1776,druid,balance,54,34,20
Daÿdream,ravencrest,1776,druid,balance,110,66,44
Darktigrou,archimonde,1775,druid,balance,30,21,9
Køgèr,kazzak,1775,druid,balance,30,19,11
Добродейтель,soulflayer,1775,druid,balance,264,152,112
Whisker,outland,1774,druid,balance,36,25,11
Yungtrappy,stormscale,1773,druid,balance,45,26,19
Åkømo,aegwynn,1773,druid,balance,54,31,23
Phatbushy,silvermoon,1773,druid,balance,123,70,53
Tárzáñ,ravencrest,1773,druid,balance,138,74,64
Råichu,kazzak,1772,druid,balance,24,20,4
Zuckersüß,twisting-nether,1772,druid,balance,33,24,9
Rivella,blackrock,1772,druid,balance,93,48,45
Арадия,gordunni,1772,druid,balance,161,80,81
Pharaah,stormscale,1771,druid,balance,77,50,27
Varokka,aegwynn,1770,druid,balance,48,29,19
Lunel,arathor,1769,druid,balance,115,64,51
Совёнушек,howling-fjord,1769,druid,balance,107,57,50
Xoap,kazzak,1768,druid,balance,36,27,9
Moonenjoyer,kazzak,1768,druid,balance,48,31,17
Holziger,azshara,1768,druid,balance,88,54,34
Chøpzjr,blackrock,1768,druid,balance,90,52,38
Skarbowka,burning-legion,1767,druid,balance,42,29,13
Utiniutini,thrall,1767,druid,balance,168,95,73
Shiftowl,tarren-mill,1766,druid,balance,36,25,11
Mayfury,blackmoore,1766,druid,balance,42,28,14
Hotsincee,stormscale,1764,druid,balance,199,110,89
Ruetinjeri,blackmoore,1764,druid,balance,109,55,54
Clonecity,ravencrest,1763,druid,balance,36,26,10
Грандал,howling-fjord,1763,druid,balance,138,74,64
Mesmerizing,ravencrest,1762,druid,balance,156,79,77
Damöb,ravencrest,1761,druid,balance,100,55,45
Pøpp,archimonde,1761,druid,balance,115,62,53
Symbiosa,silvermoon,1760,druid,balance,147,89,58
Flæppy,blackmoore,1760,druid,balance,482,237,245
Kotaryzi,kazzak,1758,druid,balance,24,19,5
Större,twisting-nether,1758,druid,balance,56,41,15
Mjáy,tarren-mill,1758,druid,balance,84,45,39
Mahwi,das-konsortium,1757,druid,balance,66,43,23
Taylorshîft,burning-legion,1757,druid,balance,60,31,29
Bearlylegál,outland,1756,druid,balance,30,19,11
Трэйкотик,blackscar,1756,druid,balance,83,48,35
Cyclonejk,blackrock,1754,druid,balance,42,28,14
Yabooni,ravencrest,1754,druid,balance,108,66,42
Felicìty,draenor,1753,druid,balance,54,34,20
Tallu,das-konsortium,1752,druid,balance,90,51,39
Baboss,chogall,1752,druid,balance,140,76,64
Мэдикейт,soulflayer,1751,druid,balance,141,80,61
Сибирячечка,greymane,1751,druid,balance,188,101,87
Louisv,kazzak,1750,druid,balance,123,64,59
Lílpèëpgødx,archimonde,1749,druid,balance,36,24,12
Minaervea,antonidas,1748,druid,balance,47,31,16
Hilom,grim-batol,1748,druid,balance,47,29,18
Blood,frostwolf,1748,druid,balance,96,52,44
Ymagyne,frostmane,1748,druid,balance,56,29,27
Balencìága,sanguino,1747,druid,balance,101,61,40
Chimmi,ragnaros,1747,druid,balance,84,44,40
Ðréws,ravencrest,1745,druid,balance,42,29,13
Malaprljavca,kazzak,1745,druid,balance,120,72,48
Kylaaz,die-ewige-wacht,1745,druid,balance,183,104,79
Zkrd,kazzak,1745,druid,balance,67,35,32
Krustý,malganis,1745,druid,balance,60,30,30
Babynaty,ravencrest,1745,druid,balance,188,91,97
Хотдиллер,howling-fjord,1744,druid,balance,54,35,19
Wykked,outland,1744,druid,balance,72,37,35
Ñêkø,ravencrest,1743,druid,balance,76,49,27
Senoxia,antonidas,1743,druid,balance,54,34,20
Naraia,aegwynn,1743,druid,balance,46,24,22
Dreathqt,twisting-nether,1742,druid,balance,114,55,59
Jamzydruid,kazzak,1741,druid,balance,114,61,53
Shreddies,the-maelstrom,1740,druid,balance,61,33,28
Azurai,blackmoore,1739,druid,balance,126,71,55
Moonasiahn,hyjal,1739,druid,balance,102,55,47
Qtrly,ravencrest,1739,druid,balance,74,36,38
Ashleyx,antonidas,1738,druid,balance,36,30,6
Kajhan,silvermoon,1738,druid,balance,96,59,37
Tshungubuäch,eredar,1737,druid,balance,54,37,17
Pewpewflap,kazzak,1737,druid,balance,125,73,52
Sagezza,draenor,1737,druid,balance,603,311,292
Nevax,blackrock,1736,druid,balance,30,21,9
Fuzzylol,haomarush,1736,druid,balance,41,24,17
Maelkan,sanguino,1736,druid,balance,245,132,113
Haanook,ravencrest,1736,druid,balance,219,117,102
Shreedex,blackmoore,1735,druid,balance,78,50,28
Ccoco,aegwynn,1735,druid,balance,108,53,55
Jaycutler,archimonde,1734,druid,balance,132,70,62
Sakkrethd,hyjal,1733,druid,balance,36,23,13
Shyngodx,archimonde,1733,druid,balance,239,129,110
Áäáäáäáäáäáä,ravencrest,1733,druid,balance,101,50,51
Xora,aegwynn,1732,druid,balance,73,43,30
Pumpingurass,twisting-nether,1732,druid,balance,54,31,23
Juvencus,twisting-nether,1731,druid,balance,48,27,21
Slaskêt,tarren-mill,1730,druid,balance,116,64,52
Obsessíon,kazzak,1729,druid,balance,101,59,42
Midnightowl,stormscale,1728,druid,balance,30,21,9
Duckiethotx,twisting-nether,1728,druid,balance,48,27,21
Cptnclone,blackmoore,1727,druid,balance,96,52,44
Зенза,howling-fjord,1727,druid,balance,150,81,69
Ахисса,gordunni,1727,druid,balance,78,37,41
Beefsteaxs,thrall,1726,druid,balance,79,56,23
Drulier,doomhammer,1726,druid,balance,114,70,44
Twerkdabooty,azjolnerub,1725,druid,balance,42,27,15
Хфикс,gordunni,1725,druid,balance,238,142,96
Ларунс,blackscar,1725,druid,balance,83,48,35
Jmaz,outland,1724,druid,balance,83,49,34
Catsareevil,silvermoon,1724,druid,balance,56,33,23
Bashfui,draenor,1724,druid,balance,228,126,102
Fiskmåsn,twisting-nether,1724,druid,balance,279,146,133
Gorthunx,kazzak,1723,druid,balance,146,88,58
Garffield,ysondre,1722,druid,balance,42,32,10
Nexirøs,hyjal,1722,druid,balance,116,74,42
Cihoyw,ragnaros,1722,druid,balance,41,26,15
Píøøx,tarren-mill,1722,druid,balance,84,53,31
Oommis,outland,1722,druid,balance,48,28,20
Кыцко,soulflayer,1722,druid,balance,145,80,65
Cowgurl,stormscale,1722,druid,balance,78,41,37
Pwnylol,teldrassil,1721,druid,balance,70,46,24
Jaiyen,ravencrest,1721,druid,balance,118,71,47
Borderliner,blackrock,1721,druid,balance,116,69,47
Hugeragê,stormreaver,1721,druid,balance,107,51,56
Anabola,frostwhisper,1720,druid,balance,77,43,34
Bôoze,nathrezim,1719,druid,balance,66,38,28
Iamobito,blackmoore,1719,druid,balance,42,24,18
Goldencat,blackhand,1719,druid,balance,108,56,52
Grisdrood,draenor,1719,druid,balance,412,211,201
Kalgarm,burning-legion,1719,druid,balance,66,29,37
Canezmvp,blackrock,1718,druid,balance,36,21,15
Nyndrà,archimonde,1717,druid,balance,195,92,103
Zulrája,outland,1716,druid,balance,42,25,17
Khålêd,kazzak,1714,druid,balance,52,38,14
Opathecool,bladefist,1714,druid,balance,71,44,27
Yapyapyapyap,eredar,1713,druid,balance,42,25,17
Hælìñgtøúçh,ysondre,1713,druid,balance,51,28,23
Ævus,outland,1713,druid,balance,74,38,36
Pradasurge,ravencrest,1712,druid,balance,179,99,80
Владибой,gordunni,1712,druid,balance,36,18,18
Zeaba,ravencrest,1711,druid,balance,24,18,6
Сансплэш,lich-king,1711,druid,balance,68,45,23
Scars,outland,1710,druid,balance,30,18,12
Rootalot,blackrock,1710,druid,balance,54,31,23
Louieform,outland,1709,druid,balance,48,32,16
Rassia,blackrock,1709,druid,balance,84,54,30
Kørra,dun-modr,1707,druid,balance,73,42,31
Bákhar,kazzak,1707,druid,balance,54,26,28
Evangels,nemesis,1706,druid,balance,24,18,6
Bonza,agamaggan,1706,druid,balance,32,20,12
Snax,aggra-português,1706,druid,balance,36,22,14
Nastyclones,kazzak,1706,druid,balance,39,23,16
Frikolina,outland,1706,druid,balance,194,104,90
Thaeris,outland,1705,druid,balance,58,34,24
Mirâculixx,dethecus,1705,druid,balance,60,34,26
Beefyglutes,moonglade,1705,druid,balance,48,26,22
Asinistar,ravencrest,1705,druid,balance,86,45,41
Sitruu,zenedar,1704,druid,balance,48,28,20
Ogx,blackmoore,1704,druid,balance,42,23,19
Leqt,ravencrest,1703,druid,balance,156,84,72
Whêylon,ragnaros,1703,druid,balance,48,24,24
Quoting,ravencrest,1703,druid,balance,53,26,27
Asoli,aegwynn,1702,druid,balance,24,18,6
Risuoksa,tarren-mill,1702,druid,balance,45,26,19
Ròb,magtheridon,1702,druid,balance,78,39,39
Djbéámgódx,ravencrest,1702,druid,balance,87,43,44
Hyunâ,dalaran,1701,druid,balance,60,38,22
Антошкапро,howling-fjord,1701,druid,balance,72,36,36
Хрофт,blackscar,1701,druid,balance,99,48,51
Neufcinqq,archimonde,1700,druid,balance,39,26,13
Shiffe,argent-dawn,1700,druid,balance,78,39,39
Brooklynzoo,ravencrest,1699,druid,balance,24,18,6
Pantheraa,twisting-nether,1699,druid,balance,102,70,32
Deßradator,stormscale,1699,druid,balance,48,31,17
Колтрэйнх,fordragon,1699,druid,balance,54,29,25
Vno,ravencrest,1698,druid,balance,42,32,10
Ploho,blackmoore,1698,druid,balance,45,23,22
Zerozerosex,archimonde,1698,druid,balance,72,34,38
Shaakm,nerathor,1697,druid,balance,66,40,26
Wildrice,blackhand,1697,druid,balance,77,44,33
Saabeq,hyjal,1697,druid,balance,162,91,71
Winarchikxxl,tarren-mill,1697,druid,balance,247,133,114
Nizrã,archimonde,1696,druid,balance,43,28,15
Sykzd,hyjal,1696,druid,balance,36,23,13
Chäz,sanguino,1696,druid,balance,128,78,50
Lililili,archimonde,1695,druid,balance,144,85,59
Kolt,rajaxx,1695,druid,balance,139,79,60
Shedzokey,tarren-mill,1695,druid,balance,211,118,93
Bubadruid,silvermoon,1694,druid,balance,71,50,21
Dullbear,ravencrest,1694,druid,balance,54,34,20
Sinalûlz,outland,1694,druid,balance,30,18,12
Mnt,pozzo-delleternità,1692,druid,balance,36,22,14
Hottiish,stormscale,1692,druid,balance,170,91,79
Suprachybre,arathi,1691,druid,balance,54,35,19
Ayamiss,outland,1690,druid,balance,48,28,20
Mendorin,stormrage,1690,druid,balance,123,66,57
Nzmdruid,burning-legion,1689,druid,balance,36,21,15
Npml,tarren-mill,1689,druid,balance,150,79,71
Бамболони,gordunni,1688,druid,balance,183,107,76
Nuqa,thrall,1688,druid,balance,61,35,26
Rapunzel,eredar,1688,druid,balance,36,20,16
Dematos,forscherliga,1687,druid,balance,126,77,49
Porzi,blackhand,1687,druid,balance,130,76,54
Wildkin,twisting-nether,1687,druid,balance,158,86,72
Gnoobr,ravencrest,1686,druid,balance,24,18,6
Sintdru,rexxar,1686,druid,balance,36,26,10
Rawr,dun-morogh,1686,druid,balance,30,20,10
Sethdr,hyjal,1686,druid,balance,35,22,13
Nergi,darksorrow,1686,druid,balance,53,31,22
Cyriaan,eredar,1686,druid,balance,101,55,46
Justtrollîng,twisting-nether,1685,druid,balance,71,42,29
Cyclonebroo,blackmoore,1684,druid,balance,64,42,22
Blownaway,outland,1684,druid,balance,68,39,29
Featherfeet,kazzak,1684,druid,balance,84,43,41
Avimoo,tarren-mill,1683,druid,balance,54,31,23
Philyoo,blackhand,1682,druid,balance,54,25,29
Болггар,gordunni,1681,druid,balance,113,68,45
Boompjeh,chamber-of-aspects,1681,druid,balance,30,18,12
Bigtouch,draenor,1681,druid,balance,71,42,29
Mäismz,hyjal,1680,druid,balance,54,37,17
Kanyevotèrx,ravencrest,1680,druid,balance,36,24,12
Moonfirecow,thrall,1678,druid,balance,114,61,53
ßoom,antonidas,1678,druid,balance,232,119,113
Sefinana,malganis,1678,druid,balance,229,117,112
Lazerbinks,blackmoore,1677,druid,balance,57,37,20
Ultrapoulet,archimonde,1677,druid,balance,36,21,15
Dmgtràsh,dun-modr,1676,druid,balance,35,21,14
Kørn,drakthul,1676,druid,balance,188,100,88
Masakrelol,sanguino,1676,druid,balance,44,22,22
Obrys,tarren-mill,1676,druid,balance,90,43,47
Barotz,hyjal,1675,druid,balance,42,26,16
Жизэ,galakrond,1675,druid,balance,110,65,45
Deetaa,eredar,1675,druid,balance,60,35,25
Dotclass,outland,1675,druid,balance,44,25,19
Mørshac,blackrock,1674,druid,balance,102,56,46
Buurzalbai,drakthul,1674,druid,balance,215,115,100
Ryuzu,aegwynn,1673,druid,balance,85,50,35
Leywä,drekthar,1673,druid,balance,65,36,29
Tiktokstar,blackrock,1671,druid,balance,41,26,15
Sodapop,aszune,1671,druid,balance,191,109,82
Elfsu,ravencrest,1671,druid,balance,233,131,102
Laødinay,hyjal,1671,druid,balance,108,58,50
Bigbaddream,stormscale,1671,druid,balance,89,46,43
Bigwurst,tarren-mill,1671,druid,balance,53,27,26
Frodds,grim-batol,1670,druid,balance,135,85,50
Someóne,stormreaver,1670,druid,balance,78,45,33
Legyna,ravencrest,1670,druid,balance,129,69,60
Gstahr,taerar,1669,druid,balance,136,75,61
Kiluavi,argent-dawn,1669,druid,balance,42,22,20
Фигарофигаро,gordunni,1669,druid,balance,136,71,65
Happybear,outland,1668,druid,balance,81,60,21
Gotnaga,silvermoon,1668,druid,balance,60,35,25
Pórts,kazzak,1668,druid,balance,90,50,40
Yuhor,outland,1668,druid,balance,232,121,111
Директорх,blackscar,1667,druid,balance,42,25,17
Thundruid,archimonde,1667,druid,balance,53,29,24
Worsteux,blackrock,1666,druid,balance,55,35,20
Zenziidruid,blackhand,1666,druid,balance,69,42,27
Femboygodx,blackmoore,1665,druid,balance,42,26,16
Мантоя,gordunni,1665,druid,balance,325,177,148
Liften,blackhand,1665,druid,balance,78,41,37
Zeptune,tarren-mill,1665,druid,balance,191,91,100
Fapmasterx,eredar,1664,druid,balance,36,23,13
Dabudi,kazzak,1664,druid,balance,157,90,67
Tâliah,silvermoon,1664,druid,balance,90,51,39
Thardruid,stormscale,1664,druid,balance,77,43,34
Ahylles,antonidas,1663,druid,balance,69,45,24
Youngdinozzo,dalaran,1663,druid,balance,41,26,15
Wísh,stormscale,1663,druid,balance,88,52,36
Threesixnìne,dun-morogh,1663,druid,balance,95,44,51
Gløbal,antonidas,1662,druid,balance,71,42,29
Wootbeam,silvermoon,1662,druid,balance,84,45,39
Корбэндетка,deepholm,1662,druid,balance,88,47,41
Treepoloski,stormscale,1661,druid,balance,69,41,28
Moffwastaken,kazzak,1661,druid,balance,231,118,113
Uptoyou,defias-brotherhood,1660,druid,balance,161,91,70
Shackari,ravencrest,1660,druid,balance,69,38,31
Tôrmêñtêd,outland,1660,druid,balance,47,21,26
Nareeik,tarren-mill,1659,druid,balance,36,21,15
Shapeshift,sanguino,1659,druid,balance,62,34,28
Séxycàt,ravencrest,1659,druid,balance,422,220,202
Suevlaki,ragnaros,1658,druid,balance,108,68,40
Møømøø,tarren-mill,1658,druid,balance,30,18,12
Abercrombx,thrall,1658,druid,balance,91,54,37
Dikc,twisting-nether,1657,druid,balance,24,21,3
Bøøstèdtréè,ravencrest,1657,druid,balance,164,87,77
Куколдос,eversong,1656,druid,balance,36,22,14
Deny,stormreaver,1656,druid,balance,83,50,33
Buffmeplz,medivh,1655,druid,balance,36,23,13
Xqtdruid,blackhand,1655,druid,balance,42,22,20
Zwierzyniec,jaedenar,1654,druid,balance,36,26,10
Sequisha,tarren-mill,1653,druid,balance,40,24,16
Leathy,eredar,1653,druid,balance,115,67,48
Devióus,twilights-hammer,1653,druid,balance,41,18,23
Penìsdetable,argent-dawn,1652,druid,balance,69,45,24
Milkywáys,draenor,1651,druid,balance,344,175,169
Naicy,khaz-modan,1650,druid,balance,48,27,21
Pewpewdruid,blackmoore,1650,druid,balance,144,79,65
Bøllemís,silvermoon,1650,druid,balance,77,42,35
Noballz,blackhand,1650,druid,balance,64,34,30
Popadegril,draenor,1649,druid,balance,90,38,52
Troc,karazhan,1648,druid,balance,30,21,9
Highonfire,grim-batol,1648,druid,balance,66,43,23
Themitch,outland,1648,druid,balance,83,49,34
Corrupthz,outland,1648,druid,balance,105,61,44
Macron,terokkar,1648,druid,balance,70,38,32
Nizkul,dun-modr,1648,druid,balance,109,58,51
Pitbull,archimonde,1648,druid,balance,138,73,65
Fatfingerx,blackrock,1647,druid,balance,42,23,19
Eärendir,ravencrest,1647,druid,balance,357,186,171
Gurudru,tarren-mill,1647,druid,balance,156,76,80
Gibsx,blackmoore,1646,druid,balance,48,33,15
Celitharion,tarren-mill,1646,druid,balance,54,32,22
Санлесс,howling-fjord,1645,druid,balance,54,32,22
Pento,aggra-português,1645,druid,balance,84,43,41
Xyzy,burning-legion,1645,druid,balance,189,92,97
Вестхем,howling-fjord,1644,druid,balance,32,22,10
Cráfty,blackrock,1644,druid,balance,73,50,23
Catten,sylvanas,1644,druid,balance,42,26,16
Ykg,twisting-nether,1644,druid,balance,93,52,41
Veyronn,burning-legion,1644,druid,balance,102,54,48
Øffroadz,blackmoore,1643,druid,balance,30,20,10
Redlung,outland,1642,druid,balance,36,23,13
Milantu,antonidas,1642,druid,balance,30,18,12
Eloomie,rexxar,1642,druid,balance,93,52,41
Starcrash,amanthul,1642,druid,balance,138,71,67
Çhîñêséðrüîð,kazzak,1642,druid,balance,43,22,21
Krathar,kazzak,1642,druid,balance,95,40,55
Cyclønegodxd,dentarg,1641,druid,balance,105,65,40
Woodzey,sylvanas,1641,druid,balance,60,35,25
Sanaponic,burning-legion,1641,druid,balance,70,39,31
Flukeyz,draenor,1640,druid,balance,30,18,12
Salvagã,outland,1640,druid,balance,48,28,20
Topfrag,outland,1640,druid,balance,83,45,38
Epicplays,sylvanas,1640,druid,balance,70,35,35
Chadru,magtheridon,1639,druid,balance,92,52,40
Bobcup,tarren-mill,1639,druid,balance,131,72,59
Drutro,hellfire,1639,druid,balance,54,27,27
Albás,kazzak,1638,druid,balance,48,35,13
Meganfoxdq,sanguino,1638,druid,balance,82,53,29
Birb,archimonde,1638,druid,balance,131,79,52
Kikïnøu,garona,1638,druid,balance,48,27,21
Druidka,grim-batol,1638,druid,balance,99,52,47
Bígbaddruid,blackrock,1637,druid,balance,36,20,16
Слоич,gordunni,1637,druid,balance,126,68,58
Däkk,draenor,1637,druid,balance,130,68,62
Nönö,tarren-mill,1637,druid,balance,54,27,27
Kungbore,draenor,1636,druid,balance,36,25,11
Zabraim,blackhand,1636,druid,balance,60,37,23
Druidflight,ravencrest,1636,druid,balance,60,34,26
Ånåphorå,archimonde,1636,druid,balance,45,25,20
Cøw,doomhammer,1635,druid,balance,78,42,36
Druidïta,dun-modr,1635,druid,balance,66,33,33
Fabuboomy,blackrock,1635,druid,balance,36,18,18
Azdr,ravencrest,1635,druid,balance,60,28,32
Deví,twilights-hammer,1634,druid,balance,48,30,18
Gsix,blackrock,1634,druid,balance,42,24,18
Niul,aegwynn,1634,druid,balance,172,98,74
Naturalbeef,argent-dawn,1634,druid,balance,40,22,18
Beamgødx,thrall,1633,druid,balance,28,19,9
Pëchy,aggra-português,1633,druid,balance,72,43,29
Màlàkaii,hyjal,1633,druid,balance,58,29,29
Cowxoxo,twisting-nether,1633,druid,balance,78,37,41
Ittei,korgall,1632,druid,balance,42,27,15
Bloomly,tarren-mill,1632,druid,balance,182,94,88
Strinx,ragnaros,1631,druid,balance,129,81,48
Pansarbamse,outland,1631,druid,balance,110,58,52
Andjuga,doomhammer,1631,druid,balance,214,109,105
Felysae,kazzak,1630,druid,balance,24,17,7
Klßa,grim-batol,1630,druid,balance,30,21,9
Dabär,mannoroth,1630,druid,balance,60,36,24
Evílz,kazzak,1630,druid,balance,36,20,16
Unknownhero,kazzak,1629,druid,balance,64,37,27
Pròtodrù,twisting-nether,1629,druid,balance,232,119,113
Dharli,stormscale,1628,druid,balance,186,91,95
Malëdictus,tarren-mill,1627,druid,balance,47,37,10
Сицилиец,galakrond,1627,druid,balance,48,32,16
Angrychicken,ravencrest,1627,druid,balance,62,39,23
Ðrpressure,blackrock,1627,druid,balance,155,94,61
Horadruid,silvermoon,1627,druid,balance,343,184,159
Scamlafsen,ragnaros,1627,druid,balance,48,25,23
Ryhen,stormscale,1627,druid,balance,110,55,55
Luckerdog,tarren-mill,1627,druid,balance,112,54,58
Qumina,azjolnerub,1627,druid,balance,52,24,28
Fâucon,eitrigg,1626,druid,balance,40,27,13
Fluffypawz,shattered-hand,1626,druid,balance,42,25,17
Miepie,blackrock,1626,druid,balance,153,83,70
Varunys,blackrock,1626,druid,balance,239,128,111
Valoruk,ravencrest,1626,druid,balance,63,32,31
Cupoftea,drakthul,1625,druid,balance,144,82,62
Hïrøshïmå,malganis,1625,druid,balance,122,64,58
Amøveo,draenor,1625,druid,balance,48,25,23
Bigbrrd,outland,1625,druid,balance,47,24,23
Disclaimed,twisting-nether,1624,druid,balance,74,44,30
Сложныйдруид,howling-fjord,1624,druid,balance,82,46,36
Saltymoo,tarren-mill,1624,druid,balance,95,52,43
Pjuske,silvermoon,1624,druid,balance,48,26,22
Kkona,silvermoon,1624,druid,balance,77,41,36
Couleaf,stormscale,1623,druid,balance,90,60,30
Ðelix,ysera,1623,druid,balance,104,60,44
Heldil,chants-éternels,1623,druid,balance,34,18,16
Polymorphler,theradras,1623,druid,balance,84,38,46
Shaandri,dethecus,1622,druid,balance,30,18,12
Pukkiakkella,burning-legion,1622,druid,balance,71,40,31
Ibuyicecream,outland,1622,druid,balance,196,108,88
Merfje,karazhan,1622,druid,balance,36,17,19
Empi,sanguino,1621,druid,balance,96,51,45
Kaïnak,dalaran,1621,druid,balance,66,33,33
Слоич,howling-fjord,1621,druid,balance,300,148,152
Diazepam,draenor,1620,druid,balance,90,52,38
Rhaf,argent-dawn,1620,druid,balance,179,101,78
Tylercatmeow,burning-legion,1620,druid,balance,74,41,33
Thielyy,blackmoore,1620,druid,balance,90,49,41
Speegle,kazzak,1620,druid,balance,54,28,26
Moonzysunzy,sylvanas,1620,druid,balance,36,17,19
Óffstér,kazzak,1620,druid,balance,138,54,84
Landesverrat,kazzak,1619,druid,balance,24,21,3
Modruid,eredar,1618,druid,balance,42,25,17
Damigjat,sylvanas,1618,druid,balance,221,126,95
Xenuss,kazzak,1618,druid,balance,48,26,22
Chángé,draenor,1617,druid,balance,91,57,34
Lörex,ravencrest,1617,druid,balance,37,23,14
Hauntie,kazzak,1617,druid,balance,123,70,53
Hashishi,grim-batol,1617,druid,balance,128,69,59
Bears,outland,1617,druid,balance,375,193,182
Elatadru,silvermoon,1617,druid,balance,71,35,36
Гнетея,howling-fjord,1616,druid,balance,107,62,45
Боблерсс,gordunni,1616,druid,balance,62,33,29
Xirbtihs,stormscale,1615,druid,balance,50,32,18
Czarnykocur,burning-legion,1615,druid,balance,193,109,84
Degnosaur,outland,1615,druid,balance,54,29,25
Aliandrel,teldrassil,1614,druid,balance,102,66,36
Vienkesh,draenor,1614,druid,balance,35,22,13
Caddan,argent-dawn,1614,druid,balance,54,32,22
Anahots,silvermoon,1614,druid,balance,347,181,166
Бонони,booty-bay,1614,druid,balance,138,69,69
Strix,dun-modr,1614,druid,balance,101,47,54
ßloöd,archimonde,1613,druid,balance,30,20,10
Rivenx,ravencrest,1613,druid,balance,59,37,22
Турбокалясик,gordunni,1613,druid,balance,79,46,33
Gòrgoth,pozzo-delleternità,1613,druid,balance,50,27,23
Karyaga,tarren-mill,1613,druid,balance,69,33,36
Crouch,ragnaros,1613,druid,balance,48,22,26
Moonwatcher,blackrock,1612,druid,balance,391,207,184
Jamley,tarren-mill,1612,druid,balance,36,19,17
Kuraina,the-maelstrom,1612,druid,balance,42,21,21
Zonsybtw,blackhand,1611,druid,balance,36,28,8
Rá,outland,1611,druid,balance,32,22,10
Muhz,nathrezim,1611,druid,balance,158,85,73
Hållkäften,twisting-nether,1611,druid,balance,149,79,70
Rifthy,nemesis,1611,druid,balance,42,22,20
Asimal,eredar,1610,druid,balance,24,17,7
Mianmar,silvermoon,1610,druid,balance,149,92,57
Itadorikun,silvermoon,1610,druid,balance,137,82,55
Angelinax,silvermoon,1609,druid,balance,41,24,17
Wafflecat,outland,1609,druid,balance,36,21,15
Rode,magtheridon,1609,druid,balance,154,88,66
Ralffoosa,auchindoun,1609,druid,balance,65,36,29
Кашаган,howling-fjord,1609,druid,balance,248,137,111
Bashloug,archimonde,1609,druid,balance,38,20,18
Epidemic,argent-dawn,1608,druid,balance,91,52,39
Boomykush,twisting-nether,1608,druid,balance,86,48,38
Newdudu,draenor,1608,druid,balance,105,58,47
Ashkaxx,ragnaros,1608,druid,balance,136,75,61
Ícekiss,hyjal,1607,druid,balance,42,29,13
Hiquien,silvermoon,1607,druid,balance,96,57,39
Huxleyys,draenor,1607,druid,balance,30,17,13
Друнуар,gordunni,1607,druid,balance,48,25,23
Fantastix,silvermoon,1607,druid,balance,102,52,50
Doncy,ragnaros,1607,druid,balance,54,24,30
Sqoopy,tarren-mill,1606,druid,balance,36,27,9
Bømping,tarren-mill,1606,druid,balance,36,24,12
Ajshadz,ravencrest,1606,druid,balance,30,18,12
Smokahontas,kilrogg,1606,druid,balance,30,17,13
Monkeynight,ambossar,1606,druid,balance,56,30,26
Veyra,dentarg,1606,druid,balance,65,31,34
Hillarious,blackmoore,1605,druid,balance,123,71,52
Seudoz,silvermoon,1605,druid,balance,129,74,55
Veijari,deathwing,1605,druid,balance,52,29,23
Teddyxbear,nefarian,1605,druid,balance,48,26,22
Tokitoc,archimonde,1605,druid,balance,122,66,56
Auches,argent-dawn,1605,druid,balance,42,22,20
Мэдикейт,gordunni,1605,druid,balance,102,53,49
Grisdrood,ragnaros,1605,druid,balance,227,117,110
Feign,blackmoore,1605,druid,balance,85,43,42
Isylia,twisting-nether,1605,druid,balance,72,36,36
Emeraldhaze,sylvanas,1604,druid,balance,97,60,37
Kittyperry,blackmoore,1604,druid,balance,69,38,31
Bizle,stormscale,1604,druid,balance,59,31,28
Rachenketzy,stormscale,1604,druid,balance,42,19,23
Drufar,outland,1603,druid,balance,29,18,11
Bearcosby,burning-legion,1603,druid,balance,41,25,16
Maaw,tarren-mill,1603,druid,balance,60,35,25
Kåmen,ravenholdt,1603,druid,balance,103,58,45
Løgbjørnen,tarren-mill,1603,druid,balance,52,29,23
Schannine,archimonde,1603,druid,balance,150,78,72
Alamâ,madmortem,1603,druid,balance,48,21,27
Irfrayl,antonidas,1602,druid,balance,30,22,8
Insanexp,antonidas,1602,druid,balance,37,24,13
Erol,silvermoon,1602,druid,balance,73,47,26
Amhro,ragnaros,1602,druid,balance,84,50,34
Socialdistnc,silvermoon,1602,druid,balance,54,32,22
Эрраптор,borean-tundra,1602,druid,balance,59,34,25
Donutella,drakthul,1602,druid,balance,34,18,16
Nomilkforyou,steamwheedle-cartel,1601,druid,balance,63,39,24
Rofyx,twisting-nether,1601,druid,balance,36,19,17
Gentle,tarren-mill,1601,druid,balance,113,58,55
Matpear,ravencrest,1601,druid,balance,42,21,21
Aenrolz,hyjal,1600,druid,balance,30,21,9
Goom,rexxar,1600,druid,balance,214,124,90
Viverion,ravencrest,1600,druid,balance,141,77,64
Elrroir,dun-modr,1599,druid,balance,78,45,33
Wildanomaly,argent-dawn,1598,druid,balance,118,64,54
Zonsy,twisting-nether,1597,druid,balance,60,28,32
Cieniuu,burning-legion,1595,druid,balance,56,42,14
Lillevän,tarren-mill,1594,druid,balance,48,27,21
Tôurnesol,khaz-modan,1594,druid,balance,242,132,110
Repiite,draenor,1593,druid,balance,42,25,17
Муниня,gordunni,1593,druid,balance,139,75,64
Соникдогх,gordunni,1593,druid,balance,72,38,34
Kattepis,argent-dawn,1593,druid,balance,54,25,29
Zydrux,outland,1592,druid,balance,24,17,7
Shaize,dalaran,1592,druid,balance,76,52,24
Hashoar,archimonde,1592,druid,balance,42,28,14
Svend,kazzak,1592,druid,balance,95,52,43
Кектахан,soulflayer,1592,druid,balance,53,29,24
Lastcroptol,dun-modr,1592,druid,balance,106,54,52
Lxz,blackhand,1591,druid,balance,88,47,41
Ryng,nagrand,1590,druid,balance,72,47,25
Easypointsx,tarren-mill,1590,druid,balance,30,19,11
Surps,ravencrest,1590,druid,balance,36,21,15
Rwq,outland,1590,druid,balance,57,30,27
Softesgirl,blackrock,1590,druid,balance,92,47,45
Lazherra,drakthul,1588,druid,balance,38,23,15
Drugnag,blackmoore,1588,druid,balance,126,70,56
Sonjin,burning-legion,1588,druid,balance,54,28,26
Truffleßuttr,kazzak,1587,druid,balance,30,17,13
Xä,bloodscalp,1587,druid,balance,159,86,73
Døttore,garona,1587,druid,balance,164,83,81
Ôp,aegwynn,1587,druid,balance,83,40,43
Knuffle,eredar,1586,druid,balance,105,62,43
Magnusson,shadowsong,1585,druid,balance,90,59,31
Notmyfriend,sylvanas,1585,druid,balance,106,62,44
Lisbethqt,nemesis,1583,druid,balance,30,19,11
Møønhorn,nemesis,1583,druid,balance,262,135,127
Esrín,the-maelstrom,1583,druid,balance,274,138,136
Hehehahaha,kazzak,1582,druid,balance,30,20,10
Weisslogia,aegwynn,1582,druid,balance,107,58,49
Derfaï,kaelthas,1582,druid,balance,82,39,43
Àspro,hyjal,1581,druid,balance,108,54,54
Malvakten,kazzak,1581,druid,balance,212,102,110
Hotdóts,outland,1580,druid,balance,30,20,10
Smashella,pozzo-delleternità,1579,druid,balance,126,80,46
Pissballs,turalyon,1579,druid,balance,102,52,50
Kâllîsto,eredar,1579,druid,balance,80,40,40
Raízun,blackmoore,1578,druid,balance,54,32,22
Daìs,dalaran,1578,druid,balance,55,31,24
Bálur,thrall,1577,druid,balance,36,20,16
Abbc,stormscale,1576,druid,balance,30,18,12
Zeromario,draenor,1575,druid,balance,42,19,23
Druidrighteu,ravencrest,1574,druid,balance,123,68,55
Ciaoxøxø,ragnaros,1574,druid,balance,184,101,83
Brainjuice,blackrock,1574,druid,balance,36,19,17
Shapeshiptur,argent-dawn,1573,druid,balance,83,46,37
Gretl,blackrock,1572,druid,balance,102,52,50
Algír,argent-dawn,1572,druid,balance,141,71,70
Kittyexpress,arygos,1572,druid,balance,105,52,53
Ylmh,archimonde,1571,druid,balance,30,19,11
Бонинайтх,gordunni,1571,druid,balance,60,30,30
Quellwell,outland,1570,druid,balance,110,55,55
Dantet,the-maelstrom,1570,druid,balance,54,24,30
Degentiuso,alakir,1569,druid,balance,96,60,36
Zlogic,tarren-mill,1568,druid,balance,30,17,13
Elodìa,antonidas,1566,druid,balance,36,25,11
Стампид,blackscar,1566,druid,balance,290,157,133
Skadruid,blackmoore,1566,druid,balance,96,50,46
Myllymatti,frostwhisper,1565,druid,balance,54,28,26
Mikeem,draenor,1563,druid,balance,38,24,14
Narkosha,kazzak,1563,druid,balance,92,57,35
Ðîwø,blackhand,1563,druid,balance,36,18,18
Underlaay,kazzak,1562,druid,balance,30,19,11
Morphael,ravencrest,1561,druid,balance,50,30,20
Lemonjohn,outland,1561,druid,balance,38,19,19
Kittenmitten,ragnaros,1560,druid,balance,189,104,85
Boomzter,frostmane,1560,druid,balance,142,77,65
Puppen,alakir,1559,druid,balance,113,64,49
Martinesämst,outland,1558,druid,balance,46,24,22
Keynn,kazzak,1558,druid,balance,116,60,56
Alexsandruid,rexxar,1556,druid,balance,33,19,14
Diolives,stormscale,1556,druid,balance,78,40,38
Ìluan,ravencrest,1556,druid,balance,48,23,25
Høtbøx,aegwynn,1555,druid,balance,81,43,38
Migami,nemesis,1555,druid,balance,72,36,36
Droodstar,archimonde,1554,druid,balance,45,29,16
Rédbull,outland,1554,druid,balance,148,81,67
Pánjav,draenor,1554,druid,balance,48,26,22
Calambius,blackhand,1553,druid,balance,224,112,112
Òniz,hyjal,1552,druid,balance,60,40,20
Blackfür,sylvanas,1552,druid,balance,206,105,101
Seysso,silvermoon,1551,druid,balance,248,127,121
Lasertipu,tarren-mill,1550,druid,balance,131,69,62
Báco,dun-modr,1550,druid,balance,65,33,32
Wildmistake,argent-dawn,1550,druid,balance,35,17,18
Potatodru,ragnaros,1549,druid,balance,30,17,13
Slycey,eredar,1549,druid,balance,54,30,24
Silvix,blackrock,1549,druid,balance,130,67,63
Tuwog,outland,1549,druid,balance,195,100,95
Dámøn,stormscale,1549,druid,balance,66,33,33
Cptsponksa,tarren-mill,1548,druid,balance,207,110,97
Грибомания,soulflayer,1548,druid,balance,35,18,17
Fishanchips,archimonde,1547,druid,balance,36,20,16
Усыильвиры,soulflayer,1547,druid,balance,70,38,32
Brokul,kazzak,1547,druid,balance,84,44,40
Duis,twilights-hammer,1547,druid,balance,124,64,60
Mercander,draenor,1547,druid,balance,65,32,33
Fluffeh,doomhammer,1546,druid,balance,60,38,22
Yabbah,blackrock,1546,druid,balance,42,26,16
Merawr,ravencrest,1546,druid,balance,136,69,67
Posiqtdruid,nemesis,1545,druid,balance,102,58,44
Vodkavodkaa,tarren-mill,1545,druid,balance,82,45,37
Curzex,blackmoore,1545,druid,balance,42,19,23
Dëåd,zenedar,1544,druid,balance,36,22,14
Tigerroll,kazzak,1544,druid,balance,66,30,36
Killforpakis,turalyon,1543,druid,balance,48,32,16
Wiligun,archimonde,1543,druid,balance,81,52,29
Ciue,tarren-mill,1543,druid,balance,39,25,14
Fruntimmern,sylvanas,1543,druid,balance,48,28,20
Hotlife,ravencrest,1543,druid,balance,67,35,32
Magiskeforme,draenor,1540,druid,balance,50,34,16
Bruddanature,blackrock,1540,druid,balance,198,108,90
Sløthy,uldum,1540,druid,balance,112,58,54
Roidcat,twisting-nether,1540,druid,balance,47,24,23
Nxee,tarren-mill,1539,druid,balance,60,41,19
Karuck,ravencrest,1539,druid,balance,172,90,82
Feralspîrît,outland,1539,druid,balance,168,84,84
Zyune,ravencrest,1539,druid,balance,36,17,19
Фонш,soulflayer,1538,druid,balance,50,26,24
Pawel,defias-brotherhood,1538,druid,balance,215,109,106
Зетзул,grom,1538,druid,balance,409,205,204
Кётре,ashenvale,1538,druid,balance,114,57,57
Larryburns,nathrezim,1538,druid,balance,120,59,61
Экстазиус,borean-tundra,1538,druid,balance,71,29,42
Gibx,ravencrest,1536,druid,balance,36,20,16
Unoseeme,outland,1536,druid,balance,36,17,19
Jazzme,aegwynn,1535,druid,balance,24,16,8
Mokujiin,burning-blade,1535,druid,balance,75,35,40
Arecsne,turalyon,1534,druid,balance,169,85,84
Уэсериктх,blackscar,1534,druid,balance,36,18,18
Noou,aegwynn,1534,druid,balance,52,25,27
Slaughtér,stormscale,1533,druid,balance,72,44,28
Mortagua,kazzak,1533,druid,balance,53,30,23
Mehgyver,ravencrest,1533,druid,balance,49,27,22
Horpet,silvermoon,1530,druid,balance,66,37,29
Bîte,blackmoore,1529,druid,balance,24,16,8
Meretrizx,kazzak,1529,druid,balance,36,19,17
Уба,gordunni,1528,druid,balance,34,20,14
Bopy,ravencrest,1528,druid,balance,30,17,13
Sheâ,nemesis,1528,druid,balance,282,151,131
Mushröøms,nemesis,1528,druid,balance,71,32,39
Renzay,ysondre,1527,druid,balance,24,16,8
Inkibek,burning-blade,1527,druid,balance,155,90,65
Rãpidã,hyjal,1527,druid,balance,54,31,23
Лунныйфилин,deathguard,1527,druid,balance,61,32,29
Wizår,outland,1526,druid,balance,30,19,11
Feyzboom,ysondre,1525,druid,balance,24,16,8
Demonbalance,silvermoon,1523,druid,balance,100,58,42
Amoveo,argent-dawn,1523,druid,balance,74,39,35
Rystafarian,kazzak,1523,druid,balance,74,36,38
Seboom,outland,1522,druid,balance,123,69,54
Hibo,dun-modr,1522,druid,balance,72,37,35
Crackfat,stormscale,1521,druid,balance,52,34,18
Kbdd,outland,1521,druid,balance,54,24,30
Kosmegpåøra,ravencrest,1521,druid,balance,54,24,30
Sofiadrood,stormreaver,1520,druid,balance,24,16,8
Massak,aegwynn,1520,druid,balance,37,24,13
Diggear,doomhammer,1520,druid,balance,42,26,16
Levéltetü,ragnaros,1520,druid,balance,30,18,12
Анестезий,soulflayer,1519,druid,balance,90,60,30
Xaeia,aegwynn,1519,druid,balance,108,67,41
Asrais,dun-modr,1519,druid,balance,72,38,34
Exca,stormscale,1519,druid,balance,54,28,26
Даорион,gordunni,1518,druid,balance,59,35,24
Herns,kazzak,1518,druid,balance,60,26,34
Belzara,sanguino,1517,druid,balance,122,68,54
Bogahcan,twisting-nether,1517,druid,balance,38,21,17
Tulleku,azjolnerub,1517,druid,balance,69,37,32
Fransman,sylvanas,1517,druid,balance,72,34,38
Nømat,defias-brotherhood,1516,druid,balance,276,152,124
Druidboss,tarren-mill,1516,druid,balance,263,142,121
Syremark,silvermoon,1515,druid,balance,55,26,29
Cantdonothig,ravencrest,1514,druid,balance,327,167,160
Delly,neptulon,1514,druid,balance,47,24,23
Zevis,outland,1514,druid,balance,168,84,84
Shapeit,blackrock,1513,druid,balance,36,25,11
Урркке,soulflayer,1513,druid,balance,114,61,53
Darlenee,kazzak,1513,druid,balance,129,69,60
Trylune,blackmoore,1513,druid,balance,36,19,17
Jónahfalcon,draenor,1512,druid,balance,24,16,8
Bénjî,khazgoroth,1512,druid,balance,157,89,68
Boomalot,auchindoun,1512,druid,balance,82,46,36
Lèafy,silvermoon,1511,druid,balance,43,26,17
Bareforms,medivh,1510,druid,balance,81,54,27
Anhoq,silvermoon,1510,druid,balance,216,115,101
Freakyo,blackrock,1509,druid,balance,59,32,27
Pyqmi,stormscale,1508,druid,balance,60,36,24
Stalkdro,elune,1508,druid,balance,33,18,15
Halouest,archimonde,1508,druid,balance,83,43,40
Хастла,galakrond,1508,druid,balance,72,37,35
Jebga,thrall,1508,druid,balance,109,54,55
Ddggss,ragnaros,1507,druid,balance,49,29,20
Killxhard,ravencrest,1507,druid,balance,36,19,17
Form,burning-legion,1506,druid,balance,24,16,8
Бульбион,gordunni,1506,druid,balance,90,56,34
Craycrays,argent-dawn,1506,druid,balance,67,38,29
Lyø,draenor,1506,druid,balance,154,85,69
Mindruid,kazzak,1506,druid,balance,48,26,22
Spaceshift,magtheridon,1506,druid,balance,252,133,119
Szubotaj,ragnaros,1505,druid,balance,36,20,16
Vongihkuhher,blackmoore,1505,druid,balance,30,16,14
Wize,pozzo-delleternità,1505,druid,balance,116,60,56
Rowlet,twisting-nether,1505,druid,balance,213,109,104
Bagginston,nazjatar,1505,druid,balance,86,44,42
Bxxmkin,draenor,1504,druid,balance,42,27,15
Бибраа,eversong,1504,druid,balance,36,20,16
Goüsta,archimonde,1504,druid,balance,72,38,34
Neshalry,blackhand,1503,druid,balance,57,32,25
Оудин,blackscar,1502,druid,balance,79,47,32
Eziyet,blackrock,1502,druid,balance,114,62,52
Баттнэйкед,gordunni,1500,druid,balance,89,42,47
Shàarøn,archimonde,1499,druid,balance,52,36,16
Ðiàblos,nemesis,1498,druid,balance,88,54,34
Opla,nethersturm,1498,druid,balance,70,42,28
Insølitø,sanguino,1498,druid,balance,111,61,50
Animalcruelt,silvermoon,1498,druid,balance,74,40,34
Ezkatka,ravencrest,1497,druid,balance,24,16,8
Karodoom,twisting-nether,1497,druid,balance,131,71,60
Shuffey,frostmane,1496,druid,balance,67,37,30
Faqbàdi,twisting-nether,1496,druid,balance,48,25,23
Sweetner,outland,1495,druid,balance,64,38,26
Maddixx,outland,1494,druid,balance,110,57,53
Carismatic,blackmoore,1494,druid,balance,224,116,108
Whythis,archimonde,1494,druid,balance,244,123,121
Heejåe,archimonde,1494,druid,balance,61,30,31
Fabutwo,blackrock,1494,druid,balance,35,16,19
Krosanx,outland,1493,druid,balance,54,24,30
Oxe,malganis,1492,druid,balance,24,19,5
Smuttán,frostmane,1492,druid,balance,24,17,7
Salvaga,outland,1492,druid,balance,47,27,20
Convokeboost,archimonde,1492,druid,balance,273,152,121
Zhroomx,blackmoore,1492,druid,balance,74,40,34
Tawaraki,outland,1491,druid,balance,245,130,115
Екфта,gordunni,1491,druid,balance,120,62,58
Ассайоу,gordunni,1490,druid,balance,102,54,48
Raszcal,blackhand,1489,druid,balance,46,27,19
Deepqt,kargath,1489,druid,balance,75,41,34
Ратататата,blackscar,1489,druid,balance,44,23,21
Telbo,ravencrest,1489,druid,balance,113,59,54
Aetheris,varimathras,1489,druid,balance,98,48,50
Schneéeule,blackrock,1489,druid,balance,60,29,31
Storpboom,drakthul,1488,druid,balance,129,75,54
Qïx,outland,1487,druid,balance,33,21,12
Rilak,nordrassil,1487,druid,balance,124,66,58
Aastal,uldaman,1487,druid,balance,103,52,51
Arrowfáx,kazzak,1486,druid,balance,90,52,38
Ихет,gordunni,1486,druid,balance,167,95,72
Bubak,deathwing,1486,druid,balance,30,17,13
Vrill,kazzak,1486,druid,balance,215,117,98
Duzky,kazzak,1486,druid,balance,30,16,14
Формун,razuvious,1485,druid,balance,33,26,7
Rayðii,archimonde,1485,druid,balance,81,48,33
Uglydruid,drakthul,1485,druid,balance,232,128,104
Mogi,pozzo-delleternità,1485,druid,balance,129,64,65
Smuktøs,twisting-nether,1484,druid,balance,63,43,20
Stêvé,silvermoon,1484,druid,balance,133,78,55
Coogee,malganis,1483,druid,balance,158,87,71
Mcbobb,ravencrest,1483,druid,balance,89,43,46
Arkatt,outland,1482,druid,balance,36,24,12
Xërxës,outland,1482,druid,balance,56,33,23
Settembre,ragnaros,1482,druid,balance,110,55,55
Brandyballix,twisting-nether,1482,druid,balance,249,123,126
Gúccî,blackrock,1481,druid,balance,36,26,10
Polypheme,chogall,1481,druid,balance,156,71,85
Flippy,blackmoore,1480,druid,balance,260,132,128
Drutiful,outland,1480,druid,balance,84,39,45
Rât,blackmoore,1478,druid,balance,54,36,18
Hashtagone,ysondre,1477,druid,balance,38,26,12
Bjærky,silvermoon,1477,druid,balance,74,49,25
Aurwen,silvermoon,1477,druid,balance,55,30,25
Nujus,kazzak,1477,druid,balance,36,18,18
Snoxy,wrathbringer,1477,druid,balance,65,32,33
Moonfetamine,silvermoon,1477,druid,balance,54,26,28
Niggler,magtheridon,1476,druid,balance,160,84,76
Rikiform,ravencrest,1476,druid,balance,59,30,29
Bullchóps,kazzak,1475,druid,balance,78,41,37
Manuka,argent-dawn,1475,druid,balance,90,45,45
Stìck,archimonde,1474,druid,balance,101,57,44
Tjeena,grim-batol,1474,druid,balance,51,22,29
Meuhtéki,hyjal,1473,druid,balance,24,16,8
Dingeren,stormscale,1473,druid,balance,30,19,11
Мутаборец,howling-fjord,1473,druid,balance,155,95,60
Dudana,argent-dawn,1472,druid,balance,60,36,24
Mahist,archimonde,1472,druid,balance,66,38,28
Whiskers,emerald-dream,1472,druid,balance,90,45,45
Baz,nemesis,1471,druid,balance,84,49,35
Imaduck,silvermoon,1471,druid,balance,97,49,48
Everdud,tarren-mill,1470,druid,balance,42,27,15
Джоннчек,gordunni,1470,druid,balance,70,44,26
Ðämøñæ,drekthar,1470,druid,balance,93,45,48
Wuodd,draenor,1469,druid,balance,30,16,14
Prinzfarming,mugthol,1469,druid,balance,57,29,28
Wallaar,ragnaros,1469,druid,balance,102,46,56
Reed,sylvanas,1469,druid,balance,42,16,26
Jatto,magtheridon,1467,druid,balance,72,39,33
Healol,sanguino,1467,druid,balance,111,58,53
Неделин,greymane,1466,druid,balance,36,23,13
Fejgi,stormreaver,1466,druid,balance,80,50,30
Iupa,silvermoon,1466,druid,balance,204,112,92
Vasilona,sanguino,1465,druid,balance,63,39,24
Manbearcat,nagrand,1465,druid,balance,44,22,22
Toffyfee,anetheron,1464,druid,balance,68,47,21
Pfandmalle,blackrock,1464,druid,balance,36,24,12
Ðãddy,ravencrest,1463,druid,balance,83,53,30
Winnysfanboy,outland,1463,druid,balance,30,16,14
Wazam,kazzak,1462,druid,balance,106,63,43
Vaizier,defias-brotherhood,1462,druid,balance,125,63,62
Nixhot,blackmoore,1462,druid,balance,76,34,42
Zaheer,silvermoon,1461,druid,balance,33,18,15
Druidere,outland,1461,druid,balance,106,56,50
Chansnax,thrall,1461,druid,balance,82,42,40
Syurn,sanguino,1460,druid,balance,42,25,17
Meatwallet,defias-brotherhood,1460,druid,balance,47,27,20
Inghlo,blackmoore,1460,druid,balance,64,36,28
Бадика,eversong,1460,druid,balance,128,69,59
Entas,kazzak,1459,druid,balance,36,24,12
Jöggel,perenolde,1459,druid,balance,48,29,19
Хоточник,gordunni,1459,druid,balance,144,75,69
Applestrudle,blackrock,1459,druid,balance,96,46,50
Arrakiz,sanguino,1458,druid,balance,89,58,31
Ashirae,drakthul,1458,druid,balance,38,20,18
Fangornn,outland,1458,druid,balance,42,17,25
Yugene,dun-modr,1457,druid,balance,32,16,16
Rocknrollà,doomhammer,1457,druid,balance,42,19,23
Sojiz,outland,1456,druid,balance,33,23,10
Dypas,chogall,1456,druid,balance,60,33,27
Milknosugar,tarren-mill,1456,druid,balance,59,25,34
Meezy,ragnaros,1455,druid,balance,69,41,28
Hulhorn,tarren-mill,1455,druid,balance,29,17,12
Freedomm,hyjal,1455,druid,balance,72,34,38
Verenai,bloodfeather,1454,druid,balance,36,24,12
Kúpfa,tichondrius,1454,druid,balance,90,51,39
Тётявискас,howling-fjord,1454,druid,balance,52,23,29
Stormspirit,hellscream,1453,druid,balance,36,24,12
Аррерон,howling-fjord,1453,druid,balance,30,16,14
Jejoueferal,chogall,1453,druid,balance,192,98,94
Endoplazmik,silvermoon,1453,druid,balance,165,83,82
Кеорл,gordunni,1453,druid,balance,69,32,37
Aègon,ravencrest,1452,druid,balance,137,72,65
Drineh,ravencrest,1452,druid,balance,42,21,21
Malolepszy,burning-legion,1452,druid,balance,76,34,42
Fåtå,archimonde,1452,druid,balance,42,17,25
Fiomy,blackhand,1451,druid,balance,107,66,41
Cagaboliches,sanguino,1451,druid,balance,77,44,33
Kuhgucci,blackmoore,1451,druid,balance,30,16,14
Yiradur,stormscale,1451,druid,balance,108,55,53
Callmev,hyjal,1449,druid,balance,28,24,4
Bighike,drakthul,1449,druid,balance,24,17,7
Fluffykin,defias-brotherhood,1449,druid,balance,72,41,31
Onè,blackhand,1449,druid,balance,60,32,28
Traplordgen,outland,1449,druid,balance,56,29,27
Chrevarraige,saurfang,1449,druid,balance,416,215,201
Жибка,howling-fjord,1449,druid,balance,62,32,30
Weregoon,blackmoore,1449,druid,balance,183,92,91
Zerofrenzy,hyjal,1449,druid,balance,309,151,158
Fûzzybear,ravencrest,1448,druid,balance,102,53,49
Bigpopp,kazzak,1448,druid,balance,114,59,55
Shanaiya,silvermoon,1448,druid,balance,32,16,16
Wxw,stormscale,1448,druid,balance,36,17,19
Chelsealeart,frostmane,1447,druid,balance,133,75,58
Sinyi,arathor,1447,druid,balance,35,19,16
Tongá,draenor,1447,druid,balance,66,34,32
Kénshin,blackhand,1447,druid,balance,90,42,48
Woopi,blackrock,1447,druid,balance,52,23,29
Käldorei,lightbringer,1446,druid,balance,30,16,14
Psycloniac,ravencrest,1446,druid,balance,36,19,17
Редмун,soulflayer,1446,druid,balance,140,73,67
Littleneo,ambossar,1446,druid,balance,125,63,62
Hunterkiller,azjolnerub,1446,druid,balance,42,21,21
Owlcápown,ravencrest,1446,druid,balance,36,18,18
Bëndover,uldaman,1445,druid,balance,42,25,17
Chúcky,twisting-nether,1445,druid,balance,139,76,63
Yomosh,eredar,1445,druid,balance,118,64,54
Fruitdealer,antonidas,1444,druid,balance,78,42,36
Leechers,silvermoon,1444,druid,balance,72,29,43
Madx,dalaran,1443,druid,balance,39,25,14
Овероний,soulflayer,1443,druid,balance,79,45,34
Iskaarjx,archimonde,1442,druid,balance,47,27,20
Moler,hyjal,1442,druid,balance,133,73,60
Buttkin,outland,1442,druid,balance,36,17,19
And,arathor,1442,druid,balance,36,16,20
Orazien,ravencrest,1441,druid,balance,30,19,11
Smøuler,sanguino,1441,druid,balance,57,30,27
Guthíx,silvermoon,1439,druid,balance,102,48,54
Мерлинз,lich-king,1439,druid,balance,42,17,25
Sycraim,zirkel-des-cenarius,1438,druid,balance,24,15,9
Giaya,turalyon,1438,druid,balance,63,37,26
Akifumi,archimonde,1438,druid,balance,50,27,23
Snedden,silvermoon,1438,druid,balance,91,46,45
Hefdgaharald,antonidas,1438,druid,balance,36,18,18
Tonutc,sanguino,1438,druid,balance,99,49,50
Flee,thrall,1437,druid,balance,18,15,3
Elfruidus,chogall,1436,druid,balance,30,22,8
Shumkott,kazzak,1436,druid,balance,34,16,18
Krtt,tarren-mill,1435,druid,balance,247,121,126
Джасэл,howling-fjord,1434,druid,balance,30,20,10
Néøu,archimonde,1434,druid,balance,24,15,9
Armadroød,hyjal,1434,druid,balance,36,19,17
Urilmæ,blackmoore,1433,druid,balance,60,30,30
Bandinator,archimonde,1432,druid,balance,24,15,9
Duskdawn,xavius,1432,druid,balance,78,39,39
Kamzik,drakthul,1432,druid,balance,42,21,21
Sajah,outland,1432,druid,balance,70,30,40
Løö,archimonde,1431,druid,balance,24,15,9
Píps,ravencrest,1431,druid,balance,24,15,9
Maglar,blackmoore,1431,druid,balance,60,37,23
Chouwa,korgall,1431,druid,balance,65,38,27
Амахасла,deathweaver,1431,druid,balance,97,56,41
Dragonforcé,twisting-nether,1431,druid,balance,39,22,17
Feetpícs,ravencrest,1431,druid,balance,113,62,51
Xclonedotcom,aegwynn,1430,druid,balance,54,36,18
Fillet,aggra-português,1430,druid,balance,71,47,24
Asterism,stormscale,1430,druid,balance,177,94,83
Кекичшрекич,soulflayer,1430,druid,balance,84,44,40
Ibnform,archimonde,1429,druid,balance,18,15,3
Elilith,auchindoun,1429,druid,balance,18,15,3
Astralbody,auchindoun,1429,druid,balance,30,17,13
Kazuid,argent-dawn,1428,druid,balance,38,24,14
Dropp,colinas-pardas,1428,druid,balance,24,15,9
Vëgâñgøðx,ragnaros,1428,druid,balance,24,15,9
Fouser,shattered-hand,1428,druid,balance,36,17,19
Carebearlol,frostmane,1428,druid,balance,123,58,65
Rrayed,kazzak,1427,druid,balance,76,49,27
Exilara,twisting-nether,1427,druid,balance,66,39,27
Cevto,drakthul,1427,druid,balance,60,33,27
Phesxd,sylvanas,1427,druid,balance,30,16,14
Abralie,kazzak,1426,druid,balance,24,15,9
Kriala,kazzak,1426,druid,balance,36,20,16
Saltilac,ragnaros,1426,druid,balance,72,39,33
Drocos,genjuros,1426,druid,balance,65,35,30
Yiriy,baelgun,1426,druid,balance,30,15,15
Doctóras,twisting-nether,1425,druid,balance,24,16,8
Drudd,hellscream,1425,druid,balance,47,20,27
Этъя,borean-tundra,1424,druid,balance,155,76,79
Ooxx,rashgarroth,1424,druid,balance,99,48,51
Timanuel,ysondre,1424,druid,balance,36,15,21
Natoro,outland,1423,druid,balance,72,38,34
Zhyra,arathor,1423,druid,balance,157,81,76
Phanÿ,garona,1423,druid,balance,74,37,37
Crazzimus,tarren-mill,1423,druid,balance,138,68,70
Garthel,sylvanas,1423,druid,balance,105,51,54
Irøñbârk,ravencrest,1423,druid,balance,48,22,26
Moonpoxdru,nerathor,1422,druid,balance,24,15,9
Nøny,gorgonnash,1422,druid,balance,86,45,41
Wildthirst,darkspear,1421,druid,balance,48,30,18
Megaball,sylvanas,1421,druid,balance,132,76,56
Paulskinbak,tarren-mill,1421,druid,balance,60,30,30
Pleasédaddy,azjolnerub,1421,druid,balance,30,15,15
Còwgummi,blackhand,1421,druid,balance,30,15,15
Petiteorange,archimonde,1420,druid,balance,24,16,8
Koffee,archimonde,1420,druid,balance,60,34,26
Малисеннта,gordunni,1420,druid,balance,42,21,21
Karolg,tyrande,1420,druid,balance,75,35,40
Катяблум,gordunni,1419,druid,balance,39,25,14
Kanataka,stormscale,1418,druid,balance,54,32,22
Harrasmoes,ravencrest,1418,druid,balance,50,27,23
Calume,dun-modr,1417,druid,balance,30,16,14
Kroaxs,draenor,1417,druid,balance,248,131,117
Cráck,nagrand,1417,druid,balance,58,30,28
Лардиан,gordunni,1417,druid,balance,30,15,15
Lyøñ,dun-modr,1417,druid,balance,35,16,19
Âutumn,antonidas,1417,druid,balance,87,37,50
Jabah,silvermoon,1416,druid,balance,36,28,8
Rullader,draenor,1416,druid,balance,102,62,40
Majokz,ravencrest,1416,druid,balance,152,71,81
Wasïro,zuljin,1416,druid,balance,66,30,36
Blazoor,frostwolf,1415,druid,balance,57,33,24
Mooyagisan,blackhand,1415,druid,balance,65,35,30
Губкобоб,galakrond,1415,druid,balance,58,31,27
Tugnann,stormscale,1414,druid,balance,43,27,16
Wartôn,blackhand,1414,druid,balance,136,79,57
Lollipopz,ravencrest,1414,druid,balance,58,29,29
Suedi,frostmane,1413,druid,balance,24,16,8
Gécko,malfurion,1413,druid,balance,34,22,12
Шубаиздуба,howling-fjord,1413,druid,balance,78,42,36
Chillerin,draenor,1413,druid,balance,132,66,66
Primdâhl,ravencrest,1413,druid,balance,66,33,33
Hypam,archimonde,1413,druid,balance,54,25,29
Quorn,pozzo-delleternità,1413,druid,balance,88,40,48
Chintawaz,archimonde,1412,druid,balance,35,18,17
Мегасв,gordunni,1411,druid,balance,172,91,81
Artío,the-maelstrom,1411,druid,balance,193,101,92
Dao,aegwynn,1411,druid,balance,38,18,20
Forigiver,draenor,1410,druid,balance,30,19,11
Nyenna,twilights-hammer,1410,druid,balance,28,16,12
Stárburst,auchindoun,1410,druid,balance,119,65,54
Tepni,ragnaros,1410,druid,balance,30,16,14
Кортанус,gordunni,1410,druid,balance,58,29,29
Димитруа,howling-fjord,1409,druid,balance,36,17,19
Billzabub,doomhammer,1409,druid,balance,66,31,35
Ахелез,gordunni,1409,druid,balance,42,17,25
Опапенелопа,blackscar,1407,druid,balance,30,15,15
Dudmæster,blackmoore,1407,druid,balance,63,31,32
Chavidruid,twisting-nether,1406,druid,balance,26,17,9
Motry,tarren-mill,1406,druid,balance,37,20,17
Youdog,kazzak,1406,druid,balance,108,47,61
Malfurryon,drakthul,1405,druid,balance,48,32,16
Johnnybims,eredar,1405,druid,balance,24,15,9
Ziele,the-maelstrom,1405,druid,balance,70,36,34
Fanboij,kazzak,1405,druid,balance,36,16,20
Yaniayip,blackrock,1404,druid,balance,357,190,167
Lørdfæke,kazzak,1404,druid,balance,59,30,29
Heav,kiljaeden,1403,druid,balance,53,33,20
Ziouk,archimonde,1403,druid,balance,36,21,15
Rbgbear,blackhand,1403,druid,balance,59,32,27
Requinymph,ravencrest,1403,druid,balance,84,41,43
Adelsten,tarren-mill,1403,druid,balance,57,26,31
Izzi,arathor,1402,druid,balance,98,53,45
Kkthanks,twisting-nether,1402,druid,balance,60,29,31
Антошкез,howling-fjord,1402,druid,balance,42,19,23
Murenito,nemesis,1402,druid,balance,130,56,74
Larayne,anubarak,1401,druid,balance,27,16,11
Toondog,doomhammer,1401,druid,balance,37,21,16
Cîalîs,blackmoore,1401,druid,balance,41,21,20
Животноеыы,howling-fjord,1401,druid,balance,59,27,32
Hëstía,outland,1400,druid,balance,29,19,10
Sephir,shattrath,1400,druid,balance,78,42,36
Çãm,magtheridon,1399,druid,balance,24,16,8
Fäcker,blackhand,1399,druid,balance,84,48,36
Xyiz,ravencrest,1399,druid,balance,80,42,38
Ilovedruid,forscherliga,1399,druid,balance,88,45,43
Elødyn,nemesis,1397,druid,balance,56,30,26
Ramgis,sanguino,1397,druid,balance,36,17,19
Gajani,stormscale,1395,druid,balance,41,20,21
Кулунхе,soulflayer,1394,druid,balance,96,57,39
Astarhot,cthun,1394,druid,balance,40,22,18
Gullíver,draenor,1394,druid,balance,109,57,52
Hardruid,sanguino,1394,druid,balance,35,18,17
Freefang,dun-modr,1393,druid,balance,40,24,16
Makoes,tarren-mill,1393,druid,balance,32,18,14
Growhoof,kazzak,1393,druid,balance,66,34,32
When,kirin-tor,1393,druid,balance,111,57,54
Ïæzêrçhîçkén,sylvanas,1393,druid,balance,46,20,26
Ibêx,blackmoore,1391,druid,balance,48,26,22
Sháko,dun-modr,1391,druid,balance,62,30,32
Irishdemón,ravencrest,1390,druid,balance,96,51,45
Køßÿ,ysondre,1390,druid,balance,54,26,28
Kalàdin,ysondre,1390,druid,balance,56,23,33
Elonax,eredar,1389,druid,balance,67,39,28
Ismackü,stormscale,1387,druid,balance,65,43,22
Gatojuan,dun-modr,1387,druid,balance,30,15,15
Ilovegrass,kazzak,1387,druid,balance,55,26,29
Layle,argent-dawn,1387,druid,balance,128,58,70
Venh,forscherliga,1386,druid,balance,93,54,39
Noctilus,steamwheedle-cartel,1386,druid,balance,30,16,14
Hárty,tarren-mill,1384,druid,balance,86,47,39
Pipima,kazzak,1384,druid,balance,85,44,41
Surgeshift,ravencrest,1384,druid,balance,84,34,50
Druidskillz,pozzo-delleternità,1383,druid,balance,41,26,15
Myex,exodar,1383,druid,balance,61,32,29
Chispiwini,cthun,1383,druid,balance,91,45,46
Stealthslash,the-maelstrom,1383,druid,balance,86,40,46
Rayko,nemesis,1382,druid,balance,63,37,26
Zedapalha,aggra-português,1382,druid,balance,75,44,31
Catsgomeow,outland,1382,druid,balance,54,27,27
Proxyy,blackrock,1382,druid,balance,46,22,24
Drazefin,twisting-nether,1382,druid,balance,42,15,27
Mercmydude,ravencrest,1381,druid,balance,111,54,57
Postmaclone,thrall,1380,druid,balance,39,23,16
Angharradh,arthas,1380,druid,balance,36,18,18
Naone,silvermoon,1379,druid,balance,147,81,66
Wainl,hyjal,1379,druid,balance,54,28,26
Lucidx,blackrock,1379,druid,balance,120,56,64
Nightingalee,stormscale,1379,druid,balance,54,24,30
Laylie,aegwynn,1379,druid,balance,47,20,27
Srkameltouss,sanguino,1378,druid,balance,24,17,7
Древогрут,howling-fjord,1378,druid,balance,25,17,8
Herrencreme,eredar,1378,druid,balance,28,16,12
Doruido,rashgarroth,1378,druid,balance,96,40,56
Salseo,uldum,1377,druid,balance,72,46,26
Pavesino,nemesis,1377,druid,balance,30,18,12
Merî,antonidas,1377,druid,balance,135,80,55
Buhuu,blackmoore,1377,druid,balance,213,108,105
Rexiehunty,aszune,1376,druid,balance,59,28,31
Данилсахарок,soulflayer,1376,druid,balance,47,20,27
Duhdudu,thrall,1375,druid,balance,77,47,30
Сэднхорни,howling-fjord,1375,druid,balance,66,32,34
Raxona,blackmoore,1374,druid,balance,36,20,16
Asklepiøs,blackmoore,1374,druid,balance,36,19,17
Schneelol,outland,1374,druid,balance,66,33,33
Neri,shattered-hand,1374,druid,balance,46,23,23
Farmerone,tarren-mill,1373,druid,balance,102,57,45
Idk,blackhand,1373,druid,balance,74,38,36
Тёмныйзверь,borean-tundra,1373,druid,balance,84,43,41
Fortuma,eredar,1372,druid,balance,89,44,45
Qoællj,dragonmaw,1372,druid,balance,48,22,26
Jarko,ysondre,1372,druid,balance,104,46,58
Drujin,hellfire,1371,druid,balance,149,78,71
Hardí,tarren-mill,1371,druid,balance,120,62,58
Neova,dun-modr,1371,druid,balance,57,29,28
Alterejuv,ravencrest,1371,druid,balance,90,41,49
Pø,blackrock,1371,druid,balance,59,26,33
Сейдр,grom,1371,druid,balance,66,24,42
Pelagius,ravencrest,1369,druid,balance,51,32,19
Mayhh,ragnaros,1369,druid,balance,143,79,64
Patchlølx,blackmoore,1368,druid,balance,63,37,26
Wârden,twisting-nether,1368,druid,balance,95,51,44
Leliaen,sylvanas,1368,druid,balance,48,23,25
Ghunm,ragnaros,1366,druid,balance,49,26,23
Rinjindin,eredar,1366,druid,balance,138,72,66
Iamramen,blackmoore,1366,druid,balance,245,124,121
Chrîslol,twisting-nether,1366,druid,balance,103,49,54
Arreton,silvermoon,1365,druid,balance,22,15,7
Suranaelle,argent-dawn,1365,druid,balance,103,57,46
Алендор,deathguard,1365,druid,balance,90,47,43
Convoke,burning-legion,1365,druid,balance,76,34,42
Fallingmoon,ravencrest,1364,druid,balance,48,27,21
Jeesman,sylvanas,1364,druid,balance,128,71,57
Kielorn,stormscale,1364,druid,balance,66,36,30
Jobberwock,outland,1364,druid,balance,30,15,15
Jaile,burning-legion,1363,druid,balance,28,18,10
Heanra,frostmane,1363,druid,balance,35,22,13
Papacarlo,ravencrest,1363,druid,balance,32,19,13
Yungle,stormscale,1363,druid,balance,102,47,55
Orchard,silvermoon,1362,druid,balance,82,50,32
Darkillaa,anetheron,1362,druid,balance,83,44,39
Arenshimoon,kazzak,1362,druid,balance,104,55,49
Moujr,draenor,1362,druid,balance,88,46,42
Mytréx,sylvanas,1362,druid,balance,96,46,50
Téddý,tarren-mill,1361,druid,balance,73,35,38
Cowárd,blackmoore,1361,druid,balance,44,20,24
Rèchy,blackrock,1360,druid,balance,33,15,18
Pfíirsich,blackmoore,1359,druid,balance,56,25,31
Oomkin,darkspear,1358,druid,balance,28,15,13
Vulyr,outland,1358,druid,balance,190,98,92
Óok,outland,1358,druid,balance,45,22,23
Ronî,arthas,1357,druid,balance,90,47,43
Catmøm,blackmoore,1357,druid,balance,94,47,47
Buikstuk,kilrogg,1356,druid,balance,57,38,19
Thepiemaker,silvermoon,1356,druid,balance,30,18,12
Variolus,dun-modr,1355,druid,balance,83,41,42
Nyetoo,dun-modr,1355,druid,balance,85,38,47
Släshes,stormreaver,1353,druid,balance,36,22,14
Ennelle,silvermoon,1353,druid,balance,38,23,15
Zertyop,arathi,1353,druid,balance,52,26,26
Endoth,blackrock,1352,druid,balance,38,20,18
Shìrò,kelthuzad,1352,druid,balance,96,48,48
Onemanzoo,drakthul,1350,druid,balance,114,60,54
Ketama,sylvanas,1350,druid,balance,85,42,43
Батлграуннт,soulflayer,1350,druid,balance,76,30,46
Icetep,sargeras,1349,druid,balance,72,35,37
Brujo,azjolnerub,1349,druid,balance,93,44,49
Convulsivez,silvermoon,1349,druid,balance,87,38,49
Doncaino,amanthul,1349,druid,balance,48,19,29
Эвкалипт,soulflayer,1348,druid,balance,48,26,22
Lothadriel,sylvanas,1347,druid,balance,111,62,49
Stosstange,blackmoore,1347,druid,balance,29,16,13
Bigpoppaz,tarren-mill,1345,druid,balance,66,31,35
Almrudi,blackrock,1345,druid,balance,86,38,48
Skywíng,stormscale,1345,druid,balance,66,28,38
Mongwau,blackrock,1344,druid,balance,48,31,17
Waymundo,blackhand,1344,druid,balance,36,16,20
Yshára,darkmoon-faire,1343,druid,balance,18,14,4
Shiftmeow,tarren-mill,1343,druid,balance,24,14,10
Broxisqt,blackrock,1343,druid,balance,24,14,10
Bolskigg,stormreaver,1343,druid,balance,54,26,28
Wenciorek,kazzak,1343,druid,balance,36,17,19
Формен,howling-fjord,1343,druid,balance,30,14,16
Joqr,tarren-mill,1342,druid,balance,18,14,4
Suppencaster,frostwolf,1342,druid,balance,18,14,4
Shapees,sylvanas,1342,druid,balance,24,14,10
Амераки,blackscar,1342,druid,balance,24,14,10
Yourßâßygîrl,sylvanas,1342,druid,balance,60,34,26
Achre,thunderhorn,1342,druid,balance,41,20,21
Superdupa,burning-blade,1341,druid,balance,30,15,15
Superpoulet,archimonde,1341,druid,balance,30,14,16
Felyß,outland,1340,druid,balance,60,35,25
Blackdrd,archimonde,1340,druid,balance,24,14,10
Speedpoppin,defias-brotherhood,1340,druid,balance,30,14,16
Piiti,burning-legion,1340,druid,balance,60,27,33
Tjann,darksorrow,1340,druid,balance,34,15,19
Braokhull,stormscale,1339,druid,balance,72,40,32
Santoniq,dun-morogh,1339,druid,balance,162,79,83
Nolak,frostwolf,1338,druid,balance,66,34,32
Claynoe,blackmoore,1337,druid,balance,27,15,12
Abadar,tarren-mill,1337,druid,balance,156,80,76
Матумбо,razuvious,1337,druid,balance,605,300,305
Kheleñ,blackrock,1336,druid,balance,20,14,6
Illebra,defias-brotherhood,1336,druid,balance,24,14,10
Sasosins,ravencrest,1336,druid,balance,24,14,10
Tonie,stormscale,1336,druid,balance,71,34,37
Reeves,lightbringer,1336,druid,balance,42,19,23
Akâmè,blackrock,1336,druid,balance,51,23,28
Éxy,kazzak,1336,druid,balance,36,15,21
Veilath,tarren-mill,1335,druid,balance,30,15,15
Raféékí,outland,1334,druid,balance,24,14,10
Revølter,kazzak,1334,druid,balance,82,38,44
Rankøne,archimonde,1333,druid,balance,24,14,10
Vandalís,garrosh,1332,druid,balance,28,19,9
Bærbell,blackrock,1332,druid,balance,48,26,22
Xérà,blackmoore,1332,druid,balance,32,16,16
Laaide,blackmoore,1331,druid,balance,54,25,29
Soward,la-croisade-écarlate,1331,druid,balance,38,17,21
Barbielolz,archimonde,1330,druid,balance,24,14,10
Razorleaf,turalyon,1330,druid,balance,60,29,31
Nëko,chamber-of-aspects,1330,druid,balance,59,23,36
Transformerr,silvermoon,1329,druid,balance,66,32,34
Lindémann,blackhand,1328,druid,balance,63,41,22
Mirikastiko,korgall,1328,druid,balance,24,14,10
Kâo,frostwolf,1328,druid,balance,24,14,10
Aik,gorgonnash,1328,druid,balance,102,46,56
Torlok,anetheron,1328,druid,balance,40,16,24
Drmz,dalaran,1327,druid,balance,58,27,31
Nerfàd,twisting-nether,1326,druid,balance,18,14,4
Bufflock,ravencrest,1326,druid,balance,24,14,10
Trol,malganis,1325,druid,balance,108,56,52
Doomkin,tichondrius,1325,druid,balance,58,30,28
Альмазар,lich-king,1325,druid,balance,98,50,48
Baracüda,draenor,1325,druid,balance,84,38,46
Coldleans,kazzak,1324,druid,balance,24,15,9
Tankis,dalaran,1324,druid,balance,137,81,56
Soneka,ravencrest,1324,druid,balance,54,30,24
Kazzeria,stormscale,1324,druid,balance,42,21,21
Pewzzd,alexstrasza,1323,druid,balance,27,16,11
Fireinmyhole,hyjal,1323,druid,balance,24,14,10
Fantaclause,tarren-mill,1323,druid,balance,334,167,167
Nymå,outland,1322,druid,balance,30,14,16
Tordo,silvermoon,1321,druid,balance,30,14,16
Ephixa,burning-legion,1321,druid,balance,30,14,16
Коктявзер,deathweaver,1320,druid,balance,60,26,34
Fey,stormrage,1320,druid,balance,65,27,38
Hisoca,tarren-mill,1319,druid,balance,120,63,57
Keerook,blackmoore,1318,druid,balance,30,15,15
Ymúmu,sanguino,1318,druid,balance,42,19,23
Bleati,silvermoon,1315,druid,balance,111,65,46
Diakamo,frostwolf,1315,druid,balance,36,20,16
Jokizy,burning-legion,1315,druid,balance,114,63,51
Bløødax,hyjal,1315,druid,balance,136,64,72
Challi,nordrassil,1314,druid,balance,54,31,23
Limmiited,ravencrest,1314,druid,balance,96,52,44
Zindaya,blades-edge,1314,druid,balance,38,20,18
Succee,stormscale,1313,druid,balance,315,163,152
Antiseptik,ysondre,1313,druid,balance,82,40,42
Matzz,burning-legion,1313,druid,balance,30,14,16
Aryitu,blackrock,1312,druid,balance,68,35,33
Bulma,dun-modr,1312,druid,balance,48,23,25
Nefariz,dun-modr,1312,druid,balance,86,38,48
Derrill,hellfire,1311,druid,balance,23,16,7
Jdogger,tarren-mill,1311,druid,balance,30,17,13
Астраджет,gordunni,1311,druid,balance,48,24,24
Madschinken,malganis,1310,druid,balance,73,42,31
Kimba,onyxia,1310,druid,balance,192,99,93
Albïnøs,arathi,1310,druid,balance,30,15,15
Hideinbushh,ravencrest,1309,druid,balance,20,15,5
Midnightwisp,blackhand,1309,druid,balance,55,30,25
Omegah,bladefist,1309,druid,balance,36,17,19
Zzblaah,archimonde,1309,druid,balance,42,15,27
Putzé,blackrock,1308,druid,balance,41,20,21
Epidruid,stormrage,1307,druid,balance,49,25,24
Solarian,ravencrest,1304,druid,balance,42,26,16
Yööi,nemesis,1304,druid,balance,30,14,16
Farodiin,blackmoore,1304,druid,balance,63,29,34
Bsp,khadgar,1303,druid,balance,30,14,16
Cénârion,les-sentinelles,1302,druid,balance,101,48,53
Исмалат,howling-fjord,1301,druid,balance,90,51,39
Incont,nemesis,1301,druid,balance,233,130,103
Drrestospec,tarren-mill,1300,druid,balance,114,66,48
Шадарлогот,gordunni,1300,druid,balance,90,52,38
Àkøs,ragnaros,1300,druid,balance,126,68,58
Sazo,elune,1300,druid,balance,28,14,14
Bigdx,blackrock,1300,druid,balance,182,90,92
Swolecat,ravencrest,1300,druid,balance,29,14,15
Wtcseven,eredar,1300,druid,balance,42,20,22
Чанголист,howling-fjord,1300,druid,balance,67,30,37
Shùrã,archimonde,1299,druid,balance,84,48,36
Zeifana,khaz-modan,1297,druid,balance,30,18,12
Oiseth,tarren-mill,1297,druid,balance,78,36,42
Yolobolo,ragnaros,1295,druid,balance,23,14,9
Àlec,silvermoon,1295,druid,balance,196,105,91
Cylàn,sylvanas,1295,druid,balance,36,16,20
Ххансолл,gordunni,1294,druid,balance,237,123,114
Voorhess,blackmoore,1294,druid,balance,64,29,35
Melyo,blackmoore,1293,druid,balance,66,37,29
Tubi,darksorrow,1293,druid,balance,36,19,17
Druice,tyrande,1292,druid,balance,41,25,16
Dancingrain,ravencrest,1292,druid,balance,35,15,20
Ковикхс,soulflayer,1290,druid,balance,71,35,36
Larbre,dalaran,1289,druid,balance,67,45,22
Réalmadruid,archimonde,1289,druid,balance,24,14,10
Roroa,ravencrest,1289,druid,balance,27,14,13
Sokay,doomhammer,1289,druid,balance,114,52,62
Whísperclaw,ravencrest,1288,druid,balance,161,83,78
Heinox,stormscale,1288,druid,balance,138,68,70
Совуф,ashenvale,1288,druid,balance,36,17,19
Forestrun,sylvanas,1287,druid,balance,48,30,18
Lærken,the-maelstrom,1287,druid,balance,89,50,39
Frenkiej,pozzo-delleternità,1287,druid,balance,74,41,33
Fhi,antonidas,1286,druid,balance,53,29,24
Cubir,turalyon,1286,druid,balance,56,29,27
Ashär,kirin-tor,1286,druid,balance,128,65,63
Quiksx,blackrock,1286,druid,balance,43,20,23
Ralokian,drakthul,1285,druid,balance,53,34,19
Betol,das-konsortium,1285,druid,balance,38,21,17
Jpxoxoq,blackhand,1285,druid,balance,39,19,20
Terrays,the-maelstrom,1284,druid,balance,78,53,25
Scottparker,sylvanas,1282,druid,balance,36,24,12
Dudutrainer,blackmoore,1282,druid,balance,53,31,22
Elekträ,ravencrest,1282,druid,balance,69,27,42
Wherismygold,ravencrest,1281,druid,balance,121,57,64
Blark,sylvanas,1281,druid,balance,36,15,21
Tekal,vashj,1280,druid,balance,36,20,16
Velnens,shattered-halls,1280,druid,balance,124,61,63
Pôpcorn,ragnaros,1279,druid,balance,147,77,70
Святогор,greymane,1279,druid,balance,36,14,22
Füsselviech,frostwolf,1278,druid,balance,21,14,7
Medreas,argent-dawn,1278,druid,balance,95,59,36
Getsomefunny,archimonde,1276,druid,balance,54,30,24
Mascraxx,earthen-ring,1276,druid,balance,103,54,49
Droodfarm,hyjal,1276,druid,balance,88,46,42
Jucie,twisting-nether,1276,druid,balance,59,29,30
Dereas,anetheron,1275,druid,balance,30,19,11
Fiagard,antonidas,1275,druid,balance,77,48,29
Kirïllx,silvermoon,1275,druid,balance,33,19,14
Видди,soulflayer,1275,druid,balance,54,27,27
Edi,twisting-nether,1275,druid,balance,30,14,16
Kittyboomy,burning-blade,1275,druid,balance,75,33,42
Youngjin,ravencrest,1274,druid,balance,36,21,15
Narai,shadowsong,1274,druid,balance,107,54,53
Æîîs,blackrock,1273,druid,balance,163,82,81
Rektjin,stormscale,1273,druid,balance,42,17,25
Altix,blackmoore,1272,druid,balance,72,40,32
Àsúnâ,eredar,1272,druid,balance,42,15,27
Eliar,burning-legion,1271,druid,balance,55,31,24
Linsight,sanguino,1271,druid,balance,66,35,31
Crazywild,archimonde,1271,druid,balance,74,29,45
Gejtu,the-venture-co,1270,druid,balance,37,16,21
Mûcke,kazzak,1269,druid,balance,35,16,19
Taylorshift,argent-dawn,1268,druid,balance,23,14,9
Balzàc,ravencrest,1268,druid,balance,88,48,40
Trollsona,twisting-nether,1268,druid,balance,30,14,16
Vrillox,blackmoore,1268,druid,balance,33,15,18
Orious,dun-modr,1267,druid,balance,28,14,14
Maniek,defias-brotherhood,1267,druid,balance,42,19,23
Kommarübär,tirion,1266,druid,balance,48,20,28
Caltvalai,ravencrest,1265,druid,balance,28,14,14
Semiflora,silvermoon,1264,druid,balance,70,33,37
Chugs,draenor,1263,druid,balance,52,27,25
Карантини,howling-fjord,1263,druid,balance,63,31,32
Månljuset,outland,1262,druid,balance,33,21,12
Ваандри,gordunni,1262,druid,balance,36,22,14
Фераладзе,gordunni,1262,druid,balance,72,36,36
Petju,darksorrow,1262,druid,balance,48,21,27
Atbõs,stormscale,1261,druid,balance,35,18,17
Jenelin,silvermoon,1260,druid,balance,42,20,22
Hypnosoad,outland,1259,druid,balance,47,20,27
Hushorde,twisting-nether,1259,druid,balance,48,17,31
Kaspurr,ravencrest,1258,druid,balance,18,14,4
Croudo,ravencrest,1258,druid,balance,36,17,19
Zombrex,blackrock,1258,druid,balance,42,18,24
Bolinette,archimonde,1258,druid,balance,48,17,31
Shehida,silvermoon,1257,druid,balance,36,17,19
Bambøué,khaz-modan,1256,druid,balance,31,19,12
Raÿz,archimonde,1255,druid,balance,24,15,9
Mööñ,hyjal,1255,druid,balance,43,23,20
Нэйроуз,howling-fjord,1254,druid,balance,95,49,46
Mäo,sylvanas,1254,druid,balance,54,24,30
Vishin,kazzak,1253,druid,balance,137,77,60
Игрог,soulflayer,1252,druid,balance,71,34,37
Putitimoriri,pozzo-delleternità,1251,druid,balance,122,68,54
Tarantinonon,kazzak,1251,druid,balance,202,102,100
Naizoll,doomhammer,1250,druid,balance,42,25,17
Опаснокрасив,soulflayer,1250,druid,balance,48,28,20
Abbî,aegwynn,1249,druid,balance,66,44,22
Zuldram,uldaman,1249,druid,balance,29,14,15
Tygra,blackrock,1248,druid,balance,18,13,5
Adoodo,argent-dawn,1248,druid,balance,59,38,21
Hadoukan,ravencrest,1248,druid,balance,53,27,26
Renewdex,thrall,1247,druid,balance,18,13,5
Tellurr,silvermoon,1247,druid,balance,18,13,5
Raféekí,stormscale,1247,druid,balance,24,13,11
Bingbe,outland,1246,druid,balance,18,13,5
Xevan,blackrock,1246,druid,balance,18,13,5
Mariss25076F,chogall,1246,druid,balance,30,18,12
Freedonnad,alleria,1246,druid,balance,29,17,12
Жесткая,lich-king,1246,druid,balance,34,16,18
Beutow,archimonde,1246,druid,balance,30,13,17
Xkirtach,dun-modr,1245,druid,balance,24,13,11
Djràkèâlòt,ravencrest,1244,druid,balance,18,13,5
Kermit,die-aldor,1244,druid,balance,168,77,91
Eranor,archimonde,1243,druid,balance,18,13,5
Ateli,kazzak,1243,druid,balance,21,14,7
Лякокля,soulflayer,1243,druid,balance,69,38,31
Ríviia,drakthul,1243,druid,balance,24,13,11
Smittly,bloodhoof,1243,druid,balance,36,17,19
Guccicken,garona,1242,druid,balance,18,13,5
Clonorrhea,tarren-mill,1242,druid,balance,24,13,11
Spoco,defias-brotherhood,1242,druid,balance,34,18,16
Vorsaufen,blackhand,1242,druid,balance,27,14,13
Rengár,blackrock,1241,druid,balance,18,13,5
Wildthing,blackmoore,1241,druid,balance,92,46,46
Dremdra,draenor,1241,druid,balance,72,34,38
Starcaller,burning-blade,1240,druid,balance,22,14,8
Skidone,ravencrest,1240,druid,balance,24,13,11
Tassutan,stormreaver,1240,druid,balance,30,15,15
Moonscreamz,tarren-mill,1240,druid,balance,36,15,21
Fossilfuel,ragnaros,1240,druid,balance,71,27,44
Nyrrh,blackmoore,1239,druid,balance,24,13,11
Smilodon,blackrock,1239,druid,balance,30,13,17
Ninoboyswag,stormscale,1238,druid,balance,30,13,17
Prettyfunny,ravencrest,1236,druid,balance,18,13,5
Conn,ravencrest,1236,druid,balance,81,45,36
Zytherqt,thrall,1236,druid,balance,24,13,11
Evølvë,burning-blade,1236,druid,balance,30,13,17
Thyrena,argent-dawn,1236,druid,balance,86,37,49
Moosliman,kazzak,1235,druid,balance,24,13,11
Slyndjur,sylvanas,1235,druid,balance,24,13,11
Trollskee,draenor,1235,druid,balance,52,24,28
Jadraeth,tarren-mill,1234,druid,balance,18,13,5
Nefertiti,baelgun,1234,druid,balance,24,13,11
Doggerz,aggra-português,1234,druid,balance,102,52,50
Derie,nazjatar,1233,druid,balance,36,21,15
Мяурицао,howling-fjord,1233,druid,balance,113,62,51
Makelsi,tarren-mill,1233,druid,balance,29,14,15
Fakeztwo,eredar,1233,druid,balance,29,14,15
Thruf,nemesis,1233,druid,balance,60,26,34
Lendron,malygos,1233,druid,balance,35,14,21
Amici,eredar,1232,druid,balance,24,13,11
Tytankon,silvermoon,1232,druid,balance,115,52,63
Друная,gordunni,1232,druid,balance,56,24,32
Kunya,tarren-mill,1231,druid,balance,361,173,188
Redyogurt,outland,1231,druid,balance,36,13,23
Eaglefôrce,blackmoore,1230,druid,balance,29,15,14
Sodniss,aggra-português,1230,druid,balance,84,41,43
Kizilbuka,ragnaros,1229,druid,balance,79,49,30
Lynysae,blackmoore,1229,druid,balance,24,13,11
Мунмунмун,gordunni,1229,druid,balance,43,19,24
Drazigo,grim-batol,1228,druid,balance,39,18,21
Oxox,defias-brotherhood,1227,druid,balance,25,14,11
Ckdruid,frostmane,1227,druid,balance,36,15,21
Pawsitive,sylvanas,1227,druid,balance,36,14,22
Ðoxi,draenor,1226,druid,balance,120,58,62
Polimorphism,tarren-mill,1226,druid,balance,78,32,46
Zaratras,arathor,1225,druid,balance,24,13,11
Maurana,sylvanas,1225,druid,balance,30,13,17
Freshener,antonidas,1224,druid,balance,62,38,24
Trydru,blackmoore,1223,druid,balance,102,50,52
Zeldaa,antonidas,1223,druid,balance,93,43,50
Kleinii,blackrock,1223,druid,balance,48,20,28
Monopolying,dentarg,1221,druid,balance,88,48,40
Demizeub,archimonde,1221,druid,balance,297,142,155
Xarxius,sanguino,1220,druid,balance,67,38,29
Ritualofmoon,darkmoon-faire,1220,druid,balance,63,31,32
Gluqt,outland,1220,druid,balance,102,48,54
Астралъх,gordunni,1220,druid,balance,152,66,86
Necare,blackmoore,1219,druid,balance,29,18,11
Buzzlîghtyea,outland,1218,druid,balance,24,13,11
Mlyzioz,ahnqiraj,1216,druid,balance,78,46,32
Søfiaa,argent-dawn,1216,druid,balance,149,84,65
ßalmain,nethersturm,1216,druid,balance,76,41,35
Laiquaril,ravencrest,1216,druid,balance,67,31,36
Aureliusx,drakthul,1215,druid,balance,48,20,28
Certton,arakarahm,1214,druid,balance,123,60,63
Holyconvoke,stormscale,1213,druid,balance,22,14,8
Zac,quelthalas,1211,druid,balance,24,13,11
Druiddamage,the-maelstrom,1210,druid,balance,225,117,108
Старс,gordunni,1208,druid,balance,24,13,11
Biggzl,silvermoon,1208,druid,balance,180,95,85
Ellordann,ravencrest,1208,druid,balance,33,17,16
Bearhúg,kazzak,1208,druid,balance,47,17,30
Jevcoh,area-52,1207,druid,balance,18,13,5
Lözbox,kazzak,1207,druid,balance,72,33,39
Lowcr,ravencrest,1204,druid,balance,61,33,28
Arntooth,burning-legion,1204,druid,balance,110,56,54
Ayven,kazzak,1204,druid,balance,36,18,18
Varladór,ravencrest,1203,druid,balance,36,21,15
Пушистаялапа,blackscar,1203,druid,balance,52,29,23
Tílac,eredar,1202,druid,balance,24,13,11
Hengst,laughing-skull,1202,druid,balance,28,15,13
Zoozian,antonidas,1201,druid,balance,18,16,2
Смизм,gordunni,1201,druid,balance,42,18,24
Loum,blackrock,1201,druid,balance,42,18,24
Croquetoro,sanguino,1200,druid,balance,28,13,15
Lucianis,drakthul,1197,druid,balance,48,17,31
Herten,tarren-mill,1196,druid,balance,24,15,9
Malammore,burning-legion,1195,druid,balance,77,49,28
Owltoy,frostmane,1195,druid,balance,27,15,12
Trækvinden,ravencrest,1193,druid,balance,63,30,33
Teldrastion,silvermoon,1193,druid,balance,85,32,53
Sarkophag,blackrock,1193,druid,balance,36,13,23
Litany,drakthul,1192,druid,balance,35,16,19
Trollisha,mannoroth,1191,druid,balance,32,17,15
Сейтил,deathguard,1191,druid,balance,97,45,52
Eralon,alleria,1191,druid,balance,40,14,26
Dêesse,archimonde,1188,druid,balance,42,20,22
Talressian,argent-dawn,1188,druid,balance,72,26,46
Дайтеполено,howling-fjord,1186,druid,balance,94,45,49
Ærîs,garona,1185,druid,balance,58,24,34
Boxosjohnny,ragnaros,1183,druid,balance,35,14,21
Blesya,ravencrest,1182,druid,balance,39,15,24
Chulainn,sylvanas,1181,druid,balance,24,18,6
Lyj,dalaran,1178,druid,balance,33,18,15
Deadmorph,ysondre,1178,druid,balance,27,14,13
Käisur,doomhammer,1178,druid,balance,34,16,18
Split,rexxar,1177,druid,balance,41,22,19
Ednaqt,grim-batol,1177,druid,balance,48,20,28
Drúîid,kazzak,1176,druid,balance,17,13,4
Duveldruid,dragonblight,1176,druid,balance,24,17,7
Забурсчу,howling-fjord,1176,druid,balance,32,20,12
Tharae,blackmoore,1176,druid,balance,28,15,13
Budz,bloodfeather,1176,druid,balance,28,14,14
Прит,gordunni,1176,druid,balance,36,13,23
Bazikk,kazzak,1174,druid,balance,76,44,32
Широзоид,howling-fjord,1174,druid,balance,23,13,10
Eliaster,ysondre,1174,druid,balance,36,20,16
Captaìncool,auchindoun,1173,druid,balance,119,67,52
Bäärbel,aegwynn,1173,druid,balance,30,13,17
Geizagobble,twisting-nether,1173,druid,balance,96,35,61
Попестовали,gordunni,1172,druid,balance,33,19,14
Trickpotato,terrordar,1172,druid,balance,42,24,18
Dobradoonga,exodar,1172,druid,balance,57,30,27
Starcat,defias-brotherhood,1172,druid,balance,26,13,13
Киллиманжаро,howling-fjord,1171,druid,balance,218,103,115
Spacebéam,ravencrest,1171,druid,balance,36,13,23
Gardenstate,silvermoon,1170,druid,balance,60,34,26
Wolfhealer,blackmoore,1168,druid,balance,60,32,28
Maelinou,archimonde,1168,druid,balance,36,19,17
Yunød,silvermoon,1168,druid,balance,136,56,80
Corkiri,tarren-mill,1167,druid,balance,17,13,4
Kotomer,defias-brotherhood,1167,druid,balance,255,121,134
Ohndankalan,kazzak,1167,druid,balance,167,76,91
Krausz,burning-legion,1166,druid,balance,70,42,28
Drdudu,dun-morogh,1166,druid,balance,61,30,31
Tahru,blackrock,1164,druid,balance,31,14,17
Radoo,thrall,1164,druid,balance,60,22,38
Werevolf,drakthul,1164,druid,balance,39,14,25
Dumbadum,blackmoore,1163,druid,balance,42,19,23
Mçgonagall,quelthalas,1159,druid,balance,102,44,58
Eýesburn,silvermoon,1159,druid,balance,70,23,47
Toxida,antonidas,1157,druid,balance,71,35,36
Haginator,twisting-nether,1157,druid,balance,102,48,54
Cobradrood,culte-de-la-rive-noire,1157,druid,balance,48,21,27
Northstar,sylvanas,1156,druid,balance,18,13,5
Gnotten,thunderhorn,1154,druid,balance,23,13,10
Царапкатян,gordunni,1154,druid,balance,25,13,12
Leyarin,argent-dawn,1154,druid,balance,188,85,103
Slurmms,sylvanas,1153,druid,balance,174,96,78
Бигтедико,gordunni,1153,druid,balance,197,102,95
Querasidru,ravencrest,1153,druid,balance,46,17,29
Sopado,draenor,1152,druid,balance,12,12,0
Trønchetto,nemesis,1152,druid,balance,18,12,6
Cryspie,garona,1152,druid,balance,18,12,6
Lêviàthäñ,blackhand,1152,druid,balance,24,12,12
Minado,outland,1151,druid,balance,12,12,0
Edenx,stormscale,1151,druid,balance,12,12,0
Vârima,ravencrest,1151,druid,balance,18,12,6
Nätsügødxqt,archimonde,1151,druid,balance,18,12,6
Vraelyon,nemesis,1151,druid,balance,18,12,6
Bigfeeder,ravencrest,1151,druid,balance,20,12,8
Fotmrerollér,darksorrow,1151,druid,balance,50,29,21
Friidaf,lightbringer,1151,druid,balance,24,12,12
Whelpss,archimonde,1151,druid,balance,27,13,14
Moder,nemesis,1150,druid,balance,33,17,16
Därgon,archimonde,1150,druid,balance,24,12,12
Diosreypollo,cthun,1149,druid,balance,21,13,8
Deblin,ragnaros,1148,druid,balance,41,23,18
Курумелька,gordunni,1148,druid,balance,24,12,12
Rønnie,ravencrest,1147,druid,balance,18,12,6
Leafsandstuf,ragnaros,1147,druid,balance,18,12,6
Rêidon,antonidas,1147,druid,balance,18,12,6
Nvy,blackmoore,1147,druid,balance,29,13,16
Rabbalala,twisting-nether,1147,druid,balance,30,12,18
Mnqn,ravencrest,1146,druid,balance,18,12,6
Merq,ravencrest,1146,druid,balance,18,12,6
Фэк,eversong,1146,druid,balance,22,13,9
Lyorn,stormscale,1145,druid,balance,24,12,12
Aestûs,outland,1145,druid,balance,24,12,12
Maxiturbogay,stormscale,1145,druid,balance,24,12,12
Glumy,silvermoon,1145,druid,balance,54,22,32
Флексим,soulflayer,1144,druid,balance,24,12,12
Mythiaran,argent-dawn,1144,druid,balance,30,12,18
Jengá,nagrand,1143,druid,balance,18,12,6
Klintxweed,hyjal,1143,druid,balance,18,12,6
Criaø,blackrock,1143,druid,balance,24,12,12
Krizkat,blackmoore,1143,druid,balance,24,12,12
Catzoro,tarren-mill,1142,druid,balance,24,12,12
Huayhey,the-maelstrom,1141,druid,balance,18,12,6
Loriann,twisting-nether,1141,druid,balance,75,36,39
Fattsocow,stormscale,1141,druid,balance,52,22,30
Avior,eonar,1141,druid,balance,59,18,41
Two,silvermoon,1140,druid,balance,103,58,45
Feraligator,sanguino,1140,druid,balance,177,84,93
Cotangens,tarren-mill,1140,druid,balance,30,12,18
Discomånkung,stormscale,1139,druid,balance,18,12,6
Shiotake,hyjal,1139,druid,balance,24,12,12
Ajgreed,grim-batol,1139,druid,balance,24,12,12
Blueedood,twisting-nether,1139,druid,balance,24,12,12
Lootmann,die-silberne-hand,1138,druid,balance,62,35,27
Mirelawe,stormscale,1138,druid,balance,41,21,20
Zoxen,nefarian,1138,druid,balance,30,12,18
Pogoth,turalyon,1137,druid,balance,24,12,12
Bztémor,archimonde,1137,druid,balance,24,12,12
Corpito,tarren-mill,1137,druid,balance,61,25,36
Пачкачая,howling-fjord,1136,druid,balance,150,80,70
Kejî,blackrock,1135,druid,balance,54,19,35
Shenzform,ysondre,1133,druid,balance,31,14,17
Bägira,sylvanas,1132,druid,balance,18,12,6
Kizerx,garona,1131,druid,balance,60,33,27
Camika,antonidas,1131,druid,balance,72,31,41
Mangékyó,antonidas,1130,druid,balance,19,13,6
Lonedrood,blackrock,1130,druid,balance,24,12,12
Dramweida,eredar,1128,druid,balance,24,12,12
Eldorädo,ravencrest,1127,druid,balance,48,14,34
Котангис,eversong,1126,druid,balance,29,15,14
Rumjin,burning-blade,1125,druid,balance,24,12,12
Flagvan,ravencrest,1125,druid,balance,25,12,13
Shag,archimonde,1125,druid,balance,125,55,70
Fjry,draenor,1124,druid,balance,29,12,17
Pretender,arathi,1123,druid,balance,40,13,27
Athenã,blackmoore,1118,druid,balance,71,33,38
Forthejoe,stormscale,1118,druid,balance,35,12,23
Erbaiolo,pozzo-delleternità,1117,druid,balance,30,18,12
Cirwen,silvermoon,1115,druid,balance,18,12,6
Serafol,argent-dawn,1115,druid,balance,78,31,47
Treenough,drakthul,1114,druid,balance,23,12,11
Bláithín,burning-legion,1114,druid,balance,48,22,26
Dôômkin,stormscale,1114,druid,balance,102,41,61
Wîzzp,magtheridon,1113,druid,balance,26,13,13
Enolcyc,frostmane,1113,druid,balance,42,12,30
Gôdzîllâ,silvermoon,1112,druid,balance,22,12,10
Codéine,krasus,1112,druid,balance,36,13,23
Morlas,kazzak,1111,druid,balance,50,22,28
Kyth,forscherliga,1110,druid,balance,51,28,23
Gallorath,draenor,1110,druid,balance,28,12,16
Бритаякиска,gordunni,1109,druid,balance,18,12,6
Sorath,aggramar,1109,druid,balance,66,28,38
Plev,chamber-of-aspects,1108,druid,balance,26,13,13
Hightotem,hakkar,1104,druid,balance,29,16,13
Taskingoman,twisting-nether,1104,druid,balance,42,17,25
Elrox,dunemaul,1103,druid,balance,61,31,30
Rungohar,stormscale,1103,druid,balance,64,26,38
Vangars,shadowsong,1099,druid,balance,78,33,45
Kazekengan,draenor,1099,druid,balance,32,13,19
Tàak,hyjal,1099,druid,balance,38,15,23
Ðelnôs,destromath,1098,druid,balance,32,12,20
Exactt,blackrock,1098,druid,balance,55,20,35
Amalou,ravencrest,1095,druid,balance,127,64,63
Chirnaruk,ravencrest,1093,druid,balance,26,13,13
Fesenjon,blackhand,1093,druid,balance,32,14,18
Felischaus,twisting-nether,1092,druid,balance,17,12,5
Tjoepert,azjolnerub,1092,druid,balance,120,51,69
Ruberg,kazzak,1091,druid,balance,21,12,9
Ambracer,silvermoon,1090,druid,balance,53,25,28
Negríno,cthun,1089,druid,balance,127,68,59
Nakkikastike,magtheridon,1089,druid,balance,82,35,47
Бруан,gordunni,1088,druid,balance,47,23,24
Mâéviss,ysondre,1088,druid,balance,78,29,49
Yaendra,dun-modr,1086,druid,balance,87,48,39
Lunarveil,draenor,1086,druid,balance,25,13,12
Kxk,blackmoore,1080,druid,balance,35,18,17
Obois,archimonde,1076,druid,balance,23,12,11
Máilo,aegwynn,1076,druid,balance,172,76,96
Бсуза,soulflayer,1076,druid,balance,116,47,69
Schebäb,blackhand,1076,druid,balance,34,12,22
Lychorn,twisting-nether,1075,druid,balance,54,22,32
Idiomatic,stormreaver,1074,druid,balance,18,13,5
Ayanakamurà,archimonde,1074,druid,balance,26,12,14
Покекек,lich-king,1073,druid,balance,57,27,30
Jibirisong,zuljin,1068,druid,balance,44,18,26
Colibrix,ravencrest,1066,druid,balance,81,33,48
Вилдвестганс,howling-fjord,1063,druid,balance,24,13,11
Aliiass,drakthul,1063,druid,balance,36,19,17
Exiztenz,deathwing,1062,druid,balance,42,21,21
Вэдэшечка,howling-fjord,1062,druid,balance,55,25,30
Vigôuróuz,blackmoore,1060,druid,balance,27,14,13
Ellüna,ravencrest,1060,druid,balance,30,14,16
Sabermoon,argent-dawn,1057,druid,balance,458,218,240
Lazerftw,ravencrest,1056,druid,balance,12,11,1
Dyuuna,hyjal,1056,druid,balance,18,11,7
Stkk,sanguino,1055,druid,balance,12,11,1
Drmoe,blackmoore,1055,druid,balance,15,12,3
Maedic,outland,1055,druid,balance,18,11,7
Buckmysallz,archimonde,1055,druid,balance,18,11,7
Lunor,kazzak,1055,druid,balance,18,11,7
Positivity,stormscale,1055,druid,balance,18,11,7
Ccoco,blackrock,1055,druid,balance,18,11,7
Crittler,forscherliga,1055,druid,balance,18,11,7
Zenkay,naxxramas,1055,druid,balance,38,19,19
Jubbs,laughing-skull,1055,druid,balance,24,11,13
Nâganalf,hyjal,1055,druid,balance,24,11,13
Réhagen,archimonde,1055,druid,balance,24,11,13
Bababus,blackhand,1054,druid,balance,18,11,7
Zwareshag,ravencrest,1054,druid,balance,18,11,7
Jac,blackhand,1054,druid,balance,18,11,7
Yngboii,twisting-nether,1054,druid,balance,24,11,13
Малфуррион,soulflayer,1053,druid,balance,18,11,7
Lechaource,silvermoon,1053,druid,balance,18,11,7
Ghostdoggie,stormscale,1053,druid,balance,18,11,7
Нортикус,soulflayer,1053,druid,balance,24,11,13
Bignunu,silvermoon,1053,druid,balance,24,11,13
Shiftyshaft,tarren-mill,1053,druid,balance,24,11,13
Lunairos,archimonde,1053,druid,balance,135,58,77
Aolynk,twisting-nether,1052,druid,balance,18,11,7
Borkusdruid,antonidas,1052,druid,balance,22,12,10
Fofosdru,kazzak,1052,druid,balance,24,11,13
Flxtn,hyjal,1052,druid,balance,30,11,19
Lifecycle,nemesis,1051,druid,balance,24,11,13
Dèxò,blackmoore,1051,druid,balance,24,11,13
Bloomboom,aegwynn,1050,druid,balance,19,11,8
Hajukin,ravencrest,1050,druid,balance,24,11,13
Yaaji,archimonde,1050,druid,balance,24,11,13
Aimwaré,ravencrest,1050,druid,balance,24,11,13
Gøtten,tarren-mill,1050,druid,balance,24,11,13
Bestboomkin,dun-modr,1050,druid,balance,25,11,14
Wonderbear,blackrock,1049,druid,balance,18,11,7
Soguu,thrall,1049,druid,balance,18,11,7
Wrathofstar,azjolnerub,1048,druid,balance,18,11,7
Twandagreat,ravencrest,1048,druid,balance,18,11,7
Skyphi,silvermoon,1048,druid,balance,18,11,7
Nopsu,stormreaver,1047,druid,balance,30,11,19
Iløvechîcken,blackrock,1046,druid,balance,18,11,7
Hecone,los-errantes,1046,druid,balance,24,11,13
Dobitok,blackrock,1045,druid,balance,18,11,7
Shifturpants,defias-brotherhood,1045,druid,balance,18,11,7
Rorugo,sanguino,1044,druid,balance,18,11,7
Haarbál,tarren-mill,1044,druid,balance,18,11,7
Jirenthegrey,antonidas,1043,druid,balance,18,11,7
Darisom,alexstrasza,1039,druid,balance,284,148,136
Buckshee,doomhammer,1038,druid,balance,53,27,26
Grinnox,outland,1038,druid,balance,24,11,13
Bluebanana,bronzebeard,1036,druid,balance,94,40,54
Sabresheep,twisting-nether,1034,druid,balance,30,11,19
Amils,twisting-nether,1032,druid,balance,41,14,27
Atheros,outland,1031,druid,balance,24,11,13
Diepauline,aegwynn,1030,druid,balance,48,25,23
Elmunia,ravencrest,1030,druid,balance,65,31,34
Dagta,aggra-português,1028,druid,balance,18,11,7
Squirtt,ravencrest,1028,druid,balance,30,11,19
Vorag,dalaran,1027,druid,balance,101,41,60
Закарпаття,galakrond,1024,druid,balance,16,12,4
Вёкс,howling-fjord,1023,druid,balance,14,12,2
Hetalia,culte-de-la-rive-noire,1023,druid,balance,30,14,16
Hiroshimaa,boulderfist,1019,druid,balance,60,23,37
Fx,mazrigos,1018,druid,balance,17,11,6
Sároman,ravencrest,1016,druid,balance,30,11,19
Nocataeth,destromath,1015,druid,balance,27,14,13
Doonttry,outland,1014,druid,balance,23,11,12
Katharo,kult-der-verdammten,1014,druid,balance,60,22,38
Bullmarkets,kazzak,1013,druid,balance,24,12,12
Bearhugzz,outland,1011,druid,balance,430,215,215
Kakaiy,shadowsong,1009,druid,balance,214,110,104
Mássacré,aegwynn,1007,druid,balance,18,11,7
Aÿä,elune,1005,druid,balance,28,11,17
Higuys,the-maelstrom,1004,druid,balance,17,11,6
Delorithalun,blackhand,1004,druid,balance,27,17,10
Jobbostibi,ragnaros,1003,druid,balance,24,11,13
Erasil,exodar,1001,druid,balance,37,12,25
Kucsmagoomba,ragnaros,1000,druid,balance,214,104,110
Ртз,eversong,997,druid,balance,23,11,12
Shainá,dun-modr,992,druid,balance,36,13,23
Eyune,tarren-mill,991,druid,balance,56,23,33
Skvll,silvermoon,987,druid,balance,26,11,15
Drdauwg,nazjatar,985,druid,balance,69,27,42
Катафей,deathguard,981,druid,balance,60,33,27
Bulvai,medivh,979,druid,balance,14,11,3
Nicolasdacry,das-syndikat,978,druid,balance,30,18,12
Zendrand,sylvanas,978,druid,balance,73,28,45
Happysw,thrall,974,druid,balance,144,59,85
Mondino,blackrock,972,druid,balance,48,14,34
Lemónde,outland,970,druid,balance,76,30,46
Théodên,dalaran,969,druid,balance,218,106,112
Потерявшийся,howling-fjord,962,druid,balance,104,44,60
Vizir,stormscale,960,druid,balance,12,10,2
Brbrøyk,tarren-mill,960,druid,balance,12,10,2
Ïmåkêïtråïñ,ravencrest,960,druid,balance,12,10,2
Ecolo,blackrock,960,druid,balance,14,10,4
Locite,blackrock,960,druid,balance,18,10,8
Djfukface,ravencrest,960,druid,balance,18,10,8
Applecake,defias-brotherhood,960,druid,balance,18,10,8
Eroxx,blackrock,960,druid,balance,24,10,14
Feralisser,ravencrest,959,druid,balance,12,10,2
Focusboomy,archimonde,959,druid,balance,18,10,8
Sün,kazzak,959,druid,balance,18,10,8
Simdruid,stormscale,959,druid,balance,18,10,8
Kissaey,emeriss,959,druid,balance,18,10,8
Tease,blackrock,959,druid,balance,18,10,8
Slâkkxz,kazzak,959,druid,balance,18,10,8
Häggrä,dalaran,959,druid,balance,18,10,8
Eftermalm,silvermoon,959,druid,balance,18,10,8
Mips,silvermoon,959,druid,balance,18,10,8
Littlecok,blackmoore,959,druid,balance,18,10,8
Zarune,sanguino,959,druid,balance,18,10,8
Ruhex,silvermoon,959,druid,balance,18,10,8
Qyoon,argent-dawn,959,druid,balance,18,10,8
Димадубощит,blackscar,959,druid,balance,24,10,14
Fistíebear,sylvanas,959,druid,balance,24,10,14
Cholic,twisting-nether,959,druid,balance,53,14,39
Thepuma,dun-modr,958,druid,balance,12,10,2
Nelíno,twisting-nether,958,druid,balance,18,10,8
Furiondox,silvermoon,958,druid,balance,18,10,8
Píssoff,stormscale,958,druid,balance,18,10,8
Pèps,dalaran,958,druid,balance,18,10,8
Sùmmèrz,ravencrest,958,druid,balance,18,10,8
Éatshiftndie,tarren-mill,958,druid,balance,18,10,8
Clone,aegwynn,958,druid,balance,18,10,8
Élán,sylvanas,958,druid,balance,24,10,14
Hoodahij,argent-dawn,958,druid,balance,24,10,14
Ibroninad,ragnaros,958,druid,balance,24,10,14
Bildukas,ravencrest,958,druid,balance,28,11,17
Owlaf,magtheridon,957,druid,balance,18,10,8
Amrul,hyjal,957,druid,balance,18,10,8
Damilibi,eredar,957,druid,balance,18,10,8
Gbq,ravencrest,957,druid,balance,18,10,8
Kahar,eredar,957,druid,balance,18,10,8
Тираэлюшка,grom,956,druid,balance,18,10,8
Jokodo,silvermoon,956,druid,balance,18,10,8
Toritoso,sanguino,956,druid,balance,24,10,14
Loubna,antonidas,956,druid,balance,24,10,14
Lîndex,sylvanas,956,druid,balance,24,10,14
Prytek,turalyon,955,druid,balance,18,10,8
Sajlol,doomhammer,955,druid,balance,18,10,8
Moordock,uldum,955,druid,balance,24,10,14
Thornat,chamber-of-aspects,955,druid,balance,24,10,14
Assterix,sylvanas,954,druid,balance,15,10,5
Moomat,hyjal,954,druid,balance,18,10,8
Lazerkito,aegwynn,953,druid,balance,12,10,2
Mafakaclones,archimonde,953,druid,balance,135,73,62
Menko,trollbane,952,druid,balance,12,10,2
Metamorfurio,arthas,952,druid,balance,76,36,40
Justycare,ragnaros,952,druid,balance,24,10,14
Yeahbuddeh,draenor,951,druid,balance,28,11,17
Inspira,teldrassil,949,druid,balance,18,10,8
Helguard,silvermoon,949,druid,balance,24,10,14
Calistane,silvermoon,949,druid,balance,83,32,51
Tombenuit,tarren-mill,948,druid,balance,24,11,13
Dxerm,colinas-pardas,948,druid,balance,34,10,24
Kûmo,blackmoore,946,druid,balance,18,10,8
Yepnesse,khaz-modan,946,druid,balance,18,10,8
Phanos,twisting-nether,945,druid,balance,24,10,14
Astralarius,argent-dawn,945,druid,balance,124,43,81
Cöyote,hyjal,944,druid,balance,90,47,43
Drude,archimonde,943,druid,balance,24,10,14
Ragingmilker,tarren-mill,941,druid,balance,17,12,5
Chlambak,archimonde,938,druid,balance,24,10,14
Resthunor,draenor,935,druid,balance,18,10,8
Neincat,sylvanas,935,druid,balance,23,10,13
Медведяра,howling-fjord,931,druid,balance,179,84,95
Rawberto,silvermoon,925,druid,balance,17,10,7
Sumbahe,blackrock,925,druid,balance,24,11,13
Puraza,kazzak,925,druid,balance,23,10,13
Papalegba,kilrogg,924,druid,balance,19,11,8
Lodne,defias-brotherhood,924,druid,balance,78,37,41
Bidodici,nemesis,920,druid,balance,48,24,24
Saxondale,aszune,918,druid,balance,30,14,16
Fakers,the-maelstrom,917,druid,balance,48,25,23
Суггуторр,howling-fjord,917,druid,balance,105,52,53
Juicý,eredar,911,druid,balance,17,10,7
Tarâkings,outland,911,druid,balance,30,13,17
Nogbraså,frostmane,908,druid,balance,17,10,7
Krakus,twisting-nether,906,druid,balance,18,10,8
Древнина,gordunni,901,druid,balance,21,10,11
Dudukush,eredar,901,druid,balance,83,35,48
Meliissa,hyjal,900,druid,balance,20,11,9
Flume,chromaggus,896,druid,balance,24,10,14
Durtidikdave,kazzak,895,druid,balance,23,10,13
Barrehealer,sylvanas,893,druid,balance,20,10,10
Anerol,arthas,893,druid,balance,77,34,43
Rønièl,tarren-mill,892,druid,balance,17,10,7
Keltaris,dun-modr,888,druid,balance,30,15,15
Ribuu,dun-morogh,886,druid,balance,24,11,13
Arms,burning-legion,880,druid,balance,13,10,3
Aloraysoda,doomhammer,879,druid,balance,83,22,61
Smexim,dalaran,876,druid,balance,49,26,23
Rockymarci,dalaran,875,druid,balance,18,10,8
Centurios,burning-legion,869,druid,balance,78,20,58
Aggibääm,blackhand,868,druid,balance,24,12,12
Momaa,neptulon,867,druid,balance,54,19,35
Ahk,outland,864,druid,balance,12,9,3
Vezir,stormscale,864,druid,balance,12,9,3
Qwopeiqpwoid,kazzak,864,druid,balance,12,9,3
Shandala,ragnaros,864,druid,balance,12,9,3
Flopparider,ravencrest,864,druid,balance,12,9,3
Marynlord,dalaran,864,druid,balance,12,9,3
Ojiw,ragnaros,864,druid,balance,12,9,3
Mâlcøm,archimonde,864,druid,balance,12,9,3
Clawlessqtx,outland,864,druid,balance,12,9,3
Daneaa,grim-batol,864,druid,balance,12,9,3
Nazferal,antonidas,864,druid,balance,12,9,3
Chir,blackrock,864,druid,balance,12,9,3
Corkiy,tarren-mill,864,druid,balance,12,9,3
Xinthie,antonidas,864,druid,balance,12,9,3
Lxstcentury,stormscale,864,druid,balance,18,9,9
Éldudu,ragnaros,864,druid,balance,18,9,9
Plinplinplon,kazzak,864,druid,balance,18,9,9
Окимоно,ashenvale,864,druid,balance,18,9,9
Yseraheal,drakthul,864,druid,balance,18,9,9
Nstt,dun-modr,864,druid,balance,18,9,9
Cioban,ravencrest,864,druid,balance,24,9,15
Pezuñera,sanguino,863,druid,balance,12,9,3
Borticow,sanguino,863,druid,balance,12,9,3
Prayx,dalaran,863,druid,balance,12,9,3
Siimpa,tarren-mill,863,druid,balance,12,9,3
Lakersinfive,argent-dawn,863,druid,balance,12,9,3
Sweedrood,hyjal,863,druid,balance,16,10,6
Buckié,twisting-nether,863,druid,balance,18,9,9
Forthis,frostmane,863,druid,balance,18,9,9
Kajidru,frostmane,863,druid,balance,18,9,9
Jæmmy,blackhand,863,druid,balance,18,9,9
Jìkkz,aegwynn,863,druid,balance,18,9,9
Sackzecke,eredar,863,druid,balance,18,9,9
Loasamdi,tarren-mill,863,druid,balance,18,9,9
Deeizm,ravencrest,863,druid,balance,18,9,9
Enzymex,burning-blade,863,druid,balance,18,9,9
Jesreyna,silvermoon,863,druid,balance,18,9,9
Shíróx,aegwynn,863,druid,balance,18,9,9
Tchoubouléru,throkferoth,863,druid,balance,77,27,50
Ezc,ravencrest,862,druid,balance,12,9,3
Metaboss,ravencrest,862,druid,balance,18,9,9
Qocotte,archimonde,862,druid,balance,18,9,9
Zethane,ragnaros,862,druid,balance,18,9,9
Ábomínatíon,draenor,862,druid,balance,18,9,9
Jabbah,defias-brotherhood,862,druid,balance,18,9,9
Blietmachine,ravencrest,862,druid,balance,18,9,9
Willhealer,outland,862,druid,balance,21,10,11
Astería,kazzak,862,druid,balance,24,9,15
Ferdiboo,draenor,861,druid,balance,18,9,9
Quza,lightbringer,861,druid,balance,18,9,9
Azína,kazzak,860,druid,balance,24,9,15
Zephris,grim-batol,860,druid,balance,24,9,15
Whoaskedyou,twisting-nether,859,druid,balance,18,9,9
Hotmenow,antonidas,859,druid,balance,18,9,9
Kânjin,stormscale,859,druid,balance,24,9,15
Corias,blackmoore,859,druid,balance,36,9,27
Summertearz,thrall,858,druid,balance,18,9,9
Wildmushroom,drakthul,858,druid,balance,18,9,9
Мяокусь,gordunni,857,druid,balance,12,9,3
Дайдорогу,blackscar,857,druid,balance,18,9,9
Rakhajan,twisting-nether,857,druid,balance,18,9,9
Sãmba,pozzo-delleternità,857,druid,balance,28,10,18
Zuldëk,sanguino,856,druid,balance,18,9,9
Кроулинг,gordunni,856,druid,balance,18,9,9
Cheeselake,blackmoore,856,druid,balance,24,9,15
Аматэррасу,blackscar,856,druid,balance,24,9,15
Ghostfurr,silvermoon,856,druid,balance,30,9,21
Rewus,burning-legion,856,druid,balance,30,9,21
Корбан,howling-fjord,856,druid,balance,36,9,27
Ghoonz,silvermoon,855,druid,balance,24,9,15
Moonkek,hyjal,854,druid,balance,18,9,9
Namelèés,blackhand,854,druid,balance,24,9,15
Drubro,ragnaros,851,druid,balance,30,9,21
Hogey,kazzak,845,druid,balance,17,9,8
Buffalus,draenor,845,druid,balance,60,28,32
Spielmann,ravencrest,839,druid,balance,23,9,14
Bloodtank,die-ewige-wacht,836,druid,balance,45,14,31
Сомеваск,deathweaver,830,druid,balance,23,9,14
Eikthyrson,alleria,829,druid,balance,16,10,6
Unbeatâbull,kazzak,828,druid,balance,22,9,13
Outofmyswamp,kazzak,815,druid,balance,14,10,4
Ishaqu,bladefist,815,druid,balance,23,9,14
Nuggetspøwa,dalaran,814,druid,balance,17,9,8
Donvulcone,stormscale,814,druid,balance,17,9,8
Burren,auchindoun,810,druid,balance,25,9,16
Hilliax,sanguino,807,druid,balance,31,10,21
Nøboorst,ravencrest,805,druid,balance,21,11,10
Máximus,blades-edge,799,druid,balance,124,47,77
Solgarna,saurfang,798,druid,balance,28,9,19
Druidaldo,blackhand,794,druid,balance,42,18,24
Fréki,ravenholdt,791,druid,balance,20,9,11
Саншаса,booty-bay,780,druid,balance,25,9,16
Maxiaz,tarren-mill,768,druid,balance,12,8,4
Ðíør,ravencrest,768,druid,balance,12,8,4
Everdreamx,arathor,768,druid,balance,12,8,4
Jimkungtwo,hyjal,768,druid,balance,12,8,4
Mirlawl,malganis,768,druid,balance,12,8,4
Луноэльф,gordunni,768,druid,balance,12,8,4
Hecatos,hyjal,768,druid,balance,12,8,4
Telidari,argent-dawn,768,druid,balance,12,8,4
Treeswinger,twisting-nether,768,druid,balance,12,8,4
Earl,thrall,768,druid,balance,12,8,4
Alok,blackmoore,768,druid,balance,12,8,4
Dontlift,stormscale,768,druid,balance,12,8,4
Jometatile,hyjal,768,druid,balance,12,8,4
Vìvi,ysondre,768,druid,balance,12,8,4
Tritit,marécage-de-zangar,768,druid,balance,12,8,4
Клыкояр,goldrinn,768,druid,balance,12,8,4
Súçúkbøømíe,aegwynn,768,druid,balance,12,8,4
Meillaeth,sylvanas,768,druid,balance,12,8,4
Luupy,draenor,768,druid,balance,12,8,4
Emochicken,silvermoon,768,druid,balance,15,9,6
Harrydòtter,eredar,768,druid,balance,18,8,10
Crossfaction,blackrock,768,druid,balance,18,8,10
Klêe,blackmoore,768,druid,balance,18,8,10
Póllen,magtheridon,768,druid,balance,18,8,10
Filiduttkatt,ravencrest,767,druid,balance,12,8,4
Sebikboomie,ravencrest,767,druid,balance,12,8,4
Rupali,darksorrow,767,druid,balance,12,8,4
Seasexsune,antonidas,767,druid,balance,12,8,4
Napukka,silvermoon,767,druid,balance,12,8,4
Xtremeterror,blackmoore,767,druid,balance,12,8,4
Буммбом,soulflayer,767,druid,balance,18,8,10
Isotopîa,antonidas,767,druid,balance,18,8,10
Ilovehannah,laughing-skull,767,druid,balance,18,8,10
Rêdx,archimonde,767,druid,balance,18,8,10
Hugepepega,ravencrest,767,druid,balance,18,8,10
Bigsmoké,die-aldor,767,druid,balance,18,8,10
Taeldryn,defias-brotherhood,767,druid,balance,18,8,10
Arydan,quelthalas,767,druid,balance,18,8,10
Nervious,la-croisade-écarlate,767,druid,balance,18,8,10
Bellatrx,darksorrow,767,druid,balance,18,8,10
Хеельхеем,gordunni,767,druid,balance,18,8,10
Milkmefast,magtheridon,767,druid,balance,18,8,10
Loswochos,blackmoore,767,druid,balance,18,8,10
Xkora,cthun,767,druid,balance,18,8,10
Nyooxix,blackmoore,767,druid,balance,18,8,10
Sùmmêrz,outland,767,druid,balance,24,8,16
Humanoidpt,aggra-português,766,druid,balance,12,8,4
Irithel,ravencrest,766,druid,balance,12,8,4
Мяф,soulflayer,766,druid,balance,12,8,4
Benzinoid,silvermoon,766,druid,balance,12,8,4
Âke,stormscale,766,druid,balance,12,8,4
Fuzzykitten,ravencrest,766,druid,balance,18,8,10
Kheluna,the-maelstrom,766,druid,balance,18,8,10
Poonkin,ravencrest,766,druid,balance,24,8,16
Darthiud,outland,765,druid,balance,12,8,4
Machie,argent-dawn,765,druid,balance,18,8,10
Acwi,dun-morogh,765,druid,balance,18,8,10
Droodu,dun-modr,765,druid,balance,30,8,22
Mongobongo,onyxia,764,druid,balance,12,8,4
Zinnform,ragnaros,764,druid,balance,18,8,10
Fiberpäls,magtheridon,764,druid,balance,18,8,10
Dwaokut,ravencrest,763,druid,balance,12,8,4
Knindza,tarren-mill,763,druid,balance,18,8,10
Silverriver,ragnaros,763,druid,balance,18,8,10
Anchoring,argent-dawn,763,druid,balance,22,9,13
Mattdrood,kazzak,763,druid,balance,30,8,22
Tartáros,blackrock,762,druid,balance,12,8,4
Sinmanos,eredar,762,druid,balance,18,8,10
Moonsama,twisting-nether,762,druid,balance,24,8,16
Mauzicek,drakthul,760,druid,balance,24,8,16
Iproxy,dalaran,759,druid,balance,12,8,4
Sherse,ravencrest,759,druid,balance,12,8,4
Celebras,chogall,756,druid,balance,12,8,4
Liegremmah,blackmoore,755,druid,balance,24,8,16
Pàws,archimonde,735,druid,balance,16,8,8
Wuki,conseil-des-ombres,735,druid,balance,18,8,10
Pegatron,outland,732,druid,balance,73,20,53
Vaea,hyjal,731,druid,balance,26,9,17
Kutjing,dun-modr,719,druid,balance,11,8,3
Maw,hellfire,717,druid,balance,11,8,3
Tsikarde,ravencrest,717,druid,balance,23,8,15
Edorush,nemesis,715,druid,balance,21,9,12
Humizon,silvermoon,714,druid,balance,21,9,12
Хуфра,greymane,714,druid,balance,23,8,15
Elpresidénté,blackmoore,713,druid,balance,12,9,3
Lockied,eredar,713,druid,balance,22,9,13
Lunably,silvermoon,705,druid,balance,18,9,9
Mynilia,blackhand,704,druid,balance,16,8,8
Kannzi,draenor,703,druid,balance,16,8,8
Fôxy,silvermoon,703,druid,balance,16,8,8
Ktn,sanguino,703,druid,balance,17,8,9
Delfin,aerie-peak,702,druid,balance,27,9,18
Bigbadcalf,burning-legion,696,druid,balance,20,8,12
Bönüs,cthun,690,druid,balance,15,8,7
Витясхватки,gordunni,686,druid,balance,17,9,8
Denleende,ravencrest,672,druid,balance,12,7,5
Delarion,nemesis,672,druid,balance,12,7,5
Spatchy,silvermoon,672,druid,balance,12,7,5
Hajlol,sylvanas,672,druid,balance,12,7,5
Kosadoodoo,sylvanas,672,druid,balance,12,7,5
Carébèar,stormscale,672,druid,balance,12,7,5
Ra,stormscale,672,druid,balance,12,7,5
Mommymìlkers,archimonde,672,druid,balance,12,7,5
Armënovitch,ravencrest,672,druid,balance,12,7,5
Ryzën,stormscale,672,druid,balance,12,7,5
Heartleon,silvermoon,672,druid,balance,12,7,5
Трусырвущая,gordunni,672,druid,balance,12,7,5
Tapex,ravencrest,672,druid,balance,12,7,5
Smølboi,ravencrest,672,druid,balance,12,7,5
Emeskay,ravencrest,672,druid,balance,12,7,5
Actron,blackrock,672,druid,balance,12,7,5
Noobr,ravencrest,672,druid,balance,12,7,5
Surlax,defias-brotherhood,672,druid,balance,12,7,5
Røsétte,archimonde,672,druid,balance,12,7,5
Epsona,dun-modr,672,druid,balance,12,7,5
Toy,ragnaros,672,druid,balance,12,7,5
Elakpou,twisting-nether,672,druid,balance,12,7,5
Grunka,silvermoon,672,druid,balance,12,7,5
Lzo,silvermoon,672,druid,balance,12,7,5
Nyzeix,eredar,672,druid,balance,12,7,5
Glúingél,tarren-mill,672,druid,balance,12,7,5
Luchano,dun-modr,672,druid,balance,12,7,5
Rootbeamftw,ravencrest,672,druid,balance,12,7,5
Тэддибиар,gordunni,672,druid,balance,12,7,5
Noggelicious,ragnaros,672,druid,balance,12,7,5
Överskåp,tarren-mill,672,druid,balance,12,7,5
Kimberon,tarren-mill,672,druid,balance,12,7,5
Akínos,tarren-mill,672,druid,balance,12,7,5
Тохи,howling-fjord,672,druid,balance,12,7,5
Pansaa,stormscale,672,druid,balance,15,8,7
Lèthal,arakarahm,672,druid,balance,18,7,11
Væx,rexxar,672,druid,balance,18,7,11
Lifty,dun-modr,672,druid,balance,18,7,11
Emidrem,ravencrest,672,druid,balance,18,7,11
Lilim,culte-de-la-rive-noire,672,druid,balance,18,7,11
Ravenfang,dun-modr,672,druid,balance,18,7,11
Bóómi,outland,672,druid,balance,18,7,11
Jrir,argent-dawn,672,druid,balance,18,7,11
Zolduran,archimonde,672,druid,balance,18,7,11
Miyá,sylvanas,672,druid,balance,24,7,17
Maruuk,argent-dawn,671,druid,balance,12,7,5
Rikayn,tarren-mill,671,druid,balance,12,7,5
Зонкс,gordunni,671,druid,balance,12,7,5
Greatpotato,blackhand,671,druid,balance,12,7,5
Halfback,blackhand,671,druid,balance,12,7,5
Morrisona,twisting-nether,671,druid,balance,12,7,5
Najiq,ravencrest,671,druid,balance,12,7,5
Myxo,aggra-português,671,druid,balance,12,7,5
Asura,nozdormu,671,druid,balance,12,7,5
Elíonora,grim-batol,671,druid,balance,12,7,5
Найадра,gordunni,671,druid,balance,12,7,5
Tigrius,defias-brotherhood,671,druid,balance,12,7,5
Freve,sylvanas,671,druid,balance,12,7,5
Alexuwu,draenor,671,druid,balance,12,7,5
Mallahide,silvermoon,671,druid,balance,12,7,5
Sollek,sylvanas,671,druid,balance,12,7,5
Wolflundgren,ravencrest,671,druid,balance,18,7,11
Лидир,blackscar,671,druid,balance,18,7,11
Димитрий,ashenvale,671,druid,balance,18,7,11
Mvpx,outland,671,druid,balance,18,7,11
Forgo,drakthul,671,druid,balance,18,7,11
Thunderzeus,mazrigos,671,druid,balance,18,7,11
Psychócat,silvermoon,671,druid,balance,18,7,11
Kivu,blackrock,671,druid,balance,18,7,11
Legevakten,grim-batol,671,druid,balance,18,7,11
Phala,outland,671,druid,balance,18,7,11
Drudonja,silvermoon,671,druid,balance,18,7,11
Quin,frostwolf,671,druid,balance,18,7,11
Telära,argent-dawn,671,druid,balance,18,7,11
Tidevar,wildhammer,671,druid,balance,18,7,11
Essaraah,dalaran,671,druid,balance,18,7,11
Fairyx,malfurion,671,druid,balance,18,7,11
Picatso,blackrock,671,druid,balance,24,7,17
Psyquallia,hellscream,671,druid,balance,24,7,17
Tschakadudu,kargath,671,druid,balance,24,7,17
Barniine,sylvanas,670,druid,balance,10,8,2
Ìronsidé,ragnaros,670,druid,balance,12,7,5
Bíerling,antonidas,670,druid,balance,18,7,11
Scranton,silvermoon,670,druid,balance,22,8,14
Klatu,doomhammer,670,druid,balance,24,7,17
Garudas,eldrethalas,669,druid,balance,24,7,17
Thyanya,blackmoore,668,druid,balance,18,7,11
Evenstar,cthun,668,druid,balance,53,14,39
Çúç,ravencrest,666,druid,balance,18,7,11
Akîra,twisting-nether,666,druid,balance,21,8,13
Thrynitie,les-sentinelles,663,druid,balance,12,7,5
Nightshape,kragjin,661,druid,balance,18,7,11
Gróòt,kiljaeden,661,druid,balance,18,7,11
Qra,area-52,660,druid,balance,12,7,5
Kawaíï,frostwolf,659,druid,balance,26,10,16
Ketash,ragnaros,657,druid,balance,12,7,5
Ciwone,blackrock,654,druid,balance,23,7,16
Kantai,dalaran,639,druid,balance,11,7,4
Yawawe,blackmoore,638,druid,balance,17,7,10
Asterya,dun-modr,637,druid,balance,14,8,6
Hecaloth,drakthul,634,druid,balance,14,8,6
Matmoo,hyjal,623,druid,balance,11,7,4
Øwlïchæt,archimonde,623,druid,balance,15,7,8
Ipossible,kazzak,623,druid,balance,15,7,8
Maartjé,thunderhorn,623,druid,balance,16,7,9
Nille,tarren-mill,617,druid,balance,14,8,6
Blazek,sylvanas,617,druid,balance,14,8,6
Kidawi,frostwolf,617,druid,balance,16,8,8
Kamatea,eredar,607,druid,balance,11,7,4
Avalòn,tarren-mill,607,druid,balance,14,7,7
Merisu,ravencrest,607,druid,balance,14,7,7
Speedlebee,malganis,607,druid,balance,16,7,9
Extäzzi,archimonde,606,druid,balance,17,8,9
Bubidiblumdr,twisting-nether,605,druid,balance,16,7,9
Músclébéach,silvermoon,605,druid,balance,22,7,15
Собачел,grom,591,druid,balance,13,7,6
Rtfz,ravencrest,591,druid,balance,13,7,6
Chúnnk,kilrogg,584,druid,balance,19,8,11
Xirxy,silvermoon,576,druid,balance,6,6,0
Flækket,tarren-mill,576,druid,balance,6,6,0
Starsurge,festung-der-stürme,576,druid,balance,6,6,0
Lðuv,archimonde,576,druid,balance,6,6,0
Worali,burning-legion,576,druid,balance,6,6,0
Epikmuhh,kazzak,576,druid,balance,6,6,0
Fattydomdom,ahnqiraj,576,druid,balance,6,6,0
Kroghelf,tarren-mill,576,druid,balance,6,6,0
Náiledx,stormscale,576,druid,balance,6,6,0
Ухухуня,gordunni,576,druid,balance,6,6,0
Náye,kazzak,576,druid,balance,6,6,0
Ghøstavdruid,ravencrest,576,druid,balance,6,6,0
Kindadumb,stormscale,576,druid,balance,6,6,0
Skillfall,ravencrest,576,druid,balance,6,6,0
Zamans,silvermoon,576,druid,balance,6,6,0
Qpoof,sylvanas,576,druid,balance,6,6,0
Psychopath,sylvanas,576,druid,balance,6,6,0
Infêrno,twisting-nether,576,druid,balance,6,6,0
Têll,draenor,576,druid,balance,6,6,0
Shmurda,archimonde,576,druid,balance,6,6,0
Jory,archimonde,576,druid,balance,10,7,3
Styxdr,blackhand,576,druid,balance,12,6,6
Pataleaqtp,sanguino,576,druid,balance,12,6,6
Ына,gordunni,576,druid,balance,12,6,6
Fèéli,twisting-nether,576,druid,balance,12,6,6
Wrx,sylvanas,576,druid,balance,12,6,6
Ghøstform,blackrock,576,druid,balance,12,6,6
Daluria,malganis,576,druid,balance,12,6,6
Bane,dun-modr,576,druid,balance,12,6,6
Seraxi,der-mithrilorden,576,druid,balance,12,6,6
Nancey,auchindoun,576,druid,balance,12,6,6
Yuln,twisting-nether,576,druid,balance,12,6,6
Maníx,tarren-mill,576,druid,balance,12,6,6
Quasarx,ravencrest,576,druid,balance,12,6,6
Pælter,draenor,576,druid,balance,12,6,6
Мунпраид,gordunni,576,druid,balance,12,6,6
Nimalâ,antonidas,576,druid,balance,12,6,6
Islandbôy,blackrock,576,druid,balance,12,6,6
Yenaiz,stormreaver,576,druid,balance,12,6,6
Слайкс,soulflayer,576,druid,balance,12,6,6
Mentaldead,tarren-mill,576,druid,balance,12,6,6
Hornyhots,sylvanas,576,druid,balance,12,6,6
Weedgras,eredar,576,druid,balance,12,6,6
Bleedslolz,colinas-pardas,576,druid,balance,12,6,6
Shadowmeldgg,stormreaver,576,druid,balance,12,6,6
Совевген,soulflayer,576,druid,balance,12,6,6
Shoca,die-ewige-wacht,576,druid,balance,12,6,6
Aewendil,twilights-hammer,576,druid,balance,12,6,6
Juri,blackrock,576,druid,balance,12,6,6
Vedee,tarren-mill,576,druid,balance,12,6,6
Teryx,blackmoore,576,druid,balance,12,6,6
Зулкхаку,soulflayer,576,druid,balance,12,6,6
Quinten,ulduar,576,druid,balance,12,6,6
Shamelêss,stormscale,576,druid,balance,12,6,6
Naturexbot,silvermoon,576,druid,balance,12,6,6
Inbml,silvermoon,576,druid,balance,12,6,6
Thefudge,silvermoon,576,druid,balance,12,6,6
Elyrias,silvermoon,576,druid,balance,12,6,6
Kamenká,aegwynn,576,druid,balance,12,6,6
Knozylg,kazzak,576,druid,balance,12,6,6
Ashamane,outland,576,druid,balance,12,6,6
Baldhir,nemesis,576,druid,balance,12,6,6
Drboomkin,frostmane,576,druid,balance,12,6,6
Lokkrip,draenor,576,druid,balance,18,6,12
Robsondruid,twisting-nether,576,druid,balance,18,6,12
Smedoge,outland,576,druid,balance,18,6,12
Disney,ragnaros,576,druid,balance,18,6,12
Kotkacy,silvermoon,576,druid,balance,18,6,12
Druul,frostwolf,576,druid,balance,18,6,12
Murmétoile,chants-éternels,576,druid,balance,18,6,12
Axrae,ravencrest,576,druid,balance,18,6,12
Mugwa,blackmoore,575,druid,balance,6,6,0
Лицеторг,howling-fjord,575,druid,balance,12,6,6
Dreäms,ravencrest,575,druid,balance,12,6,6
Bigmatty,defias-brotherhood,575,druid,balance,12,6,6
Shirokaze,argent-dawn,575,druid,balance,12,6,6
Nonamà,nemesis,575,druid,balance,12,6,6
Xlife,silvermoon,575,druid,balance,12,6,6
Syx,conseil-des-ombres,575,druid,balance,12,6,6
Zàykz,dragonmaw,575,druid,balance,12,6,6
Eshlana,twisting-nether,575,druid,balance,12,6,6
Praythysun,khaz-modan,575,druid,balance,12,6,6
Qdrood,quelthalas,575,druid,balance,12,6,6
Dinamitko,silvermoon,575,druid,balance,12,6,6
Gruvkatt,stormscale,575,druid,balance,12,6,6
Graffyrre,eonar,575,druid,balance,13,6,7
Barkskin,grim-batol,575,druid,balance,15,6,9
Oxxy,arathor,575,druid,balance,18,6,12
Feraflux,dragonblight,575,druid,balance,18,6,12
Bunnyxo,outland,575,druid,balance,18,6,12
Дарзамат,blackscar,575,druid,balance,18,6,12
Cosue,malganis,575,druid,balance,18,6,12
Robinchwän,archimonde,575,druid,balance,18,6,12
Stjärna,kult-der-verdammten,575,druid,balance,18,6,12
Aimïn,sanguino,575,druid,balance,18,6,12
Shífthappenz,grim-batol,575,druid,balance,24,6,18
Ancón,silvermoon,575,druid,balance,24,6,18
Wardruíd,outland,575,druid,balance,24,6,18
Penywiser,sylvanas,575,druid,balance,24,6,18
Lúthiëñ,silvermoon,575,druid,balance,24,6,18
Nikitos,blackrock,575,druid,balance,26,6,20
Raciness,grim-batol,574,druid,balance,12,6,6
Тиликум,goldrinn,574,druid,balance,12,6,6
Apodruid,tarren-mill,574,druid,balance,12,6,6
Tyreek,eredar,574,druid,balance,16,7,9
Satish,blackmoore,574,druid,balance,24,6,18
Жекакотик,eversong,574,druid,balance,24,6,18
Agrodudu,draenor,573,druid,balance,18,6,12
Starfalls,turalyon,570,druid,balance,12,6,6
Harryharrt,veknilash,570,druid,balance,18,6,12
Xkenz,archimonde,569,druid,balance,30,8,22
Rédbullz,silvermoon,569,druid,balance,24,6,18
Vendeqt,aegwynn,543,druid,balance,11,6,5
Duwaz,blackmoore,543,druid,balance,14,7,7
Ancientix,burning-legion,543,druid,balance,17,6,11
Loceeva,kazzak,540,druid,balance,22,6,16
Saílormoon,nazjatar,528,druid,balance,9,6,3
Starhopper,ravencrest,528,druid,balance,11,7,4
Blamer,thrall,527,druid,balance,17,6,11
Zyell,silvermoon,526,druid,balance,17,6,11
Shreddít,tarren-mill,522,druid,balance,27,7,20
Felfran,ravencrest,521,druid,balance,18,7,11
Vullija,sylvanas,521,druid,balance,27,7,20
Halyconwings,outland,511,druid,balance,8,6,2
Kissa,blackrock,511,druid,balance,17,6,11
Ultimoos,aggra-português,510,druid,balance,14,6,8
Voodoomkinn,frostwhisper,480,druid,balance,6,5,1
Tellurr,draenor,480,druid,balance,6,5,1
Destrøz,draenor,480,druid,balance,6,5,1
Surfingbirdx,ragnaros,480,druid,balance,6,5,1
Snupyjunior,silvermoon,480,druid,balance,6,5,1
Bk,chamber-of-aspects,480,druid,balance,6,5,1
Svartvit,sylvanas,480,druid,balance,6,5,1
Imhiswife,ravencrest,480,druid,balance,6,5,1
Kobbyx,outland,480,druid,balance,6,5,1
Lastbest,draenor,480,druid,balance,6,5,1
Backroomcast,ravencrest,480,druid,balance,6,5,1
Cowieowie,draenor,480,druid,balance,6,5,1
Barsikfjwm,ravencrest,480,druid,balance,6,5,1
Likh,das-konsortium,480,druid,balance,6,5,1
Snupy,outland,480,druid,balance,6,5,1
Aurdudu,draenor,480,druid,balance,6,5,1
Хлайси,gordunni,480,druid,balance,6,5,1
Skínchanger,draenor,480,druid,balance,6,5,1
Tångfløde,emerald-dream,480,druid,balance,6,5,1
Mutaattori,sylvanas,480,druid,balance,6,5,1
Sàyo,blackmoore,480,druid,balance,6,5,1
Tåylor,laughing-skull,480,druid,balance,6,5,1
Murdok,suramar,480,druid,balance,6,5,1
Deepgreen,malganis,480,druid,balance,6,5,1
Nivod,aggramar,480,druid,balance,6,5,1
Pinkpanda,arthas,480,druid,balance,6,5,1
Torrixs,blackhand,480,druid,balance,6,5,1
Whaazzform,tarren-mill,480,druid,balance,6,5,1
Haxly,ravencrest,480,druid,balance,6,5,1
Yalø,blackrock,480,druid,balance,6,5,1
Напроломчег,soulflayer,480,druid,balance,6,5,1
Änimâls,ysondre,480,druid,balance,6,5,1
Roral,silvermoon,480,druid,balance,6,5,1
Staffios,argent-dawn,480,druid,balance,6,5,1
Cháep,kargath,480,druid,balance,6,5,1
Smøkyyd,eredar,480,druid,balance,6,5,1
Xhifty,ravencrest,480,druid,balance,6,5,1
Catpatroll,burning-blade,480,druid,balance,6,5,1
Boomytunes,silvermoon,480,druid,balance,6,5,1
Ohmyboom,twisting-nether,480,druid,balance,6,5,1
Pevezengin,outland,480,druid,balance,6,5,1
Jincksdru,anachronos,480,druid,balance,6,5,1
Daisyx,eredar,480,druid,balance,9,6,3
Öøöøöøöøöøöø,anachronos,480,druid,balance,9,6,3
Ischumekcid,anubarak,480,druid,balance,9,6,3
Mîraculix,dun-morogh,480,druid,balance,12,5,7
Tomäkh,ysondre,480,druid,balance,12,5,7
Лолэтохег,soulflayer,480,druid,balance,12,5,7
Зандэр,blackscar,480,druid,balance,12,5,7
Hardbasior,burning-legion,480,druid,balance,12,5,7
Hairydøtter,aegwynn,480,druid,balance,12,5,7
Kalypsoo,dun-modr,480,druid,balance,12,5,7
Heffko,thrall,480,druid,balance,12,5,7
Doup,alakir,480,druid,balance,12,5,7
Angrykejton,silvermoon,480,druid,balance,12,5,7
Agreus,frostwolf,480,druid,balance,12,5,7
Bizzi,frostwolf,480,druid,balance,12,5,7
Hansbørge,outland,480,druid,balance,12,5,7
Grîsh,burning-legion,480,druid,balance,12,5,7
Ragnahr,sanguino,480,druid,balance,12,5,7
Yadon,the-maelstrom,480,druid,balance,12,5,7
Naturina,shattered-hand,480,druid,balance,12,5,7
Shawkz,kazzak,480,druid,balance,12,5,7
Hussain,silvermoon,480,druid,balance,12,5,7
Feraline,stormrage,480,druid,balance,12,5,7
Meowborghini,draenor,480,druid,balance,12,5,7
Samthael,antonidas,480,druid,balance,12,5,7
Эскоф,gordunni,480,druid,balance,12,5,7
Pøwêr,blackrock,480,druid,balance,12,5,7
Norwy,kazzak,480,druid,balance,12,5,7
Alunjá,chamber-of-aspects,480,druid,balance,12,5,7
Elayria,blackmoore,480,druid,balance,12,5,7
Zebår,runetotem,480,druid,balance,12,5,7
Wotahn,antonidas,480,druid,balance,12,5,7
Faelwinter,blackhand,480,druid,balance,12,5,7
Quisp,ravencrest,480,druid,balance,12,5,7
Theridrax,twisting-nether,480,druid,balance,12,5,7
Balanced,blackhand,480,druid,balance,12,5,7
Balls,ravenholdt,480,druid,balance,12,5,7
Vyzir,stormscale,480,druid,balance,12,5,7
Goated,stormscale,480,druid,balance,12,5,7
Kovalawa,archimonde,480,druid,balance,12,5,7
Benghie,tarren-mill,480,druid,balance,12,5,7
Nasdruu,twisting-nether,480,druid,balance,12,5,7
Bafere,twisting-nether,480,druid,balance,12,5,7
Brunogösta,aerie-peak,480,druid,balance,12,5,7
Flowpowder,stormscale,480,druid,balance,12,5,7
Zomgcow,twisting-nether,480,druid,balance,12,5,7
Elrandir,tarren-mill,480,druid,balance,12,5,7
Lyrvaz,ravencrest,480,druid,balance,12,5,7
Meowu,twisting-nether,480,druid,balance,12,5,7
Rayjin,bronzebeard,480,druid,balance,12,5,7
Tomixdd,stormrage,480,druid,balance,12,5,7
Baccon,ravencrest,480,druid,balance,12,5,7
Assowl,dalaran,480,druid,balance,12,5,7
Notdrood,tarren-mill,480,druid,balance,12,5,7
Liiandri,khaz-modan,480,druid,balance,12,5,7
Dendru,ravencrest,480,druid,balance,12,5,7
Ysu,silvermoon,480,druid,balance,12,5,7
Muhlí,malygos,480,druid,balance,12,5,7
Vodibull,aegwynn,480,druid,balance,15,6,9
Sendorac,die-silberne-hand,480,druid,balance,20,7,13
Kotakota,twisting-nether,480,druid,balance,18,5,13
Galadhor,nemesis,480,druid,balance,18,5,13
Segundø,archimonde,480,druid,balance,18,5,13
Teog,stormreaver,480,druid,balance,18,5,13
Друличч,blackscar,480,druid,balance,18,5,13
Nyankash,draenor,480,druid,balance,18,5,13
Ðæøm,outland,479,druid,balance,6,5,1
Barley,aegwynn,479,druid,balance,6,5,1
Tribemeister,twisting-nether,479,druid,balance,12,5,7
Willferal,ravenholdt,479,druid,balance,12,5,7
Santoni,conseil-des-ombres,479,druid,balance,12,5,7
Leifbloomin,silvermoon,479,druid,balance,12,5,7
Qflow,kazzak,479,druid,balance,12,5,7
Khàoticz,draenor,479,druid,balance,12,5,7
Flãre,antonidas,479,druid,balance,12,5,7
Biologie,onyxia,479,druid,balance,12,5,7
Larsia,nordrassil,479,druid,balance,12,5,7
Garadon,pozzo-delleternità,479,druid,balance,18,5,13
Wíllférál,twisting-nether,479,druid,balance,18,5,13
Тахикамару,blackscar,479,druid,balance,18,5,13
Zube,ravencrest,479,druid,balance,18,5,13
Любимоетвое,gordunni,479,druid,balance,24,5,19
Druza,draenor,478,druid,balance,12,5,7
Lysende,arathor,478,druid,balance,12,5,7
Чепенкос,gordunni,478,druid,balance,12,5,7
Барли,grom,478,druid,balance,16,6,10
Druvian,argent-dawn,478,druid,balance,24,5,19
Bøa,twisting-nether,477,druid,balance,12,5,7
Surinox,blackrock,476,druid,balance,12,5,7
Натурка,razuvious,476,druid,balance,12,5,7
Stanjr,archimonde,476,druid,balance,18,5,13
Spellmáster,ravencrest,473,druid,balance,12,5,7
Drix,frostwolf,463,druid,balance,17,5,12
Chouan,marécage-de-zangar,457,druid,balance,21,7,14
Gurranq,argent-dawn,448,druid,balance,15,7,8
Gatouss,eldrethalas,446,druid,balance,8,6,2
Omijin,chogall,432,druid,balance,9,5,4
Snec,draenor,431,druid,balance,11,5,6
Rakúsh,thrall,431,druid,balance,15,5,10
Boomlex,defias-brotherhood,426,druid,balance,18,6,12
Hkguy,kazzak,425,druid,balance,18,6,12
Kimiza,hyjal,425,druid,balance,26,6,20
Foxîo,frostmane,415,druid,balance,8,5,3
Narmn,dalaran,415,druid,balance,10,5,5
Thaiboimbyy,veknilash,408,druid,balance,33,11,22
Goingfurglad,argent-dawn,384,druid,balance,9,6,3
Vertabrain,twilights-hammer,384,druid,balance,6,4,2
Badbird,thunderhorn,384,druid,balance,6,4,2
Крстлзхс,gordunni,384,druid,balance,6,4,2
Cpt,xavius,384,druid,balance,6,4,2
Bølzki,twisting-nether,384,druid,balance,6,4,2
Isokukko,stormreaver,384,druid,balance,6,4,2
Paatz,aegwynn,384,druid,balance,6,4,2
Drkarp,stormreaver,384,druid,balance,6,4,2
Alenemor,frostmane,384,druid,balance,6,4,2
Stkk,dun-modr,384,druid,balance,6,4,2
Ieatbooty,blackrock,384,druid,balance,6,4,2
Hyoyoe,stormreaver,384,druid,balance,6,4,2
Supremedruid,twisting-nether,384,druid,balance,6,4,2
Андердру,soulflayer,384,druid,balance,6,4,2
Didgeridru,silvermoon,384,druid,balance,6,4,2
Sapheà,burning-legion,384,druid,balance,6,4,2
Fzx,aegwynn,384,druid,balance,6,4,2
Varokkâ,aegwynn,384,druid,balance,6,4,2
Mylanqx,ragnaros,384,druid,balance,6,4,2
Kattbjörnen,ragnaros,384,druid,balance,6,4,2
Çÿçløñëz,aegwynn,384,druid,balance,6,4,2
Kefaheden,kazzak,384,druid,balance,6,4,2
Kasugia,aegwynn,384,druid,balance,6,4,2
Aelins,twisting-nether,384,druid,balance,6,4,2
Lovepower,nemesis,384,druid,balance,6,4,2
Noodledru,tarren-mill,384,druid,balance,6,4,2
Кристтл,howling-fjord,384,druid,balance,6,4,2
Ljóskann,kazzak,384,druid,balance,6,4,2
Skavenlol,zuljin,384,druid,balance,6,4,2
Sic,quelthalas,384,druid,balance,6,4,2
Kupalinka,nemesis,384,druid,balance,6,4,2
Adonbilivit,blackrock,384,druid,balance,6,4,2
Эйонар,howling-fjord,384,druid,balance,6,4,2
Организмхд,soulflayer,384,druid,balance,6,4,2
Rugsul,kazzak,384,druid,balance,6,4,2
Mojojojjo,sylvanas,384,druid,balance,6,4,2
Womzas,blackhand,384,druid,balance,6,4,2
Razorboris,outland,384,druid,balance,6,4,2
Lolaven,turalyon,384,druid,balance,6,4,2
Ejaculinho,malganis,384,druid,balance,6,4,2
Cornowlius,defias-brotherhood,384,druid,balance,6,4,2
Dermegon,outland,384,druid,balance,6,4,2
Knatch,outland,384,druid,balance,6,4,2
Clonesy,outland,384,druid,balance,6,4,2
Bigbitez,kazzak,384,druid,balance,6,4,2
Anorixx,outland,384,druid,balance,6,4,2
Izzyb,draenor,384,druid,balance,6,4,2
Ekologiskxx,outland,384,druid,balance,6,4,2
Belgïanblue,silvermoon,384,druid,balance,6,4,2
Yòò,outland,384,druid,balance,6,4,2
Arkarya,blackmoore,384,druid,balance,6,4,2
Xvmon,draenor,384,druid,balance,6,4,2
Youngdipper,draenor,384,druid,balance,6,4,2
Mirde,ravencrest,384,druid,balance,6,4,2
Doggydawg,tarren-mill,384,druid,balance,6,4,2
Jwifgodx,archimonde,384,druid,balance,6,4,2
Lolodaad,tarren-mill,384,druid,balance,6,4,2
Høt,draenor,384,druid,balance,6,4,2
Kkriss,stormscale,384,druid,balance,6,4,2
Amellian,silvermoon,384,druid,balance,6,4,2
Weremyst,outland,384,druid,balance,6,4,2
Oloreformed,ravencrest,384,druid,balance,6,4,2
Dekuul,stormscale,384,druid,balance,6,4,2
Druikraut,silvermoon,384,druid,balance,6,4,2
Fordragos,ravencrest,384,druid,balance,6,4,2
Hîvê,argent-dawn,384,druid,balance,6,4,2
Freshpussyz,ravencrest,384,druid,balance,6,4,2
Tacodudu,ravencrest,384,druid,balance,6,4,2
Imalama,ravencrest,384,druid,balance,6,4,2
Trèes,outland,384,druid,balance,6,4,2
Cmzdruidxdd,ravencrest,384,druid,balance,6,4,2
Stoptheclone,nordrassil,384,druid,balance,6,4,2
Zyzk,outland,384,druid,balance,6,4,2
Mêõwmëówxð,hyjal,384,druid,balance,6,4,2
Jp,eredar,384,druid,balance,6,4,2
Grailer,tarren-mill,384,druid,balance,6,4,2
Ponardo,outland,384,druid,balance,6,4,2
Allnatural,cthun,384,druid,balance,6,4,2
Petypeet,drakthul,384,druid,balance,6,4,2
Wheretowrite,ravencrest,384,druid,balance,6,4,2
Kvalitet,outland,384,druid,balance,6,4,2
Zootxd,ravencrest,384,druid,balance,6,4,2
Kelbim,draenor,384,druid,balance,6,4,2
Sunisan,stormscale,384,druid,balance,6,4,2
Cursedmee,blackrock,384,druid,balance,9,5,4
Viktornado,sylvanas,384,druid,balance,8,4,4
Gonco,blackrock,384,druid,balance,8,4,4
Фамай,howling-fjord,384,druid,balance,8,4,4
Galadrys,defias-brotherhood,384,druid,balance,12,4,8
Tvert,dalaran,384,druid,balance,12,4,8
Pathetik,archimonde,384,druid,balance,12,4,8
Allîyâ,archimonde,384,druid,balance,12,4,8
Konvoke,ravencrest,384,druid,balance,12,4,8
Nelfboyuk,tarren-mill,384,druid,balance,12,4,8
Ppr,stormscale,384,druid,balance,12,4,8
Alyrion,stormscale,384,druid,balance,12,4,8
Supacat,archimonde,384,druid,balance,12,4,8
Мукару,howling-fjord,384,druid,balance,12,4,8
Elainx,thrall,384,druid,balance,12,4,8
Laguna,ravencrest,384,druid,balance,12,4,8
Lizziath,ravencrest,384,druid,balance,12,4,8
Tiroxytxz,agamaggan,384,druid,balance,12,4,8
Nighttsorrow,drakthul,384,druid,balance,12,4,8
Delaghetto,kilrogg,384,druid,balance,12,4,8
Alanpapi,sanguino,384,druid,balance,12,4,8
Cegorach,xavius,384,druid,balance,12,4,8
Drujoty,cthun,384,druid,balance,12,4,8
Athai,conseil-des-ombres,384,druid,balance,12,4,8
Феразинария,gordunni,384,druid,balance,12,4,8
Rettoo,shadowsong,384,druid,balance,12,4,8
Kooglaash,kazzak,384,druid,balance,12,4,8
Biebear,sylvanas,384,druid,balance,12,4,8
Hipnos,sanguino,384,druid,balance,12,4,8
Zjukov,ragnaros,384,druid,balance,12,4,8
Drodiax,outland,384,druid,balance,12,4,8
Moonkin,sylvanas,384,druid,balance,12,4,8
Rastamona,draenor,384,druid,balance,12,4,8
Druidytrudy,blackrock,384,druid,balance,12,4,8
Menance,draenor,384,druid,balance,12,4,8
Zerebrô,mannoroth,384,druid,balance,12,4,8
Funka,uldum,384,druid,balance,12,4,8
Auden,arathor,384,druid,balance,12,4,8
Kiggstar,blackmoore,384,druid,balance,12,4,8
Astracat,korgall,384,druid,balance,12,4,8
Alillaeth,ravencrest,384,druid,balance,12,4,8
Lorucka,die-nachtwache,384,druid,balance,12,4,8
Dortalon,outland,384,druid,balance,12,4,8
Zerwurster,kazzak,384,druid,balance,12,4,8
Tønychopper,sanguino,384,druid,balance,12,4,8
Sâty,draenor,384,druid,balance,12,4,8
Vard,burning-legion,384,druid,balance,12,4,8
Zitom,kazzak,384,druid,balance,12,4,8
Pengington,blackrock,384,druid,balance,12,4,8
Manimalia,kazzak,384,druid,balance,12,4,8
Hypdsbrazz,aegwynn,384,druid,balance,12,4,8
Faintntt,outland,384,druid,balance,12,4,8
Ralenia,ravencrest,384,druid,balance,12,4,8
Sixtyinches,burning-blade,384,druid,balance,12,4,8
Ghastxd,aggra-português,384,druid,balance,12,4,8
Yee,twisting-nether,384,druid,balance,12,4,8
Roxshifter,tarren-mill,384,druid,balance,12,4,8
Spenkdetank,grim-batol,384,druid,balance,12,4,8
Kasiopee,hyjal,384,druid,balance,12,4,8
Foqua,twisting-nether,384,druid,balance,12,4,8
Мехнакиске,howling-fjord,384,druid,balance,14,4,10
Ênfaktüs,silvermoon,384,druid,balance,14,4,10
Lelyssa,burning-legion,384,druid,balance,18,4,14
Caatty,silvermoon,384,druid,balance,18,4,14
Gwendalyr,silvermoon,384,druid,balance,18,4,14
Leekroom,forscherliga,384,druid,balance,24,4,20
Elm,trollbane,383,druid,balance,6,4,2
Храмульчик,blackscar,383,druid,balance,6,4,2
Fluke,thrall,383,druid,balance,11,4,7
Ondope,blackmoore,383,druid,balance,12,4,8
Zedmok,archimonde,383,druid,balance,12,4,8
Moonpouk,archimonde,383,druid,balance,12,4,8
Blablábla,silvermoon,383,druid,balance,12,4,8
Rústy,baelgun,383,druid,balance,12,4,8
Ferlinas,the-maelstrom,383,druid,balance,12,4,8
Barnea,malfurion,383,druid,balance,18,4,14
Azazumi,silvermoon,383,druid,balance,18,4,14
Wickser,archimonde,383,druid,balance,18,4,14
Xenoovia,silvermoon,383,druid,balance,24,4,20
Manglefury,ravencrest,382,druid,balance,12,4,8
Puuhalí,stormreaver,380,druid,balance,12,4,8
Kocovali,frostmane,379,druid,balance,12,4,8
Billybobb,dentarg,377,druid,balance,19,8,11
Ráw,dun-modr,367,druid,balance,11,4,7
Submeplz,archimonde,352,druid,balance,10,4,6
Blakemonster,khaz-modan,351,druid,balance,8,5,3
Adonia,kul-tiras,351,druid,balance,8,5,3
Zrp,kazzak,351,druid,balance,11,4,7
Nightshaðe,argent-dawn,351,druid,balance,11,4,7
Oaeb,stormscale,351,druid,balance,11,4,7
Zybri,ragnaros,351,druid,balance,11,4,7
Soný,aegwynn,336,druid,balance,9,5,4
Sjikz,garrosh,336,druid,balance,9,4,5
Sketit,grim-batol,335,druid,balance,11,4,7
Азраешль,gordunni,330,druid,balance,10,6,4
Dresten,burning-blade,330,druid,balance,13,5,8
Ueihtam,archimonde,330,druid,balance,17,6,11
Tarîx,aegwynn,330,druid,balance,15,5,10
Eclipße,silvermoon,319,druid,balance,5,4,1
Blinkmorph,frostmane,319,druid,balance,8,4,4
Olula,blackmoore,319,druid,balance,8,4,4
Shapeshifts,kul-tiras,319,druid,balance,8,4,4
Alligatordru,kazzak,319,druid,balance,20,4,16
Neldoran,outland,304,druid,balance,7,4,3
Casir,burning-legion,304,druid,balance,7,4,3
Jaccz,twisting-nether,288,druid,balance,6,3,3
Testopöllö,ravencrest,288,druid,balance,6,3,3
Ripmacmiller,grim-batol,288,druid,balance,6,3,3
Måckïngsx,the-maelstrom,288,druid,balance,6,3,3
Treerion,ravencrest,288,druid,balance,6,3,3
Sparkex,ravencrest,288,druid,balance,6,3,3
Shermi,eredar,288,druid,balance,6,3,3
Djvapelordx,stormscale,288,druid,balance,6,3,3
Дизельпауэр,soulflayer,288,druid,balance,6,3,3
Gourdingodx,archimonde,288,druid,balance,6,3,3
Phike,blackrock,288,druid,balance,6,3,3
Bontenmaru,eldrethalas,288,druid,balance,6,3,3
Gnarrdrood,eredar,288,druid,balance,6,3,3
Дядявадядру,soulflayer,288,druid,balance,6,3,3
Durlehardu,archimonde,288,druid,balance,6,3,3
Kâtsu,ysondre,288,druid,balance,6,3,3
Haffro,twisting-nether,288,druid,balance,6,3,3
Cáptnmorgan,blackmoore,288,druid,balance,6,3,3
Moonkyye,hyjal,288,druid,balance,6,3,3
Amakary,blackrock,288,druid,balance,6,3,3
Сэнтэс,soulflayer,288,druid,balance,6,3,3
Holographic,ravencrest,288,druid,balance,6,3,3
Skailzdruid,hyjal,288,druid,balance,6,3,3
Stiffýz,archimonde,288,druid,balance,6,3,3
Hippycraft,the-maelstrom,288,druid,balance,6,3,3
Pèreco,hyjal,288,druid,balance,6,3,3
Bäckey,silvermoon,288,druid,balance,6,3,3
Zagrem,antonidas,288,druid,balance,6,3,3
Catgirlx,ravencrest,288,druid,balance,6,3,3
Solutionx,aegwynn,288,druid,balance,6,3,3
Fayn,aggra-português,288,druid,balance,6,3,3
Sucukk,antonidas,288,druid,balance,6,3,3
Devilmag,twisting-nether,288,druid,balance,6,3,3
Sasabinks,antonidas,288,druid,balance,6,3,3
Junglelist,antonidas,288,druid,balance,6,3,3
Pandøøræ,archimonde,288,druid,balance,6,3,3
Maldrýn,stormscale,288,druid,balance,6,3,3
Okboomi,hyjal,288,druid,balance,6,3,3
Seey,thrall,288,druid,balance,6,3,3
Moonrake,antonidas,288,druid,balance,6,3,3
Amyblack,aegwynn,288,druid,balance,6,3,3
Halown,twisting-nether,288,druid,balance,6,3,3
Barbulloup,hyjal,288,druid,balance,6,3,3
Zfaf,hyjal,288,druid,balance,6,3,3
Moolfurian,draenor,288,druid,balance,6,3,3
Hordepwnr,sylvanas,288,druid,balance,6,3,3
Sÿlph,sylvanas,288,druid,balance,6,3,3
Flaiq,twisting-nether,288,druid,balance,6,3,3
Radicall,archimonde,288,druid,balance,6,3,3
Àyóorts,archimonde,288,druid,balance,6,3,3
Framoin,archimonde,288,druid,balance,6,3,3
Hð,blackmoore,288,druid,balance,6,3,3
Treksta,draenor,288,druid,balance,6,3,3
Yezzir,defias-brotherhood,288,druid,balance,6,3,3
Yulivée,blackmoore,288,druid,balance,6,3,3
Llcooljay,ravencrest,288,druid,balance,6,3,3
Hahafun,ravencrest,288,druid,balance,6,3,3
Yeats,blackmoore,288,druid,balance,6,3,3
Shizeem,malganis,288,druid,balance,6,3,3
Kusho,draenor,288,druid,balance,6,3,3
Ninato,blackmoore,288,druid,balance,6,3,3
Bloomin,sylvanas,288,druid,balance,6,3,3
Weestevie,ragnaros,288,druid,balance,6,3,3
Houwalia,archimonde,288,druid,balance,6,3,3
Drester,blackrock,288,druid,balance,6,3,3
Druesafta,ravencrest,288,druid,balance,6,3,3
Bámbí,sylvanas,288,druid,balance,6,3,3
Treebags,ravencrest,288,druid,balance,6,3,3
Skiiter,draenor,288,druid,balance,6,3,3
Liette,dalaran,288,druid,balance,6,3,3
Lorritha,sylvanas,288,druid,balance,6,3,3
Yezzízò,ravencrest,288,druid,balance,6,3,3
Ripthat,silvermoon,288,druid,balance,6,3,3
Exjuggy,twisting-nether,288,druid,balance,6,3,3
Dízzy,malganis,288,druid,balance,6,3,3
Bartax,culte-de-la-rive-noire,288,druid,balance,6,3,3
Graegan,archimonde,288,druid,balance,6,3,3
Timxie,outland,288,druid,balance,6,3,3
Kesismahmut,twisting-nether,288,druid,balance,6,3,3
Вооми,gordunni,288,druid,balance,6,3,3
Peit,blackmoore,288,druid,balance,6,3,3
Ihatemétoo,stormscale,288,druid,balance,6,3,3
Fishe,twisting-nether,288,druid,balance,6,3,3
Erelieva,silvermoon,288,druid,balance,6,3,3
Blazingmoon,twisting-nether,288,druid,balance,6,3,3
Блинчек,gordunni,288,druid,balance,6,3,3
Kärämel,archimonde,288,druid,balance,6,3,3
Ullainho,stormscale,288,druid,balance,6,3,3
Flower,aggramar,288,druid,balance,6,3,3
Jazeera,ragnaros,288,druid,balance,6,3,3
Galerion,ragnaros,288,druid,balance,6,3,3
Mikeisbike,ragnaros,288,druid,balance,6,3,3
Duchaliot,nemesis,288,druid,balance,6,3,3
Baubles,ghostlands,288,druid,balance,6,3,3
Vícvega,ravencrest,288,druid,balance,6,3,3
Balthazaar,ysera,288,druid,balance,6,3,3
Rallemaister,tarren-mill,288,druid,balance,6,3,3
Yogui,zuljin,288,druid,balance,6,3,3
Høtbøt,ysera,288,druid,balance,6,3,3
Quinteness,silvermoon,288,druid,balance,6,3,3
Mogwaî,arygos,288,druid,balance,6,3,3
Aczino,shendralar,288,druid,balance,6,3,3
Qzaaq,tarren-mill,288,druid,balance,6,3,3
Wai,ravencrest,288,druid,balance,6,3,3
Rbg,dun-modr,288,druid,balance,6,3,3
Taraka,blackmoore,288,druid,balance,6,3,3
Djclonebot,kazzak,288,druid,balance,6,3,3
Trixdudu,emerald-dream,288,druid,balance,6,3,3
Uníverse,blackmoore,288,druid,balance,6,3,3
Quitex,darkspear,288,druid,balance,6,3,3
Kropieto,outland,288,druid,balance,6,3,3
Sweqt,argent-dawn,288,druid,balance,6,3,3
Panoramiix,throkferoth,288,druid,balance,6,3,3
Jaykerlol,kazzak,288,druid,balance,6,3,3
Porklife,tarren-mill,288,druid,balance,6,3,3
Ilus,outland,288,druid,balance,6,3,3
Dfjguidfg,baelgun,288,druid,balance,6,3,3
Shyasiandru,area-52,288,druid,balance,6,3,3
Druidat,kazzak,288,druid,balance,6,3,3
Tyldormeow,tarren-mill,288,druid,balance,6,3,3
Èspartana,dun-modr,288,druid,balance,6,3,3
Gargasina,colinas-pardas,288,druid,balance,6,3,3
Kvngthegoat,kazzak,288,druid,balance,6,3,3
Johndru,kazzak,288,druid,balance,6,3,3
Clonebotxd,kazzak,288,druid,balance,6,3,3
Svantte,stormreaver,288,druid,balance,6,3,3
Leslra,agamaggan,288,druid,balance,6,3,3
Moonskeng,quelthalas,288,druid,balance,6,3,3
Dabulla,kazzak,288,druid,balance,6,3,3
Замакибо,howling-fjord,288,druid,balance,11,5,6
Furíouz,darksorrow,288,druid,balance,9,4,5
Terompotodo,cthun,288,druid,balance,10,4,6
Bootydrooty,thrall,288,druid,balance,9,3,6
Benduu,doomhammer,288,druid,balance,11,3,8
Astralpandas,kazzak,288,druid,balance,15,4,11
Viølin,silvermoon,288,druid,balance,12,3,9
Druidlaba,drakthul,288,druid,balance,12,3,9
Иссарил,gordunni,288,druid,balance,12,3,9
Leafceld,aggra-português,288,druid,balance,12,3,9
Zuwyldxd,blackrock,288,druid,balance,12,3,9
Kidow,wrathbringer,288,druid,balance,12,3,9
Rashtazul,blackmoore,288,druid,balance,12,3,9
Kíggi,blackmoore,288,druid,balance,12,3,9
Kodislem,grim-batol,288,druid,balance,12,3,9
Kãrá,argent-dawn,288,druid,balance,12,3,9
Kärmä,eldrethalas,288,druid,balance,12,3,9
Жолудь,gordunni,288,druid,balance,12,3,9
Tayswiftmend,defias-brotherhood,288,druid,balance,12,3,9
Balfor,arathor,288,druid,balance,12,3,9
Akkamory,terokkar,288,druid,balance,12,3,9
Thaneo,blackmoore,288,druid,balance,12,3,9
Loverace,dun-modr,288,druid,balance,12,3,9
Groncowski,blackmoore,288,druid,balance,12,3,9
Cosmovibe,terokkar,288,druid,balance,12,3,9
Chickenlegx,blackmoore,288,druid,balance,12,3,9
Aiwendil,alakir,288,druid,balance,12,3,9
Redgreenblue,ravencrest,288,druid,balance,12,3,9
Onlycustard,outland,288,druid,balance,12,3,9
Astralcaller,kazzak,288,druid,balance,12,3,9
Tuathdedann,ravencrest,288,druid,balance,12,3,9
Nyomnom,ravencrest,288,druid,balance,12,3,9
Grizzleh,shattered-halls,288,druid,balance,18,3,15
Hävefunny,archimonde,288,druid,balance,18,3,15
Dasgrandeur,kazzak,287,druid,balance,6,3,3
Bigcappa,ahnqiraj,287,druid,balance,6,3,3
Dewis,stormscale,287,druid,balance,6,3,3
Walkao,tarren-mill,287,druid,balance,6,3,3
Slachtafval,twisting-nether,287,druid,balance,14,3,11
Razah,ravencrest,286,druid,balance,12,3,9
Millworgen,norgannon,286,druid,balance,12,3,9
Rahkki,malfurion,284,druid,balance,12,3,9
Шев,blackscar,270,druid,balance,7,4,3
Jhiun,ragnaros,256,druid,balance,4,4,0
Calligenia,antonidas,256,druid,balance,16,3,13
Bóssít,doomhammer,255,druid,balance,11,3,8
Drulius,tarren-mill,240,druid,balance,9,4,5
Yinkxzwo,blackmoore,240,druid,balance,9,3,6
Herdnotseen,stormscale,240,druid,balance,9,3,6
Octul,magtheridon,239,druid,balance,5,3,2
Bookashde,frostmane,234,druid,balance,7,4,3
Treebearded,agamaggan,234,druid,balance,7,4,3
Tmhaikyu,blackhand,234,druid,balance,15,5,10
Tiemyrôpe,outland,223,druid,balance,14,3,11
Блэкфорест,gordunni,211,druid,balance,19,6,13
Morboka,dalaran,208,druid,balance,13,3,10
Qoatazinha,malganis,192,druid,balance,4,3,1
Shaeliea,argent-dawn,192,druid,balance,6,2,4
Lem,dentarg,192,druid,balance,6,2,4
Tamburoo,tarren-mill,192,druid,balance,6,2,4
Faetish,hyjal,192,druid,balance,6,2,4
Tallbutshort,stormscale,192,druid,balance,6,2,4
Jimmyxdd,kazzak,192,druid,balance,6,2,4
Slakkielief,archimonde,192,druid,balance,6,2,4
Dacat,kazzak,192,druid,balance,6,2,4
Chickenrice,blackhand,192,druid,balance,6,2,4
Lagiana,zirkel-des-cenarius,192,druid,balance,6,2,4
Gladiata,tarren-mill,192,druid,balance,6,2,4
Lashed,tarren-mill,192,druid,balance,6,2,4
Iqqzazagotme,hyjal,192,druid,balance,6,2,4
Layzz,archimonde,192,druid,balance,6,2,4
Marryat,argent-dawn,192,druid,balance,6,2,4
Mermelijn,argent-dawn,192,druid,balance,6,2,4
Jambalaja,stormscale,192,druid,balance,6,2,4
Svanturken,kazzak,192,druid,balance,6,2,4
Paskixoxo,ravencrest,192,druid,balance,6,2,4
Raïby,archimonde,192,druid,balance,6,2,4
Héryse,hyjal,192,druid,balance,6,2,4
Voganz,archimonde,192,druid,balance,6,2,4
Анкарон,howling-fjord,192,druid,balance,6,2,4
Edal,chogall,192,druid,balance,6,2,4
Panørax,archimonde,192,druid,balance,6,2,4
Manymal,chogall,192,druid,balance,6,2,4
Hâyâbusa,antonidas,192,druid,balance,6,2,4
Wakanishu,tarren-mill,192,druid,balance,6,2,4
Уличныйиисус,azuregos,192,druid,balance,6,2,4
Dawzd,archimonde,192,druid,balance,6,2,4
Blacksage,dragonmaw,192,druid,balance,6,2,4
Liionheart,khaz-modan,192,druid,balance,6,2,4
Meatus,ragnaros,192,druid,balance,6,2,4
Successhaver,argent-dawn,192,druid,balance,6,2,4
Twodaysordie,ravencrest,192,druid,balance,6,2,4
Biggestbirdx,stormscale,192,druid,balance,6,2,4
Tranduiil,drakthul,192,druid,balance,6,2,4
Druidbox,ravencrest,192,druid,balance,6,2,4
Dinnalia,ravencrest,192,druid,balance,6,2,4
Halfaway,ravencrest,192,druid,balance,6,2,4
Mistic,twisting-nether,192,druid,balance,6,2,4
Eschatos,argent-dawn,192,druid,balance,6,2,4
Natzuri,lothar,192,druid,balance,6,2,4
Djkoolaid,frostwolf,192,druid,balance,6,2,4
Hotributionx,ravencrest,192,druid,balance,6,2,4
Trashgamex,eredar,192,druid,balance,6,2,4
Chzycow,twisting-nether,192,druid,balance,6,2,4
Nîppe,ravencrest,192,druid,balance,6,2,4
Sychlone,ravencrest,192,druid,balance,6,2,4
Имбахилка,lich-king,192,druid,balance,6,2,4
Exist,kul-tiras,192,druid,balance,6,2,4
Devill,grim-batol,192,druid,balance,6,2,4
Fripôuille,ysondre,192,druid,balance,6,2,4
Varìx,ysondre,192,druid,balance,6,2,4
Borne,aggra-português,192,druid,balance,6,2,4
Versality,lightnings-blade,192,druid,balance,6,2,4
Dzeve,the-maelstrom,192,druid,balance,6,2,4
Wonjin,nerathor,192,druid,balance,6,2,4
Violess,burning-legion,192,druid,balance,6,2,4
Kwenden,arygos,192,druid,balance,6,2,4
Дробовик,soulflayer,192,druid,balance,6,2,4
Катали,soulflayer,192,druid,balance,6,2,4
Arzalor,burning-legion,192,druid,balance,6,2,4
Lillu,aggramar,192,druid,balance,6,2,4
Çât,kazzak,192,druid,balance,6,2,4
Pepenno,draenor,192,druid,balance,6,2,4
Jflow,draenor,192,druid,balance,6,2,4
Mmhcharal,voljin,192,druid,balance,6,2,4
Healingwool,ravencrest,192,druid,balance,6,2,4
Zhu,outland,192,druid,balance,6,2,4
Trueforms,ravencrest,192,druid,balance,6,2,4
Caskas,nemesis,192,druid,balance,6,2,4
Bamso,daggerspine,192,druid,balance,6,2,4
Galgaan,burning-legion,192,druid,balance,6,2,4
Fevine,arathor,192,druid,balance,6,2,4
Natuh,outland,192,druid,balance,6,2,4
Zeeqi,draenor,192,druid,balance,6,2,4
Seøms,aegwynn,192,druid,balance,6,2,4
Moonleek,draenor,192,druid,balance,6,2,4
Jaffacakeqt,draenor,192,druid,balance,6,2,4
Burnsois,draenor,192,druid,balance,6,2,4
Luveena,kazzak,192,druid,balance,6,2,4
Tuuqa,draenor,192,druid,balance,6,2,4
Micifuz,aegwynn,192,druid,balance,6,2,4
Scopix,aegwynn,192,druid,balance,6,2,4
Kittyclâw,perenolde,192,druid,balance,6,2,4
Santaana,silvermoon,192,druid,balance,6,2,4
Hotenhope,sylvanas,192,druid,balance,6,2,4
Jordnötssmör,draenor,192,druid,balance,6,2,4
Daunt,wrathbringer,192,druid,balance,6,2,4
Bossdruid,aegwynn,192,druid,balance,6,2,4
Deezforms,kazzak,192,druid,balance,6,2,4
Lïlara,elune,192,druid,balance,6,2,4
Vëlînøf,sanguino,192,druid,balance,6,2,4
Amberleaf,chamber-of-aspects,192,druid,balance,6,2,4
Chickenboss,sanguino,192,druid,balance,6,2,4
Маалир,gordunni,192,druid,balance,6,2,4
Бабкавтанке,gordunni,192,druid,balance,6,2,4
Erkerkerk,twisting-nether,192,druid,balance,6,2,4
Silverdice,thrall,192,druid,balance,6,2,4
Kawaiiswag,kazzak,192,druid,balance,6,2,4
Maxreflect,pozzo-delleternità,192,druid,balance,6,2,4
Spidete,sanguino,192,druid,balance,6,2,4
Старселлер,gordunni,192,druid,balance,6,2,4
Natsuheal,drakthul,192,druid,balance,6,2,4
Pawnamera,norgannon,192,druid,balance,6,2,4
Filderah,doomhammer,192,druid,balance,6,2,4
Chupapoya,pozzo-delleternità,192,druid,balance,6,2,4
Ляшок,gordunni,192,druid,balance,6,2,4
Elflord,nemesis,192,druid,balance,6,2,4
Jonnaxø,ravencrest,192,druid,balance,6,2,4
Hadespool,sanguino,192,druid,balance,6,2,4
Foxglove,ravencrest,192,druid,balance,6,2,4
Kätsumï,dun-modr,192,druid,balance,6,2,4
Kuzka,dun-modr,192,druid,balance,6,2,4
Peardraax,draenor,192,druid,balance,6,2,4
Nilatsfloda,quelthalas,192,druid,balance,6,2,4
Csmedruid,blackrock,192,druid,balance,6,2,4
Brømberry,blackrock,192,druid,balance,6,2,4
Gymii,blackmoore,192,druid,balance,6,2,4
Escares,blackrock,192,druid,balance,6,2,4
Jéssíé,silvermoon,192,druid,balance,6,2,4
Susaru,blackrock,192,druid,balance,6,2,4
Entelol,blackrock,192,druid,balance,6,2,4
Ahriany,blackmoore,192,druid,balance,6,2,4
Wheyproteín,dun-modr,192,druid,balance,6,2,4
Metteaglê,blackrock,192,druid,balance,6,2,4
Tadoson,blackmoore,192,druid,balance,6,2,4
Skrewu,silvermoon,192,druid,balance,6,2,4
Saliencias,kazzak,192,druid,balance,6,2,4
Æsc,cthun,192,druid,balance,6,2,4
Hîlal,blackrock,192,druid,balance,6,2,4
Gotika,blackrock,192,druid,balance,6,2,4
Снэйк,borean-tundra,192,druid,balance,6,2,4
Fromeden,silvermoon,192,druid,balance,6,2,4
Mül,blackmoore,192,druid,balance,6,2,4
Auntypat,defias-brotherhood,192,druid,balance,6,2,4
Xulian,exodar,192,druid,balance,6,2,4
Descarn,nazjatar,192,druid,balance,6,2,4
Roshgar,magtheridon,192,druid,balance,6,2,4
Deadlydudu,magtheridon,192,druid,balance,6,2,4
Trowbsi,blackmoore,192,druid,balance,6,2,4
Brusinho,tyrande,192,druid,balance,6,2,4
Sorkoxd,silvermoon,192,druid,balance,6,2,4
Kaamirach,blackmoore,192,druid,balance,6,2,4
Chugs,blackmoore,192,druid,balance,6,2,4
Energäde,twisting-nether,192,druid,balance,7,2,5
Денчикбратиш,soulflayer,192,druid,balance,7,2,5
Gortarn,defias-brotherhood,192,druid,balance,8,2,6
Aceeu,dalaran,192,druid,balance,9,2,7
Lycîrpar,archimonde,192,druid,balance,10,2,8
Ostrich,arathor,192,druid,balance,11,2,9
Ãnimal,argent-dawn,192,druid,balance,12,2,10
Nitro,kazzak,192,druid,balance,12,2,10
Wolfverine,dentarg,192,druid,balance,12,2,10
Kramit,ravencrest,192,druid,balance,12,2,10
Avanishri,defias-brotherhood,192,druid,balance,12,2,10
Fizzybubelle,blackhand,192,druid,balance,12,2,10
Onmyass,dragonblight,192,druid,balance,12,2,10
Celainiël,argent-dawn,192,druid,balance,12,2,10
Druidja,sylvanas,192,druid,balance,12,2,10
Chiendetalus,ysondre,192,druid,balance,12,2,10
Dørzz,blackmoore,192,druid,balance,12,2,10
Asanaria,ravencrest,192,druid,balance,12,2,10
Aristrea,dun-morogh,192,druid,balance,12,2,10
Darksthero,draenor,192,druid,balance,12,2,10
Broasted,stormscale,192,druid,balance,12,2,10
Gîgî,defias-brotherhood,191,druid,balance,6,2,4
Catbear,kazzak,191,druid,balance,6,2,4
Сугрик,deathweaver,191,druid,balance,9,2,7
Silvacustos,teldrassil,191,druid,balance,12,2,10
Arrock,malfurion,191,druid,balance,12,2,10
Myrddil,kult-der-verdammten,191,druid,balance,12,2,10
Truebadass,draenor,190,druid,balance,10,4,6
Garbagemonky,amanthul,169,druid,balance,12,5,7
Yudaqu,thrall,159,druid,balance,5,2,3
Bellatrx,blackmoore,159,druid,balance,5,2,3
Ацкийдру,gordunni,159,druid,balance,5,2,3
Fabsl,archimonde,159,druid,balance,5,2,3
Forbode,darkspear,159,druid,balance,5,2,3
Khachiruloh,zuljin,159,druid,balance,5,2,3
Testoprime,draenor,159,druid,balance,5,2,3
Aerobicgirlx,malganis,159,druid,balance,11,2,9
Aütumn,twisting-nether,144,druid,balance,9,3,6
Иосси,soulflayer,138,druid,balance,9,5,4
Блиденг,gordunni,138,druid,balance,9,3,6
Kôrtêx,blackmoore,138,druid,balance,10,3,7
Jãy,ravencrest,128,druid,balance,4,2,2
Andra,alleria,128,druid,balance,4,2,2
Xaahl,archimonde,128,druid,balance,4,2,2
Tekilaz,sanguino,128,druid,balance,4,2,2
Uwina,silvermoon,96,druid,balance,3,2,1
Deethra,stormscale,96,druid,balance,3,2,1
Ligoz,silvermoon,96,druid,balance,3,2,1
Scar,dentarg,96,druid,balance,6,1,5
Shalysae,silvermoon,96,druid,balance,6,1,5
Nermax,kazzak,96,druid,balance,6,1,5
Drroger,kazzak,96,druid,balance,6,1,5
Apojeanne,hyjal,96,druid,balance,6,1,5
Jænne,ysondre,96,druid,balance,6,1,5
Maum,outland,96,druid,balance,6,1,5
Telavie,antonidas,96,druid,balance,6,1,5
Droodzerqt,archimonde,96,druid,balance,6,1,5
Donoz,ravencrest,96,druid,balance,6,1,5
Kintàro,nemesis,96,druid,balance,6,1,5
Möõ,tarren-mill,96,druid,balance,6,1,5
Cattdamon,outland,96,druid,balance,6,1,5
Xwerzz,stormscale,96,druid,balance,6,1,5
Ripndip,eredar,96,druid,balance,6,1,5
Nayemi,blackmoore,96,druid,balance,6,1,5
Brownny,dun-modr,96,druid,balance,6,1,5
Leronox,blackmoore,96,druid,balance,6,1,5
Bullseaman,stormscale,96,druid,balance,6,1,5
Môõn,tarren-mill,96,druid,balance,6,1,5
Kaira,kazzak,96,druid,balance,6,1,5
Pudseytree,doomhammer,96,druid,balance,6,1,5
Tigerbalm,ravenholdt,96,druid,balance,6,1,5
Eredhion,stormscale,96,druid,balance,6,1,5
Fullcyclone,stormscale,96,druid,balance,6,1,5
Dreathie,kazzak,96,druid,balance,6,1,5
Beginníng,outland,96,druid,balance,6,1,5
Хенет,blackscar,96,druid,balance,6,1,5
Basz,outland,96,druid,balance,6,1,5
Ferdax,outland,96,druid,balance,6,1,5
Saralya,argent-dawn,96,druid,balance,6,1,5
Рублюсук,howling-fjord,96,druid,balance,6,1,5
Арбузир,howling-fjord,96,druid,balance,6,1,5
Пё,howling-fjord,96,druid,balance,6,1,5
Гринфрэш,howling-fjord,96,druid,balance,6,1,5
Skinnyleg,baelgun,96,druid,balance,6,1,5
Siahra,khaz-modan,96,druid,balance,6,1,5
Jamaicanherb,bronzebeard,96,druid,balance,6,1,5
Anahita,emerald-dream,96,druid,balance,6,1,5
Blùwe,archimonde,96,druid,balance,6,1,5
Scarykejton,draenor,96,druid,balance,6,1,5
Frequentist,ragnaros,96,druid,balance,6,1,5
Lofastfox,ragnaros,96,druid,balance,6,1,5
Hotseîdank,blackrock,96,druid,balance,6,1,5
Druiduis,minahonda,96,druid,balance,6,1,5
Avis,dethecus,96,druid,balance,6,1,5
Ewena,ragnaros,96,druid,balance,6,1,5
Herekitykity,frostmane,96,druid,balance,6,1,5
Voodeen,burning-legion,96,druid,balance,6,1,5
Gyome,sargeras,96,druid,balance,6,1,5
Tàazz,sargeras,96,druid,balance,6,1,5
Beatball,aegwynn,96,druid,balance,6,1,5
Сверххищникк,soulflayer,96,druid,balance,6,1,5
Magneziie,drakthul,96,druid,balance,6,1,5
Kakoje,burning-legion,96,druid,balance,6,1,5
Маминапуська,soulflayer,96,druid,balance,6,1,5
Gracelock,argent-dawn,96,druid,balance,6,1,5
Bjaerntass,darksorrow,96,druid,balance,6,1,5
Tortugo,dun-modr,96,druid,balance,6,1,5
Jarál,argent-dawn,96,druid,balance,6,1,5
Владбутират,soulflayer,96,druid,balance,6,1,5
Ösdru,tarren-mill,96,druid,balance,6,1,5
Пасторизсша,soulflayer,96,druid,balance,6,1,5
Garudax,blackrock,96,druid,balance,6,1,5
Reyk,sunstrider,96,druid,balance,6,1,5
Citral,balnazzar,96,druid,balance,6,1,5
Titurel,zuljin,96,druid,balance,6,1,5
Ekxn,archimonde,96,druid,balance,6,1,5
Uniquz,sylvanas,96,druid,balance,6,1,5
Enia,azjolnerub,96,druid,balance,6,1,5
Lilkâzzam,blackrock,96,druid,balance,6,1,5
Nubsi,aegwynn,96,druid,balance,6,1,5
Aniprimal,auchindoun,96,druid,balance,6,1,5
Arebia,blackrock,96,druid,balance,6,1,5
Leafy,sanguino,96,druid,balance,6,1,5
Miniours,varimathras,96,druid,balance,6,1,5
Ashiothie,argent-dawn,96,druid,balance,6,1,5
Panigale,dun-modr,96,druid,balance,6,1,5
Stuntgirlcat,pozzo-delleternità,96,druid,balance,6,1,5
Котябра,gordunni,96,druid,balance,6,1,5
Druwidess,archimonde,96,druid,balance,6,1,5
Samuelito,ravencrest,96,druid,balance,6,1,5
Ironveins,ravencrest,96,druid,balance,6,1,5
Твойбарсик,gordunni,96,druid,balance,6,1,5
Arún,nazjatar,96,druid,balance,6,1,5
Редонт,gordunni,96,druid,balance,6,1,5
Ilsar,burning-legion,96,druid,balance,6,1,5
Liunara,nemesis,96,druid,balance,6,1,5
Karbonaten,draenor,96,druid,balance,6,1,5
Zaerox,ambossar,96,druid,balance,6,1,5
Maaghera,silvermoon,96,druid,balance,6,1,5
Snigesnige,silvermoon,96,druid,balance,6,1,5
Nøwørnever,ulduar,96,druid,balance,6,1,5
Ghxsty,silvermoon,96,druid,balance,6,1,5
Treksta,silvermoon,96,druid,balance,6,1,5
Boszorka,silvermoon,96,druid,balance,6,1,5
Blolzz,silvermoon,96,druid,balance,6,1,5
Flauschtatze,wrathbringer,96,druid,balance,6,1,5
Psitol,silvermoon,96,druid,balance,6,1,5
Пониджус,howling-fjord,96,druid,balance,26,4,22
Búll,aegwynn,96,druid,balance,7,1,6
Soléda,thrall,96,druid,balance,7,1,6
Ghostpaws,doomhammer,96,druid,balance,11,1,10
Ninmah,quelthalas,96,druid,balance,12,1,11
Woolee,area-52,96,druid,balance,12,1,11
Summër,los-errantes,96,druid,balance,12,1,11
Tarendil,argent-dawn,96,druid,balance,12,1,11
Maßka,terokkar,96,druid,balance,12,1,11
Periklasus,antonidas,96,druid,balance,12,1,11
Nissemand,ravencrest,96,druid,balance,12,1,11
Noiir,malfurion,96,druid,balance,12,1,11
Bìerchen,antonidas,96,druid,balance,12,1,11
Grynoth,silvermoon,96,druid,balance,12,1,11
Lïs,the-maelstrom,96,druid,balance,12,1,11
Gawsworth,aerie-peak,95,druid,balance,6,1,5
Bráveukrainé,ravencrest,79,druid,balance,5,1,4
Qb,blackrock,79,druid,balance,5,1,4
Revoidý,blackmoore,79,druid,balance,5,1,4
Kodobursto,stormscale,79,druid,balance,6,1,5
Ушастикэ,gordunni,64,druid,balance,4,1,3
Китрасх,soulflayer,64,druid,balance,4,1,3
Exïlla,archimonde,48,druid,balance,3,1,2
Soofyan,kazzak,48,druid,balance,3,1,2
Møønhaven,silvermoon,48,druid,balance,3,1,2
Detlaff,draenor,48,druid,balance,9,1,8
Энокей,gordunni,42,druid,balance,8,2,6
Melonjuicer,argent-dawn,42,druid,balance,9,2,7
Plankface,ravencrest,42,druid,balance,21,3,18
Trànsformer,nemesis,31,druid,balance,2,1,1
Nalreaa,kazzak,31,druid,balance,8,1,7
Sarishi,kazzak,16,druid,balance,1,1,0
Báttlx,blackrock,16,druid,balance,7,1,6
Nèthy,argent-dawn,2244,evoker,preservation,77,47,30
Kankethyr,korgall,2241,evoker,preservation,113,67,46
Néthy,argent-dawn,2191,evoker,preservation,186,105,81
Elcocodrilo,tarren-mill,2180,evoker,preservation,84,44,40
Nesedon,stormscale,2166,evoker,preservation,389,204,185
Gardennewt,ravencrest,2158,evoker,preservation,90,49,41
Jacko,nemesis,2158,evoker,preservation,89,48,41
Gardenewt,ravencrest,2153,evoker,preservation,108,59,49
Бедныйгрузин,howling-fjord,2146,evoker,preservation,72,43,29
Zychodrac,draenor,2145,evoker,preservation,148,74,74
Najikí,tarren-mill,2135,evoker,preservation,149,86,63
Bodytypezero,terenas,2133,evoker,preservation,140,77,63
Sukkmymadnes,draenor,2120,evoker,preservation,79,39,40
Сансетшторм,gordunni,2119,evoker,preservation,88,47,41
Vokedrak,eredar,2118,evoker,preservation,113,58,55
Drogon,shendralar,2114,evoker,preservation,114,67,47
Kronata,sanguino,2112,evoker,preservation,102,45,57
Dn,shattered-hand,2111,evoker,preservation,89,46,43
Драконсила,gordunni,2100,evoker,preservation,131,73,58
Dragonsweat,hyjal,2088,evoker,preservation,120,66,54
Bodytypefour,stormscale,2084,evoker,preservation,120,57,63
Onelastdance,ravencrest,2083,evoker,preservation,89,76,13
Ms,ravencrest,2052,evoker,preservation,82,43,39
Haxyia,outland,2052,evoker,preservation,138,71,67
Smellybreath,ravencrest,2048,evoker,preservation,54,32,22
Puzikloh,ravencrest,2043,evoker,preservation,54,27,27
Humòngóus,kazzak,2042,evoker,preservation,60,31,29
Flyhacker,blackrock,2039,evoker,preservation,72,37,35
Гачитварь,galakrond,2039,evoker,preservation,317,156,161
Flouzzx,blackmoore,2038,evoker,preservation,90,50,40
Ltmdrgn,ravencrest,2032,evoker,preservation,94,53,41
Zimbello,nemesis,2015,evoker,preservation,402,216,186
Dizablise,burning-legion,2011,evoker,preservation,136,71,65
Dreamwalk,archimonde,2010,evoker,preservation,120,71,49
Nerfevøker,ragnaros,2008,evoker,preservation,130,66,64
Podonok,ravencrest,2005,evoker,preservation,251,129,122
Diggidydract,silvermoon,2005,evoker,preservation,68,32,36
Dracthal,blackmoore,2004,evoker,preservation,78,46,32
Sính,ravencrest,1997,evoker,preservation,71,38,33
Xays,ravencrest,1987,evoker,preservation,100,50,50
Krustyvoker,sargeras,1983,evoker,preservation,53,33,20
Sinéstrà,antonidas,1982,evoker,preservation,246,125,121
Шафлэнжоер,fordragon,1977,evoker,preservation,36,23,13
Asgá,kazzak,1973,evoker,preservation,50,24,26
Baddragonn,nemesis,1972,evoker,preservation,47,28,19
Ноубадиаттак,soulflayer,1963,evoker,preservation,102,49,53
Schwañ,twisting-nether,1951,evoker,preservation,144,84,60
Rvrsl,outland,1948,evoker,preservation,435,219,216
Plogi,twisting-nether,1945,evoker,preservation,84,47,37
Nivoker,kazzak,1937,evoker,preservation,90,49,41
Asyncgosa,ravencrest,1935,evoker,preservation,107,51,56
Púñterx,kazzak,1934,evoker,preservation,101,54,47
Sindragonk,ravencrest,1931,evoker,preservation,48,33,15
Ipho,twisting-nether,1930,evoker,preservation,120,57,63
Lazey,stormscale,1928,evoker,preservation,207,107,100
Woodý,draenor,1923,evoker,preservation,48,29,19
Matrixslave,tarren-mill,1922,evoker,preservation,133,74,59
Dragonmeta,kazzak,1919,evoker,preservation,48,25,23
Dragondaddy,eredar,1917,evoker,preservation,114,63,51
Béatér,aegwynn,1913,evoker,preservation,166,93,73
Waifuwu,blackhand,1912,evoker,preservation,229,111,118
Mauül,ravencrest,1911,evoker,preservation,156,95,61
Seafolk,stormscale,1909,evoker,preservation,291,157,134
Jamesdéan,twisting-nether,1905,evoker,preservation,113,70,43
Mistrßroducr,stormreaver,1905,evoker,preservation,42,21,21
Swainsupp,archimonde,1904,evoker,preservation,75,35,40
Notadvanced,draenor,1904,evoker,preservation,104,46,58
Bluesaphir,ravencrest,1897,evoker,preservation,42,23,19
Theories,blackhand,1897,evoker,preservation,145,67,78
Mvoker,blackmoore,1892,evoker,preservation,53,32,21
Huxleysroar,draenor,1888,evoker,preservation,54,26,28
Ðåñîq,kazzak,1888,evoker,preservation,89,38,51
Phnx,blackrock,1886,evoker,preservation,246,125,121
Myxiwinxy,archimonde,1885,evoker,preservation,36,23,13
Jakelóng,ravencrest,1883,evoker,preservation,58,29,29
Däkuookami,twisting-nether,1881,evoker,preservation,42,28,14
Amadeusx,ravencrest,1881,evoker,preservation,108,53,55
Theories,aegwynn,1880,evoker,preservation,53,29,24
Baiyuekui,blackmoore,1879,evoker,preservation,410,206,204
Alusiedrake,ravencrest,1878,evoker,preservation,372,204,168
Адоннис,gordunni,1876,evoker,preservation,107,59,48
Jkdrage,stormscale,1874,evoker,preservation,98,45,53
Bümber,stormscale,1867,evoker,preservation,201,102,99
Dragondn,alleria,1865,evoker,preservation,54,37,17
Eccotwogay,frostwhisper,1862,evoker,preservation,112,57,55
Silverwingg,tarren-mill,1859,evoker,preservation,48,28,20
Titnoute,archimonde,1856,evoker,preservation,60,25,35
Gneltharion,draenor,1855,evoker,preservation,86,42,44
Лабирон,blackscar,1854,evoker,preservation,95,47,48
Nahfr,terenas,1852,evoker,preservation,222,118,104
Zaffira,kazzak,1850,evoker,preservation,48,27,21
Lurkî,blackhand,1850,evoker,preservation,354,179,175
Kapevok,sanguino,1848,evoker,preservation,150,89,61
Shroudflight,draenor,1847,evoker,preservation,412,211,201
Myshagini,ravencrest,1846,evoker,preservation,45,27,18
Odiin,dun-modr,1836,evoker,preservation,63,37,26
Ambuy,kazzak,1835,evoker,preservation,83,42,41
Hornyxj,draenor,1835,evoker,preservation,209,99,110
Dargenpont,turalyon,1834,evoker,preservation,113,59,54
Голдамбер,gordunni,1834,evoker,preservation,66,30,36
Yulinex,argent-dawn,1833,evoker,preservation,160,92,68
Keñwøød,ysondre,1832,evoker,preservation,66,37,29
Malboroasted,archimonde,1832,evoker,preservation,66,35,31
Ramfurry,kazzak,1831,evoker,preservation,460,226,234
Æzorahai,area-52,1830,evoker,preservation,84,38,46
Cellv,kazzak,1829,evoker,preservation,156,88,68
Runewing,turalyon,1827,evoker,preservation,53,30,23
Talim,terrordar,1827,evoker,preservation,90,44,46
Dârys,kazzak,1826,evoker,preservation,70,31,39
Aeste,dun-modr,1825,evoker,preservation,66,41,25
Froststraza,chamber-of-aspects,1825,evoker,preservation,66,31,35
Bòrís,kazzak,1821,evoker,preservation,30,28,2
Nakavoker,arygos,1820,evoker,preservation,244,118,126
Flipflapflop,twisting-nether,1817,evoker,preservation,53,31,22
Cptdrakon,twisting-nether,1815,evoker,preservation,105,58,47
Brynesuge,ragnaros,1813,evoker,preservation,218,117,101
Smâûg,silvermoon,1812,evoker,preservation,48,27,21
Mixn,argent-dawn,1812,evoker,preservation,93,41,52
Myshavion,hyjal,1810,evoker,preservation,107,50,57
Puffthemagic,archimonde,1810,evoker,preservation,60,28,32
Nhoru,stormscale,1807,evoker,preservation,64,32,32
Evodorie,ravencrest,1807,evoker,preservation,68,33,35
Wakûwakû,kazzak,1805,evoker,preservation,135,72,63
Thèrèse,hyjal,1805,evoker,preservation,84,42,42
Evokis,tarren-mill,1804,evoker,preservation,71,40,31
Трейш,soulflayer,1804,evoker,preservation,90,42,48
Novvae,hyjal,1802,evoker,preservation,96,55,41
Lerrastrasza,zirkel-des-cenarius,1802,evoker,preservation,48,24,24
Wernøker,archimonde,1800,evoker,preservation,83,40,43
Ксенондрейк,gordunni,1793,evoker,preservation,102,55,47
Kalevra,eredar,1791,evoker,preservation,187,98,89
Løcøtømmy,blackrock,1785,evoker,preservation,42,24,18
Justyowxs,archimonde,1782,evoker,preservation,139,74,65
Антошадф,gordunni,1779,evoker,preservation,72,39,33
Notkzii,argent-dawn,1777,evoker,preservation,42,19,23
Udewedu,ravencrest,1775,evoker,preservation,36,19,17
Бунтз,howling-fjord,1775,evoker,preservation,77,39,38
Yayaxoxoxoxo,hyjal,1775,evoker,preservation,54,25,29
Сайберри,gordunni,1768,evoker,preservation,60,28,32
Drakela,frostwhisper,1756,evoker,preservation,60,32,28
Dragonello,stormscale,1755,evoker,preservation,54,27,27
Setraxia,argent-dawn,1753,evoker,preservation,190,114,76
Detdragetid,zenedar,1751,evoker,preservation,139,64,75
Drookun,outland,1750,evoker,preservation,123,56,67
Evocy,ravencrest,1748,evoker,preservation,96,51,45
Soyd,dun-morogh,1747,evoker,preservation,57,33,24
Branados,argent-dawn,1747,evoker,preservation,66,38,28
Alphabét,ravencrest,1746,evoker,preservation,114,55,59
Yavak,blackmoore,1745,evoker,preservation,55,30,25
Хронолиса,blackscar,1738,evoker,preservation,407,205,202
Cynvoke,twisting-nether,1730,evoker,preservation,54,40,14
Trainsaw,kazzak,1724,evoker,preservation,90,48,42
Drakeadorie,twisting-nether,1723,evoker,preservation,72,36,36
Bugdul,twisting-nether,1713,evoker,preservation,74,46,28
Даэдра,gordunni,1712,evoker,preservation,186,94,92
Ранкондракон,lich-king,1712,evoker,preservation,95,42,53
Tetrís,blackhand,1712,evoker,preservation,50,21,29
Maxthecar,draenor,1710,evoker,preservation,136,87,49
Häröpallo,stormscale,1703,evoker,preservation,81,48,33
Infidus,ravencrest,1702,evoker,preservation,180,95,85
Dokkàmxk,archimonde,1702,evoker,preservation,48,21,27
Crocodeal,ysondre,1701,evoker,preservation,78,45,33
Jaje,nerathor,1701,evoker,preservation,46,24,22
Nst,zuljin,1700,evoker,preservation,36,21,15
Zemar,dalaran,1700,evoker,preservation,36,19,17
Nyghtx,sanguino,1698,evoker,preservation,100,45,55
Dragonsphera,sylvanas,1696,evoker,preservation,84,36,48
Luderx,outland,1695,evoker,preservation,160,95,65
Mìnos,drakthul,1695,evoker,preservation,132,64,68
Kanketo,ravencrest,1695,evoker,preservation,48,23,25
Dragóndééz,draenor,1694,evoker,preservation,66,33,33
Thairesse,archimonde,1690,evoker,preservation,66,33,33
Swooshz,ragnaros,1690,evoker,preservation,54,26,28
Kackaloch,tarren-mill,1689,evoker,preservation,81,46,35
Tombeelee,kazzak,1687,evoker,preservation,36,21,15
Camdaddy,magtheridon,1686,evoker,preservation,185,92,93
Healevoker,aegwynn,1686,evoker,preservation,237,111,126
Mobidra,twisting-nether,1683,evoker,preservation,64,34,30
Adriia,draenor,1680,evoker,preservation,48,24,24
Столаас,gordunni,1677,evoker,preservation,35,19,16
Valkroth,argent-dawn,1677,evoker,preservation,341,168,173
Castytopg,blackrock,1673,evoker,preservation,78,37,41
Reska,archimonde,1672,evoker,preservation,84,40,44
Buqxrawrr,antonidas,1670,evoker,preservation,62,36,26
Nekrosdrake,tarren-mill,1669,evoker,preservation,233,125,108
Roth,stormreaver,1669,evoker,preservation,495,249,246
Dragarius,tarren-mill,1669,evoker,preservation,108,43,65
Carrotz,doomhammer,1668,evoker,preservation,66,29,37
Вексалис,gordunni,1667,evoker,preservation,90,48,42
Ezinice,hyjal,1666,evoker,preservation,137,67,70
Mixoö,throkferoth,1664,evoker,preservation,78,39,39
Visage,kul-tiras,1662,evoker,preservation,169,85,84
Nahkiainen,darksorrow,1662,evoker,preservation,108,50,58
Аскми,blackscar,1658,evoker,preservation,130,59,71
Evoxter,twisting-nether,1656,evoker,preservation,147,78,69
Elleavo,tarren-mill,1655,evoker,preservation,122,55,67
Iblvicanfly,stormscale,1654,evoker,preservation,91,52,39
Bònéz,blackmoore,1654,evoker,preservation,267,134,133
Sebek,archimonde,1653,evoker,preservation,33,19,14
Kuubski,ravencrest,1652,evoker,preservation,116,62,54
Sedricae,twisting-nether,1649,evoker,preservation,155,83,72
Панераи,gordunni,1649,evoker,preservation,93,44,49
Rondog,moonglade,1648,evoker,preservation,60,32,28
Drazor,blackhand,1646,evoker,preservation,95,47,48
Lycêrâ,antonidas,1644,evoker,preservation,46,25,21
Jayrexx,doomhammer,1642,evoker,preservation,164,102,62
Solutionevok,aegwynn,1642,evoker,preservation,53,29,24
Ashmoo,archimonde,1640,evoker,preservation,54,28,26
Themasktw,kazzak,1640,evoker,preservation,129,57,72
Динамика,borean-tundra,1638,evoker,preservation,437,232,205
Mysaldo,sylvanas,1637,evoker,preservation,60,35,25
Valtion,stormscale,1634,evoker,preservation,48,26,22
Gg,wildhammer,1632,evoker,preservation,101,64,37
Rüllatorsven,stormscale,1631,evoker,preservation,36,21,15
Fearawr,malganis,1631,evoker,preservation,150,68,82
Draskathyr,sylvanas,1630,evoker,preservation,53,32,21
Тирэсплюс,soulflayer,1630,evoker,preservation,30,17,13
Kajer,nemesis,1630,evoker,preservation,36,19,17
Prevolol,outland,1629,evoker,preservation,60,40,20
Akly,nemesis,1627,evoker,preservation,66,41,25
Ацидракон,blackscar,1627,evoker,preservation,147,72,75
Malowux,outland,1626,evoker,preservation,42,22,20
Cutegirlx,blackrock,1626,evoker,preservation,36,17,19
Nexxà,archimonde,1624,evoker,preservation,147,95,52
Пидрактир,soulflayer,1624,evoker,preservation,101,50,51
Trixle,thrall,1624,evoker,preservation,66,28,38
Jcloud,shattered-hand,1623,evoker,preservation,77,44,33
Kda,die-nachtwache,1623,evoker,preservation,60,23,37
Judragon,kazzak,1622,evoker,preservation,50,21,29
Snällaldo,bladefist,1621,evoker,preservation,57,39,18
Skypov,sylvanas,1621,evoker,preservation,89,53,36
Escaaboy,stormscale,1621,evoker,preservation,40,19,21
Drgigapump,blackmoore,1621,evoker,preservation,36,17,19
Sinistrea,conseil-des-ombres,1620,evoker,preservation,147,84,63
Chronowalker,ragnaros,1620,evoker,preservation,41,22,19
Diläw,archimonde,1620,evoker,preservation,56,29,27
Qiasyr,hyjal,1620,evoker,preservation,46,20,26
Methamfetami,kazzak,1619,evoker,preservation,78,43,35
Âspên,archimonde,1619,evoker,preservation,308,151,157
Ariskesh,draenor,1616,evoker,preservation,35,23,12
Chasxstrasza,ravencrest,1616,evoker,preservation,54,20,34
Kwynus,archimonde,1615,evoker,preservation,36,18,18
Cith,ravencrest,1615,evoker,preservation,66,32,34
Полковниксан,soulflayer,1614,evoker,preservation,200,101,99
Louftarion,ysondre,1614,evoker,preservation,83,38,45
Blueaizu,draenor,1612,evoker,preservation,137,78,59
Gracyn,ravencrest,1612,evoker,preservation,64,34,30
Fartinhaler,ravencrest,1611,evoker,preservation,56,34,22
Drageye,tarren-mill,1611,evoker,preservation,213,120,93
Rawrus,blackrock,1611,evoker,preservation,101,49,52
Parodize,thrall,1610,evoker,preservation,67,37,30
Pcerainer,stormscale,1610,evoker,preservation,113,51,62
Потныйдракон,soulflayer,1608,evoker,preservation,48,23,25
Eryot,aggra-português,1606,evoker,preservation,191,94,97
Srache,frostwolf,1606,evoker,preservation,60,29,31
Berstrasz,frostwolf,1606,evoker,preservation,120,57,63
Rgedrake,blackrock,1605,evoker,preservation,114,67,47
Sysstrasza,archimonde,1604,evoker,preservation,95,55,40
Dracum,kazzak,1604,evoker,preservation,36,19,17
Reptak,stormscale,1603,evoker,preservation,48,27,21
Hjucen,twisting-nether,1603,evoker,preservation,90,49,41
Alamostrasza,doomhammer,1602,evoker,preservation,54,27,27
Bråckie,draenor,1600,evoker,preservation,84,49,35
Silversnakex,ravencrest,1598,evoker,preservation,54,30,24
Hîppokrates,dethecus,1596,evoker,preservation,77,50,27
Lytër,sanguino,1596,evoker,preservation,160,86,74
Kaipha,ravencrest,1596,evoker,preservation,89,43,46
Rackelhahn,azshara,1594,evoker,preservation,47,24,23
Rmplol,twisting-nether,1594,evoker,preservation,48,21,27
Kremost,sylvanas,1593,evoker,preservation,48,19,29
Féféledragon,archimonde,1591,evoker,preservation,134,66,68
Эндемический,soulflayer,1591,evoker,preservation,133,63,70
Etier,aegwynn,1590,evoker,preservation,102,58,44
Syrrah,kazzak,1585,evoker,preservation,60,26,34
Scarydragôn,draenor,1584,evoker,preservation,152,86,66
Cheryl,aggra-português,1583,evoker,preservation,37,18,19
Штеци,howling-fjord,1582,evoker,preservation,462,224,238
Крашевокер,soulflayer,1582,evoker,preservation,118,56,62
Medeostrasz,throkferoth,1581,evoker,preservation,36,22,14
Odensbest,silvermoon,1580,evoker,preservation,79,48,31
Ystarblaze,tarren-mill,1580,evoker,preservation,103,49,54
Dwagonzuv,the-maelstrom,1578,evoker,preservation,72,40,32
Profdrake,zuluhed,1578,evoker,preservation,84,40,44
Quoz,ragnaros,1577,evoker,preservation,63,23,40
Antiflexx,ragnaros,1571,evoker,preservation,82,40,42
Phyrrax,silvermoon,1569,evoker,preservation,94,50,44
Flowerscale,tarren-mill,1569,evoker,preservation,117,48,69
Бадикабаер,thermaplugg,1566,evoker,preservation,267,140,127
Devidra,defias-brotherhood,1564,evoker,preservation,308,144,164
Ятромантис,gordunni,1563,evoker,preservation,709,359,350
Detixbae,blackrock,1563,evoker,preservation,53,22,31
Îragnîr,sinstralis,1562,evoker,preservation,90,41,49
Sanktcs,blackhand,1562,evoker,preservation,79,35,44
Vyore,silvermoon,1560,evoker,preservation,66,34,32
Draelaynex,eredar,1560,evoker,preservation,75,37,38
Websensation,twisting-nether,1559,evoker,preservation,102,41,61
Sissilisko,sylvanas,1555,evoker,preservation,111,69,42
Siìre,thrall,1555,evoker,preservation,65,36,29
Blazelt,blackrock,1555,evoker,preservation,37,19,18
Vydrag,der-rat-von-dalaran,1553,evoker,preservation,35,17,18
Tannløsto,kazzak,1547,evoker,preservation,61,25,36
Oldwhiteman,guldan,1545,evoker,preservation,74,39,35
ßëkûsåùrús,ragnaros,1544,evoker,preservation,61,30,31
Dart,sanguino,1544,evoker,preservation,66,31,35
Zenvoker,silvermoon,1543,evoker,preservation,119,60,59
Sárkány,ravencrest,1541,evoker,preservation,84,41,43
Meteo,the-maelstrom,1537,evoker,preservation,68,40,28
Jpeo,blackhand,1537,evoker,preservation,66,33,33
Нежныйболт,howling-fjord,1536,evoker,preservation,134,68,66
Akaos,silvermoon,1536,evoker,preservation,127,53,74
Bountyk,sanguino,1533,evoker,preservation,24,16,8
Ryujinx,blackhand,1532,evoker,preservation,46,19,27
Wingard,twisting-nether,1531,evoker,preservation,41,25,16
Evizard,nagrand,1529,evoker,preservation,172,94,78
Antouxd,shadowsong,1529,evoker,preservation,67,34,33
Madbreath,cthun,1528,evoker,preservation,88,34,54
Omac,sylvanas,1527,evoker,preservation,137,64,73
Dracronix,the-maelstrom,1527,evoker,preservation,42,19,23
Bubbleblower,stormscale,1524,evoker,preservation,42,27,15
Navilism,kazzak,1523,evoker,preservation,512,271,241
Dragnthsnuts,sylvanas,1523,evoker,preservation,74,35,39
Johnpowell,defias-brotherhood,1522,evoker,preservation,34,17,17
Sürion,grim-batol,1520,evoker,preservation,84,44,40
Драгонпупс,soulflayer,1519,evoker,preservation,201,106,95
Copíl,stormscale,1519,evoker,preservation,70,35,35
Cuckingsock,drakthul,1518,evoker,preservation,51,24,27
Viseriøn,kazzak,1518,evoker,preservation,165,75,90
Pokemongame,draenor,1516,evoker,preservation,40,25,15
Ivokerz,tarren-mill,1516,evoker,preservation,60,28,32
Auti,draenor,1515,evoker,preservation,240,121,119
Kirivoker,dun-modr,1515,evoker,preservation,89,44,45
Mithrandir,marécage-de-zangar,1515,evoker,preservation,60,29,31
Ностепонснэк,ashenvale,1513,evoker,preservation,42,20,22
Peppapigsdad,outland,1511,evoker,preservation,36,19,17
Nanthira,darksorrow,1508,evoker,preservation,145,73,72
Polzeig,dentarg,1507,evoker,preservation,57,24,33
Voraxos,silvermoon,1506,evoker,preservation,48,29,19
Rhaenaya,tarren-mill,1506,evoker,preservation,266,139,127
Indragon,blackmoore,1505,evoker,preservation,108,52,56
Droyle,blackrock,1504,evoker,preservation,51,28,23
Xexií,blackmoore,1503,evoker,preservation,42,23,19
Зирухит,soulflayer,1499,evoker,preservation,151,73,78
Дарконикс,gordunni,1499,evoker,preservation,158,73,85
Kharduk,outland,1498,evoker,preservation,58,26,32
Eagleflow,aszune,1494,evoker,preservation,127,63,64
Kocaina,ravencrest,1492,evoker,preservation,33,20,13
Мефодийевок,howling-fjord,1492,evoker,preservation,102,49,53
Kelzoker,ysondre,1491,evoker,preservation,44,26,18
Superflyy,kazzak,1490,evoker,preservation,285,138,147
Tobbebakar,silvermoon,1490,evoker,preservation,48,22,26
Lytër,dun-modr,1488,evoker,preservation,63,28,35
Obbwoke,ravencrest,1486,evoker,preservation,120,53,67
Cirøvoke,ravencrest,1485,evoker,preservation,47,16,31
Viodragon,blackrock,1484,evoker,preservation,51,22,29
Snow,ysera,1483,evoker,preservation,101,51,50
Síire,ravencrest,1481,evoker,preservation,48,26,22
Baszz,aegwynn,1481,evoker,preservation,81,41,40
Didii,frostwhisper,1478,evoker,preservation,244,117,127
Minnimoi,zuluhed,1478,evoker,preservation,128,59,69
Th,stormscale,1477,evoker,preservation,78,50,28
Dunderone,kazzak,1476,evoker,preservation,148,69,79
Snackyeend,twisting-nether,1476,evoker,preservation,48,17,31
Donns,frostmane,1474,evoker,preservation,111,66,45
Emeraldino,twisting-nether,1474,evoker,preservation,36,16,20
Coarraze,eldrethalas,1470,evoker,preservation,71,37,34
Cokayn,eonar,1468,evoker,preservation,82,41,41
Pflanz,nozdormu,1467,evoker,preservation,48,29,19
Rngayzus,ysondre,1465,evoker,preservation,35,19,16
Liliwood,ravencrest,1464,evoker,preservation,335,168,167
Scottpula,tarren-mill,1462,evoker,preservation,41,18,23
Adromed,kazzak,1460,evoker,preservation,114,59,55
Samidr,ravencrest,1460,evoker,preservation,41,16,25
Vimoker,trollbane,1459,evoker,preservation,156,74,82
Kuramir,twisting-nether,1459,evoker,preservation,132,62,70
Lazurius,ravencrest,1459,evoker,preservation,107,45,62
Tabalugaqt,eredar,1458,evoker,preservation,75,37,38
Dragoncya,archimonde,1456,evoker,preservation,120,59,61
Драмуся,gordunni,1456,evoker,preservation,96,43,53
Djrabtah,sargeras,1455,evoker,preservation,105,56,49
Benedict,die-ewige-wacht,1455,evoker,preservation,42,19,23
Beefwing,xavius,1454,evoker,preservation,48,21,27
Blokie,silvermoon,1454,evoker,preservation,56,19,37
Драдексн,gordunni,1453,evoker,preservation,30,17,13
Madelynxoxo,draenor,1450,evoker,preservation,30,25,5
Lizardwizard,darksorrow,1450,evoker,preservation,42,23,19
Nerõ,thrall,1449,evoker,preservation,54,28,26
Орехдракона,gordunni,1448,evoker,preservation,48,26,22
Korialstraz,aegwynn,1447,evoker,preservation,59,33,26
Dägon,drakthul,1447,evoker,preservation,280,144,136
Bigaluga,blackmoore,1447,evoker,preservation,60,25,35
Dazaar,kazzak,1446,evoker,preservation,84,50,34
Ripgódx,bronzebeard,1444,evoker,preservation,372,190,182
Draxaer,outland,1443,evoker,preservation,447,234,213
Zarisd,tarren-mill,1443,evoker,preservation,103,50,53
Шкуроносец,gordunni,1442,evoker,preservation,36,20,16
Cragheart,ravencrest,1441,evoker,preservation,116,59,57
Krayvoker,tarren-mill,1439,evoker,preservation,59,26,33
Nutson,blackrock,1436,evoker,preservation,30,15,15
Conwoker,ravencrest,1435,evoker,preservation,30,15,15
Zezus,outland,1434,evoker,preservation,54,31,23
Poporaight,archimonde,1432,evoker,preservation,30,15,15
Dåseskjuul,kazzak,1431,evoker,preservation,76,42,34
Tarecgosa,sanguino,1431,evoker,preservation,245,118,127
Sakade,archimonde,1431,evoker,preservation,74,34,40
Dragonbrx,blackrock,1430,evoker,preservation,55,33,22
Drogon,nordrassil,1429,evoker,preservation,23,16,7
Dramarx,dun-modr,1428,evoker,preservation,24,15,9
Vafanede,twisting-nether,1427,evoker,preservation,48,18,30
Natashtrasza,tarren-mill,1427,evoker,preservation,72,26,46
Dmnzz,blackrock,1425,evoker,preservation,34,18,16
Scalo,kazzak,1425,evoker,preservation,143,73,70
Arniye,ravencrest,1422,evoker,preservation,175,91,84
Ptipangoevok,dalaran,1422,evoker,preservation,70,32,38
Mirajhti,blackrock,1421,evoker,preservation,118,57,61
Torae,burning-legion,1421,evoker,preservation,168,80,88
Greensmokey,sanguino,1420,evoker,preservation,24,16,8
Seboker,nemesis,1420,evoker,preservation,55,34,21
Sârmikas,blackhand,1420,evoker,preservation,30,15,15
Àtòmìc,malorne,1419,evoker,preservation,30,15,15
Yeatsa,blackmoore,1417,evoker,preservation,24,15,9
Nynnaydoth,drakthul,1417,evoker,preservation,178,95,83
Fubukinoryuu,frostwolf,1413,evoker,preservation,147,77,70
Psheetae,kazzak,1413,evoker,preservation,50,23,27
Lichbõrne,outland,1411,evoker,preservation,42,18,24
Baskoter,turalyon,1411,evoker,preservation,65,24,41
Beec,tarren-mill,1408,evoker,preservation,108,55,53
Draevil,emerald-dream,1406,evoker,preservation,83,45,38
Драксинед,howling-fjord,1406,evoker,preservation,129,65,64
Spiragon,ysondre,1406,evoker,preservation,154,76,78
Smrdimipytel,drakthul,1406,evoker,preservation,64,29,35
Cryuu,burning-legion,1404,evoker,preservation,36,15,21
Toadyx,eredar,1404,evoker,preservation,48,18,30
Dragio,blackrock,1403,evoker,preservation,54,29,25
Fiiery,deathwing,1403,evoker,preservation,129,62,67
Емари,howling-fjord,1401,evoker,preservation,49,33,16
Spánkpróof,kazzak,1401,evoker,preservation,43,24,19
Karristrasza,silvermoon,1401,evoker,preservation,36,18,18
Candicewho,twisting-nether,1400,evoker,preservation,30,15,15
Condrage,grim-batol,1399,evoker,preservation,108,55,53
Resectxz,kazzak,1399,evoker,preservation,118,58,60
Evoketing,tarren-mill,1396,evoker,preservation,24,15,9
Ragnai,sunstrider,1396,evoker,preservation,38,18,20
Drachenlilie,aegwynn,1396,evoker,preservation,84,39,45
Omnipøtens,silvermoon,1394,evoker,preservation,48,28,20
Scarlexo,ravencrest,1392,evoker,preservation,77,41,36
Faa,ravencrest,1391,evoker,preservation,60,31,29
Nadoney,hyjal,1389,evoker,preservation,67,42,25
Ammendorn,blackrock,1384,evoker,preservation,46,27,19
Rustynails,ragnaros,1384,evoker,preservation,48,17,31
Danriedrake,ravencrest,1383,evoker,preservation,41,22,19
Loveheart,die-aldor,1383,evoker,preservation,206,102,104
Azorgaron,outland,1383,evoker,preservation,60,26,34
Ëvølûtïøñ,pozzo-delleternità,1383,evoker,preservation,45,19,26
Asraestrasz,silvermoon,1380,evoker,preservation,38,24,14
Jamiewing,ravencrest,1380,evoker,preservation,42,25,17
Matysniak,burning-legion,1380,evoker,preservation,127,64,63
Ydun,blackrock,1380,evoker,preservation,114,53,61
Cinquanteuro,hyjal,1374,evoker,preservation,107,49,58
Awfultrash,archimonde,1372,evoker,preservation,42,16,26
Suhnrysanti,argent-dawn,1369,evoker,preservation,66,28,38
Schismxx,outland,1368,evoker,preservation,173,78,95
Hakuzah,terokkar,1367,evoker,preservation,36,19,17
Dragonsimp,archimonde,1360,evoker,preservation,34,20,14
Психея,soulflayer,1358,evoker,preservation,102,57,45
Blúéráý,ravencrest,1358,evoker,preservation,137,65,72
Dreamevoker,draenor,1358,evoker,preservation,35,16,19
Aêro,malganis,1358,evoker,preservation,79,35,44
Diezzounette,ysondre,1357,evoker,preservation,54,30,24
Eidachsal,antonidas,1357,evoker,preservation,111,39,72
Drackarys,tarren-mill,1354,evoker,preservation,72,35,37
Scalie,ravencrest,1353,evoker,preservation,54,31,23
Rhaenîra,twisting-nether,1352,evoker,preservation,49,27,22
Еваэльфийка,howling-fjord,1351,evoker,preservation,36,18,18
Flygfjås,stormscale,1350,evoker,preservation,195,100,95
Drakkujjer,twisting-nether,1348,evoker,preservation,53,28,25
Balgardarth,chamber-of-aspects,1348,evoker,preservation,48,24,24
Erhvoker,veknilash,1348,evoker,preservation,147,71,76
Kitoed,aegwynn,1344,evoker,preservation,78,35,43
Rayehm,hyjal,1344,evoker,preservation,54,22,32
Kryselakatos,dun-modr,1343,evoker,preservation,48,25,23
Zanarian,defias-brotherhood,1343,evoker,preservation,113,48,65
Vastorius,argent-dawn,1342,evoker,preservation,24,14,10
Dracanus,bronze-dragonflight,1342,evoker,preservation,112,55,57
Xdxd,burning-blade,1342,evoker,preservation,96,45,51
Skatt,aegwynn,1341,evoker,preservation,242,125,117
Soø,kazzak,1341,evoker,preservation,30,14,16
Dragondznutz,defias-brotherhood,1341,evoker,preservation,110,50,60
Alldru,outland,1341,evoker,preservation,83,31,52
Drdrag,blackmoore,1340,evoker,preservation,48,31,17
Novadrake,blackrock,1340,evoker,preservation,24,14,10
Folevo,stormreaver,1340,evoker,preservation,471,238,233
Маркзук,gordunni,1340,evoker,preservation,116,54,62
Drarent,hyjal,1340,evoker,preservation,54,24,30
Kimwoker,kazzak,1338,evoker,preservation,36,17,19
Xdingo,blackrock,1338,evoker,preservation,36,14,22
Argnir,archimonde,1337,evoker,preservation,30,14,16
Evoris,frostmane,1337,evoker,preservation,108,47,61
Голденджо,gordunni,1336,evoker,preservation,77,31,46
Imperiux,outland,1335,evoker,preservation,66,39,27
Emberturd,blackmoore,1335,evoker,preservation,74,35,39
Ривалгодх,blackscar,1332,evoker,preservation,57,36,21
Лесанор,gordunni,1332,evoker,preservation,35,18,17
Pindaar,zenedar,1332,evoker,preservation,90,43,47
Druggz,burning-blade,1331,evoker,preservation,54,35,19
Icemushu,twisting-nether,1331,evoker,preservation,24,14,10
Ludracy,antonidas,1331,evoker,preservation,114,62,52
Sitdownnow,blackrock,1331,evoker,preservation,111,53,58
Wïligun,archimonde,1330,evoker,preservation,24,15,9
Spyróò,ravencrest,1330,evoker,preservation,88,39,49
Lizandros,blackrock,1330,evoker,preservation,60,26,34
Feloñ,blackrock,1328,evoker,preservation,54,26,28
Brxdragon,antonidas,1327,evoker,preservation,77,44,33
Gissthebuzzy,dun-modr,1326,evoker,preservation,42,24,18
Wrcdragon,drakthul,1325,evoker,preservation,224,109,115
Создать,deathguard,1324,evoker,preservation,55,33,22
Desnø,frostwolf,1324,evoker,preservation,42,24,18
Fetzi,blackhand,1324,evoker,preservation,126,63,63
Wambino,ravencrest,1324,evoker,preservation,60,29,31
Dragonflye,kazzak,1324,evoker,preservation,202,96,106
Chaks,ravencrest,1323,evoker,preservation,48,23,25
Maudragosa,blackmoore,1322,evoker,preservation,111,59,52
Ruszymondias,argent-dawn,1319,evoker,preservation,60,26,34
Airwaves,hyjal,1318,evoker,preservation,65,35,30
Woeisme,blackhand,1317,evoker,preservation,45,21,24
Uroegevoker,twisting-nether,1316,evoker,preservation,68,36,32
Breall,tarren-mill,1315,evoker,preservation,911,447,464
Dodgens,auchindoun,1315,evoker,preservation,30,14,16
Звездобык,borean-tundra,1315,evoker,preservation,48,21,27
Dárnast,draenor,1314,evoker,preservation,24,14,10
Ámenó,stormscale,1314,evoker,preservation,51,25,26
Darigo,ravencrest,1313,evoker,preservation,81,39,42
Eedava,argent-dawn,1312,evoker,preservation,42,25,17
Fredgobrr,tarren-mill,1312,evoker,preservation,126,74,52
Dumbledrogen,ragnaros,1311,evoker,preservation,72,43,29
Choubalo,archimonde,1311,evoker,preservation,265,133,132
Crunktusk,twisting-nether,1310,evoker,preservation,72,27,45
Thellon,frostwolf,1308,evoker,preservation,97,49,48
Zygumy,hyjal,1306,evoker,preservation,30,14,16
Xerragon,ravencrest,1306,evoker,preservation,60,20,40
Dagruel,exodar,1305,evoker,preservation,30,14,16
Horiz,kazzak,1302,evoker,preservation,36,14,22
Louiekin,outland,1302,evoker,preservation,36,14,22
Burningflo,naxxramas,1301,evoker,preservation,44,27,17
Miscodevoker,twisting-nether,1300,evoker,preservation,28,15,13
Spudvoker,silvermoon,1300,evoker,preservation,48,23,25
Esalisko,kazzak,1299,evoker,preservation,60,34,26
Mikevoker,aegwynn,1297,evoker,preservation,48,29,19
Ìzànamì,hyjal,1297,evoker,preservation,87,51,36
Nonolildrake,ysondre,1297,evoker,preservation,82,46,36
Vahamut,argent-dawn,1297,evoker,preservation,42,22,20
Nikoo,runetotem,1297,evoker,preservation,90,45,45
Saga,aegwynn,1297,evoker,preservation,184,90,94
Rescuegirl,blackrock,1297,evoker,preservation,105,51,54
Ятутглавный,howling-fjord,1297,evoker,preservation,93,45,48
Chronicryder,draenor,1296,evoker,preservation,57,22,35
Dragonerr,kiljaeden,1293,evoker,preservation,86,47,39
Burndaddy,dun-modr,1292,evoker,preservation,53,28,25
Skrix,khadgar,1292,evoker,preservation,69,34,35
Thyrke,aegwynn,1289,evoker,preservation,242,122,120
Absoto,dun-morogh,1288,evoker,preservation,23,14,9
Ricidevo,nerathor,1288,evoker,preservation,60,22,38
Dothemath,blackmoore,1285,evoker,preservation,136,63,73
Pelington,silvermoon,1285,evoker,preservation,77,34,43
Søâ,blackrock,1285,evoker,preservation,53,22,31
Ксдз,soulflayer,1284,evoker,preservation,44,22,22
Drgnokn,silvermoon,1283,evoker,preservation,106,62,44
Riihi,twisting-nether,1283,evoker,preservation,69,33,36
Cothikos,ysondre,1282,evoker,preservation,34,15,19
Lohis,grim-batol,1282,evoker,preservation,42,15,27
Mercoledi,aegwynn,1280,evoker,preservation,42,29,13
Xiomarita,frostmane,1280,evoker,preservation,60,29,31
Draagon,burning-legion,1280,evoker,preservation,42,18,24
Anso,sanguino,1279,evoker,preservation,137,74,63
Zaoexo,defias-brotherhood,1278,evoker,preservation,60,28,32
Wokevon,ravencrest,1277,evoker,preservation,76,44,32
Varkoth,nemesis,1277,evoker,preservation,118,55,63
Dragondisnut,sylvanas,1276,evoker,preservation,54,28,26
Deflamee,draenor,1275,evoker,preservation,62,35,27
Lynastrasza,silvermoon,1274,evoker,preservation,147,78,69
Zeigrem,antonidas,1273,evoker,preservation,24,17,7
Dragonspaff,argent-dawn,1273,evoker,preservation,44,23,21
Dedx,sylvanas,1273,evoker,preservation,42,20,22
Kleftra,stormscale,1273,evoker,preservation,50,21,29
Aphi,frostwolf,1272,evoker,preservation,99,52,47
Elenaevoker,stormscale,1272,evoker,preservation,208,107,101
Beharot,silvermoon,1272,evoker,preservation,96,33,63
Malfø,exodar,1271,evoker,preservation,145,73,72
Woke,the-venture-co,1271,evoker,preservation,42,17,25
Sondosa,twisting-nether,1270,evoker,preservation,36,18,18
Vyron,amanthul,1270,evoker,preservation,52,22,30
Discodidling,silvermoon,1269,evoker,preservation,74,37,37
Evokazoran,dentarg,1269,evoker,preservation,90,30,60
Awaboo,draenor,1268,evoker,preservation,30,16,14
Дрэгтир,lich-king,1266,evoker,preservation,205,112,93
Ithijin,blackmoore,1266,evoker,preservation,113,55,58
Giü,archimonde,1266,evoker,preservation,183,86,97
Bìå,ravencrest,1265,evoker,preservation,23,18,5
Cxsmetic,antonidas,1265,evoker,preservation,39,23,16
Dorkthyr,sylvanas,1264,evoker,preservation,182,93,89
Goalkeeper,ravencrest,1264,evoker,preservation,90,44,46
Mjkevo,tarren-mill,1264,evoker,preservation,60,27,33
Sudrac,antonidas,1263,evoker,preservation,42,21,21
Howtodragon,twisting-nether,1262,evoker,preservation,48,26,22
Aebivoker,dalaran,1261,evoker,preservation,88,48,40
Modini,blackrock,1261,evoker,preservation,78,38,40
Heilzan,dalaran,1258,evoker,preservation,34,18,16
Виндигос,soulflayer,1258,evoker,preservation,42,19,23
Эбиб,gordunni,1257,evoker,preservation,160,90,70
Colacorta,zuljin,1257,evoker,preservation,231,119,112
Badrig,silvermoon,1256,evoker,preservation,181,88,93
Detdragetid,stormscale,1254,evoker,preservation,36,21,15
Dayandnight,quelthalas,1254,evoker,preservation,127,64,63
Хвзрываюсьх,howling-fjord,1252,evoker,preservation,102,51,51
Firaxis,kazzak,1252,evoker,preservation,30,14,16
Drakhtyr,draenor,1251,evoker,preservation,48,29,19
Nhervo,hyjal,1251,evoker,preservation,83,39,44
Dinotron,uldaman,1249,evoker,preservation,54,27,27
Cenca,blackmoore,1248,evoker,preservation,222,105,117
Aphelïon,dun-modr,1248,evoker,preservation,214,100,114
Ecovoker,outland,1247,evoker,preservation,24,13,11
Drogøn,khaz-modan,1247,evoker,preservation,48,23,25
Smokitor,kazzak,1246,evoker,preservation,54,28,26
Elpolioloco,culte-de-la-rive-noire,1246,evoker,preservation,30,13,17
Últimdrac,dun-modr,1245,evoker,preservation,30,13,17
Nazalath,eonar,1245,evoker,preservation,42,18,24
Rullatorsvên,sylvanas,1244,evoker,preservation,24,13,11
Rsol,kirin-tor,1244,evoker,preservation,44,20,24
Rozugos,blackrock,1243,evoker,preservation,24,13,11
Crottedezen,archimonde,1243,evoker,preservation,30,13,17
Apaçi,ravencrest,1243,evoker,preservation,51,19,32
Jugzie,twisting-nether,1243,evoker,preservation,36,13,23
Coaxoch,thunderhorn,1242,evoker,preservation,24,14,10
Muccavok,stormrage,1242,evoker,preservation,91,51,40
Holyvoker,aegwynn,1242,evoker,preservation,24,13,11
Gloris,aegwynn,1242,evoker,preservation,63,34,29
Mortlalune,conseil-des-ombres,1241,evoker,preservation,168,83,85
Släshés,ravencrest,1241,evoker,preservation,30,14,16
Boonvoker,the-maelstrom,1241,evoker,preservation,138,61,77
Nagoli,silvermoon,1240,evoker,preservation,67,31,36
Ladrieth,hyjal,1239,evoker,preservation,135,62,73
Kymura,archimonde,1239,evoker,preservation,30,13,17
Stjáuni,ravencrest,1238,evoker,preservation,64,33,31
Тектрис,howling-fjord,1238,evoker,preservation,126,58,68
Парадпланет,howling-fjord,1238,evoker,preservation,83,35,48
Teneja,malganis,1237,evoker,preservation,30,13,17
Kampe,nemesis,1236,evoker,preservation,72,36,36
Yorfyr,ravencrest,1234,evoker,preservation,43,20,23
Deathwinng,twisting-nether,1234,evoker,preservation,112,52,60
Dragonban,tarren-mill,1234,evoker,preservation,88,34,54
Xorago,guldan,1233,evoker,preservation,106,53,53
Tenibris,die-nachtwache,1233,evoker,preservation,251,109,142
Kujira,draenor,1232,evoker,preservation,63,34,29
Yeetsera,thrall,1229,evoker,preservation,76,35,41
Beenus,doomhammer,1228,evoker,preservation,36,24,12
Nagimurr,kazzak,1228,evoker,preservation,141,71,70
Glouglouti,drekthar,1228,evoker,preservation,90,45,45
Драгоблуд,soulflayer,1227,evoker,preservation,54,25,29
Âbs,archimonde,1227,evoker,preservation,99,41,58
Ragnon,blackrock,1226,evoker,preservation,82,41,41
Drachenglas,antonidas,1226,evoker,preservation,72,33,39
Distinkd,draenor,1221,evoker,preservation,60,32,28
Уконэ,blackscar,1221,evoker,preservation,83,41,42
Cudius,archimonde,1220,evoker,preservation,128,72,56
Kalerinozi,blackhand,1219,evoker,preservation,109,49,60
Мвпгуччи,blackscar,1219,evoker,preservation,36,13,23
Drakdilla,tarren-mill,1216,evoker,preservation,24,13,11
Sorextrazy,twisting-nether,1216,evoker,preservation,143,69,74
Tsukiko,archimonde,1216,evoker,preservation,73,35,38
Shnptyr,ragnaros,1215,evoker,preservation,42,22,20
Setoc,blackrock,1215,evoker,preservation,31,15,16
Lojinevo,twisting-nether,1215,evoker,preservation,95,43,52
Tettareddast,kazzak,1214,evoker,preservation,62,29,33
Uztfuzt,blackmoore,1213,evoker,preservation,55,35,20
Ruinastrasza,silvermoon,1212,evoker,preservation,24,13,11
Vaermithor,tarren-mill,1212,evoker,preservation,98,50,48
Fôxxyguard,azshara,1212,evoker,preservation,36,17,19
Shosho,uldaman,1212,evoker,preservation,68,28,40
Varaug,veklor,1211,evoker,preservation,40,25,15
Nordbert,draenor,1211,evoker,preservation,95,45,50
Lynt,burning-blade,1210,evoker,preservation,90,44,46
Mesarin,eredar,1210,evoker,preservation,30,13,17
Everdrop,blackmoore,1209,evoker,preservation,24,13,11
Tokidormi,nemesis,1209,evoker,preservation,36,17,19
Flyingaway,tarren-mill,1209,evoker,preservation,42,19,23
Amaterãsu,kazzak,1208,evoker,preservation,131,66,65
Therzer,drakthul,1208,evoker,preservation,54,25,29
Kutdraak,laughing-skull,1206,evoker,preservation,36,20,16
Khaela,archimonde,1206,evoker,preservation,153,79,74
Drakutyr,defias-brotherhood,1205,evoker,preservation,49,27,22
Мэриджэин,soulflayer,1205,evoker,preservation,41,18,23
Draghini,silvermoon,1205,evoker,preservation,48,20,28
Whitelizzard,tarren-mill,1204,evoker,preservation,80,39,41
Sqedidragon,burning-legion,1203,evoker,preservation,48,15,33
Flawxy,blackmoore,1200,evoker,preservation,30,17,13
Lapaneri,sylvanas,1200,evoker,preservation,36,14,22
Azwel,khaz-modan,1198,evoker,preservation,82,44,38
Asharys,argent-dawn,1198,evoker,preservation,82,33,49
Aayala,dalaran,1196,evoker,preservation,44,24,20
Corneflex,chogall,1196,evoker,preservation,27,13,14
Sarapakara,burning-blade,1195,evoker,preservation,68,28,40
Drashiku,zuljin,1195,evoker,preservation,168,68,100
Saucy,sanguino,1194,evoker,preservation,85,48,37
Viserione,outland,1194,evoker,preservation,24,13,11
Lagadta,antonidas,1194,evoker,preservation,84,44,40
Пероник,gordunni,1194,evoker,preservation,184,86,98
Kuzzan,blackhand,1193,evoker,preservation,48,23,25
Ogzan,stormscale,1191,evoker,preservation,66,34,32
Tusibi,hyjal,1190,evoker,preservation,83,53,30
Asinitaris,ravencrest,1189,evoker,preservation,116,57,59
Sibvoker,kazzak,1188,evoker,preservation,108,52,56
Smoochbumble,argent-dawn,1188,evoker,preservation,27,13,14
Патриотика,howling-fjord,1188,evoker,preservation,206,98,108
Salamanderx,stormscale,1186,evoker,preservation,22,14,8
Fusion,dun-modr,1186,evoker,preservation,84,41,43
Dragawn,grim-batol,1185,evoker,preservation,281,145,136
Drakatha,kazzak,1185,evoker,preservation,113,56,57
Dratheon,dun-modr,1185,evoker,preservation,150,69,81
Leblon,stormreaver,1182,evoker,preservation,66,33,33
Plexd,alleria,1182,evoker,preservation,60,26,34
Drackheal,kaelthas,1181,evoker,preservation,71,35,36
Crazylucifer,kazzak,1181,evoker,preservation,32,15,17
Thundermifln,nemesis,1180,evoker,preservation,78,38,40
Filtendragon,stormscale,1179,evoker,preservation,90,38,52
Orocimaaru,pozzo-delleternità,1178,evoker,preservation,76,34,42
Belkavoker,zirkel-des-cenarius,1177,evoker,preservation,42,14,28
Molem,defias-brotherhood,1176,evoker,preservation,128,62,66
Irvethius,argent-dawn,1175,evoker,preservation,24,13,11
Fumfum,twisting-nether,1174,evoker,preservation,42,19,23
Urelix,ragnaros,1172,evoker,preservation,20,14,6
Zethreus,silvermoon,1171,evoker,preservation,70,36,34
Ohcaralho,outland,1171,evoker,preservation,62,25,37
Dratsch,blackhand,1170,evoker,preservation,24,17,7
Emolion,draenor,1168,evoker,preservation,60,20,40
Dreiwyn,kazzak,1165,evoker,preservation,60,39,21
Awerdoos,burning-legion,1165,evoker,preservation,84,38,46
Iscale,twisting-nether,1164,evoker,preservation,145,73,72
Dolphdrago,outland,1164,evoker,preservation,46,23,23
Meyowuo,doomhammer,1164,evoker,preservation,58,22,36
Nurilla,twisting-nether,1159,evoker,preservation,41,23,18
Theocean,turalyon,1158,evoker,preservation,301,138,163
Dracobelli,drakthul,1157,evoker,preservation,30,14,16
Dangai,draenor,1157,evoker,preservation,35,15,20
Rosestrasza,drakthul,1154,evoker,preservation,34,23,11
Naloqa,frostwolf,1153,evoker,preservation,31,13,18
Evyzz,blackmoore,1152,evoker,preservation,18,12,6
Jmy,bloodhoof,1152,evoker,preservation,18,12,6
Lînkôs,aegwynn,1151,evoker,preservation,83,43,40
Hehehihihaha,ravencrest,1151,evoker,preservation,24,12,12
Flatterhipy,blackrock,1151,evoker,preservation,24,12,12
Wingzy,chogall,1151,evoker,preservation,240,112,128
Лунарфоллс,howling-fjord,1150,evoker,preservation,18,12,6
Iandret,destromath,1150,evoker,preservation,25,12,13
Theflight,ravencrest,1150,evoker,preservation,30,12,18
Jupezi,sylvanas,1149,evoker,preservation,85,43,42
Kerandina,alleria,1149,evoker,preservation,30,15,15
Dragonkim,draenor,1149,evoker,preservation,30,12,18
Favera,taerar,1149,evoker,preservation,36,14,22
Monftroglou,archimonde,1148,evoker,preservation,30,12,18
Laurenzos,tarren-mill,1148,evoker,preservation,30,12,18
Veryspikes,twisting-nether,1148,evoker,preservation,30,12,18
Groovyy,hyjal,1145,evoker,preservation,114,61,53
Uwudyret,tarren-mill,1145,evoker,preservation,30,12,18
Råcòoñ,ravencrest,1144,evoker,preservation,24,12,12
Sinusiitiis,destromath,1142,evoker,preservation,18,12,6
Рептаиль,howling-fjord,1142,evoker,preservation,71,32,39
Geckonen,stormreaver,1141,evoker,preservation,249,121,128
Elaijaz,turalyon,1140,evoker,preservation,72,45,27
Drakeish,kazzak,1140,evoker,preservation,35,16,19
Ryujíin,kazzak,1139,evoker,preservation,23,12,11
Blamdrake,blackhand,1139,evoker,preservation,135,60,75
Syrax,burning-blade,1138,evoker,preservation,18,12,6
Jimmytrivet,archimonde,1137,evoker,preservation,142,64,78
Clamtucker,twisting-nether,1135,evoker,preservation,54,16,38
Flymetothemo,twisting-nether,1134,evoker,preservation,75,41,34
Runs,ravencrest,1134,evoker,preservation,186,92,94
Dragonna,argent-dawn,1134,evoker,preservation,123,60,63
Блэкмакарти,soulflayer,1134,evoker,preservation,36,12,24
Hems,bronzebeard,1133,evoker,preservation,124,65,59
Nisiris,doomhammer,1133,evoker,preservation,88,44,44
Кровит,soulflayer,1133,evoker,preservation,40,14,26
Darkstrasza,hellfire,1132,evoker,preservation,18,12,6
Bestofriendo,eredar,1132,evoker,preservation,112,59,53
Verithian,kazzak,1131,evoker,preservation,84,39,45
Syccs,blackrock,1130,evoker,preservation,24,12,12
Steeken,haomarush,1130,evoker,preservation,66,32,34
Adnoc,tarren-mill,1127,evoker,preservation,37,17,20
Hyggëê,sanguino,1127,evoker,preservation,70,25,45
Draknr,alakir,1125,evoker,preservation,42,16,26
Djolero,silvermoon,1124,evoker,preservation,60,28,32
Twocats,twisting-nether,1124,evoker,preservation,35,14,21
Raikirix,silvermoon,1123,evoker,preservation,24,12,12
Siderion,drakthul,1122,evoker,preservation,24,14,10
Gilgakek,darksorrow,1120,evoker,preservation,122,58,64
Raøug,blackmoore,1119,evoker,preservation,126,50,76
Kharalambos,stormscale,1118,evoker,preservation,48,21,27
Юнигоса,soulflayer,1117,evoker,preservation,28,14,14
Pe,dalaran,1117,evoker,preservation,24,12,12
Draktoros,kazzak,1117,evoker,preservation,50,23,27
Trellie,die-aldor,1116,evoker,preservation,23,12,11
Dracarysfire,kazzak,1116,evoker,preservation,30,15,15
Eosin,blackrock,1115,evoker,preservation,35,18,17
Drogoon,ravencrest,1114,evoker,preservation,29,12,17
Scaleyfurry,azshara,1113,evoker,preservation,34,23,11
Chrisussy,argent-dawn,1111,evoker,preservation,35,12,23
Kekvoker,antonidas,1107,evoker,preservation,84,37,47
Huusdrache,outland,1107,evoker,preservation,34,14,20
Renistra,argent-dawn,1105,evoker,preservation,102,49,53
Spïzz,dun-modr,1103,evoker,preservation,72,31,41
Bombrush,ragnaros,1102,evoker,preservation,33,20,13
Dracwyn,shattrath,1102,evoker,preservation,43,19,24
Kédragon,archimonde,1102,evoker,preservation,31,13,18
Stormwing,twilights-hammer,1098,evoker,preservation,77,35,42
Алекстраса,blackscar,1097,evoker,preservation,30,16,14
Dmn,defias-brotherhood,1097,evoker,preservation,54,24,30
Azdajae,gilneas,1096,evoker,preservation,42,25,17
Kurger,twisting-nether,1096,evoker,preservation,98,42,56
Tennin,thrall,1095,evoker,preservation,63,33,30
Saphirá,hyjal,1094,evoker,preservation,28,13,15
Frreeyya,silvermoon,1094,evoker,preservation,29,13,16
Xidalulz,sylvanas,1093,evoker,preservation,12,12,0
Douevnfly,ravencrest,1093,evoker,preservation,105,52,53
Nebulai,silvermoon,1093,evoker,preservation,60,25,35
Slimygecko,ravencrest,1090,evoker,preservation,94,44,50
Mugeki,burning-legion,1089,evoker,preservation,68,31,37
Чвкдрагонит,soulflayer,1088,evoker,preservation,66,27,39
Dräcø,dalaran,1087,evoker,preservation,52,30,22
Шадофдрагон,deathweaver,1087,evoker,preservation,115,64,51
Tussyy,exodar,1084,evoker,preservation,60,26,34
Theurdragon,blades-edge,1084,evoker,preservation,97,40,57
Doriangray,drakthul,1082,evoker,preservation,38,19,19
Targzæ,hyjal,1082,evoker,preservation,36,15,21
Draakoñ,outland,1082,evoker,preservation,29,12,17
Richterscale,defias-brotherhood,1080,evoker,preservation,96,35,61
Bambusák,draenor,1076,evoker,preservation,236,104,132
Blackli,kazzak,1074,evoker,preservation,33,14,19
Pikiscalez,bronzebeard,1073,evoker,preservation,30,15,15
Bullettail,silvermoon,1073,evoker,preservation,55,18,37
Zaverion,nathrezim,1072,evoker,preservation,97,51,46
Dontiá,draenor,1072,evoker,preservation,188,95,93
Огнеметчег,razuvious,1070,evoker,preservation,71,41,30
Ärt,argent-dawn,1068,evoker,preservation,114,46,68
Iphonetwo,ravencrest,1067,evoker,preservation,50,28,22
Killafoolz,kazzak,1067,evoker,preservation,25,12,13
Rafale,the-maelstrom,1063,evoker,preservation,270,133,137
Cazé,archimonde,1062,evoker,preservation,60,29,31
Guntoker,tarren-mill,1062,evoker,preservation,156,73,83
Dreamiee,kazzak,1062,evoker,preservation,108,50,58
Lusacan,tarren-mill,1058,evoker,preservation,57,28,29
Llwyin,ragnaros,1058,evoker,preservation,62,28,34
Lazorkröte,blackrock,1058,evoker,preservation,72,26,46
Hool,silvermoon,1057,evoker,preservation,285,142,143
Øoøoøoøo,outland,1056,evoker,preservation,12,11,1
Вискписк,soulflayer,1056,evoker,preservation,12,11,1
Berlyvoke,stormscale,1056,evoker,preservation,18,11,7
Launisch,amanthul,1056,evoker,preservation,24,11,13
Fûrý,twisting-nether,1056,evoker,preservation,24,11,13
Drâcarys,destromath,1055,evoker,preservation,116,64,52
Jessamy,ragnaros,1055,evoker,preservation,24,11,13
Xiarya,draenor,1055,evoker,preservation,24,11,13
Tarystrasza,blackrock,1055,evoker,preservation,42,16,26
Lacer,minahonda,1055,evoker,preservation,30,11,19
Elathru,kazzak,1055,evoker,preservation,48,17,31
Tojodormi,argent-dawn,1054,evoker,preservation,24,11,13
Enzetrius,argent-dawn,1054,evoker,preservation,24,11,13
Adrienne,steamwheedle-cartel,1054,evoker,preservation,30,13,17
Drdrayk,balnazzar,1051,evoker,preservation,24,11,13
Momodragon,draenor,1050,evoker,preservation,18,11,7
Beetk,tarren-mill,1049,evoker,preservation,24,11,13
Reolden,stormscale,1048,evoker,preservation,20,11,9
Manegø,eredar,1048,evoker,preservation,24,11,13
Twokgbananas,blackhand,1047,evoker,preservation,30,11,19
Deathwingx,sylvanas,1046,evoker,preservation,24,11,13
Tritiana,blackrock,1046,evoker,preservation,36,11,25
Meshuggåh,deathwing,1045,evoker,preservation,138,56,82
Zenbaka,marécage-de-zangar,1044,evoker,preservation,24,11,13
Deathgodsh,draenor,1043,evoker,preservation,38,16,22
Pyrestra,argent-dawn,1042,evoker,preservation,18,11,7
Zonye,archimonde,1042,evoker,preservation,38,16,22
Alicendre,hyjal,1040,evoker,preservation,18,11,7
Wtwt,draenor,1040,evoker,preservation,36,11,25
Predatax,drakthul,1039,evoker,preservation,142,71,71
Artïa,archimonde,1039,evoker,preservation,54,27,27
Iceslinger,stormscale,1036,evoker,preservation,143,69,74
Haawwt,eredar,1035,evoker,preservation,48,20,28
Axuli,blackrock,1035,evoker,preservation,41,17,24
Antistrasza,argent-dawn,1033,evoker,preservation,48,22,26
Dioni,sylvanas,1033,evoker,preservation,51,22,29
Pixxell,blackmoore,1031,evoker,preservation,59,32,27
Chrisú,thrall,1029,evoker,preservation,30,12,18
Athyrstria,blackmoore,1028,evoker,preservation,65,18,47
Shenronox,ragnaros,1026,evoker,preservation,58,25,33
Zathîel,argent-dawn,1026,evoker,preservation,149,64,85
Lizardofoz,argent-dawn,1023,evoker,preservation,42,23,19
Fernasdrake,aggra-português,1023,evoker,preservation,42,21,21
Koristrasza,ravencrest,1022,evoker,preservation,36,15,21
Ovipare,archimonde,1021,evoker,preservation,45,24,21
Kärlethos,dun-modr,1020,evoker,preservation,24,12,12
Nurant,blackmoore,1020,evoker,preservation,209,98,111
Drâker,twisting-nether,1020,evoker,preservation,35,11,24
Aarón,der-mithrilorden,1019,evoker,preservation,23,11,12
Gilarys,silvermoon,1019,evoker,preservation,23,11,12
Chromatus,azjolnerub,1018,evoker,preservation,57,31,26
Aezthaza,outland,1018,evoker,preservation,26,12,14
Markies,chogall,1018,evoker,preservation,51,20,31
Kamings,outland,1016,evoker,preservation,44,28,16
Dractarys,arathi,1016,evoker,preservation,96,47,49
Драколайт,eversong,1015,evoker,preservation,24,11,13
Nochance,dentarg,1015,evoker,preservation,193,85,108
Offering,ravencrest,1015,evoker,preservation,30,11,19
Klim,temple-noir,1014,evoker,preservation,42,11,31
Bimbola,sanguino,1013,evoker,preservation,24,12,12
Jurrassic,defias-brotherhood,1013,evoker,preservation,123,61,62
Гопоп,gordunni,1011,evoker,preservation,31,14,17
Ewings,archimonde,1009,evoker,preservation,54,18,36
Hateroll,ravencrest,1008,evoker,preservation,24,13,11
Retyss,twisting-nether,1008,evoker,preservation,390,193,197
Blewjobs,sylvanas,1007,evoker,preservation,137,65,72
Blackwing,twilights-hammer,1007,evoker,preservation,75,34,41
Belledejour,magtheridon,1005,evoker,preservation,70,23,47
Лалиса,soulflayer,1003,evoker,preservation,36,12,24
Xzarak,kazzak,1001,evoker,preservation,30,11,19
Мйлкйвей,deathguard,1000,evoker,preservation,52,32,20
Blazeros,sylvanas,1000,evoker,preservation,60,34,26
Thedrake,aegwynn,1000,evoker,preservation,53,30,23
Kyrathir,hyjal,1000,evoker,preservation,72,31,41
Archont,eredar,999,evoker,preservation,42,12,30
Escamosa,exodar,998,evoker,preservation,66,20,46
Morlie,argent-dawn,996,evoker,preservation,82,37,45
Ophois,malygos,995,evoker,preservation,16,12,4
Liane,drakthul,994,evoker,preservation,48,19,29
Lemustache,argent-dawn,994,evoker,preservation,36,12,24
Капрал,gordunni,993,evoker,preservation,39,14,25
Palindre,argent-dawn,991,evoker,preservation,101,50,51
Evooke,outland,989,evoker,preservation,34,11,23
Viseron,zuljin,987,evoker,preservation,155,63,92
Deadfyre,dun-modr,986,evoker,preservation,30,15,15
Hios,twisting-nether,984,evoker,preservation,60,33,27
Kraaznus,ravencrest,984,evoker,preservation,20,11,9
Gantsu,blackhand,984,evoker,preservation,102,50,52
Schenlong,kelthuzad,982,evoker,preservation,114,52,62
Voryax,kirin-tor,981,evoker,preservation,118,56,62
Vicmilo,sanguino,981,evoker,preservation,36,16,20
Kirinde,draenor,978,evoker,preservation,230,100,130
Taynia,stormscale,978,evoker,preservation,28,12,16
Pigioto,silvermoon,973,evoker,preservation,234,116,118
Norgam,chogall,967,evoker,preservation,24,15,9
Adula,azjolnerub,965,evoker,preservation,60,23,37
Алифсе,howling-fjord,965,evoker,preservation,84,23,61
Drazikz,archimonde,964,evoker,preservation,112,58,54
Æwárosaurus,ravencrest,963,evoker,preservation,31,15,16
Voltyrh,antonidas,962,evoker,preservation,25,11,14
Drakares,la-croisade-écarlate,962,evoker,preservation,54,19,35
Drâkarys,khaz-modan,961,evoker,preservation,63,24,39
Cinnamoon,defias-brotherhood,960,evoker,preservation,21,12,9
Konzaa,argent-dawn,960,evoker,preservation,18,10,8
Rexerection,silvermoon,960,evoker,preservation,24,10,14
Turbodragon,archimonde,959,evoker,preservation,12,10,2
Zekurm,ragnaros,959,evoker,preservation,15,11,4
Snipy,burning-legion,959,evoker,preservation,18,10,8
Shôrty,ravencrest,959,evoker,preservation,18,10,8
Gedzon,silvermoon,959,evoker,preservation,18,10,8
Lootharon,blackhand,959,evoker,preservation,24,10,14
Hound,lordaeron,959,evoker,preservation,30,11,19
Sobeki,sanguino,958,evoker,preservation,12,10,2
Азизиус,howling-fjord,958,evoker,preservation,18,10,8
Inspecto,turalyon,956,evoker,preservation,55,32,23
Nebulon,dethecus,956,evoker,preservation,137,62,75
Shenronblue,bloodscalp,956,evoker,preservation,30,10,20
Zalegos,kazzak,955,evoker,preservation,24,10,14
Adriia,ravencrest,954,evoker,preservation,18,10,8
Xorizard,runetotem,954,evoker,preservation,24,10,14
Zahaak,doomhammer,953,evoker,preservation,81,35,46
Jhoanna,grim-batol,951,evoker,preservation,66,32,34
Тафл,blackscar,950,evoker,preservation,24,10,14
Bobonakia,sylvanas,950,evoker,preservation,24,10,14
Ninecloud,executus,949,evoker,preservation,24,15,9
Singe,nemesis,949,evoker,preservation,126,43,83
Margouillat,ysondre,948,evoker,preservation,18,10,8
Difigiano,blackmoore,948,evoker,preservation,18,10,8
Slashlowe,archimonde,948,evoker,preservation,40,18,22
Campus,blackrock,947,evoker,preservation,30,10,20
Exacgos,sanguino,946,evoker,preservation,24,15,9
Yukemaster,drakthul,946,evoker,preservation,36,10,26
Dragonblade,drakthul,945,evoker,preservation,18,10,8
Gaulavoker,ragnaros,944,evoker,preservation,30,10,20
Vores,norgannon,942,evoker,preservation,94,44,50
Räze,twisting-nether,942,evoker,preservation,24,10,14
Iswíftz,twisting-nether,941,evoker,preservation,42,10,32
Винтер,azuregos,935,evoker,preservation,19,11,8
Vozzat,stormscale,934,evoker,preservation,24,11,13
Draklorn,moonglade,933,evoker,preservation,75,36,39
Touge,varimathras,932,evoker,preservation,36,16,20
Dracnass,silvermoon,930,evoker,preservation,18,10,8
Evocatrice,nemesis,929,evoker,preservation,18,10,8
Nicholbolas,nordrassil,929,evoker,preservation,29,16,13
Jamesdouglas,eredar,929,evoker,preservation,60,33,27
Kalestis,arthas,925,evoker,preservation,38,20,18
Zaraten,hyjal,924,evoker,preservation,63,32,31
Purpledrac,draenor,923,evoker,preservation,50,25,25
Hazizsarkany,ragnaros,919,evoker,preservation,18,12,6
Aevon,blackrock,919,evoker,preservation,179,84,95
Zymotîx,stormscale,919,evoker,preservation,36,10,26
Schüppchên,antonidas,917,evoker,preservation,34,17,17
Ashla,nemesis,917,evoker,preservation,115,56,59
Лунет,lich-king,917,evoker,preservation,54,25,29
Turmonk,nordrassil,917,evoker,preservation,24,10,14
Микрощука,gordunni,911,evoker,preservation,23,10,13
Grizu,die-ewige-wacht,911,evoker,preservation,24,10,14
Ahyllesevok,antonidas,907,evoker,preservation,21,11,10
Psycotrop,illidan,904,evoker,preservation,18,11,7
Tf,doomhammer,903,evoker,preservation,70,26,44
Krestrazzos,blackmoore,902,evoker,preservation,60,21,39
Cárried,twilights-hammer,902,evoker,preservation,33,11,22
Canitabravar,cthun,898,evoker,preservation,60,30,30
Exxa,tarren-mill,894,evoker,preservation,26,10,16
Minifléx,burning-legion,893,evoker,preservation,22,10,12
Anlong,alakir,893,evoker,preservation,47,20,27
Reddeaddrago,silvermoon,890,evoker,preservation,68,33,35
Morsan,tichondrius,890,evoker,preservation,51,24,27
Domynevoc,hyjal,889,evoker,preservation,126,63,63
Балрогхаоса,gordunni,887,evoker,preservation,54,22,32
Skìttlês,antonidas,886,evoker,preservation,291,136,155
Drakars,kazzak,886,evoker,preservation,62,27,35
Montralkyr,antonidas,886,evoker,preservation,24,10,14
Калесгоз,howling-fjord,883,evoker,preservation,123,49,74
Drachi,ambossar,880,evoker,preservation,78,35,43
Leonarty,nemesis,879,evoker,preservation,36,16,20
Quetzalcoâtl,burning-blade,878,evoker,preservation,66,31,35
Mergwahlbark,hyjal,878,evoker,preservation,29,10,19
Верметор,soulflayer,874,evoker,preservation,150,61,89
Drakthur,terenas,874,evoker,preservation,39,11,28
Mariorel,stormscale,872,evoker,preservation,62,21,41
Thenotelmat,twisting-nether,868,evoker,preservation,17,11,6
Pentraktar,pozzo-delleternità,868,evoker,preservation,37,12,25
Dekaralol,ravencrest,864,evoker,preservation,12,9,3
Flystowardsu,argent-dawn,864,evoker,preservation,12,9,3
Antifightx,kazzak,864,evoker,preservation,12,9,3
Dracthyrael,drakthul,864,evoker,preservation,18,9,9
Skytrace,silvermoon,864,evoker,preservation,52,12,40
Мишанячешуя,gordunni,863,evoker,preservation,12,9,3
Nassuada,dalaran,863,evoker,preservation,18,9,9
Rímmer,kazzak,863,evoker,preservation,18,9,9
Wjörm,outland,863,evoker,preservation,18,9,9
Arbîter,eredar,863,evoker,preservation,18,9,9
Cupcâke,dalaran,863,evoker,preservation,18,9,9
Myntara,tarren-mill,863,evoker,preservation,24,9,15
Dractharion,blackrock,863,evoker,preservation,30,9,21
Yesdaddyowo,draenor,862,evoker,preservation,18,9,9
Навидх,howling-fjord,862,evoker,preservation,24,9,15
Jondal,kazzak,862,evoker,preservation,24,9,15
Mimic,scarshield-legion,861,evoker,preservation,18,9,9
Thymian,ambossar,861,evoker,preservation,195,90,105
Mistvoke,kazzak,860,evoker,preservation,18,9,9
Ивдигодх,gordunni,860,evoker,preservation,24,9,15
Paizz,tarren-mill,859,evoker,preservation,18,9,9
Lithnxv,bladefist,859,evoker,preservation,18,9,9
Damssx,medivh,858,evoker,preservation,45,20,25
Evok,deathwing,858,evoker,preservation,24,10,14
Azza,uldum,858,evoker,preservation,45,18,27
Nedflanderss,silvermoon,856,evoker,preservation,18,9,9
Поплавочек,soulflayer,856,evoker,preservation,60,27,33
Fafnîr,stormrage,854,evoker,preservation,18,9,9
Dudebrö,arathor,854,evoker,preservation,18,9,9
Minikuja,culte-de-la-rive-noire,853,evoker,preservation,68,28,40
Alulu,ysondre,852,evoker,preservation,52,25,27
Eurydíke,blackhand,852,evoker,preservation,24,9,15
Baléryon,archimonde,849,evoker,preservation,17,10,7
Javåscript,outland,849,evoker,preservation,18,9,9
Аверьятор,fordragon,848,evoker,preservation,18,9,9
Iashiak,silvermoon,848,evoker,preservation,21,10,11
Evÿ,turalyon,846,evoker,preservation,48,19,29
Kaiser,trollbane,845,evoker,preservation,24,9,15
Yadormi,sylvanas,843,evoker,preservation,60,28,32
Drakmool,ysondre,840,evoker,preservation,54,23,31
Malougos,ragnaros,839,evoker,preservation,196,79,117
Spirow,archimonde,839,evoker,preservation,91,36,55
Eymo,archimonde,836,evoker,preservation,24,9,15
Абьюз,galakrond,835,evoker,preservation,406,204,202
Dazzus,twilights-hammer,833,evoker,preservation,24,9,15
Roastedpig,kazzak,831,evoker,preservation,17,9,8
Zerario,blackhand,827,evoker,preservation,23,9,14
Mendes,kazzak,827,evoker,preservation,84,26,58
Sumo,burning-legion,826,evoker,preservation,58,25,33
Xanthisa,malganis,824,evoker,preservation,57,25,32
Деонтология,blackscar,823,evoker,preservation,42,16,26
Azurewings,argent-dawn,821,evoker,preservation,98,37,61
Myndragosa,varimathras,816,evoker,preservation,21,10,11
Miumyuki,drakthul,815,evoker,preservation,54,21,33
Kàzuée,outland,812,evoker,preservation,44,14,30
Drakelussac,silvermoon,809,evoker,preservation,22,10,12
Uxiono,dun-modr,808,evoker,preservation,38,10,28
Smegma,norgannon,806,evoker,preservation,23,9,14
Terrorwings,twisting-nether,802,evoker,preservation,29,11,18
Vantu,grim-batol,798,evoker,preservation,20,10,10
Viseriðn,archimonde,792,evoker,preservation,48,16,32
Cheapdragon,tarren-mill,791,evoker,preservation,45,18,27
Scraier,ravenholdt,789,evoker,preservation,21,11,10
Эфирид,blackscar,779,evoker,preservation,59,22,37
Тирдде,deathweaver,778,evoker,preservation,168,73,95
Høt,nemesis,775,evoker,preservation,19,9,10
Mefedrone,argent-dawn,771,evoker,preservation,30,9,21
Lurkarian,stormscale,768,evoker,preservation,12,8,4
Naicover,kazzak,768,evoker,preservation,12,8,4
Ghettovoke,sylvanas,768,evoker,preservation,12,8,4
Zendaë,archimonde,768,evoker,preservation,12,8,4
Mentallyoff,ravencrest,768,evoker,preservation,12,8,4
Kanketopg,kazzak,768,evoker,preservation,12,8,4
Nyxion,shattered-halls,768,evoker,preservation,18,8,10
Ringil,tarren-mill,768,evoker,preservation,18,8,10
Waytwohigh,ravencrest,768,evoker,preservation,18,8,10
Nastywing,magtheridon,768,evoker,preservation,18,8,10
Дрейкорг,howling-fjord,768,evoker,preservation,24,8,16
Змеетян,gordunni,768,evoker,preservation,24,8,16
Krazuntus,argent-dawn,767,evoker,preservation,12,8,4
Jormün,dalaran,767,evoker,preservation,12,8,4
Ñancey,draenor,767,evoker,preservation,18,8,10
Mundyr,sylvanas,767,evoker,preservation,18,8,10
Alariath,mannoroth,767,evoker,preservation,18,8,10
Инкуласан,gordunni,767,evoker,preservation,24,8,16
Дракорэй,gordunni,767,evoker,preservation,24,8,16
Nêóô,blackrock,765,evoker,preservation,18,8,10
Daracthyr,arathor,765,evoker,preservation,18,8,10
Dragonsito,cthun,765,evoker,preservation,18,8,10
Mfdragon,grim-batol,765,evoker,preservation,24,8,16
Toplevel,eredar,765,evoker,preservation,24,8,16
Уполнамоченн,soulflayer,764,evoker,preservation,12,8,4
Arecibo,tarren-mill,762,evoker,preservation,12,8,4
Turdbreather,kazzak,759,evoker,preservation,24,8,16
Archedify,norgannon,759,evoker,preservation,36,8,28
Sarodari,blackhand,757,evoker,preservation,18,8,10
Dragonrocker,silvermoon,757,evoker,preservation,24,8,16
Sunfyres,frostmane,757,evoker,preservation,37,11,26
Cyclops,zuljin,756,evoker,preservation,24,8,16
Sáróman,ravencrest,755,evoker,preservation,44,16,28
Omnivoker,quelthalas,754,evoker,preservation,18,8,10
Maverickx,nemesis,753,evoker,preservation,18,8,10
Marasz,silvermoon,753,evoker,preservation,102,44,58
Lunariëlle,les-sentinelles,749,evoker,preservation,12,8,4
Fodom,medivh,744,evoker,preservation,24,8,16
Kathaa,archimonde,740,evoker,preservation,54,16,38
Dracanis,shendralar,739,evoker,preservation,42,17,25
Missnorway,blackmoore,734,evoker,preservation,17,8,9
Dragonpd,ysondre,727,evoker,preservation,23,8,15
Lunarxina,burning-legion,716,evoker,preservation,36,10,26
Moondraka,outland,714,evoker,preservation,18,9,9
Altairion,dalaran,708,evoker,preservation,42,21,21
Nêrifiel,hyjal,707,evoker,preservation,23,8,15
Avizz,tarren-mill,687,evoker,preservation,26,12,14
Stormnn,kazzak,672,evoker,preservation,12,7,5
Needstherapy,ravencrest,672,evoker,preservation,12,7,5
Zarikus,argent-dawn,672,evoker,preservation,12,7,5
Ðovahkiin,tarren-mill,672,evoker,preservation,18,7,11
Sulführer,sanguino,672,evoker,preservation,18,7,11
Deadwing,eonar,672,evoker,preservation,18,7,11
Óceiros,silvermoon,672,evoker,preservation,18,7,11
Selectaa,grim-batol,672,evoker,preservation,18,7,11
Spacebreath,ravencrest,672,evoker,preservation,18,7,11
Iwaavoker,archimonde,672,evoker,preservation,18,7,11
Tabalugajr,arthas,672,evoker,preservation,23,8,15
Soupmah,silvermoon,672,evoker,preservation,24,7,17
Cynicál,blackmoore,671,evoker,preservation,12,7,5
Flookx,silvermoon,671,evoker,preservation,12,7,5
Draaxy,twisting-nether,671,evoker,preservation,15,8,7
Fusanabide,kazzak,671,evoker,preservation,14,7,7
Иванза,howling-fjord,671,evoker,preservation,18,7,11
Гневиан,eversong,671,evoker,preservation,18,7,11
Liroo,hyjal,670,evoker,preservation,12,7,5
Myszostrasza,burning-legion,670,evoker,preservation,12,7,5
Daxiniti,ragnaros,670,evoker,preservation,24,7,17
Bobbyheal,blackmoore,670,evoker,preservation,30,7,23
Malfestio,zuljin,669,evoker,preservation,12,7,5
Avemonetemus,silvermoon,669,evoker,preservation,18,7,11
Morddragonx,draenor,669,evoker,preservation,18,7,11
Tamargon,frostwhisper,669,evoker,preservation,24,7,17
Finnh,kazzak,669,evoker,preservation,24,7,17
Vatiras,magtheridon,669,evoker,preservation,24,7,17
Entombevoker,twisting-nether,668,evoker,preservation,12,7,5
Wywill,eitrigg,668,evoker,preservation,12,7,5
Prikkedøden,grim-batol,668,evoker,preservation,18,7,11
Панкрок,thermaplugg,668,evoker,preservation,21,7,14
Morph,talnivarr,667,evoker,preservation,18,7,11
Hornbeam,tarren-mill,666,evoker,preservation,18,7,11
Acnologîa,ysondre,665,evoker,preservation,12,7,5
Gihzmo,tarren-mill,664,evoker,preservation,12,7,5
Ignisaureus,silvermoon,659,evoker,preservation,30,7,23
Папугайка,gordunni,655,evoker,preservation,18,7,11
Gimmetheloop,blackrock,655,evoker,preservation,20,7,13
Charezard,draenor,638,evoker,preservation,17,7,10
Nurazar,azuremyst,618,evoker,preservation,15,8,7
Blyatcuka,kazzak,617,evoker,preservation,17,8,9
Quewl,blackmoore,606,evoker,preservation,11,7,4
Shëitan,sinstralis,604,evoker,preservation,29,9,20
Büsselberg,blackmoore,595,evoker,preservation,27,8,19
Младодуб,soulflayer,588,evoker,preservation,51,8,43
Asrwea,draenor,576,evoker,preservation,12,6,6
Dizatwo,silvermoon,576,evoker,preservation,12,6,6
Talynn,sylvanas,576,evoker,preservation,12,6,6
Arfedar,kazzak,576,evoker,preservation,12,6,6
Lereena,la-croisade-écarlate,576,evoker,preservation,12,6,6
Oceirós,draenor,576,evoker,preservation,12,6,6
Glefs,stormscale,576,evoker,preservation,12,6,6
Drakovitch,archimonde,576,evoker,preservation,12,6,6
Luu,the-maelstrom,576,evoker,preservation,12,6,6
Krakadayle,archimonde,576,evoker,preservation,12,6,6
Lasissi,dragonblight,576,evoker,preservation,12,6,6
Ritoplis,cthun,576,evoker,preservation,12,6,6
Drakarroar,ragnaros,576,evoker,preservation,12,6,6
Rømmegrøt,tarren-mill,576,evoker,preservation,12,6,6
Darkevokoul,conseil-des-ombres,576,evoker,preservation,12,6,6
Dréegon,hyjal,576,evoker,preservation,12,6,6
Djsnake,twisting-nether,576,evoker,preservation,12,6,6
Scrípt,blackmoore,576,evoker,preservation,12,6,6
Nosnipeofc,blackmoore,576,evoker,preservation,18,6,12
Khaliy,blackrock,576,evoker,preservation,18,6,12
Lorixia,argent-dawn,576,evoker,preservation,18,6,12
Discodraken,stormscale,576,evoker,preservation,18,6,12
Lolprevoker,outland,576,evoker,preservation,18,6,12
Eliteena,kazzak,576,evoker,preservation,18,6,12
Дэзвинк,gordunni,576,evoker,preservation,24,6,18
Lìssàndra,argent-dawn,576,evoker,preservation,24,6,18
Invinite,blackrock,576,evoker,preservation,24,6,18
Drakuin,ravencrest,576,evoker,preservation,30,6,24
Drakeó,kazzak,575,evoker,preservation,12,6,6
Dragonzo,arathor,575,evoker,preservation,12,6,6
Drachenbeton,blackhand,575,evoker,preservation,12,6,6
Draccaris,silvermoon,575,evoker,preservation,12,6,6
Pasqvoker,ravencrest,575,evoker,preservation,12,6,6
Timyst,outland,575,evoker,preservation,12,6,6
Nevara,ragnaros,575,evoker,preservation,12,6,6
Dragonlet,twisting-nether,575,evoker,preservation,12,6,6
Сулистраза,blackscar,575,evoker,preservation,12,6,6
Fivebeers,silvermoon,575,evoker,preservation,12,6,6
Raegos,ravencrest,575,evoker,preservation,12,6,6
Nexevo,blackmoore,575,evoker,preservation,18,6,12
Lykine,blackrock,575,evoker,preservation,18,6,12
Dreamdoll,tarren-mill,575,evoker,preservation,24,6,18
Drakpojke,stormscale,574,evoker,preservation,12,6,6
Vaporesso,dun-modr,574,evoker,preservation,12,6,6
Dikkedraak,dentarg,574,evoker,preservation,12,6,6
Luftwaffel,blackmoore,574,evoker,preservation,18,6,12
Apolerion,ragnaros,573,evoker,preservation,12,6,6
Etherwood,bronze-dragonflight,573,evoker,preservation,12,6,6
Blainedragon,arathor,573,evoker,preservation,18,6,12
Seldar,steamwheedle-cartel,572,evoker,preservation,12,6,6
Yodrago,kazzak,572,evoker,preservation,12,6,6
Fandango,silvermoon,572,evoker,preservation,12,6,6
Jaratitz,dun-modr,572,evoker,preservation,18,6,12
Нирт,gordunni,572,evoker,preservation,18,6,12
Synpho,ahnqiraj,571,evoker,preservation,12,6,6
Фульфикс,soulflayer,571,evoker,preservation,18,6,12
Evocae,blackmoore,570,evoker,preservation,12,6,6
Mjoke,the-maelstrom,570,evoker,preservation,30,6,24
Aevnon,sylvanas,569,evoker,preservation,12,6,6
Adônis,malorne,569,evoker,preservation,31,6,25
Адалдракулий,howling-fjord,568,evoker,preservation,18,6,12
Synhtol,ragnaros,564,evoker,preservation,18,6,12
Donevoker,blackrock,542,evoker,preservation,17,6,11
Rasalhague,uldum,522,evoker,preservation,15,6,9
Dracarysx,grim-batol,520,evoker,preservation,15,7,8
Ddraig,thunderhorn,513,evoker,preservation,28,7,21
Drakinas,outland,511,evoker,preservation,11,6,5
Tyuz,antonidas,509,evoker,preservation,14,6,8
Nemrák,blackmoore,495,evoker,preservation,13,6,7
Jàcè,antonidas,480,evoker,preservation,6,5,1
Hungryhank,ragnaros,480,evoker,preservation,6,5,1
Hàzinette,sargeras,480,evoker,preservation,6,5,1
Tsunamì,ysondre,480,evoker,preservation,6,5,1
Stêwpit,blackhand,480,evoker,preservation,6,5,1
Ralfferion,auchindoun,480,evoker,preservation,6,5,1
Patatrake,sanguino,480,evoker,preservation,6,5,1
Chilledx,tarren-mill,480,evoker,preservation,6,5,1
Jmyzard,tarren-mill,480,evoker,preservation,10,6,4
Soläryx,hyjal,480,evoker,preservation,12,6,6
Frozenblast,archimonde,480,evoker,preservation,12,5,7
Aryv,ragnaros,480,evoker,preservation,12,5,7
Bigreddragon,outland,480,evoker,preservation,12,5,7
Paarthursnax,tarren-mill,480,evoker,preservation,12,5,7
Драгонкокс,gordunni,480,evoker,preservation,12,5,7
Dzin,burning-legion,480,evoker,preservation,12,5,7
Drakkaz,burning-legion,480,evoker,preservation,12,5,7
Monkeyvoker,archimonde,480,evoker,preservation,12,5,7
Mistime,twisting-nether,480,evoker,preservation,12,5,7
Belzevoker,blackrock,480,evoker,preservation,12,5,7
Morkek,dun-modr,480,evoker,preservation,12,5,7
Evolié,ravencrest,480,evoker,preservation,12,5,7
Interféctá,aegwynn,480,evoker,preservation,12,5,7
Safcøn,eredar,480,evoker,preservation,12,5,7
Tymían,burning-legion,480,evoker,preservation,12,5,7
Emeraldcomun,twisting-nether,480,evoker,preservation,12,5,7
Катяламизил,howling-fjord,480,evoker,preservation,12,5,7
Necorínexx,silvermoon,480,evoker,preservation,12,5,7
Feddra,twisting-nether,480,evoker,preservation,12,5,7
Evokoloko,outland,480,evoker,preservation,12,5,7
Alanikus,silvermoon,480,evoker,preservation,12,5,7
Vizdraken,tarren-mill,480,evoker,preservation,12,5,7
Fnom,hyjal,480,evoker,preservation,12,5,7
Murato,nemesis,480,evoker,preservation,12,5,7
Twøførms,twisting-nether,480,evoker,preservation,15,6,9
Siipiveíkko,stormreaver,480,evoker,preservation,18,5,13
Xyphoo,kazzak,480,evoker,preservation,18,5,13
Miraas,burning-blade,480,evoker,preservation,18,5,13
Rise,tarren-mill,480,evoker,preservation,24,5,19
Néphrekh,archimonde,479,evoker,preservation,6,5,1
Mélagos,ysondre,479,evoker,preservation,12,5,7
Scaleflux,argent-dawn,479,evoker,preservation,12,5,7
Puffdaddyxd,twisting-nether,479,evoker,preservation,12,5,7
Drunkvoker,stormscale,479,evoker,preservation,12,5,7
Vermithors,ravencrest,479,evoker,preservation,12,5,7
Chunlooi,baelgun,479,evoker,preservation,12,5,7
Rex,stormreaver,479,evoker,preservation,12,5,7
Loveyoudaddy,sylvanas,479,evoker,preservation,12,5,7
Shosk,chamber-of-aspects,479,evoker,preservation,12,5,7
Darksaider,draenor,479,evoker,preservation,12,5,7
Dractopelle,garona,479,evoker,preservation,12,5,7
Chizy,aegwynn,479,evoker,preservation,18,5,13
Whelp,antonidas,479,evoker,preservation,18,5,13
Миме,howling-fjord,479,evoker,preservation,18,5,13
Evobse,silvermoon,479,evoker,preservation,24,5,19
Effrt,ravencrest,479,evoker,preservation,24,5,19
Tatsuki,arthas,479,evoker,preservation,24,5,19
Widow,chromaggus,478,evoker,preservation,12,5,7
Alèd,hyjal,478,evoker,preservation,12,5,7
Bbuszek,outland,478,evoker,preservation,18,5,13
Vereeza,draenor,477,evoker,preservation,15,6,9
Exelott,ravencrest,477,evoker,preservation,14,5,9
Suicidel,silvermoon,477,evoker,preservation,18,5,13
Dragomi,kazzak,477,evoker,preservation,18,5,13
Dragorasi,frostwolf,476,evoker,preservation,24,5,19
Гарил,grom,475,evoker,preservation,12,5,7
Ensîmîst,twisting-nether,475,evoker,preservation,12,5,7
Bufor,sanguino,475,evoker,preservation,12,5,7
Gladdrake,doomhammer,474,evoker,preservation,18,5,13
Ngaokoang,khaz-modan,473,evoker,preservation,24,5,19
Traumflügel,teldrassil,472,evoker,preservation,12,5,7
Fricandela,sanguino,472,evoker,preservation,18,5,13
Valasthor,argent-dawn,469,evoker,preservation,18,5,13
Ormqt,ravencrest,468,evoker,preservation,25,8,17
Incarnevoke,ravencrest,463,evoker,preservation,11,5,6
Thyriån,kazzak,447,evoker,preservation,11,5,6
Яссон,howling-fjord,447,evoker,preservation,14,6,8
Sentos,blackmoore,447,evoker,preservation,16,5,11
Kássadaín,the-maelstrom,447,evoker,preservation,16,5,11
Giangiungiua,pozzo-delleternità,431,evoker,preservation,11,5,6
Elrycx,tarren-mill,431,evoker,preservation,21,6,15
Uwulogie,tarren-mill,425,evoker,preservation,26,6,20
Veridius,lightbringer,425,evoker,preservation,28,6,22
Grajade,dun-modr,422,evoker,preservation,15,6,9
Hazes,blackmoore,415,evoker,preservation,10,5,5
Alrakis,kragjin,415,evoker,preservation,16,5,11
Clw,blackrock,384,evoker,preservation,6,4,2
Snàx,aggra-português,384,evoker,preservation,6,4,2
Dragneel,ravenholdt,384,evoker,preservation,6,4,2
Grumes,blackmoore,384,evoker,preservation,6,4,2
Zankthorx,stormscale,384,evoker,preservation,6,4,2
Variandre,ravencrest,384,evoker,preservation,6,4,2
Drangonildo,turalyon,384,evoker,preservation,6,4,2
Нэйджи,borean-tundra,384,evoker,preservation,6,4,2
Creaxx,kirin-tor,384,evoker,preservation,6,4,2
Zettaflare,nazjatar,384,evoker,preservation,6,4,2
Rbgdragon,silvermoon,384,evoker,preservation,6,4,2
Похмуррий,gordunni,384,evoker,preservation,6,4,2
Killmeifucan,twisting-nether,384,evoker,preservation,6,4,2
Ahnë,archimonde,384,evoker,preservation,6,4,2
Rhaeghal,hyjal,384,evoker,preservation,6,4,2
Kyu,die-nachtwache,384,evoker,preservation,6,4,2
Wyrovoker,ragnaros,384,evoker,preservation,6,4,2
Bindrasz,ahnqiraj,384,evoker,preservation,6,4,2
Тимтс,gordunni,384,evoker,preservation,6,4,2
Quasarized,ravencrest,384,evoker,preservation,6,4,2
Bumforce,ravencrest,384,evoker,preservation,6,4,2
Aymoreth,argent-dawn,384,evoker,preservation,6,4,2
Kuve,stormscale,384,evoker,preservation,6,4,2
Blakhrua,ragnaros,384,evoker,preservation,6,4,2
Evossy,tarren-mill,384,evoker,preservation,6,4,2
Aoryx,dun-modr,384,evoker,preservation,6,4,2
Floats,arathor,384,evoker,preservation,12,4,8
Evokker,antonidas,384,evoker,preservation,12,4,8
Ch,ghostlands,384,evoker,preservation,12,4,8
Fomoerectus,eredar,384,evoker,preservation,12,4,8
Tokvoker,tarren-mill,384,evoker,preservation,12,4,8
Epicfire,ravencrest,384,evoker,preservation,12,4,8
Feradely,thrall,384,evoker,preservation,12,4,8
Azdaja,blackmoore,384,evoker,preservation,12,4,8
Галактиг,thermaplugg,384,evoker,preservation,12,4,8
Ninhursag,hyjal,384,evoker,preservation,12,4,8
Yaraxes,outland,384,evoker,preservation,12,4,8
Gryrdrid,draenor,384,evoker,preservation,12,4,8
Tömmöfwarrs,archimonde,384,evoker,preservation,12,4,8
Toílet,blackmoore,384,evoker,preservation,12,4,8
Whatisthis,archimonde,384,evoker,preservation,12,4,8
Feyrbrand,ysera,384,evoker,preservation,12,4,8
Larmédrio,archimonde,384,evoker,preservation,15,4,11
Fogwing,ravencrest,384,evoker,preservation,18,4,14
Aldien,antonidas,384,evoker,preservation,18,4,14
Boostedape,ahnqiraj,384,evoker,preservation,18,4,14
Belzilian,dalaran,384,evoker,preservation,18,4,14
Multytür,antonidas,384,evoker,preservation,18,4,14
Dragønlord,blackrock,384,evoker,preservation,18,4,14
Wiskeryon,ravencrest,384,evoker,preservation,18,4,14
Firelizardxd,archimonde,384,evoker,preservation,24,4,20
Кефтыме,soulflayer,383,evoker,preservation,6,4,2
Timeshifter,stormscale,383,evoker,preservation,6,4,2
Nicnacx,stormscale,383,evoker,preservation,6,4,2
Tisik,terokkar,383,evoker,preservation,6,4,2
Amarisnex,ragnaros,383,evoker,preservation,6,4,2
Evozilla,blackrock,383,evoker,preservation,12,4,8
Pureshot,archimonde,383,evoker,preservation,12,4,8
Dracarÿs,outland,383,evoker,preservation,12,4,8
Astridae,kirin-tor,383,evoker,preservation,12,4,8
Сантанико,grom,383,evoker,preservation,12,4,8
Batmanjasii,eredar,383,evoker,preservation,12,4,8
Pavel,steamwheedle-cartel,383,evoker,preservation,12,4,8
Yaldthion,dun-modr,383,evoker,preservation,18,4,14
Sowinger,ragnaros,382,evoker,preservation,6,4,2
Steadyop,doomhammer,382,evoker,preservation,6,4,2
Meruzhan,chamber-of-aspects,382,evoker,preservation,18,4,14
Dolceprada,stormscale,381,evoker,preservation,12,4,8
Dragonboss,doomhammer,380,evoker,preservation,12,4,8
Мизурион,gordunni,379,evoker,preservation,12,4,8
Ekko,nethersturm,379,evoker,preservation,13,4,9
Rãptør,tarren-mill,367,evoker,preservation,11,4,7
Friggr,defias-brotherhood,367,evoker,preservation,23,4,19
Nevagonafly,archimonde,351,evoker,preservation,10,6,4
Kynirà,magtheridon,351,evoker,preservation,11,4,7
Sinastral,sanguino,350,evoker,preservation,11,4,7
Rhäegal,kaelthas,350,evoker,preservation,17,4,13
Breathkiller,stormscale,330,evoker,preservation,10,6,4
Caida,stormscale,330,evoker,preservation,12,5,7
Zarog,frostwolf,303,evoker,preservation,7,4,3
Drachenbeton,antonidas,288,evoker,preservation,6,3,3
Jmý,tarren-mill,288,evoker,preservation,6,3,3
Zordrach,quelthalas,288,evoker,preservation,6,3,3
Iso,ravencrest,288,evoker,preservation,6,3,3
Ramilbest,ravencrest,288,evoker,preservation,6,3,3
Møndaychest,stormscale,288,evoker,preservation,6,3,3
Sïmana,aggra-português,288,evoker,preservation,6,3,3
Botomforgold,ravencrest,288,evoker,preservation,6,3,3
Saphiraa,lightnings-blade,288,evoker,preservation,6,3,3
Cauter,draenor,288,evoker,preservation,6,3,3
Pfuffi,steamwheedle-cartel,288,evoker,preservation,6,3,3
Rippo,tarren-mill,288,evoker,preservation,6,3,3
Keizal,twisting-nether,288,evoker,preservation,6,3,3
Знамядрак,soulflayer,288,evoker,preservation,6,3,3
Dokkamok,hyjal,288,evoker,preservation,6,3,3
Yeahhoe,ravencrest,288,evoker,preservation,6,3,3
Ceroxs,aegwynn,288,evoker,preservation,6,3,3
Pruttburk,draenor,288,evoker,preservation,6,3,3
Trixvoke,ragnaros,288,evoker,preservation,6,3,3
Espâgnøl,hyjal,288,evoker,preservation,6,3,3
Limbimpi,twilights-hammer,288,evoker,preservation,6,3,3
Rhel,the-maelstrom,288,evoker,preservation,6,3,3
Flâneur,ysondre,288,evoker,preservation,6,3,3
Моралдракон,soulflayer,288,evoker,preservation,6,3,3
Niffdra,twisting-nether,288,evoker,preservation,6,3,3
Griefgodx,draenor,288,evoker,preservation,6,3,3
Mushux,grim-batol,288,evoker,preservation,6,3,3
Dràcøfeugødx,archimonde,288,evoker,preservation,6,3,3
Meezyevo,ragnaros,288,evoker,preservation,6,3,3
Evokimag,grim-batol,288,evoker,preservation,6,3,3
Gigabreath,ravencrest,288,evoker,preservation,6,3,3
Petleg,sanguino,288,evoker,preservation,6,3,3
Nezruslfarm,cthun,288,evoker,preservation,6,3,3
Tactician,stormreaver,288,evoker,preservation,6,3,3
Speckjarrow,blackrock,288,evoker,preservation,6,3,3
Snackthyr,silvermoon,288,evoker,preservation,6,3,3
Konstraz,kazzak,288,evoker,preservation,6,3,3
Noogon,outland,288,evoker,preservation,6,3,3
Jackarlys,outland,288,evoker,preservation,6,3,3
Renalia,blackrock,288,evoker,preservation,6,3,3
Suirz,sanguino,288,evoker,preservation,9,4,5
Flygpajk,kazzak,288,evoker,preservation,10,4,6
Кунидракон,gordunni,288,evoker,preservation,10,4,6
Siigge,draenor,288,evoker,preservation,12,3,9
Dragonboi,archimonde,288,evoker,preservation,12,3,9
Taktcik,archimonde,288,evoker,preservation,12,3,9
Clênas,kazzak,288,evoker,preservation,12,3,9
Reelona,silvermoon,288,evoker,preservation,12,3,9
Bemil,twisting-nether,288,evoker,preservation,12,3,9
Боевойхомякд,howling-fjord,288,evoker,preservation,12,3,9
Zenda,turalyon,288,evoker,preservation,12,3,9
Vaníliasodó,ragnaros,288,evoker,preservation,12,3,9
Edgybeb,archimonde,288,evoker,preservation,12,3,9
Elderruan,shattered-hand,288,evoker,preservation,12,3,9
Buuf,sanguino,288,evoker,preservation,12,3,9
Cadwalader,blades-edge,288,evoker,preservation,12,3,9
Brevsparven,ravencrest,288,evoker,preservation,12,3,9
Viscervanthe,tarren-mill,288,evoker,preservation,12,3,9
Falkoria,drakthul,288,evoker,preservation,12,3,9
Phillip,tarren-mill,288,evoker,preservation,12,3,9
Evildrake,twisting-nether,288,evoker,preservation,12,3,9
Moltenazo,dun-modr,288,evoker,preservation,13,3,10
Extintor,silvermoon,288,evoker,preservation,18,3,15
Wosabivoker,stormscale,287,evoker,preservation,6,3,3
Dragonpastor,kazzak,287,evoker,preservation,6,3,3
Delta,blackhand,287,evoker,preservation,6,3,3
Gelu,burning-legion,287,evoker,preservation,6,3,3
Милеис,soulflayer,287,evoker,preservation,6,3,3
Elexatra,hyjal,287,evoker,preservation,12,3,9
Broocklyn,blackrock,287,evoker,preservation,12,3,9
Drackial,zuljin,286,evoker,preservation,12,3,9
Silberdorn,rexxar,286,evoker,preservation,12,3,9
Òhrabzack,blackmoore,286,evoker,preservation,24,3,21
Valystrá,die-aldor,285,evoker,preservation,24,3,21
Kelisthrasa,antonidas,284,evoker,preservation,12,3,9
Норыч,soulflayer,284,evoker,preservation,26,3,23
Quarsilly,frostwolf,271,evoker,preservation,11,3,8
Pixenen,ravencrest,271,evoker,preservation,11,3,8
Эйвия,soulflayer,256,evoker,preservation,4,4,0
Draginy,blackrock,255,evoker,preservation,8,4,4
Agnî,sanguino,240,evoker,preservation,9,3,6
Axüra,nemesis,240,evoker,preservation,9,3,6
Elvifirerage,twisting-nether,239,evoker,preservation,5,3,2
Goldenshower,bladefist,234,evoker,preservation,14,4,10
Zelenobelata,neptulon,234,evoker,preservation,16,4,12
Provôker,tarren-mill,223,evoker,preservation,8,3,5
Baranzion,twisting-nether,207,evoker,preservation,8,3,5
Exitelolx,blackrock,192,evoker,preservation,4,3,1
Protesturken,shadowsong,192,evoker,preservation,4,3,1
Aegón,uldum,192,evoker,preservation,6,2,4
Chamustrasza,sanguino,192,evoker,preservation,6,2,4
Nooshy,burning-legion,192,evoker,preservation,6,2,4
Azurog,blackmoore,192,evoker,preservation,6,2,4
Glurakk,aegwynn,192,evoker,preservation,6,2,4
Zelëph,archimonde,192,evoker,preservation,6,2,4
Язычник,thermaplugg,192,evoker,preservation,6,2,4
Freesckretx,archimonde,192,evoker,preservation,6,2,4
Dno,archimonde,192,evoker,preservation,6,2,4
Ræyna,blackmoore,192,evoker,preservation,6,2,4
Braitnezdrag,blackrock,192,evoker,preservation,6,2,4
Sloeez,kazzak,192,evoker,preservation,6,2,4
Soondeleted,eredar,192,evoker,preservation,6,2,4
Fuoco,wrathbringer,192,evoker,preservation,6,2,4
Cousinbetty,defias-brotherhood,192,evoker,preservation,6,2,4
Змийх,gordunni,192,evoker,preservation,6,2,4
Norpineto,ravencrest,192,evoker,preservation,6,2,4
Chalgoumax,ysondre,192,evoker,preservation,6,2,4
Chanceflared,defias-brotherhood,192,evoker,preservation,6,2,4
Frogzey,kazzak,192,evoker,preservation,6,2,4
Sheràqt,blackrock,192,evoker,preservation,6,2,4
Rngmåchinè,ravencrest,192,evoker,preservation,6,2,4
Shinad,ravencrest,192,evoker,preservation,6,2,4
Voldermort,ravencrest,192,evoker,preservation,6,2,4
Neomswosj,kazzak,192,evoker,preservation,6,2,4
Kafrineslim,ysondre,192,evoker,preservation,6,2,4
Dragonlol,stormscale,192,evoker,preservation,6,2,4
Matyas,tarren-mill,192,evoker,preservation,6,2,4
Лфграб,howling-fjord,192,evoker,preservation,6,2,4
Maysiesthraz,ravencrest,192,evoker,preservation,6,2,4
Zendervish,draenor,192,evoker,preservation,6,2,4
Asunarion,silvermoon,192,evoker,preservation,6,2,4
Chíliena,ravencrest,192,evoker,preservation,6,2,4
Popelka,shattered-halls,192,evoker,preservation,6,2,4
Timotheus,draenor,192,evoker,preservation,6,2,4
Garussy,draenor,192,evoker,preservation,6,2,4
Notdasilva,twisting-nether,192,evoker,preservation,6,2,4
Magmarôs,argent-dawn,192,evoker,preservation,6,2,4
Nordomu,silvermoon,192,evoker,preservation,6,2,4
Глорунг,howling-fjord,192,evoker,preservation,6,2,4
Glurak,stormscale,192,evoker,preservation,6,2,4
Ysgrin,argent-dawn,192,evoker,preservation,6,2,4
Tacthyr,blackrock,192,evoker,preservation,6,2,4
Sénkú,silvermoon,192,evoker,preservation,6,2,4
Oontäälihis,ravencrest,192,evoker,preservation,6,2,4
Youzfull,blackrock,192,evoker,preservation,6,2,4
Chronogosa,argent-dawn,192,evoker,preservation,6,2,4
Puzzles,ravencrest,192,evoker,preservation,6,2,4
Darker,garrosh,192,evoker,preservation,6,2,4
Überflieger,blackmoore,192,evoker,preservation,6,2,4
Raeinar,tyrande,192,evoker,preservation,12,2,10
Wuschwuscha,thrall,192,evoker,preservation,12,2,10
Margouillax,archimonde,192,evoker,preservation,12,2,10
Lììn,hyjal,192,evoker,preservation,12,2,10
Reworkedmage,twisting-nether,192,evoker,preservation,12,2,10
Dráthír,blackrock,192,evoker,preservation,12,2,10
Teyvoker,blackmoore,192,evoker,preservation,12,2,10
Saphyroth,blackmoore,192,evoker,preservation,12,2,10
Flametender,silvermoon,192,evoker,preservation,12,2,10
Pico,madmortem,192,evoker,preservation,12,2,10
Atotheerawr,kazzak,192,evoker,preservation,12,2,10
Mylittlepony,conseil-des-ombres,192,evoker,preservation,12,2,10
Thunderthorn,blackrock,192,evoker,preservation,12,2,10
Dragaras,twisting-nether,192,evoker,preservation,12,2,10
Gibefigg,antonidas,192,evoker,preservation,12,2,10
Chocodragon,blackmoore,192,evoker,preservation,12,2,10
Djage,kazzak,192,evoker,preservation,14,2,12
Dracipsouk,drakthul,192,evoker,preservation,18,2,16
Copíum,silvermoon,192,evoker,preservation,18,2,16
Macdrac,area-52,192,evoker,preservation,18,2,16
Morpheuzx,tarren-mill,191,evoker,preservation,6,2,4
Muraki,ysondre,191,evoker,preservation,6,2,4
Sinnkra,argent-dawn,191,evoker,preservation,6,2,4
Ясосалочка,howling-fjord,191,evoker,preservation,6,2,4
Yuyux,sanguino,191,evoker,preservation,6,2,4
Droeffel,antonidas,191,evoker,preservation,6,2,4
Flameclaw,argent-dawn,191,evoker,preservation,12,2,10
Viorias,argent-dawn,191,evoker,preservation,27,2,25
Wardrache,nerathor,190,evoker,preservation,18,2,16
Тримони,soulflayer,175,evoker,preservation,11,4,7
Eldrax,emerald-dream,159,evoker,preservation,5,2,3
Dandrake,shattered-hand,159,evoker,preservation,5,2,3
Outsider,aegwynn,144,evoker,preservation,3,3,0
Stinka,blackmoore,138,evoker,preservation,9,5,4
Primepewpew,ragnaros,138,evoker,preservation,15,3,12
Tizuki,twisting-nether,138,evoker,preservation,16,3,13
Zzaazaa,argent-dawn,137,evoker,preservation,10,3,7
Marcelproust,burning-legion,127,evoker,preservation,4,2,2
Zuhana,twisting-nether,127,evoker,preservation,4,2,2
Azzazed,dun-modr,127,evoker,preservation,4,2,2
Рбгсвинья,howling-fjord,96,evoker,preservation,3,2,1
Connorbigboi,ragnaros,96,evoker,preservation,6,1,5
Kroqmoo,drekthar,96,evoker,preservation,6,1,5
Foldoudoune,archimonde,96,evoker,preservation,6,1,5
Dragonpro,kazzak,96,evoker,preservation,6,1,5
Spyroe,aegwynn,96,evoker,preservation,6,1,5
Rickastley,ragnaros,96,evoker,preservation,6,1,5
Смехокрыл,deathguard,96,evoker,preservation,6,1,5
Oogabuga,outland,96,evoker,preservation,6,1,5
Brystrasza,quelthalas,96,evoker,preservation,6,1,5
Breathpitt,blackrock,96,evoker,preservation,6,1,5
Calise,kazzak,96,evoker,preservation,6,1,5
Ajjemen,outland,96,evoker,preservation,6,1,5
Ibexphénix,conseil-des-ombres,96,evoker,preservation,6,1,5
Kaezmasterx,blackrock,96,evoker,preservation,6,1,5
Suntigi,neptulon,96,evoker,preservation,6,1,5
Dewi,anachronos,96,evoker,preservation,6,1,5
Азивокер,howling-fjord,96,evoker,preservation,6,1,5
Tarecgos,sanguino,96,evoker,preservation,6,1,5
Louzard,draenor,96,evoker,preservation,6,1,5
Nezruslfarm,dun-modr,96,evoker,preservation,6,1,5
Woasid,outland,96,evoker,preservation,6,1,5
Slaskenyah,tarren-mill,96,evoker,preservation,6,1,5
Huangzhang,burning-legion,96,evoker,preservation,6,1,5
Pikemiz,sanguino,96,evoker,preservation,6,1,5
Cattiche,draenor,96,evoker,preservation,6,1,5
Gwindora,azjolnerub,96,evoker,preservation,6,1,5
Awienz,kazzak,96,evoker,preservation,6,1,5
Pipe,sanguino,96,evoker,preservation,6,1,5
Drgn,blackhand,96,evoker,preservation,6,1,5
Yaboismok,burning-legion,96,evoker,preservation,6,1,5
Kedel,tarren-mill,96,evoker,preservation,6,1,5
Drakenballen,ragnaros,96,evoker,preservation,6,1,5
Хафр,deathguard,96,evoker,preservation,6,1,5
Mulqahdiiv,archimonde,96,evoker,preservation,6,1,5
Eurasia,ravenholdt,96,evoker,preservation,6,1,5
Lumberdrake,stormscale,96,evoker,preservation,6,1,5
Mazzdrake,sylvanas,96,evoker,preservation,6,1,5
Jouke,dentarg,96,evoker,preservation,6,1,5
Charovoker,blackmoore,96,evoker,preservation,6,1,5
Varyse,stormscale,96,evoker,preservation,6,1,5
Asdkmelkm,stormscale,96,evoker,preservation,6,1,5
Pavelito,ysondre,96,evoker,preservation,6,1,5
Drachenlord,alakir,96,evoker,preservation,6,1,5
Hojoker,twisting-nether,96,evoker,preservation,6,1,5
Freyrn,drakthul,96,evoker,preservation,6,1,5
Bisxcuit,dun-modr,96,evoker,preservation,6,1,5
Larrykoopa,hyjal,96,evoker,preservation,6,1,5
Leandrini,ravencrest,96,evoker,preservation,6,1,5
Xqa,hyjal,96,evoker,preservation,6,1,5
Ceerdrogo,twisting-nether,96,evoker,preservation,9,1,8
Vänesiä,sylvanas,96,evoker,preservation,12,1,11
Bigusdickus,ysondre,96,evoker,preservation,12,1,11
Duveloker,dragonblight,96,evoker,preservation,12,1,11
Baddragonxxl,sylvanas,96,evoker,preservation,12,1,11
Sopollina,draenor,96,evoker,preservation,12,1,11
Hizzo,burning-legion,96,evoker,preservation,12,1,11
Vullgred,sylvanas,96,evoker,preservation,12,1,11
Heidrun,ravenholdt,95,evoker,preservation,6,1,5
Fluffykoi,silvermoon,95,evoker,preservation,12,1,11
Wirenth,chogall,95,evoker,preservation,12,1,11
Imend,stormscale,79,evoker,preservation,5,1,4
Hnsons,earthen-ring,64,evoker,preservation,10,1,9
Floofboi,ravencrest,63,evoker,preservation,2,2,0
Dopëshow,drakthul,48,evoker,preservation,3,1,2
Nickydragonx,stormscale,42,evoker,preservation,10,3,7
Faijer,blackmoore,42,evoker,preservation,10,3,7
Flyvern,kazzak,42,evoker,preservation,8,2,6
Wildcardbob,draenor,31,evoker,preservation,2,1,1
Кеннокс,soulflayer,2225,evoker,devastation,144,78,66
Hehehihihaha,ravencrest,2179,evoker,devastation,130,67,63
Дракшотик,blackscar,2146,evoker,devastation,89,52,37
Rexzstrasza,eredar,2132,evoker,devastation,143,81,62
Animenorgam,alakir,2126,evoker,devastation,254,151,103
Sârmikas,blackhand,2124,evoker,devastation,302,159,143
Babodrake,blackhand,2122,evoker,devastation,121,61,60
Judda,stormscale,2118,evoker,devastation,227,118,109
Brokz,twisting-nether,2116,evoker,devastation,172,95,77
Meust,blackrock,2111,evoker,devastation,66,42,24
Heõ,twisting-nether,2102,evoker,devastation,369,183,186
Пивнаябошка,soulflayer,2099,evoker,devastation,96,49,47
Carlospapa,lothar,2074,evoker,devastation,113,75,38
Drakenyasha,tarren-mill,2060,evoker,devastation,261,130,131
Dracohfeu,archimonde,2055,evoker,devastation,100,58,42
Дракшотик,soulflayer,2031,evoker,devastation,54,30,24
Twodeep,blackrock,1999,evoker,devastation,183,94,89
Kamehaméha,outland,1975,evoker,devastation,105,59,46
Soondeleted,eredar,1970,evoker,devastation,66,35,31
Silvior,outland,1969,evoker,devastation,78,38,40
Uglylizard,stormscale,1968,evoker,devastation,66,42,24
Crueh,outland,1967,evoker,devastation,60,33,27
Darkssoul,outland,1967,evoker,devastation,144,77,67
Lesgrossman,ravencrest,1965,evoker,devastation,90,47,43
Edvoker,twisting-nether,1960,evoker,devastation,174,92,82
Claxy,ragnaros,1952,evoker,devastation,72,38,34
Balthinar,argent-dawn,1951,evoker,devastation,108,54,54
Diznutz,kazzak,1941,evoker,devastation,132,66,66
Zmej,twisting-nether,1937,evoker,devastation,113,55,58
Dracofeuxd,archimonde,1936,evoker,devastation,99,55,44
Wexvoker,darksorrow,1936,evoker,devastation,109,59,50
Ryujíin,kazzak,1929,evoker,devastation,101,61,40
Myxker,burning-legion,1922,evoker,devastation,77,36,41
Ipanicsoar,tarren-mill,1921,evoker,devastation,158,81,77
Evodraxx,hyjal,1911,evoker,devastation,72,32,40
Sloeez,kazzak,1903,evoker,devastation,60,30,30
Jeannedebruj,ravencrest,1902,evoker,devastation,231,120,111
Jibobo,the-maelstrom,1900,evoker,devastation,65,31,34
Нерфсрочно,gordunni,1897,evoker,devastation,240,117,123
Salk,stormscale,1891,evoker,devastation,36,20,16
Ønce,durotan,1888,evoker,devastation,111,57,54
Advancedboy,archimonde,1887,evoker,devastation,75,35,40
Драгонтьма,gordunni,1877,evoker,devastation,131,68,63
Juhadormu,stormreaver,1875,evoker,devastation,143,74,69
Дреадди,soulflayer,1869,evoker,devastation,157,81,76
Ízma,ravencrest,1866,evoker,devastation,198,101,97
Lidldragon,argent-dawn,1862,evoker,devastation,38,28,10
Nigesaurus,burning-legion,1862,evoker,devastation,39,21,18
Enzetrius,argent-dawn,1861,evoker,devastation,36,22,14
Whaazzdragon,tarren-mill,1858,evoker,devastation,42,24,18
Atoll,scarshield-legion,1858,evoker,devastation,55,29,26
Lizardbøi,blackhand,1855,evoker,devastation,72,37,35
Hëroinhenry,tarren-mill,1853,evoker,devastation,66,44,22
Xzvoker,kazzak,1848,evoker,devastation,134,67,67
Ryuu,mazrigos,1848,evoker,devastation,65,30,35
Kàido,ravencrest,1844,evoker,devastation,753,374,379
Calygosa,antonidas,1843,evoker,devastation,36,23,13
Nazyr,blackhand,1838,evoker,devastation,72,41,31
Фиамниэль,gordunni,1838,evoker,devastation,72,34,38
Sagrax,silvermoon,1835,evoker,devastation,68,40,28
Polbiwe,silvermoon,1835,evoker,devastation,128,69,59
Гиперзверь,gordunni,1831,evoker,devastation,68,35,33
Аксиомх,soulflayer,1831,evoker,devastation,76,39,37
Korvi,ravencrest,1830,evoker,devastation,44,25,19
Mizamiza,blackrock,1829,evoker,devastation,160,84,76
Keñwøød,ysondre,1829,evoker,devastation,56,27,29
Draxxys,blackmoore,1826,evoker,devastation,156,84,72
Viscervanthe,tarren-mill,1826,evoker,devastation,78,38,40
Bigmacfrite,ysondre,1823,evoker,devastation,106,54,52
Irvethius,argent-dawn,1822,evoker,devastation,203,103,100
Tremmérz,outland,1821,evoker,devastation,72,37,35
Jamzyevoker,emerald-dream,1819,evoker,devastation,73,38,35
Ларенил,gordunni,1817,evoker,devastation,90,44,46
Krazuntus,argent-dawn,1816,evoker,devastation,93,51,42
Jamiewing,ravencrest,1815,evoker,devastation,243,128,115
Lurkî,blackhand,1815,evoker,devastation,114,57,57
Ryuujin,outland,1815,evoker,devastation,66,30,36
Avë,kazzak,1814,evoker,devastation,89,46,43
Âspên,archimonde,1813,evoker,devastation,80,47,33
Shimmerscale,blackhand,1811,evoker,devastation,173,101,72
Amadeusx,ravencrest,1810,evoker,devastation,55,30,25
Ðø,antonidas,1810,evoker,devastation,59,28,31
Sleyvoker,draenor,1806,evoker,devastation,42,26,16
Дарратель,gordunni,1806,evoker,devastation,195,106,89
Nerfmeplze,outland,1804,evoker,devastation,140,67,73
Zephlas,sunstrider,1803,evoker,devastation,49,27,22
Meust,destromath,1803,evoker,devastation,54,28,26
Dracoli,eredar,1800,evoker,devastation,125,71,54
Zendaÿa,silvermoon,1800,evoker,devastation,120,60,60
Elbozo,kazzak,1799,evoker,devastation,110,59,51
Azorgaron,outland,1796,evoker,devastation,42,24,18
Jaimery,ravencrest,1796,evoker,devastation,54,29,25
Merqury,ravencrest,1795,evoker,devastation,42,29,13
Ralygos,ravencrest,1795,evoker,devastation,138,79,59
Apacstrasza,ragnaros,1790,evoker,devastation,197,98,99
Oontäälihis,ravencrest,1789,evoker,devastation,199,101,98
Shaze,zuljin,1788,evoker,devastation,59,39,20
Rahzk,twisting-nether,1788,evoker,devastation,48,28,20
Pinacóladaqt,stormscale,1787,evoker,devastation,72,34,38
Saintly,kult-der-verdammten,1785,evoker,devastation,122,67,55
Obbwoke,ravencrest,1782,evoker,devastation,132,69,63
Infopaki,stormscale,1781,evoker,devastation,94,53,41
Frozendragon,twisting-nether,1771,evoker,devastation,107,57,50
Yimvoker,blackrock,1770,evoker,devastation,36,21,15
Спайрок,gordunni,1765,evoker,devastation,230,120,110
Zyndigos,ravencrest,1762,evoker,devastation,61,31,30
Митокада,soulflayer,1757,evoker,devastation,71,40,31
Дракарус,soulflayer,1754,evoker,devastation,60,30,30
Archdragon,argent-dawn,1751,evoker,devastation,201,109,92
Valdrakon,doomhammer,1750,evoker,devastation,133,71,62
Eldunaries,argent-dawn,1749,evoker,devastation,197,99,98
Juicyjeffe,blackrock,1748,evoker,devastation,42,25,17
Верестраз,howling-fjord,1746,evoker,devastation,72,34,38
Wuiflyta,dun-modr,1746,evoker,devastation,131,60,71
Lagerstrasza,stormreaver,1741,evoker,devastation,99,56,43
Hollowbreath,sanguino,1737,evoker,devastation,262,130,132
Ceerdrogo,twisting-nether,1736,evoker,devastation,77,41,36
Devictxd,ragnaros,1730,evoker,devastation,59,34,25
Strangedog,ravencrest,1727,evoker,devastation,74,43,31
Homeoffice,zenedar,1727,evoker,devastation,108,57,51
Ralfferion,auchindoun,1724,evoker,devastation,60,30,30
Melodio,outland,1722,evoker,devastation,78,46,32
Cinnannoe,tarren-mill,1719,evoker,devastation,197,110,87
Tamargon,frostwhisper,1719,evoker,devastation,52,28,24
Øseria,khaz-modan,1718,evoker,devastation,212,123,89
Dragonlia,blackrock,1717,evoker,devastation,42,28,14
Rzektwo,eredar,1717,evoker,devastation,106,53,53
Kymaíra,hyjal,1716,evoker,devastation,48,22,26
Sintharion,ravencrest,1715,evoker,devastation,223,114,109
Kôlaghan,archimonde,1709,evoker,devastation,71,38,33
Voklath,kazzak,1708,evoker,devastation,193,98,95
Notadvanced,draenor,1707,evoker,devastation,66,35,31
Famouszorc,sanguino,1704,evoker,devastation,168,96,72
Инсейнмэн,soulflayer,1697,evoker,devastation,253,134,119
Elitedraach,tarren-mill,1697,evoker,devastation,35,18,17
Гневиан,eversong,1694,evoker,devastation,186,96,90
Cybraxq,kazzak,1692,evoker,devastation,30,18,12
Flâneur,ysondre,1691,evoker,devastation,101,51,50
Sawk,archimonde,1690,evoker,devastation,114,66,48
Merkels,blackmoore,1689,evoker,devastation,802,404,398
Duvahkahr,ragnaros,1689,evoker,devastation,81,39,42
Bubbleblower,stormscale,1688,evoker,devastation,52,33,19
Telepathy,ravencrest,1683,evoker,devastation,71,43,28
Углекислот,howling-fjord,1683,evoker,devastation,90,44,46
Woasid,outland,1682,evoker,devastation,123,73,50
Skùzito,ysondre,1676,evoker,devastation,134,67,67
Dispelgodx,eredar,1673,evoker,devastation,60,30,30
Rokki,blackrock,1672,evoker,devastation,100,53,47
Amnevoker,dalaran,1671,evoker,devastation,30,18,12
Tetsú,tarren-mill,1668,evoker,devastation,234,123,111
Galanix,argent-dawn,1667,evoker,devastation,54,26,28
Draakoñ,outland,1666,evoker,devastation,78,42,36
Lecutos,sunstrider,1665,evoker,devastation,36,24,12
Psheetae,kazzak,1664,evoker,devastation,60,36,24
Хетсв,gordunni,1663,evoker,devastation,102,57,45
Tezkaz,blackmoore,1657,evoker,devastation,343,176,167
Capybaro,blackrock,1656,evoker,devastation,48,31,17
Schismxx,outland,1652,evoker,devastation,158,89,69
Swapxyevo,ravencrest,1650,evoker,devastation,36,22,14
Emeraldino,twisting-nether,1649,evoker,devastation,54,22,32
Emiltate,ravencrest,1648,evoker,devastation,30,19,11
Скорукх,gordunni,1647,evoker,devastation,159,86,73
Badrig,silvermoon,1647,evoker,devastation,405,214,191
Paarthursnax,tarren-mill,1646,evoker,devastation,59,35,24
Hanoostrasz,tarren-mill,1646,evoker,devastation,129,70,59
Ольменго,fordragon,1646,evoker,devastation,81,41,40
Iíiìl,silvermoon,1643,evoker,devastation,60,40,20
Serulyon,draenor,1643,evoker,devastation,102,53,49
Sürion,grim-batol,1642,evoker,devastation,72,39,33
Zaralek,stormscale,1641,evoker,devastation,54,34,20
Ruinastrasza,silvermoon,1641,evoker,devastation,235,118,117
Släshés,ravencrest,1641,evoker,devastation,125,60,65
Charocharo,silvermoon,1640,evoker,devastation,66,39,27
Ясъелинеры,gordunni,1640,evoker,devastation,54,31,23
Boostedape,ahnqiraj,1639,evoker,devastation,164,92,72
Devoxz,tarren-mill,1639,evoker,devastation,132,72,60
Aclysia,outland,1639,evoker,devastation,118,62,56
Dragonide,draenor,1638,evoker,devastation,59,31,28
Mekverath,stormscale,1635,evoker,devastation,306,154,152
Hyperan,twisting-nether,1635,evoker,devastation,82,40,42
Nydolir,hyjal,1632,evoker,devastation,77,46,31
Niddhøgg,ragnaros,1632,evoker,devastation,36,21,15
Drakeoo,twisting-nether,1630,evoker,devastation,69,35,34
Papayoyo,draenor,1630,evoker,devastation,156,75,81
Drôgon,archimonde,1627,evoker,devastation,77,39,38
Deathdream,stormscale,1627,evoker,devastation,36,17,19
Hömeöffice,sylvanas,1624,evoker,devastation,110,59,51
Matrixslave,tarren-mill,1624,evoker,devastation,126,67,59
Кунидракон,gordunni,1624,evoker,devastation,175,91,84
Eskavoker,kazzak,1623,evoker,devastation,36,22,14
Rise,tarren-mill,1622,evoker,devastation,36,22,14
Mørningstãr,ragnaros,1622,evoker,devastation,113,56,57
Thorhygos,sinstralis,1620,evoker,devastation,65,35,30
Pesoo,kazzak,1619,evoker,devastation,24,17,7
Kiwí,antonidas,1619,evoker,devastation,30,17,13
Грринч,deathweaver,1619,evoker,devastation,94,49,45
Hyperflexx,blackrock,1617,evoker,devastation,36,21,15
Балерия,blackscar,1615,evoker,devastation,36,23,13
Notomorrow,twisting-nether,1615,evoker,devastation,30,17,13
Nisper,ravencrest,1615,evoker,devastation,54,30,24
Камиороти,borean-tundra,1613,evoker,devastation,33,19,14
Mazaw,burning-legion,1613,evoker,devastation,72,41,31
Batsquatch,argent-dawn,1612,evoker,devastation,36,23,13
Zapaflap,silvermoon,1612,evoker,devastation,119,65,54
Màlakir,chogall,1612,evoker,devastation,142,72,70
Evøkergøðx,ravencrest,1612,evoker,devastation,293,144,149
Bakspek,kilrogg,1610,evoker,devastation,36,24,12
Zkrdrgn,kazzak,1610,evoker,devastation,98,53,45
Mommystrasza,dentarg,1610,evoker,devastation,110,59,51
Bigbaddragen,stormscale,1609,evoker,devastation,36,21,15
Ysterja,darkspear,1608,evoker,devastation,54,37,17
Denegos,sylvanas,1606,evoker,devastation,66,40,26
Drakshoff,khaz-modan,1606,evoker,devastation,265,142,123
Xendragon,kazzak,1606,evoker,devastation,86,45,41
Solandor,kazzak,1605,evoker,devastation,48,31,17
Xtdrakaris,uldum,1605,evoker,devastation,818,415,403
Lizarduck,tarren-mill,1605,evoker,devastation,52,26,26
Stefanosxios,bloodfeather,1604,evoker,devastation,149,80,69
Voldermort,ravencrest,1603,evoker,devastation,89,52,37
Hästdrake,the-maelstrom,1603,evoker,devastation,42,20,22
Дракарион,ashenvale,1602,evoker,devastation,60,36,24
Delorraine,burning-legion,1602,evoker,devastation,30,17,13
Nalî,dethecus,1600,evoker,devastation,42,23,19
Мнякуня,howling-fjord,1600,evoker,devastation,46,24,22
Drakeflaps,lightnings-blade,1599,evoker,devastation,30,18,12
Soleric,drakthul,1599,evoker,devastation,127,60,67
Lilpooper,bloodhoof,1598,evoker,devastation,115,63,52
Bigaluga,blackmoore,1598,evoker,devastation,54,26,28
Spýröo,kazzak,1596,evoker,devastation,281,156,125
Aegón,uldum,1595,evoker,devastation,102,46,56
Nagoli,silvermoon,1594,evoker,devastation,168,90,78
Zexiø,blackmoore,1594,evoker,devastation,42,19,23
Sadlylate,dentarg,1593,evoker,devastation,120,58,62
Krothus,outland,1590,evoker,devastation,124,67,57
Kaskala,dun-morogh,1587,evoker,devastation,90,48,42
Ludwoker,tarren-mill,1586,evoker,devastation,94,57,37
Калесгоз,howling-fjord,1586,evoker,devastation,52,23,29
Bindrasz,ahnqiraj,1579,evoker,devastation,42,19,23
Emayra,argent-dawn,1578,evoker,devastation,41,29,12
Dèéz,ravencrest,1574,evoker,devastation,51,34,17
Shumma,frostmane,1572,evoker,devastation,93,42,51
Enzospatalo,nemesis,1568,evoker,devastation,65,39,26
Aesstrass,hyjal,1568,evoker,devastation,164,83,81
Хаззаш,gordunni,1566,evoker,devastation,32,19,13
Fededorit,kazzak,1565,evoker,devastation,36,17,19
Rootzdx,ravencrest,1564,evoker,devastation,54,35,19
Øxyom,archimonde,1563,evoker,devastation,63,35,28
Glennett,silvermoon,1563,evoker,devastation,85,45,40
Touchmywings,ravencrest,1560,evoker,devastation,24,17,7
Gämeovêrkïd,archimonde,1559,evoker,devastation,95,54,41
Hørnythyria,hyjal,1559,evoker,devastation,88,45,43
Fyndassil,blackrock,1558,evoker,devastation,155,66,89
Фаламэйн,soulflayer,1554,evoker,devastation,84,46,38
Yol,bladefist,1554,evoker,devastation,165,83,82
Эндемический,soulflayer,1553,evoker,devastation,36,23,13
Dikkondrus,twisting-nether,1551,evoker,devastation,180,94,86
Yuhabahha,kazzak,1550,evoker,devastation,178,89,89
Cûddles,hyjal,1548,evoker,devastation,171,87,84
Draguzee,draenor,1546,evoker,devastation,66,37,29
Ch,ghostlands,1546,evoker,devastation,47,22,25
Arbîter,eredar,1544,evoker,devastation,36,21,15
Burnrate,draenor,1544,evoker,devastation,110,54,56
Choubalo,archimonde,1543,evoker,devastation,54,31,23
Drazam,blackrock,1543,evoker,devastation,111,61,50
Mushü,kazzak,1542,evoker,devastation,107,57,50
Kayly,twisting-nether,1540,evoker,devastation,42,29,13
Abyssfyre,sylvanas,1540,evoker,devastation,99,53,46
Лечулечу,blackscar,1539,evoker,devastation,166,80,86
Ксдз,soulflayer,1537,evoker,devastation,141,76,65
Леерустан,howling-fjord,1537,evoker,devastation,62,32,30
Tiganj,silvermoon,1536,evoker,devastation,48,31,17
Саммеракс,gordunni,1536,evoker,devastation,108,46,62
Dragonandyy,blackrock,1534,evoker,devastation,189,97,92
Gle,ragnaros,1530,evoker,devastation,90,40,50
Lùñe,hyjal,1528,evoker,devastation,18,16,2
Chck,ragnaros,1528,evoker,devastation,78,41,37
Emmagosa,argent-dawn,1528,evoker,devastation,204,106,98
Beeragos,deathwing,1528,evoker,devastation,54,28,26
Tõyz,tarren-mill,1527,evoker,devastation,72,40,32
Филлид,gordunni,1525,evoker,devastation,43,19,24
Pêengei,blackrock,1524,evoker,devastation,87,44,43
Storhorn,silvermoon,1520,evoker,devastation,42,18,24
Darksmouke,forscherliga,1519,evoker,devastation,38,18,20
Простокоршун,howling-fjord,1518,evoker,devastation,117,66,51
Arbylegion,outland,1518,evoker,devastation,136,74,62
Evokimag,grim-batol,1518,evoker,devastation,48,20,28
Dreamfyrez,dun-modr,1515,evoker,devastation,87,48,39
Tigurius,onyxia,1514,evoker,devastation,83,49,34
Draconz,stormrage,1513,evoker,devastation,60,34,26
Temeraire,argent-dawn,1513,evoker,devastation,60,32,28
Savaithnir,draenor,1513,evoker,devastation,30,16,14
Emptynuts,ravencrest,1507,evoker,devastation,36,20,16
Bodytypechad,ravencrest,1507,evoker,devastation,66,36,30
Lazurius,ravencrest,1507,evoker,devastation,54,26,28
Dracyan,taerar,1506,evoker,devastation,54,31,23
Голденджо,gordunni,1506,evoker,devastation,94,51,43
Draghad,blackmoore,1506,evoker,devastation,75,37,38
Grillkylling,outland,1503,evoker,devastation,98,54,44
Firebutt,argent-dawn,1501,evoker,devastation,106,67,39
Rfid,perenolde,1499,evoker,devastation,36,22,14
Gypsydrake,tarren-mill,1496,evoker,devastation,55,31,24
Madeinhæven,ravencrest,1495,evoker,devastation,76,37,39
Dractaris,khaz-modan,1493,evoker,devastation,162,77,85
Orrub,azshara,1493,evoker,devastation,47,21,26
Tilwahlzok,pozzo-delleternità,1492,evoker,devastation,72,37,35
Lumberdrake,stormscale,1490,evoker,devastation,58,29,29
Onsirion,argent-dawn,1489,evoker,devastation,90,44,46
Drákon,dalaran,1488,evoker,devastation,223,111,112
Kaynyxia,argent-dawn,1487,evoker,devastation,45,25,20
Caliss,archimonde,1487,evoker,devastation,124,66,58
Syraxxes,sanguino,1486,evoker,devastation,57,25,32
Dratheon,dun-modr,1485,evoker,devastation,51,30,21
Fogwing,ravencrest,1485,evoker,devastation,119,62,57
Юнигоса,soulflayer,1484,evoker,devastation,179,94,85
Malfoyer,arathor,1483,evoker,devastation,107,58,49
Йормунгандка,soulflayer,1482,evoker,devastation,55,30,25
Gaargaveko,blackmoore,1482,evoker,devastation,60,29,31
Ghiscar,dentarg,1481,evoker,devastation,134,67,67
Shroomzthyr,blackmoore,1481,evoker,devastation,96,48,48
Skywitch,ragnaros,1481,evoker,devastation,120,58,62
Уфдрактир,howling-fjord,1479,evoker,devastation,96,48,48
Shenrøn,defias-brotherhood,1476,evoker,devastation,97,42,55
Лабриса,galakrond,1475,evoker,devastation,337,167,170
Kroqmoo,drekthar,1474,evoker,devastation,279,141,138
Shenlongoat,ravencrest,1473,evoker,devastation,70,41,29
Алексатэтсуя,ashenvale,1473,evoker,devastation,95,55,40
Dragorus,stormscale,1472,evoker,devastation,81,41,40
Magmarôs,argent-dawn,1471,evoker,devastation,152,84,68
Tályn,twisting-nether,1470,evoker,devastation,66,37,29
Kuve,stormscale,1470,evoker,devastation,95,49,46
Feuerspuckii,blackrock,1468,evoker,devastation,42,25,17
Kuhi,twisting-nether,1468,evoker,devastation,126,65,61
Dreadnés,runetotem,1468,evoker,devastation,48,24,24
Maladrake,archimonde,1468,evoker,devastation,51,24,27
Shenronblue,bloodscalp,1465,evoker,devastation,30,16,14
Ken,la-croisade-écarlate,1464,evoker,devastation,376,191,185
Ninhursag,hyjal,1462,evoker,devastation,42,26,16
Волккейн,soulflayer,1462,evoker,devastation,58,28,30
Эралир,gordunni,1461,evoker,devastation,92,42,50
Dreek,emerald-dream,1460,evoker,devastation,60,37,23
Galakrond,auchindoun,1460,evoker,devastation,48,21,27
Drunkino,aegwynn,1459,evoker,devastation,126,66,60
Phanex,bloodhoof,1459,evoker,devastation,126,56,70
Baroqs,antonidas,1456,evoker,devastation,24,18,6
Varenion,sylvanas,1456,evoker,devastation,42,19,23
Shyke,draenor,1455,evoker,devastation,90,54,36
Норимида,soulflayer,1455,evoker,devastation,109,61,48
Iscale,twisting-nether,1455,evoker,devastation,82,45,37
Mölnlycke,twisting-nether,1455,evoker,devastation,60,32,28
Potéto,rashgarroth,1455,evoker,devastation,129,64,65
Fireandash,draenor,1453,evoker,devastation,59,33,26
Abehethan,archimonde,1452,evoker,devastation,58,29,29
Grougale,archimonde,1452,evoker,devastation,75,36,39
Kaìdo,tarren-mill,1451,evoker,devastation,72,36,36
Skyrés,dalaran,1450,evoker,devastation,28,16,12
Tibimbo,blackrock,1446,evoker,devastation,104,55,49
Rytoshi,medivh,1446,evoker,devastation,343,171,172
Скозложёп,ashenvale,1446,evoker,devastation,55,22,33
Axro,ravencrest,1445,evoker,devastation,78,48,30
Yála,anetheron,1440,evoker,devastation,291,147,144
Nuvese,tarren-mill,1438,evoker,devastation,72,31,41
Dimethyr,silvermoon,1436,evoker,devastation,130,66,64
Phyx,talnivarr,1436,evoker,devastation,66,30,36
Паунфаунд,eversong,1435,evoker,devastation,96,45,51
Tayrona,sanguino,1434,evoker,devastation,38,21,17
Piyuli,silvermoon,1434,evoker,devastation,64,34,30
Erenhan,archimonde,1434,evoker,devastation,54,19,35
Drakea,sanguino,1432,evoker,devastation,98,49,49
Echadication,tarren-mill,1431,evoker,devastation,30,15,15
Дыханиеочка,howling-fjord,1430,evoker,devastation,83,40,43
Drâker,twisting-nether,1427,evoker,devastation,24,15,9
Flaminghot,stormreaver,1427,evoker,devastation,503,269,234
Motloh,ravencrest,1427,evoker,devastation,110,54,56
Flügelnix,blackmoore,1422,evoker,devastation,65,32,33
Murrakhan,ravencrest,1421,evoker,devastation,89,39,50
Drokki,burning-legion,1420,evoker,devastation,35,19,16
Ocanada,draenor,1420,evoker,devastation,158,77,81
Raagnar,kazzak,1419,evoker,devastation,99,54,45
Héaven,nemesis,1419,evoker,devastation,113,60,53
Varagon,rexxar,1418,evoker,devastation,106,55,51
Freaksy,blackmoore,1417,evoker,devastation,27,16,11
Lektar,eredar,1416,evoker,devastation,71,34,37
Lknubraosanu,sylvanas,1415,evoker,devastation,30,16,14
Eldraegosa,argent-dawn,1415,evoker,devastation,36,16,20
Ljudigusteri,kazzak,1413,evoker,devastation,71,40,31
Scalo,kazzak,1412,evoker,devastation,55,33,22
Marvok,bloodfeather,1410,evoker,devastation,145,66,79
Geckonen,stormreaver,1409,evoker,devastation,115,65,50
Ssjblack,archimonde,1409,evoker,devastation,47,24,23
Drevo,nemesis,1407,evoker,devastation,18,15,3
Xéíoín,kazzak,1407,evoker,devastation,120,64,56
Deadlyvok,zenedar,1407,evoker,devastation,47,24,23
Pippomale,nemesis,1407,evoker,devastation,60,30,30
Мусье,soulflayer,1407,evoker,devastation,48,19,29
Hellvarg,twisting-nether,1406,evoker,devastation,66,34,32
Hornytail,doomhammer,1406,evoker,devastation,88,45,43
Dragondeezs,silvermoon,1405,evoker,devastation,66,36,30
Драгс,razuvious,1403,evoker,devastation,41,25,16
Thavion,forscherliga,1402,evoker,devastation,42,20,22
Jeremiah,earthen-ring,1401,evoker,devastation,54,25,29
Ironwing,sanguino,1400,evoker,devastation,605,309,296
Feyrbrand,ysera,1400,evoker,devastation,104,53,51
Snoby,onyxia,1400,evoker,devastation,218,104,114
Billyhassan,stormscale,1399,evoker,devastation,23,15,8
Альтэфчетыре,blackscar,1397,evoker,devastation,48,30,18
Dschíses,malganis,1395,evoker,devastation,30,19,11
Cocardona,zuljin,1395,evoker,devastation,53,29,24
Smegma,norgannon,1395,evoker,devastation,60,30,30
Vagar,garona,1394,evoker,devastation,66,33,33
Yaboismok,burning-legion,1394,evoker,devastation,59,28,31
Haltorr,ravencrest,1394,evoker,devastation,90,37,53
Paintballhd,kazzak,1392,evoker,devastation,36,15,21
Wjörm,outland,1391,evoker,devastation,48,34,14
Avizz,tarren-mill,1391,evoker,devastation,51,27,24
Dragonaked,silvermoon,1390,evoker,devastation,144,75,69
Childofdawn,blackmoore,1389,evoker,devastation,99,57,42
Gasparievok,sylvanas,1388,evoker,devastation,217,106,111
Ouaitamaman,draenor,1386,evoker,devastation,30,15,15
Agnî,sanguino,1384,evoker,devastation,116,54,62
Darktempest,onyxia,1383,evoker,devastation,102,53,49
Фелсейер,gordunni,1383,evoker,devastation,136,65,71
Deskölorio,shendralar,1382,evoker,devastation,108,65,43
Wingit,frostmane,1382,evoker,devastation,159,90,69
Drãco,auchindoun,1381,evoker,devastation,102,37,65
Dracsona,twisting-nether,1378,evoker,devastation,72,35,37
Ðovahkiin,tarren-mill,1378,evoker,devastation,33,15,18
Yoshinora,archimonde,1377,evoker,devastation,69,34,35
Razthyr,twisting-nether,1376,evoker,devastation,106,57,49
Nathraakhza,argent-dawn,1376,evoker,devastation,54,29,25
Skabaluga,blackrock,1376,evoker,devastation,126,65,61
Gendowyn,draenor,1376,evoker,devastation,42,20,22
Dramec,dun-morogh,1375,evoker,devastation,64,39,25
Dragruf,aegwynn,1374,evoker,devastation,30,15,15
Llael,blackhand,1374,evoker,devastation,134,64,70
Nurilla,twisting-nether,1370,evoker,devastation,60,30,30
Metadrak,kazzak,1369,evoker,devastation,30,17,13
Zárelyón,ragnaros,1368,evoker,devastation,31,23,8
Steeken,haomarush,1365,evoker,devastation,177,87,90
Batmanjasii,eredar,1364,evoker,devastation,47,26,21
Wircea,kazzak,1363,evoker,devastation,42,27,15
Conservion,silvermoon,1363,evoker,devastation,93,49,44
Thebigsmoke,lightbringer,1361,evoker,devastation,168,90,78
Drackial,zuljin,1361,evoker,devastation,78,33,45
Chronoalis,nemesis,1359,evoker,devastation,50,34,16
Sakade,archimonde,1359,evoker,devastation,66,22,44
Sindras,frostmane,1358,evoker,devastation,29,15,14
Cenca,blackmoore,1357,evoker,devastation,41,21,20
Hodunormu,argent-dawn,1356,evoker,devastation,53,27,26
Parisinka,silvermoon,1356,evoker,devastation,484,245,239
Rufistraz,burning-legion,1355,evoker,devastation,187,95,92
Yaldthion,dun-modr,1352,evoker,devastation,84,41,43
Димадракон,gordunni,1350,evoker,devastation,94,56,38
Keeqo,silvermoon,1350,evoker,devastation,60,35,25
Seryphys,blackhand,1350,evoker,devastation,94,48,46
Aììzen,khaz-modan,1350,evoker,devastation,30,15,15
Cuufizix,silvermoon,1349,evoker,devastation,76,40,36
Gosuvoker,eredar,1348,evoker,devastation,65,29,36
Zyevoker,silvermoon,1347,evoker,devastation,37,19,18
Lynt,burning-blade,1346,evoker,devastation,42,25,17
Bloodspiral,tarren-mill,1346,evoker,devastation,54,26,28
Ferante,ragnaros,1346,evoker,devastation,131,60,71
Йеле,soulflayer,1345,evoker,devastation,48,22,26
Thyriån,kazzak,1344,evoker,devastation,42,19,23
Flypzz,stormscale,1343,evoker,devastation,48,24,24
Skyfire,stormscale,1343,evoker,devastation,61,29,32
Oudwood,onyxia,1343,evoker,devastation,42,16,26
Echoker,stormscale,1342,evoker,devastation,61,34,27
Zsyntra,blackmoore,1342,evoker,devastation,73,29,44
Mezoudormu,argent-dawn,1342,evoker,devastation,60,17,43
Dractyr,korgall,1341,evoker,devastation,30,14,16
Lizzar,ravencrest,1340,evoker,devastation,84,40,44
Schmoker,stormscale,1338,evoker,devastation,30,14,16
Mekez,draenor,1332,evoker,devastation,24,14,10
Draqthyr,frostmane,1331,evoker,devastation,143,70,73
Magalàs,pozzo-delleternità,1328,evoker,devastation,36,18,18
Zhabrina,silvermoon,1328,evoker,devastation,42,15,27
Karnâks,silvermoon,1326,evoker,devastation,30,16,14
Chuckyy,archimonde,1326,evoker,devastation,92,44,48
Xendrag,silvermoon,1324,evoker,devastation,155,78,77
Алыйкиви,howling-fjord,1323,evoker,devastation,92,53,39
Evokíng,argent-dawn,1323,evoker,devastation,336,170,166
Füjür,dun-modr,1323,evoker,devastation,78,38,40
Cazé,archimonde,1320,evoker,devastation,43,19,24
Henvokah,ravencrest,1318,evoker,devastation,47,26,21
Darthagos,outland,1317,evoker,devastation,24,14,10
Zenda,turalyon,1316,evoker,devastation,114,57,57
Yantaî,hyjal,1315,evoker,devastation,48,30,18
Ayders,khaz-modan,1315,evoker,devastation,208,103,105
Minikuja,culte-de-la-rive-noire,1314,evoker,devastation,776,401,375
Tenshà,nemesis,1314,evoker,devastation,71,35,36
Barneyxx,tarren-mill,1314,evoker,devastation,42,14,28
Dakir,blackmoore,1312,evoker,devastation,38,26,12
Camilis,archimonde,1312,evoker,devastation,109,54,55
Dopëshow,drakthul,1311,evoker,devastation,60,37,23
Kárás,silvermoon,1311,evoker,devastation,60,29,31
Snitties,tarren-mill,1309,evoker,devastation,52,23,29
Abcxqt,hyjal,1307,evoker,devastation,82,47,35
Akaitzu,blackmoore,1307,evoker,devastation,54,30,24
Kelebron,bloodscalp,1307,evoker,devastation,30,14,16
Лимисар,gordunni,1307,evoker,devastation,59,26,33
Movoker,twisting-nether,1306,evoker,devastation,30,14,16
Nochance,dentarg,1305,evoker,devastation,102,51,51
Nazalath,eonar,1304,evoker,devastation,118,56,62
Bruhwhat,ravencrest,1303,evoker,devastation,51,23,28
Tokzestra,hyjal,1301,evoker,devastation,141,70,71
Tremola,twisting-nether,1301,evoker,devastation,39,19,20
Tendoker,ragnaros,1300,evoker,devastation,28,18,10
Drdrake,aszune,1299,evoker,devastation,42,20,22
Sharaxis,blackmoore,1298,evoker,devastation,111,58,53
Rowzy,sylvanas,1298,evoker,devastation,227,111,116
Draxone,malfurion,1297,evoker,devastation,109,61,48
Loveheart,die-aldor,1297,evoker,devastation,132,64,68
Гекаш,soulflayer,1297,evoker,devastation,94,42,52
Alèd,hyjal,1296,evoker,devastation,30,16,14
Shoggoth,chogall,1295,evoker,devastation,545,269,276
Iordred,kazzak,1294,evoker,devastation,48,27,21
Ryújín,blackhand,1294,evoker,devastation,35,15,20
Leyca,outland,1288,evoker,devastation,134,63,71
Kklur,twisting-nether,1284,evoker,devastation,30,15,15
Saratharion,argent-dawn,1280,evoker,devastation,160,78,82
Airbourne,sanguino,1280,evoker,devastation,38,18,20
Zelëph,archimonde,1277,evoker,devastation,72,34,38
Honz,antonidas,1275,evoker,devastation,85,38,47
Ceenaastra,ragnaros,1274,evoker,devastation,23,14,9
Wôpz,archimonde,1274,evoker,devastation,155,80,75
Шотнутый,soulflayer,1272,evoker,devastation,62,34,28
Shmog,stormscale,1272,evoker,devastation,41,15,26
Dyrokan,blackhand,1271,evoker,devastation,35,17,18
Драгтир,blackscar,1270,evoker,devastation,106,57,49
Tazouu,marécage-de-zangar,1264,evoker,devastation,48,31,17
Ppiaxx,dalaran,1263,evoker,devastation,30,15,15
Aeryz,burning-legion,1261,evoker,devastation,71,22,49
Abragan,aegwynn,1260,evoker,devastation,57,29,28
Коляомон,gordunni,1256,evoker,devastation,71,38,33
Kirinde,draenor,1256,evoker,devastation,54,27,27
Dragonppl,kazzak,1252,evoker,devastation,60,32,28
Душнот,fordragon,1252,evoker,devastation,87,45,42
Drakô,festung-der-stürme,1252,evoker,devastation,101,48,53
Aerodractyr,blackmoore,1250,evoker,devastation,66,26,40
Ryuniss,argent-dawn,1249,evoker,devastation,42,21,21
Чешуеплет,grom,1249,evoker,devastation,54,20,34
Orazur,hyjal,1247,evoker,devastation,18,13,5
Рептилойдина,howling-fjord,1247,evoker,devastation,136,69,67
Mesmerìze,khaz-modan,1247,evoker,devastation,60,30,30
Evojøa,tarren-mill,1246,evoker,devastation,24,13,11
Эллъис,gordunni,1246,evoker,devastation,70,22,48
Malithyr,blackmoore,1245,evoker,devastation,36,21,15
Azulade,stormscale,1245,evoker,devastation,30,13,17
Hodnsak,blackmoore,1244,evoker,devastation,24,13,11
Veo,aggra-português,1244,evoker,devastation,42,20,22
Nerõ,thrall,1244,evoker,devastation,30,13,17
Kássadaín,the-maelstrom,1243,evoker,devastation,102,48,54
Натссу,borean-tundra,1241,evoker,devastation,98,50,48
Rzre,stormscale,1241,evoker,devastation,72,32,40
Batmanwing,draenor,1240,evoker,devastation,24,13,11
Kelistrasza,die-aldor,1240,evoker,devastation,124,61,63
Veiv,tarren-mill,1240,evoker,devastation,32,14,18
Nyedrak,kilrogg,1239,evoker,devastation,18,13,5
Dowaa,tarren-mill,1239,evoker,devastation,57,21,36
Dragønlord,blackrock,1235,evoker,devastation,30,13,17
Archidrake,ravencrest,1233,evoker,devastation,79,37,42
Flyingaway,tarren-mill,1231,evoker,devastation,18,13,5
Ignisaureus,silvermoon,1229,evoker,devastation,36,17,19
Zalizopuz,tarren-mill,1229,evoker,devastation,36,13,23
Craichead,defias-brotherhood,1228,evoker,devastation,36,19,17
Favill,blackhand,1228,evoker,devastation,93,39,54
Naömi,archimonde,1227,evoker,devastation,24,13,11
Itisabuse,antonidas,1227,evoker,devastation,78,38,40
Кровит,soulflayer,1225,evoker,devastation,42,17,25
Доракарис,deathweaver,1224,evoker,devastation,82,39,43
Mâhýo,rexxar,1221,evoker,devastation,30,13,17
Серцедраконн,gordunni,1219,evoker,devastation,101,45,56
Умгак,gordunni,1218,evoker,devastation,29,13,16
Sleepnot,argent-dawn,1215,evoker,devastation,24,15,9
Hyunastraza,dalaran,1215,evoker,devastation,57,28,29
Starblazed,defias-brotherhood,1213,evoker,devastation,80,52,28
Dragoncloak,blackrock,1209,evoker,devastation,106,59,47
Fullyndra,archimonde,1205,evoker,devastation,114,52,62
Лавеон,gordunni,1199,evoker,devastation,30,13,17
Ahiresegyfej,ragnaros,1198,evoker,devastation,123,67,56
Rafale,the-maelstrom,1196,evoker,devastation,84,40,44
Babbendrakar,grim-batol,1195,evoker,devastation,60,23,37
Spyyrø,sanguino,1192,evoker,devastation,121,53,68
Cørvus,silvermoon,1192,evoker,devastation,43,17,26
Ziqqispyro,thrall,1190,evoker,devastation,30,13,17
Xfckd,ragnaros,1180,evoker,devastation,77,36,41
Папиич,soulflayer,1176,evoker,devastation,59,21,38
Azzul,teldrassil,1175,evoker,devastation,90,45,45
Firaxis,kazzak,1173,evoker,devastation,66,35,31
Рагира,gordunni,1172,evoker,devastation,86,34,52
Bæxo,blackrock,1170,evoker,devastation,106,45,61
Terenus,hellfire,1164,evoker,devastation,36,14,22
Kalep,kazzak,1163,evoker,devastation,33,16,17
Lugarius,gilneas,1162,evoker,devastation,77,41,36
Gharløk,outland,1162,evoker,devastation,92,45,47
Jelboen,draenor,1161,evoker,devastation,52,30,22
Lago,gorgonnash,1161,evoker,devastation,122,65,57
Klim,temple-noir,1160,evoker,devastation,41,15,26
Noky,aegwynn,1153,evoker,devastation,60,29,31
Kmzi,twisting-nether,1151,evoker,devastation,24,12,12
Spicylizard,stormscale,1151,evoker,devastation,24,12,12
Draclight,nemesis,1151,evoker,devastation,54,23,31
Deny,frostmane,1150,evoker,devastation,18,12,6
Spyro,bloodfeather,1150,evoker,devastation,24,12,12
Paizz,tarren-mill,1149,evoker,devastation,18,12,6
Isizzu,draenor,1149,evoker,devastation,115,56,59
Luu,the-maelstrom,1148,evoker,devastation,24,12,12
Tömmöfwarrs,archimonde,1145,evoker,devastation,27,13,14
Imwhite,doomhammer,1144,evoker,devastation,48,22,26
Aintnospyro,silvermoon,1143,evoker,devastation,114,49,65
Туймаада,soulflayer,1141,evoker,devastation,18,12,6
Flawxy,blackmoore,1141,evoker,devastation,24,12,12
Valdrakk,argent-dawn,1140,evoker,devastation,24,12,12
Crygon,outland,1140,evoker,devastation,57,26,31
Dàenérys,hyjal,1139,evoker,devastation,74,46,28
Gissthebuzzy,dun-modr,1138,evoker,devastation,24,12,12
Scathethrel,draenor,1135,evoker,devastation,24,12,12
Hazzèr,blackrock,1135,evoker,devastation,313,152,161
Wurm,shadowsong,1132,evoker,devastation,18,12,6
Antistrasza,argent-dawn,1125,evoker,devastation,33,15,18
Rhel,the-maelstrom,1123,evoker,devastation,65,31,34
Mirazare,khadgar,1122,evoker,devastation,126,63,63
Hijeon,ravencrest,1121,evoker,devastation,30,12,18
Deathdula,draenor,1117,evoker,devastation,30,14,16
Dranke,silvermoon,1115,evoker,devastation,85,45,40
Tecalagos,ragnaros,1114,evoker,devastation,23,12,11
Dragônslayer,amanthul,1113,evoker,devastation,78,43,35
Dragomakry,blackmoore,1113,evoker,devastation,84,45,39
Clueless,nemesis,1112,evoker,devastation,29,12,17
Theredpepper,outland,1104,evoker,devastation,30,12,18
Arella,mannoroth,1103,evoker,devastation,592,303,289
Oldlizard,blackrock,1100,evoker,devastation,39,12,27
Rîncêwind,uldum,1099,evoker,devastation,100,57,43
Flapant,archimonde,1098,evoker,devastation,37,15,22
Kvothe,malygos,1098,evoker,devastation,42,17,25
Krithdow,terokkar,1097,evoker,devastation,29,16,13
Ferdibaba,aegwynn,1092,evoker,devastation,139,62,77
Morsan,tichondrius,1089,evoker,devastation,31,16,15
Vucashi,blackhand,1089,evoker,devastation,70,33,37
Dragis,die-aldor,1088,evoker,devastation,36,17,19
Dovakin,arathi,1087,evoker,devastation,26,15,11
Kubae,ravencrest,1087,evoker,devastation,39,19,20
Nebulai,silvermoon,1086,evoker,devastation,91,41,50
Sethos,dalaran,1082,evoker,devastation,54,21,33
Fruhans,tarren-mill,1080,evoker,devastation,29,15,14
Stuffi,frostwolf,1080,evoker,devastation,86,40,46
Ekko,nethersturm,1079,evoker,devastation,60,31,29
Padrepì,nemesis,1078,evoker,devastation,18,13,5
Provoker,die-arguswacht,1078,evoker,devastation,24,13,11
Syraxis,shadowsong,1074,evoker,devastation,28,12,16
Canitabravar,cthun,1073,evoker,devastation,142,72,70
Zhannezza,kazzak,1070,evoker,devastation,23,12,11
Akúda,blackhand,1069,evoker,devastation,42,20,22
Монархдракон,eversong,1068,evoker,devastation,49,19,30
Jkrowlingxox,ravencrest,1067,evoker,devastation,60,34,26
Дархо,goldrinn,1062,evoker,devastation,48,27,21
Iolite,dun-modr,1055,evoker,devastation,140,68,72
Fabrizios,blackrock,1055,evoker,devastation,24,11,13
Predictrash,archimonde,1054,evoker,devastation,24,11,13
Zirra,ravencrest,1054,evoker,devastation,24,11,13
Pandagos,archimonde,1053,evoker,devastation,18,11,7
Zerotales,turalyon,1053,evoker,devastation,30,18,12
Pêrcevâl,archimonde,1053,evoker,devastation,24,11,13
Lonte,hyjal,1052,evoker,devastation,18,11,7
Алрад,gordunni,1051,evoker,devastation,21,12,9
Vagar,dun-modr,1051,evoker,devastation,80,37,43
Daboc,tarren-mill,1051,evoker,devastation,74,30,44
Orangechkn,ravencrest,1050,evoker,devastation,24,11,13
Elrycx,tarren-mill,1049,evoker,devastation,18,11,7
Rodolpho,malganis,1049,evoker,devastation,24,11,13
Zweibek,stormscale,1047,evoker,devastation,30,11,19
Bot,arathor,1046,evoker,devastation,24,11,13
Spikydragon,ysondre,1043,evoker,devastation,18,11,7
Kirkgon,terokkar,1043,evoker,devastation,66,27,39
Hateroll,ravencrest,1041,evoker,devastation,24,11,13
Draganeel,frostwolf,1038,evoker,devastation,89,34,55
Otr,draenor,1035,evoker,devastation,90,38,52
Büsselberg,blackmoore,1034,evoker,devastation,42,20,22
Vrèsh,blackrock,1032,evoker,devastation,87,35,52
Драганайт,gordunni,1026,evoker,devastation,163,84,79
Alberdo,outland,1022,evoker,devastation,90,35,55
Vanima,forscherliga,1020,evoker,devastation,66,38,28
Мизурион,gordunni,1019,evoker,devastation,66,38,28
Pedogos,outland,1016,evoker,devastation,75,31,44
Dragonhero,arygos,1014,evoker,devastation,138,74,64
Evosker,zuljin,1014,evoker,devastation,95,34,61
Rieper,twisting-nether,1009,evoker,devastation,223,106,117
Валказар,gordunni,1004,evoker,devastation,106,48,58
Drakridarn,kazzak,999,evoker,devastation,29,11,18
Flyingfak,ravencrest,994,evoker,devastation,30,19,11
Malfø,exodar,990,evoker,devastation,28,12,16
Капрал,gordunni,988,evoker,devastation,14,11,3
Raktoy,frostwolf,986,evoker,devastation,106,43,63
Julerion,draenor,984,evoker,devastation,42,26,16
Драконилья,azuregos,982,evoker,devastation,26,11,15
Котик,greymane,974,evoker,devastation,82,33,49
Disizmaju,silvermoon,967,evoker,devastation,122,65,57
Dragonsweat,hyjal,960,evoker,devastation,12,10,2
Bläckrow,tarren-mill,960,evoker,devastation,12,10,2
Rhegal,auchindoun,960,evoker,devastation,12,10,2
Scalash,drakthul,960,evoker,devastation,109,58,51
Elorand,ulduar,960,evoker,devastation,144,60,84
Azustraza,ysondre,960,evoker,devastation,24,10,14
Jinthyr,anachronos,959,evoker,devastation,12,10,2
Bal,arakarahm,959,evoker,devastation,18,10,8
Terradòr,die-aldor,959,evoker,devastation,18,10,8
Ewoky,ravencrest,959,evoker,devastation,57,25,32
Safcøn,eredar,959,evoker,devastation,30,10,20
Danaval,blackhand,955,evoker,devastation,18,10,8
Maccen,twisting-nether,955,evoker,devastation,18,10,8
Grajade,dun-modr,954,evoker,devastation,18,10,8
Cxsmetic,antonidas,954,evoker,devastation,18,10,8
Xatures,twisting-nether,953,evoker,devastation,36,21,15
Mijähh,taerar,953,evoker,devastation,24,10,14
Drakkisat,archimonde,952,evoker,devastation,40,21,19
Boulior,defias-brotherhood,952,evoker,devastation,24,10,14
Mallor,kirin-tor,952,evoker,devastation,47,18,29
Lizzardhero,kazzak,948,evoker,devastation,24,10,14
Synhtol,ragnaros,947,evoker,devastation,12,10,2
Azza,uldum,947,evoker,devastation,72,30,42
Evokraut,silvermoon,938,evoker,devastation,30,15,15
Shenrøn,garona,937,evoker,devastation,41,18,23
Zpartadraga,ragnaros,928,evoker,devastation,38,20,18
Эфирид,blackscar,926,evoker,devastation,85,44,41
Leskano,aegwynn,923,evoker,devastation,30,14,16
Acedragniir,khaz-modan,920,evoker,devastation,62,32,30
Speedoflight,ragnaros,916,evoker,devastation,51,18,33
Deimong,khaz-modan,913,evoker,devastation,35,16,19
Roth,stormreaver,909,evoker,devastation,29,10,19
Stormydude,doomhammer,907,evoker,devastation,24,13,11
Аверьятор,fordragon,906,evoker,devastation,24,10,14
Ashlàr,earthen-ring,896,evoker,devastation,139,62,77
Blazinamazin,korgall,884,evoker,devastation,22,10,12
Быковскии,howling-fjord,882,evoker,devastation,96,49,47
Dragotar,malygos,880,evoker,devastation,133,66,67
Дракариса,eversong,879,evoker,devastation,49,21,28
Tenkenfutsu,elune,879,evoker,devastation,100,41,59
Donairian,doomhammer,878,evoker,devastation,134,67,67
Lifestrasza,drakthul,868,evoker,devastation,13,10,3
Thebabayag,kazzak,868,evoker,devastation,30,13,17
Drataniel,draenor,864,evoker,devastation,18,9,9
Selectaa,grim-batol,864,evoker,devastation,18,9,9
Сойлизард,gordunni,864,evoker,devastation,24,9,15
Drachenwut,aegwynn,864,evoker,devastation,24,9,15
Brxdragon,antonidas,863,evoker,devastation,12,9,3
Dratsch,blackhand,863,evoker,devastation,12,9,3
Пласедусакс,soulflayer,863,evoker,devastation,12,9,3
Killrogos,thrall,863,evoker,devastation,12,9,3
Kylor,zuljin,863,evoker,devastation,12,9,3
Рогатыйдебик,gordunni,863,evoker,devastation,18,9,9
Féféledragon,archimonde,863,evoker,devastation,18,9,9
Setutekh,argent-dawn,863,evoker,devastation,24,9,15
Zamolx,ragnaros,862,evoker,devastation,12,9,3
Tholanía,baelgun,862,evoker,devastation,12,9,3
Akumaryu,blackrock,862,evoker,devastation,12,9,3
Ernesti,draenor,862,evoker,devastation,18,9,9
Runednmf,kazzak,862,evoker,devastation,18,9,9
Nanderoza,the-maelstrom,861,evoker,devastation,12,9,3
Dracofion,ravencrest,861,evoker,devastation,18,9,9
Rekinn,tarren-mill,861,evoker,devastation,18,9,9
Bronkek,drakthul,860,evoker,devastation,30,9,21
Нирт,gordunni,859,evoker,devastation,18,9,9
Copíum,silvermoon,859,evoker,devastation,30,9,21
Звездобык,borean-tundra,856,evoker,devastation,24,9,15
Франкич,fordragon,856,evoker,devastation,28,10,18
Заднс,howling-fjord,855,evoker,devastation,24,9,15
Karistrasza,sylvanas,854,evoker,devastation,24,9,15
Azzazed,dun-modr,853,evoker,devastation,20,9,11
Дрэгшторм,gordunni,851,evoker,devastation,12,9,3
Calonddraig,turalyon,849,evoker,devastation,61,29,32
Sleipnyr,garrosh,845,evoker,devastation,72,31,41
Xarshar,dragonblight,844,evoker,devastation,17,9,8
Флардикас,gordunni,842,evoker,devastation,24,9,15
Sivaas,arathi,832,evoker,devastation,60,29,31
Syccs,blackrock,828,evoker,devastation,23,11,12
Crynerf,ravencrest,814,evoker,devastation,168,81,87
Dahwi,blackmoore,804,evoker,devastation,56,22,34
Dragneêl,nozdormu,803,evoker,devastation,27,10,17
Chrysaetor,argent-dawn,788,evoker,devastation,18,9,9
Moondragoon,ravencrest,768,evoker,devastation,12,8,4
Alusiedrake,ravencrest,768,evoker,devastation,12,8,4
Tsunamì,ysondre,768,evoker,devastation,12,8,4
Dromar,malganis,768,evoker,devastation,12,8,4
Xnazelou,hyjal,768,evoker,devastation,12,8,4
Gloombloom,emeriss,768,evoker,devastation,13,8,5
Súnny,archimonde,768,evoker,devastation,15,8,7
Malowux,outland,768,evoker,devastation,18,8,10
Zp,kazzak,768,evoker,devastation,18,8,10
Lulvoker,blackrock,768,evoker,devastation,18,8,10
Garussy,draenor,768,evoker,devastation,18,8,10
Nekrosdrake,tarren-mill,768,evoker,devastation,18,8,10
Mazakqt,draenor,768,evoker,devastation,18,8,10
Balerioon,draenor,767,evoker,devastation,12,8,4
Fetzi,blackhand,767,evoker,devastation,12,8,4
Elastrasza,burning-blade,767,evoker,devastation,12,8,4
Fayral,blackmoore,767,evoker,devastation,12,8,4
Iblvicanfly,stormscale,767,evoker,devastation,12,8,4
Rófyx,twisting-nether,767,evoker,devastation,12,8,4
Shazag,ragnaros,767,evoker,devastation,18,8,10
Tooltipshow,ragnaros,767,evoker,devastation,18,8,10
Knööz,antonidas,767,evoker,devastation,18,8,10
Bramvoker,outland,767,evoker,devastation,18,8,10
Deathwingx,sylvanas,767,evoker,devastation,18,8,10
Aiakès,marécage-de-zangar,766,evoker,devastation,12,8,4
Chatyr,kazzak,766,evoker,devastation,12,8,4
Мутаре,borean-tundra,766,evoker,devastation,18,8,10
Koris,arakarahm,765,evoker,devastation,12,8,4
Чвкдрагонит,soulflayer,765,evoker,devastation,18,8,10
Ogienoddech,silvermoon,762,evoker,devastation,18,8,10
Oeos,dragonblight,757,evoker,devastation,118,42,76
Drakenballen,ragnaros,755,evoker,devastation,15,8,7
Viorias,argent-dawn,751,evoker,devastation,24,8,16
Davioncz,thunderhorn,749,evoker,devastation,12,8,4
Reptilebrain,twisting-nether,743,evoker,devastation,25,10,15
Sakrifizér,kazzak,735,evoker,devastation,23,8,15
Dantex,ravencrest,719,evoker,devastation,15,8,7
Ominobari,silvermoon,699,evoker,devastation,31,9,22
Snookicooki,stormscale,692,evoker,devastation,16,8,8
Sebek,archimonde,672,evoker,devastation,12,7,5
Gonzalo,dun-modr,672,evoker,devastation,12,7,5
Grymvild,earthen-ring,672,evoker,devastation,12,7,5
Arecibo,tarren-mill,672,evoker,devastation,12,7,5
Taoheat,blackrock,672,evoker,devastation,12,7,5
Styxev,blackhand,672,evoker,devastation,12,7,5
Zezus,outland,672,evoker,devastation,12,7,5
Maru,outland,672,evoker,devastation,12,7,5
Flythe,silvermoon,672,evoker,devastation,12,7,5
Ishtaro,ysondre,672,evoker,devastation,12,7,5
Zettaflare,nazjatar,672,evoker,devastation,12,7,5
Эбиб,gordunni,672,evoker,devastation,12,7,5
Xiarya,draenor,672,evoker,devastation,12,7,5
Cascadia,deathwing,672,evoker,devastation,15,8,7
Glurakk,aegwynn,672,evoker,devastation,18,7,11
Ziibah,outland,672,evoker,devastation,18,7,11
Furah,thrall,672,evoker,devastation,18,7,11
Zaradreth,grim-batol,672,evoker,devastation,18,7,11
Jrmdragik,kaelthas,672,evoker,devastation,18,7,11
Kda,die-nachtwache,672,evoker,devastation,18,7,11
Drexxe,boulderfist,672,evoker,devastation,24,7,17
Ayon,frostwhisper,671,evoker,devastation,12,7,5
Kábutø,antonidas,671,evoker,devastation,12,7,5
Jarhys,draenor,671,evoker,devastation,12,7,5
Evoslaps,norgannon,671,evoker,devastation,12,7,5
Stalkhyr,elune,671,evoker,devastation,18,7,11
Manegø,eredar,671,evoker,devastation,18,7,11
Ciranazus,twisting-nether,671,evoker,devastation,18,7,11
Mishecgos,kazzak,671,evoker,devastation,18,7,11
Holdya,archimonde,670,evoker,devastation,18,7,11
Bullseiye,silvermoon,670,evoker,devastation,18,7,11
Plexd,alleria,670,evoker,devastation,18,7,11
Enemi,twisting-nether,669,evoker,devastation,14,9,5
Антиброник,gordunni,666,evoker,devastation,12,7,5
Kayizer,archimonde,657,evoker,devastation,12,7,5
Flameclaw,argent-dawn,657,evoker,devastation,12,7,5
Evokah,der-abyssische-rat,655,evoker,devastation,23,7,16
Draknil,ysondre,640,evoker,devastation,16,7,9
Auchedrax,argent-dawn,639,evoker,devastation,14,8,6
Otøgí,antonidas,638,evoker,devastation,17,7,10
Zharas,nemesis,623,evoker,devastation,11,7,4
Adônis,malorne,617,evoker,devastation,23,8,15
Kharon,garrosh,609,evoker,devastation,41,9,32
Драгур,fordragon,579,evoker,devastation,19,7,12
Ewwoker,stormreaver,576,evoker,devastation,6,6,0
Henmon,defias-brotherhood,576,evoker,devastation,6,6,0
Mérkèls,alakir,576,evoker,devastation,6,6,0
Kallistian,argent-dawn,576,evoker,devastation,6,6,0
Глорунг,howling-fjord,576,evoker,devastation,12,6,6
Gwamalak,archimonde,576,evoker,devastation,12,6,6
Gorgonn,cthun,576,evoker,devastation,12,6,6
Terrorclaw,ragnaros,576,evoker,devastation,12,6,6
Needstherapy,ravencrest,576,evoker,devastation,12,6,6
Nahida,terokkar,576,evoker,devastation,12,6,6
Nørgan,die-aldor,576,evoker,devastation,12,6,6
Puffdaddyxd,twisting-nether,576,evoker,devastation,12,6,6
Awadrake,ysondre,576,evoker,devastation,12,6,6
Apexpredator,terokkar,576,evoker,devastation,12,6,6
Lìzardboi,draenor,576,evoker,devastation,12,6,6
Tizuki,twisting-nether,576,evoker,devastation,12,6,6
Skipity,ravencrest,576,evoker,devastation,12,6,6
Charezard,draenor,576,evoker,devastation,12,6,6
Scalewind,twisting-nether,576,evoker,devastation,12,6,6
Khimari,xavius,576,evoker,devastation,12,6,6
Mattyastrasz,hyjal,576,evoker,devastation,12,6,6
Zoskinipon,frostmane,576,evoker,devastation,12,6,6
Gelth,zuljin,576,evoker,devastation,15,7,8
Dracalos,silvermoon,576,evoker,devastation,14,6,8
Croker,ravencrest,576,evoker,devastation,18,6,12
Империа,howling-fjord,576,evoker,devastation,24,6,18
Sandakari,kazzak,575,evoker,devastation,12,6,6
Zuhana,twisting-nether,575,evoker,devastation,12,6,6
Mefedrone,argent-dawn,575,evoker,devastation,12,6,6
Chunlooi,baelgun,575,evoker,devastation,12,6,6
Ágarosz,sanguino,575,evoker,devastation,12,6,6
Prismari,burning-legion,575,evoker,devastation,12,6,6
Meyowuo,doomhammer,575,evoker,devastation,14,6,8
Uprover,kazzak,575,evoker,devastation,18,6,12
Малесиндра,gordunni,575,evoker,devastation,18,6,12
Lubellion,kelthuzad,575,evoker,devastation,18,6,12
Jetfqds,archimonde,575,evoker,devastation,24,6,18
Mazzg,blackmoore,574,evoker,devastation,21,7,14
Morph,talnivarr,574,evoker,devastation,18,6,12
Dragonpastor,kazzak,574,evoker,devastation,18,6,12
Dragorona,kult-der-verdammten,572,evoker,devastation,12,6,6
Faijer,blackmoore,572,evoker,devastation,12,6,6
Voraxe,draenor,568,evoker,devastation,12,6,6
Нелдарий,grom,567,evoker,devastation,12,6,6
Torrik,drakthul,565,evoker,devastation,12,6,6
Sheego,anetheron,565,evoker,devastation,12,6,6
Sebiker,ravencrest,543,evoker,devastation,12,8,4
Molem,defias-brotherhood,543,evoker,devastation,11,6,5
Lilvorki,silvermoon,543,evoker,devastation,17,6,11
Hekatonshire,hyjal,539,evoker,devastation,11,6,5
Icyy,stormrage,528,evoker,devastation,9,7,2
Aéras,blackhand,527,evoker,devastation,11,6,5
Snàx,aggra-português,527,evoker,devastation,17,6,11
Argentrenard,twilights-hammer,526,evoker,devastation,11,6,5
Jaykvoker,kazzak,522,evoker,devastation,14,7,7
Somntersu,argent-dawn,511,evoker,devastation,14,7,7
Chronougi,ravencrest,480,evoker,devastation,6,5,1
Hösh,elune,480,evoker,devastation,6,5,1
Tovaro,xavius,480,evoker,devastation,6,5,1
Spýró,tarren-mill,480,evoker,devastation,6,5,1
Côle,blackrock,480,evoker,devastation,6,5,1
Elvarg,ragnaros,480,evoker,devastation,6,5,1
Zendervish,draenor,480,evoker,devastation,6,5,1
Zenvoker,silvermoon,480,evoker,devastation,6,5,1
Streetspyro,ravencrest,480,evoker,devastation,6,5,1
Côlt,twisting-nether,480,evoker,devastation,6,5,1
Lyssa,stormreaver,480,evoker,devastation,12,5,7
Ripgódx,bronzebeard,480,evoker,devastation,12,5,7
Yongmun,hyjal,480,evoker,devastation,12,5,7
Wuschwuscha,thrall,480,evoker,devastation,12,5,7
Arqeltzha,ravencrest,480,evoker,devastation,12,5,7
Piecemaker,malganis,480,evoker,devastation,12,5,7
Béhème,dalaran,480,evoker,devastation,12,5,7
Skulblakas,blackmoore,480,evoker,devastation,12,5,7
Icyevoker,ravencrest,480,evoker,devastation,12,5,7
Chàrizàd,archimonde,480,evoker,devastation,12,5,7
Cooperevoker,blackrock,480,evoker,devastation,12,5,7
Сансетшторм,gordunni,480,evoker,devastation,12,5,7
Chürbis,blackmoore,480,evoker,devastation,12,5,7
Dracnass,silvermoon,480,evoker,devastation,12,5,7
Niddhog,antonidas,480,evoker,devastation,12,5,7
Drgndeznuts,kazzak,480,evoker,devastation,12,5,7
Pavelito,ysondre,480,evoker,devastation,12,5,7
Dedwing,silvermoon,480,evoker,devastation,12,5,7
Monstrosity,proudmoore,480,evoker,devastation,12,5,7
Ettox,darksorrow,480,evoker,devastation,12,5,7
Trocken,blackmoore,480,evoker,devastation,12,5,7
Невердракон,howling-fjord,480,evoker,devastation,18,5,13
Nelatharius,argent-dawn,480,evoker,devastation,18,5,13
Rikji,blackmoore,480,evoker,devastation,18,5,13
Haligos,the-maelstrom,480,evoker,devastation,24,5,19
Кайрэс,gordunni,479,evoker,devastation,12,5,7
Magicae,drakthul,479,evoker,devastation,12,5,7
Polithyr,tarren-mill,479,evoker,devastation,12,5,7
Драккалис,eversong,479,evoker,devastation,12,5,7
Vermithors,ravencrest,479,evoker,devastation,12,5,7
Bombrush,ragnaros,479,evoker,devastation,15,6,9
Slyrax,nemesis,479,evoker,devastation,18,5,13
Кмандр,gordunni,479,evoker,devastation,18,5,13
Meruzhan,chamber-of-aspects,479,evoker,devastation,18,5,13
Aegonis,archimonde,477,evoker,devastation,18,5,13
Граукасия,soulflayer,456,evoker,devastation,23,7,16
Martosaurus,ravencrest,426,evoker,devastation,16,6,10
Caomanjin,silvermoon,398,evoker,devastation,7,5,2
Drominus,die-silberne-hand,384,evoker,devastation,6,4,2
Albinuaric,tarren-mill,384,evoker,devastation,6,4,2
Штеци,howling-fjord,384,evoker,devastation,6,4,2
Dragonhead,zuljin,384,evoker,devastation,6,4,2
Lonte,archimonde,384,evoker,devastation,6,4,2
Верникс,gordunni,384,evoker,devastation,6,4,2
Skiora,argent-dawn,384,evoker,devastation,6,4,2
Theralon,tarren-mill,384,evoker,devastation,6,4,2
Gulimvoker,aegwynn,384,evoker,devastation,6,4,2
Blamdrake,blackhand,384,evoker,devastation,6,4,2
Hungryhank,ragnaros,384,evoker,devastation,6,4,2
Arractas,blackhand,384,evoker,devastation,9,5,4
Fueu,draenor,384,evoker,devastation,12,4,8
Nózdormuwu,argent-dawn,384,evoker,devastation,12,4,8
Bolgrod,dun-modr,384,evoker,devastation,12,4,8
Huangzhang,burning-legion,384,evoker,devastation,12,4,8
Darkshadow,eldrethalas,384,evoker,devastation,12,4,8
Ärt,argent-dawn,384,evoker,devastation,12,4,8
Ãbl,silvermoon,384,evoker,devastation,12,4,8
Pentraktar,pozzo-delleternità,384,evoker,devastation,12,4,8
Spyróò,ravencrest,384,evoker,devastation,12,4,8
Dragondisnut,sylvanas,384,evoker,devastation,12,4,8
Nadrenion,argent-dawn,384,evoker,devastation,12,4,8
Kalki,twisting-nether,384,evoker,devastation,12,4,8
Shirim,tarren-mill,384,evoker,devastation,12,4,8
Draceon,argent-dawn,384,evoker,devastation,12,4,8
Gazunkle,draenor,384,evoker,devastation,12,4,8
Automizez,draenor,384,evoker,devastation,12,4,8
Nynnaydoth,drakthul,384,evoker,devastation,12,4,8
Dralija,sylvanas,384,evoker,devastation,12,4,8
Jamesdouglas,eredar,383,evoker,devastation,6,4,2
Лериостраз,howling-fjord,383,evoker,devastation,10,5,5
Lafaevo,alakir,383,evoker,devastation,24,4,20
Хурипро,soulflayer,382,evoker,devastation,18,4,14
Quicksmoke,argent-dawn,379,evoker,devastation,21,6,15
Dracsamdi,tarren-mill,367,evoker,devastation,11,4,7
Crispywingz,draenor,366,evoker,devastation,11,4,7
Renalia,blackrock,351,evoker,devastation,14,5,9
Krestrazzos,blackmoore,335,evoker,devastation,11,4,7
Belkavoker,zirkel-des-cenarius,319,evoker,devastation,5,4,1
Spyrothedrag,outland,319,evoker,devastation,8,4,4
Drakodêd,drakthul,304,evoker,devastation,7,4,3
Dragenlul,tarren-mill,288,evoker,devastation,6,3,3
Shåmsse,kazzak,288,evoker,devastation,6,3,3
Purplelizard,twisting-nether,288,evoker,devastation,6,3,3
Evoxir,draenor,288,evoker,devastation,6,3,3
Silverscale,ragnaros,288,evoker,devastation,6,3,3
Dragondo,aegwynn,288,evoker,devastation,6,3,3
Fivebeers,silvermoon,288,evoker,devastation,6,3,3
Kitoed,aegwynn,288,evoker,devastation,6,3,3
Lajra,ragnaros,288,evoker,devastation,6,3,3
Ughvoker,kazzak,288,evoker,devastation,6,3,3
Vyore,silvermoon,288,evoker,devastation,6,3,3
Bestofriendo,eredar,288,evoker,devastation,6,3,3
Rizato,kazzak,288,evoker,devastation,6,3,3
Chronolight,draenor,288,evoker,devastation,6,3,3
Ursinne,ravencrest,288,evoker,devastation,6,3,3
Flippmoker,argent-dawn,288,evoker,devastation,6,3,3
Clênas,kazzak,288,evoker,devastation,6,3,3
Talim,terrordar,288,evoker,devastation,6,3,3
Mollÿ,sanguino,288,evoker,devastation,6,3,3
Keltullis,archimonde,288,evoker,devastation,6,3,3
Ðragøn,argent-dawn,288,evoker,devastation,6,3,3
Drakdilla,tarren-mill,288,evoker,devastation,6,3,3
Lìshrá,baelgun,288,evoker,devastation,6,3,3
Shroudflight,draenor,288,evoker,devastation,6,3,3
Merrius,der-rat-von-dalaran,288,evoker,devastation,6,3,3
Nijo,alleria,288,evoker,devastation,6,3,3
Aviseth,draenor,288,evoker,devastation,6,3,3
Тектрис,howling-fjord,288,evoker,devastation,6,3,3
Норус,howling-fjord,288,evoker,devastation,6,3,3
Навидх,howling-fjord,288,evoker,devastation,6,3,3
Dracpal,senjin,288,evoker,devastation,6,3,3
Dracoumel,silvermoon,288,evoker,devastation,6,3,3
Louzard,draenor,288,evoker,devastation,6,3,3
Griefgodx,draenor,288,evoker,devastation,6,3,3
Feldrac,ravencrest,288,evoker,devastation,6,3,3
Iëemanjâä,dalaran,288,evoker,devastation,6,3,3
Lyncry,draenor,288,evoker,devastation,6,3,3
Barney,korgall,288,evoker,devastation,6,3,3
Nakavoker,arygos,288,evoker,devastation,6,3,3
Ðragonite,frostmane,288,evoker,devastation,6,3,3
Whysera,sylvanas,288,evoker,devastation,6,3,3
Scraier,ravenholdt,288,evoker,devastation,6,3,3
Drdrayk,balnazzar,288,evoker,devastation,6,3,3
Xceqt,blackrock,288,evoker,devastation,6,3,3
Dragonbrx,blackrock,288,evoker,devastation,6,3,3
Feinerkerl,blackmoore,288,evoker,devastation,6,3,3
Драмуся,gordunni,288,evoker,devastation,6,3,3
Brovoker,sylvanas,288,evoker,devastation,6,3,3
Rosiash,auchindoun,288,evoker,devastation,6,3,3
Лордмакс,gordunni,288,evoker,devastation,6,3,3
Dalsath,silvermoon,288,evoker,devastation,6,3,3
Azurog,blackmoore,288,evoker,devastation,6,3,3
Dragonfish,grim-batol,288,evoker,devastation,11,3,8
Raøug,blackmoore,288,evoker,devastation,12,3,9
Dragondagger,stormreaver,288,evoker,devastation,12,3,9
Vynestria,argent-dawn,288,evoker,devastation,12,3,9
Gailliade,archimonde,288,evoker,devastation,12,3,9
Twinkillerx,dun-morogh,288,evoker,devastation,12,3,9
Purge,sporeggar,288,evoker,devastation,12,3,9
Shindragøsa,ysondre,288,evoker,devastation,12,3,9
Duveloker,dragonblight,288,evoker,devastation,12,3,9
Lagarkrizos,zuljin,288,evoker,devastation,12,3,9
Valdrakken,anubarak,288,evoker,devastation,12,3,9
Имбапвп,lich-king,288,evoker,devastation,12,3,9
Абьюз,galakrond,288,evoker,devastation,12,3,9
Dundrion,outland,288,evoker,devastation,12,3,9
Sáróman,ravencrest,288,evoker,devastation,13,3,10
Fågelskräma,silvermoon,288,evoker,devastation,18,3,15
Nybxx,frostmane,288,evoker,devastation,18,3,15
Òhrabzack,blackmoore,288,evoker,devastation,18,3,15
Sliimshady,dalaran,287,evoker,devastation,6,3,3
Belianf,silvermoon,287,evoker,devastation,6,3,3
Drakonovic,blackrock,287,evoker,devastation,6,3,3
Drks,draenor,287,evoker,devastation,12,4,8
Wardrache,nerathor,287,evoker,devastation,18,3,15
Драгоблуд,soulflayer,271,evoker,devastation,14,4,10
Monkeyvoker,archimonde,256,evoker,devastation,10,3,7
Drakoonz,ravencrest,256,evoker,devastation,10,3,7
Unwoker,draenor,256,evoker,devastation,16,3,13
Escaaboy,stormscale,234,evoker,devastation,7,4,3
Kirien,blackhand,234,evoker,devastation,22,4,18
Färsia,drakthul,223,evoker,devastation,8,3,5
Ezinice,hyjal,192,evoker,devastation,6,2,4
Untuvapilvi,silvermoon,192,evoker,devastation,6,2,4
Draagon,burning-legion,192,evoker,devastation,6,2,4
Draknr,alakir,192,evoker,devastation,6,2,4
Moodyevo,kazzak,192,evoker,devastation,6,2,4
Drazaru,sanguino,192,evoker,devastation,6,2,4
Keltrasz,los-errantes,192,evoker,devastation,6,2,4
Pawthyr,dun-modr,192,evoker,devastation,6,2,4
Reddeaddrago,silvermoon,192,evoker,devastation,6,2,4
Oogabuga,outland,192,evoker,devastation,6,2,4
Shalizir,silvermoon,192,evoker,devastation,6,2,4
Flookx,silvermoon,192,evoker,devastation,6,2,4
Майтимаус,goldrinn,192,evoker,devastation,6,2,4
Norskairline,kazzak,192,evoker,devastation,6,2,4
Bossen,magtheridon,192,evoker,devastation,6,2,4
Zalegos,kazzak,192,evoker,devastation,6,2,4
Adamâs,archimonde,192,evoker,devastation,6,2,4
Evøcado,blackmoore,192,evoker,devastation,6,2,4
Frogzey,kazzak,192,evoker,devastation,6,2,4
Drakela,frostwhisper,192,evoker,devastation,6,2,4
Shenronn,zuljin,192,evoker,devastation,6,2,4
Evokelution,twisting-nether,192,evoker,devastation,6,2,4
Hühnchen,alexstrasza,192,evoker,devastation,6,2,4
Авидогх,gordunni,192,evoker,devastation,6,2,4
Безлад,gordunni,192,evoker,devastation,6,2,4
Bittewhyally,grim-batol,192,evoker,devastation,6,2,4
Airplanepeek,draenor,192,evoker,devastation,6,2,4
Kavreel,draenor,192,evoker,devastation,6,2,4
Drevoker,daggerspine,192,evoker,devastation,6,2,4
Azzaanan,kirin-tor,192,evoker,devastation,6,2,4
Draconir,stormscale,192,evoker,devastation,6,2,4
Lifetime,ravencrest,192,evoker,devastation,6,2,4
Yohkii,eredar,192,evoker,devastation,6,2,4
Exitelolx,blackrock,192,evoker,devastation,6,2,4
Dragthraz,blackhand,192,evoker,devastation,6,2,4
Natrixx,tarren-mill,192,evoker,devastation,6,2,4
Timotheus,draenor,192,evoker,devastation,6,2,4
Twokgbananas,blackhand,192,evoker,devastation,6,2,4
Kethrir,blackhand,192,evoker,devastation,6,2,4
Drogoon,ravencrest,192,evoker,devastation,6,2,4
Draaxy,twisting-nether,192,evoker,devastation,6,2,4
Niluslangbal,stormscale,192,evoker,devastation,6,2,4
Gelamk,twisting-nether,192,evoker,devastation,6,2,4
Listigrlurch,antonidas,192,evoker,devastation,6,2,4
Liljonson,stormscale,192,evoker,devastation,6,2,4
Lelemion,arathor,192,evoker,devastation,6,2,4
Malydra,blackhand,192,evoker,devastation,6,2,4
Polzeig,dentarg,192,evoker,devastation,6,2,4
Feloñ,blackrock,192,evoker,devastation,6,2,4
Deeha,antonidas,192,evoker,devastation,6,2,4
Blewjobs,sylvanas,192,evoker,devastation,6,2,4
Hahahahalolx,twisting-nether,192,evoker,devastation,6,2,4
Drakary,chogall,192,evoker,devastation,6,2,4
Kandragor,antonidas,192,evoker,devastation,6,2,4
Ellphi,illidan,192,evoker,devastation,6,2,4
Grogar,hellfire,192,evoker,devastation,6,2,4
Iyaiya,draenor,192,evoker,devastation,6,2,4
Keristrsa,argent-dawn,192,evoker,devastation,6,2,4
Lubyan,pozzo-delleternità,192,evoker,devastation,18,3,15
Mireu,twisting-nether,192,evoker,devastation,12,2,10
Redwing,pozzo-delleternità,192,evoker,devastation,12,2,10
Shellfire,twisting-nether,192,evoker,devastation,12,2,10
Jacra,twisting-nether,192,evoker,devastation,12,2,10
Órdnung,mannoroth,192,evoker,devastation,12,2,10
Czerwonooki,turalyon,192,evoker,devastation,12,2,10
Дракомант,eversong,192,evoker,devastation,12,2,10
Amaterasu,aggra-português,192,evoker,devastation,12,2,10
Andragosa,confrérie-du-thorium,192,evoker,devastation,12,2,10
Erazias,draenor,192,evoker,devastation,12,2,10
Ластнейм,blackscar,192,evoker,devastation,12,2,10
Dargonboy,draenor,192,evoker,devastation,12,2,10
Jpeo,blackhand,192,evoker,devastation,12,2,10
Obsidiana,argent-dawn,192,evoker,devastation,16,2,14
Генне,gordunni,192,evoker,devastation,17,2,15
Réku,ragnaros,192,evoker,devastation,18,2,16
Tatsuki,arthas,192,evoker,devastation,18,2,16
Marconubsii,wrathbringer,191,evoker,devastation,6,2,4
Kraakraa,turalyon,191,evoker,devastation,6,2,4
Fuecunizzu,pozzo-delleternità,191,evoker,devastation,6,2,4
Calise,kazzak,191,evoker,devastation,12,2,10
Вжухкия,gordunni,159,evoker,devastation,5,2,3
Bàz,thrall,138,evoker,devastation,6,3,3
Rock,darkspear,138,evoker,devastation,11,4,7
Acientone,kelthuzad,128,evoker,devastation,4,2,2
Kekeri,blackhand,112,evoker,devastation,7,2,5
Tneen,stormscale,96,evoker,devastation,3,2,1
Gabbabomb,blackrock,96,evoker,devastation,6,1,5
Devanthar,argent-dawn,96,evoker,devastation,6,1,5
Vahamut,argent-dawn,96,evoker,devastation,6,1,5
Vinczeform,silvermoon,96,evoker,devastation,6,1,5
Парадпланет,howling-fjord,96,evoker,devastation,6,1,5
Erones,burning-blade,96,evoker,devastation,6,1,5
Shlea,kazzak,96,evoker,devastation,6,1,5
Retyss,twisting-nether,96,evoker,devastation,6,1,5
Белыйдракон,greymane,96,evoker,devastation,6,1,5
Kerzayn,argent-dawn,96,evoker,devastation,6,1,5
Dracarysfire,kazzak,96,evoker,devastation,6,1,5
Rhaenyra,twilights-hammer,96,evoker,devastation,6,1,5
Jugzie,twisting-nether,96,evoker,devastation,6,1,5
Terrorwings,twisting-nether,96,evoker,devastation,6,1,5
Craycry,argent-dawn,96,evoker,devastation,6,1,5
Jkdrage,stormscale,96,evoker,devastation,6,1,5
Kwynus,archimonde,96,evoker,devastation,6,1,5
Møndaychest,stormscale,96,evoker,devastation,6,1,5
Uxiono,dun-modr,96,evoker,devastation,6,1,5
Гадзандопало,soulflayer,96,evoker,devastation,6,1,5
Suba,tarren-mill,96,evoker,devastation,6,1,5
Gigabreath,ravencrest,96,evoker,devastation,6,1,5
Тренакса,soulflayer,96,evoker,devastation,6,1,5
Rawrdragon,twisting-nether,96,evoker,devastation,6,1,5
Stormfury,ragnaros,96,evoker,devastation,6,1,5
Zørix,hyjal,96,evoker,devastation,6,1,5
Ronmanarmy,blackrock,96,evoker,devastation,6,1,5
Amarzu,tarren-mill,96,evoker,devastation,6,1,5
Xahal,hyjal,96,evoker,devastation,6,1,5
Redemp,kazzak,96,evoker,devastation,6,1,5
Daragnarag,aegwynn,96,evoker,devastation,6,1,5
Пухлыйхиллер,gordunni,96,evoker,devastation,6,1,5
Психея,soulflayer,96,evoker,devastation,6,1,5
Asharys,argent-dawn,96,evoker,devastation,6,1,5
Dägon,drakthul,96,evoker,devastation,6,1,5
Чобыш,gordunni,96,evoker,devastation,6,1,5
Zerario,blackhand,96,evoker,devastation,6,1,5
Silrains,silvermoon,96,evoker,devastation,6,1,5
Sléêpy,blackmoore,96,evoker,devastation,6,1,5
Gacky,ysondre,96,evoker,devastation,6,1,5
Мельхиор,booty-bay,96,evoker,devastation,6,1,5
Charovoker,blackmoore,96,evoker,devastation,6,1,5
Dreamwing,ravencrest,96,evoker,devastation,6,1,5
Setur,outland,96,evoker,devastation,12,1,11
Manadrake,silvermoon,96,evoker,devastation,12,1,11
Effrt,ravencrest,96,evoker,devastation,12,1,11
Eosin,blackrock,96,evoker,devastation,12,1,11
Exitexit,hellscream,96,evoker,devastation,12,1,11
Spioche,burning-legion,96,evoker,devastation,12,1,11
Provokerx,ravencrest,96,evoker,devastation,14,1,13
Evobse,silvermoon,79,evoker,devastation,5,1,4
Xidalulz,sylvanas,63,evoker,devastation,2,2,0
Gortthan,defias-brotherhood,48,evoker,devastation,3,1,2
Bulydracguir,kazzak,42,evoker,devastation,7,2,5
Kàzuée,outland,31,evoker,devastation,8,1,7
Jincksevoker,anachronos,16,evoker,devastation,1,1,0
Thundermifln,nemesis,16,evoker,devastation,7,1,6
Yasuohasagi,archimonde,2211,hunter,marksmanship,90,49,41
Ceitronox,argent-dawn,2201,hunter,marksmanship,119,63,56
Olyleskotch,ravencrest,2171,hunter,marksmanship,96,49,47
Ancalarion,tarren-mill,2151,hunter,marksmanship,84,45,39
Nidaliyae,archimonde,2108,hunter,marksmanship,143,70,73
Yezzu,sylvanas,2106,hunter,marksmanship,131,71,60
Deuterium,stormscale,2031,hunter,marksmanship,104,69,35
Techpoint,silvermoon,2010,hunter,marksmanship,83,49,34
Ynv,argent-dawn,1998,hunter,marksmanship,78,47,31
Мартидэн,howling-fjord,1984,hunter,marksmanship,427,213,214
Chindala,zuljin,1964,hunter,marksmanship,73,34,39
Stavfel,kazzak,1959,hunter,marksmanship,158,81,77
Арамор,blackscar,1946,hunter,marksmanship,99,54,45
Drxta,blackrock,1943,hunter,marksmanship,138,69,69
Cadvan,nagrand,1942,hunter,marksmanship,81,40,41
Wruck,echsenkessel,1929,hunter,marksmanship,126,71,55
Эксп,ashenvale,1922,hunter,marksmanship,97,48,49
Gukéx,stormscale,1921,hunter,marksmanship,60,30,30
Matasso,burning-legion,1912,hunter,marksmanship,359,178,181
Trashcarlito,eredar,1902,hunter,marksmanship,66,41,25
Cenaa,ragnaros,1898,hunter,marksmanship,31,23,8
Trapmanager,kazzak,1887,hunter,marksmanship,94,49,45
Pjållistani,ravencrest,1887,hunter,marksmanship,236,121,115
Душнила,razuvious,1885,hunter,marksmanship,299,152,147
Gorethaur,twisting-nether,1880,hunter,marksmanship,96,64,32
Harrianlar,ravenholdt,1879,hunter,marksmanship,290,137,153
Stylez,emeriss,1873,hunter,marksmanship,117,58,59
Medgical,outland,1871,hunter,marksmanship,54,25,29
Samuru,auchindoun,1861,hunter,marksmanship,77,37,40
Заллара,booty-bay,1850,hunter,marksmanship,64,35,29
Passalaqua,aegwynn,1849,hunter,marksmanship,106,63,43
Hollyz,auchindoun,1844,hunter,marksmanship,64,37,27
Skillzone,silvermoon,1843,hunter,marksmanship,54,25,29
Sizemattersx,kazzak,1842,hunter,marksmanship,208,110,98
Klarix,outland,1840,hunter,marksmanship,134,72,62
Aimywinehaus,drakthul,1840,hunter,marksmanship,60,31,29
Spirys,drakthul,1838,hunter,marksmanship,60,28,32
Nennimi,ravencrest,1833,hunter,marksmanship,117,54,63
Johnreapèr,sylvanas,1832,hunter,marksmanship,149,75,74
Onlystuns,sylvanas,1831,hunter,marksmanship,89,46,43
Mogwai,stormscale,1831,hunter,marksmanship,116,56,60
Trapsfordays,tarren-mill,1827,hunter,marksmanship,70,41,29
Maverz,blackhand,1827,hunter,marksmanship,63,35,28
Evacuatur,argent-dawn,1826,hunter,marksmanship,66,33,33
Dis,twilights-hammer,1824,hunter,marksmanship,65,32,33
Wildheárt,aegwynn,1822,hunter,marksmanship,108,56,52
Kittykite,thunderhorn,1820,hunter,marksmanship,114,53,61
Аккулэйд,blackscar,1819,hunter,marksmanship,107,48,59
Drakona,outland,1818,hunter,marksmanship,35,23,12
Spoonfingers,ravencrest,1817,hunter,marksmanship,56,30,26
Rashoumon,zuljin,1816,hunter,marksmanship,52,35,17
Crôwley,twisting-nether,1816,hunter,marksmanship,54,30,24
Huntrag,tarren-mill,1816,hunter,marksmanship,277,141,136
Jodd,ragnaros,1814,hunter,marksmanship,48,23,25
Moonzsu,ravencrest,1813,hunter,marksmanship,46,30,16
Sindorian,aggra-português,1811,hunter,marksmanship,166,89,77
Iceyx,stormscale,1810,hunter,marksmanship,48,21,27
Лесбиянюсь,gordunni,1809,hunter,marksmanship,30,19,11
Warmus,auchindoun,1808,hunter,marksmanship,75,32,43
Zulthos,kazzak,1806,hunter,marksmanship,133,67,66
Eenel,twisting-nether,1804,hunter,marksmanship,90,50,40
Noobsnatcher,draenor,1804,hunter,marksmanship,279,149,130
Áñmy,ravencrest,1804,hunter,marksmanship,53,28,25
Khregan,aerie-peak,1802,hunter,marksmanship,66,32,34
Aimshotx,stormscale,1801,hunter,marksmanship,48,28,20
Skadè,silvermoon,1801,hunter,marksmanship,66,36,30
Hï,eitrigg,1801,hunter,marksmanship,189,93,96
Gunfroor,the-maelstrom,1800,hunter,marksmanship,82,42,40
Играсломана,howling-fjord,1795,hunter,marksmanship,81,44,37
Xawai,ragnaros,1793,hunter,marksmanship,111,53,58
Suchskill,stormreaver,1790,hunter,marksmanship,83,39,44
Bøgs,the-maelstrom,1788,hunter,marksmanship,42,21,21
Huprah,ravencrest,1788,hunter,marksmanship,161,77,84
Skilachi,stormscale,1787,hunter,marksmanship,102,46,56
Dexter,ravencrest,1781,hunter,marksmanship,471,237,234
Xzmiq,outland,1780,hunter,marksmanship,162,86,76
Buffrøgues,ravencrest,1780,hunter,marksmanship,269,137,132
Ледо,deathguard,1779,hunter,marksmanship,110,58,52
Åíøñs,kazzak,1778,hunter,marksmanship,35,19,16
Самокаратель,gordunni,1772,hunter,marksmanship,78,50,28
Misstrap,drakthul,1771,hunter,marksmanship,71,44,27
Myice,twisting-nether,1771,hunter,marksmanship,66,36,30
Тайв,deepholm,1768,hunter,marksmanship,48,25,23
Xoarqt,aegwynn,1768,hunter,marksmanship,168,76,92
Миссклик,soulflayer,1765,hunter,marksmanship,137,82,55
Murtagh,khaz-modan,1764,hunter,marksmanship,102,53,49
Mousysnok,ravencrest,1762,hunter,marksmanship,103,49,54
Triggery,ravencrest,1751,hunter,marksmanship,59,32,27
Gernoqz,frostwolf,1750,hunter,marksmanship,60,31,29
Warbringerx,stormscale,1748,hunter,marksmanship,70,32,38
Мюльфинштейн,howling-fjord,1741,hunter,marksmanship,65,31,34
Naid,lordaeron,1739,hunter,marksmanship,58,34,24
Мунгардина,blackscar,1739,hunter,marksmanship,48,22,26
Outkást,sylvanas,1736,hunter,marksmanship,65,29,36
Lîs,kargath,1735,hunter,marksmanship,92,52,40
Podroto,tyrande,1733,hunter,marksmanship,112,50,62
Amistat,kazzak,1732,hunter,marksmanship,199,99,100
Luzivarus,malganis,1731,hunter,marksmanship,48,25,23
Velrox,blackmoore,1731,hunter,marksmanship,132,68,64
Imfiné,outland,1729,hunter,marksmanship,72,40,32
Eldrekou,kazzak,1729,hunter,marksmanship,60,26,34
Лотариель,howling-fjord,1728,hunter,marksmanship,66,34,32
Lègolas,sylvanas,1721,hunter,marksmanship,66,28,38
Barrybigtoe,tarren-mill,1720,hunter,marksmanship,36,20,16
Setyouintrap,ravencrest,1717,hunter,marksmanship,60,34,26
Hallé,frostmane,1714,hunter,marksmanship,84,46,38
Filizvogel,aegwynn,1713,hunter,marksmanship,35,19,16
Strikke,archimonde,1712,hunter,marksmanship,81,36,45
Sipsomewater,ravencrest,1711,hunter,marksmanship,30,18,12
Mógwaí,stormscale,1710,hunter,marksmanship,72,36,36
Nirn,ravencrest,1707,hunter,marksmanship,47,25,22
Maticshorter,blackmoore,1704,hunter,marksmanship,86,41,45
Dragnial,kazzak,1703,hunter,marksmanship,53,26,27
Килофвратх,gordunni,1702,hunter,marksmanship,266,135,131
Sãnsãs,archimonde,1701,hunter,marksmanship,95,51,44
Адвентурер,howling-fjord,1697,hunter,marksmanship,120,66,54
Kirimbald,blackmoore,1697,hunter,marksmanship,54,28,26
Alêx,outland,1697,hunter,marksmanship,180,81,99
Wêskêr,tarren-mill,1696,hunter,marksmanship,60,28,32
Natchell,ysondre,1695,hunter,marksmanship,59,29,30
Xanter,blackrock,1695,hunter,marksmanship,86,41,45
Bestregards,ravencrest,1695,hunter,marksmanship,166,77,89
Weilerz,drakthul,1695,hunter,marksmanship,54,24,30
Ðeüterium,outland,1692,hunter,marksmanship,60,32,28
Kalimdoar,blackhand,1689,hunter,marksmanship,108,53,55
Swaggercatx,stormscale,1685,hunter,marksmanship,42,19,23
Jêsslíne,ravencrest,1684,hunter,marksmanship,36,20,16
Huntsmart,kazzak,1682,hunter,marksmanship,78,34,44
Lowcaskor,turalyon,1678,hunter,marksmanship,47,26,21
Murkek,drakthul,1676,hunter,marksmanship,66,39,27
Jamesie,ravencrest,1675,hunter,marksmanship,35,21,14
Jurá,perenolde,1672,hunter,marksmanship,149,78,71
Sandchaton,ragnaros,1671,hunter,marksmanship,42,22,20
Хжв,ashenvale,1670,hunter,marksmanship,190,103,87
Pewpewstuff,draenor,1669,hunter,marksmanship,42,22,20
Birdemic,stormscale,1668,hunter,marksmanship,68,35,33
Jabela,eredar,1668,hunter,marksmanship,78,35,43
Spacenøub,archimonde,1664,hunter,marksmanship,58,24,34
Crudeconzept,talnivarr,1663,hunter,marksmanship,36,20,16
Pandanero,ravencrest,1660,hunter,marksmanship,36,20,16
Сашатетива,gordunni,1658,hunter,marksmanship,84,42,42
Cryneth,ravencrest,1657,hunter,marksmanship,193,103,90
Tidèz,aegwynn,1657,hunter,marksmanship,84,39,45
Хальвеген,gordunni,1653,hunter,marksmanship,355,183,172
Meetyour,stormscale,1652,hunter,marksmanship,54,26,28
Speedhack,argent-dawn,1650,hunter,marksmanship,63,35,28
Xqzmytrapz,blackrock,1650,hunter,marksmanship,36,18,18
Lenooby,blades-edge,1649,hunter,marksmanship,144,69,75
Snuupz,kazzak,1647,hunter,marksmanship,78,40,38
Jayri,ravencrest,1646,hunter,marksmanship,96,49,47
Mfbloom,blackmoore,1643,hunter,marksmanship,90,45,45
Elonyr,sanguino,1640,hunter,marksmanship,500,251,249
Rizlay,the-maelstrom,1640,hunter,marksmanship,108,50,58
Hõth,kazzak,1639,hunter,marksmanship,72,36,36
Triggaz,stormscale,1637,hunter,marksmanship,83,39,44
Шотнес,gordunni,1636,hunter,marksmanship,138,68,70
Sùnzí,alakir,1633,hunter,marksmanship,30,21,9
Deathshots,ravencrest,1633,hunter,marksmanship,36,20,16
Everya,ravencrest,1632,hunter,marksmanship,69,41,28
Srsbsnshunta,kazzak,1632,hunter,marksmanship,43,24,19
Yolo,drakthul,1632,hunter,marksmanship,42,23,19
Smekminbåge,tarren-mill,1632,hunter,marksmanship,92,49,43
Nyjal,archimonde,1629,hunter,marksmanship,30,20,10
Дарктеххно,howling-fjord,1629,hunter,marksmanship,36,18,18
Амореселф,gordunni,1629,hunter,marksmanship,59,25,34
Куфачка,soulflayer,1627,hunter,marksmanship,36,17,19
Unreachable,dethecus,1626,hunter,marksmanship,36,20,16
Мизэрица,soulflayer,1625,hunter,marksmanship,91,47,44
Nelf,shattered-hand,1625,hunter,marksmanship,42,17,25
Thysalee,hyjal,1624,hunter,marksmanship,61,29,32
Jeeves,outland,1624,hunter,marksmanship,72,34,38
Evengance,dragonblight,1620,hunter,marksmanship,96,58,38
Streetxpres,nethersturm,1620,hunter,marksmanship,71,33,38
Slÿzqx,archimonde,1618,hunter,marksmanship,35,21,14
Nätzz,dun-modr,1618,hunter,marksmanship,67,29,38
Elywiél,frostwolf,1616,hunter,marksmanship,107,50,57
Ixxmhunt,blackrock,1616,hunter,marksmanship,54,24,30
Бипбип,galakrond,1615,hunter,marksmanship,35,20,15
Doubletap,ysondre,1613,hunter,marksmanship,36,28,8
Metak,auchindoun,1611,hunter,marksmanship,44,26,18
Memehunter,aegwynn,1609,hunter,marksmanship,83,59,24
Loretta,ragnaros,1609,hunter,marksmanship,47,27,20
Desudi,tarren-mill,1607,hunter,marksmanship,107,55,52
Crétin,archimonde,1605,hunter,marksmanship,38,20,18
Blackbane,ravencrest,1604,hunter,marksmanship,91,46,45
Legosoldaten,stormscale,1604,hunter,marksmanship,53,21,32
Breezhunt,twisting-nether,1604,hunter,marksmanship,53,21,32
Çryneth,ravencrest,1602,hunter,marksmanship,92,49,43
Mönster,ravenholdt,1600,hunter,marksmanship,194,105,89
Hesuss,kazzak,1600,hunter,marksmanship,39,19,20
Mycélium,outland,1598,hunter,marksmanship,52,21,31
Xrey,ragnaros,1596,hunter,marksmanship,132,69,63
Slmao,tarren-mill,1594,hunter,marksmanship,100,56,44
Rêmøórsêlês,outland,1594,hunter,marksmanship,39,19,20
Brk,dun-modr,1592,hunter,marksmanship,35,19,16
Hotshòt,silvermoon,1588,hunter,marksmanship,150,80,70
Крой,howling-fjord,1588,hunter,marksmanship,83,40,43
Scheixanter,drakthul,1587,hunter,marksmanship,191,95,96
Bearmane,tarren-mill,1587,hunter,marksmanship,112,54,58
Draktron,blackmoore,1587,hunter,marksmanship,48,22,26
Bekrepál,outland,1587,hunter,marksmanship,90,37,53
Boulaax,ysondre,1585,hunter,marksmanship,71,41,30
Cryneth,twisting-nether,1583,hunter,marksmanship,63,35,28
Beletor,medivh,1582,hunter,marksmanship,36,23,13
Prodanhunts,frostmane,1580,hunter,marksmanship,280,149,131
Arung,ravencrest,1580,hunter,marksmanship,60,27,33
Nutshotx,stormscale,1580,hunter,marksmanship,144,61,83
Surtfire,alonsus,1579,hunter,marksmanship,241,126,115
Vangeroth,kazzak,1579,hunter,marksmanship,401,207,194
Трольболь,eversong,1579,hunter,marksmanship,36,17,19
Ravensoulz,stormscale,1576,hunter,marksmanship,150,81,69
Ремонтлицаа,gordunni,1575,hunter,marksmanship,139,74,65
Riflur,stormscale,1574,hunter,marksmanship,42,20,22
Джоуе,ashenvale,1574,hunter,marksmanship,42,18,24
Nmrd,archimonde,1573,hunter,marksmanship,36,19,17
Melriya,ravencrest,1573,hunter,marksmanship,106,55,51
Андреймвп,galakrond,1573,hunter,marksmanship,60,28,32
Inayah,outland,1571,hunter,marksmanship,137,73,64
Hurion,sanguino,1571,hunter,marksmanship,46,21,25
Роктджана,deathguard,1568,hunter,marksmanship,112,61,51
Hävenofün,archimonde,1565,hunter,marksmanship,64,36,28
Littlerat,kult-der-verdammten,1565,hunter,marksmanship,48,23,25
Nêzz,tarren-mill,1565,hunter,marksmanship,117,52,65
Griffithstew,blackmoore,1564,hunter,marksmanship,48,17,31
Лисатия,gordunni,1562,hunter,marksmanship,48,22,26
Yarnvid,twisting-nether,1559,hunter,marksmanship,165,85,80
Daela,elune,1558,hunter,marksmanship,148,71,77
Gunlaugr,defias-brotherhood,1556,hunter,marksmanship,57,28,29
Ekz,twisting-nether,1555,hunter,marksmanship,100,51,49
Rattentäter,alexstrasza,1554,hunter,marksmanship,66,36,30
Mclooving,runetotem,1554,hunter,marksmanship,36,19,17
Рэмпейджшот,soulflayer,1552,hunter,marksmanship,68,31,37
Будкусломаю,grom,1550,hunter,marksmanship,99,50,49
Травок,gordunni,1548,hunter,marksmanship,70,34,36
Jetay,silvermoon,1547,hunter,marksmanship,125,63,62
Манаррия,soulflayer,1547,hunter,marksmanship,116,53,63
Hylzen,outland,1546,hunter,marksmanship,83,49,34
Dafhel,hyjal,1546,hunter,marksmanship,126,64,62
Короткиствол,gordunni,1546,hunter,marksmanship,84,42,42
Anschy,ambossar,1546,hunter,marksmanship,66,29,37
Recrent,kazzak,1544,hunter,marksmanship,153,80,73
Narziel,die-todeskrallen,1543,hunter,marksmanship,130,74,56
Kanzlerkohl,frostwolf,1542,hunter,marksmanship,46,31,15
Ravator,azshara,1542,hunter,marksmanship,129,57,72
Rex,chamber-of-aspects,1541,hunter,marksmanship,57,35,22
Miladinorc,azjolnerub,1540,hunter,marksmanship,54,32,22
Zeanoff,ravencrest,1540,hunter,marksmanship,96,53,43
Donfabio,norgannon,1540,hunter,marksmanship,36,18,18
Wowkulaka,kazzak,1539,hunter,marksmanship,197,105,92
Jup,elune,1536,hunter,marksmanship,67,27,40
Lookmyezzy,ravencrest,1535,hunter,marksmanship,32,17,15
Lebalaffré,arathi,1535,hunter,marksmanship,125,64,61
Brake,kelthuzad,1533,hunter,marksmanship,46,20,26
Elja,laughing-skull,1531,hunter,marksmanship,73,40,33
Cpflex,arthas,1531,hunter,marksmanship,160,77,83
Jamzyhunter,emerald-dream,1530,hunter,marksmanship,42,17,25
Draveric,drakthul,1528,hunter,marksmanship,83,43,40
Focushunter,outland,1527,hunter,marksmanship,124,61,63
Bapt,blackrock,1527,hunter,marksmanship,101,49,52
Pargz,auchindoun,1525,hunter,marksmanship,72,41,31
Darts,outland,1521,hunter,marksmanship,150,73,77
Ditbjrapex,chants-éternels,1520,hunter,marksmanship,48,28,20
Länika,ravencrest,1519,hunter,marksmanship,64,34,30
Trytoconnect,ravencrest,1518,hunter,marksmanship,90,47,43
Keskolica,outland,1518,hunter,marksmanship,116,60,56
Lore,hyjal,1518,hunter,marksmanship,54,27,27
Bluffmakarn,silvermoon,1518,hunter,marksmanship,42,17,25
Jahunter,aggra-português,1517,hunter,marksmanship,42,23,19
Gugenot,tarren-mill,1512,hunter,marksmanship,78,41,37
Thallia,todeswache,1509,hunter,marksmanship,60,31,29
Sinplify,emeriss,1509,hunter,marksmanship,84,39,45
Ôrïøn,archimonde,1508,hunter,marksmanship,42,24,18
Crowsza,archimonde,1508,hunter,marksmanship,35,19,16
Deatharow,ravencrest,1507,hunter,marksmanship,157,80,77
Mînérvá,blackhand,1506,hunter,marksmanship,96,55,41
Дисконнэктор,soulflayer,1505,hunter,marksmanship,77,31,46
Klinksz,ysondre,1503,hunter,marksmanship,61,26,35
Kayvaal,kaelthas,1502,hunter,marksmanship,59,29,30
Hunsed,sanguino,1501,hunter,marksmanship,48,31,17
Biggusdickuz,tarren-mill,1496,hunter,marksmanship,163,88,75
Mantinell,hellfire,1496,hunter,marksmanship,42,21,21
Длинноемоджо,soulflayer,1493,hunter,marksmanship,864,431,433
Vyana,sylvanas,1493,hunter,marksmanship,41,20,21
Ahpwall,archimonde,1492,hunter,marksmanship,96,52,44
Zirilan,nemesis,1492,hunter,marksmanship,318,160,158
Executéqt,frostmourne,1490,hunter,marksmanship,41,20,21
Ileira,blackmoore,1489,hunter,marksmanship,32,18,14
Mindgap,pozzo-delleternità,1489,hunter,marksmanship,217,110,107
Coxxie,ragnaros,1489,hunter,marksmanship,48,20,28
Bæst,elune,1488,hunter,marksmanship,65,38,27
Хемари,eversong,1488,hunter,marksmanship,48,24,24
Rikishot,ravencrest,1487,hunter,marksmanship,70,37,33
Bonjwa,aegwynn,1487,hunter,marksmanship,36,17,19
Hardscoped,tarren-mill,1487,hunter,marksmanship,88,40,48
Rzeezznik,burning-legion,1487,hunter,marksmanship,46,20,26
Setis,uldaman,1485,hunter,marksmanship,66,27,39
Ронингуд,gordunni,1484,hunter,marksmanship,131,67,64
Vruh,antonidas,1483,hunter,marksmanship,66,34,32
Doomhorg,quelthalas,1482,hunter,marksmanship,204,110,94
Glad,argent-dawn,1480,hunter,marksmanship,207,103,104
Meinkoenig,frostwolf,1479,hunter,marksmanship,54,34,20
Chaussons,kazzak,1478,hunter,marksmanship,204,103,101
Barnabaz,skullcrusher,1478,hunter,marksmanship,111,56,55
Enfinici,eitrigg,1475,hunter,marksmanship,60,31,29
Оверман,azuregos,1475,hunter,marksmanship,42,20,22
Killitoss,blackmoore,1475,hunter,marksmanship,51,23,28
Nharul,blackmoore,1475,hunter,marksmanship,42,16,26
Шимэйла,gordunni,1474,hunter,marksmanship,97,51,46
Смотрюанимэ,gordunni,1474,hunter,marksmanship,66,26,40
Pínnen,draenor,1473,hunter,marksmanship,36,19,17
Kariss,khaz-modan,1473,hunter,marksmanship,197,96,101
Афигеннски,ashenvale,1473,hunter,marksmanship,66,31,35
Ozzaty,drekthar,1471,hunter,marksmanship,78,39,39
Emnia,argent-dawn,1470,hunter,marksmanship,78,37,41
Migro,sylvanas,1469,hunter,marksmanship,56,26,30
Marcher,aggra-português,1468,hunter,marksmanship,44,19,25
Mervyl,burning-legion,1467,hunter,marksmanship,42,21,21
Epheso,daggerspine,1467,hunter,marksmanship,36,16,20
Iliketraps,blackmoore,1464,hunter,marksmanship,47,19,28
Poatan,outland,1463,hunter,marksmanship,369,197,172
Jimbow,blackrock,1462,hunter,marksmanship,64,33,31
Fixel,pozzo-delleternità,1461,hunter,marksmanship,186,96,90
Trapeure,archimonde,1461,hunter,marksmanship,33,16,17
Jocitwitch,ragnaros,1460,hunter,marksmanship,33,17,16
Soupsoupsòup,blackmoore,1458,hunter,marksmanship,36,19,17
Shedzargo,twisting-nether,1458,hunter,marksmanship,42,20,22
Вееном,gordunni,1458,hunter,marksmanship,111,51,60
Скартэкс,howling-fjord,1455,hunter,marksmanship,62,39,23
Djidawn,ysondre,1454,hunter,marksmanship,42,21,21
Valkhen,boulderfist,1453,hunter,marksmanship,54,31,23
Minisay,magtheridon,1452,hunter,marksmanship,378,186,192
Øßlíck,ysondre,1451,hunter,marksmanship,58,28,30
Koratoz,blackmoore,1445,hunter,marksmanship,120,68,52
Snipèr,blackmoore,1444,hunter,marksmanship,67,36,31
Swïtchz,hyjal,1443,hunter,marksmanship,141,70,71
Reyst,moonglade,1441,hunter,marksmanship,60,31,29
Fiveshøt,blackmoore,1440,hunter,marksmanship,42,19,23
Хантвкроксах,gordunni,1438,hunter,marksmanship,52,29,23
Hiðe,archimonde,1438,hunter,marksmanship,92,48,44
Watchouttah,the-maelstrom,1438,hunter,marksmanship,36,15,21
Fugass,ragnaros,1437,hunter,marksmanship,53,31,22
Luuszapfae,aegwynn,1436,hunter,marksmanship,29,16,13
Velites,aggra-português,1436,hunter,marksmanship,54,17,37
Bøøgy,silvermoon,1435,hunter,marksmanship,234,122,112
Nagu,antonidas,1435,hunter,marksmanship,30,15,15
Räguel,ravencrest,1433,hunter,marksmanship,75,40,35
Masthuhn,blackmoore,1432,hunter,marksmanship,24,15,9
Ønske,azjolnerub,1432,hunter,marksmanship,179,91,88
Eferos,quelthalas,1432,hunter,marksmanship,120,54,66
Owyea,kazzak,1432,hunter,marksmanship,54,24,30
Carnificis,sanguino,1432,hunter,marksmanship,75,33,42
Ixlxlxlxl,kazzak,1431,hunter,marksmanship,78,48,30
Poman,azjolnerub,1431,hunter,marksmanship,71,33,38
Rísu,argent-dawn,1429,hunter,marksmanship,86,49,37
Zushji,ysondre,1429,hunter,marksmanship,420,208,212
Dezmoinez,twisting-nether,1429,hunter,marksmanship,72,35,37
Stingarrow,stormscale,1428,hunter,marksmanship,78,44,34
Shieryu,archimonde,1428,hunter,marksmanship,92,47,45
Babclaar,culte-de-la-rive-noire,1426,hunter,marksmanship,72,40,32
Xalaar,frostwolf,1426,hunter,marksmanship,98,54,44
Begøne,draenor,1423,hunter,marksmanship,42,28,14
Lennyx,quelthalas,1423,hunter,marksmanship,55,25,30
Poppson,magtheridon,1422,hunter,marksmanship,120,65,55
Tackleberry,ysondre,1422,hunter,marksmanship,48,21,27
Ahrtemís,destromath,1422,hunter,marksmanship,36,15,21
Агелетка,gordunni,1421,hunter,marksmanship,24,15,9
Yoúmad,draenor,1421,hunter,marksmanship,34,17,17
Bluelol,ravencrest,1420,hunter,marksmanship,147,67,80
Мейрелис,blackscar,1417,hunter,marksmanship,24,15,9
Kokowawaa,kazzak,1417,hunter,marksmanship,108,53,55
Jàsøn,ravencrest,1417,hunter,marksmanship,33,16,17
Kyudo,ravencrest,1416,hunter,marksmanship,148,74,74
Longblow,outland,1416,hunter,marksmanship,51,21,30
Белыйатомщик,howling-fjord,1416,hunter,marksmanship,54,22,32
Kalima,malfurion,1416,hunter,marksmanship,72,28,44
Zulthat,thrall,1415,hunter,marksmanship,42,23,19
Exstri,sargeras,1414,hunter,marksmanship,42,18,24
Shootingbob,blackrock,1413,hunter,marksmanship,62,32,30
Deathshots,aggra-português,1411,hunter,marksmanship,132,63,69
Аскентр,gordunni,1411,hunter,marksmanship,67,31,36
Qapheze,silvermoon,1409,hunter,marksmanship,127,61,66
Capball,kelthuzad,1409,hunter,marksmanship,42,20,22
Fitzgerald,ragnaros,1409,hunter,marksmanship,102,48,54
Argahnim,azjolnerub,1405,hunter,marksmanship,406,203,203
Гефесте,gordunni,1404,hunter,marksmanship,30,15,15
Хантнерюга,gordunni,1404,hunter,marksmanship,74,33,41
Eledryn,bronze-dragonflight,1403,hunter,marksmanship,50,27,23
Wielok,burning-legion,1402,hunter,marksmanship,80,41,39
Pekkoe,khaz-modan,1401,hunter,marksmanship,108,61,47
Stripedcani,kelthuzad,1398,hunter,marksmanship,36,19,17
Darm,sunstrider,1398,hunter,marksmanship,36,15,21
Lobos,ravencrest,1394,hunter,marksmanship,66,29,37
Iniduhr,dalaran,1394,hunter,marksmanship,39,17,22
Rèyz,blackhand,1393,hunter,marksmanship,117,58,59
Nanns,silvermoon,1393,hunter,marksmanship,120,58,62
Ashimaru,sylvanas,1393,hunter,marksmanship,69,33,36
Firescorpion,onyxia,1392,hunter,marksmanship,48,27,21
Muddí,ravencrest,1391,hunter,marksmanship,24,15,9
Encore,sylvanas,1391,hunter,marksmanship,72,37,35
Zajaczek,burning-legion,1391,hunter,marksmanship,64,30,34
Ëluna,burning-legion,1389,hunter,marksmanship,148,79,69
Plzdontrun,sylvanas,1389,hunter,marksmanship,47,24,23
Gwalëndil,hyjal,1389,hunter,marksmanship,102,52,50
Курунирка,gordunni,1388,hunter,marksmanship,42,18,24
Tiidus,burning-legion,1387,hunter,marksmanship,94,48,46
Bollo,malganis,1387,hunter,marksmanship,102,48,54
Duckling,argent-dawn,1387,hunter,marksmanship,54,25,29
Антисерт,ashenvale,1387,hunter,marksmanship,48,18,30
Anjeschka,nemesis,1386,hunter,marksmanship,66,36,30
Aimnfire,anachronos,1384,hunter,marksmanship,91,47,44
Mânhunt,blackhand,1383,hunter,marksmanship,76,40,36
Tntabsotrap,silvermoon,1383,hunter,marksmanship,88,44,44
Ashrîel,outland,1382,hunter,marksmanship,94,44,50
Treyzzor,blackmoore,1381,hunter,marksmanship,36,15,21
Angelcr,uldum,1381,hunter,marksmanship,36,15,21
Bgxd,tarren-mill,1381,hunter,marksmanship,42,17,25
Vethan,die-aldor,1381,hunter,marksmanship,68,27,41
Amortên,silvermoon,1380,hunter,marksmanship,29,15,14
Balamut,aegwynn,1379,hunter,marksmanship,104,53,51
Nékfeu,hyjal,1377,hunter,marksmanship,42,23,19
Эвилтар,soulflayer,1377,hunter,marksmanship,32,16,16
Lincolne,ravencrest,1375,hunter,marksmanship,41,17,24
Animäl,stormscale,1375,hunter,marksmanship,76,30,46
Tupalax,outland,1374,hunter,marksmanship,129,61,68
Имбакласс,howling-fjord,1373,hunter,marksmanship,104,53,51
Kbesagrillo,sanguino,1372,hunter,marksmanship,42,18,24
Scatshot,grim-batol,1370,hunter,marksmanship,60,32,28
Эльк,gordunni,1370,hunter,marksmanship,99,51,48
Samhunt,blackrock,1370,hunter,marksmanship,35,15,20
Kértor,die-aldor,1370,hunter,marksmanship,52,21,31
Antiork,doomhammer,1369,hunter,marksmanship,114,56,58
Giwtus,blackmoore,1369,hunter,marksmanship,40,15,25
Enfaktüs,silvermoon,1367,hunter,marksmanship,60,30,30
Doncar,stormscale,1367,hunter,marksmanship,99,44,55
Sivoh,silvermoon,1366,hunter,marksmanship,217,112,105
Summa,silvermoon,1366,hunter,marksmanship,100,45,55
Джинксан,blackscar,1366,hunter,marksmanship,60,27,33
Ensomnia,silvermoon,1365,hunter,marksmanship,34,23,11
Еввнух,gordunni,1365,hunter,marksmanship,102,45,57
Ofortuna,silvermoon,1364,hunter,marksmanship,78,42,36
Athel,moonglade,1364,hunter,marksmanship,42,16,26
Луврен,deepholm,1363,hunter,marksmanship,52,15,37
Absolutnoob,blackrock,1362,hunter,marksmanship,38,21,17
Souljâh,ravencrest,1361,hunter,marksmanship,83,38,45
Яриона,galakrond,1360,hunter,marksmanship,158,87,71
Crar,frostwolf,1360,hunter,marksmanship,94,50,44
Aguerex,alleria,1358,hunter,marksmanship,30,20,10
Starborne,draenor,1358,hunter,marksmanship,39,17,22
Амобарбиталх,gordunni,1357,hunter,marksmanship,129,62,67
Minerva,malfurion,1356,hunter,marksmanship,106,58,48
Incompetence,argent-dawn,1356,hunter,marksmanship,38,17,21
Jeddaj,stormscale,1356,hunter,marksmanship,42,16,26
Llaz,silvermoon,1355,hunter,marksmanship,28,15,13
Szybky,defias-brotherhood,1354,hunter,marksmanship,60,25,35
Robingood,alexstrasza,1353,hunter,marksmanship,91,36,55
Phillon,blackrock,1351,hunter,marksmanship,36,28,8
Itenik,frostwolf,1350,hunter,marksmanship,30,16,14
Girithsirion,stormscale,1349,hunter,marksmanship,36,20,16
Тантрабой,howling-fjord,1348,hunter,marksmanship,30,18,12
Krypzit,garona,1348,hunter,marksmanship,240,111,129
Гусецап,gordunni,1348,hunter,marksmanship,144,65,79
Полития,azuregos,1348,hunter,marksmanship,39,17,22
Langerlauf,alexstrasza,1346,hunter,marksmanship,42,18,24
Vavabxl,ysondre,1345,hunter,marksmanship,114,52,62
Booskihunter,burning-legion,1345,hunter,marksmanship,35,15,20
Iòvól,azuremyst,1344,hunter,marksmanship,121,63,58
Meskette,ravencrest,1344,hunter,marksmanship,36,18,18
Евилик,gordunni,1341,hunter,marksmanship,30,14,16
Laskoo,tarren-mill,1340,hunter,marksmanship,178,91,87
Deadfire,hyjal,1340,hunter,marksmanship,54,27,27
Ghostriders,archimonde,1340,hunter,marksmanship,65,28,37
Lofiv,turalyon,1340,hunter,marksmanship,40,17,23
Warkum,zuljin,1339,hunter,marksmanship,47,24,23
Øtemløol,sanguino,1339,hunter,marksmanship,30,14,16
Muckel,area-52,1339,hunter,marksmanship,42,19,23
Enÿo,ysondre,1339,hunter,marksmanship,48,16,32
Noxxen,burning-legion,1338,hunter,marksmanship,45,25,20
Adariana,archimonde,1338,hunter,marksmanship,114,54,60
Допустимхант,howling-fjord,1337,hunter,marksmanship,35,17,18
Jachtorc,kazzak,1337,hunter,marksmanship,42,18,24
Легчайшийбот,gordunni,1336,hunter,marksmanship,42,14,28
Headshott,agamaggan,1335,hunter,marksmanship,24,14,10
Barrex,guldan,1335,hunter,marksmanship,64,32,32
Jeston,amanthul,1335,hunter,marksmanship,90,40,50
Xesih,twisting-nether,1333,hunter,marksmanship,112,56,56
Lennylynx,garrosh,1333,hunter,marksmanship,66,29,37
Moschtix,forscherliga,1333,hunter,marksmanship,48,20,28
Огнеборик,howling-fjord,1333,hunter,marksmanship,71,28,43
Selaesa,chamber-of-aspects,1332,hunter,marksmanship,81,41,40
Sanhunter,eredar,1332,hunter,marksmanship,48,21,27
Оути,azuregos,1331,hunter,marksmanship,24,14,10
Travels,tarren-mill,1331,hunter,marksmanship,173,82,91
Nezekielle,drekthar,1331,hunter,marksmanship,66,27,39
Воуб,gordunni,1330,hunter,marksmanship,84,40,44
Chrishyh,blackrock,1330,hunter,marksmanship,60,28,32
Gramyr,ysondre,1329,hunter,marksmanship,24,14,10
Opî,eldrethalas,1328,hunter,marksmanship,190,95,95
Kolgrim,temple-noir,1328,hunter,marksmanship,64,31,33
Skaedi,silvermoon,1327,hunter,marksmanship,25,16,9
Elyar,eredar,1327,hunter,marksmanship,58,31,27
Azmena,silvermoon,1327,hunter,marksmanship,29,15,14
Fränko,ravencrest,1327,hunter,marksmanship,146,63,83
Chrysantes,forscherliga,1326,hunter,marksmanship,30,14,16
Carpante,nemesis,1326,hunter,marksmanship,96,42,54
Diapositiv,draenor,1325,hunter,marksmanship,30,14,16
Maroxy,ragnaros,1325,hunter,marksmanship,35,14,21
Zendar,blackmoore,1322,hunter,marksmanship,174,89,85
Bizzrip,kazzak,1320,hunter,marksmanship,48,28,20
Amphi,stormscale,1320,hunter,marksmanship,66,36,30
Milhambré,ysondre,1320,hunter,marksmanship,36,15,21
Saejku,archimonde,1319,hunter,marksmanship,34,21,13
Jalu,die-aldor,1319,hunter,marksmanship,36,21,15
Khajiizu,frostwolf,1318,hunter,marksmanship,54,28,26
Pickaboo,defias-brotherhood,1318,hunter,marksmanship,333,161,172
Boarthrills,ravencrest,1317,hunter,marksmanship,47,18,29
Zelira,boulderfist,1316,hunter,marksmanship,142,68,74
Heísenberg,ragnaros,1316,hunter,marksmanship,49,22,27
Snipekill,bronze-dragonflight,1315,hunter,marksmanship,36,20,16
Psychlolzxr,burning-legion,1315,hunter,marksmanship,53,26,27
Avaîo,ysondre,1315,hunter,marksmanship,64,24,40
Abraxan,twisting-nether,1314,hunter,marksmanship,58,34,24
Virdirthera,silvermoon,1314,hunter,marksmanship,60,30,30
Snípér,blackhand,1314,hunter,marksmanship,53,17,36
Thedoors,twisting-nether,1312,hunter,marksmanship,60,25,35
Найтхантишка,gordunni,1312,hunter,marksmanship,36,14,22
Сентуслип,fordragon,1310,hunter,marksmanship,171,78,93
Arrowdoxx,silvermoon,1310,hunter,marksmanship,117,51,66
Soviectk,aggra-português,1309,hunter,marksmanship,48,24,24
Zrogan,archimonde,1309,hunter,marksmanship,30,14,16
Asthorio,stormscale,1309,hunter,marksmanship,106,44,62
Фузег,deathguard,1308,hunter,marksmanship,36,18,18
Xaotsu,ravencrest,1308,hunter,marksmanship,51,24,27
Insanepvper,argent-dawn,1307,hunter,marksmanship,60,24,36
Lrr,grim-batol,1306,hunter,marksmanship,30,19,11
Enerhunt,ysondre,1306,hunter,marksmanship,103,57,46
Narawinger,silvermoon,1303,hunter,marksmanship,54,30,24
Silvyina,todeswache,1302,hunter,marksmanship,86,43,43
Sarblade,bronze-dragonflight,1302,hunter,marksmanship,35,17,18
Àfpro,hyjal,1302,hunter,marksmanship,128,56,72
Coft,sargeras,1301,hunter,marksmanship,42,23,19
Høøli,nethersturm,1300,hunter,marksmanship,60,36,24
Clouder,blackhand,1300,hunter,marksmanship,36,20,16
Hunterbeck,ravencrest,1299,hunter,marksmanship,128,68,60
Buzzle,sylvanas,1298,hunter,marksmanship,54,32,22
Kaktus,shattered-hand,1298,hunter,marksmanship,30,16,14
Neldrassil,blackmoore,1297,hunter,marksmanship,203,107,96
Wmaximoff,tarren-mill,1296,hunter,marksmanship,86,34,52
Тамирка,deathguard,1295,hunter,marksmanship,23,14,9
Bobleearrow,darkspear,1295,hunter,marksmanship,71,34,37
Casey,zuluhed,1295,hunter,marksmanship,42,19,23
Нереальнно,blackscar,1294,hunter,marksmanship,120,57,63
Aurah,les-clairvoyants,1292,hunter,marksmanship,48,23,25
Rydén,pozzo-delleternità,1291,hunter,marksmanship,48,19,29
Loca,twilights-hammer,1290,hunter,marksmanship,135,69,66
Booms,eonar,1290,hunter,marksmanship,99,49,50
Blackmood,twisting-nether,1287,hunter,marksmanship,46,27,19
Hollybuster,perenolde,1287,hunter,marksmanship,63,34,29
Aerieshan,ravencrest,1286,hunter,marksmanship,88,41,47
Piit,elune,1286,hunter,marksmanship,102,41,61
Tavira,zuljin,1285,hunter,marksmanship,311,156,155
Sïrrys,nemesis,1285,hunter,marksmanship,64,32,32
Sharpeyezz,ravencrest,1285,hunter,marksmanship,97,38,59
Gromaya,elune,1284,hunter,marksmanship,65,30,35
Куников,booty-bay,1284,hunter,marksmanship,36,14,22
Elisande,die-aldor,1284,hunter,marksmanship,60,23,37
Autoturret,eredar,1283,hunter,marksmanship,118,53,65
Smitheye,argent-dawn,1282,hunter,marksmanship,183,89,94
Turtíe,argent-dawn,1281,hunter,marksmanship,42,24,18
Aneji,hyjal,1281,hunter,marksmanship,160,82,78
Røxxilia,blackmoore,1280,hunter,marksmanship,72,30,42
Ксидре,eversong,1279,hunter,marksmanship,78,39,39
Orcarevolver,tarren-mill,1279,hunter,marksmanship,48,23,25
Götthunter,antonidas,1277,hunter,marksmanship,74,35,39
Silverinn,turalyon,1277,hunter,marksmanship,39,17,22
Kimia,pozzo-delleternità,1276,hunter,marksmanship,30,18,12
Waltuhwhite,teldrassil,1275,hunter,marksmanship,20,14,6
Kyßa,uldum,1275,hunter,marksmanship,81,39,42
Mainblu,nemesis,1275,hunter,marksmanship,64,30,34
Féliché,elune,1275,hunter,marksmanship,84,36,48
Lillynahh,argent-dawn,1274,hunter,marksmanship,217,109,108
Ihateyoumore,ravencrest,1274,hunter,marksmanship,48,18,30
Vanstro,ragnaros,1274,hunter,marksmanship,38,14,24
Дайпострелят,gordunni,1273,hunter,marksmanship,36,15,21
Atiyêsh,arthas,1272,hunter,marksmanship,42,17,25
Rupeebtw,stormscale,1271,hunter,marksmanship,168,79,89
Rmnsbm,blackmoore,1271,hunter,marksmanship,30,14,16
Shaib,kazzak,1270,hunter,marksmanship,28,15,13
Kaminôr,antonidas,1270,hunter,marksmanship,59,29,30
Elmadre,arthas,1270,hunter,marksmanship,66,31,35
Deathchoice,azshara,1270,hunter,marksmanship,36,14,22
Tokkie,burning-blade,1268,hunter,marksmanship,24,14,10
Zajebantip,sylvanas,1268,hunter,marksmanship,111,51,60
Salderyo,silvermoon,1266,hunter,marksmanship,38,17,21
Andtamed,thunderhorn,1264,hunter,marksmanship,90,44,46
Mmaaee,ravencrest,1263,hunter,marksmanship,81,41,40
Skyren,defias-brotherhood,1262,hunter,marksmanship,80,35,45
Gilgharsh,rajaxx,1262,hunter,marksmanship,70,30,40
Nightshäde,aggra-português,1261,hunter,marksmanship,94,42,52
Honzu,silvermoon,1260,hunter,marksmanship,42,22,20
Ililivillumi,tarren-mill,1259,hunter,marksmanship,54,26,28
Арийская,gordunni,1258,hunter,marksmanship,116,55,61
Шамагута,gordunni,1258,hunter,marksmanship,30,14,16
Yunalèsca,eredar,1258,hunter,marksmanship,40,15,25
Феорика,grom,1257,hunter,marksmanship,66,33,33
Пулемётчик,eversong,1257,hunter,marksmanship,61,29,32
Bazrzokh,elune,1256,hunter,marksmanship,42,21,21
Keritos,outland,1256,hunter,marksmanship,28,14,14
Mizumo,burning-legion,1254,hunter,marksmanship,151,77,74
Cutehuntér,ragnaros,1254,hunter,marksmanship,131,59,72
Sinequanon,mannoroth,1254,hunter,marksmanship,54,21,33
Colm,kirin-tor,1252,hunter,marksmanship,36,17,19
Skohal,draenor,1250,hunter,marksmanship,114,56,58
Bulseye,kilrogg,1250,hunter,marksmanship,30,14,16
Арктиум,gordunni,1249,hunter,marksmanship,20,14,6
Mspt,archimonde,1248,hunter,marksmanship,30,13,17
Sallina,blutkessel,1247,hunter,marksmanship,30,15,15
Magmageul,archimonde,1247,hunter,marksmanship,105,50,55
Tudjuk,arathor,1247,hunter,marksmanship,37,14,23
Ruffixvs,blackrock,1246,hunter,marksmanship,18,13,5
Fetts,silvermoon,1246,hunter,marksmanship,68,37,31
Avyo,tichondrius,1246,hunter,marksmanship,24,13,11
Curtiss,sanguino,1246,hunter,marksmanship,118,60,58
Kendow,blackrock,1246,hunter,marksmanship,126,63,63
Lísy,hyjal,1244,hunter,marksmanship,24,13,11
Huntseeker,draenor,1244,hunter,marksmanship,32,14,18
Деллвиш,howling-fjord,1244,hunter,marksmanship,30,13,17
Stormwrath,kul-tiras,1244,hunter,marksmanship,60,23,37
Iilac,argent-dawn,1242,hunter,marksmanship,184,104,80
Tinlop,ragnaros,1242,hunter,marksmanship,169,83,86
Scark,tarren-mill,1241,hunter,marksmanship,49,29,20
Huntatard,silvermoon,1241,hunter,marksmanship,28,16,12
Рбг,blackscar,1241,hunter,marksmanship,30,13,17
Zurzok,blackrock,1239,hunter,marksmanship,60,24,36
Darksmoky,forscherliga,1239,hunter,marksmanship,36,13,23
Hantdown,defias-brotherhood,1238,hunter,marksmanship,29,14,15
Blazingshot,lightbringer,1236,hunter,marksmanship,30,13,17
Jðsi,dalaran,1235,hunter,marksmanship,83,38,45
Металшот,blackscar,1234,hunter,marksmanship,74,36,38
Birgitta,jaedenar,1234,hunter,marksmanship,30,13,17
Beyzworld,antonidas,1233,hunter,marksmanship,24,13,11
Hunntte,ravencrest,1233,hunter,marksmanship,54,27,27
Corrupth,outland,1233,hunter,marksmanship,33,14,19
Huntaloko,outland,1232,hunter,marksmanship,35,17,18
Bousillator,archimonde,1228,hunter,marksmanship,42,23,19
Qiruun,draenor,1228,hunter,marksmanship,24,13,11
Barneyarrow,tarren-mill,1227,hunter,marksmanship,24,13,11
Huntazt,draenor,1225,hunter,marksmanship,24,13,11
Niwariell,silvermoon,1225,hunter,marksmanship,96,50,46
Lonewolfe,ravencrest,1225,hunter,marksmanship,547,274,273
Corrwus,argent-dawn,1225,hunter,marksmanship,111,54,57
Neuwi,stormreaver,1225,hunter,marksmanship,42,18,24
Silvyn,pozzo-delleternità,1223,hunter,marksmanship,70,33,37
Viséeauto,confrérie-du-thorium,1221,hunter,marksmanship,72,36,36
Зуллден,soulflayer,1221,hunter,marksmanship,31,13,18
Oatmeal,dun-morogh,1219,hunter,marksmanship,263,139,124
Serihu,cthun,1219,hunter,marksmanship,134,61,73
Oneeyed,kazzak,1218,hunter,marksmanship,30,14,16
Elektrô,blackmoore,1218,hunter,marksmanship,51,19,32
Blutack,stormscale,1217,hunter,marksmanship,36,15,21
Kravên,anubarak,1216,hunter,marksmanship,138,62,76
Yanger,burning-legion,1216,hunter,marksmanship,72,31,41
Elladiel,blackmoore,1215,hunter,marksmanship,31,15,16
Pappous,kul-tiras,1215,hunter,marksmanship,124,57,67
Хакаар,grom,1214,hunter,marksmanship,134,69,65
Costner,darksorrow,1213,hunter,marksmanship,36,13,23
Faenor,arygos,1212,hunter,marksmanship,102,40,62
Emti,outland,1212,hunter,marksmanship,54,20,34
Sàclak,ysondre,1211,hunter,marksmanship,126,59,67
Deneja,kilrogg,1211,hunter,marksmanship,48,20,28
Elyxa,ysondre,1210,hunter,marksmanship,74,40,34
Gødzftw,kazzak,1210,hunter,marksmanship,34,13,21
Urith,les-clairvoyants,1209,hunter,marksmanship,26,14,12
Donneraàn,blackrock,1209,hunter,marksmanship,107,53,54
Ashide,dun-modr,1209,hunter,marksmanship,30,13,17
Îratus,blackmoore,1208,hunter,marksmanship,30,16,14
Overhït,hyjal,1208,hunter,marksmanship,191,95,96
Rabiate,blackrock,1208,hunter,marksmanship,68,30,38
Gintønic,blackmoore,1207,hunter,marksmanship,42,13,29
Sindeerolla,magtheridon,1206,hunter,marksmanship,108,48,60
Rosiee,dun-modr,1205,hunter,marksmanship,18,13,5
Isohunt,alakir,1205,hunter,marksmanship,54,23,31
Redneckjoe,draenor,1204,hunter,marksmanship,58,26,32
Qqc,burning-legion,1203,hunter,marksmanship,123,62,61
Kaliistda,blackmoore,1203,hunter,marksmanship,42,17,25
Lightarròw,nordrassil,1203,hunter,marksmanship,54,21,33
Lunnaae,stormscale,1203,hunter,marksmanship,53,16,37
Kakadoo,twisting-nether,1202,hunter,marksmanship,78,40,38
Nigmatulin,burning-legion,1202,hunter,marksmanship,54,18,36
Milandria,antonidas,1200,hunter,marksmanship,92,54,38
Vïcødïnë,sinstralis,1199,hunter,marksmanship,113,52,61
Эннабонни,gordunni,1198,hunter,marksmanship,36,16,20
Fanstwo,tarren-mill,1198,hunter,marksmanship,42,14,28
Løløsifredo,ysondre,1197,hunter,marksmanship,49,26,23
Krothga,blackrock,1197,hunter,marksmanship,57,29,28
Aaryel,outland,1197,hunter,marksmanship,35,17,18
Jablaka,blackhand,1193,hunter,marksmanship,107,52,55
Оленнька,howling-fjord,1191,hunter,marksmanship,84,44,40
Ríffraff,silvermoon,1190,hunter,marksmanship,36,19,17
Bigfoot,argent-dawn,1189,hunter,marksmanship,129,56,73
Mackiemax,defias-brotherhood,1188,hunter,marksmanship,29,13,16
Salomone,nerathor,1187,hunter,marksmanship,33,14,19
Оркистор,eversong,1186,hunter,marksmanship,84,30,54
Breier,argent-dawn,1185,hunter,marksmanship,137,69,68
Azaella,tarren-mill,1185,hunter,marksmanship,48,23,25
Khâ,garona,1182,hunter,marksmanship,95,49,46
Zion,kul-tiras,1182,hunter,marksmanship,34,13,21
Rediction,ravencrest,1182,hunter,marksmanship,61,23,38
Meläna,ysondre,1180,hunter,marksmanship,48,21,27
Blueredfox,ravencrest,1180,hunter,marksmanship,35,13,22
Stevienícks,draenor,1180,hunter,marksmanship,41,15,26
Cxc,dun-modr,1179,hunter,marksmanship,55,27,28
Swáy,twisting-nether,1179,hunter,marksmanship,303,148,155
Zerkarok,draenor,1179,hunter,marksmanship,42,17,25
Darilli,wildhammer,1179,hunter,marksmanship,72,28,44
Laara,khaz-modan,1178,hunter,marksmanship,308,158,150
Omixloua,ragnaros,1178,hunter,marksmanship,141,72,69
Blackas,dun-modr,1178,hunter,marksmanship,96,45,51
Nivada,sylvanas,1178,hunter,marksmanship,29,13,16
Banemonkey,kazzak,1176,hunter,marksmanship,107,49,58
Ruger,hyjal,1176,hunter,marksmanship,55,24,31
Hoody,culte-de-la-rive-noire,1175,hunter,marksmanship,41,24,17
Rubbler,ravencrest,1175,hunter,marksmanship,66,25,41
Survivr,frostmane,1173,hunter,marksmanship,36,20,16
Одисенс,eversong,1173,hunter,marksmanship,115,57,58
Каизик,soulflayer,1173,hunter,marksmanship,36,14,22
Bobeck,blackrock,1173,hunter,marksmanship,35,13,22
Hunterdream,aszune,1171,hunter,marksmanship,52,21,31
Madtony,aegwynn,1169,hunter,marksmanship,50,23,27
Soppatorsk,shadowsong,1168,hunter,marksmanship,48,19,29
Chizuna,dun-morogh,1167,hunter,marksmanship,26,13,13
Tingly,grim-batol,1167,hunter,marksmanship,32,14,18
Celtya,archimonde,1166,hunter,marksmanship,135,69,66
Linneâ,blackmoore,1166,hunter,marksmanship,32,15,17
Skitari,draenor,1165,hunter,marksmanship,48,14,34
Dahunter,blackmoore,1164,hunter,marksmanship,36,19,17
Джантига,howling-fjord,1161,hunter,marksmanship,36,13,23
Ártemide,pozzo-delleternità,1160,hunter,marksmanship,75,41,34
Ромажиробас,gordunni,1159,hunter,marksmanship,48,22,26
Sâetha,dun-modr,1158,hunter,marksmanship,51,20,31
Cooroona,stormrage,1157,hunter,marksmanship,78,36,42
Chaydee,stormscale,1157,hunter,marksmanship,73,32,41
Naven,minahonda,1157,hunter,marksmanship,47,20,27
Watty,chogall,1156,hunter,marksmanship,154,77,77
Naizoo,doomhammer,1156,hunter,marksmanship,30,14,16
Tiph,argent-dawn,1155,hunter,marksmanship,30,18,12
Пуллятель,borean-tundra,1155,hunter,marksmanship,80,39,41
Жабра,gordunni,1155,hunter,marksmanship,58,24,34
Wasteoftimee,silvermoon,1155,hunter,marksmanship,60,21,39
Jozsiur,ragnaros,1152,hunter,marksmanship,30,18,12
Påtrîckbátém,ravencrest,1152,hunter,marksmanship,24,12,12
Foxhunt,turalyon,1152,hunter,marksmanship,50,21,29
Фанатшла,gordunni,1151,hunter,marksmanship,18,12,6
Bøost,stormscale,1151,hunter,marksmanship,18,12,6
Feelmyfurý,tarren-mill,1151,hunter,marksmanship,18,12,6
Géeked,ravencrest,1150,hunter,marksmanship,24,12,12
Olamay,blackmoore,1148,hunter,marksmanship,36,18,18
Tigér,arathor,1148,hunter,marksmanship,24,12,12
Zirgoo,outland,1148,hunter,marksmanship,81,31,50
Hxnk,argent-dawn,1147,hunter,marksmanship,18,12,6
Farmerjoee,alakir,1147,hunter,marksmanship,24,13,11
Bobihunt,argent-dawn,1147,hunter,marksmanship,53,27,26
Анхантэй,lich-king,1147,hunter,marksmanship,440,222,218
Сынсема,blackscar,1147,hunter,marksmanship,133,62,71
Lamenob,neptulon,1147,hunter,marksmanship,78,31,47
Leílah,kazzak,1145,hunter,marksmanship,102,41,61
Taveon,turalyon,1144,hunter,marksmanship,42,15,27
Jiton,grim-batol,1144,hunter,marksmanship,42,15,27
Bgkrasavec,stormscale,1142,hunter,marksmanship,75,36,39
Flintenwilly,die-aldor,1142,hunter,marksmanship,42,19,23
Üx,hyjal,1141,hunter,marksmanship,30,16,14
Халикер,soulflayer,1138,hunter,marksmanship,24,12,12
Alluan,blackrock,1138,hunter,marksmanship,30,12,18
Artémíss,kazzak,1138,hunter,marksmanship,30,12,18
Shïndh,archimonde,1137,hunter,marksmanship,24,12,12
Ruppig,nozdormu,1137,hunter,marksmanship,66,30,36
Sylphie,dalaran,1136,hunter,marksmanship,30,12,18
Heavenlyx,area-52,1135,hunter,marksmanship,66,29,37
Nym,eitrigg,1135,hunter,marksmanship,41,18,23
Partouche,sargeras,1134,hunter,marksmanship,30,12,18
Механямка,gordunni,1134,hunter,marksmanship,35,13,22
Kilölek,ragnaros,1133,hunter,marksmanship,24,12,12
Zrijad,draenor,1133,hunter,marksmanship,24,12,12
Хапмьюзик,howling-fjord,1133,hunter,marksmanship,96,39,57
Dramin,defias-brotherhood,1132,hunter,marksmanship,42,16,26
Обнимуха,soulflayer,1132,hunter,marksmanship,36,12,24
Matarmeya,los-errantes,1131,hunter,marksmanship,58,30,28
Slayné,silvermoon,1131,hunter,marksmanship,24,12,12
Docchr,doomhammer,1131,hunter,marksmanship,96,44,52
Thelasiel,aerie-peak,1130,hunter,marksmanship,79,41,38
Jyzoro,stormscale,1130,hunter,marksmanship,35,15,20
Aszasi,azjolnerub,1130,hunter,marksmanship,31,13,18
Vardnev,dun-modr,1128,hunter,marksmanship,23,13,10
Snaped,malganis,1128,hunter,marksmanship,71,29,42
Panfilmaaj,burning-legion,1127,hunter,marksmanship,42,20,22
Hanzolo,uldum,1127,hunter,marksmanship,60,28,32
Tránsphobic,kilrogg,1125,hunter,marksmanship,78,37,41
Showdown,hellscream,1124,hunter,marksmanship,125,54,71
Anpaytoo,antonidas,1124,hunter,marksmanship,48,20,28
Apolix,ragnaros,1124,hunter,marksmanship,42,16,26
Jägarbröje,kazzak,1123,hunter,marksmanship,42,24,18
Juliã,dalaran,1122,hunter,marksmanship,36,17,19
Травмаопасен,gordunni,1120,hunter,marksmanship,42,13,29
Gorá,dethecus,1118,hunter,marksmanship,18,12,6
Blowplac,moonglade,1118,hunter,marksmanship,147,67,80
Guevnerm,outland,1118,hunter,marksmanship,74,26,48
Réja,norgannon,1117,hunter,marksmanship,61,28,33
Blacksyo,elune,1116,hunter,marksmanship,97,39,58
Narøs,blackhand,1114,hunter,marksmanship,94,37,57
Kilshot,burning-legion,1111,hunter,marksmanship,48,28,20
Áragorn,frostmane,1108,hunter,marksmanship,60,30,30
Ðepleter,outland,1108,hunter,marksmanship,30,12,18
Æthelflæd,nathrezim,1108,hunter,marksmanship,48,17,31
Ashkabous,kazzak,1107,hunter,marksmanship,75,42,33
Wlndrunner,ravencrest,1107,hunter,marksmanship,30,12,18
Berk,kragjin,1107,hunter,marksmanship,54,21,33
Bélier,hyjal,1105,hunter,marksmanship,56,31,25
Hollabackgrl,outland,1105,hunter,marksmanship,42,18,24
Azsräel,dalaran,1104,hunter,marksmanship,255,123,132
Barbrady,nethersturm,1103,hunter,marksmanship,36,16,20
Akyra,runetotem,1102,hunter,marksmanship,216,101,115
Hntard,stormscale,1100,hunter,marksmanship,26,13,13
Talcaliste,archimonde,1100,hunter,marksmanship,101,46,55
Ezpwnfml,aegwynn,1100,hunter,marksmanship,35,14,21
Aratoxx,blackmoore,1099,hunter,marksmanship,101,53,48
Крипа,gordunni,1099,hunter,marksmanship,92,42,50
Elcouche,draenor,1099,hunter,marksmanship,54,18,36
Bloodfallen,onyxia,1097,hunter,marksmanship,61,18,43
Airelina,kazzak,1095,hunter,marksmanship,42,16,26
Yrtja,minahonda,1090,hunter,marksmanship,73,41,32
Брухлянка,gordunni,1089,hunter,marksmanship,49,27,22
Лорбан,gordunni,1089,hunter,marksmanship,44,20,24
Halvarr,ulduar,1088,hunter,marksmanship,42,20,22
Harmonía,outland,1088,hunter,marksmanship,76,32,44
Nezuqo,archimonde,1087,hunter,marksmanship,42,16,26
Йошумитсу,howling-fjord,1084,hunter,marksmanship,56,29,27
Mántîs,argent-dawn,1084,hunter,marksmanship,73,32,41
Voitelka,terokkar,1083,hunter,marksmanship,128,64,64
Bendit,eredar,1082,hunter,marksmanship,69,34,35
Robìnhood,nemesis,1080,hunter,marksmanship,42,22,20
Shubichou,illidan,1080,hunter,marksmanship,36,16,20
Glockzs,auchindoun,1078,hunter,marksmanship,54,16,38
Sinsé,conseil-des-ombres,1077,hunter,marksmanship,58,27,31
Opsi,area-52,1076,hunter,marksmanship,126,54,72
Retroxia,stormreaver,1075,hunter,marksmanship,26,12,14
Slicer,arthas,1074,hunter,marksmanship,103,48,55
Nastytraps,blackrock,1073,hunter,marksmanship,30,12,18
Towknee,tarren-mill,1072,hunter,marksmanship,24,15,9
Touscahunter,kazzak,1072,hunter,marksmanship,288,141,147
Leafstorm,vashj,1068,hunter,marksmanship,84,33,51
Myplague,darkmoon-faire,1067,hunter,marksmanship,54,33,21
Hkizzler,kazzak,1066,hunter,marksmanship,115,53,62
Fistiecuff,auchindoun,1066,hunter,marksmanship,48,21,27
Nycto,norgannon,1065,hunter,marksmanship,24,14,10
Sekeh,ragnaros,1064,hunter,marksmanship,90,37,53
Moyraina,tarren-mill,1063,hunter,marksmanship,42,15,27
Thauana,los-errantes,1060,hunter,marksmanship,30,14,16
Nutzz,ragnaros,1059,hunter,marksmanship,59,26,33
Гилара,soulflayer,1059,hunter,marksmanship,34,12,22
Noobhuntress,norgannon,1058,hunter,marksmanship,68,22,46
Sazak,draenor,1056,hunter,marksmanship,54,31,23
Серргио,soulflayer,1056,hunter,marksmanship,36,17,19
Vèreesa,azjolnerub,1056,hunter,marksmanship,72,29,43
Кукито,goldrinn,1056,hunter,marksmanship,30,11,19
Jungletime,outland,1055,hunter,marksmanship,18,11,7
Änglatrumpet,stormreaver,1055,hunter,marksmanship,18,11,7
Bicepz,azjolnerub,1055,hunter,marksmanship,23,12,11
Анреал,gordunni,1055,hunter,marksmanship,56,27,29
Axran,ravencrest,1055,hunter,marksmanship,24,11,13
Frágile,drakthul,1055,hunter,marksmanship,24,11,13
Othellö,kazzak,1055,hunter,marksmanship,30,11,19
Енвина,gordunni,1054,hunter,marksmanship,29,13,16
Kissmyaxé,draenor,1053,hunter,marksmanship,18,11,7
Uncø,kazzak,1053,hunter,marksmanship,18,11,7
Dunkenmere,kazzak,1053,hunter,marksmanship,24,11,13
Medûse,stormscale,1053,hunter,marksmanship,24,11,13
Bladewing,archimonde,1053,hunter,marksmanship,30,11,19
Fìnwë,varimathras,1052,hunter,marksmanship,18,11,7
Blàdê,blackrock,1052,hunter,marksmanship,18,11,7
Zøk,stormscale,1051,hunter,marksmanship,18,11,7
Twak,kilrogg,1050,hunter,marksmanship,24,13,11
Хихихихх,gordunni,1050,hunter,marksmanship,24,11,13
Cøbrâ,hyjal,1050,hunter,marksmanship,33,15,18
Nìsalle,argent-dawn,1050,hunter,marksmanship,32,13,19
Eskubar,burning-legion,1049,hunter,marksmanship,144,65,79
Iziz,stormscale,1049,hunter,marksmanship,30,11,19
Слезыотлука,howling-fjord,1048,hunter,marksmanship,18,11,7
Pøca,kaelthas,1045,hunter,marksmanship,18,11,7
Mijnoke,antonidas,1044,hunter,marksmanship,24,11,13
Eilyn,quelthalas,1044,hunter,marksmanship,36,11,25
Armoredtiger,grim-batol,1043,hunter,marksmanship,140,73,67
Bloodhøund,draenor,1043,hunter,marksmanship,30,12,18
Переферия,galakrond,1043,hunter,marksmanship,30,11,19
Seariko,draenor,1043,hunter,marksmanship,37,13,24
Jaggatee,senjin,1042,hunter,marksmanship,64,29,35
Ямакасси,thermaplugg,1042,hunter,marksmanship,124,52,72
Эолиана,borean-tundra,1041,hunter,marksmanship,81,38,43
Винтаж,deepholm,1041,hunter,marksmanship,59,26,33
Cêdric,alleria,1041,hunter,marksmanship,28,12,16
Ричардн,howling-fjord,1040,hunter,marksmanship,24,11,13
Missingno,sporeggar,1039,hunter,marksmanship,42,19,23
Diosteayuda,dun-modr,1038,hunter,marksmanship,24,14,10
Dentaar,draenor,1038,hunter,marksmanship,195,96,99
Argato,eredar,1038,hunter,marksmanship,93,41,52
Nyri,drakthul,1038,hunter,marksmanship,30,11,19
Hunterixx,outland,1037,hunter,marksmanship,48,18,30
Djzntrap,outland,1035,hunter,marksmanship,30,12,18
Madida,ravencrest,1034,hunter,marksmanship,88,49,39
Eéilin,the-maelstrom,1033,hunter,marksmanship,18,11,7
Weridia,der-rat-von-dalaran,1033,hunter,marksmanship,22,12,10
Ruxu,drakthul,1033,hunter,marksmanship,36,11,25
Saccä,ysondre,1030,hunter,marksmanship,115,57,58
Artexxia,kazzak,1030,hunter,marksmanship,66,27,39
Gilgalat,drakthul,1029,hunter,marksmanship,47,20,27
Ispo,frostwolf,1028,hunter,marksmanship,100,48,52
Илюшааимшот,gordunni,1028,hunter,marksmanship,30,11,19
Nathah,burning-legion,1027,hunter,marksmanship,18,11,7
Kerrveros,ravencrest,1025,hunter,marksmanship,42,20,22
Miezuu,ravencrest,1025,hunter,marksmanship,63,27,36
Falenwing,blackmoore,1024,hunter,marksmanship,34,16,18
Quinty,durotan,1024,hunter,marksmanship,32,13,19
Olnàk,ysondre,1023,hunter,marksmanship,60,32,28
Fèhn,krasus,1019,hunter,marksmanship,24,14,10
Titanx,sylvanas,1019,hunter,marksmanship,48,23,25
Noobatala,tarren-mill,1018,hunter,marksmanship,42,20,22
Odyzeus,drakthul,1018,hunter,marksmanship,28,12,16
Ygrittéé,blackrock,1018,hunter,marksmanship,32,13,19
Zlejkadlec,burning-blade,1018,hunter,marksmanship,28,11,17
Maríschká,amanthul,1016,hunter,marksmanship,81,41,40
Конар,soulflayer,1012,hunter,marksmanship,24,11,13
Sisilianno,khaz-modan,1012,hunter,marksmanship,182,82,100
Thebalrog,korgall,1010,hunter,marksmanship,36,14,22
Nimrod,norgannon,1009,hunter,marksmanship,45,19,26
Nonamenoskil,sylvanas,1008,hunter,marksmanship,24,13,11
Кикто,gordunni,1007,hunter,marksmanship,18,11,7
Bobbers,ravencrest,1006,hunter,marksmanship,36,14,22
Венгс,howling-fjord,1005,hunter,marksmanship,39,14,25
Irïna,arakarahm,1004,hunter,marksmanship,162,88,74
Gorett,kazzak,1004,hunter,marksmanship,36,12,24
Speedofpain,kazzak,1003,hunter,marksmanship,119,55,64
Waresfido,nordrassil,1003,hunter,marksmanship,50,21,29
Jisila,ravencrest,1002,hunter,marksmanship,165,80,85
Whitehor,ragnaros,1001,hunter,marksmanship,54,23,31
Basìcs,nemesis,998,hunter,marksmanship,24,12,12
Naghtel,die-silberne-hand,998,hunter,marksmanship,128,63,65
Boomkillshot,zuljin,996,hunter,marksmanship,259,126,133
Jaýlah,draenor,991,hunter,marksmanship,54,24,30
Bonquiesha,tarren-mill,991,hunter,marksmanship,25,11,14
Vérfarkas,arathor,990,hunter,marksmanship,28,15,13
Mendinar,sylvanas,990,hunter,marksmanship,71,19,52
Tomtus,aggramar,988,hunter,marksmanship,88,44,44
Ашмадей,eversong,988,hunter,marksmanship,30,13,17
Dropthunthun,argent-dawn,985,hunter,marksmanship,50,14,36
Мальберна,eversong,984,hunter,marksmanship,70,34,36
Tungusta,defias-brotherhood,983,hunter,marksmanship,66,30,36
Aidsmacka,shattered-hand,982,hunter,marksmanship,20,11,9
Robros,dentarg,982,hunter,marksmanship,55,28,27
Ядрис,gordunni,980,hunter,marksmanship,54,23,31
Honilsom,thunderhorn,979,hunter,marksmanship,72,24,48
Wìndrunner,malfurion,977,hunter,marksmanship,107,54,53
Gohsthunter,dun-morogh,976,hunter,marksmanship,30,17,13
Faelhorn,archimonde,976,hunter,marksmanship,42,22,20
Фломидзе,gordunni,975,hunter,marksmanship,19,11,8
Olendor,blackmoore,974,hunter,marksmanship,24,14,10
Adventures,darkmoon-faire,973,hunter,marksmanship,36,21,15
Neosmoke,shadowsong,972,hunter,marksmanship,196,88,108
Krøsh,blackmoore,967,hunter,marksmanship,130,65,65
Chassfurax,hyjal,965,hunter,marksmanship,96,39,57
Väärä,stormscale,963,hunter,marksmanship,33,14,19
Коватори,borean-tundra,963,hunter,marksmanship,42,12,30
Nyxìa,shattered-halls,960,hunter,marksmanship,18,10,8
Imonér,frostmane,960,hunter,marksmanship,18,10,8
Квит,blackscar,960,hunter,marksmanship,24,10,14
Cill,ravencrest,959,hunter,marksmanship,18,10,8
Exquisitor,silvermoon,959,hunter,marksmanship,18,10,8
Dregor,nemesis,959,hunter,marksmanship,18,10,8
Srédder,defias-brotherhood,959,hunter,marksmanship,18,10,8
Freexkite,aegwynn,959,hunter,marksmanship,20,10,10
Crní,tarren-mill,959,hunter,marksmanship,87,38,49
Bãbas,sargeras,959,hunter,marksmanship,24,10,14
Scartet,blackmoore,959,hunter,marksmanship,24,10,14
Sazox,blackrock,959,hunter,marksmanship,24,10,14
Therakal,culte-de-la-rive-noire,958,hunter,marksmanship,18,10,8
Metalbaci,sylvanas,958,hunter,marksmanship,18,10,8
Jibolad,stormreaver,958,hunter,marksmanship,72,37,35
Muxilina,ravencrest,958,hunter,marksmanship,24,10,14
Tyrone,saurfang,958,hunter,marksmanship,33,11,22
Yelanna,argent-dawn,957,hunter,marksmanship,18,10,8
Dasimir,blackrock,957,hunter,marksmanship,24,10,14
Thrund,burning-legion,956,hunter,marksmanship,25,14,11
Multigodx,draenor,956,hunter,marksmanship,24,10,14
Chaoticshot,ravencrest,955,hunter,marksmanship,24,10,14
Johnydep,silvermoon,955,hunter,marksmanship,30,10,20
Rickgrimés,silvermoon,954,hunter,marksmanship,24,10,14
Majuli,stormrage,954,hunter,marksmanship,24,10,14
Dúnknóé,nordrassil,953,hunter,marksmanship,18,10,8
Isarnexx,dun-modr,953,hunter,marksmanship,47,22,25
Napa,kazzak,953,hunter,marksmanship,24,10,14
Абунай,soulflayer,952,hunter,marksmanship,30,10,20
Makaxx,stormscale,952,hunter,marksmanship,30,10,20
Amaziing,sanguino,951,hunter,marksmanship,24,10,14
Evelhunter,kargath,950,hunter,marksmanship,18,10,8
Euphellius,darkmoon-faire,950,hunter,marksmanship,95,46,49
Deathtrapper,bronzebeard,949,hunter,marksmanship,18,10,8
Lani,talnivarr,949,hunter,marksmanship,19,10,9
Quasar,arakarahm,947,hunter,marksmanship,107,44,63
Aureboby,hyjal,946,hunter,marksmanship,36,10,26
Freezyshinkn,blackrock,945,hunter,marksmanship,18,11,7
Primator,argent-dawn,942,hunter,marksmanship,15,11,4
Aspéct,ravencrest,939,hunter,marksmanship,24,10,14
Kliantra,wildhammer,938,hunter,marksmanship,224,107,117
Сандабар,borean-tundra,938,hunter,marksmanship,79,35,44
Лордввт,howling-fjord,937,hunter,marksmanship,78,41,37
Ayshæ,tarren-mill,937,hunter,marksmanship,41,21,20
Mhood,dun-morogh,931,hunter,marksmanship,56,27,29
Sogoru,dun-modr,927,hunter,marksmanship,69,37,32
Мокку,howling-fjord,925,hunter,marksmanship,54,24,30
Arkell,los-errantes,924,hunter,marksmanship,30,12,18
Кривоватый,galakrond,923,hunter,marksmanship,19,12,7
Джимуха,soulflayer,922,hunter,marksmanship,48,26,22
Ninmul,quelthalas,921,hunter,marksmanship,18,10,8
Cilia,suramar,913,hunter,marksmanship,60,23,37
Ratwithgat,argent-dawn,913,hunter,marksmanship,28,10,18
Sloe,sylvanas,911,hunter,marksmanship,26,11,15
Nawwaf,tarren-mill,911,hunter,marksmanship,59,14,45
Hnut,kazzak,908,hunter,marksmanship,59,23,36
Selini,bloodfeather,906,hunter,marksmanship,48,22,26
Koørai,outland,905,hunter,marksmanship,62,26,36
Zaragattas,aggra-português,905,hunter,marksmanship,29,12,17
Шумогон,gordunni,903,hunter,marksmanship,66,18,48
Гекагека,gordunni,902,hunter,marksmanship,36,15,21
Zicko,argent-dawn,900,hunter,marksmanship,95,42,53
Agnõr,chants-éternels,897,hunter,marksmanship,41,21,20
Storphunt,drakthul,897,hunter,marksmanship,23,10,13
Thieuu,twisting-nether,894,hunter,marksmanship,17,10,7
Umani,lightnings-blade,894,hunter,marksmanship,23,10,13
Ранбоу,howling-fjord,893,hunter,marksmanship,121,57,64
Kælan,grim-batol,893,hunter,marksmanship,35,10,25
Rivery,azjolnerub,892,hunter,marksmanship,48,24,24
Deadyeyez,doomhammer,892,hunter,marksmanship,27,12,15
Pulica,the-maelstrom,891,hunter,marksmanship,30,14,16
Prodoomer,twisting-nether,891,hunter,marksmanship,69,32,37
Burondeya,twisting-nether,888,hunter,marksmanship,36,16,20
Luckyshooter,nethersturm,884,hunter,marksmanship,95,45,50
Belkane,elune,883,hunter,marksmanship,24,10,14
Kenshinhu,turalyon,879,hunter,marksmanship,59,27,32
Grinfall,archimonde,879,hunter,marksmanship,77,26,51
Erdna,khaz-modan,877,hunter,marksmanship,66,33,33
Шикаа,gordunni,876,hunter,marksmanship,23,11,12
Gyldain,argent-dawn,874,hunter,marksmanship,137,54,83
Aliyah,blackmoore,867,hunter,marksmanship,66,33,33
Robinho,cthun,867,hunter,marksmanship,24,12,12
Slo,sylvanas,864,hunter,marksmanship,12,9,3
Mòzetonq,ravencrest,864,hunter,marksmanship,18,9,9
Ðõt,ravencrest,864,hunter,marksmanship,18,9,9
Denkstah,tarren-mill,864,hunter,marksmanship,18,9,9
Liquidhunter,quelthalas,864,hunter,marksmanship,18,9,9
Adefthunt,kazzak,864,hunter,marksmanship,18,9,9
Auxsan,outland,864,hunter,marksmanship,21,10,11
Фожа,howling-fjord,863,hunter,marksmanship,12,9,3
Dariusmm,silvermoon,863,hunter,marksmanship,12,9,3
Xygotn,sylvanas,863,hunter,marksmanship,18,9,9
Elfyhunter,outland,863,hunter,marksmanship,18,9,9
Bärlibupi,tarren-mill,863,hunter,marksmanship,18,9,9
Thugzilla,auchindoun,863,hunter,marksmanship,18,9,9
Gaudio,outland,863,hunter,marksmanship,24,9,15
Valarixx,twisting-nether,863,hunter,marksmanship,24,9,15
Jagarbladet,ravencrest,863,hunter,marksmanship,24,9,15
Xurrl,kazzak,863,hunter,marksmanship,24,9,15
Bloodshot,nethersturm,863,hunter,marksmanship,30,11,19
Какжеплевать,gordunni,862,hunter,marksmanship,12,9,3
Chloros,ysondre,862,hunter,marksmanship,18,9,9
Thazur,blackmoore,862,hunter,marksmanship,18,9,9
Fantus,sylvanas,862,hunter,marksmanship,18,9,9
Grolmgar,malganis,862,hunter,marksmanship,18,9,9
Obii,stormscale,862,hunter,marksmanship,18,9,9
Retropunk,ravencrest,862,hunter,marksmanship,18,9,9
Petardas,outland,862,hunter,marksmanship,62,29,33
Serpos,cthun,862,hunter,marksmanship,24,9,15
Нэйе,deepholm,862,hunter,marksmanship,64,13,51
Lancer,aggra-português,861,hunter,marksmanship,18,9,9
Bosseleon,blackrock,861,hunter,marksmanship,18,9,9
Qpse,silvermoon,861,hunter,marksmanship,24,9,15
Theuzikat,ragnaros,861,hunter,marksmanship,24,9,15
Djbombastic,archimonde,861,hunter,marksmanship,24,9,15
Vandathien,stormrage,861,hunter,marksmanship,24,9,15
Screewu,twisting-nether,861,hunter,marksmanship,27,9,18
Ggproiettili,pozzo-delleternità,860,hunter,marksmanship,24,9,15
Jalcer,draenor,860,hunter,marksmanship,30,9,21
Enistee,silvermoon,859,hunter,marksmanship,19,9,10
Marleyson,uldum,858,hunter,marksmanship,13,9,4
Arrown,outland,858,hunter,marksmanship,46,20,26
Ätea,hyjal,858,hunter,marksmanship,30,9,21
Krippie,dun-modr,857,hunter,marksmanship,42,19,23
Prougefate,darksorrow,855,hunter,marksmanship,18,9,9
Вилежанин,ashenvale,855,hunter,marksmanship,18,9,9
Qmbonboni,ravencrest,855,hunter,marksmanship,24,9,15
Helioshin,pozzo-delleternità,855,hunter,marksmanship,30,9,21
Arkhantos,anetheron,854,hunter,marksmanship,27,10,17
Душакотлетки,eversong,854,hunter,marksmanship,30,9,21
Aliriana,doomhammer,853,hunter,marksmanship,18,9,9
Baldazr,shadowsong,853,hunter,marksmanship,24,9,15
Targetor,the-maelstrom,852,hunter,marksmanship,19,9,10
Sasi,burning-legion,851,hunter,marksmanship,36,18,18
Eppinefrin,silvermoon,851,hunter,marksmanship,65,32,33
Oneofus,malygos,851,hunter,marksmanship,24,9,15
Dreemshoot,stormscale,850,hunter,marksmanship,18,9,9
Talanar,tarren-mill,850,hunter,marksmanship,18,9,9
Фридор,deathguard,850,hunter,marksmanship,24,10,14
Hunterhouse,draenor,847,hunter,marksmanship,29,9,20
Èrá,blackmoore,844,hunter,marksmanship,23,9,14
Jondone,silvermoon,842,hunter,marksmanship,42,9,33
Nogneteen,chamber-of-aspects,840,hunter,marksmanship,29,11,18
Borac,magtheridon,837,hunter,marksmanship,60,19,41
Penelopé,darkmoon-faire,836,hunter,marksmanship,30,9,21
Calea,zirkel-des-cenarius,835,hunter,marksmanship,30,13,17
Lilsnuss,outland,831,hunter,marksmanship,17,9,8
Куфа,blackscar,831,hunter,marksmanship,20,10,10
Kartouche,culte-de-la-rive-noire,831,hunter,marksmanship,115,56,59
Ходилипадал,borean-tundra,830,hunter,marksmanship,18,9,9
Lokarg,ragnaros,829,hunter,marksmanship,17,9,8
Digsholes,ravencrest,828,hunter,marksmanship,17,9,8
Annihllation,twilights-hammer,826,hunter,marksmanship,18,9,9
Gramakgora,kazzak,826,hunter,marksmanship,18,9,9
Eldrilaon,arthas,823,hunter,marksmanship,45,20,25
Aous,burning-legion,820,hunter,marksmanship,54,19,35
Rollei,uldum,816,hunter,marksmanship,18,9,9
Pibealistrea,argent-dawn,815,hunter,marksmanship,15,9,6
Lilsnipè,outland,815,hunter,marksmanship,17,9,8
Banshees,sylvanas,815,hunter,marksmanship,18,9,9
Badytriel,wildhammer,815,hunter,marksmanship,121,58,63
Banàna,draenor,815,hunter,marksmanship,23,9,14
Rockymarciaa,dalaran,808,hunter,marksmanship,27,9,18
Фаффурион,gordunni,807,hunter,marksmanship,25,11,14
Honrø,hyjal,806,hunter,marksmanship,78,31,47
Dontspeakeng,ravencrest,800,hunter,marksmanship,72,25,47
Ímpulsion,stormscale,799,hunter,marksmanship,20,9,11
Rndhunt,shattrath,799,hunter,marksmanship,22,9,13
Steelballs,turalyon,792,hunter,marksmanship,15,10,5
Agarez,blackrock,790,hunter,marksmanship,75,35,40
Greel,saurfang,787,hunter,marksmanship,98,42,56
Neiloh,defias-brotherhood,782,hunter,marksmanship,13,9,4
Ntw,aggra-português,782,hunter,marksmanship,16,9,7
Lumidii,burning-legion,774,hunter,marksmanship,30,11,19
Maô,archimonde,773,hunter,marksmanship,25,9,16
Rockét,malorne,770,hunter,marksmanship,30,9,21
Tenkai,cthun,769,hunter,marksmanship,71,31,40
Luzivar,malganis,768,hunter,marksmanship,12,8,4
Mckie,chromaggus,768,hunter,marksmanship,12,8,4
Îløvémêld,kazzak,768,hunter,marksmanship,12,8,4
Calibrë,dun-modr,768,hunter,marksmanship,12,8,4
Ormsliskaren,shattered-hand,768,hunter,marksmanship,12,8,4
Küredent,archimonde,768,hunter,marksmanship,12,8,4
Cabuløsø,aggra-português,768,hunter,marksmanship,18,8,10
Carre,twilights-hammer,768,hunter,marksmanship,18,8,10
Wolfud,pozzo-delleternità,768,hunter,marksmanship,18,8,10
Focüs,les-sentinelles,768,hunter,marksmanship,18,8,10
Dtq,silvermoon,768,hunter,marksmanship,18,8,10
Celesticx,chamber-of-aspects,768,hunter,marksmanship,18,8,10
Palav,outland,768,hunter,marksmanship,18,8,10
Gíggí,malganis,768,hunter,marksmanship,24,8,16
Deviaz,blackrock,768,hunter,marksmanship,24,8,16
Prokh,twisting-nether,767,hunter,marksmanship,12,8,4
Sylverain,silvermoon,767,hunter,marksmanship,12,8,4
Nétharian,tarren-mill,767,hunter,marksmanship,12,8,4
Ðarrk,tarren-mill,767,hunter,marksmanship,12,8,4
Mareyn,argent-dawn,767,hunter,marksmanship,12,8,4
Иттириса,gordunni,767,hunter,marksmanship,18,8,10
Рэкрэйван,gordunni,767,hunter,marksmanship,18,8,10
Raegal,sanguino,767,hunter,marksmanship,18,8,10
Bomshot,frostmane,767,hunter,marksmanship,18,8,10
Jettraichu,aggra-português,767,hunter,marksmanship,18,8,10
Galeán,kazzak,767,hunter,marksmanship,18,8,10
Bicepflex,ragnaros,767,hunter,marksmanship,18,8,10
Progh,ragnaros,767,hunter,marksmanship,18,8,10
Halfogre,draenor,767,hunter,marksmanship,18,8,10
Lathisa,zenedar,767,hunter,marksmanship,18,8,10
Krooghan,outland,767,hunter,marksmanship,18,8,10
Lourse,ysondre,767,hunter,marksmanship,18,8,10
Sepzi,ravencrest,767,hunter,marksmanship,24,8,16
Shockzzyyh,ravencrest,767,hunter,marksmanship,24,8,16
Funkemarie,blackmoore,767,hunter,marksmanship,24,8,16
Иоссифсталин,soulflayer,767,hunter,marksmanship,24,8,16
Nelftard,agamaggan,766,hunter,marksmanship,12,8,4
Aenina,kazzak,766,hunter,marksmanship,18,8,10
Splishy,ravencrest,766,hunter,marksmanship,18,8,10
Макнерис,gordunni,766,hunter,marksmanship,18,8,10
Nyxor,kazzak,766,hunter,marksmanship,18,8,10
Sohunter,twisting-nether,766,hunter,marksmanship,22,8,14
Shoót,blackmoore,766,hunter,marksmanship,24,8,16
Ластшотик,gordunni,766,hunter,marksmanship,24,8,16
Мафчик,razuvious,766,hunter,marksmanship,24,8,16
Warpo,ysondre,766,hunter,marksmanship,24,8,16
Slimeshít,blackrock,766,hunter,marksmanship,29,8,21
Galadris,kirin-tor,765,hunter,marksmanship,18,8,10
Sylvina,todeswache,765,hunter,marksmanship,18,8,10
Ixôn,tarren-mill,765,hunter,marksmanship,24,8,16
Guerrilla,stormscale,765,hunter,marksmanship,24,8,16
Jonsy,blackrock,764,hunter,marksmanship,18,8,10
Oneeyedjoe,the-maelstrom,764,hunter,marksmanship,18,8,10
Aourön,archimonde,764,hunter,marksmanship,18,8,10
Beryllium,pozzo-delleternità,764,hunter,marksmanship,24,8,16
Аалка,gordunni,764,hunter,marksmanship,24,8,16
Тайэре,blackscar,763,hunter,marksmanship,12,8,4
Tock,terenas,763,hunter,marksmanship,12,8,4
Пирс,eversong,763,hunter,marksmanship,18,8,10
Shibai,outland,762,hunter,marksmanship,18,8,10
Лордорион,gordunni,762,hunter,marksmanship,59,25,34
Galintzor,area-52,761,hunter,marksmanship,18,8,10
Secrety,doomhammer,761,hunter,marksmanship,23,8,15
Wetto,ravencrest,759,hunter,marksmanship,18,8,10
Lynx,chogall,759,hunter,marksmanship,18,8,10
Biggie,azshara,759,hunter,marksmanship,24,8,16
Legath,emerald-dream,758,hunter,marksmanship,22,11,11
Usøøp,dalaran,757,hunter,marksmanship,24,8,16
Turkos,krasus,756,hunter,marksmanship,12,8,4
Skynner,blackrock,755,hunter,marksmanship,18,8,10
Kveyther,silvermoon,754,hunter,marksmanship,18,8,10
Mimiop,hyjal,751,hunter,marksmanship,108,49,59
Kichassequi,khaz-modan,750,hunter,marksmanship,29,10,19
Kratozs,outland,750,hunter,marksmanship,25,8,17
Hellriderr,silvermoon,748,hunter,marksmanship,81,33,48
Спелла,goldrinn,748,hunter,marksmanship,29,8,21
Erestor,hellfire,747,hunter,marksmanship,12,8,4
Ønur,twisting-nether,747,hunter,marksmanship,18,8,10
Karmios,drakthul,747,hunter,marksmanship,24,9,15
Sixty,rajaxx,740,hunter,marksmanship,24,8,16
Aadarshh,turalyon,739,hunter,marksmanship,66,28,38
Sodomaizer,turalyon,739,hunter,marksmanship,30,8,22
Leonhart,sanguino,735,hunter,marksmanship,22,8,14
Leontus,stormscale,731,hunter,marksmanship,16,8,8
Mirselle,drakthul,725,hunter,marksmanship,32,11,21
Athará,aegwynn,719,hunter,marksmanship,11,8,3
Deathøfrats,ravencrest,719,hunter,marksmanship,11,8,3
Gen,twisting-nether,719,hunter,marksmanship,17,8,9
Deahtviper,blackmoore,717,hunter,marksmanship,21,9,12
Ryhope,silvermoon,714,hunter,marksmanship,11,8,3
Selvele,hyjal,712,hunter,marksmanship,27,9,18
Banninymph,culte-de-la-rive-noire,711,hunter,marksmanship,117,47,70
Чизано,deathguard,710,hunter,marksmanship,18,9,9
Загзигзаг,soulflayer,710,hunter,marksmanship,21,9,12
Jägarenen,kazzak,707,hunter,marksmanship,22,11,11
Grafhunter,antonidas,707,hunter,marksmanship,177,83,94
Multishot,dalaran,706,hunter,marksmanship,120,32,88
Ролингуд,galakrond,705,hunter,marksmanship,18,9,9
Sauer,stormreaver,704,hunter,marksmanship,24,8,16
Supertdk,quelthalas,703,hunter,marksmanship,20,8,12
Grantafla,silvermoon,692,hunter,marksmanship,44,8,36
Chicagoto,sylvanas,689,hunter,marksmanship,39,8,31
Tuskah,stormreaver,687,hunter,marksmanship,19,8,11
Yoey,tarren-mill,672,hunter,marksmanship,12,7,5
Rockshredder,ravencrest,672,hunter,marksmanship,12,7,5
Meeturmakerr,ravencrest,672,hunter,marksmanship,12,7,5
Veñom,stormscale,672,hunter,marksmanship,12,7,5
Джэймсхант,gordunni,672,hunter,marksmanship,12,7,5
Vrikenh,tarren-mill,672,hunter,marksmanship,12,7,5
Brubeck,terokkar,672,hunter,marksmanship,12,7,5
Killershadow,twisting-nether,672,hunter,marksmanship,12,7,5
Huntingash,twisting-nether,672,hunter,marksmanship,12,7,5
Eliune,silvermoon,672,hunter,marksmanship,12,7,5
Kygoshi,argent-dawn,672,hunter,marksmanship,12,7,5
Zynga,sylvanas,672,hunter,marksmanship,12,7,5
Аабстрактная,gordunni,672,hunter,marksmanship,12,7,5
Alfacera,steamwheedle-cartel,672,hunter,marksmanship,12,7,5
Хвоостт,gordunni,672,hunter,marksmanship,12,7,5
Fluttershy,terokkar,672,hunter,marksmanship,12,7,5
Merquryh,ravencrest,672,hunter,marksmanship,12,7,5
Píkant,silvermoon,672,hunter,marksmanship,12,7,5
Bawzé,archimonde,672,hunter,marksmanship,12,7,5
Vracarx,silvermoon,672,hunter,marksmanship,12,7,5
Bigbowyahurd,draenor,672,hunter,marksmanship,12,7,5
Monnee,outland,672,hunter,marksmanship,12,7,5
Avaren,archimonde,672,hunter,marksmanship,12,7,5
Bnji,hyjal,672,hunter,marksmanship,18,7,11
Делишез,fordragon,672,hunter,marksmanship,18,7,11
Elonmask,argent-dawn,672,hunter,marksmanship,18,7,11
Doghxnter,ravencrest,672,hunter,marksmanship,18,7,11
Powerofanime,drakthul,672,hunter,marksmanship,18,7,11
Землепух,howling-fjord,672,hunter,marksmanship,18,7,11
Джарвиз,soulflayer,672,hunter,marksmanship,18,7,11
Онкьяр,gordunni,672,hunter,marksmanship,24,7,17
Mewithoutyou,ragnaros,672,hunter,marksmanship,24,7,17
Hugø,twisting-nether,672,hunter,marksmanship,24,7,17
Piksî,kazzak,672,hunter,marksmanship,24,7,17
Moroezxoxo,ravencrest,672,hunter,marksmanship,24,7,17
Хантероо,gordunni,671,hunter,marksmanship,12,7,5
Omnomnom,die-arguswacht,671,hunter,marksmanship,12,7,5
Jonayhunter,dun-modr,671,hunter,marksmanship,12,7,5
Maknamara,tarren-mill,671,hunter,marksmanship,12,7,5
Недоношенная,howling-fjord,671,hunter,marksmanship,12,7,5
Санясурв,gordunni,671,hunter,marksmanship,12,7,5
Штейн,greymane,671,hunter,marksmanship,12,7,5
Avâlos,dentarg,671,hunter,marksmanship,18,7,11
Hawkeyé,forscherliga,671,hunter,marksmanship,18,7,11
Jomerin,thrall,671,hunter,marksmanship,18,7,11
Carrilynn,blackrock,671,hunter,marksmanship,18,7,11
Svèntratore,nemesis,671,hunter,marksmanship,18,7,11
Lorthymar,ravenholdt,671,hunter,marksmanship,18,7,11
Hashaya,hyjal,671,hunter,marksmanship,18,7,11
Ashrak,frostmourne,671,hunter,marksmanship,18,7,11
Thengill,draenor,671,hunter,marksmanship,18,7,11
Bobshmurda,defias-brotherhood,671,hunter,marksmanship,18,7,11
Famex,blackmoore,671,hunter,marksmanship,18,7,11
Snaptrap,eredar,671,hunter,marksmanship,18,7,11
Exthaza,drakthul,671,hunter,marksmanship,18,7,11
Smiren,ragnaros,671,hunter,marksmanship,18,7,11
Opamortis,karazhan,671,hunter,marksmanship,24,7,17
Ceres,kaelthas,671,hunter,marksmanship,24,7,17
Trøllmagedøn,ysondre,671,hunter,marksmanship,24,7,17
Ooneshott,outland,671,hunter,marksmanship,24,7,17
Fenomhunt,silvermoon,671,hunter,marksmanship,24,7,17
Sjufemman,ravencrest,671,hunter,marksmanship,24,7,17
Pôts,blackrock,671,hunter,marksmanship,24,7,17
Cheesychees,sylvanas,670,hunter,marksmanship,12,7,5
Lilbaw,the-maelstrom,670,hunter,marksmanship,12,7,5
Pewpewshotz,stormscale,670,hunter,marksmanship,12,7,5
Jéllytots,ravencrest,670,hunter,marksmanship,12,7,5
Suburra,stormscale,670,hunter,marksmanship,18,7,11
Spêctrâ,sylvanas,670,hunter,marksmanship,18,7,11
Yip,twisting-nether,670,hunter,marksmanship,18,7,11
Anthélià,antonidas,670,hunter,marksmanship,18,7,11
Skyttelaj,stormscale,670,hunter,marksmanship,18,7,11
Okumo,the-maelstrom,670,hunter,marksmanship,18,7,11
Querro,azshara,670,hunter,marksmanship,24,7,17
Huntbegin,burning-legion,669,hunter,marksmanship,12,7,5
Bulhumt,draenor,669,hunter,marksmanship,17,9,8
Kaudza,archimonde,669,hunter,marksmanship,18,7,11
Aggyaceshot,silvermoon,669,hunter,marksmanship,18,7,11
Naregar,draenor,669,hunter,marksmanship,24,7,17
Marudô,aegwynn,669,hunter,marksmanship,24,7,17
Chase,wildhammer,669,hunter,marksmanship,36,7,29
Wishmeweed,kazzak,668,hunter,marksmanship,18,7,11
Rayzør,eitrigg,668,hunter,marksmanship,18,7,11
Lunalai,antonidas,668,hunter,marksmanship,18,7,11
Gaili,ravenholdt,667,hunter,marksmanship,24,7,17
Xborn,draenor,666,hunter,marksmanship,18,7,11
Nevarline,twisting-nether,665,hunter,marksmanship,12,7,5
Aleshanee,anetheron,664,hunter,marksmanship,18,7,11
Vjell,blackhand,663,hunter,marksmanship,18,7,11
Halfstone,frostmane,663,hunter,marksmanship,30,7,23
Eilaa,ravencrest,662,hunter,marksmanship,18,7,11
Kalzifahr,ysera,662,hunter,marksmanship,18,7,11
Schaaxx,archimonde,662,hunter,marksmanship,18,7,11
Fernetcola,los-errantes,661,hunter,marksmanship,12,7,5
Крошкамэг,eversong,661,hunter,marksmanship,19,8,11
Arkman,malganis,660,hunter,marksmanship,30,7,23
Blattfeder,blackmoore,658,hunter,marksmanship,18,7,11
Shokre,silvermoon,657,hunter,marksmanship,12,7,5
Miisakaa,antonidas,656,hunter,marksmanship,18,7,11
Amogustroll,burning-blade,652,hunter,marksmanship,24,10,14
Есселин,thermaplugg,650,hunter,marksmanship,18,7,11
Cernunnos,auchindoun,639,hunter,marksmanship,11,7,4
Fylealaes,ravencrest,639,hunter,marksmanship,17,7,10
Пушкабомби,soulflayer,636,hunter,marksmanship,27,9,18
Zwerglogan,amanthul,625,hunter,marksmanship,29,7,22
Элфй,gordunni,623,hunter,marksmanship,21,7,14
Kyliun,frostmane,620,hunter,marksmanship,17,7,10
Issue,hyjal,619,hunter,marksmanship,24,7,17
Legöläs,tarren-mill,617,hunter,marksmanship,17,7,10
Trachunt,twisting-nether,607,hunter,marksmanship,11,7,4
Wîldhunt,burning-legion,607,hunter,marksmanship,25,7,18
Саэсантессис,howling-fjord,601,hunter,marksmanship,16,7,9
Connyrövöga,draenor,576,hunter,marksmanship,6,6,0
Monsterwhite,stormreaver,576,hunter,marksmanship,6,6,0
Самоанец,gordunni,576,hunter,marksmanship,12,6,6
Dolwen,argent-dawn,576,hunter,marksmanship,12,6,6
Инкризшот,gordunni,576,hunter,marksmanship,12,6,6
Myriadx,sylvanas,576,hunter,marksmanship,12,6,6
Shína,argent-dawn,576,hunter,marksmanship,12,6,6
Hunlin,kazzak,576,hunter,marksmanship,12,6,6
Blazinghunt,kazzak,576,hunter,marksmanship,12,6,6
Vorsia,tarren-mill,576,hunter,marksmanship,12,6,6
Stamzer,drakthul,576,hunter,marksmanship,12,6,6
Grandiosity,tarren-mill,576,hunter,marksmanship,12,6,6
Daemonhunt,tarren-mill,576,hunter,marksmanship,12,6,6
Oogie,laughing-skull,576,hunter,marksmanship,12,6,6
Løssen,outland,576,hunter,marksmanship,12,6,6
Колякилшот,gordunni,576,hunter,marksmanship,12,6,6
Madjia,ravencrest,576,hunter,marksmanship,12,6,6
Dugini,ravencrest,576,hunter,marksmanship,12,6,6
Pläpp,stormscale,576,hunter,marksmanship,12,6,6
Destynarîa,illidan,576,hunter,marksmanship,12,6,6
Pantero,kazzak,576,hunter,marksmanship,12,6,6
Kasperhawser,silvermoon,576,hunter,marksmanship,12,6,6
Scrubbi,destromath,576,hunter,marksmanship,12,6,6
Кимчик,borean-tundra,576,hunter,marksmanship,12,6,6
Гунныч,grom,576,hunter,marksmanship,12,6,6
Sketana,silvermoon,576,hunter,marksmanship,12,6,6
Zhao,zenedar,576,hunter,marksmanship,12,6,6
Abaforth,bronze-dragonflight,576,hunter,marksmanship,12,6,6
Rakeesh,hyjal,576,hunter,marksmanship,12,6,6
Greg,defias-brotherhood,576,hunter,marksmanship,12,6,6
Артуша,booty-bay,576,hunter,marksmanship,12,6,6
Borbotir,silvermoon,576,hunter,marksmanship,12,6,6
Sqedihunter,silvermoon,576,hunter,marksmanship,12,6,6
Antisniper,kazzak,576,hunter,marksmanship,17,6,11
Bréanni,auchindoun,576,hunter,marksmanship,18,6,12
Deepcleaning,kazzak,576,hunter,marksmanship,18,6,12
Oobe,hyjal,576,hunter,marksmanship,18,6,12
Tomli,nemesis,576,hunter,marksmanship,18,6,12
Юките,soulflayer,576,hunter,marksmanship,18,6,12
Такувами,gordunni,576,hunter,marksmanship,18,6,12
Instinctx,agamaggan,576,hunter,marksmanship,18,6,12
Bigramy,sanguino,576,hunter,marksmanship,18,6,12
Sayn,la-croisade-écarlate,576,hunter,marksmanship,18,6,12
Sokrám,sanguino,576,hunter,marksmanship,18,6,12
Bloodymarìe,kelthuzad,576,hunter,marksmanship,18,6,12
Jinxpeasant,twisting-nether,576,hunter,marksmanship,18,6,12
Ðayla,nethersturm,576,hunter,marksmanship,18,6,12
Somethíngmad,stormscale,576,hunter,marksmanship,24,6,18
Кэрнел,gordunni,576,hunter,marksmanship,24,6,18
Тохадиско,gordunni,575,hunter,marksmanship,6,6,0
Squidy,archimonde,575,hunter,marksmanship,12,6,6
Stralthir,argent-dawn,575,hunter,marksmanship,12,6,6
Rohald,silvermoon,575,hunter,marksmanship,12,6,6
Twinkhunter,pozzo-delleternità,575,hunter,marksmanship,12,6,6
Mattiz,ragnaros,575,hunter,marksmanship,12,6,6
Maeba,shendralar,575,hunter,marksmanship,12,6,6
Tolkienn,archimonde,575,hunter,marksmanship,12,6,6
Xeragon,frostwolf,575,hunter,marksmanship,12,6,6
Ina,tarren-mill,575,hunter,marksmanship,12,6,6
Manatodamoon,aerie-peak,575,hunter,marksmanship,12,6,6
Domsín,ravencrest,575,hunter,marksmanship,12,6,6
Dirtydolores,thrall,575,hunter,marksmanship,12,6,6
Earlyspring,ragnaros,575,hunter,marksmanship,12,6,6
Donpromìlló,blackhand,575,hunter,marksmanship,15,7,8
Bourrinax,kazzak,575,hunter,marksmanship,18,6,12
Bawwykwipkee,ragnaros,575,hunter,marksmanship,18,6,12
Patuk,exodar,575,hunter,marksmanship,18,6,12
Frilance,dun-modr,575,hunter,marksmanship,18,6,12
Harckel,elune,575,hunter,marksmanship,18,6,12
Dritzdòurden,dun-modr,575,hunter,marksmanship,18,6,12
Maexo,anetheron,575,hunter,marksmanship,18,6,12
Ozaï,eredar,575,hunter,marksmanship,18,6,12
Gxx,burning-blade,575,hunter,marksmanship,18,6,12
Elvenian,twisting-nether,575,hunter,marksmanship,18,6,12
Spineshot,thrall,575,hunter,marksmanship,24,6,18
Egy,the-maelstrom,574,hunter,marksmanship,12,6,6
Longshot,burning-legion,574,hunter,marksmanship,12,6,6
Aimeddead,doomhammer,574,hunter,marksmanship,12,6,6
Djurslavaren,draenor,574,hunter,marksmanship,18,6,12
Hagall,chamber-of-aspects,574,hunter,marksmanship,24,6,18
Dannydynx,burning-legion,573,hunter,marksmanship,24,6,18
Анариэлль,gordunni,572,hunter,marksmanship,12,6,6
Hitscan,ravencrest,572,hunter,marksmanship,12,6,6
Ninjaskillss,ravencrest,572,hunter,marksmanship,18,6,12
Orcgun,mugthol,572,hunter,marksmanship,18,6,12
Koreic,silvermoon,572,hunter,marksmanship,24,6,18
Cronox,sporeggar,571,hunter,marksmanship,12,6,6
Ginterjudo,burning-legion,571,hunter,marksmanship,12,6,6
Algar,tarren-mill,570,hunter,marksmanship,12,6,6
Dødshøt,twisting-nether,569,hunter,marksmanship,18,6,12
Deadlymayhem,dragonblight,568,hunter,marksmanship,18,6,12
Denixxia,bronzebeard,567,hunter,marksmanship,15,7,8
Chapiru,burning-legion,567,hunter,marksmanship,18,6,12
Jilkhar,twisting-nether,565,hunter,marksmanship,12,6,6
Mooj,malganis,559,hunter,marksmanship,11,6,5
Kaldine,argent-dawn,543,hunter,marksmanship,28,6,22
Aqpa,twisting-nether,542,hunter,marksmanship,11,6,5
Gigashot,nemesis,528,hunter,marksmanship,9,7,2
Senelor,dalaran,514,hunter,marksmanship,27,7,20
Novifløw,archimonde,512,hunter,marksmanship,10,6,4
Gamosh,anetheron,511,hunter,marksmanship,14,6,8
Emriye,antonidas,510,hunter,marksmanship,14,6,8
Фэйсконтроль,azuregos,506,hunter,marksmanship,20,6,14
Sulom,tarren-mill,480,hunter,marksmanship,6,5,1
Wolder,burning-legion,480,hunter,marksmanship,6,5,1
Hvaskøduenme,stormscale,480,hunter,marksmanship,6,5,1
Eveo,antonidas,480,hunter,marksmanship,6,5,1
Mecamoot,drekthar,480,hunter,marksmanship,6,5,1
Toptìérgoðx,drakthul,480,hunter,marksmanship,6,5,1
Аматорика,howling-fjord,480,hunter,marksmanship,6,5,1
Hawkinstinct,tarren-mill,480,hunter,marksmanship,6,5,1
Bredpew,kazzak,480,hunter,marksmanship,6,5,1
Akkixz,antonidas,480,hunter,marksmanship,6,5,1
Хорпяр,soulflayer,480,hunter,marksmanship,6,5,1
Сальверди,gordunni,480,hunter,marksmanship,6,5,1
Graniz,archimonde,480,hunter,marksmanship,6,5,1
Trapzila,aggra-português,480,hunter,marksmanship,6,5,1
Torgnolgamin,archimonde,480,hunter,marksmanship,6,5,1
Soloist,sylvanas,480,hunter,marksmanship,6,5,1
Spitchy,kazzak,480,hunter,marksmanship,12,5,7
Níghtshot,twisting-nether,480,hunter,marksmanship,12,5,7
Agbaba,twisting-nether,480,hunter,marksmanship,12,5,7
Kikilirilivi,ysondre,480,hunter,marksmanship,12,5,7
Яроняютрапу,gordunni,480,hunter,marksmanship,12,5,7
Rykini,twisting-nether,480,hunter,marksmanship,12,5,7
Balarium,twisting-nether,480,hunter,marksmanship,12,5,7
Gakco,twisting-nether,480,hunter,marksmanship,12,5,7
Хароко,gordunni,480,hunter,marksmanship,12,5,7
Sloee,sylvanas,480,hunter,marksmanship,12,5,7
Msir,kazzak,480,hunter,marksmanship,12,5,7
Denaik,ravencrest,480,hunter,marksmanship,12,5,7
Adhdbad,tarren-mill,480,hunter,marksmanship,12,5,7
Carkaroth,uldum,480,hunter,marksmanship,12,5,7
Givz,outland,480,hunter,marksmanship,12,5,7
Lambtron,tarren-mill,480,hunter,marksmanship,12,5,7
Stimpak,nordrassil,480,hunter,marksmanship,12,5,7
Djøgi,archimonde,480,hunter,marksmanship,12,5,7
Mercoman,bronze-dragonflight,480,hunter,marksmanship,12,5,7
Mazhug,stormreaver,480,hunter,marksmanship,12,5,7
Ghøst,madmortem,480,hunter,marksmanship,12,5,7
Уайлен,gordunni,480,hunter,marksmanship,12,5,7
Flowless,sunstrider,480,hunter,marksmanship,12,5,7
Sodavand,silvermoon,480,hunter,marksmanship,12,5,7
Присуньмне,galakrond,480,hunter,marksmanship,12,5,7
Larrek,aegwynn,480,hunter,marksmanship,12,5,7
Deathmarks,blackrock,480,hunter,marksmanship,12,5,7
Trapgoddxx,archimonde,480,hunter,marksmanship,12,5,7
Setadomijo,tarren-mill,480,hunter,marksmanship,12,5,7
Huntardös,outland,480,hunter,marksmanship,12,5,7
Yoggys,outland,480,hunter,marksmanship,12,5,7
Semda,blackmoore,480,hunter,marksmanship,12,5,7
Zerrash,ravencrest,480,hunter,marksmanship,12,5,7
Ðæom,outland,480,hunter,marksmanship,12,5,7
Sissnik,thrall,480,hunter,marksmanship,12,5,7
Wàterloo,marécage-de-zangar,480,hunter,marksmanship,12,5,7
Kundra,ravencrest,480,hunter,marksmanship,12,5,7
Sashobg,aerie-peak,480,hunter,marksmanship,12,5,7
Peremptør,alleria,480,hunter,marksmanship,12,5,7
Хипдо,soulflayer,480,hunter,marksmanship,12,5,7
Бэталол,gordunni,480,hunter,marksmanship,12,5,7
Кайсго,gordunni,480,hunter,marksmanship,12,5,7
Nothrokh,auchindoun,480,hunter,marksmanship,12,5,7
Mahuntah,drakthul,480,hunter,marksmanship,12,5,7
Olsenas,silvermoon,480,hunter,marksmanship,12,5,7
Galou,ghostlands,480,hunter,marksmanship,12,5,7
Yerî,die-aldor,480,hunter,marksmanship,12,5,7
Thúnar,aegwynn,480,hunter,marksmanship,12,5,7
Geete,kazzak,480,hunter,marksmanship,12,5,7
Meghanmarkle,tarren-mill,480,hunter,marksmanship,13,5,8
Draknik,nemesis,480,hunter,marksmanship,16,6,10
Jakis,silvermoon,480,hunter,marksmanship,18,5,13
Deathwallker,silvermoon,480,hunter,marksmanship,18,5,13
Hÿyrøk,ysondre,480,hunter,marksmanship,18,5,13
Тэуреэль,gordunni,480,hunter,marksmanship,18,5,13
Hakamael,kirin-tor,480,hunter,marksmanship,18,5,13
Rêxxer,blackmoore,480,hunter,marksmanship,18,5,13
Tetiscaza,sanguino,480,hunter,marksmanship,24,5,19
Arawnork,stormreaver,479,hunter,marksmanship,6,5,1
Золларис,deathguard,479,hunter,marksmanship,6,5,1
Asâya,blackmoore,479,hunter,marksmanship,6,5,1
Toxical,ragnaros,479,hunter,marksmanship,12,5,7
Tirador,uldum,479,hunter,marksmanship,12,5,7
Whereismypet,azjolnerub,479,hunter,marksmanship,12,5,7
Zäyk,zuljin,479,hunter,marksmanship,12,5,7
Hapocalypt,pozzo-delleternità,479,hunter,marksmanship,12,5,7
Xeqter,ravencrest,479,hunter,marksmanship,12,5,7
Starfinder,saurfang,479,hunter,marksmanship,12,5,7
Typex,defias-brotherhood,479,hunter,marksmanship,12,5,7
Живадер,ashenvale,479,hunter,marksmanship,12,5,7
Razzét,stormscale,479,hunter,marksmanship,12,5,7
Shogos,aggra-português,479,hunter,marksmanship,12,5,7
Grimazg,chogall,479,hunter,marksmanship,12,5,7
Rasttrim,dun-modr,479,hunter,marksmanship,13,5,8
Attileus,ragnaros,479,hunter,marksmanship,15,5,10
Smígol,stormreaver,479,hunter,marksmanship,18,5,13
Зиргус,gordunni,479,hunter,marksmanship,18,5,13
Гангстита,gordunni,479,hunter,marksmanship,18,5,13
Nígruløl,arthas,479,hunter,marksmanship,18,5,13
Hentt,burning-legion,479,hunter,marksmanship,18,5,13
Cazaó,sanguino,479,hunter,marksmanship,18,5,13
Gêorge,teldrassil,479,hunter,marksmanship,18,5,13
Galedjïn,conseil-des-ombres,479,hunter,marksmanship,18,5,13
Камсшотт,gordunni,479,hunter,marksmanship,18,5,13
Fugerlynipps,stormrage,479,hunter,marksmanship,24,5,19
Nightarrows,ravencrest,478,hunter,marksmanship,6,5,1
Bæbåk,frostmane,478,hunter,marksmanship,6,5,1
Cybertruck,cthun,478,hunter,marksmanship,12,5,7
Лукорды,gordunni,478,hunter,marksmanship,12,5,7
Pylos,azshara,477,hunter,marksmanship,12,5,7
Bijuelfe,draenor,477,hunter,marksmanship,12,5,7
Zanrawo,blutkessel,476,hunter,marksmanship,12,5,7
Klittcrit,bloodhoof,475,hunter,marksmanship,12,5,7
Thebaddy,auchindoun,473,hunter,marksmanship,18,5,13
Skapig,frostwolf,473,hunter,marksmanship,18,5,13
Juki,pozzo-delleternità,472,hunter,marksmanship,12,5,7
Buffini,nethersturm,469,hunter,marksmanship,18,5,13
Sylasteria,twisting-nether,467,hunter,marksmanship,27,8,19
Brønkø,azshara,463,hunter,marksmanship,17,5,12
Rdevill,outland,448,hunter,marksmanship,16,5,11
Шэнчи,greymane,447,hunter,marksmanship,11,6,5
Littlenugget,ravencrest,447,hunter,marksmanship,11,5,6
Haleth,uldum,447,hunter,marksmanship,17,5,12
Rea,archimonde,442,hunter,marksmanship,22,5,17
Thedanchodak,stormrage,440,hunter,marksmanship,11,5,6
Grokis,blackhand,437,hunter,marksmanship,17,5,12
Traveler,earthen-ring,427,hunter,marksmanship,17,5,12
Cais,drakthul,426,hunter,marksmanship,18,6,12
Neremyn,sylvanas,426,hunter,marksmanship,21,6,15
Bâng,zuljin,424,hunter,marksmanship,19,6,13
Koltyn,culte-de-la-rive-noire,424,hunter,marksmanship,30,6,24
Obata,arathor,423,hunter,marksmanship,15,6,9
Sleepyarrow,chogall,420,hunter,marksmanship,12,6,6
Artaeos,lordaeron,416,hunter,marksmanship,16,5,11
Mylolol,outland,416,hunter,marksmanship,16,5,11
Geruga,thrall,415,hunter,marksmanship,8,5,3
Kowaki,blackmoore,415,hunter,marksmanship,10,5,5
Thðr,elune,415,hunter,marksmanship,11,5,6
Gotha,festung-der-stürme,414,hunter,marksmanship,14,5,9
Hokro,thrall,392,hunter,marksmanship,17,7,10
Niffe,stormscale,384,hunter,marksmanship,6,4,2
Mcloppe,ravencrest,384,hunter,marksmanship,6,4,2
Hntudwn,azshara,384,hunter,marksmanship,6,4,2
Kragán,silvermoon,384,hunter,marksmanship,6,4,2
Rymous,nemesis,384,hunter,marksmanship,6,4,2
Zøzø,stormscale,384,hunter,marksmanship,6,4,2
Greymountain,twisting-nether,384,hunter,marksmanship,6,4,2
Kirenox,quelthalas,384,hunter,marksmanship,6,4,2
Telladril,burning-legion,384,hunter,marksmanship,6,4,2
Haranti,dun-modr,384,hunter,marksmanship,6,4,2
Burninghunt,ravencrest,384,hunter,marksmanship,6,4,2
Darllene,kazzak,384,hunter,marksmanship,6,4,2
Éclipze,outland,384,hunter,marksmanship,6,4,2
Zoêva,blackhand,384,hunter,marksmanship,6,4,2
Nöbody,khaz-modan,384,hunter,marksmanship,6,4,2
Likandria,blackmoore,384,hunter,marksmanship,6,4,2
Ðøper,hyjal,384,hunter,marksmanship,6,4,2
Junqué,sanguino,384,hunter,marksmanship,6,4,2
Nßatrapper,outland,384,hunter,marksmanship,6,4,2
Beeper,twisting-nether,384,hunter,marksmanship,6,4,2
Moggbang,ravencrest,384,hunter,marksmanship,6,4,2
Pergola,spinebreaker,384,hunter,marksmanship,6,4,2
Vantagepoint,arathor,384,hunter,marksmanship,6,4,2
Джеймсфранко,blackscar,384,hunter,marksmanship,6,4,2
Thain,stormscale,384,hunter,marksmanship,6,4,2
Myoui,silvermoon,384,hunter,marksmanship,6,4,2
Бикмекс,howling-fjord,384,hunter,marksmanship,6,4,2
Marcs,antonidas,384,hunter,marksmanship,6,4,2
Idtrapthat,nagrand,384,hunter,marksmanship,6,4,2
Тумбаюмб,howling-fjord,384,hunter,marksmanship,6,4,2
Clydefrog,outland,384,hunter,marksmanship,6,4,2
Леегголасс,fordragon,384,hunter,marksmanship,6,4,2
Benbutton,antonidas,384,hunter,marksmanship,6,4,2
Переснежник,howling-fjord,384,hunter,marksmanship,6,4,2
Kiritõ,frostwolf,384,hunter,marksmanship,6,4,2
Ramela,sanguino,384,hunter,marksmanship,6,4,2
Стёпкахант,gordunni,384,hunter,marksmanship,6,4,2
Томбомбадил,howling-fjord,384,hunter,marksmanship,6,4,2
Spyte,twisting-nether,384,hunter,marksmanship,6,4,2
Kanisha,dalaran,384,hunter,marksmanship,6,4,2
Unßørn,archimonde,384,hunter,marksmanship,6,4,2
Fiercemoon,outland,384,hunter,marksmanship,6,4,2
Sovanz,aggra-português,384,hunter,marksmanship,6,4,2
Roke,malganis,384,hunter,marksmanship,6,4,2
Skytraped,hyjal,384,hunter,marksmanship,6,4,2
Дарцетос,greymane,384,hunter,marksmanship,6,4,2
Атумен,borean-tundra,384,hunter,marksmanship,6,4,2
Yuichiro,senjin,384,hunter,marksmanship,6,4,2
Kukenisluken,stormscale,384,hunter,marksmanship,6,4,2
Bøømshøtkill,blackrock,384,hunter,marksmanship,6,4,2
Síden,sylvanas,384,hunter,marksmanship,6,4,2
Grøøhx,rashgarroth,384,hunter,marksmanship,6,4,2
Kelnax,draenor,384,hunter,marksmanship,6,4,2
Velen,pozzo-delleternità,384,hunter,marksmanship,6,4,2
Deadhot,dun-morogh,384,hunter,marksmanship,6,4,2
Чэрпак,gordunni,384,hunter,marksmanship,6,4,2
Shîaa,draenor,384,hunter,marksmanship,6,4,2
Comegetme,auchindoun,384,hunter,marksmanship,6,4,2
Natheldir,silvermoon,384,hunter,marksmanship,6,4,2
Kovx,turalyon,384,hunter,marksmanship,6,4,2
Intoxd,sylvanas,384,hunter,marksmanship,6,4,2
Сацыви,gordunni,384,hunter,marksmanship,6,4,2
Vypaz,twisting-nether,384,hunter,marksmanship,6,4,2
Snipinx,draenor,384,hunter,marksmanship,6,4,2
Rèxxar,arygos,384,hunter,marksmanship,6,4,2
Lovica,draenor,384,hunter,marksmanship,6,4,2
Selynne,grim-batol,384,hunter,marksmanship,6,4,2
Goreac,cthun,384,hunter,marksmanship,9,5,4
Áv,outland,384,hunter,marksmanship,14,5,9
Hallem,karazhan,384,hunter,marksmanship,12,4,8
Антагонистка,soulflayer,384,hunter,marksmanship,12,4,8
Deeparrow,stormscale,384,hunter,marksmanship,12,4,8
Cowmelk,stormscale,384,hunter,marksmanship,12,4,8
Draoclick,hyjal,384,hunter,marksmanship,12,4,8
Tonttulul,draenor,384,hunter,marksmanship,12,4,8
Jannolafrite,ysondre,384,hunter,marksmanship,12,4,8
Графруру,soulflayer,384,hunter,marksmanship,12,4,8
Jskey,aggramar,384,hunter,marksmanship,12,4,8
Raínbow,aegwynn,384,hunter,marksmanship,12,4,8
Vííiíiíiiíí,stormscale,384,hunter,marksmanship,12,4,8
Double,sylvanas,384,hunter,marksmanship,12,4,8
Rhyle,hyjal,384,hunter,marksmanship,12,4,8
Zeyron,ravencrest,384,hunter,marksmanship,12,4,8
Vallêria,malganis,384,hunter,marksmanship,12,4,8
Keyshu,die-aldor,384,hunter,marksmanship,12,4,8
Верат,howling-fjord,384,hunter,marksmanship,12,4,8
Slinkywinky,eonar,384,hunter,marksmanship,12,4,8
Tytoyz,khaz-modan,384,hunter,marksmanship,12,4,8
Shadowxx,silvermoon,384,hunter,marksmanship,12,4,8
Vohnívak,turalyon,384,hunter,marksmanship,12,4,8
Kanlina,ravencrest,384,hunter,marksmanship,12,4,8
Calyssae,shattered-halls,384,hunter,marksmanship,12,4,8
Egodennis,frostwolf,384,hunter,marksmanship,12,4,8
Eykons,ragnaros,384,hunter,marksmanship,12,4,8
Mexine,dun-morogh,384,hunter,marksmanship,12,4,8
Rapid,sylvanas,384,hunter,marksmanship,12,4,8
Sharún,sylvanas,384,hunter,marksmanship,12,4,8
Wildslip,archimonde,384,hunter,marksmanship,12,4,8
Tartaupommes,hyjal,384,hunter,marksmanship,12,4,8
Hreo,twisting-nether,384,hunter,marksmanship,12,4,8
Bugspitz,outland,384,hunter,marksmanship,12,4,8
Oròg,hyjal,384,hunter,marksmanship,12,4,8
Hiddenstalk,outland,384,hunter,marksmanship,12,4,8
Свадебная,gordunni,384,hunter,marksmanship,12,4,8
Birdbow,sylvanas,384,hunter,marksmanship,12,4,8
Linguinhas,aggra-português,384,hunter,marksmanship,12,4,8
Chapovito,twisting-nether,384,hunter,marksmanship,12,4,8
Sjins,draenor,384,hunter,marksmanship,12,4,8
Marodan,ambossar,384,hunter,marksmanship,12,4,8
Becoming,burning-legion,384,hunter,marksmanship,12,4,8
Ecalter,dun-modr,384,hunter,marksmanship,12,4,8
Darkshe,dun-modr,384,hunter,marksmanship,12,4,8
Scárzz,silvermoon,384,hunter,marksmanship,12,4,8
Зангейра,blackscar,384,hunter,marksmanship,12,4,8
Melvinn,shattered-hand,384,hunter,marksmanship,12,4,8
Йинги,gordunni,384,hunter,marksmanship,12,4,8
Araemveus,moonglade,384,hunter,marksmanship,12,4,8
Diqtore,aszune,384,hunter,marksmanship,12,4,8
Farkrin,silvermoon,384,hunter,marksmanship,12,4,8
Косаяя,gordunni,384,hunter,marksmanship,12,4,8
Лерочкалиса,gordunni,384,hunter,marksmanship,12,4,8
Powerslade,sanguino,384,hunter,marksmanship,12,4,8
Fennecshand,colinas-pardas,384,hunter,marksmanship,12,4,8
Drágø,blackmoore,384,hunter,marksmanship,12,4,8
Taurd,dragonmaw,384,hunter,marksmanship,12,4,8
Peonfarmer,argent-dawn,384,hunter,marksmanship,12,4,8
Dorkos,sanguino,384,hunter,marksmanship,12,4,8
Aamön,tarren-mill,384,hunter,marksmanship,12,4,8
Dangerousfoe,argent-dawn,384,hunter,marksmanship,12,4,8
Hardshots,tarren-mill,384,hunter,marksmanship,12,4,8
Døømslayer,nemesis,384,hunter,marksmanship,12,4,8
Stefraton,tarren-mill,384,hunter,marksmanship,12,4,8
Бладшоот,gordunni,384,hunter,marksmanship,12,4,8
Aimedbot,azjolnerub,384,hunter,marksmanship,12,4,8
Naestra,tarren-mill,384,hunter,marksmanship,12,4,8
Forthehordee,chamber-of-aspects,384,hunter,marksmanship,14,4,10
Cachapas,ravencrest,384,hunter,marksmanship,18,4,14
Маори,deepholm,384,hunter,marksmanship,18,4,14
Kêêpsmile,blackmoore,384,hunter,marksmanship,18,4,14
Haraigoshí,grim-batol,384,hunter,marksmanship,18,4,14
Jamais,stormscale,384,hunter,marksmanship,18,4,14
Ruhen,aegwynn,384,hunter,marksmanship,18,4,14
Sylverein,silvermoon,384,hunter,marksmanship,18,4,14
Strykers,stormscale,384,hunter,marksmanship,18,4,14
Pommespinnes,outland,384,hunter,marksmanship,18,4,14
Enablee,lightbringer,384,hunter,marksmanship,24,4,20
Køûrø,hyjal,383,hunter,marksmanship,6,4,2
Вевери,blackscar,383,hunter,marksmanship,6,4,2
Wakar,alakir,383,hunter,marksmanship,6,4,2
Snajper,kragjin,383,hunter,marksmanship,6,4,2
Jägerelf,malfurion,383,hunter,marksmanship,6,4,2
Amiosi,sanguino,383,hunter,marksmanship,10,5,5
Zirriath,mazrigos,383,hunter,marksmanship,12,4,8
Kyéra,kirin-tor,383,hunter,marksmanship,12,4,8
Slicerfoot,ghostlands,383,hunter,marksmanship,12,4,8
Jinzala,argent-dawn,383,hunter,marksmanship,12,4,8
Meletis,stormreaver,383,hunter,marksmanship,12,4,8
Ushiuno,defias-brotherhood,383,hunter,marksmanship,12,4,8
Somixx,ragnaros,383,hunter,marksmanship,12,4,8
Aamøn,nemesis,383,hunter,marksmanship,12,4,8
Tervel,dun-morogh,383,hunter,marksmanship,12,4,8
Amsterdamer,sylvanas,383,hunter,marksmanship,12,4,8
Grognyre,silvermoon,383,hunter,marksmanship,12,4,8
Lacertia,kazzak,383,hunter,marksmanship,12,4,8
Anguerande,khaz-modan,383,hunter,marksmanship,12,4,8
Kyliân,stormscale,383,hunter,marksmanship,12,4,8
Beaupapa,archimonde,383,hunter,marksmanship,14,4,10
Musux,uldum,383,hunter,marksmanship,18,4,14
Youardead,arthas,383,hunter,marksmanship,18,4,14
Trillu,madmortem,383,hunter,marksmanship,18,4,14
Dartas,outland,383,hunter,marksmanship,18,4,14
Boogaloo,hellscream,382,hunter,marksmanship,6,4,2
Deadshout,kazzak,382,hunter,marksmanship,6,4,2
Бурбоньчик,soulflayer,382,hunter,marksmanship,12,4,8
Costae,aerie-peak,382,hunter,marksmanship,12,4,8
Metapouk,archimonde,382,hunter,marksmanship,12,4,8
Lardobrave,blackhand,381,hunter,marksmanship,18,4,14
Enérgize,argent-dawn,380,hunter,marksmanship,18,4,14
Pâthfînder,destromath,379,hunter,marksmanship,12,4,8
Кисяныч,gordunni,372,hunter,marksmanship,18,7,11
Wrymn,sanguino,367,hunter,marksmanship,11,4,7
Dhmuntar,ravencrest,367,hunter,marksmanship,11,4,7
Éddiémórphín,kazzak,367,hunter,marksmanship,11,4,7
Ketsh,antonidas,367,hunter,marksmanship,17,4,13
Boehelientje,defias-brotherhood,351,hunter,marksmanship,11,4,7
Doojas,archimonde,351,hunter,marksmanship,11,4,7
Naepy,thrall,351,hunter,marksmanship,16,4,12
Lujägy,antonidas,344,hunter,marksmanship,14,5,9
Shadoox,argent-dawn,335,hunter,marksmanship,11,4,7
Bìglenny,shattered-hand,335,hunter,marksmanship,11,4,7
Redstormfx,blades-edge,335,hunter,marksmanship,17,4,13
Waizen,archimonde,330,hunter,marksmanship,16,6,10
Nimri,kazzak,329,hunter,marksmanship,15,5,10
Arwenna,argent-dawn,328,hunter,marksmanship,11,6,5
Bloópy,silvermoon,320,hunter,marksmanship,10,4,6
Rixxâr,blackrock,320,hunter,marksmanship,10,4,6
Rakmo,blackmoore,320,hunter,marksmanship,10,4,6
Выпейдождь,gordunni,319,hunter,marksmanship,8,4,4
Samasukë,grim-batol,319,hunter,marksmanship,8,4,4
Rakshor,thrall,288,hunter,marksmanship,6,3,3
Atranex,ravencrest,288,hunter,marksmanship,6,3,3
Zyhraa,ravencrest,288,hunter,marksmanship,6,3,3
Комомура,soulflayer,288,hunter,marksmanship,6,3,3
Meridià,malorne,288,hunter,marksmanship,6,3,3
Трапча,soulflayer,288,hunter,marksmanship,6,3,3
Surgethyme,ravencrest,288,hunter,marksmanship,6,3,3
Hordasso,burning-legion,288,hunter,marksmanship,6,3,3
Lowboblarry,ravencrest,288,hunter,marksmanship,6,3,3
Taenic,azshara,288,hunter,marksmanship,6,3,3
Aimshot,ravencrest,288,hunter,marksmanship,6,3,3
Каэсс,gordunni,288,hunter,marksmanship,6,3,3
Phinecone,stormscale,288,hunter,marksmanship,6,3,3
Burbutsuluki,silvermoon,288,hunter,marksmanship,6,3,3
Kofie,steamwheedle-cartel,288,hunter,marksmanship,6,3,3
Stickthrower,steamwheedle-cartel,288,hunter,marksmanship,6,3,3
Rachelicious,ravencrest,288,hunter,marksmanship,6,3,3
Lopsa,terokkar,288,hunter,marksmanship,6,3,3
Hopeanuoli,terokkar,288,hunter,marksmanship,6,3,3
Kahbe,ravencrest,288,hunter,marksmanship,6,3,3
Velne,ravencrest,288,hunter,marksmanship,6,3,3
Bláckthorn,ravencrest,288,hunter,marksmanship,6,3,3
Fåded,ravencrest,288,hunter,marksmanship,6,3,3
Sniipe,arthas,288,hunter,marksmanship,6,3,3
Thebigboom,outland,288,hunter,marksmanship,6,3,3
Topgrill,stormscale,288,hunter,marksmanship,6,3,3
Clánkér,madmortem,288,hunter,marksmanship,6,3,3
Iif,frostwolf,288,hunter,marksmanship,6,3,3
Zugzlug,tarren-mill,288,hunter,marksmanship,6,3,3
Celebor,sanguino,288,hunter,marksmanship,6,3,3
Deadluck,kazzak,288,hunter,marksmanship,6,3,3
Djfury,archimonde,288,hunter,marksmanship,6,3,3
Labestiia,sanguino,288,hunter,marksmanship,6,3,3
Экономист,fordragon,288,hunter,marksmanship,6,3,3
Pointnclick,the-maelstrom,288,hunter,marksmanship,6,3,3
Трапавграунд,howling-fjord,288,hunter,marksmanship,6,3,3
Spunkybum,nagrand,288,hunter,marksmanship,6,3,3
Ев,lich-king,288,hunter,marksmanship,6,3,3
Homoride,alleria,288,hunter,marksmanship,6,3,3
Emànuela,outland,288,hunter,marksmanship,6,3,3
Ðøpèz,frostwolf,288,hunter,marksmanship,6,3,3
Techpøint,silvermoon,288,hunter,marksmanship,6,3,3
Kaznek,hyjal,288,hunter,marksmanship,6,3,3
Naramir,ysondre,288,hunter,marksmanship,6,3,3
Zhorks,sanguino,288,hunter,marksmanship,6,3,3
Jarhead,arthas,288,hunter,marksmanship,6,3,3
Marcoh,die-arguswacht,288,hunter,marksmanship,6,3,3
Альцнтриен,eversong,288,hunter,marksmanship,6,3,3
Neescafe,sylvanas,288,hunter,marksmanship,6,3,3
Shall,outland,288,hunter,marksmanship,6,3,3
Soulflyer,draenor,288,hunter,marksmanship,6,3,3
Lithell,kazzak,288,hunter,marksmanship,6,3,3
Ayiu,argent-dawn,288,hunter,marksmanship,6,3,3
Crispyqt,kazzak,288,hunter,marksmanship,6,3,3
Kandrena,argent-dawn,288,hunter,marksmanship,6,3,3
Andrøk,archimonde,288,hunter,marksmanship,6,3,3
Välk,sylvanas,288,hunter,marksmanship,6,3,3
Vystrelil,drakthul,288,hunter,marksmanship,6,3,3
Misstrap,nemesis,288,hunter,marksmanship,6,3,3
Søp,marécage-de-zangar,288,hunter,marksmanship,6,3,3
Padancete,sanguino,288,hunter,marksmanship,6,3,3
Arnasus,silvermoon,288,hunter,marksmanship,6,3,3
Sheilare,doomhammer,288,hunter,marksmanship,6,3,3
Люблюлюбовь,gordunni,288,hunter,marksmanship,6,3,3
Ägris,die-todeskrallen,288,hunter,marksmanship,6,3,3
Kayflock,kazzak,288,hunter,marksmanship,6,3,3
Qaedri,kazzak,288,hunter,marksmanship,6,3,3
Hatemybow,ragnaros,288,hunter,marksmanship,6,3,3
Ökisek,drakthul,288,hunter,marksmanship,6,3,3
Zwockeline,blutkessel,288,hunter,marksmanship,6,3,3
Dethroner,dun-modr,288,hunter,marksmanship,6,3,3
ßæro,hyjal,288,hunter,marksmanship,6,3,3
Westcøãst,archimonde,288,hunter,marksmanship,6,3,3
Гринмех,gordunni,288,hunter,marksmanship,6,3,3
Nerdhark,hyjal,288,hunter,marksmanship,6,3,3
Osie,kazzak,288,hunter,marksmanship,6,3,3
Rindarshot,dun-modr,288,hunter,marksmanship,6,3,3
Aimywinehaus,burning-blade,288,hunter,marksmanship,6,3,3
Jetleesnipez,blackmoore,288,hunter,marksmanship,6,3,3
Threeguns,blackrock,288,hunter,marksmanship,6,3,3
Bocek,silvermoon,288,hunter,marksmanship,6,3,3
Tardoboy,blackrock,288,hunter,marksmanship,6,3,3
Ulischwonsen,blackmoore,288,hunter,marksmanship,6,3,3
Babûsch,blackmoore,288,hunter,marksmanship,6,3,3
Mariabanks,aegwynn,288,hunter,marksmanship,6,3,3
Mhb,quelthalas,288,hunter,marksmanship,6,3,3
Aliltoxic,silvermoon,288,hunter,marksmanship,6,3,3
Nexztwo,blackrock,288,hunter,marksmanship,6,3,3
Fizè,blackmoore,288,hunter,marksmanship,6,3,3
Brûmovitch,archimonde,288,hunter,marksmanship,6,3,3
Annababygirl,silvermoon,288,hunter,marksmanship,6,3,3
Deta,blackmoore,288,hunter,marksmanship,6,3,3
Feyoonxx,blackrock,288,hunter,marksmanship,6,3,3
Elnino,eonar,288,hunter,marksmanship,6,3,3
Fize,blackmoore,288,hunter,marksmanship,6,3,3
Kfcmanagerx,silvermoon,288,hunter,marksmanship,6,3,3
Dedral,aegwynn,288,hunter,marksmanship,6,3,3
Osron,blackmoore,288,hunter,marksmanship,6,3,3
Graavi,silvermoon,288,hunter,marksmanship,6,3,3
Nightarrowq,tarren-mill,288,hunter,marksmanship,9,4,5
Amdéa,boulderfist,288,hunter,marksmanship,10,4,6
Boen,nordrassil,288,hunter,marksmanship,8,3,5
Нойран,eversong,288,hunter,marksmanship,9,3,6
Hidalgô,kult-der-verdammten,288,hunter,marksmanship,9,3,6
Лонтерикс,gordunni,288,hunter,marksmanship,11,3,8
Bengeh,tarren-mill,288,hunter,marksmanship,12,3,9
Кактусджекк,gordunni,288,hunter,marksmanship,12,3,9
Akù,magtheridon,288,hunter,marksmanship,12,3,9
Горгудц,gordunni,288,hunter,marksmanship,12,3,9
Jensa,darksorrow,288,hunter,marksmanship,12,3,9
Augie,kazzak,288,hunter,marksmanship,12,3,9
Hunteraction,lightbringer,288,hunter,marksmanship,12,3,9
Foxmis,kazzak,288,hunter,marksmanship,12,3,9
Zubro,kazzak,288,hunter,marksmanship,12,3,9
Скадхи,blackscar,288,hunter,marksmanship,12,3,9
Zammies,aggramar,288,hunter,marksmanship,12,3,9
Clickpao,outland,288,hunter,marksmanship,12,3,9
Нэвлоск,gordunni,288,hunter,marksmanship,12,3,9
Oduross,minahonda,288,hunter,marksmanship,12,3,9
Missdarkness,shattered-hand,288,hunter,marksmanship,12,3,9
Lioness,ahnqiraj,288,hunter,marksmanship,12,3,9
Demoira,genjuros,288,hunter,marksmanship,12,3,9
Lùchiean,kazzak,288,hunter,marksmanship,12,3,9
Rosoken,kazzak,288,hunter,marksmanship,12,3,9
Dafragger,blackmoore,288,hunter,marksmanship,12,3,9
Bowgamerx,ravencrest,288,hunter,marksmanship,12,3,9
Hedinen,the-venture-co,288,hunter,marksmanship,12,3,9
Sphinx,neptulon,288,hunter,marksmanship,12,3,9
Lilyss,outland,288,hunter,marksmanship,12,3,9
Ghenter,sargeras,288,hunter,marksmanship,12,3,9
Aîmshot,ravencrest,288,hunter,marksmanship,12,3,9
Mcperra,zuljin,288,hunter,marksmanship,12,3,9
Flucxx,stormscale,288,hunter,marksmanship,12,3,9
Naaztko,stormscale,288,hunter,marksmanship,12,3,9
Бубунн,howling-fjord,288,hunter,marksmanship,12,3,9
Бычарник,eversong,288,hunter,marksmanship,12,3,9
Ибражы,howling-fjord,288,hunter,marksmanship,12,3,9
Snipar,chogall,288,hunter,marksmanship,12,3,9
Хедшоттер,blackscar,288,hunter,marksmanship,12,3,9
Unclehowdy,sanguino,288,hunter,marksmanship,12,3,9
Avp,sylvanas,288,hunter,marksmanship,12,3,9
Saîtek,chogall,288,hunter,marksmanship,12,3,9
Spakster,blackrock,288,hunter,marksmanship,12,3,9
Rløad,hyjal,288,hunter,marksmanship,12,3,9
Астериел,blackscar,288,hunter,marksmanship,12,3,9
Chassuu,khaz-modan,288,hunter,marksmanship,12,3,9
Spítz,outland,288,hunter,marksmanship,12,3,9
Dãhrn,sanguino,288,hunter,marksmanship,12,3,9
Dajägaa,blackmoore,288,hunter,marksmanship,12,3,9
Galathrin,twisting-nether,288,hunter,marksmanship,12,3,9
Fatfrumos,twisting-nether,288,hunter,marksmanship,12,3,9
Wödën,argent-dawn,288,hunter,marksmanship,12,3,9
Thalanel,arthas,288,hunter,marksmanship,12,3,9
Deify,grim-batol,288,hunter,marksmanship,12,3,9
Nímren,ambossar,288,hunter,marksmanship,12,3,9
Grubabicza,silvermoon,288,hunter,marksmanship,12,3,9
Flyingnipp,arthas,288,hunter,marksmanship,12,3,9
Tharzo,thrall,288,hunter,marksmanship,12,3,9
Arslan,archimonde,288,hunter,marksmanship,16,3,13
Tsía,ysondre,288,hunter,marksmanship,17,3,14
Richidex,zuljin,288,hunter,marksmanship,18,3,15
Pulsaðenura,dun-modr,288,hunter,marksmanship,18,3,15
Castbuny,drakthul,288,hunter,marksmanship,18,3,15
Sidera,der-rat-von-dalaran,288,hunter,marksmanship,18,3,15
Gabbriel,ravencrest,288,hunter,marksmanship,18,3,15
Bmo,zuljin,288,hunter,marksmanship,18,3,15
Shademd,ahnqiraj,288,hunter,marksmanship,18,3,15
Showdope,drakthul,288,hunter,marksmanship,18,3,15
Дэнарис,gordunni,288,hunter,marksmanship,18,3,15
Оркос,deathweaver,287,hunter,marksmanship,6,3,3
Btk,sanguino,287,hunter,marksmanship,6,3,3
Thyrazs,archimonde,287,hunter,marksmanship,6,3,3
Gamwhunter,twisting-nether,287,hunter,marksmanship,6,3,3
Kolskoot,kilrogg,287,hunter,marksmanship,6,3,3
Schwarzreh,ulduar,287,hunter,marksmanship,12,3,9
Worus,argent-dawn,287,hunter,marksmanship,12,3,9
Constantín,aegwynn,287,hunter,marksmanship,12,3,9
Onexshot,draenor,287,hunter,marksmanship,12,3,9
Dwoas,darkspear,287,hunter,marksmanship,12,3,9
Guf,eredar,287,hunter,marksmanship,13,3,10
Сяову,gordunni,287,hunter,marksmanship,18,3,15
Dambrä,eredar,286,hunter,marksmanship,6,3,3
Jomoguin,stormscale,286,hunter,marksmanship,6,3,3
Millhunter,norgannon,284,hunter,marksmanship,12,3,9
Darkstripe,turalyon,281,hunter,marksmanship,13,5,8
Dryko,silvermoon,271,hunter,marksmanship,11,3,8
Najetazruda,drakthul,255,hunter,marksmanship,10,3,7
Бещеный,ashenvale,255,hunter,marksmanship,11,3,8
Eazzyy,auchindoun,239,hunter,marksmanship,5,3,2
Dracy,baelgun,239,hunter,marksmanship,5,3,2
Jaguarundy,dun-modr,239,hunter,marksmanship,5,3,2
Олдорк,howling-fjord,239,hunter,marksmanship,12,3,9
Incrediown,tarren-mill,234,hunter,marksmanship,7,4,3
Merrengoj,frostmourne,234,hunter,marksmanship,8,4,4
Doloresman,tarren-mill,234,hunter,marksmanship,9,4,5
Yuptae,alonsus,234,hunter,marksmanship,10,4,6
Everz,silvermoon,234,hunter,marksmanship,13,4,9
Loydzz,hyjal,234,hunter,marksmanship,14,4,10
Vasco,chogall,223,hunter,marksmanship,8,3,5
Falakras,ragnaros,223,hunter,marksmanship,8,3,5
Dampfwâlzê,nozdormu,223,hunter,marksmanship,14,3,11
Dann,uldum,208,hunter,marksmanship,7,3,4
Skarra,zuljin,208,hunter,marksmanship,7,3,4
Taurïel,stormscale,208,hunter,marksmanship,7,3,4
Kodakcrack,draenor,192,hunter,marksmanship,6,2,4
Dola,archimonde,192,hunter,marksmanship,6,2,4
Røgrøck,archimonde,192,hunter,marksmanship,6,2,4
Darkshàdow,archimonde,192,hunter,marksmanship,6,2,4
Rafaela,genjuros,192,hunter,marksmanship,6,2,4
Traenuss,azuremyst,192,hunter,marksmanship,6,2,4
Womper,silvermoon,192,hunter,marksmanship,6,2,4
Doknak,gilneas,192,hunter,marksmanship,6,2,4
Bowner,frostmane,192,hunter,marksmanship,6,2,4
Notikâ,aegwynn,192,hunter,marksmanship,6,2,4
Sylvanaskwt,silvermoon,192,hunter,marksmanship,6,2,4
Isokrates,das-syndikat,192,hunter,marksmanship,6,2,4
Anoroxx,arthas,192,hunter,marksmanship,6,2,4
Arrowlight,archimonde,192,hunter,marksmanship,6,2,4
Adkins,elune,192,hunter,marksmanship,6,2,4
Aspergun,ragnaros,192,hunter,marksmanship,6,2,4
Eilet,pozzo-delleternità,192,hunter,marksmanship,6,2,4
Craisax,nemesis,192,hunter,marksmanship,6,2,4
Kagan,nemesis,192,hunter,marksmanship,6,2,4
Mìrilass,nemesis,192,hunter,marksmanship,6,2,4
Vâleriaa,blackrock,192,hunter,marksmanship,6,2,4
Anklar,blackrock,192,hunter,marksmanship,6,2,4
Gedept,blackrock,192,hunter,marksmanship,6,2,4
Plilolz,archimonde,192,hunter,marksmanship,6,2,4
Drigs,blackrock,192,hunter,marksmanship,6,2,4
Svolatch,blackrock,192,hunter,marksmanship,6,2,4
Realme,blackrock,192,hunter,marksmanship,6,2,4
Naass,silvermoon,192,hunter,marksmanship,6,2,4
Ecthelione,the-venture-co,192,hunter,marksmanship,6,2,4
Настякобра,blackscar,192,hunter,marksmanship,6,2,4
Sebrienne,defias-brotherhood,192,hunter,marksmanship,6,2,4
Фираналь,blackscar,192,hunter,marksmanship,6,2,4
Азифаель,gordunni,192,hunter,marksmanship,6,2,4
Nnoyk,defias-brotherhood,192,hunter,marksmanship,6,2,4
Changwehh,blackmoore,192,hunter,marksmanship,6,2,4
Гернриета,gordunni,192,hunter,marksmanship,6,2,4
Cryka,blackmoore,192,hunter,marksmanship,6,2,4
Виндрунир,gordunni,192,hunter,marksmanship,6,2,4
Шейхант,gordunni,192,hunter,marksmanship,6,2,4
Seifér,auchindoun,192,hunter,marksmanship,6,2,4
Traplørdx,sylvanas,192,hunter,marksmanship,6,2,4
Lamîndra,blackmoore,192,hunter,marksmanship,6,2,4
Ðkð,archimonde,192,hunter,marksmanship,6,2,4
Qled,sylvanas,192,hunter,marksmanship,6,2,4
Lagich,sylvanas,192,hunter,marksmanship,6,2,4
Flick,auchindoun,192,hunter,marksmanship,6,2,4
Wujekwania,silvermoon,192,hunter,marksmanship,6,2,4
Thunderstarr,blackmoore,192,hunter,marksmanship,6,2,4
Otekkâ,hyjal,192,hunter,marksmanship,6,2,4
Velvett,blackmoore,192,hunter,marksmanship,6,2,4
Brizza,talnivarr,192,hunter,marksmanship,6,2,4
Охотуначал,soulflayer,192,hunter,marksmanship,6,2,4
Entaiy,blackmoore,192,hunter,marksmanship,6,2,4
Фетсол,soulflayer,192,hunter,marksmanship,6,2,4
Зихантер,soulflayer,192,hunter,marksmanship,6,2,4
Broodhar,hyjal,192,hunter,marksmanship,6,2,4
Эвелан,soulflayer,192,hunter,marksmanship,6,2,4
Bóssit,skullcrusher,192,hunter,marksmanship,6,2,4
Sankari,blackmoore,192,hunter,marksmanship,6,2,4
Ricoshet,silvermoon,192,hunter,marksmanship,6,2,4
Шалларис,soulflayer,192,hunter,marksmanship,6,2,4
Сактарион,soulflayer,192,hunter,marksmanship,6,2,4
Phanos,draenor,192,hunter,marksmanship,6,2,4
Шергала,soulflayer,192,hunter,marksmanship,6,2,4
Bowzaa,blackmoore,192,hunter,marksmanship,6,2,4
Knallêrbse,blackmoore,192,hunter,marksmanship,6,2,4
Slickbackdan,the-maelstrom,192,hunter,marksmanship,6,2,4
Sugmèg,dragonblight,192,hunter,marksmanship,6,2,4
Goldnug,karazhan,192,hunter,marksmanship,6,2,4
Andressc,colinas-pardas,192,hunter,marksmanship,6,2,4
Elvyns,silvermoon,192,hunter,marksmanship,6,2,4
Fullxtrap,hyjal,192,hunter,marksmanship,6,2,4
Keinzira,hyjal,192,hunter,marksmanship,6,2,4
Тоу,deathguard,192,hunter,marksmanship,6,2,4
Joshalama,quelthalas,192,hunter,marksmanship,6,2,4
Eule,dun-modr,192,hunter,marksmanship,6,2,4
Eclipsax,cthun,192,hunter,marksmanship,6,2,4
Batalul,twisting-nether,192,hunter,marksmanship,6,2,4
Juhiu,hyjal,192,hunter,marksmanship,6,2,4
Arunaky,uldum,192,hunter,marksmanship,6,2,4
Viktorijå,draenor,192,hunter,marksmanship,6,2,4
Upresa,sanguino,192,hunter,marksmanship,6,2,4
Mobshot,twisting-nether,192,hunter,marksmanship,6,2,4
Meztarinnan,twisting-nether,192,hunter,marksmanship,6,2,4
Zulldek,sanguino,192,hunter,marksmanship,6,2,4
Tòràk,twisting-nether,192,hunter,marksmanship,6,2,4
Greenstar,twisting-nether,192,hunter,marksmanship,6,2,4
Corrector,outland,192,hunter,marksmanship,6,2,4
Nightsprout,neptulon,192,hunter,marksmanship,6,2,4
Hexorn,ysondre,192,hunter,marksmanship,6,2,4
Wicmex,les-sentinelles,192,hunter,marksmanship,6,2,4
Arrow,shattered-hand,192,hunter,marksmanship,6,2,4
Huntbeard,ragnaros,192,hunter,marksmanship,6,2,4
Themehdi,silvermoon,192,hunter,marksmanship,6,2,4
Denixilith,eredar,192,hunter,marksmanship,6,2,4
Велайна,galakrond,192,hunter,marksmanship,6,2,4
Köblow,khaz-modan,192,hunter,marksmanship,6,2,4
Bignug,conseil-des-ombres,192,hunter,marksmanship,6,2,4
Machini,terokkar,192,hunter,marksmanship,6,2,4
Vengigodx,outland,192,hunter,marksmanship,6,2,4
Artdragon,burning-legion,192,hunter,marksmanship,6,2,4
Madeyhunt,burning-legion,192,hunter,marksmanship,6,2,4
Illicit,silvermoon,192,hunter,marksmanship,6,2,4
Походупопал,howling-fjord,192,hunter,marksmanship,6,2,4
Nînux,frostwolf,192,hunter,marksmanship,6,2,4
Дианнесса,howling-fjord,192,hunter,marksmanship,6,2,4
Eanflaed,drakthul,192,hunter,marksmanship,6,2,4
Хисдед,howling-fjord,192,hunter,marksmanship,6,2,4
Juicewrld,xavius,192,hunter,marksmanship,6,2,4
Marrow,alleria,192,hunter,marksmanship,6,2,4
Skjutkänslan,outland,192,hunter,marksmanship,6,2,4
Bláckheart,doomhammer,192,hunter,marksmanship,6,2,4
Nitroni,rexxar,192,hunter,marksmanship,6,2,4
Кейтпрнстар,howling-fjord,192,hunter,marksmanship,6,2,4
Gretchin,bloodhoof,192,hunter,marksmanship,6,2,4
Larrylegend,der-rat-von-dalaran,192,hunter,marksmanship,6,2,4
Трисциллочка,howling-fjord,192,hunter,marksmanship,6,2,4
Bärberøusse,illidan,192,hunter,marksmanship,6,2,4
Reeceyree,outland,192,hunter,marksmanship,6,2,4
Bellecoq,arathi,192,hunter,marksmanship,6,2,4
Arnakua,outland,192,hunter,marksmanship,6,2,4
Zinà,naxxramas,192,hunter,marksmanship,6,2,4
Trollì,stormreaver,192,hunter,marksmanship,6,2,4
Kírathril,blackhand,192,hunter,marksmanship,6,2,4
Hadto,der-rat-von-dalaran,192,hunter,marksmanship,6,2,4
Linkinranger,tarren-mill,192,hunter,marksmanship,6,2,4
Rimmig,malganis,192,hunter,marksmanship,6,2,4
Gladodjurig,tarren-mill,192,hunter,marksmanship,6,2,4
Silenta,outland,192,hunter,marksmanship,6,2,4
Carioca,blackhand,192,hunter,marksmanship,6,2,4
Garrash,teldrassil,192,hunter,marksmanship,6,2,4
Hvnn,stormscale,192,hunter,marksmanship,6,2,4
Edrenalin,ravencrest,192,hunter,marksmanship,6,2,4
Emiliabr,stormscale,192,hunter,marksmanship,6,2,4
Olrik,dentarg,192,hunter,marksmanship,6,2,4
Eilosh,outland,192,hunter,marksmanship,6,2,4
Ptx,stormscale,192,hunter,marksmanship,6,2,4
Grytax,outland,192,hunter,marksmanship,6,2,4
Miracleh,tarren-mill,192,hunter,marksmanship,6,2,4
Slayman,kazzak,192,hunter,marksmanship,6,2,4
Jamesyy,ravencrest,192,hunter,marksmanship,6,2,4
Tÿro,ravencrest,192,hunter,marksmanship,6,2,4
Runescapes,ravencrest,192,hunter,marksmanship,6,2,4
Gwaewel,argent-dawn,192,hunter,marksmanship,6,2,4
Sinadoreck,sargeras,192,hunter,marksmanship,6,2,4
Najli,kazzak,192,hunter,marksmanship,6,2,4
Ävírøñskÿ,ravencrest,192,hunter,marksmanship,6,2,4
Nigina,ravencrest,192,hunter,marksmanship,6,2,4
Chenony,ravencrest,192,hunter,marksmanship,6,2,4
Nashanael,argent-dawn,192,hunter,marksmanship,6,2,4
Sizzlepop,argent-dawn,192,hunter,marksmanship,6,2,4
Nyght,ravencrest,192,hunter,marksmanship,6,2,4
Tórbjorn,argent-dawn,192,hunter,marksmanship,6,2,4
Melloy,drakthul,192,hunter,marksmanship,6,2,4
Lethalshotz,tarren-mill,192,hunter,marksmanship,7,2,5
Resputimothy,emeriss,192,hunter,marksmanship,9,2,7
Лиасон,howling-fjord,192,hunter,marksmanship,12,2,10
Explicits,stormscale,192,hunter,marksmanship,12,2,10
Dmanite,ravencrest,192,hunter,marksmanship,12,2,10
Headshota,stormscale,192,hunter,marksmanship,12,2,10
Gingiismydad,outland,192,hunter,marksmanship,12,2,10
Pennymarks,blackhand,192,hunter,marksmanship,12,2,10
Ølympx,blackhand,192,hunter,marksmanship,12,2,10
Weedonyhunt,hyjal,192,hunter,marksmanship,12,2,10
Кетроуз,howling-fjord,192,hunter,marksmanship,12,2,10
Oneshotbigi,ravencrest,192,hunter,marksmanship,12,2,10
Hyod,khaz-modan,192,hunter,marksmanship,12,2,10
Chassour,archimonde,192,hunter,marksmanship,12,2,10
Kenpach,frostmane,192,hunter,marksmanship,12,2,10
Waalth,ragnaros,192,hunter,marksmanship,12,2,10
Täladrielle,hyjal,192,hunter,marksmanship,12,2,10
Negz,eredar,192,hunter,marksmanship,12,2,10
Застрельщикц,soulflayer,192,hunter,marksmanship,12,2,10
Litia,ysondre,192,hunter,marksmanship,12,2,10
Friskì,draenor,192,hunter,marksmanship,12,2,10
Vèla,ysondre,192,hunter,marksmanship,12,2,10
Zefirr,sanguino,192,hunter,marksmanship,12,2,10
Katharyne,argent-dawn,192,hunter,marksmanship,12,2,10
Almêryck,ysondre,192,hunter,marksmanship,12,2,10
Jaysonmore,argent-dawn,192,hunter,marksmanship,12,2,10
Banglor,shattered-hand,192,hunter,marksmanship,12,2,10
Fedya,kazzak,192,hunter,marksmanship,12,2,10
Elitepeon,blackmoore,192,hunter,marksmanship,12,2,10
Poszipabre,magtheridon,192,hunter,marksmanship,12,2,10
Suchykeb,silvermoon,192,hunter,marksmanship,12,2,10
Oktoc,dalaran,192,hunter,marksmanship,13,2,11
Taureno,lordaeron,192,hunter,marksmanship,14,2,12
Kronzucker,eredar,192,hunter,marksmanship,18,2,16
Haïry,kazzak,192,hunter,marksmanship,18,2,16
Fakepvper,darksorrow,191,hunter,marksmanship,6,2,4
Sushimän,kaelthas,191,hunter,marksmanship,6,2,4
Downpipe,shattered-hand,191,hunter,marksmanship,6,2,4
Graff,grim-batol,191,hunter,marksmanship,6,2,4
Enanorabioso,minahonda,191,hunter,marksmanship,6,2,4
Stormhoofd,bloodhoof,191,hunter,marksmanship,6,2,4
Chalyto,dun-morogh,191,hunter,marksmanship,12,2,10
Fingon,alleria,191,hunter,marksmanship,12,2,10
Kure,blackrock,191,hunter,marksmanship,12,2,10
Glaukôs,die-nachtwache,190,hunter,marksmanship,12,2,10
Inzyplatv,blackmoore,160,hunter,marksmanship,10,2,8
Jaguàr,kazzak,159,hunter,marksmanship,5,2,3
Buttsnipe,sylvanas,159,hunter,marksmanship,5,2,3
Bryanblak,colinas-pardas,159,hunter,marksmanship,5,2,3
Bigbababotan,blackrock,159,hunter,marksmanship,5,2,3
Ofilantii,ragnaros,144,hunter,marksmanship,3,3,0
Tràpz,archimonde,144,hunter,marksmanship,9,2,7
Sylariel,die-aldor,138,hunter,marksmanship,10,4,6
Gilgämesh,hyjal,138,hunter,marksmanship,10,3,7
Spagooters,argent-dawn,138,hunter,marksmanship,11,3,8
Louce,argent-dawn,128,hunter,marksmanship,7,2,5
Akahr,thrall,96,hunter,marksmanship,3,2,1
Tryx,darksorrow,96,hunter,marksmanship,3,2,1
Janoh,dalaran,96,hunter,marksmanship,3,2,1
Åbomìnatïon,ravencrest,96,hunter,marksmanship,18,3,15
Puciak,drakthul,96,hunter,marksmanship,6,1,5
Guttz,chants-éternels,96,hunter,marksmanship,6,1,5
Johnnygnus,drakthul,96,hunter,marksmanship,6,1,5
Pinocion,drakthul,96,hunter,marksmanship,6,1,5
Cítyzens,drakthul,96,hunter,marksmanship,6,1,5
Tuljan,ravencrest,96,hunter,marksmanship,6,1,5
Fayenia,ravencrest,96,hunter,marksmanship,6,1,5
Chantalia,ravencrest,96,hunter,marksmanship,6,1,5
Elaresas,argent-dawn,96,hunter,marksmanship,6,1,5
Arkancia,throkferoth,96,hunter,marksmanship,6,1,5
Yurai,argent-dawn,96,hunter,marksmanship,6,1,5
Xaraimz,ravencrest,96,hunter,marksmanship,6,1,5
Baramia,theradras,96,hunter,marksmanship,6,1,5
Leaxs,onyxia,96,hunter,marksmanship,6,1,5
Velcy,ravencrest,96,hunter,marksmanship,6,1,5
Akaname,ravencrest,96,hunter,marksmanship,6,1,5
Crowcifer,argent-dawn,96,hunter,marksmanship,6,1,5
Nalys,argent-dawn,96,hunter,marksmanship,6,1,5
Cendrac,ravencrest,96,hunter,marksmanship,6,1,5
Salie,argent-dawn,96,hunter,marksmanship,6,1,5
Ninjakimi,ravencrest,96,hunter,marksmanship,6,1,5
Envixia,tarren-mill,96,hunter,marksmanship,6,1,5
Jtechasse,outland,96,hunter,marksmanship,6,1,5
Gbpusd,outland,96,hunter,marksmanship,6,1,5
Cléò,kazzak,96,hunter,marksmanship,6,1,5
Syldroxia,antonidas,96,hunter,marksmanship,6,1,5
Djtrapdaddy,outland,96,hunter,marksmanship,6,1,5
Nethria,antonidas,96,hunter,marksmanship,6,1,5
Zórk,malganis,96,hunter,marksmanship,6,1,5
Reakanz,tarren-mill,96,hunter,marksmanship,6,1,5
Sentriks,tarren-mill,96,hunter,marksmanship,6,1,5
Dryagesteak,norgannon,96,hunter,marksmanship,6,1,5
Teedfredd,tarren-mill,96,hunter,marksmanship,6,1,5
Hunthem,kazzak,96,hunter,marksmanship,6,1,5
Applix,tarren-mill,96,hunter,marksmanship,6,1,5
Cllaaw,kazzak,96,hunter,marksmanship,6,1,5
Thorka,tarren-mill,96,hunter,marksmanship,6,1,5
Sângha,frostwolf,96,hunter,marksmanship,6,1,5
Xnightmare,draenor,96,hunter,marksmanship,6,1,5
Eowale,outland,96,hunter,marksmanship,6,1,5
Ferdinandl,draenor,96,hunter,marksmanship,6,1,5
Гижуна,howling-fjord,96,hunter,marksmanship,6,1,5
Ashjen,aszune,96,hunter,marksmanship,6,1,5
Huntred,malfurion,96,hunter,marksmanship,6,1,5
Барев,howling-fjord,96,hunter,marksmanship,6,1,5
Wolfmcquade,draenor,96,hunter,marksmanship,6,1,5
Lyute,draenor,96,hunter,marksmanship,6,1,5
Наладдчик,howling-fjord,96,hunter,marksmanship,6,1,5
Avizi,anachronos,96,hunter,marksmanship,6,1,5
Лсныйпамп,howling-fjord,96,hunter,marksmanship,6,1,5
Thefoxsay,draenor,96,hunter,marksmanship,6,1,5
Санзи,howling-fjord,96,hunter,marksmanship,6,1,5
Mehtäsika,xavius,96,hunter,marksmanship,6,1,5
Badkirves,kazzak,96,hunter,marksmanship,6,1,5
Darthbow,outland,96,hunter,marksmanship,6,1,5
Iddqd,outland,96,hunter,marksmanship,6,1,5
Pampers,silvermoon,96,hunter,marksmanship,6,1,5
Nortroll,draenor,96,hunter,marksmanship,6,1,5
Elmerthehunt,archimonde,96,hunter,marksmanship,6,1,5
Frapt,dalaran,96,hunter,marksmanship,6,1,5
Feedbackloop,silvermoon,96,hunter,marksmanship,6,1,5
Itamedruid,eredar,96,hunter,marksmanship,6,1,5
Mackpass,ysondre,96,hunter,marksmanship,6,1,5
Surprises,ysondre,96,hunter,marksmanship,6,1,5
Hanzú,argent-dawn,96,hunter,marksmanship,6,1,5
Raverave,burning-legion,96,hunter,marksmanship,6,1,5
Kongweaver,ragnaros,96,hunter,marksmanship,6,1,5
Навальница,gordunni,96,hunter,marksmanship,6,1,5
Toulouki,silvermoon,96,hunter,marksmanship,6,1,5
Asery,blackmoore,96,hunter,marksmanship,6,1,5
Roupinol,aggra-português,96,hunter,marksmanship,6,1,5
Púrefect,ragnaros,96,hunter,marksmanship,6,1,5
Pestilencio,shendralar,96,hunter,marksmanship,6,1,5
Wantsumsnipe,twisting-nether,96,hunter,marksmanship,6,1,5
Ninielnienor,thrall,96,hunter,marksmanship,6,1,5
Superfacial,twisting-nether,96,hunter,marksmanship,6,1,5
Faccacamoale,twisting-nether,96,hunter,marksmanship,6,1,5
Drolarin,zuljin,96,hunter,marksmanship,6,1,5
Valora,zuluhed,96,hunter,marksmanship,6,1,5
Udolff,twisting-nether,96,hunter,marksmanship,6,1,5
Mästerkill,dun-modr,96,hunter,marksmanship,6,1,5
Pagman,thrall,96,hunter,marksmanship,6,1,5
Wonderbrax,nemesis,96,hunter,marksmanship,6,1,5
Орталиус,deathguard,96,hunter,marksmanship,6,1,5
Xarhunt,azjolnerub,96,hunter,marksmanship,6,1,5
Randire,guldan,96,hunter,marksmanship,6,1,5
Syx,amanthul,96,hunter,marksmanship,6,1,5
Tesourinho,aggra-português,96,hunter,marksmanship,6,1,5
Statik,deathwing,96,hunter,marksmanship,6,1,5
Høøl,hyjal,96,hunter,marksmanship,6,1,5
Killzo,sylvanas,96,hunter,marksmanship,6,1,5
Flechaoscurä,exodar,96,hunter,marksmanship,6,1,5
Ренектон,soulflayer,96,hunter,marksmanship,6,1,5
Хантунец,soulflayer,96,hunter,marksmanship,6,1,5
Maity,die-ewige-wacht,96,hunter,marksmanship,6,1,5
Варсор,soulflayer,96,hunter,marksmanship,6,1,5
Jackchuka,das-syndikat,96,hunter,marksmanship,6,1,5
Баянист,soulflayer,96,hunter,marksmanship,6,1,5
Wèdra,hyjal,96,hunter,marksmanship,6,1,5
Longbeardkh,silvermoon,96,hunter,marksmanship,6,1,5
Desow,blackrock,96,hunter,marksmanship,6,1,5
Обспн,borean-tundra,96,hunter,marksmanship,6,1,5
Merci,nazjatar,96,hunter,marksmanship,6,1,5
Tillhunt,kargath,96,hunter,marksmanship,6,1,5
Sbop,aegwynn,96,hunter,marksmanship,6,1,5
Дэнвин,deathweaver,96,hunter,marksmanship,6,1,5
Левери,gordunni,96,hunter,marksmanship,6,1,5
Chillø,elune,96,hunter,marksmanship,6,1,5
Камшотовна,blackscar,96,hunter,marksmanship,6,1,5
Хэйоуу,gordunni,96,hunter,marksmanship,6,1,5
Ispityoudie,defias-brotherhood,96,hunter,marksmanship,6,1,5
Lòò,aegwynn,96,hunter,marksmanship,6,1,5
Горгонт,blackscar,96,hunter,marksmanship,6,1,5
Câlimerô,blackrock,96,hunter,marksmanship,6,1,5
Luftikuss,arthas,96,hunter,marksmanship,6,1,5
Sagytaryus,nemesis,96,hunter,marksmanship,11,1,10
Riplëy,dun-modr,96,hunter,marksmanship,12,1,11
Dewshot,silvermoon,96,hunter,marksmanship,12,1,11
Donáldtrúmp,tarren-mill,96,hunter,marksmanship,12,1,11
Râpton,blackmoore,96,hunter,marksmanship,12,1,11
Gorgorotha,ragnaros,96,hunter,marksmanship,12,1,11
Noskillbot,twisting-nether,96,hunter,marksmanship,12,1,11
Tiguy,archimonde,96,hunter,marksmanship,12,1,11
Moskalhunter,terokkar,96,hunter,marksmanship,12,1,11
Kayoo,stormscale,96,hunter,marksmanship,12,1,11
Cauron,blackrock,96,hunter,marksmanship,12,1,11
Mavis,bloodfeather,96,hunter,marksmanship,12,1,11
Yumyúm,antonidas,96,hunter,marksmanship,12,1,11
Acuatropatas,sanguino,96,hunter,marksmanship,12,1,11
Volupting,confrérie-du-thorium,96,hunter,marksmanship,17,1,16
Florâ,burning-legion,95,hunter,marksmanship,6,1,5
Magahra,thrall,95,hunter,marksmanship,6,1,5
Gettóbuxa,arathor,79,hunter,marksmanship,5,1,4
Aesrh,drakthul,79,hunter,marksmanship,5,1,4
Carnivorius,silvermoon,64,hunter,marksmanship,4,1,3
Dréws,kazzak,64,hunter,marksmanship,4,1,3
Draugrinnh,tarren-mill,48,hunter,marksmanship,3,1,2
Howlinjoe,darkspear,48,hunter,marksmanship,9,1,8
Merveilleux,hyjal,42,hunter,marksmanship,11,3,8
Daweí,draenor,42,hunter,marksmanship,9,2,7
Lyiene,silvermoon,42,hunter,marksmanship,10,2,8
Aethelred,azjolnerub,41,hunter,marksmanship,9,2,7
Deathproof,haomarush,31,hunter,marksmanship,2,1,1
Svinrbglol,arygos,31,hunter,marksmanship,2,1,1
Lootgobbo,antonidas,16,hunter,marksmanship,1,1,0
Дунморг,grom,16,hunter,marksmanship,1,1,0
Imortaltroll,kazzak,16,hunter,marksmanship,1,1,0
Elgango,blackrock,16,hunter,marksmanship,1,1,0
Bicmex,ravencrest,2437,hunter,survival,211,129,82
Brkh,ravencrest,2353,hunter,survival,108,62,46
Åíøñs,kazzak,2240,hunter,survival,96,55,41
Gíggí,malganis,2223,hunter,survival,78,44,34
Musen,draenor,2206,hunter,survival,102,55,47
Куфа,blackscar,2193,hunter,survival,84,46,38
Bonquiesha,tarren-mill,2163,hunter,survival,120,69,51
Corossity,blackmoore,2155,hunter,survival,107,71,36
Zpf,silvermoon,2150,hunter,survival,289,152,137
Kfcmanagerx,silvermoon,2143,hunter,survival,250,138,112
Harrianlar,ravenholdt,2143,hunter,survival,196,100,96
Goosebite,ravencrest,2141,hunter,survival,216,113,103
Rynex,festung-der-stürme,2134,hunter,survival,78,45,33
Pridz,archimonde,2121,hunter,survival,186,94,92
Rewgodxq,ravencrest,2115,hunter,survival,441,228,213
Djfortnite,ravencrest,2113,hunter,survival,65,39,26
Nikzeubii,archimonde,2113,hunter,survival,66,39,27
Krakenaspect,kazzak,2112,hunter,survival,74,47,27
Gukexa,outland,2106,hunter,survival,84,51,33
Momohenní,archimonde,2105,hunter,survival,234,133,101
Rayadz,nethersturm,2104,hunter,survival,240,124,116
Svinrbglol,arygos,2103,hunter,survival,107,59,48
Razoorine,blackrock,2102,hunter,survival,162,90,72
Josethepimpo,stormscale,2102,hunter,survival,263,135,128
Djheartstrng,argent-dawn,2100,hunter,survival,144,85,59
Scypher,ragnaros,2092,hunter,survival,80,49,31
Earfalass,twisting-nether,2082,hunter,survival,256,143,113
Fíng,tarren-mill,2079,hunter,survival,216,109,107
Stormblãze,ravencrest,2076,hunter,survival,187,92,95
Yake,kazzak,2071,hunter,survival,112,56,56
Uglybaboon,draenor,2064,hunter,survival,305,150,155
Zhulk,los-errantes,2063,hunter,survival,220,114,106
Götdelen,kult-der-verdammten,2053,hunter,survival,341,176,165
Urrane,archimonde,2052,hunter,survival,78,48,30
Belaux,archimonde,2049,hunter,survival,373,190,183
Bubby,burning-legion,2044,hunter,survival,76,45,31
Mestar,outland,2041,hunter,survival,282,143,139
Mógwaí,stormscale,2040,hunter,survival,84,61,23
Jànet,ravencrest,2037,hunter,survival,132,64,68
Yeezu,sylvanas,2032,hunter,survival,126,66,60
Razôr,blackhand,2031,hunter,survival,72,45,27
Sneakyshot,nemesis,2030,hunter,survival,156,78,78
Gukéx,stormscale,2029,hunter,survival,348,180,168
Wickked,ravencrest,2018,hunter,survival,102,60,42
Pokefangirlx,grim-batol,2014,hunter,survival,319,172,147
Macrolaim,outland,2009,hunter,survival,347,170,177
Imtpain,kazzak,2007,hunter,survival,78,45,33
Akronis,outland,2006,hunter,survival,157,79,78
Huntity,kazzak,2003,hunter,survival,119,63,56
Marvelmary,ravencrest,1988,hunter,survival,127,59,68
Lutza,sanguino,1986,hunter,survival,150,77,73
Ilovejwrld,dun-modr,1984,hunter,survival,100,51,49
Løvebombing,ravencrest,1982,hunter,survival,70,44,26
Booxun,sylvanas,1982,hunter,survival,133,68,65
Epicsurvive,ravencrest,1982,hunter,survival,114,57,57
Rubydacherrý,argent-dawn,1980,hunter,survival,84,51,33
Garxzhunter,tarren-mill,1978,hunter,survival,87,48,39
Lultrap,nemesis,1977,hunter,survival,36,25,11
Mmkekw,guldan,1976,hunter,survival,66,42,24
Dyndns,blackmoore,1975,hunter,survival,150,77,73
Dackeldustin,norgannon,1970,hunter,survival,59,50,9
Майен,thermaplugg,1970,hunter,survival,150,76,74
Feignfisto,draenor,1966,hunter,survival,75,41,34
Djshibalxd,argent-dawn,1966,hunter,survival,263,135,128
Hyderr,aegwynn,1964,hunter,survival,54,34,20
Kurdo,outland,1963,hunter,survival,70,41,29
Saedelaerex,twisting-nether,1958,hunter,survival,133,86,47
Marchik,outland,1956,hunter,survival,76,50,26
Mspt,archimonde,1956,hunter,survival,165,81,84
Bnak,thrall,1950,hunter,survival,65,39,26
Aboleon,ragnaros,1949,hunter,survival,110,55,55
Jamboss,twisting-nether,1945,hunter,survival,60,29,31
Lágåta,outland,1940,hunter,survival,59,32,27
Woahx,silvermoon,1939,hunter,survival,36,23,13
Svetlanatrap,stormscale,1939,hunter,survival,101,54,47
Katzila,outland,1937,hunter,survival,71,44,27
Fatbushpig,stormscale,1937,hunter,survival,60,36,24
Nwnw,tarren-mill,1932,hunter,survival,48,27,21
Raelaf,zuljin,1927,hunter,survival,79,39,40
Yemistar,archimonde,1924,hunter,survival,108,56,52
Vènuhá,ravencrest,1914,hunter,survival,317,169,148
Merryhuntin,ravencrest,1912,hunter,survival,66,38,28
Karuso,ravencrest,1911,hunter,survival,77,33,44
Kalthrog,ragnaros,1908,hunter,survival,118,69,49
Kyosoku,silvermoon,1908,hunter,survival,69,33,36
Mortybeans,ravencrest,1904,hunter,survival,48,28,20
Mogumogu,blackhand,1903,hunter,survival,146,77,69
Crucfixion,kazzak,1899,hunter,survival,90,46,44
Fotmspec,tarren-mill,1892,hunter,survival,48,32,16
Sneakyshoot,nemesis,1891,hunter,survival,107,60,47
Jamesyy,ravencrest,1890,hunter,survival,59,37,22
Saliressa,ravencrest,1890,hunter,survival,120,63,57
Дарктеххно,howling-fjord,1884,hunter,survival,84,45,39
Killerkatze,outland,1884,hunter,survival,48,25,23
Obbnfriends,ravencrest,1877,hunter,survival,119,61,58
Alwaysthug,ravencrest,1875,hunter,survival,72,37,35
Draxil,archimonde,1874,hunter,survival,154,86,68
Лесбиянюсь,gordunni,1874,hunter,survival,173,91,82
Аркеро,soulflayer,1873,hunter,survival,115,65,50
Астериел,blackscar,1873,hunter,survival,58,30,28
Horku,kazzak,1871,hunter,survival,72,35,37
Skewdar,hyjal,1869,hunter,survival,180,90,90
Nttcoopzz,silvermoon,1868,hunter,survival,66,40,26
Bláckthorn,ravencrest,1868,hunter,survival,118,68,50
Jackjager,ravencrest,1868,hunter,survival,123,67,56
Hyparion,kazzak,1868,hunter,survival,105,54,51
Хансбург,howling-fjord,1866,hunter,survival,128,68,60
Lugnåls,hyjal,1865,hunter,survival,141,73,68
Glosendra,ravencrest,1863,hunter,survival,168,93,75
Nintara,outland,1859,hunter,survival,97,57,40
Yosia,draenor,1857,hunter,survival,178,95,83
Xamisch,eredar,1856,hunter,survival,141,83,58
Farell,laughing-skull,1856,hunter,survival,60,35,25
Микихаса,galakrond,1855,hunter,survival,237,127,110
Clydefrog,outland,1854,hunter,survival,70,35,35
Fablet,draenor,1851,hunter,survival,96,56,40
Øvade,argent-dawn,1851,hunter,survival,84,49,35
Летмимейт,howling-fjord,1851,hunter,survival,166,91,75
Sipsomewater,ravencrest,1851,hunter,survival,72,34,38
Kaghrot,ragnaros,1850,hunter,survival,180,88,92
Блатнайт,blackscar,1849,hunter,survival,195,98,97
Глефард,fordragon,1848,hunter,survival,179,100,79
Ехесу,soulflayer,1848,hunter,survival,77,41,36
Síraw,tarren-mill,1848,hunter,survival,84,39,45
Ksreport,stormscale,1844,hunter,survival,183,89,94
Bnak,die-ewige-wacht,1842,hunter,survival,42,30,12
Åzey,hyjal,1842,hunter,survival,103,62,41
Sandina,sylvanas,1842,hunter,survival,66,32,34
Búddhìst,ravencrest,1842,hunter,survival,96,46,50
Бубунн,howling-fjord,1840,hunter,survival,129,78,51
Dabeszt,draenor,1839,hunter,survival,156,87,69
Buoma,kazzak,1839,hunter,survival,97,51,46
Hûntyhunt,silvermoon,1838,hunter,survival,83,48,35
Daweí,draenor,1838,hunter,survival,102,53,49
Maiver,ravencrest,1837,hunter,survival,42,26,16
Moustø,archimonde,1836,hunter,survival,47,29,18
Zerberas,blackrock,1835,hunter,survival,60,32,28
Квит,blackscar,1832,hunter,survival,30,20,10
Lagich,stormscale,1832,hunter,survival,40,26,14
Privelle,argent-dawn,1832,hunter,survival,42,27,15
Ódelagga,sylvanas,1832,hunter,survival,242,135,107
Боцекабузер,galakrond,1830,hunter,survival,48,22,26
Fwaffidack,tarren-mill,1829,hunter,survival,63,36,27
Dedral,aegwynn,1829,hunter,survival,90,51,39
Vunter,malganis,1828,hunter,survival,48,26,22
Kukenisluken,stormscale,1827,hunter,survival,41,26,15
Jabela,eredar,1827,hunter,survival,154,84,70
Xexhel,twisting-nether,1824,hunter,survival,92,53,39
Zanpa,archimonde,1823,hunter,survival,141,78,63
Sarrow,ravencrest,1822,hunter,survival,115,64,51
Qwèrts,stormscale,1822,hunter,survival,60,33,27
Doghxnter,ravencrest,1819,hunter,survival,53,31,22
Nixerious,alakir,1819,hunter,survival,126,73,53
Skârlock,blackmoore,1819,hunter,survival,89,50,39
Cadier,argent-dawn,1818,hunter,survival,60,34,26
Raínbow,aegwynn,1818,hunter,survival,114,64,50
Зеленыйиисус,gordunni,1818,hunter,survival,153,84,69
Exquisitor,draenor,1818,hunter,survival,562,283,279
Stuckstepbro,silvermoon,1818,hunter,survival,47,22,25
Ðévi,ravencrest,1817,hunter,survival,38,27,11
Киссмайпет,howling-fjord,1815,hunter,survival,78,47,31
Ekexy,aegwynn,1810,hunter,survival,89,47,42
Erethrus,ravencrest,1810,hunter,survival,80,41,39
Sphexya,ravencrest,1809,hunter,survival,86,42,44
Errowini,blackmoore,1807,hunter,survival,66,38,28
Relo,dun-modr,1807,hunter,survival,74,40,34
Irefutabilâ,outland,1806,hunter,survival,35,20,15
Hühneknubbel,blackmoore,1806,hunter,survival,54,29,25
Hekyna,ravencrest,1805,hunter,survival,72,45,27
Кисяныч,gordunni,1805,hunter,survival,78,48,30
Mewithoutyou,ragnaros,1805,hunter,survival,292,144,148
Соняпиво,gordunni,1804,hunter,survival,72,41,31
Мигнитюша,blackscar,1803,hunter,survival,48,27,21
Cjezka,blackmoore,1803,hunter,survival,195,95,100
Xlít,outland,1802,hunter,survival,54,29,25
Polaqu,burning-legion,1801,hunter,survival,72,42,30
Unsáinted,ravencrest,1801,hunter,survival,359,192,167
Inter,hellscream,1801,hunter,survival,56,28,28
Brattamer,twisting-nether,1800,hunter,survival,50,36,14
Thalanos,antonidas,1800,hunter,survival,48,26,22
Burbutsuluki,silvermoon,1798,hunter,survival,66,33,33
Agnêas,silvermoon,1797,hunter,survival,84,43,41
Hunjo,quelthalas,1797,hunter,survival,155,74,81
Avaren,archimonde,1794,hunter,survival,124,63,61
Alexdi,kazzak,1792,hunter,survival,66,30,36
Jske,silvermoon,1790,hunter,survival,86,49,37
Eunte,archimonde,1786,hunter,survival,164,85,79
Thugzilla,auchindoun,1784,hunter,survival,77,42,35
Горгонт,blackscar,1779,hunter,survival,174,89,85
Твояпомощь,gordunni,1777,hunter,survival,60,40,20
Jögga,draenor,1777,hunter,survival,54,33,21
Kq,argent-dawn,1776,hunter,survival,63,34,29
Merquryh,ravencrest,1773,hunter,survival,30,23,7
Marryme,blackhand,1773,hunter,survival,128,76,52
Onlylfg,drakthul,1772,hunter,survival,68,35,33
Calesthas,tarren-mill,1771,hunter,survival,120,60,60
Ravebae,silvermoon,1771,hunter,survival,359,177,182
Dreämhäck,ravencrest,1768,hunter,survival,78,47,31
Chrønôs,archimonde,1758,hunter,survival,47,27,20
Lìmpy,stormreaver,1757,hunter,survival,48,29,19
Madzynette,archimonde,1757,hunter,survival,95,53,42
Pwon,ravencrest,1757,hunter,survival,248,129,119
Easyclass,hyjal,1756,hunter,survival,78,40,38
Minibicmex,aegwynn,1753,hunter,survival,106,53,53
Petshøp,outland,1752,hunter,survival,30,23,7
Astair,hyjal,1752,hunter,survival,114,65,49
Xhn,stormscale,1752,hunter,survival,108,57,51
Dheredre,silvermoon,1749,hunter,survival,53,28,25
Clifton,archimonde,1748,hunter,survival,42,27,15
Betarayjinx,kazzak,1746,hunter,survival,81,44,37
Eilosh,outland,1743,hunter,survival,72,38,34
Nienel,archimonde,1742,hunter,survival,192,94,98
Amyst,senjin,1742,hunter,survival,77,33,44
Sunyjuyono,ravencrest,1741,hunter,survival,95,47,48
Варкраб,blackscar,1740,hunter,survival,87,49,38
Shøt,stormreaver,1738,hunter,survival,88,51,37
Calyssae,shattered-halls,1737,hunter,survival,141,82,59
Døvah,argent-dawn,1737,hunter,survival,60,33,27
Âmalphy,ravencrest,1737,hunter,survival,60,27,33
Kayhh,stormscale,1736,hunter,survival,24,19,5
Skytraped,hyjal,1736,hunter,survival,53,34,19
Dorkos,sanguino,1736,hunter,survival,51,28,23
Monkeytrapz,norgannon,1733,hunter,survival,72,38,34
Леоа,howling-fjord,1733,hunter,survival,60,28,32
Knokkelmann,outland,1730,hunter,survival,60,33,27
Næmes,hyjal,1725,hunter,survival,70,40,30
Evengance,dragonblight,1724,hunter,survival,36,22,14
Смертонносна,lich-king,1724,hunter,survival,44,26,18
Thalanos,blackmoore,1724,hunter,survival,55,25,30
Shotazz,frostmane,1722,hunter,survival,60,36,24
Morkahs,dalaran,1722,hunter,survival,66,38,28
Pecorinö,archimonde,1722,hunter,survival,48,24,24
Boops,ragnaros,1722,hunter,survival,156,74,82
Gurrmex,stormscale,1718,hunter,survival,44,24,20
Gedept,blackrock,1716,hunter,survival,110,59,51
Тэмплест,howling-fjord,1714,hunter,survival,48,32,16
Paxiwtf,eredar,1713,hunter,survival,40,26,14
Wicmex,les-sentinelles,1713,hunter,survival,33,21,12
Критпояйцам,howling-fjord,1712,hunter,survival,41,24,17
Фломидзе,gordunni,1711,hunter,survival,244,134,110
Субоота,gordunni,1710,hunter,survival,229,117,112
Zapzy,ravencrest,1709,hunter,survival,237,125,112
Xiumiune,antonidas,1708,hunter,survival,131,74,57
Poggersdaddy,kazzak,1707,hunter,survival,48,28,20
Копия,azuregos,1705,hunter,survival,118,56,62
Natchell,ysondre,1704,hunter,survival,66,34,32
Ntwoõ,ravencrest,1701,hunter,survival,113,63,50
Motri,tarren-mill,1701,hunter,survival,109,58,51
Zoo,archimonde,1700,hunter,survival,63,32,31
Veðir,argent-dawn,1700,hunter,survival,110,53,57
Ufecläimbe,eredar,1699,hunter,survival,40,25,15
Sorozo,aegwynn,1699,hunter,survival,120,62,58
Focüs,les-sentinelles,1699,hunter,survival,38,19,19
Mahikotwo,arathor,1697,hunter,survival,42,24,18
Grulog,kazzak,1697,hunter,survival,133,63,70
Yazqua,deathwing,1696,hunter,survival,70,42,28
Ластшот,blackscar,1696,hunter,survival,44,24,20
Разплюханка,howling-fjord,1696,hunter,survival,132,68,64
Skydraz,ysondre,1695,hunter,survival,96,54,42
Скадхи,blackscar,1695,hunter,survival,240,119,121
Cira,archimonde,1691,hunter,survival,66,36,30
Laayopeh,argent-dawn,1690,hunter,survival,240,122,118
Xallis,outland,1689,hunter,survival,80,46,34
Chopitoo,blackmoore,1686,hunter,survival,144,74,70
Frapt,dalaran,1684,hunter,survival,34,20,14
Véncsótány,ragnaros,1684,hunter,survival,93,49,44
Детмазай,soulflayer,1684,hunter,survival,36,18,18
Бамбра,thermaplugg,1684,hunter,survival,66,29,37
Kurkelx,ravencrest,1683,hunter,survival,84,49,35
Zacxx,ravencrest,1682,hunter,survival,95,63,32
Skyh,outland,1682,hunter,survival,127,63,64
Wonkeedx,ravencrest,1681,hunter,survival,48,23,25
Nurki,the-maelstrom,1680,hunter,survival,53,26,27
Trapbot,drakthul,1680,hunter,survival,48,23,25
Shiceloch,blackmoore,1679,hunter,survival,53,26,27
Kajtarn,outland,1678,hunter,survival,84,41,43
Alibigjungle,ravencrest,1678,hunter,survival,48,23,25
Doraxa,sanguino,1678,hunter,survival,116,54,62
Slizzle,sporeggar,1675,hunter,survival,78,42,36
Frog,crushridge,1671,hunter,survival,150,77,73
Arrcher,thrall,1670,hunter,survival,36,26,10
Максиммужик,soulflayer,1670,hunter,survival,30,18,12
Lxoh,turalyon,1668,hunter,survival,506,255,251
Reelgigachad,archimonde,1668,hunter,survival,42,19,23
Surgethyme,ravencrest,1666,hunter,survival,39,23,16
Liikes,arygos,1664,hunter,survival,48,25,23
Pechvogel,blackmoore,1663,hunter,survival,78,45,33
Waza,grim-batol,1663,hunter,survival,197,103,94
Waziralwazar,auchindoun,1661,hunter,survival,100,52,48
Иснсейшн,soulflayer,1660,hunter,survival,59,32,27
Subha,quelthalas,1660,hunter,survival,122,66,56
Wuad,silvermoon,1659,hunter,survival,66,37,29
Стингергодх,gordunni,1659,hunter,survival,115,59,56
Нью,soulflayer,1659,hunter,survival,66,27,39
Horxxa,kul-tiras,1658,hunter,survival,120,74,46
Capullospawn,dun-morogh,1656,hunter,survival,65,40,25
Lukez,ravencrest,1656,hunter,survival,48,28,20
Fusko,ysondre,1655,hunter,survival,122,61,61
Tiffanydoll,hyjal,1654,hunter,survival,96,53,43
Meghanmarkle,tarren-mill,1653,hunter,survival,39,22,17
Løngßeâm,ysondre,1653,hunter,survival,90,47,43
Zäroury,ravencrest,1653,hunter,survival,64,32,32
Aspects,blackrock,1652,hunter,survival,42,23,19
Zérpent,kazzak,1652,hunter,survival,102,55,47
Dribla,blackhand,1652,hunter,survival,57,30,27
Rizlay,the-maelstrom,1652,hunter,survival,192,98,94
Xelsera,antonidas,1651,hunter,survival,48,27,21
Фираналь,blackscar,1650,hunter,survival,120,60,60
Xxø,ravencrest,1650,hunter,survival,42,21,21
Ashimaru,sylvanas,1649,hunter,survival,60,34,26
Regale,archimonde,1649,hunter,survival,216,103,113
Жэш,howling-fjord,1648,hunter,survival,72,37,35
Satantrapbot,outland,1647,hunter,survival,108,51,57
Amilienne,nozdormu,1646,hunter,survival,45,22,23
Nazona,blackmoore,1645,hunter,survival,36,24,12
Hiddenstalke,argent-dawn,1645,hunter,survival,29,18,11
Бомбетта,grom,1645,hunter,survival,150,73,77
Erhu,drakthul,1644,hunter,survival,30,18,12
Ryomen,garona,1644,hunter,survival,200,102,98
Crapulegangz,archimonde,1644,hunter,survival,56,20,36
Kértor,die-aldor,1642,hunter,survival,45,26,19
Blvckjvckz,ravencrest,1642,hunter,survival,107,55,52
Fiskerr,darksorrow,1641,hunter,survival,42,19,23
Анариэльсин,soulflayer,1640,hunter,survival,243,129,114
Defix,argent-dawn,1640,hunter,survival,163,84,79
Vruh,antonidas,1638,hunter,survival,48,33,15
Zulldek,sanguino,1638,hunter,survival,78,42,36
Avizi,anachronos,1637,hunter,survival,90,44,46
Geevhunt,hyjal,1637,hunter,survival,48,22,26
Lottemor,tarren-mill,1636,hunter,survival,95,61,34
Bren,shattrath,1636,hunter,survival,145,75,70
Atalnta,ravencrest,1636,hunter,survival,123,62,61
Closeenought,ravencrest,1633,hunter,survival,102,51,51
Виралатта,gordunni,1632,hunter,survival,60,35,25
Geralt,argent-dawn,1632,hunter,survival,54,26,28
Iloveluna,silvermoon,1631,hunter,survival,24,17,7
Maiverx,ravencrest,1631,hunter,survival,24,17,7
ßlackjack,thrall,1630,hunter,survival,54,35,19
Olk,stormscale,1629,hunter,survival,30,17,13
Spiffs,twisting-nether,1628,hunter,survival,84,45,39
Sàvannah,ravencrest,1627,hunter,survival,177,92,85
Jeanpisse,hyjal,1624,hunter,survival,137,72,65
Iceyx,stormscale,1624,hunter,survival,49,22,27
Zøk,stormscale,1623,hunter,survival,208,110,98
Миаур,gordunni,1622,hunter,survival,112,54,58
Janoh,dalaran,1621,hunter,survival,303,155,148
Taurïel,stormscale,1620,hunter,survival,199,111,88
Urtanis,stormscale,1619,hunter,survival,113,60,53
Алекскиллшот,blackscar,1618,hunter,survival,42,23,19
Жуткойкрот,lich-king,1618,hunter,survival,114,50,64
Musekiker,tarren-mill,1617,hunter,survival,38,23,15
Neyv,blackmoore,1617,hunter,survival,75,39,36
Mahikosan,outland,1617,hunter,survival,42,20,22
Leviáckerman,ravencrest,1617,hunter,survival,36,17,19
Iòvól,azuremyst,1616,hunter,survival,162,87,75
Huntaro,blackmoore,1616,hunter,survival,158,81,77
Bigbababotan,blackrock,1615,hunter,survival,117,71,46
Fyrya,ravencrest,1615,hunter,survival,36,21,15
Gradevine,twisting-nether,1614,hunter,survival,146,83,63
Synthyxqt,silvermoon,1614,hunter,survival,212,109,103
Bittercoast,stormscale,1613,hunter,survival,53,24,29
Серебрин,howling-fjord,1611,hunter,survival,40,26,14
Lunikehunt,eldrethalas,1611,hunter,survival,84,40,44
Cenesthesia,draenor,1609,hunter,survival,118,65,53
Sharún,sylvanas,1608,hunter,survival,70,42,28
Галятрицепс,eversong,1608,hunter,survival,79,43,36
Swïtchz,hyjal,1607,hunter,survival,42,27,15
Westcøãst,archimonde,1607,hunter,survival,60,37,23
Ruxhunter,sanguino,1607,hunter,survival,90,50,40
Gorgorm,ravencrest,1606,hunter,survival,30,17,13
Kydérr,aegwynn,1606,hunter,survival,48,23,25
Christophèr,grim-batol,1606,hunter,survival,66,31,35
Mclooving,runetotem,1604,hunter,survival,49,29,20
Jexxa,draenor,1603,hunter,survival,54,34,20
Turdy,executus,1603,hunter,survival,94,51,43
Nillaxy,blackmoore,1602,hunter,survival,42,25,17
Florya,blackhand,1602,hunter,survival,63,32,31
Axehead,outland,1602,hunter,survival,72,32,40
Оверман,azuregos,1602,hunter,survival,50,22,28
Slougshot,archimonde,1601,hunter,survival,29,18,11
Robzyhunter,kazzak,1601,hunter,survival,124,66,58
Ozga,magtheridon,1601,hunter,survival,82,41,41
Сабакаа,borean-tundra,1600,hunter,survival,90,50,40
Pluttbug,xavius,1599,hunter,survival,24,20,4
Juniorm,kazzak,1599,hunter,survival,54,29,25
Albumx,hyjal,1599,hunter,survival,277,141,136
Losiané,thrall,1599,hunter,survival,98,49,49
Darllene,kazzak,1599,hunter,survival,101,46,55
Dariusmm,silvermoon,1598,hunter,survival,58,32,26
Mahmoudá,archimonde,1596,hunter,survival,36,21,15
Trappewpew,blackmoore,1596,hunter,survival,45,25,20
Curbý,blackhand,1596,hunter,survival,66,30,36
Snippy,sanguino,1595,hunter,survival,252,119,133
Fyxo,talnivarr,1594,hunter,survival,56,30,26
Zisqa,alleria,1593,hunter,survival,72,37,35
Repap,defias-brotherhood,1593,hunter,survival,48,24,24
Snarer,argent-dawn,1590,hunter,survival,120,61,59
Notikâ,aegwynn,1589,hunter,survival,307,160,147
Yemmeth,argent-dawn,1589,hunter,survival,264,132,132
Zeer,sylvanas,1589,hunter,survival,207,98,109
Оути,azuregos,1588,hunter,survival,138,76,62
Свадебная,gordunni,1588,hunter,survival,208,109,99
Zeanoff,ravencrest,1588,hunter,survival,48,24,24
Jinxpeasant,twisting-nether,1585,hunter,survival,48,29,19
Sznxøxo,ravencrest,1585,hunter,survival,42,24,18
Éddiémórphín,kazzak,1585,hunter,survival,42,22,20
Clicktrap,runetotem,1585,hunter,survival,50,24,26
Næ,kazzak,1584,hunter,survival,130,71,59
Savageone,frostwhisper,1584,hunter,survival,60,28,32
Nozugzug,blackmoore,1583,hunter,survival,175,96,79
Æblesaft,stormscale,1583,hunter,survival,54,28,26
Huntdekalité,khaz-modan,1582,hunter,survival,36,19,17
Lowfet,neptulon,1581,hunter,survival,156,79,77
Stellhammer,kazzak,1580,hunter,survival,40,21,19
Chaxxqt,aegwynn,1580,hunter,survival,39,20,19
Zion,kul-tiras,1580,hunter,survival,53,27,26
Renathir,argent-dawn,1579,hunter,survival,103,53,50
Оскорбление,howling-fjord,1579,hunter,survival,138,65,73
Oczkuhne,burning-legion,1577,hunter,survival,60,29,31
Danissia,argent-dawn,1576,hunter,survival,116,58,58
Подлыйстарик,gordunni,1575,hunter,survival,133,84,49
Смолильщик,gordunni,1575,hunter,survival,119,61,58
Ashjen,aszune,1575,hunter,survival,79,39,40
Tillhunt,kargath,1573,hunter,survival,87,50,37
Kuzes,ravencrest,1573,hunter,survival,61,27,34
Jäegr,hyjal,1572,hunter,survival,72,40,32
Гудхантер,blackscar,1571,hunter,survival,120,64,56
Плутяра,blackscar,1570,hunter,survival,162,75,87
Sparcùs,stormreaver,1569,hunter,survival,54,37,17
Slickbackdan,the-maelstrom,1568,hunter,survival,78,46,32
Hawambae,draenor,1567,hunter,survival,34,19,15
Каморан,grom,1566,hunter,survival,82,45,37
Orcflayer,outland,1565,hunter,survival,60,31,29
Headhunterrz,burning-legion,1563,hunter,survival,102,56,46
Dhadhar,kazzak,1562,hunter,survival,71,38,33
Vâzâyô,ravencrest,1562,hunter,survival,42,20,22
Aspergun,ragnaros,1562,hunter,survival,64,30,34
Глаззалмаз,howling-fjord,1561,hunter,survival,40,25,15
Skzu,archimonde,1560,hunter,survival,53,32,21
Coopatron,silvermoon,1560,hunter,survival,36,21,15
Jakis,silvermoon,1558,hunter,survival,61,29,32
Ävírøñskÿ,ravencrest,1557,hunter,survival,30,18,12
Турбоквардо,howling-fjord,1557,hunter,survival,47,22,25
Khodii,aegwynn,1556,hunter,survival,30,18,12
Coromant,blackrock,1556,hunter,survival,72,34,38
Хитвейн,gordunni,1553,hunter,survival,96,48,48
Shrapnela,ravencrest,1553,hunter,survival,77,27,50
Otekkâ,hyjal,1552,hunter,survival,100,50,50
Skumrask,outland,1552,hunter,survival,54,27,27
Burninghunt,ravencrest,1551,hunter,survival,30,17,13
Kayvaal,kaelthas,1551,hunter,survival,48,27,21
Survsen,kazzak,1551,hunter,survival,108,58,50
Teztded,ravencrest,1551,hunter,survival,54,29,25
Rasmi,kazzak,1549,hunter,survival,217,106,111
Løwg,drekthar,1549,hunter,survival,84,41,43
Pizzafanatic,blackrock,1547,hunter,survival,59,28,31
Пистоглазка,howling-fjord,1544,hunter,survival,29,18,11
Oggi,draenor,1544,hunter,survival,114,61,53
Noop,sylvanas,1542,hunter,survival,153,75,78
Bågeniburen,draenor,1541,hunter,survival,36,21,15
Flappypig,stormscale,1541,hunter,survival,44,21,23
Abeji,malygos,1541,hunter,survival,41,19,22
Nemámponetí,drakthul,1540,hunter,survival,84,44,40
Halfogre,draenor,1540,hunter,survival,42,22,20
Wikariusz,kazzak,1540,hunter,survival,72,30,42
Onyros,hyjal,1539,hunter,survival,42,20,22
Capd,kazzak,1538,hunter,survival,71,39,32
Jónes,dunemaul,1538,hunter,survival,74,40,34
Ищименявтени,gordunni,1538,hunter,survival,84,43,41
Ledrox,ravencrest,1538,hunter,survival,78,39,39
Qapheze,silvermoon,1536,hunter,survival,48,28,20
Riema,ragnaros,1536,hunter,survival,100,48,52
Suzumebachi,twisting-nether,1535,hunter,survival,115,63,52
Survivalhunt,draenor,1534,hunter,survival,48,28,20
Knoxblå,stormscale,1533,hunter,survival,24,16,8
Китас,soulflayer,1531,hunter,survival,207,118,89
Piercing,stormrage,1531,hunter,survival,42,17,25
Куджикс,gordunni,1531,hunter,survival,44,17,27
Nastynutshot,stormscale,1530,hunter,survival,24,16,8
Badäpple,ravencrest,1530,hunter,survival,56,28,28
Bigmøist,ravencrest,1528,hunter,survival,174,94,80
Saejku,archimonde,1528,hunter,survival,119,59,60
Vâleriaa,blackrock,1527,hunter,survival,106,53,53
Larrylegend,der-rat-von-dalaran,1526,hunter,survival,24,16,8
Sheronin,sylvanas,1526,hunter,survival,66,42,24
Warroan,kilrogg,1525,hunter,survival,24,16,8
Ранкон,lich-king,1525,hunter,survival,30,16,14
Regele,silvermoon,1525,hunter,survival,200,105,95
Raztreadör,dun-modr,1525,hunter,survival,342,175,167
Feignindeath,twisting-nether,1524,hunter,survival,116,66,50
Jøki,blackmoore,1524,hunter,survival,36,16,20
Axered,outland,1523,hunter,survival,30,17,13
Akasa,twilights-hammer,1523,hunter,survival,53,27,26
Neddly,draenor,1523,hunter,survival,36,16,20
Fmatzen,the-maelstrom,1522,hunter,survival,96,45,51
Гаррельд,blackscar,1521,hunter,survival,78,42,36
Vexxed,thrall,1518,hunter,survival,36,21,15
Badboyxoxo,stormscale,1517,hunter,survival,139,81,58
Outofcontrol,karazhan,1515,hunter,survival,30,17,13
Óneshóter,madmortem,1515,hunter,survival,92,51,41
Zaphody,doomhammer,1511,hunter,survival,149,81,68
Twitche,ravencrest,1511,hunter,survival,131,64,67
Zrijad,draenor,1510,hunter,survival,50,35,15
Mert,ravencrest,1510,hunter,survival,168,90,78
Mcgloebels,archimonde,1509,hunter,survival,57,33,24
Хальвеген,gordunni,1509,hunter,survival,96,47,49
Джулибуба,howling-fjord,1509,hunter,survival,61,26,35
Psychotik,stormreaver,1506,hunter,survival,332,169,163
Kleiar,dun-modr,1505,hunter,survival,33,17,16
Petman,area-52,1503,hunter,survival,42,24,18
Молеандрис,gordunni,1503,hunter,survival,81,41,40
Шеддикс,gordunni,1501,hunter,survival,47,25,22
Trapfish,dalaran,1498,hunter,survival,278,147,131
Melissax,silvermoon,1498,hunter,survival,69,30,39
Andjelaa,kazzak,1496,hunter,survival,60,30,30
Abeba,grim-batol,1496,hunter,survival,59,29,30
Solotrap,kazzak,1495,hunter,survival,39,17,22
Clicker,runetotem,1494,hunter,survival,90,43,47
Chiwa,cthun,1494,hunter,survival,84,37,47
Bøøya,aegwynn,1492,hunter,survival,34,24,10
Illnysa,silvermoon,1492,hunter,survival,47,24,23
Ðarrk,tarren-mill,1492,hunter,survival,72,36,36
Хантзер,howling-fjord,1491,hunter,survival,158,75,83
Ázurâ,blackhand,1490,hunter,survival,187,89,98
Robinbuds,stormscale,1489,hunter,survival,59,31,28
Kabedon,drakthul,1489,hunter,survival,98,50,48
Lilsnuss,outland,1488,hunter,survival,48,27,21
Hakkoti,argent-dawn,1486,hunter,survival,72,36,36
Killitoss,blackmoore,1485,hunter,survival,58,29,29
Чууч,blackscar,1485,hunter,survival,236,108,128
Плутис,howling-fjord,1484,hunter,survival,90,38,52
Rolky,silvermoon,1483,hunter,survival,76,43,33
Unferth,the-venture-co,1483,hunter,survival,85,41,44
Kaynor,dalaran,1482,hunter,survival,36,20,16
Ravendy,stormscale,1479,hunter,survival,36,16,20
Sayn,la-croisade-écarlate,1478,hunter,survival,80,42,38
Rettoo,aszune,1478,hunter,survival,54,28,26
Чужойй,howling-fjord,1478,hunter,survival,54,28,26
Akibane,blackmoore,1475,hunter,survival,38,21,17
Яшатаю,soulflayer,1474,hunter,survival,57,35,22
Himatoumi,elune,1473,hunter,survival,42,21,21
Babûsch,blackmoore,1473,hunter,survival,102,44,58
Крэин,howling-fjord,1472,hunter,survival,94,49,45
Kobayashi,arathor,1471,hunter,survival,210,106,104
Hreo,twisting-nether,1467,hunter,survival,90,45,45
Jailevaccin,khaz-modan,1465,hunter,survival,175,84,91
Танчибосс,soulflayer,1464,hunter,survival,139,67,72
Blackwarz,la-croisade-écarlate,1462,hunter,survival,44,29,15
Ashablack,argent-dawn,1462,hunter,survival,268,143,125
Zuggander,ravencrest,1462,hunter,survival,42,21,21
Jeddaj,stormscale,1462,hunter,survival,125,61,64
Луврен,deepholm,1461,hunter,survival,38,19,19
Shall,outland,1460,hunter,survival,30,18,12
Кир,blackscar,1460,hunter,survival,88,52,36
Йинги,gordunni,1460,hunter,survival,95,52,43
Graavi,silvermoon,1459,hunter,survival,62,32,30
Vorsord,zuljin,1458,hunter,survival,102,54,48
Ðrãke,blackmoore,1458,hunter,survival,84,42,42
Русланяшный,soulflayer,1458,hunter,survival,102,50,52
Hoffen,dentarg,1456,hunter,survival,48,31,17
Jackdaniéls,twisting-nether,1452,hunter,survival,70,30,40
Шадак,soulflayer,1451,hunter,survival,196,101,95
Headshotxd,ragnaros,1451,hunter,survival,49,21,28
Макфлайь,howling-fjord,1448,hunter,survival,42,18,24
Nalys,argent-dawn,1447,hunter,survival,70,39,31
Westend,draenor,1444,hunter,survival,42,21,21
Kazzaak,kazzak,1440,hunter,survival,126,63,63
Звериныйпапа,gordunni,1440,hunter,survival,58,27,31
Kasperle,frostwolf,1439,hunter,survival,30,20,10
Куджикс,soulflayer,1439,hunter,survival,24,15,9
Gormlokar,kazzak,1438,hunter,survival,30,16,14
Crème,blackrock,1438,hunter,survival,326,161,165
Ðoñko,hyjal,1438,hunter,survival,223,110,113
Islide,ravencrest,1438,hunter,survival,36,15,21
Konghans,ravencrest,1437,hunter,survival,91,51,40
Комомура,soulflayer,1437,hunter,survival,155,78,77
Cásper,tarren-mill,1436,hunter,survival,84,48,36
Штынь,gordunni,1436,hunter,survival,84,39,45
Jäinenool,outland,1435,hunter,survival,30,15,15
Plebtor,drakthul,1434,hunter,survival,44,19,25
Дэнитрехо,soulflayer,1433,hunter,survival,42,19,23
Deathwallker,silvermoon,1432,hunter,survival,135,77,58
Huntsmart,kazzak,1432,hunter,survival,30,15,15
Boggy,outland,1431,hunter,survival,81,42,39
Eufumo,sanguino,1431,hunter,survival,53,26,27
Tyrone,saurfang,1431,hunter,survival,48,19,29
Pyrep,draenor,1430,hunter,survival,42,23,19
Dashaft,kazzak,1429,hunter,survival,93,52,41
Афганыч,soulflayer,1428,hunter,survival,54,24,30
Вилдфлекс,gordunni,1426,hunter,survival,36,25,11
Artemisïa,archimonde,1426,hunter,survival,72,32,40
Тэуреэль,gordunni,1426,hunter,survival,66,26,40
Ambermyst,outland,1425,hunter,survival,30,16,14
Wræqraxx,ravencrest,1424,hunter,survival,168,98,70
Rheyl,dun-morogh,1423,hunter,survival,18,15,3
Malgorn,burning-legion,1423,hunter,survival,75,47,28
Хипдо,soulflayer,1422,hunter,survival,30,15,15
Pentaboule,archimonde,1421,hunter,survival,150,78,72
Enistee,silvermoon,1421,hunter,survival,62,30,32
Shibai,outland,1420,hunter,survival,71,34,37
Ashendan,silvermoon,1420,hunter,survival,48,17,31
Мандалорецц,soulflayer,1418,hunter,survival,148,74,74
Bigter,arathor,1417,hunter,survival,50,27,23
Перидот,howling-fjord,1417,hunter,survival,30,15,15
Torelk,dalaran,1416,hunter,survival,36,17,19
Nunziatellà,nemesis,1415,hunter,survival,30,15,15
Sívér,antonidas,1414,hunter,survival,90,41,49
Hännibal,nazjatar,1413,hunter,survival,65,30,35
Dorota,auchindoun,1412,hunter,survival,61,31,30
Bicepspump,dun-morogh,1412,hunter,survival,36,15,21
Сильвиина,eversong,1411,hunter,survival,48,24,24
Röwene,argent-dawn,1410,hunter,survival,62,35,27
Suxino,doomhammer,1410,hunter,survival,118,57,61
Arykes,drakthul,1410,hunter,survival,65,30,35
Kürze,silvermoon,1409,hunter,survival,58,27,31
Bowmasterjay,kazzak,1408,hunter,survival,54,30,24
Zárnah,defias-brotherhood,1408,hunter,survival,42,15,27
Sarbacanes,hyjal,1405,hunter,survival,60,30,30
Grusijohn,executus,1405,hunter,survival,30,15,15
Кфоззи,soulflayer,1403,hunter,survival,48,23,25
Äzul,ysondre,1402,hunter,survival,91,44,47
Zinà,naxxramas,1401,hunter,survival,71,36,35
Heliandra,dun-modr,1400,hunter,survival,42,23,19
Pewpewronin,the-maelstrom,1400,hunter,survival,57,31,26
Ниалла,thermaplugg,1399,hunter,survival,60,28,32
Bôbby,kelthuzad,1395,hunter,survival,36,17,19
Живучийорех,gordunni,1394,hunter,survival,24,15,9
Айхана,gordunni,1393,hunter,survival,59,35,24
Zehned,ysondre,1392,hunter,survival,110,54,56
Кулерквест,soulflayer,1390,hunter,survival,144,67,77
Littlhuntard,tarren-mill,1388,hunter,survival,30,17,13
Millebobert,kazzak,1388,hunter,survival,42,20,22
Moralisa,eredar,1388,hunter,survival,66,31,35
Chupsor,ravencrest,1388,hunter,survival,98,46,52
Twérk,blackmoore,1387,hunter,survival,71,36,35
Tortoise,blackrock,1386,hunter,survival,21,15,6
Makeawish,antonidas,1385,hunter,survival,82,44,38
Amadia,defias-brotherhood,1385,hunter,survival,42,18,24
Schwabbels,silvermoon,1384,hunter,survival,30,15,15
Assaultrifle,frostmane,1384,hunter,survival,42,19,23
Sekkeh,ragnaros,1383,hunter,survival,95,47,48
Wastage,draenor,1383,hunter,survival,54,26,28
Santiägø,archimonde,1380,hunter,survival,66,37,29
Ajko,blackmoore,1378,hunter,survival,60,33,27
Spidak,stormscale,1378,hunter,survival,30,15,15
Ballistix,elune,1376,hunter,survival,64,29,35
Toesniper,argent-dawn,1375,hunter,survival,75,42,33
Darksylvanas,arathor,1372,hunter,survival,47,25,22
Buszos,burning-legion,1369,hunter,survival,48,28,20
Hotgrillexde,sylvanas,1369,hunter,survival,29,15,14
Odmehb,silvermoon,1368,hunter,survival,78,52,26
Dzago,burning-legion,1368,hunter,survival,38,15,23
Kalani,la-croisade-écarlate,1366,hunter,survival,202,96,106
Harrak,ysondre,1365,hunter,survival,72,47,25
Hunttes,nagrand,1365,hunter,survival,29,15,14
Cinnè,frostwolf,1364,hunter,survival,28,15,13
Борькабритва,soulflayer,1363,hunter,survival,66,28,38
Getsniffarn,sylvanas,1362,hunter,survival,108,57,51
Скримзх,gordunni,1360,hunter,survival,103,61,42
Sasquaczek,burning-legion,1360,hunter,survival,86,47,39
Shootingu,aegwynn,1359,hunter,survival,173,88,85
Huntiika,silvermoon,1359,hunter,survival,101,49,52
Pls,blackmoore,1359,hunter,survival,35,16,19
Dîdierraoult,archimonde,1358,hunter,survival,29,15,14
Herubin,doomhammer,1357,hunter,survival,111,58,53
Vengefull,draenor,1357,hunter,survival,174,88,86
Sarttrap,aerie-peak,1354,hunter,survival,60,30,30
Myoui,silvermoon,1354,hunter,survival,30,15,15
Gakco,twisting-nether,1353,hunter,survival,72,40,32
Dauria,blackhand,1352,hunter,survival,38,16,22
Mizumo,burning-legion,1352,hunter,survival,42,16,26
Wolder,burning-legion,1350,hunter,survival,29,15,14
Abovival,ragnaros,1349,hunter,survival,30,20,10
Reðrighthånð,throkferoth,1349,hunter,survival,61,32,29
Juícecannon,twisting-nether,1349,hunter,survival,66,31,35
Ilørell,archimonde,1348,hunter,survival,77,35,42
Cosmokid,shadowsong,1347,hunter,survival,190,108,82
Yszï,dalaran,1346,hunter,survival,60,32,28
Воррен,howling-fjord,1345,hunter,survival,71,38,33
Ägris,die-todeskrallen,1343,hunter,survival,332,171,161
Вандамос,soulflayer,1343,hunter,survival,148,74,74
Liltitan,tarren-mill,1343,hunter,survival,36,17,19
Shoty,zuluhed,1343,hunter,survival,118,54,64
Santaana,twisting-nether,1343,hunter,survival,50,22,28
Согекхей,gordunni,1343,hunter,survival,120,51,69
Orzâ,blackrock,1342,hunter,survival,36,20,16
Самоанец,gordunni,1342,hunter,survival,31,16,15
Antisober,ravencrest,1341,hunter,survival,18,14,4
Ketaminösa,zuljin,1341,hunter,survival,24,14,10
Icetrapped,eredar,1341,hunter,survival,30,14,16
Xaone,blackrock,1340,hunter,survival,18,14,4
Knoxröd,outland,1340,hunter,survival,18,14,4
Svinaset,shattered-hand,1339,hunter,survival,63,32,31
Tôm,ravencrest,1338,hunter,survival,48,30,18
Рэдхаант,soulflayer,1338,hunter,survival,107,47,60
Snôptas,blackmoore,1337,hunter,survival,32,15,17
Purée,ragnaros,1337,hunter,survival,30,14,16
Roacher,hyjal,1337,hunter,survival,70,32,38
Kishunt,ravencrest,1336,hunter,survival,27,15,12
Jalcer,draenor,1334,hunter,survival,62,28,34
Забзаб,soulflayer,1333,hunter,survival,24,14,10
Spitchy,kazzak,1333,hunter,survival,62,33,29
Grimazg,chogall,1332,hunter,survival,42,25,17
Мюнхаусен,gordunni,1331,hunter,survival,31,19,12
Oneshootqt,aegwynn,1331,hunter,survival,91,48,43
Misscreggor,ravencrest,1328,hunter,survival,66,28,38
Пятницкий,soulflayer,1326,hunter,survival,41,22,19
Beksha,blackrock,1325,hunter,survival,24,14,10
Itchy,das-syndikat,1325,hunter,survival,128,61,67
Noréaga,suramar,1325,hunter,survival,42,19,23
Badhunt,stormscale,1325,hunter,survival,36,16,20
Murotar,dalaran,1323,hunter,survival,30,18,12
Стивстифлер,razuvious,1323,hunter,survival,84,44,40
Jamalinho,silvermoon,1322,hunter,survival,60,38,22
Бандерака,goldrinn,1322,hunter,survival,48,27,21
Tortillia,madmortem,1322,hunter,survival,150,72,78
Junglez,nagrand,1320,hunter,survival,64,36,28
Speartusk,blackhand,1319,hunter,survival,42,22,20
Danaetia,aerie-peak,1317,hunter,survival,30,14,16
Onefatalshot,the-maelstrom,1317,hunter,survival,54,23,31
Алестея,gordunni,1316,hunter,survival,30,14,16
Slagatronic,ragnaros,1314,hunter,survival,114,60,54
Kamayail,skullcrusher,1312,hunter,survival,80,40,40
Jimpage,eredar,1310,hunter,survival,35,15,20
Volotyr,ravencrest,1309,hunter,survival,42,23,19
Pãstèque,ravencrest,1309,hunter,survival,28,15,13
Занзуолли,howling-fjord,1309,hunter,survival,66,32,34
Ubietza,aegwynn,1304,hunter,survival,48,23,25
Karabeg,twisting-nether,1301,hunter,survival,53,22,31
Thëoden,cthun,1298,hunter,survival,30,16,14
Iyelee,malfurion,1297,hunter,survival,33,16,17
Steezowl,kazzak,1297,hunter,survival,47,20,27
Prodanhunts,frostmane,1296,hunter,survival,30,14,16
Torrë,sanguino,1295,hunter,survival,109,51,58
Карвинн,soulflayer,1290,hunter,survival,57,25,32
Lrr,grim-batol,1289,hunter,survival,87,42,45
Zwerghauer,arthas,1286,hunter,survival,42,20,22
Cliff,kiljaeden,1285,hunter,survival,51,25,26
Wôôdsy,blackrock,1280,hunter,survival,48,22,26
Барабаша,deathguard,1278,hunter,survival,40,15,25
Фурболгов,gordunni,1274,hunter,survival,83,38,45
Apachy,amanthul,1268,hunter,survival,35,17,18
Тике,soulflayer,1267,hunter,survival,116,59,57
Dhmain,frostmane,1267,hunter,survival,93,40,53
Wessin,ysondre,1266,hunter,survival,60,31,29
Мауровани,eversong,1265,hunter,survival,30,16,14
Никизаняты,ashenvale,1264,hunter,survival,42,21,21
Foxyfoxo,guldan,1263,hunter,survival,54,26,28
Doojas,archimonde,1263,hunter,survival,30,14,16
Hopefol,ravencrest,1261,hunter,survival,48,17,31
Yakx,dun-modr,1260,hunter,survival,36,18,18
Huntanova,antonidas,1259,hunter,survival,72,28,44
Jomoguin,stormscale,1255,hunter,survival,54,27,27
Haku,burning-legion,1254,hunter,survival,57,27,30
Henario,ravencrest,1251,hunter,survival,31,15,16
Whyareurunin,silvermoon,1251,hunter,survival,70,28,42
Goblinhood,tarren-mill,1250,hunter,survival,72,35,37
Didzon,ravencrest,1249,hunter,survival,24,14,10
Adram,burning-legion,1249,hunter,survival,51,20,31
Kaboumba,archimonde,1248,hunter,survival,30,19,11
Rollin,khaz-modan,1247,hunter,survival,24,15,9
Oey,ravencrest,1247,hunter,survival,30,13,17
Giggiwho,malganis,1247,hunter,survival,30,13,17
Jumong,ragnaros,1246,hunter,survival,24,13,11
Skyyw,tarren-mill,1246,hunter,survival,109,54,55
Spliinter,twisting-nether,1245,hunter,survival,58,37,21
Caelas,outland,1245,hunter,survival,36,17,19
Vargar,arygos,1245,hunter,survival,30,13,17
Guanchin,silvermoon,1245,hunter,survival,42,16,26
Nkl,archimonde,1243,hunter,survival,30,13,17
Tomasínos,drakthul,1241,hunter,survival,30,13,17
Querro,azshara,1241,hunter,survival,54,17,37
Hasselunden,ravencrest,1237,hunter,survival,24,13,11
Caìuz,pozzo-delleternità,1236,hunter,survival,30,13,17
Sláyer,the-shatar,1233,hunter,survival,82,45,37
Petcan,twisting-nether,1230,hunter,survival,30,13,17
Umani,lightnings-blade,1230,hunter,survival,30,13,17
Zaboozá,ragnaros,1230,hunter,survival,75,31,44
Lebalaffré,arathi,1228,hunter,survival,24,13,11
Мертвыйпсарь,soulflayer,1228,hunter,survival,52,25,27
Døømslayer,nemesis,1226,hunter,survival,47,28,19
Kapitannapas,deathwing,1225,hunter,survival,30,13,17
Girlfwiend,argent-dawn,1225,hunter,survival,36,14,22
Bairex,magtheridon,1222,hunter,survival,120,66,54
Sainttcc,thrall,1221,hunter,survival,78,38,40
Питбуль,deepholm,1219,hunter,survival,30,17,13
Bloodxx,ragnaros,1218,hunter,survival,104,49,55
Bhalmar,the-maelstrom,1218,hunter,survival,30,13,17
Doru,silvermoon,1215,hunter,survival,166,84,82
Kaletorw,ragnaros,1209,hunter,survival,36,17,19
Тельдритис,gordunni,1207,hunter,survival,35,14,21
Aequitaz,blackhand,1207,hunter,survival,44,16,28
Nvukaze,argent-dawn,1205,hunter,survival,39,23,16
Caedus,argent-dawn,1205,hunter,survival,48,18,30
Bâng,zuljin,1204,hunter,survival,30,15,15
Eledanu,blackmoore,1200,hunter,survival,24,16,8
Voltár,antonidas,1198,hunter,survival,76,35,41
Jarekk,auchindoun,1192,hunter,survival,23,14,9
Wållåce,rexxar,1192,hunter,survival,28,14,14
Míoo,antonidas,1188,hunter,survival,100,49,51
Санясурв,gordunni,1186,hunter,survival,36,18,18
Blhunt,magtheridon,1181,hunter,survival,22,13,9
Trackmedown,kazzak,1180,hunter,survival,22,13,9
Dragonflayer,sylvanas,1180,hunter,survival,66,37,29
Binhoker,argent-dawn,1173,hunter,survival,18,13,5
Pàtküt,blackmoore,1173,hunter,survival,34,15,19
Тофуитер,howling-fjord,1168,hunter,survival,36,13,23
Zisga,blackrock,1167,hunter,survival,30,14,16
Raley,archimonde,1165,hunter,survival,29,13,16
Platza,ragnaros,1162,hunter,survival,36,17,19
Chalid,aegwynn,1161,hunter,survival,48,25,23
Pôîson,kazzak,1158,hunter,survival,155,73,82
Chamillon,archimonde,1154,hunter,survival,60,26,34
Alpharaven,ravencrest,1151,hunter,survival,18,12,6
Sniperqueenx,bloodscalp,1151,hunter,survival,18,12,6
Vilopez,arthas,1151,hunter,survival,18,12,6
Lightxyz,ravencrest,1151,hunter,survival,24,12,12
Wórldz,dun-modr,1151,hunter,survival,24,12,12
Ähäkutti,kazzak,1151,hunter,survival,30,12,18
Hexojs,outland,1150,hunter,survival,18,12,6
Niro,argent-dawn,1150,hunter,survival,24,12,12
Xoarqt,aegwynn,1150,hunter,survival,24,12,12
Sadmasl,blackmoore,1149,hunter,survival,18,12,6
Nondinhos,burning-legion,1149,hunter,survival,22,13,9
Еваджонсон,gordunni,1149,hunter,survival,24,12,12
Shergeon,sanguino,1149,hunter,survival,42,19,23
Ryubeast,hyjal,1148,hunter,survival,18,12,6
Bacongodx,archimonde,1147,hunter,survival,18,12,6
Kirax,ravencrest,1147,hunter,survival,27,13,14
Terrorduni,tarren-mill,1147,hunter,survival,30,12,18
Nevêrse,archimonde,1147,hunter,survival,30,12,18
Jäegarn,ravencrest,1146,hunter,survival,18,12,6
Eyvin,defias-brotherhood,1144,hunter,survival,24,12,12
Zerøskilgodx,antonidas,1143,hunter,survival,18,12,6
Мэйвиан,gordunni,1143,hunter,survival,24,12,12
Orcpie,defias-brotherhood,1143,hunter,survival,36,16,20
Anklar,blackrock,1142,hunter,survival,30,12,18
Såvëâmäzøñíà,stormscale,1142,hunter,survival,30,12,18
Jâckíe,aegwynn,1139,hunter,survival,27,13,14
Gilzog,exodar,1138,hunter,survival,30,12,18
Cabaim,eredar,1137,hunter,survival,18,12,6
Хантероо,gordunni,1137,hunter,survival,30,17,13
Grufflin,bronzebeard,1137,hunter,survival,54,22,32
Karruck,tarren-mill,1137,hunter,survival,30,12,18
Absolutnoob,blackrock,1136,hunter,survival,110,56,54
Riscante,dun-morogh,1136,hunter,survival,52,25,27
Huntoon,doomhammer,1135,hunter,survival,24,12,12
Autoturret,eredar,1130,hunter,survival,30,12,18
Cämper,aegwynn,1124,hunter,survival,24,12,12
Leemool,ysondre,1123,hunter,survival,30,18,12
Azuren,twisting-nether,1122,hunter,survival,29,13,16
Nith,ungoro,1119,hunter,survival,114,53,61
Ayshæ,tarren-mill,1119,hunter,survival,114,48,66
Fãdê,ravencrest,1118,hunter,survival,20,13,7
Eonait,ravencrest,1117,hunter,survival,23,12,11
Marvii,drakthul,1117,hunter,survival,66,26,40
Renegansnipe,silvermoon,1115,hunter,survival,48,18,30
Floris,outland,1108,hunter,survival,114,50,64
Зомбим,soulflayer,1103,hunter,survival,53,20,33
Aszasi,azjolnerub,1096,hunter,survival,23,12,11
Eromoar,outland,1091,hunter,survival,45,20,25
Himba,dentarg,1088,hunter,survival,36,18,18
Mefhunter,tarren-mill,1081,hunter,survival,17,12,5
Zudith,sanguino,1081,hunter,survival,47,20,27
Sliki,auchindoun,1079,hunter,survival,49,18,31
Archfiend,stormscale,1077,hunter,survival,27,12,15
Dørrak,hyjal,1076,hunter,survival,112,46,66
Therön,silvermoon,1074,hunter,survival,71,23,48
Tessuti,doomhammer,1065,hunter,survival,38,13,25
Milandra,the-maelstrom,1064,hunter,survival,88,43,45
Daiking,pozzo-delleternità,1064,hunter,survival,160,68,92
Speedymarieh,argent-dawn,1056,hunter,survival,18,11,7
Djsecousse,hyjal,1056,hunter,survival,18,11,7
Guccyfied,blackrock,1056,hunter,survival,18,11,7
Alvúk,kazzak,1056,hunter,survival,21,12,9
Supcuz,stormscale,1056,hunter,survival,24,11,13
Syniix,ravencrest,1055,hunter,survival,18,11,7
Djtrápálót,dragonmaw,1055,hunter,survival,18,11,7
Djurmästaren,ravencrest,1055,hunter,survival,18,11,7
Ремонтлицаа,gordunni,1055,hunter,survival,24,11,13
Virts,hyjal,1055,hunter,survival,24,11,13
Morgard,uldum,1055,hunter,survival,24,11,13
Jayquillen,sylvanas,1055,hunter,survival,24,11,13
Miggs,hellfire,1054,hunter,survival,66,29,37
Nobuno,dun-modr,1053,hunter,survival,18,11,7
Tràpz,archimonde,1053,hunter,survival,18,11,7
Неужто,deathguard,1053,hunter,survival,24,11,13
Survivartji,burning-legion,1053,hunter,survival,24,11,13
Cataleýà,outland,1052,hunter,survival,18,11,7
Abgeherjoe,antonidas,1051,hunter,survival,30,11,19
Isøbu,hyjal,1047,hunter,survival,30,11,19
Haileyjones,darkmoon-faire,1046,hunter,survival,18,11,7
Klittcrit,bloodhoof,1046,hunter,survival,24,11,13
Haranti,dun-modr,1042,hunter,survival,18,11,7
Cazados,shendralar,1038,hunter,survival,28,12,16
Phiix,blackhand,1033,hunter,survival,18,11,7
Yinn,kilrogg,1026,hunter,survival,115,51,64
Bawzé,archimonde,1022,hunter,survival,22,11,11
Nèxz,blackrock,1021,hunter,survival,29,11,18
Shanè,blackrock,1021,hunter,survival,36,13,23
Szybky,defias-brotherhood,1017,hunter,survival,18,11,7
Фетсол,soulflayer,1017,hunter,survival,23,11,12
Utt,argent-dawn,1016,hunter,survival,47,16,31
Giobi,draenor,1013,hunter,survival,36,20,16
Desertgipsy,ragnaros,1012,hunter,survival,22,11,11
Magicnanø,nemesis,1008,hunter,survival,27,11,16
Midooaa,nerathor,1007,hunter,survival,17,11,6
Kubelwagen,dun-modr,1004,hunter,survival,23,11,12
Kinaou,sargeras,1003,hunter,survival,54,25,29
Animàl,argent-dawn,988,hunter,survival,22,11,11
Keinzira,hyjal,988,hunter,survival,32,12,20
Huntoruu,outland,983,hunter,survival,113,48,65
Naramir,ysondre,981,hunter,survival,38,11,27
Agarez,blackrock,978,hunter,survival,60,26,34
Änubïs,culte-de-la-rive-noire,973,hunter,survival,28,12,16
Крысюкпифпаф,blackscar,971,hunter,survival,19,11,8
Tayu,throkferoth,960,hunter,survival,12,10,2
Аминотоксид,blackscar,960,hunter,survival,12,10,2
Reviam,ravencrest,960,hunter,survival,12,10,2
Gerzyy,drakthul,960,hunter,survival,18,10,8
Vincex,ravencrest,960,hunter,survival,18,10,8
Neilime,marécage-de-zangar,960,hunter,survival,80,37,43
Cyhi,ravencrest,960,hunter,survival,24,10,14
Nayeem,silvermoon,959,hunter,survival,12,10,2
Canezhnt,aegwynn,959,hunter,survival,18,10,8
Патчхороший,howling-fjord,959,hunter,survival,18,10,8
Fóx,sunstrider,959,hunter,survival,18,10,8
Painaldeepz,stormscale,959,hunter,survival,18,10,8
Masthuhn,blackmoore,959,hunter,survival,24,10,14
Cryts,dun-modr,959,hunter,survival,24,10,14
Ревирин,gordunni,958,hunter,survival,12,10,2
Менстряк,deathguard,958,hunter,survival,18,10,8
Уроборос,gordunni,958,hunter,survival,18,10,8
Silverlaine,quelthalas,957,hunter,survival,12,10,2
Elyar,eredar,957,hunter,survival,18,10,8
Dekax,blackhand,957,hunter,survival,20,10,10
Элфй,gordunni,956,hunter,survival,18,10,8
Starkt,ragnaros,956,hunter,survival,24,10,14
Раелиин,gordunni,955,hunter,survival,24,10,14
Цезарьрома,soulflayer,955,hunter,survival,33,10,23
Hevl,silvermoon,954,hunter,survival,18,10,8
Shenra,argent-dawn,954,hunter,survival,18,10,8
Nokti,die-ewige-wacht,954,hunter,survival,18,10,8
Louårn,hyjal,952,hunter,survival,63,19,44
Memli,uldaman,950,hunter,survival,18,10,8
Marluxiâ,archimonde,947,hunter,survival,30,11,19
Zimmoo,tarren-mill,942,hunter,survival,33,11,22
Zipzâp,blackrock,936,hunter,survival,18,10,8
Shannaë,sanguino,924,hunter,survival,12,10,2
Reenacer,dun-modr,920,hunter,survival,60,28,32
Arashïn,silvermoon,911,hunter,survival,21,10,11
Maikbb,stormreaver,910,hunter,survival,23,10,13
Chillibetv,blackrock,906,hunter,survival,27,11,16
Jezter,darksorrow,905,hunter,survival,27,10,17
Eretreyya,draenor,901,hunter,survival,28,13,15
Killdembro,sunstrider,896,hunter,survival,430,187,243
Bláckheart,doomhammer,888,hunter,survival,22,10,12
Ирртой,grom,885,hunter,survival,24,10,14
Bowkeeper,kazzak,870,hunter,survival,103,50,53
Techpøint,silvermoon,864,hunter,survival,12,9,3
Crøxx,archimonde,864,hunter,survival,12,9,3
Veganmuscles,madmortem,864,hunter,survival,15,10,5
Bùddhíst,ravencrest,864,hunter,survival,18,9,9
Vukal,kazzak,864,hunter,survival,18,9,9
Rynextwo,khaz-modan,864,hunter,survival,18,9,9
Feyoonxx,blackrock,864,hunter,survival,18,9,9
Theeonetime,ravencrest,864,hunter,survival,24,9,15
Nooksem,blackrock,864,hunter,survival,24,9,15
Murkek,drakthul,863,hunter,survival,12,9,3
Mileysaures,stormscale,863,hunter,survival,12,9,3
Tomli,nemesis,863,hunter,survival,12,9,3
Sagitari,chamber-of-aspects,863,hunter,survival,18,9,9
Merkabba,kazzak,863,hunter,survival,18,9,9
Waizen,archimonde,863,hunter,survival,18,9,9
Nirn,ravencrest,863,hunter,survival,18,9,9
Shubou,silvermoon,863,hunter,survival,18,9,9
Тиометра,gordunni,862,hunter,survival,12,9,3
Kailley,conseil-des-ombres,862,hunter,survival,12,9,3
Sjufemman,ravencrest,862,hunter,survival,18,9,9
Fluffiis,twisting-nether,861,hunter,survival,12,9,3
Koblajan,draenor,861,hunter,survival,16,10,6
Worlogosh,stormscale,861,hunter,survival,18,9,9
Kissnodig,outland,861,hunter,survival,18,9,9
Secrety,doomhammer,860,hunter,survival,18,9,9
Välk,sylvanas,860,hunter,survival,18,9,9
Пивпавнах,gordunni,859,hunter,survival,12,9,3
Raenard,ragnaros,858,hunter,survival,21,10,11
Madtony,aegwynn,858,hunter,survival,24,9,15
Karasana,earthen-ring,855,hunter,survival,30,9,21
Blackox,zirkel-des-cenarius,853,hunter,survival,18,9,9
Mufassa,sinstralis,849,hunter,survival,18,9,9
Beaupapa,archimonde,846,hunter,survival,18,9,9
Wolfína,drakthul,842,hunter,survival,30,9,21
Powerhord,burning-legion,839,hunter,survival,41,16,25
Charlet,archimonde,837,hunter,survival,18,9,9
Trabucones,sanguino,830,hunter,survival,24,9,15
Louce,argent-dawn,810,hunter,survival,26,10,16
Lofiv,turalyon,799,hunter,survival,16,9,7
Greel,saurfang,781,hunter,survival,117,50,67
Норапина,eversong,769,hunter,survival,49,21,28
Deuteríum,outland,768,hunter,survival,12,8,4
Slighth,ragnaros,768,hunter,survival,12,8,4
Jaggy,hyjal,768,hunter,survival,12,8,4
Dumbfoundead,argent-dawn,768,hunter,survival,12,8,4
Scopieturner,burning-blade,768,hunter,survival,12,8,4
Adefthunt,kazzak,768,hunter,survival,12,8,4
Joetheripper,dun-modr,768,hunter,survival,12,8,4
Velen,pozzo-delleternità,768,hunter,survival,12,8,4
Techpoint,silvermoon,768,hunter,survival,12,8,4
Notrexx,kazzak,768,hunter,survival,18,8,10
Ormassey,drakthul,768,hunter,survival,18,8,10
Bø,burning-blade,768,hunter,survival,18,8,10
Пьёт,gordunni,768,hunter,survival,18,8,10
Equiph,silvermoon,768,hunter,survival,18,8,10
Трапавграунд,howling-fjord,768,hunter,survival,18,8,10
Янемилашка,howling-fjord,768,hunter,survival,24,8,16
Epicsurvive,kazzak,768,hunter,survival,24,8,16
Viperr,nemesis,768,hunter,survival,30,8,22
Alissón,aegwynn,767,hunter,survival,12,8,4
Суперструнка,gordunni,767,hunter,survival,12,8,4
Luftikuss,arthas,767,hunter,survival,12,8,4
Øpedro,kirin-tor,767,hunter,survival,12,8,4
Lockshot,ragnaros,767,hunter,survival,12,8,4
Scröte,draenor,767,hunter,survival,12,8,4
Тиандриса,soulflayer,767,hunter,survival,12,8,4
Nawaal,kazzak,767,hunter,survival,18,8,10
Scarletgirl,draenor,767,hunter,survival,18,8,10
Double,sylvanas,767,hunter,survival,18,8,10
Tyqqepiq,the-maelstrom,767,hunter,survival,18,8,10
Arnakua,outland,767,hunter,survival,18,8,10
Вкинулматрас,gordunni,767,hunter,survival,18,8,10
Outofarrows,earthen-ring,766,hunter,survival,18,8,10
Kaj,kelthuzad,766,hunter,survival,18,8,10
Вуйчеч,howling-fjord,766,hunter,survival,24,8,16
Lînc,twisting-nether,765,hunter,survival,12,8,4
Twinkies,ysondre,765,hunter,survival,12,8,4
Lucrecius,magtheridon,765,hunter,survival,18,8,10
Pispirelul,ravencrest,765,hunter,survival,21,9,12
Темикс,ashenvale,765,hunter,survival,22,9,13
Травмаопасен,gordunni,765,hunter,survival,28,9,19
Harmonía,outland,764,hunter,survival,24,8,16
Nece,argent-dawn,764,hunter,survival,24,8,16
Haskeer,shattrath,763,hunter,survival,24,8,16
Риппер,gordunni,762,hunter,survival,24,8,16
Кардеин,gordunni,761,hunter,survival,16,8,8
Läderhora,stormscale,759,hunter,survival,24,8,16
Thëhunter,tyrande,749,hunter,survival,17,8,9
Hanibale,burning-blade,740,hunter,survival,31,8,23
Pjållistani,ravencrest,735,hunter,survival,11,8,3
Katwizrø,hyjal,734,hunter,survival,17,8,9
Frozenpies,stormscale,719,hunter,survival,21,8,13
Ватмано,gordunni,718,hunter,survival,11,8,3
Soukoukouu,archimonde,704,hunter,survival,16,8,8
Shàlý,antonidas,703,hunter,survival,11,8,3
Ilòóll,veknilash,703,hunter,survival,17,8,9
Reefa,the-maelstrom,702,hunter,survival,11,8,3
Dexx,kazzak,698,hunter,survival,17,9,8
Ilovemax,archimonde,672,hunter,survival,12,7,5
Nulles,ravencrest,672,hunter,survival,12,7,5
Atod,dalaran,672,hunter,survival,12,7,5
Trapsgaye,blackmoore,672,hunter,survival,12,7,5
Трапгодикс,eversong,672,hunter,survival,12,7,5
Drvix,outland,672,hunter,survival,12,7,5
Laptopplayër,ravencrest,672,hunter,survival,12,7,5
Enim,tarren-mill,672,hunter,survival,12,7,5
Muxilina,ravencrest,672,hunter,survival,12,7,5
Гринмех,gordunni,672,hunter,survival,12,7,5
Nopopehere,draenor,672,hunter,survival,12,7,5
Yonsa,blackmoore,672,hunter,survival,12,7,5
Tomorrow,ravencrest,672,hunter,survival,12,7,5
Weedonyhunt,hyjal,672,hunter,survival,12,7,5
Волкорн,gordunni,672,hunter,survival,12,7,5
Davidghettô,dalaran,672,hunter,survival,12,7,5
Avashah,ravencrest,672,hunter,survival,16,7,9
Kapowz,kazzak,672,hunter,survival,18,7,11
Хикази,soulflayer,672,hunter,survival,18,7,11
Crostaws,terokkar,672,hunter,survival,18,7,11
Moscowmule,tarren-mill,672,hunter,survival,18,7,11
Creedncali,outland,672,hunter,survival,19,7,12
Flamehand,kazzak,671,hunter,survival,12,7,5
Oldlynx,ravencrest,671,hunter,survival,12,7,5
Ямабусетэнгу,gordunni,671,hunter,survival,12,7,5
Fyoni,silvermoon,671,hunter,survival,12,7,5
Theme,aegwynn,671,hunter,survival,12,7,5
Mechakænytwo,antonidas,671,hunter,survival,13,7,6
Shanndu,ravencrest,671,hunter,survival,18,7,11
Alithanar,drekthar,671,hunter,survival,18,7,11
Oneshotr,aegwynn,671,hunter,survival,18,7,11
Neepal,archimonde,671,hunter,survival,18,7,11
Koblih,draenor,671,hunter,survival,30,7,23
Ertestuing,tarren-mill,670,hunter,survival,18,7,11
Panfilmaaj,burning-legion,670,hunter,survival,19,7,12
Tyràél,mugthol,669,hunter,survival,12,7,5
Sylverein,silvermoon,669,hunter,survival,24,7,17
Jsâ,blackmoore,667,hunter,survival,18,7,11
Mahemi,mazrigos,664,hunter,survival,30,7,23
Skyythe,dun-morogh,649,hunter,survival,18,7,11
Drolig,blackmoore,643,hunter,survival,21,11,10
Denzal,archimonde,640,hunter,survival,16,7,9
Jalu,die-aldor,639,hunter,survival,12,8,4
Iendx,silvermoon,623,hunter,survival,11,7,4
Beersalma,arathor,623,hunter,survival,11,7,4
Axiøs,thrall,623,hunter,survival,17,7,10
Bugspitz,outland,622,hunter,survival,11,7,4
Хищник,gordunni,622,hunter,survival,14,8,6
Gharzok,blackrock,618,hunter,survival,14,8,6
Prøxyh,hyjal,607,hunter,survival,11,7,4
Hræsvëlg,archimonde,607,hunter,survival,16,7,9
Азирона,gordunni,576,hunter,survival,6,6,0
Charterjk,eredar,576,hunter,survival,6,6,0
Vinniehunter,archimonde,576,hunter,survival,6,6,0
Ynv,argent-dawn,576,hunter,survival,6,6,0
Kustjägaren,twisting-nether,576,hunter,survival,6,6,0
Ernorx,stormscale,576,hunter,survival,6,6,0
Gitanìlla,dun-modr,576,hunter,survival,6,6,0
Fådèd,ravencrest,576,hunter,survival,6,6,0
Гусевод,gordunni,576,hunter,survival,9,7,2
Куоль,gordunni,576,hunter,survival,12,6,6
Common,drakthul,576,hunter,survival,12,6,6
Bkrbot,dun-modr,576,hunter,survival,12,6,6
Annóyance,ravencrest,576,hunter,survival,12,6,6
Ямилигодц,soulflayer,576,hunter,survival,12,6,6
Коблазнх,howling-fjord,576,hunter,survival,12,6,6
Lizch,argent-dawn,576,hunter,survival,12,6,6
Bitbytes,kazzak,576,hunter,survival,12,6,6
Snoude,silvermoon,576,hunter,survival,12,6,6
Uranîa,blackmoore,576,hunter,survival,12,6,6
Nagal,ragnaros,576,hunter,survival,12,6,6
Zøøkëëper,silvermoon,576,hunter,survival,12,6,6
Psghunt,argent-dawn,576,hunter,survival,12,6,6
Milkyway,jaedenar,576,hunter,survival,12,6,6
Yezzu,sylvanas,576,hunter,survival,12,6,6
Bicmeks,ravencrest,576,hunter,survival,12,6,6
Mouganstine,archimonde,576,hunter,survival,12,6,6
Jamoneame,sanguino,576,hunter,survival,12,6,6
Anupephu,stormscale,576,hunter,survival,12,6,6
Weraxo,ravencrest,576,hunter,survival,12,6,6
Maddoqx,frostwolf,576,hunter,survival,12,6,6
Voldtzeig,dentarg,576,hunter,survival,15,6,9
Эвилтар,soulflayer,576,hunter,survival,18,6,12
Seandeluxe,defias-brotherhood,576,hunter,survival,18,6,12
Borbotir,silvermoon,576,hunter,survival,18,6,12
Faccacamoale,twisting-nether,576,hunter,survival,18,6,12
Cough,earthen-ring,576,hunter,survival,18,6,12
Bobshmurda,defias-brotherhood,576,hunter,survival,18,6,12
Knösler,anetheron,575,hunter,survival,12,6,6
Broomyuk,kilrogg,575,hunter,survival,12,6,6
Lòò,aegwynn,575,hunter,survival,12,6,6
Йеттеринг,deathweaver,575,hunter,survival,15,7,8
Дондонандон,gordunni,575,hunter,survival,18,6,12
Amjamh,hyjal,575,hunter,survival,18,6,12
Sàclak,ysondre,575,hunter,survival,18,6,12
Ohnostepbro,blackmoore,575,hunter,survival,18,6,12
Jwishrankone,outland,574,hunter,survival,12,6,6
Васябицепс,howling-fjord,574,hunter,survival,18,6,12
Vuloshi,twisting-nether,573,hunter,survival,18,6,12
Блоуйоэсс,howling-fjord,573,hunter,survival,24,6,18
Mâjôô,blackhand,544,hunter,survival,10,6,4
Vavabxl,ysondre,543,hunter,survival,11,6,5
Sumecxh,aegwynn,543,hunter,survival,11,6,5
Natheldir,silvermoon,527,hunter,survival,11,6,5
Yvenne,uldaman,525,hunter,survival,11,6,5
Eazzyy,auchindoun,522,hunter,survival,14,7,7
Mustyflor,ravencrest,511,hunter,survival,14,6,8
Хантвкроксах,gordunni,496,hunter,survival,13,6,7
Deek,ysera,480,hunter,survival,6,5,1
Spirys,drakthul,480,hunter,survival,6,5,1
Zybxd,drakthul,480,hunter,survival,6,5,1
Glama,archimonde,480,hunter,survival,6,5,1
Lilpancake,kazzak,480,hunter,survival,6,5,1
Lansha,hyjal,480,hunter,survival,6,5,1
Alohunt,archimonde,480,hunter,survival,6,5,1
Jelibon,ragnaros,480,hunter,survival,6,5,1
Smellygroin,darksorrow,480,hunter,survival,6,5,1
Mòzetónq,ravencrest,480,hunter,survival,6,5,1
Sebikh,ravencrest,480,hunter,survival,6,5,1
Osskkar,uldum,480,hunter,survival,6,5,1
Lísy,hyjal,480,hunter,survival,6,5,1
Intensivigel,blackmoore,480,hunter,survival,6,5,1
Unscripted,kazzak,480,hunter,survival,6,5,1
Animalistic,twisting-nether,480,hunter,survival,6,5,1
Hunterado,burning-legion,480,hunter,survival,12,5,7
Oof,lightnings-blade,480,hunter,survival,12,5,7
Akyra,runetotem,480,hunter,survival,12,5,7
Neyli,aegwynn,480,hunter,survival,12,5,7
Gogolehunt,archimonde,480,hunter,survival,12,5,7
Yakayoshi,kazzak,480,hunter,survival,12,5,7
Doloresman,tarren-mill,480,hunter,survival,12,5,7
Steffxd,twisting-nether,480,hunter,survival,12,5,7
Lostinmist,kazzak,480,hunter,survival,12,5,7
Mercpet,tarren-mill,480,hunter,survival,12,5,7
Аскентр,gordunni,480,hunter,survival,12,5,7
Baconflips,ravencrest,480,hunter,survival,12,5,7
Acefyre,sylvanas,480,hunter,survival,12,5,7
Сыньйорита,howling-fjord,480,hunter,survival,12,5,7
Vypaz,twisting-nether,480,hunter,survival,12,5,7
Noneedtotrap,darksorrow,480,hunter,survival,12,5,7
Asery,blackmoore,480,hunter,survival,12,5,7
Olamay,blackmoore,480,hunter,survival,12,5,7
Ðîe,ysondre,480,hunter,survival,12,5,7
Baddschr,blackmoore,480,hunter,survival,12,5,7
Djzntrap,outland,480,hunter,survival,12,5,7
Discoråttan,stormscale,480,hunter,survival,12,5,7
Kàisèr,shendralar,480,hunter,survival,12,5,7
Yukina,frostmourne,480,hunter,survival,12,5,7
Bubboo,dun-modr,480,hunter,survival,12,5,7
Beletor,medivh,480,hunter,survival,18,5,13
Ector,silvermoon,480,hunter,survival,18,5,13
Sharpeyezz,ravencrest,480,hunter,survival,18,5,13
Огнеборик,howling-fjord,480,hunter,survival,18,5,13
Beaststeaks,thrall,480,hunter,survival,18,5,13
Aleenya,dalaran,480,hunter,survival,18,5,13
Zireal,pozzo-delleternità,479,hunter,survival,6,5,1
Kayflock,blackmoore,479,hunter,survival,10,6,4
Фемтто,greymane,479,hunter,survival,12,5,7
Loading,garrosh,479,hunter,survival,12,5,7
Daltyr,ravencrest,479,hunter,survival,12,5,7
Trollshadow,tarren-mill,479,hunter,survival,18,5,13
Сногивкабину,soulflayer,479,hunter,survival,18,5,13
Jumangi,blackmoore,478,hunter,survival,12,5,7
Absolutenon,alakir,478,hunter,survival,18,5,13
Лукасика,ashenvale,474,hunter,survival,18,5,13
Sharrowkyn,twisting-nether,448,hunter,survival,10,6,4
Nazumåks,stormscale,448,hunter,survival,16,5,11
Blackbane,ravencrest,447,hunter,survival,11,5,6
Nektard,ravencrest,425,hunter,survival,14,6,8
Bubonciêl,archimonde,425,hunter,survival,22,7,15
Minisay,magtheridon,424,hunter,survival,18,6,12
Youngbepse,blackrock,384,hunter,survival,6,4,2
Lergosh,zenedar,384,hunter,survival,6,4,2
Vádîazmeý,twisting-nether,384,hunter,survival,6,4,2
Granteqar,ysondre,384,hunter,survival,6,4,2
Ледо,deathguard,384,hunter,survival,6,4,2
Cranekickzhu,blackmoore,384,hunter,survival,6,4,2
Nomorex,frostwhisper,384,hunter,survival,6,4,2
Bièretrand,les-clairvoyants,384,hunter,survival,6,4,2
Tibaq,burning-legion,384,hunter,survival,6,4,2
Meat,ravencrest,384,hunter,survival,6,4,2
Oída,blackmoore,384,hunter,survival,6,4,2
Nyxìa,shattered-halls,384,hunter,survival,6,4,2
Deyanirah,sanguino,384,hunter,survival,6,4,2
Thresha,ravenholdt,384,hunter,survival,6,4,2
Jeppe,sylvanas,384,hunter,survival,6,4,2
Krohant,auchindoun,384,hunter,survival,6,4,2
Zhannezza,sylvanas,384,hunter,survival,6,4,2
Hvaskøduenme,stormscale,384,hunter,survival,6,4,2
Luckissues,argent-dawn,384,hunter,survival,6,4,2
Muttsnuts,argent-dawn,384,hunter,survival,6,4,2
Akahr,thrall,384,hunter,survival,6,4,2
Donneraàn,blackrock,384,hunter,survival,6,4,2
Rokmahr,stormscale,384,hunter,survival,6,4,2
Националь,gordunni,384,hunter,survival,6,4,2
Trapandstun,aszune,384,hunter,survival,6,4,2
Яналице,gordunni,384,hunter,survival,6,4,2
Mooj,malganis,384,hunter,survival,6,4,2
Schmoopz,silvermoon,384,hunter,survival,6,4,2
Virzion,silvermoon,384,hunter,survival,6,4,2
Ujikãy,archimonde,384,hunter,survival,6,4,2
Salvo,silvermoon,384,hunter,survival,6,4,2
Kayflock,kazzak,384,hunter,survival,6,4,2
Sÿkzz,hyjal,384,hunter,survival,6,4,2
Djøgi,archimonde,384,hunter,survival,6,4,2
Copenhyggen,silvermoon,384,hunter,survival,6,4,2
Jêsslíne,ravencrest,384,hunter,survival,11,5,6
Castbuny,drakthul,384,hunter,survival,15,5,10
Esperion,ragnaros,384,hunter,survival,12,4,8
Fíwhale,tarren-mill,384,hunter,survival,12,4,8
Salie,argent-dawn,384,hunter,survival,12,4,8
Terraxx,die-ewige-wacht,384,hunter,survival,12,4,8
Callmepapi,kazzak,384,hunter,survival,12,4,8
Badwar,twisting-nether,384,hunter,survival,12,4,8
Rudimentary,ravencrest,384,hunter,survival,12,4,8
Jorhan,ravencrest,384,hunter,survival,12,4,8
Dettas,silvermoon,384,hunter,survival,12,4,8
Helvetiya,sylvanas,384,hunter,survival,12,4,8
Hulnhigh,grim-batol,384,hunter,survival,12,4,8
Nimoria,zuluhed,384,hunter,survival,12,4,8
Dalkus,stormscale,384,hunter,survival,12,4,8
Illuminate,laughing-skull,384,hunter,survival,12,4,8
Friendlyone,quelthalas,384,hunter,survival,12,4,8
Фарфира,gordunni,384,hunter,survival,12,4,8
Simppeli,sylvanas,384,hunter,survival,12,4,8
Wezzó,kazzak,384,hunter,survival,12,4,8
Эдерим,gordunni,384,hunter,survival,12,4,8
Vvax,stormscale,384,hunter,survival,12,4,8
Voldagor,hyjal,384,hunter,survival,12,4,8
Eâgleêyê,frostwolf,384,hunter,survival,12,4,8
Rákthar,blackmoore,384,hunter,survival,12,4,8
Wärft,arathi,384,hunter,survival,12,4,8
Claimi,silvermoon,384,hunter,survival,24,4,20
Brittany,pozzo-delleternità,383,hunter,survival,6,4,2
Arshino,argent-dawn,383,hunter,survival,12,4,8
Alongshot,outland,383,hunter,survival,24,6,18
Kayarii,ravencrest,382,hunter,survival,13,6,7
Sluhser,eredar,372,hunter,survival,20,8,12
Vhaagarr,blackmoore,351,hunter,survival,11,4,7
Ghob,kazzak,330,hunter,survival,8,5,3
Ptx,stormscale,319,hunter,survival,5,4,1
Эквинтия,soulflayer,319,hunter,survival,5,4,1
Sùnzí,alakir,319,hunter,survival,6,4,2
Velrhegal,tarren-mill,304,hunter,survival,13,4,9
Whis,blackrock,288,hunter,survival,6,3,3
Spakster,blackrock,288,hunter,survival,6,3,3
Травахант,gordunni,288,hunter,survival,6,3,3
Kovokmah,lordaeron,288,hunter,survival,6,3,3
Рэкрэйван,gordunni,288,hunter,survival,6,3,3
Likandria,blackmoore,288,hunter,survival,6,3,3
Rayburst,sylvanas,288,hunter,survival,6,3,3
Azeky,uldum,288,hunter,survival,6,3,3
Røgrøck,archimonde,288,hunter,survival,6,3,3
Iamedward,silvermoon,288,hunter,survival,6,3,3
Prinzz,blackmoore,288,hunter,survival,6,3,3
Kyrâx,silvermoon,288,hunter,survival,6,3,3
Mayhemshotz,silvermoon,288,hunter,survival,6,3,3
Deskö,shendralar,288,hunter,survival,6,3,3
Sworra,silvermoon,288,hunter,survival,6,3,3
Марчик,blackscar,288,hunter,survival,6,3,3
Oneeyedjoe,the-maelstrom,288,hunter,survival,6,3,3
Чобушек,eversong,288,hunter,survival,6,3,3
Ашмадей,eversong,288,hunter,survival,6,3,3
Unöhänä,archimonde,288,hunter,survival,6,3,3
Ténsion,silvermoon,288,hunter,survival,6,3,3
Aidsmacka,shattered-hand,288,hunter,survival,6,3,3
Rangedrouge,bloodfeather,288,hunter,survival,6,3,3
Металшот,blackscar,288,hunter,survival,6,3,3
Monnezzus,nemesis,288,hunter,survival,6,3,3
Aamøn,nemesis,288,hunter,survival,6,3,3
Паркх,soulflayer,288,hunter,survival,6,3,3
Daddytrap,burning-legion,288,hunter,survival,6,3,3
Suetøløgx,shadowsong,288,hunter,survival,6,3,3
Remiss,sanguino,288,hunter,survival,6,3,3
Hépheistos,kelthuzad,288,hunter,survival,6,3,3
Dogthebounty,tarren-mill,288,hunter,survival,6,3,3
Psychadelic,chamber-of-aspects,288,hunter,survival,6,3,3
Hiðe,archimonde,288,hunter,survival,6,3,3
Drandra,tarren-mill,288,hunter,survival,6,3,3
Narziel,die-todeskrallen,288,hunter,survival,6,3,3
Lajnus,frostmane,288,hunter,survival,6,3,3
Nashanael,argent-dawn,288,hunter,survival,6,3,3
Palesson,ragnaros,288,hunter,survival,6,3,3
Zwergjäger,aegwynn,288,hunter,survival,6,3,3
Goblinstyle,kazzak,288,hunter,survival,6,3,3
Igyunk,ragnaros,288,hunter,survival,6,3,3
Engetsu,drakthul,288,hunter,survival,6,3,3
Fjarla,aegwynn,288,hunter,survival,6,3,3
Peppiz,ragnaros,288,hunter,survival,6,3,3
Hugart,sylvanas,288,hunter,survival,6,3,3
Nightvarn,burning-blade,288,hunter,survival,6,3,3
Jondone,silvermoon,288,hunter,survival,6,3,3
Нойран,eversong,288,hunter,survival,6,3,3
Lootgobbo,antonidas,288,hunter,survival,6,3,3
Kirinó,ragnaros,288,hunter,survival,6,3,3
Xý,hyjal,288,hunter,survival,6,3,3
Gilgämesh,hyjal,288,hunter,survival,6,3,3
Syzuu,ravencrest,288,hunter,survival,6,3,3
Bearimcat,ravencrest,288,hunter,survival,6,3,3
Givz,outland,288,hunter,survival,6,3,3
Crispystix,draenor,288,hunter,survival,6,3,3
Arrowknee,outland,288,hunter,survival,6,3,3
Majhin,ravencrest,288,hunter,survival,6,3,3
Grippage,draenor,288,hunter,survival,6,3,3
Nyyrikkí,ravencrest,288,hunter,survival,6,3,3
Badboybørge,draenor,288,hunter,survival,6,3,3
Ефимушка,howling-fjord,288,hunter,survival,6,3,3
Properchub,ravencrest,288,hunter,survival,6,3,3
Jám,blackhand,288,hunter,survival,6,3,3
Leonyy,blackhand,288,hunter,survival,6,3,3
Buekåre,outland,288,hunter,survival,6,3,3
Swaffield,stormscale,288,hunter,survival,6,3,3
Dîzzy,malganis,288,hunter,survival,6,3,3
Benbutton,antonidas,288,hunter,survival,6,3,3
Thekev,ravencrest,288,hunter,survival,6,3,3
Queueagain,stormscale,288,hunter,survival,6,3,3
Raylauch,nethersturm,288,hunter,survival,6,3,3
Telluric,silvermoon,288,hunter,survival,8,3,5
Twinshot,anetheron,288,hunter,survival,11,4,7
Pull,kirin-tor,288,hunter,survival,12,3,9
Sláynôs,blackrock,288,hunter,survival,12,3,9
Ддондигидон,gordunni,288,hunter,survival,12,3,9
Diabloiv,doomhammer,288,hunter,survival,12,3,9
Bigtobacco,outland,288,hunter,survival,12,3,9
Ansâvage,ravencrest,288,hunter,survival,12,3,9
Zäphiiro,archimonde,288,hunter,survival,12,3,9
Шмалетар,gordunni,288,hunter,survival,12,3,9
Aella,thrall,288,hunter,survival,12,3,9
Homesz,blackmoore,288,hunter,survival,12,3,9
Ullburn,tyrande,288,hunter,survival,12,3,9
Dezmoinez,twisting-nether,288,hunter,survival,12,3,9
Bigfoot,argent-dawn,288,hunter,survival,12,3,9
Heoden,nemesis,288,hunter,survival,12,3,9
Àfpro,hyjal,288,hunter,survival,12,3,9
Nestór,todeswache,288,hunter,survival,12,3,9
Zlotar,doomhammer,288,hunter,survival,18,3,15
Grundibg,chamber-of-aspects,288,hunter,survival,18,3,15
Lezigoulleur,marécage-de-zangar,287,hunter,survival,6,3,3
Weedstin,ravencrest,287,hunter,survival,12,3,9
Jarhead,arthas,287,hunter,survival,12,3,9
Bosnimph,bloodfeather,285,hunter,survival,18,3,15
Arkeye,draenor,271,hunter,survival,11,3,8
Twinkhunter,pozzo-delleternità,256,hunter,survival,10,3,7
Jacobszy,outland,255,hunter,survival,8,4,4
Wódén,draenor,255,hunter,survival,17,3,14
Fakepvper,darksorrow,239,hunter,survival,5,3,2
Стёпкахант,gordunni,239,hunter,survival,5,3,2
Arrowboss,kazzak,239,hunter,survival,5,3,2
Bowtreat,aggramar,239,hunter,survival,5,3,2
Дочьпескова,gordunni,239,hunter,survival,5,3,2
Quilent,anachronos,239,hunter,survival,11,3,8
Sizemattersx,kazzak,239,hunter,survival,11,3,8
Arisko,silvermoon,234,hunter,survival,8,4,4
Himpy,twisting-nether,234,hunter,survival,14,4,10
Одисенс,eversong,233,hunter,survival,13,4,9
Rosiee,dun-modr,208,hunter,survival,7,3,4
Cryptstalkér,antonidas,192,hunter,survival,4,3,1
Abomìnatìon,blackhand,192,hunter,survival,6,2,4
Robosexual,ravencrest,192,hunter,survival,6,2,4
Oidxari,aegwynn,192,hunter,survival,6,2,4
Wirda,ravencrest,192,hunter,survival,6,2,4
Rusticroll,stormscale,192,hunter,survival,6,2,4
Geppet,pozzo-delleternità,192,hunter,survival,6,2,4
Nígruløl,arthas,192,hunter,survival,6,2,4
Demónhunter,frostmane,192,hunter,survival,6,2,4
Xaotsu,ravencrest,192,hunter,survival,6,2,4
Evazeonhunt,antonidas,192,hunter,survival,6,2,4
Leeyuael,stormscale,192,hunter,survival,6,2,4
Bèâr,stormscale,192,hunter,survival,6,2,4
Jablaka,blackhand,192,hunter,survival,6,2,4
Hänta,hyjal,192,hunter,survival,6,2,4
Gulkhar,ysondre,192,hunter,survival,6,2,4
Talnaru,ravencrest,192,hunter,survival,6,2,4
Yopps,draenor,192,hunter,survival,6,2,4
Monsterbácke,nathrezim,192,hunter,survival,6,2,4
Reinschrubba,ravencrest,192,hunter,survival,6,2,4
Делишез,fordragon,192,hunter,survival,6,2,4
Rølyn,hyjal,192,hunter,survival,6,2,4
Nøøtx,ravencrest,192,hunter,survival,6,2,4
Blàdê,blackrock,192,hunter,survival,6,2,4
Lardobrave,blackhand,192,hunter,survival,6,2,4
Canadianboy,draenor,192,hunter,survival,6,2,4
Наладдчик,howling-fjord,192,hunter,survival,6,2,4
Vasco,chogall,192,hunter,survival,6,2,4
Ducdolan,outland,192,hunter,survival,6,2,4
Дунморг,grom,192,hunter,survival,6,2,4
Marshmallorr,dalaran,192,hunter,survival,6,2,4
Twobuttngodx,blackrock,192,hunter,survival,6,2,4
Goonii,bronzebeard,192,hunter,survival,6,2,4
Reijuan,doomhammer,192,hunter,survival,6,2,4
Тандеркейдж,gordunni,192,hunter,survival,6,2,4
Skä,archimonde,192,hunter,survival,6,2,4
Aléx,ravencrest,192,hunter,survival,6,2,4
Avyo,tichondrius,192,hunter,survival,6,2,4
Ратататат,eversong,192,hunter,survival,6,2,4
Gynax,hyjal,192,hunter,survival,6,2,4
Aggrobatics,blackmoore,192,hunter,survival,6,2,4
Aevlerz,draenor,192,hunter,survival,6,2,4
Brindefolìe,archimonde,192,hunter,survival,6,2,4
Roscke,drakthul,192,hunter,survival,6,2,4
Оркос,deathweaver,192,hunter,survival,6,2,4
Kënpachi,silvermoon,192,hunter,survival,6,2,4
Toxical,ragnaros,192,hunter,survival,6,2,4
Svolatch,blackrock,192,hunter,survival,6,2,4
Fullxtrap,hyjal,192,hunter,survival,6,2,4
Púrefect,ragnaros,192,hunter,survival,6,2,4
Slayné,silvermoon,192,hunter,survival,6,2,4
Honeytrap,blackmoore,192,hunter,survival,6,2,4
Sakaryali,silvermoon,192,hunter,survival,6,2,4
Valtondre,argent-dawn,192,hunter,survival,6,2,4
Badenhunt,ravencrest,192,hunter,survival,6,2,4
Bloópy,silvermoon,192,hunter,survival,6,2,4
Ayaera,argent-dawn,192,hunter,survival,6,2,4
Daarkkhunter,twisting-nether,192,hunter,survival,6,2,4
Fajitax,lightbringer,192,hunter,survival,6,2,4
Ammò,kazzak,192,hunter,survival,6,2,4
Bloodyshot,dun-modr,192,hunter,survival,6,2,4
Gransu,argent-dawn,192,hunter,survival,6,2,4
Senedeck,silvermoon,192,hunter,survival,6,2,4
Hunterkolben,blackmoore,192,hunter,survival,6,2,4
Akhtabot,twisting-nether,192,hunter,survival,6,2,4
Draugrinnh,tarren-mill,192,hunter,survival,6,2,4
Nýka,sanguino,192,hunter,survival,6,2,4
Lithell,kazzak,192,hunter,survival,6,2,4
Tdapills,sanguino,192,hunter,survival,6,2,4
Орталиус,deathguard,192,hunter,survival,6,2,4
Flexifys,tarren-mill,192,hunter,survival,6,2,4
Lotto,stormreaver,192,hunter,survival,6,2,4
Triipiachu,zuljin,192,hunter,survival,6,2,4
Bearday,silvermoon,192,hunter,survival,6,2,4
Пиворк,soulflayer,192,hunter,survival,6,2,4
Helloman,darksorrow,192,hunter,survival,6,2,4
Pantherovich,ravencrest,192,hunter,survival,6,2,4
Мусафа,eversong,192,hunter,survival,6,2,4
Howlinjoe,darkspear,192,hunter,survival,6,2,4
Malover,ravencrest,192,hunter,survival,6,2,4
Prettyy,ravencrest,192,hunter,survival,6,2,4
Alenda,auchindoun,192,hunter,survival,7,2,5
Layro,burning-legion,192,hunter,survival,9,2,7
Zéros,argent-dawn,192,hunter,survival,12,2,10
Ecthelione,the-venture-co,192,hunter,survival,12,2,10
Sicktrigger,aegwynn,192,hunter,survival,12,2,10
Thorkai,runetotem,192,hunter,survival,12,2,10
Hntrleka,argent-dawn,192,hunter,survival,12,2,10
Ryztik,garona,192,hunter,survival,12,2,10
Hallem,karazhan,192,hunter,survival,12,2,10
Réja,norgannon,192,hunter,survival,12,2,10
Nolsey,outland,192,hunter,survival,12,2,10
Sixty,rajaxx,192,hunter,survival,18,2,16
Bélier,hyjal,191,hunter,survival,6,2,4
Klarix,outland,159,hunter,survival,5,2,3
Grracio,tarren-mill,159,hunter,survival,5,2,3
Kissay,blackmoore,159,hunter,survival,5,2,3
Naokyy,sanguino,159,hunter,survival,5,2,3
Bnji,hyjal,159,hunter,survival,11,2,9
Trapyourheal,archimonde,138,hunter,survival,16,6,10
Rdwlf,draenor,138,hunter,survival,8,3,5
Alary,burning-legion,128,hunter,survival,4,2,2
Zethik,argent-dawn,128,hunter,survival,4,2,2
Donaldtrap,archimonde,128,hunter,survival,4,2,2
Fígo,burning-blade,96,hunter,survival,3,2,1
Sisilianno,khaz-modan,96,hunter,survival,10,2,8
Gordo,burning-legion,96,hunter,survival,6,1,5
Барановируса,soulflayer,96,hunter,survival,6,1,5
Тораджи,soulflayer,96,hunter,survival,6,1,5
Убершванц,soulflayer,96,hunter,survival,6,1,5
Bôwdan,magtheridon,96,hunter,survival,6,1,5
Zynga,sylvanas,96,hunter,survival,6,1,5
Neremyn,sylvanas,96,hunter,survival,6,1,5
Algar,tarren-mill,96,hunter,survival,6,1,5
Gyurkicz,hyjal,96,hunter,survival,6,1,5
Oobe,hyjal,96,hunter,survival,6,1,5
Дакоока,deepholm,96,hunter,survival,6,1,5
Blackszpak,jaedenar,96,hunter,survival,6,1,5
Aimywinehaus,drakthul,96,hunter,survival,6,1,5
Durion,tichondrius,96,hunter,survival,6,1,5
Encharged,kazzak,96,hunter,survival,6,1,5
Varkiza,sylvanas,96,hunter,survival,6,1,5
Kideyosi,silvermoon,96,hunter,survival,6,1,5
Fantus,sylvanas,96,hunter,survival,6,1,5
Themfkiller,outland,96,hunter,survival,6,1,5
Ditbjrapex,chants-éternels,96,hunter,survival,6,1,5
Хипстеркотик,gordunni,96,hunter,survival,6,1,5
Softishot,archimonde,96,hunter,survival,6,1,5
Khalimèro,kaelthas,96,hunter,survival,6,1,5
Leaxs,onyxia,96,hunter,survival,6,1,5
Негатившица,gordunni,96,hunter,survival,6,1,5
Hentt,burning-legion,96,hunter,survival,6,1,5
Оркистор,eversong,96,hunter,survival,6,1,5
Noobhuntress,norgannon,96,hunter,survival,6,1,5
Escaflôwn,aegwynn,96,hunter,survival,6,1,5
Aneji,hyjal,96,hunter,survival,6,1,5
Rambow,ravenholdt,96,hunter,survival,6,1,5
Grollar,ragnaros,96,hunter,survival,6,1,5
Fatshaming,silvermoon,96,hunter,survival,6,1,5
Zuggi,defias-brotherhood,96,hunter,survival,6,1,5
Stirea,alakir,96,hunter,survival,6,1,5
Fôx,frostmane,96,hunter,survival,6,1,5
Liljan,kult-der-verdammten,96,hunter,survival,6,1,5
Торая,gordunni,96,hunter,survival,6,1,5
Askaris,ravencrest,96,hunter,survival,6,1,5
Saksa,blackrock,96,hunter,survival,6,1,5
Panzershot,hyjal,96,hunter,survival,6,1,5
Skidzo,alakir,96,hunter,survival,6,1,5
Серомиг,eversong,96,hunter,survival,6,1,5
Freezyshinkn,blackrock,96,hunter,survival,6,1,5
Артуша,booty-bay,96,hunter,survival,6,1,5
Yezzízo,ravencrest,96,hunter,survival,6,1,5
Multigodx,draenor,96,hunter,survival,6,1,5
Katzchen,burning-legion,96,hunter,survival,6,1,5
Axran,ravencrest,96,hunter,survival,6,1,5
Síevis,stormreaver,95,hunter,survival,6,1,5
Эннабонни,gordunni,79,hunter,survival,5,1,4
Рангмар,howling-fjord,79,hunter,survival,5,1,4
Skrag,outland,79,hunter,survival,5,1,4
Pilogbueferd,silvermoon,64,hunter,survival,4,1,3
Zuxz,blackmoore,64,hunter,survival,4,1,3
Silßow,dun-modr,63,hunter,survival,2,2,0
Хароко,gordunni,42,hunter,survival,9,3,6
Фдшер,soulflayer,42,hunter,survival,10,2,8
Brajanush,silvermoon,31,hunter,survival,2,1,1
Hypse,kazzak,2356,hunter,beastmastery,534,274,260
Cbã,ravencrest,2257,hunter,beastmastery,78,43,35
Куфа,blackscar,2222,hunter,beastmastery,78,43,35
Brokeasalwys,ravencrest,2216,hunter,beastmastery,96,51,45
Hypsenn,kazzak,2214,hunter,beastmastery,120,61,59
Mariabanks,aegwynn,2192,hunter,beastmastery,270,139,131
Куфачка,soulflayer,2181,hunter,beastmastery,77,41,36
Ataxyz,draenor,2172,hunter,beastmastery,114,59,55
Jägarntwo,stormscale,2171,hunter,beastmastery,99,52,47
Kásúxôxô,ravencrest,2157,hunter,beastmastery,60,34,26
Jägarn,stormscale,2154,hunter,beastmastery,114,59,55
Марчик,blackscar,2136,hunter,beastmastery,69,38,31
Zxll,silvermoon,2136,hunter,beastmastery,86,44,42
Ynv,argent-dawn,2130,hunter,beastmastery,272,145,127
Беби,gordunni,2129,hunter,beastmastery,96,49,47
Màdnéss,blackmoore,2126,hunter,beastmastery,78,46,32
Voldtzeig,dentarg,2125,hunter,beastmastery,150,76,74
Pryse,hyjal,2124,hunter,beastmastery,78,46,32
Zyrøra,ravencrest,2124,hunter,beastmastery,126,68,58
Tøkyô,ravencrest,2123,hunter,beastmastery,101,65,36
Krakenaspect,kazzak,2121,hunter,beastmastery,66,33,33
Moscowmule,tarren-mill,2109,hunter,beastmastery,89,44,45
Nelida,ragnaros,2105,hunter,beastmastery,60,32,28
Watchouttah,the-maelstrom,2103,hunter,beastmastery,78,44,34
Noorky,kazzak,2093,hunter,beastmastery,78,43,35
Kachaxa,kazzak,2087,hunter,beastmastery,153,76,77
Roarmantic,blackrock,2072,hunter,beastmastery,84,41,43
Poggelicious,terenas,2055,hunter,beastmastery,72,37,35
Fãdê,ravencrest,2053,hunter,beastmastery,114,72,42
Kachaxaa,ravencrest,2042,hunter,beastmastery,112,54,58
Plugonbaby,hyjal,2035,hunter,beastmastery,77,37,40
Тружка,soulflayer,2027,hunter,beastmastery,102,48,54
Truejkee,silvermoon,2026,hunter,beastmastery,166,87,79
Esperion,ragnaros,2025,hunter,beastmastery,167,81,86
Nivshot,kazzak,2024,hunter,beastmastery,60,37,23
Каосси,gordunni,2024,hunter,beastmastery,84,43,41
Kfcmanagerx,silvermoon,2024,hunter,beastmastery,90,42,48
Bøgs,the-maelstrom,2024,hunter,beastmastery,96,44,52
Baltímore,stormscale,2023,hunter,beastmastery,83,39,44
Luzivarus,malganis,2020,hunter,beastmastery,141,70,71
Doghxnter,ravencrest,2009,hunter,beastmastery,78,37,41
Jambomambo,twisting-nether,2008,hunter,beastmastery,90,46,44
Vectør,anachronos,2007,hunter,beastmastery,197,101,96
Jàsøn,ravencrest,2002,hunter,beastmastery,102,49,53
Xoarqt,aegwynn,2001,hunter,beastmastery,268,134,134
Дашатрирубля,soulflayer,1999,hunter,beastmastery,96,47,49
Pëâcêßß,outland,1998,hunter,beastmastery,90,57,33
Hasáblover,ragnaros,1996,hunter,beastmastery,66,34,32
Deadshøt,outland,1993,hunter,beastmastery,59,42,17
Ashily,blackhand,1977,hunter,beastmastery,152,79,73
Nennimi,ravencrest,1977,hunter,beastmastery,78,40,38
Gernoqz,frostwolf,1973,hunter,beastmastery,107,51,56
Seviante,outland,1967,hunter,beastmastery,126,62,64
Pfizershotx,khaz-modan,1966,hunter,beastmastery,126,65,61
Winiswin,stormscale,1966,hunter,beastmastery,201,100,101
Ghost,tarren-mill,1966,hunter,beastmastery,66,31,35
Eldrekou,kazzak,1962,hunter,beastmastery,216,110,106
Zyphx,der-rat-von-dalaran,1962,hunter,beastmastery,174,83,91
Wilfyre,twisting-nether,1959,hunter,beastmastery,447,225,222
Priceqtxd,ravencrest,1956,hunter,beastmastery,193,115,78
Expiraa,twisting-nether,1954,hunter,beastmastery,72,35,37
Luzivar,malganis,1954,hunter,beastmastery,109,52,57
Dangen,stormreaver,1952,hunter,beastmastery,54,27,27
Гринмех,gordunni,1951,hunter,beastmastery,72,39,33
Mekerosh,burning-legion,1951,hunter,beastmastery,130,60,70
Masthuhn,blackmoore,1950,hunter,beastmastery,77,48,29
Raawy,blackmoore,1948,hunter,beastmastery,42,31,11
Miraculous,dalaran,1948,hunter,beastmastery,87,46,41
Рагнарианх,gordunni,1944,hunter,beastmastery,147,73,74
Sipsomewater,ravencrest,1943,hunter,beastmastery,69,36,33
Syveera,twisting-nether,1939,hunter,beastmastery,84,41,43
Enîgmatîke,archimonde,1935,hunter,beastmastery,69,32,37
Krampack,dun-modr,1933,hunter,beastmastery,61,37,24
Snarthelg,tarren-mill,1932,hunter,beastmastery,78,43,35
Scrubbi,destromath,1932,hunter,beastmastery,77,39,38
Экономист,fordragon,1929,hunter,beastmastery,84,47,37
Thogel,hyjal,1928,hunter,beastmastery,108,53,55
Kabaro,rajaxx,1926,hunter,beastmastery,102,46,56
Babýrage,twisting-nether,1923,hunter,beastmastery,96,49,47
Twineyes,ravencrest,1923,hunter,beastmastery,208,106,102
Bobmàrley,frostwolf,1921,hunter,beastmastery,282,158,124
Odeôn,twisting-nether,1921,hunter,beastmastery,65,27,38
Irefutabil,stormscale,1920,hunter,beastmastery,102,46,56
Мираклдримз,gordunni,1919,hunter,beastmastery,72,38,34
Hacz,bronzebeard,1919,hunter,beastmastery,273,142,131
Tagz,ravencrest,1917,hunter,beastmastery,66,31,35
Wiffed,tarren-mill,1916,hunter,beastmastery,60,36,24
Nondinhos,burning-legion,1915,hunter,beastmastery,83,38,45
Âmalphy,ravencrest,1915,hunter,beastmastery,59,27,32
Поппишот,blackscar,1914,hunter,beastmastery,59,28,31
Mestar,outland,1914,hunter,beastmastery,145,68,77
Samanou,kazzak,1912,hunter,beastmastery,124,62,62
Lambo,laughing-skull,1912,hunter,beastmastery,72,35,37
Найстити,deathguard,1909,hunter,beastmastery,120,60,60
Aimshots,twisting-nether,1908,hunter,beastmastery,130,67,63
Gaeln,outland,1905,hunter,beastmastery,387,193,194
Nexztwo,blackrock,1905,hunter,beastmastery,145,72,73
Brokenpetman,defias-brotherhood,1902,hunter,beastmastery,48,26,22
Akrokillshot,outland,1901,hunter,beastmastery,57,39,18
Онкьяр,gordunni,1901,hunter,beastmastery,98,53,45
Silverwolfa,dun-modr,1900,hunter,beastmastery,93,54,39
Thing,kazzak,1900,hunter,beastmastery,42,24,18
Jawox,antonidas,1898,hunter,beastmastery,78,35,43
Каоссхант,howling-fjord,1896,hunter,beastmastery,71,45,26
Антошадпс,gordunni,1896,hunter,beastmastery,158,89,69
Колякилшот,gordunni,1895,hunter,beastmastery,66,33,33
Trapgoddxx,archimonde,1894,hunter,beastmastery,65,44,21
Teals,blackrock,1891,hunter,beastmastery,351,176,175
Баянист,soulflayer,1890,hunter,beastmastery,153,74,79
Bynen,tarren-mill,1890,hunter,beastmastery,125,55,70
Raggeh,frostwhisper,1887,hunter,beastmastery,114,57,57
Feevah,frostmane,1885,hunter,beastmastery,283,140,143
Дэнвин,deathweaver,1884,hunter,beastmastery,281,147,134
Ayiu,argent-dawn,1884,hunter,beastmastery,83,40,43
Fullxtrap,hyjal,1884,hunter,beastmastery,53,25,28
Trend,silvermoon,1881,hunter,beastmastery,545,269,276
Dohter,kazzak,1877,hunter,beastmastery,61,34,27
Крайдершот,howling-fjord,1876,hunter,beastmastery,65,33,32
Кукито,goldrinn,1875,hunter,beastmastery,71,32,39
Huntchonk,kazzak,1874,hunter,beastmastery,71,32,39
Piky,nemesis,1873,hunter,beastmastery,108,54,54
Txa,hyjal,1873,hunter,beastmastery,77,38,39
Pussirotta,stormreaver,1869,hunter,beastmastery,60,30,30
Avyo,tichondrius,1869,hunter,beastmastery,66,31,35
Mottorhead,kazzak,1865,hunter,beastmastery,63,40,23
Phesx,sylvanas,1865,hunter,beastmastery,54,27,27
Ígrågøßñø,silvermoon,1864,hunter,beastmastery,44,30,14
Биско,gordunni,1864,hunter,beastmastery,240,119,121
Filaliel,outland,1863,hunter,beastmastery,59,34,25
Hanuong,ragnaros,1862,hunter,beastmastery,36,20,16
Infléx,silvermoon,1862,hunter,beastmastery,161,89,72
Dogetrainer,silvermoon,1860,hunter,beastmastery,313,160,153
Safnirx,tarren-mill,1860,hunter,beastmastery,78,33,45
Tyranski,ravencrest,1858,hunter,beastmastery,231,122,109
Евилик,gordunni,1856,hunter,beastmastery,269,130,139
Thetrashness,kazzak,1855,hunter,beastmastery,44,34,10
Lufreak,ravencrest,1855,hunter,beastmastery,78,56,22
Chillbroo,twisting-nether,1855,hunter,beastmastery,161,78,83
Draxil,archimonde,1855,hunter,beastmastery,60,27,33
Freakyhoe,twisting-nether,1854,hunter,beastmastery,54,27,27
Alpharaven,ravencrest,1853,hunter,beastmastery,102,51,51
Ridbàck,archimonde,1853,hunter,beastmastery,89,35,54
Lysanhunt,zuljin,1852,hunter,beastmastery,72,36,36
Trapgodxx,archimonde,1852,hunter,beastmastery,54,22,32
Кронн,howling-fjord,1849,hunter,beastmastery,89,43,46
Dafhel,hyjal,1848,hunter,beastmastery,131,65,66
Wêskêr,tarren-mill,1848,hunter,beastmastery,72,35,37
Appirc,tarren-mill,1847,hunter,beastmastery,54,27,27
Djfury,archimonde,1847,hunter,beastmastery,70,34,36
Kondy,twisting-nether,1845,hunter,beastmastery,55,35,20
Burninghunt,ravencrest,1843,hunter,beastmastery,78,42,36
Дианнесса,howling-fjord,1843,hunter,beastmastery,101,49,52
Nyzuri,die-aldor,1843,hunter,beastmastery,54,26,28
Мерзкийбот,gordunni,1843,hunter,beastmastery,74,33,41
Sekzpitch,blackmoore,1842,hunter,beastmastery,78,40,38
Берх,gordunni,1842,hunter,beastmastery,274,130,144
Nøne,sylvanas,1840,hunter,beastmastery,36,26,10
Negz,eredar,1840,hunter,beastmastery,72,43,29
Лесбиянюсь,gordunni,1838,hunter,beastmastery,60,43,17
Dheredre,silvermoon,1835,hunter,beastmastery,48,27,21
Miløø,silvermoon,1835,hunter,beastmastery,48,26,22
Manj,blackhand,1835,hunter,beastmastery,65,32,33
Ætå,blackmoore,1834,hunter,beastmastery,71,34,37
Hlogic,tarren-mill,1834,hunter,beastmastery,108,51,57
Breezme,twisting-nether,1834,hunter,beastmastery,143,66,77
Ilovedf,dun-modr,1830,hunter,beastmastery,36,23,13
Næmes,hyjal,1830,hunter,beastmastery,66,32,34
Piranhaa,archimonde,1829,hunter,beastmastery,51,24,27
Кразайс,ashenvale,1829,hunter,beastmastery,91,39,52
Elfyhunter,outland,1829,hunter,beastmastery,77,33,44
Fotmrerollér,aegwynn,1828,hunter,beastmastery,96,51,45
Petshopgirl,ravencrest,1828,hunter,beastmastery,102,52,50
Diktatos,kazzak,1828,hunter,beastmastery,64,31,33
Ryxzn,eredar,1828,hunter,beastmastery,113,53,60
Altimor,blackmoore,1827,hunter,beastmastery,41,22,19
Джаствэл,howling-fjord,1827,hunter,beastmastery,56,29,27
Jêsslíne,ravencrest,1827,hunter,beastmastery,66,31,35
Bilbohunter,draenor,1825,hunter,beastmastery,48,27,21
Горгонт,blackscar,1825,hunter,beastmastery,47,25,22
Izmad,archimonde,1824,hunter,beastmastery,341,187,154
Axran,ravencrest,1824,hunter,beastmastery,124,67,57
Jungletime,outland,1823,hunter,beastmastery,72,38,34
Sukzess,antonidas,1823,hunter,beastmastery,190,91,99
Hawkeyé,forscherliga,1823,hunter,beastmastery,169,80,89
Libanais,archimonde,1823,hunter,beastmastery,269,125,144
Nystaleoss,grim-batol,1821,hunter,beastmastery,302,151,151
Kásúxøxø,ravencrest,1820,hunter,beastmastery,28,20,8
Solò,eredar,1820,hunter,beastmastery,48,27,21
Куроните,howling-fjord,1820,hunter,beastmastery,48,27,21
Rakeesh,hyjal,1820,hunter,beastmastery,54,27,27
Irükandji,chants-éternels,1819,hunter,beastmastery,48,24,24
Ветрослав,thermaplugg,1817,hunter,beastmastery,48,32,16
Omegakek,madmortem,1817,hunter,beastmastery,85,45,40
Rïm,haomarush,1817,hunter,beastmastery,72,33,39
Blackszpak,jaedenar,1816,hunter,beastmastery,48,24,24
Ilovemax,archimonde,1816,hunter,beastmastery,52,25,27
Играсломана,howling-fjord,1815,hunter,beastmastery,60,39,21
Antisniper,kazzak,1815,hunter,beastmastery,99,55,44
Bíllybobbs,argent-dawn,1815,hunter,beastmastery,36,19,17
Пожилойпупь,soulflayer,1815,hunter,beastmastery,66,32,34
Ooh,doomhammer,1815,hunter,beastmastery,120,56,64
Jabela,eredar,1814,hunter,beastmastery,59,42,17
Ashjen,aszune,1814,hunter,beastmastery,65,37,28
Альриен,gordunni,1814,hunter,beastmastery,422,220,202
Nèxz,blackrock,1814,hunter,beastmastery,107,51,56
Лордсахарок,gordunni,1814,hunter,beastmastery,90,40,50
Vrikenh,tarren-mill,1813,hunter,beastmastery,133,80,53
Nîøssx,blackrock,1813,hunter,beastmastery,125,70,55
Оуаоа,blackscar,1813,hunter,beastmastery,121,66,55
Jackjager,ravencrest,1813,hunter,beastmastery,57,27,30
Dréws,kazzak,1811,hunter,beastmastery,58,26,32
Bøøya,aegwynn,1810,hunter,beastmastery,163,86,77
Jamesyy,ravencrest,1810,hunter,beastmastery,66,30,36
Mòzetonq,ravencrest,1809,hunter,beastmastery,42,22,20
Corossity,blackmoore,1808,hunter,beastmastery,30,19,11
Reptile,outland,1808,hunter,beastmastery,146,86,60
Yarrgi,kazzak,1808,hunter,beastmastery,108,63,45
Tháyn,tarren-mill,1808,hunter,beastmastery,180,99,81
Galileo,sanguino,1808,hunter,beastmastery,109,57,52
Hiddenx,blackmoore,1808,hunter,beastmastery,42,21,21
Хантунец,soulflayer,1807,hunter,beastmastery,101,59,42
Father,auchindoun,1807,hunter,beastmastery,119,65,54
Цитрукс,gordunni,1806,hunter,beastmastery,90,47,43
Imcuteandfun,ravencrest,1806,hunter,beastmastery,153,77,76
Spirys,drakthul,1806,hunter,beastmastery,47,20,27
Круперок,howling-fjord,1805,hunter,beastmastery,90,46,44
Astari,outland,1804,hunter,beastmastery,60,29,31
Denkstah,tarren-mill,1804,hunter,beastmastery,75,32,43
Quasar,ravencrest,1804,hunter,beastmastery,66,28,38
Jägarnmt,twisting-nether,1804,hunter,beastmastery,95,40,55
Johnblønn,stormscale,1803,hunter,beastmastery,86,46,40
Crippa,tarren-mill,1803,hunter,beastmastery,54,28,26
Tillhunt,kargath,1803,hunter,beastmastery,54,26,28
Pawzz,kazzak,1803,hunter,beastmastery,96,46,50
Drakona,outland,1803,hunter,beastmastery,65,31,34
Lolez,dun-modr,1803,hunter,beastmastery,66,30,36
Orcji,blackhand,1802,hunter,beastmastery,149,74,75
Трапгодикс,eversong,1800,hunter,beastmastery,176,95,81
Spergmeister,argent-dawn,1797,hunter,beastmastery,41,25,16
Bluefluclue,draenor,1795,hunter,beastmastery,223,109,114
Лвндскейп,gordunni,1793,hunter,beastmastery,83,41,42
Cor,ravencrest,1793,hunter,beastmastery,136,65,71
Riflur,stormscale,1792,hunter,beastmastery,156,79,77
Dìgítal,twisting-nether,1792,hunter,beastmastery,101,51,50
Kestlér,twisting-nether,1792,hunter,beastmastery,204,99,105
Пивопьюня,ashenvale,1790,hunter,beastmastery,71,34,37
Pkz,dun-modr,1790,hunter,beastmastery,125,59,66
Laserkamel,aegwynn,1789,hunter,beastmastery,30,22,8
Zæuz,outland,1789,hunter,beastmastery,63,30,33
Smhx,stormscale,1788,hunter,beastmastery,30,21,9
Келен,blackscar,1788,hunter,beastmastery,88,52,36
Wodhunterxdd,outland,1788,hunter,beastmastery,53,25,28
Hugø,twisting-nether,1788,hunter,beastmastery,179,79,100
Giwtus,blackmoore,1788,hunter,beastmastery,48,19,29
Baïonnettex,archimonde,1785,hunter,beastmastery,54,22,32
Simpyani,silvermoon,1784,hunter,beastmastery,80,47,33
Deathcode,stormscale,1784,hunter,beastmastery,66,27,39
Shroomynuts,kazzak,1782,hunter,beastmastery,120,70,50
Хаурос,soulflayer,1781,hunter,beastmastery,72,35,37
Thinkerer,silvermoon,1780,hunter,beastmastery,127,68,59
Ruffixvs,blackrock,1779,hunter,beastmastery,47,23,24
Nevier,tarren-mill,1779,hunter,beastmastery,48,21,27
Sparcùs,stormreaver,1777,hunter,beastmastery,146,81,65
Narolaf,doomhammer,1776,hunter,beastmastery,69,38,31
Exlune,sylvanas,1775,hunter,beastmastery,102,52,50
Coltan,nemesis,1774,hunter,beastmastery,108,51,57
Hacx,ravencrest,1774,hunter,beastmastery,134,63,71
Gucçi,kazzak,1773,hunter,beastmastery,73,42,31
Tobbè,silvermoon,1773,hunter,beastmastery,71,32,39
Treaz,sanguino,1770,hunter,beastmastery,78,40,38
Gigamesh,sporeggar,1769,hunter,beastmastery,240,133,107
Gostry,archimonde,1768,hunter,beastmastery,66,34,32
Ambarcrojas,kazzak,1767,hunter,beastmastery,122,69,53
Блэкстейдж,howling-fjord,1767,hunter,beastmastery,217,115,102
Wîldhunt,burning-legion,1767,hunter,beastmastery,250,120,130
Nimhunt,dentarg,1766,hunter,beastmastery,173,83,90
Donixx,blackrock,1765,hunter,beastmastery,60,29,31
Dogwatcher,outland,1762,hunter,beastmastery,60,29,31
Скадхи,blackscar,1762,hunter,beastmastery,88,42,46
Rndhunt,shattrath,1762,hunter,beastmastery,126,57,69
Vènuhá,ravencrest,1761,hunter,beastmastery,54,29,25
Ansâvage,ravencrest,1761,hunter,beastmastery,120,57,63
Guccihuntlol,ravencrest,1760,hunter,beastmastery,74,35,39
Наспидахх,blackscar,1759,hunter,beastmastery,90,50,40
Lothram,les-sentinelles,1759,hunter,beastmastery,60,31,29
Jamzyhunter,emerald-dream,1759,hunter,beastmastery,120,60,60
Rákthar,blackmoore,1759,hunter,beastmastery,167,79,88
Порошокк,gordunni,1756,hunter,beastmastery,75,32,43
Hitandtrap,stormscale,1755,hunter,beastmastery,66,32,34
Dtq,silvermoon,1755,hunter,beastmastery,149,72,77
Nollieflip,stormscale,1754,hunter,beastmastery,114,67,47
Мэлвиса,borean-tundra,1754,hunter,beastmastery,90,50,40
Duppdupp,eredar,1754,hunter,beastmastery,108,51,57
Erethrus,ravencrest,1752,hunter,beastmastery,54,20,34
Dwgkia,ravencrest,1751,hunter,beastmastery,60,26,34
Pewpewshotz,stormscale,1750,hunter,beastmastery,229,117,112
Порошокк,howling-fjord,1748,hunter,beastmastery,48,23,25
Haltrâdar,archimonde,1746,hunter,beastmastery,104,48,56
Trendsetterx,pozzo-delleternità,1746,hunter,beastmastery,48,22,26
Tëmeh,ysondre,1744,hunter,beastmastery,48,25,23
Мориартис,ashenvale,1744,hunter,beastmastery,83,43,40
Джарвиз,soulflayer,1743,hunter,beastmastery,54,31,23
Sentriks,tarren-mill,1743,hunter,beastmastery,54,24,30
Åsynåmvp,twisting-nether,1742,hunter,beastmastery,65,29,36
Fôx,frostmane,1741,hunter,beastmastery,36,27,9
Noversia,aegwynn,1741,hunter,beastmastery,165,81,84
Wlâd,archimonde,1740,hunter,beastmastery,47,29,18
Киборка,howling-fjord,1739,hunter,beastmastery,94,59,35
Boomgorush,kazzak,1739,hunter,beastmastery,60,36,24
Amyndôr,ravencrest,1738,hunter,beastmastery,78,41,37
Reyko,stormscale,1738,hunter,beastmastery,72,29,43
Dregor,nemesis,1737,hunter,beastmastery,48,28,20
Híldir,draenor,1737,hunter,beastmastery,36,19,17
Cnby,stormscale,1736,hunter,beastmastery,73,44,29
Shinkichi,archimonde,1736,hunter,beastmastery,48,23,25
Hunterla,tarren-mill,1735,hunter,beastmastery,81,42,39
Такувами,gordunni,1735,hunter,beastmastery,168,74,94
Blmlooter,stormreaver,1734,hunter,beastmastery,49,26,23
Saggymilkies,outland,1734,hunter,beastmastery,132,60,72
Недостижений,soulflayer,1734,hunter,beastmastery,60,24,36
Космодиск,gordunni,1733,hunter,beastmastery,54,29,25
Freemàén,drakthul,1733,hunter,beastmastery,95,42,53
Stingsz,chogall,1733,hunter,beastmastery,64,25,39
Lofiel,blackrock,1732,hunter,beastmastery,92,50,42
Letsrock,outland,1732,hunter,beastmastery,116,62,54
Arcø,dun-modr,1732,hunter,beastmastery,50,26,24
Land,darkspear,1731,hunter,beastmastery,77,42,35
Kmps,ravencrest,1731,hunter,beastmastery,48,25,23
Sankari,blackmoore,1731,hunter,beastmastery,156,80,76
Mentalasylum,blackmoore,1731,hunter,beastmastery,51,24,27
Ðéadsøulz,stormscale,1729,hunter,beastmastery,159,86,73
Thogelle,hyjal,1729,hunter,beastmastery,316,160,156
Misstrap,nemesis,1728,hunter,beastmastery,90,42,48
Clockwerk,durotan,1728,hunter,beastmastery,88,41,47
Кертион,howling-fjord,1727,hunter,beastmastery,84,38,46
Elmez,outland,1727,hunter,beastmastery,60,26,34
Valkrys,die-aldor,1726,hunter,beastmastery,70,35,35
Oldbear,frostmane,1725,hunter,beastmastery,70,38,32
Badboybørge,draenor,1725,hunter,beastmastery,71,33,38
Qtìp,aegwynn,1725,hunter,beastmastery,107,48,59
Hizzenstein,blackhand,1724,hunter,beastmastery,54,27,27
Kamar,archimonde,1722,hunter,beastmastery,78,50,28
Xxiioo,ravencrest,1722,hunter,beastmastery,157,90,67
Fatmum,magtheridon,1721,hunter,beastmastery,176,90,86
Bigdog,eredar,1721,hunter,beastmastery,89,43,46
Mtrider,twisting-nether,1721,hunter,beastmastery,105,50,55
Morìtz,ravencrest,1720,hunter,beastmastery,66,38,28
Bobletty,tarren-mill,1720,hunter,beastmastery,36,19,17
Sagethunt,blackrock,1720,hunter,beastmastery,107,47,60
Bêastî,blackrock,1718,hunter,beastmastery,54,29,25
Вождь,howling-fjord,1718,hunter,beastmastery,89,42,47
Easyclass,hyjal,1717,hunter,beastmastery,184,101,83
Lëgølåslõrdx,blackrock,1717,hunter,beastmastery,98,52,46
Venomtrap,sanguino,1716,hunter,beastmastery,59,24,35
Janko,ravencrest,1715,hunter,beastmastery,470,240,230
Swallowbaby,lothar,1714,hunter,beastmastery,102,51,51
Koffh,argent-dawn,1714,hunter,beastmastery,84,39,45
Palav,outland,1713,hunter,beastmastery,60,34,26
Fåded,ravencrest,1713,hunter,beastmastery,112,58,54
Yezzu,sylvanas,1713,hunter,beastmastery,48,21,27
Pagman,thrall,1713,hunter,beastmastery,53,23,30
Xenvantos,stormscale,1711,hunter,beastmastery,54,26,28
Spider,zuljin,1710,hunter,beastmastery,188,97,91
Mogwai,stormscale,1709,hunter,beastmastery,42,18,24
Kissnodig,outland,1708,hunter,beastmastery,128,80,48
Танчибосс,soulflayer,1708,hunter,beastmastery,54,33,21
Erilis,twisting-nether,1706,hunter,beastmastery,43,24,19
Feijfeij,stormreaver,1706,hunter,beastmastery,96,50,46
Bicmax,archimonde,1705,hunter,beastmastery,45,20,25
Impxgodx,outland,1704,hunter,beastmastery,51,24,27
Lobo,kazzak,1704,hunter,beastmastery,66,28,38
Joffey,stormscale,1704,hunter,beastmastery,54,22,32
Sayn,la-croisade-écarlate,1703,hunter,beastmastery,125,60,65
Ysina,arathi,1703,hunter,beastmastery,108,50,58
Saiko,kazzak,1703,hunter,beastmastery,42,18,24
Gnubbzn,aegwynn,1703,hunter,beastmastery,54,21,33
Unßørn,archimonde,1702,hunter,beastmastery,96,38,58
Vilopez,arthas,1701,hunter,beastmastery,24,20,4
Parhainkoira,argent-dawn,1701,hunter,beastmastery,102,56,46
Murtagh,khaz-modan,1701,hunter,beastmastery,66,36,30
Lyllidrop,varimathras,1701,hunter,beastmastery,56,27,29
Krix,ragnaros,1700,hunter,beastmastery,120,67,53
Legosoldaten,stormscale,1700,hunter,beastmastery,40,22,18
Jeskö,tarren-mill,1700,hunter,beastmastery,42,21,21
Леао,howling-fjord,1699,hunter,beastmastery,93,59,34
Agrmash,drakthul,1699,hunter,beastmastery,42,26,16
Elamondria,outland,1699,hunter,beastmastery,72,42,30
Sznxøxo,ravencrest,1699,hunter,beastmastery,54,29,25
Idtrapthat,nagrand,1698,hunter,beastmastery,108,52,56
Traplørdx,sylvanas,1697,hunter,beastmastery,54,24,30
Grynu,kazzak,1697,hunter,beastmastery,78,31,47
Pekaxôxô,sanguino,1696,hunter,beastmastery,60,43,17
Адыгах,blackscar,1696,hunter,beastmastery,78,44,34
Liquidhunter,quelthalas,1696,hunter,beastmastery,48,26,22
Фираналь,blackscar,1696,hunter,beastmastery,188,93,95
Angeedau,kazzak,1696,hunter,beastmastery,66,28,38
Azzazeal,drakthul,1694,hunter,beastmastery,54,24,30
Merquryh,ravencrest,1693,hunter,beastmastery,48,27,21
Vinsanity,dunemaul,1693,hunter,beastmastery,54,21,33
Bebiyo,sanguino,1692,hunter,beastmastery,130,65,65
Заксель,soulflayer,1692,hunter,beastmastery,72,36,36
Timec,outland,1692,hunter,beastmastery,42,18,24
Lîs,kargath,1691,hunter,beastmastery,36,20,16
Naraxis,blackrock,1691,hunter,beastmastery,102,51,51
Madeyhunt,burning-legion,1691,hunter,beastmastery,48,23,25
Chrysantes,forscherliga,1691,hunter,beastmastery,44,21,23
Ericspet,stormscale,1690,hunter,beastmastery,66,40,26
Fluphy,thrall,1690,hunter,beastmastery,106,55,51
Tauriêl,blutkessel,1690,hunter,beastmastery,48,24,24
Douglas,die-silberne-hand,1690,hunter,beastmastery,76,35,41
Fize,blackmoore,1689,hunter,beastmastery,101,48,53
Painaldeepz,stormscale,1688,hunter,beastmastery,90,46,44
Mânhunt,blackhand,1688,hunter,beastmastery,659,328,331
Дуссита,gordunni,1688,hunter,beastmastery,149,70,79
Utoast,ravencrest,1687,hunter,beastmastery,60,30,30
Askaway,sylvanas,1686,hunter,beastmastery,48,35,13
Balthazzarxx,ravencrest,1686,hunter,beastmastery,68,36,32
Dragonbomb,tarren-mill,1686,hunter,beastmastery,60,25,35
Earlygrey,ravencrest,1685,hunter,beastmastery,213,107,106
Kalá,defias-brotherhood,1684,hunter,beastmastery,51,23,28
Carioca,blackhand,1684,hunter,beastmastery,78,34,44
Ðxlz,archimonde,1683,hunter,beastmastery,71,35,36
Hunterlolz,tarren-mill,1682,hunter,beastmastery,138,74,64
Svolatch,blackrock,1681,hunter,beastmastery,42,18,24
Bówyóurfácé,outland,1680,hunter,beastmastery,66,37,29
Забзаб,soulflayer,1680,hunter,beastmastery,63,31,32
Trapzila,aggra-português,1679,hunter,beastmastery,132,73,59
Vajraw,blackrock,1679,hunter,beastmastery,243,120,123
Nestór,todeswache,1678,hunter,beastmastery,47,28,19
Миилленниум,howling-fjord,1675,hunter,beastmastery,66,27,39
Pewpewcus,ravencrest,1674,hunter,beastmastery,241,141,100
Brawnshunt,stormscale,1674,hunter,beastmastery,95,44,51
Hultasy,outland,1673,hunter,beastmastery,197,100,97
Cubro,sanguino,1672,hunter,beastmastery,95,53,42
Ремонтлицаа,gordunni,1672,hunter,beastmastery,68,31,37
Knocked,quelthalas,1672,hunter,beastmastery,90,39,51
Xenvantoss,silvermoon,1671,hunter,beastmastery,36,19,17
Hîldegard,todeswache,1670,hunter,beastmastery,70,35,35
Irefutabilâ,outland,1670,hunter,beastmastery,144,66,78
Kethos,draenor,1669,hunter,beastmastery,93,56,37
Hiddenxsabo,blackmoore,1669,hunter,beastmastery,47,26,21
Techpøint,silvermoon,1669,hunter,beastmastery,35,18,17
Greavius,kazzak,1669,hunter,beastmastery,48,24,24
Инкризшот,gordunni,1668,hunter,beastmastery,83,43,40
Twirlylock,emerald-dream,1668,hunter,beastmastery,60,27,33
Kerólus,blackhand,1668,hunter,beastmastery,54,20,34
Дэскрайт,soulflayer,1667,hunter,beastmastery,78,44,34
Raindra,twisting-nether,1667,hunter,beastmastery,78,37,41
Neïç,antonidas,1666,hunter,beastmastery,125,57,68
Berenger,twisting-nether,1665,hunter,beastmastery,36,21,15
Triggaz,stormscale,1665,hunter,beastmastery,216,109,107
Фэннон,gordunni,1665,hunter,beastmastery,63,28,35
Áñmy,ravencrest,1664,hunter,beastmastery,70,46,24
Zanpa,archimonde,1663,hunter,beastmastery,122,56,66
Atrisi,tarren-mill,1662,hunter,beastmastery,41,25,16
Hõth,kazzak,1662,hunter,beastmastery,42,18,24
Flanägan,hyjal,1661,hunter,beastmastery,119,70,49
Mævis,ravencrest,1661,hunter,beastmastery,52,23,29
Sivoh,silvermoon,1660,hunter,beastmastery,44,31,13
Trenesta,tarren-mill,1659,hunter,beastmastery,34,18,16
Zubro,kazzak,1659,hunter,beastmastery,231,116,115
Psymòn,ravencrest,1659,hunter,beastmastery,48,24,24
Noór,silvermoon,1658,hunter,beastmastery,75,47,28
Eggcowmeow,azjolnerub,1658,hunter,beastmastery,102,52,50
Wayland,dalaran,1658,hunter,beastmastery,120,51,69
Pérnix,tarren-mill,1657,hunter,beastmastery,30,18,12
Gondoo,tarren-mill,1656,hunter,beastmastery,42,20,22
Wolfster,kazzak,1655,hunter,beastmastery,96,50,46
Meghanmarkle,tarren-mill,1655,hunter,beastmastery,111,56,55
Chúx,twisting-nether,1655,hunter,beastmastery,233,117,116
Kravchenko,draenor,1653,hunter,beastmastery,109,62,47
Diapositiv,draenor,1653,hunter,beastmastery,119,65,54
Futureman,blackrock,1653,hunter,beastmastery,67,33,34
Grabbin,silvermoon,1652,hunter,beastmastery,64,32,32
Séyena,outland,1652,hunter,beastmastery,114,51,63
Гигапупсх,howling-fjord,1651,hunter,beastmastery,183,100,83
Ðrtrapx,blackmoore,1650,hunter,beastmastery,74,40,34
Digital,twisting-nether,1650,hunter,beastmastery,45,24,21
Taoshii,die-aldor,1649,hunter,beastmastery,100,55,45
Jaxxoo,outland,1648,hunter,beastmastery,36,23,13
Bebar,kazzak,1648,hunter,beastmastery,156,81,75
Djøgi,archimonde,1648,hunter,beastmastery,66,33,33
Røzy,twisting-nether,1647,hunter,beastmastery,48,35,13
Ritmkesh,draenor,1647,hunter,beastmastery,61,36,25
Zisqa,alleria,1647,hunter,beastmastery,46,25,21
Poupoune,uldum,1647,hunter,beastmastery,102,50,52
Tiendat,kazzak,1646,hunter,beastmastery,78,44,34
Hask,pozzo-delleternità,1646,hunter,beastmastery,39,21,18
Nkdchef,outland,1646,hunter,beastmastery,66,35,31
Oldcocknbals,silvermoon,1645,hunter,beastmastery,100,54,46
Mirmona,stormscale,1645,hunter,beastmastery,120,60,60
Beeasty,aegwynn,1644,hunter,beastmastery,42,25,17
Digimørtal,kazzak,1644,hunter,beastmastery,54,28,26
Bearday,silvermoon,1644,hunter,beastmastery,96,40,56
Darksmoke,forscherliga,1643,hunter,beastmastery,83,41,42
Ефрейя,gordunni,1643,hunter,beastmastery,56,25,31
Hellhawk,twisting-nether,1642,hunter,beastmastery,35,21,14
Rachelgg,ravencrest,1642,hunter,beastmastery,40,18,22
Peazý,ravencrest,1641,hunter,beastmastery,114,57,57
Sazox,blackrock,1641,hunter,beastmastery,36,18,18
Смертонносна,lich-king,1641,hunter,beastmastery,71,30,41
Rynx,hellfire,1640,hunter,beastmastery,120,58,62
Шергала,soulflayer,1640,hunter,beastmastery,383,183,200
Paraskámu,twisting-nether,1639,hunter,beastmastery,41,23,18
Ariabeast,archimonde,1639,hunter,beastmastery,60,30,30
Shoranon,stormscale,1639,hunter,beastmastery,48,23,25
Ingvi,antonidas,1639,hunter,beastmastery,209,100,109
Teestylee,stormscale,1638,hunter,beastmastery,42,21,21
Ксила,blackscar,1637,hunter,beastmastery,77,41,36
Drøøðqt,blackrock,1637,hunter,beastmastery,60,31,29
Jinxpeasant,twisting-nether,1636,hunter,beastmastery,42,27,15
Akaris,archimonde,1635,hunter,beastmastery,78,35,43
Coôkie,ysondre,1635,hunter,beastmastery,54,24,30
Daxhunter,twisting-nether,1635,hunter,beastmastery,54,23,31
Yolofant,blackhand,1634,hunter,beastmastery,36,22,14
Imdepressed,sylvanas,1634,hunter,beastmastery,57,31,26
Куоль,gordunni,1634,hunter,beastmastery,53,23,30
Fizè,blackmoore,1633,hunter,beastmastery,53,32,21
Dealtqt,ysondre,1633,hunter,beastmastery,54,23,31
Notx,ravencrest,1632,hunter,beastmastery,54,29,25
Sïmc,archimonde,1632,hunter,beastmastery,136,70,66
Cicatrice,kazzak,1631,hunter,beastmastery,40,19,21
Horhyndan,ragnaros,1631,hunter,beastmastery,51,24,27
Santiino,silvermoon,1630,hunter,beastmastery,94,47,47
Smecher,ravencrest,1630,hunter,beastmastery,86,41,45
Malover,ravencrest,1630,hunter,beastmastery,47,21,26
Pareia,blackrock,1629,hunter,beastmastery,30,20,10
Pareîa,alexstrasza,1629,hunter,beastmastery,33,18,15
Ðesøtø,frostwolf,1628,hunter,beastmastery,66,33,33
Dullcat,ravencrest,1627,hunter,beastmastery,36,22,14
Drewsx,ravencrest,1627,hunter,beastmastery,36,22,14
Porch,dragonmaw,1627,hunter,beastmastery,49,26,23
Gramzy,blackmoore,1627,hunter,beastmastery,197,103,94
Nashanael,argent-dawn,1626,hunter,beastmastery,48,22,26
Wolder,burning-legion,1625,hunter,beastmastery,30,20,10
ßeans,sanguino,1625,hunter,beastmastery,41,20,21
Gibiswag,outland,1625,hunter,beastmastery,36,17,19
Uglybaboon,draenor,1625,hunter,beastmastery,42,17,25
Noxin,blackrock,1624,hunter,beastmastery,48,24,24
Dispairge,antonidas,1624,hunter,beastmastery,48,21,27
Sicktrapbtw,hyjal,1624,hunter,beastmastery,42,17,25
Illaice,antonidas,1623,hunter,beastmastery,42,23,19
Fiftyóne,festung-der-stürme,1623,hunter,beastmastery,120,65,55
Пихпахах,gordunni,1623,hunter,beastmastery,148,74,74
Акройя,gordunni,1622,hunter,beastmastery,132,70,62
Pluttbug,xavius,1622,hunter,beastmastery,38,20,18
Podroto,tyrande,1622,hunter,beastmastery,47,22,25
Downey,azshara,1622,hunter,beastmastery,100,40,60
Índigo,kazzak,1620,hunter,beastmastery,56,30,26
Зоотян,gordunni,1620,hunter,beastmastery,117,59,58
Ausgefuchst,forscherliga,1620,hunter,beastmastery,54,24,30
Flappypig,stormscale,1620,hunter,beastmastery,50,22,28
Jomerin,thrall,1620,hunter,beastmastery,53,23,30
Gzà,kazzak,1620,hunter,beastmastery,59,24,35
Bulletride,stormscale,1619,hunter,beastmastery,36,21,15
Ðoxz,blackrock,1619,hunter,beastmastery,30,17,13
Ilovekatsu,archimonde,1619,hunter,beastmastery,30,17,13
Jèrsèy,draenor,1619,hunter,beastmastery,42,22,20
Onof,archimonde,1619,hunter,beastmastery,36,17,19
Vezeka,ravencrest,1618,hunter,beastmastery,42,26,16
Githo,argent-dawn,1618,hunter,beastmastery,115,67,48
Chasxc,kazzak,1618,hunter,beastmastery,124,64,60
Вееном,gordunni,1618,hunter,beastmastery,78,37,41
Poatan,outland,1617,hunter,beastmastery,176,104,72
Tràxes,quelthalas,1617,hunter,beastmastery,378,193,185
Bobon,stormscale,1617,hunter,beastmastery,54,26,28
Klausmanne,blackrock,1617,hunter,beastmastery,389,187,202
Deathvain,tarren-mill,1617,hunter,beastmastery,91,38,53
Notdilly,varimathras,1617,hunter,beastmastery,48,20,28
Criticalbomb,kazzak,1616,hunter,beastmastery,54,28,26
Zuxz,blackmoore,1616,hunter,beastmastery,103,50,53
Трапча,soulflayer,1615,hunter,beastmastery,30,19,11
Thatsaturtle,arathor,1615,hunter,beastmastery,30,17,13
Eltrapo,ravencrest,1613,hunter,beastmastery,24,17,7
Oife,auchindoun,1613,hunter,beastmastery,101,61,40
Trnx,antonidas,1613,hunter,beastmastery,36,21,15
Asâya,blackmoore,1613,hunter,beastmastery,184,104,80
Missmytraps,ravencrest,1613,hunter,beastmastery,39,20,19
Kawal,hyjal,1613,hunter,beastmastery,42,21,21
Zusale,azshara,1612,hunter,beastmastery,66,35,31
Rapidfirez,twisting-nether,1611,hunter,beastmastery,24,17,7
Gajoshunter,frostwolf,1611,hunter,beastmastery,30,18,12
Shenely,kazzak,1611,hunter,beastmastery,30,17,13
Aroeris,ravencrest,1611,hunter,beastmastery,57,32,25
Xraay,stormscale,1610,hunter,beastmastery,54,31,23
Blupo,stormscale,1610,hunter,beastmastery,359,182,177
Dawil,ragnaros,1610,hunter,beastmastery,66,30,36
Мальберна,eversong,1609,hunter,beastmastery,48,30,18
Slmao,tarren-mill,1608,hunter,beastmastery,251,125,126
Búddhá,stormscale,1608,hunter,beastmastery,198,95,103
Zoo,archimonde,1608,hunter,beastmastery,51,24,27
Каэлланис,soulflayer,1608,hunter,beastmastery,95,44,51
Kdjschgzdsv,archimonde,1608,hunter,beastmastery,47,18,29
Símpíng,tarren-mill,1607,hunter,beastmastery,24,17,7
Nukenfoobs,draenor,1607,hunter,beastmastery,36,23,13
Nolove,burning-legion,1607,hunter,beastmastery,173,87,86
Paimen,darksorrow,1606,hunter,beastmastery,108,57,51
Сенджогахара,greymane,1606,hunter,beastmastery,91,45,46
Æblesaft,stormscale,1605,hunter,beastmastery,94,45,49
Sadira,echsenkessel,1604,hunter,beastmastery,45,28,17
Céah,blackrock,1604,hunter,beastmastery,54,28,26
Calutis,blackmoore,1603,hunter,beastmastery,66,39,27
Chasseurcool,argent-dawn,1603,hunter,beastmastery,56,31,25
Bànsundara,hyjal,1603,hunter,beastmastery,97,53,44
Pumbuboo,deathwing,1603,hunter,beastmastery,133,72,61
Xeld,outland,1603,hunter,beastmastery,36,19,17
Yoey,tarren-mill,1603,hunter,beastmastery,68,35,33
Xplosiveshot,tarren-mill,1602,hunter,beastmastery,35,22,13
Atlanta,arygos,1602,hunter,beastmastery,42,22,20
Sjins,draenor,1601,hunter,beastmastery,35,20,15
Pancakesgo,twilights-hammer,1601,hunter,beastmastery,185,96,89
Эвилтар,soulflayer,1601,hunter,beastmastery,120,61,59
Feralhound,exodar,1601,hunter,beastmastery,491,248,243
Povish,twisting-nether,1601,hunter,beastmastery,59,28,31
Ivanthebeast,twisting-nether,1600,hunter,beastmastery,111,65,46
Stickey,antonidas,1600,hunter,beastmastery,66,34,32
Zinco,ravencrest,1600,hunter,beastmastery,171,84,87
Иоссифсталин,soulflayer,1600,hunter,beastmastery,127,60,67
Fatihvahset,stormscale,1600,hunter,beastmastery,39,18,21
Gorebatschov,aegwynn,1600,hunter,beastmastery,60,21,39
Coldmonster,tarren-mill,1598,hunter,beastmastery,202,112,90
Оути,azuregos,1595,hunter,beastmastery,69,37,32
Zendra,sylvanas,1595,hunter,beastmastery,242,129,113
Wraithlit,bronzebeard,1595,hunter,beastmastery,78,41,37
Gukexa,outland,1594,hunter,beastmastery,37,19,18
Smegmagol,baelgun,1594,hunter,beastmastery,95,48,47
Ðìløx,ysondre,1593,hunter,beastmastery,54,25,29
Daveq,drakthul,1593,hunter,beastmastery,71,32,39
Amigoss,argent-dawn,1592,hunter,beastmastery,120,65,55
Akhtabot,twisting-nether,1592,hunter,beastmastery,42,19,23
Memehunter,aegwynn,1591,hunter,beastmastery,78,47,31
Latschodives,malorne,1589,hunter,beastmastery,175,89,86
Hecken,nemesis,1588,hunter,beastmastery,30,20,10
Brisbya,khaz-modan,1588,hunter,beastmastery,59,35,24
Arcaniz,ravencrest,1588,hunter,beastmastery,72,38,34
Wicmex,les-sentinelles,1588,hunter,beastmastery,47,23,24
Nordafrøst,antonidas,1587,hunter,beastmastery,72,29,43
Barrybigtoe,tarren-mill,1585,hunter,beastmastery,30,17,13
Dragosvis,arathor,1585,hunter,beastmastery,77,41,36
Saymqt,blackrock,1584,hunter,beastmastery,87,42,45
Sallya,kazzak,1583,hunter,beastmastery,53,28,25
Солевойй,gordunni,1583,hunter,beastmastery,75,38,37
Survabuse,silvermoon,1581,hunter,beastmastery,33,20,13
Encore,sylvanas,1581,hunter,beastmastery,221,118,103
Luckyxcharm,blackrock,1580,hunter,beastmastery,102,51,51
Wrongtarget,auchindoun,1580,hunter,beastmastery,65,28,37
Eazzyy,auchindoun,1578,hunter,beastmastery,138,65,73
Гульнарамвд,gordunni,1578,hunter,beastmastery,48,20,28
Kafkules,outland,1577,hunter,beastmastery,155,83,72
Domnite,ravencrest,1577,hunter,beastmastery,330,173,157
Cyclontrapgg,antonidas,1576,hunter,beastmastery,41,21,20
Wèndy,blackrock,1576,hunter,beastmastery,94,46,48
Miladinorc,azjolnerub,1574,hunter,beastmastery,42,25,17
Akïratqz,sanguino,1572,hunter,beastmastery,30,18,12
Drivenscope,twisting-nether,1572,hunter,beastmastery,52,29,23
Пулявзубах,gordunni,1572,hunter,beastmastery,144,76,68
Nickyhunt,stormscale,1572,hunter,beastmastery,79,39,40
Жэш,howling-fjord,1571,hunter,beastmastery,93,61,32
Orcoro,ysondre,1571,hunter,beastmastery,353,175,178
Grapemint,blackrock,1570,hunter,beastmastery,30,18,12
Strélka,blackrock,1570,hunter,beastmastery,72,36,36
Snaipergirl,twisting-nether,1570,hunter,beastmastery,132,62,70
Омежка,deepholm,1570,hunter,beastmastery,88,35,53
Tuskah,stormreaver,1569,hunter,beastmastery,72,41,31
Йокуя,blackscar,1568,hunter,beastmastery,90,51,39
Pandanero,ravencrest,1568,hunter,beastmastery,36,18,18
Комомура,soulflayer,1568,hunter,beastmastery,53,24,29
Темпеест,gordunni,1567,hunter,beastmastery,48,22,26
Callmepapi,kazzak,1566,hunter,beastmastery,56,32,24
Huntma,kazzak,1566,hunter,beastmastery,133,70,63
Trapyx,malganis,1566,hunter,beastmastery,417,210,207
Snipertjuh,silvermoon,1565,hunter,beastmastery,193,97,96
Øô,dun-morogh,1564,hunter,beastmastery,95,50,45
Yeign,eredar,1563,hunter,beastmastery,96,51,45
Кейдлер,gordunni,1563,hunter,beastmastery,62,31,31
Dragomirka,kazzak,1563,hunter,beastmastery,117,58,59
Fritzi,outland,1563,hunter,beastmastery,41,18,23
Amigosaa,draenor,1560,hunter,beastmastery,42,24,18
Gedzer,silvermoon,1560,hunter,beastmastery,78,38,40
Proccter,silvermoon,1558,hunter,beastmastery,168,91,77
Charleramsey,outland,1558,hunter,beastmastery,60,30,30
Тоффи,blackscar,1557,hunter,beastmastery,47,21,26
Expoh,blackmoore,1556,hunter,beastmastery,49,25,24
Tigerups,burning-legion,1556,hunter,beastmastery,60,29,31
Shkorvi,drakthul,1555,hunter,beastmastery,36,17,19
Britannia,frostmane,1554,hunter,beastmastery,42,26,16
Pjållistani,ravencrest,1554,hunter,beastmastery,48,18,30
Søuïlløn,archimonde,1553,hunter,beastmastery,48,30,18
Zugmypole,stormscale,1553,hunter,beastmastery,84,44,40
Жмыххунтер,howling-fjord,1553,hunter,beastmastery,78,38,40
Lsa,kazzak,1553,hunter,beastmastery,95,40,55
Жокра,greymane,1553,hunter,beastmastery,61,25,36
Eaglexx,twisting-nether,1552,hunter,beastmastery,84,40,44
Asery,blackmoore,1552,hunter,beastmastery,60,25,35
Маунтдроп,gordunni,1551,hunter,beastmastery,231,122,109
Трэйсх,howling-fjord,1551,hunter,beastmastery,42,21,21
Тиблэк,soulflayer,1551,hunter,beastmastery,107,53,54
Толяарканшот,razuvious,1550,hunter,beastmastery,60,36,24
Fearmygun,grim-batol,1550,hunter,beastmastery,36,18,18
Haleth,uldum,1550,hunter,beastmastery,47,21,26
Камшотовна,blackscar,1549,hunter,beastmastery,205,114,91
Solot,silvermoon,1549,hunter,beastmastery,96,47,49
Sharún,sylvanas,1548,hunter,beastmastery,56,27,29
Hyunkies,ysondre,1548,hunter,beastmastery,71,30,41
Deadlysnîpe,antonidas,1547,hunter,beastmastery,46,26,20
Homesz,blackmoore,1547,hunter,beastmastery,46,25,21
Раелиин,gordunni,1546,hunter,beastmastery,37,21,16
Siegbald,ragnaros,1545,hunter,beastmastery,76,37,39
Spinella,antonidas,1545,hunter,beastmastery,185,90,95
Мунлэс,lich-king,1545,hunter,beastmastery,99,44,55
Xiioo,ravencrest,1544,hunter,beastmastery,119,53,66
Grusijohn,executus,1543,hunter,beastmastery,72,35,37
Ixix,blackhand,1543,hunter,beastmastery,81,37,44
Bigfoot,argent-dawn,1541,hunter,beastmastery,252,132,120
Dmanite,ravencrest,1541,hunter,beastmastery,180,90,90
Yoorizz,outland,1540,hunter,beastmastery,78,32,46
Ziathiel,draenor,1539,hunter,beastmastery,45,27,18
Lobos,ravencrest,1539,hunter,beastmastery,134,70,64
Crâsh,ysondre,1538,hunter,beastmastery,80,40,40
Антисерт,ashenvale,1538,hunter,beastmastery,70,33,37
Ileira,blackmoore,1538,hunter,beastmastery,73,34,39
Kürze,silvermoon,1537,hunter,beastmastery,151,81,70
Bortian,argent-dawn,1536,hunter,beastmastery,73,41,32
Ганидони,soulflayer,1536,hunter,beastmastery,115,49,66
Corrupth,outland,1535,hunter,beastmastery,43,22,21
Gunde,kazzak,1535,hunter,beastmastery,182,92,90
Avatarofwoe,blackmoore,1535,hunter,beastmastery,54,24,30
Rachelzane,blackrock,1534,hunter,beastmastery,30,16,14
Fanjah,sylvanas,1534,hunter,beastmastery,87,39,48
Уроборос,gordunni,1533,hunter,beastmastery,35,19,16
Lòò,aegwynn,1533,hunter,beastmastery,113,55,58
Sonìc,kazzak,1531,hunter,beastmastery,44,25,19
Wondersnipes,stormrage,1531,hunter,beastmastery,57,26,31
Massimox,draenor,1529,hunter,beastmastery,30,22,8
Nottberozz,silvermoon,1529,hunter,beastmastery,284,138,146
Yryyh,silvermoon,1529,hunter,beastmastery,90,41,49
Crippler,arthas,1528,hunter,beastmastery,46,29,17
Отерон,gordunni,1528,hunter,beastmastery,182,96,86
Tayaa,draenor,1528,hunter,beastmastery,91,47,44
Jagarbladet,ravencrest,1528,hunter,beastmastery,52,26,26
Onphonecall,kazzak,1527,hunter,beastmastery,36,20,16
Córelly,outland,1527,hunter,beastmastery,119,57,62
Синглшот,blackscar,1525,hunter,beastmastery,43,24,19
Bladestalker,trollbane,1525,hunter,beastmastery,60,32,28
Anklar,blackrock,1525,hunter,beastmastery,65,25,40
Nycrom,ravencrest,1524,hunter,beastmastery,62,29,33
Focüs,les-sentinelles,1523,hunter,beastmastery,24,16,8
Blakkablakka,eredar,1523,hunter,beastmastery,59,33,26
Sarrow,ravencrest,1523,hunter,beastmastery,77,41,36
Arthó,kazzak,1522,hunter,beastmastery,42,24,18
Crowsza,archimonde,1522,hunter,beastmastery,91,50,41
Lowfet,neptulon,1522,hunter,beastmastery,269,138,131
Renamexyz,blackmoore,1521,hunter,beastmastery,48,26,22
Cosmol,kazzak,1521,hunter,beastmastery,126,68,58
Gnouminøu,archimonde,1521,hunter,beastmastery,212,110,102
Assbúrgers,silvermoon,1521,hunter,beastmastery,118,60,58
Nallepuuoh,outland,1520,hunter,beastmastery,135,67,68
Оксанчек,howling-fjord,1520,hunter,beastmastery,47,17,30
Ханзолес,gordunni,1519,hunter,beastmastery,89,49,40
Lightcheese,twisting-nether,1518,hunter,beastmastery,48,23,25
Thieuu,twisting-nether,1518,hunter,beastmastery,36,17,19
Cajakekw,madmortem,1517,hunter,beastmastery,24,16,8
Soulthirsty,ravencrest,1517,hunter,beastmastery,144,69,75
Reijuan,doomhammer,1516,hunter,beastmastery,30,16,14
Кежма,howling-fjord,1515,hunter,beastmastery,54,32,22
Субоота,gordunni,1515,hunter,beastmastery,58,21,37
Trapyoubro,blackrock,1514,hunter,beastmastery,36,16,20
Recrent,kazzak,1513,hunter,beastmastery,48,33,15
Spidak,stormscale,1513,hunter,beastmastery,60,29,31
Xarhunt,azjolnerub,1512,hunter,beastmastery,24,16,8
Dhadhar,kazzak,1512,hunter,beastmastery,324,153,171
Pizzafanatic,blackrock,1511,hunter,beastmastery,30,16,14
Жажждущий,gordunni,1511,hunter,beastmastery,190,95,95
Lis,gorgonnash,1511,hunter,beastmastery,78,35,43
Johnwick,aerie-peak,1510,hunter,beastmastery,78,44,34
Engetsu,drakthul,1509,hunter,beastmastery,127,63,64
Анастазис,soulflayer,1509,hunter,beastmastery,36,17,19
Garfie,tarren-mill,1508,hunter,beastmastery,32,17,15
Стэпси,gordunni,1506,hunter,beastmastery,56,23,33
Gerentral,burning-legion,1505,hunter,beastmastery,106,58,48
Spizglub,defias-brotherhood,1504,hunter,beastmastery,83,43,40
Icetrapped,eredar,1502,hunter,beastmastery,41,25,16
Bujie,ragnaros,1502,hunter,beastmastery,42,16,26
Zevlove,kazzak,1501,hunter,beastmastery,74,32,42
Яроняютрапу,gordunni,1500,hunter,beastmastery,52,33,19
Ryuwen,dun-modr,1499,hunter,beastmastery,142,68,74
Kalt,twisting-nether,1498,hunter,beastmastery,70,41,29
Jannolafrite,ysondre,1498,hunter,beastmastery,68,33,35
Moistmán,kazzak,1498,hunter,beastmastery,260,126,134
Flytomars,ravencrest,1498,hunter,beastmastery,41,18,23
Palaur,kazzak,1496,hunter,beastmastery,190,97,93
Holdmypurse,kazzak,1496,hunter,beastmastery,42,18,24
Mêshuggah,ravencrest,1495,hunter,beastmastery,54,30,24
Funkalation,ravencrest,1495,hunter,beastmastery,36,20,16
Pennymarks,blackhand,1494,hunter,beastmastery,74,36,38
Ledrox,ravencrest,1494,hunter,beastmastery,90,42,48
Jeeso,baelgun,1494,hunter,beastmastery,189,88,101
Arslan,archimonde,1493,hunter,beastmastery,39,19,20
Raxedo,blackrock,1492,hunter,beastmastery,50,25,25
Zeniar,pozzo-delleternità,1492,hunter,beastmastery,83,40,43
Pewmasters,stormscale,1492,hunter,beastmastery,79,37,42
Pufyrella,kilrogg,1491,hunter,beastmastery,78,43,35
Shantala,frostwolf,1490,hunter,beastmastery,72,40,32
Idetylem,burning-legion,1490,hunter,beastmastery,84,44,40
Честнный,howling-fjord,1490,hunter,beastmastery,310,153,157
Almogrote,sanguino,1490,hunter,beastmastery,90,43,47
Nätzz,dun-modr,1490,hunter,beastmastery,65,31,34
Luckissues,argent-dawn,1490,hunter,beastmastery,42,20,22
Бей,gordunni,1490,hunter,beastmastery,73,33,40
Лёт,azuregos,1489,hunter,beastmastery,80,45,35
Laoriane,hyjal,1489,hunter,beastmastery,51,28,23
Vimd,archimonde,1489,hunter,beastmastery,89,45,44
Chenony,ravencrest,1489,hunter,beastmastery,84,38,46
Рэттс,soulflayer,1488,hunter,beastmastery,122,63,59
Kasperhawser,silvermoon,1488,hunter,beastmastery,42,21,21
Heoden,nemesis,1488,hunter,beastmastery,66,32,34
Сотк,howling-fjord,1488,hunter,beastmastery,65,28,37
Smitheye,argent-dawn,1487,hunter,beastmastery,60,31,29
Vescar,argent-dawn,1487,hunter,beastmastery,54,17,37
Druckwelle,frostwolf,1486,hunter,beastmastery,120,54,66
Stòkke,stormscale,1486,hunter,beastmastery,60,25,35
Luniel,gilneas,1485,hunter,beastmastery,36,21,15
Ahlgood,stormscale,1484,hunter,beastmastery,30,16,14
Sylvænæs,stormscale,1483,hunter,beastmastery,87,42,45
Делар,howling-fjord,1483,hunter,beastmastery,68,29,39
Budhunter,alakir,1481,hunter,beastmastery,169,88,81
Tukene,kazzak,1481,hunter,beastmastery,57,22,35
Zantorious,ravencrest,1480,hunter,beastmastery,99,59,40
Sindørei,lightbringer,1480,hunter,beastmastery,39,21,18
Váal,dun-modr,1479,hunter,beastmastery,85,49,36
Lokiis,hyjal,1479,hunter,beastmastery,138,75,63
Кривоватый,galakrond,1479,hunter,beastmastery,30,16,14
Dirtydolores,thrall,1478,hunter,beastmastery,41,24,17
Glorfindhel,archimonde,1478,hunter,beastmastery,108,59,49
Valldes,argent-dawn,1478,hunter,beastmastery,75,33,42
Gumm,gorgonnash,1477,hunter,beastmastery,120,60,60
Аллони,booty-bay,1477,hunter,beastmastery,189,90,99
Aenina,kazzak,1476,hunter,beastmastery,78,43,35
Gaiä,sanguino,1476,hunter,beastmastery,42,22,20
Чапуршилов,lich-king,1476,hunter,beastmastery,279,140,139
Pego,grim-batol,1476,hunter,beastmastery,61,29,32
Djbombastic,archimonde,1475,hunter,beastmastery,72,42,30
Снюсинка,gordunni,1475,hunter,beastmastery,88,44,44
Cabal,alleria,1474,hunter,beastmastery,43,21,22
Enty,blackrock,1473,hunter,beastmastery,26,17,9
Wingclip,ravencrest,1472,hunter,beastmastery,40,17,23
Bastianapa,twisting-nether,1471,hunter,beastmastery,66,31,35
Эмомото,howling-fjord,1471,hunter,beastmastery,60,26,34
Bogüen,sanguino,1470,hunter,beastmastery,66,33,33
Ñápøléóñ,draenor,1469,hunter,beastmastery,30,18,12
Sylariel,die-aldor,1469,hunter,beastmastery,46,23,23
Lascazador,dun-modr,1469,hunter,beastmastery,80,33,47
Варсор,soulflayer,1468,hunter,beastmastery,42,18,24
Dzikabestia,burning-legion,1467,hunter,beastmastery,36,21,15
Leriath,shadowsong,1466,hunter,beastmastery,149,82,67
Råhl,zuljin,1466,hunter,beastmastery,41,17,24
Ângell,kirin-tor,1465,hunter,beastmastery,54,22,32
Kibola,antonidas,1465,hunter,beastmastery,72,29,43
Viktorijå,draenor,1464,hunter,beastmastery,59,35,24
Halfogre,draenor,1464,hunter,beastmastery,36,18,18
Measpy,blackrock,1462,hunter,beastmastery,48,28,20
Зимняясказка,soulflayer,1461,hunter,beastmastery,48,19,29
Zäroury,ravencrest,1458,hunter,beastmastery,88,39,49
Mufdii,sylvanas,1457,hunter,beastmastery,34,16,18
Desow,blackrock,1456,hunter,beastmastery,84,49,35
Рэмпейджшот,soulflayer,1455,hunter,beastmastery,42,24,18
Dramin,defias-brotherhood,1455,hunter,beastmastery,239,128,111
Anca,aegwynn,1454,hunter,beastmastery,213,105,108
Crispystix,draenor,1454,hunter,beastmastery,35,16,19
Naramir,ysondre,1453,hunter,beastmastery,33,18,15
Rdom,stormreaver,1453,hunter,beastmastery,180,89,91
Freebïrd,shattered-hand,1453,hunter,beastmastery,54,25,29
Хедшоттер,blackscar,1453,hunter,beastmastery,38,17,21
Туруханец,gordunni,1452,hunter,beastmastery,266,142,124
Dzördzo,kazzak,1452,hunter,beastmastery,48,21,27
Anjeschka,nemesis,1451,hunter,beastmastery,64,37,27
Гернриета,gordunni,1451,hunter,beastmastery,78,37,41
Acmé,kazzak,1451,hunter,beastmastery,54,22,32
Ynfik,sinstralis,1450,hunter,beastmastery,130,70,60
Shawnrai,drakthul,1449,hunter,beastmastery,44,24,20
Bambamgalke,antonidas,1449,hunter,beastmastery,131,66,65
Vaelyste,doomhammer,1449,hunter,beastmastery,127,63,64
Wolfyx,cthun,1449,hunter,beastmastery,66,28,38
Jarekk,auchindoun,1446,hunter,beastmastery,91,48,43
Vypaz,twisting-nether,1446,hunter,beastmastery,60,30,30
Drigs,blackrock,1445,hunter,beastmastery,117,59,58
Whazupdude,drakthul,1444,hunter,beastmastery,53,34,19
Toxical,ragnaros,1444,hunter,beastmastery,42,26,16
Metrolog,twisting-nether,1444,hunter,beastmastery,117,57,60
Loyuf,burning-blade,1443,hunter,beastmastery,39,20,19
Trapwann,argent-dawn,1443,hunter,beastmastery,98,46,52
Фдкд,howling-fjord,1442,hunter,beastmastery,134,62,72
Makaxx,stormscale,1441,hunter,beastmastery,49,31,18
Dêstiny,dun-modr,1441,hunter,beastmastery,60,35,25
Vasu,azjolnerub,1440,hunter,beastmastery,72,41,31
Rifle,dun-morogh,1440,hunter,beastmastery,58,29,29
Leáa,eredar,1439,hunter,beastmastery,54,27,27
Syniix,ravencrest,1439,hunter,beastmastery,30,15,15
Draugrinnh,tarren-mill,1439,hunter,beastmastery,72,29,43
Tràpz,archimonde,1439,hunter,beastmastery,57,22,35
Luluxfire,burning-legion,1438,hunter,beastmastery,64,30,34
Tokyodripztv,drakthul,1437,hunter,beastmastery,48,27,21
Khatia,blackrock,1437,hunter,beastmastery,42,21,21
Xenvantos,silvermoon,1437,hunter,beastmastery,30,15,15
Juha,the-maelstrom,1437,hunter,beastmastery,57,28,29
Secretagent,zenedar,1436,hunter,beastmastery,30,16,14
Kayoo,stormscale,1436,hunter,beastmastery,54,20,34
Mágaz,draenor,1435,hunter,beastmastery,48,26,22
Wüst,tarren-mill,1435,hunter,beastmastery,30,16,14
Wøden,ysondre,1435,hunter,beastmastery,117,51,66
Застрельщикц,soulflayer,1434,hunter,beastmastery,72,41,31
Rachelicious,ravencrest,1434,hunter,beastmastery,30,15,15
Mdmalol,malganis,1433,hunter,beastmastery,30,15,15
Galduhr,silvermoon,1433,hunter,beastmastery,36,16,20
Dyve,antonidas,1433,hunter,beastmastery,60,25,35
Vhalín,magtheridon,1433,hunter,beastmastery,36,15,21
Tipsü,blackmoore,1432,hunter,beastmastery,45,25,20
Arrowman,burning-legion,1432,hunter,beastmastery,42,22,20
Pixxeel,khaz-modan,1432,hunter,beastmastery,36,18,18
Gbureczka,burning-legion,1432,hunter,beastmastery,68,29,39
Duïvell,grim-batol,1432,hunter,beastmastery,36,15,21
Noréaga,suramar,1431,hunter,beastmastery,36,20,16
Zäyk,zuljin,1431,hunter,beastmastery,79,42,37
Jaxteller,archimonde,1431,hunter,beastmastery,30,15,15
Velites,aggra-português,1430,hunter,beastmastery,57,27,30
Natchell,ysondre,1429,hunter,beastmastery,30,15,15
Yoggys,outland,1429,hunter,beastmastery,95,47,48
Ayyubi,blackrock,1428,hunter,beastmastery,89,44,45
Toosmall,stormscale,1427,hunter,beastmastery,58,33,25
Eufumo,sanguino,1427,hunter,beastmastery,88,48,40
Steezowl,kazzak,1427,hunter,beastmastery,33,17,16
Necromercy,burning-legion,1426,hunter,beastmastery,76,41,35
Зуланария,howling-fjord,1426,hunter,beastmastery,100,49,51
Clickbile,twisting-nether,1426,hunter,beastmastery,32,15,17
Хипдо,soulflayer,1426,hunter,beastmastery,48,15,33
Bibsy,tarren-mill,1425,hunter,beastmastery,35,19,16
Tasdiingo,tarren-mill,1423,hunter,beastmastery,48,20,28
Beorind,frostwolf,1422,hunter,beastmastery,24,15,9
Mytown,hyjal,1422,hunter,beastmastery,227,113,114
Shieryu,archimonde,1422,hunter,beastmastery,78,33,45
Торая,gordunni,1421,hunter,beastmastery,30,15,15
Medûse,stormscale,1420,hunter,beastmastery,79,40,39
Mariehunt,blackmoore,1420,hunter,beastmastery,108,52,56
Graavi,silvermoon,1420,hunter,beastmastery,45,18,27
Crynomore,tarren-mill,1418,hunter,beastmastery,68,41,27
Crossjob,kazzak,1417,hunter,beastmastery,48,25,23
Andjelaa,kazzak,1417,hunter,beastmastery,38,19,19
Thorkron,sanguino,1417,hunter,beastmastery,30,15,15
Metalmaison,archimonde,1417,hunter,beastmastery,202,97,105
Lustor,ravencrest,1417,hunter,beastmastery,155,73,82
Zy,silvermoon,1416,hunter,beastmastery,30,15,15
Badkirves,kazzak,1416,hunter,beastmastery,109,50,59
Thyala,twisting-nether,1416,hunter,beastmastery,69,30,39
Бвонсамдик,howling-fjord,1415,hunter,beastmastery,76,39,37
Dogthebounty,tarren-mill,1414,hunter,beastmastery,43,25,18
Miracleh,tarren-mill,1414,hunter,beastmastery,42,22,20
Weiaw,blackmoore,1414,hunter,beastmastery,57,26,31
Metsänmies,defias-brotherhood,1413,hunter,beastmastery,52,31,21
Velocity,nagrand,1411,hunter,beastmastery,41,19,22
Batalul,twisting-nether,1410,hunter,beastmastery,48,29,19
Маянашашлыки,galakrond,1410,hunter,beastmastery,108,60,48
Hruon,sporeggar,1410,hunter,beastmastery,66,31,35
Earnzie,outland,1410,hunter,beastmastery,84,36,48
Focuslhunt,archimonde,1409,hunter,beastmastery,76,40,36
Дипшот,deathguard,1408,hunter,beastmastery,103,53,50
Andraz,burning-legion,1408,hunter,beastmastery,60,25,35
Стреладемона,gordunni,1407,hunter,beastmastery,75,43,32
Jas,kargath,1406,hunter,beastmastery,184,94,90
Taveon,turalyon,1406,hunter,beastmastery,56,28,28
Lännennopein,outland,1405,hunter,beastmastery,65,27,38
Tizzlbang,ragnaros,1404,hunter,beastmastery,30,17,13
Loógosh,blackmoore,1404,hunter,beastmastery,120,59,61
Glizzygobblr,kazzak,1404,hunter,beastmastery,62,29,33
Neíth,the-maelstrom,1404,hunter,beastmastery,129,60,69
Àrsaidh,draenor,1403,hunter,beastmastery,59,33,26
Джантига,howling-fjord,1403,hunter,beastmastery,54,30,24
Retropunk,ravencrest,1403,hunter,beastmastery,48,23,25
Xiaoly,kaelthas,1403,hunter,beastmastery,36,15,21
Ravis,aegwynn,1403,hunter,beastmastery,44,18,26
Môrkh,sanguino,1403,hunter,beastmastery,42,17,25
Rhee,the-maelstrom,1402,hunter,beastmastery,157,72,85
Elsasehunter,zuljin,1402,hunter,beastmastery,132,60,72
Geete,kazzak,1400,hunter,beastmastery,30,17,13
Lunaunii,argent-dawn,1400,hunter,beastmastery,36,20,16
Drestan,drakthul,1400,hunter,beastmastery,96,47,49
Phinecone,stormscale,1399,hunter,beastmastery,42,18,24
Flunkytim,blackmoore,1398,hunter,beastmastery,108,58,50
Napa,kazzak,1396,hunter,beastmastery,29,16,13
Artemisas,draenor,1396,hunter,beastmastery,60,23,37
Belorgrim,kirin-tor,1395,hunter,beastmastery,90,49,41
Беспокойный,soulflayer,1395,hunter,beastmastery,71,31,40
Xystîco,thrall,1394,hunter,beastmastery,66,32,34
Mââl,archimonde,1394,hunter,beastmastery,36,16,20
Бубунн,howling-fjord,1394,hunter,beastmastery,96,42,54
Blàdê,blackrock,1393,hunter,beastmastery,30,15,15
Гиладар,borean-tundra,1393,hunter,beastmastery,69,33,36
Hiðe,archimonde,1393,hunter,beastmastery,61,25,36
Câonimâ,twisting-nether,1392,hunter,beastmastery,90,46,44
Sníper,aggra-português,1392,hunter,beastmastery,125,58,67
Шионо,howling-fjord,1391,hunter,beastmastery,56,29,27
Traktorr,stormscale,1391,hunter,beastmastery,102,50,52
Ázurâ,blackhand,1390,hunter,beastmastery,86,42,44
Bigbababotan,blackrock,1390,hunter,beastmastery,45,20,25
Straybullet,kazzak,1389,hunter,beastmastery,284,142,142
Kareltje,stormscale,1388,hunter,beastmastery,37,21,16
Афигеннски,ashenvale,1387,hunter,beastmastery,54,25,29
Adram,burning-legion,1386,hunter,beastmastery,29,16,13
Hammertime,sanguino,1385,hunter,beastmastery,114,58,56
Reiign,burning-legion,1385,hunter,beastmastery,59,24,35
Xüscha,ysera,1384,hunter,beastmastery,152,69,83
Curtiss,sanguino,1384,hunter,beastmastery,56,25,31
Кулинарк,howling-fjord,1383,hunter,beastmastery,94,50,44
Waalth,ragnaros,1381,hunter,beastmastery,166,81,85
Beardmastery,auchindoun,1380,hunter,beastmastery,36,16,20
Фожа,howling-fjord,1379,hunter,beastmastery,110,47,63
Skribez,blackmoore,1378,hunter,beastmastery,59,32,27
Vachekiki,archimonde,1377,hunter,beastmastery,77,52,25
Ikschietjou,frostmane,1377,hunter,beastmastery,83,45,38
Dybhalsma,outland,1377,hunter,beastmastery,29,15,14
Sørha,chogall,1376,hunter,beastmastery,26,17,9
Афонадзе,gordunni,1376,hunter,beastmastery,140,67,73
Хлопс,howling-fjord,1376,hunter,beastmastery,36,16,20
Haggy,die-nachtwache,1375,hunter,beastmastery,30,16,14
Фетсол,soulflayer,1375,hunter,beastmastery,54,28,26
Vruh,antonidas,1374,hunter,beastmastery,43,22,21
Esgar,blackrock,1374,hunter,beastmastery,74,34,40
Texaco,dun-modr,1374,hunter,beastmastery,55,25,30
Bøwjøb,arthas,1373,hunter,beastmastery,74,42,32
Зихантер,soulflayer,1372,hunter,beastmastery,50,24,26
Retroxia,stormreaver,1370,hunter,beastmastery,42,24,18
Шуггарэй,soulflayer,1370,hunter,beastmastery,41,17,24
Нариса,soulflayer,1369,hunter,beastmastery,36,18,18
Yayoo,cthun,1369,hunter,beastmastery,77,31,46
Jaky,illidan,1368,hunter,beastmastery,179,104,75
Vivako,silvermoon,1368,hunter,beastmastery,66,35,31
Demónhunter,frostmane,1368,hunter,beastmastery,38,16,22
Анариэльсин,soulflayer,1368,hunter,beastmastery,36,15,21
Ubietza,aegwynn,1367,hunter,beastmastery,260,125,135
Dunkelmut,arthas,1367,hunter,beastmastery,36,15,21
Beletor,medivh,1365,hunter,beastmastery,30,15,15
Dzikapumpa,burning-legion,1363,hunter,beastmastery,69,29,40
Saromán,ravencrest,1362,hunter,beastmastery,42,23,19
Tåxi,silvermoon,1362,hunter,beastmastery,207,102,105
Soulflyer,draenor,1362,hunter,beastmastery,55,23,32
Gabbriel,ravencrest,1361,hunter,beastmastery,49,30,19
Kiingsane,archimonde,1361,hunter,beastmastery,55,23,32
Kënpachi,silvermoon,1360,hunter,beastmastery,52,22,30
Devøurer,blackmoore,1359,hunter,beastmastery,42,21,21
Бедствиие,galakrond,1359,hunter,beastmastery,127,57,70
Diablohuntt,burning-legion,1359,hunter,beastmastery,51,16,35
Zúzú,hyjal,1358,hunter,beastmastery,54,32,22
Erenjaeger,onyxia,1356,hunter,beastmastery,72,43,29
Halgen,medivh,1355,hunter,beastmastery,140,67,73
Xndr,sanguino,1354,hunter,beastmastery,24,15,9
Фузег,deathguard,1353,hunter,beastmastery,257,130,127
Shädoh,outland,1353,hunter,beastmastery,48,24,24
Bufosh,twisting-nether,1352,hunter,beastmastery,139,74,65
Сатарр,gordunni,1351,hunter,beastmastery,208,101,107
Cfueb,doomhammer,1351,hunter,beastmastery,42,15,27
Elanimal,blackmoore,1350,hunter,beastmastery,52,24,28
Boulaax,ysondre,1349,hunter,beastmastery,136,73,63
Neescafe,sylvanas,1349,hunter,beastmastery,83,42,41
Кэрнел,gordunni,1349,hunter,beastmastery,71,34,37
Lootgobbo,antonidas,1349,hunter,beastmastery,63,30,33
Joshalama,quelthalas,1348,hunter,beastmastery,64,34,30
Amitar,tarren-mill,1347,hunter,beastmastery,60,33,27
Sebastien,frostmane,1347,hunter,beastmastery,33,17,16
Grrizzly,kazzak,1347,hunter,beastmastery,61,31,30
Hogar,frostwolf,1347,hunter,beastmastery,38,17,21
Zelarun,ragnaros,1345,hunter,beastmastery,42,24,18
Radley,conseil-des-ombres,1345,hunter,beastmastery,42,21,21
Ловихимеру,soulflayer,1345,hunter,beastmastery,78,37,41
Rafizox,kazzak,1343,hunter,beastmastery,24,14,10
Raymear,kazzak,1343,hunter,beastmastery,92,45,47
Slippytoad,kazzak,1342,hunter,beastmastery,18,14,4
Инойхохо,gordunni,1342,hunter,beastmastery,18,14,4
Grandiosity,tarren-mill,1342,hunter,beastmastery,47,29,18
Onlyforfun,ravencrest,1342,hunter,beastmastery,24,14,10
Чизано,deathguard,1342,hunter,beastmastery,53,25,28
Bonobo,dentarg,1342,hunter,beastmastery,30,14,16
Лиор,howling-fjord,1342,hunter,beastmastery,153,68,85
Chuntardi,stormscale,1342,hunter,beastmastery,36,14,22
Keoph,tarren-mill,1342,hunter,beastmastery,36,14,22
Swâân,sanguino,1341,hunter,beastmastery,39,20,19
Missmytrap,archimonde,1340,hunter,beastmastery,18,14,4
Karuso,ravencrest,1340,hunter,beastmastery,30,14,16
Meskette,ravencrest,1340,hunter,beastmastery,70,30,40
Swargano,archimonde,1339,hunter,beastmastery,48,16,32
Võnbødefeld,frostmourne,1338,hunter,beastmastery,46,24,22
Дафирия,deathguard,1338,hunter,beastmastery,124,62,62
Стрелывалеры,gordunni,1338,hunter,beastmastery,36,14,22
Декгардпро,blackscar,1336,hunter,beastmastery,30,14,16
Bláckheart,doomhammer,1336,hunter,beastmastery,38,16,22
Notikâ,aegwynn,1336,hunter,beastmastery,48,20,28
Bågeniburen,draenor,1335,hunter,beastmastery,44,23,21
Marleyson,uldum,1335,hunter,beastmastery,54,27,27
Pammycakes,bronze-dragonflight,1335,hunter,beastmastery,194,96,98
Ххун,gordunni,1335,hunter,beastmastery,94,44,50
Raythe,argent-dawn,1335,hunter,beastmastery,30,14,16
Huntercheese,ravencrest,1334,hunter,beastmastery,41,23,18
Kaaj,nemesis,1334,hunter,beastmastery,30,16,14
Дэментед,soulflayer,1333,hunter,beastmastery,30,14,16
Шурикцаревич,galakrond,1333,hunter,beastmastery,66,23,43
Гримкааг,eversong,1332,hunter,beastmastery,102,56,46
Cryptstalkér,antonidas,1332,hunter,beastmastery,36,18,18
Ninjaskillss,ravencrest,1331,hunter,beastmastery,30,17,13
Цумочка,blackscar,1331,hunter,beastmastery,35,18,17
Tonk,garrosh,1331,hunter,beastmastery,72,32,40
Midist,stormscale,1330,hunter,beastmastery,30,14,16
Blastarrow,the-maelstrom,1330,hunter,beastmastery,102,46,56
Eagletalon,twisting-nether,1330,hunter,beastmastery,79,34,45
Bessa,skullcrusher,1329,hunter,beastmastery,78,41,37
Unrealy,grim-batol,1329,hunter,beastmastery,235,119,116
Сашатетива,gordunni,1329,hunter,beastmastery,30,14,16
Feignindeath,twisting-nether,1328,hunter,beastmastery,60,35,25
Hantro,argent-dawn,1327,hunter,beastmastery,60,33,27
Magrha,khaz-modan,1327,hunter,beastmastery,63,34,29
Rogg,destromath,1327,hunter,beastmastery,28,15,13
Hílfíger,kazzak,1327,hunter,beastmastery,89,37,52
Tsivoula,twisting-nether,1326,hunter,beastmastery,35,21,14
Ахотакрепкая,gordunni,1326,hunter,beastmastery,24,14,10
Hardo,guldan,1326,hunter,beastmastery,60,30,30
Dotkor,laughing-skull,1325,hunter,beastmastery,168,86,82
Rabyan,zuljin,1325,hunter,beastmastery,81,32,49
Holdmabeerx,silvermoon,1324,hunter,beastmastery,45,20,25
Sélenaé,hyjal,1324,hunter,beastmastery,58,24,34
Settisetä,defias-brotherhood,1323,hunter,beastmastery,24,14,10
Platzpatron,eredar,1323,hunter,beastmastery,132,62,70
Twinshot,anetheron,1322,hunter,beastmastery,102,56,46
Waidø,blackhand,1321,hunter,beastmastery,48,25,23
Travels,tarren-mill,1320,hunter,beastmastery,165,82,83
Eéilin,the-maelstrom,1320,hunter,beastmastery,46,22,24
Ríckybobby,kazzak,1319,hunter,beastmastery,43,22,21
Halessia,ravencrest,1318,hunter,beastmastery,190,94,96
Хантвкроксах,gordunni,1317,hunter,beastmastery,38,18,20
Gamosh,anetheron,1317,hunter,beastmastery,60,25,35
Tyssar,kazzak,1317,hunter,beastmastery,53,22,31
Macabremoon,silvermoon,1316,hunter,beastmastery,24,14,10
Angrypickle,defias-brotherhood,1315,hunter,beastmastery,105,52,53
Rushgarroth,ravencrest,1315,hunter,beastmastery,138,67,71
Кровавыйсэм,howling-fjord,1315,hunter,beastmastery,42,14,28
Имбакласс,howling-fjord,1314,hunter,beastmastery,24,15,9
Ridlas,silvermoon,1314,hunter,beastmastery,201,102,99
Øßlíck,ysondre,1314,hunter,beastmastery,30,14,16
Nomadest,silvermoon,1313,hunter,beastmastery,24,14,10
Meredo,burning-legion,1313,hunter,beastmastery,64,33,31
Dùmbo,khaz-modan,1313,hunter,beastmastery,96,46,50
Konghans,ravencrest,1313,hunter,beastmastery,83,38,45
Baileé,onyxia,1312,hunter,beastmastery,80,40,40
Вижусвет,howling-fjord,1311,hunter,beastmastery,66,35,31
Люблюлюбовь,gordunni,1310,hunter,beastmastery,42,27,15
Талигар,razuvious,1310,hunter,beastmastery,135,59,76
Goethe,ravencrest,1309,hunter,beastmastery,42,22,20
Élenas,confrérie-du-thorium,1309,hunter,beastmastery,36,17,19
Aneji,hyjal,1308,hunter,beastmastery,86,45,41
Герциг,gordunni,1306,hunter,beastmastery,40,20,20
Expulse,eredar,1305,hunter,beastmastery,18,14,4
Showerhead,silvermoon,1305,hunter,beastmastery,32,14,18
Sillychilly,frostwolf,1305,hunter,beastmastery,45,17,28
Эннабонни,gordunni,1304,hunter,beastmastery,60,29,31
Soen,zuljin,1304,hunter,beastmastery,70,32,38
Hoffarex,grim-batol,1304,hunter,beastmastery,42,18,24
Ziday,sargeras,1304,hunter,beastmastery,42,16,26
Felorya,kazzak,1303,hunter,beastmastery,58,30,28
Coxxie,ragnaros,1303,hunter,beastmastery,51,24,27
Karên,blackmoore,1303,hunter,beastmastery,41,19,22
Zerisi,silvermoon,1302,hunter,beastmastery,41,25,16
Bãldur,ravencrest,1301,hunter,beastmastery,34,17,17
Ivvy,defias-brotherhood,1301,hunter,beastmastery,48,23,25
Zamale,arakarahm,1300,hunter,beastmastery,54,24,30
Druvnik,zenedar,1300,hunter,beastmastery,60,26,34
Румлис,gordunni,1299,hunter,beastmastery,111,62,49
Birdseye,thrall,1299,hunter,beastmastery,60,29,31
Пиворк,soulflayer,1299,hunter,beastmastery,59,20,39
Magarosh,eredar,1298,hunter,beastmastery,30,14,16
Buc,burning-legion,1298,hunter,beastmastery,64,22,42
Blackdingo,lightnings-blade,1296,hunter,beastmastery,24,14,10
Mînérvá,blackhand,1296,hunter,beastmastery,42,22,20
Asousa,stormscale,1296,hunter,beastmastery,78,39,39
Lovecjelenu,drakthul,1296,hunter,beastmastery,49,20,29
Paînfull,kazzak,1296,hunter,beastmastery,35,14,21
Tbeck,ragnaros,1295,hunter,beastmastery,36,16,20
Xéraphine,mannoroth,1295,hunter,beastmastery,127,55,72
Nyght,ravencrest,1294,hunter,beastmastery,134,63,71
Ommadawn,dun-modr,1292,hunter,beastmastery,83,40,43
Cabuløsø,aggra-português,1291,hunter,beastmastery,54,29,25
Tidydarts,balnazzar,1291,hunter,beastmastery,43,22,21
Sueky,dun-modr,1290,hunter,beastmastery,24,14,10
Shaznak,argent-dawn,1290,hunter,beastmastery,48,25,23
Kideyosi,silvermoon,1290,hunter,beastmastery,85,38,47
Oneshotkill,laughing-skull,1289,hunter,beastmastery,48,26,22
Cêleste,kaelthas,1289,hunter,beastmastery,128,64,64
Verathelon,drakthul,1288,hunter,beastmastery,69,35,34
Bourrinax,kazzak,1288,hunter,beastmastery,151,75,76
Râxxis,alleria,1288,hunter,beastmastery,77,35,42
Keinzira,hyjal,1288,hunter,beastmastery,53,24,29
Бирмингем,ashenvale,1287,hunter,beastmastery,96,48,48
Sbegodx,hyjal,1287,hunter,beastmastery,195,96,99
Yoüllsuffer,twisting-nether,1285,hunter,beastmastery,36,15,21
Фитьфитий,howling-fjord,1284,hunter,beastmastery,70,37,33
Дзэнмашина,booty-bay,1284,hunter,beastmastery,110,55,55
Nymmbtw,tarren-mill,1281,hunter,beastmastery,41,22,19
Nelthara,burning-blade,1281,hunter,beastmastery,36,15,21
Анютикус,gordunni,1280,hunter,beastmastery,72,43,29
Chagaure,hyjal,1280,hunter,beastmastery,60,25,35
Балласкиндер,gordunni,1279,hunter,beastmastery,82,46,36
Fenstad,dalaran,1279,hunter,beastmastery,52,25,27
Random,sylvanas,1278,hunter,beastmastery,32,15,17
Darkdexou,defias-brotherhood,1277,hunter,beastmastery,24,14,10
Drothani,argent-dawn,1277,hunter,beastmastery,48,17,31
Nerdhark,hyjal,1276,hunter,beastmastery,105,50,55
Grumpyhuntér,draenor,1272,hunter,beastmastery,30,15,15
Edùens,ysondre,1272,hunter,beastmastery,213,104,109
Скелус,soulflayer,1271,hunter,beastmastery,30,15,15
Drowranger,frostwolf,1271,hunter,beastmastery,65,30,35
Безос,soulflayer,1270,hunter,beastmastery,44,23,21
Basìcs,nemesis,1270,hunter,beastmastery,179,90,89
Shadowmiz,shattered-hand,1270,hunter,beastmastery,50,23,27
Footsy,twisting-nether,1270,hunter,beastmastery,54,24,30
Watntietjes,burning-blade,1270,hunter,beastmastery,66,29,37
Øï,outland,1269,hunter,beastmastery,56,24,32
Oogyboogy,draenor,1269,hunter,beastmastery,35,14,21
Melèxè,ysondre,1269,hunter,beastmastery,47,18,29
Whatifany,tarren-mill,1268,hunter,beastmastery,102,41,61
Тысячиимен,gordunni,1267,hunter,beastmastery,30,16,14
Salvia,chromaggus,1267,hunter,beastmastery,266,135,131
Krasavcik,shattrath,1264,hunter,beastmastery,24,14,10
Rxr,kazzak,1264,hunter,beastmastery,54,17,37
Lusifa,antonidas,1263,hunter,beastmastery,123,65,58
Vådesskudd,outland,1262,hunter,beastmastery,60,35,25
Pêvépê,silvermoon,1261,hunter,beastmastery,48,29,19
Filluu,dalaran,1261,hunter,beastmastery,48,24,24
Барбарисовна,ashenvale,1260,hunter,beastmastery,89,38,51
Gheezana,blackhand,1260,hunter,beastmastery,36,14,22
Аквилеон,gordunni,1260,hunter,beastmastery,40,15,25
Slojork,thrall,1259,hunter,beastmastery,300,146,154
Cdorak,zuljin,1259,hunter,beastmastery,53,25,28
Diac,dalaran,1258,hunter,beastmastery,30,19,11
Mentera,doomhammer,1258,hunter,beastmastery,30,16,14
Zalacko,ragnaros,1258,hunter,beastmastery,30,15,15
Fahin,draenor,1256,hunter,beastmastery,130,62,68
Nårgai,kargath,1255,hunter,beastmastery,108,56,52
Ïnayä,dalaran,1255,hunter,beastmastery,52,26,26
Taemper,azshara,1255,hunter,beastmastery,54,26,28
Linchpin,dentarg,1255,hunter,beastmastery,62,28,34
Kaktus,shattered-hand,1254,hunter,beastmastery,30,15,15
Vavabxl,ysondre,1254,hunter,beastmastery,30,14,16
Míoo,antonidas,1254,hunter,beastmastery,36,14,22
Graltar,tarren-mill,1253,hunter,beastmastery,110,59,51
Lioness,ahnqiraj,1252,hunter,beastmastery,51,23,28
Woriodhuntz,twisting-nether,1251,hunter,beastmastery,79,39,40
Snípér,blackhand,1251,hunter,beastmastery,60,26,34
Древнинко,greymane,1251,hunter,beastmastery,42,15,27
Michaelvm,ravencrest,1250,hunter,beastmastery,47,24,23
Nesthor,sinstralis,1250,hunter,beastmastery,58,26,32
Deblaze,aegwynn,1248,hunter,beastmastery,24,13,11
Monodeguyabo,sanguino,1248,hunter,beastmastery,30,14,16
Oliene,twisting-nether,1248,hunter,beastmastery,58,27,31
Kermitjump,drakthul,1248,hunter,beastmastery,92,42,50
Ðowz,ysondre,1248,hunter,beastmastery,30,13,17
Lagich,sylvanas,1247,hunter,beastmastery,30,13,17
Omarah,sanguino,1247,hunter,beastmastery,53,21,32
Dravara,blackmoore,1246,hunter,beastmastery,118,63,55
Eluun,saurfang,1246,hunter,beastmastery,47,23,24
Sâtaria,blackhand,1246,hunter,beastmastery,31,15,16
Ivanoé,archimonde,1246,hunter,beastmastery,30,13,17
Jablaka,blackhand,1245,hunter,beastmastery,197,95,102
Iamedward,silvermoon,1242,hunter,beastmastery,49,31,18
Flugsmälla,kazzak,1242,hunter,beastmastery,24,13,11
Skytraped,hyjal,1242,hunter,beastmastery,24,13,11
Arkelion,argent-dawn,1242,hunter,beastmastery,24,13,11
Papramorgóó,ragnaros,1241,hunter,beastmastery,34,14,20
Хастла,greymane,1240,hunter,beastmastery,30,13,17
Blazeityolo,outland,1240,hunter,beastmastery,36,13,23
Puska,gilneas,1239,hunter,beastmastery,117,59,58
Денвиин,deathweaver,1239,hunter,beastmastery,30,13,17
Bmazor,silvermoon,1238,hunter,beastmastery,18,13,5
Pitton,tarren-mill,1238,hunter,beastmastery,24,17,7
Zyhraa,ravencrest,1238,hunter,beastmastery,24,13,11
Killshotovna,stormscale,1238,hunter,beastmastery,24,13,11
Lurigalinda,twisting-nether,1237,hunter,beastmastery,30,13,17
Huntardxx,outland,1237,hunter,beastmastery,30,13,17
Deathwallker,silvermoon,1236,hunter,beastmastery,24,13,11
Ázèrøñå,draenor,1235,hunter,beastmastery,18,13,5
Шмыгахант,gordunni,1235,hunter,beastmastery,30,13,17
Jyenety,stormscale,1234,hunter,beastmastery,54,27,27
Benbutton,antonidas,1234,hunter,beastmastery,58,27,31
Sackboy,thrall,1233,hunter,beastmastery,33,16,17
Bisschen,azshara,1232,hunter,beastmastery,106,51,55
Jegeralv,argent-dawn,1232,hunter,beastmastery,92,36,56
Aguerex,alleria,1232,hunter,beastmastery,42,14,28
Skidzo,alakir,1231,hunter,beastmastery,32,15,17
Lowpital,hyjal,1230,hunter,beastmastery,30,13,17
Dariatate,eredar,1229,hunter,beastmastery,64,34,30
Sauce,alonsus,1228,hunter,beastmastery,36,13,23
Zercore,echsenkessel,1227,hunter,beastmastery,65,32,33
Penthesîlea,aegwynn,1227,hunter,beastmastery,133,63,70
Arseniic,dalaran,1227,hunter,beastmastery,34,14,20
Qmbonboni,ravencrest,1226,hunter,beastmastery,55,32,23
Spíke,tarren-mill,1225,hunter,beastmastery,18,13,5
Toralfmoralf,aegwynn,1225,hunter,beastmastery,24,13,11
Davíncí,tarren-mill,1224,hunter,beastmastery,77,41,36
Neeske,sylvanas,1224,hunter,beastmastery,30,13,17
Tsoutsoukoss,silvermoon,1223,hunter,beastmastery,247,126,121
Deunan,shattered-hand,1223,hunter,beastmastery,96,48,48
Bravestarr,blades-edge,1223,hunter,beastmastery,90,42,48
Noaim,blackrock,1222,hunter,beastmastery,26,14,12
Annisaqt,kazzak,1222,hunter,beastmastery,59,31,28
Vexhh,outland,1221,hunter,beastmastery,24,13,11
Lore,hyjal,1221,hunter,beastmastery,29,14,15
Biggbazzaa,aggramar,1221,hunter,beastmastery,71,32,39
Ililivillumi,tarren-mill,1220,hunter,beastmastery,49,27,22
Huntiio,khaz-modan,1220,hunter,beastmastery,84,41,43
Sisilianno,khaz-modan,1219,hunter,beastmastery,48,26,22
Wolfyh,terokkar,1219,hunter,beastmastery,30,16,14
Ecalter,dun-modr,1219,hunter,beastmastery,72,35,37
Kyliun,frostmane,1219,hunter,beastmastery,89,42,47
Mehtäsika,xavius,1219,hunter,beastmastery,74,34,40
Robal,burning-legion,1219,hunter,beastmastery,42,19,23
Logales,dragonblight,1219,hunter,beastmastery,50,20,30
Пулемётчег,razuvious,1218,hunter,beastmastery,40,19,21
Badhunt,stormscale,1218,hunter,beastmastery,36,13,23
Труласек,blackscar,1217,hunter,beastmastery,27,15,12
Stogie,auchindoun,1217,hunter,beastmastery,24,13,11
Arnatti,tyrande,1217,hunter,beastmastery,34,18,16
Mikhäilxdløl,tarren-mill,1217,hunter,beastmastery,75,36,39
Darkhunt,ysondre,1217,hunter,beastmastery,50,24,26
Glückskiller,nozdormu,1215,hunter,beastmastery,48,15,33
Тофуитер,howling-fjord,1214,hunter,beastmastery,57,25,32
Oròme,pozzo-delleternità,1213,hunter,beastmastery,131,69,62
Гримнар,borean-tundra,1213,hunter,beastmastery,29,13,16
Berkobaggins,twisting-nether,1213,hunter,beastmastery,74,32,42
Heita,sylvanas,1212,hunter,beastmastery,30,13,17
Squidy,archimonde,1212,hunter,beastmastery,30,13,17
Blutack,stormscale,1210,hunter,beastmastery,112,44,68
Snipingdog,stormscale,1209,hunter,beastmastery,36,18,18
Hunteriye,twisting-nether,1209,hunter,beastmastery,30,14,16
Heylie,senjin,1206,hunter,beastmastery,47,16,31
Tedohunter,ragnaros,1205,hunter,beastmastery,108,55,53
Bråndy,draenor,1204,hunter,beastmastery,28,14,14
Loridana,tichondrius,1204,hunter,beastmastery,113,47,66
Грознострел,gordunni,1203,hunter,beastmastery,88,49,39
Papithagore,hyjal,1203,hunter,beastmastery,29,13,16
Bouboule,elune,1202,hunter,beastmastery,122,74,48
Самомаза,soulflayer,1202,hunter,beastmastery,113,57,56
Skyren,defias-brotherhood,1202,hunter,beastmastery,74,33,41
Sithrom,blackmoore,1201,hunter,beastmastery,28,13,15
Heedbónger,tarren-mill,1200,hunter,beastmastery,53,22,31
Spineshot,thrall,1199,hunter,beastmastery,93,40,53
Kaletorw,ragnaros,1197,hunter,beastmastery,66,35,31
Panbuczek,defias-brotherhood,1197,hunter,beastmastery,54,21,33
Vör,drakthul,1194,hunter,beastmastery,32,14,18
Tempestes,tarren-mill,1193,hunter,beastmastery,101,53,48
Blêst,tarren-mill,1193,hunter,beastmastery,151,67,84
Marsian,lordaeron,1193,hunter,beastmastery,55,24,31
Cobra,magtheridon,1193,hunter,beastmastery,131,57,74
Noskillclasz,sylvanas,1193,hunter,beastmastery,47,19,28
Spycke,dalaran,1192,hunter,beastmastery,45,29,16
Faramír,azjolnerub,1192,hunter,beastmastery,54,21,33
Graniz,archimonde,1191,hunter,beastmastery,24,14,10
Tunhaa,arthas,1191,hunter,beastmastery,72,38,34
Demolaiser,dun-modr,1191,hunter,beastmastery,111,56,55
Nieki,eitrigg,1191,hunter,beastmastery,134,61,73
Johntoffee,eredar,1190,hunter,beastmastery,35,14,21
Крисмаз,gordunni,1190,hunter,beastmastery,56,16,40
Mazekhin,khaz-modan,1188,hunter,beastmastery,48,18,30
Phalakorn,blackhand,1187,hunter,beastmastery,48,20,28
Быщь,gordunni,1186,hunter,beastmastery,29,14,15
Straikkeri,draenor,1184,hunter,beastmastery,111,54,57
Mckanê,ysondre,1183,hunter,beastmastery,30,14,16
Remiss,sanguino,1182,hunter,beastmastery,28,15,13
Harpin,azuremyst,1181,hunter,beastmastery,95,47,48
Loyalman,blackmoore,1180,hunter,beastmastery,24,15,9
Винченцо,blackscar,1180,hunter,beastmastery,27,13,14
Mizumi,frostmane,1177,hunter,beastmastery,47,20,27
Sehkmet,silvermoon,1176,hunter,beastmastery,68,34,34
Shnidelwoods,blackrock,1171,hunter,beastmastery,56,29,27
Heiltfürzwei,ungoro,1171,hunter,beastmastery,133,61,72
Drakar,eredar,1170,hunter,beastmastery,60,30,30
Guanchin,silvermoon,1169,hunter,beastmastery,106,49,57
Bakatumbah,draenor,1168,hunter,beastmastery,52,26,26
Мэдраэль,deathguard,1165,hunter,beastmastery,63,31,32
Lakys,cthun,1165,hunter,beastmastery,82,33,49
Kure,blackrock,1164,hunter,beastmastery,185,96,89
Jimmý,sylvanas,1164,hunter,beastmastery,56,27,29
Kiwala,burning-legion,1164,hunter,beastmastery,77,35,42
Bigramy,sanguino,1164,hunter,beastmastery,52,15,37
Eddy,the-maelstrom,1162,hunter,beastmastery,76,39,37
Biscuitt,kazzak,1161,hunter,beastmastery,47,16,31
Laerya,les-clairvoyants,1158,hunter,beastmastery,36,16,20
Cinan,twisting-nether,1157,hunter,beastmastery,397,199,198
Maglór,senjin,1157,hunter,beastmastery,98,44,54
Ägris,die-todeskrallen,1155,hunter,beastmastery,192,90,102
Lajnus,frostmane,1152,hunter,beastmastery,24,12,12
Nidromel,stormscale,1152,hunter,beastmastery,178,88,90
Fivebabe,tarren-mill,1152,hunter,beastmastery,66,32,34
Äyumi,chogall,1152,hunter,beastmastery,127,54,73
Zeanort,nordrassil,1152,hunter,beastmastery,30,12,18
Jachu,blackhand,1151,hunter,beastmastery,24,12,12
Mercoßenz,kazzak,1151,hunter,beastmastery,24,12,12
Bullterrier,ragnaros,1151,hunter,beastmastery,24,12,12
Beeng,ravencrest,1151,hunter,beastmastery,30,14,16
Kayluh,sylvanas,1150,hunter,beastmastery,18,12,6
Blazinghunt,kazzak,1150,hunter,beastmastery,18,12,6
Lilpancake,kazzak,1150,hunter,beastmastery,18,12,6
Chambiann,tarren-mill,1150,hunter,beastmastery,24,12,12
Leza,kult-der-verdammten,1150,hunter,beastmastery,24,12,12
Shïndh,archimonde,1150,hunter,beastmastery,24,12,12
Амореселф,gordunni,1150,hunter,beastmastery,30,12,18
Outkást,sylvanas,1150,hunter,beastmastery,30,12,18
Næ,kazzak,1150,hunter,beastmastery,30,12,18
Mâjôô,blackhand,1149,hunter,beastmastery,22,13,9
Opalus,ravenholdt,1149,hunter,beastmastery,24,12,12
Gorett,kazzak,1149,hunter,beastmastery,131,64,67
Forthehordee,chamber-of-aspects,1148,hunter,beastmastery,24,12,12
Petitsui,zuljin,1148,hunter,beastmastery,30,12,18
Megagloc,shadowsong,1147,hunter,beastmastery,24,12,12
Envam,outland,1147,hunter,beastmastery,36,12,24
Adcabuser,tarren-mill,1146,hunter,beastmastery,24,12,12
Подлыйстарик,gordunni,1146,hunter,beastmastery,24,12,12
Jollis,argent-dawn,1146,hunter,beastmastery,173,81,92
Brmwall,twisting-nether,1146,hunter,beastmastery,30,12,18
Gorgorm,ravencrest,1146,hunter,beastmastery,36,12,24
Foxyyo,emerald-dream,1145,hunter,beastmastery,18,12,6
Топотелло,ashenvale,1145,hunter,beastmastery,34,19,15
Ládysháyà,blackrock,1145,hunter,beastmastery,238,119,119
Лсныйпамп,howling-fjord,1145,hunter,beastmastery,24,12,12
Eöe,ragnaros,1145,hunter,beastmastery,28,12,16
Брзенк,gordunni,1145,hunter,beastmastery,90,33,57
Ниамх,blackscar,1144,hunter,beastmastery,59,25,34
Hunterbeck,ravencrest,1144,hunter,beastmastery,78,32,46
Yoimdjsebo,twisting-nether,1142,hunter,beastmastery,18,12,6
Haraigoshí,grim-batol,1142,hunter,beastmastery,24,12,12
Alongshot,outland,1142,hunter,beastmastery,28,13,15
Nissa,blackrock,1142,hunter,beastmastery,30,12,18
Scräppÿ,kazzak,1141,hunter,beastmastery,27,13,14
Hlynsson,tarren-mill,1140,hunter,beastmastery,18,12,6
Isaîas,uldum,1139,hunter,beastmastery,106,45,61
Mordhunterx,draenor,1138,hunter,beastmastery,24,12,12
Pilogbueferd,silvermoon,1138,hunter,beastmastery,24,12,12
Zpy,blackmoore,1137,hunter,beastmastery,18,12,6
Korneatza,twisting-nether,1137,hunter,beastmastery,36,12,24
Abovival,ragnaros,1134,hunter,beastmastery,24,12,12
Vorthrax,drakthul,1134,hunter,beastmastery,30,12,18
Tomli,nemesis,1133,hunter,beastmastery,27,13,14
Crmov,silvermoon,1131,hunter,beastmastery,18,12,6
Ázèrøñå,ravencrest,1129,hunter,beastmastery,27,16,11
Bozidarka,kazzak,1129,hunter,beastmastery,24,12,12
Maknamara,tarren-mill,1127,hunter,beastmastery,63,32,31
Koopo,stormreaver,1125,hunter,beastmastery,149,72,77
Tremby,kazzak,1124,hunter,beastmastery,27,13,14
Biorson,silvermoon,1124,hunter,beastmastery,46,17,29
Ønur,twisting-nether,1122,hunter,beastmastery,78,39,39
Quasar,arakarahm,1122,hunter,beastmastery,59,22,37
Plong,argent-dawn,1121,hunter,beastmastery,24,14,10
Anthorio,cthun,1121,hunter,beastmastery,36,16,20
Täpy,arathor,1120,hunter,beastmastery,30,12,18
Sokyokuh,burning-legion,1119,hunter,beastmastery,24,12,12
Kirky,terokkar,1118,hunter,beastmastery,45,20,25
Бэрими,gordunni,1118,hunter,beastmastery,29,12,17
Axams,archimonde,1118,hunter,beastmastery,117,47,70
Marudô,aegwynn,1118,hunter,beastmastery,35,12,23
Ezelina,lightnings-blade,1117,hunter,beastmastery,82,42,40
Ratul,pozzo-delleternità,1117,hunter,beastmastery,47,16,31
Karstarkk,sanguino,1116,hunter,beastmastery,71,32,39
Гоу,fordragon,1116,hunter,beastmastery,60,26,34
Jooetheman,stormscale,1114,hunter,beastmastery,29,12,17
Soulshoot,khaz-modan,1113,hunter,beastmastery,94,48,46
Айлиси,soulflayer,1111,hunter,beastmastery,67,20,47
Doômzi,ysondre,1109,hunter,beastmastery,36,20,16
Cäri,colinas-pardas,1109,hunter,beastmastery,36,16,20
Шейхант,gordunni,1106,hunter,beastmastery,48,26,22
Øutkast,silvermoon,1105,hunter,beastmastery,29,18,11
Ertestuing,tarren-mill,1105,hunter,beastmastery,33,16,17
Papiou,les-sentinelles,1105,hunter,beastmastery,42,20,22
Epheso,daggerspine,1105,hunter,beastmastery,33,15,18
Savori,kazzak,1100,hunter,beastmastery,37,21,16
Jeyl,aegwynn,1099,hunter,beastmastery,23,12,11
Somixx,ragnaros,1098,hunter,beastmastery,82,44,38
Jaguarundy,dun-modr,1098,hunter,beastmastery,38,16,22
Zorana,twisting-nether,1097,hunter,beastmastery,34,12,22
Atraxi,aegwynn,1096,hunter,beastmastery,64,28,36
Goonii,bronzebeard,1094,hunter,beastmastery,24,12,12
Janjal,silvermoon,1094,hunter,beastmastery,129,57,72
Noobatala,tarren-mill,1093,hunter,beastmastery,48,18,30
Bâng,zuljin,1088,hunter,beastmastery,34,16,18
Crittix,kiljaeden,1088,hunter,beastmastery,30,12,18
Chillarn,tarren-mill,1086,hunter,beastmastery,76,34,42
Zsara,ravencrest,1085,hunter,beastmastery,22,12,10
Salemenos,silvermoon,1085,hunter,beastmastery,22,12,10
Ulyash,ysondre,1085,hunter,beastmastery,90,41,49
Tracrium,hyjal,1084,hunter,beastmastery,71,24,47
Brometheus,sylvanas,1083,hunter,beastmastery,41,15,26
Nèlandar,archimonde,1082,hunter,beastmastery,42,19,23
Armanny,sylvanas,1082,hunter,beastmastery,139,54,85
Nerfjuice,silvermoon,1081,hunter,beastmastery,81,41,40
Bigbadhunter,twilights-hammer,1080,hunter,beastmastery,24,12,12
Huntarent,argent-dawn,1080,hunter,beastmastery,60,16,44
Авроратян,blackscar,1079,hunter,beastmastery,23,15,8
Feigur,sanguino,1078,hunter,beastmastery,65,36,29
Olamay,blackmoore,1078,hunter,beastmastery,90,43,47
Seviaz,draenor,1077,hunter,beastmastery,29,12,17
Pawder,silvermoon,1077,hunter,beastmastery,42,15,27
Musraah,zuljin,1076,hunter,beastmastery,21,13,8
Амобарбиталх,gordunni,1075,hunter,beastmastery,44,23,21
Bladius,ragnaros,1075,hunter,beastmastery,60,23,37
Hugechode,kazzak,1074,hunter,beastmastery,24,12,12
Latira,eonar,1072,hunter,beastmastery,84,38,46
Ветиринарша,gordunni,1069,hunter,beastmastery,48,18,30
Yasopp,draenor,1066,hunter,beastmastery,24,13,11
Aamøn,nemesis,1066,hunter,beastmastery,41,21,20
Spiritshot,baelgun,1066,hunter,beastmastery,34,14,20
Zhazha,chamber-of-aspects,1065,hunter,beastmastery,43,21,22
Hentt,burning-legion,1064,hunter,beastmastery,28,13,15
Ceres,kaelthas,1063,hunter,beastmastery,30,12,18
Venkox,archimonde,1062,hunter,beastmastery,79,42,37
Sàclak,ysondre,1062,hunter,beastmastery,43,19,24
Cruelsummer,kul-tiras,1061,hunter,beastmastery,60,22,38
Teacee,twisting-nether,1060,hunter,beastmastery,53,28,25
Arrowin,ravencrest,1060,hunter,beastmastery,24,12,12
Sixty,rajaxx,1059,hunter,beastmastery,119,52,67
Rudeness,frostmane,1058,hunter,beastmastery,42,12,30
Slide,dalaran,1056,hunter,beastmastery,65,30,35
Dorkos,sanguino,1056,hunter,beastmastery,24,11,13
Ayaz,ravencrest,1056,hunter,beastmastery,30,11,19
Мунгардина,blackscar,1056,hunter,beastmastery,36,11,25
Styxht,blackhand,1055,hunter,beastmastery,18,11,7
Nihau,ravencrest,1055,hunter,beastmastery,18,11,7
Vanthaes,argent-dawn,1055,hunter,beastmastery,24,11,13
Deadshøt,thrall,1055,hunter,beastmastery,24,11,13
Azrhu,ravencrest,1055,hunter,beastmastery,30,11,19
Gitanìlla,dun-modr,1055,hunter,beastmastery,36,11,25
Hariana,hyjal,1054,hunter,beastmastery,18,11,7
Bazouf,outland,1054,hunter,beastmastery,18,11,7
Mettämies,twisting-nether,1054,hunter,beastmastery,18,11,7
Funkysht,outland,1054,hunter,beastmastery,22,12,10
Leemool,ysondre,1054,hunter,beastmastery,36,18,18
Barneyarrow,tarren-mill,1054,hunter,beastmastery,24,11,13
Рафлекс,eversong,1054,hunter,beastmastery,26,11,15
Jimbowjones,antonidas,1053,hunter,beastmastery,24,11,13
Pigoen,sporeggar,1053,hunter,beastmastery,141,64,77
Bempl,onyxia,1053,hunter,beastmastery,30,11,19
Jakis,silvermoon,1052,hunter,beastmastery,18,11,7
Gobliniehoóo,azuremyst,1051,hunter,beastmastery,16,12,4
Greg,defias-brotherhood,1051,hunter,beastmastery,24,11,13
Unreachable,dethecus,1051,hunter,beastmastery,24,11,13
Darllene,kazzak,1051,hunter,beastmastery,30,11,19
Melilissya,dalaran,1051,hunter,beastmastery,30,11,19
Oramar,archimonde,1050,hunter,beastmastery,36,17,19
Nandrohunt,dalaran,1049,hunter,beastmastery,30,11,19
Хантетский,howling-fjord,1048,hunter,beastmastery,26,12,14
Sourxete,silvermoon,1048,hunter,beastmastery,24,11,13
Коблазнх,howling-fjord,1048,hunter,beastmastery,24,11,13
Sheilare,doomhammer,1047,hunter,beastmastery,18,11,7
Fléqs,antonidas,1046,hunter,beastmastery,24,11,13
Bezi,tarren-mill,1045,hunter,beastmastery,47,21,26
Strade,argent-dawn,1044,hunter,beastmastery,24,11,13
Tusibi,dalaran,1044,hunter,beastmastery,30,11,19
Shinibon,blackmoore,1044,hunter,beastmastery,36,11,25
Dreemshoot,stormscale,1043,hunter,beastmastery,26,12,14
Ayaille,marécage-de-zangar,1043,hunter,beastmastery,40,14,26
Pickaboo,defias-brotherhood,1040,hunter,beastmastery,24,11,13
Lucivs,ravenholdt,1040,hunter,beastmastery,29,13,16
Glarco,eldrethalas,1039,hunter,beastmastery,36,19,17
Dorkis,sanguino,1039,hunter,beastmastery,29,11,18
Rubyblack,archimonde,1038,hunter,beastmastery,78,41,37
Yukina,frostmourne,1038,hunter,beastmastery,28,13,15
Rivery,azjolnerub,1038,hunter,beastmastery,43,17,26
Pennyflame,blackmoore,1037,hunter,beastmastery,28,12,16
Skullstah,ravencrest,1034,hunter,beastmastery,78,33,45
Sika,nozdormu,1031,hunter,beastmastery,30,11,19
Pîpî,blackrock,1027,hunter,beastmastery,23,13,10
Auau,the-maelstrom,1027,hunter,beastmastery,67,30,37
Attiladagun,hellfire,1027,hunter,beastmastery,67,19,48
Китас,soulflayer,1021,hunter,beastmastery,28,11,17
Eilnu,zuljin,1021,hunter,beastmastery,78,24,54
Бодрыйсэм,soulflayer,1020,hunter,beastmastery,34,17,17
Bmilfhunter,blackhand,1020,hunter,beastmastery,28,11,17
Bellecoq,arathi,1019,hunter,beastmastery,23,11,12
Cityhunter,archimonde,1018,hunter,beastmastery,114,50,64
Grollar,ragnaros,1014,hunter,beastmastery,80,42,38
Faze,hellfire,1013,hunter,beastmastery,60,30,30
Arakton,drakthul,1008,hunter,beastmastery,46,23,23
Sâranjágo,argent-dawn,1008,hunter,beastmastery,90,40,50
Orgasmatronn,stormscale,1008,hunter,beastmastery,30,11,19
Weisswinter,drakthul,1004,hunter,beastmastery,24,12,12
Talija,nathrezim,1003,hunter,beastmastery,36,18,18
Ohwagga,pozzo-delleternità,1003,hunter,beastmastery,30,15,15
Wolfmarko,ragnaros,1003,hunter,beastmastery,61,25,36
Клак,howling-fjord,1003,hunter,beastmastery,92,33,59
Knokkelmann,outland,1001,hunter,beastmastery,28,13,15
Kagan,nemesis,998,hunter,beastmastery,29,17,12
Апельсинчес,howling-fjord,997,hunter,beastmastery,17,11,6
Sinux,lordaeron,995,hunter,beastmastery,17,11,6
Insanepvper,argent-dawn,995,hunter,beastmastery,27,11,16
Happyrme,thrall,992,hunter,beastmastery,48,26,22
Lissudarlin,stormreaver,992,hunter,beastmastery,543,274,269
Хантнерюга,gordunni,991,hunter,beastmastery,20,11,9
Brotaniku,tarren-mill,991,hunter,beastmastery,114,49,65
Enanorabioso,minahonda,991,hunter,beastmastery,30,12,18
Atnan,vashj,990,hunter,beastmastery,48,20,28
Frencharena,the-venture-co,990,hunter,beastmastery,29,11,18
Neuromancien,archimonde,990,hunter,beastmastery,35,11,24
Wutrapog,kazzak,988,hunter,beastmastery,20,11,9
Aryelis,draenor,988,hunter,beastmastery,26,11,15
Pumukle,madmortem,987,hunter,beastmastery,45,18,27
Schnezzler,nerathor,986,hunter,beastmastery,310,152,158
Qled,sylvanas,986,hunter,beastmastery,37,15,22
Kekkistä,ravencrest,986,hunter,beastmastery,46,15,31
Talentlos,guldan,986,hunter,beastmastery,47,15,32
Nixxay,antonidas,984,hunter,beastmastery,54,30,24
Floppybobby,burning-blade,980,hunter,beastmastery,29,12,17
Frittman,silvermoon,978,hunter,beastmastery,42,18,24
Bloodxx,ragnaros,976,hunter,beastmastery,48,22,26
Jamaro,dun-modr,974,hunter,beastmastery,128,59,69
Yümekø,khaz-modan,973,hunter,beastmastery,19,11,8
Arrowlight,archimonde,973,hunter,beastmastery,61,31,30
Kyßa,uldum,971,hunter,beastmastery,19,11,8
Jaydogg,lightbringer,970,hunter,beastmastery,19,11,8
Vystrelil,drakthul,970,hunter,beastmastery,202,104,98
Гррешница,galakrond,968,hunter,beastmastery,54,29,25
Kikijojo,ravencrest,968,hunter,beastmastery,51,26,25
Kruk,blackhand,968,hunter,beastmastery,22,11,11
Traenuss,azuremyst,968,hunter,beastmastery,48,19,29
Olddèath,archimonde,966,hunter,beastmastery,30,12,18
Amdonesia,ravencrest,966,hunter,beastmastery,70,24,46
Llamp,draenor,964,hunter,beastmastery,60,29,31
Zanéy,ravencrest,960,hunter,beastmastery,12,10,2
Dathrixjr,ravencrest,960,hunter,beastmastery,12,10,2
Hahahxd,ragnaros,960,hunter,beastmastery,18,10,8
Tiffanydoll,hyjal,960,hunter,beastmastery,18,10,8
Hollyz,auchindoun,960,hunter,beastmastery,24,10,14
Dashiro,drakthul,960,hunter,beastmastery,24,10,14
Jwah,tarren-mill,960,hunter,beastmastery,24,10,14
Silencxz,aegwynn,960,hunter,beastmastery,30,10,20
Bubby,burning-legion,960,hunter,beastmastery,34,11,23
Rashoumon,zuljin,959,hunter,beastmastery,18,10,8
Dragh,blackrock,959,hunter,beastmastery,18,10,8
Velrox,blackmoore,959,hunter,beastmastery,18,10,8
Woöky,dalaran,959,hunter,beastmastery,94,49,45
Appollo,magtheridon,959,hunter,beastmastery,24,10,14
Artze,outland,959,hunter,beastmastery,24,10,14
Alée,twisting-nether,959,hunter,beastmastery,30,10,20
Rikitikii,burning-legion,958,hunter,beastmastery,15,11,4
Shikar,sanguino,958,hunter,beastmastery,18,10,8
Komesz,ragnaros,958,hunter,beastmastery,18,10,8
Soblazed,twisting-nether,958,hunter,beastmastery,18,10,8
Multigodx,draenor,958,hunter,beastmastery,18,10,8
Versache,kazzak,958,hunter,beastmastery,24,10,14
Zithis,argent-dawn,958,hunter,beastmastery,24,10,14
Mahuntah,drakthul,958,hunter,beastmastery,24,10,14
Haihappen,das-konsortium,958,hunter,beastmastery,30,10,20
Blainehunts,arathor,958,hunter,beastmastery,36,11,25
Choukzt,archimonde,957,hunter,beastmastery,18,10,8
Therasin,ravenholdt,957,hunter,beastmastery,18,10,8
Vortee,drakthul,957,hunter,beastmastery,18,10,8
Huntarbeît,eredar,957,hunter,beastmastery,33,11,22
Khaos,zuluhed,957,hunter,beastmastery,30,10,20
Skipee,ravencrest,956,hunter,beastmastery,18,10,8
Machinedream,sylvanas,956,hunter,beastmastery,18,10,8
Feerea,burning-legion,956,hunter,beastmastery,24,10,14
Bowere,kazzak,956,hunter,beastmastery,24,10,14
Блудитролль,soulflayer,956,hunter,beastmastery,24,10,14
Vassiliadis,bronze-dragonflight,956,hunter,beastmastery,30,10,20
Ahsóka,frostwhisper,955,hunter,beastmastery,18,10,8
Cirenivel,draenor,955,hunter,beastmastery,22,11,11
Flecheoeil,hyjal,955,hunter,beastmastery,30,10,20
Beaststeaks,thrall,954,hunter,beastmastery,18,10,8
Kairrux,twisting-nether,954,hunter,beastmastery,18,10,8
Usop,medivh,953,hunter,beastmastery,24,14,10
Herpray,blackmoore,953,hunter,beastmastery,18,10,8
Ragingdragon,turalyon,953,hunter,beastmastery,18,10,8
Katsa,ragnaros,953,hunter,beastmastery,30,10,20
Phillon,blackrock,952,hunter,beastmastery,24,10,14
Topgrill,stormscale,952,hunter,beastmastery,30,10,20
Beefchops,draenor,951,hunter,beastmastery,18,10,8
Вагар,blackscar,951,hunter,beastmastery,51,27,24
Misscreggor,ravencrest,951,hunter,beastmastery,24,10,14
Luckyhunty,dalaran,951,hunter,beastmastery,101,42,59
Misfîre,tarren-mill,950,hunter,beastmastery,18,10,8
Xyrone,bladefist,950,hunter,beastmastery,104,51,53
Zappikhunter,silvermoon,950,hunter,beastmastery,24,10,14
Zarlena,tarren-mill,947,hunter,beastmastery,43,19,24
Hjørnz,stormscale,947,hunter,beastmastery,30,10,20
Telx,blackmoore,946,hunter,beastmastery,18,10,8
Jorch,ahnqiraj,946,hunter,beastmastery,18,10,8
Cernunnos,auchindoun,944,hunter,beastmastery,19,10,9
Lemeric,blackmoore,942,hunter,beastmastery,19,10,9
Heallena,magtheridon,941,hunter,beastmastery,36,10,26
Hixia,archimonde,940,hunter,beastmastery,17,10,7
Зоопсихолог,gordunni,935,hunter,beastmastery,138,70,68
Shtooko,conseil-des-ombres,934,hunter,beastmastery,35,12,23
Bammbammx,twisting-nether,932,hunter,beastmastery,24,12,12
Dioxis,silvermoon,932,hunter,beastmastery,118,57,61
Utopia,korgall,928,hunter,beastmastery,116,53,63
Elfanka,sanguino,925,hunter,beastmastery,30,15,15
Heegal,stormscale,922,hunter,beastmastery,42,20,22
Anghron,minahonda,921,hunter,beastmastery,25,10,15
Towu,archimonde,918,hunter,beastmastery,30,11,19
Stjordal,chamber-of-aspects,917,hunter,beastmastery,63,30,33
Axg,burning-legion,916,hunter,beastmastery,53,21,32
Kronzucker,eredar,914,hunter,beastmastery,36,16,20
Dis,twilights-hammer,911,hunter,beastmastery,23,10,13
Allcollapse,outland,910,hunter,beastmastery,21,11,10
Нью,soulflayer,910,hunter,beastmastery,23,10,13
Lynx,garona,909,hunter,beastmastery,96,40,56
Bitig,argent-dawn,909,hunter,beastmastery,28,10,18
Mankkis,stormscale,909,hunter,beastmastery,48,14,34
Bjarnhild,die-aldor,906,hunter,beastmastery,24,11,13
Vargar,arygos,906,hunter,beastmastery,26,11,15
Dafragger,blackmoore,905,hunter,beastmastery,25,12,13
Delazi,proudmoore,905,hunter,beastmastery,30,11,19
Ñava,dalaran,898,hunter,beastmastery,24,11,13
Zoomiesuwu,antonidas,895,hunter,beastmastery,17,10,7
Draknik,nemesis,895,hunter,beastmastery,39,10,29
Igotwatuneed,kazzak,894,hunter,beastmastery,24,11,13
Kënshiro,kazzak,893,hunter,beastmastery,20,10,10
Slaghunter,argent-dawn,893,hunter,beastmastery,23,10,13
Bornum,khaz-modan,892,hunter,beastmastery,31,10,21
Catmother,grim-batol,886,hunter,beastmastery,20,12,8
Sylverein,silvermoon,886,hunter,beastmastery,109,38,71
Zimmoo,tarren-mill,884,hunter,beastmastery,77,35,42
Penelopé,darkmoon-faire,883,hunter,beastmastery,97,42,55
Shpider,burning-blade,883,hunter,beastmastery,82,33,49
Mcperra,zuljin,882,hunter,beastmastery,26,10,16
Colth,hyjal,882,hunter,beastmastery,47,16,31
Wodlenprince,draenor,881,hunter,beastmastery,82,22,60
Ranrôk,rexxar,878,hunter,beastmastery,68,27,41
Араэль,galakrond,877,hunter,beastmastery,66,33,33
Kurtanâ,blackmoore,877,hunter,beastmastery,27,10,17
Баззи,grom,866,hunter,beastmastery,121,61,60
Eenel,twisting-nether,864,hunter,beastmastery,12,9,3
Ледо,deathguard,864,hunter,beastmastery,12,9,3
Tholano,rexxar,864,hunter,beastmastery,12,9,3
Азирона,gordunni,864,hunter,beastmastery,12,9,3
Hispanøxd,sanguino,864,hunter,beastmastery,12,9,3
Kapowz,kazzak,864,hunter,beastmastery,12,9,3
Тирин,ashenvale,864,hunter,beastmastery,12,9,3
Réâlñúððà,kazzak,864,hunter,beastmastery,18,9,9
Flouky,blackmoore,864,hunter,beastmastery,18,9,9
Охотницагодх,borean-tundra,864,hunter,beastmastery,18,9,9
Lísy,hyjal,864,hunter,beastmastery,18,9,9
Dåo,doomhammer,864,hunter,beastmastery,18,9,9
Weoneshot,ravencrest,864,hunter,beastmastery,18,9,9
Autopilot,aegwynn,864,hunter,beastmastery,18,9,9
Orosko,archimonde,864,hunter,beastmastery,18,9,9
Chipok,outland,864,hunter,beastmastery,29,11,18
Pilpetra,tarren-mill,864,hunter,beastmastery,24,9,15
Akkixz,antonidas,864,hunter,beastmastery,24,9,15
Cryptomars,twisting-nether,864,hunter,beastmastery,24,9,15
Elionora,kazzak,864,hunter,beastmastery,24,9,15
Valhnir,sanguino,864,hunter,beastmastery,24,9,15
Леоа,howling-fjord,864,hunter,beastmastery,27,10,17
Ancalarion,tarren-mill,864,hunter,beastmastery,27,9,18
Hunterstein,archimonde,864,hunter,beastmastery,30,9,21
Skeng,xavius,863,hunter,beastmastery,12,9,3
Brâzahart,silvermoon,863,hunter,beastmastery,12,9,3
Srvol,dun-modr,863,hunter,beastmastery,12,9,3
Duviidb,drakthul,863,hunter,beastmastery,12,9,3
Jordlol,hellscream,863,hunter,beastmastery,18,9,9
Генрах,soulflayer,863,hunter,beastmastery,18,9,9
Сальверди,gordunni,863,hunter,beastmastery,18,9,9
Fléxyz,sylvanas,863,hunter,beastmastery,18,9,9
Кишмякхант,howling-fjord,863,hunter,beastmastery,18,9,9
Sarganno,archimonde,863,hunter,beastmastery,18,9,9
Reshka,dunemaul,863,hunter,beastmastery,18,9,9
Sgmarine,khaz-modan,863,hunter,beastmastery,18,9,9
Ванхогер,gordunni,863,hunter,beastmastery,18,9,9
Jahunter,aggra-português,863,hunter,beastmastery,18,9,9
Fogknows,ravencrest,863,hunter,beastmastery,18,9,9
Iliíilíiílíl,outland,863,hunter,beastmastery,18,9,9
Nillaxy,blackmoore,863,hunter,beastmastery,18,9,9
Aliltoxic,silvermoon,863,hunter,beastmastery,18,9,9
Markev,norgannon,863,hunter,beastmastery,18,9,9
Aelridel,kirin-tor,863,hunter,beastmastery,133,53,80
Tjodalf,zuluhed,863,hunter,beastmastery,24,9,15
Дарцетос,greymane,863,hunter,beastmastery,24,9,15
Nettie,arathor,863,hunter,beastmastery,24,9,15
Tylahnem,hyjal,863,hunter,beastmastery,24,9,15
Krâven,ysondre,863,hunter,beastmastery,36,9,27
Softishot,archimonde,862,hunter,beastmastery,18,9,9
Vyrê,ghostlands,862,hunter,beastmastery,18,9,9
Bluffmakarn,silvermoon,862,hunter,beastmastery,18,9,9
Therakal,culte-de-la-rive-noire,862,hunter,beastmastery,18,9,9
Vu,shattered-hand,862,hunter,beastmastery,18,9,9
Zirheael,argent-dawn,862,hunter,beastmastery,18,9,9
Mecamoot,drekthar,862,hunter,beastmastery,18,9,9
Максиммужик,soulflayer,862,hunter,beastmastery,24,9,15
Ecthelione,the-venture-co,862,hunter,beastmastery,24,9,15
Aamön,tarren-mill,862,hunter,beastmastery,24,9,15
Hävenofün,archimonde,862,hunter,beastmastery,30,9,21
Xalh,hyjal,861,hunter,beastmastery,18,9,9
Marlaska,exodar,861,hunter,beastmastery,233,115,118
Nîco,nathrezim,861,hunter,beastmastery,24,9,15
Andraethanal,ravencrest,860,hunter,beastmastery,17,10,7
Petfeelya,antonidas,860,hunter,beastmastery,18,9,9
Ashryqt,ravencrest,860,hunter,beastmastery,18,9,9
Steìn,ysondre,860,hunter,beastmastery,24,9,15
Vïcødïnë,sinstralis,859,hunter,beastmastery,18,9,9
Rògor,sylvanas,859,hunter,beastmastery,18,9,9
Hattoro,drakthul,859,hunter,beastmastery,24,9,15
Focùs,eredar,859,hunter,beastmastery,24,9,15
Ludo,chogall,858,hunter,beastmastery,93,45,48
Darilli,wildhammer,858,hunter,beastmastery,19,9,10
Rem,zuljin,858,hunter,beastmastery,24,9,15
Mindgap,pozzo-delleternità,858,hunter,beastmastery,24,9,15
Bolgroth,balnazzar,857,hunter,beastmastery,18,9,9
Бруксиан,fordragon,857,hunter,beastmastery,19,9,10
Deathcrôwler,shattrath,857,hunter,beastmastery,24,9,15
Maxtozer,silvermoon,857,hunter,beastmastery,24,9,15
Скартэкс,howling-fjord,856,hunter,beastmastery,12,9,3
Abendstern,silvermoon,855,hunter,beastmastery,36,9,27
Фаталлити,grom,853,hunter,beastmastery,18,9,9
Arrechus,khaz-modan,852,hunter,beastmastery,174,81,93
Scatterinc,antonidas,851,hunter,beastmastery,24,9,15
Roclen,uldum,850,hunter,beastmastery,24,9,15
Zinnady,outland,846,hunter,beastmastery,12,9,3
Greenstar,twisting-nether,846,hunter,beastmastery,27,10,17
Ârhya,ysondre,845,hunter,beastmastery,36,15,21
Barzti,thrall,842,hunter,beastmastery,24,11,13
Ôrly,outland,839,hunter,beastmastery,51,25,26
Sushimän,kaelthas,834,hunter,beastmastery,18,10,8
Venõm,pozzo-delleternità,832,hunter,beastmastery,21,11,10
Deathmarks,blackrock,830,hunter,beastmastery,35,9,26
Куников,booty-bay,829,hunter,beastmastery,14,10,4
Lembó,zuljin,827,hunter,beastmastery,18,9,9
Drogostorm,steamwheedle-cartel,823,hunter,beastmastery,71,31,40
Aryaae,les-clairvoyants,822,hunter,beastmastery,52,23,29
Anoroxx,arthas,815,hunter,beastmastery,17,9,8
Шаурмэ,gordunni,815,hunter,beastmastery,21,9,12
Хихихихх,gordunni,814,hunter,beastmastery,21,9,12
Akrepkral,kargath,813,hunter,beastmastery,100,47,53
Speartusk,blackhand,813,hunter,beastmastery,23,9,14
Кустурица,azuregos,811,hunter,beastmastery,34,9,25
Kreiden,twisting-nether,810,hunter,beastmastery,34,11,23
Thebigboom,outland,809,hunter,beastmastery,21,10,11
Belgorin,alexstrasza,806,hunter,beastmastery,159,76,83
Abgeherjoe,antonidas,799,hunter,beastmastery,16,9,7
Arkell,los-errantes,797,hunter,beastmastery,18,9,9
Bnji,hyjal,797,hunter,beastmastery,22,9,13
Rezgor,stormscale,796,hunter,beastmastery,17,9,8
Dorollo,khaz-modan,791,hunter,beastmastery,56,25,31
Bihoreanul,sylvanas,790,hunter,beastmastery,36,15,21
Rozgnyy,silvermoon,783,hunter,beastmastery,11,9,2
Elíonora,kazzak,783,hunter,beastmastery,19,9,10
Goliathoz,blackmoore,773,hunter,beastmastery,100,46,54
Dáky,ravencrest,768,hunter,beastmastery,12,8,4
Puopoufu,drakthul,768,hunter,beastmastery,12,8,4
Turbogt,stormscale,768,hunter,beastmastery,12,8,4
Sejkxi,malganis,768,hunter,beastmastery,12,8,4
Rollingpork,silvermoon,768,hunter,beastmastery,12,8,4
Papisbae,stormscale,768,hunter,beastmastery,12,8,4
Ebobuss,tarren-mill,768,hunter,beastmastery,12,8,4
Strazza,ragnaros,768,hunter,beastmastery,12,8,4
Suffrebobbs,ravencrest,768,hunter,beastmastery,12,8,4
Khyleanxøxø,dun-modr,768,hunter,beastmastery,12,8,4
Tøkÿöghøül,ravencrest,768,hunter,beastmastery,13,8,5
Deenkz,ravencrest,768,hunter,beastmastery,15,9,6
Xn,cthun,768,hunter,beastmastery,18,8,10
Белатраиса,gordunni,768,hunter,beastmastery,18,8,10
Leonidazar,draenor,768,hunter,beastmastery,18,8,10
Vasco,chogall,768,hunter,beastmastery,18,8,10
Iliketraps,blackmoore,768,hunter,beastmastery,18,8,10
Lökout,twilights-hammer,768,hunter,beastmastery,18,8,10
Winniepuuh,outland,768,hunter,beastmastery,18,8,10
Double,sylvanas,768,hunter,beastmastery,18,8,10
Justeclicd,hyjal,768,hunter,beastmastery,18,8,10
Lowboblarry,ravencrest,768,hunter,beastmastery,18,8,10
Spazi,kazzak,768,hunter,beastmastery,18,8,10
Ishotharambe,doomhammer,768,hunter,beastmastery,18,8,10
Synaticx,thrall,768,hunter,beastmastery,18,8,10
Yamadorî,blackrock,768,hunter,beastmastery,18,8,10
Geeked,tarren-mill,768,hunter,beastmastery,18,8,10
Pewpewstuff,draenor,768,hunter,beastmastery,18,8,10
Xalihuntio,ravencrest,768,hunter,beastmastery,18,8,10
Матопопа,gordunni,768,hunter,beastmastery,18,8,10
Krâýnn,aegwynn,768,hunter,beastmastery,18,8,10
Myriadx,sylvanas,768,hunter,beastmastery,18,8,10
Lambikas,argent-dawn,768,hunter,beastmastery,18,8,10
Páiz,tarren-mill,768,hunter,beastmastery,18,8,10
Ráptør,silvermoon,768,hunter,beastmastery,24,8,16
Mobshot,twisting-nether,768,hunter,beastmastery,24,8,16
Stuckstepbro,silvermoon,768,hunter,beastmastery,24,8,16
Джулибуба,howling-fjord,768,hunter,beastmastery,24,8,16
Бранцо,howling-fjord,768,hunter,beastmastery,24,8,16
Mogumogu,blackhand,768,hunter,beastmastery,24,8,16
Zárnah,defias-brotherhood,768,hunter,beastmastery,24,8,16
Fridion,argent-dawn,768,hunter,beastmastery,24,8,16
Poke,aggra-português,768,hunter,beastmastery,24,8,16
Deepcleaning,kazzak,768,hunter,beastmastery,30,8,22
Síthrom,blackmoore,767,hunter,beastmastery,12,8,4
Gordo,burning-legion,767,hunter,beastmastery,12,8,4
Huntyadaun,blackrock,767,hunter,beastmastery,12,8,4
Nocturr,ragnaros,767,hunter,beastmastery,12,8,4
Kuljaa,ravencrest,767,hunter,beastmastery,12,8,4
Loydzz,hyjal,767,hunter,beastmastery,12,8,4
Nulldmgmaker,malganis,767,hunter,beastmastery,12,8,4
Awoe,blackrock,767,hunter,beastmastery,12,8,4
Aldra,kelthuzad,767,hunter,beastmastery,12,8,4
Ahrtemís,destromath,767,hunter,beastmastery,12,8,4
Blackbane,ravencrest,767,hunter,beastmastery,12,8,4
Арнесс,deepholm,767,hunter,beastmastery,15,9,6
Demyxerus,sanguino,767,hunter,beastmastery,18,8,10
Венкара,gordunni,767,hunter,beastmastery,18,8,10
Huntzki,tarren-mill,767,hunter,beastmastery,18,8,10
Zajebantip,sylvanas,767,hunter,beastmastery,18,8,10
Hakamael,kirin-tor,767,hunter,beastmastery,18,8,10
Рофшор,gordunni,767,hunter,beastmastery,18,8,10
Kurobi,kazzak,767,hunter,beastmastery,18,8,10
Elionora,grim-batol,767,hunter,beastmastery,18,8,10
Kartantrax,culte-de-la-rive-noire,767,hunter,beastmastery,18,8,10
Sylda,blutkessel,767,hunter,beastmastery,18,8,10
Jónes,dunemaul,767,hunter,beastmastery,18,8,10
Prodanhunts,frostmane,767,hunter,beastmastery,24,8,16
Гунныч,grom,767,hunter,beastmastery,30,8,22
Oozzee,tarren-mill,766,hunter,beastmastery,12,8,4
Rdwlf,draenor,766,hunter,beastmastery,18,8,10
Notley,thrall,766,hunter,beastmastery,18,8,10
Aluara,burning-legion,766,hunter,beastmastery,24,8,16
Msâka,blackrock,766,hunter,beastmastery,24,8,16
Amberye,dalaran,766,hunter,beastmastery,24,8,16
Airtz,ysondre,766,hunter,beastmastery,24,8,16
Rickh,ravencrest,765,hunter,beastmastery,12,8,4
Isøbu,hyjal,765,hunter,beastmastery,15,9,6
Cxc,dun-modr,765,hunter,beastmastery,18,8,10
Лузановка,gordunni,765,hunter,beastmastery,18,8,10
Poine,sylvanas,765,hunter,beastmastery,36,14,22
Джэромо,gordunni,765,hunter,beastmastery,24,8,16
Castbuny,drakthul,765,hunter,beastmastery,24,8,16
Saîtek,chogall,764,hunter,beastmastery,12,8,4
Tuturz,la-croisade-écarlate,764,hunter,beastmastery,18,8,10
Abraxan,twisting-nether,764,hunter,beastmastery,18,8,10
Ceedlulz,antonidas,764,hunter,beastmastery,24,8,16
Chalid,aegwynn,764,hunter,beastmastery,24,8,16
Killzo,sylvanas,763,hunter,beastmastery,18,8,10
Maríschká,amanthul,763,hunter,beastmastery,18,8,10
Ferdinandl,draenor,763,hunter,beastmastery,18,8,10
Фаусти,gordunni,762,hunter,beastmastery,12,8,4
Furian,der-rat-von-dalaran,762,hunter,beastmastery,18,8,10
Djzntrap,outland,761,hunter,beastmastery,18,8,10
Boompuf,draenor,761,hunter,beastmastery,24,8,16
Trollhunt,bloodscalp,759,hunter,beastmastery,21,9,12
Bliss,senjin,756,hunter,beastmastery,12,8,4
Oldrocker,sylvanas,756,hunter,beastmastery,24,8,16
Арогорд,gordunni,756,hunter,beastmastery,24,8,16
Franzfuchs,blackmoore,751,hunter,beastmastery,17,8,9
Petoveri,stormreaver,746,hunter,beastmastery,24,9,15
Begehunter,sylvanas,740,hunter,beastmastery,18,8,10
Пушкабомби,soulflayer,737,hunter,beastmastery,112,46,66
Wödën,argent-dawn,735,hunter,beastmastery,26,9,17
Механямка,gordunni,735,hunter,beastmastery,29,8,21
Kakopaikths,sylvanas,733,hunter,beastmastery,23,8,15
Anesa,lightbringer,728,hunter,beastmastery,21,9,12
Guna,aggra-português,727,hunter,beastmastery,23,8,15
Сяову,gordunni,724,hunter,beastmastery,142,54,88
Stayswag,nemesis,718,hunter,beastmastery,21,8,13
Rkd,stormrage,715,hunter,beastmastery,23,8,15
Адула,eversong,714,hunter,beastmastery,59,22,37
Grufflin,bronzebeard,713,hunter,beastmastery,23,8,15
Дикийджош,soulflayer,707,hunter,beastmastery,17,9,8
Tetrapet,pozzo-delleternità,706,hunter,beastmastery,46,22,24
Онурисс,grom,703,hunter,beastmastery,16,8,8
Chibimonx,ravencrest,703,hunter,beastmastery,16,8,8
Feyoonx,blackrock,703,hunter,beastmastery,23,9,14
Wakar,alakir,701,hunter,beastmastery,16,8,8
Huntbeard,aegwynn,695,hunter,beastmastery,22,8,14
Attileus,ragnaros,687,hunter,beastmastery,17,8,9
Crostaws,terokkar,686,hunter,beastmastery,22,8,14
Jexxa,draenor,681,hunter,beastmastery,33,9,24
Elledrin,argent-dawn,680,hunter,beastmastery,21,11,10
Mykris,aegwynn,675,hunter,beastmastery,93,35,58
Зорэллка,soulflayer,672,hunter,beastmastery,12,7,5
Dankohunt,drakthul,672,hunter,beastmastery,12,7,5
Lultrap,nemesis,672,hunter,beastmastery,12,7,5
Belaux,archimonde,672,hunter,beastmastery,12,7,5
Marcsman,blackrock,672,hunter,beastmastery,12,7,5
Gødcømplêx,ravencrest,672,hunter,beastmastery,12,7,5
Waza,grim-batol,672,hunter,beastmastery,12,7,5
Wülfhart,argent-dawn,672,hunter,beastmastery,12,7,5
Alexdi,kazzak,672,hunter,beastmastery,12,7,5
Rânchiêk,ravencrest,672,hunter,beastmastery,12,7,5
Nightvarn,burning-blade,672,hunter,beastmastery,12,7,5
Mspt,archimonde,672,hunter,beastmastery,12,7,5
Varkiza,sylvanas,672,hunter,beastmastery,12,7,5
Загзигзаг,soulflayer,672,hunter,beastmastery,12,7,5
Zamx,outland,672,hunter,beastmastery,12,7,5
Exzö,outland,672,hunter,beastmastery,12,7,5
Clayh,silvermoon,672,hunter,beastmastery,12,7,5
Ufecläimbe,eredar,672,hunter,beastmastery,12,7,5
Potatobeast,twisting-nether,672,hunter,beastmastery,12,7,5
Haxaids,sylvanas,672,hunter,beastmastery,12,7,5
Merakai,aegwynn,672,hunter,beastmastery,12,7,5
Stamzer,drakthul,672,hunter,beastmastery,12,7,5
Eretrya,blackmoore,672,hunter,beastmastery,12,7,5
Mewithoutyou,ragnaros,672,hunter,beastmastery,12,7,5
Hunttes,nagrand,672,hunter,beastmastery,12,7,5
Slejpy,drakthul,672,hunter,beastmastery,12,7,5
Adenøsin,blackmoore,672,hunter,beastmastery,12,7,5
Stillflowi,draenor,672,hunter,beastmastery,12,7,5
Lïîlÿ,ysondre,672,hunter,beastmastery,12,7,5
Kioception,blackrock,672,hunter,beastmastery,12,7,5
Hølinkasbabe,blackmoore,672,hunter,beastmastery,12,7,5
Виралатта,gordunni,672,hunter,beastmastery,12,7,5
Xerathdinger,elune,672,hunter,beastmastery,12,7,5
Whiskeylover,outland,672,hunter,beastmastery,12,7,5
Eisenhørn,archimonde,672,hunter,beastmastery,12,7,5
Hiddenstalke,argent-dawn,672,hunter,beastmastery,12,7,5
Ulfrîc,exodar,672,hunter,beastmastery,12,7,5
Connyrøvøga,stormscale,672,hunter,beastmastery,12,7,5
Сашказнаток,azuregos,672,hunter,beastmastery,12,7,5
Wodhunterjr,ravencrest,672,hunter,beastmastery,12,7,5
Ahotnik,aegwynn,672,hunter,beastmastery,12,7,5
Npkhunt,outland,672,hunter,beastmastery,12,7,5
Найтсол,greymane,672,hunter,beastmastery,12,7,5
Razuye,nerathor,672,hunter,beastmastery,12,7,5
Frods,dun-modr,672,hunter,beastmastery,16,8,8
Fyô,outland,672,hunter,beastmastery,15,7,8
Grokis,blackhand,672,hunter,beastmastery,137,55,82
Chabbs,stormscale,672,hunter,beastmastery,18,7,11
Ромкола,gordunni,672,hunter,beastmastery,18,7,11
Zublime,dragonblight,672,hunter,beastmastery,18,7,11
Düivell,grim-batol,672,hunter,beastmastery,18,7,11
Goosebite,ravencrest,672,hunter,beastmastery,18,7,11
Svinrbglol,arygos,672,hunter,beastmastery,18,7,11
Chïefhunt,twisting-nether,672,hunter,beastmastery,18,7,11
Géeked,ravencrest,672,hunter,beastmastery,18,7,11
Bosessz,ragnaros,672,hunter,beastmastery,18,7,11
Nôldagôn,aegwynn,672,hunter,beastmastery,18,7,11
Mårcxb,antonidas,672,hunter,beastmastery,18,7,11
Дьярэ,gordunni,672,hunter,beastmastery,18,7,11
Boybiron,silvermoon,672,hunter,beastmastery,18,7,11
Slougshot,archimonde,672,hunter,beastmastery,18,7,11
Тандеркейдж,gordunni,672,hunter,beastmastery,18,7,11
Penehuntos,eredar,672,hunter,beastmastery,24,7,17
Uselessx,kazzak,672,hunter,beastmastery,24,7,17
Hêndricks,eredar,672,hunter,beastmastery,24,7,17
Setyouintrap,ravencrest,672,hunter,beastmastery,24,7,17
Летмимейт,howling-fjord,672,hunter,beastmastery,26,7,19
Døømslayer,nemesis,671,hunter,beastmastery,12,7,5
Euhh,stormscale,671,hunter,beastmastery,12,7,5
Junqué,sanguino,671,hunter,beastmastery,12,7,5
Nakepw,stormscale,671,hunter,beastmastery,12,7,5
Nemámponetí,drakthul,671,hunter,beastmastery,12,7,5
Aýsun,kazzak,671,hunter,beastmastery,12,7,5
Cycada,antonidas,671,hunter,beastmastery,12,7,5
Nith,ungoro,671,hunter,beastmastery,12,7,5
Weedonyhunt,hyjal,671,hunter,beastmastery,12,7,5
Бэталол,gordunni,671,hunter,beastmastery,12,7,5
Szrek,frostmane,671,hunter,beastmastery,12,7,5
Karabos,nemesis,671,hunter,beastmastery,12,7,5
Onacid,tarren-mill,671,hunter,beastmastery,12,7,5
Nothrokh,auchindoun,671,hunter,beastmastery,12,7,5
Doubleoseven,frostmane,671,hunter,beastmastery,12,7,5
Aorence,kirin-tor,671,hunter,beastmastery,12,7,5
Стёпкахант,gordunni,671,hunter,beastmastery,15,8,7
Orian,argent-dawn,671,hunter,beastmastery,18,7,11
Thromkhar,sanguino,671,hunter,beastmastery,18,7,11
Lebalaffré,arathi,671,hunter,beastmastery,18,7,11
Убершванц,soulflayer,671,hunter,beastmastery,18,7,11
Mehtämìes,kazzak,671,hunter,beastmastery,18,7,11
Jezaja,draenor,671,hunter,beastmastery,18,7,11
Stónéyyx,azjolnerub,671,hunter,beastmastery,18,7,11
Álfié,ravencrest,671,hunter,beastmastery,18,7,11
Kaisêl,silvermoon,671,hunter,beastmastery,18,7,11
Huntness,kazzak,671,hunter,beastmastery,21,7,14
Shakoor,argent-dawn,671,hunter,beastmastery,24,7,17
Tstigaard,argent-dawn,671,hunter,beastmastery,24,7,17
Løløsifredo,ysondre,671,hunter,beastmastery,26,7,19
Hugart,sylvanas,670,hunter,beastmastery,12,7,5
Èlo,dun-morogh,670,hunter,beastmastery,12,7,5
Хантмантхант,howling-fjord,670,hunter,beastmastery,12,7,5
Äctæon,ravencrest,670,hunter,beastmastery,12,7,5
Hoppelchen,blackmoore,670,hunter,beastmastery,12,7,5
Swaffel,draenor,670,hunter,beastmastery,15,8,7
Sxmphxny,argent-dawn,670,hunter,beastmastery,18,7,11
Hpyhun,draenor,670,hunter,beastmastery,18,7,11
Nocalories,grim-batol,670,hunter,beastmastery,18,7,11
Shalinda,azshara,670,hunter,beastmastery,24,7,17
Paradisiaco,sanguino,670,hunter,beastmastery,24,7,17
Gladiátor,kult-der-verdammten,669,hunter,beastmastery,12,7,5
Хантероо,gordunni,669,hunter,beastmastery,14,7,7
Rhiko,argent-dawn,669,hunter,beastmastery,18,7,11
Casey,zuluhed,669,hunter,beastmastery,18,7,11
Nelerias,defias-brotherhood,669,hunter,beastmastery,24,7,17
Asharial,twisting-nether,668,hunter,beastmastery,21,8,13
Arhyah,medivh,668,hunter,beastmastery,24,7,17
Oldgrandpa,stormscale,667,hunter,beastmastery,18,7,11
Okumo,the-maelstrom,667,hunter,beastmastery,18,7,11
Örrn,ragnaros,667,hunter,beastmastery,24,7,17
Rollei,uldum,666,hunter,beastmastery,12,7,5
Losc,blackrock,666,hunter,beastmastery,18,7,11
Аеессо,gordunni,666,hunter,beastmastery,24,7,17
Papagallo,los-errantes,665,hunter,beastmastery,12,7,5
Aroldo,kazzak,665,hunter,beastmastery,12,7,5
Саэсантессис,howling-fjord,665,hunter,beastmastery,18,7,11
Electrastar,illidan,664,hunter,beastmastery,12,7,5
Beerox,ysondre,664,hunter,beastmastery,18,7,11
Winfar,draenor,664,hunter,beastmastery,24,7,17
Zikkem,burning-legion,663,hunter,beastmastery,24,7,17
Ticklez,shadowsong,658,hunter,beastmastery,12,7,5
Akù,magtheridon,653,hunter,beastmastery,23,7,16
Skaði,bloodfeather,640,hunter,beastmastery,10,8,2
Harog,thrall,639,hunter,beastmastery,14,8,6
Kokorambow,silvermoon,639,hunter,beastmastery,17,7,10
Sniffprince,ragnaros,624,hunter,beastmastery,15,7,8
Shòurén,blackmoore,620,hunter,beastmastery,11,7,4
Craná,blackrock,618,hunter,beastmastery,27,8,19
Stukrotka,hellfire,617,hunter,beastmastery,15,7,8
Silenthunter,blackrock,616,hunter,beastmastery,17,9,8
Zwergnàse,thrall,616,hunter,beastmastery,23,7,16
Tiratats,sylvanas,615,hunter,beastmastery,14,8,6
Skullshooter,twisting-nether,608,hunter,beastmastery,16,7,9
Truxp,tarren-mill,608,hunter,beastmastery,16,7,9
Sferâ,burning-legion,606,hunter,beastmastery,16,7,9
Dnuma,tarren-mill,587,hunter,beastmastery,21,8,13
Mentalbowie,stormreaver,576,hunter,beastmastery,6,6,0
Luke,chromaggus,576,hunter,beastmastery,6,6,0
Slip,silvermoon,576,hunter,beastmastery,12,6,6
Skarra,zuljin,576,hunter,beastmastery,12,6,6
Kabá,eredar,576,hunter,beastmastery,12,6,6
Cítyzens,drakthul,576,hunter,beastmastery,12,6,6
Hidethegun,draenor,576,hunter,beastmastery,12,6,6
Nómarak,drakthul,576,hunter,beastmastery,12,6,6
Razoorine,blackrock,576,hunter,beastmastery,12,6,6
Gîsh,burning-legion,576,hunter,beastmastery,12,6,6
Imonér,frostmane,576,hunter,beastmastery,12,6,6
Зеленыйиисус,gordunni,576,hunter,beastmastery,12,6,6
Burbutsuluki,silvermoon,576,hunter,beastmastery,12,6,6
Darkstripe,turalyon,576,hunter,beastmastery,12,6,6
Astair,hyjal,576,hunter,beastmastery,12,6,6
Мишечкатоп,gordunni,576,hunter,beastmastery,12,6,6
Batony,ravencrest,576,hunter,beastmastery,12,6,6
Массовик,blackscar,576,hunter,beastmastery,12,6,6
Ptithoms,hyjal,576,hunter,beastmastery,12,6,6
Valtondre,argent-dawn,576,hunter,beastmastery,12,6,6
Magicnanø,nemesis,576,hunter,beastmastery,12,6,6
Zêrøtwø,draenor,576,hunter,beastmastery,12,6,6
Niedzwiedzor,silvermoon,576,hunter,beastmastery,12,6,6
Chileys,blackrock,576,hunter,beastmastery,12,6,6
Beasted,frostwolf,576,hunter,beastmastery,12,6,6
Ventrillo,draenor,576,hunter,beastmastery,12,6,6
Iuyiuy,dalaran,576,hunter,beastmastery,12,6,6
Schwaiger,blackhand,576,hunter,beastmastery,12,6,6
Nagu,antonidas,576,hunter,beastmastery,12,6,6
Bodytypedog,ragnaros,576,hunter,beastmastery,12,6,6
Дайсё,soulflayer,576,hunter,beastmastery,12,6,6
Стейнтар,gordunni,576,hunter,beastmastery,12,6,6
Malmet,shattered-hand,576,hunter,beastmastery,12,6,6
Bubboo,dun-modr,576,hunter,beastmastery,12,6,6
Pointnclick,the-maelstrom,576,hunter,beastmastery,12,6,6
Bierbjörn,eredar,576,hunter,beastmastery,12,6,6
Xiviora,archimonde,576,hunter,beastmastery,12,6,6
Boen,nordrassil,576,hunter,beastmastery,12,6,6
Gréènthumbs,ragnaros,576,hunter,beastmastery,12,6,6
Maverz,blackhand,576,hunter,beastmastery,12,6,6
Дэльфис,howling-fjord,576,hunter,beastmastery,12,6,6
Efficíent,auchindoun,576,hunter,beastmastery,12,6,6
Raegal,sanguino,576,hunter,beastmastery,12,6,6
Showdope,drakthul,576,hunter,beastmastery,12,6,6
Ówl,silvermoon,576,hunter,beastmastery,12,6,6
Келентори,gordunni,576,hunter,beastmastery,12,6,6
Pedji,alakir,576,hunter,beastmastery,12,6,6
Fraps,garona,576,hunter,beastmastery,12,6,6
Bablor,kul-tiras,576,hunter,beastmastery,12,6,6
Hï,eitrigg,576,hunter,beastmastery,12,6,6
Xðxðxðxðxðxð,sylvanas,576,hunter,beastmastery,12,6,6
Batcool,tarren-mill,576,hunter,beastmastery,12,6,6
Mclooving,runetotem,576,hunter,beastmastery,12,6,6
Cynosa,tarren-mill,576,hunter,beastmastery,12,6,6
Metalbaci,sylvanas,576,hunter,beastmastery,12,6,6
Testotorben,malfurion,576,hunter,beastmastery,12,6,6
Kaballa,ahnqiraj,576,hunter,beastmastery,12,6,6
Toptìérgoðx,drakthul,576,hunter,beastmastery,12,6,6
Trapiswinyes,aegwynn,576,hunter,beastmastery,12,6,6
Guidomista,drakthul,576,hunter,beastmastery,12,6,6
Healscare,dalaran,576,hunter,beastmastery,16,7,9
Ñibiru,archimonde,576,hunter,beastmastery,21,7,14
Wetto,ravencrest,576,hunter,beastmastery,18,6,12
Bloodpanter,ragnaros,576,hunter,beastmastery,18,6,12
Ramboblast,ravencrest,576,hunter,beastmastery,18,6,12
Qsun,auchindoun,576,hunter,beastmastery,18,6,12
Матанал,gordunni,576,hunter,beastmastery,18,6,12
Realme,blackrock,576,hunter,beastmastery,18,6,12
Vepzen,haomarush,576,hunter,beastmastery,18,6,12
Pergola,spinebreaker,576,hunter,beastmastery,18,6,12
Exwifey,ravencrest,576,hunter,beastmastery,18,6,12
Raztreadör,dun-modr,576,hunter,beastmastery,18,6,12
Klèo,frostwhisper,576,hunter,beastmastery,18,6,12
Safnirxx,tarren-mill,576,hunter,beastmastery,18,6,12
Disyö,kazzak,576,hunter,beastmastery,18,6,12
Zelghor,frostwolf,576,hunter,beastmastery,18,6,12
Nerøz,ravencrest,576,hunter,beastmastery,18,6,12
Cronoz,stormscale,576,hunter,beastmastery,18,6,12
Headhunterzz,dun-modr,576,hunter,beastmastery,18,6,12
Suisiide,antonidas,576,hunter,beastmastery,18,6,12
Свадебная,gordunni,576,hunter,beastmastery,18,6,12
Fotmspec,tarren-mill,576,hunter,beastmastery,18,6,12
Седактив,grom,576,hunter,beastmastery,27,7,20
Сексишмекс,soulflayer,576,hunter,beastmastery,24,6,18
Rheyl,dun-morogh,576,hunter,beastmastery,30,6,24
Superx,argent-dawn,575,hunter,beastmastery,6,6,0
Nosfuratu,stormscale,575,hunter,beastmastery,12,6,6
Blacksyo,elune,575,hunter,beastmastery,12,6,6
Robinlebois,ysondre,575,hunter,beastmastery,12,6,6
Truedetectiv,aggramar,575,hunter,beastmastery,12,6,6
Нагито,galakrond,575,hunter,beastmastery,12,6,6
Splodge,kazzak,575,hunter,beastmastery,12,6,6
Gløbi,malfurion,575,hunter,beastmastery,12,6,6
Deôrro,twisting-nether,575,hunter,beastmastery,12,6,6
Elua,guldan,575,hunter,beastmastery,12,6,6
Jimpage,eredar,575,hunter,beastmastery,12,6,6
Dippöverdos,outland,575,hunter,beastmastery,12,6,6
Tukezz,outland,575,hunter,beastmastery,12,6,6
Абунай,soulflayer,575,hunter,beastmastery,12,6,6
Eyetto,dun-modr,575,hunter,beastmastery,12,6,6
Ghanik,draenor,575,hunter,beastmastery,12,6,6
Ipad,cthun,575,hunter,beastmastery,12,6,6
Iddqd,outland,575,hunter,beastmastery,12,6,6
Hunterizi,silvermoon,575,hunter,beastmastery,12,6,6
Ølympx,blackhand,575,hunter,beastmastery,18,6,12
Slaÿers,archimonde,575,hunter,beastmastery,18,6,12
Donneraàn,blackrock,575,hunter,beastmastery,18,6,12
Ápêx,ravencrest,575,hunter,beastmastery,18,6,12
Szafri,draenor,575,hunter,beastmastery,18,6,12
Piit,elune,575,hunter,beastmastery,18,6,12
Sylphie,dalaran,575,hunter,beastmastery,18,6,12
Dödskatten,kazzak,575,hunter,beastmastery,18,6,12
Hitray,stormscale,575,hunter,beastmastery,18,6,12
Çraze,silvermoon,575,hunter,beastmastery,18,6,12
Ketator,archimonde,574,hunter,beastmastery,12,6,6
Musjägaretvå,silvermoon,574,hunter,beastmastery,15,7,8
Kannon,twisting-nether,574,hunter,beastmastery,18,6,12
Вентрана,gordunni,574,hunter,beastmastery,18,6,12
Talmïr,archimonde,574,hunter,beastmastery,24,6,18
Syldroxia,antonidas,574,hunter,beastmastery,24,6,18
Cliff,kiljaeden,572,hunter,beastmastery,30,6,24
Jsâ,blackmoore,571,hunter,beastmastery,12,6,6
Jelezenchuk,outland,571,hunter,beastmastery,12,6,6
Naarâ,blackhand,571,hunter,beastmastery,24,6,18
Úlfynja,sylvanas,570,hunter,beastmastery,12,6,6
Corrwus,argent-dawn,570,hunter,beastmastery,18,6,12
Кеоки,soulflayer,569,hunter,beastmastery,18,6,12
Merodin,nerathor,569,hunter,beastmastery,18,6,12
Олькахант,galakrond,568,hunter,beastmastery,12,6,6
Zahgrug,aerie-peak,568,hunter,beastmastery,12,6,6
Notrapnaga,stormscale,559,hunter,beastmastery,11,6,5
Crasharrow,stormscale,544,hunter,beastmastery,22,6,16
Béarrockx,alleria,543,hunter,beastmastery,11,6,5
Egoshôoter,eredar,543,hunter,beastmastery,14,7,7
Hamina,tarren-mill,543,hunter,beastmastery,17,6,11
Åånei,twisting-nether,528,hunter,beastmastery,15,6,9
Инфлэйн,howling-fjord,527,hunter,beastmastery,11,6,5
Kukenisluken,stormscale,527,hunter,beastmastery,11,6,5
Archfiend,stormscale,527,hunter,beastmastery,11,6,5
Braatski,stormscale,526,hunter,beastmastery,18,7,11
Kissay,blackmoore,522,hunter,beastmastery,12,7,5
Dràcula,tarren-mill,521,hunter,beastmastery,20,7,13
Devilmilo,khaz-modan,520,hunter,beastmastery,15,6,9
Raxxic,eredar,512,hunter,beastmastery,10,6,4
Buzzle,sylvanas,512,hunter,beastmastery,22,6,16
Níne,sylvanas,511,hunter,beastmastery,11,6,5
Powerfist,blackhand,511,hunter,beastmastery,16,6,10
Sacroz,frostwhisper,510,hunter,beastmastery,20,6,14
Gnomslakter,ragnaros,509,hunter,beastmastery,16,6,10
Nefroo,defias-brotherhood,505,hunter,beastmastery,11,6,5
Sunyjuyono,ravencrest,480,hunter,beastmastery,6,5,1
Xreroll,ysondre,480,hunter,beastmastery,6,5,1
Samuru,auchindoun,480,hunter,beastmastery,6,5,1
Smokerofweed,kazzak,480,hunter,beastmastery,6,5,1
Wellocérapt,confrérie-du-thorium,480,hunter,beastmastery,6,5,1
Connyrövöga,draenor,480,hunter,beastmastery,6,5,1
Dogliz,stormscale,480,hunter,beastmastery,6,5,1
Huntourd,eredar,480,hunter,beastmastery,6,5,1
Jinxbomber,draenor,480,hunter,beastmastery,6,5,1
Qaedri,kazzak,480,hunter,beastmastery,6,5,1
Techpoint,silvermoon,480,hunter,beastmastery,6,5,1
Мунмейстер,blackscar,480,hunter,beastmastery,6,5,1
Pantherovich,ravencrest,480,hunter,beastmastery,6,5,1
Arkhalis,drakthul,480,hunter,beastmastery,6,5,1
Jorhan,ravencrest,480,hunter,beastmastery,6,5,1
Badboyxoxo,stormscale,480,hunter,beastmastery,6,5,1
Sheeya,argent-dawn,480,hunter,beastmastery,6,5,1
Virel,sanguino,480,hunter,beastmastery,7,5,2
Bashrah,blackrock,480,hunter,beastmastery,9,6,3
Kongharald,ravencrest,480,hunter,beastmastery,12,5,7
Mjkhunt,tarren-mill,480,hunter,beastmastery,12,5,7
Нитидон,howling-fjord,480,hunter,beastmastery,12,5,7
Lersey,blackmoore,480,hunter,beastmastery,12,5,7
Noraka,blackrock,480,hunter,beastmastery,12,5,7
Sharkeater,outland,480,hunter,beastmastery,12,5,7
Bubbahubba,ragnaros,480,hunter,beastmastery,12,5,7
Mïrynn,culte-de-la-rive-noire,480,hunter,beastmastery,12,5,7
Вуйчеч,howling-fjord,480,hunter,beastmastery,12,5,7
Ôrïøn,archimonde,480,hunter,beastmastery,12,5,7
Sarhina,draenor,480,hunter,beastmastery,12,5,7
Aleina,dentarg,480,hunter,beastmastery,12,5,7
Khort,twisting-nether,480,hunter,beastmastery,12,5,7
Zrijad,draenor,480,hunter,beastmastery,12,5,7
Waneìs,stormscale,480,hunter,beastmastery,12,5,7
Джеймсфранко,blackscar,480,hunter,beastmastery,12,5,7
Søtyz,dalaran,480,hunter,beastmastery,12,5,7
Juniorm,kazzak,480,hunter,beastmastery,12,5,7
Shimzz,twisting-nether,480,hunter,beastmastery,12,5,7
Copenhyggen,silvermoon,480,hunter,beastmastery,12,5,7
Drandra,tarren-mill,480,hunter,beastmastery,12,5,7
Peppiz,ragnaros,480,hunter,beastmastery,12,5,7
Квит,blackscar,480,hunter,beastmastery,12,5,7
Dordok,ysondre,480,hunter,beastmastery,12,5,7
Thursty,twisting-nether,480,hunter,beastmastery,12,5,7
Bloodymarìe,kelthuzad,480,hunter,beastmastery,12,5,7
Bojestemrudy,outland,480,hunter,beastmastery,12,5,7
Eredark,zuljin,480,hunter,beastmastery,12,5,7
Minisniper,aegwynn,480,hunter,beastmastery,12,5,7
Óné,blackhand,480,hunter,beastmastery,12,5,7
Yésdave,stormscale,480,hunter,beastmastery,12,5,7
Eferos,quelthalas,480,hunter,beastmastery,12,5,7
Darkdrais,archimonde,480,hunter,beastmastery,12,5,7
Chase,wildhammer,480,hunter,beastmastery,12,5,7
Hiff,burning-legion,480,hunter,beastmastery,12,5,7
Elvenian,twisting-nether,480,hunter,beastmastery,12,5,7
Келкузд,howling-fjord,480,hunter,beastmastery,12,5,7
Kanzlerkohl,frostwolf,480,hunter,beastmastery,12,5,7
Naposin,ragnaros,480,hunter,beastmastery,12,5,7
Feelmyfurý,tarren-mill,480,hunter,beastmastery,12,5,7
Quoicoubèh,hyjal,480,hunter,beastmastery,12,5,7
Wildwingsebb,nazjatar,480,hunter,beastmastery,12,5,7
Palomo,argent-dawn,480,hunter,beastmastery,12,5,7
Honeey,dun-modr,480,hunter,beastmastery,12,5,7
Benjtrapgodx,antonidas,480,hunter,beastmastery,12,5,7
Двустволка,gordunni,480,hunter,beastmastery,12,5,7
Maruxs,dun-modr,480,hunter,beastmastery,12,5,7
Arsola,sylvanas,480,hunter,beastmastery,12,5,7
Roomeo,the-maelstrom,480,hunter,beastmastery,12,5,7
Jins,illidan,480,hunter,beastmastery,12,5,7
Тоу,deathguard,480,hunter,beastmastery,13,5,8
Elðer,dentarg,480,hunter,beastmastery,16,6,10
Lepap,arygos,480,hunter,beastmastery,17,5,12
Hiphophunter,thunderhorn,480,hunter,beastmastery,18,5,13
Duaij,outland,480,hunter,beastmastery,18,5,13
Schwen,grim-batol,480,hunter,beastmastery,18,5,13
Begøne,draenor,480,hunter,beastmastery,18,5,13
Uqash,outland,480,hunter,beastmastery,18,5,13
Ohboy,dun-morogh,480,hunter,beastmastery,18,5,13
Killstreak,magtheridon,480,hunter,beastmastery,18,5,13
Stomugromova,ragnaros,480,hunter,beastmastery,18,5,13
Chrishyh,blackrock,480,hunter,beastmastery,18,5,13
Artexxia,kazzak,479,hunter,beastmastery,6,5,1
Möttii,blackrock,479,hunter,beastmastery,6,5,1
Скримзх,gordunni,479,hunter,beastmastery,6,5,1
Droubidi,garona,479,hunter,beastmastery,12,5,7
Zanto,aegwynn,479,hunter,beastmastery,12,5,7
Енвина,gordunni,479,hunter,beastmastery,12,5,7
Baldazr,shadowsong,479,hunter,beastmastery,12,5,7
Hallem,karazhan,479,hunter,beastmastery,12,5,7
Ivanrockstar,draenor,479,hunter,beastmastery,12,5,7
Slett,twisting-nether,479,hunter,beastmastery,12,5,7
Живучийорех,gordunni,479,hunter,beastmastery,12,5,7
Atranex,ravencrest,479,hunter,beastmastery,12,5,7
Swïtchz,hyjal,479,hunter,beastmastery,12,5,7
Jana,ragnaros,479,hunter,beastmastery,12,5,7
Snots,stormscale,479,hunter,beastmastery,18,5,13
Arielowy,doomhammer,479,hunter,beastmastery,18,5,13
Itssharpwall,stormscale,479,hunter,beastmastery,24,5,19
Agarez,blackrock,478,hunter,beastmastery,6,5,1
Kepâssa,ysondre,478,hunter,beastmastery,12,5,7
Добрыйклыкач,gordunni,478,hunter,beastmastery,12,5,7
Спиночух,lich-king,477,hunter,beastmastery,12,5,7
Starfinder,saurfang,477,hunter,beastmastery,16,6,10
Ghostaim,kazzak,475,hunter,beastmastery,10,6,4
Alunite,sporeggar,475,hunter,beastmastery,12,5,7
Asca,eldrethalas,475,hunter,beastmastery,18,5,13
Опаснаяя,borean-tundra,473,hunter,beastmastery,12,5,7
Ferax,alleria,472,hunter,beastmastery,12,5,7
Ahilleaa,aegwynn,472,hunter,beastmastery,12,5,7
Ruhen,aegwynn,463,hunter,beastmastery,11,5,6
Tiguy,archimonde,462,hunter,beastmastery,23,5,18
Momohenní,archimonde,448,hunter,beastmastery,10,5,5
Kabedon,drakthul,448,hunter,beastmastery,16,5,11
Artemmis,tarren-mill,447,hunter,beastmastery,11,5,6
Drennak,kult-der-verdammten,447,hunter,beastmastery,17,5,12
Xsniper,sylvanas,446,hunter,beastmastery,17,5,12
Prebranatz,the-shatar,432,hunter,beastmastery,15,5,10
Såvëâmäzøñíà,stormscale,431,hunter,beastmastery,11,5,6
Braînbúg,blackmoore,426,hunter,beastmastery,12,6,6
Robingood,alexstrasza,425,hunter,beastmastery,17,7,10
Grollrik,blackhand,425,hunter,beastmastery,15,6,9
Sarnak,thrall,416,hunter,beastmastery,10,5,5
Valamié,stormscale,415,hunter,beastmastery,8,5,3
Topbow,talnivarr,415,hunter,beastmastery,10,5,5
Роктавия,howling-fjord,415,hunter,beastmastery,10,5,5
Darkshe,dun-modr,415,hunter,beastmastery,14,5,9
Барногор,gordunni,384,hunter,beastmastery,6,4,2
Evengance,dragonblight,384,hunter,beastmastery,6,4,2
Kyarin,draenor,384,hunter,beastmastery,6,4,2
Sindaro,kazzak,384,hunter,beastmastery,6,4,2
Evílíckxøxø,ravencrest,384,hunter,beastmastery,6,4,2
Трисциллочка,howling-fjord,384,hunter,beastmastery,6,4,2
Ntguilty,blackrock,384,hunter,beastmastery,6,4,2
Nihae,drakthul,384,hunter,beastmastery,6,4,2
Crooklyn,ravencrest,384,hunter,beastmastery,6,4,2
Khregan,aerie-peak,384,hunter,beastmastery,6,4,2
Dasimir,blackrock,384,hunter,beastmastery,6,4,2
Dackeldustin,norgannon,384,hunter,beastmastery,6,4,2
Zyprix,blackrock,384,hunter,beastmastery,6,4,2
Саняприцел,howling-fjord,384,hunter,beastmastery,6,4,2
Sambucamasta,draenor,384,hunter,beastmastery,6,4,2
Патапум,deathguard,384,hunter,beastmastery,6,4,2
Djurmästaren,ravencrest,384,hunter,beastmastery,6,4,2
Wristflex,kazzak,384,hunter,beastmastery,6,4,2
Sín,kirin-tor,384,hunter,beastmastery,6,4,2
Вихтриэль,gordunni,384,hunter,beastmastery,6,4,2
Dràka,twisting-nether,384,hunter,beastmastery,6,4,2
Вандамос,soulflayer,384,hunter,beastmastery,6,4,2
Murkek,drakthul,384,hunter,beastmastery,6,4,2
Marksmaniak,ysondre,384,hunter,beastmastery,6,4,2
Moelester,eredar,384,hunter,beastmastery,6,4,2
Няшуличка,gordunni,384,hunter,beastmastery,6,4,2
Ihsie,eredar,384,hunter,beastmastery,6,4,2
Ðøpèz,frostwolf,384,hunter,beastmastery,6,4,2
Psychotik,dalaran,384,hunter,beastmastery,6,4,2
Mothmanx,kazzak,384,hunter,beastmastery,6,4,2
Кайсго,gordunni,384,hunter,beastmastery,6,4,2
Schwabbels,silvermoon,384,hunter,beastmastery,6,4,2
Riema,ragnaros,384,hunter,beastmastery,6,4,2
Cryneth,ravencrest,384,hunter,beastmastery,6,4,2
Arellia,blackmoore,384,hunter,beastmastery,6,4,2
Szybky,defias-brotherhood,384,hunter,beastmastery,6,4,2
Поторопись,gordunni,384,hunter,beastmastery,6,4,2
Разплюханка,howling-fjord,384,hunter,beastmastery,6,4,2
Шадоуселект,howling-fjord,384,hunter,beastmastery,6,4,2
Хипстеркотик,gordunni,384,hunter,beastmastery,6,4,2
Garratha,burning-legion,384,hunter,beastmastery,6,4,2
Электракрут,gordunni,384,hunter,beastmastery,6,4,2
Toonzdude,blackmoore,384,hunter,beastmastery,6,4,2
Mórz,magtheridon,384,hunter,beastmastery,6,4,2
Robbingyou,tarren-mill,384,hunter,beastmastery,6,4,2
Oobe,hyjal,384,hunter,beastmastery,6,4,2
Zbyrkana,neptulon,384,hunter,beastmastery,6,4,2
Hetzenauer,nathrezim,384,hunter,beastmastery,6,4,2
Chindaliña,zuljin,384,hunter,beastmastery,6,4,2
Misfire,archimonde,384,hunter,beastmastery,6,4,2
Noxxen,burning-legion,384,hunter,beastmastery,6,4,2
Ginirosh,blackmoore,384,hunter,beastmastery,6,4,2
Ghõst,frostmane,384,hunter,beastmastery,6,4,2
Kàisèr,shendralar,384,hunter,beastmastery,6,4,2
Fajitax,lightbringer,384,hunter,beastmastery,6,4,2
Ещёвмете,blackscar,384,hunter,beastmastery,6,4,2
Missmytraps,stormscale,384,hunter,beastmastery,6,4,2
Lávender,magtheridon,384,hunter,beastmastery,6,4,2
Nomorepain,outland,384,hunter,beastmastery,6,4,2
Bohemond,stormrage,384,hunter,beastmastery,6,4,2
Cainzy,silvermoon,384,hunter,beastmastery,6,4,2
Balamut,aegwynn,384,hunter,beastmastery,6,4,2
Celebor,sanguino,384,hunter,beastmastery,6,4,2
Dzesija,aszune,384,hunter,beastmastery,6,4,2
Noux,stormscale,384,hunter,beastmastery,6,4,2
Yungkillshot,aegwynn,384,hunter,beastmastery,6,4,2
Elonyr,sanguino,384,hunter,beastmastery,6,4,2
Stingarrow,stormscale,384,hunter,beastmastery,6,4,2
Quasarx,draenor,384,hunter,beastmastery,9,5,4
Зонксс,gordunni,384,hunter,beastmastery,9,5,4
Lancer,aggra-português,384,hunter,beastmastery,12,6,6
Pson,draenor,384,hunter,beastmastery,10,5,5
Mystyle,sylvanas,384,hunter,beastmastery,15,5,10
Reakanz,tarren-mill,384,hunter,beastmastery,12,4,8
Khyleanqt,dun-modr,384,hunter,beastmastery,12,4,8
Marzenielas,silvermoon,384,hunter,beastmastery,12,4,8
Somethíngmad,stormscale,384,hunter,beastmastery,12,4,8
Zähmbar,malganis,384,hunter,beastmastery,12,4,8
Dissectiøn,hyjal,384,hunter,beastmastery,12,4,8
Thekev,ravencrest,384,hunter,beastmastery,12,4,8
Qiix,kargath,384,hunter,beastmastery,12,4,8
Sharpeneye,ragnaros,384,hunter,beastmastery,12,4,8
Örjans,tarren-mill,384,hunter,beastmastery,12,4,8
Toonzbro,blackmoore,384,hunter,beastmastery,12,4,8
Donbonz,blackmoore,384,hunter,beastmastery,12,4,8
Вейзу,ashenvale,384,hunter,beastmastery,12,4,8
Valomeere,tarren-mill,384,hunter,beastmastery,12,4,8
Aléxy,sanguino,384,hunter,beastmastery,12,4,8
Bobtroll,twisting-nether,384,hunter,beastmastery,12,4,8
Nastynutshot,stormscale,384,hunter,beastmastery,12,4,8
Бочонок,goldrinn,384,hunter,beastmastery,12,4,8
Katana,stormreaver,384,hunter,beastmastery,12,4,8
Rockshredder,ravencrest,384,hunter,beastmastery,12,4,8
Sîriell,arthas,384,hunter,beastmastery,12,4,8
Samasukë,grim-batol,384,hunter,beastmastery,12,4,8
Дэлмор,greymane,384,hunter,beastmastery,12,4,8
Hattorisama,ghostlands,384,hunter,beastmastery,12,4,8
Teddybeardo,stormscale,384,hunter,beastmastery,12,4,8
Catman,stormreaver,384,hunter,beastmastery,12,4,8
Tøixøna,tyrande,384,hunter,beastmastery,12,4,8
Grigur,dalaran,384,hunter,beastmastery,12,4,8
Chui,twisting-nether,384,hunter,beastmastery,12,4,8
Biciclentiu,twisting-nether,384,hunter,beastmastery,12,4,8
Thérón,ravencrest,384,hunter,beastmastery,12,4,8
Bæbækk,frostmane,384,hunter,beastmastery,12,4,8
Zakert,zuljin,384,hunter,beastmastery,12,4,8
Staynador,turalyon,384,hunter,beastmastery,12,4,8
Shakuran,burning-legion,384,hunter,beastmastery,12,4,8
Trollohunt,twisting-nether,384,hunter,beastmastery,12,4,8
Navarro,nemesis,384,hunter,beastmastery,12,4,8
Серцебиение,soulflayer,384,hunter,beastmastery,12,4,8
Skydraz,ysondre,384,hunter,beastmastery,12,4,8
Nßatrapper,outland,384,hunter,beastmastery,12,4,8
Neocb,ravencrest,384,hunter,beastmastery,12,4,8
Greim,blackmoore,384,hunter,beastmastery,12,4,8
Sjufemman,ravencrest,384,hunter,beastmastery,12,4,8
Zippyzen,twisting-nether,384,hunter,beastmastery,12,4,8
Monnee,outland,384,hunter,beastmastery,12,4,8
Horxxa,kul-tiras,384,hunter,beastmastery,12,4,8
Mógwaí,stormscale,384,hunter,beastmastery,12,4,8
Zynga,sylvanas,384,hunter,beastmastery,12,4,8
Khanö,twisting-nether,384,hunter,beastmastery,12,4,8
Амадаре,howling-fjord,384,hunter,beastmastery,12,4,8
Venatrixx,azjolnerub,384,hunter,beastmastery,12,4,8
Zaknow,dalaran,384,hunter,beastmastery,12,4,8
Willzz,ravencrest,384,hunter,beastmastery,12,4,8
Rabiate,blackrock,384,hunter,beastmastery,12,4,8
Korkyra,outland,384,hunter,beastmastery,12,4,8
Brønkø,azshara,384,hunter,beastmastery,12,4,8
Lexayah,twisting-nether,384,hunter,beastmastery,12,4,8
Xavers,outland,384,hunter,beastmastery,12,4,8
Nizzoz,blackmoore,384,hunter,beastmastery,12,4,8
Malromero,outland,384,hunter,beastmastery,12,4,8
Дланьгоспода,soulflayer,384,hunter,beastmastery,13,4,9
Petshopbøy,veklor,384,hunter,beastmastery,13,4,9
Gps,twilights-hammer,384,hunter,beastmastery,18,4,14
Darts,outland,384,hunter,beastmastery,18,4,14
Døgtamer,twisting-nether,384,hunter,beastmastery,18,4,14
Kayvaal,kaelthas,384,hunter,beastmastery,18,4,14
Mélovéa,sinstralis,384,hunter,beastmastery,18,4,14
Tervueren,burning-blade,384,hunter,beastmastery,18,4,14
Bemtistaru,draenor,384,hunter,beastmastery,18,4,14
Resonate,stormreaver,383,hunter,beastmastery,6,4,2
Whyareurunin,silvermoon,383,hunter,beastmastery,6,4,2
Zrip,kazzak,383,hunter,beastmastery,6,4,2
Lyute,draenor,383,hunter,beastmastery,6,4,2
Xscaper,twilights-hammer,383,hunter,beastmastery,6,4,2
Doguago,draenor,383,hunter,beastmastery,12,4,8
Irduzir,silvermoon,383,hunter,beastmastery,12,4,8
Зукипер,borean-tundra,383,hunter,beastmastery,12,4,8
Steez,hyjal,383,hunter,beastmastery,12,4,8
Åhman,defias-brotherhood,383,hunter,beastmastery,12,4,8
Lalluna,malganis,383,hunter,beastmastery,12,4,8
Huntseeker,draenor,383,hunter,beastmastery,12,4,8
Greenhorned,antonidas,383,hunter,beastmastery,12,4,8
Aaxecute,silvermoon,383,hunter,beastmastery,12,4,8
Enerhunt,ysondre,383,hunter,beastmastery,12,4,8
Luvnoc,hyjal,383,hunter,beastmastery,12,4,8
Nuyy,blackrock,383,hunter,beastmastery,12,4,8
Annababygirl,silvermoon,383,hunter,beastmastery,12,4,8
Machini,terokkar,383,hunter,beastmastery,17,4,13
Mugiwaras,eldrethalas,383,hunter,beastmastery,18,4,14
Neuwi,stormreaver,382,hunter,beastmastery,12,4,8
Яугеныч,blackscar,381,hunter,beastmastery,12,4,8
Sanite,dun-morogh,381,hunter,beastmastery,12,4,8
Jolox,blackrock,379,hunter,beastmastery,12,4,8
Thelasiel,aerie-peak,379,hunter,beastmastery,14,4,10
Uab,dun-morogh,371,hunter,beastmastery,30,4,26
Стрижкакаре,soulflayer,367,hunter,beastmastery,11,4,7
Masarusan,eredar,366,hunter,beastmastery,17,4,13
Løssen,outland,352,hunter,beastmastery,10,4,6
Zakos,kirin-tor,351,hunter,beastmastery,17,4,13
Jaszczomp,magtheridon,350,hunter,beastmastery,16,4,12
Meridià,malorne,336,hunter,beastmastery,9,4,5
Harpers,kazzak,336,hunter,beastmastery,15,4,11
Itzcritch,tarren-mill,330,hunter,beastmastery,14,5,9
Skyh,outland,330,hunter,beastmastery,16,5,11
Foxielove,ghostlands,330,hunter,beastmastery,18,5,13
Greinktar,archimonde,317,hunter,beastmastery,10,4,6
Kyudoka,sylvanas,288,hunter,beastmastery,6,3,3
Sugutor,malfurion,288,hunter,beastmastery,6,3,3
Knallêrbse,blackmoore,288,hunter,beastmastery,6,3,3
Birdwatcher,kazzak,288,hunter,beastmastery,6,3,3
Доррети,howling-fjord,288,hunter,beastmastery,6,3,3
Kronkh,nemesis,288,hunter,beastmastery,6,3,3
Mooj,malganis,288,hunter,beastmastery,6,3,3
Sebikh,ravencrest,288,hunter,beastmastery,6,3,3
Козладой,gordunni,288,hunter,beastmastery,6,3,3
Наладдчик,howling-fjord,288,hunter,beastmastery,6,3,3
Dragnial,kazzak,288,hunter,beastmastery,6,3,3
Prurt,pozzo-delleternità,288,hunter,beastmastery,6,3,3
Teasyh,sylvanas,288,hunter,beastmastery,6,3,3
Деллвиш,howling-fjord,288,hunter,beastmastery,6,3,3
Zoophobiaqt,silvermoon,288,hunter,beastmastery,6,3,3
Unferth,the-venture-co,288,hunter,beastmastery,6,3,3
Lastshott,kazzak,288,hunter,beastmastery,6,3,3
Колтрэйнборз,blackscar,288,hunter,beastmastery,6,3,3
Lioneli,sylvanas,288,hunter,beastmastery,6,3,3
Enthur,sylvanas,288,hunter,beastmastery,6,3,3
Skrag,outland,288,hunter,beastmastery,6,3,3
Ártemide,pozzo-delleternità,288,hunter,beastmastery,6,3,3
Elbatale,sylvanas,288,hunter,beastmastery,6,3,3
Anhur,blackmoore,288,hunter,beastmastery,6,3,3
Fangzahn,aegwynn,288,hunter,beastmastery,6,3,3
Элаган,soulflayer,288,hunter,beastmastery,6,3,3
Daela,elune,288,hunter,beastmastery,6,3,3
Visas,burning-legion,288,hunter,beastmastery,6,3,3
Innaria,argent-dawn,288,hunter,beastmastery,6,3,3
Демела,gordunni,288,hunter,beastmastery,6,3,3
Trapbing,ravencrest,288,hunter,beastmastery,6,3,3
Bugspitz,outland,288,hunter,beastmastery,6,3,3
Djtrapyasis,blackmoore,288,hunter,beastmastery,6,3,3
Lûnelle,argent-dawn,288,hunter,beastmastery,6,3,3
Verøx,kazzak,288,hunter,beastmastery,6,3,3
Ruttless,tarren-mill,288,hunter,beastmastery,6,3,3
Akahr,thrall,288,hunter,beastmastery,6,3,3
Atromist,argent-dawn,288,hunter,beastmastery,6,3,3
Delaghettoo,kilrogg,288,hunter,beastmastery,6,3,3
Kíllshot,blades-edge,288,hunter,beastmastery,6,3,3
Killkekmand,ravencrest,288,hunter,beastmastery,6,3,3
Nervetøxin,ravencrest,288,hunter,beastmastery,6,3,3
Артекриогг,soulflayer,288,hunter,beastmastery,6,3,3
Стингергодх,gordunni,288,hunter,beastmastery,6,3,3
Huntaloko,outland,288,hunter,beastmastery,6,3,3
Кискавтесте,gordunni,288,hunter,beastmastery,6,3,3
Tokkie,burning-blade,288,hunter,beastmastery,6,3,3
Шеннокс,howling-fjord,288,hunter,beastmastery,6,3,3
Nestereo,zirkel-des-cenarius,288,hunter,beastmastery,6,3,3
Czauner,blackmoore,288,hunter,beastmastery,6,3,3
Humanoidorc,the-maelstrom,288,hunter,beastmastery,6,3,3
Aimshot,ravencrest,288,hunter,beastmastery,6,3,3
Japuog,kazzak,288,hunter,beastmastery,6,3,3
Zorine,culte-de-la-rive-noire,288,hunter,beastmastery,6,3,3
Nathah,burning-legion,288,hunter,beastmastery,6,3,3
Yssup,frostmane,288,hunter,beastmastery,6,3,3
Трапавграунд,howling-fjord,288,hunter,beastmastery,6,3,3
Gehrketrap,silvermoon,288,hunter,beastmastery,6,3,3
Huntsolo,ravencrest,288,hunter,beastmastery,6,3,3
Katzchen,burning-legion,288,hunter,beastmastery,6,3,3
Оркос,deathweaver,288,hunter,beastmastery,6,3,3
Datagrám,kazzak,288,hunter,beastmastery,6,3,3
Fedya,kazzak,288,hunter,beastmastery,6,3,3
Káfros,ravencrest,288,hunter,beastmastery,6,3,3
Mikâil,blackmoore,288,hunter,beastmastery,6,3,3
Izummii,sylvanas,288,hunter,beastmastery,6,3,3
Râkim,blackmoore,288,hunter,beastmastery,6,3,3
Будкусломаю,grom,288,hunter,beastmastery,6,3,3
Natashä,area-52,288,hunter,beastmastery,6,3,3
Nelf,shattered-hand,288,hunter,beastmastery,6,3,3
Люциферо,goldrinn,288,hunter,beastmastery,6,3,3
Скукота,grom,288,hunter,beastmastery,6,3,3
Keyshu,die-aldor,288,hunter,beastmastery,6,3,3
Pispirelul,ravencrest,288,hunter,beastmastery,6,3,3
Боураш,gordunni,288,hunter,beastmastery,6,3,3
Noop,sylvanas,288,hunter,beastmastery,6,3,3
Scartet,blackmoore,288,hunter,beastmastery,6,3,3
Кромен,eversong,288,hunter,beastmastery,6,3,3
Тохаад,eversong,288,hunter,beastmastery,6,3,3
Дедзловред,eversong,288,hunter,beastmastery,6,3,3
Svinaset,shattered-hand,288,hunter,beastmastery,6,3,3
Popofles,outland,288,hunter,beastmastery,6,3,3
Moccapudding,stormreaver,288,hunter,beastmastery,6,3,3
Zdravkomamic,kazzak,288,hunter,beastmastery,6,3,3
Calyssae,shattered-halls,288,hunter,beastmastery,6,3,3
Kxx,kazzak,288,hunter,beastmastery,6,3,3
Vanrazorz,darksorrow,288,hunter,beastmastery,6,3,3
Ликсандор,gordunni,288,hunter,beastmastery,6,3,3
Nevêrse,archimonde,288,hunter,beastmastery,6,3,3
Rhaonor,draenor,288,hunter,beastmastery,6,3,3
Lofiel,aegwynn,288,hunter,beastmastery,6,3,3
Hinorist,ravencrest,288,hunter,beastmastery,6,3,3
Køhr,archimonde,288,hunter,beastmastery,6,3,3
Taurïel,stormscale,288,hunter,beastmastery,6,3,3
Ostia,stormscale,288,hunter,beastmastery,6,3,3
Bawzé,archimonde,288,hunter,beastmastery,6,3,3
Müvészúr,ragnaros,288,hunter,beastmastery,6,3,3
Rhyle,hyjal,288,hunter,beastmastery,6,3,3
Heskel,hyjal,288,hunter,beastmastery,6,3,3
Pîngkongx,antonidas,288,hunter,beastmastery,6,3,3
Tonttulul,draenor,288,hunter,beastmastery,6,3,3
Exquisitor,draenor,288,hunter,beastmastery,6,3,3
Микихаса,galakrond,288,hunter,beastmastery,6,3,3
Lunastrike,frostwolf,288,hunter,beastmastery,6,3,3
Steenzor,twisting-nether,288,hunter,beastmastery,6,3,3
Chassgirlz,archimonde,288,hunter,beastmastery,6,3,3
Goldenböw,ravencrest,288,hunter,beastmastery,6,3,3
Varøsch,thrall,288,hunter,beastmastery,6,3,3
Blazeblue,hyjal,288,hunter,beastmastery,6,3,3
Eatmenow,antonidas,288,hunter,beastmastery,6,3,3
Sakaryali,silvermoon,288,hunter,beastmastery,6,3,3
Eveo,antonidas,288,hunter,beastmastery,6,3,3
Hunterbestie,eredar,288,hunter,beastmastery,6,3,3
Bòw,antonidas,288,hunter,beastmastery,6,3,3
Ellemanae,dalaran,288,hunter,beastmastery,6,3,3
Shedzargo,twisting-nether,288,hunter,beastmastery,6,3,3
Qwèrts,stormscale,288,hunter,beastmastery,6,3,3
Randire,guldan,288,hunter,beastmastery,6,3,3
Cartuzinho,twisting-nether,288,hunter,beastmastery,6,3,3
Bârli,amanthul,288,hunter,beastmastery,6,3,3
Kelp,silvermoon,288,hunter,beastmastery,6,3,3
Kragán,silvermoon,288,hunter,beastmastery,6,3,3
Selvele,hyjal,288,hunter,beastmastery,6,3,3
Frendo,stormscale,288,hunter,beastmastery,6,3,3
Ðøømsðay,sanguino,288,hunter,beastmastery,6,3,3
Ilovejwrld,dun-modr,288,hunter,beastmastery,6,3,3
Arcô,dun-modr,288,hunter,beastmastery,6,3,3
Heîsì,eredar,288,hunter,beastmastery,6,3,3
Hexorn,ysondre,288,hunter,beastmastery,6,3,3
Chrønôs,archimonde,288,hunter,beastmastery,6,3,3
Djihadi,ysondre,288,hunter,beastmastery,6,3,3
Adewale,archimonde,288,hunter,beastmastery,6,3,3
Darthbow,outland,288,hunter,beastmastery,6,3,3
Whitehor,ragnaros,288,hunter,beastmastery,6,3,3
Lookmyezzy,ravencrest,288,hunter,beastmastery,6,3,3
Ekz,twisting-nether,288,hunter,beastmastery,6,3,3
Janoh,dalaran,288,hunter,beastmastery,6,3,3
Dashaft,kazzak,288,hunter,beastmastery,6,3,3
Abonah,khaz-modan,288,hunter,beastmastery,6,3,3
Kanwfulldmg,stormscale,288,hunter,beastmastery,6,3,3
Hùntård,hyjal,288,hunter,beastmastery,6,3,3
Cooroona,stormrage,288,hunter,beastmastery,6,3,3
Trïsha,stormscale,288,hunter,beastmastery,6,3,3
Chasseeur,archimonde,288,hunter,beastmastery,6,3,3
Ledarkchauve,archimonde,288,hunter,beastmastery,6,3,3
Kondirox,twisting-nether,288,hunter,beastmastery,6,3,3
Shallia,thrall,288,hunter,beastmastery,6,3,3
Haeero,archimonde,288,hunter,beastmastery,6,3,3
Jennïfer,archimonde,288,hunter,beastmastery,6,3,3
Anayhh,dun-modr,288,hunter,beastmastery,6,3,3
Heavenknøws,dun-modr,288,hunter,beastmastery,9,4,5
Prossh,ravencrest,288,hunter,beastmastery,9,4,5
Onlyarenaz,kazzak,288,hunter,beastmastery,10,4,6
Irri,drakthul,288,hunter,beastmastery,10,4,6
Sìnøn,alleria,288,hunter,beastmastery,8,3,5
Tackleberry,ysondre,288,hunter,beastmastery,8,3,5
Chêckpvp,outland,288,hunter,beastmastery,9,3,6
Teddy,perenolde,288,hunter,beastmastery,12,3,9
Marusmaskin,kazzak,288,hunter,beastmastery,12,3,9
Cotxqt,outland,288,hunter,beastmastery,12,3,9
Faelendal,darksorrow,288,hunter,beastmastery,12,3,9
Хансбург,howling-fjord,288,hunter,beastmastery,12,3,9
Mark,runetotem,288,hunter,beastmastery,12,3,9
Jellyfat,silvermoon,288,hunter,beastmastery,12,3,9
Elgreedo,sylvanas,288,hunter,beastmastery,12,3,9
Hante,ravencrest,288,hunter,beastmastery,12,3,9
Thrystana,kazzak,288,hunter,beastmastery,12,3,9
Ímpulsion,stormscale,288,hunter,beastmastery,12,3,9
Sabnak,burning-blade,288,hunter,beastmastery,12,3,9
Frikandelli,outland,288,hunter,beastmastery,12,3,9
Sokrám,sanguino,288,hunter,beastmastery,12,3,9
Rrushi,argent-dawn,288,hunter,beastmastery,12,3,9
Spakster,blackrock,288,hunter,beastmastery,12,3,9
Bilbogodx,outland,288,hunter,beastmastery,12,3,9
Fiveguys,ravencrest,288,hunter,beastmastery,12,3,9
Оскорбление,howling-fjord,288,hunter,beastmastery,12,3,9
Deathshots,ravencrest,288,hunter,beastmastery,12,3,9
Mârked,argent-dawn,288,hunter,beastmastery,12,3,9
Zeanoff,ravencrest,288,hunter,beastmastery,12,3,9
Fmatzen,the-maelstrom,288,hunter,beastmastery,12,3,9
Skirnier,blackrock,288,hunter,beastmastery,12,3,9
Liikes,arygos,288,hunter,beastmastery,12,3,9
Krëmpai,frostmane,288,hunter,beastmastery,12,3,9
Венгс,howling-fjord,288,hunter,beastmastery,12,3,9
Lethalhands,neptulon,288,hunter,beastmastery,12,3,9
Штейн,greymane,288,hunter,beastmastery,12,3,9
Perkxd,stormscale,288,hunter,beastmastery,12,3,9
Drakess,daggerspine,288,hunter,beastmastery,12,3,9
Ønlýfans,ravencrest,288,hunter,beastmastery,12,3,9
Jamesbownd,ravencrest,288,hunter,beastmastery,12,3,9
Riik,ragnaros,288,hunter,beastmastery,12,3,9
Drherbs,bloodhoof,288,hunter,beastmastery,12,3,9
Panlong,tarren-mill,288,hunter,beastmastery,12,3,9
Narziel,die-todeskrallen,288,hunter,beastmastery,12,3,9
Wildbeek,sanguino,288,hunter,beastmastery,12,3,9
Эолиана,borean-tundra,288,hunter,beastmastery,12,3,9
Vèreesa,azjolnerub,288,hunter,beastmastery,12,3,9
Götthunter,antonidas,288,hunter,beastmastery,12,3,9
Ядрис,gordunni,288,hunter,beastmastery,12,3,9
Undefine,outland,288,hunter,beastmastery,12,3,9
Kitrinos,silvermoon,288,hunter,beastmastery,12,3,9
Дварфмэн,gordunni,288,hunter,beastmastery,13,3,10
Dexiji,ragnaros,288,hunter,beastmastery,18,3,15
Drakono,draenor,288,hunter,beastmastery,18,3,15
Primeq,blackhand,288,hunter,beastmastery,18,3,15
Bloodkillzz,ragnaros,287,hunter,beastmastery,6,3,3
Oneeyedjoe,the-maelstrom,287,hunter,beastmastery,6,3,3
Shogos,aggra-português,287,hunter,beastmastery,6,3,3
Annixa,ravencrest,287,hunter,beastmastery,6,3,3
Oatmeal,dun-morogh,287,hunter,beastmastery,12,3,9
Voraxh,draenor,287,hunter,beastmastery,12,3,9
Промахнулся,gordunni,287,hunter,beastmastery,12,3,9
Jazminluv,blackrock,287,hunter,beastmastery,12,3,9
Brynwolf,argent-dawn,286,hunter,beastmastery,6,3,3
Snehvit,bloodhoof,285,hunter,beastmastery,18,3,15
Trapgodz,ragnaros,271,hunter,beastmastery,11,3,8
Lightrandom,kazzak,269,hunter,beastmastery,11,3,8
Suetøløgx,emeriss,256,hunter,beastmastery,10,3,7
Psailaa,azjolnerub,256,hunter,beastmastery,22,3,19
Ватмано,gordunni,255,hunter,beastmastery,8,4,4
Sarblade,bronze-dragonflight,255,hunter,beastmastery,11,3,8
Shoothim,destromath,254,hunter,beastmastery,8,4,4
Кулерквест,soulflayer,240,hunter,beastmastery,9,3,6
Zion,kul-tiras,239,hunter,beastmastery,5,3,2
Waresfido,nordrassil,239,hunter,beastmastery,5,3,2
Kasyuo,outland,239,hunter,beastmastery,5,3,2
Eilosh,outland,239,hunter,beastmastery,15,3,12
Huntinger,twisting-nether,234,hunter,beastmastery,10,5,5
Sloter,stormscale,234,hunter,beastmastery,16,6,10
Слышумертвых,gordunni,234,hunter,beastmastery,15,5,10
Snakepit,archimonde,234,hunter,beastmastery,17,4,13
Beastmaster,ragnaros,233,hunter,beastmastery,16,4,12
Góllum,ravencrest,224,hunter,beastmastery,10,3,7
Shagora,dalaran,223,hunter,beastmastery,8,3,5
Fineas,theradras,192,hunter,beastmastery,4,3,1
Waveshoot,hyjal,192,hunter,beastmastery,6,2,4
Não,onyxia,192,hunter,beastmastery,6,2,4
Sizemattersx,kazzak,192,hunter,beastmastery,6,2,4
Sotu,stormscale,192,hunter,beastmastery,6,2,4
Teyo,blackhand,192,hunter,beastmastery,6,2,4
Sarbacanes,hyjal,192,hunter,beastmastery,6,2,4
Cøkø,sanguino,192,hunter,beastmastery,6,2,4
Doraxa,sanguino,192,hunter,beastmastery,6,2,4
Trapzy,stormscale,192,hunter,beastmastery,6,2,4
Atylla,ravencrest,192,hunter,beastmastery,6,2,4
Mabön,zuljin,192,hunter,beastmastery,6,2,4
Pzz,archimonde,192,hunter,beastmastery,6,2,4
Zulldek,sanguino,192,hunter,beastmastery,6,2,4
Maeba,shendralar,192,hunter,beastmastery,6,2,4
Lørenzø,archimonde,192,hunter,beastmastery,6,2,4
Ataxyjr,ravencrest,192,hunter,beastmastery,6,2,4
Deskö,shendralar,192,hunter,beastmastery,6,2,4
Dola,archimonde,192,hunter,beastmastery,6,2,4
Bmo,zuljin,192,hunter,beastmastery,6,2,4
Gunforhire,ravencrest,192,hunter,beastmastery,6,2,4
Hvaskøduenme,stormscale,192,hunter,beastmastery,6,2,4
Аматорика,howling-fjord,192,hunter,beastmastery,6,2,4
Хароко,gordunni,192,hunter,beastmastery,6,2,4
Florindeel,die-aldor,192,hunter,beastmastery,6,2,4
Deathhowl,stormscale,192,hunter,beastmastery,6,2,4
Mufassa,sinstralis,192,hunter,beastmastery,6,2,4
Aliyaan,twisting-nether,192,hunter,beastmastery,6,2,4
Фломидзе,gordunni,192,hunter,beastmastery,6,2,4
Nikzeubii,archimonde,192,hunter,beastmastery,6,2,4
Edar,sanguino,192,hunter,beastmastery,6,2,4
Skydragøn,die-aldor,192,hunter,beastmastery,6,2,4
Exæquo,archimonde,192,hunter,beastmastery,6,2,4
Chamillon,archimonde,192,hunter,beastmastery,6,2,4
Bloópy,silvermoon,192,hunter,beastmastery,6,2,4
Realbigwilly,outland,192,hunter,beastmastery,6,2,4
Smekminbåge,tarren-mill,192,hunter,beastmastery,6,2,4
Shademd,ahnqiraj,192,hunter,beastmastery,6,2,4
Zarrøn,thrall,192,hunter,beastmastery,6,2,4
Aillin,antonidas,192,hunter,beastmastery,6,2,4
Brindefolìe,archimonde,192,hunter,beastmastery,6,2,4
Kahoonas,silvermoon,192,hunter,beastmastery,6,2,4
Ninielnienor,thrall,192,hunter,beastmastery,6,2,4
Shinsey,antonidas,192,hunter,beastmastery,6,2,4
Bushwhack,outland,192,hunter,beastmastery,6,2,4
Tanjîrø,antonidas,192,hunter,beastmastery,6,2,4
Tyrone,saurfang,192,hunter,beastmastery,6,2,4
Mustásh,stormscale,192,hunter,beastmastery,6,2,4
Skalgor,thrall,192,hunter,beastmastery,6,2,4
Absolutenon,alakir,192,hunter,beastmastery,6,2,4
Falconrok,antonidas,192,hunter,beastmastery,6,2,4
Zaakolack,burning-legion,192,hunter,beastmastery,6,2,4
Jayyke,frostmane,192,hunter,beastmastery,6,2,4
Progh,ragnaros,192,hunter,beastmastery,6,2,4
Bæbåk,frostmane,192,hunter,beastmastery,6,2,4
Scycs,nazjatar,192,hunter,beastmastery,6,2,4
Nigina,ravencrest,192,hunter,beastmastery,6,2,4
Satúhati,stormscale,192,hunter,beastmastery,6,2,4
Holytrapqt,aegwynn,192,hunter,beastmastery,6,2,4
Foleck,aegwynn,192,hunter,beastmastery,6,2,4
Gukéx,stormscale,192,hunter,beastmastery,6,2,4
Kirinó,ragnaros,192,hunter,beastmastery,6,2,4
Thecorruptor,skullcrusher,192,hunter,beastmastery,6,2,4
Díkembe,aegwynn,192,hunter,beastmastery,6,2,4
Grytax,outland,192,hunter,beastmastery,6,2,4
Pets,aegwynn,192,hunter,beastmastery,6,2,4
Starkt,ragnaros,192,hunter,beastmastery,6,2,4
Luuszapfae,aegwynn,192,hunter,beastmastery,6,2,4
Korlog,kragjin,192,hunter,beastmastery,6,2,4
Yakayoshi,kazzak,192,hunter,beastmastery,6,2,4
Thárkay,malygos,192,hunter,beastmastery,6,2,4
Véncsótány,ragnaros,192,hunter,beastmastery,6,2,4
Nerfit,argent-dawn,192,hunter,beastmastery,6,2,4
Longblow,outland,192,hunter,beastmastery,6,2,4
Wolfariana,chamber-of-aspects,192,hunter,beastmastery,6,2,4
Neaife,ragnaros,192,hunter,beastmastery,6,2,4
Elastaplast,thunderhorn,192,hunter,beastmastery,6,2,4
Cataleja,pozzo-delleternità,192,hunter,beastmastery,6,2,4
Какулимёт,gordunni,192,hunter,beastmastery,6,2,4
Dragoki,blackmoore,192,hunter,beastmastery,6,2,4
Klittcrit,bloodhoof,192,hunter,beastmastery,6,2,4
Stronkbeast,kazzak,192,hunter,beastmastery,6,2,4
Arozar,ragnaros,192,hunter,beastmastery,6,2,4
Droz,blackmoore,192,hunter,beastmastery,6,2,4
Trickspar,bloodscalp,192,hunter,beastmastery,6,2,4
Huntzie,argent-dawn,192,hunter,beastmastery,6,2,4
Lágåta,outland,192,hunter,beastmastery,6,2,4
Naid,lordaeron,192,hunter,beastmastery,6,2,4
Brummel,frostwolf,192,hunter,beastmastery,6,2,4
Myoui,silvermoon,192,hunter,beastmastery,6,2,4
Трольпифпаф,deathguard,192,hunter,beastmastery,6,2,4
Xeragon,frostwolf,192,hunter,beastmastery,6,2,4
Avâlos,dentarg,192,hunter,beastmastery,6,2,4
Feedbackloop,silvermoon,192,hunter,beastmastery,6,2,4
Nektard,ravencrest,192,hunter,beastmastery,6,2,4
Snakepit,stormscale,192,hunter,beastmastery,6,2,4
Солевойбалон,gordunni,192,hunter,beastmastery,6,2,4
Dogstrust,stormscale,192,hunter,beastmastery,6,2,4
Sharrowkyn,twisting-nether,192,hunter,beastmastery,6,2,4
Фанатшла,gordunni,192,hunter,beastmastery,6,2,4
Nythilia,blackrock,192,hunter,beastmastery,6,2,4
Килофвратх,gordunni,192,hunter,beastmastery,6,2,4
Сайнтификх,eversong,192,hunter,beastmastery,6,2,4
Trollshadow,tarren-mill,192,hunter,beastmastery,6,2,4
Sinsirellam,twisting-nether,192,hunter,beastmastery,6,2,4
Khaleezi,blackmoore,192,hunter,beastmastery,6,2,4
Ототрал,gordunni,192,hunter,beastmastery,6,2,4
Talanar,tarren-mill,192,hunter,beastmastery,6,2,4
Triopas,silvermoon,192,hunter,beastmastery,6,2,4
Sharshoor,twisting-nether,192,hunter,beastmastery,6,2,4
Dentaar,draenor,192,hunter,beastmastery,6,2,4
Bethenny,draenor,192,hunter,beastmastery,6,2,4
Zetaph,argent-dawn,192,hunter,beastmastery,6,2,4
Marryme,blackhand,192,hunter,beastmastery,6,2,4
Ренектон,soulflayer,192,hunter,beastmastery,6,2,4
Miesmuschel,guldan,192,hunter,beastmastery,6,2,4
Gandro,blackmoore,192,hunter,beastmastery,6,2,4
Шимэйла,gordunni,192,hunter,beastmastery,6,2,4
Stokesly,terenas,192,hunter,beastmastery,6,2,4
Риперквин,gordunni,192,hunter,beastmastery,6,2,4
Mâgnesium,blackmoore,192,hunter,beastmastery,6,2,4
Cørvino,der-rat-von-dalaran,192,hunter,beastmastery,6,2,4
Thorka,tarren-mill,192,hunter,beastmastery,6,2,4
Earfalass,twisting-nether,192,hunter,beastmastery,6,2,4
Спелла,goldrinn,192,hunter,beastmastery,6,2,4
Sylasteria,twisting-nether,192,hunter,beastmastery,6,2,4
Gunmeister,bronzebeard,192,hunter,beastmastery,6,2,4
Azahunt,kazzak,192,hunter,beastmastery,6,2,4
Danstonpif,kaelthas,192,hunter,beastmastery,6,2,4
Patrouifort,ysondre,192,hunter,beastmastery,6,2,4
Phantoprowl,stormscale,192,hunter,beastmastery,6,2,4
Raysist,arathor,192,hunter,beastmastery,6,2,4
Avp,sylvanas,192,hunter,beastmastery,6,2,4
Meltox,blackhand,192,hunter,beastmastery,6,2,4
Snôptas,blackmoore,192,hunter,beastmastery,6,2,4
Fofoulinaki,silvermoon,192,hunter,beastmastery,6,2,4
Cranekickzhu,blackmoore,192,hunter,beastmastery,6,2,4
Bradunov,sylvanas,192,hunter,beastmastery,6,2,4
Privelle,argent-dawn,192,hunter,beastmastery,6,2,4
Vôrtax,blackmoore,192,hunter,beastmastery,6,2,4
Diabloiv,doomhammer,192,hunter,beastmastery,6,2,4
Legolex,burning-blade,192,hunter,beastmastery,6,2,4
Phyllobates,blackrock,192,hunter,beastmastery,6,2,4
Фэйсконтроль,azuregos,192,hunter,beastmastery,6,2,4
Yolo,drakthul,192,hunter,beastmastery,6,2,4
Kimmimaru,draenor,192,hunter,beastmastery,6,2,4
Anas,argent-dawn,192,hunter,beastmastery,6,2,4
Korrekt,stormscale,192,hunter,beastmastery,6,2,4
Одисенс,eversong,192,hunter,beastmastery,6,2,4
Гусецап,gordunni,192,hunter,beastmastery,6,2,4
Lifeiscool,drakthul,192,hunter,beastmastery,6,2,4
Poccâ,die-nachtwache,192,hunter,beastmastery,6,2,4
Arankis,norgannon,192,hunter,beastmastery,6,2,4
Phutkapre,doomhammer,192,hunter,beastmastery,6,2,4
Bernhardoder,blackhand,192,hunter,beastmastery,6,2,4
Jarran,karazhan,192,hunter,beastmastery,6,2,4
Znu,argent-dawn,192,hunter,beastmastery,6,2,4
Gilgharsh,rajaxx,192,hunter,beastmastery,6,2,4
Superachmed,kazzak,192,hunter,beastmastery,6,2,4
Allessía,argent-dawn,192,hunter,beastmastery,6,2,4
Cheesychees,sylvanas,192,hunter,beastmastery,6,2,4
Aughtism,turalyon,192,hunter,beastmastery,6,2,4
Травок,gordunni,192,hunter,beastmastery,6,2,4
As,kazzak,192,hunter,beastmastery,6,2,4
Mkaymkay,drakthul,192,hunter,beastmastery,6,2,4
Manatodamoon,aerie-peak,192,hunter,beastmastery,6,2,4
Arykes,drakthul,192,hunter,beastmastery,6,2,4
Kuzes,ravencrest,192,hunter,beastmastery,6,2,4
Marionhood,sylvanas,192,hunter,beastmastery,6,2,4
Comegetme,auchindoun,192,hunter,beastmastery,6,2,4
Dahunter,blackmoore,192,hunter,beastmastery,6,2,4
Hatethis,kazzak,192,hunter,beastmastery,6,2,4
Atticüs,burning-blade,192,hunter,beastmastery,6,2,4
Clawy,auchindoun,192,hunter,beastmastery,6,2,4
Жабра,gordunni,192,hunter,beastmastery,11,3,8
Shockzzyyh,ravencrest,192,hunter,beastmastery,9,2,7
Киллкук,howling-fjord,192,hunter,beastmastery,9,2,7
Куджикс,soulflayer,192,hunter,beastmastery,19,4,15
Фомкалол,howling-fjord,192,hunter,beastmastery,12,2,10
Calesthas,tarren-mill,192,hunter,beastmastery,12,2,10
Chillyourbon,ravencrest,192,hunter,beastmastery,12,2,10
Anhyzer,nemesis,192,hunter,beastmastery,12,2,10
Zulkhan,nemesis,192,hunter,beastmastery,12,2,10
Pôîson,kazzak,192,hunter,beastmastery,12,2,10
Schräubchen,antonidas,192,hunter,beastmastery,12,2,10
Vadász,chamber-of-aspects,192,hunter,beastmastery,12,2,10
Jeddaj,stormscale,192,hunter,beastmastery,12,2,10
Dorakor,ysondre,192,hunter,beastmastery,12,2,10
Bullebank,kazzak,192,hunter,beastmastery,12,2,10
Tyronjr,tarren-mill,192,hunter,beastmastery,12,2,10
Waraëlle,dalaran,192,hunter,beastmastery,12,2,10
Samodiva,twisting-nether,192,hunter,beastmastery,12,2,10
Bleidarabm,silvermoon,192,hunter,beastmastery,12,2,10
Willýs,ysondre,192,hunter,beastmastery,12,2,10
Bloodking,madmortem,192,hunter,beastmastery,12,2,10
Saskatchewan,dun-modr,192,hunter,beastmastery,12,2,10
Elja,laughing-skull,192,hunter,beastmastery,12,2,10
Pasiõra,archimonde,192,hunter,beastmastery,18,2,16
Ayda,zuljin,192,hunter,beastmastery,18,2,16
Slayman,kazzak,192,hunter,beastmastery,18,2,16
Сыньйорита,howling-fjord,192,hunter,beastmastery,18,2,16
Ukkô,eredar,192,hunter,beastmastery,18,2,16
Sërennà,chogall,192,hunter,beastmastery,18,2,16
Myplague,darkmoon-faire,191,hunter,beastmastery,6,2,4
Sylvíke,ragnaros,191,hunter,beastmastery,6,2,4
Charlet,archimonde,191,hunter,beastmastery,6,2,4
Traknard,confrérie-du-thorium,191,hunter,beastmastery,6,2,4
Сливочкии,goldrinn,191,hunter,beastmastery,6,2,4
Kizscamander,magtheridon,191,hunter,beastmastery,12,2,10
Cucumbert,antonidas,190,hunter,beastmastery,12,2,10
Aewena,hyjal,190,hunter,beastmastery,12,2,10
Ozunâ,blackmoore,168,hunter,beastmastery,25,8,17
Ripulianneli,stormscale,159,hunter,beastmastery,6,3,3
Dolwen,argent-dawn,159,hunter,beastmastery,5,2,3
Carru,blackrock,159,hunter,beastmastery,5,2,3
Rakmo,blackmoore,159,hunter,beastmastery,5,2,3
Beastfather,twilights-hammer,159,hunter,beastmastery,5,2,3
Сталька,blackscar,159,hunter,beastmastery,7,2,5
Phinox,sanguino,159,hunter,beastmastery,11,2,9
Cadier,argent-dawn,144,hunter,beastmastery,3,3,0
Gilgämesh,hyjal,138,hunter,beastmastery,9,4,5
Hakaîí,aegwynn,138,hunter,beastmastery,10,4,6
Tanteaab,blackmoore,138,hunter,beastmastery,11,4,7
Kobrán,gilneas,138,hunter,beastmastery,9,3,6
Kauli,turalyon,138,hunter,beastmastery,15,3,12
Иттириса,gordunni,128,hunter,beastmastery,4,2,2
Bobihunt,argent-dawn,128,hunter,beastmastery,4,2,2
Elnazar,archimonde,128,hunter,beastmastery,4,2,2
Laiguutan,blackmoore,128,hunter,beastmastery,4,2,2
Deathøfrats,ravencrest,128,hunter,beastmastery,4,2,2
Liscie,silvermoon,105,hunter,beastmastery,16,4,12
Буреклык,gordunni,96,hunter,beastmastery,6,1,5
Hafarian,the-maelstrom,96,hunter,beastmastery,6,1,5
Exorbitant,blackrock,96,hunter,beastmastery,6,1,5
Imthatbtch,argent-dawn,96,hunter,beastmastery,6,1,5
Rîsas,draenor,96,hunter,beastmastery,6,1,5
Turtíe,argent-dawn,96,hunter,beastmastery,6,1,5
Sláynôs,blackrock,96,hunter,beastmastery,6,1,5
Дочьпескова,gordunni,96,hunter,beastmastery,6,1,5
Bowlox,kazzak,96,hunter,beastmastery,6,1,5
Zogzøg,draenor,96,hunter,beastmastery,6,1,5
Темикс,ashenvale,96,hunter,beastmastery,6,1,5
Zurzok,blackrock,96,hunter,beastmastery,6,1,5
Huntze,kazzak,96,hunter,beastmastery,6,1,5
Hechozar,kazzak,96,hunter,beastmastery,6,1,5
Carrilynn,blackrock,96,hunter,beastmastery,6,1,5
Koraag,culte-de-la-rive-noire,96,hunter,beastmastery,6,1,5
Оркистор,eversong,96,hunter,beastmastery,6,1,5
Leviaa,argent-dawn,96,hunter,beastmastery,6,1,5
Золларис,deathguard,96,hunter,beastmastery,6,1,5
Jackdaniéls,twisting-nether,96,hunter,beastmastery,6,1,5
Dubtrap,blackmoore,96,hunter,beastmastery,6,1,5
Buoma,kazzak,96,hunter,beastmastery,6,1,5
Maticshorter,blackmoore,96,hunter,beastmastery,6,1,5
Billythree,argent-dawn,96,hunter,beastmastery,6,1,5
Ройзх,gordunni,96,hunter,beastmastery,6,1,5
Runescimmy,twisting-nether,96,hunter,beastmastery,6,1,5
Speedofpain,kazzak,96,hunter,beastmastery,6,1,5
Koróth,tarren-mill,96,hunter,beastmastery,6,1,5
Zelesrian,twisting-nether,96,hunter,beastmastery,6,1,5
Пиппиракон,soulflayer,96,hunter,beastmastery,6,1,5
Oneclickaway,tarren-mill,96,hunter,beastmastery,6,1,5
Ichbringbier,blackrock,96,hunter,beastmastery,6,1,5
Hÿyrøk,ysondre,96,hunter,beastmastery,6,1,5
Левери,gordunni,96,hunter,beastmastery,6,1,5
Øô,blackrock,96,hunter,beastmastery,6,1,5
Jägerjokke,blackrock,96,hunter,beastmastery,6,1,5
Teedfredd,tarren-mill,96,hunter,beastmastery,6,1,5
Airelina,kazzak,96,hunter,beastmastery,6,1,5
Jackson,blackmoore,96,hunter,beastmastery,6,1,5
Gurkans,aggramar,96,hunter,beastmastery,6,1,5
Травмаопасен,gordunni,96,hunter,beastmastery,6,1,5
Hiddenstalk,outland,96,hunter,beastmastery,6,1,5
Grutoss,eredar,96,hunter,beastmastery,6,1,5
Foxhunt,turalyon,96,hunter,beastmastery,6,1,5
Târâx,blackmoore,96,hunter,beastmastery,6,1,5
Traptard,blackrock,96,hunter,beastmastery,6,1,5
Xilo,eredar,96,hunter,beastmastery,6,1,5
Valiriz,blackmoore,96,hunter,beastmastery,6,1,5
Shaib,kazzak,96,hunter,beastmastery,6,1,5
Zugzlug,tarren-mill,96,hunter,beastmastery,6,1,5
Настякобра,blackscar,96,hunter,beastmastery,6,1,5
Jozsiur,ragnaros,96,hunter,beastmastery,6,1,5
Hairyplottér,kazzak,96,hunter,beastmastery,6,1,5
Xåndra,sylvanas,96,hunter,beastmastery,6,1,5
Börjeson,ragnaros,96,hunter,beastmastery,6,1,5
Craisax,nemesis,96,hunter,beastmastery,6,1,5
Vérfarkas,arathor,96,hunter,beastmastery,6,1,5
Hashaya,hyjal,96,hunter,beastmastery,6,1,5
Dasmusdrückn,antonidas,96,hunter,beastmastery,6,1,5
Ventaric,pozzo-delleternità,96,hunter,beastmastery,6,1,5
Aravis,moonglade,96,hunter,beastmastery,6,1,5
Nicoh,elune,96,hunter,beastmastery,6,1,5
Hntudwn,azshara,96,hunter,beastmastery,6,1,5
Deneja,kilrogg,96,hunter,beastmastery,6,1,5
Betarayjinx,kazzak,96,hunter,beastmastery,6,1,5
Wórldz,dun-modr,96,hunter,beastmastery,6,1,5
Artdragon,burning-legion,96,hunter,beastmastery,6,1,5
Loquenahak,grim-batol,96,hunter,beastmastery,6,1,5
Opasan,nordrassil,96,hunter,beastmastery,6,1,5
Imahuntard,frostmane,96,hunter,beastmastery,6,1,5
Bensoussan,archimonde,96,hunter,beastmastery,6,1,5
Breidy,dun-modr,96,hunter,beastmastery,6,1,5
Weafster,outland,96,hunter,beastmastery,6,1,5
Furheious,archimonde,96,hunter,beastmastery,6,1,5
Rezà,thrall,96,hunter,beastmastery,6,1,5
Nmrd,archimonde,96,hunter,beastmastery,6,1,5
Луврен,deepholm,96,hunter,beastmastery,6,1,5
Nomorex,frostwhisper,96,hunter,beastmastery,6,1,5
Fakepvper,darksorrow,96,hunter,beastmastery,6,1,5
Táráh,proudmoore,96,hunter,beastmastery,6,1,5
Deathtime,sanguino,96,hunter,beastmastery,6,1,5
Warthugg,khaz-modan,96,hunter,beastmastery,6,1,5
Jakuken,dun-modr,96,hunter,beastmastery,6,1,5
Furiouslao,eredar,96,hunter,beastmastery,6,1,5
Wideshut,eldrethalas,96,hunter,beastmastery,6,1,5
Ëcheniquë,sanguino,96,hunter,beastmastery,6,1,5
Syjinny,kazzak,96,hunter,beastmastery,6,1,5
Platano,hyjal,96,hunter,beastmastery,6,1,5
Darkray,dalaran,96,hunter,beastmastery,6,1,5
Bloodfallen,onyxia,96,hunter,beastmastery,6,1,5
Boudicok,archimonde,96,hunter,beastmastery,6,1,5
Doojas,archimonde,96,hunter,beastmastery,6,1,5
Anun,magtheridon,96,hunter,beastmastery,6,1,5
Drolarin,zuljin,96,hunter,beastmastery,6,1,5
Justchill,ravencrest,96,hunter,beastmastery,6,1,5
Вкинулматрас,gordunni,96,hunter,beastmastery,6,1,5
Oneshotbaby,archimonde,96,hunter,beastmastery,6,1,5
Перидот,howling-fjord,96,hunter,beastmastery,6,1,5
Babyfart,terenas,96,hunter,beastmastery,6,1,5
Rayana,garrosh,96,hunter,beastmastery,6,1,5
Женистайл,howling-fjord,96,hunter,beastmastery,6,1,5
Oou,auchindoun,96,hunter,beastmastery,6,1,5
Masimo,emerald-dream,96,hunter,beastmastery,6,1,5
Fizí,stormscale,96,hunter,beastmastery,6,1,5
Achiles,die-todeskrallen,96,hunter,beastmastery,6,1,5
Сочнаятурель,howling-fjord,96,hunter,beastmastery,6,1,5
Фекаладочка,howling-fjord,96,hunter,beastmastery,6,1,5
Gabrriel,ravencrest,96,hunter,beastmastery,6,1,5
Qeav,stormscale,96,hunter,beastmastery,6,1,5
Odenssbest,silvermoon,96,hunter,beastmastery,6,1,5
Zergst,nathrezim,96,hunter,beastmastery,6,1,5
Ríse,blackhand,96,hunter,beastmastery,6,1,5
Clownchef,blackhand,96,hunter,beastmastery,6,1,5
Derhùnethàl,hyjal,96,hunter,beastmastery,6,1,5
Dugini,ravencrest,96,hunter,beastmastery,6,1,5
Noxll,gorgonnash,96,hunter,beastmastery,6,1,5
Wræqraxx,ravencrest,96,hunter,beastmastery,6,1,5
Arthass,die-aldor,96,hunter,beastmastery,12,1,11
Лиасон,howling-fjord,96,hunter,beastmastery,12,1,11
Enfaktüs,silvermoon,96,hunter,beastmastery,12,1,11
Patjuh,silvermoon,96,hunter,beastmastery,12,1,11
Lardobrave,blackhand,96,hunter,beastmastery,12,1,11
Plagktos,conseil-des-ombres,96,hunter,beastmastery,12,1,11
Vandathien,stormrage,96,hunter,beastmastery,12,1,11
Mistledove,lightbringer,96,hunter,beastmastery,12,1,11
Thóorin,ravencrest,96,hunter,beastmastery,12,1,11
Críted,blackmoore,96,hunter,beastmastery,12,1,11
Детмазай,soulflayer,96,hunter,beastmastery,12,1,11
Johnnygnus,drakthul,96,hunter,beastmastery,12,1,11
Schmaikell,blackmoore,96,hunter,beastmastery,12,1,11
Tsyapka,tarren-mill,96,hunter,beastmastery,12,1,11
Milandria,antonidas,96,hunter,beastmastery,18,1,17
Бусюлька,gordunni,95,hunter,beastmastery,18,1,17
Халфен,eversong,79,hunter,beastmastery,5,1,4
Beentrill,kazzak,79,hunter,beastmastery,5,1,4
Acuatropatas,sanguino,64,hunter,beastmastery,4,1,3
Youngjinh,ravencrest,64,hunter,beastmastery,4,1,3
Currahee,kirin-tor,64,hunter,beastmastery,4,1,3
Flaregodx,twisting-nether,64,hunter,beastmastery,4,1,3
Quiarà,elune,64,hunter,beastmastery,4,1,3
Yahamenistos,ysondre,64,hunter,beastmastery,4,1,3
Qqc,burning-legion,48,hunter,beastmastery,3,1,2
Illnysa,silvermoon,48,hunter,beastmastery,3,1,2
Huggiwuggi,tarren-mill,48,hunter,beastmastery,3,1,2
Графруру,soulflayer,48,hunter,beastmastery,3,1,2
Trayomrusnik,stormscale,42,hunter,beastmastery,7,3,4
Æxinora,antonidas,42,hunter,beastmastery,8,2,6
Ржавченко,soulflayer,42,hunter,beastmastery,9,2,7
Jamestráp,dun-morogh,42,hunter,beastmastery,9,2,7
Тхойне,gordunni,42,hunter,beastmastery,10,2,8
Rockymarciaa,dalaran,31,hunter,beastmastery,2,1,1
Котюнечка,gordunni,31,hunter,beastmastery,2,1,1
Melloy,drakthul,31,hunter,beastmastery,2,1,1
Martuk,aegwynn,31,hunter,beastmastery,2,1,1
Vethan,die-aldor,16,hunter,beastmastery,7,1,6
Gwaan,outland,9,hunter,beastmastery,6,2,4
Млдбоярин,gordunni,2180,mage,arcane,72,41,31
Макотшельник,gordunni,2163,mage,arcane,72,47,25
Boogeymanx,ravencrest,2052,mage,arcane,180,100,80
Проблембойх,gordunni,2024,mage,arcane,134,63,71
Cubis,archimonde,2022,mage,arcane,156,77,79
Aleteia,stormscale,1998,mage,arcane,228,114,114
Waterhagx,tarren-mill,1976,mage,arcane,71,49,22
Aleç,ravencrest,1971,mage,arcane,66,33,33
Magegôd,outland,1969,mage,arcane,81,44,37
Ånei,ravencrest,1903,mage,arcane,78,44,34
Choll,stormscale,1866,mage,arcane,30,20,10
Фоулли,howling-fjord,1864,mage,arcane,82,40,42
Бигдикмаг,soulflayer,1852,mage,arcane,107,52,55
Wàneís,ravencrest,1843,mage,arcane,78,38,40
Sallesauruus,outland,1835,mage,arcane,232,120,112
Castorcato,kazzak,1823,mage,arcane,102,53,49
Obbcontrol,ravencrest,1820,mage,arcane,84,45,39
Tiqma,sylvanas,1810,mage,arcane,173,85,88
Belthesad,twisting-nether,1806,mage,arcane,62,42,20
Lemaroxd,draenor,1801,mage,arcane,59,33,26
Nvpk,blackrock,1786,mage,arcane,72,40,32
Tokerlol,stormscale,1780,mage,arcane,227,124,103
Рбгпотаскуха,gordunni,1777,mage,arcane,36,26,10
Ephreaym,stormscale,1772,mage,arcane,189,92,97
Jînexo,shattrath,1748,mage,arcane,70,35,35
Magijoana,silvermoon,1745,mage,arcane,50,26,24
Нефростмаг,gordunni,1730,mage,arcane,318,159,159
Bebenm,archimonde,1727,mage,arcane,194,90,104
Derett,stormscale,1725,mage,arcane,48,22,26
Raíku,ravencrest,1723,mage,arcane,30,18,12
Непутевыймаг,gordunni,1715,mage,arcane,24,23,1
Covran,stormscale,1715,mage,arcane,101,49,52
Uskomaaginen,ravencrest,1714,mage,arcane,72,33,39
Mercem,stormscale,1711,mage,arcane,30,21,9
Папущенный,soulflayer,1709,mage,arcane,151,76,75
Abóve,outland,1707,mage,arcane,24,18,6
Frostseeker,tarren-mill,1704,mage,arcane,78,41,37
Dárdie,ravencrest,1697,mage,arcane,52,26,26
Wracrz,argent-dawn,1696,mage,arcane,114,61,53
Alustrasz,skullcrusher,1693,mage,arcane,155,85,70
Sÿmera,dun-modr,1691,mage,arcane,97,47,50
Breezzme,twisting-nether,1689,mage,arcane,72,35,37
Shirrunn,the-maelstrom,1687,mage,arcane,38,19,19
Ecovation,tarren-mill,1685,mage,arcane,133,72,61
Dardíe,ravencrest,1681,mage,arcane,54,31,23
Barbeuqxo,garona,1675,mage,arcane,191,100,91
Absie,tarren-mill,1672,mage,arcane,131,79,52
Fearbeäch,ravencrest,1666,mage,arcane,52,25,27
Hachiro,onyxia,1666,mage,arcane,48,23,25
Ziao,outland,1660,mage,arcane,198,99,99
Astrryy,burning-legion,1650,mage,arcane,41,19,22
Uknowhowwedu,blackrock,1649,mage,arcane,36,22,14
Сизаам,howling-fjord,1644,mage,arcane,140,72,68
Димаскунфу,howling-fjord,1640,mage,arcane,154,76,78
Nelg,silvermoon,1635,mage,arcane,72,46,26
Bullegong,archimonde,1633,mage,arcane,72,38,34
Sérc,ravencrest,1626,mage,arcane,30,17,13
Медивера,gordunni,1622,mage,arcane,24,17,7
Orkamor,sylvanas,1622,mage,arcane,42,17,25
Jatha,turalyon,1619,mage,arcane,124,66,58
Barbeuqx,garona,1600,mage,arcane,344,176,168
Scoopssama,ravencrest,1598,mage,arcane,90,42,48
Burstology,kazzak,1597,mage,arcane,221,111,110
Фемна,soulflayer,1589,mage,arcane,111,55,56
Persi,dentarg,1582,mage,arcane,311,152,159
Vxvfrowstxvx,jaedenar,1579,mage,arcane,90,49,41
Frostandrew,twisting-nether,1563,mage,arcane,42,27,15
Helloimgone,blackmoore,1550,mage,arcane,66,31,35
Ekron,sanguino,1544,mage,arcane,707,358,349
Gypsymagic,doomhammer,1537,mage,arcane,113,59,54
Radiantfury,outland,1533,mage,arcane,30,17,13
Shiranize,aegwynn,1528,mage,arcane,144,68,76
Antaos,drakthul,1523,mage,arcane,222,117,105
Meløs,blackmoore,1522,mage,arcane,39,22,17
Portal,scarshield-legion,1515,mage,arcane,73,42,31
Vaerén,malganis,1495,mage,arcane,49,29,20
Inaruy,hyjal,1494,mage,arcane,35,18,17
Jukedstreet,outland,1493,mage,arcane,42,18,24
Råståfåri,uldum,1490,mage,arcane,107,60,47
Poochmage,archimonde,1488,mage,arcane,90,42,48
Samirra,stormscale,1487,mage,arcane,72,38,34
Nakamura,outland,1486,mage,arcane,344,171,173
Blinked,eredar,1481,mage,arcane,53,32,21
Xÿv,azshara,1467,mage,arcane,33,17,16
Aristarco,outland,1455,mage,arcane,144,72,72
Akâri,silvermoon,1451,mage,arcane,119,68,51
Ahstin,teldrassil,1444,mage,arcane,24,18,6
Kudakto,ravencrest,1437,mage,arcane,42,15,27
Раканчик,gordunni,1434,mage,arcane,92,46,46
Ðøæø,twisting-nether,1433,mage,arcane,111,54,57
Даанрен,galakrond,1425,mage,arcane,60,25,35
Ogarcanefist,outland,1424,mage,arcane,69,35,34
Sapien,sanguino,1422,mage,arcane,88,40,48
Jhawkwizard,draenor,1421,mage,arcane,324,167,157
Манкай,fordragon,1419,mage,arcane,411,209,202
Nelluc,turalyon,1417,mage,arcane,74,40,34
Jayhó,outland,1411,mage,arcane,54,28,26
Arkeus,turalyon,1406,mage,arcane,89,54,35
Десскельтер,deathguard,1405,mage,arcane,206,106,100
Sukalamink,alonsus,1405,mage,arcane,48,22,26
Faxchungus,argent-dawn,1401,mage,arcane,54,34,20
Tokyodes,twisting-nether,1401,mage,arcane,296,153,143
Aloxigozal,shendralar,1400,mage,arcane,24,17,7
Techies,archimonde,1397,mage,arcane,24,15,9
Манаманна,gordunni,1391,mage,arcane,1049,530,519
Elor,eredar,1389,mage,arcane,69,36,33
Magikere,tarren-mill,1384,mage,arcane,131,76,55
Gravehagx,ravencrest,1381,mage,arcane,21,15,6
Barspin,lightnings-blade,1381,mage,arcane,207,107,100
Diper,burning-legion,1379,mage,arcane,41,18,23
Rmnzr,blackrock,1377,mage,arcane,48,19,29
Rayniß,blackmoore,1370,mage,arcane,30,17,13
Calientay,ragnaros,1366,mage,arcane,47,21,26
Lusionator,defias-brotherhood,1365,mage,arcane,60,33,27
Azuredragon,tarren-mill,1361,mage,arcane,61,30,31
Másterdukè,silvermoon,1357,mage,arcane,185,86,99
Leanboy,dun-modr,1353,mage,arcane,55,24,31
Angryalways,stormscale,1350,mage,arcane,32,16,16
Hâplo,burning-legion,1348,mage,arcane,98,54,44
Sszz,ravencrest,1335,mage,arcane,257,139,118
Nefrendel,kazzak,1327,mage,arcane,133,67,66
Tnhigh,blackrock,1325,mage,arcane,81,42,39
Fadi,anachronos,1325,mage,arcane,30,14,16
Krykz,sanguino,1321,mage,arcane,60,26,34
Xiaomofashi,quelthalas,1320,mage,arcane,240,123,117
Ímnotback,outland,1319,mage,arcane,282,140,142
Aeghis,darkspear,1318,mage,arcane,30,15,15
Kaelasha,magtheridon,1314,mage,arcane,42,18,24
Mannenye,stormscale,1306,mage,arcane,47,17,30
Paradigma,sylvanas,1305,mage,arcane,30,14,16
Scaleeth,kazzak,1300,mage,arcane,36,14,22
Kazeen,silvermoon,1292,mage,arcane,106,60,46
Mäalaka,archimonde,1289,mage,arcane,42,16,26
Pradapimp,ravencrest,1286,mage,arcane,32,15,17
Nimdáá,stormscale,1286,mage,arcane,54,24,30
Bananflickan,kazzak,1285,mage,arcane,198,108,90
Venchimage,silvermoon,1284,mage,arcane,62,26,36
Spicymash,chogall,1275,mage,arcane,30,16,14
Trucy,eredar,1275,mage,arcane,180,83,97
Estelliên,burning-legion,1273,mage,arcane,27,14,13
Весиал,deathguard,1262,mage,arcane,189,96,93
Валбериса,deepholm,1259,mage,arcane,83,49,34
Säga,the-venture-co,1254,mage,arcane,177,86,91
Tiamorg,drakthul,1248,mage,arcane,23,14,9
Айсъмэджик,azuregos,1247,mage,arcane,119,59,60
Moxine,la-croisade-écarlate,1247,mage,arcane,95,44,51
Sadrã,kazzak,1247,mage,arcane,69,30,39
Яшабурстх,blackscar,1246,mage,arcane,30,13,17
Нормалмап,soulflayer,1246,mage,arcane,66,27,39
Angélique,ragnaros,1244,mage,arcane,84,40,44
Oreog,ravencrest,1243,mage,arcane,36,13,23
Nécrømage,confrérie-du-thorium,1235,mage,arcane,18,13,5
Аненази,goldrinn,1235,mage,arcane,24,13,11
Gnarrly,tarren-mill,1235,mage,arcane,27,13,14
Æones,kult-der-verdammten,1233,mage,arcane,36,13,23
Beardmorph,auchindoun,1232,mage,arcane,47,19,28
Ozdewish,hyjal,1230,mage,arcane,159,77,82
Iwannakissu,gorgonnash,1224,mage,arcane,202,108,94
Канеллис,howling-fjord,1219,mage,arcane,49,20,29
Hardways,archimonde,1214,mage,arcane,405,197,208
Nïo,ravencrest,1199,mage,arcane,116,47,69
Hruon,ravenholdt,1195,mage,arcane,30,14,16
Romethito,dun-modr,1186,mage,arcane,62,29,33
Noarcane,twisting-nether,1185,mage,arcane,183,98,85
Meolchum,outland,1180,mage,arcane,51,23,28
Léa,rashgarroth,1175,mage,arcane,72,31,41
Clappycheeks,antonidas,1162,mage,arcane,66,25,41
Динэй,blackscar,1161,mage,arcane,30,16,14
Nelfchewer,ravencrest,1160,mage,arcane,29,13,16
Scaless,stormscale,1157,mage,arcane,52,19,33
Sulteaxion,garrosh,1154,mage,arcane,36,19,17
Demizboub,archimonde,1154,mage,arcane,168,85,83
Wanrltw,ragnaros,1151,mage,arcane,24,12,12
Knúbbz,ravencrest,1147,mage,arcane,36,12,24
Minglul,archimonde,1142,mage,arcane,24,12,12
Sydrel,ragnaros,1130,mage,arcane,18,12,6
Khadgia,argent-dawn,1126,mage,arcane,24,12,12
Oao,chamber-of-aspects,1124,mage,arcane,61,25,36
Icx,tarren-mill,1107,mage,arcane,61,34,27
Rezre,stormscale,1107,mage,arcane,125,60,65
Kobrass,spinebreaker,1101,mage,arcane,76,28,48
Malshash,outland,1100,mage,arcane,42,21,21
Вадимодесса,soulflayer,1099,mage,arcane,113,62,51
Shedooxwrtx,antonidas,1092,mage,arcane,63,23,40
Netomb,kazzak,1080,mage,arcane,30,20,10
Zezt,tarren-mill,1078,mage,arcane,48,17,31
Darmie,burning-legion,1077,mage,arcane,122,48,74
Antïsocïal,hyjal,1076,mage,arcane,84,41,43
Vaelwin,argent-dawn,1074,mage,arcane,65,31,34
Fôôxy,aegwynn,1059,mage,arcane,36,16,20
Elvesnomage,sylvanas,1057,mage,arcane,134,64,70
Kilstine,outland,1056,mage,arcane,30,12,18
Toshoin,defias-brotherhood,1054,mage,arcane,18,11,7
Mëgu,silvermoon,1050,mage,arcane,68,33,35
Soulraider,tarren-mill,1050,mage,arcane,24,11,13
Дантрий,gordunni,1045,mage,arcane,42,24,18
Sosîbîos,blackmoore,1044,mage,arcane,60,34,26
Corlys,defias-brotherhood,1043,mage,arcane,24,15,9
Roulettefar,kazzak,1038,mage,arcane,24,11,13
Gorn,ravencrest,1035,mage,arcane,84,42,42
Burnqq,twisting-nether,1024,mage,arcane,157,76,81
Kuhbi,blackrock,1023,mage,arcane,30,11,19
Plor,exodar,1019,mage,arcane,26,13,13
Roughfked,silvermoon,1017,mage,arcane,128,70,58
Ihatemages,stormreaver,1002,mage,arcane,105,44,61
Sarjeta,grim-batol,997,mage,arcane,36,13,23
Magitis,blackhand,995,mage,arcane,54,14,40
Mylord,bronze-dragonflight,993,mage,arcane,53,21,32
Кронни,razuvious,979,mage,arcane,23,11,12
Сморгонец,gordunni,962,mage,arcane,32,14,18
Banjó,twilights-hammer,959,mage,arcane,12,10,2
Arcticfury,ravencrest,959,mage,arcane,18,10,8
Исусина,borean-tundra,959,mage,arcane,54,28,26
Magiwan,silvermoon,959,mage,arcane,30,10,20
Jamzymage,emerald-dream,958,mage,arcane,15,11,4
Chrome,ysondre,957,mage,arcane,24,10,14
Niulita,outland,956,mage,arcane,18,10,8
Remantin,blackrock,956,mage,arcane,24,10,14
Иссэя,borean-tundra,954,mage,arcane,37,21,16
Чобон,soulflayer,952,mage,arcane,30,10,20
Дырявка,galakrond,949,mage,arcane,30,10,20
Brugg,antonidas,915,mage,arcane,30,15,15
Frostdeath,medivh,906,mage,arcane,24,10,14
Alaryeth,chamber-of-aspects,894,mage,arcane,58,23,35
Êigul,blackrock,894,mage,arcane,26,10,16
Uknowhowwedu,aegwynn,864,mage,arcane,12,9,3
Puni,emerald-dream,864,mage,arcane,12,9,3
Fuhry,tarren-mill,864,mage,arcane,12,9,3
Liga,outland,864,mage,arcane,12,9,3
Thegoodoctor,kazzak,864,mage,arcane,18,9,9
Letsa,stormscale,863,mage,arcane,12,9,3
Arcann,ravencrest,863,mage,arcane,18,9,9
Superduck,ragnaros,863,mage,arcane,24,9,15
Pearbear,argent-dawn,862,mage,arcane,12,9,3
Médivh,archimonde,862,mage,arcane,18,9,9
Mðj,kazzak,862,mage,arcane,24,9,15
Zorqi,argent-dawn,860,mage,arcane,12,9,3
Julieliphie,silvermoon,860,mage,arcane,24,9,15
Caesarclown,silvermoon,857,mage,arcane,27,10,17
Neséri,blackmoore,855,mage,arcane,46,18,28
Kaevelin,argent-dawn,852,mage,arcane,24,9,15
Odor,haomarush,846,mage,arcane,54,26,28
Merlïne,les-clairvoyants,838,mage,arcane,72,31,41
Modjahead,tarren-mill,822,mage,arcane,29,9,20
Mageé,argent-dawn,807,mage,arcane,23,9,14
Bogher,pozzo-delleternità,799,mage,arcane,24,10,14
Diaflash,silvermoon,779,mage,arcane,76,31,45
Syltris,drakthul,771,mage,arcane,105,41,64
Zimbabweborc,burning-legion,768,mage,arcane,12,8,4
Zehnvonzehn,antonidas,767,mage,arcane,18,8,10
Isralysa,ravencrest,767,mage,arcane,24,8,16
Ekelkreatur,blackmoore,766,mage,arcane,12,8,4
Dudè,azshara,766,mage,arcane,18,8,10
Jambonpistol,archimonde,764,mage,arcane,24,8,16
Datamaster,burning-blade,761,mage,arcane,24,8,16
Phyzed,archimonde,735,mage,arcane,17,8,9
Sticlachivas,stormscale,730,mage,arcane,23,8,15
Dcolon,tarren-mill,719,mage,arcane,17,8,9
Зухвала,howling-fjord,708,mage,arcane,41,12,29
Pyroden,stormscale,700,mage,arcane,20,8,12
Seraf,argent-dawn,688,mage,arcane,25,8,17
Aletheía,stormscale,672,mage,arcane,12,7,5
Doryy,silvermoon,672,mage,arcane,12,7,5
Manafuzz,outland,672,mage,arcane,12,7,5
Jengele,argent-dawn,672,mage,arcane,12,7,5
Pizwiz,kazzak,672,mage,arcane,16,8,8
Ranyl,shattrath,672,mage,arcane,18,7,11
Ignyx,ragnaros,672,mage,arcane,24,7,17
Adetin,tarren-mill,671,mage,arcane,12,7,5
Nötmârtònxø,ragnaros,671,mage,arcane,12,7,5
Spellfolk,burning-legion,671,mage,arcane,18,7,11
Shockólot,outland,671,mage,arcane,24,7,17
Falzao,ravencrest,670,mage,arcane,12,7,5
Thorstäin,ragnaros,670,mage,arcane,18,7,11
Itzlucky,twisting-nether,670,mage,arcane,18,7,11
Mortlol,chamber-of-aspects,667,mage,arcane,18,7,11
Milton,dunemaul,666,mage,arcane,30,7,23
Morphous,eonar,648,mage,arcane,18,7,11
Schiattacap,doomhammer,643,mage,arcane,84,13,71
Roslinda,outland,641,mage,arcane,18,7,11
Nàtcho,tichondrius,623,mage,arcane,11,7,4
Альтанис,howling-fjord,623,mage,arcane,21,7,14
Nergl,darksorrow,623,mage,arcane,27,7,20
Sheepthroat,forscherliga,576,mage,arcane,6,6,0
Xue,azshara,576,mage,arcane,6,6,0
Kold,stormscale,576,mage,arcane,12,6,6
Pyllymake,kazzak,576,mage,arcane,12,6,6
Ãshs,archimonde,576,mage,arcane,12,6,6
Яайку,gordunni,576,mage,arcane,18,6,12
Soulkinq,blackmoore,576,mage,arcane,18,6,12
Meisterg,frostwolf,575,mage,arcane,9,7,2
Shõrty,thrall,575,mage,arcane,12,6,6
Mysticbeard,argent-dawn,575,mage,arcane,12,6,6
Apc,sylvanas,575,mage,arcane,12,6,6
Tarovan,defias-brotherhood,575,mage,arcane,12,6,6
Purrpl,twisting-nether,575,mage,arcane,12,6,6
Карраско,soulflayer,575,mage,arcane,12,6,6
Aod,chogall,575,mage,arcane,12,6,6
ßjwercke,stormscale,575,mage,arcane,18,6,12
Dareah,blackmoore,575,mage,arcane,18,6,12
Окости,howling-fjord,574,mage,arcane,12,6,6
Egirllover,hyjal,570,mage,arcane,21,6,15
Leil,die-todeskrallen,569,mage,arcane,24,6,18
Freshforces,ragnaros,553,mage,arcane,26,8,18
Héstia,sylvanas,544,mage,arcane,10,6,4
Sparrowixx,turalyon,537,mage,arcane,14,7,7
Tamtheone,frostwhisper,480,mage,arcane,6,5,1
Мистркорбэн,soulflayer,480,mage,arcane,6,5,1
Línus,twisting-nether,480,mage,arcane,6,5,1
Magevnr,hyjal,480,mage,arcane,12,5,7
Thamagus,burning-legion,480,mage,arcane,12,5,7
Alarak,drakthul,480,mage,arcane,12,5,7
Barryscótt,stormscale,480,mage,arcane,12,5,7
Focusmage,outland,480,mage,arcane,12,5,7
Auchenax,argent-dawn,480,mage,arcane,12,5,7
Pwntt,terenas,480,mage,arcane,12,5,7
Serctheone,ravencrest,480,mage,arcane,15,6,9
Ледянойкекс,gordunni,480,mage,arcane,18,5,13
Mupana,nagrand,480,mage,arcane,18,5,13
Skankengine,twisting-nether,479,mage,arcane,6,5,1
Ewina,twisting-nether,479,mage,arcane,6,5,1
Insømnium,stormscale,479,mage,arcane,12,5,7
Winterblues,frostmourne,479,mage,arcane,12,5,7
Dualin,sanguino,479,mage,arcane,18,5,13
Gripe,defias-brotherhood,478,mage,arcane,6,5,1
Reiggo,silvermoon,478,mage,arcane,9,6,3
Trúkez,ragnaros,384,mage,arcane,6,4,2
Hexmath,tarren-mill,384,mage,arcane,6,4,2
Apollohouse,ravencrest,384,mage,arcane,6,4,2
Yunox,stormscale,384,mage,arcane,6,4,2
Extracting,stormscale,384,mage,arcane,6,4,2
Krispycreme,kazzak,384,mage,arcane,6,4,2
Harpelmage,auchindoun,384,mage,arcane,6,4,2
Thaldariel,blackmoore,384,mage,arcane,6,4,2
Ccxz,draenor,384,mage,arcane,6,4,2
Rizzlybear,outland,384,mage,arcane,6,4,2
Wizkhafury,ravencrest,384,mage,arcane,6,4,2
Мглавечная,azuregos,384,mage,arcane,6,4,2
Эллестра,howling-fjord,384,mage,arcane,6,4,2
Boogeyone,drakthul,384,mage,arcane,12,4,8
Plattyjoobs,draenor,384,mage,arcane,12,4,8
Zgnilakus,burning-legion,384,mage,arcane,12,4,8
Cysbb,arathi,384,mage,arcane,12,4,8
Uní,emerald-dream,384,mage,arcane,12,4,8
Zoot,ravencrest,384,mage,arcane,12,4,8
Dambii,ravencrest,384,mage,arcane,12,4,8
Киренка,gordunni,384,mage,arcane,12,4,8
Arimila,sylvanas,384,mage,arcane,12,4,8
Mikaelà,blackmoore,383,mage,arcane,6,4,2
Мюша,razuvious,382,mage,arcane,12,4,8
Khebu,anubarak,380,mage,arcane,12,4,8
Némmesis,zuljin,378,mage,arcane,12,4,8
Bigshape,frostwolf,351,mage,arcane,11,4,7
Ryalanna,silvermoon,313,mage,arcane,14,4,10
Roxolani,defias-brotherhood,303,mage,arcane,14,4,10
Euphorie,twisting-nether,288,mage,arcane,6,3,3
Mylanq,ragnaros,288,mage,arcane,6,3,3
Núk,blackrock,288,mage,arcane,6,3,3
Gagaj,ravencrest,288,mage,arcane,6,3,3
Rvca,shadowsong,288,mage,arcane,6,3,3
Seyece,silvermoon,288,mage,arcane,6,3,3
Havokh,blackmoore,288,mage,arcane,6,3,3
Zzpf,silvermoon,288,mage,arcane,6,3,3
Æskalatîøn,blackmoore,288,mage,arcane,6,3,3
Onlymage,outland,288,mage,arcane,6,3,3
Szlay,blackmoore,288,mage,arcane,6,3,3
Choise,stormscale,288,mage,arcane,6,3,3
Xirzy,silvermoon,288,mage,arcane,6,3,3
Suidas,auchindoun,288,mage,arcane,6,3,3
Watchmeclick,archimonde,288,mage,arcane,6,3,3
Datpyrotho,stormscale,288,mage,arcane,6,3,3
Ovrpwrdxd,kazzak,288,mage,arcane,6,3,3
Kyrn,zuljin,288,mage,arcane,6,3,3
Khoshgele,draenor,288,mage,arcane,6,3,3
Brokenlegman,defias-brotherhood,288,mage,arcane,6,3,3
Takayaki,terokkar,288,mage,arcane,6,3,3
Euklid,ravencrest,288,mage,arcane,6,3,3
Мактай,gordunni,288,mage,arcane,6,3,3
Bmbiscuit,ravencrest,288,mage,arcane,6,3,3
Astroknight,silvermoon,288,mage,arcane,6,3,3
Hógwarts,aegwynn,288,mage,arcane,6,3,3
Колдрагос,gordunni,288,mage,arcane,6,3,3
Tìktokthot,outland,288,mage,arcane,6,3,3
Sippebób,laughing-skull,288,mage,arcane,12,3,9
Хблэйз,howling-fjord,288,mage,arcane,12,3,9
Noblockgødx,dun-modr,288,mage,arcane,12,3,9
Lesoleil,archimonde,288,mage,arcane,12,3,9
Ionofrost,stormscale,288,mage,arcane,12,3,9
Schøkø,eredar,288,mage,arcane,12,3,9
Эпсиха,lich-king,288,mage,arcane,18,3,15
Chimará,eredar,288,mage,arcane,18,3,15
Frökenfrost,stormscale,287,mage,arcane,6,3,3
Burnem,kult-der-verdammten,287,mage,arcane,6,3,3
Магборода,soulflayer,287,mage,arcane,6,3,3
Arcadua,sanguino,287,mage,arcane,6,3,3
Buttet,blackmoore,287,mage,arcane,18,3,15
Kasus,sporeggar,286,mage,arcane,6,3,3
Ivoc,drakthul,254,mage,arcane,11,3,8
Naween,hyjal,239,mage,arcane,5,3,2
Cris,azuremyst,239,mage,arcane,5,3,2
Rafixmag,chamber-of-aspects,238,mage,arcane,20,5,15
Kairøs,dragonblight,223,mage,arcane,16,3,13
Fàbious,ysondre,192,mage,arcane,6,2,4
Леракобольд,gordunni,192,mage,arcane,6,2,4
Kjh,twisting-nether,192,mage,arcane,6,2,4
Yungmago,ysondre,192,mage,arcane,6,2,4
Rommelo,ravencrest,192,mage,arcane,6,2,4
Teeclis,twisting-nether,192,mage,arcane,6,2,4
Sheeptowin,thrall,192,mage,arcane,6,2,4
Галадриелька,gordunni,192,mage,arcane,6,2,4
Ashioth,argent-dawn,192,mage,arcane,6,2,4
Noviina,argent-dawn,192,mage,arcane,6,2,4
Lìx,ravencrest,192,mage,arcane,6,2,4
Oorly,aegwynn,192,mage,arcane,6,2,4
Spellonfire,ravencrest,192,mage,arcane,6,2,4
Gôodgame,frostmane,192,mage,arcane,6,2,4
Naomypayton,tarren-mill,192,mage,arcane,6,2,4
Соорка,gordunni,192,mage,arcane,6,2,4
Миднаит,gordunni,192,mage,arcane,6,2,4
Hechicero,ravencrest,192,mage,arcane,6,2,4
Quaile,malygos,192,mage,arcane,6,2,4
Nerzzhul,burning-legion,192,mage,arcane,6,2,4
Capubell,nethersturm,192,mage,arcane,6,2,4
Bloodycast,archimonde,192,mage,arcane,6,2,4
Versachi,neptulon,192,mage,arcane,6,2,4
Génociidz,archimonde,192,mage,arcane,6,2,4
Зерагуд,eversong,192,mage,arcane,6,2,4
Widepekka,ragnaros,192,mage,arcane,6,2,4
Йяу,howling-fjord,192,mage,arcane,6,2,4
Azoru,twisting-nether,192,mage,arcane,6,2,4
Kuhwar,echsenkessel,192,mage,arcane,6,2,4
Ryûblast,archimonde,192,mage,arcane,6,2,4
Линклер,fordragon,192,mage,arcane,6,2,4
Imbatto,quelthalas,192,mage,arcane,6,2,4
Drinte,blackmoore,192,mage,arcane,6,2,4
Сонатра,howling-fjord,192,mage,arcane,6,2,4
Crinkles,laughing-skull,192,mage,arcane,6,2,4
Mejtschazor,twisting-nether,192,mage,arcane,6,2,4
Noxkin,stormscale,192,mage,arcane,6,2,4
Kbd,outland,192,mage,arcane,6,2,4
Dramajohns,silvermoon,192,mage,arcane,6,2,4
Magepress,silvermoon,192,mage,arcane,6,2,4
Pølåris,outland,192,mage,arcane,6,2,4
Drencast,hyjal,192,mage,arcane,6,2,4
Äßäm,outland,192,mage,arcane,6,2,4
Rusto,hellscream,192,mage,arcane,12,2,10
Аделфорн,eversong,192,mage,arcane,12,2,10
Farciminis,outland,192,mage,arcane,12,2,10
Smlx,outland,192,mage,arcane,12,2,10
Veveroiu,defias-brotherhood,191,mage,arcane,6,2,4
Magse,kirin-tor,191,mage,arcane,6,2,4
Anderl,kirin-tor,191,mage,arcane,12,2,10
Frendor,turalyon,191,mage,arcane,18,2,16
Gadeplan,argent-dawn,159,mage,arcane,5,2,3
Deadtedd,twisting-nether,138,mage,arcane,9,3,6
Døomey,ravencrest,138,mage,arcane,15,3,12
Carufera,defias-brotherhood,110,mage,arcane,7,2,5
Старкскрим,gordunni,96,mage,arcane,6,1,5
Адренохромх,gordunni,96,mage,arcane,6,1,5
Шарансул,soulflayer,96,mage,arcane,6,1,5
Калихор,gordunni,96,mage,arcane,6,1,5
Yungbambix,twisting-nether,96,mage,arcane,6,1,5
Sorrow,outland,96,mage,arcane,6,1,5
Криаркана,howling-fjord,96,mage,arcane,6,1,5
Рэймонд,howling-fjord,96,mage,arcane,6,1,5
Karysta,blackhand,96,mage,arcane,6,1,5
Thelastmage,outland,96,mage,arcane,6,1,5
Саназэр,howling-fjord,96,mage,arcane,6,1,5
Шпексх,soulflayer,96,mage,arcane,6,1,5
Glacius,stormscale,96,mage,arcane,6,1,5
Wushii,aggra-português,96,mage,arcane,6,1,5
Hotafazz,ravencrest,96,mage,arcane,6,1,5
Oz,frostmane,96,mage,arcane,6,1,5
Sidildur,ravencrest,96,mage,arcane,6,1,5
Moosemæn,stormscale,96,mage,arcane,6,1,5
Bakeren,frostmane,96,mage,arcane,6,1,5
Dobbite,archimonde,96,mage,arcane,6,1,5
Zerøsílgødx,antonidas,96,mage,arcane,6,1,5
Azakadabra,ysondre,96,mage,arcane,6,1,5
Firerazer,hyjal,96,mage,arcane,6,1,5
Firehasse,draenor,96,mage,arcane,6,1,5
Bigkent,stormscale,96,mage,arcane,6,1,5
Zeklo,frostmane,96,mage,arcane,6,1,5
Мерац,howling-fjord,96,mage,arcane,6,1,5
Malicä,ravencrest,96,mage,arcane,6,1,5
Autramage,emerald-dream,96,mage,arcane,6,1,5
Lêgólás,blackmoore,96,mage,arcane,6,1,5
Grönmonster,shattered-hand,96,mage,arcane,6,1,5
Animaze,argent-dawn,96,mage,arcane,6,1,5
Kaiyn,argent-dawn,96,mage,arcane,6,1,5
Zadnik,tarren-mill,96,mage,arcane,6,1,5
Sîrã,tarren-mill,96,mage,arcane,6,1,5
Kalokoh,tarren-mill,96,mage,arcane,6,1,5
Facerollyo,tarren-mill,96,mage,arcane,6,1,5
Mfnz,stormreaver,96,mage,arcane,6,1,5
Souldemon,burning-legion,96,mage,arcane,6,1,5
Spellwind,silvermoon,96,mage,arcane,6,1,5
Nohbrain,blackmoore,96,mage,arcane,6,1,5
Lumberth,sanguino,96,mage,arcane,6,1,5
Akharthion,defias-brotherhood,96,mage,arcane,6,1,5
Yanir,die-arguswacht,96,mage,arcane,6,1,5
Hólmess,silvermoon,96,mage,arcane,6,1,5
Bananaslam,silvermoon,96,mage,arcane,6,1,5
Magicpowers,silvermoon,96,mage,arcane,12,1,11
Patricstewrd,draenor,96,mage,arcane,12,1,11
Varini,twisting-nether,96,mage,arcane,12,1,11
Damnlate,blackmoore,96,mage,arcane,18,1,17
Dârigaaz,blackmoore,96,mage,arcane,18,1,17
Xläderz,ravencrest,79,mage,arcane,5,1,4
Zovos,sporeggar,79,mage,arcane,11,1,10
Манднесс,azuregos,79,mage,arcane,11,1,10
Vinlimar,drakthul,64,mage,arcane,4,1,3
Stümpy,ravencrest,64,mage,arcane,5,1,4
Baravar,blackrock,42,mage,arcane,11,3,8
Partypower,twisting-nether,2404,mage,fire,66,48,18
Laynerz,kazzak,2388,mage,fire,105,68,37
Raíku,ravencrest,2360,mage,fire,84,50,34
Барсуктри,deathguard,2322,mage,fire,154,95,59
Tommy,laughing-skull,2309,mage,fire,142,81,61
Thegoodoctor,kazzak,2275,mage,fire,430,226,204
Gelußaßa,ravencrest,2244,mage,fire,101,57,44
Шипми,gordunni,2237,mage,fire,259,142,117
Hatsu,kazzak,2237,mage,fire,165,87,78
Jíncks,draenor,2216,mage,fire,178,97,81
Slôw,kazzak,2215,mage,fire,83,54,29
Milkenjoyer,ravencrest,2205,mage,fire,82,53,29
Oseri,defias-brotherhood,2189,mage,fire,220,115,105
Arnoldkelly,tarren-mill,2180,mage,fire,72,45,27
Watchmeclic,archimonde,2170,mage,fire,84,44,40
Рофкастер,gordunni,2160,mage,fire,275,141,134
Håtsu,ravencrest,2160,mage,fire,209,107,102
Róseonly,ravencrest,2158,mage,fire,154,82,72
Nilitar,kazzak,2157,mage,fire,138,72,66
Файрус,soulflayer,2132,mage,fire,176,94,82
Røysi,ravencrest,2128,mage,fire,135,77,58
Xinda,hellfire,2127,mage,fire,71,43,28
Plexyoo,thrall,2123,mage,fire,74,40,34
Slashspít,ravencrest,2119,mage,fire,69,40,29
Søz,agamaggan,2115,mage,fire,78,49,29
Fairus,ravencrest,2107,mage,fire,83,56,27
Smlx,outland,2105,mage,fire,136,79,57
Lemaroxd,draenor,2102,mage,fire,116,66,50
Serctheone,ravencrest,2100,mage,fire,76,46,30
Файрусх,deathguard,2097,mage,fire,69,40,29
Cörnflekz,stormscale,2091,mage,fire,110,70,40
Aleç,ravencrest,2083,mage,fire,63,39,24
Фоулли,howling-fjord,2071,mage,fire,229,124,105
Frozentwink,kul-tiras,2066,mage,fire,208,112,96
Прауз,soulflayer,2063,mage,fire,175,96,79
Tiáno,drakthul,2044,mage,fire,210,112,98
Uknowhowwedu,aegwynn,2043,mage,fire,54,33,21
Wheí,ravencrest,2038,mage,fire,96,60,36
Lisanalgaib,kilrogg,2037,mage,fire,105,59,46
Rizzlybear,outland,2035,mage,fire,87,45,42
Espressno,ravencrest,2030,mage,fire,42,35,7
Nuj,blackrock,2028,mage,fire,42,27,15
Twizzkek,silvermoon,2024,mage,fire,237,117,120
Ráìkù,ravencrest,2021,mage,fire,60,32,28
Ðevlqt,blackmoore,2018,mage,fire,257,142,115
Yh,ragnaros,2017,mage,fire,59,42,17
Sóz,ravencrest,2017,mage,fire,53,35,18
Dyen,hyjal,2015,mage,fire,132,73,59
Nilitarrgh,outland,2012,mage,fire,56,29,27
Setyouoncs,ravencrest,2010,mage,fire,160,89,71
Uknowhowwedu,blackrock,2006,mage,fire,72,41,31
Evovar,silvermoon,2005,mage,fire,267,138,129
Síckmode,khadgar,2001,mage,fire,192,108,84
Gossipgirlz,outland,2000,mage,fire,159,92,67
Avizura,kazzak,1998,mage,fire,42,30,12
Magiwan,silvermoon,1998,mage,fire,117,65,52
Cornfloax,ravencrest,1995,mage,fire,84,53,31
Pisini,tarren-mill,1991,mage,fire,90,45,45
Octtmiss,twisting-nether,1989,mage,fire,110,64,46
Lilbolts,outland,1981,mage,fire,54,34,20
Spicyboi,archimonde,1978,mage,fire,53,37,16
Randommagexd,ravencrest,1977,mage,fire,42,31,11
Реордиан,gordunni,1975,mage,fire,86,38,48
Dxdxdxdxdx,drakthul,1970,mage,fire,131,77,54
Bigkent,stormscale,1964,mage,fire,86,44,42
Нереварин,soulflayer,1962,mage,fire,168,92,76
Håtemebaby,kazzak,1962,mage,fire,90,39,51
Magijoana,silvermoon,1958,mage,fire,132,70,62
Калихор,gordunni,1956,mage,fire,156,95,61
Dazz,ravencrest,1954,mage,fire,371,186,185
Grumpié,ravencrest,1953,mage,fire,48,34,14
Ввнд,galakrond,1941,mage,fire,66,33,33
Zoot,ravencrest,1939,mage,fire,125,64,61
Aìnz,hyjal,1935,mage,fire,101,61,40
Evohz,stormscale,1932,mage,fire,91,49,42
Choll,stormscale,1932,mage,fire,249,133,116
Tpøtmenenø,ravencrest,1931,mage,fire,48,34,14
Uniquenoodle,alakir,1931,mage,fire,104,52,52
Ãshs,archimonde,1927,mage,fire,36,24,12
Mssilvy,sylvanas,1927,mage,fire,258,140,118
Navolav,turalyon,1924,mage,fire,65,43,22
Urkela,sylvanas,1923,mage,fire,168,92,76
Lyssæ,khaz-modan,1922,mage,fire,203,107,96
Darkfiré,blackmoore,1916,mage,fire,110,56,54
Диссоциация,greymane,1916,mage,fire,190,96,94
Sleepingfate,stormscale,1913,mage,fire,80,44,36
Зефенжо,howling-fjord,1913,mage,fire,89,48,41
Nihilvm,dalaran,1912,mage,fire,124,66,58
Symera,dun-modr,1910,mage,fire,89,58,31
Sanjoop,tarren-mill,1907,mage,fire,96,52,44
Ygø,hyjal,1907,mage,fire,294,148,146
Noxkin,stormscale,1906,mage,fire,83,48,35
Brokenlegman,defias-brotherhood,1903,mage,fire,42,26,16
Reyown,archimonde,1901,mage,fire,82,58,24
Tacomagex,kazzak,1897,mage,fire,124,79,45
Obbcontrol,ravencrest,1894,mage,fire,240,130,110
Mejtschazor,silvermoon,1893,mage,fire,89,56,33
Goomba,tarren-mill,1893,mage,fire,125,59,66
Ticklefinger,agamaggan,1886,mage,fire,30,21,9
Wwjd,darksorrow,1885,mage,fire,55,31,24
Вовзон,howling-fjord,1883,mage,fire,185,103,82
Tìktokthot,outland,1882,mage,fire,36,23,13
Magnopvp,sanguino,1878,mage,fire,53,35,18
Яшабурстх,blackscar,1874,mage,fire,297,148,149
Altraftw,archimonde,1871,mage,fire,77,52,25
Uní,emerald-dream,1869,mage,fire,42,29,13
Rewq,twisting-nether,1866,mage,fire,98,62,36
Ilovedana,dun-modr,1865,mage,fire,60,42,18
Djflashz,archimonde,1865,mage,fire,189,97,92
Prácticemàge,archimonde,1864,mage,fire,54,35,19
Илайза,fordragon,1862,mage,fire,39,29,10
Spelltastìc,blackmoore,1859,mage,fire,96,53,43
Medivqt,ragnaros,1858,mage,fire,60,44,16
Dardie,ravencrest,1856,mage,fire,54,33,21
Sticki,malganis,1855,mage,fire,48,34,14
Maguscarlsen,ravencrest,1853,mage,fire,186,111,75
Excuséme,ravencrest,1851,mage,fire,51,27,24
Mßs,outland,1851,mage,fire,89,44,45
Frøstqt,ravencrest,1851,mage,fire,65,30,35
Hazewrld,ravencrest,1848,mage,fire,132,62,70
Lotharie,aegwynn,1847,mage,fire,36,23,13
Sérum,drakthul,1847,mage,fire,54,33,21
Spelltastíc,blackmoore,1844,mage,fire,54,34,20
Kindled,argent-dawn,1843,mage,fire,116,70,46
Larmp,outland,1842,mage,fire,72,39,33
Underscore,outland,1841,mage,fire,91,51,40
Camefromzoo,outland,1839,mage,fire,40,26,14
Covran,stormscale,1838,mage,fire,36,21,15
Timzør,outland,1837,mage,fire,60,37,23
Belled,silvermoon,1836,mage,fire,95,64,31
Колтрэйн,blackscar,1836,mage,fire,45,30,15
Hooksclay,archimonde,1836,mage,fire,78,45,33
Shíróyama,ravencrest,1835,mage,fire,92,58,34
Nøw,ravencrest,1835,mage,fire,75,40,35
Wenant,ravencrest,1834,mage,fire,285,144,141
Watchmeclick,archimonde,1833,mage,fire,29,20,9
Skylezy,blackrock,1833,mage,fire,71,37,34
Shavay,blackmoore,1832,mage,fire,62,31,31
Archíques,kazzak,1831,mage,fire,46,24,22
Dubbleblast,draenor,1830,mage,fire,54,34,20
Shîmmer,ravencrest,1830,mage,fire,48,23,25
Jumpfanqt,stormscale,1827,mage,fire,42,30,12
Wàneís,ravencrest,1827,mage,fire,116,58,58
Aryasa,silvermoon,1824,mage,fire,42,28,14
Quentin,grim-batol,1824,mage,fire,320,169,151
Твейзи,blackscar,1823,mage,fire,40,24,16
Stepdaddyy,kazzak,1823,mage,fire,54,28,26
Dizzy,ahnqiraj,1823,mage,fire,286,141,145
Rambau,archimonde,1821,mage,fire,91,56,35
Хехгодх,gordunni,1818,mage,fire,33,20,13
Stümpy,ravencrest,1818,mage,fire,126,75,51
Fireblood,runetotem,1818,mage,fire,102,53,49
Nøw,kazzak,1816,mage,fire,48,29,19
Worstdenmark,stormscale,1816,mage,fire,35,20,15
Hiryú,kazzak,1815,mage,fire,30,20,10
Cleophe,burning-legion,1815,mage,fire,122,78,44
Elmaestró,aegwynn,1815,mage,fire,48,30,18
Abruaa,tarren-mill,1815,mage,fire,65,34,31
Hólmess,silvermoon,1815,mage,fire,144,72,72
Smittywerbn,stormscale,1814,mage,fire,141,78,63
Asiman,eredar,1814,mage,fire,84,42,42
Thughunterqt,silvermoon,1812,mage,fire,398,211,187
Шуткам,gordunni,1811,mage,fire,42,26,16
Рамблз,gordunni,1811,mage,fire,66,39,27
Jirt,stormscale,1810,mage,fire,71,41,30
Khorosho,draenor,1810,mage,fire,54,26,28
Ókamí,ravencrest,1809,mage,fire,139,72,67
Cienaños,outland,1807,mage,fire,102,59,43
Миллерфест,howling-fjord,1807,mage,fire,88,47,41
Ширм,blackscar,1807,mage,fire,48,24,24
Divey,draenor,1805,mage,fire,304,166,138
Фюртэ,howling-fjord,1803,mage,fire,42,26,16
Nihiliz,twisting-nether,1803,mage,fire,47,27,20
Moojob,kazzak,1801,mage,fire,54,30,24
Harrisøn,dun-modr,1799,mage,fire,78,47,31
Anisovsky,archimonde,1797,mage,fire,82,39,43
Azety,archimonde,1796,mage,fire,42,29,13
Stoychav,outland,1796,mage,fire,211,114,97
Алаурс,howling-fjord,1794,mage,fire,213,117,96
Isenhour,frostmane,1794,mage,fire,294,148,146
Borp,defias-brotherhood,1791,mage,fire,42,27,15
Sâkuya,blackrock,1790,mage,fire,100,57,43
Missl,draenor,1790,mage,fire,49,26,23
Fuego,sylvanas,1788,mage,fire,256,135,121
Djfrosty,kazzak,1786,mage,fire,182,103,79
Roxxis,kazzak,1783,mage,fire,54,25,29
Czd,outland,1779,mage,fire,285,139,146
Shahnoza,thrall,1775,mage,fire,51,31,20
Mowns,ravencrest,1775,mage,fire,48,21,27
Mathematik,outland,1773,mage,fire,66,26,40
Funkyfriday,twisting-nether,1770,mage,fire,36,20,16
Insaneex,aegwynn,1769,mage,fire,54,32,22
Consquens,aszune,1767,mage,fire,54,34,20
Excuses,chamber-of-aspects,1767,mage,fire,169,94,75
Takayaki,terokkar,1766,mage,fire,142,77,65
Htwhy,kazzak,1766,mage,fire,370,195,175
Auchenax,argent-dawn,1764,mage,fire,97,55,42
Haxyo,twisting-nether,1764,mage,fire,162,88,74
Nebbur,dun-modr,1763,mage,fire,57,33,24
Деозар,eversong,1762,mage,fire,409,216,193
Magicrex,alleria,1761,mage,fire,96,60,36
Hey,khazgoroth,1759,mage,fire,188,99,89
Двинск,soulflayer,1756,mage,fire,111,57,54
Arcticfury,ravencrest,1753,mage,fire,36,22,14
Nocturnes,sylvanas,1753,mage,fire,73,31,42
Ipen,bloodfeather,1752,mage,fire,36,23,13
Büyübaba,twisting-nether,1752,mage,fire,171,90,81
Yungbambix,twisting-nether,1751,mage,fire,68,37,31
Abêj,malygos,1747,mage,fire,56,31,25
Ecovation,tarren-mill,1747,mage,fire,92,46,46
Titarie,ravencrest,1742,mage,fire,42,22,20
Гекомория,fordragon,1736,mage,fire,65,26,39
Volksmagier,ravencrest,1735,mage,fire,103,62,41
Snowbob,drakthul,1734,mage,fire,107,59,48
Миднаит,gordunni,1733,mage,fire,190,106,84
Carufera,defias-brotherhood,1733,mage,fire,249,137,112
Zzpf,silvermoon,1732,mage,fire,126,60,66
Cesi,silvermoon,1732,mage,fire,101,47,54
Camelshaver,tarren-mill,1730,mage,fire,123,70,53
Mohammedjiba,ragnaros,1728,mage,fire,104,56,48
Brainsick,kazzak,1727,mage,fire,48,26,22
Келлазар,gordunni,1727,mage,fire,168,90,78
Пыроженное,deathguard,1727,mage,fire,158,81,77
Asterixus,sylvanas,1726,mage,fire,84,50,34
Aflamé,kilrogg,1724,mage,fire,54,34,20
Lìx,ravencrest,1722,mage,fire,36,24,12
Isildurone,ragnaros,1721,mage,fire,62,35,27
Проблембойх,gordunni,1719,mage,fire,60,25,35
Climatrix,twisting-nether,1718,mage,fire,47,35,12
Акиххабара,gordunni,1717,mage,fire,87,51,36
Enandia,darksorrow,1716,mage,fire,148,80,68
Vulcanô,sanguino,1715,mage,fire,202,103,99
Cardioexpert,ravencrest,1711,mage,fire,36,29,7
Laciee,silvermoon,1711,mage,fire,80,44,36
Siérra,outland,1708,mage,fire,119,70,49
Авгурей,howling-fjord,1708,mage,fire,142,70,72
Equálity,blackrock,1707,mage,fire,90,53,37
Andors,conseil-des-ombres,1707,mage,fire,60,33,27
Skrex,blackrock,1707,mage,fire,446,233,213
Kilstine,outland,1706,mage,fire,30,21,9
Tokerlol,stormscale,1706,mage,fire,81,49,32
Soxlol,sylvanas,1704,mage,fire,35,19,16
Magão,frostmane,1704,mage,fire,154,81,73
Мактай,gordunni,1703,mage,fire,70,42,28
Crooja,antonidas,1701,mage,fire,60,39,21
Rekzaop,ravencrest,1700,mage,fire,28,19,9
Hil,blackrock,1700,mage,fire,83,52,31
Lo,kilrogg,1700,mage,fire,121,69,52
Magethings,kazzak,1700,mage,fire,196,104,92
Sèrum,drakthul,1700,mage,fire,59,26,33
Saiyangodx,twisting-nether,1698,mage,fire,108,53,55
Sendro,twisting-nether,1697,mage,fire,69,40,29
Rizzycakes,silvermoon,1697,mage,fire,96,48,48
Ahstin,teldrassil,1696,mage,fire,54,40,14
Triplesevenx,silvermoon,1696,mage,fire,313,166,147
Сплитсистема,galakrond,1694,mage,fire,48,29,19
Достижений,soulflayer,1694,mage,fire,125,58,67
Арара,gordunni,1693,mage,fire,42,20,22
Magnobi,sanguino,1692,mage,fire,42,24,18
Únna,sanguino,1691,mage,fire,66,35,31
Blix,sanguino,1690,mage,fire,60,34,26
Cheerió,aggramar,1688,mage,fire,371,196,175
Äntigood,outland,1688,mage,fire,53,27,26
Einsmagus,blackrock,1687,mage,fire,189,103,86
Agáné,ravencrest,1686,mage,fire,34,25,9
Nùts,archimonde,1686,mage,fire,84,39,45
Dantiqa,ravencrest,1685,mage,fire,712,362,350
Nàtcho,tichondrius,1685,mage,fire,71,35,36
Defrozen,twisting-nether,1684,mage,fire,118,64,54
Macheat,kazzak,1684,mage,fire,138,72,66
Blinkinpark,pozzo-delleternità,1683,mage,fire,63,37,26
Midooa,nerathor,1683,mage,fire,117,66,51
Pumped,haomarush,1683,mage,fire,93,48,45
Akâri,silvermoon,1682,mage,fire,122,69,53
Âcryz,blackrock,1682,mage,fire,111,55,56
Onkela,arygos,1681,mage,fire,36,34,2
Castorcato,kazzak,1681,mage,fire,48,21,27
Elldiamage,draenor,1680,mage,fire,57,31,26
Koltom,ravencrest,1676,mage,fire,36,26,10
Bumboozling,kazzak,1676,mage,fire,72,46,26
Nelfchewer,ravencrest,1676,mage,fire,46,26,20
Kurtcobain,draenor,1676,mage,fire,85,48,37
Silmara,shadowsong,1675,mage,fire,66,39,27
Magegodx,rexxar,1674,mage,fire,165,96,69
Bezelgeuse,nemesis,1673,mage,fire,113,63,50
Icoz,nemesis,1673,mage,fire,100,55,45
Relik,sylvanas,1673,mage,fire,60,31,29
Мосгормаг,gordunni,1671,mage,fire,77,43,34
Cilaa,silvermoon,1670,mage,fire,41,24,17
Arcann,ravencrest,1669,mage,fire,84,51,33
Aronnax,ravencrest,1668,mage,fire,88,48,40
Felìá,kazzak,1665,mage,fire,54,32,22
Twoeightybpm,draenor,1664,mage,fire,58,33,25
Soz,agamaggan,1663,mage,fire,29,18,11
Sukky,todeswache,1663,mage,fire,66,40,26
Xîzy,outland,1663,mage,fire,48,24,24
Фроз,soulflayer,1661,mage,fire,128,71,57
Doonii,ragnaros,1661,mage,fire,71,34,37
Avæ,stormscale,1659,mage,fire,88,52,36
Texmexguden,tarren-mill,1659,mage,fire,72,40,32
Аквамэрис,gordunni,1658,mage,fire,36,21,15
Baldazzor,ravencrest,1658,mage,fire,89,48,41
Bebenm,archimonde,1655,mage,fire,41,20,21
Møøk,magtheridon,1654,mage,fire,30,19,11
Cenzored,chamber-of-aspects,1654,mage,fire,35,22,13
Hernêise,silvermoon,1654,mage,fire,184,97,87
Dcolon,tarren-mill,1650,mage,fire,54,28,26
Mëismz,hyjal,1649,mage,fire,46,26,20
Meisterg,frostwolf,1648,mage,fire,34,19,15
Netrinkuet,outland,1648,mage,fire,41,21,20
Denaleidi,stormscale,1645,mage,fire,45,24,21
Knoxvit,tarren-mill,1644,mage,fire,36,24,12
Rusdorcito,frostwhisper,1644,mage,fire,41,23,18
Máximus,ravencrest,1644,mage,fire,48,26,22
Robsn,blackrock,1643,mage,fire,30,19,11
Kickyaa,twisting-nether,1643,mage,fire,126,71,55
Azakadabra,ysondre,1643,mage,fire,105,59,46
Turbomedusa,draenor,1642,mage,fire,34,22,12
Нефростмаг,gordunni,1642,mage,fire,130,69,61
Sheepmeepbip,ravencrest,1642,mage,fire,172,81,91
Chrismage,argent-dawn,1641,mage,fire,109,60,49
Uskomaaginen,ravencrest,1640,mage,fire,65,38,27
Fessadimamt,draenor,1640,mage,fire,36,21,15
Elynaé,draenor,1639,mage,fire,48,26,22
Pluggis,the-maelstrom,1638,mage,fire,72,40,32
Itrius,tarren-mill,1638,mage,fire,99,48,51
Magenerfed,archimonde,1637,mage,fire,42,21,21
Dannyvye,outland,1635,mage,fire,36,23,13
Sekulicgoga,draenor,1634,mage,fire,150,94,56
Reqwyz,ragnaros,1634,mage,fire,86,51,35
Akrapovic,drakthul,1633,mage,fire,60,32,28
Магмагистр,blackscar,1633,mage,fire,156,81,75
Axhole,darksorrow,1631,mage,fire,34,25,9
Fakeklepter,sylvanas,1631,mage,fire,30,21,9
Faunas,kazzak,1631,mage,fire,152,94,58
Fuhrem,blackrock,1630,mage,fire,36,23,13
Gavno,ravencrest,1629,mage,fire,30,20,10
Backped,kazzak,1629,mage,fire,70,35,35
Benjibop,ravencrest,1628,mage,fire,29,21,8
Ayken,burning-legion,1628,mage,fire,42,26,16
Цепнойпёс,goldrinn,1627,mage,fire,53,31,22
Råståfåri,uldum,1627,mage,fire,87,47,40
Intz,twisting-nether,1627,mage,fire,105,55,50
Ênizt,archimonde,1626,mage,fire,58,34,24
Chucknoir,draenor,1626,mage,fire,72,42,30
Айслэнц,howling-fjord,1625,mage,fire,82,38,44
Yésdávé,stormscale,1624,mage,fire,24,17,7
Sany,anubarak,1624,mage,fire,30,20,10
Aestus,outland,1624,mage,fire,54,25,29
Aarsengel,ravencrest,1623,mage,fire,30,18,12
Radiantfury,outland,1623,mage,fire,88,41,47
Смилер,gordunni,1622,mage,fire,138,76,62
Satyrnaar,tarren-mill,1622,mage,fire,72,36,36
Nurfdm,ravencrest,1621,mage,fire,35,23,12
Игрдлпдров,gordunni,1621,mage,fire,163,91,72
Qqcult,ravencrest,1620,mage,fire,51,31,20
Rayniß,blackmoore,1620,mage,fire,171,91,80
Mariiejanee,nozdormu,1620,mage,fire,54,25,29
Firecold,silvermoon,1619,mage,fire,191,105,86
Джелиона,gordunni,1619,mage,fire,66,36,30
Naps,argent-dawn,1619,mage,fire,158,86,72
Neird,sinstralis,1618,mage,fire,108,63,45
Resheep,kazzak,1617,mage,fire,77,42,35
Combusturmum,outland,1617,mage,fire,36,19,17
Sinanspappa,argent-dawn,1616,mage,fire,24,18,6
Tdv,draenor,1616,mage,fire,42,24,18
Dbshèépgôdx,silvermoon,1616,mage,fire,48,27,21
Lilblinks,silvermoon,1616,mage,fire,126,67,59
Hambones,outland,1616,mage,fire,68,30,38
Speedshatter,aegwynn,1615,mage,fire,30,17,13
Cameljoe,blackhand,1615,mage,fire,80,42,38
Xyfys,azshara,1613,mage,fire,36,22,14
Magikere,tarren-mill,1613,mage,fire,78,42,36
Wafflegodx,turalyon,1612,mage,fire,36,22,14
Flocca,argent-dawn,1612,mage,fire,50,26,24
Itsøkay,archimonde,1611,mage,fire,36,21,15
Kbd,outland,1611,mage,fire,90,49,41
Витуз,gordunni,1610,mage,fire,66,35,31
Badguy,arathor,1610,mage,fire,42,21,21
Línus,twisting-nether,1609,mage,fire,24,21,3
Хблэйз,howling-fjord,1609,mage,fire,61,35,26
Firedeáth,kazzak,1608,mage,fire,100,55,45
Alluryeine,draenor,1607,mage,fire,54,30,24
Blackpowerrx,ravencrest,1606,mage,fire,60,35,25
Aimaniac,stormscale,1606,mage,fire,211,118,93
Jessaniel,chogall,1605,mage,fire,52,29,23
Sondremage,outland,1605,mage,fire,54,26,28
Тачитачи,gordunni,1604,mage,fire,125,71,54
Magegødx,eredar,1603,mage,fire,114,64,50
Neuralnetwrk,sylvanas,1603,mage,fire,60,32,28
Незерёб,soulflayer,1603,mage,fire,42,22,20
Yanir,die-arguswacht,1602,mage,fire,30,17,13
Whats,korgall,1602,mage,fire,112,61,51
Колдрагос,gordunni,1602,mage,fire,94,50,44
Zimbabweborc,burning-legion,1600,mage,fire,36,25,11
Spellfaker,drakthul,1600,mage,fire,84,49,35
Glacialspike,eredar,1600,mage,fire,48,25,23
Emoden,silvermoon,1599,mage,fire,48,24,24
Yshax,malganis,1599,mage,fire,130,64,66
Raikuswife,twisting-nether,1598,mage,fire,30,17,13
Fearbeäch,ravencrest,1597,mage,fire,65,36,29
Petepan,argent-dawn,1591,mage,fire,42,24,18
Gaárá,stormscale,1591,mage,fire,582,292,290
Greaterkick,blackrock,1588,mage,fire,46,27,19
Shínsou,burning-blade,1588,mage,fire,188,101,87
Гунмаказ,gordunni,1587,mage,fire,46,28,18
Stickiburn,malganis,1586,mage,fire,30,19,11
Carinuz,blackmoore,1585,mage,fire,162,82,80
Säroumäne,archimonde,1584,mage,fire,61,31,30
Ethiqq,gorgonnash,1584,mage,fire,60,28,32
Frígíd,outland,1581,mage,fire,84,41,43
Hardelf,kazzak,1580,mage,fire,25,20,5
Dorá,azjolnerub,1579,mage,fire,66,35,31
Wenndrid,draenor,1579,mage,fire,491,258,233
Cooy,stormscale,1576,mage,fire,74,41,33
Realone,ragnaros,1576,mage,fire,42,21,21
Lïppoutou,archimonde,1575,mage,fire,30,17,13
Libre,stormscale,1575,mage,fire,548,278,270
Hængovêr,antonidas,1574,mage,fire,125,70,55
Mëgu,silvermoon,1573,mage,fire,454,240,214
Слизерин,gordunni,1573,mage,fire,68,33,35
Shinegami,hyjal,1569,mage,fire,48,27,21
Né,dalaran,1569,mage,fire,123,66,57
Alni,thrall,1567,mage,fire,59,32,27
Xanaxgød,outland,1565,mage,fire,29,17,12
Witak,ysondre,1565,mage,fire,180,89,91
Qulinx,kazzak,1564,mage,fire,40,22,18
Аластормаг,deathweaver,1562,mage,fire,153,82,71
Hardtimes,blackhand,1556,mage,fire,74,38,36
Êigul,blackrock,1556,mage,fire,65,28,37
Shainax,dun-modr,1554,mage,fire,49,24,25
Ustafrr,argent-dawn,1553,mage,fire,121,74,47
Meign,eredar,1553,mage,fire,54,29,25
Swizzy,arathor,1552,mage,fire,36,20,16
Darríck,argent-dawn,1552,mage,fire,119,63,56
Zíru,outland,1552,mage,fire,115,57,58
Lilkiki,archimonde,1551,mage,fire,30,19,11
Cryptik,blackmoore,1549,mage,fire,145,80,65
Gagaj,ravencrest,1549,mage,fire,66,32,34
Liendri,aegwynn,1548,mage,fire,120,64,56
Dauwen,silvermoon,1548,mage,fire,78,40,38
Mante,antonidas,1547,mage,fire,317,159,158
Whócárés,dragonmaw,1546,mage,fire,30,17,13
Apócalyptic,tarren-mill,1546,mage,fire,249,130,119
Natchèl,ysondre,1544,mage,fire,42,25,17
Invinsible,xavius,1544,mage,fire,54,30,24
Terlon,ragnaros,1543,mage,fire,186,99,87
Poporciné,archimonde,1542,mage,fire,30,20,10
Гнилоглазка,howling-fjord,1542,mage,fire,136,73,63
Banausisch,blackmoore,1541,mage,fire,64,34,30
Kjh,twisting-nether,1540,mage,fire,26,17,9
Kyrn,zuljin,1540,mage,fire,170,90,80
Эарвенн,galakrond,1537,mage,fire,48,29,19
Ënjaz,sylvanas,1537,mage,fire,61,31,30
Нетлель,soulflayer,1536,mage,fire,113,63,50
Razrkh,ragnaros,1536,mage,fire,123,68,55
Noblockgødx,dun-modr,1536,mage,fire,82,39,43
Avb,twisting-nether,1535,mage,fire,24,16,8
Héffér,outland,1535,mage,fire,89,49,40
Djdankzter,outland,1534,mage,fire,30,16,14
Shortchange,stormscale,1534,mage,fire,72,35,37
Consulalgeri,archimonde,1534,mage,fire,54,26,28
Твейдей,blackscar,1533,mage,fire,30,16,14
Séptímus,kazzak,1532,mage,fire,127,72,55
Bloodycast,archimonde,1531,mage,fire,153,79,74
Steveishigh,tarren-mill,1531,mage,fire,68,35,33
Hbarftw,ravencrest,1528,mage,fire,30,20,10
Sîrã,tarren-mill,1528,mage,fire,24,16,8
Stîckî,malganis,1528,mage,fire,29,19,10
Экзорсус,goldrinn,1528,mage,fire,246,125,121
Dázz,twisting-nether,1527,mage,fire,24,16,8
Дэлос,gordunni,1526,mage,fire,41,20,21
Æones,kult-der-verdammten,1525,mage,fire,113,57,56
Bònk,sylvanas,1524,mage,fire,78,42,36
Jonku,tarren-mill,1523,mage,fire,66,42,24
Flypz,stormscale,1523,mage,fire,120,68,52
Caesarclown,silvermoon,1523,mage,fire,501,266,235
Petar,tarren-mill,1523,mage,fire,145,72,73
Аквамелис,gordunni,1522,mage,fire,84,36,48
Aletheía,stormscale,1521,mage,fire,24,16,8
Ahkkar,ravencrest,1520,mage,fire,36,17,19
Sedmaka,neptulon,1519,mage,fire,122,65,57
Utarii,deathwing,1519,mage,fire,130,66,64
Hexmath,tarren-mill,1518,mage,fire,53,30,23
Imtrynasheep,kazzak,1517,mage,fire,72,41,31
Mons,the-venture-co,1517,mage,fire,318,163,155
Xaynny,alakir,1515,mage,fire,125,62,63
Baxeraa,draenor,1512,mage,fire,97,56,41
Xqtmage,blackhand,1511,mage,fire,24,16,8
Tromie,archimonde,1511,mage,fire,156,84,72
Pradapimp,ravencrest,1511,mage,fire,92,48,44
Спэйсбарелла,soulflayer,1510,mage,fire,202,101,101
Pyrobomb,sylvanas,1509,mage,fire,96,45,51
Нерария,howling-fjord,1507,mage,fire,51,30,21
Frøzzen,blackrock,1506,mage,fire,56,31,25
Aisha,neptulon,1506,mage,fire,33,18,15
Insanewizard,kazzak,1505,mage,fire,74,38,36
Mieria,argent-dawn,1504,mage,fire,54,30,24
Sakuranosuke,twisting-nether,1503,mage,fire,48,23,25
Yåsmine,outland,1502,mage,fire,42,18,24
Aulny,kaelthas,1501,mage,fire,153,78,75
Tomia,burning-legion,1499,mage,fire,164,82,82
Mensonger,archimonde,1499,mage,fire,121,59,62
Buzzcraft,draenor,1496,mage,fire,128,74,54
Watchmepanda,ravencrest,1496,mage,fire,45,20,25
Neférú,thrall,1494,mage,fire,52,27,25
Gnomag,argent-dawn,1494,mage,fire,288,147,141
Blinked,eredar,1493,mage,fire,66,40,26
Morphis,talnivarr,1493,mage,fire,56,30,26
Zensheep,silvermoon,1493,mage,fire,54,28,26
Averus,outland,1491,mage,fire,26,17,9
Räikü,ravencrest,1490,mage,fire,66,42,24
Doparismenos,twisting-nether,1490,mage,fire,66,38,28
Scoopssama,ravencrest,1490,mage,fire,108,56,52
Coqo,silvermoon,1490,mage,fire,78,35,43
Mouhlaghofrr,ysondre,1490,mage,fire,65,25,40
Revanov,outland,1486,mage,fire,48,29,19
Aikamie,draenor,1486,mage,fire,270,139,131
Halfanapple,the-maelstrom,1485,mage,fire,54,25,29
Manvo,bloodscalp,1484,mage,fire,270,143,127
Дрраго,greymane,1484,mage,fire,236,121,115
Fingolfin,amanthul,1483,mage,fire,553,279,274
Pandathis,frostwolf,1482,mage,fire,36,24,12
Paradigma,sylvanas,1481,mage,fire,49,27,22
Ízumi,stormscale,1479,mage,fire,54,28,26
Calientay,ragnaros,1479,mage,fire,72,34,38
Kold,stormscale,1479,mage,fire,42,18,24
Интровертка,blackscar,1477,mage,fire,52,27,25
Бингчилинг,howling-fjord,1476,mage,fire,54,25,29
Ohateyz,burning-legion,1475,mage,fire,48,24,24
Ghalanz,ravencrest,1474,mage,fire,141,70,71
Мозифорест,gordunni,1474,mage,fire,78,37,41
Wambamm,ravencrest,1474,mage,fire,93,41,52
Skaleech,draenor,1474,mage,fire,42,18,24
Mikefires,blackrock,1473,mage,fire,34,21,13
Пирабластер,gordunni,1472,mage,fire,45,27,18
Ðamage,sanguino,1472,mage,fire,27,16,11
Rockyballboa,silvermoon,1471,mage,fire,68,39,29
Pyrobro,the-venture-co,1471,mage,fire,120,66,54
Camiina,shattered-hand,1468,mage,fire,167,86,81
Alystan,burning-blade,1467,mage,fire,108,50,58
Moleester,twisting-nether,1467,mage,fire,54,24,30
Drcs,kazzak,1466,mage,fire,48,33,15
Creak,blackhand,1465,mage,fire,35,21,14
Karima,drekthar,1465,mage,fire,40,22,18
Robowhoore,silvermoon,1465,mage,fire,92,49,43
Bclaudiu,terokkar,1464,mage,fire,144,77,67
Delieth,nemesis,1463,mage,fire,33,18,15
Волшпробуда,gordunni,1462,mage,fire,88,52,36
Ãzi,ravencrest,1462,mage,fire,36,19,17
Auzt,kazzak,1461,mage,fire,63,32,31
Qusx,malganis,1460,mage,fire,29,16,13
Goodopeners,outland,1460,mage,fire,71,37,34
Rilac,nordrassil,1460,mage,fire,98,50,48
Alorin,dun-modr,1460,mage,fire,86,40,46
Weedup,zuljin,1459,mage,fire,72,36,36
Versachi,neptulon,1458,mage,fire,54,30,24
Alèxjones,stormscale,1458,mage,fire,42,18,24
Zøe,aggra-português,1457,mage,fire,23,16,7
Obosmage,blackmoore,1457,mage,fire,42,25,17
Nohbrain,blackmoore,1457,mage,fire,142,75,67
Shockólot,outland,1457,mage,fire,41,21,20
Anthrex,drakthul,1456,mage,fire,66,27,39
Sukalamink,alonsus,1455,mage,fire,105,58,47
Hansdrol,outland,1455,mage,fire,60,33,27
Fortian,boulderfist,1455,mage,fire,36,19,17
Plætinum,ravencrest,1455,mage,fire,134,68,66
Lokilus,dalaran,1454,mage,fire,99,55,44
Antaos,drakthul,1453,mage,fire,43,20,23
Sadrã,kazzak,1452,mage,fire,123,61,62
Røvso,ragnaros,1452,mage,fire,60,27,33
Ziao,outland,1450,mage,fire,41,19,22
Musfis,burning-legion,1449,mage,fire,89,43,46
Ayoubz,outland,1449,mage,fire,43,20,23
Aylamo,outland,1448,mage,fire,30,20,10
Estelliên,burning-legion,1448,mage,fire,54,25,29
Elcølgaø,sanguino,1446,mage,fire,131,63,68
Glïder,archimonde,1446,mage,fire,53,24,29
Wizandor,tarren-mill,1445,mage,fire,65,37,28
Bobbasor,defias-brotherhood,1445,mage,fire,121,63,58
ßerkoßaggins,ravencrest,1445,mage,fire,128,64,64
Xue,azshara,1442,mage,fire,23,18,5
Magicdingo,lightnings-blade,1442,mage,fire,59,33,26
Tûttifrutti,ravencrest,1442,mage,fire,84,41,43
Marøjuniõr,draenor,1439,mage,fire,24,15,9
Secretagent,aegwynn,1439,mage,fire,66,37,29
Wizkidcutt,tarren-mill,1439,mage,fire,61,34,27
Akhali,chamber-of-aspects,1438,mage,fire,140,77,63
Чобон,soulflayer,1437,mage,fire,48,23,25
Lmåo,ravencrest,1435,mage,fire,25,15,10
Marybaguette,archimonde,1434,mage,fire,24,15,9
Bloodymage,zenedar,1432,mage,fire,28,16,12
Barbeuqx,garona,1432,mage,fire,47,24,23
Kappotjeplif,ravencrest,1431,mage,fire,120,64,56
Mäalaka,archimonde,1430,mage,fire,78,41,37
Fenrirson,drakthul,1429,mage,fire,336,177,159
Nøstradanus,archimonde,1428,mage,fire,126,77,49
Iceorb,azshara,1428,mage,fire,89,46,43
Quie,stormscale,1427,mage,fire,36,21,15
Cinoox,blackrock,1427,mage,fire,243,130,113
Альвиам,borean-tundra,1426,mage,fire,39,23,16
Otpmage,tarren-mill,1425,mage,fire,24,15,9
Mikaelà,blackmoore,1423,mage,fire,66,40,26
Sunlolly,terokkar,1423,mage,fire,54,31,23
Shizzy,onyxia,1423,mage,fire,63,33,30
Sheepwithmeh,blackrock,1423,mage,fire,30,15,15
Ryzea,ravencrest,1422,mage,fire,125,67,58
Zeklo,frostmane,1422,mage,fire,62,33,29
Diper,burning-legion,1422,mage,fire,136,69,67
Guilty,naxxramas,1422,mage,fire,30,15,15
Mínêrvâ,blackrock,1420,mage,fire,41,22,19
Zéngã,kazzak,1420,mage,fire,86,44,42
Vizarden,stormscale,1418,mage,fire,30,15,15
Ncs,hellfire,1418,mage,fire,36,15,21
Töframaður,draenor,1417,mage,fire,120,66,54
Roohna,blackmoore,1417,mage,fire,139,76,63
Pepsimaxlord,silvermoon,1417,mage,fire,30,15,15
Semiron,twisting-nether,1417,mage,fire,55,26,29
Исендэя,gordunni,1415,mage,fire,63,27,36
Mostevildude,blackhand,1414,mage,fire,24,15,9
Gpye,archimonde,1414,mage,fire,54,26,28
Charizard,emerald-dream,1413,mage,fire,21,16,5
Michellee,ravencrest,1413,mage,fire,30,16,14
Atixx,aegwynn,1412,mage,fire,72,34,38
Noviina,argent-dawn,1411,mage,fire,90,48,42
Zazatorica,tarren-mill,1411,mage,fire,216,112,104
Primodious,kazzak,1410,mage,fire,44,29,15
Xÿv,azshara,1409,mage,fire,24,15,9
Rictue,silvermoon,1409,mage,fire,78,44,34
Meskay,ravencrest,1409,mage,fire,153,75,78
Gødstopmeplz,aegwynn,1409,mage,fire,35,17,18
Szlay,blackmoore,1409,mage,fire,54,24,30
Гатмир,gordunni,1406,mage,fire,133,73,60
Extracting,stormscale,1406,mage,fire,340,174,166
Yenkonidas,blackmoore,1405,mage,fire,48,26,22
Kippercarry,outland,1403,mage,fire,24,16,8
Elesios,blackmoore,1402,mage,fire,111,51,60
Exitelol,blackrock,1401,mage,fire,34,22,12
Kalokoh,tarren-mill,1401,mage,fire,54,27,27
Mejtschazor,twisting-nether,1400,mage,fire,29,16,13
Дырявка,galakrond,1399,mage,fire,94,50,44
Layzzy,kazzak,1399,mage,fire,30,15,15
Goldensands,stormscale,1398,mage,fire,26,16,10
Колинас,soulflayer,1398,mage,fire,59,25,34
Naissa,arathor,1398,mage,fire,36,15,21
Slimugur,sylvanas,1397,mage,fire,76,45,31
Blinklolz,ysondre,1397,mage,fire,34,18,16
Luxxurious,xavius,1396,mage,fire,93,51,42
Critr,sylvanas,1396,mage,fire,289,154,135
Krykz,sanguino,1394,mage,fire,75,36,39
Decemba,kirin-tor,1393,mage,fire,30,16,14
Рифтиг,howling-fjord,1392,mage,fire,136,67,69
Calegos,twisting-nether,1390,mage,fire,54,29,25
Ледянойкекс,gordunni,1390,mage,fire,52,26,26
Yatsune,defias-brotherhood,1388,mage,fire,54,35,19
Koreanbbq,outland,1388,mage,fire,30,15,15
Mythiox,antonidas,1387,mage,fire,53,31,22
Muzbi,turalyon,1387,mage,fire,103,53,50
Gêrky,drakthul,1387,mage,fire,30,15,15
Babidi,nemesis,1386,mage,fire,140,66,74
Seeva,kazzak,1385,mage,fire,71,28,43
Tragíc,blackmoore,1383,mage,fire,29,15,14
Baconlife,tarren-mill,1382,mage,fire,47,37,10
Slite,nazjatar,1382,mage,fire,42,27,15
Jääpuikko,grim-batol,1381,mage,fire,34,19,15
Pawah,exodar,1380,mage,fire,48,28,20
Animaze,argent-dawn,1380,mage,fire,144,79,65
Icepiece,tarren-mill,1380,mage,fire,51,23,28
Malshash,outland,1379,mage,fire,60,31,29
Arckaen,elune,1378,mage,fire,54,32,22
Shreedmage,blackmoore,1378,mage,fire,133,65,68
Xdu,silvermoon,1378,mage,fire,68,23,45
Bceps,stormscale,1377,mage,fire,140,67,73
Kinetiq,kazzak,1377,mage,fire,36,17,19
Fullpolly,twisting-nether,1376,mage,fire,36,17,19
Rèsí,dun-morogh,1375,mage,fire,97,58,39
Ratedr,silvermoon,1373,mage,fire,47,26,21
Freeyourmind,kazzak,1371,mage,fire,74,35,39
Óoj,outland,1370,mage,fire,57,32,25
Aeghis,darkspear,1370,mage,fire,36,20,16
Frostytutes,ragnaros,1369,mage,fire,132,69,63
Бабайбайкала,gordunni,1369,mage,fire,239,120,119
Zorw,aggra-português,1368,mage,fire,48,23,25
Camaeel,aegwynn,1367,mage,fire,47,21,26
Spellsteal,antonidas,1366,mage,fire,126,54,72
Stylaaz,twisting-nether,1365,mage,fire,89,47,42
Uppara,stormrage,1365,mage,fire,48,24,24
Wëylin,chogall,1364,mage,fire,51,28,23
Kundry,tarren-mill,1363,mage,fire,42,19,23
Zigøuillette,hyjal,1363,mage,fire,48,20,28
Rapidfrost,drakthul,1362,mage,fire,72,49,23
Sylvîe,tarren-mill,1362,mage,fire,107,53,54
Jorik,burning-legion,1361,mage,fire,33,19,14
Drwrey,tarren-mill,1361,mage,fire,53,29,24
Bustymage,tarren-mill,1361,mage,fire,38,17,21
Tigerblod,tarren-mill,1360,mage,fire,28,16,12
Lompenlouder,ragnaros,1360,mage,fire,29,15,14
Justjunzy,archimonde,1360,mage,fire,40,20,20
Immortanjoe,thrall,1359,mage,fire,105,55,50
Spispi,burning-legion,1359,mage,fire,44,19,25
Pewwpewwpeww,doomhammer,1354,mage,fire,161,81,80
Ønlyfünds,archimonde,1354,mage,fire,81,37,44
Dubstep,blackrock,1353,mage,fire,84,47,37
Heimer,ravencrest,1352,mage,fire,66,35,31
Magmarro,burning-legion,1350,mage,fire,155,78,77
Usèless,blackmoore,1350,mage,fire,48,20,28
Loøgaã,ysondre,1347,mage,fire,66,33,33
Durdi,silvermoon,1346,mage,fire,114,63,51
Capz,outland,1346,mage,fire,48,22,26
Айсфурия,gordunni,1344,mage,fire,49,24,25
Ckrax,sanguino,1343,mage,fire,29,15,14
Барсукже,howling-fjord,1342,mage,fire,18,14,4
Snogagane,ravencrest,1341,mage,fire,18,14,4
Росвенд,gordunni,1341,mage,fire,24,14,10
Magegôd,outland,1340,mage,fire,24,14,10
Quiwi,dun-modr,1339,mage,fire,69,43,26
Hérä,archimonde,1337,mage,fire,24,14,10
Teaeeth,silvermoon,1337,mage,fire,42,24,18
Jennao,stormscale,1336,mage,fire,24,14,10
Lepeps,silvermoon,1336,mage,fire,61,28,33
Pyro,eldrethalas,1336,mage,fire,63,28,35
Gandelfmaly,burning-legion,1335,mage,fire,24,14,10
Firever,sanguino,1335,mage,fire,72,32,40
Spacehoe,stormscale,1335,mage,fire,36,14,22
Vali,drakthul,1335,mage,fire,42,16,26
Belgravia,silvermoon,1334,mage,fire,24,14,10
Yoken,tarren-mill,1334,mage,fire,24,14,10
Djpørtnite,blackrock,1334,mage,fire,48,19,29
Olzaa,outland,1333,mage,fire,24,14,10
Zumbacafew,twisting-nether,1333,mage,fire,24,14,10
Pyroden,stormscale,1332,mage,fire,60,36,24
Vyuca,argent-dawn,1332,mage,fire,32,16,16
Specta,tarren-mill,1331,mage,fire,30,14,16
Stønéy,outland,1330,mage,fire,36,20,16
Wumz,blackrock,1330,mage,fire,63,29,34
Фирдаркнесс,howling-fjord,1330,mage,fire,41,16,25
Ice,sargeras,1328,mage,fire,36,17,19
Zjap,argent-dawn,1327,mage,fire,48,25,23
Plessx,sylvanas,1326,mage,fire,51,35,16
Pwntt,terenas,1325,mage,fire,54,26,28
Xianji,ragnaros,1325,mage,fire,30,14,16
Màzikeen,stormscale,1324,mage,fire,30,14,16
Magicalmig,draenor,1323,mage,fire,126,75,51
Criticaldmg,malganis,1322,mage,fire,60,30,30
Feuererdnuss,blackhand,1321,mage,fire,86,46,40
Chïll,ragnaros,1320,mage,fire,33,16,17
Onlymage,ravencrest,1319,mage,fire,54,30,24
Anshara,stormscale,1318,mage,fire,90,55,35
Mirobol,hyjal,1318,mage,fire,60,29,31
Fireghost,antonidas,1317,mage,fire,34,15,19
Martiqabelle,dun-morogh,1316,mage,fire,45,24,21
Мерджреквест,howling-fjord,1315,mage,fire,78,40,38
Shinzel,hyjal,1314,mage,fire,83,44,39
Sonofdragon,frostwolf,1314,mage,fire,36,19,17
Tombkiller,kult-der-verdammten,1313,mage,fire,156,77,79
Jockin,stormrage,1312,mage,fire,30,15,15
Drëâms,archimonde,1310,mage,fire,30,15,15
Drunkpunk,kazzak,1309,mage,fire,115,69,46
Xkod,draenor,1309,mage,fire,54,27,27
Shiftea,argent-dawn,1307,mage,fire,30,16,14
Tiltedpapi,ravencrest,1307,mage,fire,86,37,49
Wormhole,kazzak,1305,mage,fire,40,15,25
Illurya,aegwynn,1302,mage,fire,30,15,15
Júñ,silvermoon,1301,mage,fire,29,16,13
Anthyria,blackmoore,1299,mage,fire,24,16,8
Быкуня,gordunni,1299,mage,fire,102,54,48
Cutiepanda,defias-brotherhood,1298,mage,fire,72,28,44
Nuvx,ravencrest,1296,mage,fire,90,51,39
Kamatschu,blackrock,1293,mage,fire,35,15,20
Dobbite,archimonde,1292,mage,fire,72,46,26
Milgha,nemesis,1292,mage,fire,48,24,24
Necro,zuljin,1292,mage,fire,62,29,33
Bakeren,frostmane,1290,mage,fire,30,14,16
Troldejan,stormscale,1289,mage,fire,24,14,10
Gregoss,elune,1289,mage,fire,54,28,26
Аваон,deathguard,1289,mage,fire,136,67,69
Darkice,sanguino,1289,mage,fire,177,86,91
Momomagic,silvermoon,1289,mage,fire,70,33,37
Hahahehe,aegwynn,1288,mage,fire,45,24,21
Kleisli,draenor,1288,mage,fire,39,15,24
Шеллестун,soulflayer,1287,mage,fire,30,20,10
Illius,kelthuzad,1287,mage,fire,53,26,27
Gerdâ,chants-éternels,1285,mage,fire,113,59,54
Cruscru,stormscale,1284,mage,fire,129,59,70
Skarxaa,sanguino,1280,mage,fire,108,49,59
Fiveboyjr,tarren-mill,1279,mage,fire,90,46,44
Slíps,silvermoon,1279,mage,fire,65,29,36
Blackpantha,blackmoore,1278,mage,fire,56,31,25
Hidrax,outland,1276,mage,fire,40,18,22
Iulie,kazzak,1275,mage,fire,43,20,23
Unresplandor,sanguino,1274,mage,fire,75,33,42
Draquengar,tyrande,1273,mage,fire,28,15,13
Sqwiz,outland,1273,mage,fire,63,30,33
Insømnium,stormscale,1270,mage,fire,31,16,15
Ziscine,tarren-mill,1270,mage,fire,63,28,35
Ihatemages,stormreaver,1270,mage,fire,66,27,39
Romethito,dun-modr,1269,mage,fire,48,31,17
Mauvé,blades-edge,1266,mage,fire,65,33,32
Prskalica,kazzak,1266,mage,fire,44,18,26
Greey,blackhand,1265,mage,fire,44,22,22
Cyrîll,malygos,1263,mage,fire,133,75,58
Zyreanx,blackrock,1263,mage,fire,25,14,11
Zionara,stormscale,1263,mage,fire,214,108,106
Maggresive,sylvanas,1262,mage,fire,96,45,51
Svalbard,ragnaros,1261,mage,fire,36,14,22
Rhodghar,ravencrest,1259,mage,fire,60,24,36
Mohovik,wildhammer,1258,mage,fire,24,14,10
Varenca,blackrock,1256,mage,fire,75,35,40
Nïo,ravencrest,1256,mage,fire,122,54,68
Fleqs,antonidas,1256,mage,fire,36,14,22
Ethélinda,kirin-tor,1256,mage,fire,54,19,35
Dmme,dun-morogh,1255,mage,fire,42,18,24
Jhawkwizard,draenor,1254,mage,fire,43,28,15
Nightplays,sylvanas,1253,mage,fire,30,15,15
Eddiee,outland,1252,mage,fire,156,73,83
Lerdasza,exodar,1252,mage,fire,51,17,34
Megancox,blackmoore,1249,mage,fire,62,35,27
Kuríbo,gorgonnash,1249,mage,fire,63,34,29
Ezìl,nemesis,1249,mage,fire,42,17,25
Litshatter,ravencrest,1247,mage,fire,18,13,5
Usererror,ravencrest,1247,mage,fire,18,13,5
Фрозитв,blackscar,1247,mage,fire,18,13,5
Lyrath,tarren-mill,1247,mage,fire,18,13,5
Wizmec,silvermoon,1247,mage,fire,207,98,109
Knulljonný,kazzak,1247,mage,fire,30,13,17
Jörs,stormreaver,1246,mage,fire,18,13,5
Monkeydmafia,blackrock,1246,mage,fire,18,13,5
Babymagici,kazzak,1246,mage,fire,24,15,9
Shirrunn,the-maelstrom,1246,mage,fire,24,13,11
Ioriyagami,dragonmaw,1245,mage,fire,23,14,9
Èverix,ravencrest,1245,mage,fire,24,13,11
Oneshotazor,silvermoon,1244,mage,fire,18,13,5
Johnnydeepp,archimonde,1244,mage,fire,18,13,5
Xläderz,ravencrest,1244,mage,fire,24,13,11
Letstryfrost,ragnaros,1243,mage,fire,54,29,25
Oz,frostmane,1242,mage,fire,21,14,7
Dsmoke,ravencrest,1242,mage,fire,24,13,11
Jezí,ghostlands,1241,mage,fire,19,15,4
Flødeost,outland,1241,mage,fire,24,13,11
Самза,howling-fjord,1240,mage,fire,90,51,39
Zivac,kazzak,1240,mage,fire,24,13,11
Diffa,tarren-mill,1240,mage,fire,24,13,11
Hógwarts,aegwynn,1240,mage,fire,24,13,11
Astaden,die-aldor,1239,mage,fire,30,13,17
Zestrax,kazzak,1238,mage,fire,60,34,26
Magicshow,arathor,1238,mage,fire,24,13,11
Vxvfrowstxvx,jaedenar,1237,mage,fire,24,13,11
Dwang,nemesis,1236,mage,fire,24,13,11
Grandbasile,hyjal,1235,mage,fire,42,13,29
Zadnik,tarren-mill,1234,mage,fire,75,37,38
Занерзулаа,soulflayer,1234,mage,fire,35,14,21
Вселениум,razuvious,1232,mage,fire,63,32,31
Дмблдр,soulflayer,1232,mage,fire,45,22,23
Estwald,arathor,1232,mage,fire,47,22,25
Themagîcian,silvermoon,1232,mage,fire,33,14,19
Jointsmøker,outland,1231,mage,fire,40,21,19
Isiah,kaelthas,1231,mage,fire,178,88,90
Вельдрик,soulflayer,1231,mage,fire,82,39,43
Grep,stormscale,1231,mage,fire,90,38,52
Khalkazzar,darkspear,1230,mage,fire,42,17,25
Susantek,antonidas,1228,mage,fire,30,13,17
Warwizz,sanguino,1226,mage,fire,24,13,11
Rutemarlene,ravencrest,1225,mage,fire,46,21,25
Zuckerzimt,ravencrest,1224,mage,fire,30,13,17
Orphx,draenor,1224,mage,fire,41,15,26
Silatara,twisting-nether,1223,mage,fire,24,13,11
Mayoeba,twisting-nether,1220,mage,fire,63,35,28
Ràyden,khaz-modan,1219,mage,fire,36,18,18
Ямм,blackscar,1218,mage,fire,48,18,30
Magicuze,argent-dawn,1217,mage,fire,90,37,53
Arandartis,kazzak,1216,mage,fire,24,13,11
Slashkiiss,archimonde,1216,mage,fire,140,73,67
Эпсиха,lich-king,1215,mage,fire,30,15,15
Roey,defias-brotherhood,1214,mage,fire,60,30,30
Айсбоунт,eversong,1214,mage,fire,72,30,42
Linyah,arathor,1211,mage,fire,30,15,15
Shadowmag,burning-legion,1209,mage,fire,207,104,103
Джеззабэль,ashenvale,1204,mage,fire,24,15,9
Zaci,argent-dawn,1201,mage,fire,30,14,16
Wankel,blackmoore,1201,mage,fire,89,38,51
Эстерленс,gordunni,1199,mage,fire,199,108,91
Neoreactor,ravencrest,1198,mage,fire,24,13,11
Wîtchcurse,dentarg,1197,mage,fire,36,15,21
Валбериса,deepholm,1193,mage,fire,22,15,7
Sephron,malganis,1192,mage,fire,47,16,31
Jaídy,aegwynn,1188,mage,fire,126,63,63
Nezousta,sinstralis,1187,mage,fire,42,21,21
Haelia,ysondre,1186,mage,fire,44,28,16
Hargun,the-maelstrom,1184,mage,fire,48,17,31
Init,argent-dawn,1183,mage,fire,76,29,47
Bonto,tarren-mill,1182,mage,fire,52,23,29
Blasic,stormscale,1182,mage,fire,41,18,23
Фрайзо,gordunni,1181,mage,fire,108,49,59
Wapity,archimonde,1178,mage,fire,40,14,26
Athenå,dalaran,1176,mage,fire,48,21,27
Линклер,fordragon,1175,mage,fire,54,23,31
Blitzo,madmortem,1174,mage,fire,53,29,24
Ascik,dalaran,1174,mage,fire,35,13,22
Clappycheeks,antonidas,1173,mage,fire,84,36,48
Fritmckhaine,archimonde,1171,mage,fire,102,56,46
Асидочка,soulflayer,1171,mage,fire,123,61,62
Sam,outland,1170,mage,fire,23,13,10
Kilféfroid,ysondre,1168,mage,fire,64,34,30
Darkoftw,ysondre,1166,mage,fire,25,13,12
Dóncójones,blackrock,1166,mage,fire,113,51,62
Kusikikkeli,stormreaver,1164,mage,fire,30,14,16
Xânârchy,minahonda,1164,mage,fire,42,17,25
Tratuf,hyjal,1163,mage,fire,27,13,14
Азгас,soulflayer,1160,mage,fire,72,38,34
Critzeklein,antonidas,1158,mage,fire,66,25,41
Larah,les-clairvoyants,1154,mage,fire,42,19,23
Posthúme,hyjal,1154,mage,fire,36,14,22
Ærrøx,hyjal,1153,mage,fire,36,15,21
Máurus,antonidas,1153,mage,fire,46,15,31
Sheepthrillz,blackmoore,1150,mage,fire,18,12,6
Bzzr,tarren-mill,1150,mage,fire,18,12,6
Barbeuqxo,garona,1150,mage,fire,18,12,6
Majinbo,doomhammer,1150,mage,fire,30,16,14
Kaki,stormscale,1150,mage,fire,36,19,17
Sidek,sylvanas,1150,mage,fire,24,12,12
Palpfiction,silvermoon,1150,mage,fire,24,12,12
Smxkýÿ,eredar,1149,mage,fire,18,12,6
Azulêera,archimonde,1149,mage,fire,24,12,12
Córgi,ravencrest,1149,mage,fire,24,12,12
Koreanbbq,kazzak,1148,mage,fire,18,12,6
Magicarno,kazzak,1147,mage,fire,60,26,34
Wizarð,archimonde,1147,mage,fire,35,14,21
Tehotyttö,dragonblight,1146,mage,fire,87,33,54
Hoodmago,blackrock,1145,mage,fire,18,12,6
Tarporion,culte-de-la-rive-noire,1145,mage,fire,24,12,12
Demensida,ravencrest,1145,mage,fire,28,13,15
Bamz,malganis,1144,mage,fire,24,12,12
Taylorswîft,ragnaros,1143,mage,fire,18,12,6
Avakadaver,draenor,1143,mage,fire,24,12,12
Drfröst,kazzak,1143,mage,fire,24,12,12
Zaruna,arathor,1143,mage,fire,24,12,12
Frostwaffles,draenor,1141,mage,fire,24,12,12
Ronnyraggare,silvermoon,1141,mage,fire,24,12,12
Crackheads,hyjal,1141,mage,fire,24,12,12
Xèrec,ysondre,1141,mage,fire,32,14,18
Zhazam,blades-edge,1141,mage,fire,54,23,31
Inaruy,hyjal,1141,mage,fire,30,12,18
Themagicguy,silvermoon,1140,mage,fire,24,12,12
Aûrûm,silvermoon,1140,mage,fire,24,12,12
Skitsó,shadowsong,1139,mage,fire,48,29,19
Oiklo,eitrigg,1139,mage,fire,42,25,17
Jemppai,outland,1139,mage,fire,24,12,12
Castaneda,hellfire,1138,mage,fire,121,69,52
Tessai,sargeras,1138,mage,fire,24,12,12
Мегумин,galakrond,1138,mage,fire,102,50,52
Fäust,drakthul,1136,mage,fire,52,16,36
Wushii,aggra-português,1133,mage,fire,31,13,18
Gàtsby,outland,1132,mage,fire,36,12,24
Vurtnez,kazzak,1129,mage,fire,42,19,23
Metaboi,ragnaros,1128,mage,fire,24,12,12
Gavra,ravencrest,1127,mage,fire,24,12,12
Lanadorei,stormscale,1126,mage,fire,53,26,27
Hiimlynx,sylvanas,1124,mage,fire,29,12,17
Rasputina,blackrock,1121,mage,fire,89,45,44
Kebkhadar,ravencrest,1121,mage,fire,36,14,22
Ðjwåtermeløn,ravencrest,1119,mage,fire,23,12,11
Lybazinga,frostmane,1118,mage,fire,55,25,30
Incenia,ravencrest,1117,mage,fire,35,14,21
Frøze,twisting-nether,1113,mage,fire,111,53,58
Sippebób,laughing-skull,1112,mage,fire,28,13,15
Leontus,outland,1110,mage,fire,30,16,14
Buuszek,outland,1109,mage,fire,53,28,25
Скиллао,gordunni,1109,mage,fire,59,28,31
Illiaria,antonidas,1108,mage,fire,66,30,36
Zedsdeadbaby,argent-dawn,1107,mage,fire,54,27,27
Searchy,blackhand,1107,mage,fire,449,224,225
Xblaz,draenor,1106,mage,fire,26,13,13
Worstlove,blackrock,1099,mage,fire,44,23,21
Мизерун,deathguard,1099,mage,fire,231,111,120
Rmforever,archimonde,1096,mage,fire,88,46,42
Focusnik,silvermoon,1095,mage,fire,23,12,11
Xenodike,blackrock,1094,mage,fire,60,34,26
Piscialetto,nemesis,1094,mage,fire,82,36,46
Cexxar,kazzak,1093,mage,fire,102,45,57
Tóadette,die-aldor,1081,mage,fire,82,38,44
Roberx,sanguino,1079,mage,fire,28,12,16
Gorleg,draenor,1072,mage,fire,47,17,30
Newtwo,ravencrest,1070,mage,fire,25,12,13
Магниффика,blackscar,1070,mage,fire,42,20,22
Blazenaa,drakthul,1069,mage,fire,43,23,20
Zeddic,burning-legion,1067,mage,fire,235,114,121
Kalyipso,blackrock,1067,mage,fire,54,21,33
Bambaga,kazzak,1061,mage,fire,31,19,12
Mirajânê,blackmoore,1059,mage,fire,28,12,16
Bördanqt,twisting-nether,1056,mage,fire,12,11,1
Ilikesheep,blackmoore,1056,mage,fire,18,11,7
Pævl,drakthul,1055,mage,fire,18,11,7
Kaeser,ravencrest,1055,mage,fire,18,11,7
Träshxd,sanguino,1055,mage,fire,24,11,13
Nihilum,dalaran,1055,mage,fire,30,11,19
Джинетикс,deathguard,1054,mage,fire,18,11,7
Ference,tichondrius,1054,mage,fire,31,12,19
Smíte,kazzak,1053,mage,fire,18,11,7
Döom,chamber-of-aspects,1053,mage,fire,30,11,19
Мьёрэ,soulflayer,1052,mage,fire,30,15,15
Coken,trollbane,1052,mage,fire,24,11,13
Zerøsílgødx,antonidas,1051,mage,fire,21,12,9
Kanjani,antonidas,1051,mage,fire,28,12,16
Zisseron,frostmane,1051,mage,fire,66,20,46
Frostfettlol,onyxia,1050,mage,fire,24,11,13
Dibzz,sanguino,1048,mage,fire,18,11,7
Barspin,lightnings-blade,1047,mage,fire,18,11,7
Pablø,blackrock,1043,mage,fire,58,29,29
Ярелия,soulflayer,1043,mage,fire,46,14,32
Laetitiah,archimonde,1042,mage,fire,26,11,15
Kyani,mannoroth,1042,mage,fire,34,12,22
Вираи,soulflayer,1041,mage,fire,30,11,19
Spader,argent-dawn,1040,mage,fire,30,12,18
Rõdokunohi,darksorrow,1039,mage,fire,46,18,28
Dyx,nemesis,1036,mage,fire,89,42,47
Mgtt,defias-brotherhood,1033,mage,fire,80,28,52
Mohrgan,malorne,1031,mage,fire,32,11,21
Zymage,silvermoon,1030,mage,fire,33,12,21
Devilpain,zuluhed,1027,mage,fire,60,26,34
Anghim,tarren-mill,1025,mage,fire,18,11,7
Deadsmells,ragnaros,1019,mage,fire,86,30,56
Freezeballs,blackmoore,1017,mage,fire,37,12,25
Непоняли,gordunni,1008,mage,fire,74,30,44
Севериан,gordunni,1004,mage,fire,51,23,28
Хээйлии,goldrinn,1001,mage,fire,30,15,15
Dualin,sanguino,1001,mage,fire,99,45,54
Furoranight,malfurion,1000,mage,fire,31,11,20
Комонщик,howling-fjord,993,mage,fire,30,11,19
Firen,thrall,992,mage,fire,30,17,13
Icx,tarren-mill,989,mage,fire,120,61,59
Arcáge,azjolnerub,988,mage,fire,29,14,15
Зубарол,gordunni,984,mage,fire,49,24,25
Tygaone,tirion,982,mage,fire,28,11,17
Lovesosa,malorne,977,mage,fire,45,21,24
Aurelius,kargath,971,mage,fire,19,11,8
Plazem,argent-dawn,971,mage,fire,54,20,34
Vêganêr,blackmoore,965,mage,fire,65,37,28
Freezandrun,tarren-mill,962,mage,fire,71,35,36
Reeceburton,stormscale,960,mage,fire,12,10,2
Sukmikok,twisting-nether,960,mage,fire,12,10,2
Benzol,eredar,960,mage,fire,18,10,8
Misay,outland,960,mage,fire,24,10,14
Blackmagiç,ravencrest,959,mage,fire,12,10,2
Stabmagey,twisting-nether,959,mage,fire,12,10,2
Jarim,alleria,959,mage,fire,15,11,4
Chareyla,argent-dawn,959,mage,fire,18,10,8
Soulraider,tarren-mill,959,mage,fire,18,10,8
Astrryy,burning-legion,959,mage,fire,18,10,8
Tfmchamp,ravencrest,959,mage,fire,18,10,8
Cÿa,tarren-mill,959,mage,fire,18,10,8
Coldikay,archimonde,959,mage,fire,18,10,8
Kirbi,blackmoore,959,mage,fire,18,10,8
Drè,daggerspine,959,mage,fire,18,10,8
Questgrills,kazzak,959,mage,fire,18,10,8
Lazuly,blackhand,959,mage,fire,117,51,66
Choccookies,lordaeron,959,mage,fire,33,11,22
Ахиригиз,gordunni,958,mage,fire,18,10,8
Sorrow,outland,958,mage,fire,24,10,14
Alyraza,chamber-of-aspects,957,mage,fire,24,10,14
Нехай,ashenvale,957,mage,fire,24,10,14
Даатхедра,booty-bay,957,mage,fire,24,10,14
Hotafazz,ravencrest,956,mage,fire,18,10,8
Люртакз,gordunni,956,mage,fire,24,10,14
Anagramix,silvermoon,955,mage,fire,21,10,11
Mìsaki,hellscream,955,mage,fire,24,10,14
Trenpapi,twisting-nether,955,mage,fire,24,10,14
Internals,tarren-mill,955,mage,fire,24,10,14
Shìnra,ravencrest,955,mage,fire,24,10,14
Jambonpistol,archimonde,954,mage,fire,18,10,8
Benihimé,doomhammer,952,mage,fire,24,10,14
Çana,thrall,952,mage,fire,30,10,20
Shealá,blackhand,951,mage,fire,24,10,14
Firewitch,blackhand,950,mage,fire,24,10,14
Cräzÿfrøst,archimonde,949,mage,fire,24,10,14
Boumayé,archimonde,949,mage,fire,24,10,14
Hopewell,aszune,949,mage,fire,30,10,20
Glacìal,ravencrest,943,mage,fire,30,10,20
Ларавэл,blackscar,941,mage,fire,27,13,14
Mässîvècøx,ragnaros,940,mage,fire,23,10,13
Iwannakissu,gorgonnash,938,mage,fire,23,12,11
Кельтаз,soulflayer,932,mage,fire,30,15,15
Jobarttrach,les-clairvoyants,930,mage,fire,97,41,56
Nécrømage,confrérie-du-thorium,926,mage,fire,17,10,7
Pyro,daggerspine,924,mage,fire,60,32,28
Häddës,archimonde,919,mage,fire,54,31,23
Netherstorm,chogall,917,mage,fire,102,49,53
Warpx,aegwynn,913,mage,fire,364,183,181
Sagregas,silvermoon,908,mage,fire,186,89,97
Flamya,stormscale,905,mage,fire,23,10,13
Tarryxa,kazzak,905,mage,fire,35,10,25
Texhex,ahnqiraj,905,mage,fire,42,11,31
Nakamura,outland,901,mage,fire,26,11,15
Laviathan,die-aldor,896,mage,fire,24,13,11
Santoz,blackrock,893,mage,fire,220,109,111
Däpper,ragnaros,892,mage,fire,20,10,10
Cheeku,outland,892,mage,fire,23,10,13
Nåzmyz,outland,891,mage,fire,23,10,13
Vantimere,twisting-nether,886,mage,fire,31,11,20
Magyxk,blackmoore,881,mage,fire,14,10,4
Smî,aegwynn,875,mage,fire,48,24,24
Abóve,outland,864,mage,fire,12,9,3
Mmrlancer,blackmoore,864,mage,fire,12,9,3
Joqz,tarren-mill,864,mage,fire,12,9,3
Magebraín,ravencrest,864,mage,fire,12,9,3
Dastion,sylvanas,864,mage,fire,12,9,3
Kiey,silvermoon,864,mage,fire,12,9,3
Twizzax,silvermoon,864,mage,fire,12,9,3
Magerocks,ragnaros,864,mage,fire,12,9,3
Garbedge,silvermoon,864,mage,fire,12,9,3
Elysiar,kazzak,864,mage,fire,12,9,3
Símple,sylvanas,864,mage,fire,18,9,9
Drfeeldgoodd,mazrigos,864,mage,fire,18,9,9
Tills,kargath,864,mage,fire,18,9,9
Gadeplan,sylvanas,864,mage,fire,18,9,9
Razx,stormscale,864,mage,fire,24,9,15
Tagrine,kaelthas,863,mage,fire,12,9,3
Underground,naxxramas,863,mage,fire,12,9,3
Инкрионити,gordunni,863,mage,fire,18,9,9
Sheepo,tarren-mill,863,mage,fire,18,9,9
Vixis,dalaran,863,mage,fire,18,9,9
Wizkhafury,ravencrest,863,mage,fire,18,9,9
Katzron,twisting-nether,863,mage,fire,18,9,9
Feath,ravencrest,863,mage,fire,18,9,9
Frostyflakés,stormscale,863,mage,fire,18,9,9
Pelsky,zenedar,863,mage,fire,18,9,9
Idron,dunemaul,863,mage,fire,24,9,15
Spellhaze,outland,863,mage,fire,24,9,15
Cesirys,silvermoon,862,mage,fire,12,9,3
Brãein,uldaman,862,mage,fire,12,9,3
Marðuk,blackmoore,862,mage,fire,18,9,9
Omegadrill,frostmane,862,mage,fire,18,9,9
Ardu,burning-legion,862,mage,fire,18,9,9
Internèthùlk,ravencrest,862,mage,fire,20,9,11
Magechonk,kazzak,862,mage,fire,24,9,15
Hokuspokicus,ravencrest,862,mage,fire,24,9,15
Феновар,goldrinn,862,mage,fire,24,9,15
Abocajarro,dun-modr,861,mage,fire,18,9,9
Sszz,ravencrest,861,mage,fire,24,9,15
Jæel,archimonde,860,mage,fire,108,38,70
Reeroll,arthas,860,mage,fire,30,9,21
Чоуза,gordunni,858,mage,fire,24,9,15
Неуклюжый,soulflayer,858,mage,fire,24,9,15
Drewna,silvermoon,856,mage,fire,16,10,6
Saturator,burning-legion,856,mage,fire,30,9,21
Houdiní,stormscale,855,mage,fire,24,10,14
Bigbazzabean,silvermoon,849,mage,fire,42,17,25
Ofeu,archimonde,845,mage,fire,29,9,20
Letsa,stormscale,839,mage,fire,18,11,7
Nagano,deathwing,827,mage,fire,23,9,14
Veveroiu,defias-brotherhood,822,mage,fire,51,22,29
Ølórin,silvermoon,820,mage,fire,72,24,48
Halbattar,garona,814,mage,fire,99,44,55
Nightnovae,ravencrest,810,mage,fire,19,10,9
Malicä,ravencrest,794,mage,fire,96,40,56
Løxyy,ysondre,793,mage,fire,36,12,24
Haileigh,tarren-mill,778,mage,fire,105,40,65
Sölø,stormscale,768,mage,fire,12,8,4
Stockfísh,ravencrest,768,mage,fire,12,8,4
Авгурей,galakrond,768,mage,fire,12,8,4
Matsuratkø,nemesis,768,mage,fire,12,8,4
Dardíe,ravencrest,768,mage,fire,12,8,4
Mlodysimba,burning-legion,768,mage,fire,12,8,4
Panikdoktor,silvermoon,768,mage,fire,12,8,4
Spellonfire,ravencrest,768,mage,fire,12,8,4
Apollohouse,ravencrest,768,mage,fire,12,8,4
Lestrangé,azjolnerub,768,mage,fire,12,8,4
Макотшельник,gordunni,768,mage,fire,12,8,4
Seshlad,stormscale,768,mage,fire,12,8,4
Wilhélm,twisting-nether,768,mage,fire,12,8,4
Dampgame,twisting-nether,768,mage,fire,18,8,10
Dalaras,archimonde,768,mage,fire,18,8,10
Procahontas,ravencrest,768,mage,fire,18,8,10
Zelimeth,outland,768,mage,fire,18,8,10
Airo,drakthul,768,mage,fire,24,8,16
Mðj,kazzak,768,mage,fire,24,8,16
Fatefully,ravencrest,767,mage,fire,12,8,4
Génociidz,archimonde,767,mage,fire,12,8,4
Чиллмен,ashenvale,767,mage,fire,12,8,4
Sapien,sanguino,767,mage,fire,18,8,10
Testzerodeux,archimonde,767,mage,fire,18,8,10
Эммилиарда,gordunni,767,mage,fire,18,8,10
Codeincassie,blackhand,767,mage,fire,18,8,10
Coldwanderer,kazzak,767,mage,fire,18,8,10
Ephai,tarren-mill,767,mage,fire,18,8,10
Elreas,blackmoore,767,mage,fire,18,8,10
Suma,archimonde,767,mage,fire,18,8,10
Grailandia,uldum,767,mage,fire,18,8,10
Вендайса,soulflayer,767,mage,fire,18,8,10
Dynamica,ravencrest,767,mage,fire,18,8,10
Fïttan,stormscale,767,mage,fire,21,9,12
Ccoco,anetheron,767,mage,fire,24,9,15
Takiix,antonidas,766,mage,fire,12,8,4
Shalima,nethersturm,766,mage,fire,18,8,10
Schøkø,eredar,766,mage,fire,24,8,16
Copiüm,kazzak,765,mage,fire,18,8,10
Quente,aegwynn,765,mage,fire,24,8,16
Solarian,nemesis,764,mage,fire,18,8,10
Exxylia,aegwynn,763,mage,fire,18,8,10
Permafrost,drakthul,763,mage,fire,24,8,16
Iamslow,sylvanas,762,mage,fire,12,8,4
Elterion,sylvanas,760,mage,fire,24,8,16
Mogettemagic,ysondre,760,mage,fire,33,9,24
Arcadua,sanguino,758,mage,fire,12,8,4
Bladzior,burning-legion,757,mage,fire,18,8,10
Damnlate,blackmoore,753,mage,fire,32,11,21
Фиеран,grom,747,mage,fire,26,10,16
Rosady,ragnaros,745,mage,fire,19,10,9
Kalyypso,arygos,735,mage,fire,16,9,7
Mitchmage,ravencrest,732,mage,fire,17,8,9
Нубарь,thermaplugg,731,mage,fire,18,8,10
Gûl,kazzak,726,mage,fire,143,38,105
Mercem,stormscale,719,mage,fire,11,8,3
Bjay,hyjal,719,mage,fire,17,8,9
Monfisback,archimonde,703,mage,fire,11,8,3
Genviedgiclé,arathi,703,mage,fire,17,8,9
Käd,la-croisade-écarlate,703,mage,fire,17,8,9
Corpusqq,eredar,702,mage,fire,17,8,9
Сенсемилия,soulflayer,702,mage,fire,20,8,12
Vallas,drakthul,688,mage,fire,13,8,5
Тудысюдым,eversong,684,mage,fire,19,8,11
Pàntera,blackmoore,683,mage,fire,31,8,23
Magicspark,madmortem,674,mage,fire,87,39,48
Iconic,eredar,672,mage,fire,12,7,5
Barzle,blackmoore,672,mage,fire,12,7,5
Rotøk,burning-legion,672,mage,fire,12,7,5
Melíssa,silvermoon,672,mage,fire,12,7,5
Fckkicks,thrall,672,mage,fire,12,7,5
Sykz,hyjal,672,mage,fire,12,7,5
Учительйода,ashenvale,672,mage,fire,12,7,5
Sylbris,outland,672,mage,fire,12,7,5
Coombuster,kazzak,672,mage,fire,12,7,5
Pyllymake,kazzak,672,mage,fire,12,7,5
Highrollerqt,tarren-mill,672,mage,fire,12,7,5
Gnðmeonfire,sylvanas,672,mage,fire,12,7,5
Sainth,sanguino,672,mage,fire,12,7,5
Pïeck,archimonde,672,mage,fire,12,7,5
Tirenia,bloodfeather,672,mage,fire,12,7,5
Euklid,ravencrest,672,mage,fire,12,7,5
Necizbored,tarren-mill,672,mage,fire,12,7,5
Кодимагх,gordunni,672,mage,fire,12,7,5
Mfnz,stormreaver,672,mage,fire,12,7,5
Pyromaníac,blackrock,672,mage,fire,16,8,8
Wmp,ravencrest,672,mage,fire,18,7,11
Waan,sylvanas,672,mage,fire,18,7,11
Anaxtra,guldan,672,mage,fire,18,7,11
Mangiafuoco,nemesis,672,mage,fire,18,7,11
Анзот,howling-fjord,672,mage,fire,18,7,11
Мелми,howling-fjord,672,mage,fire,24,7,17
Uwutehe,ravencrest,671,mage,fire,12,7,5
Azîlko,frostwolf,671,mage,fire,12,7,5
Mumpii,blackrock,671,mage,fire,12,7,5
Ødegaård,argent-dawn,671,mage,fire,12,7,5
Sokardes,the-maelstrom,671,mage,fire,16,8,8
Cammly,drakthul,671,mage,fire,18,7,11
Hacksopa,twisting-nether,671,mage,fire,18,7,11
Hasslad,tarren-mill,671,mage,fire,18,7,11
Julieliphie,silvermoon,671,mage,fire,18,7,11
Mansnotblock,antonidas,671,mage,fire,18,7,11
Arhan,argent-dawn,670,mage,fire,12,7,5
Ceinxjk,ravencrest,670,mage,fire,12,7,5
Didub,outland,670,mage,fire,12,7,5
Crackcocainx,blackrock,670,mage,fire,18,7,11
Жгумпель,howling-fjord,670,mage,fire,24,7,17
Awart,burning-legion,670,mage,fire,24,7,17
Vanah,the-maelstrom,669,mage,fire,12,7,5
Azadan,pozzo-delleternità,669,mage,fire,12,7,5
Dzomage,kazzak,669,mage,fire,18,7,11
Harmal,nemesis,668,mage,fire,18,7,11
Jipa,tarren-mill,668,mage,fire,24,7,17
Flammiwa,confrérie-du-thorium,668,mage,fire,36,7,29
Kaktuzze,antonidas,664,mage,fire,24,7,17
Elypøde,ysondre,657,mage,fire,12,7,5
Vulcanx,stormscale,638,mage,fire,17,7,10
Eatmybarrage,ragnaros,638,mage,fire,17,7,10
ßåsåñ,archimonde,623,mage,fire,11,7,4
Ассих,soulflayer,622,mage,fire,24,7,17
Goukakyu,ravencrest,618,mage,fire,11,7,4
Blueoid,ravencrest,617,mage,fire,19,8,11
Elcritadoré,ragnaros,617,mage,fire,20,8,12
Mansnotbløck,ravencrest,607,mage,fire,11,7,4
Phenoxi,sylvanas,607,mage,fire,14,7,7
Medium,der-rat-von-dalaran,576,mage,fire,6,6,0
Paiz,tarren-mill,576,mage,fire,6,6,0
Ózí,ravencrest,576,mage,fire,6,6,0
Adinferno,zenedar,576,mage,fire,6,6,0
Apcg,sylvanas,576,mage,fire,6,6,0
Linkxd,stormscale,576,mage,fire,6,6,0
Mm,twisting-nether,576,mage,fire,13,7,6
Frostvirgin,twisting-nether,576,mage,fire,12,6,6
Tainted,eredar,576,mage,fire,12,6,6
Zaralarssòn,ravencrest,576,mage,fire,12,6,6
Skylez,blackrock,576,mage,fire,12,6,6
Aetaliken,eredar,576,mage,fire,12,6,6
Needforsheep,archimonde,576,mage,fire,12,6,6
Naween,hyjal,576,mage,fire,12,6,6
Aelín,argent-dawn,576,mage,fire,12,6,6
Polyvon,ravencrest,576,mage,fire,12,6,6
Merlindo,outland,576,mage,fire,12,6,6
Blästz,hyjal,576,mage,fire,12,6,6
Johannlafer,ravencrest,576,mage,fire,12,6,6
Khronic,darksorrow,576,mage,fire,12,6,6
Saucise,hyjal,576,mage,fire,12,6,6
Suñshiny,ragnaros,576,mage,fire,12,6,6
Alterwhite,archimonde,576,mage,fire,12,6,6
Santriss,defias-brotherhood,576,mage,fire,12,6,6
Canceled,kazzak,576,mage,fire,12,6,6
Tragìc,blackmoore,576,mage,fire,12,6,6
Facerollyo,tarren-mill,576,mage,fire,12,6,6
Naidm,blackmoore,576,mage,fire,12,6,6
Jengele,argent-dawn,576,mage,fire,12,6,6
Macey,ravencrest,576,mage,fire,12,6,6
Мэджу,gordunni,576,mage,fire,12,6,6
Mfu,blackmoore,576,mage,fire,12,6,6
Kogeren,tarren-mill,576,mage,fire,12,6,6
Onebutononly,stormrage,576,mage,fire,12,6,6
Qtpoof,sylvanas,576,mage,fire,12,6,6
Frôstît,aegwynn,576,mage,fire,12,6,6
Azraiël,burning-legion,576,mage,fire,12,6,6
Frostys,les-sentinelles,576,mage,fire,12,6,6
Derchong,kazzak,576,mage,fire,12,6,6
Aurorax,ravencrest,576,mage,fire,12,6,6
Lovësosa,hyjal,576,mage,fire,16,7,9
Qwibbly,kazzak,576,mage,fire,18,6,12
Gunglefutz,the-maelstrom,576,mage,fire,18,6,12
Nötmârtònxø,ragnaros,576,mage,fire,18,6,12
Banjó,twilights-hammer,576,mage,fire,18,6,12
Machydapha,outland,575,mage,fire,12,6,6
Sickles,thrall,575,mage,fire,12,6,6
Burnchildren,burning-steppes,575,mage,fire,12,6,6
Kitchimage,ravencrest,575,mage,fire,12,6,6
Umaguma,elune,575,mage,fire,18,6,12
Arhi,silvermoon,575,mage,fire,18,6,12
Choons,twisting-nether,575,mage,fire,18,6,12
Lifymage,sylvanas,575,mage,fire,18,6,12
Levora,ragnaros,575,mage,fire,18,6,12
Cuishle,kaelthas,575,mage,fire,18,6,12
Lupuus,anubarak,575,mage,fire,24,6,18
Explosìve,arthas,574,mage,fire,12,6,6
Purrpl,twisting-nether,574,mage,fire,12,6,6
Йяу,howling-fjord,574,mage,fire,18,6,12
Shâykó,sylvanas,573,mage,fire,12,6,6
Roythelan,steamwheedle-cartel,573,mage,fire,18,6,12
Mononokeeh,turalyon,572,mage,fire,6,6,0
Поймайбелку,booty-bay,572,mage,fire,12,6,6
Melimar,khaz-modan,572,mage,fire,12,6,6
Труупоед,borean-tundra,571,mage,fire,12,6,6
Evrem,karazhan,566,mage,fire,12,6,6
Nabucor,culte-de-la-rive-noire,559,mage,fire,37,8,29
Mirlan,malganis,543,mage,fire,8,7,1
Nâmiz,blackrock,528,mage,fire,9,6,3
Мэдраша,gordunni,527,mage,fire,23,6,17
Xoløtl,ravencrest,522,mage,fire,17,7,10
Шарансул,soulflayer,521,mage,fire,21,8,13
Dárdie,ravencrest,512,mage,fire,10,6,4
Helloimgone,blackmoore,480,mage,fire,6,5,1
Ицка,fordragon,480,mage,fire,6,5,1
Магуччи,gordunni,480,mage,fire,6,5,1
Dastion,ravencrest,480,mage,fire,6,5,1
Acidboltz,kazzak,480,mage,fire,6,5,1
Oriliana,azjolnerub,480,mage,fire,6,5,1
Kudakto,ravencrest,480,mage,fire,6,5,1
Liga,outland,480,mage,fire,6,5,1
Jél,stormscale,480,mage,fire,6,5,1
Addícted,thrall,480,mage,fire,6,5,1
Arýà,blackmoore,480,mage,fire,6,5,1
Tenetic,thrall,480,mage,fire,6,5,1
Полеморв,soulflayer,480,mage,fire,6,5,1
Yoku,nethersturm,480,mage,fire,6,5,1
Папущенный,soulflayer,480,mage,fire,6,5,1
Xigore,blackrock,480,mage,fire,6,5,1
Polÿmorph,stormscale,480,mage,fire,12,5,7
Mobjar,twisting-nether,480,mage,fire,12,5,7
Kàtsu,tarren-mill,480,mage,fire,12,5,7
Cerewyn,ravencrest,480,mage,fire,12,5,7
Augustusi,argent-dawn,480,mage,fire,12,5,7
Artikotchoin,archimonde,480,mage,fire,12,5,7
Zoba,sylvanas,480,mage,fire,12,5,7
Arcandor,tarren-mill,480,mage,fire,12,5,7
Nékrà,archimonde,480,mage,fire,12,5,7
Kaevelin,argent-dawn,480,mage,fire,12,5,7
Cleancc,blackhand,480,mage,fire,12,5,7
Lorthizas,azjolnerub,480,mage,fire,12,5,7
Palyd,the-maelstrom,480,mage,fire,12,5,7
Srema,thrall,480,mage,fire,12,5,7
Пиньон,borean-tundra,480,mage,fire,12,5,7
Kúmblåstgødx,archimonde,480,mage,fire,12,5,7
Iceterror,ravencrest,480,mage,fire,12,5,7
Bírbeck,silvermoon,480,mage,fire,12,5,7
Teeclis,twisting-nether,480,mage,fire,12,5,7
Quincy,frostwolf,480,mage,fire,12,5,7
Щавзорву,gordunni,480,mage,fire,12,5,7
Namemage,stormscale,480,mage,fire,12,5,7
ßigzok,kazzak,480,mage,fire,12,5,7
Runbabyrun,hyjal,480,mage,fire,12,5,7
Хаскивсказке,gordunni,480,mage,fire,12,5,7
Grìmmjow,tarren-mill,480,mage,fire,12,5,7
Onemanrave,ravencrest,480,mage,fire,12,5,7
Ovrhà,kazzak,480,mage,fire,12,5,7
Sused,outland,480,mage,fire,12,5,7
Lenzalol,nemesis,480,mage,fire,12,5,7
Shifteurprõ,hyjal,480,mage,fire,12,5,7
Jazzi,blackrock,480,mage,fire,15,6,9
Исполлин,howling-fjord,480,mage,fire,18,5,13
Infamage,draenor,480,mage,fire,18,5,13
Ysari,ravencrest,480,mage,fire,18,5,13
Jimcarey,sylvanas,479,mage,fire,12,5,7
Heleng,draenor,479,mage,fire,18,5,13
Beardmorph,auchindoun,479,mage,fire,18,5,13
Incendi,ravencrest,479,mage,fire,18,5,13
Bhalïn,dun-modr,479,mage,fire,36,5,31
Oneal,the-maelstrom,478,mage,fire,12,5,7
Magimikey,tarren-mill,477,mage,fire,12,5,7
Exorifrigo,dun-modr,477,mage,fire,22,5,17
Eldiablo,dun-modr,476,mage,fire,12,5,7
Draenaya,forscherliga,473,mage,fire,21,6,15
Begra,silvermoon,472,mage,fire,12,5,7
Ðonkeykong,outland,463,mage,fire,11,5,6
Thatblink,twisting-nether,448,mage,fire,16,5,11
Oreog,ravencrest,432,mage,fire,21,5,16
Jondahr,emerald-dream,416,mage,fire,16,5,11
Сморгонец,gordunni,412,mage,fire,14,5,9
Waterhagx,tarren-mill,384,mage,fire,6,4,2
Praison,defias-brotherhood,384,mage,fire,6,4,2
Drfunk,shadowsong,384,mage,fire,6,4,2
Yenneferr,magtheridon,384,mage,fire,6,4,2
Xsro,blackrock,384,mage,fire,6,4,2
Ovrpwrdxd,kazzak,384,mage,fire,6,4,2
Botbotamba,hyjal,384,mage,fire,6,4,2
Doryy,silvermoon,384,mage,fire,6,4,2
Zezzim,draenor,384,mage,fire,6,4,2
Kyomachix,ahnqiraj,384,mage,fire,6,4,2
Farmassist,stormscale,384,mage,fire,6,4,2
Saryotheone,silvermoon,384,mage,fire,6,4,2
Bestowalfaun,blackmoore,384,mage,fire,6,4,2
Wopi,sylvanas,384,mage,fire,6,4,2
Bergillos,sanguino,384,mage,fire,6,4,2
Aern,sinstralis,384,mage,fire,6,4,2
Proffset,ravencrest,384,mage,fire,6,4,2
Magmâr,ravencrest,384,mage,fire,6,4,2
Nellý,stormreaver,384,mage,fire,6,4,2
Cyser,kazzak,384,mage,fire,6,4,2
Stíckí,malganis,384,mage,fire,6,4,2
Pavlé,draenor,384,mage,fire,6,4,2
Zirelian,ravencrest,384,mage,fire,6,4,2
Njl,blackmoore,384,mage,fire,6,4,2
Naote,blackhand,384,mage,fire,6,4,2
Jínró,draenor,384,mage,fire,6,4,2
Bazemage,twisting-nether,384,mage,fire,6,4,2
Tadaa,blackmoore,384,mage,fire,6,4,2
Аристраз,soulflayer,384,mage,fire,6,4,2
Extol,tarren-mill,384,mage,fire,6,4,2
Гандолъер,soulflayer,384,mage,fire,6,4,2
Ogj,ravencrest,384,mage,fire,6,4,2
Shyasianmage,area-52,384,mage,fire,6,4,2
Esculapìo,nemesis,384,mage,fire,6,4,2
Смоукиайс,blackscar,384,mage,fire,6,4,2
Curran,ravencrest,384,mage,fire,6,4,2
Pogböss,malorne,384,mage,fire,6,4,2
Chièlui,silvermoon,384,mage,fire,6,4,2
Gennésïs,darksorrow,384,mage,fire,6,4,2
Pstkstpst,ravencrest,384,mage,fire,6,4,2
Kkohp,ravencrest,384,mage,fire,6,4,2
Nelway,hyjal,384,mage,fire,6,4,2
Âres,kargath,384,mage,fire,6,4,2
Blinker,frostwhisper,384,mage,fire,6,4,2
Fkndog,ravencrest,384,mage,fire,6,4,2
Blackfirez,ravencrest,384,mage,fire,6,4,2
Mnday,ravencrest,384,mage,fire,6,4,2
Интродюс,soulflayer,384,mage,fire,6,4,2
Kenjablejz,the-maelstrom,384,mage,fire,6,4,2
Eìnì,kazzak,384,mage,fire,6,4,2
Whìtewalker,pozzo-delleternità,384,mage,fire,6,4,2
Vorst,shattered-hand,384,mage,fire,6,4,2
Henqo,burning-legion,384,mage,fire,15,5,10
Аркагос,gordunni,384,mage,fire,12,4,8
Øtemplmag,dun-modr,384,mage,fire,12,4,8
Muchmage,silvermoon,384,mage,fire,12,4,8
Nelfpanda,ravencrest,384,mage,fire,12,4,8
Exael,ravencrest,384,mage,fire,12,4,8
Дантрий,gordunni,384,mage,fire,12,4,8
Jåvåscript,stormscale,384,mage,fire,12,4,8
Викликс,borean-tundra,384,mage,fire,12,4,8
Гелиадо,soulflayer,384,mage,fire,12,4,8
Padavoane,khaz-modan,384,mage,fire,12,4,8
Раканчик,gordunni,384,mage,fire,12,4,8
Kazeen,silvermoon,384,mage,fire,12,4,8
Деорро,gordunni,384,mage,fire,12,4,8
Imelin,silvermoon,384,mage,fire,12,4,8
Aarcheon,kazzak,384,mage,fire,12,4,8
Aláz,twisting-nether,384,mage,fire,12,4,8
Diji,the-maelstrom,384,mage,fire,12,4,8
Pipihu,silvermoon,384,mage,fire,12,4,8
Kisik,die-ewige-wacht,384,mage,fire,12,4,8
Rooven,aegwynn,384,mage,fire,12,4,8
Bænoß,ravencrest,384,mage,fire,12,4,8
Флоррет,gordunni,384,mage,fire,12,4,8
Yennéfér,outland,384,mage,fire,12,4,8
Khadgia,argent-dawn,384,mage,fire,12,4,8
Lonero,antonidas,384,mage,fire,12,4,8
Zeromagic,tarren-mill,384,mage,fire,12,4,8
Warfio,garona,384,mage,fire,12,4,8
Redsparrow,frostwolf,384,mage,fire,12,4,8
Popbg,outland,384,mage,fire,12,4,8
Pølåris,outland,384,mage,fire,12,4,8
Néiloth,frostmane,384,mage,fire,12,4,8
Bananabread,the-maelstrom,384,mage,fire,12,4,8
Feuern,antonidas,384,mage,fire,12,4,8
Ludak,stormscale,384,mage,fire,20,5,15
Drgyo,blackrock,384,mage,fire,18,4,14
Lusionator,defias-brotherhood,384,mage,fire,18,4,14
Reapor,draenor,384,mage,fire,18,4,14
Djblink,twisting-nether,384,mage,fire,18,4,14
Bonî,dun-modr,384,mage,fire,18,4,14
Magibeck,ravencrest,384,mage,fire,18,4,14
Арканмета,howling-fjord,384,mage,fire,18,4,14
Swansea,emeriss,384,mage,fire,20,4,16
Birdlort,draenor,383,mage,fire,6,4,2
Timbaa,veklor,383,mage,fire,6,4,2
Мэджиксул,grom,383,mage,fire,12,4,8
Ildrøv,stormscale,383,mage,fire,12,4,8
Unhedged,eredar,383,mage,fire,12,4,8
Chroniikk,hyjal,381,mage,fire,12,4,8
Chimará,eredar,367,mage,fire,17,4,13
Stillfrostin,blackrock,352,mage,fire,10,4,6
Lusifera,outland,336,mage,fire,9,4,5
Niivel,ysondre,336,mage,fire,15,4,11
Fkeverybody,ravencrest,330,mage,fire,8,5,3
Anev,sylvanas,330,mage,fire,11,5,6
Frostspree,wildhammer,319,mage,fire,5,4,1
Doidadetanga,aggra-português,319,mage,fire,9,4,5
Songosuu,eredar,319,mage,fire,20,4,16
Tvångstralla,tarren-mill,304,mage,fire,7,4,3
Гамаюнх,deathguard,304,mage,fire,7,4,3
Mimicassa,defias-brotherhood,301,mage,fire,38,18,20
Perk,grim-batol,288,mage,fire,6,3,3
Darkseidez,alonsus,288,mage,fire,6,3,3
Wracrz,argent-dawn,288,mage,fire,6,3,3
Elor,eredar,288,mage,fire,6,3,3
Rmage,kazzak,288,mage,fire,6,3,3
Mystiqu,ravencrest,288,mage,fire,6,3,3
Gôodgame,frostmane,288,mage,fire,6,3,3
Sonybonanza,kazzak,288,mage,fire,6,3,3
Couñterspell,eredar,288,mage,fire,6,3,3
Balderk,sanguino,288,mage,fire,6,3,3
Ghylias,kazzak,288,mage,fire,6,3,3
Zheakz,kazzak,288,mage,fire,6,3,3
Calyppo,sanguino,288,mage,fire,6,3,3
Tildetbfa,antonidas,288,mage,fire,6,3,3
Azriath,darksorrow,288,mage,fire,6,3,3
Malanti,grim-batol,288,mage,fire,6,3,3
Driana,dragonmaw,288,mage,fire,6,3,3
Riboe,outland,288,mage,fire,6,3,3
Kebabenjoyer,ravencrest,288,mage,fire,6,3,3
Lëyra,ysondre,288,mage,fire,6,3,3
Hansknechtt,frostwolf,288,mage,fire,6,3,3
Makez,draenor,288,mage,fire,6,3,3
Xlarb,kazzak,288,mage,fire,6,3,3
Frøstdream,dun-modr,288,mage,fire,6,3,3
Zehnvonzehn,antonidas,288,mage,fire,6,3,3
Snexo,kazzak,288,mage,fire,6,3,3
Abovè,outland,288,mage,fire,6,3,3
Mága,grim-batol,288,mage,fire,6,3,3
Sleîhg,sanguino,288,mage,fire,6,3,3
Kaizeri,draenor,288,mage,fire,6,3,3
Botstyle,ravencrest,288,mage,fire,6,3,3
Adetin,tarren-mill,288,mage,fire,6,3,3
Ørka,stormscale,288,mage,fire,6,3,3
Kryptass,aegwynn,288,mage,fire,6,3,3
Yasinthêdon,ravencrest,288,mage,fire,6,3,3
Salvadordalí,ravencrest,288,mage,fire,6,3,3
Capphaow,ravencrest,288,mage,fire,6,3,3
Îcecube,blackhand,288,mage,fire,6,3,3
Ccxz,draenor,288,mage,fire,6,3,3
Freelegend,ravencrest,288,mage,fire,6,3,3
Matroze,sylvanas,288,mage,fire,6,3,3
Torbalan,kazzak,288,mage,fire,6,3,3
Fleurdelacur,ravencrest,288,mage,fire,6,3,3
Feuertonne,blackmoore,288,mage,fire,6,3,3
Frozonë,draenor,288,mage,fire,6,3,3
Alearis,die-aldor,288,mage,fire,6,3,3
Sylênna,kazzak,288,mage,fire,6,3,3
Tyronesbone,stormscale,288,mage,fire,6,3,3
Kèj,kazzak,288,mage,fire,6,3,3
Блья,howling-fjord,288,mage,fire,6,3,3
Hasbe,kazzak,288,mage,fire,6,3,3
Manafuzz,outland,288,mage,fire,6,3,3
Texita,sylvanas,288,mage,fire,6,3,3
Сизаам,howling-fjord,288,mage,fire,6,3,3
Cubis,archimonde,288,mage,fire,6,3,3
Mihisa,outland,288,mage,fire,6,3,3
Trowbe,blackmoore,288,mage,fire,6,3,3
Ёшимитсо,howling-fjord,288,mage,fire,6,3,3
Kokirii,doomhammer,288,mage,fire,6,3,3
Maveya,blackmoore,288,mage,fire,6,3,3
Coachrmp,ravencrest,288,mage,fire,6,3,3
Portalpotty,sylvanas,288,mage,fire,6,3,3
Deadmagix,ravencrest,288,mage,fire,6,3,3
Fötmslävé,tarren-mill,288,mage,fire,6,3,3
Serclulz,ravencrest,288,mage,fire,6,3,3
Êgôn,perenolde,288,mage,fire,6,3,3
Säradok,outland,288,mage,fire,6,3,3
Shinigamí,blackrock,288,mage,fire,6,3,3
Zenó,blackrock,288,mage,fire,6,3,3
Dollzer,khaz-modan,288,mage,fire,6,3,3
Brandonjames,ragnaros,288,mage,fire,6,3,3
Modrone,ragnaros,288,mage,fire,6,3,3
Clitch,blutkessel,288,mage,fire,6,3,3
Ozdewish,hyjal,288,mage,fire,6,3,3
Shermî,blackrock,288,mage,fire,6,3,3
Fuchso,area-52,288,mage,fire,6,3,3
Trxkxx,ragnaros,288,mage,fire,6,3,3
Memanja,tarren-mill,288,mage,fire,6,3,3
Narexa,silvermoon,288,mage,fire,6,3,3
Mylanq,ragnaros,288,mage,fire,6,3,3
Ignyx,ragnaros,288,mage,fire,6,3,3
Inyøurassx,hyjal,288,mage,fire,6,3,3
Valimage,twisting-nether,288,mage,fire,6,3,3
Álco,outland,288,mage,fire,6,3,3
Onlymage,outland,288,mage,fire,6,3,3
Yasuomain,ragnaros,288,mage,fire,6,3,3
Mauiry,drakthul,288,mage,fire,6,3,3
Avizura,argent-dawn,288,mage,fire,6,3,3
Discast,anetheron,288,mage,fire,6,3,3
Legaliser,outland,288,mage,fire,6,3,3
Glindalefay,silvermoon,288,mage,fire,6,3,3
Хаппер,deathguard,288,mage,fire,6,3,3
Bràndy,twisting-nether,288,mage,fire,6,3,3
Fatcasts,silvermoon,288,mage,fire,6,3,3
Homellander,silvermoon,288,mage,fire,6,3,3
Jamesbang,blackmoore,288,mage,fire,7,3,4
Suidas,auchindoun,288,mage,fire,12,3,9
Шишиня,gordunni,288,mage,fire,12,3,9
Poochmage,archimonde,288,mage,fire,12,3,9
Timeforplanb,frostwolf,288,mage,fire,12,3,9
Megart,stormscale,288,mage,fire,12,3,9
Иньфанта,deathguard,288,mage,fire,12,3,9
Кешунчик,soulflayer,288,mage,fire,12,3,9
Oblív,ravencrest,288,mage,fire,12,3,9
Crusa,burning-blade,288,mage,fire,12,3,9
Lenka,ravencrest,288,mage,fire,12,3,9
Milton,dunemaul,288,mage,fire,12,3,9
Рровер,eversong,288,mage,fire,12,3,9
Овеча,gordunni,288,mage,fire,12,3,9
Pixlld,aegwynn,288,mage,fire,12,3,9
Frökenfrost,stormscale,288,mage,fire,12,3,9
Kampam,draenor,288,mage,fire,12,3,9
Saivedija,blackmoore,288,mage,fire,12,3,9
Lëfay,argent-dawn,288,mage,fire,12,3,9
Shiiron,blackrock,288,mage,fire,12,3,9
Juicedup,blackrock,288,mage,fire,12,3,9
Enkida,exodar,288,mage,fire,12,3,9
Tsubas,blackmoore,288,mage,fire,12,3,9
Rasaku,argent-dawn,288,mage,fire,12,3,9
Aylan,kazzak,288,mage,fire,12,3,9
Xlity,silvermoon,288,mage,fire,12,3,9
Rosenkrauz,kul-tiras,287,mage,fire,6,3,3
Maaleki,dalaran,287,mage,fire,6,3,3
Arkanieer,blackrock,287,mage,fire,6,3,3
Fireboss,the-maelstrom,287,mage,fire,6,3,3
Хадя,blackscar,287,mage,fire,6,3,3
Kyrox,ysondre,287,mage,fire,12,3,9
Ceanna,argent-dawn,287,mage,fire,12,3,9
Bulma,khaz-modan,286,mage,fire,6,3,3
Regenn,kazzak,286,mage,fire,6,3,3
Ionofrost,stormscale,272,mage,fire,7,5,2
Венлич,gordunni,271,mage,fire,9,4,5
Festers,kazzak,271,mage,fire,11,3,8
Mostevilgirl,blackhand,265,mage,fire,13,5,8
Liloz,aegwynn,256,mage,fire,4,4,0
Alarak,drakthul,256,mage,fire,10,3,7
Tahiti,twisting-nether,255,mage,fire,11,3,8
Novalia,wrathbringer,239,mage,fire,5,3,2
Arcitech,tarren-mill,239,mage,fire,5,3,2
Khalix,blackmoore,239,mage,fire,5,3,2
Szusigombóc,ragnaros,234,mage,fire,10,6,4
Søphiâ,thrall,234,mage,fire,10,4,6
Edelvise,azjolnerub,223,mage,fire,8,3,5
Worstwòrld,draenor,208,mage,fire,7,3,4
Roast,ahnqiraj,192,mage,fire,4,3,1
Fadbunny,outland,192,mage,fire,6,2,4
Majnoun,archimonde,192,mage,fire,6,2,4
Hêra,archimonde,192,mage,fire,6,2,4
Thylren,argent-dawn,192,mage,fire,6,2,4
Cytotoxic,emerald-dream,192,mage,fire,6,2,4
Gadeplan,argent-dawn,192,mage,fire,6,2,4
Charwizard,outland,192,mage,fire,6,2,4
Grodez,archimonde,192,mage,fire,6,2,4
Nyskal,tarren-mill,192,mage,fire,6,2,4
Oizar,hyjal,192,mage,fire,6,2,4
Exitalis,outland,192,mage,fire,6,2,4
Drfrostfire,drakthul,192,mage,fire,6,2,4
Nøxas,archimonde,192,mage,fire,6,2,4
Wortyvery,outland,192,mage,fire,6,2,4
Solitaria,tarren-mill,192,mage,fire,6,2,4
Fantâz,tarren-mill,192,mage,fire,6,2,4
Ikefire,draenor,192,mage,fire,6,2,4
Ôbsury,hyjal,192,mage,fire,6,2,4
Deathzzaky,ravencrest,192,mage,fire,6,2,4
Lilekx,archimonde,192,mage,fire,6,2,4
Isaru,draenor,192,mage,fire,6,2,4
Scoodles,kazzak,192,mage,fire,6,2,4
Jokiss,draenor,192,mage,fire,6,2,4
Kairøs,dragonblight,192,mage,fire,6,2,4
Khoshgele,draenor,192,mage,fire,6,2,4
Eksl,draenor,192,mage,fire,6,2,4
Magewarr,stormscale,192,mage,fire,6,2,4
Mahote,draenor,192,mage,fire,6,2,4
Dnt,twilights-hammer,192,mage,fire,6,2,4
Femboywaifu,stormscale,192,mage,fire,6,2,4
Transformo,draenor,192,mage,fire,6,2,4
Audraptor,medivh,192,mage,fire,6,2,4
Revelio,blackrock,192,mage,fire,6,2,4
Maxik,outland,192,mage,fire,6,2,4
Sickßlink,outland,192,mage,fire,6,2,4
Kenjos,silvermoon,192,mage,fire,6,2,4
Caliwee,eredar,192,mage,fire,6,2,4
Shédudé,silvermoon,192,mage,fire,6,2,4
Jjustice,outland,192,mage,fire,6,2,4
Shyoxmage,rexxar,192,mage,fire,6,2,4
Zeusmon,ragnaros,192,mage,fire,6,2,4
Компромис,howling-fjord,192,mage,fire,6,2,4
Akyrâz,blackrock,192,mage,fire,6,2,4
Ixbllyix,alonsus,192,mage,fire,6,2,4
Blasty,guldan,192,mage,fire,6,2,4
Yushinó,antonidas,192,mage,fire,6,2,4
Cortis,outland,192,mage,fire,6,2,4
Wetx,kilrogg,192,mage,fire,6,2,4
Izhi,arathor,192,mage,fire,6,2,4
Briner,ravencrest,192,mage,fire,6,2,4
Ghosty,festung-der-stürme,192,mage,fire,6,2,4
Naykor,dalaran,192,mage,fire,6,2,4
Mupana,nagrand,192,mage,fire,6,2,4
Lindsaylohan,silvermoon,192,mage,fire,6,2,4
Magenox,blackrock,192,mage,fire,6,2,4
Puracz,defias-brotherhood,192,mage,fire,6,2,4
Apc,sylvanas,192,mage,fire,6,2,4
Kapueca,jaedenar,192,mage,fire,6,2,4
Leafløver,ravencrest,192,mage,fire,6,2,4
Abiogenesis,silvermoon,192,mage,fire,6,2,4
Архиусэх,howling-fjord,192,mage,fire,6,2,4
Tudorthemage,xavius,192,mage,fire,6,2,4
ßalca,twisting-nether,192,mage,fire,6,2,4
Halcyón,ravencrest,192,mage,fire,6,2,4
Faitha,ravencrest,192,mage,fire,6,2,4
Krëkk,ragnaros,192,mage,fire,6,2,4
Ruhea,silvermoon,192,mage,fire,6,2,4
Letitsnow,ravencrest,192,mage,fire,6,2,4
Gacosane,chamber-of-aspects,192,mage,fire,6,2,4
Dríme,ravencrest,192,mage,fire,6,2,4
Summermàge,ravencrest,192,mage,fire,6,2,4
Minae,stormscale,192,mage,fire,6,2,4
Belthesad,twisting-nether,192,mage,fire,6,2,4
Гендральф,soulflayer,192,mage,fire,6,2,4
Lêgólás,blackmoore,192,mage,fire,6,2,4
Bannana,dun-modr,192,mage,fire,6,2,4
Djbjmage,ravencrest,192,mage,fire,6,2,4
Candyløve,ravencrest,192,mage,fire,6,2,4
Crashice,blackmoore,192,mage,fire,6,2,4
Magekaoz,sylvanas,192,mage,fire,6,2,4
Milminmage,ravencrest,192,mage,fire,6,2,4
Дэката,grom,192,mage,fire,6,2,4
Blinkblank,ravencrest,192,mage,fire,6,2,4
Atzin,sanguino,192,mage,fire,6,2,4
Skyliné,ravencrest,192,mage,fire,6,2,4
Alberdoor,blackmoore,192,mage,fire,6,2,4
Szarbán,ragnaros,192,mage,fire,6,2,4
Magicalpit,magtheridon,192,mage,fire,6,2,4
Интенса,gordunni,192,mage,fire,6,2,4
Димаскунфу,howling-fjord,192,mage,fire,6,2,4
Nyíks,blackhand,192,mage,fire,6,2,4
Кеото,gordunni,192,mage,fire,6,2,4
Decedé,dun-modr,192,mage,fire,6,2,4
Saveq,kazzak,192,mage,fire,6,2,4
Дарнивил,gordunni,192,mage,fire,6,2,4
Zerobelow,silvermoon,192,mage,fire,6,2,4
Quínt,blackhand,192,mage,fire,6,2,4
Vanser,kazzak,192,mage,fire,6,2,4
Skankengine,twisting-nether,192,mage,fire,6,2,4
Бигдикмаг,soulflayer,192,mage,fire,6,2,4
Гнег,gordunni,192,mage,fire,6,2,4
Hurtinlo,dun-modr,192,mage,fire,6,2,4
Nolifér,magtheridon,192,mage,fire,6,2,4
Harpelmage,auchindoun,192,mage,fire,7,2,5
Tacto,ravencrest,192,mage,fire,7,2,5
Buzzgnom,malfurion,192,mage,fire,12,2,10
Mesvef,archimonde,192,mage,fire,12,2,10
Хопкиллер,ashenvale,192,mage,fire,12,2,10
Çatàclysmík,kazzak,192,mage,fire,12,2,10
Firelight,argent-dawn,192,mage,fire,12,2,10
Xùrg,stormscale,192,mage,fire,12,2,10
Psilocybea,defias-brotherhood,192,mage,fire,12,2,10
Bekkmzi,drakthul,192,mage,fire,12,2,10
Убегай,soulflayer,192,mage,fire,12,2,10
Optimelk,bronzebeard,192,mage,fire,12,2,10
Лордбелиал,soulflayer,192,mage,fire,12,2,10
Symbiano,twisting-nether,192,mage,fire,12,2,10
Stepsiss,magtheridon,192,mage,fire,12,2,10
Zagori,sylvanas,192,mage,fire,12,2,10
Xatures,tarren-mill,192,mage,fire,12,2,10
Toxttr,drakthul,192,mage,fire,13,2,11
Kenny,nerzhul,192,mage,fire,24,2,22
Kirripirri,doomhammer,191,mage,fire,12,2,10
Mamacitá,ravencrest,175,mage,fire,11,2,9
Azegodxlul,kazzak,159,mage,fire,5,2,3
Magusbabus,ravencrest,159,mage,fire,5,2,3
Gotone,tarren-mill,159,mage,fire,8,3,5
Kathago,antonidas,154,mage,fire,12,4,8
Doglordx,lightbringer,144,mage,fire,3,3,0
Xhal,hyjal,138,mage,fire,9,3,6
Bratnasty,neptulon,138,mage,fire,11,3,8
Явернулси,soulflayer,138,mage,fire,20,3,17
Xxi,gorgonnash,128,mage,fire,4,2,2
Catafract,kazzak,128,mage,fire,4,2,2
Burstology,kazzak,128,mage,fire,4,2,2
Rukiax,blackrock,128,mage,fire,4,2,2
Donishakur,ragnaros,127,mage,fire,8,2,6
Imnis,outland,112,mage,fire,7,2,5
Nozarashí,hyjal,96,mage,fire,3,2,1
Малесгос,gordunni,96,mage,fire,6,1,5
Hotpockets,die-aldor,96,mage,fire,6,1,5
Zakardo,kazzak,96,mage,fire,6,1,5
Martixx,stormscale,96,mage,fire,6,1,5
Sunburstz,sylvanas,96,mage,fire,6,1,5
Perfection,cthun,96,mage,fire,6,1,5
Caststuffatu,sylvanas,96,mage,fire,6,1,5
Kaevos,ravencrest,96,mage,fire,6,1,5
Leonora,blackhand,96,mage,fire,6,1,5
Dingin,bronze-dragonflight,96,mage,fire,6,1,5
Westx,blackmoore,96,mage,fire,6,1,5
Alteretime,ravencrest,96,mage,fire,6,1,5
Alexandra,turalyon,96,mage,fire,6,1,5
Thoria,sylvanas,96,mage,fire,6,1,5
Farciminis,outland,96,mage,fire,6,1,5
Камаёри,howling-fjord,96,mage,fire,6,1,5
Akadran,blackmoore,96,mage,fire,6,1,5
Joulz,ravencrest,96,mage,fire,6,1,5
Одз,grom,96,mage,fire,6,1,5
Masseman,sylvanas,96,mage,fire,6,1,5
Evilmagíc,tarren-mill,96,mage,fire,6,1,5
Mageé,argent-dawn,96,mage,fire,6,1,5
Фантомланс,howling-fjord,96,mage,fire,6,1,5
Amalou,stormscale,96,mage,fire,6,1,5
Каппашилка,gordunni,96,mage,fire,6,1,5
Polilla,jaedenar,96,mage,fire,6,1,5
Дизордерх,gordunni,96,mage,fire,6,1,5
Дивеансерт,blackscar,96,mage,fire,6,1,5
Kangwizard,kazzak,96,mage,fire,6,1,5
Fumachustas,kazzak,96,mage,fire,6,1,5
Georgé,stormscale,96,mage,fire,6,1,5
Sniperorb,sylvanas,96,mage,fire,6,1,5
Amarántha,kazzak,96,mage,fire,6,1,5
Anzzmage,kazzak,96,mage,fire,6,1,5
Zïa,kazzak,96,mage,fire,6,1,5
Kushuka,burning-legion,96,mage,fire,6,1,5
Sikici,aegwynn,96,mage,fire,6,1,5
Zalfax,sinstralis,96,mage,fire,6,1,5
Alaster,culte-de-la-rive-noire,96,mage,fire,6,1,5
Nerzzhul,burning-legion,96,mage,fire,6,1,5
Boredpeon,burning-legion,96,mage,fire,6,1,5
Sheepurcheap,draenor,96,mage,fire,6,1,5
Arempy,tarren-mill,96,mage,fire,6,1,5
Vorsi,tarren-mill,96,mage,fire,6,1,5
Cavadrex,arathor,96,mage,fire,6,1,5
Grimrreaper,stormscale,96,mage,fire,6,1,5
Rbý,outland,96,mage,fire,6,1,5
Gehrkeblock,silvermoon,96,mage,fire,6,1,5
Saüron,burning-legion,96,mage,fire,6,1,5
Johnnyblazin,outland,96,mage,fire,6,1,5
Queuefiend,eredar,96,mage,fire,6,1,5
Arcanik,archimonde,96,mage,fire,6,1,5
Jeiqfogjioqs,archimonde,96,mage,fire,6,1,5
Slïnks,stormscale,96,mage,fire,6,1,5
Procrank,forscherliga,96,mage,fire,6,1,5
Scitzy,ragnaros,96,mage,fire,6,1,5
Laenadria,argent-dawn,96,mage,fire,6,1,5
Allattar,drakthul,96,mage,fire,6,1,5
Crankjuice,argent-dawn,96,mage,fire,6,1,5
Rivií,drakthul,96,mage,fire,6,1,5
Варриморыч,soulflayer,96,mage,fire,6,1,5
Пламяорды,soulflayer,96,mage,fire,6,1,5
Nodnarb,dragonblight,96,mage,fire,6,1,5
Satheril,argent-dawn,96,mage,fire,6,1,5
Stromz,silvermoon,96,mage,fire,6,1,5
Satoryu,silvermoon,96,mage,fire,6,1,5
Меззамоор,soulflayer,96,mage,fire,6,1,5
Slashlife,wrathbringer,96,mage,fire,6,1,5
Kaì,twisting-nether,96,mage,fire,6,1,5
Mexxî,thrall,96,mage,fire,6,1,5
Tokyodes,twisting-nether,96,mage,fire,6,1,5
Gabbaq,blackrock,96,mage,fire,6,1,5
Prinskoekie,twisting-nether,96,mage,fire,6,1,5
Hellburn,stormrage,96,mage,fire,6,1,5
Êmmá,blackmoore,96,mage,fire,6,1,5
Tsungy,twisting-nether,96,mage,fire,6,1,5
Lowdam,dun-modr,96,mage,fire,7,1,6
Maybeblood,kazzak,96,mage,fire,12,1,11
Serlath,defias-brotherhood,96,mage,fire,12,1,11
Ilikepoly,blackmoore,96,mage,fire,12,1,11
Latiny,blackrock,96,mage,fire,12,1,11
Lebron,blackrock,96,mage,fire,12,1,11
Yesuz,blackhand,96,mage,fire,12,1,11
Miyukì,dun-morogh,96,mage,fire,12,1,11
Mallph90A0B8,archimonde,96,mage,fire,12,1,11
Maregom,dun-modr,96,mage,fire,12,1,11
Tachipiirina,nemesis,96,mage,fire,12,1,11
Syltris,drakthul,96,mage,fire,18,1,17
Pyrias,sylvanas,95,mage,fire,6,1,5
Shâdozy,blackmoore,89,mage,fire,6,3,3
Сонатра,howling-fjord,79,mage,fire,5,1,4
Alkhazzar,defias-brotherhood,64,mage,fire,4,1,3
Hecht,burning-legion,64,mage,fire,4,1,3
Унитазныймаг,howling-fjord,63,mage,fire,2,2,0
Манапич,soulflayer,48,mage,fire,3,1,2
Preí,archimonde,42,mage,fire,12,3,9
Drakura,burning-legion,31,mage,fire,2,1,1
Nøøkîè,antonidas,31,mage,fire,2,1,1
Озобочений,greymane,31,mage,fire,2,1,1
Hakapelto,lightbringer,16,mage,fire,1,1,0
Petronillo,dun-modr,16,mage,fire,1,1,0
Ðøæø,twisting-nether,16,mage,fire,1,1,0
Fayja,draenor,16,mage,fire,7,1,6
Mercem,stormscale,2351,mage,frost,80,50,30
Ðeejkñ,archimonde,2315,mage,frost,102,61,41
Laynerz,kazzak,2287,mage,frost,103,59,44
Aleç,ravencrest,2270,mage,frost,134,71,63
Медивера,gordunni,2227,mage,frost,179,97,82
Partypower,twisting-nether,2219,mage,frost,273,138,135
Gelußaßa,ravencrest,2209,mage,frost,109,58,51
Philoû,archimonde,2205,mage,frost,157,82,75
Chikounet,archimonde,2188,mage,frost,150,78,72
Ràiku,ravencrest,2184,mage,frost,78,43,35
Tommy,laughing-skull,2148,mage,frost,136,67,69
Sìckofme,aegwynn,2143,mage,frost,72,46,26
Usererror,ravencrest,2139,mage,frost,137,69,68
Dodgezdream,kazzak,2138,mage,frost,195,119,76
Dastion,ravencrest,2138,mage,frost,103,52,51
Avizura,kazzak,2134,mage,frost,60,35,25
Fakér,ravencrest,2130,mage,frost,190,94,96
Watchmeclic,archimonde,2126,mage,frost,108,54,54
Kilstine,outland,2126,mage,frost,78,39,39
Kurtkiels,draenor,2112,mage,frost,96,49,47
Akyrâz,blackrock,2108,mage,frost,277,138,139
Яшабурстх,blackscar,2101,mage,frost,101,59,42
Ðazzftw,archimonde,2065,mage,frost,69,51,18
Søz,agamaggan,2059,mage,frost,161,79,82
Ãshs,archimonde,2057,mage,frost,206,101,105
Crylz,kazzak,2044,mage,frost,83,42,41
Serctheone,ravencrest,2038,mage,frost,244,121,123
Oscarwizyo,ravencrest,2036,mage,frost,95,44,51
Макотшельник,gordunni,2033,mage,frost,91,55,36
Sóz,ravencrest,2033,mage,frost,109,51,58
Neverblockx,blackrock,2028,mage,frost,64,44,20
Efes,dun-modr,2021,mage,frost,218,106,112
Thegoodoctor,kazzak,2018,mage,frost,76,52,24
Drfeeldgoodd,mazrigos,2018,mage,frost,327,165,162
Naynn,archimonde,2016,mage,frost,271,138,133
Frostboltop,ravencrest,2011,mage,frost,83,39,44
Ticklefinger,agamaggan,2004,mage,frost,59,40,19
Kalamaras,quelthalas,1999,mage,frost,291,145,146
Arnoldkelly,tarren-mill,1998,mage,frost,55,32,23
Барсуктри,deathguard,1984,mage,frost,60,30,30
Elgriefo,sylvanas,1981,mage,frost,84,36,48
Mizt,ragnaros,1975,mage,frost,96,43,53
Lyndsey,dalaran,1973,mage,frost,89,44,45
Highrollerqt,tarren-mill,1971,mage,frost,192,111,81
Незерёб,soulflayer,1959,mage,frost,168,87,81
Gavno,ravencrest,1955,mage,frost,54,26,28
Ввнд,galakrond,1953,mage,frost,108,50,58
Jíncks,anachronos,1946,mage,frost,48,28,20
Unsaìntly,kult-der-verdammten,1946,mage,frost,81,37,44
Ëloenn,dalaran,1935,mage,frost,83,39,44
Фоулли,howling-fjord,1934,mage,frost,75,39,36
Whïm,ysondre,1932,mage,frost,149,73,76
Setyouoncs,ravencrest,1927,mage,frost,84,42,42
Калихор,gordunni,1921,mage,frost,107,65,42
Abovè,outland,1918,mage,frost,54,23,31
Wmp,ravencrest,1917,mage,frost,66,31,35
Missl,draenor,1916,mage,frost,92,47,45
Øscarwizyo,ravencrest,1916,mage,frost,212,103,109
Oseri,defias-brotherhood,1915,mage,frost,161,77,84
Gossipgirlz,outland,1913,mage,frost,292,151,141
Sukmikok,twisting-nether,1911,mage,frost,190,94,96
Evovar,silvermoon,1911,mage,frost,254,124,130
Nilitar,kazzak,1910,mage,frost,60,24,36
Watchmeclick,archimonde,1909,mage,frost,36,20,16
Wickedblink,ravencrest,1905,mage,frost,68,33,35
Môv,tarren-mill,1902,mage,frost,63,31,32
Нереварин,soulflayer,1899,mage,frost,96,42,54
Барсукже,howling-fjord,1893,mage,frost,60,40,20
Aìnz,hyjal,1893,mage,frost,120,58,62
Аресуперпрес,gordunni,1893,mage,frost,85,40,45
Azrx,blackmoore,1891,mage,frost,76,37,39
Slôw,kazzak,1891,mage,frost,54,26,28
Funkyfriday,twisting-nether,1889,mage,frost,48,23,25
Rosady,ragnaros,1884,mage,frost,194,99,95
Shîmmer,ravencrest,1877,mage,frost,48,28,20
Zimbabweborc,burning-legion,1875,mage,frost,100,62,38
Bigkent,stormscale,1870,mage,frost,78,38,40
Лемозяра,gordunni,1862,mage,frost,40,26,14
Прауз,soulflayer,1860,mage,frost,50,30,20
Eìnì,kazzak,1860,mage,frost,37,22,15
Zhodusqt,ragnaros,1859,mage,frost,54,27,27
Néiloth,frostmane,1858,mage,frost,71,34,37
Ráìkù,ravencrest,1857,mage,frost,42,27,15
Rufatopapari,ravencrest,1856,mage,frost,112,54,58
Henqo,burning-legion,1856,mage,frost,64,30,34
Jocelynn,aggramar,1854,mage,frost,125,59,66
Cleophe,burning-legion,1853,mage,frost,81,44,37
Praison,defias-brotherhood,1853,mage,frost,81,41,40
Reðemption,dun-modr,1848,mage,frost,53,35,18
Sunehx,blackrock,1842,mage,frost,84,46,38
Watchmylance,blackrock,1842,mage,frost,48,23,25
Ironhood,nemesis,1841,mage,frost,66,42,24
Mlogic,tarren-mill,1841,mage,frost,148,78,70
Róseonly,ravencrest,1841,mage,frost,123,62,61
Voerk,twisting-nether,1840,mage,frost,118,57,61
Лакифриз,gordunni,1839,mage,frost,284,157,127
Tadaa,blackmoore,1839,mage,frost,60,32,28
Sâkuya,blackrock,1838,mage,frost,163,84,79
Ogfreshlance,stormscale,1837,mage,frost,158,85,73
Chazs,kazzak,1836,mage,frost,78,41,37
Babyboyj,blackmoore,1835,mage,frost,60,27,33
Datpolytho,twisting-nether,1834,mage,frost,205,121,84
Unsaîntly,kult-der-verdammten,1833,mage,frost,46,20,26
Sìsia,ragnaros,1832,mage,frost,42,24,18
Lìx,ravencrest,1832,mage,frost,47,25,22
Exone,sylvanas,1828,mage,frost,66,32,34
Shakeándbake,ravencrest,1828,mage,frost,82,38,44
Laurents,silvermoon,1825,mage,frost,128,86,42
Soz,agamaggan,1823,mage,frost,42,23,19
Knometsj,ravencrest,1823,mage,frost,54,29,25
Arkhaen,archimonde,1822,mage,frost,106,53,53
Goneforever,draenor,1820,mage,frost,42,27,15
Heathrow,ravencrest,1820,mage,frost,278,158,120
Ovrpwrdxd,kazzak,1819,mage,frost,48,34,14
Nightnovae,ravencrest,1817,mage,frost,157,76,81
Shunii,ravencrest,1817,mage,frost,55,24,31
Novaco,ravencrest,1816,mage,frost,65,30,35
Унитазныймаг,howling-fjord,1815,mage,frost,36,19,17
Stîckî,malganis,1814,mage,frost,69,31,38
Pryt,ragnaros,1813,mage,frost,137,78,59
Rambau,archimonde,1813,mage,frost,347,175,172
Djdankzter,outland,1812,mage,frost,42,19,23
Деорро,gordunni,1809,mage,frost,84,45,39
Máximus,ravencrest,1809,mage,frost,53,27,26
Reflexz,thrall,1805,mage,frost,42,25,17
Xmoo,blackrock,1805,mage,frost,48,24,24
Mßs,outland,1804,mage,frost,48,24,24
Baconlance,stormscale,1803,mage,frost,42,23,19
Shíróyama,ravencrest,1803,mage,frost,223,121,102
Tellysia,blackmoore,1802,mage,frost,47,26,21
Ghettomagé,aegwynn,1802,mage,frost,42,22,20
Lzd,ravencrest,1802,mage,frost,54,28,26
Símple,sylvanas,1802,mage,frost,60,27,33
Nickg,ravencrest,1801,mage,frost,60,30,30
Lidely,kazzak,1800,mage,frost,30,19,11
Takayaki,terokkar,1800,mage,frost,187,103,84
Emoden,silvermoon,1800,mage,frost,331,171,160
Medara,darkspear,1799,mage,frost,84,45,39
Ånei,ravencrest,1798,mage,frost,36,26,10
Whócárés,dragonmaw,1798,mage,frost,45,32,13
Løwskìll,outland,1795,mage,frost,95,53,42
Valyndra,twisting-nether,1793,mage,frost,162,87,75
Einsmagus,blackrock,1793,mage,frost,60,31,29
Santriss,defias-brotherhood,1790,mage,frost,108,51,57
Transformo,draenor,1789,mage,frost,42,23,19
Мэтаскрим,soulflayer,1787,mage,frost,188,91,97
Sheepmaster,aegwynn,1786,mage,frost,60,35,25
Blasty,guldan,1786,mage,frost,136,70,66
Zoot,ravencrest,1785,mage,frost,119,55,64
Rekzaop,ravencrest,1785,mage,frost,144,66,78
Gegovski,ravencrest,1784,mage,frost,42,25,17
Kahyo,argent-dawn,1784,mage,frost,65,34,31
Titsu,stormreaver,1783,mage,frost,106,53,53
Auchenax,argent-dawn,1783,mage,frost,173,85,88
Onnÿy,dun-modr,1781,mage,frost,80,37,43
Maege,ragnaros,1780,mage,frost,74,47,27
Mlodysimba,burning-legion,1776,mage,frost,76,36,40
Snowsánji,blackmoore,1775,mage,frost,53,28,25
Polÿmorph,stormscale,1774,mage,frost,65,33,32
Knulljonný,kazzak,1773,mage,frost,54,24,30
Rere,zenedar,1766,mage,frost,38,21,17
Stickiburn,malganis,1766,mage,frost,99,47,52
Zøe,aggra-português,1762,mage,frost,90,51,39
Quadekun,tarren-mill,1762,mage,frost,42,23,19
Sorrow,outland,1762,mage,frost,90,42,48
Lorothar,blackhand,1762,mage,frost,72,30,42
Crzyubrdrver,blackrock,1761,mage,frost,36,21,15
Lolmageop,aegwynn,1761,mage,frost,154,76,78
Shakéx,outland,1758,mage,frost,51,26,25
Леракобольд,gordunni,1755,mage,frost,56,30,26
Озобочений,greymane,1754,mage,frost,211,111,100
Èverix,ravencrest,1750,mage,frost,136,59,77
Колинас,soulflayer,1749,mage,frost,107,53,54
Kõl,ravencrest,1748,mage,frost,78,42,36
Mexxî,thrall,1747,mage,frost,78,41,37
Nightfee,eredar,1745,mage,frost,42,21,21
Vareesy,drakthul,1742,mage,frost,153,88,65
Tagrine,kaelthas,1742,mage,frost,182,92,90
Ôbsury,hyjal,1739,mage,frost,142,79,63
Helloimgone,blackmoore,1737,mage,frost,59,27,32
Mumage,blackrock,1735,mage,frost,60,32,28
Senedai,stormscale,1734,mage,frost,133,71,62
Bestial,alexstrasza,1734,mage,frost,188,95,93
Tánu,quelthalas,1734,mage,frost,275,137,138
Ганссмаг,soulflayer,1734,mage,frost,60,29,31
Emerlyn,ragnaros,1732,mage,frost,42,23,19
Icydeadsheep,draenor,1732,mage,frost,107,52,55
Ioriyagami,dragonmaw,1732,mage,frost,94,45,49
Fireblood,runetotem,1730,mage,frost,96,45,51
Darkoftw,ysondre,1729,mage,frost,125,58,67
Kyomachix,ahnqiraj,1727,mage,frost,60,31,29
Jamzymage,emerald-dream,1727,mage,frost,86,44,42
Yshax,malganis,1727,mage,frost,78,33,45
Silverlining,ravencrest,1726,mage,frost,252,126,126
Neymar,aszune,1725,mage,frost,35,24,11
Blackfirez,ravencrest,1725,mage,frost,30,18,12
Xall,silvermoon,1725,mage,frost,193,105,88
Гелиадо,soulflayer,1724,mage,frost,42,19,23
Naylz,archimonde,1723,mage,frost,62,34,28
Wàneís,ravencrest,1723,mage,frost,60,24,36
Nilitarrgh,outland,1721,mage,frost,36,18,18
Grandbasile,hyjal,1719,mage,frost,66,31,35
Dastion,sylvanas,1718,mage,frost,36,18,18
Мибринк,soulflayer,1717,mage,frost,156,79,77
Swizzy,arathor,1716,mage,frost,76,42,34
Sweetcandy,outland,1715,mage,frost,107,62,45
Äntigood,outland,1715,mage,frost,306,156,150
Mystikj,arathor,1715,mage,frost,72,35,37
Lilblinks,silvermoon,1714,mage,frost,197,106,91
Esscheppert,blackrock,1713,mage,frost,299,145,154
Мэдвэйз,gordunni,1710,mage,frost,118,62,56
Tabueno,kazzak,1709,mage,frost,150,70,80
Klueless,ravencrest,1708,mage,frost,30,19,11
Covran,stormscale,1706,mage,frost,149,75,74
Hambones,outland,1706,mage,frost,86,39,47
Babidi,nemesis,1704,mage,frost,66,36,30
Donishakur,ragnaros,1704,mage,frost,73,35,38
Charliezard,argent-dawn,1704,mage,frost,42,18,24
Marybaguette,archimonde,1702,mage,frost,54,25,29
Calina,azshara,1700,mage,frost,53,32,21
Axhole,darksorrow,1700,mage,frost,54,26,28
Tfmchamp,ravencrest,1698,mage,frost,33,22,11
Сизаам,howling-fjord,1697,mage,frost,54,34,20
Borêta,blackrock,1697,mage,frost,217,114,103
Andors,conseil-des-ombres,1697,mage,frost,42,18,24
Альмодера,gordunni,1696,mage,frost,60,35,25
Wracrz,argent-dawn,1696,mage,frost,102,51,51
Barryscótt,stormscale,1695,mage,frost,30,21,9
Seikatsu,sylvanas,1694,mage,frost,42,20,22
Bigacombusta,tarren-mill,1693,mage,frost,134,65,69
Melíssa,silvermoon,1692,mage,frost,36,25,11
Elrorfiniel,draenor,1692,mage,frost,56,29,27
Vilain,tarren-mill,1692,mage,frost,88,44,44
Ephixis,ravencrest,1691,mage,frost,116,51,65
Alearis,die-aldor,1690,mage,frost,72,38,34
Synblink,eredar,1690,mage,frost,86,42,44
Frostgodxqt,ravencrest,1689,mage,frost,105,58,47
Kythie,thrall,1688,mage,frost,148,73,75
Jennao,stormscale,1686,mage,frost,47,26,21
Scoodles,kazzak,1685,mage,frost,48,26,22
Bebenm,archimonde,1685,mage,frost,72,37,35
Khimeron,twisting-nether,1685,mage,frost,84,36,48
Риктусемпра,ashenvale,1684,mage,frost,99,62,37
Raíner,eredar,1683,mage,frost,137,73,64
Xep,ragnaros,1682,mage,frost,54,27,27
Bombswag,bloodhoof,1682,mage,frost,329,163,166
Kiirin,drakthul,1682,mage,frost,140,69,71
Kaeser,ravencrest,1681,mage,frost,151,79,72
Jenggot,ravencrest,1681,mage,frost,35,18,17
Корадо,gordunni,1679,mage,frost,297,150,147
Cavadrex,arathor,1677,mage,frost,102,54,48
Xirrasho,argent-dawn,1677,mage,frost,42,22,20
Fîsheye,blackrock,1676,mage,frost,30,18,12
Алаурс,howling-fjord,1676,mage,frost,194,94,100
Манахк,gordunni,1674,mage,frost,48,22,26
Tiqma,sylvanas,1673,mage,frost,42,23,19
Jezí,ghostlands,1673,mage,frost,90,41,49
Ishimura,eredar,1669,mage,frost,96,51,45
Afterimage,zuljin,1669,mage,frost,199,99,100
Sylbris,outland,1667,mage,frost,177,84,93
Саваннхмаег,blackscar,1665,mage,frost,57,34,23
Espressno,ravencrest,1664,mage,frost,35,22,13
Arimila,sylvanas,1664,mage,frost,300,152,148
Lïppoutou,archimonde,1663,mage,frost,35,18,17
Wýr,archimonde,1661,mage,frost,157,80,77
Secretagent,aegwynn,1660,mage,frost,36,26,10
Anniemykween,ravencrest,1660,mage,frost,136,79,57
Quinella,ravencrest,1660,mage,frost,137,73,64
Akâri,silvermoon,1660,mage,frost,85,40,45
Nozarashí,hyjal,1656,mage,frost,225,114,111
Ahdetärjag,silvermoon,1655,mage,frost,59,32,27
Gensorèd,darksorrow,1655,mage,frost,74,36,38
Trowbe,blackmoore,1654,mage,frost,48,26,22
Гекомория,fordragon,1654,mage,frost,74,39,35
Манакса,gordunni,1654,mage,frost,54,24,30
Smashdown,blackrock,1651,mage,frost,66,36,30
Chíefsheep,thrall,1651,mage,frost,71,33,38
Firzen,defias-brotherhood,1650,mage,frost,38,20,18
Nebbur,dun-modr,1650,mage,frost,54,25,29
Slobbery,aggramar,1649,mage,frost,95,48,47
Lo,kilrogg,1649,mage,frost,120,57,63
Shattermaybe,blackrock,1646,mage,frost,36,21,15
Johnnydeepp,archimonde,1646,mage,frost,36,18,18
Soloqtarget,archimonde,1645,mage,frost,223,108,115
Rukiax,blackrock,1645,mage,frost,54,18,36
Botanicula,the-maelstrom,1644,mage,frost,42,20,22
Shizzy,onyxia,1644,mage,frost,66,31,35
Djflashz,archimonde,1644,mage,frost,42,18,24
Firebaw,tarren-mill,1643,mage,frost,36,25,11
Helminsterr,archimonde,1642,mage,frost,90,47,43
Dostoïevskix,hyjal,1640,mage,frost,30,19,11
Schmutzki,eredar,1638,mage,frost,113,63,50
Astaden,die-aldor,1637,mage,frost,105,61,44
Icekíss,hyjal,1637,mage,frost,103,55,48
Jirø,cthun,1637,mage,frost,226,110,116
Вольняша,azuregos,1637,mage,frost,244,118,126
Slithìce,kazzak,1637,mage,frost,54,22,32
Emesarry,scarshield-legion,1636,mage,frost,29,18,11
Magerocks,ragnaros,1635,mage,frost,36,20,16
Rodeyy,nathrezim,1635,mage,frost,124,67,57
Rihnou,blackmoore,1635,mage,frost,185,91,94
Sondremage,outland,1635,mage,frost,134,60,74
Jonku,tarren-mill,1634,mage,frost,59,31,28
Tærrëñshíll,tarren-mill,1634,mage,frost,48,22,26
Obbcontrol,ravencrest,1633,mage,frost,48,21,27
Vilenciaga,kazzak,1632,mage,frost,72,37,35
Mecharience,rexxar,1632,mage,frost,62,31,31
Jaimey,blackhand,1632,mage,frost,167,76,91
Scorchira,outland,1631,mage,frost,30,18,12
Asiman,eredar,1631,mage,frost,51,22,29
Skretx,archimonde,1630,mage,frost,72,46,26
Frígíd,outland,1630,mage,frost,54,25,29
Naween,hyjal,1629,mage,frost,42,24,18
Frostique,kazzak,1629,mage,frost,175,99,76
Thesiôu,ravencrest,1629,mage,frost,36,20,16
Buddi,burning-blade,1629,mage,frost,287,148,139
Farciminis,outland,1629,mage,frost,241,124,117
Ønlyfünds,archimonde,1628,mage,frost,48,32,16
Bzzr,tarren-mill,1627,mage,frost,66,42,24
Sinanspappa,argent-dawn,1627,mage,frost,30,18,12
Проблембойх,gordunni,1627,mage,frost,36,20,16
Dsmoke,ravencrest,1627,mage,frost,75,35,40
Nightseven,emeriss,1626,mage,frost,30,21,9
Thinamerican,defias-brotherhood,1626,mage,frost,60,34,26
Аквамелис,gordunni,1626,mage,frost,132,60,72
Venque,blackrock,1625,mage,frost,72,33,39
Homellander,silvermoon,1624,mage,frost,481,249,232
Glowie,stormreaver,1623,mage,frost,36,20,16
Lyramage,draenor,1623,mage,frost,66,32,34
Xenant,ravencrest,1623,mage,frost,42,18,24
Ёкай,soulflayer,1622,mage,frost,415,220,195
Rusdor,frostwhisper,1622,mage,frost,90,40,50
Kaì,twisting-nether,1621,mage,frost,160,91,69
Pharohe,stormscale,1621,mage,frost,86,40,46
Scaleeth,kazzak,1620,mage,frost,82,44,38
Knúbbz,ravencrest,1620,mage,frost,78,38,40
Maquiwizz,aggra-português,1618,mage,frost,85,49,36
Digi,ravencrest,1617,mage,frost,57,22,35
Find,archimonde,1616,mage,frost,232,118,114
Anaxtra,guldan,1616,mage,frost,147,70,77
Mclancealot,tarren-mill,1616,mage,frost,101,48,53
Walian,burning-blade,1615,mage,frost,60,36,24
Boomboomciao,nemesis,1614,mage,frost,186,92,94
Layzzy,kazzak,1614,mage,frost,268,128,140
Pezi,outland,1613,mage,frost,67,39,28
Sykz,hyjal,1612,mage,frost,101,53,48
Shøcked,blackrock,1612,mage,frost,114,56,58
Манаксаа,gordunni,1612,mage,frost,45,21,24
Джейнанис,gordunni,1611,mage,frost,88,50,38
Xæll,silvermoon,1611,mage,frost,120,64,56
Labyssra,argent-dawn,1611,mage,frost,68,33,35
Qtpoof,sylvanas,1610,mage,frost,42,22,20
Фирдаркнесс,howling-fjord,1610,mage,frost,78,40,38
Únna,sanguino,1609,mage,frost,99,58,41
Isralysa,ravencrest,1609,mage,frost,344,181,163
Shainax,dun-modr,1609,mage,frost,301,158,143
Nelfchewer,ravencrest,1609,mage,frost,56,25,31
Mollymorph,ragnaros,1609,mage,frost,54,21,33
Frostandrew,twisting-nether,1608,mage,frost,41,23,18
Akúmã,stormscale,1607,mage,frost,390,206,184
Mupana,nagrand,1607,mage,frost,150,76,74
Shalien,tarren-mill,1607,mage,frost,83,41,42
Focusmage,outland,1606,mage,frost,82,47,35
Fboltprocd,ragnaros,1606,mage,frost,30,17,13
Miokimijima,draenor,1606,mage,frost,38,21,17
Tills,kargath,1606,mage,frost,42,20,22
Zauberdose,blackhand,1605,mage,frost,42,20,22
Келлазар,gordunni,1605,mage,frost,83,38,45
Razx,stormscale,1605,mage,frost,140,63,77
Манахк,blackscar,1605,mage,frost,53,21,32
Фристейт,soulflayer,1605,mage,frost,78,30,48
Hardtimes,blackhand,1604,mage,frost,35,27,8
Copyright,deathwing,1604,mage,frost,36,17,19
Sandalf,lightnings-blade,1603,mage,frost,73,42,31
Noxkin,stormscale,1603,mage,frost,36,17,19
Magethings,kazzak,1603,mage,frost,54,25,29
Søbert,hyjal,1602,mage,frost,47,25,22
Мэдраша,gordunni,1602,mage,frost,116,50,66
Réd,earthen-ring,1601,mage,frost,77,36,41
Snaapz,kazzak,1600,mage,frost,48,22,26
Absoluteswag,tarren-mill,1598,mage,frost,39,22,17
Itzlucky,twisting-nether,1598,mage,frost,202,102,100
Rinuria,blackrock,1596,mage,frost,30,19,11
Doidadetanga,aggra-português,1596,mage,frost,81,43,38
Sam,outland,1595,mage,frost,36,22,14
Райоми,fordragon,1595,mage,frost,355,179,176
Tromie,archimonde,1594,mage,frost,221,115,106
Tableau,blackrock,1592,mage,frost,62,31,31
Jedite,die-todeskrallen,1590,mage,frost,379,201,178
Sersei,garona,1590,mage,frost,36,17,19
Порнушный,gordunni,1589,mage,frost,48,26,22
Hógwarts,aegwynn,1588,mage,frost,90,46,44
Rankonedeep,kazzak,1587,mage,frost,63,34,29
Råståfåri,uldum,1586,mage,frost,191,95,96
Autramage,emerald-dream,1583,mage,frost,60,33,27
Okayhehexd,dun-morogh,1583,mage,frost,126,69,57
Sheepthrillz,blackmoore,1583,mage,frost,65,34,31
Joulz,ravencrest,1583,mage,frost,200,94,106
Iceteen,aegwynn,1579,mage,frost,42,22,20
Óuíja,outland,1576,mage,frost,51,31,20
Nimdáá,stormscale,1575,mage,frost,204,113,91
Løxyy,ysondre,1575,mage,frost,194,102,92
Demensida,ravencrest,1574,mage,frost,268,137,131
Bumbumdead,sylvanas,1573,mage,frost,66,33,33
Hectiickz,bloodhoof,1572,mage,frost,36,18,18
Hazzá,ravencrest,1571,mage,frost,36,17,19
Opíum,tarren-mill,1570,mage,frost,48,27,21
Dubbleblast,draenor,1570,mage,frost,48,25,23
Ингилейф,howling-fjord,1570,mage,frost,46,18,28
Vyuca,argent-dawn,1569,mage,frost,64,34,30
Realone,ragnaros,1569,mage,frost,81,39,42
Manafuzz,outland,1569,mage,frost,48,22,26
Marikisanx,blackmoore,1568,mage,frost,42,22,20
Iroya,festung-der-stürme,1568,mage,frost,499,250,249
Brolyzerr,archimonde,1567,mage,frost,37,19,18
Girldalf,silvermoon,1567,mage,frost,225,111,114
Microsmag,thrall,1566,mage,frost,24,17,7
Phélenia,sargeras,1564,mage,frost,226,115,111
Bodyrocker,sylvanas,1564,mage,frost,35,17,18
Dubstep,blackrock,1561,mage,frost,60,27,33
Nilys,chogall,1559,mage,frost,78,50,28
Вендайса,soulflayer,1558,mage,frost,274,156,118
Chareyla,argent-dawn,1558,mage,frost,83,42,41
Xawokem,outland,1558,mage,frost,42,18,24
Sakuranosuke,twisting-nether,1557,mage,frost,72,39,33
Tjq,ravencrest,1556,mage,frost,646,327,319
Gaduz,kazzak,1556,mage,frost,72,31,41
Mgtowforlife,ravencrest,1554,mage,frost,325,155,170
Muchmage,silvermoon,1553,mage,frost,107,47,60
Samath,conseil-des-ombres,1552,mage,frost,78,34,44
Discomorph,the-maelstrom,1551,mage,frost,34,21,13
Tdv,draenor,1551,mage,frost,111,52,59
Elcritadoré,ragnaros,1550,mage,frost,52,26,26
Гамаюнх,deathguard,1550,mage,frost,60,28,32
Bananabread,the-maelstrom,1549,mage,frost,105,51,54
Xyfys,azshara,1547,mage,frost,41,23,18
Misslance,kazzak,1547,mage,frost,36,20,16
Mxrrz,kazzak,1547,mage,frost,211,111,100
Delvir,stormreaver,1546,mage,frost,96,46,50
Ghalanz,ravencrest,1545,mage,frost,60,29,31
Azakadabra,ysondre,1544,mage,frost,69,43,26
Petepan,argent-dawn,1543,mage,frost,115,55,60
Бингчилинг,howling-fjord,1543,mage,frost,64,30,34
Naissa,arathor,1542,mage,frost,60,23,37
Llura,ragnaros,1541,mage,frost,66,32,34
Næj,hyjal,1541,mage,frost,49,21,28
Koreanbbq,outland,1541,mage,frost,42,18,24
Fullpolly,twisting-nether,1538,mage,frost,47,29,18
Ozon,sylvanas,1538,mage,frost,60,29,31
Borko,rashgarroth,1536,mage,frost,42,23,19
Hendersson,blackrock,1536,mage,frost,48,21,27
Nàtcho,tichondrius,1535,mage,frost,60,35,25
Sickofme,aegwynn,1535,mage,frost,30,16,14
Alicánte,silvermoon,1535,mage,frost,126,65,61
Beaun,tarren-mill,1534,mage,frost,195,101,94
Comodus,ragnaros,1534,mage,frost,148,74,74
Gødstopmeplz,aegwynn,1534,mage,frost,36,18,18
Fïttan,stormscale,1533,mage,frost,143,72,71
Iverson,kazzak,1533,mage,frost,110,49,61
Apeex,chamber-of-aspects,1532,mage,frost,160,77,83
Aurelius,kargath,1531,mage,frost,42,24,18
Elldiamage,draenor,1531,mage,frost,30,16,14
Gêrky,drakthul,1531,mage,frost,140,73,67
Миднаит,gordunni,1531,mage,frost,111,50,61
Karstnstenzl,blackrock,1530,mage,frost,78,39,39
Dumblemore,ragnaros,1529,mage,frost,66,38,28
Marcotekk,dun-modr,1529,mage,frost,56,30,26
Hbarftw,ravencrest,1528,mage,frost,71,35,36
Roberx,sanguino,1528,mage,frost,101,48,53
Styxmg,blackhand,1526,mage,frost,42,18,24
Мосгормаг,gordunni,1525,mage,frost,55,28,27
Leafløver,ravencrest,1525,mage,frost,95,46,49
Ковенн,howling-fjord,1525,mage,frost,54,26,28
Evilmagíc,tarren-mill,1523,mage,frost,30,16,14
ßalca,twisting-nether,1522,mage,frost,50,27,23
Homper,argent-dawn,1521,mage,frost,36,19,17
Icefix,dun-modr,1520,mage,frost,153,81,72
Qùb,eldrethalas,1519,mage,frost,42,23,19
Excuses,chamber-of-aspects,1519,mage,frost,314,155,159
Tvångstralla,tarren-mill,1519,mage,frost,79,38,41
Xue,azshara,1518,mage,frost,60,29,31
Airo,drakthul,1517,mage,frost,66,40,26
Larmp,outland,1517,mage,frost,42,16,26
Ney,drakthul,1516,mage,frost,24,16,8
Exelo,rashgarroth,1516,mage,frost,61,34,27
Sekulicgoga,draenor,1515,mage,frost,309,168,141
Hetaxata,kazzak,1513,mage,frost,54,31,23
Xoouuboo,eredar,1513,mage,frost,30,16,14
Elcølgaø,sanguino,1512,mage,frost,156,76,80
Mohovik,wildhammer,1510,mage,frost,42,23,19
Метох,soulflayer,1510,mage,frost,219,106,113
Adagar,chamber-of-aspects,1509,mage,frost,101,55,46
Viro,defias-brotherhood,1509,mage,frost,33,17,16
Ðíø,twisting-nether,1507,mage,frost,94,49,45
Nutsa,silvermoon,1507,mage,frost,35,18,17
Thamagus,burning-legion,1507,mage,frost,52,26,26
Track,blackhand,1507,mage,frost,53,22,31
Rexør,frostwolf,1505,mage,frost,54,31,23
Denaleidi,stormscale,1505,mage,frost,54,30,24
Alluryeine,draenor,1505,mage,frost,65,36,29
Amyseven,kazzak,1505,mage,frost,96,43,53
Ckrax,sanguino,1504,mage,frost,48,24,24
Оай,gordunni,1504,mage,frost,72,32,40
Kukerr,burning-legion,1503,mage,frost,45,26,19
Newintown,blackmoore,1503,mage,frost,62,32,30
Arridon,echsenkessel,1500,mage,frost,122,68,54
Addew,the-maelstrom,1500,mage,frost,101,55,46
Confine,twisting-nether,1498,mage,frost,180,95,85
Spellcast,ravencrest,1496,mage,frost,33,18,15
Нонекс,soulflayer,1496,mage,frost,118,59,59
Fyriel,burning-legion,1495,mage,frost,42,20,22
Митгори,gordunni,1493,mage,frost,74,39,35
Trais,blackrock,1492,mage,frost,57,35,22
Lukewizard,twisting-nether,1492,mage,frost,110,63,47
Aeternitaz,outland,1492,mage,frost,53,28,25
Ímnotback,outland,1492,mage,frost,438,224,214
Averus,outland,1490,mage,frost,36,21,15
Velâska,malganis,1490,mage,frost,136,79,57
Drmng,stormscale,1490,mage,frost,39,18,21
Мозифрост,gordunni,1490,mage,frost,62,23,39
Jakuub,outland,1489,mage,frost,42,23,19
Сосулькина,gordunni,1488,mage,frost,95,50,45
Qqpwn,ragnaros,1488,mage,frost,76,38,38
Chicke,outland,1486,mage,frost,64,33,31
Свдпро,deathguard,1486,mage,frost,82,40,42
Kokenn,hyjal,1485,mage,frost,114,61,53
Файрусх,blackscar,1484,mage,frost,72,41,31
Pronyma,outland,1484,mage,frost,84,39,45
Kleptocracy,stormscale,1483,mage,frost,52,24,28
Lesoleil,archimonde,1479,mage,frost,48,28,20
Wukidiwn,draenor,1478,mage,frost,107,49,58
Lÿra,chants-éternels,1478,mage,frost,42,19,23
Drandis,blackmoore,1478,mage,frost,36,16,20
Kelthuzed,twisting-nether,1477,mage,frost,54,28,26
Frostspree,wildhammer,1476,mage,frost,55,30,25
Octtmiss,twisting-nether,1476,mage,frost,33,17,16
Alkhazzar,defias-brotherhood,1476,mage,frost,474,234,240
Pølåris,outland,1475,mage,frost,126,64,62
Maxik,outland,1474,mage,frost,63,31,32
Spamblink,archimonde,1474,mage,frost,63,18,45
Lyès,uldaman,1473,mage,frost,42,21,21
Vannq,silvermoon,1473,mage,frost,124,55,69
Zaruna,arathor,1472,mage,frost,87,45,42
Sciren,nagrand,1471,mage,frost,31,16,15
Psika,kazzak,1470,mage,frost,162,78,84
Widmage,silvermoon,1469,mage,frost,140,63,77
Destrech,aggra-português,1467,mage,frost,36,21,15
Phenoxi,sylvanas,1466,mage,frost,72,36,36
Lepeps,silvermoon,1465,mage,frost,59,22,37
Фемна,soulflayer,1464,mage,frost,166,87,79
Stace,area-52,1463,mage,frost,54,19,35
Caststuffatu,sylvanas,1462,mage,frost,125,62,63
Lusionator,defias-brotherhood,1461,mage,frost,112,63,49
Warwizz,sanguino,1461,mage,frost,57,30,27
Grumpyorc,ravencrest,1461,mage,frost,305,151,154
Рэймонд,howling-fjord,1461,mage,frost,47,19,28
Snakebit,kazzak,1459,mage,frost,168,84,84
Saucise,hyjal,1459,mage,frost,102,51,51
Katarapower,silvermoon,1458,mage,frost,488,245,243
Kraliz,ysondre,1458,mage,frost,59,24,35
Novalia,wrathbringer,1457,mage,frost,131,70,61
Аваон,deathguard,1457,mage,frost,153,76,77
Derbomber,guldan,1456,mage,frost,53,22,31
Aceripper,ragnaros,1455,mage,frost,182,96,86
Diji,the-maelstrom,1455,mage,frost,36,17,19
Spellfaker,drakthul,1454,mage,frost,27,18,9
Анзот,howling-fjord,1453,mage,frost,82,47,35
Knoxvit,tarren-mill,1453,mage,frost,63,35,28
Ia,kirin-tor,1452,mage,frost,46,25,21
Luxxurious,xavius,1451,mage,frost,58,27,31
Sangumage,silvermoon,1451,mage,frost,54,25,29
Мэлфариус,soulflayer,1450,mage,frost,42,23,19
Stillfrostin,blackrock,1449,mage,frost,99,59,40
Necizbored,tarren-mill,1449,mage,frost,61,33,28
Smöked,tarren-mill,1449,mage,frost,383,198,185
Plætinum,ravencrest,1449,mage,frost,216,108,108
Dllarky,drakthul,1448,mage,frost,48,24,24
Widurr,burning-legion,1448,mage,frost,66,31,35
Zenó,blackrock,1448,mage,frost,42,17,25
Badcouz,dalaran,1447,mage,frost,41,21,20
Woorm,sylvanas,1446,mage,frost,76,44,32
Tôke,kaelthas,1446,mage,frost,114,61,53
Bebarz,darksorrow,1446,mage,frost,184,96,88
Цепнойпёс,goldrinn,1446,mage,frost,46,24,22
Azadan,pozzo-delleternità,1446,mage,frost,47,23,24
Старкскрим,gordunni,1445,mage,frost,130,60,70
Gàtsby,outland,1444,mage,frost,138,73,65
Datakrigern,tarren-mill,1444,mage,frost,81,41,40
Summermàge,ravencrest,1444,mage,frost,60,29,31
Енотмаг,gordunni,1443,mage,frost,100,52,48
Afklow,pozzo-delleternità,1442,mage,frost,39,21,18
Кварийм,howling-fjord,1442,mage,frost,133,67,66
Darkseidez,alonsus,1442,mage,frost,84,41,43
Eldariel,ravencrest,1442,mage,frost,83,39,44
Rusdorcito,frostwhisper,1442,mage,frost,51,18,33
Gyanni,blackmoore,1441,mage,frost,30,17,13
Учительйода,ashenvale,1440,mage,frost,96,54,42
Frostvirgin,twisting-nether,1438,mage,frost,54,24,30
Sukky,todeswache,1438,mage,frost,82,36,46
Kèj,kazzak,1438,mage,frost,69,30,39
Tìktokthot,outland,1437,mage,frost,24,15,9
Sippebób,laughing-skull,1437,mage,frost,100,55,45
Bengeezuz,silvermoon,1437,mage,frost,42,15,27
Shnitz,stormscale,1436,mage,frost,24,15,9
Ceillech,blackrock,1436,mage,frost,112,52,60
Pipihu,silvermoon,1435,mage,frost,72,37,35
Инкрионити,gordunni,1433,mage,frost,29,16,13
Firemindz,argent-dawn,1430,mage,frost,24,15,9
Surlancealot,outland,1428,mage,frost,95,42,53
Пиньон,borean-tundra,1425,mage,frost,36,21,15
Дарнивил,gordunni,1425,mage,frost,218,110,108
Фростидзе,gordunni,1425,mage,frost,90,42,48
Aileean,burning-legion,1422,mage,frost,125,71,54
Gûl,kazzak,1422,mage,frost,30,15,15
Fontaíne,doomhammer,1422,mage,frost,30,15,15
Eclyftw,blackmoore,1422,mage,frost,60,29,31
Tainted,eredar,1422,mage,frost,89,43,46
Koreanbbq,kazzak,1422,mage,frost,65,31,34
Wslyx,dun-morogh,1422,mage,frost,84,32,52
Däpper,ragnaros,1421,mage,frost,72,33,39
Destruct,doomhammer,1420,mage,frost,257,137,120
Snîrs,thrall,1420,mage,frost,36,17,19
Reblink,draenor,1420,mage,frost,36,15,21
Pixlet,kazzak,1420,mage,frost,66,25,41
Drfröst,kazzak,1419,mage,frost,24,15,9
Tàylerdarden,nemesis,1419,mage,frost,136,65,71
Bantos,khadgar,1419,mage,frost,66,27,39
Iceiceice,stormscale,1418,mage,frost,54,30,24
Spellsteal,antonidas,1418,mage,frost,135,65,70
Filoux,frostwolf,1418,mage,frost,44,18,26
Гатмир,gordunni,1417,mage,frost,375,187,188
Hellionblast,ragnaros,1416,mage,frost,30,15,15
Frèézê,frostwolf,1416,mage,frost,54,26,28
Сэрруденкент,soulflayer,1414,mage,frost,42,23,19
Ilovedana,dun-modr,1414,mage,frost,56,16,40
Саккер,gordunni,1413,mage,frost,30,15,15
Hexmath,tarren-mill,1413,mage,frost,30,15,15
Messatsux,tarren-mill,1411,mage,frost,30,15,15
Dïabolike,archimonde,1410,mage,frost,96,55,41
Zionw,frostwolf,1410,mage,frost,121,60,61
Dzikk,silvermoon,1410,mage,frost,97,46,51
Umaguma,elune,1409,mage,frost,100,50,50
Phaynz,cthun,1408,mage,frost,42,25,17
Seyece,silvermoon,1408,mage,frost,59,34,25
Ãzi,ravencrest,1406,mage,frost,46,28,18
Манднесс,azuregos,1406,mage,frost,37,21,16
Лрее,gordunni,1406,mage,frost,95,46,49
Aern,sinstralis,1405,mage,frost,53,25,28
Викликс,borean-tundra,1404,mage,frost,94,53,41
Illius,kelthuzad,1404,mage,frost,198,101,97
Grismage,twisting-nether,1404,mage,frost,60,21,39
Fistersfrizz,aegwynn,1403,mage,frost,64,36,28
Karliah,azshara,1403,mage,frost,50,24,26
Ayoubz,outland,1403,mage,frost,35,16,19
Sixx,aegwynn,1402,mage,frost,152,76,76
Shagee,stormscale,1399,mage,frost,30,16,14
Iulie,kazzak,1398,mage,frost,220,111,109
Crackheads,hyjal,1398,mage,frost,96,48,48
Kippercarry,outland,1398,mage,frost,30,15,15
Pluribusunum,outland,1398,mage,frost,38,17,21
Justleblanc,dalaran,1397,mage,frost,106,53,53
Flavie,hellfire,1395,mage,frost,35,24,11
Hernêise,silvermoon,1395,mage,frost,185,94,91
Elynaé,draenor,1395,mage,frost,70,33,37
Tìnder,tarren-mill,1394,mage,frost,161,84,77
Raikøn,blackmoore,1394,mage,frost,56,29,27
Mdog,stormreaver,1393,mage,frost,102,55,47
Azkarr,stormscale,1393,mage,frost,65,34,31
Archyl,kazzak,1393,mage,frost,30,15,15
Apócalyptic,tarren-mill,1392,mage,frost,76,44,32
Hoodmago,blackrock,1392,mage,frost,53,30,23
Manôu,kirin-tor,1391,mage,frost,60,24,36
Faunas,kazzak,1390,mage,frost,115,58,57
Khivax,twisting-nether,1390,mage,frost,126,55,71
Rodatudo,ravencrest,1389,mage,frost,207,96,111
Wormhole,kazzak,1389,mage,frost,42,17,25
Quilava,ghostlands,1388,mage,frost,61,34,27
Esculapìo,nemesis,1386,mage,frost,343,179,164
Vignoni,the-maelstrom,1382,mage,frost,130,74,56
Pyro,eldrethalas,1382,mage,frost,99,48,51
Icé,auchindoun,1382,mage,frost,80,33,47
Nevaehine,ravencrest,1381,mage,frost,295,152,143
Leonora,blackhand,1380,mage,frost,60,22,38
Nøw,kazzak,1378,mage,frost,39,16,23
Shêepwithme,ravencrest,1376,mage,frost,35,20,15
Sleîhg,sanguino,1376,mage,frost,82,40,42
Spiridrell,silvermoon,1375,mage,frost,51,17,34
Remantin,blackrock,1374,mage,frost,110,53,57
Lsdt,stormscale,1372,mage,frost,42,16,26
Oizar,hyjal,1371,mage,frost,48,25,23
Shüri,kazzak,1370,mage,frost,84,46,38
Xîzy,outland,1370,mage,frost,28,15,13
Javelintouch,eldrethalas,1370,mage,frost,45,22,23
Nodmg,nefarian,1368,mage,frost,45,29,16
Nellý,stormreaver,1368,mage,frost,30,18,12
Hayaka,sanguino,1367,mage,frost,125,61,64
Орижн,howling-fjord,1366,mage,frost,53,29,24
Àrtix,silvermoon,1364,mage,frost,30,16,14
Iceorb,azshara,1364,mage,frost,114,52,62
Arlunea,blackmoore,1364,mage,frost,50,20,30
Laenadria,argent-dawn,1363,mage,frost,121,55,66
Фрайбл,gordunni,1361,mage,frost,31,16,15
Cheerió,aggramar,1360,mage,frost,254,118,136
Feuererdnuss,blackhand,1359,mage,frost,41,18,23
Ibexia,blackrock,1358,mage,frost,53,19,34
Ymirë,khaz-modan,1357,mage,frost,51,22,29
Cardioexpert,ravencrest,1356,mage,frost,25,15,10
Иксайс,soulflayer,1356,mage,frost,57,24,33
Abolf,twisting-nether,1354,mage,frost,58,31,27
Kyraja,arthas,1354,mage,frost,72,31,41
Гунмаказ,soulflayer,1353,mage,frost,58,34,24
Tyronesbone,stormscale,1352,mage,frost,47,24,23
Alktraz,outland,1352,mage,frost,102,48,54
Tuxedo,thrall,1349,mage,frost,31,15,16
Inaruy,hyjal,1347,mage,frost,26,15,11
Skarxaa,sanguino,1347,mage,frost,89,49,40
Sylênna,kazzak,1347,mage,frost,60,30,30
Corpusqq,eredar,1347,mage,frost,54,26,28
Shroomie,eredar,1346,mage,frost,214,107,107
Morphees,twisting-nether,1345,mage,frost,42,25,17
Zwölfte,outland,1345,mage,frost,148,84,64
Bolesnimage,draenor,1345,mage,frost,59,33,26
Manvo,bloodscalp,1345,mage,frost,60,23,37
Nightplays,sylvanas,1344,mage,frost,54,29,25
Preí,archimonde,1344,mage,frost,37,15,22
Shédudé,silvermoon,1343,mage,frost,36,19,17
Dabka,argent-dawn,1341,mage,frost,378,188,190
Daneliam,outland,1341,mage,frost,61,30,31
Dmmeforcam,archimonde,1340,mage,frost,26,15,11
Jokiss,draenor,1339,mage,frost,114,57,57
Лемозюка,gordunni,1338,mage,frost,24,14,10
Iggilaus,blackhand,1338,mage,frost,487,245,242
Medium,der-rat-von-dalaran,1337,mage,frost,96,52,44
Cinoox,blackrock,1337,mage,frost,34,15,19
Crooja,antonidas,1337,mage,frost,45,15,30
Glöden,ravencrest,1336,mage,frost,44,20,24
Хоф,deathguard,1336,mage,frost,53,24,29
Xläderz,ravencrest,1335,mage,frost,24,14,10
Kaaguraa,ravencrest,1335,mage,frost,335,173,162
Моритакаа,gordunni,1335,mage,frost,172,86,86
Frostytutes,ragnaros,1335,mage,frost,59,28,31
Mfnz,stormreaver,1335,mage,frost,41,18,23
Tirenia,bloodfeather,1335,mage,frost,41,15,26
Spelltastíc,blackmoore,1333,mage,frost,24,14,10
Ledenata,twisting-nether,1333,mage,frost,75,28,47
Navolav,turalyon,1332,mage,frost,24,14,10
Imbatto,quelthalas,1332,mage,frost,42,20,22
Badphaz,frostmane,1331,mage,frost,30,16,14
Маушко,soulflayer,1331,mage,frost,170,87,83
Lovma,doomhammer,1331,mage,frost,54,27,27
Shinzel,hyjal,1331,mage,frost,64,26,38
Sqwiz,outland,1330,mage,frost,96,41,55
Suidas,auchindoun,1329,mage,frost,118,58,60
Жемчужина,eversong,1329,mage,frost,48,23,25
Осмотрфанеры,howling-fjord,1329,mage,frost,90,41,49
Atixx,aegwynn,1329,mage,frost,54,18,36
Кройзис,howling-fjord,1328,mage,frost,80,46,34
Iceterror,ravencrest,1328,mage,frost,76,40,36
Trìxì,draenor,1328,mage,frost,42,17,25
Xânârchy,minahonda,1327,mage,frost,84,42,42
Игрдлпдров,gordunni,1327,mage,frost,72,34,38
Mogettemagic,ysondre,1325,mage,frost,107,53,54
Magegodx,rexxar,1325,mage,frost,81,39,42
Nuvx,ravencrest,1325,mage,frost,44,19,25
Braxxorz,chamber-of-aspects,1324,mage,frost,59,38,21
Veemi,blackmoore,1324,mage,frost,125,63,62
Zanazanelor,twisting-nether,1324,mage,frost,42,21,21
Caesarclown,silvermoon,1324,mage,frost,171,84,87
Bumboozling,kazzak,1324,mage,frost,30,14,16
Westellion,stormreaver,1323,mage,frost,41,20,21
Badguy,arathor,1323,mage,frost,30,14,16
Iìíìíìíìíl,ravencrest,1323,mage,frost,47,19,28
Nyskal,tarren-mill,1322,mage,frost,53,24,29
Sused,outland,1321,mage,frost,30,16,14
Morozuvko,tarren-mill,1321,mage,frost,30,15,15
Ewina,twisting-nether,1320,mage,frost,30,16,14
Pruneau,hyjal,1320,mage,frost,101,52,49
Texita,sylvanas,1319,mage,frost,83,42,41
Icexx,outland,1319,mage,frost,30,15,15
Frostyfart,tarren-mill,1319,mage,frost,30,15,15
Nïo,ravencrest,1318,mage,frost,36,19,17
Rektd,blackhand,1317,mage,frost,222,110,112
Vioulette,elune,1317,mage,frost,66,27,39
Meydoum,archimonde,1316,mage,frost,30,17,13
Tarkún,dun-modr,1316,mage,frost,104,58,46
Лутиум,howling-fjord,1315,mage,frost,223,121,102
Ramires,xavius,1313,mage,frost,24,15,9
Iceym,ravencrest,1313,mage,frost,41,17,24
Bænoß,ravencrest,1312,mage,frost,30,16,14
Фиджарь,soulflayer,1312,mage,frost,165,83,82
Jemppai,outland,1312,mage,frost,51,19,32
Тачмахал,soulflayer,1309,mage,frost,98,43,55
Левченкопро,soulflayer,1308,mage,frost,261,132,129
Immobilizer,eredar,1308,mage,frost,138,68,70
Quail,anubarak,1308,mage,frost,225,109,116
Ромзесх,howling-fjord,1307,mage,frost,18,14,4
Thry,bronzebeard,1307,mage,frost,146,69,77
Aûrûm,silvermoon,1306,mage,frost,90,44,46
Vrajitöru,doomhammer,1304,mage,frost,26,16,10
Zisseron,frostmane,1303,mage,frost,42,20,22
Animaze,argent-dawn,1302,mage,frost,185,102,83
Keathlin,hyjal,1302,mage,frost,55,26,29
Magitron,wildhammer,1301,mage,frost,35,18,17
Frostburns,stormscale,1300,mage,frost,44,20,24
Cuishle,kaelthas,1299,mage,frost,36,14,22
Psychosiss,kazzak,1298,mage,frost,49,27,22
Zice,antonidas,1298,mage,frost,61,27,34
Dyx,nemesis,1297,mage,frost,90,42,48
Nuryielle,blackmoore,1296,mage,frost,36,18,18
Momolamoto,hyjal,1294,mage,frost,108,57,51
Xaerow,archimonde,1294,mage,frost,42,22,20
Kleini,die-aldor,1291,mage,frost,49,28,21
Winterblues,frostmourne,1291,mage,frost,36,20,16
Tjayy,kazzak,1291,mage,frost,105,48,57
Beardyman,haomarush,1291,mage,frost,48,20,28
Odisea,dun-modr,1290,mage,frost,30,17,13
Fractox,ysondre,1290,mage,frost,166,84,82
Estupen,sanguino,1290,mage,frost,67,33,34
Tradez,norgannon,1290,mage,frost,60,26,34
Lemonshelo,archimonde,1289,mage,frost,146,73,73
Kundry,tarren-mill,1289,mage,frost,42,16,26
Frostjävel,grim-batol,1288,mage,frost,46,24,22
Endymîøn,aegwynn,1288,mage,frost,33,15,18
Narzoul,ysondre,1285,mage,frost,88,50,38
Selith,magtheridon,1284,mage,frost,30,15,15
Voldemort,bronzebeard,1284,mage,frost,51,24,27
Nups,ravencrest,1284,mage,frost,139,63,76
Gliffy,terokkar,1283,mage,frost,119,66,53
Bengé,ragnaros,1283,mage,frost,40,22,18
Zoubaz,archimonde,1281,mage,frost,43,21,22
Гаразлик,howling-fjord,1278,mage,frost,198,92,106
Ilikepoly,blackmoore,1277,mage,frost,79,42,37
Xhal,hyjal,1277,mage,frost,36,18,18
Хадъюич,grom,1277,mage,frost,36,18,18
Orelox,kazzak,1277,mage,frost,35,14,21
Êgôn,perenolde,1276,mage,frost,35,18,17
Deepfeed,ravencrest,1275,mage,frost,20,14,6
Lovësosa,hyjal,1275,mage,frost,59,28,31
Vathalis,zuluhed,1274,mage,frost,143,65,78
Ellyson,silvermoon,1273,mage,frost,39,16,23
Шанлис,gordunni,1272,mage,frost,30,16,14
Silvariy,stormscale,1272,mage,frost,142,71,71
Funakin,blackrock,1272,mage,frost,88,38,50
Chread,bronze-dragonflight,1272,mage,frost,42,15,27
Teuboku,ysondre,1271,mage,frost,43,27,16
Frozenwisp,stormrage,1271,mage,frost,83,49,34
Fleurdelacur,ravencrest,1270,mage,frost,75,41,34
Asteria,twisting-nether,1268,mage,frost,190,91,99
Amarántha,kazzak,1266,mage,frost,30,15,15
Jackin,burning-legion,1265,mage,frost,95,45,50
Вельдрик,soulflayer,1264,mage,frost,232,118,114
Vaessi,doomhammer,1263,mage,frost,29,14,15
Dabina,sanguino,1261,mage,frost,129,63,66
Fleqs,antonidas,1258,mage,frost,37,18,19
Zoba,sylvanas,1258,mage,frost,47,18,29
Darríck,argent-dawn,1258,mage,frost,42,14,28
Suikune,twisting-nether,1253,mage,frost,30,20,10
Popixx,magtheridon,1253,mage,frost,96,43,53
Tacto,ravencrest,1252,mage,frost,385,197,188
Metaboi,ragnaros,1252,mage,frost,124,58,66
Kapueca,jaedenar,1251,mage,frost,63,42,21
Lupuus,anubarak,1251,mage,frost,56,26,30
Firehasse,draenor,1250,mage,frost,120,64,56
Sikaia,twisting-nether,1250,mage,frost,99,47,52
Cantbelieve,sylvanas,1250,mage,frost,36,16,20
ßooh,kazzak,1249,mage,frost,75,40,35
Sickofme,blackmoore,1248,mage,frost,24,13,11
Ryydee,silvermoon,1248,mage,frost,625,314,311
Dríme,ravencrest,1248,mage,frost,30,14,16
Bambaga,kazzak,1248,mage,frost,66,27,39
Phonkim,stormscale,1247,mage,frost,24,13,11
Abruaa,tarren-mill,1246,mage,frost,18,13,5
Schaap,tarren-mill,1245,mage,frost,18,13,5
Apic,blackrock,1245,mage,frost,29,19,10
Sàltym,ravencrest,1245,mage,frost,24,13,11
Bceps,stormscale,1245,mage,frost,66,35,31
Pwntt,terenas,1245,mage,frost,183,87,96
Wartheur,sanguino,1245,mage,frost,74,33,41
Isenhour,frostmane,1245,mage,frost,35,14,21
Ehren,ravencrest,1243,mage,frost,38,16,22
Bokvar,twisting-nether,1242,mage,frost,54,29,25
Faycia,blackhand,1242,mage,frost,107,49,58
Oiklo,eitrigg,1242,mage,frost,61,25,36
Njl,blackmoore,1241,mage,frost,24,13,11
Máurus,antonidas,1241,mage,frost,66,25,41
Kleisli,draenor,1240,mage,frost,30,13,17
Rafaeala,argent-dawn,1239,mage,frost,217,116,101
Scoxywoxy,ragnaros,1239,mage,frost,80,40,40
Блья,howling-fjord,1238,mage,frost,91,53,38
Titanshao,silvermoon,1237,mage,frost,24,16,8
Bossgb,twisting-nether,1237,mage,frost,75,40,35
Дырявка,galakrond,1237,mage,frost,84,37,47
Вайконд,howling-fjord,1236,mage,frost,50,23,27
Maeflix,aegwynn,1235,mage,frost,29,17,12
Magicppl,kazzak,1235,mage,frost,32,15,17
Wumz,blackrock,1233,mage,frost,24,13,11
Camaeel,aegwynn,1233,mage,frost,32,14,18
Gameboycolor,ravencrest,1233,mage,frost,36,13,23
Jokèr,silvermoon,1232,mage,frost,31,17,14
Isolia,silvermoon,1232,mage,frost,47,21,26
Colder,hyjal,1231,mage,frost,36,15,21
Mordy,stormreaver,1230,mage,frost,26,15,11
Cumburlok,silvermoon,1230,mage,frost,30,13,17
Irreversal,ravencrest,1227,mage,frost,149,78,71
Heavyfire,kazzak,1226,mage,frost,53,27,26
Juicedup,blackrock,1226,mage,frost,30,13,17
Aelire,die-aldor,1226,mage,frost,57,23,34
Zevúlòs,ravencrest,1225,mage,frost,84,50,34
Pinkis,darkmoon-faire,1225,mage,frost,223,116,107
Stryee,ragnaros,1225,mage,frost,30,14,16
Seelengott,onyxia,1224,mage,frost,322,158,164
Zeusmon,ragnaros,1224,mage,frost,113,52,61
Pyroden,stormscale,1224,mage,frost,42,18,24
Хблэйз,howling-fjord,1222,mage,frost,36,14,22
Boredpeon,burning-legion,1221,mage,frost,102,52,50
Nazø,archimonde,1221,mage,frost,138,67,71
Eléaena,argent-dawn,1221,mage,frost,30,13,17
Edelvise,azjolnerub,1219,mage,frost,102,39,63
Magicuze,argent-dawn,1218,mage,frost,48,22,26
Aeternà,elune,1215,mage,frost,60,28,32
Misskity,blackrock,1215,mage,frost,42,18,24
Deano,outland,1214,mage,frost,24,14,10
Ákyraz,blackrock,1214,mage,frost,26,14,12
Trøll,nemesis,1212,mage,frost,24,13,11
Klésh,nemesis,1210,mage,frost,24,13,11
Lenycz,burning-blade,1210,mage,frost,87,42,45
Dollzer,khaz-modan,1209,mage,frost,24,13,11
Криолетта,gordunni,1209,mage,frost,90,40,50
Bublesk,outland,1208,mage,frost,24,13,11
Jaghahah,tarren-mill,1206,mage,frost,114,62,52
Nandie,stormreaver,1206,mage,frost,38,19,19
Thoria,sylvanas,1205,mage,frost,116,54,62
Olivaresa,ravencrest,1205,mage,frost,50,17,33
Saphiregos,dalaran,1204,mage,frost,273,139,134
Lole,uldum,1204,mage,frost,108,54,54
Zagori,sylvanas,1204,mage,frost,103,47,56
Momotemp,emerald-dream,1203,mage,frost,120,61,59
Qwixxis,sylvanas,1201,mage,frost,125,64,61
Noviina,argent-dawn,1198,mage,frost,100,45,55
Sheeppuncher,drakthul,1198,mage,frost,42,13,29
Zvuta,sanguino,1197,mage,frost,45,29,16
Gacosane,chamber-of-aspects,1197,mage,frost,129,59,70
Ananaskana,ragnaros,1196,mage,frost,36,23,13
Séptímus,kazzak,1195,mage,frost,64,28,36
Kosso,twisting-nether,1195,mage,frost,88,36,52
Trîîck,nethersturm,1194,mage,frost,23,13,10
Jodiefroster,bronzebeard,1194,mage,frost,82,44,38
Шеллестун,soulflayer,1192,mage,frost,55,28,27
Phaege,defias-brotherhood,1192,mage,frost,32,15,17
Shâykó,sylvanas,1191,mage,frost,26,14,12
Søphiâ,thrall,1191,mage,frost,72,38,34
Flamya,stormscale,1190,mage,frost,59,27,32
Iceyvein,antonidas,1190,mage,frost,36,13,23
Mínêrvâ,blackrock,1189,mage,frost,28,15,13
Vanser,kazzak,1189,mage,frost,36,13,23
Вескнам,lich-king,1188,mage,frost,84,36,48
Синийлед,galakrond,1187,mage,frost,168,74,94
Brutal,thrall,1187,mage,frost,36,14,22
Брюнхильда,deepholm,1186,mage,frost,53,21,32
Сибиди,gordunni,1185,mage,frost,24,13,11
Salvijä,dun-modr,1185,mage,frost,47,22,25
Magicdingo,lightnings-blade,1183,mage,frost,36,13,23
Claramvi,lightnings-blade,1183,mage,frost,50,18,32
Vermilia,darksorrow,1181,mage,frost,144,63,81
Хируэль,gordunni,1180,mage,frost,98,47,51
Turandot,ravencrest,1178,mage,frost,42,28,14
Scaless,stormscale,1176,mage,frost,77,37,40
Yenkonidas,blackmoore,1175,mage,frost,54,23,31
Этридемус,howling-fjord,1175,mage,frost,71,28,43
Shivah,onyxia,1173,mage,frost,148,65,83
Niivel,ysondre,1172,mage,frost,178,100,78
Hagiko,archimonde,1171,mage,frost,57,31,26
Rutemarlene,ravencrest,1171,mage,frost,88,45,43
Baravar,blackrock,1171,mage,frost,65,28,37
Sephis,anubarak,1170,mage,frost,50,15,35
Cns,tarren-mill,1167,mage,frost,39,19,20
Zzombi,sylvanas,1166,mage,frost,81,39,42
Augustusi,argent-dawn,1165,mage,frost,72,26,46
Морозящий,howling-fjord,1162,mage,frost,165,84,81
Mutly,kazzak,1161,mage,frost,38,23,15
Latiny,blackrock,1159,mage,frost,159,78,81
Broduy,draenor,1159,mage,frost,156,76,80
Icyshot,blackhand,1159,mage,frost,33,16,17
Rayiah,blackmoore,1159,mage,frost,60,24,36
Fôôxy,aegwynn,1157,mage,frost,88,40,48
Machydapha,outland,1157,mage,frost,36,15,21
Tylic,doomhammer,1157,mage,frost,54,20,34
Ón,burning-steppes,1154,mage,frost,37,17,20
Zyxiie,sylvanas,1154,mage,frost,105,41,64
Balthezaj,defias-brotherhood,1151,mage,frost,18,12,6
Айсбоунт,eversong,1151,mage,frost,49,27,22
Sainth,sanguino,1151,mage,frost,24,12,12
Amicuta,ravencrest,1150,mage,frost,60,30,30
Procahontas,ravencrest,1150,mage,frost,30,12,18
Gladxp,outland,1149,mage,frost,24,12,12
Arcticfury,ravencrest,1149,mage,frost,24,12,12
Panlong,twisting-nether,1149,mage,frost,43,21,22
Aterso,azshara,1149,mage,frost,27,13,14
Rusto,hellscream,1149,mage,frost,36,13,23
Archilól,drakthul,1148,mage,frost,30,14,16
Quincy,frostwolf,1148,mage,frost,90,41,49
Gedzi,silvermoon,1147,mage,frost,36,24,12
Targaryen,haomarush,1147,mage,frost,22,13,9
Чистокрут,gordunni,1146,mage,frost,36,12,24
Jodíefroster,doomhammer,1145,mage,frost,24,12,12
Alytà,ravencrest,1145,mage,frost,24,12,12
Goukí,drakthul,1144,mage,frost,18,12,6
Frostmyst,outland,1143,mage,frost,30,12,18
Tiltedpapi,ravencrest,1142,mage,frost,46,24,22
Магсимум,ashenvale,1142,mage,frost,37,18,19
Qulinx,kazzak,1142,mage,frost,29,13,16
Hotafazz,ravencrest,1141,mage,frost,57,21,36
Pariseta,ragnaros,1140,mage,frost,29,15,14
Maggresive,sylvanas,1140,mage,frost,30,15,15
Valkruz,nemesis,1140,mage,frost,30,12,18
Iceicebáby,draenor,1139,mage,frost,36,17,19
Elmaestró,aegwynn,1139,mage,frost,49,16,33
Sheepster,sylvanas,1138,mage,frost,49,28,21
Flakeh,outland,1138,mage,frost,122,55,67
Illastrov,silvermoon,1138,mage,frost,30,12,18
Yvonnita,chamber-of-aspects,1137,mage,frost,18,12,6
Sásen,blackrock,1137,mage,frost,93,41,52
Miidi,doomhammer,1136,mage,frost,48,29,19
Serclulz,ravencrest,1135,mage,frost,23,12,11
Oathkeepper,silvermoon,1135,mage,frost,124,60,64
Escobar,frostmane,1135,mage,frost,48,16,32
Sântillius,twisting-nether,1134,mage,frost,42,25,17
Коласольдом,gordunni,1134,mage,frost,42,19,23
Fairysoul,ravencrest,1133,mage,frost,59,30,29
Souleh,ravencrest,1133,mage,frost,24,12,12
Айсвеном,gordunni,1133,mage,frost,132,64,68
Blinkfloyd,blackmoore,1133,mage,frost,39,15,24
Kanjani,antonidas,1132,mage,frost,36,12,24
Erzà,todeswache,1131,mage,frost,83,47,36
Dobbite,archimonde,1131,mage,frost,30,13,17
Iamslow,sylvanas,1130,mage,frost,18,12,6
Adunaphel,blackmoore,1129,mage,frost,56,31,25
Unpleasant,hyjal,1129,mage,frost,36,15,21
Driana,dragonmaw,1127,mage,frost,18,12,6
Tomuru,draenor,1127,mage,frost,74,44,30
Shakamage,grim-batol,1127,mage,frost,93,48,45
Laggynoob,ravencrest,1124,mage,frost,24,12,12
Иньфанта,deathguard,1124,mage,frost,73,30,43
Naote,blackhand,1122,mage,frost,24,12,12
Brandonjames,ragnaros,1122,mage,frost,32,14,18
Thorstäin,ragnaros,1121,mage,frost,24,12,12
Длинныеухи,blackscar,1120,mage,frost,42,17,25
Darrnor,hyjal,1119,mage,frost,20,14,6
Lêgólás,blackmoore,1119,mage,frost,24,12,12
Bolthen,uldum,1119,mage,frost,36,13,23
Tiefkühler,norgannon,1118,mage,frost,63,36,27
Луциаз,gordunni,1117,mage,frost,116,62,54
Djblink,twisting-nether,1113,mage,frost,43,22,21
Qtiepatootie,silvermoon,1113,mage,frost,202,103,99
Lenali,burning-legion,1111,mage,frost,42,18,24
Rüja,aegwynn,1110,mage,frost,24,12,12
Roey,defias-brotherhood,1110,mage,frost,30,14,16
Faithseed,dun-modr,1108,mage,frost,60,34,26
Мрперут,eversong,1108,mage,frost,245,132,113
Lylla,cthun,1107,mage,frost,48,14,34
Кельтузат,azuregos,1106,mage,frost,30,15,15
Devon,haomarush,1106,mage,frost,65,23,42
Килавый,eversong,1105,mage,frost,76,42,34
Roxarch,nordrassil,1105,mage,frost,66,24,42
Сайджена,howling-fjord,1105,mage,frost,66,22,44
Kótaranka,kazzak,1104,mage,frost,83,37,46
Vexperious,tarren-mill,1102,mage,frost,18,12,6
Arcáge,azjolnerub,1101,mage,frost,61,26,35
Blark,malygos,1099,mage,frost,30,13,17
Ørcan,azshara,1098,mage,frost,129,57,72
Treyz,tichondrius,1098,mage,frost,30,12,18
Aoes,twisting-nether,1097,mage,frost,29,12,17
Kalyipso,blackrock,1097,mage,frost,48,14,34
Дивеансерт,blackscar,1096,mage,frost,72,30,42
Arogance,archimonde,1094,mage,frost,72,39,33
Kyrox,ysondre,1090,mage,frost,78,34,44
Prinskoekie,twisting-nether,1090,mage,frost,191,79,112
Соорка,gordunni,1090,mage,frost,33,12,21
Melkyore,archimonde,1088,mage,frost,57,24,33
Нефростмаг,gordunni,1087,mage,frost,33,14,19
Nintho,ysondre,1086,mage,frost,42,21,21
Саназэр,howling-fjord,1086,mage,frost,84,39,45
Æyhvr,hyjal,1084,mage,frost,46,26,20
Euklid,ravencrest,1083,mage,frost,22,12,10
Goeb,kazzak,1083,mage,frost,35,14,21
Roughfked,silvermoon,1079,mage,frost,118,62,56
Kadsy,tarren-mill,1079,mage,frost,53,24,29
Юлианх,gordunni,1077,mage,frost,413,205,208
Tygaone,tirion,1076,mage,frost,112,54,58
Xenedra,twisting-nether,1074,mage,frost,56,21,35
Çxçx,dun-modr,1072,mage,frost,51,19,32
Iceinmyveinz,silvermoon,1072,mage,frost,42,14,28
Galdrari,sylvanas,1071,mage,frost,30,13,17
Ketem,dun-modr,1069,mage,frost,48,17,31
Nåzmyz,outland,1066,mage,frost,98,45,53
Yojimbot,archimonde,1065,mage,frost,48,15,33
Arcanik,archimonde,1065,mage,frost,49,14,35
Дедамаг,eversong,1064,mage,frost,36,18,18
Loriana,tichondrius,1063,mage,frost,34,12,22
Ryzea,ravencrest,1060,mage,frost,41,24,17
Xèrec,ysondre,1058,mage,frost,36,12,24
Cexxar,kazzak,1057,mage,frost,48,18,30
Uknowhowwedu,aegwynn,1056,mage,frost,18,11,7
Gizzoo,draenor,1055,mage,frost,18,11,7
Decedé,dun-modr,1055,mage,frost,18,11,7
Tenetic,thrall,1055,mage,frost,20,11,9
Ramcoz,twisting-nether,1055,mage,frost,48,25,23
Sesseel,veklor,1055,mage,frost,48,22,26
Stümpy,ravencrest,1055,mage,frost,24,11,13
Síckmode,khadgar,1055,mage,frost,36,11,25
Ghosty,festung-der-stürme,1054,mage,frost,18,11,7
Grömit,drakthul,1053,mage,frost,18,11,7
Djeypoly,magtheridon,1053,mage,frost,18,11,7
Schtenen,silvermoon,1053,mage,frost,385,186,199
Xzp,der-rat-von-dalaran,1052,mage,frost,24,11,13
Bengtzzon,aszune,1052,mage,frost,73,29,44
Vel,grim-batol,1051,mage,frost,18,11,7
Drencast,hyjal,1051,mage,frost,24,11,13
Рамблз,gordunni,1051,mage,frost,24,11,13
Винилочка,deathguard,1051,mage,frost,24,11,13
Bamz,malganis,1051,mage,frost,24,11,13
Брэгг,gordunni,1051,mage,frost,38,16,22
Ízumi,stormscale,1051,mage,frost,30,11,19
Khanno,twisting-nether,1051,mage,frost,30,11,19
Primodious,kazzak,1050,mage,frost,30,11,19
Lalli,silvermoon,1049,mage,frost,24,11,13
Полеморв,soulflayer,1049,mage,frost,33,14,19
Chililol,dun-modr,1048,mage,frost,24,11,13
Myes,stormscale,1048,mage,frost,24,11,13
Obsidion,sporeggar,1047,mage,frost,42,13,29
Hasbe,kazzak,1046,mage,frost,30,11,19
Круксина,howling-fjord,1045,mage,frost,30,11,19
Férécide,ysondre,1045,mage,frost,30,11,19
Flocca,argent-dawn,1044,mage,frost,21,12,9
Dominos,medivh,1044,mage,frost,64,26,38
Bobbasor,defias-brotherhood,1044,mage,frost,37,14,23
Kyrn,zuljin,1044,mage,frost,30,11,19
Arcaneiun,nagrand,1043,mage,frost,30,11,19
Feuerquampfa,blackmoore,1042,mage,frost,22,12,10
Snowrain,chogall,1042,mage,frost,71,37,34
Razzìatore,pozzo-delleternità,1041,mage,frost,25,11,14
Blinklet,twisting-nether,1040,mage,frost,26,17,9
Deymo,dun-modr,1040,mage,frost,36,14,22
Fashes,sunstrider,1039,mage,frost,105,53,52
Khoshgele,draenor,1039,mage,frost,24,11,13
Vamelia,blackmoore,1038,mage,frost,124,60,64
Arkanieer,blackrock,1036,mage,frost,114,58,56
Aloona,malganis,1035,mage,frost,64,32,32
Gnoumen,shadowsong,1033,mage,frost,56,28,28
Ангилема,gordunni,1033,mage,frost,24,11,13
Ergonz,tarren-mill,1033,mage,frost,57,25,32
Clonefcf,sylvanas,1032,mage,frost,55,31,24
Madbad,auchindoun,1031,mage,frost,36,17,19
Êmmá,blackmoore,1029,mage,frost,72,36,36
Elesand,kazzak,1029,mage,frost,75,34,41
Smõóve,hyjal,1028,mage,frost,169,75,94
Hargun,the-maelstrom,1028,mage,frost,58,19,39
Aériza,silvermoon,1026,mage,frost,29,14,15
Shallari,argent-dawn,1026,mage,frost,30,11,19
Ptilouis,archimonde,1025,mage,frost,24,11,13
Skyra,les-sentinelles,1024,mage,frost,42,24,18
Zeeker,mannoroth,1022,mage,frost,18,11,7
Magjaw,twisting-nether,1020,mage,frost,54,26,28
Yasheaa,ysondre,1020,mage,frost,23,11,12
Dumbledores,aegwynn,1018,mage,frost,65,28,37
Furoranight,malfurion,1016,mage,frost,78,39,39
Edwiin,dun-morogh,1013,mage,frost,87,30,57
Shíntaro,stormscale,1013,mage,frost,41,12,29
Didub,outland,1010,mage,frost,60,26,34
Vurtnez,kazzak,1009,mage,frost,21,11,10
Qirko,drakthul,1009,mage,frost,72,26,46
Mystto,silvermoon,1008,mage,frost,54,31,23
Илайла,booty-bay,1007,mage,frost,15,12,3
Xblaze,balnazzar,1006,mage,frost,18,11,7
Thalaja,kazzak,1005,mage,frost,29,11,18
Экструдия,gordunni,1002,mage,frost,19,12,7
Бальзамон,eversong,1002,mage,frost,73,32,41
Tyrannith,argent-dawn,1000,mage,frost,91,39,52
Rillia,argent-dawn,999,mage,frost,27,12,15
Julieliphie,silvermoon,998,mage,frost,23,11,12
Forestie,silvermoon,992,mage,frost,80,37,43
Misscandy,doomhammer,991,mage,frost,133,62,71
Xakiha,kazzak,989,mage,frost,23,11,12
Éasy,blackmoore,985,mage,frost,20,11,9
Atreu,mazrigos,985,mage,frost,56,28,28
Maximilian,pozzo-delleternità,983,mage,frost,32,11,21
Nytram,terokkar,982,mage,frost,36,16,20
Kumakara,archimonde,981,mage,frost,24,12,12
Lunnysvet,blackrock,977,mage,frost,64,31,33
Chogger,blackmoore,974,mage,frost,42,24,18
Pinguíni,aegwynn,974,mage,frost,72,33,39
Dnt,twilights-hammer,974,mage,frost,24,11,13
Klita,blackmoore,974,mage,frost,83,36,47
Лордбелиал,soulflayer,973,mage,frost,48,21,27
Свиноколдун,howling-fjord,970,mage,frost,31,11,20
Tekuard,ravencrest,970,mage,frost,54,17,37
Gravetaxi,twisting-nether,966,mage,frost,84,29,55
Líquiçìty,ragnaros,965,mage,frost,81,27,54
Мэджиксул,grom,963,mage,frost,24,11,13
Ezzekkiel,elune,962,mage,frost,36,18,18
Fujitoras,khaz-modan,961,mage,frost,71,34,37
Acx,drakthul,960,mage,frost,18,10,8
Cosmostms,ravencrest,960,mage,frost,18,10,8
Oblív,ravencrest,960,mage,frost,24,10,14
Jesjess,ravencrest,960,mage,frost,24,10,14
Chucknoir,draenor,959,mage,frost,12,10,2
Инфолфг,gordunni,959,mage,frost,18,10,8
Reákan,ragnaros,959,mage,frost,18,10,8
Утрус,soulflayer,959,mage,frost,18,10,8
Spacehoe,stormscale,959,mage,frost,24,10,14
Тортикток,soulflayer,959,mage,frost,24,10,14
Gønzô,blackmoore,959,mage,frost,55,22,33
Джинетикс,deathguard,958,mage,frost,18,10,8
Onemanrave,ravencrest,957,mage,frost,24,10,14
Cunnus,stormreaver,955,mage,frost,18,10,8
Anthrex,drakthul,955,mage,frost,24,10,14
Сорримама,soulflayer,955,mage,frost,24,10,14
Poter,silvermoon,953,mage,frost,18,10,8
Hotpockets,die-aldor,953,mage,frost,18,10,8
Йяу,howling-fjord,953,mage,frost,54,19,35
Zedsdeadbaby,argent-dawn,952,mage,frost,139,66,73
Чобон,soulflayer,952,mage,frost,24,10,14
Райдзен,greymane,952,mage,frost,80,31,49
Broccosoup,kazzak,951,mage,frost,24,10,14
Xerv,thrall,951,mage,frost,24,10,14
Бабайбайкала,gordunni,951,mage,frost,36,10,26
Bakeren,frostmane,950,mage,frost,18,10,8
Dabzm,twisting-nether,950,mage,frost,24,10,14
Haljina,kazzak,949,mage,frost,255,117,138
Celdra,blackrock,949,mage,frost,24,10,14
Salem,neptulon,949,mage,frost,36,10,26
Shanny,argent-dawn,948,mage,frost,18,10,8
Madzía,ravencrest,947,mage,frost,61,33,28
Maybeblood,kazzak,946,mage,frost,28,11,17
Frisstana,outland,946,mage,frost,30,10,20
Evuryl,nemesis,944,mage,frost,24,10,14
Ignöre,stormscale,943,mage,frost,36,10,26
Lifemagic,chamber-of-aspects,942,mage,frost,139,70,69
Hakunaplz,twisting-nether,940,mage,frost,33,11,22
Тестостеронс,gordunni,939,mage,frost,18,10,8
Флоррет,gordunni,939,mage,frost,24,10,14
Héidi,area-52,938,mage,frost,18,10,8
Ference,tichondrius,936,mage,frost,18,10,8
Qwibbly,kazzak,935,mage,frost,18,11,7
Margow,die-arguswacht,930,mage,frost,24,13,11
Coldnight,uldum,930,mage,frost,67,35,32
Speedshatter,aegwynn,928,mage,frost,22,10,12
Soulspell,vashj,928,mage,frost,41,18,23
Ghostgivree,archimonde,927,mage,frost,69,35,34
Terlon,ragnaros,925,mage,frost,23,10,13
Døliprane,garona,918,mage,frost,89,45,44
Умелецмаг,gordunni,918,mage,frost,73,32,41
Boogiewizz,stormscale,916,mage,frost,46,16,30
Teals,turalyon,915,mage,frost,48,16,32
Jobarttrach,les-clairvoyants,911,mage,frost,270,135,135
Toxttr,drakthul,908,mage,frost,18,11,7
Флоой,gordunni,906,mage,frost,28,11,17
Сенсемилия,soulflayer,902,mage,frost,24,11,13
Sinanogan,draenor,899,mage,frost,48,17,31
Fadead,stormreaver,896,mage,frost,28,10,18
Cybercommand,blackmoore,895,mage,frost,102,51,51
Funnyzowie,minahonda,895,mage,frost,20,10,10
Няо,howling-fjord,894,mage,frost,20,10,10
Familyfrost,thunderhorn,894,mage,frost,24,10,14
Мистркорбэн,soulflayer,893,mage,frost,20,10,10
Çana,thrall,893,mage,frost,22,10,12
Ттэль,gordunni,892,mage,frost,123,58,65
Insanewizard,kazzak,890,mage,frost,16,10,6
Wopi,sylvanas,890,mage,frost,36,13,23
Magicoliwia,ysera,886,mage,frost,57,29,28
Piego,turalyon,885,mage,frost,182,90,92
Setyon,burning-legion,885,mage,frost,26,10,16
Eliosia,drakthul,884,mage,frost,17,10,7
Frigus,khaz-modan,884,mage,frost,33,10,23
Juntara,stormscale,880,mage,frost,24,11,13
Осуждаюпве,gordunni,880,mage,frost,31,10,21
Щавзорву,gordunni,878,mage,frost,22,10,12
Kaptanati,silvermoon,874,mage,frost,24,12,12
Neps,chamber-of-aspects,868,mage,frost,54,24,30
Bigbarrage,blackrock,864,mage,frost,12,9,3
Fakeklepter,sylvanas,864,mage,frost,12,9,3
Blockumad,ragnaros,864,mage,frost,18,9,9
Justvik,eredar,864,mage,frost,18,9,9
Curran,ravencrest,864,mage,frost,24,9,15
Facerollyo,tarren-mill,864,mage,frost,24,9,15
Мирикон,gordunni,863,mage,frost,18,9,9
Qqcult,ravencrest,863,mage,frost,18,9,9
Ascik,dalaran,863,mage,frost,18,9,9
Moleester,twisting-nether,863,mage,frost,18,9,9
Casteerr,kazzak,863,mage,frost,18,9,9
Авгурей,howling-fjord,863,mage,frost,18,9,9
Musé,kazzak,863,mage,frost,18,9,9
Nergl,darksorrow,863,mage,frost,22,10,12
Bloodycast,archimonde,863,mage,frost,24,9,15
Løgi,drakthul,863,mage,frost,24,9,15
Слизерин,gordunni,863,mage,frost,30,9,21
Izotza,ravencrest,863,mage,frost,36,9,27
Gotone,tarren-mill,862,mage,frost,18,9,9
Yajimage,archimonde,862,mage,frost,24,9,15
Meroo,hyjal,862,mage,frost,24,9,15
Shifteurprõ,hyjal,861,mage,frost,18,9,9
Driäm,ragnaros,861,mage,frost,18,9,9
Lumberth,sanguino,861,mage,frost,18,9,9
Strychne,ragnaros,860,mage,frost,12,9,3
Thairlas,ragnaros,860,mage,frost,131,48,83
Amazona,veklor,859,mage,frost,38,18,20
Querasimar,blackrock,859,mage,frost,24,9,15
Elitriz,grim-batol,857,mage,frost,12,9,3
Ravenice,sylvanas,857,mage,frost,21,10,11
Spankpróóf,kazzak,856,mage,frost,24,9,15
Markasaura,kazzak,856,mage,frost,38,11,27
Voralastor,doomhammer,855,mage,frost,12,9,3
Maagni,outland,855,mage,frost,18,9,9
Nargaroc,blackhand,855,mage,frost,24,9,15
Dzomage,kazzak,855,mage,frost,30,9,21
Farrä,dun-modr,854,mage,frost,53,26,27
Бд,blackscar,854,mage,frost,24,9,15
Jèphy,silvermoon,851,mage,frost,18,9,9
Laureen,outland,851,mage,frost,18,9,9
Zaubererblod,silvermoon,849,mage,frost,78,28,50
Банана,lich-king,847,mage,frost,18,9,9
Сэбат,soulflayer,846,mage,frost,24,9,15
Hérésïa,kirin-tor,846,mage,frost,24,9,15
Alefraide,la-croisade-écarlate,843,mage,frost,18,9,9
Rifinouu,archimonde,841,mage,frost,18,9,9
Sargelius,grim-batol,841,mage,frost,24,9,15
Larsimore,drakthul,839,mage,frost,24,9,15
Lonero,antonidas,835,mage,frost,12,9,3
Дроййд,gordunni,835,mage,frost,94,28,66
Arttu,defias-brotherhood,830,mage,frost,110,43,67
Rintoh,pozzo-delleternità,828,mage,frost,30,9,21
Фростмага,gordunni,825,mage,frost,24,10,14
Lexalia,blackmoore,823,mage,frost,68,31,37
Arinel,stormreaver,823,mage,frost,83,23,60
Aerius,lightnings-blade,813,mage,frost,21,9,12
Soulcatcheus,archimonde,811,mage,frost,30,10,20
Vraesh,blackrock,810,mage,frost,23,11,12
Пвнзглад,gordunni,809,mage,frost,22,10,12
Чвкашкалу,soulflayer,805,mage,frost,17,9,8
Jockin,stormrage,805,mage,frost,25,10,15
Ширм,blackscar,800,mage,frost,16,9,7
Pelsky,zenedar,799,mage,frost,22,9,13
Xyhno,eredar,798,mage,frost,19,10,9
Hooffer,stormscale,797,mage,frost,28,9,19
Flaire,thunderhorn,793,mage,frost,18,9,9
Lothymond,runetotem,793,mage,frost,26,9,17
Xæl,ravencrest,791,mage,frost,159,76,83
Явернулси,soulflayer,789,mage,frost,45,12,33
Sammelbot,kargath,780,mage,frost,78,36,42
Slôwz,kazzak,768,mage,frost,12,8,4
Subzeraxo,archimonde,768,mage,frost,12,8,4
Txsty,dalaran,768,mage,frost,12,8,4
Ambulancex,kazzak,768,mage,frost,12,8,4
Séxmachiné,draenor,768,mage,frost,12,8,4
Méphis,eredar,768,mage,frost,12,8,4
Arunx,magtheridon,768,mage,frost,12,8,4
Trashmage,blackrock,768,mage,frost,12,8,4
Urkela,sylvanas,768,mage,frost,15,9,6
Arempy,tarren-mill,768,mage,frost,18,8,10
Väänik,draenor,768,mage,frost,18,8,10
Terash,ravencrest,768,mage,frost,18,8,10
Гдедипфриз,soulflayer,768,mage,frost,18,8,10
Jarim,alleria,768,mage,frost,18,8,10
Fearbeäch,ravencrest,768,mage,frost,18,8,10
Wortyvery,outland,768,mage,frost,18,8,10
Mðj,kazzak,768,mage,frost,18,8,10
Dueudafrøven,stormscale,768,mage,frost,18,8,10
Jînexo,shattrath,768,mage,frost,21,8,13
Wambamm,ravencrest,768,mage,frost,24,8,16
Zelimeth,outland,768,mage,frost,24,8,16
Mackattack,nemesis,767,mage,frost,12,8,4
Tajos,drakthul,767,mage,frost,12,8,4
Zili,draenor,767,mage,frost,12,8,4
Next,ysondre,767,mage,frost,12,8,4
Gagaj,ravencrest,767,mage,frost,12,8,4
Нуклер,howling-fjord,767,mage,frost,12,8,4
Insømnium,stormscale,767,mage,frost,18,8,10
Goodheadcake,ragnaros,767,mage,frost,18,8,10
Переливпро,blackscar,767,mage,frost,18,8,10
Okey,frostwhisper,767,mage,frost,18,8,10
Vallas,drakthul,767,mage,frost,18,8,10
Alirya,stormscale,767,mage,frost,18,8,10
Magenox,blackrock,767,mage,frost,18,8,10
Oryom,blackhand,767,mage,frost,52,22,30
Khorosho,draenor,767,mage,frost,24,8,16
Vinlimar,drakthul,767,mage,frost,24,8,16
Héffér,outland,766,mage,frost,12,8,4
Anoez,kargath,766,mage,frost,18,8,10
Spell,blackmoore,766,mage,frost,18,8,10
Deathcast,ravencrest,766,mage,frost,18,8,10
Kàtsu,tarren-mill,766,mage,frost,18,8,10
Antaos,drakthul,766,mage,frost,24,8,16
Fatcasts,silvermoon,765,mage,frost,12,8,4
Illiaria,antonidas,765,mage,frost,12,8,4
Ærrflôw,frostwolf,765,mage,frost,18,8,10
Partagedeco,dalaran,765,mage,frost,18,8,10
Marokanez,eredar,764,mage,frost,65,28,37
Skinirp,dun-modr,764,mage,frost,24,8,16
Greey,blackhand,763,mage,frost,12,8,4
Ezìl,nemesis,763,mage,frost,27,9,18
Braínfreeze,kazzak,763,mage,frost,24,8,16
Нитро,soulflayer,763,mage,frost,24,8,16
Lakénz,archimonde,762,mage,frost,18,8,10
Fumandalonso,sanguino,762,mage,frost,24,8,16
Frostytipz,tarren-mill,760,mage,frost,24,8,16
Tomjedusor,hyjal,757,mage,frost,12,8,4
Saladora,anachronos,757,mage,frost,12,8,4
Crashleaf,argent-dawn,755,mage,frost,77,16,61
Zenoss,khaz-modan,752,mage,frost,91,41,50
Croaky,alleria,749,mage,frost,17,8,9
Мерджреквест,howling-fjord,745,mage,frost,17,8,9
Ploufatak,hyjal,743,mage,frost,84,27,57
Hurlscream,marécage-de-zangar,743,mage,frost,49,14,35
Pickaachu,doomhammer,739,mage,frost,46,22,24
Qqlool,draenor,735,mage,frost,23,8,15
Amalou,stormscale,729,mage,frost,32,9,23
Morrigane,shattered-hand,721,mage,frost,18,8,10
Magipus,anetheron,721,mage,frost,43,15,28
Mumpii,blackrock,719,mage,frost,23,8,15
Clitch,blutkessel,715,mage,frost,20,9,11
Bibidibabidi,nefarian,711,mage,frost,23,9,14
Rayniß,blackmoore,702,mage,frost,26,8,18
Neboonu,sylvanas,696,mage,frost,91,40,51
Lanere,argent-dawn,684,mage,frost,19,8,11
Venu,dun-modr,677,mage,frost,77,40,37
Hérä,archimonde,672,mage,frost,12,7,5
Monkeydmafia,blackrock,672,mage,frost,12,7,5
Gøsu,rexxar,672,mage,frost,12,7,5
Glindalefay,silvermoon,672,mage,frost,12,7,5
Ðevlqt,blackmoore,672,mage,frost,12,7,5
Birckin,sanguino,672,mage,frost,12,7,5
Yobys,burning-legion,672,mage,frost,12,7,5
Skyblink,hyjal,672,mage,frost,12,7,5
Icéy,kazzak,672,mage,frost,12,7,5
Blinked,eredar,672,mage,frost,12,7,5
Sölø,stormscale,672,mage,frost,12,7,5
Agus,ravencrest,672,mage,frost,12,7,5
Kold,stormscale,672,mage,frost,12,7,5
Candydead,alakir,672,mage,frost,18,7,11
Chrome,ysondre,672,mage,frost,18,7,11
Azegodxlul,kazzak,672,mage,frost,18,7,11
Jakora,bronze-dragonflight,672,mage,frost,18,7,11
Dalaras,archimonde,672,mage,frost,18,7,11
Magekaoz,sylvanas,672,mage,frost,18,7,11
Mageyreid,quelthalas,672,mage,frost,18,7,11
Drwrey,tarren-mill,672,mage,frost,18,7,11
Lillelord,defias-brotherhood,672,mage,frost,18,7,11
Mezaiyh,blackmoore,672,mage,frost,18,7,11
Krookéd,tarren-mill,672,mage,frost,24,7,17
Wenndrid,draenor,672,mage,frost,30,7,23
Optimelk,bronzebeard,672,mage,frost,30,7,23
Geepie,twisting-nether,671,mage,frost,12,7,5
Nynduriella,teldrassil,671,mage,frost,12,7,5
Møstwãntêd,aegwynn,671,mage,frost,12,7,5
Поэтик,soulflayer,671,mage,frost,12,7,5
Wîtchcurse,dentarg,671,mage,frost,12,7,5
Kazekudo,archimonde,671,mage,frost,12,7,5
Droll,kazzak,671,mage,frost,12,7,5
Blitzo,madmortem,671,mage,frost,12,7,5
Ice,sargeras,671,mage,frost,18,7,11
Bigraphael,ravencrest,671,mage,frost,18,7,11
Crayz,magtheridon,671,mage,frost,18,7,11
Finkle,spinebreaker,671,mage,frost,18,7,11
Hardways,archimonde,671,mage,frost,18,7,11
Astoriontv,elune,671,mage,frost,18,7,11
ßaßastarz,archimonde,671,mage,frost,18,7,11
Alcatrax,bronze-dragonflight,671,mage,frost,18,7,11
Iceelance,tarren-mill,671,mage,frost,24,7,17
Huylusha,kazzak,671,mage,frost,24,7,17
Suitx,draenor,670,mage,frost,12,7,5
Hotpotatox,ravencrest,670,mage,frost,13,7,6
Ronnyraggare,silvermoon,670,mage,frost,18,7,11
Комонщик,howling-fjord,670,mage,frost,18,7,11
Unreadyx,archimonde,670,mage,frost,18,7,11
Nery,ravencrest,670,mage,frost,18,7,11
Placidius,twisting-nether,670,mage,frost,18,7,11
Luckymango,alakir,670,mage,frost,18,7,11
Quaile,malygos,670,mage,frost,24,7,17
Schiniie,argent-dawn,669,mage,frost,16,7,9
Luckydo,turalyon,669,mage,frost,18,7,11
Lyrika,sanguino,669,mage,frost,18,7,11
Crematorium,argent-dawn,669,mage,frost,19,7,12
Kairøs,dragonblight,669,mage,frost,27,8,19
Diomaniaco,shattered-hand,668,mage,frost,18,7,11
Allotropia,ravencrest,668,mage,frost,18,7,11
Zionara,stormscale,668,mage,frost,18,7,11
Faldanor,archimonde,667,mage,frost,12,7,5
Depai,blackrock,666,mage,frost,21,8,13
Jknl,ravencrest,666,mage,frost,19,7,12
Carcan,aggramar,665,mage,frost,18,7,11
Шиллаа,blackscar,665,mage,frost,18,7,11
Listro,argent-dawn,664,mage,frost,12,7,5
Donfalken,anachronos,664,mage,frost,18,7,11
Malicä,ravencrest,663,mage,frost,42,7,35
Bina,drakthul,661,mage,frost,19,8,11
Nthya,kazzak,661,mage,frost,24,7,17
Xatures,tarren-mill,653,mage,frost,23,7,16
Dumbledoré,frostwolf,648,mage,frost,18,7,11
Чогоце,eversong,643,mage,frost,108,29,79
Expulse,blackmoore,639,mage,frost,11,7,4
Shínsou,burning-blade,637,mage,frost,17,7,10
Zérodose,dalaran,635,mage,frost,14,8,6
Margistikus,die-aldor,626,mage,frost,112,57,55
Lepronsito,kazzak,623,mage,frost,15,7,8
Skæde,ravencrest,618,mage,frost,17,11,6
Svanteg,kazzak,618,mage,frost,14,8,6
Transan,stormscale,618,mage,frost,16,9,7
Verygoodgame,blackrock,617,mage,frost,15,8,7
Hidrax,outland,617,mage,frost,21,9,12
Tsubas,blackmoore,617,mage,frost,21,8,13
Tharillion,drakthul,606,mage,frost,14,7,7
Förstörarn,stormscale,606,mage,frost,20,7,13
Substitutes,draenor,606,mage,frost,26,7,19
Abóve,outland,576,mage,frost,6,6,0
Khartx,silvermoon,576,mage,frost,6,6,0
Mohammedjiba,ragnaros,576,mage,frost,6,6,0
Escapematrix,ravencrest,576,mage,frost,6,6,0
Estonka,ravencrest,576,mage,frost,6,6,0
Vønmûller,dalaran,576,mage,frost,6,6,0
Ecnaclappy,blackrock,576,mage,frost,12,6,6
Invinsible,xavius,576,mage,frost,12,6,6
Миллерфест,howling-fjord,576,mage,frost,12,6,6
Olzaa,outland,576,mage,frost,12,6,6
Titarie,ravencrest,576,mage,frost,12,6,6
Мбапи,soulflayer,576,mage,frost,12,6,6
Nécrømage,confrérie-du-thorium,576,mage,frost,12,6,6
Atioo,blackhand,576,mage,frost,12,6,6
Creden,frostmane,576,mage,frost,12,6,6
Адренохромх,gordunni,576,mage,frost,12,6,6
Skdroople,ravencrest,576,mage,frost,12,6,6
Dragotus,dragonblight,576,mage,frost,12,6,6
Søo,kazzak,576,mage,frost,12,6,6
Ouija,kazzak,576,mage,frost,12,6,6
Halfanapple,the-maelstrom,576,mage,frost,12,6,6
Perfection,cthun,576,mage,frost,12,6,6
Kurtcobain,draenor,576,mage,frost,12,6,6
Nøw,ravencrest,576,mage,frost,12,6,6
Zírí,malygos,576,mage,frost,12,6,6
Magicsheep,nemesis,576,mage,frost,12,6,6
Yexo,draenor,576,mage,frost,12,6,6
Ixbllyix,alonsus,576,mage,frost,12,6,6
Adeftm,kazzak,576,mage,frost,12,6,6
Sekaia,hyjal,576,mage,frost,12,6,6
Wheí,ravencrest,576,mage,frost,12,6,6
Thughunterqt,silvermoon,576,mage,frost,12,6,6
Necro,zuljin,576,mage,frost,12,6,6
Jingom,ravencrest,576,mage,frost,12,6,6
Froststarr,burning-legion,576,mage,frost,12,6,6
Forgotenn,draenor,576,mage,frost,12,6,6
Ballesteinen,outland,576,mage,frost,12,6,6
Айслэнц,howling-fjord,576,mage,frost,18,6,12
Зефенжо,howling-fjord,576,mage,frost,18,6,12
Деметрадон,gordunni,576,mage,frost,18,6,12
Articunoh,ravencrest,576,mage,frost,18,6,12
Ury,hyjal,576,mage,frost,18,6,12
Zikyo,silvermoon,576,mage,frost,18,6,12
Reeroll,arthas,576,mage,frost,18,6,12
Kbd,outland,576,mage,frost,18,6,12
Диппро,soulflayer,576,mage,frost,24,6,18
Cafcaf,archimonde,575,mage,frost,12,6,6
Pitbones,archimonde,575,mage,frost,12,6,6
Elünia,ysondre,575,mage,frost,12,6,6
Milminmage,ravencrest,575,mage,frost,12,6,6
Kídnappér,twisting-nether,575,mage,frost,12,6,6
Nilslegend,tarren-mill,575,mage,frost,12,6,6
Morteús,tarren-mill,575,mage,frost,12,6,6
Ælirion,antonidas,575,mage,frost,12,6,6
Zulko,krasus,575,mage,frost,12,6,6
Nanosh,kazzak,575,mage,frost,12,6,6
Firerazer,hyjal,575,mage,frost,15,7,8
Kobana,ravencrest,575,mage,frost,18,6,12
Saturator,burning-legion,575,mage,frost,18,6,12
Bloodymage,zenedar,575,mage,frost,18,6,12
Tricolos,sanguino,575,mage,frost,18,6,12
Pickindim,terokkar,575,mage,frost,19,6,13
Kaptenski,stormscale,575,mage,frost,24,6,18
Bhaâl,hyjal,574,mage,frost,12,6,6
Вхламинка,howling-fjord,574,mage,frost,12,6,6
Whitestiev,antonidas,574,mage,frost,18,6,12
Stilnox,nemesis,574,mage,frost,18,6,12
Pumpzy,tarren-mill,574,mage,frost,18,6,12
Tripel,blackmoore,574,mage,frost,24,6,18
Lalaura,sanguino,573,mage,frost,12,6,6
Coldstormz,terenas,573,mage,frost,24,6,18
Yennéfér,outland,573,mage,frost,30,6,24
Piscialetto,nemesis,572,mage,frost,18,6,12
Mayalac,archimonde,572,mage,frost,24,6,18
Støneð,blackhand,571,mage,frost,12,6,6
Игаша,gordunni,568,mage,frost,12,6,6
Serlath,defias-brotherhood,565,mage,frost,12,6,6
Hadziaj,doomhammer,565,mage,frost,30,6,24
Milhoux,ysondre,559,mage,frost,17,6,11
Kaeki,khaz-modan,558,mage,frost,22,10,12
Maran,outland,555,mage,frost,24,6,18
Meign,eredar,537,mage,frost,22,8,14
Bessiie,ragnaros,536,mage,frost,16,6,10
Pyllymake,kazzak,527,mage,frost,11,6,5
Lidin,draenor,527,mage,frost,11,6,5
Avb,twisting-nether,527,mage,frost,17,6,11
Nøxas,archimonde,527,mage,frost,17,6,11
Iif,zirkel-des-cenarius,525,mage,frost,11,6,5
Королеваланс,deathguard,522,mage,frost,16,9,7
Consquens,aszune,522,mage,frost,24,7,17
Modjahead,tarren-mill,521,mage,frost,27,8,19
Tschelo,eredar,512,mage,frost,16,6,10
Quente,aegwynn,511,mage,frost,10,6,4
Stylaaz,twisting-nether,511,mage,frost,14,6,8
Miihawkk,khaz-modan,510,mage,frost,20,6,14
Yoxt,blackhand,507,mage,frost,14,6,8
Regenn,kazzak,506,mage,frost,11,6,5
Magicstorm,anubarak,504,mage,frost,16,6,10
Fatefully,ravencrest,494,mage,frost,25,6,19
Iceage,nemesis,480,mage,frost,6,5,1
Línus,twisting-nether,480,mage,frost,6,5,1
Vorst,shattered-hand,480,mage,frost,6,5,1
Jasmira,kazzak,480,mage,frost,6,5,1
Zehnvonzehn,antonidas,480,mage,frost,6,5,1
Crystalice,zuljin,480,mage,frost,6,5,1
Khronic,darksorrow,480,mage,frost,6,5,1
Magnopvp,sanguino,480,mage,frost,10,6,4
Reznøør,confrérie-du-thorium,480,mage,frost,12,5,7
Shirrunn,the-maelstrom,480,mage,frost,12,5,7
Chubbyjoe,blackmoore,480,mage,frost,12,5,7
Nyoto,silvermoon,480,mage,frost,12,5,7
Milkenjoyer,ravencrest,480,mage,frost,12,5,7
Bræckdønæs,sanguino,480,mage,frost,12,5,7
Barzle,blackmoore,480,mage,frost,12,5,7
Lijla,blackrock,480,mage,frost,12,5,7
Moffmage,sylvanas,480,mage,frost,12,5,7
Ralfík,drakthul,480,mage,frost,12,5,7
Ikefire,draenor,480,mage,frost,12,5,7
Dudè,azshara,480,mage,frost,12,5,7
Fîrestorm,doomhammer,480,mage,frost,12,5,7
Xÿv,azshara,480,mage,frost,12,5,7
Burnit,dalaran,480,mage,frost,12,5,7
Javellja,ravencrest,480,mage,frost,12,5,7
Zaurok,sanguino,480,mage,frost,12,5,7
Betomage,blackmoore,480,mage,frost,12,5,7
Snowberry,blackrock,480,mage,frost,12,5,7
Maestrá,outland,480,mage,frost,12,5,7
Vapurx,blackmoore,480,mage,frost,12,5,7
Витуз,gordunni,480,mage,frost,12,5,7
Chrømy,twisting-nether,480,mage,frost,12,5,7
Kleptomania,archimonde,480,mage,frost,12,5,7
Shatterdude,kazzak,480,mage,frost,12,5,7
Médivh,archimonde,480,mage,frost,12,5,7
Thelastmage,outland,480,mage,frost,12,5,7
Slite,nazjatar,480,mage,frost,12,5,7
Oxidoxy,ragnaros,480,mage,frost,12,5,7
Glar,defias-brotherhood,480,mage,frost,12,5,7
Radiantfury,outland,480,mage,frost,12,5,7
Pixlld,aegwynn,480,mage,frost,12,5,7
Внд,gordunni,480,mage,frost,18,5,13
Шипкастермвп,howling-fjord,480,mage,frost,18,5,13
Trevise,ravencrest,480,mage,frost,18,5,13
Malygassa,ragnaros,480,mage,frost,18,5,13
Арара,gordunni,480,mage,frost,18,5,13
Intêrnet,archimonde,480,mage,frost,26,5,21
Restinnpiss,twisting-nether,479,mage,frost,6,5,1
Vaynes,stormscale,479,mage,frost,6,5,1
Olinourss,archimonde,479,mage,frost,12,5,7
Loøgaã,ysondre,479,mage,frost,12,5,7
Wizart,moonglade,479,mage,frost,12,5,7
Промагер,gordunni,479,mage,frost,12,5,7
Kalterfurz,thrall,479,mage,frost,12,5,7
Xýton,azjolnerub,479,mage,frost,12,5,7
Zyllu,argent-dawn,479,mage,frost,12,5,7
Quickbolt,ravencrest,479,mage,frost,18,5,13
Faitha,ravencrest,479,mage,frost,18,5,13
Deletron,ragnaros,479,mage,frost,18,5,13
Elreas,blackmoore,479,mage,frost,18,5,13
Waîdø,blackhand,478,mage,frost,9,6,3
Feuerflamme,theradras,478,mage,frost,12,5,7
Потныйдпс,eversong,478,mage,frost,16,6,10
Crypticc,dentarg,477,mage,frost,12,5,7
Valtarisoo,amanthul,477,mage,frost,12,5,7
Polflop,sylvanas,476,mage,frost,12,5,7
Phibonaci,sylvanas,475,mage,frost,12,5,7
Mëtåøra,khaz-modan,467,mage,frost,18,5,13
Диссоциация,greymane,458,mage,frost,19,7,12
Blinkinggoat,ragnaros,448,mage,frost,18,5,13
Dcolon,tarren-mill,447,mage,frost,11,5,6
Aerathâ,blackrock,447,mage,frost,11,5,6
Blacksheep,ravencrest,447,mage,frost,14,6,8
Saytmage,ragnaros,447,mage,frost,17,5,12
Nebby,argent-dawn,447,mage,frost,17,5,12
Swemagus,outland,432,mage,frost,9,5,4
Bíscuít,ragnaros,431,mage,frost,11,5,6
Dozono,silvermoon,428,mage,frost,15,5,10
Whitecrown,draenor,426,mage,frost,10,6,4
Internals,tarren-mill,425,mage,frost,20,6,14
Kîshkamen,ravencrest,425,mage,frost,22,6,16
Торар,deathguard,415,mage,frost,16,5,11
Xerathon,ravencrest,414,mage,frost,16,5,11
Merdon,ravencrest,413,mage,frost,10,5,5
Redsparrow,frostwolf,400,mage,frost,13,5,8
Leylus,blackmoore,399,mage,frost,5,5,0
Xaramael,colinas-pardas,389,mage,frost,16,7,9
Sneakii,the-maelstrom,384,mage,frost,6,4,2
Tnhigh,blackrock,384,mage,frost,6,4,2
Swoboswagins,draenor,384,mage,frost,6,4,2
Rubzim,draenor,384,mage,frost,6,4,2
Dauwen,silvermoon,384,mage,frost,6,4,2
Génociidz,archimonde,384,mage,frost,6,4,2
Сонатра,howling-fjord,384,mage,frost,6,4,2
Spellhaze,outland,384,mage,frost,6,4,2
Minglul,archimonde,384,mage,frost,6,4,2
Saiyangodx,twisting-nether,384,mage,frost,6,4,2
Lusifera,outland,384,mage,frost,6,4,2
Doryy,silvermoon,384,mage,frost,6,4,2
Sylvîe,tarren-mill,384,mage,frost,6,4,2
Anev,sylvanas,384,mage,frost,6,4,2
Âres,kargath,384,mage,frost,6,4,2
Gravelegacy,quelthalas,384,mage,frost,6,4,2
Syráx,blackmoore,384,mage,frost,6,4,2
Belgravia,silvermoon,384,mage,frost,6,4,2
Friedkek,ravencrest,384,mage,frost,6,4,2
Zanmalath,stormscale,384,mage,frost,6,4,2
Папущенный,soulflayer,384,mage,frost,6,4,2
Maegisniec,ragnaros,384,mage,frost,6,4,2
Willmajacki,blackmoore,384,mage,frost,6,4,2
Zerobelow,silvermoon,384,mage,frost,6,4,2
Twoeightybpm,draenor,384,mage,frost,6,4,2
Ahøllic,frostwolf,384,mage,frost,6,4,2
Màgí,stormscale,384,mage,frost,6,4,2
Saryotheone,silvermoon,384,mage,frost,6,4,2
Тризельда,soulflayer,384,mage,frost,6,4,2
Proudmøøre,argent-dawn,384,mage,frost,6,4,2
Жестьх,blackscar,384,mage,frost,6,4,2
Mowens,ravencrest,384,mage,frost,6,4,2
Icescreamer,auchindoun,384,mage,frost,6,4,2
Nightcàller,pozzo-delleternità,384,mage,frost,6,4,2
Hasslad,tarren-mill,384,mage,frost,6,4,2
Deathzzaky,ravencrest,384,mage,frost,6,4,2
Fuhry,tarren-mill,384,mage,frost,6,4,2
Cesi,silvermoon,384,mage,frost,6,4,2
Arcitech,tarren-mill,384,mage,frost,6,4,2
Xaryi,blackhand,384,mage,frost,6,4,2
Skyla,tarren-mill,384,mage,frost,6,4,2
Hundredslaps,ragnaros,384,mage,frost,6,4,2
Dwang,nemesis,384,mage,frost,6,4,2
Pinkusbruh,aggra-português,384,mage,frost,6,4,2
Nötmârtònxø,ragnaros,384,mage,frost,6,4,2
Zetstez,tarren-mill,384,mage,frost,6,4,2
Elmînster,aerie-peak,384,mage,frost,6,4,2
Zvezdica,kilrogg,384,mage,frost,9,5,4
Kirbi,blackmoore,384,mage,frost,10,5,5
Arýà,blackmoore,384,mage,frost,8,4,4
Sweekz,eredar,384,mage,frost,8,4,4
Shuty,hyjal,384,mage,frost,14,5,9
Rivií,drakthul,384,mage,frost,12,4,8
Kebkhadar,ravencrest,384,mage,frost,12,4,8
Халадель,howling-fjord,384,mage,frost,12,4,8
Flywoman,ravencrest,384,mage,frost,12,4,8
Dphz,tarren-mill,384,mage,frost,12,4,8
Fäust,drakthul,384,mage,frost,12,4,8
Odall,sylvanas,384,mage,frost,12,4,8
Wîldcard,sylvanas,384,mage,frost,12,4,8
Jazzi,blackrock,384,mage,frost,12,4,8
Gnðmeonfire,sylvanas,384,mage,frost,12,4,8
Xcender,sylvanas,384,mage,frost,12,4,8
Magemeni,sylvanas,384,mage,frost,12,4,8
Lilekx,archimonde,384,mage,frost,12,4,8
Ðarkreaver,kaelthas,384,mage,frost,12,4,8
Flejb,kazzak,384,mage,frost,12,4,8
Equálity,blackrock,384,mage,frost,12,4,8
Alterwhite,archimonde,384,mage,frost,12,4,8
Felïnnayry,hyjal,384,mage,frost,12,4,8
Tarovan,defias-brotherhood,384,mage,frost,12,4,8
Гунмаказ,gordunni,384,mage,frost,12,4,8
Индаррил,howling-fjord,384,mage,frost,12,4,8
Magicrex,alleria,384,mage,frost,12,4,8
Mopus,ravencrest,384,mage,frost,12,4,8
Vorsi,tarren-mill,384,mage,frost,12,4,8
Newtwo,ravencrest,384,mage,frost,12,4,8
Ëgï,azshara,384,mage,frost,12,4,8
Stellarie,sylvanas,384,mage,frost,12,4,8
Пламяорды,soulflayer,384,mage,frost,12,4,8
Fikkamika,ragnaros,384,mage,frost,12,4,8
Alithekuru,silvermoon,384,mage,frost,12,4,8
Вулльф,gordunni,384,mage,frost,12,4,8
Kaschnatze,blackmoore,384,mage,frost,12,4,8
Consulalgeri,archimonde,384,mage,frost,12,4,8
Wwjd,darksorrow,384,mage,frost,12,4,8
Юджегс,soulflayer,384,mage,frost,12,4,8
Ørixx,blackhand,384,mage,frost,12,4,8
Arszéllius,dalaran,384,mage,frost,12,4,8
Свитерок,soulflayer,384,mage,frost,12,4,8
Псайххо,soulflayer,384,mage,frost,12,4,8
Stærq,blackrock,384,mage,frost,12,4,8
Béboutosaure,varimathras,384,mage,frost,12,4,8
Liinki,draenor,384,mage,frost,12,4,8
Acclay,malganis,384,mage,frost,12,4,8
Baldazzor,ravencrest,384,mage,frost,12,4,8
Yasuomain,ragnaros,384,mage,frost,12,4,8
Managurke,blackrock,384,mage,frost,12,4,8
Elor,eredar,384,mage,frost,12,4,8
Kuhwar,echsenkessel,384,mage,frost,12,4,8
Lambaa,thrall,384,mage,frost,12,4,8
Proffset,outland,384,mage,frost,12,4,8
Johnnyblazin,outland,384,mage,frost,12,4,8
Muntiks,ravencrest,384,mage,frost,12,4,8
Ripdeepfreez,culte-de-la-rive-noire,384,mage,frost,18,4,14
Gylith,kirin-tor,384,mage,frost,18,4,14
Ruténa,aegwynn,384,mage,frost,18,4,14
Watchmepanda,ravencrest,384,mage,frost,18,4,14
Mobjar,twisting-nether,384,mage,frost,18,4,14
Бигдикмаг,soulflayer,384,mage,frost,18,4,14
Blinkmehome,silvermoon,384,mage,frost,18,4,14
Ratamiel,tarren-mill,384,mage,frost,18,4,14
Krykz,sanguino,384,mage,frost,18,4,14
Audraptor,medivh,384,mage,frost,21,4,17
Schwombette,blackmoore,383,mage,frost,6,4,2
Nortohg,ragnaros,383,mage,frost,6,4,2
Capyla,blackmoore,383,mage,frost,6,4,2
Wuffwuffspik,grim-batol,383,mage,frost,6,4,2
Xenodike,blackrock,383,mage,frost,12,4,8
Скватро,gordunni,383,mage,frost,12,4,8
Pwndyo,gilneas,383,mage,frost,12,4,8
Nanet,cthun,383,mage,frost,12,4,8
Труупоед,borean-tundra,383,mage,frost,12,4,8
Magiocre,silvermoon,383,mage,frost,12,4,8
Khad,nemesis,383,mage,frost,12,4,8
Zadnik,tarren-mill,383,mage,frost,15,4,11
Ashkalor,frostwolf,383,mage,frost,17,4,13
Kaiyn,argent-dawn,383,mage,frost,18,4,14
Asnesh,silvermoon,383,mage,frost,18,4,14
Perhorus,hyjal,382,mage,frost,6,4,2
Maglush,ysondre,382,mage,frost,6,4,2
Skankengine,twisting-nether,382,mage,frost,12,4,8
Gefríerpunkt,thrall,381,mage,frost,12,4,8
Aurayaa,teldrassil,377,mage,frost,23,4,19
Bisuke,stormscale,367,mage,frost,11,4,7
Whosthemage,kazzak,351,mage,frost,8,5,3
Frostitutíon,kazzak,336,mage,frost,15,4,11
Møøk,magtheridon,336,mage,frost,15,4,11
Taelson,stormscale,335,mage,frost,11,4,7
Pringlesrör,ragnaros,332,mage,frost,15,4,11
Grönmonster,shattered-hand,330,mage,frost,13,5,8
Pascalmabite,outland,330,mage,frost,14,5,9
Leontus,outland,330,mage,frost,16,5,11
Distrophy,vashj,330,mage,frost,18,5,13
Scras,ragnaros,320,mage,frost,10,4,6
Tiduhasi,antonidas,319,mage,frost,11,4,7
Jambonpistol,archimonde,319,mage,frost,20,4,16
Flizwiz,ragnaros,303,mage,frost,13,4,9
Arandartis,kazzak,288,mage,frost,6,3,3
Soulraider,tarren-mill,288,mage,frost,6,3,3
Vodjka,nemesis,288,mage,frost,6,3,3
Mannefury,pozzo-delleternità,288,mage,frost,6,3,3
Fízzií,wildhammer,288,mage,frost,6,3,3
Merlín,malganis,288,mage,frost,6,3,3
Куканыч,fordragon,288,mage,frost,6,3,3
Каперниан,fordragon,288,mage,frost,6,3,3
Brunettdelux,archimonde,288,mage,frost,6,3,3
Wúddy,blackrock,288,mage,frost,6,3,3
Halø,bloodhoof,288,mage,frost,6,3,3
Effectxx,ravencrest,288,mage,frost,6,3,3
Trinki,bloodscalp,288,mage,frost,6,3,3
Illîllîllî,blackrock,288,mage,frost,6,3,3
Cyser,kazzak,288,mage,frost,6,3,3
Gelubabadook,ravencrest,288,mage,frost,6,3,3
Muuckie,blackrock,288,mage,frost,6,3,3
Pirileena,ravencrest,288,mage,frost,6,3,3
Meras,die-ewige-wacht,288,mage,frost,6,3,3
Nevertøxic,ravencrest,288,mage,frost,6,3,3
Yésdávé,stormscale,288,mage,frost,6,3,3
Zsage,ragnaros,288,mage,frost,6,3,3
Marðuk,blackmoore,288,mage,frost,6,3,3
Xlarb,kazzak,288,mage,frost,6,3,3
Håtemebaby,kazzak,288,mage,frost,6,3,3
Hànsól,antonidas,288,mage,frost,6,3,3
Zlacked,tarren-mill,288,mage,frost,6,3,3
Trúkez,ragnaros,288,mage,frost,6,3,3
Sozie,tarren-mill,288,mage,frost,6,3,3
Amaterâsu,antonidas,288,mage,frost,6,3,3
Siérra,outland,288,mage,frost,6,3,3
Skrba,kazzak,288,mage,frost,6,3,3
Mégaera,archimonde,288,mage,frost,6,3,3
Makez,draenor,288,mage,frost,6,3,3
ßerkoßaggins,ravencrest,288,mage,frost,6,3,3
Maybelline,frostwolf,288,mage,frost,6,3,3
Onegaisenpai,ragnaros,288,mage,frost,6,3,3
Rohthalas,frostwolf,288,mage,frost,6,3,3
Haginatorr,twisting-nether,288,mage,frost,6,3,3
Rèkt,lightbringer,288,mage,frost,6,3,3
Cubis,archimonde,288,mage,frost,6,3,3
Blåskjell,kazzak,288,mage,frost,6,3,3
Diper,burning-legion,288,mage,frost,6,3,3
Frökenfrost,stormscale,288,mage,frost,6,3,3
Fkeverybody,ravencrest,288,mage,frost,6,3,3
Ghayaa,defias-brotherhood,288,mage,frost,6,3,3
Баблби,greymane,288,mage,frost,6,3,3
Hutylo,ysondre,288,mage,frost,6,3,3
Bóósh,alakir,288,mage,frost,6,3,3
Овеча,gordunni,288,mage,frost,6,3,3
Zørïna,ysondre,288,mage,frost,6,3,3
Aestus,outland,288,mage,frost,6,3,3
Тейемор,gordunni,288,mage,frost,6,3,3
Hourgen,ysondre,288,mage,frost,6,3,3
Bigburns,draenor,288,mage,frost,6,3,3
Tudorthemage,xavius,288,mage,frost,6,3,3
Psicotropico,shendralar,288,mage,frost,6,3,3
Kao,ravencrest,288,mage,frost,6,3,3
Timzør,outland,288,mage,frost,6,3,3
Thelaere,dun-modr,288,mage,frost,6,3,3
Astrryy,burning-legion,288,mage,frost,6,3,3
Tommyboy,dragonblight,288,mage,frost,6,3,3
Hassanabi,defias-brotherhood,288,mage,frost,6,3,3
Айсъмэджик,azuregos,288,mage,frost,6,3,3
Hachiro,onyxia,288,mage,frost,6,3,3
Periphery,zenedar,288,mage,frost,6,3,3
Боожженька,howling-fjord,288,mage,frost,6,3,3
Kimfjongmajs,silvermoon,288,mage,frost,6,3,3
Lepapes,doomhammer,288,mage,frost,6,3,3
Волшебну,soulflayer,288,mage,frost,6,3,3
Strawßerry,sanguino,288,mage,frost,6,3,3
Askannor,norgannon,288,mage,frost,6,3,3
Waysha,dun-modr,288,mage,frost,6,3,3
ßjwercke,stormscale,288,mage,frost,6,3,3
Swayyx,sylvanas,288,mage,frost,6,3,3
Frìsko,sylvanas,288,mage,frost,6,3,3
Wingzz,outland,288,mage,frost,6,3,3
Gehrkeblock,silvermoon,288,mage,frost,6,3,3
Martiqabelle,dun-morogh,288,mage,frost,6,3,3
Narcîsa,sanguino,288,mage,frost,6,3,3
Nortí,drakthul,288,mage,frost,6,3,3
Sanderboy,twilights-hammer,288,mage,frost,6,3,3
Myuou,hyjal,288,mage,frost,6,3,3
Дмблдр,soulflayer,288,mage,frost,6,3,3
Triuno,sylvanas,288,mage,frost,10,4,6
Janovawitnes,azuremyst,288,mage,frost,10,3,7
Sérum,drakthul,288,mage,frost,12,3,9
Nùts,archimonde,288,mage,frost,12,3,9
Котофайв,howling-fjord,288,mage,frost,12,3,9
Скайлуйт,gordunni,288,mage,frost,12,3,9
Rachouu,archimonde,288,mage,frost,12,3,9
Эммилиарда,gordunni,288,mage,frost,12,3,9
Micklolz,blackmoore,288,mage,frost,12,3,9
Чоуза,gordunni,288,mage,frost,12,3,9
Ахиригиз,gordunni,288,mage,frost,12,3,9
Paradigma,sylvanas,288,mage,frost,12,3,9
Sérc,ravencrest,288,mage,frost,12,3,9
Catafract,kazzak,288,mage,frost,12,3,9
Jóhnnybravó,draenor,288,mage,frost,12,3,9
Rizzlybear,outland,288,mage,frost,12,3,9
Avæ,stormscale,288,mage,frost,12,3,9
Xeldary,blackmoore,288,mage,frost,12,3,9
Blastus,ragnaros,288,mage,frost,12,3,9
Harpelmage,auchindoun,288,mage,frost,12,3,9
Fernandéz,ravencrest,288,mage,frost,12,3,9
Heatwavesa,ravencrest,288,mage,frost,12,3,9
Arcon,garrosh,288,mage,frost,12,3,9
Kryptass,aegwynn,288,mage,frost,12,3,9
Imasheeper,silvermoon,288,mage,frost,12,3,9
Whìtewalker,pozzo-delleternità,288,mage,frost,12,3,9
Gogara,kazzak,288,mage,frost,12,3,9
Schøkø,eredar,288,mage,frost,12,3,9
Bumps,bronze-dragonflight,288,mage,frost,12,3,9
Lycfatum,twisting-nether,288,mage,frost,12,3,9
Flarriux,twisting-nether,288,mage,frost,12,3,9
Gorrou,hyjal,288,mage,frost,12,3,9
Barspin,lightnings-blade,288,mage,frost,12,3,9
Whïtebøy,hyjal,288,mage,frost,12,3,9
Onlymage,outland,288,mage,frost,12,3,9
Subtempo,silvermoon,288,mage,frost,12,3,9
Äßäm,outland,288,mage,frost,12,3,9
Waterhagx,tarren-mill,288,mage,frost,12,3,9
Хадя,blackscar,288,mage,frost,12,3,9
Voraxma,draenor,288,mage,frost,12,3,9
Тудысюдым,eversong,288,mage,frost,12,3,9
Hacimari,hyjal,288,mage,frost,12,3,9
Kilféfroid,ysondre,288,mage,frost,13,3,10
Ypy,dragonmaw,288,mage,frost,14,3,11
Cortis,outland,288,mage,frost,18,3,15
Icystar,antonidas,288,mage,frost,18,3,15
Nerobus,malorne,288,mage,frost,18,3,15
Напряжеметр,soulflayer,287,mage,frost,6,3,3
Zuza,magtheridon,287,mage,frost,6,3,3
Fumachustas,kazzak,287,mage,frost,6,3,3
Tsr,burning-legion,287,mage,frost,6,3,3
Magó,eredar,287,mage,frost,6,3,3
Reeyymmoo,draenor,287,mage,frost,6,3,3
Эпсиха,lich-king,287,mage,frost,6,3,3
Zhazam,blades-edge,287,mage,frost,6,3,3
Kasus,sporeggar,287,mage,frost,12,3,9
Mexxlaz,eredar,287,mage,frost,12,3,9
Lightbínder,antonidas,287,mage,frost,12,3,9
Nekroulis,agamaggan,287,mage,frost,17,3,14
Gamah,exodar,287,mage,frost,18,3,15
Freeto,blackmoore,286,mage,frost,6,3,3
Maélïne,hyjal,286,mage,frost,6,3,3
Rosenkrauz,kul-tiras,280,mage,frost,26,3,23
Torryel,silvermoon,256,mage,frost,10,3,7
Кагумми,gordunni,256,mage,frost,16,3,13
Колдунская,gordunni,255,mage,frost,11,3,8
Latory,aegwynn,239,mage,frost,5,3,2
Deepsteez,tarren-mill,239,mage,frost,5,3,2
Alèxjones,stormscale,239,mage,frost,5,3,2
Ipen,bloodfeather,192,mage,frost,6,2,4
Фроз,soulflayer,192,mage,frost,6,2,4
Labius,dun-modr,192,mage,frost,6,2,4
Welt,drakthul,192,mage,frost,6,2,4
Lorakruul,sanguino,192,mage,frost,6,2,4
Budgetziqo,ravencrest,192,mage,frost,6,2,4
Vaerén,malganis,192,mage,frost,6,2,4
Berylton,argent-dawn,192,mage,frost,6,2,4
Harzallane,kirin-tor,192,mage,frost,6,2,4
Frostbringer,archimonde,192,mage,frost,6,2,4
Димаскунфу,howling-fjord,192,mage,frost,6,2,4
Mooryel,burning-legion,192,mage,frost,6,2,4
Meteofrost,draenor,192,mage,frost,6,2,4
Шарансул,soulflayer,192,mage,frost,6,2,4
Ingibjorg,auchindoun,192,mage,frost,6,2,4
Naldora,turalyon,192,mage,frost,6,2,4
Ellianor,drakthul,192,mage,frost,6,2,4
Adetin,tarren-mill,192,mage,frost,6,2,4
Shealá,blackhand,192,mage,frost,6,2,4
Malghar,rashgarroth,192,mage,frost,6,2,4
Ðøæø,twisting-nether,192,mage,frost,6,2,4
Wroneq,burning-legion,192,mage,frost,6,2,4
Celestis,sylvanas,192,mage,frost,6,2,4
Etherìon,los-errantes,192,mage,frost,6,2,4
Ghuurall,burning-legion,192,mage,frost,6,2,4
Колдрагос,gordunni,192,mage,frost,6,2,4
Barka,colinas-pardas,192,mage,frost,6,2,4
Noxia,minahonda,192,mage,frost,6,2,4
Tesho,sylvanas,192,mage,frost,6,2,4
Jengele,argent-dawn,192,mage,frost,6,2,4
Эникор,gordunni,192,mage,frost,6,2,4
Ehbehad,doomhammer,192,mage,frost,6,2,4
Yunion,burning-legion,192,mage,frost,6,2,4
Merwido,the-maelstrom,192,mage,frost,6,2,4
Ceinxjk,ravencrest,192,mage,frost,6,2,4
Ðps,grim-batol,192,mage,frost,6,2,4
Animositymg,draenor,192,mage,frost,6,2,4
Xblaz,draenor,192,mage,frost,6,2,4
Ahuenchik,stormscale,192,mage,frost,6,2,4
Cyreniax,the-maelstrom,192,mage,frost,6,2,4
Swørd,aggra-português,192,mage,frost,6,2,4
Queuefiend,eredar,192,mage,frost,6,2,4
Exael,ravencrest,192,mage,frost,6,2,4
Balmak,doomhammer,192,mage,frost,6,2,4
Zeramage,eredar,192,mage,frost,6,2,4
Gandulf,malorne,192,mage,frost,6,2,4
Magovix,archimonde,192,mage,frost,6,2,4
Flanor,pozzo-delleternità,192,mage,frost,6,2,4
Sperow,marécage-de-zangar,192,mage,frost,6,2,4
Creak,blackhand,192,mage,frost,6,2,4
Brísingamen,outland,192,mage,frost,6,2,4
Smokedaddy,stormscale,192,mage,frost,6,2,4
Ohateyz,burning-legion,192,mage,frost,6,2,4
Imnis,outland,192,mage,frost,6,2,4
Zulkas,stormreaver,192,mage,frost,6,2,4
Darmie,burning-legion,192,mage,frost,6,2,4
Benthortm,tarren-mill,192,mage,frost,6,2,4
Levioosah,draenor,192,mage,frost,6,2,4
Haxyo,twisting-nether,192,mage,frost,6,2,4
Goodopeners,outland,192,mage,frost,6,2,4
Ekron,sanguino,192,mage,frost,6,2,4
Congelation,tarren-mill,192,mage,frost,6,2,4
Джинжилах,gordunni,192,mage,frost,6,2,4
Mässîvècøx,ragnaros,192,mage,frost,6,2,4
Kriokola,steamwheedle-cartel,192,mage,frost,6,2,4
Héstia,sylvanas,192,mage,frost,6,2,4
Dxdxdxdxdx,drakthul,192,mage,frost,6,2,4
Zerøsílgødx,antonidas,192,mage,frost,6,2,4
Proxanlulz,ravencrest,192,mage,frost,6,2,4
Yinula,stormscale,192,mage,frost,6,2,4
Вовзон,howling-fjord,192,mage,frost,6,2,4
Usidore,sylvanas,192,mage,frost,6,2,4
Uwutehe,ravencrest,192,mage,frost,6,2,4
Frazztato,tarren-mill,192,mage,frost,6,2,4
Tomia,burning-legion,192,mage,frost,6,2,4
Kasidead,archimonde,192,mage,frost,6,2,4
Bugica,drakthul,192,mage,frost,6,2,4
Kobrass,spinebreaker,192,mage,frost,6,2,4
Crite,blackmoore,192,mage,frost,6,2,4
Qalisp,twisting-nether,192,mage,frost,6,2,4
Alieni,stormreaver,192,mage,frost,6,2,4
Hacksopa,twisting-nether,192,mage,frost,6,2,4
Liloz,aegwynn,192,mage,frost,6,2,4
Jeâns,alexstrasza,192,mage,frost,6,2,4
Maveya,blackmoore,192,mage,frost,6,2,4
Tobie,bladefist,192,mage,frost,6,2,4
Галадриелька,gordunni,192,mage,frost,6,2,4
Gameart,alexstrasza,192,mage,frost,6,2,4
Feath,ravencrest,192,mage,frost,6,2,4
Infamage,draenor,192,mage,frost,6,2,4
Micro,auchindoun,192,mage,frost,6,2,4
Missáh,archimonde,192,mage,frost,6,2,4
Фрайзо,gordunni,192,mage,frost,6,2,4
Мегазад,gordunni,192,mage,frost,6,2,4
Auzt,kazzak,192,mage,frost,6,2,4
Youded,arthas,192,mage,frost,6,2,4
Bananaslam,silvermoon,192,mage,frost,6,2,4
Firen,thrall,192,mage,frost,6,2,4
Burnem,kult-der-verdammten,192,mage,frost,6,2,4
Nypààx,anetheron,192,mage,frost,6,2,4
Zilus,gilneas,192,mage,frost,6,2,4
Wizoz,blackrock,192,mage,frost,6,2,4
Skylezy,blackrock,192,mage,frost,6,2,4
Sebers,kazzak,192,mage,frost,6,2,4
Banausisch,blackmoore,192,mage,frost,6,2,4
Alleii,kazzak,192,mage,frost,6,2,4
Firecold,silvermoon,192,mage,frost,6,2,4
Mageta,silvermoon,192,mage,frost,6,2,4
Ratedr,silvermoon,192,mage,frost,6,2,4
Helixmg,silvermoon,192,mage,frost,6,2,4
Laciee,silvermoon,192,mage,frost,6,2,4
Zheakz,kazzak,192,mage,frost,6,2,4
Robsn,blackrock,192,mage,frost,6,2,4
Saveq,kazzak,192,mage,frost,6,2,4
Sany,anubarak,192,mage,frost,6,2,4
Betoxin,dunemaul,192,mage,frost,7,2,5
Zugkzugk,eredar,192,mage,frost,9,2,7
Mariujana,ravencrest,192,mage,frost,12,2,10
Flamê,ragnaros,192,mage,frost,12,2,10
Bêta,dun-modr,192,mage,frost,12,2,10
Freezeballs,blackmoore,192,mage,frost,12,2,10
Toyash,ragnaros,192,mage,frost,12,2,10
Illiot,twisting-nether,192,mage,frost,12,2,10
Blinkyrascal,silvermoon,192,mage,frost,12,2,10
Myriel,thrall,192,mage,frost,12,2,10
Rapidfrost,drakthul,192,mage,frost,12,2,10
Portnography,draenor,192,mage,frost,12,2,10
Qtoli,tarren-mill,192,mage,frost,12,2,10
Магниффика,blackscar,192,mage,frost,12,2,10
Shiftea,argent-dawn,192,mage,frost,12,2,10
Nifer,tarren-mill,192,mage,frost,12,2,10
Kaevelin,argent-dawn,192,mage,frost,12,2,10
Alystan,burning-blade,192,mage,frost,12,2,10
Shadyexd,ravencrest,192,mage,frost,12,2,10
Buzzcraft,draenor,192,mage,frost,12,2,10
Pogmage,blackrock,192,mage,frost,12,2,10
Atírpá,doomhammer,192,mage,frost,12,2,10
Nefine,azshara,192,mage,frost,12,2,10
Hruon,ravenholdt,192,mage,frost,15,2,13
Blainemagus,arathor,192,mage,frost,17,2,15
Aaropalli,kazzak,191,mage,frost,6,2,4
Illusionx,grim-batol,191,mage,frost,6,2,4
Duncanidaho,throkferoth,191,mage,frost,6,2,4
Mallisto,magtheridon,191,mage,frost,6,2,4
Makkertje,silvermoon,191,mage,frost,6,2,4
Мюша,razuvious,191,mage,frost,6,2,4
Mátraxx,silvermoon,191,mage,frost,12,2,10
Enkida,exodar,191,mage,frost,18,2,16
Proxj,stormscale,175,mage,frost,11,2,9
Cerewyn,ravencrest,175,mage,frost,11,2,9
Mauvé,blades-edge,169,mage,frost,10,5,5
Dødo,archimonde,159,mage,frost,5,2,3
Ivailo,ravencrest,159,mage,frost,5,2,3
Hord,zuljin,159,mage,frost,5,2,3
Kyan,burning-legion,159,mage,frost,5,2,3
Codeincassie,blackhand,138,mage,frost,10,4,6
Zôot,ravencrest,138,mage,frost,11,4,7
Drinte,blackmoore,138,mage,frost,10,3,7
Asmodeuz,spinebreaker,138,mage,frost,10,3,7
Winswin,stormscale,138,mage,frost,11,3,8
Lovesosa,malorne,138,mage,frost,13,3,10
Anazolium,outland,128,mage,frost,4,2,2
Швайго,gordunni,128,mage,frost,4,2,2
Klivapå,aggramar,128,mage,frost,4,2,2
Ostentatious,twisting-nether,128,mage,frost,4,2,2
Tehotyttö,dragonblight,128,mage,frost,4,2,2
Frostlocked,silvermoon,128,mage,frost,4,2,2
Felmington,silvermoon,127,mage,frost,4,2,2
Skitsó,shadowsong,127,mage,frost,4,2,2
Arghen,nemesis,105,mage,frost,13,3,10
Ntintsec,tarren-mill,96,mage,frost,3,2,1
Akharthion,defias-brotherhood,96,mage,frost,3,2,1
Firestárter,ravencrest,96,mage,frost,3,2,1
Чаклунхитрун,gordunni,96,mage,frost,6,1,5
Raktor,blackrock,96,mage,frost,6,1,5
Холдми,gordunni,96,mage,frost,6,1,5
Даатхедра,booty-bay,96,mage,frost,6,1,5
Колтрэйн,blackscar,96,mage,frost,6,1,5
Imshilling,ravencrest,96,mage,frost,6,1,5
Wingman,tarren-mill,96,mage,frost,6,1,5
Dóncójones,blackrock,96,mage,frost,6,1,5
Arcann,ravencrest,96,mage,frost,6,1,5
Homeessa,stormreaver,96,mage,frost,6,1,5
Loskapaska,stormreaver,96,mage,frost,6,1,5
Squirtee,drakthul,96,mage,frost,6,1,5
Vali,drakthul,96,mage,frost,6,1,5
Vildfogel,tarren-mill,96,mage,frost,6,1,5
Ghelder,drakthul,96,mage,frost,6,1,5
Coombuster,kazzak,96,mage,frost,6,1,5
Silmara,shadowsong,96,mage,frost,6,1,5
Pungvre,kazzak,96,mage,frost,6,1,5
Froostii,aegwynn,96,mage,frost,6,1,5
Sendera,taerar,96,mage,frost,6,1,5
Bebelusa,agamaggan,96,mage,frost,6,1,5
Ледянойкекс,gordunni,96,mage,frost,6,1,5
Aarcheon,kazzak,96,mage,frost,6,1,5
Miyukì,dun-morogh,96,mage,frost,6,1,5
Víóla,nagrand,96,mage,frost,6,1,5
Petri,laughing-skull,96,mage,frost,6,1,5
Dwarfyy,frostmane,96,mage,frost,6,1,5
Ноусес,soulflayer,96,mage,frost,6,1,5
Сморгонец,gordunni,96,mage,frost,6,1,5
Ekyoo,blackrock,96,mage,frost,6,1,5
Devòna,silvermoon,96,mage,frost,6,1,5
Sílvér,draenor,96,mage,frost,6,1,5
Drfunk,shadowsong,96,mage,frost,6,1,5
Rouxbignol,archimonde,96,mage,frost,6,1,5
Feudobois,archimonde,96,mage,frost,6,1,5
Cleanaf,hellfire,96,mage,frost,6,1,5
Poochmage,archimonde,96,mage,frost,6,1,5
Одз,grom,96,mage,frost,6,1,5
Wilhélm,twisting-nether,96,mage,frost,6,1,5
Testoletku,twisting-nether,96,mage,frost,6,1,5
Kpacey,guldan,96,mage,frost,6,1,5
Deathbrínger,alakir,96,mage,frost,6,1,5
Mésai,silvermoon,96,mage,frost,6,1,5
Rezre,stormscale,96,mage,frost,6,1,5
Volksmagier,ravencrest,96,mage,frost,6,1,5
Velkyn,ravencrest,96,mage,frost,6,1,5
Ibfear,twisting-nether,96,mage,frost,6,1,5
Hisokâ,eitrigg,96,mage,frost,6,1,5
Pflanzenn,nozdormu,96,mage,frost,6,1,5
Chimará,eredar,96,mage,frost,6,1,5
Sløbinia,blackhand,96,mage,frost,6,1,5
Sheeptonreup,archimonde,96,mage,frost,6,1,5
Dampgame,twisting-nether,96,mage,frost,6,1,5
Serbzor,stormscale,96,mage,frost,6,1,5
Trenpapi,twisting-nether,96,mage,frost,6,1,5
Eryssz,archimonde,96,mage,frost,6,1,5
Mëgu,silvermoon,96,mage,frost,6,1,5
Graell,archimonde,96,mage,frost,6,1,5
Meisterg,frostwolf,96,mage,frost,6,1,5
Rmforever,archimonde,96,mage,frost,6,1,5
Teeclis,twisting-nether,96,mage,frost,6,1,5
Adoptamage,hyjal,96,mage,frost,6,1,5
Niladyel,hyjal,96,mage,frost,6,1,5
Magîny,antonidas,96,mage,frost,6,1,5
Nullso,zuljin,96,mage,frost,6,1,5
Генстащитка,gordunni,96,mage,frost,6,1,5
Dphalos,ravencrest,96,mage,frost,6,1,5
Dyen,hyjal,96,mage,frost,6,1,5
Hurtinlo,dun-modr,96,mage,frost,6,1,5
Shawarm,stormscale,96,mage,frost,6,1,5
Alphaburstqx,ragnaros,96,mage,frost,6,1,5
Romaga,quelthalas,96,mage,frost,6,1,5
Squìshy,magtheridon,96,mage,frost,6,1,5
Keïji,khaz-modan,96,mage,frost,6,1,5
Ïcyveins,thrall,96,mage,frost,6,1,5
Rushhdj,exodar,96,mage,frost,6,1,5
Capz,outland,96,mage,frost,6,1,5
Rilac,nordrassil,96,mage,frost,6,1,5
Slavaroski,khaz-modan,96,mage,frost,6,1,5
Babynilli,ravencrest,96,mage,frost,6,1,5
Jâm,bronze-dragonflight,96,mage,frost,6,1,5
Cheeku,outland,96,mage,frost,6,1,5
Wàrpten,draenor,96,mage,frost,12,1,11
Vïto,zuljin,96,mage,frost,12,1,11
Snowy,sargeras,96,mage,frost,12,1,11
Pihkanaaras,stormscale,96,mage,frost,12,1,11
Fintexmex,ravencrest,96,mage,frost,12,1,11
Floé,twisting-nether,95,mage,frost,6,1,5
Зухвала,howling-fjord,95,mage,frost,6,1,5
Elkayizer,archimonde,95,mage,frost,12,1,11
Nalord,saurfang,95,mage,frost,12,1,11
Bagss,ysondre,95,mage,frost,12,1,11
Levora,ragnaros,79,mage,frost,5,1,4
Хаскивсказке,gordunni,64,mage,frost,4,1,3
Каппашилка,gordunni,64,mage,frost,4,1,3
Деозар,eversong,63,mage,frost,2,2,0
Magebraín,ravencrest,63,mage,frost,2,2,0
Gocu,tarren-mill,63,mage,frost,2,2,0
Натсумен,soulflayer,48,mage,frost,3,1,2
Ямурайхо,howling-fjord,48,mage,frost,3,1,2
Тачитачи,gordunni,48,mage,frost,3,1,2
Aeghis,darkspear,42,mage,frost,10,3,7
Avizura,argent-dawn,42,mage,frost,10,3,7
Mayreel,antonidas,42,mage,frost,11,3,8
Лайнэя,galakrond,42,mage,frost,10,2,8
Boned,ravencrest,42,mage,frost,17,3,14
Zibiz,outland,42,mage,frost,16,2,14
Sawaragi,blackmoore,31,mage,frost,2,1,1
Интровертка,blackscar,31,mage,frost,2,1,1
Jondahr,emerald-dream,31,mage,frost,8,1,7
Commadore,draenor,2339,monk,mistweaver,173,102,71
Cømmadore,sylvanas,2315,monk,mistweaver,115,70,45
Fister,zuljin,2305,monk,mistweaver,83,58,25
Fisterino,zuljin,2304,monk,mistweaver,54,42,12
Botweaver,tarren-mill,2297,monk,mistweaver,145,91,54
Nnsstt,zuljin,2290,monk,mistweaver,110,69,41
Cocojones,tarren-mill,2289,monk,mistweaver,209,143,66
Пиписечка,gordunni,2279,monk,mistweaver,126,80,46
Brickeduptwo,twisting-nether,2268,monk,mistweaver,180,132,48
Brickedup,twisting-nether,2267,monk,mistweaver,157,92,65
Лабирончик,blackscar,2263,monk,mistweaver,166,112,54
Lxstcxntury,stormscale,2254,monk,mistweaver,95,60,35
Фуфинус,gordunni,2254,monk,mistweaver,89,53,36
Sâu,twisting-nether,2249,monk,mistweaver,128,81,47
Kurbanov,stormscale,2249,monk,mistweaver,296,163,133
Керизз,gordunni,2245,monk,mistweaver,94,60,34
Bankmw,tarren-mill,2242,monk,mistweaver,107,70,37
Umadbrohuh,outland,2237,monk,mistweaver,99,60,39
Ínsanez,dun-modr,2232,monk,mistweaver,138,82,56
Lp,mugthol,2231,monk,mistweaver,90,59,31
Chichigneux,hyjal,2218,monk,mistweaver,134,87,47
Loiyah,dun-modr,2215,monk,mistweaver,138,75,63
Pivø,ravencrest,2212,monk,mistweaver,124,80,44
Nsnz,stormscale,2212,monk,mistweaver,209,121,88
Loiyh,dun-modr,2211,monk,mistweaver,144,77,67
Kanketoe,korgall,2210,monk,mistweaver,107,58,49
Sqxgodx,ragnaros,2209,monk,mistweaver,83,50,33
Kêkburagol,kazzak,2209,monk,mistweaver,246,148,98
Problematic,blackmoore,2207,monk,mistweaver,130,80,50
Loiythree,dun-modr,2199,monk,mistweaver,120,65,55
Kåtsumi,sanguino,2198,monk,mistweaver,199,127,72
Lifelessons,blackrock,2198,monk,mistweaver,81,49,32
Chsx,ravencrest,2196,monk,mistweaver,162,110,52
Djsqx,outland,2195,monk,mistweaver,70,41,29
Ðurîmar,ravencrest,2191,monk,mistweaver,115,68,47
Quendiz,frostwolf,2190,monk,mistweaver,96,52,44
Donitrivegas,blackrock,2188,monk,mistweaver,297,185,112
Zabjudah,stormscale,2186,monk,mistweaver,116,75,41
Montex,stormscale,2178,monk,mistweaver,149,78,71
Gloon,ravencrest,2176,monk,mistweaver,81,50,31
Swoshz,ragnaros,2175,monk,mistweaver,72,39,33
Monkdrak,eredar,2170,monk,mistweaver,75,48,27
Онимэшнеца,gordunni,2170,monk,mistweaver,77,48,29
Ballademager,magtheridon,2167,monk,mistweaver,154,88,66
Tierrax,cthun,2166,monk,mistweaver,129,69,60
Ashm,shattered-halls,2164,monk,mistweaver,152,87,65
Meliowo,ravencrest,2162,monk,mistweaver,108,62,46
Turricane,blackmoore,2160,monk,mistweaver,252,132,120
Trashcarlita,eredar,2159,monk,mistweaver,114,64,50
Sofunny,blackrock,2157,monk,mistweaver,141,86,55
Tryhârdx,stormscale,2157,monk,mistweaver,150,79,71
Srdarr,kazzak,2156,monk,mistweaver,144,86,58
Zaerin,eredar,2155,monk,mistweaver,67,39,28
Vienuolè,silvermoon,2149,monk,mistweaver,72,42,30
Nesedondondn,stormscale,2147,monk,mistweaver,101,64,37
Lyashi,dalaran,2147,monk,mistweaver,107,56,51
Bigbøøty,silvermoon,2145,monk,mistweaver,96,50,46
Nawak,archimonde,2144,monk,mistweaver,201,108,93
Фунтос,soulflayer,2142,monk,mistweaver,72,45,27
Ltmdwarf,ravencrest,2142,monk,mistweaver,108,59,49
Buddiline,baelgun,2142,monk,mistweaver,114,60,54
Shonbadatret,argent-dawn,2141,monk,mistweaver,132,79,53
Loofey,ragnaros,2140,monk,mistweaver,242,140,102
Akanetsu,kazzak,2139,monk,mistweaver,138,80,58
Ðalvan,blackrock,2139,monk,mistweaver,114,62,52
Xámell,ravencrest,2133,monk,mistweaver,96,49,47
Lízãriñ,ravencrest,2132,monk,mistweaver,265,174,91
Maedicweaver,aegwynn,2130,monk,mistweaver,66,48,18
Mønkeÿ,ravencrest,2130,monk,mistweaver,70,42,28
Veganweaver,ravencrest,2129,monk,mistweaver,78,50,28
Ltmxy,ravencrest,2127,monk,mistweaver,66,40,26
Mibe,alonsus,2127,monk,mistweaver,222,113,109
Vivie,destromath,2126,monk,mistweaver,78,48,30
Willxmonk,silvermoon,2126,monk,mistweaver,101,56,45
Shorus,blackmoore,2125,monk,mistweaver,132,84,48
Monkield,kazzak,2125,monk,mistweaver,400,230,170
Rocknreroll,executus,2124,monk,mistweaver,300,171,129
Гроксси,howling-fjord,2122,monk,mistweaver,206,127,79
Notzaele,zuljin,2122,monk,mistweaver,240,130,110
Quendi,frostwolf,2122,monk,mistweaver,352,177,175
Sinted,blackmoore,2120,monk,mistweaver,107,65,42
Flowy,uldum,2120,monk,mistweaver,66,34,32
Cítysushi,draenor,2119,monk,mistweaver,442,239,203
Beetlejuicé,stormscale,2118,monk,mistweaver,42,28,14
Mharlie,stormscale,2117,monk,mistweaver,291,158,133
Дамбмонк,blackscar,2116,monk,mistweaver,76,46,30
Sookrates,ragnaros,2116,monk,mistweaver,176,101,75
Monkrah,blackmoore,2116,monk,mistweaver,138,75,63
Ûwù,ravencrest,2115,monk,mistweaver,72,55,17
Fortnitekid,outland,2115,monk,mistweaver,160,102,58
Bmane,archimonde,2114,monk,mistweaver,71,40,31
Bjj,blackrock,2113,monk,mistweaver,83,48,35
Bighealz,aggra-português,2113,monk,mistweaver,77,43,34
Dekaramw,ravencrest,2112,monk,mistweaver,42,33,9
Vanost,kazzak,2112,monk,mistweaver,170,86,84
Jimpaa,outland,2111,monk,mistweaver,149,95,54
Tigermw,twisting-nether,2111,monk,mistweaver,166,97,69
Brxndimonk,antonidas,2111,monk,mistweaver,117,68,49
Diorc,outland,2110,monk,mistweaver,212,116,96
Seeyoulater,nemesis,2110,monk,mistweaver,354,184,170
Cranex,terenas,2109,monk,mistweaver,118,72,46
Blacktee,eredar,2109,monk,mistweaver,78,44,34
Кулакх,blackscar,2109,monk,mistweaver,208,113,95
Egg,frostmane,2108,monk,mistweaver,96,62,34
Neszesmonk,ragnaros,2108,monk,mistweaver,391,210,181
Нимбмонк,soulflayer,2108,monk,mistweaver,89,45,44
Йорита,soulflayer,2107,monk,mistweaver,102,59,43
Mememaster,blackhand,2106,monk,mistweaver,172,105,67
Lmnsx,ravencrest,2106,monk,mistweaver,96,56,40
Elmezz,burning-legion,2106,monk,mistweaver,99,50,49
Deepl,dun-modr,2105,monk,mistweaver,78,45,33
Meldi,ravencrest,2104,monk,mistweaver,78,46,32
Боецкфц,soulflayer,2104,monk,mistweaver,82,46,36
Syy,medivh,2104,monk,mistweaver,66,35,31
Bobthewild,draenor,2104,monk,mistweaver,449,233,216
Wajøba,blackhand,2103,monk,mistweaver,66,37,29
Fisterbean,outland,2103,monk,mistweaver,72,40,32
Ruurruuru,archimonde,2102,monk,mistweaver,245,140,105
Кулачонка,blackscar,2102,monk,mistweaver,119,68,51
Blubberwurst,gorgonnash,2102,monk,mistweaver,130,74,56
Webhottie,twisting-nether,2102,monk,mistweaver,155,88,67
Karsat,hyjal,2102,monk,mistweaver,639,339,300
Wajoba,blackhand,2102,monk,mistweaver,114,58,56
Глитч,deepholm,2100,monk,mistweaver,66,43,23
Adgoh,tarren-mill,2100,monk,mistweaver,94,61,33
Hiryu,argent-dawn,2100,monk,mistweaver,125,75,50
Yellowtape,kiljaeden,2100,monk,mistweaver,215,127,88
Pennøe,ravencrest,2100,monk,mistweaver,128,73,55
Dollyqt,ravencrest,2100,monk,mistweaver,90,46,44
Skïrmíshgødx,ravencrest,2100,monk,mistweaver,108,55,53
Lylleri,darksorrow,2089,monk,mistweaver,68,40,28
Qwertyxo,draenor,2087,monk,mistweaver,394,230,164
Кербю,gordunni,2083,monk,mistweaver,137,74,63
Strillen,twisting-nether,2083,monk,mistweaver,360,192,168
Iminar,blackrock,2082,monk,mistweaver,156,86,70
Zonsym,twisting-nether,2082,monk,mistweaver,264,144,120
Speedahx,dun-modr,2079,monk,mistweaver,196,115,81
Maybeexm,ravencrest,2077,monk,mistweaver,114,68,46
Анимешнеца,gordunni,2077,monk,mistweaver,78,41,37
Mergina,silvermoon,2077,monk,mistweaver,114,59,55
Jmw,silvermoon,2074,monk,mistweaver,95,62,33
Кимлейн,blackscar,2072,monk,mistweaver,60,36,24
Monkeyi,silvermoon,2071,monk,mistweaver,155,79,76
Lîlilîlîlîlí,stormscale,2066,monk,mistweaver,66,37,29
Кодизи,gordunni,2063,monk,mistweaver,83,53,30
Myeers,dun-modr,2063,monk,mistweaver,348,194,154
Zevenblad,stormscale,2063,monk,mistweaver,123,66,57
Wrynja,blackmoore,2061,monk,mistweaver,121,73,48
Førzãlêvskî,ravencrest,2059,monk,mistweaver,105,70,35
Tímmz,blackrock,2058,monk,mistweaver,126,71,55
Roadrunnér,ravencrest,2058,monk,mistweaver,138,74,64
Monkeystar,archimonde,2056,monk,mistweaver,143,79,64
Marvboy,aegwynn,2055,monk,mistweaver,72,46,26
Swoshz,sylvanas,2051,monk,mistweaver,78,44,34
Kêza,culte-de-la-rive-noire,2050,monk,mistweaver,48,28,20
Леолайт,borean-tundra,2048,monk,mistweaver,124,70,54
Mistkueefer,tarren-mill,2045,monk,mistweaver,60,34,26
Ouhmaikgød,dun-modr,2045,monk,mistweaver,314,160,154
Vienuole,silvermoon,2039,monk,mistweaver,101,53,48
Pizelx,ravencrest,2039,monk,mistweaver,110,55,55
Insanepace,blackmoore,2035,monk,mistweaver,283,148,135
Timmzý,blackmoore,2033,monk,mistweaver,167,98,69
Joke,ragnaros,2033,monk,mistweaver,144,72,72
Pizzabud,ravencrest,2031,monk,mistweaver,76,48,28
Фейкнаут,soulflayer,2031,monk,mistweaver,204,111,93
Gresmar,defias-brotherhood,2030,monk,mistweaver,101,54,47
Djreckx,kazzak,2029,monk,mistweaver,66,44,22
Loobee,ravencrest,2027,monk,mistweaver,66,37,29
Shanlle,dun-modr,2025,monk,mistweaver,155,77,78
Lanuia,aegwynn,2024,monk,mistweaver,69,45,24
Mugenzen,sanguino,2022,monk,mistweaver,60,30,30
Uao,tarren-mill,2022,monk,mistweaver,72,34,38
Слишкомхорош,thermaplugg,2021,monk,mistweaver,53,38,15
Youkâi,blackrock,2020,monk,mistweaver,89,46,43
Frkn,blackrock,2019,monk,mistweaver,126,74,52
Marqinio,archimonde,2019,monk,mistweaver,102,57,45
Chitea,argent-dawn,2019,monk,mistweaver,88,47,41
Snówtea,silvermoon,2018,monk,mistweaver,74,40,34
Mickeyworms,archimonde,2018,monk,mistweaver,76,37,39
Sushiroller,blackrock,2017,monk,mistweaver,126,70,56
Haìryplotter,kazzak,2017,monk,mistweaver,348,191,157
Ганссмонк,blackscar,2015,monk,mistweaver,239,125,114
Kaguræ,hyjal,2013,monk,mistweaver,83,48,35
Texiq,drakthul,2012,monk,mistweaver,512,285,227
Stringg,zuljin,2012,monk,mistweaver,360,196,164
Pwner,daggerspine,2012,monk,mistweaver,328,175,153
Shadezz,blackmoore,2011,monk,mistweaver,117,75,42
Fåtjøë,ravencrest,2010,monk,mistweaver,48,31,17
Flandersmonk,ravencrest,2008,monk,mistweaver,96,60,36
Howtoown,burning-legion,2008,monk,mistweaver,72,42,30
Шортмневноги,howling-fjord,2008,monk,mistweaver,137,74,63
Øméga,ravencrest,2006,monk,mistweaver,212,137,75
Lanory,blackmoore,2005,monk,mistweaver,78,49,29
Угвей,deepholm,2003,monk,mistweaver,52,38,14
Darkllinè,twisting-nether,2003,monk,mistweaver,236,122,114
Суммрачная,gordunni,2002,monk,mistweaver,144,89,55
Zeoverx,ragnaros,2000,monk,mistweaver,84,39,45
Skailzkrtwo,hyjal,1996,monk,mistweaver,120,64,56
Xàmell,kazzak,1995,monk,mistweaver,50,33,17
Kêkbûrâgól,kazzak,1994,monk,mistweaver,193,103,90
Another,frostmourne,1993,monk,mistweaver,179,107,72
Mösêê,eredar,1992,monk,mistweaver,88,39,49
Melysà,antonidas,1991,monk,mistweaver,87,48,39
Bigmilkies,ysondre,1991,monk,mistweaver,200,108,92
Féfè,archimonde,1991,monk,mistweaver,108,57,51
Àjay,outland,1990,monk,mistweaver,66,45,21
Toram,burning-legion,1990,monk,mistweaver,114,61,53
Çoomðragon,stormscale,1989,monk,mistweaver,48,33,15
Couchfrmikea,twisting-nether,1988,monk,mistweaver,102,52,50
Кекичан,gordunni,1985,monk,mistweaver,125,79,46
Wernos,archimonde,1983,monk,mistweaver,78,47,31
Holyrop,aegwynn,1982,monk,mistweaver,36,25,11
Abdulhealer,stormscale,1982,monk,mistweaver,96,46,50
Trifogeorge,archimonde,1981,monk,mistweaver,60,38,22
Hélpx,stormscale,1980,monk,mistweaver,66,35,31
Groyaboy,twisting-nether,1979,monk,mistweaver,84,58,26
Gronkr,draenor,1979,monk,mistweaver,285,148,137
Pizelx,alakir,1977,monk,mistweaver,112,60,52
Batmanwife,stormscale,1976,monk,mistweaver,89,48,41
Фунтос,gordunni,1975,monk,mistweaver,96,60,36
Demmonkz,stormreaver,1975,monk,mistweaver,90,53,37
Fshn,sylvanas,1974,monk,mistweaver,37,26,11
Fullzi,dalaran,1973,monk,mistweaver,66,36,30
Selendis,terrordar,1973,monk,mistweaver,395,202,193
Xadez,ravencrest,1971,monk,mistweaver,128,74,54
Bigbummer,blackmoore,1971,monk,mistweaver,324,166,158
Wèéman,grim-batol,1970,monk,mistweaver,66,44,22
Jackål,silvermoon,1969,monk,mistweaver,109,60,49
Вульфхильда,soulflayer,1967,monk,mistweaver,288,159,129
Musclemage,turalyon,1965,monk,mistweaver,78,46,32
Nsq,ravencrest,1965,monk,mistweaver,90,48,42
Môûsè,ravencrest,1964,monk,mistweaver,216,117,99
Butterbean,conseil-des-ombres,1963,monk,mistweaver,109,66,43
Jinxini,twisting-nether,1962,monk,mistweaver,42,31,11
Wrathx,draenor,1962,monk,mistweaver,132,85,47
Killibrew,ravencrest,1961,monk,mistweaver,138,84,54
Yexìu,kult-der-verdammten,1961,monk,mistweaver,72,41,31
Prototyp,burning-legion,1961,monk,mistweaver,184,96,88
Beili,ravencrest,1960,monk,mistweaver,85,46,39
Homes,blackmoore,1959,monk,mistweaver,176,96,80
Fansolini,burning-legion,1959,monk,mistweaver,81,44,37
Chailatte,kazzak,1958,monk,mistweaver,54,36,18
Neyoklol,blackrock,1958,monk,mistweaver,162,95,67
Kapud,twisting-nether,1958,monk,mistweaver,84,47,37
Фунтих,soulflayer,1957,monk,mistweaver,70,39,31
Phyxone,twisting-nether,1956,monk,mistweaver,72,40,32
Pabloboy,kazzak,1955,monk,mistweaver,112,49,63
Yoogychi,ravencrest,1953,monk,mistweaver,42,28,14
Jiest,outland,1952,monk,mistweaver,60,40,20
Wh,terenas,1952,monk,mistweaver,48,27,21
Erannas,turalyon,1952,monk,mistweaver,71,38,33
Pennyflame,stormscale,1952,monk,mistweaver,149,77,72
Анстапоблх,grom,1951,monk,mistweaver,114,52,62
Jam,aerie-peak,1949,monk,mistweaver,54,35,19
Manjini,blackhand,1949,monk,mistweaver,147,76,71
Фдма,soulflayer,1948,monk,mistweaver,89,51,38
Magixc,drakthul,1947,monk,mistweaver,158,90,68
Exbuddhist,outland,1947,monk,mistweaver,78,41,37
Lanvia,argent-dawn,1946,monk,mistweaver,228,129,99
Srav,archimonde,1946,monk,mistweaver,152,85,67
Digzzy,draenor,1946,monk,mistweaver,140,76,64
Wwvwwvwwvwwv,ragnaros,1946,monk,mistweaver,102,49,53
Alomonk,archimonde,1945,monk,mistweaver,40,29,11
Tjann,stormscale,1944,monk,mistweaver,138,90,48
Mistyhoe,twisting-nether,1944,monk,mistweaver,312,160,152
Ajay,outland,1942,monk,mistweaver,66,36,30
Rolxx,twisting-nether,1942,monk,mistweaver,229,117,112
Aromipesäx,outland,1941,monk,mistweaver,107,57,50
Monkeymain,tarren-mill,1939,monk,mistweaver,136,68,68
Basilbrushxd,stormscale,1936,monk,mistweaver,60,35,25
Chanzey,silvermoon,1936,monk,mistweaver,342,189,153
Bads,sanguino,1935,monk,mistweaver,96,57,39
Fashion,outland,1934,monk,mistweaver,60,38,22
Chichi,ravencrest,1934,monk,mistweaver,572,298,274
Lildaddymonk,ravencrest,1933,monk,mistweaver,89,39,50
Chisurgeon,outland,1931,monk,mistweaver,36,22,14
Incmines,ravencrest,1931,monk,mistweaver,92,50,42
Stemanit,draenor,1930,monk,mistweaver,112,65,47
Brofistmw,outland,1930,monk,mistweaver,218,116,102
Podekouil,ysondre,1929,monk,mistweaver,42,28,14
Tidemist,argent-dawn,1929,monk,mistweaver,77,50,27
Lildaddymunk,ravencrest,1928,monk,mistweaver,54,31,23
Trnd,draenor,1928,monk,mistweaver,80,37,43
Vingurd,terokkar,1927,monk,mistweaver,63,35,28
Nuke,steamwheedle-cartel,1927,monk,mistweaver,81,42,39
Fistus,dentarg,1927,monk,mistweaver,74,38,36
Arenatwo,outland,1925,monk,mistweaver,93,56,37
Fistpunk,kazzak,1925,monk,mistweaver,75,40,35
Pudgefeed,silvermoon,1924,monk,mistweaver,108,65,43
Hajlong,outland,1922,monk,mistweaver,83,43,40
Machó,kazzak,1922,monk,mistweaver,71,36,35
Jamiedhism,ravencrest,1922,monk,mistweaver,72,36,36
Péppy,aegwynn,1921,monk,mistweaver,64,38,26
Dmonk,aegwynn,1921,monk,mistweaver,185,87,98
Mëñghûøx,sylvanas,1920,monk,mistweaver,43,25,18
Déffly,ravencrest,1920,monk,mistweaver,72,38,34
Çheeks,kazzak,1920,monk,mistweaver,60,31,29
Mafiazøo,hyjal,1919,monk,mistweaver,154,95,59
Dmonkz,magtheridon,1919,monk,mistweaver,126,70,56
Cåpybårå,outland,1919,monk,mistweaver,422,222,200
Gaalon,ravencrest,1916,monk,mistweaver,24,20,4
Øllen,stormscale,1916,monk,mistweaver,157,79,78
Døk,twisting-nether,1915,monk,mistweaver,54,35,19
Kratzl,blackrock,1915,monk,mistweaver,72,45,27
Æøwyn,ragnaros,1915,monk,mistweaver,178,106,72
Tinydolls,archimonde,1915,monk,mistweaver,42,24,18
Panson,twisting-nether,1915,monk,mistweaver,90,45,45
Tanata,blackmoore,1914,monk,mistweaver,135,86,49
Kóan,stormscale,1914,monk,mistweaver,483,255,228
Perceptîon,thrall,1913,monk,mistweaver,168,89,79
Remyhadley,dun-modr,1912,monk,mistweaver,95,55,40
Ryx,twisting-nether,1912,monk,mistweaver,133,71,62
Porcman,archimonde,1912,monk,mistweaver,207,108,99
Yoghurtz,frostmourne,1911,monk,mistweaver,264,142,122
Residùe,kazzak,1909,monk,mistweaver,130,71,59
Кувырбек,howling-fjord,1906,monk,mistweaver,48,32,16
Yuukiiqt,kult-der-verdammten,1906,monk,mistweaver,137,73,64
Meemyo,blackmoore,1904,monk,mistweaver,83,34,49
Muchobijca,defias-brotherhood,1903,monk,mistweaver,84,47,37
Notachi,doomhammer,1903,monk,mistweaver,285,159,126
Koguosa,outland,1902,monk,mistweaver,54,37,17
Sikaan,blackhand,1902,monk,mistweaver,54,32,22
Ipmanlol,archimonde,1902,monk,mistweaver,244,139,105
Brxmonki,antonidas,1902,monk,mistweaver,95,53,42
Yadokaí,darkmoon-faire,1901,monk,mistweaver,84,47,37
Ilovesanrio,kazzak,1900,monk,mistweaver,110,69,41
Monkeycoke,ragnaros,1900,monk,mistweaver,47,29,18
Zoida,azuremyst,1900,monk,mistweaver,478,242,236
Poyi,ravencrest,1899,monk,mistweaver,36,25,11
ßockwurst,tarren-mill,1899,monk,mistweaver,53,29,24
Monkbtw,kazzak,1898,monk,mistweaver,42,32,10
Subàru,draenor,1898,monk,mistweaver,93,60,33
Alessîca,aegwynn,1898,monk,mistweaver,66,37,29
Halùnkè,eredar,1898,monk,mistweaver,281,153,128
Siignmonk,ravencrest,1898,monk,mistweaver,266,139,127
Fistíe,sylvanas,1896,monk,mistweaver,45,32,13
Munktjejen,argent-dawn,1896,monk,mistweaver,36,20,16
Seventhirty,ravencrest,1896,monk,mistweaver,36,20,16
Djsnake,blackrock,1895,monk,mistweaver,84,47,37
Bekachu,ragnaros,1894,monk,mistweaver,48,34,14
Crñ,blackmoore,1894,monk,mistweaver,56,32,24
Bossmanfred,outland,1893,monk,mistweaver,96,66,30
Kéza,culte-de-la-rive-noire,1893,monk,mistweaver,40,25,15
Shirkán,ragnaros,1893,monk,mistweaver,168,92,76
Коконгкд,blackscar,1893,monk,mistweaver,532,277,255
Cptschneider,blackmoore,1892,monk,mistweaver,60,40,20
Holymonkx,nagrand,1892,monk,mistweaver,117,73,44
Véxyra,draenor,1892,monk,mistweaver,60,36,24
Judochops,sylvanas,1892,monk,mistweaver,60,29,31
Plânche,outland,1891,monk,mistweaver,72,48,24
Traickomonk,eredar,1891,monk,mistweaver,48,29,19
Shâng,blackhand,1891,monk,mistweaver,96,55,41
Ûnknöw,archimonde,1891,monk,mistweaver,72,41,31
Swagmonk,silvermoon,1891,monk,mistweaver,158,79,79
Mistreeker,tarren-mill,1890,monk,mistweaver,48,37,11
Uwû,ravencrest,1890,monk,mistweaver,107,73,34
Waramow,eredar,1890,monk,mistweaver,48,32,16
Jokkemonk,silvermoon,1890,monk,mistweaver,95,56,39
Dog,garona,1890,monk,mistweaver,126,63,63
Yum,anetheron,1889,monk,mistweaver,126,67,59
Brewstea,kazzak,1889,monk,mistweaver,150,79,71
Tøwtc,outland,1888,monk,mistweaver,102,64,38
Astromune,draenor,1888,monk,mistweaver,77,41,36
Zælyqt,archimonde,1887,monk,mistweaver,44,30,14
Babysaurus,ravencrest,1887,monk,mistweaver,120,78,42
Rokux,kazzak,1887,monk,mistweaver,49,28,21
Hamsster,ravencrest,1886,monk,mistweaver,278,148,130
Zanzetsu,twisting-nether,1886,monk,mistweaver,269,143,126
Heartless,sporeggar,1885,monk,mistweaver,287,173,114
Pikemi,dun-modr,1883,monk,mistweaver,138,86,52
Tedelbrew,kazzak,1883,monk,mistweaver,36,20,16
Schøcker,blackmoore,1881,monk,mistweaver,77,42,35
Репабликус,gordunni,1880,monk,mistweaver,48,27,21
Нопеурорсогп,soulflayer,1879,monk,mistweaver,60,35,25
Manatoiled,draenor,1879,monk,mistweaver,72,39,33
Эифорйя,howling-fjord,1879,monk,mistweaver,306,156,150
Vizfist,tarren-mill,1879,monk,mistweaver,60,29,31
Рендикаое,soulflayer,1878,monk,mistweaver,229,128,101
Fredmonk,stormscale,1878,monk,mistweaver,78,43,35
Людзяо,galakrond,1878,monk,mistweaver,170,92,78
Babbub,tarren-mill,1877,monk,mistweaver,156,91,65
Iliketofist,ravencrest,1877,monk,mistweaver,88,50,38
Jingfeng,arthas,1877,monk,mistweaver,212,110,102
Yungsooth,stormscale,1876,monk,mistweaver,107,68,39
Enoffovicz,archimonde,1876,monk,mistweaver,156,94,62
Voltzeig,dentarg,1876,monk,mistweaver,408,209,199
Nåwãk,archimonde,1875,monk,mistweaver,145,71,74
Holyropx,aegwynn,1874,monk,mistweaver,54,33,21
Амаранточка,howling-fjord,1874,monk,mistweaver,102,61,41
Tøxicweaver,kazzak,1873,monk,mistweaver,36,21,15
Sleepleaf,silvermoon,1873,monk,mistweaver,82,43,39
Mistyfox,aszune,1873,monk,mistweaver,119,59,60
Bicmex,archimonde,1873,monk,mistweaver,102,50,52
Onaiâ,ravencrest,1871,monk,mistweaver,84,54,30
Yamqt,thrall,1871,monk,mistweaver,63,39,24
Mugn,sanguino,1871,monk,mistweaver,50,30,20
Taeyhung,thrall,1870,monk,mistweaver,165,94,71
Zekm,alleria,1869,monk,mistweaver,102,71,31
Pamtu,dun-modr,1869,monk,mistweaver,114,74,40
Минимонахх,blackscar,1869,monk,mistweaver,90,58,32
Саас,gordunni,1869,monk,mistweaver,89,49,40
Onlyfunds,blackrock,1868,monk,mistweaver,36,27,9
Fisterinos,blackrock,1868,monk,mistweaver,192,123,69
Crymonkya,aegwynn,1867,monk,mistweaver,256,150,106
Carlteaz,drakthul,1867,monk,mistweaver,198,114,84
Dr,sylvanas,1867,monk,mistweaver,60,34,26
Luru,outland,1867,monk,mistweaver,83,47,36
Oikodomos,twisting-nether,1867,monk,mistweaver,142,79,63
Siphem,ravencrest,1867,monk,mistweaver,369,195,174
Séi,kazzak,1867,monk,mistweaver,48,25,23
Soulring,kazzak,1867,monk,mistweaver,75,38,37
Kungfublyat,twisting-nether,1865,monk,mistweaver,83,57,26
Ræïzò,dun-morogh,1865,monk,mistweaver,58,34,24
Флориусс,soulflayer,1865,monk,mistweaver,71,37,34
Hurricaine,hyjal,1864,monk,mistweaver,36,23,13
Факингдог,blackscar,1864,monk,mistweaver,45,26,19
Patiencebro,archimonde,1863,monk,mistweaver,84,48,36
Wrox,sylvanas,1863,monk,mistweaver,220,125,95
Neyoklan,blackrock,1863,monk,mistweaver,132,73,59
Jiafei,tarren-mill,1862,monk,mistweaver,42,25,17
Cptsensey,draenor,1861,monk,mistweaver,42,29,13
Räpeltäjä,stormreaver,1861,monk,mistweaver,108,68,40
Jabington,aegwynn,1860,monk,mistweaver,133,80,53
Лемонк,gordunni,1860,monk,mistweaver,82,40,42
Ранки,lich-king,1860,monk,mistweaver,66,31,35
Wåñmëíßãøx,sylvanas,1859,monk,mistweaver,58,34,24
Nule,outland,1859,monk,mistweaver,59,31,28
Джулибубба,borean-tundra,1858,monk,mistweaver,105,67,38
Cæsifer,ungoro,1858,monk,mistweaver,59,33,26
Rullsimpa,ravencrest,1858,monk,mistweaver,77,34,43
Deeyna,defias-brotherhood,1857,monk,mistweaver,137,74,63
Swaghäuser,blackmoore,1857,monk,mistweaver,320,172,148
Dragzol,tarren-mill,1856,monk,mistweaver,162,81,81
Capkum,dun-modr,1855,monk,mistweaver,218,113,105
Crôcøpx,blackhand,1855,monk,mistweaver,78,39,39
Løta,blackmoore,1854,monk,mistweaver,101,64,37
Päws,kazzak,1854,monk,mistweaver,65,37,28
Flowey,uldum,1854,monk,mistweaver,48,21,27
Powerloom,aegwynn,1853,monk,mistweaver,60,44,16
Atralês,azshara,1853,monk,mistweaver,75,44,31
Fùckaround,emeriss,1853,monk,mistweaver,149,82,67
Redneckfist,draenor,1852,monk,mistweaver,88,61,27
Táy,ravencrest,1852,monk,mistweaver,114,68,46
Doffm,auchindoun,1851,monk,mistweaver,125,74,51
Jemp,ravencrest,1851,monk,mistweaver,598,329,269
Playbîrd,archimonde,1851,monk,mistweaver,112,61,51
Itwillbenice,archimonde,1849,monk,mistweaver,48,33,15
Saibell,scarshield-legion,1849,monk,mistweaver,144,89,55
Мичан,howling-fjord,1849,monk,mistweaver,146,88,58
Grauwe,stormscale,1848,monk,mistweaver,63,39,24
Vöyage,kazzak,1848,monk,mistweaver,48,26,22
Madraven,ravencrest,1846,monk,mistweaver,66,28,38
Tasteh,cthun,1844,monk,mistweaver,67,43,24
Фешнмонк,soulflayer,1844,monk,mistweaver,137,83,54
Zxcursèd,tarren-mill,1844,monk,mistweaver,60,36,24
Nouraxo,kazzak,1844,monk,mistweaver,220,120,100
Cdriscas,aggra-português,1844,monk,mistweaver,178,97,81
Neisha,drakthul,1843,monk,mistweaver,108,66,42
Enveløp,stormscale,1842,monk,mistweaver,42,29,13
Chazu,outland,1842,monk,mistweaver,78,41,37
Thiiogg,archimonde,1842,monk,mistweaver,113,57,56
Poohya,silvermoon,1842,monk,mistweaver,48,24,24
Zöumi,ravencrest,1841,monk,mistweaver,314,168,146
Monkgolitaxd,dun-modr,1841,monk,mistweaver,837,434,403
Peace,aerie-peak,1840,monk,mistweaver,47,33,14
Stdzym,tarren-mill,1840,monk,mistweaver,146,71,75
Panicfist,stormscale,1839,monk,mistweaver,141,88,53
Legsweep,blackhand,1839,monk,mistweaver,187,115,72
Monkler,blackhand,1839,monk,mistweaver,114,57,57
Justacomma,outland,1839,monk,mistweaver,60,29,31
Pøhx,ragnaros,1838,monk,mistweaver,132,74,58
Motang,blackmoore,1837,monk,mistweaver,68,38,30
Mwmonk,blackrock,1836,monk,mistweaver,65,42,23
Mommymonk,outland,1836,monk,mistweaver,103,57,46
Hurri,krasus,1835,monk,mistweaver,48,32,16
Bonnybravo,wildhammer,1834,monk,mistweaver,54,36,18
Ultdave,eredar,1834,monk,mistweaver,251,142,109
Бадика,howling-fjord,1834,monk,mistweaver,343,183,160
Extrimist,sylvanas,1834,monk,mistweaver,358,190,168
Muerb,die-arguswacht,1833,monk,mistweaver,51,30,21
Bmwmthree,draenor,1832,monk,mistweaver,165,84,81
Mikalou,sylvanas,1831,monk,mistweaver,34,25,9
Ønlyfäns,kazzak,1831,monk,mistweaver,112,67,45
Belärus,outland,1831,monk,mistweaver,66,39,27
Dojoman,draenor,1830,monk,mistweaver,48,35,13
Tmnmnk,alakir,1830,monk,mistweaver,29,20,9
Annoyingtwo,archimonde,1830,monk,mistweaver,90,56,34
Exru,draenor,1830,monk,mistweaver,45,26,19
Otemøøn,sanguino,1830,monk,mistweaver,87,48,39
Кикподхвост,blackscar,1829,monk,mistweaver,102,52,50
Limbaskalol,dun-modr,1829,monk,mistweaver,623,314,309
Santoron,baelgun,1829,monk,mistweaver,75,36,39
Callysra,archimonde,1828,monk,mistweaver,58,40,18
Мефодийкун,howling-fjord,1828,monk,mistweaver,165,92,73
Xameht,the-maelstrom,1828,monk,mistweaver,301,163,138
Нубстриимс,gordunni,1828,monk,mistweaver,62,33,29
Mêshuggâh,malganis,1828,monk,mistweaver,102,52,50
Kuug,ravencrest,1827,monk,mistweaver,107,65,42
Wrv,kazzak,1827,monk,mistweaver,403,210,193
Sonydl,archimonde,1827,monk,mistweaver,118,57,61
Xurf,draenor,1825,monk,mistweaver,142,88,54
Soothz,uldaman,1824,monk,mistweaver,60,42,18
Scribzw,twisting-nether,1824,monk,mistweaver,77,43,34
Calmed,tarren-mill,1824,monk,mistweaver,295,163,132
Элонхаск,gordunni,1824,monk,mistweaver,54,29,25
Sprutleif,auchindoun,1823,monk,mistweaver,112,77,35
Maesha,ahnqiraj,1823,monk,mistweaver,90,57,33
Campix,blackmoore,1823,monk,mistweaver,153,92,61
Fulgrem,stormscale,1823,monk,mistweaver,135,81,54
Dokternelg,silvermoon,1823,monk,mistweaver,54,32,22
Sugra,frostwolf,1823,monk,mistweaver,87,50,37
Actionsusi,area-52,1823,monk,mistweaver,54,31,23
Perelman,burning-legion,1823,monk,mistweaver,138,75,63
Cochonhalall,archimonde,1823,monk,mistweaver,102,53,49
Nèver,dalaran,1822,monk,mistweaver,48,29,19
Raveleth,silvermoon,1822,monk,mistweaver,90,53,37
Sadmw,archimonde,1822,monk,mistweaver,54,28,26
Jongxina,ravencrest,1822,monk,mistweaver,73,34,39
Aessella,antonidas,1821,monk,mistweaver,48,29,19
Çhên,draenor,1821,monk,mistweaver,173,104,69
Лиянь,soulflayer,1821,monk,mistweaver,114,65,49
Karmasnitch,antonidas,1821,monk,mistweaver,90,50,40
Шенген,soulflayer,1821,monk,mistweaver,198,108,90
Shehulkk,ravencrest,1821,monk,mistweaver,90,48,42
Jiuhjitsu,blackmoore,1820,monk,mistweaver,60,34,26
Nqar,ravencrest,1820,monk,mistweaver,84,47,37
Zlodey,laughing-skull,1820,monk,mistweaver,127,70,57
Polch,archimonde,1820,monk,mistweaver,84,41,43
Almonkdiga,sanguino,1819,monk,mistweaver,108,58,50
Sushirøll,draenor,1818,monk,mistweaver,73,47,26
Hokespokus,silvermoon,1818,monk,mistweaver,106,68,38
Камикадзэн,gordunni,1818,monk,mistweaver,156,100,56
Слишкомхорош,howling-fjord,1818,monk,mistweaver,30,19,11
Шэганэ,deathguard,1818,monk,mistweaver,74,45,29
Birgitbuddha,gorgonnash,1818,monk,mistweaver,90,53,37
Elamø,sanguino,1818,monk,mistweaver,131,77,54
Типмах,howling-fjord,1818,monk,mistweaver,92,54,38
Shushux,ysondre,1818,monk,mistweaver,36,21,15
Ariliaxo,blackhand,1817,monk,mistweaver,60,40,20
Qwértsy,stormscale,1817,monk,mistweaver,102,63,39
Natsuø,nemesis,1817,monk,mistweaver,78,46,32
Флориус,soulflayer,1817,monk,mistweaver,65,36,29
Claudiå,kazzak,1817,monk,mistweaver,111,56,55
Аци,blackscar,1816,monk,mistweaver,88,57,31
Endir,mazrigos,1816,monk,mistweaver,161,101,60
Menecares,blackhand,1816,monk,mistweaver,41,24,17
Precocconx,stormreaver,1816,monk,mistweaver,36,19,17
Твикса,soulflayer,1816,monk,mistweaver,114,54,60
Jades,emeriss,1815,monk,mistweaver,274,136,138
Papimonkx,garona,1815,monk,mistweaver,54,25,29
Mwaneu,archimonde,1814,monk,mistweaver,66,40,26
Nêøø,blackrock,1814,monk,mistweaver,340,201,139
Zulein,defias-brotherhood,1814,monk,mistweaver,36,21,15
Jolude,nemesis,1814,monk,mistweaver,212,115,97
Тамаз,gordunni,1814,monk,mistweaver,59,24,35
Millhouse,die-aldor,1813,monk,mistweaver,128,69,59
Oukaläv,archimonde,1813,monk,mistweaver,113,59,54
Колтиняшка,blackscar,1812,monk,mistweaver,77,59,18
Seandyche,ravencrest,1812,monk,mistweaver,40,26,14
Inear,chogall,1812,monk,mistweaver,397,211,186
Kæmará,blackrock,1812,monk,mistweaver,98,52,46
Teampro,ragnaros,1812,monk,mistweaver,365,185,180
Moariann,drakthul,1812,monk,mistweaver,150,75,75
Vxs,blackhand,1811,monk,mistweaver,72,45,27
Mônkykong,ravencrest,1811,monk,mistweaver,42,26,16
Sugermum,outland,1811,monk,mistweaver,60,34,26
Errowin,blackmoore,1810,monk,mistweaver,153,93,60
Leiwill,stormreaver,1810,monk,mistweaver,100,59,41
Xoconut,kazzak,1810,monk,mistweaver,292,160,132
Shyheimyo,outland,1810,monk,mistweaver,54,27,27
Оргриммен,soulflayer,1810,monk,mistweaver,173,85,88
Blantai,tarren-mill,1810,monk,mistweaver,108,51,57
Evad,kazzak,1809,monk,mistweaver,113,69,44
Schizacademy,draenor,1809,monk,mistweaver,44,26,18
Dewamønk,blackmoore,1809,monk,mistweaver,97,56,41
Ana,eredar,1809,monk,mistweaver,54,30,24
Fìstpwnjk,forscherliga,1808,monk,mistweaver,145,93,52
Darlaa,ravencrest,1807,monk,mistweaver,71,42,29
Jpstwo,gorgonnash,1807,monk,mistweaver,114,67,47
Brysiqtx,aegwynn,1807,monk,mistweaver,87,45,42
Baatu,frostmane,1807,monk,mistweaver,317,159,158
Kamene,kazzak,1806,monk,mistweaver,119,88,31
Kyukoku,blackmoore,1806,monk,mistweaver,46,30,16
Дольчих,soulflayer,1806,monk,mistweaver,243,148,95
Lukeybabyy,defias-brotherhood,1806,monk,mistweaver,250,142,108
Kîrânâ,eredar,1806,monk,mistweaver,54,29,25
Xarêlla,aegwynn,1806,monk,mistweaver,120,62,58
Axelight,chants-éternels,1805,monk,mistweaver,54,31,23
Тащунаскилле,thermaplugg,1805,monk,mistweaver,86,48,38
Ninetz,tarren-mill,1804,monk,mistweaver,51,31,20
Adis,nerathor,1804,monk,mistweaver,89,53,36
Yto,gorgonnash,1804,monk,mistweaver,54,26,28
Uckkm,ragnaros,1803,monk,mistweaver,65,39,26
Yulonian,argent-dawn,1803,monk,mistweaver,206,123,83
Handarbetare,ravencrest,1803,monk,mistweaver,147,78,69
Vanicweaver,aegwynn,1802,monk,mistweaver,36,26,10
Кроанла,howling-fjord,1802,monk,mistweaver,54,34,20
Pogimonkey,ragnaros,1802,monk,mistweaver,120,64,56
Djpunchable,blackrock,1801,monk,mistweaver,50,38,12
Papours,ysondre,1801,monk,mistweaver,54,37,17
Heramonk,dun-modr,1801,monk,mistweaver,58,30,28
Гачитварина,galakrond,1800,monk,mistweaver,114,72,42
Trollroll,defias-brotherhood,1800,monk,mistweaver,138,76,62
Репаблликуес,gordunni,1800,monk,mistweaver,52,28,24
Rogvi,argent-dawn,1800,monk,mistweaver,269,136,133
Callmeks,stormscale,1799,monk,mistweaver,228,122,106
Wiwâ,outland,1798,monk,mistweaver,139,73,66
Mobrac,twisting-nether,1797,monk,mistweaver,74,36,38
Monkwithlove,blackhand,1795,monk,mistweaver,316,166,150
Bammemw,archimonde,1791,monk,mistweaver,60,27,33
Bearmw,draenor,1789,monk,mistweaver,71,44,27
Shishasho,stormreaver,1788,monk,mistweaver,101,54,47
Binkote,zuljin,1787,monk,mistweaver,292,165,127
Sosyc,malganis,1787,monk,mistweaver,71,36,35
Jorahmarmond,tarren-mill,1786,monk,mistweaver,48,35,13
Pyrìt,blackhand,1785,monk,mistweaver,94,58,36
Kaezm,blackrock,1785,monk,mistweaver,48,28,20
Yäffa,archimonde,1785,monk,mistweaver,150,82,68
Барлиос,soulflayer,1784,monk,mistweaver,541,281,260
Savagex,sanguino,1784,monk,mistweaver,100,51,49
Rhatid,twisting-nether,1783,monk,mistweaver,371,197,174
Shortinlegs,silvermoon,1783,monk,mistweaver,84,44,40
Sinnermonkk,outland,1782,monk,mistweaver,42,27,15
Destom,archimonde,1782,monk,mistweaver,194,101,93
Greentape,kiljaeden,1781,monk,mistweaver,48,31,17
Infamøus,uldum,1781,monk,mistweaver,56,33,23
Gømbøz,tarren-mill,1781,monk,mistweaver,166,96,70
Goamix,ravencrest,1781,monk,mistweaver,40,21,19
Temhota,perenolde,1780,monk,mistweaver,58,33,25
Nabsi,aegwynn,1780,monk,mistweaver,90,50,40
Mistïnguette,dalaran,1779,monk,mistweaver,394,220,174
Amzu,kazzak,1779,monk,mistweaver,84,44,40
Сазуко,gordunni,1777,monk,mistweaver,300,152,148
Eedaza,blackrock,1776,monk,mistweaver,205,123,82
Monknice,sylvanas,1776,monk,mistweaver,83,42,41
Kickin,burning-legion,1775,monk,mistweaver,76,45,31
Sukmadika,twisting-nether,1775,monk,mistweaver,52,30,22
Kungfupanda,stormscale,1775,monk,mistweaver,122,68,54
Эрмонд,soulflayer,1775,monk,mistweaver,80,44,36
Bluran,dalaran,1774,monk,mistweaver,111,60,51
Тсайм,howling-fjord,1774,monk,mistweaver,100,52,48
Threesíxníne,dun-morogh,1774,monk,mistweaver,162,83,79
Xeratino,ragnaros,1773,monk,mistweaver,107,64,43
Cøcøøn,blackrock,1773,monk,mistweaver,152,82,70
Inuria,ravencrest,1772,monk,mistweaver,153,89,64
Òó,vashj,1772,monk,mistweaver,182,103,79
Srchi,aggra-português,1772,monk,mistweaver,103,52,51
Bankdream,bronze-dragonflight,1770,monk,mistweaver,58,33,25
Mwrbg,shadowsong,1770,monk,mistweaver,137,77,60
Ignygodx,ragnaros,1770,monk,mistweaver,88,48,40
Fckisrael,archimonde,1770,monk,mistweaver,48,23,25
Foaqer,aegwynn,1769,monk,mistweaver,40,26,14
Djalexmw,kazzak,1767,monk,mistweaver,36,24,12
Mistur,blackrock,1767,monk,mistweaver,78,45,33
Sîono,antonidas,1766,monk,mistweaver,81,50,31
Shurdax,silvermoon,1766,monk,mistweaver,102,54,48
Ashenore,outland,1765,monk,mistweaver,96,48,48
Onlyfunn,sanguino,1762,monk,mistweaver,133,74,59
Varea,blackrock,1762,monk,mistweaver,131,70,61
Brewnox,ragnaros,1762,monk,mistweaver,65,31,34
Maikez,stormreaver,1762,monk,mistweaver,100,47,53
Dodomino,archimonde,1761,monk,mistweaver,41,24,17
Izuwumi,ragnaros,1761,monk,mistweaver,48,27,21
Notfist,kazzak,1760,monk,mistweaver,90,64,26
Ричфлекс,howling-fjord,1760,monk,mistweaver,368,212,156
Marceliná,blackmoore,1760,monk,mistweaver,69,34,35
Ahyllesmonk,azjolnerub,1759,monk,mistweaver,41,32,9
Kackwalker,blackmoore,1759,monk,mistweaver,40,29,11
Sícknéss,aegwynn,1759,monk,mistweaver,42,26,16
Rashakura,blackrock,1759,monk,mistweaver,83,50,33
Riendy,silvermoon,1759,monk,mistweaver,302,167,135
Idrdob,kazzak,1759,monk,mistweaver,447,239,208
Tavqtwo,tarren-mill,1759,monk,mistweaver,48,20,28
Soundzw,antonidas,1758,monk,mistweaver,90,48,42
Shiftkin,stormscale,1758,monk,mistweaver,96,44,52
Bigmckoy,kazzak,1757,monk,mistweaver,39,27,12
Rascah,archimonde,1757,monk,mistweaver,166,89,77
Inlakech,auchindoun,1757,monk,mistweaver,225,110,115
Gréèñðrägôñ,stormscale,1756,monk,mistweaver,36,26,10
Wwception,blackrock,1756,monk,mistweaver,56,33,23
Harislkwamk,aegwynn,1756,monk,mistweaver,266,152,114
Yukimøn,hyjal,1755,monk,mistweaver,115,79,36
Diffenbachia,outland,1755,monk,mistweaver,140,89,51
Aseidith,tarren-mill,1755,monk,mistweaver,54,32,22
Frónzy,kazzak,1755,monk,mistweaver,252,143,109
Sniffn,ravencrest,1754,monk,mistweaver,54,35,19
Фучой,howling-fjord,1754,monk,mistweaver,87,51,36
Kwondo,archimonde,1754,monk,mistweaver,60,32,28
Blamethegame,hyjal,1753,monk,mistweaver,35,24,11
Crazyninja,arathor,1753,monk,mistweaver,66,38,28
Dicedkiwi,quelthalas,1753,monk,mistweaver,676,360,316
Esriin,shattered-hand,1752,monk,mistweaver,48,28,20
Januslapuce,culte-de-la-rive-noire,1752,monk,mistweaver,35,19,16
Йуппи,galakrond,1752,monk,mistweaver,48,26,22
Sitekm,burning-legion,1750,monk,mistweaver,89,61,28
Jayber,laughing-skull,1749,monk,mistweaver,72,46,26
Clemoine,archimonde,1749,monk,mistweaver,54,30,24
Callim,blackrock,1748,monk,mistweaver,30,19,11
Healinspam,twilights-hammer,1748,monk,mistweaver,114,59,55
Chünlii,dun-modr,1748,monk,mistweaver,150,77,73
Glaphan,the-maelstrom,1747,monk,mistweaver,46,29,17
Hôn,sanguino,1746,monk,mistweaver,53,36,17
Piedliés,ravencrest,1746,monk,mistweaver,160,75,85
Imeon,dun-modr,1744,monk,mistweaver,54,31,23
Neash,silvermoon,1744,monk,mistweaver,90,51,39
Craneovic,kult-der-verdammten,1744,monk,mistweaver,60,26,34
Mcscrub,ragnaros,1743,monk,mistweaver,77,44,33
Teahihi,ravencrest,1742,monk,mistweaver,36,27,9
Xadoqt,aegwynn,1742,monk,mistweaver,35,24,11
Xado,aegwynn,1742,monk,mistweaver,48,32,16
Tallein,drakthul,1742,monk,mistweaver,204,116,88
Steveé,kazzak,1740,monk,mistweaver,47,33,14
Monkatapiti,malganis,1740,monk,mistweaver,66,41,25
Ультрадевка,blackscar,1740,monk,mistweaver,82,43,39
Stifmeister,tarren-mill,1740,monk,mistweaver,136,71,65
Aironqqt,blackhand,1739,monk,mistweaver,203,121,82
Hidekami,archimonde,1739,monk,mistweaver,138,65,73
Frednmonk,twisting-nether,1738,monk,mistweaver,84,48,36
Lurklee,blackhand,1738,monk,mistweaver,70,38,32
Päjcsi,ragnaros,1738,monk,mistweaver,54,29,25
Olgachocolat,blackmoore,1737,monk,mistweaver,150,104,46
Konnîchîwa,kazzak,1737,monk,mistweaver,173,94,79
Fisterin,eredar,1737,monk,mistweaver,90,44,46
Behrens,defias-brotherhood,1736,monk,mistweaver,45,25,20
Donkeymønk,hyjal,1736,monk,mistweaver,367,195,172
Tîptâp,blackrock,1735,monk,mistweaver,33,23,10
Snookzlol,aegwynn,1735,monk,mistweaver,89,56,33
Mgp,the-maelstrom,1735,monk,mistweaver,138,78,60
Seava,kazzak,1734,monk,mistweaver,90,55,35
Modequillo,blackmoore,1734,monk,mistweaver,127,65,62
Táuriéll,eredar,1734,monk,mistweaver,42,21,21
Rivasstv,grim-batol,1733,monk,mistweaver,49,31,18
Xiâomèi,dun-modr,1732,monk,mistweaver,186,105,81
Meoox,outland,1731,monk,mistweaver,87,51,36
Nognegodx,ravencrest,1731,monk,mistweaver,174,78,96
Papermakerx,blackrock,1730,monk,mistweaver,108,63,45
Milkhy,minahonda,1729,monk,mistweaver,203,102,101
Wørsthealxd,alakir,1728,monk,mistweaver,88,59,29
Monkiszonz,burning-legion,1727,monk,mistweaver,60,33,27
Súzy,stormscale,1727,monk,mistweaver,124,67,57
Ziibaa,outland,1726,monk,mistweaver,81,48,33
Tû,nerathor,1726,monk,mistweaver,133,78,55
Dundermonken,silvermoon,1726,monk,mistweaver,48,28,20
Teamviewer,blackmoore,1726,monk,mistweaver,77,43,34
Taekwonroll,stormscale,1726,monk,mistweaver,48,25,23
Apolskis,ravencrest,1725,monk,mistweaver,66,46,20
Fatdad,magtheridon,1725,monk,mistweaver,95,46,49
Skailzkrt,hyjal,1725,monk,mistweaver,89,43,46
Bonk,defias-brotherhood,1725,monk,mistweaver,59,27,32
Таеуеоп,soulflayer,1724,monk,mistweaver,18,18,0
Théverre,uldaman,1724,monk,mistweaver,195,121,74
Notadrâgon,sylvanas,1724,monk,mistweaver,49,27,22
Effeots,blackrock,1724,monk,mistweaver,314,156,158
Gôky,stormscale,1723,monk,mistweaver,77,47,30
Nrafflig,draenor,1722,monk,mistweaver,48,32,16
Blackphil,terenas,1720,monk,mistweaver,108,64,44
Rsk,antonidas,1720,monk,mistweaver,82,47,35
Hoschirama,antonidas,1719,monk,mistweaver,45,29,16
Simpavev,ravencrest,1719,monk,mistweaver,52,27,25
Risesx,blackmoore,1719,monk,mistweaver,103,53,50
Demakis,stormscale,1718,monk,mistweaver,155,96,59
Bidzi,kazzak,1718,monk,mistweaver,42,25,17
Zintsu,khaz-modan,1718,monk,mistweaver,58,34,24
Chimara,kazzak,1718,monk,mistweaver,79,45,34
Nirexi,blackrock,1718,monk,mistweaver,99,55,44
Encanthar,blackhand,1718,monk,mistweaver,309,161,148
Boomxd,twisting-nether,1717,monk,mistweaver,67,41,26
Radamonk,drakthul,1717,monk,mistweaver,83,48,35
Çz,tarren-mill,1717,monk,mistweaver,86,48,38
Slugerpigen,stormscale,1717,monk,mistweaver,417,231,186
Místborn,ravencrest,1716,monk,mistweaver,30,18,12
Devivify,twilights-hammer,1716,monk,mistweaver,150,87,63
Calli,auchindoun,1716,monk,mistweaver,148,77,71
Kilograme,tarren-mill,1715,monk,mistweaver,95,47,48
Wisear,silvermoon,1715,monk,mistweaver,65,31,34
Galã,elune,1714,monk,mistweaver,228,124,104
Youssee,silvermoon,1714,monk,mistweaver,321,173,148
ßojo,kazzak,1713,monk,mistweaver,113,70,43
Arcøtea,frostwolf,1713,monk,mistweaver,166,96,70
Olympiiee,archimonde,1713,monk,mistweaver,299,160,139
Garcon,tarren-mill,1712,monk,mistweaver,168,93,75
Albakauz,shattered-hand,1712,monk,mistweaver,36,18,18
Caipha,ravencrest,1711,monk,mistweaver,66,41,25
Atoóthéé,the-maelstrom,1711,monk,mistweaver,31,19,12
Tráïner,madmortem,1711,monk,mistweaver,287,143,144
Nillebpgodx,kazzak,1711,monk,mistweaver,59,26,33
Tríxìe,stormscale,1710,monk,mistweaver,146,80,66
Ashjaxa,silvermoon,1710,monk,mistweaver,42,18,24
Avizionqt,anachronos,1709,monk,mistweaver,103,62,41
Ultrasense,outland,1709,monk,mistweaver,30,18,12
Aklimist,stormscale,1709,monk,mistweaver,90,51,39
Tolachi,blackhand,1709,monk,mistweaver,45,22,23
Lyfah,archimonde,1708,monk,mistweaver,108,63,45
Pikachi,ysondre,1707,monk,mistweaver,36,22,14
Bigdaddypump,blackmoore,1707,monk,mistweaver,42,25,17
Zorkev,dun-modr,1707,monk,mistweaver,125,71,54
Ellimak,archimonde,1707,monk,mistweaver,52,29,23
Farmander,silvermoon,1706,monk,mistweaver,293,172,121
Авентусс,howling-fjord,1706,monk,mistweaver,222,124,98
Ofwgkta,moonglade,1706,monk,mistweaver,48,26,22
Cubw,archimonde,1706,monk,mistweaver,54,29,25
Mugotea,twisting-nether,1706,monk,mistweaver,220,112,108
Shyheim,outland,1705,monk,mistweaver,48,36,12
Saneshayne,ravencrest,1705,monk,mistweaver,35,21,14
Bruceliam,emerald-dream,1705,monk,mistweaver,102,60,42
Jainagodxd,dun-modr,1705,monk,mistweaver,72,39,33
Simonex,ravencrest,1705,monk,mistweaver,78,42,36
Ulns,blackrock,1705,monk,mistweaver,114,58,56
ßsøßxx,hyjal,1704,monk,mistweaver,24,18,6
Öhlinmonk,outland,1704,monk,mistweaver,42,24,18
Kebabrolle,blackrock,1704,monk,mistweaver,42,21,21
Loddarita,ravencrest,1703,monk,mistweaver,84,60,24
Zýru,ragnaros,1703,monk,mistweaver,148,86,62
Фапдао,howling-fjord,1703,monk,mistweaver,302,161,141
Moontríx,kazzak,1703,monk,mistweaver,114,53,61
Nerdmonkx,tarren-mill,1702,monk,mistweaver,88,53,35
Даопецдын,howling-fjord,1702,monk,mistweaver,80,46,34
Hollymêdx,blackmoore,1701,monk,mistweaver,109,66,43
Mîstxd,kazzak,1701,monk,mistweaver,65,37,28
Samaja,aegwynn,1701,monk,mistweaver,36,19,17
Scribz,twisting-nether,1701,monk,mistweaver,36,18,18
Yörg,eredar,1700,monk,mistweaver,87,53,34
Proxxyqt,blackrock,1700,monk,mistweaver,120,73,47
Shigong,hellscream,1700,monk,mistweaver,66,36,30
Палерм,gordunni,1699,monk,mistweaver,57,37,20
Bananatux,tarren-mill,1699,monk,mistweaver,32,20,12
Mòñkêÿgøðx,outland,1699,monk,mistweaver,77,48,29
Shyrea,nazjatar,1699,monk,mistweaver,30,18,12
Orcimon,draenor,1699,monk,mistweaver,36,20,16
Alprox,moonglade,1699,monk,mistweaver,188,92,96
Orfantal,ravencrest,1698,monk,mistweaver,120,71,49
Merína,ragnaros,1698,monk,mistweaver,266,138,128
Финуправ,soulflayer,1697,monk,mistweaver,42,28,14
Rullefald,stormscale,1697,monk,mistweaver,102,57,45
Zenmaster,grim-batol,1697,monk,mistweaver,91,42,49
Coularx,stormscale,1696,monk,mistweaver,90,47,43
Dihsa,ragnaros,1695,monk,mistweaver,24,18,6
Sneptichitz,draenor,1695,monk,mistweaver,418,222,196
Deusfist,ravencrest,1694,monk,mistweaver,66,33,33
Träskolasse,tarren-mill,1693,monk,mistweaver,50,26,24
Yapouw,garona,1693,monk,mistweaver,85,42,43
Pitrols,twisting-nether,1692,monk,mistweaver,237,134,103
Smoothia,outland,1691,monk,mistweaver,199,114,85
Trónìq,outland,1690,monk,mistweaver,42,28,14
Dearmw,silvermoon,1690,monk,mistweaver,138,76,62
Lünara,ambossar,1690,monk,mistweaver,108,57,51
Viggex,outland,1690,monk,mistweaver,42,18,24
Key,stormreaver,1689,monk,mistweaver,112,62,50
Doll,stormscale,1689,monk,mistweaver,36,18,18
Sinthorasas,blackrock,1688,monk,mistweaver,166,95,71
Irêfutabil,sylvanas,1688,monk,mistweaver,63,34,29
Iixil,sylvanas,1687,monk,mistweaver,24,18,6
Caniluvz,eredar,1687,monk,mistweaver,60,39,21
Jûzô,illidan,1687,monk,mistweaver,42,23,19
Clydemonk,outland,1686,monk,mistweaver,24,18,6
Ness,hyjal,1686,monk,mistweaver,42,24,18
Kukn,twisting-nether,1686,monk,mistweaver,87,44,43
Cykatea,dun-modr,1685,monk,mistweaver,1333,681,652
Эрумонк,gordunni,1685,monk,mistweaver,36,18,18
Freyas,outland,1683,monk,mistweaver,113,65,48
Esooz,defias-brotherhood,1682,monk,mistweaver,36,29,7
Bullergøjen,ravencrest,1682,monk,mistweaver,90,59,31
Ðarent,hyjal,1682,monk,mistweaver,48,28,20
Дилейнх,gordunni,1682,monk,mistweaver,66,36,30
Sanktxy,blackhand,1682,monk,mistweaver,129,63,66
Stonkss,ragnaros,1682,monk,mistweaver,189,89,100
Lkä,hyjal,1681,monk,mistweaver,34,22,12
Socialfailur,ravencrest,1679,monk,mistweaver,38,23,15
Makïi,archimonde,1679,monk,mistweaver,283,163,120
Kñútølåfx,sylvanas,1679,monk,mistweaver,37,20,17
Tygertyger,silvermoon,1679,monk,mistweaver,42,21,21
Smitheal,outland,1678,monk,mistweaver,96,67,29
Trulor,draenor,1677,monk,mistweaver,40,30,10
Milksbtw,kazzak,1676,monk,mistweaver,113,79,34
Airgirl,terrordar,1676,monk,mistweaver,70,43,27
Вакидзави,gordunni,1676,monk,mistweaver,60,36,24
Quickmist,draenor,1675,monk,mistweaver,107,65,42
Æbscourgê,azjolnerub,1675,monk,mistweaver,90,50,40
Vayyn,kazzak,1674,monk,mistweaver,42,24,18
Elhäbedehä,eredar,1673,monk,mistweaver,372,187,185
Lonechi,sylvanas,1673,monk,mistweaver,60,24,36
Mkeev,blackrock,1672,monk,mistweaver,24,21,3
Jerymonk,tarren-mill,1672,monk,mistweaver,231,123,108
Shokko,uldaman,1672,monk,mistweaver,113,60,53
Mistchorus,argent-dawn,1671,monk,mistweaver,30,21,9
Asho,outland,1671,monk,mistweaver,62,37,25
Zarona,outland,1671,monk,mistweaver,60,34,26
Автотюн,gordunni,1671,monk,mistweaver,40,18,22
Deadlywuu,antonidas,1670,monk,mistweaver,89,56,33
Neehl,aegwynn,1670,monk,mistweaver,35,22,13
Børis,draenor,1670,monk,mistweaver,171,100,71
Ellevance,draenor,1670,monk,mistweaver,54,29,25
Shixen,ragnaros,1670,monk,mistweaver,60,24,36
Артэкрио,soulflayer,1669,monk,mistweaver,54,37,17
Andoran,hyjal,1669,monk,mistweaver,42,26,16
Ilikeducks,ravencrest,1669,monk,mistweaver,213,125,88
Watchôut,blackmoore,1669,monk,mistweaver,246,135,111
Sindresa,outland,1669,monk,mistweaver,292,152,140
Potkuri,stormreaver,1669,monk,mistweaver,36,18,18
Notdearmw,shattered-hand,1666,monk,mistweaver,36,24,12
Junâ,les-sentinelles,1666,monk,mistweaver,43,23,20
Suliya,zuluhed,1666,monk,mistweaver,96,51,45
Taylorghost,ravencrest,1666,monk,mistweaver,167,88,79
Marcjess,kazzak,1666,monk,mistweaver,48,24,24
Telder,sylvanas,1665,monk,mistweaver,62,37,25
Xanderpowa,sanguino,1665,monk,mistweaver,36,21,15
Dharmå,norgannon,1665,monk,mistweaver,62,32,30
Pafia,sargeras,1665,monk,mistweaver,168,79,89
Oneshotmacro,spinebreaker,1663,monk,mistweaver,42,26,16
Syvifw,outland,1663,monk,mistweaver,48,29,19
Tîptap,blackrock,1663,monk,mistweaver,42,20,22
Nerfmonk,archimonde,1662,monk,mistweaver,24,18,6
Tokz,ravencrest,1662,monk,mistweaver,60,42,18
Minichi,aegwynn,1661,monk,mistweaver,42,23,19
Mistwave,eredar,1660,monk,mistweaver,40,28,12
Insømnia,ragnaros,1660,monk,mistweaver,34,21,13
Shiguru,dun-morogh,1660,monk,mistweaver,239,136,103
Shailene,kazzak,1660,monk,mistweaver,450,251,199
Yshaolin,tarren-mill,1660,monk,mistweaver,44,22,22
Needthát,twisting-nether,1658,monk,mistweaver,60,38,22
Twerki,grim-batol,1658,monk,mistweaver,82,45,37
Sploof,ravencrest,1657,monk,mistweaver,36,24,12
Búns,draenor,1657,monk,mistweaver,95,55,40
Аскмилол,deathweaver,1657,monk,mistweaver,136,71,65
Melamonk,ravencrest,1657,monk,mistweaver,359,187,172
Èlesd,ravencrest,1656,monk,mistweaver,39,26,13
Trollandroll,stormscale,1655,monk,mistweaver,131,71,60
Эддрос,gordunni,1655,monk,mistweaver,66,35,31
Mistbringer,kazzak,1655,monk,mistweaver,530,278,252
Cîanurø,zuljin,1655,monk,mistweaver,105,55,50
Mangi,rexxar,1655,monk,mistweaver,72,37,35
Kareek,sylvanas,1655,monk,mistweaver,48,24,24
Lazyslooth,ravencrest,1655,monk,mistweaver,47,21,26
Benenutz,archimonde,1654,monk,mistweaver,77,54,23
Kaàli,pozzo-delleternità,1654,monk,mistweaver,36,21,15
Xdhehehexd,twisting-nether,1654,monk,mistweaver,94,47,47
Deniise,kult-der-verdammten,1653,monk,mistweaver,84,52,32
Akkadianx,ravencrest,1653,monk,mistweaver,65,38,27
Brewsli,ragnaros,1653,monk,mistweaver,86,50,36
Swollboom,outland,1653,monk,mistweaver,45,24,21
Lacasyto,sanguino,1651,monk,mistweaver,60,43,17
Ohmegah,frostmane,1651,monk,mistweaver,73,49,24
Hotmiist,kazzak,1651,monk,mistweaver,77,44,33
Assaalaria,argent-dawn,1651,monk,mistweaver,404,224,180
Монккд,gordunni,1651,monk,mistweaver,224,124,100
Bamiegoreng,aegwynn,1650,monk,mistweaver,36,20,16
Sigvald,kaelthas,1649,monk,mistweaver,54,30,24
Mezchi,blackhand,1649,monk,mistweaver,144,76,68
Sart,aerie-peak,1649,monk,mistweaver,72,38,34
Milkabtw,kazzak,1648,monk,mistweaver,94,52,42
Sensorium,ravencrest,1648,monk,mistweaver,180,97,83
Stanimirov,outland,1648,monk,mistweaver,89,43,46
Supaverli,archimonde,1647,monk,mistweaver,30,21,9
Myfresh,ysondre,1647,monk,mistweaver,91,46,45
Plaguer,nordrassil,1646,monk,mistweaver,80,50,30
Etzu,shattrath,1646,monk,mistweaver,72,43,29
Guthäxlul,khazgoroth,1646,monk,mistweaver,551,296,255
Масакрейн,howling-fjord,1646,monk,mistweaver,645,326,319
Monkiz,veknilash,1645,monk,mistweaver,42,24,18
Mÿsphere,archimonde,1645,monk,mistweaver,121,67,54
Бладмонки,soulflayer,1645,monk,mistweaver,102,56,46
Drugashe,archimonde,1645,monk,mistweaver,360,177,183
Эрмилинда,gordunni,1645,monk,mistweaver,120,55,65
Gingerbrew,hyjal,1644,monk,mistweaver,27,19,8
Pundok,blackrock,1644,monk,mistweaver,182,107,75
Yumhai,dun-modr,1644,monk,mistweaver,101,59,42
Linshai,eredar,1644,monk,mistweaver,48,28,20
Chiuna,sylvanas,1644,monk,mistweaver,66,37,29
Smehonk,outland,1644,monk,mistweaver,48,26,22
Unsanegodx,ravencrest,1643,monk,mistweaver,54,38,16
Psychoo,ragnaros,1643,monk,mistweaver,66,41,25
Eugenn,alonsus,1643,monk,mistweaver,52,29,23
Invadem,shattered-hand,1642,monk,mistweaver,33,22,11
Пивкотянка,gordunni,1642,monk,mistweaver,95,60,35
Blondefurry,twisting-nether,1642,monk,mistweaver,92,56,36
Nepho,twisting-nether,1642,monk,mistweaver,38,23,15
Фистингкоуч,gordunni,1642,monk,mistweaver,97,54,43
Fbmonk,kazzak,1642,monk,mistweaver,255,140,115
Ilovesnoopy,blackmoore,1641,monk,mistweaver,42,25,17
Найтчерри,deathguard,1641,monk,mistweaver,251,138,113
Mimimatrick,hyjal,1641,monk,mistweaver,108,59,49
Brewteaful,outland,1641,monk,mistweaver,63,34,29
Leôlulu,blackmoore,1640,monk,mistweaver,86,59,27
Monkadorie,twisting-nether,1640,monk,mistweaver,97,65,32
Kaizetsu,drakthul,1640,monk,mistweaver,84,52,32
Aritisi,tarren-mill,1640,monk,mistweaver,36,20,16
Fistify,destromath,1639,monk,mistweaver,24,20,4
Zahj,ysondre,1639,monk,mistweaver,195,113,82
Kâî,outland,1638,monk,mistweaver,48,31,17
Zikzer,darksorrow,1638,monk,mistweaver,87,52,35
Wushin,antonidas,1638,monk,mistweaver,55,30,25
Gernokz,antonidas,1638,monk,mistweaver,383,205,178
Knucklejuice,kazzak,1638,monk,mistweaver,78,39,39
Турениш,soulflayer,1637,monk,mistweaver,46,27,19
Tetetete,silvermoon,1637,monk,mistweaver,199,110,89
Hoibglotzn,antonidas,1637,monk,mistweaver,86,39,47
Meltfistqt,ravencrest,1636,monk,mistweaver,208,101,107
Ricidora,nerathor,1635,monk,mistweaver,36,22,14
Karoou,kelthuzad,1635,monk,mistweaver,89,48,41
Jacksa,bronze-dragonflight,1635,monk,mistweaver,302,149,153
Yusomean,ravencrest,1634,monk,mistweaver,30,18,12
Leblatt,blackhand,1634,monk,mistweaver,130,77,53
Fistymisty,ragnaros,1634,monk,mistweaver,66,36,30
Vregorx,twisting-nether,1634,monk,mistweaver,67,36,31
Якунка,soulflayer,1634,monk,mistweaver,54,25,29
Zúlay,aegwynn,1633,monk,mistweaver,42,26,16
Sweatymonkey,ravencrest,1633,monk,mistweaver,42,24,18
Pe,blackhand,1633,monk,mistweaver,106,58,48
Namelessmist,drakthul,1632,monk,mistweaver,90,52,38
Gøøgodx,tarren-mill,1632,monk,mistweaver,41,23,18
Plancton,kazzak,1631,monk,mistweaver,24,17,7
Teninchwilly,outland,1631,monk,mistweaver,74,47,27
Energyqt,twisting-nether,1631,monk,mistweaver,42,22,20
Toadmuncher,eredar,1631,monk,mistweaver,64,29,35
Simbabsu,thrall,1630,monk,mistweaver,75,50,25
Syyn,twisting-nether,1630,monk,mistweaver,383,209,174
Shyreen,zirkel-des-cenarius,1630,monk,mistweaver,47,25,22
Quinnkesh,draenor,1629,monk,mistweaver,27,21,6
Hulkules,blackhand,1629,monk,mistweaver,94,63,31
Xineeaa,outland,1629,monk,mistweaver,159,84,75
Amatör,frostwolf,1629,monk,mistweaver,180,93,87
Quotes,darksorrow,1629,monk,mistweaver,78,38,40
Brüderlichke,elune,1629,monk,mistweaver,48,21,27
Kapitan,sanguino,1628,monk,mistweaver,123,72,51
Dachilla,gilneas,1628,monk,mistweaver,61,35,26
Macpunchy,defias-brotherhood,1628,monk,mistweaver,72,38,34
Эйдриса,howling-fjord,1628,monk,mistweaver,36,19,17
Angeryw,kazzak,1627,monk,mistweaver,30,20,10
Vooxis,drakthul,1627,monk,mistweaver,90,51,39
Sugmadigg,argent-dawn,1626,monk,mistweaver,55,40,15
Ðéliora,la-croisade-écarlate,1626,monk,mistweaver,60,30,30
Zaiyox,thrall,1626,monk,mistweaver,42,20,22
Twistie,aegwynn,1626,monk,mistweaver,36,17,19
Incapmaestro,doomhammer,1624,monk,mistweaver,65,47,18
Старыйхиро,gordunni,1624,monk,mistweaver,24,17,7
Yotke,ravencrest,1624,monk,mistweaver,48,30,18
Kazemja,ragnaros,1624,monk,mistweaver,63,39,24
Sooths,uldaman,1624,monk,mistweaver,43,25,18
Jeaylzxko,archimonde,1624,monk,mistweaver,48,25,23
Джисаку,gordunni,1624,monk,mistweaver,37,19,18
Elskling,earthen-ring,1624,monk,mistweaver,473,239,234
Endif,stormscale,1623,monk,mistweaver,76,41,35
Egï,azshara,1623,monk,mistweaver,82,43,39
Chexmonk,silvermoon,1623,monk,mistweaver,184,94,90
Патаомальчик,blackscar,1622,monk,mistweaver,100,53,47
Akwaman,stormscale,1622,monk,mistweaver,54,23,31
Shouldbeokai,ravencrest,1621,monk,mistweaver,24,17,7
Samxin,archimonde,1621,monk,mistweaver,53,36,17
Luciellie,archimonde,1621,monk,mistweaver,30,19,11
Pandare,bronze-dragonflight,1621,monk,mistweaver,86,51,35
Córporation,outland,1621,monk,mistweaver,48,25,23
Varyat,uldum,1621,monk,mistweaver,83,43,40
Spinonyou,silvermoon,1620,monk,mistweaver,30,20,10
Zenmastêr,twisting-nether,1620,monk,mistweaver,249,140,109
Äeøwyn,ragnaros,1620,monk,mistweaver,40,22,18
Issho,der-rat-von-dalaran,1620,monk,mistweaver,36,19,17
Qlmo,ravencrest,1619,monk,mistweaver,151,88,63
Biftas,nagrand,1619,monk,mistweaver,75,42,33
Moonloxe,silvermoon,1619,monk,mistweaver,35,19,16
Mâki,ravencrest,1619,monk,mistweaver,36,17,19
Tyzin,blackrock,1618,monk,mistweaver,166,97,69
Aryaz,ravencrest,1618,monk,mistweaver,93,49,44
Thorasobär,aegwynn,1618,monk,mistweaver,57,30,27
Chanjike,anetheron,1618,monk,mistweaver,78,39,39
Nylzz,archimonde,1618,monk,mistweaver,44,22,22
Xoleck,aegwynn,1618,monk,mistweaver,48,21,27
Gobssi,archimonde,1617,monk,mistweaver,120,77,43
Хилюзаоргазм,howling-fjord,1617,monk,mistweaver,86,50,36
Khaven,hyjal,1616,monk,mistweaver,29,24,5
Emblax,blackhand,1616,monk,mistweaver,48,29,19
Monkéy,blackhand,1616,monk,mistweaver,54,30,24
Refi,blackrock,1616,monk,mistweaver,175,96,79
Rheinair,antonidas,1616,monk,mistweaver,144,78,66
Kwa,grim-batol,1616,monk,mistweaver,69,37,32
Mankee,kazzak,1616,monk,mistweaver,191,98,93
Shkorwi,drakthul,1615,monk,mistweaver,78,40,38
Saduh,thrall,1615,monk,mistweaver,84,43,41
Hymonk,draenor,1614,monk,mistweaver,103,62,41
Fabulistic,outland,1614,monk,mistweaver,60,31,29
Breezegodx,stormscale,1614,monk,mistweaver,78,39,39
Toshi,argent-dawn,1613,monk,mistweaver,130,84,46
Spicyrice,twisting-nether,1613,monk,mistweaver,274,138,136
Chundan,twisting-nether,1612,monk,mistweaver,105,69,36
Zodyiac,blackrock,1611,monk,mistweaver,41,29,12
Uftis,thrall,1611,monk,mistweaver,83,58,25
Garuda,darkspear,1611,monk,mistweaver,34,23,11
Липисинка,howling-fjord,1611,monk,mistweaver,93,53,40
Mönchalot,der-abyssische-rat,1611,monk,mistweaver,30,17,13
Izen,eredar,1611,monk,mistweaver,54,30,24
Hydrôlîcz,blackrock,1611,monk,mistweaver,48,26,22
Jian,tarren-mill,1611,monk,mistweaver,76,40,36
Koraxx,blackmoore,1611,monk,mistweaver,90,46,44
Zorxen,argent-dawn,1611,monk,mistweaver,42,20,22
Сэм,gordunni,1610,monk,mistweaver,30,21,9
Crazydingo,lightnings-blade,1610,monk,mistweaver,115,73,42
Аникибой,gordunni,1610,monk,mistweaver,109,69,40
Cbmonk,sylvanas,1609,monk,mistweaver,74,50,24
Mahhist,archimonde,1609,monk,mistweaver,35,23,12
Биак,howling-fjord,1609,monk,mistweaver,38,23,15
Windwalkergy,chamber-of-aspects,1609,monk,mistweaver,72,40,32
Kitingbuddha,aegwynn,1609,monk,mistweaver,114,62,52
Plebmonkx,frostmane,1609,monk,mistweaver,185,98,87
Saadlol,sanguino,1609,monk,mistweaver,36,19,17
Erapanzon,nemesis,1609,monk,mistweaver,96,50,46
Лолидевочка,soulflayer,1609,monk,mistweaver,61,24,37
Mikeson,sylvanas,1608,monk,mistweaver,56,35,21
Saeedki,wildhammer,1608,monk,mistweaver,67,37,30
Cerrya,silvermoon,1608,monk,mistweaver,48,21,27
Жариха,soulflayer,1607,monk,mistweaver,93,60,33
Кирэнви,soulflayer,1607,monk,mistweaver,54,34,20
Benzzy,ragnaros,1607,monk,mistweaver,110,68,42
Castrø,argent-dawn,1607,monk,mistweaver,108,62,46
Mélêxe,ysondre,1607,monk,mistweaver,30,17,13
Larå,ravencrest,1607,monk,mistweaver,352,191,161
Mannmann,thrall,1607,monk,mistweaver,54,29,25
Pembi,blades-edge,1607,monk,mistweaver,98,51,47
Ларкес,howling-fjord,1607,monk,mistweaver,41,19,22
Áyell,archimonde,1606,monk,mistweaver,171,95,76
Klotsobunidi,kazzak,1606,monk,mistweaver,191,100,91
Pìmpìnelle,garona,1606,monk,mistweaver,47,23,24
Kernbohrung,ravencrest,1605,monk,mistweaver,30,20,10
Civix,sanguino,1605,monk,mistweaver,225,131,94
Fluki,twisting-nether,1605,monk,mistweaver,90,50,40
Nastyføxÿ,ysondre,1605,monk,mistweaver,42,22,20
Spoompls,argent-dawn,1605,monk,mistweaver,78,40,38
Monkasape,nemesis,1605,monk,mistweaver,39,19,20
Lillklappz,outland,1604,monk,mistweaver,48,33,15
Pøwcow,blackrock,1604,monk,mistweaver,203,114,89
Rulletunna,grim-batol,1604,monk,mistweaver,78,42,36
Rngmåchínè,ravencrest,1604,monk,mistweaver,98,50,48
Zuvzuv,the-maelstrom,1604,monk,mistweaver,125,63,62
Uwugodx,archimonde,1603,monk,mistweaver,69,41,28
Waitaminute,outland,1603,monk,mistweaver,166,97,69
Leesun,burning-legion,1603,monk,mistweaver,53,28,25
Timboqt,blackmoore,1602,monk,mistweaver,82,48,34
Shmanatik,nemesis,1602,monk,mistweaver,224,127,97
Lizardspock,hyjal,1602,monk,mistweaver,30,17,13
Stealthsøul,outland,1602,monk,mistweaver,30,17,13
Räyh,outland,1602,monk,mistweaver,57,31,26
Brummbierle,blackrock,1602,monk,mistweaver,46,24,22
Kurasaki,blackmoore,1601,monk,mistweaver,25,19,6
Loma,drakthul,1601,monk,mistweaver,148,94,54
Kajï,frostmane,1601,monk,mistweaver,78,48,30
Healingchan,outland,1601,monk,mistweaver,137,84,53
Aldèbarån,nemesis,1601,monk,mistweaver,133,75,58
Rebekko,pozzo-delleternità,1601,monk,mistweaver,347,179,168
Aebì,dalaran,1600,monk,mistweaver,87,55,32
Eluai,kilrogg,1600,monk,mistweaver,42,24,18
Setup,thrall,1600,monk,mistweaver,197,111,86
Arimira,outland,1600,monk,mistweaver,140,75,65
Onlyvegan,ravencrest,1600,monk,mistweaver,40,21,19
Buffmw,burning-steppes,1599,monk,mistweaver,41,29,12
Mjk,tarren-mill,1599,monk,mistweaver,114,64,50
Jum,blackhand,1599,monk,mistweaver,142,79,63
Индоран,howling-fjord,1598,monk,mistweaver,78,55,23
Knotseboenk,outland,1598,monk,mistweaver,187,94,93
Rokobasilisk,outland,1598,monk,mistweaver,42,19,23
Widsilson,hyjal,1596,monk,mistweaver,24,17,7
Selici,defias-brotherhood,1596,monk,mistweaver,138,77,61
Akatzu,silvermoon,1595,monk,mistweaver,35,22,13
Uglyfister,kazzak,1595,monk,mistweaver,71,41,30
Brêwjob,archimonde,1595,monk,mistweaver,100,57,43
Ivanzamonka,stormscale,1595,monk,mistweaver,113,64,49
Darkkmonk,dun-modr,1595,monk,mistweaver,167,87,80
Desmî,ravencrest,1594,monk,mistweaver,32,24,8
Ceeja,blackmoore,1594,monk,mistweaver,172,93,79
Zenfir,sylvanas,1593,monk,mistweaver,74,46,28
Venemy,sanguino,1593,monk,mistweaver,96,55,41
Zødiac,quelthalas,1593,monk,mistweaver,51,28,23
Salsina,nemesis,1593,monk,mistweaver,314,171,143
Jetleê,eredar,1593,monk,mistweaver,150,76,74
Punkfukanda,drakthul,1592,monk,mistweaver,69,41,28
Alë,argent-dawn,1592,monk,mistweaver,146,81,65
Yepp,blackmoore,1592,monk,mistweaver,86,34,52
Watchmedamp,draenor,1591,monk,mistweaver,218,124,94
Schane,zuluhed,1591,monk,mistweaver,94,50,44
Elmonkodonko,draenor,1590,monk,mistweaver,30,17,13
Boomboôom,outland,1590,monk,mistweaver,93,47,46
Monkymonka,antonidas,1589,monk,mistweaver,204,103,101
Stramonk,nemesis,1589,monk,mistweaver,261,125,136
Yanuxî,aegwynn,1588,monk,mistweaver,82,47,35
Windspiritt,ragnaros,1586,monk,mistweaver,90,49,41
Kammia,drekthar,1585,monk,mistweaver,30,17,13
Monkim,chogall,1585,monk,mistweaver,48,27,21
Quehorror,dun-modr,1585,monk,mistweaver,55,29,26
Quezatrix,ravencrest,1585,monk,mistweaver,292,153,139
Phyro,uldum,1585,monk,mistweaver,98,47,51
Монккд,soulflayer,1584,monk,mistweaver,158,93,65
Anzii,silvermoon,1584,monk,mistweaver,39,22,17
Xadu,frostwolf,1584,monk,mistweaver,101,56,45
Pitit,outland,1584,monk,mistweaver,78,31,47
Warsox,aegwynn,1583,monk,mistweaver,102,53,49
Bonbón,scarshield-legion,1583,monk,mistweaver,42,21,21
Igozoom,draenor,1582,monk,mistweaver,65,42,23
Glorytw,outland,1582,monk,mistweaver,72,44,28
Katmunk,kazzak,1582,monk,mistweaver,30,18,12
Esco,genjuros,1582,monk,mistweaver,83,46,37
Факенщет,soulflayer,1581,monk,mistweaver,97,56,41
Parkroy,ravencrest,1581,monk,mistweaver,60,32,28
Brapbrap,stormscale,1581,monk,mistweaver,75,39,36
Лютыйкулак,borean-tundra,1580,monk,mistweaver,30,20,10
Chirukka,dun-modr,1580,monk,mistweaver,186,104,82
Крибл,howling-fjord,1580,monk,mistweaver,36,20,16
Chinmachine,kazzak,1580,monk,mistweaver,120,66,54
Pleasure,laughing-skull,1580,monk,mistweaver,66,35,31
Rogeri,kazzak,1579,monk,mistweaver,48,26,22
Кубермонкер,gordunni,1579,monk,mistweaver,42,20,22
Mulfmonk,darksorrow,1578,monk,mistweaver,137,83,54
Dosakua,silvermoon,1578,monk,mistweaver,114,63,51
Shreckmonk,burning-blade,1578,monk,mistweaver,98,54,44
Hardi,chamber-of-aspects,1578,monk,mistweaver,151,74,77
Mythrixie,draenor,1577,monk,mistweaver,47,28,19
Taìka,archimonde,1577,monk,mistweaver,33,19,14
Teacup,aegwynn,1577,monk,mistweaver,440,237,203
Ånåsenpåi,archimonde,1576,monk,mistweaver,41,23,18
Psychømonk,antonidas,1575,monk,mistweaver,36,21,15
Appéltje,ravencrest,1574,monk,mistweaver,30,17,13
Húrka,drakthul,1574,monk,mistweaver,64,36,28
Vanessaflexz,aegwynn,1574,monk,mistweaver,72,40,32
Bitbird,zirkel-des-cenarius,1573,monk,mistweaver,48,29,19
Otuschxin,blackmoore,1573,monk,mistweaver,120,63,57
Slizzlie,outland,1573,monk,mistweaver,93,47,46
Phyromonky,uldum,1572,monk,mistweaver,36,23,13
Mentonk,frostwolf,1572,monk,mistweaver,36,20,16
Statícx,twisting-nether,1572,monk,mistweaver,105,56,49
Vanoarabidze,ravencrest,1572,monk,mistweaver,78,36,42
Zekunpow,zenedar,1571,monk,mistweaver,89,60,29
Vasknem,hyjal,1571,monk,mistweaver,72,46,26
Børshka,nemesis,1571,monk,mistweaver,98,62,36
Sèrafin,burning-legion,1571,monk,mistweaver,30,18,12
Medinâ,kult-der-verdammten,1571,monk,mistweaver,66,35,31
Zanizu,blackhand,1571,monk,mistweaver,96,50,46
Wieseljäger,blackmoore,1570,monk,mistweaver,54,29,25
Headakzar,kazzak,1570,monk,mistweaver,108,52,56
Уиннии,soulflayer,1569,monk,mistweaver,42,23,19
Calmpalms,tarren-mill,1569,monk,mistweaver,111,60,51
Orgasmix,tarren-mill,1569,monk,mistweaver,42,21,21
Lenor,blackmoore,1569,monk,mistweaver,36,17,19
Ussak,stormreaver,1568,monk,mistweaver,119,74,45
Spîndêmôrt,stormscale,1568,monk,mistweaver,161,96,65
Jasonbbmist,stormscale,1568,monk,mistweaver,101,56,45
Brewsky,tarren-mill,1568,monk,mistweaver,60,29,31
Mâxs,archimonde,1567,monk,mistweaver,24,17,7
Kiziibrla,archimonde,1567,monk,mistweaver,66,34,32
Lumpiiná,antonidas,1566,monk,mistweaver,114,69,45
Mer,outland,1566,monk,mistweaver,68,37,31
Xiaokingqvq,silvermoon,1566,monk,mistweaver,120,64,56
Тучковский,lich-king,1565,monk,mistweaver,233,126,107
Meuhporgg,hyjal,1564,monk,mistweaver,60,42,18
Nurfdmonk,ravencrest,1564,monk,mistweaver,49,32,17
Progresse,tarren-mill,1564,monk,mistweaver,60,32,28
Monkini,kazzak,1563,monk,mistweaver,30,21,9
Mwmkgodxz,archimonde,1563,monk,mistweaver,27,18,9
Jacm,blackhand,1563,monk,mistweaver,53,30,23
Nihao,tarren-mill,1563,monk,mistweaver,115,62,53
Hokke,tarren-mill,1563,monk,mistweaver,66,34,32
Jinhee,nemesis,1562,monk,mistweaver,68,45,23
Тадоичи,soulflayer,1562,monk,mistweaver,108,67,41
Saitamä,archimonde,1562,monk,mistweaver,122,58,64
Fithz,kaelthas,1561,monk,mistweaver,60,43,17
Вдыхайтуман,gordunni,1561,monk,mistweaver,140,75,65
Madafis,twisting-nether,1560,monk,mistweaver,42,28,14
Simòna,dun-modr,1559,monk,mistweaver,868,434,434
Luvmollý,silvermoon,1559,monk,mistweaver,192,87,105
Kylâas,die-ewige-wacht,1558,monk,mistweaver,66,33,33
Нийтринно,howling-fjord,1558,monk,mistweaver,174,86,88
Jeanmartin,hyjal,1557,monk,mistweaver,90,50,40
Psychocop,drakthul,1556,monk,mistweaver,499,253,246
Pepe,garona,1555,monk,mistweaver,50,32,18
Kbwser,silvermoon,1555,monk,mistweaver,54,32,22
Isadri,madmortem,1555,monk,mistweaver,36,21,15
Gronoz,drakthul,1555,monk,mistweaver,144,82,62
Reyaiba,dalaran,1554,monk,mistweaver,30,21,9
Quikes,blackrock,1554,monk,mistweaver,165,94,71
Mushush,draenor,1554,monk,mistweaver,62,34,28
Mmrkick,kazzak,1554,monk,mistweaver,106,56,50
Hoshisora,ravencrest,1554,monk,mistweaver,42,22,20
Wwz,hyjal,1554,monk,mistweaver,48,21,27
Hullumunkki,blackmoore,1553,monk,mistweaver,28,18,10
Botspec,twisting-nether,1553,monk,mistweaver,81,48,33
Aaronijshn,silvermoon,1552,monk,mistweaver,121,70,51
Ouaipäül,archimonde,1552,monk,mistweaver,36,19,17
Тевикс,gordunni,1551,monk,mistweaver,131,68,63
Scpdevil,outland,1550,monk,mistweaver,117,67,50
Chikokon,silvermoon,1549,monk,mistweaver,105,64,41
Happymonktwo,ravencrest,1549,monk,mistweaver,166,83,83
Kattlåda,darkspear,1548,monk,mistweaver,36,21,15
Rzi,amanthul,1548,monk,mistweaver,155,86,69
Elvand,twisting-nether,1548,monk,mistweaver,143,72,71
Ðisbalance,ravencrest,1548,monk,mistweaver,35,17,18
Bluebery,burning-legion,1547,monk,mistweaver,30,17,13
Prettysus,silvermoon,1546,monk,mistweaver,66,41,25
Wannabejoker,stormscale,1546,monk,mistweaver,72,38,34
Amnis,pozzo-delleternità,1545,monk,mistweaver,47,31,16
Ønøf,rashgarroth,1545,monk,mistweaver,77,38,39
Painswîft,blackhand,1544,monk,mistweaver,54,34,20
Kirkeý,ravencrest,1544,monk,mistweaver,55,31,24
Barracüs,dun-modr,1544,monk,mistweaver,78,43,35
Lysanmonk,zuljin,1544,monk,mistweaver,123,67,56
Aryphus,blackmoore,1544,monk,mistweaver,76,39,37
Inthepoopa,outland,1543,monk,mistweaver,102,56,46
Kåýðø,archimonde,1543,monk,mistweaver,102,54,48
Njursten,twilights-hammer,1543,monk,mistweaver,296,150,146
Eckø,rashgarroth,1542,monk,mistweaver,88,52,36
Groundnpound,silvermoon,1541,monk,mistweaver,48,23,25
Slayâtwo,blackrock,1539,monk,mistweaver,33,23,10
Bambøuéqtz,khaz-modan,1539,monk,mistweaver,60,40,20
Mordmonkx,draenor,1539,monk,mistweaver,393,207,186
Нунтяк,gordunni,1539,monk,mistweaver,364,178,186
Lefferubie,hyjal,1538,monk,mistweaver,72,40,32
Onepunchmon,ragnaros,1538,monk,mistweaver,46,24,22
Drylezm,twisting-nether,1537,monk,mistweaver,28,20,8
Mará,burning-legion,1537,monk,mistweaver,54,35,19
Molgar,tarren-mill,1537,monk,mistweaver,86,48,38
Kushvendorx,silvermoon,1537,monk,mistweaver,72,38,34
Zaheer,xavius,1537,monk,mistweaver,59,17,42
Мирюзаки,gordunni,1536,monk,mistweaver,78,50,28
Gôeller,stormscale,1536,monk,mistweaver,29,17,12
Диванн,howling-fjord,1535,monk,mistweaver,50,29,21
Absolutezen,tarren-mill,1535,monk,mistweaver,66,34,32
Dmonk,alakir,1533,monk,mistweaver,119,58,61
Лалафест,soulflayer,1532,monk,mistweaver,58,32,26
Мегаалюль,gordunni,1532,monk,mistweaver,36,16,20
Pikajeww,kazzak,1531,monk,mistweaver,80,57,23
Dumplings,earthen-ring,1531,monk,mistweaver,78,48,30
Hanhunden,grim-batol,1531,monk,mistweaver,337,179,158
Xloxloxloxy,outland,1530,monk,mistweaver,24,16,8
Ninjasven,bladefist,1530,monk,mistweaver,42,19,23
Mattybfast,tarren-mill,1529,monk,mistweaver,59,44,15
Soulxq,blackrock,1529,monk,mistweaver,219,112,107
Noni,gorgonnash,1529,monk,mistweaver,113,57,56
Hokutoken,hyjal,1528,monk,mistweaver,30,19,11
Karatekickyo,ravencrest,1528,monk,mistweaver,40,22,18
Discoelysia,outland,1528,monk,mistweaver,171,93,78
Brucechi,kargath,1527,monk,mistweaver,93,67,26
Timboxd,blackmoore,1527,monk,mistweaver,85,49,36
Aeolôs,hyjal,1527,monk,mistweaver,120,65,55
Urbàs,blackmoore,1526,monk,mistweaver,42,29,13
Applestrûdel,blackrock,1526,monk,mistweaver,93,55,38
Тоталиспайс,lich-king,1526,monk,mistweaver,95,52,43
Annaftz,kirin-tor,1525,monk,mistweaver,33,18,15
Yuyuni,laughing-skull,1525,monk,mistweaver,60,29,31
Føxy,sunstrider,1523,monk,mistweaver,78,45,33
Shiesel,draenor,1523,monk,mistweaver,98,53,45
Phébz,archimonde,1523,monk,mistweaver,68,36,32
Spánkproóf,kazzak,1522,monk,mistweaver,30,18,12
Vivir,stormreaver,1522,monk,mistweaver,228,126,102
Boomshaq,defias-brotherhood,1522,monk,mistweaver,319,169,150
Miînd,archimonde,1521,monk,mistweaver,78,46,32
Uncleheal,tarren-mill,1521,monk,mistweaver,37,21,16
Ароба,blackscar,1521,monk,mistweaver,47,23,24
Màru,blackrock,1520,monk,mistweaver,48,27,21
Musashiden,twisting-nether,1520,monk,mistweaver,75,40,35
Zerym,silvermoon,1520,monk,mistweaver,78,38,40
Correforrest,dun-modr,1519,monk,mistweaver,132,81,51
Rizzwalker,ravencrest,1519,monk,mistweaver,89,52,37
Bóber,kazzak,1519,monk,mistweaver,54,30,24
Atommyran,frostmane,1519,monk,mistweaver,141,76,65
Whoszeus,archimonde,1519,monk,mistweaver,356,184,172
Sînê,archimonde,1518,monk,mistweaver,174,98,76
Monarko,twisting-nether,1518,monk,mistweaver,143,80,63
Kanajambe,twisting-nether,1517,monk,mistweaver,60,41,19
Mightnorn,tarren-mill,1517,monk,mistweaver,36,20,16
Jimbearend,argent-dawn,1516,monk,mistweaver,212,116,96
Carlocolucci,the-maelstrom,1516,monk,mistweaver,61,33,28
Eynodiggity,blackmoore,1516,monk,mistweaver,72,38,34
Ukrytywaz,burning-legion,1516,monk,mistweaver,376,191,185
Zands,ysondre,1515,monk,mistweaver,60,42,18
Ticktak,archimonde,1515,monk,mistweaver,92,55,37
Conguitø,colinas-pardas,1515,monk,mistweaver,156,84,72
Sobadzlolz,alexstrasza,1515,monk,mistweaver,60,28,32
Joshimitsu,sylvanas,1515,monk,mistweaver,98,45,53
Shàká,stormscale,1514,monk,mistweaver,42,28,14
Drúdkh,tarren-mill,1514,monk,mistweaver,72,41,31
Saliya,draenor,1514,monk,mistweaver,40,20,20
Løsang,blackrock,1513,monk,mistweaver,239,140,99
Kungfox,frostwolf,1513,monk,mistweaver,84,43,41
Dromarch,dun-modr,1513,monk,mistweaver,81,39,42
Jcchi,xavius,1513,monk,mistweaver,126,60,66
Xhanc,aegwynn,1512,monk,mistweaver,24,18,6
Spiritualia,kazzak,1512,monk,mistweaver,247,133,114
Bazalka,blackmoore,1512,monk,mistweaver,30,16,14
Jbzzu,outland,1512,monk,mistweaver,48,23,25
Monkiful,haomarush,1512,monk,mistweaver,52,21,31
Ronkingkong,ravencrest,1512,monk,mistweaver,42,16,26
Vajawalker,twisting-nether,1511,monk,mistweaver,132,76,56
Elity,archimonde,1510,monk,mistweaver,82,54,28
Ragenn,zuljin,1510,monk,mistweaver,49,32,17
Oogwai,twisting-nether,1510,monk,mistweaver,108,64,44
Кулаквнос,gordunni,1510,monk,mistweaver,210,106,104
Shoryugrops,chants-éternels,1509,monk,mistweaver,26,18,8
Åshêrs,stormscale,1509,monk,mistweaver,36,22,14
Orkiya,archimonde,1509,monk,mistweaver,348,182,166
Krysira,blackrock,1508,monk,mistweaver,30,19,11
Reivil,kazzak,1508,monk,mistweaver,30,16,14
Fungxi,archimonde,1508,monk,mistweaver,78,33,45
Lobnx,kazzak,1507,monk,mistweaver,41,25,16
Romk,darkspear,1506,monk,mistweaver,60,43,17
Zentina,outland,1506,monk,mistweaver,66,44,22
Bendís,twisting-nether,1506,monk,mistweaver,131,70,61
Wifepuncher,blackhand,1506,monk,mistweaver,36,19,17
Backseatgmr,ravencrest,1506,monk,mistweaver,106,54,52
Smâsh,blackhand,1505,monk,mistweaver,88,51,37
Sneezao,ravencrest,1505,monk,mistweaver,162,89,73
Chípmonk,earthen-ring,1505,monk,mistweaver,213,117,96
Musslee,elune,1505,monk,mistweaver,123,61,62
Gravityfist,aegwynn,1505,monk,mistweaver,102,48,54
Basthek,blackhand,1505,monk,mistweaver,107,50,57
Вондерофъю,gordunni,1505,monk,mistweaver,54,24,30
Chiroan,twisting-nether,1504,monk,mistweaver,112,64,48
Møjíto,stormscale,1504,monk,mistweaver,83,43,40
Kungfuppl,kazzak,1504,monk,mistweaver,103,46,57
Инженерия,howling-fjord,1503,monk,mistweaver,60,36,24
Visk,blackmoore,1503,monk,mistweaver,203,108,95
Bullbøx,chamber-of-aspects,1503,monk,mistweaver,123,55,68
Rolegsweep,arathor,1502,monk,mistweaver,94,45,49
Mongretod,ravencrest,1501,monk,mistweaver,30,16,14
Самадайка,howling-fjord,1501,monk,mistweaver,166,86,80
Doingmaster,blackrock,1500,monk,mistweaver,60,30,30
Riotplz,draenor,1500,monk,mistweaver,45,22,23
Nexìan,kazzak,1499,monk,mistweaver,36,27,9
Skusle,defias-brotherhood,1499,monk,mistweaver,36,22,14
Timmyßênz,kaelthas,1499,monk,mistweaver,107,60,47
Quendi,arthas,1499,monk,mistweaver,299,161,138
Амаззонния,soulflayer,1498,monk,mistweaver,380,186,194
Endorrphine,ravencrest,1498,monk,mistweaver,146,65,81
Zeldrís,ragnaros,1497,monk,mistweaver,102,51,51
Jihaaz,nemesis,1496,monk,mistweaver,187,97,90
Германика,soulflayer,1496,monk,mistweaver,383,192,191
Bigballs,ysera,1496,monk,mistweaver,66,30,36
Busfâhrer,antonidas,1495,monk,mistweaver,29,16,13
Fistyboyuk,tarren-mill,1494,monk,mistweaver,29,17,12
Mecin,ragnaros,1493,monk,mistweaver,60,32,28
Evilrui,ravencrest,1493,monk,mistweaver,93,49,44
Pandimaci,ragnaros,1492,monk,mistweaver,152,87,65
Каземат,booty-bay,1492,monk,mistweaver,90,51,39
Fistarfrans,sylvanas,1491,monk,mistweaver,32,24,8
Píkachuu,ragnaros,1491,monk,mistweaver,65,41,24
Incapme,outland,1490,monk,mistweaver,180,98,82
Chakuro,ravencrest,1488,monk,mistweaver,30,20,10
Quicc,ravencrest,1488,monk,mistweaver,72,36,36
Scare,stormreaver,1487,monk,mistweaver,111,63,48
Dupengchi,blackrock,1487,monk,mistweaver,54,26,28
Tonyjohns,draenor,1486,monk,mistweaver,30,18,12
Kegrøll,doomhammer,1486,monk,mistweaver,54,29,25
Cmk,outland,1486,monk,mistweaver,102,42,60
Moveietss,stormscale,1485,monk,mistweaver,18,16,2
Teztouza,kazzak,1485,monk,mistweaver,42,26,16
Fungku,azjolnerub,1485,monk,mistweaver,357,180,177
Lunarès,antonidas,1483,monk,mistweaver,32,19,13
Maiver,stormscale,1482,monk,mistweaver,139,78,61
Mekki,outland,1481,monk,mistweaver,21,17,4
Boozmoo,stormscale,1481,monk,mistweaver,76,55,21
Ajita,blackmoore,1481,monk,mistweaver,66,35,31
Chàrràth,blackmoore,1481,monk,mistweaver,255,127,128
Asterii,archimonde,1481,monk,mistweaver,42,20,22
Pati,blackrock,1480,monk,mistweaver,147,78,69
Lilmanfist,stormscale,1480,monk,mistweaver,42,22,20
Monkzdino,destromath,1480,monk,mistweaver,83,41,42
Kano,burning-legion,1479,monk,mistweaver,38,23,15
Mistyice,kazzak,1479,monk,mistweaver,30,17,13
Sororicide,stormscale,1479,monk,mistweaver,48,25,23
Aguerxf,alleria,1479,monk,mistweaver,65,30,35
Юансноу,blackscar,1478,monk,mistweaver,108,64,44
Saáru,argent-dawn,1478,monk,mistweaver,114,57,57
Ytonie,gorgonnash,1477,monk,mistweaver,36,28,8
Kreynich,blackhand,1477,monk,mistweaver,36,25,11
Sanhollo,stormscale,1477,monk,mistweaver,29,17,12
Dìó,tarren-mill,1477,monk,mistweaver,210,117,93
Coopers,hyjal,1477,monk,mistweaver,108,60,48
Huricän,drakthul,1477,monk,mistweaver,57,27,30
Okdontnerf,kazzak,1476,monk,mistweaver,130,64,66
Wølfy,argent-dawn,1476,monk,mistweaver,50,24,26
Shiveri,outland,1476,monk,mistweaver,89,42,47
Shouling,outland,1475,monk,mistweaver,97,55,42
Nimander,burning-legion,1475,monk,mistweaver,39,19,20
Gucciweaver,tarren-mill,1474,monk,mistweaver,35,22,13
Влажныйтач,soulflayer,1474,monk,mistweaver,42,25,17
Mareki,nethersturm,1473,monk,mistweaver,107,62,45
Skâte,dun-modr,1473,monk,mistweaver,77,42,35
Affrro,drakthul,1471,monk,mistweaver,89,51,38
Sheishot,kazzak,1471,monk,mistweaver,61,32,29
Монкиннияя,gordunni,1471,monk,mistweaver,45,21,24
Thuz,kazzak,1470,monk,mistweaver,75,39,36
Анамо,blackscar,1469,monk,mistweaver,78,45,33
Tòrian,pozzo-delleternità,1469,monk,mistweaver,42,20,22
Rebeka,dun-modr,1469,monk,mistweaver,36,17,19
Зелёныймонк,soulflayer,1468,monk,mistweaver,114,63,51
Moistweaver,hellfire,1468,monk,mistweaver,84,44,40
Capwouk,tarren-mill,1468,monk,mistweaver,36,16,20
Vitnam,auchindoun,1467,monk,mistweaver,287,151,136
Zenfoxy,blackrock,1467,monk,mistweaver,54,23,31
Mystd,hyjal,1466,monk,mistweaver,41,24,17
Jusn,tarren-mill,1466,monk,mistweaver,173,91,82
Vørdèthxd,outland,1465,monk,mistweaver,84,58,26
Æctò,blackmoore,1465,monk,mistweaver,180,92,88
Hærleyquin,ravencrest,1465,monk,mistweaver,48,23,25
Jyll,malganis,1465,monk,mistweaver,185,80,105
Sámal,draenor,1464,monk,mistweaver,72,44,28
Onÿz,hyjal,1464,monk,mistweaver,57,32,25
Fisticuffs,tarren-mill,1464,monk,mistweaver,70,37,33
Yararsizz,twisting-nether,1463,monk,mistweaver,61,39,22
Rymz,sanguino,1463,monk,mistweaver,109,65,44
Byoß,stormscale,1463,monk,mistweaver,85,50,35
Rìnox,blackmoore,1463,monk,mistweaver,132,71,61
Gatubarnet,stormscale,1463,monk,mistweaver,77,41,36
Varanthyra,argent-dawn,1463,monk,mistweaver,66,34,32
Mønía,ysondre,1463,monk,mistweaver,60,25,35
Bigkim,khadgar,1462,monk,mistweaver,36,16,20
Dudulinda,silvermoon,1461,monk,mistweaver,120,64,56
Xplosiv,twisting-nether,1461,monk,mistweaver,271,143,128
Zavarius,silvermoon,1461,monk,mistweaver,42,20,22
Farrken,drakthul,1460,monk,mistweaver,55,32,23
Badonna,burning-legion,1460,monk,mistweaver,102,59,43
Россиянин,thermaplugg,1460,monk,mistweaver,78,41,37
Moohamood,argent-dawn,1460,monk,mistweaver,150,72,78
Idkfa,sylvanas,1459,monk,mistweaver,79,45,34
Bîgmø,blades-edge,1459,monk,mistweaver,42,22,20
Misthera,burning-legion,1459,monk,mistweaver,142,65,77
Salvaje,stormscale,1458,monk,mistweaver,78,46,32
Hitsumia,archimonde,1458,monk,mistweaver,48,18,30
Zaïn,hyjal,1457,monk,mistweaver,73,46,27
Atómic,eredar,1457,monk,mistweaver,34,18,16
Muix,draenor,1457,monk,mistweaver,48,23,25
Zenzu,blackmoore,1455,monk,mistweaver,54,34,20
Zinnout,twisting-nether,1455,monk,mistweaver,137,76,61
Dembe,darksorrow,1454,monk,mistweaver,126,67,59
Diabolùs,blackmoore,1454,monk,mistweaver,48,20,28
Marielo,blackmoore,1453,monk,mistweaver,116,63,53
Vicmønk,kazzak,1453,monk,mistweaver,74,40,34
Tsifsakari,silvermoon,1453,monk,mistweaver,255,125,130
Venturi,aegwynn,1452,monk,mistweaver,81,42,39
Lilfist,thrall,1451,monk,mistweaver,32,21,11
Themistius,kazzak,1451,monk,mistweaver,29,19,10
Latsu,silvermoon,1451,monk,mistweaver,42,21,21
Gruslinovica,archimonde,1451,monk,mistweaver,67,31,36
Beerbringer,kazzak,1450,monk,mistweaver,36,24,12
Сестраджосси,gordunni,1450,monk,mistweaver,29,17,12
Wryktas,aegwynn,1449,monk,mistweaver,24,20,4
Cocoonkappa,dun-modr,1447,monk,mistweaver,45,27,18
Cmgxbrew,blackrock,1447,monk,mistweaver,41,16,25
Lökmedsmör,draenor,1446,monk,mistweaver,30,23,7
Изимонк,gordunni,1446,monk,mistweaver,41,25,16
Edll,silvermoon,1446,monk,mistweaver,66,34,32
Siamesedream,outland,1445,monk,mistweaver,212,121,91
Kandislee,ravencrest,1444,monk,mistweaver,72,36,36
Zenified,ragnaros,1444,monk,mistweaver,94,45,49
Chìless,shadowsong,1443,monk,mistweaver,30,21,9
Ônlýféédx,burning-blade,1443,monk,mistweaver,36,16,20
Guanglee,silvermoon,1441,monk,mistweaver,56,37,19
Acidflexx,kazzak,1441,monk,mistweaver,69,39,30
Bigbuddha,outland,1441,monk,mistweaver,41,21,20
Sadfacetiki,kazzak,1441,monk,mistweaver,45,20,25
Caskgut,ravencrest,1440,monk,mistweaver,155,88,67
Furrychan,blackmoore,1440,monk,mistweaver,42,23,19
Torqualis,kazzak,1440,monk,mistweaver,340,175,165
Mugenzenx,sanguino,1439,monk,mistweaver,24,15,9
Kz,culte-de-la-rive-noire,1439,monk,mistweaver,24,15,9
Daitaro,ravencrest,1439,monk,mistweaver,92,49,43
Shàllýn,antonidas,1439,monk,mistweaver,42,21,21
Chijis,blackmoore,1439,monk,mistweaver,30,15,15
Draxed,kazzak,1438,monk,mistweaver,30,20,10
Fuzzypunch,draenor,1438,monk,mistweaver,140,79,61
Bláckøutx,quelthalas,1438,monk,mistweaver,97,50,47
Moorf,ravencrest,1438,monk,mistweaver,30,15,15
Morebuffz,ravencrest,1437,monk,mistweaver,135,72,63
Koalazero,kazzak,1437,monk,mistweaver,30,15,15
Eradasmw,kazzak,1436,monk,mistweaver,24,15,9
Futtzi,thrall,1436,monk,mistweaver,59,34,25
Ryle,forscherliga,1436,monk,mistweaver,36,19,17
Garweaver,frostwolf,1436,monk,mistweaver,36,15,21
Nezuko,kazzak,1435,monk,mistweaver,61,37,24
Icantstopme,argent-dawn,1435,monk,mistweaver,48,29,19
Laggedfist,kazzak,1435,monk,mistweaver,48,28,20
Akuuji,silvermoon,1435,monk,mistweaver,30,15,15
Neverendxx,draenor,1435,monk,mistweaver,68,31,37
Habmit,ravencrest,1434,monk,mistweaver,18,15,3
Ähronius,stormscale,1434,monk,mistweaver,24,15,9
Ainamw,ravencrest,1434,monk,mistweaver,26,15,11
Musaya,chamber-of-aspects,1434,monk,mistweaver,48,21,27
Danîi,dun-morogh,1433,monk,mistweaver,56,34,22
Bleja,blackhand,1433,monk,mistweaver,262,137,125
Неэверида,deepholm,1433,monk,mistweaver,296,152,144
Santanax,ravencrest,1432,monk,mistweaver,30,17,13
Thralg,neptulon,1432,monk,mistweaver,78,44,34
Fistingfury,burning-blade,1432,monk,mistweaver,162,82,80
Xoonaki,turalyon,1431,monk,mistweaver,24,15,9
Akùmawíns,archimonde,1431,monk,mistweaver,60,30,30
Nievah,argent-dawn,1430,monk,mistweaver,39,24,15
Tinkerholic,frostmane,1430,monk,mistweaver,308,158,150
Monkgd,sylvanas,1428,monk,mistweaver,152,85,67
Nela,sanguino,1428,monk,mistweaver,72,39,33
Degentz,alakir,1428,monk,mistweaver,86,41,45
Tiashun,argent-dawn,1427,monk,mistweaver,48,28,20
Venac,burning-legion,1427,monk,mistweaver,291,161,130
Angelofchaos,outland,1426,monk,mistweaver,30,23,7
Скорпин,ashenvale,1426,monk,mistweaver,68,35,33
Kazutora,archimonde,1425,monk,mistweaver,18,15,3
Achtal,blackmoore,1425,monk,mistweaver,71,38,33
Nrkbob,ysondre,1425,monk,mistweaver,101,54,47
Brewzleè,ravencrest,1425,monk,mistweaver,64,33,31
Letmerollplz,ravencrest,1424,monk,mistweaver,70,44,26
Atenazadonte,sanguino,1424,monk,mistweaver,39,23,16
Néovo,blackmoore,1424,monk,mistweaver,120,65,55
Kungfupandy,blackmoore,1424,monk,mistweaver,298,161,137
Fredder,blackrock,1422,monk,mistweaver,305,166,139
Bigchaz,outland,1421,monk,mistweaver,24,15,9
Ikuyaa,ravencrest,1421,monk,mistweaver,29,15,14
Meeralya,ravencrest,1421,monk,mistweaver,42,18,24
Ronocs,turalyon,1420,monk,mistweaver,57,33,24
Peaceweaver,kilrogg,1419,monk,mistweaver,48,30,18
Azouko,onyxia,1419,monk,mistweaver,37,20,17
Imamonk,tarren-mill,1419,monk,mistweaver,30,15,15
Kégman,silvermoon,1418,monk,mistweaver,51,30,21
Woushou,outland,1418,monk,mistweaver,178,98,80
Bukkits,argent-dawn,1418,monk,mistweaver,72,35,37
Xianxiaa,ravencrest,1417,monk,mistweaver,100,57,43
ßountÿ,kazzak,1416,monk,mistweaver,66,46,20
Xanadoll,outland,1416,monk,mistweaver,30,19,11
Yarie,blackmoore,1416,monk,mistweaver,126,63,63
Flaton,draenor,1415,monk,mistweaver,45,25,20
Luffix,outland,1415,monk,mistweaver,54,29,25
Nexyyfist,kazzak,1415,monk,mistweaver,99,48,51
Moonachi,tarren-mill,1414,monk,mistweaver,72,42,30
Zenvex,tarren-mill,1414,monk,mistweaver,50,27,23
Barks,archimonde,1414,monk,mistweaver,140,75,65
Konïï,dalaran,1414,monk,mistweaver,30,15,15
Fleecymonk,blackmoore,1414,monk,mistweaver,54,23,31
Tacktix,defias-brotherhood,1413,monk,mistweaver,35,22,13
Lpm,draenor,1413,monk,mistweaver,46,26,20
Тефтелъка,soulflayer,1413,monk,mistweaver,52,29,23
Генжуро,blackscar,1413,monk,mistweaver,30,15,15
Tílidin,malganis,1412,monk,mistweaver,30,21,9
Lazuros,auchindoun,1412,monk,mistweaver,30,16,14
Newlol,outland,1412,monk,mistweaver,66,34,32
Tily,stormreaver,1411,monk,mistweaver,84,45,39
Suggy,kilrogg,1411,monk,mistweaver,46,24,22
Azkaal,marécage-de-zangar,1410,monk,mistweaver,30,20,10
Drâcømørt,dalaran,1410,monk,mistweaver,57,31,26
Eclipsè,dragonmaw,1409,monk,mistweaver,59,34,25
Банзашарик,gordunni,1409,monk,mistweaver,96,54,42
Khakk,elune,1408,monk,mistweaver,36,21,15
Nivi,aegwynn,1408,monk,mistweaver,30,15,15
Piednuques,archimonde,1408,monk,mistweaver,54,22,32
Asmiu,die-aldor,1406,monk,mistweaver,36,23,13
Loth,archimonde,1406,monk,mistweaver,30,17,13
Khapta,ysondre,1406,monk,mistweaver,78,40,38
Toaborsten,tarren-mill,1405,monk,mistweaver,58,49,9
Kazume,pozzo-delleternità,1404,monk,mistweaver,57,35,22
Kroyus,antonidas,1404,monk,mistweaver,164,84,80
Cicera,kazzak,1404,monk,mistweaver,59,25,34
Qtonboard,garrosh,1403,monk,mistweaver,153,71,82
Xfu,auchindoun,1403,monk,mistweaver,142,64,78
Nîcko,ravencrest,1402,monk,mistweaver,42,25,17
Kify,dun-modr,1402,monk,mistweaver,33,19,14
Lunì,nathrezim,1402,monk,mistweaver,42,24,18
Amélith,kirin-tor,1402,monk,mistweaver,48,27,21
Dipdop,blackhand,1401,monk,mistweaver,229,129,100
Hewlz,blackmoore,1401,monk,mistweaver,42,21,21
Astolfochan,silvermoon,1400,monk,mistweaver,36,18,18
Facetimee,ahnqiraj,1399,monk,mistweaver,74,42,32
Mischenka,thrall,1399,monk,mistweaver,90,50,40
Staane,hyjal,1399,monk,mistweaver,48,23,25
Тхэгык,soulflayer,1399,monk,mistweaver,36,15,21
Shakal,outland,1397,monk,mistweaver,72,46,26
Perseverance,illidan,1397,monk,mistweaver,42,26,16
Blackthorens,sylvanas,1396,monk,mistweaver,85,58,27
Coliusz,bloodhoof,1396,monk,mistweaver,47,19,28
Popcornn,archimonde,1394,monk,mistweaver,66,35,31
Schaulong,blackmoore,1394,monk,mistweaver,108,57,51
Pantyypolice,blackrock,1393,monk,mistweaver,22,16,6
Anadia,blackrock,1393,monk,mistweaver,24,15,9
Folfimo,silvermoon,1393,monk,mistweaver,29,17,12
Wontdie,dalaran,1393,monk,mistweaver,90,25,65
Juicyloux,aegwynn,1392,monk,mistweaver,98,64,34
Valdaras,runetotem,1392,monk,mistweaver,36,15,21
Knäven,defias-brotherhood,1391,monk,mistweaver,24,15,9
Bibidøng,drakthul,1391,monk,mistweaver,36,21,15
Mistsen,kazzak,1391,monk,mistweaver,87,49,38
Spittq,ysondre,1390,monk,mistweaver,81,48,33
Baddany,sanguino,1390,monk,mistweaver,102,57,45
Malfius,shadowsong,1390,monk,mistweaver,58,32,26
Zukatan,tarren-mill,1389,monk,mistweaver,136,77,59
Рекилоллз,gordunni,1389,monk,mistweaver,130,69,61
Kungfubatti,stormscale,1389,monk,mistweaver,219,116,103
Puddinpop,auchindoun,1389,monk,mistweaver,91,42,49
Cypriot,mazrigos,1387,monk,mistweaver,89,57,32
Katse,eredar,1387,monk,mistweaver,128,74,54
Vuzashiji,argent-dawn,1387,monk,mistweaver,139,69,70
Mistfistmw,outland,1387,monk,mistweaver,78,35,43
Ðëvx,argent-dawn,1386,monk,mistweaver,126,70,56
Monkhônk,blackmoore,1386,monk,mistweaver,59,28,31
Cybert,blackmoore,1386,monk,mistweaver,70,28,42
Adamlól,tarren-mill,1386,monk,mistweaver,44,17,27
Nahir,ragnaros,1385,monk,mistweaver,106,52,54
Keksmash,ravencrest,1385,monk,mistweaver,80,38,42
Mythadeya,stormscale,1385,monk,mistweaver,90,39,51
Eniyl,hyjal,1384,monk,mistweaver,84,40,44
Саинтифик,gordunni,1384,monk,mistweaver,42,19,23
Котэлатэ,gordunni,1384,monk,mistweaver,50,22,28
Smmithyy,draenor,1383,monk,mistweaver,40,22,18
Roidcarry,blackrock,1383,monk,mistweaver,41,16,25
Jumper,xavius,1382,monk,mistweaver,48,29,19
Striptina,blackmoore,1382,monk,mistweaver,90,49,41
Oregan,conseil-des-ombres,1382,monk,mistweaver,113,59,54
Tisculaccio,pozzo-delleternità,1382,monk,mistweaver,424,216,208
Fizted,tarren-mill,1382,monk,mistweaver,59,30,29
Pandacus,silvermoon,1381,monk,mistweaver,90,40,50
Тиктокмонк,gordunni,1381,monk,mistweaver,49,20,29
Haxxo,die-nachtwache,1380,monk,mistweaver,68,40,28
Sandbox,aszune,1380,monk,mistweaver,29,15,14
Bulletproof,bloodscalp,1379,monk,mistweaver,127,71,56
Lucebree,nozdormu,1379,monk,mistweaver,216,118,98
Saolin,emeriss,1379,monk,mistweaver,84,44,40
Kruemelkeks,frostwolf,1378,monk,mistweaver,57,33,24
Antinun,kazzak,1378,monk,mistweaver,112,62,50
Kobudo,burning-legion,1378,monk,mistweaver,203,93,110
Fatskeleton,stormreaver,1378,monk,mistweaver,457,209,248
Awesomebrah,the-maelstrom,1377,monk,mistweaver,24,15,9
Gigilonis,korgall,1377,monk,mistweaver,257,138,119
Rakowo,arthas,1377,monk,mistweaver,30,16,14
Grintilif,malygos,1376,monk,mistweaver,36,23,13
Сильфиета,gordunni,1375,monk,mistweaver,75,43,32
Xladerzz,kazzak,1374,monk,mistweaver,23,15,8
Ninpou,blackrock,1374,monk,mistweaver,62,35,27
Jarô,silvermoon,1374,monk,mistweaver,130,58,72
Mvpßæ,stormscale,1373,monk,mistweaver,84,48,36
Xwtdreamz,hyjal,1373,monk,mistweaver,139,72,67
Portugas,aegwynn,1373,monk,mistweaver,54,22,32
Freebírd,shattered-hand,1372,monk,mistweaver,75,44,31
Sshbrew,kazzak,1372,monk,mistweaver,60,28,32
Rhemm,the-maelstrom,1371,monk,mistweaver,95,49,46
Swiftmonky,azuremyst,1371,monk,mistweaver,35,15,20
Rollsamdi,tarren-mill,1370,monk,mistweaver,63,37,26
Greenshortea,aegwynn,1370,monk,mistweaver,58,31,27
Fattysan,argent-dawn,1369,monk,mistweaver,90,46,44
Nausìcaa,defias-brotherhood,1368,monk,mistweaver,30,20,10
Kirtachi,dun-modr,1368,monk,mistweaver,23,15,8
Pandalezanda,silvermoon,1368,monk,mistweaver,63,40,23
Jeydi,ravencrest,1368,monk,mistweaver,97,52,45
Trancendent,silvermoon,1368,monk,mistweaver,34,15,19
Pämella,alleria,1367,monk,mistweaver,30,24,6
Faa,archimonde,1367,monk,mistweaver,23,17,6
Fistmeg,grim-batol,1367,monk,mistweaver,47,16,31
Horriblemonk,archimonde,1366,monk,mistweaver,36,21,15
Krylin,antonidas,1366,monk,mistweaver,165,83,82
Beaglemo,blackrock,1366,monk,mistweaver,35,15,20
Coollann,drakthul,1364,monk,mistweaver,64,29,35
Légit,argent-dawn,1363,monk,mistweaver,98,61,37
Tøngpø,argent-dawn,1363,monk,mistweaver,30,18,12
Carloz,drakthul,1363,monk,mistweaver,110,63,47
Монкпех,gordunni,1363,monk,mistweaver,147,74,73
Vetocorleone,kazzak,1362,monk,mistweaver,190,99,91
Masumi,sanguino,1362,monk,mistweaver,88,43,45
Gilario,silvermoon,1361,monk,mistweaver,132,66,66
Blaeys,blackmoore,1360,monk,mistweaver,81,48,33
Charlett,the-venture-co,1360,monk,mistweaver,52,28,24
Monkehst,dun-modr,1359,monk,mistweaver,120,61,59
Theichi,draenor,1358,monk,mistweaver,105,57,48
Aznreznzfdqs,grim-batol,1356,monk,mistweaver,42,27,15
Nevelbeast,rexxar,1356,monk,mistweaver,69,38,31
Bigdickmonk,blackmoore,1356,monk,mistweaver,81,41,40
Rëliq,wildhammer,1355,monk,mistweaver,30,16,14
Allosthenos,ravencrest,1355,monk,mistweaver,141,72,69
Pechu,blackhand,1355,monk,mistweaver,33,15,18
Papasan,aggramar,1354,monk,mistweaver,66,37,29
Medovic,blackmoore,1354,monk,mistweaver,262,137,125
Ðømínus,blackmoore,1354,monk,mistweaver,160,82,78
Thayne,blades-edge,1354,monk,mistweaver,30,15,15
Melikicks,silvermoon,1354,monk,mistweaver,42,19,23
Nìkâ,blackmoore,1353,monk,mistweaver,87,48,39
Missmstweavr,blackrock,1353,monk,mistweaver,42,21,21
Pusityv,silvermoon,1352,monk,mistweaver,60,32,28
Rasputín,draenor,1352,monk,mistweaver,94,50,44
Eltonj,sylvanas,1351,monk,mistweaver,142,82,60
Muaba,outland,1351,monk,mistweaver,46,21,25
Nasaislying,grim-batol,1350,monk,mistweaver,102,57,45
Rbgmachine,burning-legion,1350,monk,mistweaver,54,28,26
Sylicia,alleria,1348,monk,mistweaver,36,21,15
Konexzx,blackmoore,1348,monk,mistweaver,42,24,18
Touchofmonk,draenor,1348,monk,mistweaver,48,26,22
Loreo,burning-legion,1348,monk,mistweaver,213,115,98
Фериго,gordunni,1348,monk,mistweaver,119,62,57
Garfeels,sylvanas,1347,monk,mistweaver,24,16,8
Brewsclues,twisting-nether,1347,monk,mistweaver,30,15,15
Kwacisawhe,die-aldor,1347,monk,mistweaver,56,25,31
Lìtenstrumpa,sylvanas,1346,monk,mistweaver,66,34,32
Bråin,ravenholdt,1346,monk,mistweaver,54,27,27
Jollaz,twisting-nether,1345,monk,mistweaver,29,15,14
Monqt,sylvanas,1344,monk,mistweaver,54,33,21
Gråce,nemesis,1344,monk,mistweaver,284,148,136
Meo,emeriss,1344,monk,mistweaver,42,17,25
Lennifer,ragnaros,1343,monk,mistweaver,18,14,4
Chochinbi,garrosh,1343,monk,mistweaver,42,25,17
Gemil,argent-dawn,1343,monk,mistweaver,24,14,10
Dunkfjås,stormscale,1343,monk,mistweaver,24,14,10
Coalsack,outland,1343,monk,mistweaver,28,15,13
Jamonkal,blackhand,1343,monk,mistweaver,39,18,21
Zagar,emeriss,1342,monk,mistweaver,24,14,10
Irønmaxx,die-aldor,1342,monk,mistweaver,24,14,10
Kryopumper,blackmoore,1342,monk,mistweaver,120,63,57
Vibemonk,outland,1341,monk,mistweaver,18,14,4
Panzergonk,ravencrest,1340,monk,mistweaver,18,14,4
Ùrìel,dalaran,1340,monk,mistweaver,30,17,13
Ðoom,sylvanas,1340,monk,mistweaver,123,60,63
Herdom,blackmoore,1339,monk,mistweaver,59,39,20
Urict,hyjal,1339,monk,mistweaver,30,16,14
Tobiboby,burning-legion,1339,monk,mistweaver,82,43,39
Jackìl,nemesis,1338,monk,mistweaver,18,14,4
Elasha,archimonde,1338,monk,mistweaver,25,16,9
Ewynamonk,silvermoon,1338,monk,mistweaver,24,14,10
Tokkz,eredar,1337,monk,mistweaver,20,17,3
Jeññie,stormscale,1337,monk,mistweaver,18,14,4
Yàfa,archimonde,1337,monk,mistweaver,24,14,10
Chillimonk,antonidas,1337,monk,mistweaver,33,17,16
Katharína,azuremyst,1337,monk,mistweaver,60,25,35
Permajuist,tarren-mill,1336,monk,mistweaver,18,14,4
Sinzy,dentarg,1336,monk,mistweaver,36,21,15
Picayune,mazrigos,1336,monk,mistweaver,101,54,47
Starside,tarren-mill,1336,monk,mistweaver,30,14,16
Sigourney,ravencrest,1335,monk,mistweaver,24,14,10
Onlyfísts,stormscale,1334,monk,mistweaver,54,20,34
Shainingzer,ysondre,1333,monk,mistweaver,28,15,13
Tastyfists,blackmoore,1333,monk,mistweaver,36,19,17
Maqs,argent-dawn,1331,monk,mistweaver,42,27,15
Choochoo,archimonde,1331,monk,mistweaver,48,22,26
Zøubida,draenor,1330,monk,mistweaver,36,21,15
Dunderfix,tarren-mill,1330,monk,mistweaver,72,41,31
Riip,ysondre,1330,monk,mistweaver,30,17,13
Monkjakt,draenor,1330,monk,mistweaver,42,17,25
Виноипиво,soulflayer,1330,monk,mistweaver,64,25,39
Køshka,archimonde,1329,monk,mistweaver,18,14,4
Квиор,deathguard,1329,monk,mistweaver,30,15,15
Anqan,outland,1329,monk,mistweaver,30,14,16
Muleerom,kazzak,1329,monk,mistweaver,30,14,16
Midgetyoda,outland,1329,monk,mistweaver,46,20,26
Sajin,la-croisade-écarlate,1329,monk,mistweaver,36,15,21
Sÿldae,dun-modr,1328,monk,mistweaver,30,21,9
Zondanmw,aegwynn,1327,monk,mistweaver,24,14,10
Yâssu,archimonde,1327,monk,mistweaver,33,18,15
Cudworth,silvermoon,1326,monk,mistweaver,78,53,25
Hyggefingerm,ravencrest,1326,monk,mistweaver,24,16,8
Ariluna,tarren-mill,1326,monk,mistweaver,24,14,10
Grenreaper,twisting-nether,1326,monk,mistweaver,30,14,16
Menazera,antonidas,1326,monk,mistweaver,87,39,48
Salix,quelthalas,1325,monk,mistweaver,38,23,15
Monkinamight,turalyon,1325,monk,mistweaver,54,31,23
Ätishâ,archimonde,1325,monk,mistweaver,163,78,85
Meehx,ravencrest,1324,monk,mistweaver,18,14,4
Unluckyday,ragnaros,1324,monk,mistweaver,46,27,19
Kapauww,twisting-nether,1324,monk,mistweaver,48,26,22
Звиздаатый,blackscar,1323,monk,mistweaver,42,26,16
Eonyzi,kazzak,1323,monk,mistweaver,66,40,26
Lcflay,archimonde,1323,monk,mistweaver,117,64,53
Akalaja,alakir,1323,monk,mistweaver,52,28,24
Saimheal,blackrock,1322,monk,mistweaver,23,15,8
Fraideberoa,ravencrest,1321,monk,mistweaver,42,30,12
Gumar,antonidas,1321,monk,mistweaver,24,14,10
Weavi,kazzak,1321,monk,mistweaver,65,33,32
Spritzbaron,blackmoore,1321,monk,mistweaver,30,14,16
Moonica,zenedar,1320,monk,mistweaver,38,23,15
Lovange,silvermoon,1320,monk,mistweaver,24,14,10
Moreløs,stormscale,1320,monk,mistweaver,66,37,29
Миамита,eversong,1320,monk,mistweaver,113,58,55
Renegatt,twisting-nether,1320,monk,mistweaver,30,14,16
Umagon,chogall,1320,monk,mistweaver,89,41,48
Mîla,sylvanas,1319,monk,mistweaver,42,26,16
Rhynne,ysondre,1319,monk,mistweaver,42,25,17
Robertoó,burning-legion,1319,monk,mistweaver,42,24,18
Badcøwboy,archimonde,1319,monk,mistweaver,131,56,75
Plasticbag,ravencrest,1318,monk,mistweaver,77,50,27
Mécagnóme,dalaran,1318,monk,mistweaver,113,58,55
Хромдар,gordunni,1316,monk,mistweaver,38,21,17
Erenaar,nemesis,1315,monk,mistweaver,54,30,24
Genjosanso,kazzak,1315,monk,mistweaver,177,97,80
Йомо,borean-tundra,1315,monk,mistweaver,60,23,37
Thegrudge,dragonblight,1315,monk,mistweaver,42,16,26
Kîârâ,frostwolf,1314,monk,mistweaver,52,30,22
Sêssai,outland,1313,monk,mistweaver,56,36,20
Stolas,spinebreaker,1313,monk,mistweaver,68,41,27
Galaxyfist,ragnaros,1313,monk,mistweaver,230,120,110
Brewswíllis,tarren-mill,1312,monk,mistweaver,18,14,4
Wøw,blackrock,1312,monk,mistweaver,18,14,4
Lfmasctop,ravencrest,1312,monk,mistweaver,22,16,6
Pinkstar,kazzak,1312,monk,mistweaver,24,15,9
Tuppence,defias-brotherhood,1312,monk,mistweaver,24,14,10
Loorda,neptulon,1312,monk,mistweaver,54,31,23
Bruceflea,blackrock,1312,monk,mistweaver,210,111,99
Szilvia,sylvanas,1312,monk,mistweaver,96,50,46
Tality,outland,1312,monk,mistweaver,42,19,23
Monkani,ravencrest,1311,monk,mistweaver,42,23,19
Blinkër,sanguino,1311,monk,mistweaver,36,19,17
Leefang,neptulon,1311,monk,mistweaver,49,24,25
Kassducu,archimonde,1310,monk,mistweaver,45,31,14
Leyira,blackmoore,1310,monk,mistweaver,65,42,23
Shaosshoshin,exodar,1310,monk,mistweaver,54,31,23
Rèddit,kazzak,1310,monk,mistweaver,78,37,41
Ролитта,gordunni,1309,monk,mistweaver,42,25,17
Ragnametal,tarren-mill,1309,monk,mistweaver,46,25,21
Rhuru,argent-dawn,1309,monk,mistweaver,61,32,29
Mórrid,draenor,1307,monk,mistweaver,36,20,16
Garmuth,tarren-mill,1307,monk,mistweaver,52,28,24
Hugemuffin,the-maelstrom,1307,monk,mistweaver,336,167,169
Токасзавода,soulflayer,1305,monk,mistweaver,52,34,18
Revii,anubarak,1305,monk,mistweaver,30,14,16
Fetchd,blackmoore,1303,monk,mistweaver,38,23,15
Lésley,ravencrest,1302,monk,mistweaver,66,35,31
Rorkito,sanguino,1302,monk,mistweaver,58,30,28
Tondi,malygos,1302,monk,mistweaver,34,17,17
Monkyou,hyjal,1301,monk,mistweaver,155,89,66
Murdalum,ravencrest,1301,monk,mistweaver,30,17,13
Pvppenergy,silvermoon,1301,monk,mistweaver,48,24,24
Galaxumi,ragnaros,1301,monk,mistweaver,36,17,19
Snitzla,drakthul,1300,monk,mistweaver,45,35,10
Lïtäø,archimonde,1300,monk,mistweaver,54,26,28
Moinalisaa,outland,1299,monk,mistweaver,30,18,12
Sideswipes,the-maelstrom,1299,monk,mistweaver,36,16,20
Poklicka,deathwing,1298,monk,mistweaver,30,24,6
Hackyback,outland,1298,monk,mistweaver,44,31,13
Nosenz,ravencrest,1297,monk,mistweaver,64,31,33
Erzull,doomhammer,1295,monk,mistweaver,92,52,40
Stegtflæsk,ravencrest,1295,monk,mistweaver,74,39,35
Zenmist,kazzak,1294,monk,mistweaver,23,14,9
Draxaxa,hyjal,1294,monk,mistweaver,30,17,13
Dánný,antonidas,1293,monk,mistweaver,95,51,44
Moistyheals,kazzak,1293,monk,mistweaver,62,29,33
Cocoxo,twisting-nether,1291,monk,mistweaver,15,15,0
Durand,blackhand,1290,monk,mistweaver,36,18,18
Sydras,silvermoon,1289,monk,mistweaver,729,372,357
Shenson,mazrigos,1288,monk,mistweaver,73,35,38
Keímohansio,twisting-nether,1288,monk,mistweaver,30,14,16
Шведишпорн,soulflayer,1287,monk,mistweaver,42,23,19
Daltailr,silvermoon,1287,monk,mistweaver,66,29,37
Draenan,blackrock,1286,monk,mistweaver,24,15,9
Kesuke,stormreaver,1286,monk,mistweaver,191,96,95
Flexxus,ravencrest,1286,monk,mistweaver,29,14,15
Tekwandn,shattrath,1285,monk,mistweaver,62,35,27
Kswis,outland,1284,monk,mistweaver,98,46,52
Mondrim,burning-legion,1283,monk,mistweaver,265,130,135
Wrathing,tarren-mill,1282,monk,mistweaver,24,18,6
Хэйхати,gordunni,1282,monk,mistweaver,164,82,82
Гиббискус,gordunni,1282,monk,mistweaver,66,28,38
Saintmoon,drakthul,1279,monk,mistweaver,111,60,51
Monkypunch,tarren-mill,1279,monk,mistweaver,64,30,34
Heyami,ravencrest,1279,monk,mistweaver,76,26,50
Masimonk,blackrock,1278,monk,mistweaver,35,22,13
Lûxz,ragnaros,1278,monk,mistweaver,66,30,36
Ashulera,archimonde,1278,monk,mistweaver,55,23,32
Numpys,sanguino,1277,monk,mistweaver,29,14,15
Gottegrisen,sylvanas,1277,monk,mistweaver,51,21,30
Slâpzz,ravencrest,1276,monk,mistweaver,18,15,3
Safíx,hyjal,1276,monk,mistweaver,47,26,21
Alurymnk,blackrock,1276,monk,mistweaver,49,25,24
Декстрометор,greymane,1275,monk,mistweaver,24,14,10
Brofist,emeriss,1274,monk,mistweaver,103,42,61
Brizs,outland,1273,monk,mistweaver,167,98,69
Nathaanel,argent-dawn,1273,monk,mistweaver,143,81,62
Ksll,silvermoon,1273,monk,mistweaver,72,35,37
Cranecannon,aegwynn,1272,monk,mistweaver,24,14,10
Carnat,blackrock,1272,monk,mistweaver,47,25,22
Adzk,tarren-mill,1272,monk,mistweaver,30,15,15
Drpajhiwo,burning-legion,1271,monk,mistweaver,58,34,24
Drboombay,kazzak,1271,monk,mistweaver,68,36,32
Profylaxist,arathor,1271,monk,mistweaver,149,73,76
Bloodpanci,ragnaros,1270,monk,mistweaver,57,32,25
Yahní,eredar,1270,monk,mistweaver,151,77,74
Akkri,tarren-mill,1270,monk,mistweaver,30,15,15
Sukisukí,ragnaros,1268,monk,mistweaver,88,49,39
Chainster,defias-brotherhood,1268,monk,mistweaver,94,49,45
Mishax,draenor,1268,monk,mistweaver,84,41,43
Трикленд,azuregos,1268,monk,mistweaver,60,29,31
Pawnzqt,stormscale,1267,monk,mistweaver,36,19,17
Джоский,borean-tundra,1267,monk,mistweaver,136,60,76
Bizzet,jaedenar,1266,monk,mistweaver,57,30,27
Pandathiss,argent-dawn,1265,monk,mistweaver,48,27,21
Томтью,gordunni,1265,monk,mistweaver,309,155,154
Sandrafarm,ragnaros,1264,monk,mistweaver,126,78,48
Mickjabber,aegwynn,1263,monk,mistweaver,66,35,31
Fistweavr,antonidas,1263,monk,mistweaver,48,23,25
Bluum,ravencrest,1263,monk,mistweaver,54,23,31
Worf,haomarush,1262,monk,mistweaver,60,34,26
Neylin,stormscale,1262,monk,mistweaver,137,65,72
Monkeytoast,ahnqiraj,1261,monk,mistweaver,45,29,16
Karatemonk,stormscale,1261,monk,mistweaver,54,23,31
Perraviciosa,sanguino,1260,monk,mistweaver,48,24,24
Алли,lich-king,1260,monk,mistweaver,72,31,41
Сигакрю,howling-fjord,1259,monk,mistweaver,39,24,15
Bbigttgothgf,doomhammer,1258,monk,mistweaver,24,14,10
Macgyverr,outland,1258,monk,mistweaver,24,14,10
Rotkäppchen,blackmoore,1258,monk,mistweaver,65,33,32
Shyasianmonk,eitrigg,1257,monk,mistweaver,24,14,10
Zyneswalker,blackhand,1257,monk,mistweaver,59,27,32
Chígoku,grim-batol,1257,monk,mistweaver,52,23,29
Malkaviano,kazzak,1256,monk,mistweaver,172,85,87
Applemonk,tarren-mill,1256,monk,mistweaver,76,35,41
Мирксимонк,soulflayer,1256,monk,mistweaver,35,16,19
Mestro,argent-dawn,1255,monk,mistweaver,172,94,78
Yorlena,malganis,1253,monk,mistweaver,35,23,12
Vladikus,tarren-mill,1253,monk,mistweaver,221,106,115
Stâhlfaust,antonidas,1253,monk,mistweaver,32,15,17
Jabarwackie,kiljaeden,1251,monk,mistweaver,24,19,5
Yokuboo,ysondre,1251,monk,mistweaver,78,41,37
Créo,azjolnerub,1251,monk,mistweaver,30,14,16
Houzagackel,blackrock,1251,monk,mistweaver,66,29,37
Bigfister,frostwhisper,1251,monk,mistweaver,36,14,22
Gozen,blackmoore,1250,monk,mistweaver,48,29,19
Snack,mannoroth,1249,monk,mistweaver,52,29,23
Адскиймех,deathweaver,1249,monk,mistweaver,99,48,51
Speedwalker,defias-brotherhood,1248,monk,mistweaver,18,13,5
Hialdó,sylvanas,1248,monk,mistweaver,24,14,10
Szerzetesý,ravencrest,1248,monk,mistweaver,24,13,11
Фонтамас,howling-fjord,1247,monk,mistweaver,18,13,5
Catmønk,drakthul,1247,monk,mistweaver,24,13,11
Zêstâgôdx,twisting-nether,1247,monk,mistweaver,24,13,11
Flãô,draenor,1247,monk,mistweaver,24,13,11
Fersokä,dun-modr,1247,monk,mistweaver,30,13,17
Badwithnames,stormscale,1246,monk,mistweaver,18,13,5
Deliveroo,twisting-nether,1246,monk,mistweaver,24,13,11
Nesthorian,draenor,1246,monk,mistweaver,123,61,62
Мистерхюй,gordunni,1246,monk,mistweaver,144,68,76
Elusen,kazzak,1245,monk,mistweaver,18,13,5
Kakos,eldrethalas,1245,monk,mistweaver,39,27,12
Níki,earthen-ring,1245,monk,mistweaver,30,20,10
Psyhooz,burning-legion,1245,monk,mistweaver,56,35,21
Deore,kazzak,1245,monk,mistweaver,24,13,11
Gedzio,silvermoon,1245,monk,mistweaver,40,15,25
Momomonku,hyjal,1244,monk,mistweaver,18,13,5
Rôckcat,blackrock,1244,monk,mistweaver,54,32,22
Kunolis,kazzak,1244,monk,mistweaver,42,22,20
Karatelady,twisting-nether,1244,monk,mistweaver,27,14,13
Skaadoosh,aggra-português,1244,monk,mistweaver,80,37,43
Shêd,sargeras,1243,monk,mistweaver,60,29,31
Yeetkunmeep,outland,1243,monk,mistweaver,54,25,29
Twigleaf,kazzak,1243,monk,mistweaver,37,14,23
Orenjis,kazzak,1242,monk,mistweaver,71,30,41
Glivilalis,drekthar,1241,monk,mistweaver,58,30,28
Snackis,blackmoore,1241,monk,mistweaver,30,13,17
Chibuku,burning-legion,1240,monk,mistweaver,24,13,11
Hazeroamer,tarren-mill,1239,monk,mistweaver,30,16,14
Freemann,archimonde,1239,monk,mistweaver,411,207,204
Ogpandapo,stormscale,1239,monk,mistweaver,205,92,113
Bréwmáster,silvermoon,1238,monk,mistweaver,18,13,5
Beesquared,stormrage,1238,monk,mistweaver,42,23,19
Виброолег,gordunni,1238,monk,mistweaver,24,13,11
Fiddle,archimonde,1238,monk,mistweaver,24,13,11
Stinkerella,blackhand,1238,monk,mistweaver,42,22,20
Такиера,gordunni,1237,monk,mistweaver,24,13,11
Эмфул,soulflayer,1237,monk,mistweaver,24,13,11
Dargaron,tarren-mill,1237,monk,mistweaver,48,19,29
Ugras,auchindoun,1237,monk,mistweaver,54,17,37
Spinalot,eredar,1236,monk,mistweaver,18,13,5
Norualy,tichondrius,1236,monk,mistweaver,65,35,30
Mcloving,turalyon,1236,monk,mistweaver,41,18,23
Boredom,wildhammer,1235,monk,mistweaver,133,70,63
Azoka,cthun,1235,monk,mistweaver,52,24,28
Bensó,stormscale,1234,monk,mistweaver,81,51,30
Joübar,archimonde,1234,monk,mistweaver,24,14,10
Mofisto,bladefist,1233,monk,mistweaver,65,33,32
Marrave,chogall,1233,monk,mistweaver,124,52,72
Bîmbâmboom,blackmoore,1232,monk,mistweaver,49,24,25
Monksim,outland,1232,monk,mistweaver,66,30,36
Jozo,hyjal,1231,monk,mistweaver,36,18,18
Stenhård,azjolnerub,1231,monk,mistweaver,60,27,33
Celph,kazzak,1231,monk,mistweaver,30,13,17
Xevol,burning-legion,1230,monk,mistweaver,25,15,10
Pepesmacks,kazzak,1230,monk,mistweaver,24,13,11
Abrra,burning-legion,1230,monk,mistweaver,30,13,17
Chingbag,dalaran,1229,monk,mistweaver,18,13,5
Mcronald,blackhand,1229,monk,mistweaver,90,50,40
Meihuaquan,ravencrest,1228,monk,mistweaver,24,13,11
Toon,eredar,1228,monk,mistweaver,142,69,73
Shiftchenko,stormscale,1227,monk,mistweaver,86,48,38
Togahoshy,antonidas,1227,monk,mistweaver,70,34,36
Chitun,malganis,1225,monk,mistweaver,22,14,8
Chiá,tarren-mill,1225,monk,mistweaver,151,80,71
Rayvi,kiljaeden,1224,monk,mistweaver,18,13,5
Vatsmijter,silvermoon,1224,monk,mistweaver,27,14,13
Suigintirno,twisting-nether,1223,monk,mistweaver,24,13,11
Matteliito,silvermoon,1222,monk,mistweaver,73,41,32
Jetchi,twisting-nether,1222,monk,mistweaver,125,68,57
Phrynè,silvermoon,1222,monk,mistweaver,55,29,26
Тэсси,blackscar,1222,monk,mistweaver,44,19,25
Jázzhands,draenor,1221,monk,mistweaver,46,24,22
Gammelbruno,azshara,1221,monk,mistweaver,64,32,32
Badonkamonk,twilights-hammer,1220,monk,mistweaver,52,31,21
Ivi,neptulon,1220,monk,mistweaver,76,40,36
Tripitakâ,dun-modr,1220,monk,mistweaver,65,30,35
Onlybench,ysondre,1219,monk,mistweaver,54,26,28
Radrielinda,veknilash,1218,monk,mistweaver,23,14,9
Creatinin,ragnaros,1217,monk,mistweaver,54,28,26
Evelios,blackmoore,1217,monk,mistweaver,65,33,32
Wûcm,silvermoon,1216,monk,mistweaver,29,13,16
Valky,bloodfeather,1213,monk,mistweaver,95,56,39
Trymax,blackmoore,1213,monk,mistweaver,57,23,34
Bhasundara,turalyon,1212,monk,mistweaver,88,51,37
Lilniccí,blackrock,1210,monk,mistweaver,62,34,28
Gozgajr,twisting-nether,1210,monk,mistweaver,54,22,32
Nezukoko,archimonde,1209,monk,mistweaver,22,13,9
Rgkekw,dun-modr,1209,monk,mistweaver,99,54,45
Trivi,blackrock,1209,monk,mistweaver,57,27,30
Nainketx,ravencrest,1208,monk,mistweaver,29,13,16
Pawfong,draenor,1207,monk,mistweaver,84,49,35
Tnt,antonidas,1207,monk,mistweaver,55,23,32
Chigee,kazzak,1206,monk,mistweaver,24,13,11
Trimperlow,blackmoore,1205,monk,mistweaver,30,14,16
Pandage,darksorrow,1205,monk,mistweaver,39,14,25
Helixsfist,outland,1204,monk,mistweaver,23,13,10
Heretogo,draenor,1203,monk,mistweaver,84,47,37
Køudbeap,archimonde,1202,monk,mistweaver,42,22,20
Yèna,pozzo-delleternità,1201,monk,mistweaver,353,169,184
Wtfmonk,twisting-nether,1200,monk,mistweaver,47,28,19
Blackmonk,chromaggus,1199,monk,mistweaver,27,16,11
Brewsmaster,archimonde,1199,monk,mistweaver,53,24,29
Wôôp,blackrock,1198,monk,mistweaver,48,26,22
Нимоник,soulflayer,1198,monk,mistweaver,96,44,52
Tintatama,aszune,1197,monk,mistweaver,148,69,79
Tolk,ravencrest,1196,monk,mistweaver,48,26,22
Lugoxi,the-maelstrom,1196,monk,mistweaver,66,35,31
Mislaw,silvermoon,1195,monk,mistweaver,33,22,11
Ricksancez,nemesis,1194,monk,mistweaver,30,20,10
Октай,gordunni,1193,monk,mistweaver,46,31,15
Stow,kazzak,1193,monk,mistweaver,21,13,8
Reòl,blackmoore,1193,monk,mistweaver,24,13,11
Vattghern,blackhand,1192,monk,mistweaver,129,61,68
Bwater,grim-batol,1192,monk,mistweaver,36,14,22
Lubeï,kirin-tor,1191,monk,mistweaver,94,52,42
Windspirit,darksorrow,1191,monk,mistweaver,72,29,43
Kayen,frostwhisper,1190,monk,mistweaver,208,110,98
Wteg,emerald-dream,1190,monk,mistweaver,93,41,52
Verd,cthun,1189,monk,mistweaver,48,22,26
Faares,tarren-mill,1188,monk,mistweaver,30,15,15
Зрти,gordunni,1188,monk,mistweaver,30,15,15
Mitsukiseven,ravencrest,1188,monk,mistweaver,48,21,27
Liveitup,kazzak,1187,monk,mistweaver,18,14,4
Putrezitu,ragnaros,1186,monk,mistweaver,51,26,25
Янезнаюкенни,soulflayer,1186,monk,mistweaver,110,51,59
Schlaganfall,outland,1184,monk,mistweaver,49,25,24
Nyrkkiseski,outland,1183,monk,mistweaver,17,13,4
Zel,dentarg,1183,monk,mistweaver,30,16,14
Shiyonô,aegwynn,1183,monk,mistweaver,29,15,14
Yunziwo,nemesis,1183,monk,mistweaver,30,15,15
Hadesboss,ravencrest,1182,monk,mistweaver,43,23,20
Betelgeuse,jaedenar,1181,monk,mistweaver,88,33,55
Brünó,kazzak,1180,monk,mistweaver,116,71,45
Eucalyptuz,draenor,1178,monk,mistweaver,30,14,16
Highmonktain,alakir,1177,monk,mistweaver,41,25,16
Skrøn,kult-der-verdammten,1176,monk,mistweaver,18,14,4
Gârdt,blackmoore,1176,monk,mistweaver,108,63,45
Яутжа,soulflayer,1176,monk,mistweaver,36,19,17
Темарон,gordunni,1176,monk,mistweaver,30,14,16
Elainmonk,thrall,1175,monk,mistweaver,17,13,4
Bierbestie,eredar,1174,monk,mistweaver,36,19,17
Wotaner,eredar,1174,monk,mistweaver,30,14,16
Amemiya,sanguino,1172,monk,mistweaver,110,52,58
Kelechi,stormreaver,1172,monk,mistweaver,32,13,19
Hvnm,ravencrest,1169,monk,mistweaver,248,126,122
Pussochkram,ravencrest,1167,monk,mistweaver,30,18,12
Eshli,ahnqiraj,1167,monk,mistweaver,25,13,12
Carcasce,la-croisade-écarlate,1166,monk,mistweaver,86,47,39
Kaizenthor,runetotem,1166,monk,mistweaver,36,13,23
Ndj,hyjal,1165,monk,mistweaver,35,21,14
Журлина,eversong,1164,monk,mistweaver,54,31,23
Akiiro,aegwynn,1164,monk,mistweaver,60,30,30
Subsul,sylvanas,1164,monk,mistweaver,94,45,49
Muggen,minahonda,1163,monk,mistweaver,41,18,23
Pandaaäaaäaa,archimonde,1162,monk,mistweaver,21,14,7
Velicko,ravencrest,1162,monk,mistweaver,38,22,16
Andrah,blackmoore,1162,monk,mistweaver,46,16,30
Несочетаемая,soulflayer,1161,monk,mistweaver,19,13,6
Sensëi,bronze-dragonflight,1161,monk,mistweaver,73,31,42
Celestine,mugthol,1159,monk,mistweaver,237,122,115
Rag,burning-legion,1159,monk,mistweaver,236,109,127
Charminbeard,antonidas,1157,monk,mistweaver,71,29,42
Jinora,theradras,1156,monk,mistweaver,36,14,22
Tamriel,korgall,1155,monk,mistweaver,36,15,21
Naskon,nemesis,1154,monk,mistweaver,48,21,27
Bananamonk,nathrezim,1153,monk,mistweaver,17,13,4
Geckazz,kazzak,1153,monk,mistweaver,27,18,9
Болетка,blackscar,1153,monk,mistweaver,158,76,82
Yuuhai,ravencrest,1152,monk,mistweaver,18,12,6
Yayaxoxoxo,archimonde,1152,monk,mistweaver,18,12,6
Олежатоксик,gordunni,1152,monk,mistweaver,18,12,6
Suhnukka,stormscale,1152,monk,mistweaver,24,12,12
Kôtsvlêkjê,outland,1151,monk,mistweaver,24,12,12
Zesha,zuljin,1151,monk,mistweaver,30,12,18
Sosschi,silvermoon,1150,monk,mistweaver,18,12,6
Дилдобойс,gordunni,1150,monk,mistweaver,18,12,6
Gnasseschef,outland,1150,monk,mistweaver,18,12,6
Verlan,quelthalas,1150,monk,mistweaver,49,25,24
Hittokick,draenor,1150,monk,mistweaver,37,13,24
Sanchios,twisting-nether,1149,monk,mistweaver,18,12,6
Ciridely,thrall,1149,monk,mistweaver,18,12,6
Varolul,aegwynn,1149,monk,mistweaver,51,27,24
Orowh,archimonde,1149,monk,mistweaver,24,12,12
Angerymonk,kazzak,1149,monk,mistweaver,30,12,18
Кукунколдыч,gordunni,1149,monk,mistweaver,36,13,23
Kemari,argent-dawn,1148,monk,mistweaver,18,12,6
Ýüñgßèëf,dun-modr,1148,monk,mistweaver,18,12,6
Shinzaø,khaz-modan,1148,monk,mistweaver,24,12,12
Relaxis,teldrassil,1148,monk,mistweaver,36,16,20
Brewdooms,laughing-skull,1148,monk,mistweaver,42,12,30
Truelo,eredar,1147,monk,mistweaver,18,12,6
Бэккс,howling-fjord,1147,monk,mistweaver,18,12,6
Egwane,argent-dawn,1147,monk,mistweaver,95,41,54
Souhei,drakthul,1145,monk,mistweaver,18,12,6
Оджи,blackscar,1145,monk,mistweaver,18,12,6
Антошамв,gordunni,1145,monk,mistweaver,36,12,24
Andelicek,burning-blade,1144,monk,mistweaver,24,12,12
Pandereta,aggra-português,1143,monk,mistweaver,18,12,6
Pô,sanguino,1143,monk,mistweaver,18,12,6
Lennykrvtz,kazzak,1142,monk,mistweaver,18,12,6
Fizzlekungfu,tarren-mill,1142,monk,mistweaver,24,12,12
Тильтоний,gordunni,1142,monk,mistweaver,24,12,12
Myez,stormscale,1141,monk,mistweaver,18,12,6
Andik,kazzak,1141,monk,mistweaver,24,12,12
Elanahi,antonidas,1141,monk,mistweaver,30,12,18
Cråzymonk,ravencrest,1140,monk,mistweaver,21,13,8
Imvengeance,stormscale,1139,monk,mistweaver,239,111,128
Lamne,quelthalas,1139,monk,mistweaver,36,16,20
Sigvar,frostmane,1139,monk,mistweaver,51,19,32
Irìss,nerzhul,1138,monk,mistweaver,86,47,39
Jagermonk,doomhammer,1138,monk,mistweaver,24,12,12
Lithenyx,bladefist,1137,monk,mistweaver,30,12,18
Алунам,soulflayer,1137,monk,mistweaver,30,12,18
Syyrø,silvermoon,1137,monk,mistweaver,36,12,24
Revna,auchindoun,1136,monk,mistweaver,24,12,12
Валялекарь,gordunni,1135,monk,mistweaver,24,12,12
Gantz,blackhand,1134,monk,mistweaver,72,28,44
Nartaran,archimonde,1134,monk,mistweaver,36,12,24
Pandasia,kargath,1133,monk,mistweaver,76,34,42
Verdi,tarren-mill,1132,monk,mistweaver,18,12,6
Thrallergik,ysondre,1132,monk,mistweaver,66,37,29
Bohjera,kazzak,1132,monk,mistweaver,30,16,14
Kyuumaa,ravencrest,1132,monk,mistweaver,26,13,13
Winwalker,archimonde,1129,monk,mistweaver,24,12,12
Desertctype,burning-legion,1129,monk,mistweaver,43,20,23
Arathos,tichondrius,1127,monk,mistweaver,151,78,73
Claudet,das-konsortium,1127,monk,mistweaver,70,32,38
Slý,archimonde,1126,monk,mistweaver,32,21,11
Vvårdenfell,hyjal,1126,monk,mistweaver,33,13,20
Tipsycookie,nozdormu,1125,monk,mistweaver,24,12,12
Skharrbrew,norgannon,1124,monk,mistweaver,66,30,36
Oddessa,ravenholdt,1122,monk,mistweaver,253,123,130
Stoutz,kazzak,1122,monk,mistweaver,30,13,17
Rampagepo,turalyon,1121,monk,mistweaver,48,19,29
Vzan,kazzak,1120,monk,mistweaver,57,29,28
Nabenja,madmortem,1120,monk,mistweaver,68,31,37
Zuzuljin,chogall,1120,monk,mistweaver,48,16,32
Friartucker,bloodhoof,1118,monk,mistweaver,68,40,28
Dræk,twisting-nether,1118,monk,mistweaver,34,15,19
Kappakick,tarren-mill,1117,monk,mistweaver,24,12,12
Brewm,silvermoon,1117,monk,mistweaver,24,12,12
Mooji,malganis,1117,monk,mistweaver,34,12,22
Tsouli,twilights-hammer,1116,monk,mistweaver,24,12,12
Flawpa,blackmoore,1115,monk,mistweaver,18,12,6
Snakeéyés,kazzak,1115,monk,mistweaver,20,13,7
Alphafist,argent-dawn,1115,monk,mistweaver,36,16,20
Limpópó,bloodfeather,1114,monk,mistweaver,24,15,9
Dankiron,darksorrow,1114,monk,mistweaver,42,13,29
Hornissy,antonidas,1113,monk,mistweaver,88,48,40
Twinny,drakthul,1113,monk,mistweaver,26,13,13
Kujanpei,rajaxx,1112,monk,mistweaver,30,14,16
Shenlong,burning-blade,1112,monk,mistweaver,33,14,19
Gaîdemar,blackmoore,1110,monk,mistweaver,34,13,21
Fastblood,kazzak,1107,monk,mistweaver,30,19,11
Jolbucheron,hyjal,1104,monk,mistweaver,24,14,10
Cheriedevile,drakthul,1104,monk,mistweaver,30,12,18
Ryanshazier,eredar,1103,monk,mistweaver,40,24,16
Serilyah,aegwynn,1102,monk,mistweaver,25,14,11
Ляосинь,deepholm,1099,monk,mistweaver,24,12,12
Chimonk,ravencrest,1099,monk,mistweaver,34,16,18
Nurthi,argent-dawn,1099,monk,mistweaver,30,13,17
Муррчалкин,howling-fjord,1098,monk,mistweaver,17,12,5
Yoruby,kazzak,1098,monk,mistweaver,32,13,19
Qungphu,silvermoon,1098,monk,mistweaver,47,13,34
Sqedi,draenor,1096,monk,mistweaver,40,15,25
Baldurr,dalaran,1095,monk,mistweaver,51,20,31
Tanyà,hyjal,1094,monk,mistweaver,18,13,5
Vanquishlølz,archimonde,1094,monk,mistweaver,60,25,35
Kalet,ragnaros,1092,monk,mistweaver,77,36,41
Добраядушка,gordunni,1091,monk,mistweaver,48,22,26
Tèam,defias-brotherhood,1089,monk,mistweaver,26,13,13
Yesman,quelthalas,1087,monk,mistweaver,73,29,44
Chun,arathor,1086,monk,mistweaver,108,54,54
Ayelas,silvermoon,1085,monk,mistweaver,26,12,14
Loctak,nathrezim,1082,monk,mistweaver,90,57,33
Samh,twisting-nether,1082,monk,mistweaver,59,37,22
Fabrew,tarren-mill,1077,monk,mistweaver,30,12,18
Baoton,blackmoore,1075,monk,mistweaver,36,12,24
Ronanze,silvermoon,1074,monk,mistweaver,108,60,48
Enceladion,burning-legion,1074,monk,mistweaver,84,40,44
ßam,ravencrest,1074,monk,mistweaver,47,21,26
Сунджи,eversong,1073,monk,mistweaver,179,81,98
Psychö,zuljin,1072,monk,mistweaver,35,17,18
Desyync,silvermoon,1071,monk,mistweaver,27,12,15
Senseithai,trollbane,1068,monk,mistweaver,30,14,16
Kungfusler,twisting-nether,1067,monk,mistweaver,30,13,17
Bobbyknuckls,ravencrest,1064,monk,mistweaver,54,17,37
Heäléna,ragnaros,1063,monk,mistweaver,33,24,9
Äcé,sylvanas,1063,monk,mistweaver,31,12,19
Fardareismai,kazzak,1062,monk,mistweaver,75,34,41
Birdymonk,boulderfist,1061,monk,mistweaver,91,53,38
Quaksalber,amanthul,1060,monk,mistweaver,119,63,56
Waytealz,stormscale,1059,monk,mistweaver,66,22,44
Павнмонкх,gordunni,1056,monk,mistweaver,18,11,7
Reidzqt,kazzak,1056,monk,mistweaver,18,11,7
Haruuka,thrall,1056,monk,mistweaver,18,11,7
Savonnettejr,culte-de-la-rive-noire,1056,monk,mistweaver,18,11,7
Totemlygodx,alakir,1056,monk,mistweaver,18,11,7
Puñetaso,los-errantes,1056,monk,mistweaver,101,47,54
Ffxivrefugee,argent-dawn,1056,monk,mistweaver,24,11,13
Darkmonkky,tarren-mill,1056,monk,mistweaver,24,11,13
Loganess,sunstrider,1056,monk,mistweaver,30,11,19
Zengrok,blackrock,1055,monk,mistweaver,12,11,1
Cerrad,twisting-nether,1055,monk,mistweaver,18,11,7
Sadcuzbad,thrall,1055,monk,mistweaver,18,11,7
Wheeslz,aegwynn,1055,monk,mistweaver,18,11,7
Feedmydreams,executus,1055,monk,mistweaver,18,11,7
Brutamonk,blackmoore,1055,monk,mistweaver,18,11,7
Flãay,ravencrest,1055,monk,mistweaver,18,11,7
Vtx,blackrock,1055,monk,mistweaver,18,11,7
Kakor,gorgonnash,1055,monk,mistweaver,18,11,7
Sandshark,argent-dawn,1055,monk,mistweaver,247,122,125
Mistmist,sylvanas,1055,monk,mistweaver,24,11,13
Gecli,stormscale,1055,monk,mistweaver,30,11,19
Unjie,outland,1054,monk,mistweaver,12,11,1
Cäpten,dethecus,1054,monk,mistweaver,12,11,1
Jakethestake,twilights-hammer,1054,monk,mistweaver,12,11,1
Savvuzzino,nemesis,1054,monk,mistweaver,18,11,7
Kragor,eredar,1054,monk,mistweaver,18,11,7
Kispiszock,bloodscalp,1054,monk,mistweaver,18,11,7
Brúcélee,silvermoon,1054,monk,mistweaver,18,11,7
Ghettomonk,blackmoore,1054,monk,mistweaver,32,15,17
Vrexza,kazzak,1054,monk,mistweaver,24,11,13
Barbielølz,archimonde,1053,monk,mistweaver,18,11,7
Nomim,kazzak,1053,monk,mistweaver,18,11,7
Namitsa,trollbane,1053,monk,mistweaver,144,67,77
Fistii,burning-legion,1053,monk,mistweaver,24,11,13
Wangho,magtheridon,1052,monk,mistweaver,126,58,68
Lambofmonkz,stormscale,1052,monk,mistweaver,36,11,25
Spinniboi,blackhand,1051,monk,mistweaver,24,11,13
Anoukxbabe,blackmoore,1051,monk,mistweaver,24,11,13
Jâdhe,zuljin,1050,monk,mistweaver,24,11,13
Brewmâster,kazzak,1050,monk,mistweaver,24,11,13
Deii,frostwolf,1050,monk,mistweaver,111,49,62
Runakar,draenor,1049,monk,mistweaver,36,11,25
Shmidi,antonidas,1048,monk,mistweaver,117,61,56
Missfist,stormscale,1047,monk,mistweaver,18,11,7
Zyphix,twisting-nether,1047,monk,mistweaver,24,11,13
Siouxxsie,thunderhorn,1045,monk,mistweaver,264,117,147
Orcput,minahonda,1044,monk,mistweaver,18,11,7
Irphan,ravencrest,1042,monk,mistweaver,18,11,7
Khaldin,hyjal,1041,monk,mistweaver,18,11,7
Monkgart,sylvanas,1041,monk,mistweaver,18,11,7
Fellatia,garrosh,1040,monk,mistweaver,57,31,26
Graffy,eonar,1040,monk,mistweaver,60,32,28
Stayinlosplz,ysondre,1039,monk,mistweaver,17,11,6
Andim,frostwolf,1039,monk,mistweaver,92,49,43
Toweliè,thrall,1039,monk,mistweaver,24,11,13
Ívó,ragnaros,1039,monk,mistweaver,24,11,13
Анпапаяя,galakrond,1039,monk,mistweaver,25,11,14
Tolomèo,nemesis,1037,monk,mistweaver,24,11,13
Kocyme,die-aldor,1034,monk,mistweaver,21,13,8
Domingovivas,dun-modr,1034,monk,mistweaver,24,13,11
Leikô,grim-batol,1033,monk,mistweaver,24,11,13
Rumiñawi,ravencrest,1033,monk,mistweaver,30,11,19
Брэйки,lich-king,1032,monk,mistweaver,30,12,18
Karmasfist,ravencrest,1029,monk,mistweaver,101,48,53
Dèathpunch,doomhammer,1027,monk,mistweaver,391,193,198
Kätelyys,dun-modr,1027,monk,mistweaver,24,11,13
Mjaweaver,stormscale,1027,monk,mistweaver,125,56,69
Eldunári,sanguino,1024,monk,mistweaver,60,22,38
Jaggsi,hellfire,1024,monk,mistweaver,102,37,65
Zywoo,emerald-dream,1022,monk,mistweaver,29,12,17
Hithxbye,stormscale,1020,monk,mistweaver,96,38,58
Апесиинка,gordunni,1019,monk,mistweaver,68,31,37
Eggroll,archimonde,1018,monk,mistweaver,23,11,12
Alexiarofl,silvermoon,1017,monk,mistweaver,20,12,8
Zedruu,tarren-mill,1015,monk,mistweaver,24,12,12
Lascala,eredar,1011,monk,mistweaver,48,18,30
Tarzaki,hyjal,1010,monk,mistweaver,25,12,13
Shontal,ravencrest,1010,monk,mistweaver,24,11,13
Pepegaswipe,ravencrest,1010,monk,mistweaver,30,11,19
Munqqi,stormscale,1009,monk,mistweaver,22,14,8
Assfist,drakthul,1008,monk,mistweaver,137,71,66
Tootenchamun,veklor,1007,monk,mistweaver,114,49,65
Ivnatorx,outland,1006,monk,mistweaver,17,11,6
Nephi,kirin-tor,1006,monk,mistweaver,54,22,32
Gaf,tarren-mill,1004,monk,mistweaver,19,12,7
Candypoppe,argent-dawn,1004,monk,mistweaver,58,30,28
Kameltreiba,antonidas,1004,monk,mistweaver,23,11,12
Zenchî,ysondre,1001,monk,mistweaver,22,13,9
Leïsha,ysondre,1000,monk,mistweaver,24,12,12
Liwong,antonidas,999,monk,mistweaver,65,32,33
Iamnudel,blackmoore,995,monk,mistweaver,24,11,13
Matrim,arathor,994,monk,mistweaver,38,12,26
Jayline,kazzak,992,monk,mistweaver,65,26,39
Unpapaya,silvermoon,991,monk,mistweaver,21,11,10
Chukwandi,ravencrest,991,monk,mistweaver,130,67,63
Холанн,greymane,991,monk,mistweaver,150,68,82
Fugmonk,ravencrest,989,monk,mistweaver,17,11,6
Bréwsléé,ragnaros,987,monk,mistweaver,21,12,9
Punto,onyxia,986,monk,mistweaver,219,107,112
Xuaolang,sanguino,986,monk,mistweaver,30,12,18
Plsdontdie,sylvanas,983,monk,mistweaver,20,11,9
Lekce,the-maelstrom,982,monk,mistweaver,17,11,6
Yøøps,dalaran,982,monk,mistweaver,45,22,23
Woguo,drakthul,981,monk,mistweaver,36,15,21
Brewtalize,defias-brotherhood,977,monk,mistweaver,30,16,14
Goya,sargeras,976,monk,mistweaver,36,21,15
Аверлорд,fordragon,973,monk,mistweaver,34,14,20
ßarghest,sanguino,971,monk,mistweaver,42,11,31
Bèfmoka,sargeras,965,monk,mistweaver,233,112,121
Suchergebnis,tarren-mill,964,monk,mistweaver,66,23,43
Catwiø,hyjal,963,monk,mistweaver,32,12,20
Horfus,stormscale,963,monk,mistweaver,36,12,24
Vadrigar,drakthul,960,monk,mistweaver,12,10,2
Culédegallah,archimonde,960,monk,mistweaver,12,10,2
Watschensepp,arthas,960,monk,mistweaver,12,10,2
Libertrixm,defias-brotherhood,960,monk,mistweaver,18,10,8
Cannonk,blackhand,960,monk,mistweaver,18,10,8
Шадофрейз,gordunni,960,monk,mistweaver,18,10,8
Hurjat,stormreaver,960,monk,mistweaver,18,10,8
Klappzz,outland,960,monk,mistweaver,18,10,8
Cocacolazeró,draenor,960,monk,mistweaver,24,10,14
Citamonk,blackmoore,959,monk,mistweaver,12,10,2
Sioumoo,malganis,959,monk,mistweaver,16,11,5
Mahøni,malganis,959,monk,mistweaver,18,10,8
Såvonnette,ysondre,959,monk,mistweaver,18,10,8
Mâjô,blackhand,959,monk,mistweaver,18,10,8
Monkfriend,quelthalas,959,monk,mistweaver,18,10,8
Dexcore,draenor,959,monk,mistweaver,18,10,8
Divinechi,kazzak,959,monk,mistweaver,18,10,8
Toastmonk,outland,959,monk,mistweaver,18,10,8
Synkek,tarren-mill,959,monk,mistweaver,18,10,8
Zekethegreat,tarren-mill,959,monk,mistweaver,18,10,8
Parlez,argent-dawn,959,monk,mistweaver,18,10,8
Mistfeeder,burning-blade,959,monk,mistweaver,18,10,8
Silentpedo,stormscale,959,monk,mistweaver,19,10,9
Хэймичх,gordunni,959,monk,mistweaver,24,10,14
Pikkupotkuri,stormreaver,959,monk,mistweaver,24,10,14
Zappikmonk,silvermoon,958,monk,mistweaver,12,10,2
Casic,tichondrius,958,monk,mistweaver,12,10,2
Mynokxu,blackmoore,958,monk,mistweaver,12,10,2
Aljabbar,ravencrest,958,monk,mistweaver,18,10,8
Fettakules,eredar,958,monk,mistweaver,18,10,8
Паклюха,howling-fjord,958,monk,mistweaver,18,10,8
Oiorie,twisting-nether,958,monk,mistweaver,18,10,8
Âechlz,malfurion,958,monk,mistweaver,18,10,8
Wkiller,outland,958,monk,mistweaver,24,10,14
Mieau,ysondre,957,monk,mistweaver,26,15,11
Lerouxx,archimonde,957,monk,mistweaver,24,10,14
Teoroll,stormscale,956,monk,mistweaver,18,10,8
Hireo,blades-edge,956,monk,mistweaver,59,25,34
Bbok,silvermoon,956,monk,mistweaver,36,10,26
Agodx,sanguino,955,monk,mistweaver,18,10,8
Dath,outland,955,monk,mistweaver,18,10,8
Ossifist,blackhand,955,monk,mistweaver,24,10,14
Justbalem,outland,955,monk,mistweaver,30,10,20
Mitchell,sylvanas,953,monk,mistweaver,18,10,8
Kurzgesagt,destromath,953,monk,mistweaver,30,10,20
Boloboc,auchindoun,951,monk,mistweaver,12,10,2
Tojokirumi,dalaran,951,monk,mistweaver,12,10,2
Dennó,mannoroth,951,monk,mistweaver,18,10,8
Marteling,silvermoon,951,monk,mistweaver,24,10,14
Garff,aggra-português,951,monk,mistweaver,26,10,16
Monkyd,stormscale,950,monk,mistweaver,18,10,8
Derok,twisting-nether,949,monk,mistweaver,24,10,14
Griffens,argent-dawn,943,monk,mistweaver,17,10,7
Daybaobao,the-maelstrom,943,monk,mistweaver,138,59,79
Монахий,gordunni,943,monk,mistweaver,24,10,14
Фистермонк,gordunni,942,monk,mistweaver,66,30,36
Serylliah,aegwynn,942,monk,mistweaver,24,10,14
Fernasmonk,aggra-português,940,monk,mistweaver,18,10,8
Røär,khaz-modan,934,monk,mistweaver,12,10,2
Xanyth,confrérie-du-thorium,934,monk,mistweaver,18,10,8
Ariä,marécage-de-zangar,930,monk,mistweaver,24,13,11
Mïsericordie,dalaran,930,monk,mistweaver,24,10,14
Liathina,sylvanas,928,monk,mistweaver,25,10,15
Jusex,stormreaver,927,monk,mistweaver,22,11,11
Nikiz,festung-der-stürme,927,monk,mistweaver,42,11,31
Kieteltje,sylvanas,926,monk,mistweaver,18,10,8
Shinergy,sylvanas,926,monk,mistweaver,23,10,13
Fréýáá,blackrock,925,monk,mistweaver,60,31,29
Shoshin,stormscale,925,monk,mistweaver,81,41,40
Buggaa,dalaran,924,monk,mistweaver,63,35,28
Madmonki,ragnaros,924,monk,mistweaver,130,72,58
Shenexo,kazzak,924,monk,mistweaver,20,11,9
Шадялинь,howling-fjord,920,monk,mistweaver,23,10,13
Blackeyé,malganis,914,monk,mistweaver,47,25,22
Olivegreen,emerald-dream,913,monk,mistweaver,42,23,19
Dinxfar,draenor,913,monk,mistweaver,21,11,10
Mku,kazzak,912,monk,mistweaver,21,11,10
Ràsetsu,nagrand,912,monk,mistweaver,41,20,21
Dícxi,ravencrest,910,monk,mistweaver,17,10,7
Чвка,booty-bay,907,monk,mistweaver,30,14,16
Kamîî,sanguino,907,monk,mistweaver,27,12,15
Xialongbao,khaz-modan,907,monk,mistweaver,45,11,34
Lilithrevan,frostmourne,905,monk,mistweaver,15,11,4
Malroj,aggramar,902,monk,mistweaver,21,11,10
Bottomoré,silvermoon,901,monk,mistweaver,95,34,61
Jamaìca,outland,898,monk,mistweaver,24,12,12
Indris,dun-modr,895,monk,mistweaver,17,10,7
Leafsoup,argent-dawn,895,monk,mistweaver,211,101,110
Мишапяточка,howling-fjord,890,monk,mistweaver,12,11,1
Mistyheals,nagrand,883,monk,mistweaver,36,19,17
Cheytana,archimonde,879,monk,mistweaver,11,10,1
Katx,marécage-de-zangar,878,monk,mistweaver,56,18,38
Schellentano,defias-brotherhood,876,monk,mistweaver,48,22,26
Greez,tarren-mill,869,monk,mistweaver,22,10,12
Neifaust,silvermoon,866,monk,mistweaver,108,38,70
Turbobär,blackrock,864,monk,mistweaver,12,9,3
Kyramea,aegwynn,864,monk,mistweaver,12,9,3
Kookmin,doomhammer,864,monk,mistweaver,12,9,3
Jokkopapoo,archimonde,864,monk,mistweaver,12,9,3
Pashtrak,argent-dawn,864,monk,mistweaver,12,9,3
Profesàur,pozzo-delleternità,864,monk,mistweaver,12,9,3
Mzdm,dalaran,864,monk,mistweaver,18,9,9
Miists,kazzak,864,monk,mistweaver,18,9,9
Åmba,blackrock,864,monk,mistweaver,18,9,9
Balia,blackrock,864,monk,mistweaver,24,9,15
Arlot,blackmoore,863,monk,mistweaver,12,9,3
Atfu,argent-dawn,863,monk,mistweaver,12,9,3
Shabaz,draenor,863,monk,mistweaver,12,9,3
Fènja,kult-der-verdammten,863,monk,mistweaver,18,9,9
Shéesh,tarren-mill,863,monk,mistweaver,18,9,9
Vejbz,blackmoore,863,monk,mistweaver,18,9,9
Зарычал,soulflayer,863,monk,mistweaver,18,9,9
Nowhaazzer,dun-modr,863,monk,mistweaver,18,9,9
Torinia,madmortem,863,monk,mistweaver,18,9,9
Kyleestrutt,stormscale,863,monk,mistweaver,18,9,9
Rminto,twisting-nether,863,monk,mistweaver,24,9,15
Rhodin,krasus,863,monk,mistweaver,30,9,21
Niborc,doomhammer,862,monk,mistweaver,12,9,3
Ribbeh,draenor,862,monk,mistweaver,12,9,3
Колбасина,gordunni,862,monk,mistweaver,12,9,3
Deepfistehr,outland,862,monk,mistweaver,12,9,3
Missislee,aegwynn,862,monk,mistweaver,12,9,3
Ricegodx,kazzak,862,monk,mistweaver,144,71,73
Puñolou,sanguino,861,monk,mistweaver,12,9,3
Mwsama,stormscale,861,monk,mistweaver,12,9,3
Koldar,grim-batol,861,monk,mistweaver,17,12,5
Tossen,ragnaros,861,monk,mistweaver,18,9,9
Misstickle,stormscale,861,monk,mistweaver,18,9,9
Rustó,ravencrest,861,monk,mistweaver,18,9,9
Ugotcraned,tarren-mill,861,monk,mistweaver,130,50,80
Notmelo,dun-modr,860,monk,mistweaver,18,9,9
Nosugars,tarren-mill,859,monk,mistweaver,12,9,3
Samie,ravencrest,859,monk,mistweaver,18,9,9
Anya,boulderfist,859,monk,mistweaver,18,9,9
Mistya,ragnaros,859,monk,mistweaver,18,9,9
Snooponk,kazzak,859,monk,mistweaver,24,9,15
Iwtkms,magtheridon,859,monk,mistweaver,24,9,15
Nortý,drakthul,858,monk,mistweaver,12,9,3
Mistréss,silvermoon,858,monk,mistweaver,18,9,9
Karmaclit,malganis,857,monk,mistweaver,18,9,9
Fhengwei,outland,857,monk,mistweaver,18,9,9
Bingching,silvermoon,857,monk,mistweaver,113,44,69
Thymesurge,ravencrest,856,monk,mistweaver,18,9,9
Chozen,blackmoore,854,monk,mistweaver,18,9,9
Healmeup,anetheron,854,monk,mistweaver,18,9,9
Drumonk,kelthuzad,854,monk,mistweaver,36,9,27
Bakersdozen,tarren-mill,852,monk,mistweaver,24,9,15
Pepefocho,sanguino,848,monk,mistweaver,24,10,14
Jugogodx,blackrock,845,monk,mistweaver,17,9,8
Keeba,kirin-tor,840,monk,mistweaver,272,126,146
Geeberz,twisting-nether,838,monk,mistweaver,18,9,9
Zuntze,guldan,834,monk,mistweaver,18,9,9
Chucknorrís,ragnaros,831,monk,mistweaver,16,9,7
Drakzyr,argent-dawn,831,monk,mistweaver,16,9,7
Cmonbruh,ravencrest,831,monk,mistweaver,17,9,8
Muuck,blackrock,830,monk,mistweaver,20,10,10
Pikafume,hellfire,827,monk,mistweaver,14,10,4
Køzuky,archimonde,825,monk,mistweaver,23,11,12
Arukoru,kazzak,819,monk,mistweaver,30,9,21
Thiccbaby,kazzak,816,monk,mistweaver,15,9,6
Mynaira,tarren-mill,811,monk,mistweaver,50,11,39
Zóma,ragnaros,810,monk,mistweaver,28,10,18
Saïtama,krasus,809,monk,mistweaver,22,10,12
Киото,ashenvale,808,monk,mistweaver,137,57,80
Alfiemonk,ravencrest,804,monk,mistweaver,48,13,35
Xalyà,archimonde,803,monk,mistweaver,18,12,6
Colita,kazzak,803,monk,mistweaver,22,11,11
Extaszeh,turalyon,802,monk,mistweaver,17,11,6
Тайви,deepholm,799,monk,mistweaver,17,9,8
Whytoosxy,silvermoon,799,monk,mistweaver,23,9,14
Mellu,kazzak,798,monk,mistweaver,14,9,5
Zerochi,kazzak,796,monk,mistweaver,19,10,9
Jînex,shattrath,784,monk,mistweaver,13,9,4
Почтисдох,soulflayer,781,monk,mistweaver,16,9,7
Умцаца,soulflayer,779,monk,mistweaver,42,9,33
Havery,sanguino,776,monk,mistweaver,11,9,2
Гошатехник,soulflayer,768,monk,mistweaver,12,8,4
Kashino,frostwhisper,768,monk,mistweaver,12,8,4
Daisymerolli,nemesis,768,monk,mistweaver,12,8,4
Starboyy,twisting-nether,768,monk,mistweaver,12,8,4
Adrianchase,ravencrest,768,monk,mistweaver,12,8,4
Myndry,varimathras,768,monk,mistweaver,12,8,4
Mvm,outland,768,monk,mistweaver,12,8,4
Jlo,stormscale,768,monk,mistweaver,12,8,4
Mástermônkèy,tarren-mill,768,monk,mistweaver,12,8,4
Miamalkøva,nemesis,768,monk,mistweaver,12,8,4
Mialena,eredar,768,monk,mistweaver,12,8,4
Cattleyah,ysondre,768,monk,mistweaver,12,8,4
Kradder,nordrassil,768,monk,mistweaver,12,8,4
Monfmonk,archimonde,768,monk,mistweaver,12,8,4
Гуппер,howling-fjord,768,monk,mistweaver,12,8,4
Egh,der-rat-von-dalaran,768,monk,mistweaver,12,8,4
Guarnounet,hyjal,768,monk,mistweaver,12,8,4
Stvilde,tarren-mill,768,monk,mistweaver,12,8,4
Wisebeb,les-clairvoyants,768,monk,mistweaver,12,8,4
Colin,aegwynn,768,monk,mistweaver,12,8,4
Eldaras,tarren-mill,768,monk,mistweaver,18,8,10
Kûngfu,tarren-mill,768,monk,mistweaver,18,8,10
Fistgodx,blackrock,768,monk,mistweaver,18,8,10
Tino,sylvanas,768,monk,mistweaver,18,8,10
Dêsmî,ravencrest,768,monk,mistweaver,18,8,10
Twåålf,kazzak,768,monk,mistweaver,18,8,10
Orki,ragnaros,768,monk,mistweaver,18,8,10
Mädravën,ragnaros,768,monk,mistweaver,24,8,16
Nêrfmeta,kazzak,767,monk,mistweaver,12,8,4
Fiststowin,blackrock,767,monk,mistweaver,12,8,4
Мистхоррор,gordunni,767,monk,mistweaver,12,8,4
Xerzulo,silvermoon,767,monk,mistweaver,12,8,4
Sozzemonk,kazzak,767,monk,mistweaver,12,8,4
Maigraith,malganis,767,monk,mistweaver,12,8,4
Baaws,blackrock,767,monk,mistweaver,12,8,4
Nöwmack,archimonde,767,monk,mistweaver,12,8,4
Hvdo,silvermoon,767,monk,mistweaver,12,8,4
Ракенрол,deathguard,767,monk,mistweaver,12,8,4
Lin,nathrezim,767,monk,mistweaver,12,8,4
Nxyytko,aegwynn,767,monk,mistweaver,16,9,7
Doyoubleed,twisting-nether,767,monk,mistweaver,18,8,10
Faki,eredar,767,monk,mistweaver,18,8,10
Aliyo,aegwynn,767,monk,mistweaver,18,8,10
Suií,blackmoore,767,monk,mistweaver,18,8,10
Gízmö,tarren-mill,767,monk,mistweaver,18,8,10
Tottle,archimonde,767,monk,mistweaver,18,8,10
Skelmir,dragonblight,767,monk,mistweaver,18,8,10
Shishalord,blackhand,767,monk,mistweaver,18,8,10
Monkfist,the-maelstrom,767,monk,mistweaver,24,8,16
Qúázu,silvermoon,767,monk,mistweaver,24,8,16
Монкмяу,howling-fjord,767,monk,mistweaver,27,8,19
Mediumzin,twisting-nether,767,monk,mistweaver,30,8,22
Qî,ravencrest,767,monk,mistweaver,30,8,22
Votix,tarren-mill,766,monk,mistweaver,13,10,3
Nulojeu,archimonde,766,monk,mistweaver,12,8,4
Weshilling,tarren-mill,766,monk,mistweaver,12,8,4
Bûbota,dun-modr,766,monk,mistweaver,12,8,4
Хере,soulflayer,766,monk,mistweaver,18,8,10
Bashboosh,stormscale,766,monk,mistweaver,18,8,10
Gakunie,blackhand,766,monk,mistweaver,18,8,10
Ebonymilfy,archimonde,765,monk,mistweaver,12,8,4
Kegbrew,kazzak,765,monk,mistweaver,12,8,4
Lorkas,darkmoon-faire,765,monk,mistweaver,12,8,4
Dukhi,kazzak,765,monk,mistweaver,12,8,4
Hersmonk,drakthul,765,monk,mistweaver,12,8,4
Pô,nemesis,765,monk,mistweaver,18,8,10
Janpu,outland,765,monk,mistweaver,18,8,10
Trxy,argent-dawn,765,monk,mistweaver,36,8,28
Jemijedno,drakthul,764,monk,mistweaver,12,8,4
Kravmaghar,arthas,764,monk,mistweaver,18,8,10
Dazll,twisting-nether,764,monk,mistweaver,24,8,16
Aíkô,dun-morogh,763,monk,mistweaver,12,8,4
Breykhar,aegwynn,762,monk,mistweaver,18,8,10
Pekinn,sanguino,761,monk,mistweaver,18,8,10
Nemevas,dun-modr,761,monk,mistweaver,30,8,22
Xèrá,antonidas,759,monk,mistweaver,30,8,22
Speki,sylvanas,758,monk,mistweaver,12,8,4
Сукавкимоно,soulflayer,758,monk,mistweaver,18,8,10
Irorii,silvermoon,747,monk,mistweaver,23,8,15
Gokentu,silvermoon,738,monk,mistweaver,43,15,28
Issan,archimonde,736,monk,mistweaver,23,9,14
Metaphysic,tarren-mill,734,monk,mistweaver,23,8,15
Ndaula,drakthul,733,monk,mistweaver,25,9,16
Spëarôu,hyjal,732,monk,mistweaver,18,10,8
Коумана,gordunni,719,monk,mistweaver,18,10,8
Дядямаготика,deathguard,719,monk,mistweaver,27,9,18
Trueks,uldum,714,monk,mistweaver,16,9,7
Zhanshì,blackmoore,714,monk,mistweaver,21,9,12
Mozzi,frostmane,712,monk,mistweaver,25,9,16
Порвуседло,soulflayer,703,monk,mistweaver,28,10,18
Nrb,outland,695,monk,mistweaver,14,8,6
Melaz,ravencrest,688,monk,mistweaver,13,8,5
Unbanplslol,ravencrest,687,monk,mistweaver,11,8,3
Tingly,kazzak,687,monk,mistweaver,15,8,7
Шаолий,gordunni,683,monk,mistweaver,30,8,22
Changzu,sanguino,680,monk,mistweaver,81,37,44
Biggesttaf,stormscale,672,monk,mistweaver,10,8,2
Vazpy,sylvanas,672,monk,mistweaver,12,7,5
Whatthemonk,arathor,672,monk,mistweaver,12,7,5
Павнмонк,gordunni,672,monk,mistweaver,12,7,5
Monkamonk,blutkessel,672,monk,mistweaver,12,7,5
Frajer,auchindoun,672,monk,mistweaver,12,7,5
Níkxz,ragnaros,672,monk,mistweaver,12,7,5
Zentyà,hyjal,672,monk,mistweaver,12,7,5
Caramellate,ragnaros,672,monk,mistweaver,12,7,5
Kyliansètuit,ysondre,672,monk,mistweaver,12,7,5
Astarrserran,drakthul,672,monk,mistweaver,12,7,5
ßreacher,argent-dawn,672,monk,mistweaver,12,7,5
Podrugabomja,outland,672,monk,mistweaver,12,7,5
Flexify,outland,672,monk,mistweaver,12,7,5
Franziskanus,das-syndikat,672,monk,mistweaver,12,7,5
Longpeng,ysera,672,monk,mistweaver,12,7,5
Mw,magtheridon,672,monk,mistweaver,12,7,5
Ryutoo,silvermoon,672,monk,mistweaver,12,7,5
Risingsunkek,ravencrest,672,monk,mistweaver,12,7,5
Osírìs,ravencrest,672,monk,mistweaver,12,7,5
Lamasauce,ravencrest,672,monk,mistweaver,12,7,5
Caliban,defias-brotherhood,672,monk,mistweaver,12,7,5
Boytoyfist,ravencrest,672,monk,mistweaver,12,7,5
Neptulion,ravencrest,672,monk,mistweaver,12,7,5
Soulcháos,ravencrest,672,monk,mistweaver,12,7,5
Prismaticx,ravencrest,672,monk,mistweaver,12,7,5
Buddhweiser,malfurion,672,monk,mistweaver,12,7,5
Monkel,frostwolf,672,monk,mistweaver,12,7,5
Hessuzen,stormreaver,672,monk,mistweaver,12,7,5
Yulon,blackrock,672,monk,mistweaver,12,7,5
Vitessewagon,ysondre,672,monk,mistweaver,12,7,5
Alutzharn,argent-dawn,672,monk,mistweaver,12,7,5
Sindfist,ysondre,672,monk,mistweaver,12,7,5
Møñk,draenor,672,monk,mistweaver,12,7,5
Ravity,blackmoore,672,monk,mistweaver,12,7,5
Zontovolo,draenor,672,monk,mistweaver,12,7,5
Ráñdømxyû,silvermoon,672,monk,mistweaver,12,7,5
Merçury,dun-morogh,672,monk,mistweaver,12,7,5
Mjoo,blackrock,672,monk,mistweaver,12,7,5
Kadoran,argent-dawn,672,monk,mistweaver,12,7,5
Вхукьютиикс,howling-fjord,672,monk,mistweaver,13,7,6
Leykom,ravencrest,672,monk,mistweaver,15,8,7
Päätöksiä,defias-brotherhood,672,monk,mistweaver,18,7,11
Fistweavingg,tarren-mill,672,monk,mistweaver,18,7,11
Fántâ,outland,672,monk,mistweaver,18,7,11
Olîvê,ravencrest,672,monk,mistweaver,18,7,11
Bâsarä,archimonde,672,monk,mistweaver,18,7,11
Alwaysme,grim-batol,672,monk,mistweaver,18,7,11
Scz,draenor,672,monk,mistweaver,18,7,11
Boîndíl,malfurion,672,monk,mistweaver,18,7,11
Кулаквтебе,borean-tundra,672,monk,mistweaver,18,7,11
Hurricrane,kazzak,672,monk,mistweaver,24,7,17
Hitmon,kazzak,671,monk,mistweaver,12,7,5
Кисеч,soulflayer,671,monk,mistweaver,12,7,5
Wudao,anubarak,671,monk,mistweaver,12,7,5
Lenalé,sanguino,671,monk,mistweaver,12,7,5
Funkystach,archimonde,671,monk,mistweaver,12,7,5
Yumrukatam,twisting-nether,671,monk,mistweaver,12,7,5
Firisz,silvermoon,671,monk,mistweaver,12,7,5
Æternia,stormscale,671,monk,mistweaver,12,7,5
Fonk,blades-edge,671,monk,mistweaver,12,7,5
Afkmonk,archimonde,671,monk,mistweaver,12,7,5
Моийам,howling-fjord,671,monk,mistweaver,18,7,11
Madweaver,tarren-mill,671,monk,mistweaver,18,7,11
Whinestein,the-venture-co,671,monk,mistweaver,18,7,11
Tiddor,burning-legion,671,monk,mistweaver,18,7,11
Zendyy,argent-dawn,670,monk,mistweaver,12,7,5
Tayruni,nazjatar,670,monk,mistweaver,18,7,11
Askmeout,ravencrest,670,monk,mistweaver,19,7,12
Furynextdoor,hyjal,669,monk,mistweaver,12,7,5
Escopetin,los-errantes,669,monk,mistweaver,18,7,11
Chenpô,gorgonnash,667,monk,mistweaver,12,7,5
Buddhamilch,nathrezim,667,monk,mistweaver,18,7,11
Dotheas,argent-dawn,667,monk,mistweaver,18,7,11
Iife,frostwolf,665,monk,mistweaver,12,7,5
Wuchanglan,blackmoore,665,monk,mistweaver,30,7,23
Zoolloonn,norgannon,664,monk,mistweaver,18,7,11
Pandadoum,ysondre,663,monk,mistweaver,12,7,5
Kapona,kazzak,661,monk,mistweaver,30,7,23
Xarii,aegwynn,640,monk,mistweaver,10,8,2
Qdwdwqerdads,ravencrest,640,monk,mistweaver,16,8,8
Klischi,taerar,639,monk,mistweaver,17,7,10
Lylaei,argent-dawn,639,monk,mistweaver,17,7,10
Shapumvilla,alonsus,637,monk,mistweaver,8,8,0
Jsuispasheal,dalaran,625,monk,mistweaver,129,52,77
Randomxbrew,draenor,624,monk,mistweaver,9,8,1
Yøda,malganis,621,monk,mistweaver,15,7,8
Ravsar,kazzak,615,monk,mistweaver,17,9,8
Cringefemboy,moonglade,607,monk,mistweaver,11,7,4
Drunkenmønk,mannoroth,592,monk,mistweaver,7,7,0
Redundänt,kazzak,576,monk,mistweaver,6,6,0
Althéia,dalaran,576,monk,mistweaver,6,6,0
Pelegrini,ravencrest,576,monk,mistweaver,6,6,0
Mowì,stormscale,576,monk,mistweaver,6,6,0
Makíima,blackrock,576,monk,mistweaver,6,6,0
Daddynasty,blackhand,576,monk,mistweaver,6,6,0
Batschmaia,shattrath,576,monk,mistweaver,6,6,0
Xanaxmaster,archimonde,576,monk,mistweaver,6,6,0
Ðêzø,stormscale,576,monk,mistweaver,6,6,0
Nigirisake,blackrock,576,monk,mistweaver,6,6,0
Адольфвейпер,gordunni,576,monk,mistweaver,6,6,0
Juicepøpe,tarren-mill,576,monk,mistweaver,10,7,3
Кончеглаз,soulflayer,576,monk,mistweaver,12,6,6
Deepênd,antonidas,576,monk,mistweaver,12,6,6
Icecoldbrew,outland,576,monk,mistweaver,12,6,6
Ryac,defias-brotherhood,576,monk,mistweaver,12,6,6
Testicolino,nemesis,576,monk,mistweaver,12,6,6
Rudiculous,malganis,576,monk,mistweaver,12,6,6
Leashed,blackmoore,576,monk,mistweaver,12,6,6
Миражмонк,howling-fjord,576,monk,mistweaver,12,6,6
Дезмимонк,ashenvale,576,monk,mistweaver,12,6,6
Gosphhell,archimonde,576,monk,mistweaver,12,6,6
Arenajunkie,pozzo-delleternità,576,monk,mistweaver,12,6,6
Ankelstrumpa,tarren-mill,576,monk,mistweaver,12,6,6
Fluxqt,ravencrest,576,monk,mistweaver,12,6,6
Vedak,stormreaver,576,monk,mistweaver,12,6,6
Garfunkel,emeriss,576,monk,mistweaver,12,6,6
Rashtamonk,blackmoore,576,monk,mistweaver,12,6,6
Vàlky,outland,576,monk,mistweaver,12,6,6
Mørbradgryde,silvermoon,576,monk,mistweaver,12,6,6
Fistandfury,outland,576,monk,mistweaver,12,6,6
Monjonagger,tyrande,576,monk,mistweaver,12,6,6
Sinensi,conseil-des-ombres,576,monk,mistweaver,12,6,6
Mamysuze,elune,576,monk,mistweaver,12,6,6
Rutikuiva,kazzak,576,monk,mistweaver,12,6,6
Pivomamrad,drakthul,576,monk,mistweaver,12,6,6
Freemmrx,kazzak,576,monk,mistweaver,12,6,6
Yez,azjolnerub,576,monk,mistweaver,12,6,6
Req,darksorrow,576,monk,mistweaver,12,6,6
Xaw,sanguino,576,monk,mistweaver,12,6,6
Ayanaami,pozzo-delleternità,576,monk,mistweaver,18,6,12
Девачки,soulflayer,576,monk,mistweaver,18,6,12
Incapfull,archimonde,576,monk,mistweaver,18,6,12
Ronnchi,twisting-nether,576,monk,mistweaver,18,6,12
Торен,soulflayer,576,monk,mistweaver,18,6,12
Siiderivalas,kazzak,576,monk,mistweaver,18,6,12
Itsthemonkky,tarren-mill,576,monk,mistweaver,24,6,18
Иклипси,gordunni,575,monk,mistweaver,6,6,0
Vexzen,tarren-mill,575,monk,mistweaver,12,6,6
Biogasanlage,tarren-mill,575,monk,mistweaver,12,6,6
Kushinaa,teldrassil,575,monk,mistweaver,12,6,6
Drír,archimonde,575,monk,mistweaver,12,6,6
Drlyn,blackmoore,575,monk,mistweaver,12,6,6
Skonk,frostmane,575,monk,mistweaver,12,6,6
Yza,dun-modr,575,monk,mistweaver,12,6,6
Pôo,medivh,575,monk,mistweaver,12,6,6
Shenyen,silvermoon,575,monk,mistweaver,12,6,6
Yogi,defias-brotherhood,575,monk,mistweaver,12,6,6
Mistbeever,ragnaros,575,monk,mistweaver,12,6,6
Loutremoine,archimonde,575,monk,mistweaver,12,6,6
Crommul,burning-legion,575,monk,mistweaver,12,6,6
Incapp,ysondre,575,monk,mistweaver,12,6,6
Jamesxdeen,stormreaver,575,monk,mistweaver,18,6,12
Mockmé,defias-brotherhood,575,monk,mistweaver,18,6,12
Monkiky,hyjal,575,monk,mistweaver,18,6,12
Mulana,sanguino,575,monk,mistweaver,18,6,12
Latify,todeswache,575,monk,mistweaver,18,6,12
Wallmonker,blackrock,574,monk,mistweaver,12,6,6
Othalain,silvermoon,574,monk,mistweaver,12,6,6
Granniz,archimonde,574,monk,mistweaver,12,6,6
Chuckmorris,draenor,574,monk,mistweaver,12,6,6
Irishdëmon,ravencrest,574,monk,mistweaver,16,6,10
Jackamonk,kazzak,574,monk,mistweaver,18,6,12
Mascrax,earthen-ring,573,monk,mistweaver,18,6,12
Tajusia,sporeggar,573,monk,mistweaver,18,6,12
Xentimus,kazzak,573,monk,mistweaver,18,6,12
Cheechong,grim-batol,573,monk,mistweaver,28,8,20
Bearknuckles,darkmoon-faire,572,monk,mistweaver,12,6,6
Tenaris,nefarian,571,monk,mistweaver,12,6,6
Shuzao,steamwheedle-cartel,569,monk,mistweaver,24,6,18
Flancho,shendralar,567,monk,mistweaver,12,6,6
Christien,ungoro,558,monk,mistweaver,29,6,23
Dinkei,sylvanas,543,monk,mistweaver,14,7,7
Jokkmonkk,sunstrider,543,monk,mistweaver,14,7,7
Chasiu,antonidas,543,monk,mistweaver,14,7,7
Sadeq,argent-dawn,542,monk,mistweaver,10,7,3
Japumonk,kazzak,540,monk,mistweaver,11,6,5
ßæutiful,silvermoon,535,monk,mistweaver,42,14,28
Yesaya,sylvanas,528,monk,mistweaver,9,6,3
Lidalol,silvermoon,527,monk,mistweaver,9,7,2
Noctaeth,destromath,527,monk,mistweaver,11,6,5
Insomniyah,tarren-mill,527,monk,mistweaver,17,6,11
Jackwondo,blackmoore,522,monk,mistweaver,16,8,8
Justinweaver,silvermoon,522,monk,mistweaver,19,9,10
Permagone,argent-dawn,522,monk,mistweaver,16,7,9
Dråf,ysondre,522,monk,mistweaver,18,7,11
Bêlebend,frostwolf,512,monk,mistweaver,10,6,4
Xzuena,blackmoore,511,monk,mistweaver,8,6,2
Годъяр,gordunni,510,monk,mistweaver,14,6,8
Fardulka,stormscale,508,monk,mistweaver,22,6,16
Shilvah,azuremyst,504,monk,mistweaver,15,6,9
Samuelka,burning-blade,493,monk,mistweaver,11,6,5
Sio,dentarg,480,monk,mistweaver,6,5,1
Notgherit,nemesis,480,monk,mistweaver,6,5,1
Chiibah,malygos,480,monk,mistweaver,6,5,1
Zoruun,quelthalas,480,monk,mistweaver,6,5,1
Hyhu,burning-legion,480,monk,mistweaver,6,5,1
Подорожнник,gordunni,480,monk,mistweaver,6,5,1
Ørcqt,tarren-mill,480,monk,mistweaver,6,5,1
Jàckiechàn,nemesis,480,monk,mistweaver,6,5,1
Veladana,chamber-of-aspects,480,monk,mistweaver,6,5,1
Укусдракона,soulflayer,480,monk,mistweaver,6,5,1
Saikwondo,silvermoon,480,monk,mistweaver,6,5,1
Sloopkogel,tarren-mill,480,monk,mistweaver,6,5,1
Awy,drakthul,480,monk,mistweaver,6,5,1
Peao,blackmoore,480,monk,mistweaver,6,5,1
Notoriousx,thrall,480,monk,mistweaver,6,5,1
Kaowar,nerzhul,480,monk,mistweaver,6,5,1
Khazanthir,terenas,480,monk,mistweaver,6,5,1
Xkäz,archimonde,480,monk,mistweaver,6,5,1
Monkoni,silvermoon,480,monk,mistweaver,6,5,1
Nobrainfist,stormscale,480,monk,mistweaver,6,5,1
Stromon,silvermoon,480,monk,mistweaver,6,5,1
Anthufufu,ysondre,480,monk,mistweaver,6,5,1
Khabibs,hyjal,480,monk,mistweaver,6,5,1
Wannabeloa,silvermoon,480,monk,mistweaver,6,5,1
Niima,archimonde,480,monk,mistweaver,6,5,1
Requizen,ravencrest,480,monk,mistweaver,6,5,1
Lyganos,dalaran,480,monk,mistweaver,6,5,1
Saenxz,blackrock,480,monk,mistweaver,6,5,1
Ilovesrya,archimonde,480,monk,mistweaver,6,5,1
Supersane,antonidas,480,monk,mistweaver,6,5,1
Ninagi,khaz-modan,480,monk,mistweaver,6,5,1
Lycerá,antonidas,480,monk,mistweaver,9,5,4
Elmun,draenor,480,monk,mistweaver,12,5,7
Дэдлитрюк,soulflayer,480,monk,mistweaver,12,5,7
Mikefist,blackrock,480,monk,mistweaver,12,5,7
Siezlebabo,blackrock,480,monk,mistweaver,12,5,7
Selambebis,twisting-nether,480,monk,mistweaver,12,5,7
Erandja,silvermoon,480,monk,mistweaver,12,5,7
Ðrçleañ,stormreaver,480,monk,mistweaver,12,5,7
Domedagsdamp,draenor,480,monk,mistweaver,12,5,7
Rockié,blackmoore,480,monk,mistweaver,12,5,7
Aurelìá,aegwynn,480,monk,mistweaver,12,5,7
Jodeen,shadowsong,480,monk,mistweaver,12,5,7
Kaichi,defias-brotherhood,480,monk,mistweaver,12,5,7
Sashun,blackmoore,480,monk,mistweaver,12,5,7
Miquella,scarshield-legion,480,monk,mistweaver,12,5,7
Kmorhin,antonidas,480,monk,mistweaver,12,5,7
Potato,aggramar,480,monk,mistweaver,12,5,7
Чебурекстень,blackscar,480,monk,mistweaver,12,5,7
Kâfkas,twisting-nether,480,monk,mistweaver,12,5,7
Cøntfarmer,ravencrest,480,monk,mistweaver,12,5,7
Rollarøund,outland,480,monk,mistweaver,12,5,7
Clenda,hyjal,480,monk,mistweaver,12,5,7
Karmonk,outland,480,monk,mistweaver,12,5,7
Bistweaver,kazzak,480,monk,mistweaver,12,5,7
Skiqzy,ravencrest,480,monk,mistweaver,12,5,7
Похмелись,blackscar,480,monk,mistweaver,12,5,7
Smahammonk,sylvanas,480,monk,mistweaver,12,5,7
Hon,sanguino,480,monk,mistweaver,12,5,7
Grïmgødx,ravencrest,480,monk,mistweaver,12,5,7
Sonixx,anubarak,480,monk,mistweaver,12,5,7
Minervaez,grim-batol,480,monk,mistweaver,12,5,7
Relentlessly,blackrock,480,monk,mistweaver,12,5,7
Loveít,blackrock,480,monk,mistweaver,12,5,7
Аэрди,howling-fjord,480,monk,mistweaver,12,5,7
Bountyño,dun-modr,480,monk,mistweaver,12,5,7
Gaspacio,silvermoon,480,monk,mistweaver,12,5,7
Yinsho,stormscale,480,monk,mistweaver,12,5,7
Tchitã,hyjal,480,monk,mistweaver,12,5,7
Kärmma,sanguino,480,monk,mistweaver,12,5,7
Mailyne,blackmoore,480,monk,mistweaver,13,5,8
Moistweaver,drakthul,480,monk,mistweaver,18,5,13
Копытька,gordunni,480,monk,mistweaver,18,5,13
Kaztruman,draenor,480,monk,mistweaver,18,5,13
Risomonk,blackrock,480,monk,mistweaver,24,5,19
Mirøc,blackmoore,479,monk,mistweaver,6,5,1
Proxxona,eredar,479,monk,mistweaver,6,5,1
Bubas,burning-legion,479,monk,mistweaver,9,5,4
Дарума,grom,479,monk,mistweaver,12,5,7
Neyîth,scarshield-legion,479,monk,mistweaver,12,5,7
Yûkang,eldrethalas,479,monk,mistweaver,12,5,7
Bigbrutus,draenor,479,monk,mistweaver,12,5,7
Dopenudel,antonidas,479,monk,mistweaver,12,5,7
Bovinebuddha,stormscale,479,monk,mistweaver,12,5,7
Luigimonk,dun-modr,479,monk,mistweaver,12,5,7
Sotqyy,stormscale,479,monk,mistweaver,12,5,7
Mîsts,aszune,479,monk,mistweaver,12,5,7
Âsmoran,blackmoore,479,monk,mistweaver,12,5,7
Shîïna,ysondre,479,monk,mistweaver,18,5,13
Knotze,eredar,479,monk,mistweaver,18,5,13
Bajabanger,stormscale,479,monk,mistweaver,18,5,13
Chîca,ysondre,479,monk,mistweaver,18,5,13
Løkî,culte-de-la-rive-noire,479,monk,mistweaver,24,5,19
Wînk,amanthul,478,monk,mistweaver,12,5,7
Backbone,auchindoun,478,monk,mistweaver,12,5,7
Nosrewolwer,burning-legion,476,monk,mistweaver,12,5,7
Leffe,thunderhorn,476,monk,mistweaver,12,5,7
Drugarix,uldaman,475,monk,mistweaver,12,5,7
Rafa,burning-blade,470,monk,mistweaver,18,5,13
Honîgbär,blackhand,470,monk,mistweaver,18,5,13
Filomenata,rexxar,469,monk,mistweaver,19,5,14
Nxmonk,sylvanas,468,monk,mistweaver,19,9,10
Frodrin,kazzak,467,monk,mistweaver,21,6,15
Ilgidius,defias-brotherhood,447,monk,mistweaver,10,5,5
Zinzyo,aegwynn,447,monk,mistweaver,11,5,6
Ñø,twisting-nether,447,monk,mistweaver,11,5,6
Doctòrmónk,tarren-mill,447,monk,mistweaver,14,6,8
Chinochuke,dun-modr,432,monk,mistweaver,9,6,3
Kawaì,frostwolf,431,monk,mistweaver,17,5,12
Mæáv,tarren-mill,426,monk,mistweaver,9,7,2
Ygêrne,archimonde,426,monk,mistweaver,15,6,9
Chakarma,twisting-nether,416,monk,mistweaver,28,5,23
Lévanà,antonidas,415,monk,mistweaver,8,5,3
Dibbz,bladefist,415,monk,mistweaver,10,5,5
Midgetjas,outland,415,monk,mistweaver,11,5,6
Sudoku,thrall,415,monk,mistweaver,14,5,9
Tedicated,tarren-mill,384,monk,mistweaver,6,4,2
Pagadi,destromath,384,monk,mistweaver,6,4,2
Thérin,silvermoon,384,monk,mistweaver,6,4,2
Bhrag,die-aldor,384,monk,mistweaver,6,4,2
Peaceweaver,ravencrest,384,monk,mistweaver,6,4,2
Rokonbigfan,blackrock,384,monk,mistweaver,6,4,2
Bratana,dun-morogh,384,monk,mistweaver,6,4,2
Roudious,arathi,384,monk,mistweaver,6,4,2
Pikahelp,ravencrest,384,monk,mistweaver,6,4,2
Fakestrxx,aegwynn,384,monk,mistweaver,6,4,2
Chiodora,ravencrest,384,monk,mistweaver,6,4,2
Berlym,tarren-mill,384,monk,mistweaver,6,4,2
Леобтв,soulflayer,384,monk,mistweaver,6,4,2
Zugzuwg,ahnqiraj,384,monk,mistweaver,6,4,2
Shanzein,dragonmaw,384,monk,mistweaver,6,4,2
Klischi,blackhand,384,monk,mistweaver,6,4,2
Ennamoly,blackmoore,384,monk,mistweaver,6,4,2
Данваго,deathguard,384,monk,mistweaver,6,4,2
Trâffix,kazzak,384,monk,mistweaver,6,4,2
Vîsdom,kazzak,384,monk,mistweaver,6,4,2
Chunkymonkee,magtheridon,384,monk,mistweaver,6,4,2
Antipedyfile,kazzak,384,monk,mistweaver,6,4,2
Lilædi,draenor,384,monk,mistweaver,6,4,2
Gyógyítóütés,ragnaros,384,monk,mistweaver,6,4,2
Mqsxww,stormscale,384,monk,mistweaver,6,4,2
Plånck,archimonde,384,monk,mistweaver,6,4,2
Tuulijäbä,stormreaver,384,monk,mistweaver,6,4,2
Meineaugen,blackhand,384,monk,mistweaver,6,4,2
Mistydex,eredar,384,monk,mistweaver,6,4,2
Claww,blackrock,384,monk,mistweaver,6,4,2
Харуказэ,howling-fjord,384,monk,mistweaver,6,4,2
Sendayam,blackhand,384,monk,mistweaver,6,4,2
Highline,draenor,384,monk,mistweaver,6,4,2
Monkersquad,doomhammer,384,monk,mistweaver,6,4,2
Rexmonk,senjin,384,monk,mistweaver,6,4,2
Trácybéákérx,kazzak,384,monk,mistweaver,6,4,2
Immadbrew,blackmoore,384,monk,mistweaver,6,4,2
Гарримонк,deathguard,384,monk,mistweaver,6,4,2
Tüüdüülüü,blackrock,384,monk,mistweaver,6,4,2
Camlen,draenor,384,monk,mistweaver,6,4,2
Oxway,silvermoon,384,monk,mistweaver,6,4,2
Kbsanityproc,kul-tiras,384,monk,mistweaver,6,4,2
Zbamonk,burning-legion,384,monk,mistweaver,6,4,2
Slokwerk,dentarg,384,monk,mistweaver,6,4,2
Naìsh,arygos,384,monk,mistweaver,6,4,2
Zenvurv,kazzak,384,monk,mistweaver,6,4,2
Kazéshini,doomhammer,384,monk,mistweaver,6,4,2
Jifun,kazzak,384,monk,mistweaver,6,4,2
Bigflex,conseil-des-ombres,384,monk,mistweaver,6,4,2
Unagui,bronzebeard,384,monk,mistweaver,6,4,2
Gangichi,blackhand,384,monk,mistweaver,9,5,4
Dúlgor,blackmoore,384,monk,mistweaver,11,6,5
Häppÿ,kazzak,384,monk,mistweaver,8,4,4
Pandamums,frostwhisper,384,monk,mistweaver,12,4,8
Subzxftw,archimonde,384,monk,mistweaver,12,4,8
Audaz,dun-modr,384,monk,mistweaver,12,4,8
Pml,ravencrest,384,monk,mistweaver,12,4,8
Тониромано,thermaplugg,384,monk,mistweaver,12,4,8
Eurocod,draenor,384,monk,mistweaver,12,4,8
Jchi,ravencrest,384,monk,mistweaver,12,4,8
Eth,nagrand,384,monk,mistweaver,12,4,8
Divljivepar,stormscale,384,monk,mistweaver,12,4,8
Bruceli,darkmoon-faire,384,monk,mistweaver,12,4,8
Pepperboer,magtheridon,384,monk,mistweaver,12,4,8
Карманедаун,howling-fjord,384,monk,mistweaver,12,4,8
Monkmonkesen,stormscale,384,monk,mistweaver,12,4,8
Chimail,blackrock,384,monk,mistweaver,12,4,8
Bûl,blackmoore,384,monk,mistweaver,12,4,8
Invsionrush,crushridge,384,monk,mistweaver,12,4,8
Pompeflûte,archimonde,384,monk,mistweaver,12,4,8
Nebelwandler,blackhand,384,monk,mistweaver,12,4,8
Altairan,ragnaros,384,monk,mistweaver,12,4,8
Cactuzjuize,ragnaros,384,monk,mistweaver,12,4,8
Obeliskbrew,kazzak,384,monk,mistweaver,12,4,8
Rustyzuki,hyjal,384,monk,mistweaver,12,4,8
Woofi,tarren-mill,384,monk,mistweaver,12,4,8
Smøkÿý,eredar,384,monk,mistweaver,12,4,8
Mîyüki,dalaran,384,monk,mistweaver,18,4,14
Supwithat,kazzak,383,monk,mistweaver,6,4,2
Goldenquinn,sylvanas,383,monk,mistweaver,6,4,2
Шалфевна,grom,383,monk,mistweaver,16,7,9
Gnomebrew,ravencrest,383,monk,mistweaver,12,4,8
Tarly,archimonde,383,monk,mistweaver,12,4,8
Ornithorynke,hyjal,383,monk,mistweaver,12,4,8
Korrok,sanguino,383,monk,mistweaver,12,4,8
Aêsir,thrall,383,monk,mistweaver,12,4,8
Doneithné,stormscale,383,monk,mistweaver,12,4,8
Holowk,archimonde,383,monk,mistweaver,17,4,13
Zaalleh,draenor,382,monk,mistweaver,7,6,1
Jackiechann,kazzak,382,monk,mistweaver,6,4,2
Fkflying,defias-brotherhood,381,monk,mistweaver,12,4,8
Fairhand,emerald-dream,367,monk,mistweaver,11,4,7
Plií,frostwolf,362,monk,mistweaver,19,6,13
Qizz,antonidas,352,monk,mistweaver,10,5,5
Iluvfistinjk,sylvanas,351,monk,mistweaver,9,5,4
Buckersxo,kazzak,330,monk,mistweaver,11,6,5
Aennie,zuljin,330,monk,mistweaver,11,5,6
Chimý,tarren-mill,330,monk,mistweaver,15,5,10
Châkra,dun-modr,330,monk,mistweaver,22,5,17
Shrimpcawk,alonsus,320,monk,mistweaver,10,4,6
Sayumì,antonidas,319,monk,mistweaver,5,4,1
Shiìnx,hyjal,288,monk,mistweaver,6,3,3
Kakukkosora,ragnaros,288,monk,mistweaver,6,3,3
Catley,archimonde,288,monk,mistweaver,6,3,3
Koba,frostwolf,288,monk,mistweaver,6,3,3
Shàolïn,dalaran,288,monk,mistweaver,6,3,3
Mivansemmi,ragnaros,288,monk,mistweaver,6,3,3
Andrèa,draenor,288,monk,mistweaver,6,3,3
Loempia,outland,288,monk,mistweaver,6,3,3
Trubushatal,ravencrest,288,monk,mistweaver,6,3,3
Sàfcony,eredar,288,monk,mistweaver,6,3,3
Kjeyro,ravencrest,288,monk,mistweaver,6,3,3
Louiemon,outland,288,monk,mistweaver,6,3,3
Коррелир,howling-fjord,288,monk,mistweaver,6,3,3
Gojò,outland,288,monk,mistweaver,6,3,3
Místerfister,ravencrest,288,monk,mistweaver,6,3,3
Enfargo,ravencrest,288,monk,mistweaver,6,3,3
Píxels,ravencrest,288,monk,mistweaver,6,3,3
Mistless,ragnaros,288,monk,mistweaver,6,3,3
Leifjuster,stormscale,288,monk,mistweaver,6,3,3
Fistwave,malganis,288,monk,mistweaver,6,3,3
Màlydôr,outland,288,monk,mistweaver,6,3,3
Baisi,blackhand,288,monk,mistweaver,6,3,3
Chiheal,outland,288,monk,mistweaver,6,3,3
Napqi,malganis,288,monk,mistweaver,6,3,3
Sennín,blackhand,288,monk,mistweaver,6,3,3
Лён,ashenvale,288,monk,mistweaver,6,3,3
Хаолей,gordunni,288,monk,mistweaver,6,3,3
Chaisun,blackrock,288,monk,mistweaver,6,3,3
Wando,defias-brotherhood,288,monk,mistweaver,6,3,3
Jackíechun,twisting-nether,288,monk,mistweaver,6,3,3
Kaskinhas,archimonde,288,monk,mistweaver,6,3,3
Муртузикх,blackscar,288,monk,mistweaver,6,3,3
Friidam,lightbringer,288,monk,mistweaver,6,3,3
Senpuu,defias-brotherhood,288,monk,mistweaver,6,3,3
Hilton,thrall,288,monk,mistweaver,6,3,3
Xarain,tyrande,288,monk,mistweaver,6,3,3
Mønkek,kazzak,288,monk,mistweaver,6,3,3
Wêntô,aegwynn,288,monk,mistweaver,6,3,3
Uggs,hyjal,288,monk,mistweaver,6,3,3
Zkrmonk,kazzak,288,monk,mistweaver,6,3,3
Napari,tichondrius,288,monk,mistweaver,6,3,3
Маруты,soulflayer,288,monk,mistweaver,6,3,3
Rotakapa,arathor,288,monk,mistweaver,6,3,3
Yutahon,azjolnerub,288,monk,mistweaver,6,3,3
Shnohh,blackmoore,288,monk,mistweaver,6,3,3
Akinhd,twisting-nether,288,monk,mistweaver,6,3,3
Shoskio,chamber-of-aspects,288,monk,mistweaver,6,3,3
Erì,malfurion,288,monk,mistweaver,6,3,3
Helacoon,archimonde,288,monk,mistweaver,6,3,3
Bronda,shadowsong,288,monk,mistweaver,6,3,3
Ilsalumiere,nemesis,288,monk,mistweaver,6,3,3
Seeyousoon,nemesis,288,monk,mistweaver,6,3,3
Ipès,archimonde,288,monk,mistweaver,6,3,3
Zyrosmonk,blackmoore,288,monk,mistweaver,6,3,3
Culiacàn,blackmoore,288,monk,mistweaver,6,3,3
Lassador,onyxia,288,monk,mistweaver,6,3,3
Lívscoachen,tarren-mill,288,monk,mistweaver,6,3,3
Greatfupanda,bronze-dragonflight,288,monk,mistweaver,6,3,3
Rípple,alakir,288,monk,mistweaver,6,3,3
Jadeterror,argent-dawn,288,monk,mistweaver,6,3,3
Div,malygos,288,monk,mistweaver,6,3,3
Perikencito,dun-modr,288,monk,mistweaver,6,3,3
Thiccolas,argent-dawn,288,monk,mistweaver,6,3,3
Kenaïï,archimonde,288,monk,mistweaver,6,3,3
Родо,blackscar,288,monk,mistweaver,6,3,3
Píco,gorgonnash,288,monk,mistweaver,6,3,3
Киликххл,deathguard,288,monk,mistweaver,6,3,3
Рнбклаб,gordunni,288,monk,mistweaver,6,3,3
Radisha,uldum,288,monk,mistweaver,6,3,3
Litenværen,tarren-mill,288,monk,mistweaver,6,3,3
Såsha,sanguino,288,monk,mistweaver,6,3,3
Nessä,kazzak,288,monk,mistweaver,6,3,3
Linçhi,dun-modr,288,monk,mistweaver,6,3,3
Bútkus,argent-dawn,288,monk,mistweaver,6,3,3
Norbii,twisting-nether,288,monk,mistweaver,6,3,3
Justfistyoux,archimonde,288,monk,mistweaver,12,3,9
Zalupina,silvermoon,288,monk,mistweaver,12,3,9
Alilith,drakthul,288,monk,mistweaver,12,3,9
Koreanbullet,archimonde,288,monk,mistweaver,12,3,9
Nikosonkush,archimonde,288,monk,mistweaver,12,3,9
Albertã,doomhammer,288,monk,mistweaver,12,3,9
Deezspin,twisting-nether,288,monk,mistweaver,12,3,9
Älys,outland,288,monk,mistweaver,12,3,9
Drunklee,aegwynn,288,monk,mistweaver,12,3,9
Sedk,kazzak,288,monk,mistweaver,12,3,9
Xvll,kaelthas,288,monk,mistweaver,12,3,9
Danèè,defias-brotherhood,288,monk,mistweaver,12,3,9
Monkenya,kazzak,288,monk,mistweaver,12,3,9
Брусуко,howling-fjord,288,monk,mistweaver,12,3,9
Gaehitmonlee,ravencrest,288,monk,mistweaver,12,3,9
Leøni,malfurion,288,monk,mistweaver,12,3,9
Shaokz,sylvanas,288,monk,mistweaver,12,3,9
Lottelita,tarren-mill,288,monk,mistweaver,12,3,9
Farkasmw,arathor,288,monk,mistweaver,12,3,9
Bigbuddha,agamaggan,288,monk,mistweaver,17,3,14
Xilasa,blackrock,288,monk,mistweaver,18,3,15
Upbringer,ragnaros,288,monk,mistweaver,18,3,15
Phínez,thunderhorn,288,monk,mistweaver,18,3,15
Velita,dun-modr,288,monk,mistweaver,18,3,15
Crayz,blackmoore,288,monk,mistweaver,18,3,15
Munkeguden,ravencrest,288,monk,mistweaver,22,3,19
Torpedoorc,blackrock,287,monk,mistweaver,6,3,3
Bo,malorne,287,monk,mistweaver,6,3,3
Playboicarti,frostwolf,287,monk,mistweaver,6,3,3
Мастерхилфу,ashenvale,287,monk,mistweaver,16,7,9
Edenbllow,twisting-nether,287,monk,mistweaver,12,3,9
Hanumahn,kilrogg,287,monk,mistweaver,12,3,9
Weedtastic,ravencrest,287,monk,mistweaver,24,3,21
Shorebreak,argent-dawn,286,monk,mistweaver,6,3,3
Holishet,twisting-nether,271,monk,mistweaver,11,3,8
Spinosa,zirkel-des-cenarius,271,monk,mistweaver,12,3,9
Maharaj,terenas,255,monk,mistweaver,11,3,8
Lupîn,veklor,253,monk,mistweaver,10,3,7
Gujja,doomhammer,239,monk,mistweaver,5,3,2
Tidox,burning-legion,239,monk,mistweaver,5,3,2
Mð,blackmoore,239,monk,mistweaver,5,3,2
Xkôra,cthun,239,monk,mistweaver,5,3,2
Glavniuhordi,twisting-nether,239,monk,mistweaver,17,3,14
Monkelise,stormscale,234,monk,mistweaver,8,5,3
Jeuxfacil,archimonde,234,monk,mistweaver,9,4,5
Nypö,hyjal,234,monk,mistweaver,10,4,6
Mouhous,hellscream,234,monk,mistweaver,13,4,9
Арнольдовна,blackscar,234,monk,mistweaver,17,4,13
Cerativ,kult-der-verdammten,234,monk,mistweaver,17,4,13
Merqurychi,ravencrest,228,monk,mistweaver,14,7,7
Злюкшо,howling-fjord,192,monk,mistweaver,10,4,6
Toxicvxpe,archimonde,192,monk,mistweaver,6,2,4
Mutai,tarren-mill,192,monk,mistweaver,6,2,4
Wifeeagro,doomhammer,192,monk,mistweaver,6,2,4
Hîtmachine,twisting-nether,192,monk,mistweaver,6,2,4
Thrìllseeker,blackmoore,192,monk,mistweaver,6,2,4
Wizzad,blackmoore,192,monk,mistweaver,6,2,4
Kolsyran,draenor,192,monk,mistweaver,6,2,4
Fettucini,anubarak,192,monk,mistweaver,6,2,4
Fullcocoon,stormscale,192,monk,mistweaver,6,2,4
Trippyv,ragnaros,192,monk,mistweaver,6,2,4
Troudbamone,dalaran,192,monk,mistweaver,6,2,4
Ódién,der-rat-von-dalaran,192,monk,mistweaver,6,2,4
Armanimads,kazzak,192,monk,mistweaver,6,2,4
Sînge,archimonde,192,monk,mistweaver,6,2,4
Liluzi,aszune,192,monk,mistweaver,6,2,4
Scorpìon,blackrock,192,monk,mistweaver,6,2,4
Watermelon,laughing-skull,192,monk,mistweaver,6,2,4
Rokou,blackmoore,192,monk,mistweaver,6,2,4
Tazerfess,culte-de-la-rive-noire,192,monk,mistweaver,6,2,4
Sørps,ravencrest,192,monk,mistweaver,6,2,4
Brogenhagen,silvermoon,192,monk,mistweaver,6,2,4
Moshka,blackhand,192,monk,mistweaver,6,2,4
Denau,aegwynn,192,monk,mistweaver,6,2,4
Mäismz,stormscale,192,monk,mistweaver,6,2,4
Spághettôni,eredar,192,monk,mistweaver,6,2,4
Denfeiteqken,ragnaros,192,monk,mistweaver,6,2,4
Morty,balnazzar,192,monk,mistweaver,6,2,4
Karatemooves,kazzak,192,monk,mistweaver,6,2,4
Merlyñ,blackmoore,192,monk,mistweaver,6,2,4
Torpedopetra,baelgun,192,monk,mistweaver,6,2,4
Aliozman,azshara,192,monk,mistweaver,6,2,4
Mystize,shattered-hand,192,monk,mistweaver,6,2,4
Shanokee,blackrock,192,monk,mistweaver,6,2,4
Shaolinjutsu,ravencrest,192,monk,mistweaver,6,2,4
Jolifine,alleria,192,monk,mistweaver,6,2,4
Amoose,blackmoore,192,monk,mistweaver,6,2,4
Laagun,blackmoore,192,monk,mistweaver,6,2,4
Baiyana,hyjal,192,monk,mistweaver,6,2,4
Ïnaho,hyjal,192,monk,mistweaver,6,2,4
Shinyin,outland,192,monk,mistweaver,6,2,4
Леронтас,gordunni,192,monk,mistweaver,6,2,4
Faustíne,blackmoore,192,monk,mistweaver,6,2,4
Axan,drekthar,192,monk,mistweaver,6,2,4
Fistyxoxo,blackrock,192,monk,mistweaver,6,2,4
Laesh,archimonde,192,monk,mistweaver,6,2,4
Nihx,dun-modr,192,monk,mistweaver,6,2,4
Brüshïë,kazzak,192,monk,mistweaver,6,2,4
Ninano,ravencrest,192,monk,mistweaver,6,2,4
Ahaa,kazzak,192,monk,mistweaver,6,2,4
Nezrusltwo,dun-modr,192,monk,mistweaver,6,2,4
Bartûs,blackmoore,192,monk,mistweaver,6,2,4
Khrajsyy,kazzak,192,monk,mistweaver,6,2,4
Kanaja,emerald-dream,192,monk,mistweaver,6,2,4
Chegweaver,ravencrest,192,monk,mistweaver,6,2,4
Izzana,onyxia,192,monk,mistweaver,6,2,4
Lïv,kirin-tor,192,monk,mistweaver,6,2,4
Auaaua,ravencrest,192,monk,mistweaver,6,2,4
Fisterxd,blackrock,192,monk,mistweaver,6,2,4
Dennismansix,sylvanas,192,monk,mistweaver,6,2,4
Kyz,darkspear,192,monk,mistweaver,6,2,4
Overcute,twisting-nether,192,monk,mistweaver,6,2,4
Шиншири,gordunni,192,monk,mistweaver,6,2,4
Wilymonka,dalaran,192,monk,mistweaver,6,2,4
Bankmw,nordrassil,192,monk,mistweaver,6,2,4
Shynlee,frostwhisper,192,monk,mistweaver,6,2,4
Starwalkin,silvermoon,192,monk,mistweaver,6,2,4
Gabbah,blackrock,192,monk,mistweaver,6,2,4
Люсилью,howling-fjord,192,monk,mistweaver,6,2,4
Jadefain,argent-dawn,192,monk,mistweaver,6,2,4
Brewzin,frostwhisper,192,monk,mistweaver,6,2,4
Jtepm,ravencrest,192,monk,mistweaver,6,2,4
Acbcz,draenor,192,monk,mistweaver,6,2,4
Flyingraven,magtheridon,192,monk,mistweaver,6,2,4
Халиосфа,gordunni,192,monk,mistweaver,6,2,4
Dalaipyjama,quelthalas,192,monk,mistweaver,6,2,4
Jetsweep,kazzak,192,monk,mistweaver,6,2,4
Зараз,gordunni,192,monk,mistweaver,6,2,4
Nashli,kazzak,192,monk,mistweaver,6,2,4
Espectrå,dun-modr,192,monk,mistweaver,6,2,4
Votegus,outland,192,monk,mistweaver,6,2,4
Xùen,blackrock,192,monk,mistweaver,6,2,4
Jinmi,blackmoore,192,monk,mistweaver,10,3,7
Karun,ravencrest,192,monk,mistweaver,7,2,5
Thomasruin,the-venture-co,192,monk,mistweaver,7,2,5
Beriberi,tichondrius,192,monk,mistweaver,7,2,5
Ascrem,ragnaros,192,monk,mistweaver,12,2,10
Annamonk,tarren-mill,192,monk,mistweaver,12,2,10
Zárl,shadowsong,192,monk,mistweaver,12,2,10
Brixelol,kazzak,192,monk,mistweaver,12,2,10
Alexandrovic,hyjal,192,monk,mistweaver,12,2,10
Anifurry,tarren-mill,192,monk,mistweaver,12,2,10
Kinoshíta,draenor,192,monk,mistweaver,12,2,10
Jacksbäro,zirkel-des-cenarius,192,monk,mistweaver,12,2,10
Bierdame,blackhand,192,monk,mistweaver,12,2,10
Doabarrelrol,blackmoore,192,monk,mistweaver,12,2,10
Sillbis,bronzebeard,192,monk,mistweaver,12,2,10
Dòrâ,archimonde,192,monk,mistweaver,12,2,10
Johnsôn,blackmoore,192,monk,mistweaver,12,2,10
Monkolben,blackmoore,192,monk,mistweaver,12,2,10
Clonaz,silvermoon,192,monk,mistweaver,12,2,10
Djkaratemunk,tarren-mill,192,monk,mistweaver,24,2,22
Sargnorak,dalaran,191,monk,mistweaver,6,2,4
Hisagi,khaz-modan,191,monk,mistweaver,6,2,4
Jackywayne,blackmoore,180,monk,mistweaver,18,5,13
Uluwatu,sanguino,160,monk,mistweaver,10,2,8
Megatazz,hyjal,159,monk,mistweaver,5,2,3
Øsys,dun-modr,159,monk,mistweaver,5,2,3
Hectør,terrordar,159,monk,mistweaver,5,2,3
Fisttweaver,twisting-nether,159,monk,mistweaver,8,3,5
Writeofl,silvermoon,144,monk,mistweaver,9,3,6
Zausmo,kazzak,144,monk,mistweaver,9,2,7
Wololomonk,silvermoon,138,monk,mistweaver,8,3,5
Mankzie,argent-dawn,138,monk,mistweaver,9,3,6
Ostarikyttä,stormscale,138,monk,mistweaver,10,3,7
Monkigobrr,draenor,138,monk,mistweaver,11,3,8
Leípe,ravencrest,138,monk,mistweaver,17,3,14
Kunleu,draenor,137,monk,mistweaver,10,4,6
Спартаннка,gordunni,137,monk,mistweaver,8,3,5
Athëlyn,hyjal,137,monk,mistweaver,11,3,8
Naisha,arygos,128,monk,mistweaver,4,2,2
Wraq,tarren-mill,128,monk,mistweaver,4,2,2
Mossadjr,blackmoore,106,monk,mistweaver,9,4,5
Ushuriel,ragnaros,96,monk,mistweaver,3,2,1
Jvousnike,chants-éternels,96,monk,mistweaver,6,1,5
Эйнея,soulflayer,96,monk,mistweaver,6,1,5
Pream,blackrock,96,monk,mistweaver,6,1,5
Bellamnk,darksorrow,96,monk,mistweaver,6,1,5
Smlpp,kazzak,96,monk,mistweaver,6,1,5
Yonahä,kazzak,96,monk,mistweaver,6,1,5
Кукуныч,deathguard,96,monk,mistweaver,6,1,5
Cbamonk,tarren-mill,96,monk,mistweaver,6,1,5
Rullandezutt,kazzak,96,monk,mistweaver,6,1,5
Fantazero,ravencrest,96,monk,mistweaver,6,1,5
Itxelita,zuljin,96,monk,mistweaver,6,1,5
Havefunguys,alakir,96,monk,mistweaver,6,1,5
Botsmw,kazzak,96,monk,mistweaver,6,1,5
Claptone,blackrock,96,monk,mistweaver,6,1,5
Fisten,xavius,96,monk,mistweaver,6,1,5
Nimonk,blackhand,96,monk,mistweaver,6,1,5
Cai,blackrock,96,monk,mistweaver,6,1,5
Krisstopherr,draenor,96,monk,mistweaver,6,1,5
Tetukss,zuljin,96,monk,mistweaver,6,1,5
Sooyung,kazzak,96,monk,mistweaver,6,1,5
Yeanwoo,burning-legion,96,monk,mistweaver,6,1,5
Aequïtas,nemesis,96,monk,mistweaver,6,1,5
Missblack,zuljin,96,monk,mistweaver,6,1,5
Kamui,naxxramas,96,monk,mistweaver,6,1,5
Tóffée,silvermoon,96,monk,mistweaver,6,1,5
Ytjin,draenor,96,monk,mistweaver,6,1,5
Bruslie,cthun,96,monk,mistweaver,6,1,5
Starplatinüm,dun-modr,96,monk,mistweaver,6,1,5
Wolfynk,kazzak,96,monk,mistweaver,6,1,5
Mandràmw,hyjal,96,monk,mistweaver,6,1,5
Guldendrak,draenor,96,monk,mistweaver,6,1,5
Vaelis,arthas,96,monk,mistweaver,6,1,5
Butrinto,hellfire,96,monk,mistweaver,6,1,5
Kanade,kul-tiras,96,monk,mistweaver,6,1,5
Tomporius,blackmoore,96,monk,mistweaver,6,1,5
Aang,blackrock,96,monk,mistweaver,6,1,5
Рискасм,soulflayer,96,monk,mistweaver,6,1,5
Duvelmonk,dragonblight,96,monk,mistweaver,6,1,5
Flekweaver,tarren-mill,96,monk,mistweaver,6,1,5
Juicylips,frostwolf,96,monk,mistweaver,6,1,5
Munkina,tarren-mill,96,monk,mistweaver,6,1,5
Chîvex,stormscale,96,monk,mistweaver,6,1,5
Ceffoine,chogall,96,monk,mistweaver,6,1,5
Brandy,kazzak,96,monk,mistweaver,6,1,5
Rostick,drakthul,96,monk,mistweaver,6,1,5
Katmunk,silvermoon,96,monk,mistweaver,6,1,5
Bumbiere,outland,96,monk,mistweaver,6,1,5
Skadchi,blackhand,96,monk,mistweaver,6,1,5
Brewbunnyqt,thrall,96,monk,mistweaver,6,1,5
Legpunch,the-maelstrom,96,monk,mistweaver,6,1,5
Monkgoatx,aegwynn,96,monk,mistweaver,6,1,5
Mezz,ahnqiraj,96,monk,mistweaver,6,1,5
Crymôreplz,blackmoore,96,monk,mistweaver,6,1,5
Prezze,outland,96,monk,mistweaver,6,1,5
Monkinator,stormreaver,96,monk,mistweaver,6,1,5
Gargalondeze,twisting-nether,96,monk,mistweaver,6,1,5
Worldfamous,stormscale,96,monk,mistweaver,6,1,5
Ponchers,aegwynn,96,monk,mistweaver,6,1,5
Toté,kazzak,96,monk,mistweaver,6,1,5
Fapmaster,aegwynn,96,monk,mistweaver,6,1,5
Lìlíy,taerar,96,monk,mistweaver,6,1,5
Àómìñêdâìkí,lightnings-blade,96,monk,mistweaver,6,1,5
Ffacé,stormscale,96,monk,mistweaver,6,1,5
Jessiemonk,blackhand,96,monk,mistweaver,6,1,5
Capos,wrathbringer,96,monk,mistweaver,11,1,10
Тевимонк,gordunni,96,monk,mistweaver,12,1,11
Dmndog,antonidas,96,monk,mistweaver,12,1,11
Tmhamm,ravencrest,96,monk,mistweaver,12,1,11
Hotfist,outland,96,monk,mistweaver,12,1,11
Sigournémist,silvermoon,96,monk,mistweaver,12,1,11
Alexì,taerar,96,monk,mistweaver,12,1,11
Marrów,chamber-of-aspects,96,monk,mistweaver,14,1,13
Eijin,arathor,95,monk,mistweaver,12,1,11
Trlmøna,gorgonnash,90,monk,mistweaver,11,4,7
Lílliv,wrathbringer,79,monk,mistweaver,5,1,4
Barendhoff,sylvanas,64,monk,mistweaver,4,1,3
Бязь,gordunni,63,monk,mistweaver,2,2,0
Fae,kirin-tor,63,monk,mistweaver,14,2,12
Johnnybgood,tarren-mill,42,monk,mistweaver,10,3,7
Axilane,outland,42,monk,mistweaver,7,2,5
Drosky,archimonde,42,monk,mistweaver,7,2,5
Флокэ,soulflayer,42,monk,mistweaver,9,2,7
Ceedxyz,antonidas,42,monk,mistweaver,9,2,7
Teemouz,hyjal,42,monk,mistweaver,9,2,7
Tonh,stormscale,42,monk,mistweaver,11,2,9
Monkeykung,defias-brotherhood,40,monk,mistweaver,16,3,13
Nïkaa,dun-modr,18,monk,mistweaver,21,10,11
Pandaaäaaäaa,archimonde,1391,monk,brewmaster,34,18,16
Jademyst,outland,1263,monk,brewmaster,40,14,26
Sinpho,ahnqiraj,1192,monk,brewmaster,48,19,29
Winchun,ravencrest,820,monk,brewmaster,32,14,18
Padawang,twisting-nether,767,monk,brewmaster,24,8,16
Комбатпро,borean-tundra,711,monk,brewmaster,138,62,76
Shirôhige,zirkel-des-cenarius,480,monk,brewmaster,12,5,7
Merqurychi,ravencrest,480,monk,brewmaster,12,5,7
Johnnykegs,draenor,288,monk,brewmaster,6,3,3
Ehrenkranich,blackrock,288,monk,brewmaster,6,3,3
Tauroné,draenor,288,monk,brewmaster,12,3,9
Tayoo,aegwynn,192,monk,brewmaster,6,2,4
Zerendir,magtheridon,192,monk,brewmaster,6,2,4
Fullzi,dalaran,192,monk,brewmaster,6,2,4
Shurak,uldaman,192,monk,brewmaster,6,2,4
Youkaii,alexstrasza,192,monk,brewmaster,12,2,10
Badcøwboy,archimonde,96,monk,brewmaster,6,1,5
Simbabsu,thrall,96,monk,brewmaster,6,1,5
Lubeï,kirin-tor,96,monk,brewmaster,6,1,5
Piedliés,ravencrest,96,monk,brewmaster,6,1,5
Tylee,tarren-mill,96,monk,brewmaster,6,1,5
Mezz,ahnqiraj,96,monk,brewmaster,6,1,5
Winarchek,tarren-mill,96,monk,brewmaster,6,1,5
Yeanwoo,burning-legion,96,monk,brewmaster,6,1,5
Lòthbar,confrérie-du-thorium,63,monk,brewmaster,2,2,0
Rmtexter,ravencrest,2404,monk,windwalker,167,94,73
Lîlilîlîlîlí,stormscale,2388,monk,windwalker,84,53,31
Sîxmonths,stormscale,2347,monk,windwalker,90,60,30
Queteapie,stormscale,2337,monk,windwalker,106,63,43
Fistyw,stormscale,2313,monk,windwalker,104,60,44
Ewynamonk,silvermoon,2310,monk,windwalker,150,81,69
Edenmonk,dun-morogh,2273,monk,windwalker,90,50,40
Tianzu,twisting-nether,2251,monk,windwalker,246,134,112
Faxax,draenor,2239,monk,windwalker,168,87,81
Ilovehim,antonidas,2237,monk,windwalker,102,58,44
Locotommy,blackrock,2228,monk,windwalker,92,51,41
Balia,blackrock,2196,monk,windwalker,181,97,84
Keeferslover,dun-morogh,2187,monk,windwalker,66,39,27
Brñ,twisting-nether,2186,monk,windwalker,84,44,40
Hitsuwalker,archimonde,2180,monk,windwalker,252,138,114
Teressah,argent-dawn,2169,monk,windwalker,84,48,36
Monkmeta,frostwolf,2167,monk,windwalker,120,72,48
Senretsu,shattered-halls,2165,monk,windwalker,120,62,58
Fistenjoyer,outland,2159,monk,windwalker,155,84,71
Stÿvww,archimonde,2152,monk,windwalker,85,48,37
Lilcatlife,tyrande,2152,monk,windwalker,72,38,34
Plaww,dalaran,2148,monk,windwalker,138,83,55
Snusochnocco,the-maelstrom,2136,monk,windwalker,126,64,62
Onlypressw,tarren-mill,2126,monk,windwalker,66,34,32
Tabetai,tarren-mill,2125,monk,windwalker,90,46,44
Redundänt,kazzak,2122,monk,windwalker,84,46,38
Daosh,nemesis,2109,monk,windwalker,121,60,61
Минимонахх,blackscar,2108,monk,windwalker,201,101,100
Melyda,ravencrest,2105,monk,windwalker,341,183,158
Shrimpcawk,alonsus,2100,monk,windwalker,271,152,119
Dêsmî,ravencrest,2098,monk,windwalker,58,36,22
Deretrox,twisting-nether,2097,monk,windwalker,101,54,47
Edenwalker,dun-morogh,2096,monk,windwalker,114,54,60
Muix,draenor,2091,monk,windwalker,60,34,26
Leppix,outland,2090,monk,windwalker,137,66,71
Váinz,ravencrest,2084,monk,windwalker,102,50,52
Elinalia,burning-legion,2067,monk,windwalker,150,75,75
Rivaz,archimonde,2061,monk,windwalker,108,55,53
Щищ,gordunni,2055,monk,windwalker,288,156,132
Rivazsunkick,archimonde,2052,monk,windwalker,322,158,164
Troopmonk,ravencrest,2047,monk,windwalker,259,133,126
Аррани,thermaplugg,2045,monk,windwalker,82,46,36
Pichouhuahua,elune,2045,monk,windwalker,234,117,117
Unpruneable,stormscale,2042,monk,windwalker,333,162,171
Padawang,twisting-nether,2034,monk,windwalker,82,44,38
Stepsyzz,stormscale,2029,monk,windwalker,172,83,89
Hefners,grim-batol,2028,monk,windwalker,71,36,35
Hôllowx,archimonde,2024,monk,windwalker,69,41,28
Dänÿww,elune,2020,monk,windwalker,92,50,42
Дезмимонк,ashenvale,2020,monk,windwalker,61,33,28
Мистмастер,soulflayer,2014,monk,windwalker,54,32,22
Имортарион,howling-fjord,2013,monk,windwalker,199,101,98
Blizò,tarren-mill,2010,monk,windwalker,78,41,37
Vyneth,draenor,2008,monk,windwalker,95,47,48
Theoww,dragonblight,2008,monk,windwalker,161,78,83
Spectré,outland,2007,monk,windwalker,101,46,55
Juujika,ravencrest,2006,monk,windwalker,65,35,30
Venuki,blackrock,2005,monk,windwalker,108,65,43
Ilovealicia,ragnaros,2005,monk,windwalker,89,47,42
Нелегитимный,howling-fjord,2001,monk,windwalker,444,225,219
Fistyfast,hyjal,1998,monk,windwalker,54,33,21
Gyto,archimonde,1998,monk,windwalker,71,39,32
Vixia,outland,1994,monk,windwalker,41,23,18
Форгетх,soulflayer,1990,monk,windwalker,84,46,38
Ililgeg,thrall,1986,monk,windwalker,68,44,24
Vexíllum,sylvanas,1986,monk,windwalker,120,67,53
Hôllowx,throkferoth,1980,monk,windwalker,66,34,32
Erazhen,blackrock,1977,monk,windwalker,60,31,29
Eth,nagrand,1975,monk,windwalker,84,42,42
Deathmøøn,tyrande,1975,monk,windwalker,93,41,52
Санварион,eversong,1971,monk,windwalker,126,66,60
Däemon,twisting-nether,1970,monk,windwalker,138,71,67
Bulluh,blackmoore,1964,monk,windwalker,59,31,28
Pandamoniun,aggra-português,1957,monk,windwalker,236,119,117
Wonkeed,hyjal,1956,monk,windwalker,185,97,88
Gorguts,stormscale,1955,monk,windwalker,90,52,38
Rismonk,twisting-nether,1950,monk,windwalker,166,84,82
Fabrina,blackrock,1949,monk,windwalker,114,58,56
Deuxmonk,outland,1943,monk,windwalker,90,40,50
Anteric,sylvanas,1941,monk,windwalker,60,36,24
Arlohan,argent-dawn,1938,monk,windwalker,48,31,17
Bannedww,ravencrest,1935,monk,windwalker,54,36,18
Милыйколян,soulflayer,1935,monk,windwalker,72,35,37
Devilmønk,thrall,1934,monk,windwalker,162,85,77
Diagmonk,arathi,1934,monk,windwalker,142,74,68
Wolmachégodx,archimonde,1933,monk,windwalker,54,30,24
Wheelchairqt,stormscale,1928,monk,windwalker,42,28,14
Fistinguhuhu,outland,1928,monk,windwalker,254,121,133
Цеска,howling-fjord,1927,monk,windwalker,166,82,84
Senniñ,ravencrest,1926,monk,windwalker,48,29,19
Enerchi,ravencrest,1926,monk,windwalker,96,51,45
Jájsemshadow,drakthul,1922,monk,windwalker,72,37,35
Orkamonka,burning-legion,1921,monk,windwalker,66,35,31
Gararasu,eredar,1921,monk,windwalker,53,28,25
Атммо,soulflayer,1919,monk,windwalker,72,39,33
Sobadzlolz,alexstrasza,1911,monk,windwalker,184,104,80
Ellipirelli,doomhammer,1911,monk,windwalker,156,74,82
Xinxanxonxin,zuljin,1910,monk,windwalker,107,53,54
Shpunk,ravencrest,1909,monk,windwalker,268,133,135
Jonnyboxer,ravencrest,1907,monk,windwalker,90,45,45
Kåýðø,archimonde,1906,monk,windwalker,74,42,32
Soulja,bloodfeather,1906,monk,windwalker,643,326,317
Riskcapcap,dentarg,1905,monk,windwalker,72,37,35
Ladderfiend,stormscale,1905,monk,windwalker,203,93,110
Fln,blackrock,1902,monk,windwalker,82,45,37
Pitball,ravencrest,1898,monk,windwalker,72,36,36
Bogey,ragnaros,1898,monk,windwalker,44,21,23
Slyonex,ravencrest,1897,monk,windwalker,202,113,89
Ksâin,ravencrest,1896,monk,windwalker,66,34,32
Nicesky,ravencrest,1896,monk,windwalker,174,86,88
Sayozz,hyjal,1895,monk,windwalker,589,299,290
Oberháupt,blackrock,1893,monk,windwalker,84,46,38
Сугробикк,soulflayer,1893,monk,windwalker,178,82,96
Seyley,tarren-mill,1889,monk,windwalker,114,69,45
Këftêmé,kazzak,1889,monk,windwalker,78,47,31
Копытька,gordunni,1889,monk,windwalker,63,35,28
Shaolinthug,stormscale,1886,monk,windwalker,89,40,49
Mikedcrybaby,tarren-mill,1885,monk,windwalker,189,101,88
Mosch,blackrock,1884,monk,windwalker,82,44,38
Pêterpump,blackrock,1884,monk,windwalker,215,115,100
Sørann,drekthar,1883,monk,windwalker,106,56,50
Муррчалкин,howling-fjord,1881,monk,windwalker,54,30,24
Rorkito,sanguino,1881,monk,windwalker,98,52,46
Niamix,archimonde,1879,monk,windwalker,423,211,212
Dévíllíá,ragnaros,1878,monk,windwalker,66,30,36
Fapmaster,aegwynn,1877,monk,windwalker,60,31,29
Fotmwalker,ragnaros,1877,monk,windwalker,547,276,271
Джэкичача,soulflayer,1877,monk,windwalker,104,51,53
Hàtéppl,ravencrest,1877,monk,windwalker,54,26,28
Dianly,ravencrest,1875,monk,windwalker,134,62,72
Omnibar,kazzak,1872,monk,windwalker,48,28,20
Ztl,twisting-nether,1871,monk,windwalker,191,104,87
Gorèdusthoof,blackhand,1871,monk,windwalker,138,67,71
Heran,ravencrest,1870,monk,windwalker,253,125,128
Mónkâs,tarren-mill,1870,monk,windwalker,120,58,62
Mäismz,stormscale,1869,monk,windwalker,30,20,10
Тихийпук,deathguard,1869,monk,windwalker,176,99,77
Denjasftw,culte-de-la-rive-noire,1868,monk,windwalker,48,30,18
Beernie,tarren-mill,1867,monk,windwalker,72,44,28
Cander,stormscale,1867,monk,windwalker,66,35,31
Ellevance,draenor,1865,monk,windwalker,77,43,34
Krothus,tarren-mill,1864,monk,windwalker,157,90,67
Ãmaterasû,kazzak,1864,monk,windwalker,61,30,31
Peaceweaver,ravencrest,1863,monk,windwalker,124,69,55
Doktormonk,blackrock,1863,monk,windwalker,232,128,104
Brüshïë,kazzak,1863,monk,windwalker,65,33,32
Häshbulla,ragnaros,1860,monk,windwalker,57,31,26
Nightingalê,silvermoon,1858,monk,windwalker,95,54,41
Helloimfrank,tarren-mill,1857,monk,windwalker,54,28,26
Bwayn,blackhand,1857,monk,windwalker,374,184,190
Yipmaan,kazzak,1856,monk,windwalker,85,52,33
Диванн,howling-fjord,1855,monk,windwalker,59,30,29
Adrianchase,ravencrest,1854,monk,windwalker,60,35,25
Coollann,drakthul,1852,monk,windwalker,66,34,32
Owalker,ravencrest,1851,monk,windwalker,54,34,20
Kitcheneer,twisting-nether,1851,monk,windwalker,69,40,29
Bobblasfists,tarren-mill,1851,monk,windwalker,61,30,31
Kokushibo,cthun,1850,monk,windwalker,54,28,26
Яагрессивный,howling-fjord,1850,monk,windwalker,74,36,38
Lullerull,silvermoon,1849,monk,windwalker,69,39,30
Ackken,twisting-nether,1849,monk,windwalker,99,52,47
Gresmar,defias-brotherhood,1848,monk,windwalker,254,132,122
Zukatan,tarren-mill,1848,monk,windwalker,191,94,97
Trendyroxy,blackrock,1846,monk,windwalker,133,64,69
Bossdog,mugthol,1844,monk,windwalker,57,33,24
Rayneo,argent-dawn,1844,monk,windwalker,78,40,38
Boostarevine,stormscale,1842,monk,windwalker,59,38,21
Uwuhehe,ravencrest,1841,monk,windwalker,82,46,36
Sororicide,stormscale,1841,monk,windwalker,257,130,127
Monksea,ravencrest,1840,monk,windwalker,42,21,21
Hitsu,archimonde,1839,monk,windwalker,42,27,15
Ревенджж,howling-fjord,1837,monk,windwalker,278,137,141
Шейдла,soulflayer,1836,monk,windwalker,148,82,66
Эльморо,goldrinn,1835,monk,windwalker,60,32,28
Ratslayerz,dun-modr,1835,monk,windwalker,108,57,51
Santanax,ravencrest,1834,monk,windwalker,42,27,15
Zéroneufsix,silvermoon,1834,monk,windwalker,68,31,37
Kungfuhkyou,tarren-mill,1833,monk,windwalker,36,23,13
Linuxx,ravencrest,1832,monk,windwalker,90,45,45
Chucknorrîs,doomhammer,1831,monk,windwalker,79,47,32
Mystx,stormrage,1831,monk,windwalker,141,78,63
Toyless,ravencrest,1831,monk,windwalker,54,27,27
Iløvealicia,ravencrest,1830,monk,windwalker,58,28,30
Маруты,soulflayer,1829,monk,windwalker,94,37,57
Ninadobrév,stormscale,1828,monk,windwalker,216,117,99
Shinjiu,kiljaeden,1827,monk,windwalker,54,34,20
Инрэйджинкап,soulflayer,1826,monk,windwalker,252,123,129
Iceym,stormscale,1825,monk,windwalker,81,41,40
Nicomonk,ravencrest,1823,monk,windwalker,69,42,27
Monkini,kazzak,1823,monk,windwalker,54,27,27
Divinechi,kazzak,1821,monk,windwalker,60,39,21
Carbozø,archimonde,1820,monk,windwalker,167,93,74
Domiqx,blackhand,1820,monk,windwalker,66,33,33
Idiot,outland,1819,monk,windwalker,112,62,50
Domww,outland,1819,monk,windwalker,174,90,84
Вагонюлеера,howling-fjord,1819,monk,windwalker,46,22,24
Vanoarabidze,ravencrest,1818,monk,windwalker,41,25,16
Bläckijackï,hyjal,1818,monk,windwalker,50,28,22
Hurricrane,kazzak,1817,monk,windwalker,256,125,131
Ютуми,soulflayer,1817,monk,windwalker,60,29,31
Saadx,ravencrest,1816,monk,windwalker,205,111,94
Vandamme,archimonde,1816,monk,windwalker,92,46,46
Sultanofrizz,draenor,1815,monk,windwalker,48,26,22
Monkees,twisting-nether,1815,monk,windwalker,65,33,32
Notmelo,dun-modr,1815,monk,windwalker,54,27,27
Dansaam,tarren-mill,1813,monk,windwalker,42,25,17
Sinted,blackmoore,1813,monk,windwalker,61,30,31
Khrylx,twisting-nether,1812,monk,windwalker,58,32,26
Rêshi,draenor,1812,monk,windwalker,310,168,142
Mebrin,ragnaros,1810,monk,windwalker,101,52,49
Ampm,ravencrest,1810,monk,windwalker,80,39,41
Moistpocket,stormscale,1809,monk,windwalker,66,29,37
Рэйвх,howling-fjord,1808,monk,windwalker,36,19,17
Sushiroll,stormrage,1808,monk,windwalker,111,55,56
Sàitama,hyjal,1808,monk,windwalker,64,30,34
Arsonists,argent-dawn,1807,monk,windwalker,52,28,24
Venrea,archimonde,1807,monk,windwalker,81,41,40
Baltimore,stormscale,1806,monk,windwalker,36,25,11
Åbyssgòd,kazzak,1805,monk,windwalker,60,24,36
Elfisto,eredar,1804,monk,windwalker,54,31,23
Möîne,arathi,1804,monk,windwalker,90,47,43
Unangebracht,silvermoon,1803,monk,windwalker,227,121,106
Pandafuki,ravencrest,1803,monk,windwalker,62,33,29
Драконзмей,soulflayer,1802,monk,windwalker,142,72,70
Aimbotkid,tarren-mill,1801,monk,windwalker,54,28,26
Windwanker,eredar,1800,monk,windwalker,36,22,14
Blïss,kazzak,1800,monk,windwalker,90,49,41
Jinpachi,ravencrest,1800,monk,windwalker,77,36,41
Flunkefar,defias-brotherhood,1800,monk,windwalker,120,55,65
Калестонз,howling-fjord,1797,monk,windwalker,60,33,27
Yacum,blackrock,1795,monk,windwalker,77,35,42
Tinjihn,magtheridon,1794,monk,windwalker,216,105,111
Barbalekos,ragnaros,1793,monk,windwalker,182,98,84
Akuuji,silvermoon,1793,monk,windwalker,60,32,28
Broner,dunemaul,1793,monk,windwalker,88,43,45
Karmaisabich,ragnaros,1792,monk,windwalker,30,19,11
Жъёь,howling-fjord,1792,monk,windwalker,77,39,38
Yukfou,tarren-mill,1792,monk,windwalker,59,28,31
Stealthsøul,outland,1789,monk,windwalker,30,21,9
Megatazz,hyjal,1787,monk,windwalker,111,62,49
Runefists,twisting-nether,1787,monk,windwalker,36,20,16
Pàrádìsé,ravencrest,1787,monk,windwalker,119,60,59
Skailzkrt,hyjal,1786,monk,windwalker,51,23,28
Projectasura,draenor,1785,monk,windwalker,261,132,129
Madelnheaven,burning-legion,1784,monk,windwalker,97,50,47
Shînøbi,dalaran,1784,monk,windwalker,205,98,107
Ravelbaby,blackrock,1783,monk,windwalker,61,31,30
Циорех,gordunni,1781,monk,windwalker,99,59,40
Tuulijäbä,stormreaver,1781,monk,windwalker,48,26,22
Эвэйжион,gordunni,1780,monk,windwalker,102,62,40
Dwdw,aerie-peak,1780,monk,windwalker,83,41,42
Тэсти,blackscar,1779,monk,windwalker,75,38,37
Freehelper,stormscale,1779,monk,windwalker,78,32,46
Heyami,ravencrest,1777,monk,windwalker,72,34,38
Gonkun,outland,1776,monk,windwalker,175,93,82
Mynokxu,blackmoore,1775,monk,windwalker,98,56,42
Mcflaïe,ysondre,1775,monk,windwalker,102,52,50
Niyka,silvermoon,1774,monk,windwalker,144,75,69
Дуэльныйчел,howling-fjord,1774,monk,windwalker,217,110,107
Fistofrage,ravencrest,1773,monk,windwalker,111,63,48
Джобишоп,howling-fjord,1769,monk,windwalker,45,27,18
Sponkas,tarren-mill,1768,monk,windwalker,42,20,22
Тхэгык,soulflayer,1767,monk,windwalker,66,27,39
Lørðbrøñkø,blackrock,1766,monk,windwalker,112,64,48
Klumpenx,draenor,1766,monk,windwalker,94,48,46
Ароба,blackscar,1766,monk,windwalker,90,42,48
Чеченборцуха,howling-fjord,1765,monk,windwalker,60,34,26
Twinny,drakthul,1765,monk,windwalker,96,54,42
Kaijam,argent-dawn,1764,monk,windwalker,96,41,55
Минагороси,galakrond,1763,monk,windwalker,112,64,48
Kjeyro,ravencrest,1762,monk,windwalker,35,20,15
Korié,ravencrest,1762,monk,windwalker,103,55,48
Donvishas,aegwynn,1761,monk,windwalker,131,69,62
Muaba,outland,1761,monk,windwalker,54,25,29
Béarly,outland,1761,monk,windwalker,48,21,27
Iminzww,ravencrest,1759,monk,windwalker,96,46,50
Moultsou,hyjal,1758,monk,windwalker,66,33,33
Fistu,silvermoon,1757,monk,windwalker,85,48,37
Zandoy,draenor,1756,monk,windwalker,82,46,36
Yassøux,archimonde,1756,monk,windwalker,329,162,167
Rismonk,frostmane,1754,monk,windwalker,114,51,63
Mollytov,tarren-mill,1753,monk,windwalker,95,40,55
Pili,aegwynn,1752,monk,windwalker,48,29,19
Arachmk,drakthul,1750,monk,windwalker,114,52,62
Monkenio,stormscale,1745,monk,windwalker,60,30,30
Ninjagaiden,archimonde,1744,monk,windwalker,60,29,31
Lonechi,sylvanas,1743,monk,windwalker,65,34,31
Фодз,soulflayer,1743,monk,windwalker,81,33,48
Desmî,ravencrest,1741,monk,windwalker,42,19,23
Salvaje,stormscale,1740,monk,windwalker,303,161,142
Aslêyia,antonidas,1739,monk,windwalker,55,28,27
Saltotriks,tarren-mill,1739,monk,windwalker,127,57,70
Гладастар,soulflayer,1736,monk,windwalker,228,117,111
Рокебайбейби,howling-fjord,1734,monk,windwalker,282,147,135
Shoenk,blackhand,1732,monk,windwalker,48,26,22
Reelaxyyz,outland,1732,monk,windwalker,90,46,44
Saodiseng,outland,1730,monk,windwalker,125,68,57
Greenshortea,aegwynn,1728,monk,windwalker,42,21,21
Shagzy,ravencrest,1727,monk,windwalker,41,25,16
Stillwater,thrall,1726,monk,windwalker,289,146,143
Такиера,gordunni,1726,monk,windwalker,66,31,35
Виндволкерша,gordunni,1725,monk,windwalker,54,31,23
Agren,argent-dawn,1725,monk,windwalker,41,19,22
Capedbaldy,blackhand,1724,monk,windwalker,41,23,18
Astriz,outland,1723,monk,windwalker,30,18,12
Rerowine,magtheridon,1723,monk,windwalker,174,83,91
Ugabugash,silvermoon,1722,monk,windwalker,72,39,33
Draina,archimonde,1721,monk,windwalker,52,24,28
Waaks,archimonde,1720,monk,windwalker,114,63,51
Roidcarry,blackrock,1720,monk,windwalker,83,45,38
Reõ,argent-dawn,1719,monk,windwalker,141,77,64
Varis,stormreaver,1718,monk,windwalker,39,19,20
Трэйци,blackscar,1716,monk,windwalker,39,23,16
Whoszeus,archimonde,1716,monk,windwalker,97,53,44
Narstie,kazzak,1714,monk,windwalker,71,36,35
Drýton,blackrock,1713,monk,windwalker,42,22,20
Виноипиво,soulflayer,1713,monk,windwalker,60,30,30
Jjslag,stormscale,1712,monk,windwalker,102,48,54
Димакарма,howling-fjord,1712,monk,windwalker,101,45,56
Мандаирины,gordunni,1710,monk,windwalker,125,66,59
Мионелолл,goldrinn,1708,monk,windwalker,106,60,46
Akhlÿs,ysondre,1707,monk,windwalker,36,21,15
Saduh,thrall,1707,monk,windwalker,50,24,26
Healbotzweik,frostwolf,1706,monk,windwalker,96,41,55
Лагвай,gordunni,1705,monk,windwalker,42,21,21
Лазанья,grom,1705,monk,windwalker,128,60,68
Wørldwâlker,kazzak,1704,monk,windwalker,36,25,11
Yeratel,argent-dawn,1704,monk,windwalker,201,97,104
Wwisalright,burning-legion,1703,monk,windwalker,68,40,28
Wwfastsoloq,zenedar,1703,monk,windwalker,48,26,22
Ñø,twisting-nether,1702,monk,windwalker,42,18,24
Sugura,dethecus,1701,monk,windwalker,126,68,58
Bugrika,tarren-mill,1700,monk,windwalker,48,24,24
Chiscake,blackrock,1699,monk,windwalker,40,22,18
Senguro,frostwolf,1699,monk,windwalker,66,36,30
Tommypistol,runetotem,1698,monk,windwalker,226,109,117
Bunnyfighter,nemesis,1698,monk,windwalker,94,42,52
Bonepalm,kazzak,1697,monk,windwalker,29,21,8
Zéroneufsizz,silvermoon,1697,monk,windwalker,42,21,21
Meineaugen,blackhand,1696,monk,windwalker,35,22,13
Shoura,blackmoore,1696,monk,windwalker,84,38,46
Fistingbull,grim-batol,1694,monk,windwalker,126,67,59
Testmonial,hyjal,1694,monk,windwalker,54,21,33
Catchmee,agamaggan,1693,monk,windwalker,36,21,15
Меняубило,howling-fjord,1693,monk,windwalker,142,70,72
Anhox,ragnaros,1691,monk,windwalker,78,42,36
Chigre,hyjal,1691,monk,windwalker,88,47,41
Ashânti,eredar,1691,monk,windwalker,62,30,32
Хекмуги,borean-tundra,1689,monk,windwalker,174,91,83
Cranekickbot,ravencrest,1689,monk,windwalker,83,36,47
Gujja,doomhammer,1689,monk,windwalker,68,28,40
Джийви,goldrinn,1687,monk,windwalker,42,22,20
Lesauceboss,kazzak,1685,monk,windwalker,48,25,23
Jafandmeja,tarren-mill,1683,monk,windwalker,106,65,41
Ktrina,ravencrest,1682,monk,windwalker,226,118,108
Mezz,ahnqiraj,1681,monk,windwalker,48,24,24
Tisaki,blackhand,1680,monk,windwalker,41,25,16
Denji,kargath,1680,monk,windwalker,42,22,20
Gozslzly,drakthul,1680,monk,windwalker,90,47,43
Hilzaxsub,archimonde,1679,monk,windwalker,47,29,18
Yobo,archimonde,1679,monk,windwalker,89,44,45
Pazü,ysondre,1679,monk,windwalker,119,57,62
Xiâomèi,dun-modr,1679,monk,windwalker,168,79,89
Yungdrippy,eredar,1678,monk,windwalker,88,43,45
Xullon,dragonblight,1677,monk,windwalker,160,82,78
Annamonk,tarren-mill,1675,monk,windwalker,66,29,37
Mädic,outland,1673,monk,windwalker,42,22,20
Shaokïng,exodar,1673,monk,windwalker,264,135,129
Jam,aerie-peak,1673,monk,windwalker,36,18,18
Zenothar,ravencrest,1672,monk,windwalker,42,28,14
Kebabvevaren,twisting-nether,1672,monk,windwalker,33,21,12
Leadgen,tarren-mill,1670,monk,windwalker,122,63,59
Pelou,culte-de-la-rive-noire,1669,monk,windwalker,239,123,116
Pawsgodx,ragnaros,1669,monk,windwalker,78,40,38
Tubørg,ravencrest,1669,monk,windwalker,48,23,25
Lemmeportbk,ravencrest,1669,monk,windwalker,68,32,36
Wuux,tarren-mill,1668,monk,windwalker,125,67,58
Dankiron,darksorrow,1668,monk,windwalker,68,32,36
Sesi,drakthul,1668,monk,windwalker,94,41,53
Antomamonk,ravencrest,1666,monk,windwalker,87,43,44
Bigfistah,tarren-mill,1663,monk,windwalker,52,25,27
Blwh,stormscale,1663,monk,windwalker,54,25,29
Vtx,blackrock,1662,monk,windwalker,30,18,12
Gojò,outland,1662,monk,windwalker,48,28,20
Hævihænning,argent-dawn,1661,monk,windwalker,48,30,18
Karateboy,dun-modr,1661,monk,windwalker,75,39,36
Ilovefreddy,stormscale,1660,monk,windwalker,54,23,31
Hazzat,nordrassil,1659,monk,windwalker,60,35,25
Geeér,outland,1658,monk,windwalker,42,24,18
Qwizqwak,twisting-nether,1657,monk,windwalker,84,41,43
Holmwalker,twisting-nether,1657,monk,windwalker,148,70,78
Шотгар,howling-fjord,1657,monk,windwalker,60,27,33
Гкдшка,blackscar,1657,monk,windwalker,57,23,34
Doobly,kazzak,1656,monk,windwalker,278,148,130
Osalot,ravencrest,1656,monk,windwalker,104,51,53
Базилмнк,howling-fjord,1655,monk,windwalker,35,22,13
Shardonay,ravencrest,1655,monk,windwalker,42,26,16
Cheethfu,ragnaros,1652,monk,windwalker,82,46,36
Tenshinhann,outland,1652,monk,windwalker,84,39,45
Zledriasa,ravencrest,1651,monk,windwalker,56,23,33
Jiya,blackmoore,1650,monk,windwalker,178,83,95
Inkegomonk,draenor,1650,monk,windwalker,114,52,62
Shirkán,ragnaros,1649,monk,windwalker,36,21,15
Djinÿ,ysondre,1649,monk,windwalker,195,106,89
Hunkfur,ravencrest,1649,monk,windwalker,68,36,32
Междунамиад,gordunni,1648,monk,windwalker,30,18,12
Сандерстрайк,howling-fjord,1648,monk,windwalker,115,63,52
Thérez,les-sentinelles,1648,monk,windwalker,42,22,20
Бадхидхаарма,booty-bay,1647,monk,windwalker,138,62,76
Кишмякмонк,howling-fjord,1646,monk,windwalker,60,31,29
Гуппер,howling-fjord,1646,monk,windwalker,54,23,31
Атакцуки,gordunni,1645,monk,windwalker,75,42,33
Такюн,howling-fjord,1645,monk,windwalker,646,322,324
Хосэ,gordunni,1645,monk,windwalker,41,19,22
Faustux,blackmoore,1644,monk,windwalker,60,28,32
Эльторо,goldrinn,1644,monk,windwalker,184,84,100
Diagmonk,kazzak,1643,monk,windwalker,48,21,27
Permagone,argent-dawn,1642,monk,windwalker,84,48,36
Nhola,sanguino,1642,monk,windwalker,148,83,65
Флурсон,gordunni,1642,monk,windwalker,58,25,33
Bubjuu,ravencrest,1642,monk,windwalker,54,22,32
Alkanphel,kazzak,1641,monk,windwalker,36,23,13
Hampocket,ravencrest,1641,monk,windwalker,56,29,27
Таайлиньх,gordunni,1640,monk,windwalker,46,18,28
Selfmademan,drakthul,1638,monk,windwalker,30,22,8
Ànklar,blackrock,1638,monk,windwalker,90,48,42
Breezzmonka,twisting-nether,1638,monk,windwalker,48,24,24
Трайтубайтми,gordunni,1638,monk,windwalker,129,64,65
Kármo,thrall,1638,monk,windwalker,41,20,21
Schøcker,blackmoore,1638,monk,windwalker,96,45,51
Phesxm,sylvanas,1637,monk,windwalker,41,23,18
Shanokee,blackrock,1635,monk,windwalker,36,21,15
Ìnconnu,dalaran,1635,monk,windwalker,160,87,73
Potsymist,twisting-nether,1635,monk,windwalker,67,33,34
Futtefut,ravencrest,1635,monk,windwalker,60,25,35
Mefîsto,blackrock,1634,monk,windwalker,69,38,31
Ybnobama,outland,1634,monk,windwalker,54,24,30
Bnî,blackmoore,1632,monk,windwalker,81,48,33
Weizi,madmortem,1632,monk,windwalker,53,29,24
Акумах,blackscar,1632,monk,windwalker,111,55,56
Pwaff,kazzak,1632,monk,windwalker,108,51,57
Ijji,argent-dawn,1630,monk,windwalker,78,32,46
Yiannischan,draenor,1629,monk,windwalker,127,64,63
Chaospilot,sylvanas,1629,monk,windwalker,218,103,115
Edgys,silvermoon,1627,monk,windwalker,24,18,6
Homelanderxx,tarren-mill,1627,monk,windwalker,42,22,20
Samantonah,nemesis,1626,monk,windwalker,63,40,23
Пекинес,gordunni,1626,monk,windwalker,42,22,20
Løllapalooza,ragnaros,1626,monk,windwalker,57,29,28
Diefist,ravencrest,1625,monk,windwalker,46,21,25
Vark,bloodscalp,1623,monk,windwalker,42,22,20
Básíl,frostwolf,1622,monk,windwalker,83,40,43
Монкигодхх,howling-fjord,1621,monk,windwalker,31,21,10
Lycké,silvermoon,1621,monk,windwalker,108,62,46
Turßo,ravencrest,1620,monk,windwalker,65,44,21
Hybridtheory,doomhammer,1620,monk,windwalker,159,81,78
Iastyn,kazzak,1620,monk,windwalker,99,50,49
Elizry,alakir,1619,monk,windwalker,94,52,42
Goldenww,sanguino,1618,monk,windwalker,123,72,51
Sérrè,tarren-mill,1618,monk,windwalker,48,25,23
Ñinjakick,outland,1618,monk,windwalker,90,42,48
Mabkww,ravencrest,1617,monk,windwalker,36,19,17
Shalysa,ravencrest,1616,monk,windwalker,47,27,20
Gaehitmonlee,ravencrest,1616,monk,windwalker,271,144,127
Gdkz,tarren-mill,1616,monk,windwalker,113,53,60
Кианасоломид,gordunni,1615,monk,windwalker,296,146,150
Erenaar,nemesis,1614,monk,windwalker,60,43,17
Karpanderi,stormreaver,1614,monk,windwalker,29,17,12
Fijiwater,draenor,1613,monk,windwalker,24,17,7
Тринх,ashenvale,1613,monk,windwalker,54,31,23
Saisha,defias-brotherhood,1613,monk,windwalker,36,20,16
Orkuru,kazzak,1613,monk,windwalker,35,17,18
Tauti,dun-morogh,1610,monk,windwalker,36,21,15
Mîsts,aszune,1610,monk,windwalker,56,27,29
Humpenpower,blackhand,1609,monk,windwalker,53,32,21
Miløøx,silvermoon,1609,monk,windwalker,82,42,40
Fokdem,tarren-mill,1608,monk,windwalker,72,41,31
Белено,deathguard,1608,monk,windwalker,36,20,16
Ocëane,sanguino,1608,monk,windwalker,228,114,114
Steros,die-aldor,1608,monk,windwalker,42,21,21
Quoc,blackmoore,1608,monk,windwalker,47,20,27
Mionoor,aegwynn,1607,monk,windwalker,322,156,166
Walie,twisting-nether,1607,monk,windwalker,66,21,45
Тайммуайтай,howling-fjord,1606,monk,windwalker,90,50,40
Хзт,howling-fjord,1606,monk,windwalker,141,67,74
Xanlee,twisting-nether,1605,monk,windwalker,30,18,12
Vayarah,antonidas,1605,monk,windwalker,54,28,26
Karmachi,ravencrest,1605,monk,windwalker,95,42,53
Thungara,emerald-dream,1604,monk,windwalker,42,22,20
Meltfistqt,ravencrest,1604,monk,windwalker,111,57,54
Valduri,stormscale,1604,monk,windwalker,60,27,33
Фортрен,deepholm,1603,monk,windwalker,105,49,56
Hoøo,hyjal,1603,monk,windwalker,48,20,28
Faustix,blackmoore,1602,monk,windwalker,78,42,36
Thyf,drakthul,1602,monk,windwalker,72,30,42
Nigu,dun-modr,1601,monk,windwalker,85,47,38
Вэилэй,gordunni,1599,monk,windwalker,36,18,18
Stormymonk,blackrock,1599,monk,windwalker,53,21,32
Зестус,galakrond,1598,monk,windwalker,42,19,23
Jeppehmonk,stormscale,1596,monk,windwalker,36,19,17
Djbuttholex,tarren-mill,1595,monk,windwalker,47,25,22
Naschitüte,blackrock,1594,monk,windwalker,387,195,192
Sori,mazrigos,1594,monk,windwalker,43,20,23
Glorïagaynor,archimonde,1593,monk,windwalker,42,17,25
Vuzashiji,argent-dawn,1591,monk,windwalker,96,51,45
Nexyyfist,kazzak,1590,monk,windwalker,65,38,27
Ròux,blackmoore,1589,monk,windwalker,53,27,26
Mikz,ravencrest,1586,monk,windwalker,104,57,47
Sylicia,alleria,1584,monk,windwalker,134,64,70
Apprentice,ravencrest,1582,monk,windwalker,29,17,12
Charlett,the-venture-co,1581,monk,windwalker,125,66,59
Bluumorc,ravencrest,1580,monk,windwalker,30,20,10
Monk,shattered-hand,1580,monk,windwalker,47,17,30
Skiplegsweeb,stormscale,1579,monk,windwalker,30,21,9
Leasyww,antonidas,1579,monk,windwalker,29,18,11
Soxx,arthas,1579,monk,windwalker,165,88,77
Fistedx,twisting-nether,1578,monk,windwalker,136,62,74
Hosh,ysondre,1577,monk,windwalker,91,44,47
Bloodfist,zuljin,1576,monk,windwalker,118,59,59
Нэдэлин,greymane,1575,monk,windwalker,42,25,17
Zenified,ragnaros,1574,monk,windwalker,72,33,39
Miamausebär,blackmoore,1573,monk,windwalker,59,24,35
Янакаблуках,howling-fjord,1572,monk,windwalker,384,203,181
Fullzi,dalaran,1572,monk,windwalker,42,20,22
Enju,tarren-mill,1570,monk,windwalker,31,17,14
Чифую,lich-king,1570,monk,windwalker,71,32,39
Heffertonne,eredar,1568,monk,windwalker,72,40,32
Rayokhen,kazzak,1568,monk,windwalker,48,24,24
Луэнн,gordunni,1567,monk,windwalker,214,111,103
Дыня,gordunni,1566,monk,windwalker,42,25,17
Lurklee,blackhand,1566,monk,windwalker,52,30,22
Saikø,silvermoon,1566,monk,windwalker,35,19,16
Secretmonk,ravencrest,1565,monk,windwalker,41,17,24
Монашкасюэ,howling-fjord,1564,monk,windwalker,42,27,15
Notsmol,quelthalas,1563,monk,windwalker,72,33,39
Crewladal,arakarahm,1562,monk,windwalker,80,33,47
Fantazero,burning-legion,1561,monk,windwalker,71,31,40
Deme,sylvanas,1553,monk,windwalker,137,74,63
Монквкроксах,howling-fjord,1553,monk,windwalker,44,22,22
Schmidti,kazzak,1553,monk,windwalker,48,17,31
Sòftx,stormscale,1549,monk,windwalker,34,22,12
Morslee,burning-legion,1549,monk,windwalker,151,69,82
Shorisensei,aszune,1547,monk,windwalker,56,24,32
Fungamelol,blackhand,1546,monk,windwalker,54,34,20
Kirkeý,ravencrest,1546,monk,windwalker,85,42,43
Chulli,stormscale,1546,monk,windwalker,61,30,31
Djshady,sylvanas,1544,monk,windwalker,72,36,36
Blickx,draenor,1542,monk,windwalker,40,21,19
Монголгодх,howling-fjord,1540,monk,windwalker,216,119,97
Street,nethersturm,1539,monk,windwalker,83,50,33
Psyhooz,burning-legion,1539,monk,windwalker,68,36,32
Investing,silvermoon,1538,monk,windwalker,42,22,20
Plsnerfmemor,hyjal,1537,monk,windwalker,70,37,33
Tea,arathor,1537,monk,windwalker,162,82,80
Babyfax,draenor,1534,monk,windwalker,30,16,14
Qdwdwqerdads,ravencrest,1533,monk,windwalker,42,21,21
Emå,nemesis,1533,monk,windwalker,52,25,27
Wajoba,blackhand,1533,monk,windwalker,36,16,20
Zahj,ysondre,1532,monk,windwalker,31,19,12
Orkuuddiu,pozzo-delleternità,1532,monk,windwalker,197,101,96
Rationis,blackmoore,1531,monk,windwalker,42,22,20
Embodimonk,twisting-nether,1531,monk,windwalker,344,175,169
Kalsdee,argent-dawn,1529,monk,windwalker,79,43,36
Defrinol,grim-batol,1529,monk,windwalker,42,21,21
Fablemayfly,tarren-mill,1528,monk,windwalker,213,106,107
Swas,outland,1527,monk,windwalker,36,16,20
Тшейши,howling-fjord,1526,monk,windwalker,54,28,26
Scribzw,twisting-nether,1524,monk,windwalker,24,16,8
Волкейн,soulflayer,1522,monk,windwalker,36,16,20
Luckyjones,tarren-mill,1521,monk,windwalker,30,16,14
Eonyzi,kazzak,1521,monk,windwalker,54,27,27
Немонахх,howling-fjord,1521,monk,windwalker,66,28,38
Jogiemonk,ravencrest,1520,monk,windwalker,24,16,8
Ролитта,gordunni,1517,monk,windwalker,78,45,33
Elpuncho,dentarg,1517,monk,windwalker,78,42,36
Swanp,dun-modr,1516,monk,windwalker,36,17,19
Andyww,doomhammer,1516,monk,windwalker,72,26,46
Litenværen,tarren-mill,1515,monk,windwalker,24,16,8
Feyzmonk,ysondre,1513,monk,windwalker,30,16,14
Rãkan,kazzak,1512,monk,windwalker,90,52,38
Gorskie,silvermoon,1512,monk,windwalker,93,48,45
Nèlvár,blackhand,1511,monk,windwalker,52,30,22
Belobe,stormscale,1511,monk,windwalker,69,33,36
Fattony,bronzebeard,1510,monk,windwalker,46,30,16
Jolbucheron,hyjal,1509,monk,windwalker,120,62,58
Ryle,forscherliga,1509,monk,windwalker,72,35,37
Kanõ,outland,1508,monk,windwalker,171,92,79
Астрал,soulflayer,1508,monk,windwalker,30,16,14
Miyagisensei,ravencrest,1508,monk,windwalker,100,50,50
Траблы,howling-fjord,1507,monk,windwalker,30,16,14
Gatyz,archimonde,1507,monk,windwalker,75,36,39
Piedliés,ravencrest,1507,monk,windwalker,36,16,20
Дивипи,blackscar,1506,monk,windwalker,54,24,30
Nggz,archimonde,1505,monk,windwalker,151,89,62
Анпапаяя,galakrond,1505,monk,windwalker,59,32,27
Kaztruman,draenor,1505,monk,windwalker,74,36,38
Mink,uldum,1503,monk,windwalker,66,32,34
Mönkgodx,outland,1502,monk,windwalker,78,38,40
Artharox,anachronos,1501,monk,windwalker,36,22,14
Qtk,arthas,1501,monk,windwalker,42,16,26
Merilwyn,argent-dawn,1500,monk,windwalker,46,27,19
Niyatî,draenor,1499,monk,windwalker,64,30,34
Lassith,ravencrest,1497,monk,windwalker,30,16,14
Okilexsan,sanguino,1495,monk,windwalker,41,30,11
Kukazamura,silvermoon,1495,monk,windwalker,83,41,42
Ноупэйн,soulflayer,1490,monk,windwalker,72,32,40
Sweeneyboo,outland,1489,monk,windwalker,144,69,75
Bèrïth,kazzak,1488,monk,windwalker,114,55,59
Weetaxx,tarren-mill,1488,monk,windwalker,36,16,20
Дайкиаомине,gordunni,1487,monk,windwalker,100,50,50
Traxxus,sanguino,1483,monk,windwalker,90,49,41
Symaro,aegwynn,1482,monk,windwalker,48,21,27
Goldengem,silvermoon,1480,monk,windwalker,60,24,36
Awesomebrah,the-maelstrom,1478,monk,windwalker,36,19,17
Блябери,howling-fjord,1478,monk,windwalker,43,21,22
ßibip,hyjal,1477,monk,windwalker,56,34,22
Mynaira,tarren-mill,1476,monk,windwalker,57,25,32
Chireapz,blackrock,1475,monk,windwalker,54,26,28
Tenszangetsu,ragnaros,1473,monk,windwalker,47,25,22
Пампич,borean-tundra,1471,monk,windwalker,108,53,55
Kunjo,earthen-ring,1470,monk,windwalker,78,38,40
Cowboy,veknilash,1470,monk,windwalker,42,20,22
Bastos,blackrock,1469,monk,windwalker,393,197,196
Pandarok,argent-dawn,1469,monk,windwalker,61,29,32
Galaxyfists,blackhand,1467,monk,windwalker,132,68,64
Xuuan,argent-dawn,1466,monk,windwalker,143,78,65
Sanshiro,defias-brotherhood,1466,monk,windwalker,52,27,25
Gotmonkon,tarren-mill,1466,monk,windwalker,42,19,23
Yinsho,stormscale,1464,monk,windwalker,42,23,19
Ívó,ragnaros,1463,monk,windwalker,102,49,53
Bîmbâmboom,blackmoore,1462,monk,windwalker,66,27,39
Cac,argent-dawn,1461,monk,windwalker,205,98,107
Купейчик,gordunni,1460,monk,windwalker,123,56,67
Des,bronzebeard,1458,monk,windwalker,32,20,12
Styxmk,blackhand,1458,monk,windwalker,29,16,13
Sagewhisper,ravencrest,1458,monk,windwalker,57,27,30
Dòrâ,archimonde,1458,monk,windwalker,93,43,50
Smørc,the-maelstrom,1458,monk,windwalker,38,17,21
Yanmonk,silvermoon,1455,monk,windwalker,32,18,14
Qtv,arthas,1455,monk,windwalker,33,16,17
Vibé,blackmoore,1454,monk,windwalker,47,27,20
Shypanda,blackhand,1454,monk,windwalker,125,68,57
Boxpunchkick,kazzak,1452,monk,windwalker,62,30,32
Yunà,twisting-nether,1451,monk,windwalker,45,17,28
Lellaccio,pozzo-delleternità,1450,monk,windwalker,48,20,28
Йетисан,gordunni,1449,monk,windwalker,246,120,126
Yuffîe,sanguino,1448,monk,windwalker,61,30,31
Toúch,blackmoore,1448,monk,windwalker,100,42,58
Kamui,naxxramas,1446,monk,windwalker,57,32,25
Mcsmack,argent-dawn,1444,monk,windwalker,54,33,21
Dumbbell,magtheridon,1443,monk,windwalker,36,18,18
Лаодзы,deathguard,1443,monk,windwalker,59,27,32
Thekaj,kazzak,1441,monk,windwalker,72,43,29
Âdonis,twisting-nether,1441,monk,windwalker,54,27,27
Реброперо,gordunni,1441,monk,windwalker,105,46,59
Hazmad,archimonde,1440,monk,windwalker,106,58,48
Fratznkicker,blackhand,1438,monk,windwalker,143,76,67
Ketakarlsson,tarren-mill,1437,monk,windwalker,461,243,218
Pepperboer,magtheridon,1437,monk,windwalker,60,29,31
Salderlol,stormscale,1437,monk,windwalker,112,53,59
Артемиоксх,blackscar,1437,monk,windwalker,37,15,22
Kàrmà,aegwynn,1437,monk,windwalker,48,19,29
Pabu,emeriss,1436,monk,windwalker,30,15,15
Ðâvàizskÿ,ysondre,1436,monk,windwalker,30,15,15
Wakmo,bladefist,1435,monk,windwalker,97,51,46
Såliten,tarren-mill,1435,monk,windwalker,30,15,15
Kneecapper,ravencrest,1434,monk,windwalker,255,127,128
Laewyn,burning-blade,1434,monk,windwalker,36,16,20
Hymek,defias-brotherhood,1433,monk,windwalker,25,16,9
Yìng,tarren-mill,1433,monk,windwalker,90,43,47
Agitoyamissj,burning-legion,1433,monk,windwalker,148,69,79
Flowér,auchindoun,1433,monk,windwalker,36,15,21
Простогаля,howling-fjord,1432,monk,windwalker,142,76,66
Домудароги,gordunni,1431,monk,windwalker,60,29,31
Кунгфурер,lich-king,1431,monk,windwalker,36,16,20
Tayoo,aegwynn,1430,monk,windwalker,42,23,19
Boutarzi,hyjal,1430,monk,windwalker,84,43,41
Jackywayne,blackmoore,1429,monk,windwalker,71,35,36
Senshí,stormscale,1429,monk,windwalker,47,21,26
Crockzy,twisting-nether,1427,monk,windwalker,54,27,27
Wonkà,archimonde,1426,monk,windwalker,36,15,21
Jukei,blackmoore,1425,monk,windwalker,30,15,15
Bakash,ysondre,1424,monk,windwalker,370,181,189
Melaz,ravencrest,1423,monk,windwalker,24,15,9
Icecoldish,tarren-mill,1423,monk,windwalker,125,68,57
Malutkie,defias-brotherhood,1423,monk,windwalker,180,92,88
Earendil,culte-de-la-rive-noire,1423,monk,windwalker,89,45,44
Räudiger,nazjatar,1423,monk,windwalker,356,178,178
Twinkletoe,twisting-nether,1423,monk,windwalker,30,15,15
Minalu,frostwolf,1423,monk,windwalker,48,22,26
Monzziess,draenor,1422,monk,windwalker,78,36,42
Greytail,argent-dawn,1422,monk,windwalker,48,22,26
Jeydi,ravencrest,1421,monk,windwalker,111,65,46
Løwping,blackmoore,1421,monk,windwalker,95,41,54
Wazari,nemesis,1420,monk,windwalker,115,58,57
Nikchi,destromath,1420,monk,windwalker,97,44,53
Байтли,gordunni,1418,monk,windwalker,102,48,54
Thighdiver,emeriss,1416,monk,windwalker,108,60,48
Fífrelin,archimonde,1416,monk,windwalker,66,34,32
Darré,sylvanas,1416,monk,windwalker,285,138,147
Klapptoast,blackmoore,1413,monk,windwalker,82,45,37
Matlahon,kazzak,1413,monk,windwalker,143,71,72
Votbo,kazzak,1412,monk,windwalker,60,25,35
Lucaspires,sylvanas,1411,monk,windwalker,131,56,75
Dræk,twisting-nether,1410,monk,windwalker,116,60,56
Chilleê,blackmoore,1409,monk,windwalker,29,16,13
Odanobunaga,ravencrest,1408,monk,windwalker,77,39,38
Гномкия,gordunni,1408,monk,windwalker,30,15,15
Shapzxd,archimonde,1408,monk,windwalker,53,20,33
Turbofinger,doomhammer,1404,monk,windwalker,79,36,43
Roptoglad,hyjal,1404,monk,windwalker,77,34,43
Alandriai,blackmoore,1403,monk,windwalker,36,18,18
Soleriasbrew,blackhand,1403,monk,windwalker,222,109,113
Бичмэн,deathguard,1403,monk,windwalker,60,26,34
Добраядушка,gordunni,1400,monk,windwalker,36,19,17
Fymvy,ravencrest,1400,monk,windwalker,30,15,15
Томтью,gordunni,1400,monk,windwalker,137,68,69
Брэгандерт,gordunni,1400,monk,windwalker,60,26,34
Pipatvs,drakthul,1399,monk,windwalker,37,24,13
Akÿo,archimonde,1399,monk,windwalker,35,15,20
Chígoku,grim-batol,1398,monk,windwalker,188,92,96
Badcøwboy,archimonde,1396,monk,windwalker,30,15,15
Risomonk,blackrock,1396,monk,windwalker,121,58,63
Azato,hyjal,1394,monk,windwalker,60,29,31
Gødxq,hyjal,1394,monk,windwalker,70,33,37
Mistbeever,ragnaros,1393,monk,windwalker,36,18,18
Norualy,tichondrius,1392,monk,windwalker,30,16,14
Kyraxs,silvermoon,1392,monk,windwalker,53,26,27
Вайлаут,gordunni,1389,monk,windwalker,23,15,8
Laggedfist,kazzak,1388,monk,windwalker,33,15,18
Spinntowin,blackmoore,1386,monk,windwalker,161,79,82
Kîngjungeîle,dalaran,1384,monk,windwalker,30,17,13
Undefinedid,ravencrest,1384,monk,windwalker,164,86,78
Fisty,lightbringer,1384,monk,windwalker,36,15,21
Blackdwarf,tarren-mill,1382,monk,windwalker,31,16,15
Behemothm,kazzak,1381,monk,windwalker,78,39,39
Кюзичка,gordunni,1379,monk,windwalker,83,38,45
Монахнехилит,howling-fjord,1379,monk,windwalker,102,45,57
Nolo,outland,1379,monk,windwalker,99,43,56
Муайтайец,howling-fjord,1379,monk,windwalker,119,51,68
Yesman,quelthalas,1378,monk,windwalker,205,106,99
Bigdickmonk,blackmoore,1377,monk,windwalker,54,23,31
Swiftmonky,azuremyst,1376,monk,windwalker,48,27,21
Recklusa,stormscale,1374,monk,windwalker,69,39,30
Kata,saurfang,1374,monk,windwalker,54,24,30
Misutò,tarren-mill,1372,monk,windwalker,54,30,24
Odelagga,draenor,1371,monk,windwalker,36,19,17
Euronymesis,silvermoon,1371,monk,windwalker,63,31,32
Крутотимс,howling-fjord,1371,monk,windwalker,77,30,47
Îrønfist,blackmoore,1368,monk,windwalker,41,23,18
Анике,howling-fjord,1365,monk,windwalker,57,24,33
Lòthbar,confrérie-du-thorium,1364,monk,windwalker,144,79,65
Cleør,blackmoore,1363,monk,windwalker,46,23,23
Cptfist,argent-dawn,1363,monk,windwalker,52,24,28
Exikûsh,frostwolf,1362,monk,windwalker,75,38,37
Galadriel,kazzak,1361,monk,windwalker,36,15,21
Ketrie,argent-dawn,1360,monk,windwalker,116,57,59
Tempestu,twisting-nether,1358,monk,windwalker,108,50,58
Shushux,ysondre,1358,monk,windwalker,36,15,21
Nodzomi,shadowsong,1357,monk,windwalker,89,45,44
Xamaan,sanguino,1355,monk,windwalker,60,32,28
Blutáar,khazgoroth,1353,monk,windwalker,161,74,87
Nerd,argent-dawn,1350,monk,windwalker,41,20,21
Vivvy,argent-dawn,1350,monk,windwalker,53,25,28
Вамптолкер,howling-fjord,1348,monk,windwalker,42,21,21
Bandiya,archimonde,1348,monk,windwalker,127,61,66
Intensivee,silvermoon,1345,monk,windwalker,77,36,41
Fantasiløs,twisting-nether,1344,monk,windwalker,77,38,39
Atrikaww,kazzak,1343,monk,windwalker,24,14,10
Verfa,twisting-nether,1341,monk,windwalker,60,30,30
Thänkky,kazzak,1340,monk,windwalker,24,14,10
Fistberul,ravencrest,1339,monk,windwalker,84,42,42
Urgoll,silvermoon,1339,monk,windwalker,59,28,31
Tecisharmony,ravencrest,1338,monk,windwalker,24,14,10
Драгслер,howling-fjord,1338,monk,windwalker,60,28,32
Vulvie,ysondre,1337,monk,windwalker,120,63,57
Manlyfistx,stormscale,1337,monk,windwalker,31,14,17
Fiststowin,blackrock,1337,monk,windwalker,36,14,22
Бладмонки,soulflayer,1336,monk,windwalker,54,22,32
Kyz,darkspear,1336,monk,windwalker,53,21,32
Djînns,blackmoore,1333,monk,windwalker,60,30,30
Blyatfist,draenor,1333,monk,windwalker,30,14,16
Девятиусатый,gordunni,1332,monk,windwalker,40,17,23
Melikicks,silvermoon,1331,monk,windwalker,54,25,29
Migg,burning-legion,1330,monk,windwalker,46,18,28
Tetetete,silvermoon,1327,monk,windwalker,60,33,27
Тейваан,soulflayer,1327,monk,windwalker,96,52,44
Blumonk,argent-dawn,1327,monk,windwalker,488,245,243
Убивашечка,blackscar,1327,monk,windwalker,63,29,34
Prototypx,blackmoore,1325,monk,windwalker,84,42,42
Øbamakush,archimonde,1323,monk,windwalker,36,17,19
Monklonk,kazzak,1323,monk,windwalker,42,19,23
Емопацан,gordunni,1321,monk,windwalker,42,27,15
Монкфейс,howling-fjord,1320,monk,windwalker,72,31,41
Shurak,uldaman,1319,monk,windwalker,36,16,20
Bcaa,outland,1317,monk,windwalker,30,16,14
Bobbyknuckls,ravencrest,1317,monk,windwalker,377,183,194
Lokregar,blackmoore,1315,monk,windwalker,36,17,19
Брысьли,howling-fjord,1312,monk,windwalker,86,42,44
Digô,malganis,1310,monk,windwalker,36,23,13
Czvibuh,drakthul,1309,monk,windwalker,66,32,34
Monkgol,stormscale,1308,monk,windwalker,58,29,29
Kungfumite,twisting-nether,1307,monk,windwalker,161,83,78
Fatlazypanda,argent-dawn,1306,monk,windwalker,62,37,25
Iluvatareru,twisting-nether,1306,monk,windwalker,48,24,24
Threevthree,kazzak,1305,monk,windwalker,33,18,15
Monwig,tarren-mill,1305,monk,windwalker,55,28,27
Sarmal,nemesis,1305,monk,windwalker,62,29,33
Fûràxx,hyjal,1300,monk,windwalker,120,61,59
Клепер,soulflayer,1298,monk,windwalker,79,45,34
Loocoos,ragnaros,1295,monk,windwalker,76,42,34
Lolipokicake,ravencrest,1294,monk,windwalker,41,16,25
Kyujushigu,silvermoon,1293,monk,windwalker,138,69,69
Rhift,draenor,1291,monk,windwalker,48,26,22
Xialongbao,khaz-modan,1291,monk,windwalker,47,19,28
Коркирас,howling-fjord,1290,monk,windwalker,96,52,44
Räws,kirin-tor,1289,monk,windwalker,30,14,16
Phyllochinon,blackrock,1288,monk,windwalker,52,32,20
Óó,los-errantes,1287,monk,windwalker,57,28,29
Maino,dalaran,1282,monk,windwalker,55,32,23
Jerrykhãn,archimonde,1280,monk,windwalker,36,16,20
Tharaën,archimonde,1280,monk,windwalker,42,14,28
Sajin,la-croisade-écarlate,1279,monk,windwalker,29,14,15
Døwe,archimonde,1279,monk,windwalker,29,14,15
Mirôku,onyxia,1279,monk,windwalker,60,28,32
Нежненький,gordunni,1278,monk,windwalker,30,14,16
Ekincheng,twisting-nether,1277,monk,windwalker,168,95,73
Scedadle,outland,1277,monk,windwalker,27,14,13
Gokuson,azjolnerub,1276,monk,windwalker,48,21,27
Betelgeuse,jaedenar,1273,monk,windwalker,33,15,18
Пивондэполо,gordunni,1271,monk,windwalker,46,22,24
Kaipo,ragnaros,1270,monk,windwalker,58,24,34
Mønkeydluffy,blackmoore,1269,monk,windwalker,66,33,33
Dummars,ragnaros,1266,monk,windwalker,30,15,15
Frictional,ravencrest,1266,monk,windwalker,104,43,61
Arshy,silvermoon,1263,monk,windwalker,29,14,15
Деоен,eversong,1261,monk,windwalker,30,14,16
Ahlu,argent-dawn,1261,monk,windwalker,45,17,28
Likethat,hyjal,1260,monk,windwalker,125,60,65
Яшкациган,howling-fjord,1259,monk,windwalker,139,65,74
Nilssön,silvermoon,1258,monk,windwalker,26,14,12
Weedonyz,hyjal,1257,monk,windwalker,18,15,3
Ayyee,blackmoore,1257,monk,windwalker,96,40,56
Gorfax,sanguino,1254,monk,windwalker,58,31,27
Mycki,dalaran,1254,monk,windwalker,131,61,70
Vajawalkerx,twisting-nether,1247,monk,windwalker,18,13,5
Djpunchable,blackrock,1247,monk,windwalker,24,13,11
Askarg,hyjal,1247,monk,windwalker,42,20,22
Rainymonday,ravencrest,1246,monk,windwalker,24,13,11
Fiddyy,outland,1246,monk,windwalker,24,13,11
Moonkeeye,stormscale,1246,monk,windwalker,114,59,55
Melombus,dun-modr,1246,monk,windwalker,30,13,17
Mcscrub,ragnaros,1245,monk,windwalker,24,13,11
Kylerøne,hyjal,1244,monk,windwalker,131,64,67
Critique,stormscale,1244,monk,windwalker,66,30,36
Mikelangelo,frostmane,1243,monk,windwalker,35,14,21
Miyaghï,dun-modr,1242,monk,windwalker,127,62,65
Pacimaru,silvermoon,1242,monk,windwalker,30,13,17
Brandy,kazzak,1242,monk,windwalker,30,13,17
Monkeystar,archimonde,1240,monk,windwalker,18,13,5
Nastyvibes,dun-modr,1240,monk,windwalker,18,13,5
Rhâzalgûl,khaz-modan,1238,monk,windwalker,24,13,11
Pandermann,antonidas,1238,monk,windwalker,30,16,14
Patadademijo,tarren-mill,1237,monk,windwalker,36,16,20
Zoyrac,malygos,1236,monk,windwalker,30,16,14
Zymonks,silvermoon,1236,monk,windwalker,36,13,23
Кирокко,gordunni,1235,monk,windwalker,30,20,10
Kouradoskylo,twisting-nether,1234,monk,windwalker,29,16,13
Blyatfast,draenor,1233,monk,windwalker,24,13,11
Чвка,booty-bay,1233,monk,windwalker,204,102,102
Monktoon,doomhammer,1233,monk,windwalker,40,20,20
Lumpero,stormreaver,1232,monk,windwalker,24,16,8
Bal,tyrande,1232,monk,windwalker,39,23,16
Macgregorc,tarren-mill,1232,monk,windwalker,27,14,13
Янасру,gordunni,1232,monk,windwalker,273,136,137
Огненныйкит,blackscar,1232,monk,windwalker,72,34,38
Kegrøll,doomhammer,1231,monk,windwalker,42,21,21
Ðøgai,frostwolf,1231,monk,windwalker,36,16,20
Calyonn,archimonde,1230,monk,windwalker,131,58,73
Samh,twisting-nether,1227,monk,windwalker,52,28,24
Ricksancez,nemesis,1224,monk,windwalker,42,24,18
Jesmander,kazzak,1224,monk,windwalker,30,16,14
Кримсон,blackscar,1221,monk,windwalker,88,45,43
Keberathom,stormscale,1221,monk,windwalker,217,99,118
Chonkard,drakthul,1221,monk,windwalker,50,18,32
Grandoreille,archimonde,1221,monk,windwalker,47,16,31
Sinziana,silvermoon,1217,monk,windwalker,20,14,6
Халиосфа,gordunni,1217,monk,windwalker,36,14,22
Bruzuh,outland,1215,monk,windwalker,31,15,16
Vushao,blackmoore,1215,monk,windwalker,174,81,93
Xem,azjolnerub,1215,monk,windwalker,30,13,17
Umagon,chogall,1215,monk,windwalker,72,31,41
Krâr,onyxia,1213,monk,windwalker,60,28,32
Joshxao,blackmoore,1211,monk,windwalker,36,13,23
Нэкстимонк,howling-fjord,1210,monk,windwalker,24,14,10
Keskonriz,ysondre,1209,monk,windwalker,108,46,62
Gúerrilla,tarren-mill,1206,monk,windwalker,111,60,51
Imvengeance,stormscale,1205,monk,windwalker,58,28,30
Joaquuin,sylvanas,1204,monk,windwalker,54,27,27
Pingxiaopo,khaz-modan,1204,monk,windwalker,52,20,32
Билльбо,fordragon,1203,monk,windwalker,132,65,67
Valky,bloodfeather,1201,monk,windwalker,42,22,20
Senkaihero,nemesis,1197,monk,windwalker,36,19,17
Trunks,turalyon,1194,monk,windwalker,54,27,27
Yøøps,dalaran,1191,monk,windwalker,71,33,38
Шмальзахар,howling-fjord,1190,monk,windwalker,53,24,29
Bâmbêlvî,tyrande,1186,monk,windwalker,27,15,12
Sillbis,bronzebeard,1185,monk,windwalker,267,122,145
Hackerman,archimonde,1183,monk,windwalker,59,26,33
Grìzzly,stormreaver,1182,monk,windwalker,86,35,51
Одиниз,gordunni,1181,monk,windwalker,96,59,37
Stronkman,frostwhisper,1180,monk,windwalker,36,24,12
Jlamonja,dun-modr,1180,monk,windwalker,25,13,12
Gozgoya,doomhammer,1176,monk,windwalker,124,60,64
Wodniuch,defias-brotherhood,1173,monk,windwalker,27,13,14
Рочч,gordunni,1172,monk,windwalker,30,17,13
Néroburnsred,eredar,1170,monk,windwalker,68,28,40
Pyto,sanguino,1156,monk,windwalker,61,33,28
Deathwishes,zenedar,1156,monk,windwalker,36,13,23
Bellarika,nemesis,1152,monk,windwalker,12,12,0
Djstepmom,ravencrest,1152,monk,windwalker,12,12,0
Ðìør,kazzak,1152,monk,windwalker,18,12,6
Buffwwx,silvermoon,1152,monk,windwalker,24,12,12
Galexuz,blackrock,1152,monk,windwalker,30,12,18
Gøøgodx,tarren-mill,1151,monk,windwalker,18,12,6
Tðptier,drakthul,1151,monk,windwalker,18,12,6
Çhina,twisting-nether,1151,monk,windwalker,24,12,12
Sander,twilights-hammer,1151,monk,windwalker,27,13,14
Daybaobao,the-maelstrom,1150,monk,windwalker,28,14,14
Martur,bronzebeard,1150,monk,windwalker,30,12,18
Zerødamage,malorne,1149,monk,windwalker,18,12,6
Stormsong,arthas,1149,monk,windwalker,18,12,6
Hypern,twisting-nether,1149,monk,windwalker,22,13,9
Elfisto,baelgun,1149,monk,windwalker,26,13,13
Azorantay,dentarg,1149,monk,windwalker,24,12,12
Monk,dun-modr,1148,monk,windwalker,24,12,12
Brorsantuck,frostmane,1147,monk,windwalker,18,12,6
Faìthlessqt,azshara,1146,monk,windwalker,24,12,12
Silvrt,tarren-mill,1145,monk,windwalker,24,12,12
Ameri,burning-steppes,1145,monk,windwalker,24,12,12
Kagëra,ysondre,1145,monk,windwalker,24,12,12
Fedrra,twisting-nether,1144,monk,windwalker,24,12,12
Sigath,emeriss,1144,monk,windwalker,42,12,30
Lottelita,tarren-mill,1143,monk,windwalker,26,12,14
Lílliv,wrathbringer,1135,monk,windwalker,30,12,18
Thichquang,sylvanas,1134,monk,windwalker,18,12,6
Ехерех,blackscar,1133,monk,windwalker,50,29,21
Gramary,silvermoon,1132,monk,windwalker,30,17,13
Sixqtn,blackrock,1131,monk,windwalker,30,12,18
Forpandariaa,kazzak,1130,monk,windwalker,36,13,23
Somonks,twisting-nether,1124,monk,windwalker,42,19,23
Kaengy,hyjal,1123,monk,windwalker,30,12,18
Kirara,talnivarr,1121,monk,windwalker,18,12,6
Changsun,confrérie-du-thorium,1117,monk,windwalker,30,12,18
Jïrén,archimonde,1115,monk,windwalker,104,41,63
Mongole,hellscream,1112,monk,windwalker,30,12,18
Bayak,antonidas,1111,monk,windwalker,82,40,42
Moreløs,stormscale,1109,monk,windwalker,71,29,42
Mönchdog,blackmoore,1108,monk,windwalker,30,15,15
Kusid,ragnaros,1106,monk,windwalker,25,14,11
Panzeerotto,nemesis,1106,monk,windwalker,106,44,62
Omoi,twisting-nether,1101,monk,windwalker,119,47,72
Noodlesauce,silvermoon,1100,monk,windwalker,15,12,3
Spêcky,blackmoore,1099,monk,windwalker,64,30,34
Югэн,azuregos,1097,monk,windwalker,30,14,16
Yamo,blackrock,1096,monk,windwalker,23,12,11
Koreangirlx,archimonde,1086,monk,windwalker,14,12,2
Iamzra,kazzak,1078,monk,windwalker,35,12,23
Yeddek,archimonde,1075,monk,windwalker,36,22,14
Ørlandéa,archimonde,1075,monk,windwalker,89,48,41
Martial,arthas,1075,monk,windwalker,95,44,51
Spiritclaw,kul-tiras,1072,monk,windwalker,78,41,37
Monkiki,hyjal,1070,monk,windwalker,31,12,19
Jayline,kazzak,1069,monk,windwalker,54,21,33
Nades,the-maelstrom,1067,monk,windwalker,17,12,5
Концептуалик,gordunni,1060,monk,windwalker,27,16,11
Wrizz,area-52,1056,monk,windwalker,18,11,7
Гидрах,soulflayer,1055,monk,windwalker,18,11,7
Cirixx,outland,1055,monk,windwalker,18,11,7
Merokiin,kazzak,1055,monk,windwalker,18,11,7
Weezé,outland,1055,monk,windwalker,18,11,7
Ogelele,twisting-nether,1055,monk,windwalker,24,11,13
Thiccboi,dragonblight,1055,monk,windwalker,24,11,13
Rollah,ravencrest,1055,monk,windwalker,28,12,16
Mahom,twisting-nether,1054,monk,windwalker,18,11,7
Garlä,archimonde,1054,monk,windwalker,18,11,7
Leolilu,ravencrest,1054,monk,windwalker,18,11,7
Turbofistsqt,kazzak,1054,monk,windwalker,18,11,7
Denwont,twisting-nether,1054,monk,windwalker,18,11,7
Hästgodx,the-maelstrom,1054,monk,windwalker,24,11,13
Ðoom,sylvanas,1054,monk,windwalker,24,11,13
Daltailr,silvermoon,1054,monk,windwalker,27,11,16
Tiaqa,aegwynn,1053,monk,windwalker,12,11,1
Karatemonk,stormscale,1053,monk,windwalker,24,11,13
Silcet,stormscale,1052,monk,windwalker,18,11,7
Fistingfury,burning-blade,1052,monk,windwalker,24,11,13
Degentz,alakir,1051,monk,windwalker,21,12,9
Kryzu,ragnaros,1051,monk,windwalker,24,11,13
Bottomoré,silvermoon,1051,monk,windwalker,30,12,18
Realiaze,tichondrius,1051,monk,windwalker,30,11,19
Bananaboat,tarren-mill,1050,monk,windwalker,18,11,7
Psychovirgîn,archimonde,1050,monk,windwalker,18,11,7
Gléipnir,ravencrest,1050,monk,windwalker,24,11,13
Sêssai,outland,1049,monk,windwalker,18,11,7
Dopi,frostmane,1049,monk,windwalker,22,12,10
Monkyou,hyjal,1046,monk,windwalker,18,11,7
Dokuziq,twisting-nether,1046,monk,windwalker,28,12,16
Sholean,die-aldor,1045,monk,windwalker,18,11,7
Youngstorm,kazzak,1040,monk,windwalker,24,13,11
Dofunk,eonar,1030,monk,windwalker,23,13,10
Tysonwonka,thrall,1030,monk,windwalker,44,20,24
Malarie,magtheridon,1028,monk,windwalker,167,90,77
Marcianorock,archimonde,1028,monk,windwalker,36,17,19
Chlamydious,silvermoon,1028,monk,windwalker,212,97,115
Xen,uldum,1027,monk,windwalker,18,11,7
Brevduwan,ragnaros,1024,monk,windwalker,24,11,13
Napqi,malganis,1023,monk,windwalker,17,11,6
Monkiatsu,turalyon,1021,monk,windwalker,50,25,25
Шоты,soulflayer,1019,monk,windwalker,18,11,7
Runny,sanguino,1008,monk,windwalker,42,12,30
Buggaa,dalaran,996,monk,windwalker,23,11,12
Undgrund,burning-legion,992,monk,windwalker,36,16,20
Rektless,nordrassil,989,monk,windwalker,20,11,9
Myiio,khaz-modan,987,monk,windwalker,42,12,30
Dokodesuka,ysondre,985,monk,windwalker,58,29,29
Agress,sanguino,984,monk,windwalker,72,33,39
Обликонт,soulflayer,983,monk,windwalker,24,12,12
Jgma,auchindoun,982,monk,windwalker,291,134,157
Yuchiiro,hyjal,973,monk,windwalker,30,13,17
Pïpöu,archimonde,960,monk,windwalker,12,10,2
Votix,tarren-mill,960,monk,windwalker,12,10,2
Wreckpuss,tarren-mill,960,monk,windwalker,18,10,8
Rìnox,blackmoore,960,monk,windwalker,18,10,8
Plånck,archimonde,960,monk,windwalker,18,10,8
Sqoobie,tarren-mill,960,monk,windwalker,18,10,8
Ðävàizskó,ysondre,960,monk,windwalker,18,10,8
Balance,laughing-skull,960,monk,windwalker,24,10,14
Kåtsumi,sanguino,960,monk,windwalker,24,10,14
Sebikm,ravencrest,959,monk,windwalker,12,10,2
Nycea,blackrock,959,monk,windwalker,18,10,8
Sàlêxz,ysondre,959,monk,windwalker,18,10,8
Bígwrékt,twisting-nether,959,monk,windwalker,18,10,8
Uglyfister,kazzak,959,monk,windwalker,18,10,8
Eggroll,archimonde,959,monk,windwalker,18,10,8
Såsha,sanguino,959,monk,windwalker,24,10,14
Rulliya,kazzak,959,monk,windwalker,24,10,14
Qoopu,frostwhisper,959,monk,windwalker,24,10,14
Miridius,silvermoon,959,monk,windwalker,24,10,14
Winifspin,twisting-nether,959,monk,windwalker,24,10,14
Jizoh,eredar,959,monk,windwalker,30,10,20
Shialemonk,twisting-nether,957,monk,windwalker,18,10,8
Михот,eversong,957,monk,windwalker,30,15,15
Pimahz,aggra-português,956,monk,windwalker,18,10,8
Doreese,moonglade,955,monk,windwalker,18,10,8
Duches,tarren-mill,955,monk,windwalker,24,10,14
Màrlux,kazzak,954,monk,windwalker,24,10,14
Orcword,ragnaros,953,monk,windwalker,18,10,8
Непорядочная,gordunni,953,monk,windwalker,51,21,30
Qsê,ysondre,951,monk,windwalker,18,10,8
Chæli,tarren-mill,944,monk,windwalker,29,12,17
Rhaekhan,kirin-tor,943,monk,windwalker,24,10,14
Zonavya,stormreaver,941,monk,windwalker,27,11,16
Jawofiron,quelthalas,941,monk,windwalker,29,10,19
Dionee,twisting-nether,939,monk,windwalker,69,30,39
Grîmjaw,nordrassil,933,monk,windwalker,30,11,19
Trolleurz,archimonde,932,monk,windwalker,32,12,20
Vandersnátch,garrosh,929,monk,windwalker,16,11,5
Sebbii,twisting-nether,927,monk,windwalker,23,10,13
Touchgodx,blackrock,927,monk,windwalker,26,11,15
Brucilli,dalaran,926,monk,windwalker,54,23,31
Khazàd,archimonde,924,monk,windwalker,17,10,7
Goltigald,archimonde,923,monk,windwalker,29,10,19
Sîstâhfîstâh,kazzak,912,monk,windwalker,15,10,5
Astmönk,archimonde,910,monk,windwalker,24,11,13
Vercya,dun-morogh,910,monk,windwalker,76,29,47
Elahn,outland,909,monk,windwalker,27,10,17
Gidmonk,darkspear,904,monk,windwalker,42,22,20
Armutschkerl,blackhand,904,monk,windwalker,35,12,23
Scorpìon,blackrock,888,monk,windwalker,20,11,9
Flyingraven,magtheridon,880,monk,windwalker,28,10,18
Апесиинка,gordunni,874,monk,windwalker,23,11,12
Broussly,voljin,871,monk,windwalker,36,15,21
Farlopeti,dun-modr,866,monk,windwalker,49,11,38
Freemmrx,kazzak,864,monk,windwalker,12,9,3
Athem,frostwolf,864,monk,windwalker,12,9,3
Larsowns,ragnaros,864,monk,windwalker,12,9,3
Eternalmoose,grim-batol,864,monk,windwalker,12,9,3
Syzztwo,stormscale,864,monk,windwalker,12,9,3
Loordcraft,silvermoon,864,monk,windwalker,12,9,3
Pattafixcrin,blackrock,864,monk,windwalker,12,9,3
Chryan,marécage-de-zangar,864,monk,windwalker,18,9,9
Varea,blackrock,864,monk,windwalker,18,9,9
Gîø,blackmoore,864,monk,windwalker,18,9,9
Brols,dalaran,864,monk,windwalker,18,9,9
Lrizz,argent-dawn,864,monk,windwalker,18,9,9
Gankplank,nemesis,864,monk,windwalker,18,9,9
Weaverman,ragnaros,864,monk,windwalker,18,9,9
Tonikor,kazzak,864,monk,windwalker,18,9,9
Hilfe,stormscale,864,monk,windwalker,18,9,9
Øåæøæøåæ,ravencrest,864,monk,windwalker,18,9,9
Zmile,ragnaros,864,monk,windwalker,18,9,9
Snookzlol,aegwynn,864,monk,windwalker,18,9,9
Notadrâgon,sylvanas,864,monk,windwalker,18,9,9
Nesedondondn,stormscale,864,monk,windwalker,18,9,9
Skriptzy,blackmoore,864,monk,windwalker,18,9,9
Jessie,bloodscalp,864,monk,windwalker,18,9,9
Dorks,sanguino,864,monk,windwalker,24,9,15
Shaokz,sylvanas,863,monk,windwalker,12,9,3
Barneyzan,tarren-mill,863,monk,windwalker,18,9,9
Jakkeez,twisting-nether,863,monk,windwalker,18,9,9
Otp,hyjal,863,monk,windwalker,18,9,9
Alphalus,khaz-modan,863,monk,windwalker,18,9,9
Miýági,blackmoore,863,monk,windwalker,18,9,9
Yeol,ravencrest,863,monk,windwalker,18,9,9
Wâgwân,hyjal,863,monk,windwalker,18,9,9
Gálaxyfist,blackhand,863,monk,windwalker,24,9,15
Thawy,sargeras,863,monk,windwalker,24,9,15
Dearm,burning-legion,863,monk,windwalker,24,9,15
Serizawã,hyjal,862,monk,windwalker,18,9,9
Nouraxo,kazzak,862,monk,windwalker,18,9,9
Krtinse,ravencrest,862,monk,windwalker,18,9,9
Sûûn,hyjal,862,monk,windwalker,18,9,9
Bonkboi,tarren-mill,862,monk,windwalker,24,9,15
Асшез,gordunni,862,monk,windwalker,24,9,15
Пропесочило,gordunni,862,monk,windwalker,28,10,18
Teztouza,kazzak,861,monk,windwalker,18,9,9
Sooyung,kazzak,861,monk,windwalker,18,9,9
Lin,nathrezim,861,monk,windwalker,18,9,9
Tylavie,silvermoon,861,monk,windwalker,18,9,9
Nandromonk,dalaran,861,monk,windwalker,24,9,15
Авентусс,howling-fjord,861,monk,windwalker,24,9,15
Franziskanus,das-syndikat,860,monk,windwalker,24,9,15
Дасний,gordunni,859,monk,windwalker,12,9,3
Jutso,argent-dawn,859,monk,windwalker,15,10,5
Monkariuz,antonidas,859,monk,windwalker,26,9,17
Velita,dun-modr,858,monk,windwalker,27,9,18
Meff,hyjal,855,monk,windwalker,16,10,6
Mozzaks,doomhammer,852,monk,windwalker,12,9,3
Linocence,draenor,849,monk,windwalker,137,68,69
Jujujitsu,archimonde,833,monk,windwalker,41,18,23
Zanizu,blackhand,831,monk,windwalker,14,10,4
Chanzey,silvermoon,831,monk,windwalker,17,9,8
Yamqt,thrall,816,monk,windwalker,27,9,18
Fusetonww,tarren-mill,815,monk,windwalker,17,9,8
Snakozer,elune,815,monk,windwalker,17,9,8
Nichonne,khaz-modan,815,monk,windwalker,30,9,21
Të,ysondre,814,monk,windwalker,21,9,12
Elayja,twisting-nether,809,monk,windwalker,20,10,10
Монкуем,gordunni,802,monk,windwalker,18,9,9
Dushimonk,runetotem,797,monk,windwalker,22,9,13
Karatiy,doomhammer,795,monk,windwalker,99,33,66
Mórrid,draenor,791,monk,windwalker,27,9,18
Shàllýn,antonidas,784,monk,windwalker,19,9,10
Carmismonk,tarren-mill,768,monk,windwalker,12,8,4
Funnymonk,magtheridon,768,monk,windwalker,12,8,4
Slayh,archimonde,768,monk,windwalker,12,8,4
Karels,archimonde,768,monk,windwalker,12,8,4
Rma,twisting-nether,768,monk,windwalker,12,8,4
Luxii,blackmoore,768,monk,windwalker,12,8,4
Arisua,blackhand,768,monk,windwalker,12,8,4
Rezuz,draenor,768,monk,windwalker,12,8,4
Nyaruko,blackrock,768,monk,windwalker,12,8,4
Wladqz,stormscale,768,monk,windwalker,12,8,4
Cuteshygirl,shattrath,768,monk,windwalker,18,8,10
Cptschneider,blackmoore,768,monk,windwalker,18,8,10
Qaanimn,ravencrest,768,monk,windwalker,18,8,10
Skymonkey,kul-tiras,768,monk,windwalker,18,8,10
Чистыйбаер,soulflayer,768,monk,windwalker,18,8,10
Archnun,stormscale,768,monk,windwalker,18,8,10
Jamiedhism,ravencrest,768,monk,windwalker,18,8,10
Meduseqt,ravencrest,768,monk,windwalker,24,8,16
Sungødx,blackrock,768,monk,windwalker,24,8,16
Denau,aegwynn,767,monk,windwalker,12,8,4
Marksanuwu,kilrogg,767,monk,windwalker,12,8,4
Daizz,magtheridon,767,monk,windwalker,12,8,4
Yungbaren,frostwolf,767,monk,windwalker,12,8,4
Nízra,archimonde,767,monk,windwalker,12,8,4
Пашаскороход,gordunni,767,monk,windwalker,12,8,4
Nokitz,kazzak,767,monk,windwalker,18,8,10
Johnsôn,blackmoore,767,monk,windwalker,18,8,10
Pinkcell,sanguino,767,monk,windwalker,18,8,10
Olgachocolat,blackmoore,767,monk,windwalker,18,8,10
Монквв,eversong,767,monk,windwalker,18,8,10
Maifu,thrall,767,monk,windwalker,18,8,10
Пенетраторд,gordunni,767,monk,windwalker,18,8,10
Wutan,burning-legion,767,monk,windwalker,18,8,10
Alurymnk,blackrock,767,monk,windwalker,18,8,10
Bansheerrz,hyjal,767,monk,windwalker,18,8,10
Válkyrìe,ravencrest,767,monk,windwalker,24,8,16
Wilywolxx,silvermoon,766,monk,windwalker,12,8,4
Plsnerfrogue,tarren-mill,766,monk,windwalker,12,8,4
Pocaa,arakarahm,766,monk,windwalker,18,8,10
Кунфуцый,gordunni,766,monk,windwalker,18,8,10
Naynayrb,draenor,766,monk,windwalker,18,8,10
Милиса,grom,764,monk,windwalker,15,9,6
Chiroidz,kazzak,764,monk,windwalker,18,8,10
Nirvanabange,sylvanas,764,monk,windwalker,24,8,16
Ørgasm,magtheridon,763,monk,windwalker,24,8,16
Rangomind,silvermoon,761,monk,windwalker,12,8,4
Sayonarami,frostmane,753,monk,windwalker,18,8,10
Wallky,burning-blade,743,monk,windwalker,30,8,22
Kûma,echsenkessel,735,monk,windwalker,16,8,8
Merjis,stormscale,719,monk,windwalker,17,8,9
Portugas,aegwynn,711,monk,windwalker,28,9,19
Takapotku,silvermoon,703,monk,windwalker,16,8,8
Fredder,blackrock,701,monk,windwalker,23,8,15
Lilßaby,archimonde,672,monk,windwalker,12,7,5
Sizok,blackmoore,672,monk,windwalker,12,7,5
Despéradø,archimonde,672,monk,windwalker,12,7,5
Мягкийпо,howling-fjord,672,monk,windwalker,12,7,5
Saburo,archimonde,672,monk,windwalker,12,7,5
Gargalondeze,twisting-nether,672,monk,windwalker,12,7,5
Pawsy,twisting-nether,672,monk,windwalker,12,7,5
Тэюкимма,gordunni,672,monk,windwalker,12,7,5
Shoelaren,ragnaros,672,monk,windwalker,12,7,5
Thailun,kazzak,672,monk,windwalker,12,7,5
Balanceqt,ravencrest,672,monk,windwalker,12,7,5
Njursten,twilights-hammer,672,monk,windwalker,12,7,5
Skalmirbadut,tarren-mill,672,monk,windwalker,12,7,5
Wowweaver,outland,672,monk,windwalker,12,7,5
Dennismansix,sylvanas,672,monk,windwalker,12,7,5
Månkey,ahnqiraj,672,monk,windwalker,12,7,5
Zerosixtyone,kazzak,672,monk,windwalker,12,7,5
Powz,nordrassil,672,monk,windwalker,12,7,5
Tortasauro,sanguino,672,monk,windwalker,12,7,5
Vixiatwo,outland,672,monk,windwalker,12,7,5
Vetocorleone,kazzak,672,monk,windwalker,12,7,5
Dmeenmonk,kazzak,672,monk,windwalker,12,7,5
Bryggarn,draenor,672,monk,windwalker,12,7,5
Arthanaar,drakthul,672,monk,windwalker,12,7,5
Jekkar,uldum,672,monk,windwalker,12,7,5
Мишадуротар,borean-tundra,672,monk,windwalker,19,9,10
Márliene,twisting-nether,672,monk,windwalker,18,7,11
Mayliene,stormscale,672,monk,windwalker,18,7,11
Elababe,ravencrest,672,monk,windwalker,18,7,11
Xkôra,cthun,672,monk,windwalker,18,7,11
Quï,hyjal,672,monk,windwalker,18,7,11
Çùçé,dalaran,672,monk,windwalker,18,7,11
Бесчувствие,blackscar,672,monk,windwalker,18,7,11
Risingspud,frostmane,672,monk,windwalker,18,7,11
Jkmonkyo,blackrock,672,monk,windwalker,18,7,11
Bloodsports,anubarak,672,monk,windwalker,18,7,11
Quendiz,frostwolf,672,monk,windwalker,24,7,17
Kajï,frostmane,672,monk,windwalker,24,7,17
Maelea,ysondre,671,monk,windwalker,12,7,5
Iluvfistinjk,sylvanas,671,monk,windwalker,12,7,5
Mystikmonk,blackrock,671,monk,windwalker,12,7,5
Dubhira,blackmoore,671,monk,windwalker,12,7,5
Azouko,onyxia,671,monk,windwalker,12,7,5
Sonofelrond,twisting-nether,671,monk,windwalker,12,7,5
Groundnpound,silvermoon,671,monk,windwalker,12,7,5
Эзархадон,lich-king,671,monk,windwalker,12,7,5
Monkacek,drakthul,671,monk,windwalker,12,7,5
Bierdame,blackhand,671,monk,windwalker,12,7,5
Boxarnsgrabb,shattered-hand,671,monk,windwalker,12,7,5
Kawaiitsuki,sanguino,671,monk,windwalker,18,7,11
Vipergaming,aggra-português,671,monk,windwalker,18,7,11
Discosean,frostmane,671,monk,windwalker,18,7,11
Zhiothe,argent-dawn,670,monk,windwalker,12,7,5
Kharnael,hyjal,670,monk,windwalker,12,7,5
Mwoinesamdi,hyjal,670,monk,windwalker,18,7,11
Shaol,stormreaver,669,monk,windwalker,12,7,5
Raychi,draenor,669,monk,windwalker,18,7,11
Мистерхюй,gordunni,669,monk,windwalker,30,7,23
Lewimoäne,khaz-modan,667,monk,windwalker,12,7,5
Pilpoo,magtheridon,665,monk,windwalker,12,7,5
Socialxty,dun-modr,618,monk,windwalker,16,8,8
Mistysausage,silvermoon,616,monk,windwalker,33,8,25
Pïpöu,kirin-tor,607,monk,windwalker,11,7,4
Fistlimc,eredar,576,monk,windwalker,6,6,0
Котэлатэ,gordunni,576,monk,windwalker,6,6,0
Mùtsúræv,ravencrest,576,monk,windwalker,6,6,0
Níko,korgall,576,monk,windwalker,12,6,6
Jollyzug,blackrock,576,monk,windwalker,12,6,6
Zaethh,drakthul,576,monk,windwalker,12,6,6
Vjelan,forscherliga,576,monk,windwalker,12,6,6
Doyoubleed,twisting-nether,576,monk,windwalker,12,6,6
Nyrkkikylpy,ravencrest,576,monk,windwalker,12,6,6
Муаннуар,soulflayer,576,monk,windwalker,12,6,6
Kiial,blackmoore,576,monk,windwalker,12,6,6
Trample,stormscale,576,monk,windwalker,12,6,6
Ilovecravmag,draenor,576,monk,windwalker,12,6,6
Мэрджик,soulflayer,576,monk,windwalker,12,6,6
Gamerboydude,silvermoon,576,monk,windwalker,12,6,6
Geezer,the-maelstrom,576,monk,windwalker,12,6,6
Willempie,stormreaver,576,monk,windwalker,12,6,6
Хмелеварня,goldrinn,576,monk,windwalker,12,6,6
Tossen,ragnaros,576,monk,windwalker,12,6,6
Gramkin,ravencrest,576,monk,windwalker,12,6,6
Fistweavs,ravencrest,576,monk,windwalker,12,6,6
Geochi,tarren-mill,576,monk,windwalker,12,6,6
Ferree,tarren-mill,576,monk,windwalker,12,6,6
Plani,ragnaros,576,monk,windwalker,12,6,6
Ilcooljay,ravencrest,576,monk,windwalker,12,6,6
Zenfoxy,blackrock,576,monk,windwalker,12,6,6
Mcgregors,aszune,576,monk,windwalker,12,6,6
Спортикус,galakrond,576,monk,windwalker,12,6,6
Sæ,kazzak,576,monk,windwalker,12,6,6
Svakkanww,kazzak,576,monk,windwalker,12,6,6
Xàrslòulolz,kazzak,576,monk,windwalker,12,6,6
Rigbone,kazzak,576,monk,windwalker,12,6,6
Аморальнохх,blackscar,576,monk,windwalker,12,6,6
Pâtâpouf,hyjal,576,monk,windwalker,12,6,6
Worasemonk,hyjal,576,monk,windwalker,12,6,6
Bbcmonkinc,aegwynn,576,monk,windwalker,16,7,9
Norgamx,alakir,576,monk,windwalker,18,6,12
Karradine,khaz-modan,576,monk,windwalker,18,6,12
Keisy,kazzak,576,monk,windwalker,18,6,12
Moai,nemesis,576,monk,windwalker,18,6,12
Howkong,archimonde,576,monk,windwalker,18,6,12
Ввмонкпбогх,gordunni,576,monk,windwalker,18,6,12
Xoconut,ravencrest,576,monk,windwalker,18,6,12
Fimis,alonsus,576,monk,windwalker,18,6,12
Кунфумастер,gordunni,576,monk,windwalker,24,6,18
Wingzzy,outland,575,monk,windwalker,6,6,0
Фистермонк,gordunni,575,monk,windwalker,12,6,6
Boojj,kazzak,575,monk,windwalker,12,6,6
Smallmonk,hyjal,575,monk,windwalker,12,6,6
Akkri,tarren-mill,575,monk,windwalker,12,6,6
Woalter,silvermoon,575,monk,windwalker,12,6,6
Teetoor,argent-dawn,575,monk,windwalker,12,6,6
Woknroll,draenor,575,monk,windwalker,12,6,6
Tofast,darksorrow,575,monk,windwalker,12,6,6
Kykymbappe,archimonde,575,monk,windwalker,12,6,6
Okpm,marécage-de-zangar,575,monk,windwalker,12,6,6
Magharald,das-syndikat,575,monk,windwalker,12,6,6
Hôók,blackhand,575,monk,windwalker,12,6,6
Trizeth,grim-batol,575,monk,windwalker,12,6,6
Klotsobunidi,kazzak,575,monk,windwalker,15,7,8
Крэйзимедвед,howling-fjord,575,monk,windwalker,18,6,12
Jaylée,thrall,574,monk,windwalker,12,6,6
Panda,das-syndikat,574,monk,windwalker,24,6,18
Veila,the-maelstrom,573,monk,windwalker,12,6,6
Izabell,bronzebeard,573,monk,windwalker,18,6,12
Mullan,eonar,573,monk,windwalker,24,6,18
What,marécage-de-zangar,572,monk,windwalker,12,6,6
Энвишь,soulflayer,559,monk,windwalker,11,6,5
Жарптыца,gordunni,559,monk,windwalker,17,6,11
Jhiqqui,archimonde,542,monk,windwalker,11,6,5
Hochiminh,eldrethalas,526,monk,windwalker,11,6,5
Kungfupandy,blackmoore,512,monk,windwalker,22,6,16
Everydayrain,ravencrest,511,monk,windwalker,14,6,8
Dasjinso,blackhand,511,monk,windwalker,14,6,8
Kassducu,archimonde,511,monk,windwalker,20,6,14
Eaghor,draenor,510,monk,windwalker,10,6,4
Жекадобряк,howling-fjord,503,monk,windwalker,15,7,8
Флейминго,soulflayer,480,monk,windwalker,6,5,1
Kretoz,stormreaver,480,monk,windwalker,6,5,1
Монкигодх,howling-fjord,480,monk,windwalker,6,5,1
Quasarmonk,ravencrest,480,monk,windwalker,6,5,1
Kapud,twisting-nether,480,monk,windwalker,6,5,1
Nekov,frostmane,480,monk,windwalker,6,5,1
Päjcsi,ragnaros,480,monk,windwalker,6,5,1
Holyrop,aegwynn,480,monk,windwalker,6,5,1
Killabees,stormscale,480,monk,windwalker,6,5,1
Карателькасл,gordunni,480,monk,windwalker,6,5,1
Brutec,blackmoore,480,monk,windwalker,6,5,1
Emptyeyés,kazzak,480,monk,windwalker,6,5,1
Nevertouch,blackrock,480,monk,windwalker,12,5,7
Enrookiejr,aegwynn,480,monk,windwalker,12,5,7
Kaelwind,burning-legion,480,monk,windwalker,12,5,7
Mickjabber,aegwynn,480,monk,windwalker,12,5,7
Plsdontdie,sylvanas,480,monk,windwalker,12,5,7
Pandaria,bronze-dragonflight,480,monk,windwalker,12,5,7
Renegatt,twisting-nether,480,monk,windwalker,12,5,7
Расселкроу,galakrond,480,monk,windwalker,12,5,7
Sermuonelis,kazzak,480,monk,windwalker,12,5,7
Krazylegs,sanguino,480,monk,windwalker,12,5,7
Yeanwoo,burning-legion,480,monk,windwalker,12,5,7
Grintilif,malygos,480,monk,windwalker,12,5,7
Señorzayo,ravencrest,480,monk,windwalker,12,5,7
Synthesize,aerie-peak,480,monk,windwalker,12,5,7
Plingpong,sylvanas,480,monk,windwalker,12,5,7
Killthemonk,rajaxx,480,monk,windwalker,12,5,7
Emejzy,draenor,480,monk,windwalker,12,5,7
Ghettomonk,blackmoore,480,monk,windwalker,12,5,7
Käsefäuste,azshara,480,monk,windwalker,12,5,7
Dertekk,archimonde,480,monk,windwalker,12,5,7
Bimberta,argent-dawn,480,monk,windwalker,12,5,7
Npkwalker,outland,480,monk,windwalker,12,5,7
Aljabbar,ravencrest,480,monk,windwalker,12,5,7
Мяуки,soulflayer,480,monk,windwalker,12,5,7
Крилни,soulflayer,480,monk,windwalker,12,5,7
Kenjibsen,blackhand,480,monk,windwalker,12,5,7
Drfistalot,blackrock,480,monk,windwalker,12,5,7
Øåæøæøåæ,kazzak,480,monk,windwalker,12,5,7
Szoney,blackhand,480,monk,windwalker,12,5,7
Беглыйлаваш,gordunni,480,monk,windwalker,12,5,7
Buddhaissara,ravencrest,480,monk,windwalker,12,5,7
Udon,argent-dawn,480,monk,windwalker,12,5,7
Salesforce,cthun,480,monk,windwalker,12,5,7
Fistus,dentarg,480,monk,windwalker,12,5,7
Áutumnfalls,stormscale,480,monk,windwalker,12,5,7
Hilmisan,ravencrest,480,monk,windwalker,12,5,7
Нагиботар,thermaplugg,480,monk,windwalker,12,5,7
Amislish,draenor,480,monk,windwalker,12,5,7
Pîna,onyxia,480,monk,windwalker,12,5,7
Sneptichitz,draenor,480,monk,windwalker,12,5,7
Celimbrimbor,eredar,480,monk,windwalker,12,5,7
Картезо,gordunni,480,monk,windwalker,12,5,7
Popox,stormreaver,480,monk,windwalker,12,5,7
Medovic,blackmoore,480,monk,windwalker,18,5,13
Microsaft,blackrock,480,monk,windwalker,18,5,13
Elmonkx,onyxia,480,monk,windwalker,18,5,13
Nicetrybuddy,draenor,480,monk,windwalker,18,5,13
Draxaxa,hyjal,480,monk,windwalker,18,5,13
Mobbært,antonidas,480,monk,windwalker,18,5,13
Wartexsenior,khaz-modan,479,monk,windwalker,6,5,1
Zaalleh,draenor,479,monk,windwalker,6,5,1
Zoldicfamily,outland,479,monk,windwalker,12,5,7
Диксэш,ashenvale,479,monk,windwalker,12,5,7
Latify,todeswache,479,monk,windwalker,12,5,7
Sdk,silvermoon,479,monk,windwalker,12,5,7
Alopécida,voljin,479,monk,windwalker,15,6,9
Øñ,cthun,479,monk,windwalker,18,5,13
Effeots,blackrock,479,monk,windwalker,18,5,13
Холанн,greymane,479,monk,windwalker,18,5,13
Mïsted,sylvanas,479,monk,windwalker,18,5,13
Tjukkas,bloodhoof,479,monk,windwalker,24,5,19
Fastblood,kazzak,478,monk,windwalker,18,5,13
Blackdu,drakthul,477,monk,windwalker,16,6,10
Sadwhi,turalyon,472,monk,windwalker,12,5,7
Манамба,blackscar,463,monk,windwalker,17,5,12
Lqp,outland,447,monk,windwalker,11,5,6
Gáchisláyer,kazzak,447,monk,windwalker,17,5,12
Chifù,silvermoon,432,monk,windwalker,19,6,13
Crokmoche,archimonde,428,monk,windwalker,12,7,5
Marqinio,archimonde,426,monk,windwalker,15,7,8
Twdabuser,tarren-mill,415,monk,windwalker,8,5,3
Камагами,howling-fjord,400,monk,windwalker,7,5,2
Криповая,deathguard,400,monk,windwalker,13,5,8
Theoalt,dragonblight,399,monk,windwalker,5,5,0
Лордволкер,gordunni,393,monk,windwalker,16,7,9
Jériícho,khaz-modan,384,monk,windwalker,6,4,2
Monkflexi,draenor,384,monk,windwalker,6,4,2
Palarîns,dalaran,384,monk,windwalker,6,4,2
Ubap,emeriss,384,monk,windwalker,6,4,2
Windstormcro,ragnaros,384,monk,windwalker,6,4,2
Màlydôr,outland,384,monk,windwalker,6,4,2
Justwannaówn,blackrock,384,monk,windwalker,6,4,2
Matexww,frostwhisper,384,monk,windwalker,6,4,2
Catchm,tarren-mill,384,monk,windwalker,6,4,2
Zuny,ravencrest,384,monk,windwalker,6,4,2
Soulspar,ragnaros,384,monk,windwalker,6,4,2
Windvibes,antonidas,384,monk,windwalker,6,4,2
Mystd,hyjal,384,monk,windwalker,6,4,2
Hotfist,outland,384,monk,windwalker,6,4,2
Orenichi,antonidas,384,monk,windwalker,6,4,2
Wushin,antonidas,384,monk,windwalker,6,4,2
Tottle,archimonde,384,monk,windwalker,6,4,2
Rhèa,todeswache,384,monk,windwalker,6,4,2
Sprizzfuaz,blackmoore,384,monk,windwalker,6,4,2
Venersere,eitrigg,384,monk,windwalker,6,4,2
Riggedwind,ragnaros,384,monk,windwalker,6,4,2
Нниндзя,fordragon,384,monk,windwalker,6,4,2
Onn,outland,384,monk,windwalker,6,4,2
Rayids,kazzak,384,monk,windwalker,6,4,2
Asceticism,twisting-nether,384,monk,windwalker,6,4,2
Alâkhai,nerzhul,384,monk,windwalker,6,4,2
Orênda,silvermoon,384,monk,windwalker,6,4,2
Karya,chogall,384,monk,windwalker,6,4,2
Ровк,howling-fjord,384,monk,windwalker,6,4,2
Wingwalker,twisting-nether,384,monk,windwalker,6,4,2
Baisi,blackhand,384,monk,windwalker,6,4,2
Disciprín,tarren-mill,384,monk,windwalker,6,4,2
Piednuques,archimonde,384,monk,windwalker,6,4,2
Karrin,ghostlands,384,monk,windwalker,6,4,2
Shadezz,blackmoore,384,monk,windwalker,6,4,2
Hertel,boulderfist,384,monk,windwalker,6,4,2
Милосердие,eversong,384,monk,windwalker,6,4,2
Dadrael,argent-dawn,384,monk,windwalker,6,4,2
Rugys,ravenholdt,384,monk,windwalker,6,4,2
Tàlo,anachronos,384,monk,windwalker,6,4,2
Larrý,sylvanas,384,monk,windwalker,6,4,2
Clìtfister,silvermoon,384,monk,windwalker,6,4,2
Àyoörts,archimonde,384,monk,windwalker,6,4,2
Møønkëy,archimonde,384,monk,windwalker,6,4,2
Кокпанчер,soulflayer,384,monk,windwalker,6,4,2
Blazeuu,drakthul,384,monk,windwalker,6,4,2
Sepi,hellfire,384,monk,windwalker,6,4,2
Laéna,argent-dawn,384,monk,windwalker,6,4,2
Ciuco,stormscale,384,monk,windwalker,6,4,2
Shailene,kazzak,384,monk,windwalker,6,4,2
Sesh,runetotem,384,monk,windwalker,6,4,2
Tacktix,defias-brotherhood,384,monk,windwalker,6,4,2
Kurtfu,ravencrest,384,monk,windwalker,6,4,2
Saysin,blackrock,384,monk,windwalker,6,4,2
Jetcee,kazzak,384,monk,windwalker,6,4,2
Garmore,blackmoore,384,monk,windwalker,9,5,4
Ожиганов,soulflayer,384,monk,windwalker,12,4,8
Dëvilliä,ragnaros,384,monk,windwalker,12,4,8
Аоепуп,soulflayer,384,monk,windwalker,12,4,8
Гарчи,azuregos,384,monk,windwalker,12,4,8
Loorda,neptulon,384,monk,windwalker,12,4,8
Вамдампощам,blackscar,384,monk,windwalker,12,4,8
Knupi,dalaran,384,monk,windwalker,12,4,8
Scribzz,twisting-nether,384,monk,windwalker,12,4,8
Tyrastel,dalaran,384,monk,windwalker,12,4,8
Billyebbasta,nemesis,384,monk,windwalker,12,4,8
Кириешек,deathguard,384,monk,windwalker,12,4,8
Bytheway,kazzak,384,monk,windwalker,12,4,8
Vaélin,area-52,384,monk,windwalker,12,4,8
Fishweaver,ravencrest,384,monk,windwalker,12,4,8
Møñkgødx,silvermoon,384,monk,windwalker,12,4,8
Axan,drekthar,384,monk,windwalker,12,4,8
Hitmônchan,ravencrest,384,monk,windwalker,12,4,8
Räyh,outland,384,monk,windwalker,12,4,8
Azia,bronzebeard,384,monk,windwalker,12,4,8
Ledoz,ravencrest,384,monk,windwalker,12,4,8
Zarkan,draenor,384,monk,windwalker,12,4,8
Goremancey,draenor,384,monk,windwalker,12,4,8
Ragobd,argent-dawn,384,monk,windwalker,12,4,8
Kushvendorx,silvermoon,384,monk,windwalker,12,4,8
Bluum,ravencrest,384,monk,windwalker,12,4,8
Showmeskillz,blackmoore,384,monk,windwalker,12,4,8
Joachi,outland,384,monk,windwalker,12,4,8
Bigkim,khadgar,384,monk,windwalker,12,4,8
Løkî,culte-de-la-rive-noire,384,monk,windwalker,12,4,8
Fueradeserie,dun-modr,384,monk,windwalker,12,4,8
Blyadislav,ravencrest,384,monk,windwalker,12,4,8
Дзинкс,howling-fjord,384,monk,windwalker,16,4,12
Bombanato,kazzak,384,monk,windwalker,17,4,13
Aesthetìc,draenor,384,monk,windwalker,18,4,14
Softjab,twisting-nether,384,monk,windwalker,18,4,14
Monkkr,argent-dawn,384,monk,windwalker,18,4,14
Dunkfjås,stormscale,384,monk,windwalker,18,4,14
Bbinzu,lothar,383,monk,windwalker,6,4,2
Huion,die-aldor,383,monk,windwalker,6,4,2
Erzull,doomhammer,383,monk,windwalker,11,4,7
Desertctype,burning-legion,367,monk,windwalker,11,4,7
Slight,ragnaros,352,monk,windwalker,10,4,6
Arkhaan,dun-modr,351,monk,windwalker,11,4,7
Youngmonk,tarren-mill,351,monk,windwalker,23,4,19
Benkkei,ysondre,336,monk,windwalker,15,4,11
Shamarinator,kazzak,330,monk,windwalker,15,5,10
Shyriu,kazzak,320,monk,windwalker,10,4,6
Choje,blackmoore,319,monk,windwalker,5,4,1
Банхелоу,ashenvale,319,monk,windwalker,8,4,4
Alë,argent-dawn,319,monk,windwalker,8,4,4
Qtchi,eredar,304,monk,windwalker,19,4,15
Xpobak,ravencrest,288,monk,windwalker,6,3,3
Cribling,stormscale,288,monk,windwalker,6,3,3
Veline,dun-modr,288,monk,windwalker,6,3,3
Tjmnk,ravencrest,288,monk,windwalker,6,3,3
Bg,blackhand,288,monk,windwalker,6,3,3
Monkelibonk,ravencrest,288,monk,windwalker,6,3,3
Deadlytouch,pozzo-delleternità,288,monk,windwalker,6,3,3
Rpzlefisc,archimonde,288,monk,windwalker,6,3,3
Jâycrane,ravencrest,288,monk,windwalker,6,3,3
Testibuul,archimonde,288,monk,windwalker,6,3,3
Parkroy,ravencrest,288,monk,windwalker,6,3,3
Vultzm,draenor,288,monk,windwalker,6,3,3
Guybrúsh,twisting-nether,288,monk,windwalker,6,3,3
Fìstmedaddy,tarren-mill,288,monk,windwalker,6,3,3
Twoßastard,kazzak,288,monk,windwalker,6,3,3
Heijus,tarren-mill,288,monk,windwalker,6,3,3
Sensei,rajaxx,288,monk,windwalker,6,3,3
Рендикаое,soulflayer,288,monk,windwalker,6,3,3
Realfighter,arathor,288,monk,windwalker,6,3,3
Nüffelbüffel,blackrock,288,monk,windwalker,6,3,3
Vayyn,kazzak,288,monk,windwalker,6,3,3
Doash,nemesis,288,monk,windwalker,6,3,3
Marcjess,kazzak,288,monk,windwalker,6,3,3
Møngøwéávé,argent-dawn,288,monk,windwalker,6,3,3
Patîence,silvermoon,288,monk,windwalker,6,3,3
Nibbly,argent-dawn,288,monk,windwalker,6,3,3
Bogopo,kazzak,288,monk,windwalker,6,3,3
Pandathiss,argent-dawn,288,monk,windwalker,6,3,3
Zéná,gilneas,288,monk,windwalker,6,3,3
Aaronm,tarren-mill,288,monk,windwalker,6,3,3
Шаоснов,eversong,288,monk,windwalker,6,3,3
Ariesani,blackmoore,288,monk,windwalker,6,3,3
Старательный,howling-fjord,288,monk,windwalker,6,3,3
Ctrlqx,garona,288,monk,windwalker,6,3,3
Exòar,ravencrest,288,monk,windwalker,6,3,3
Zunixxww,terrordar,288,monk,windwalker,6,3,3
Бреэйн,howling-fjord,288,monk,windwalker,6,3,3
Ratfacè,outland,288,monk,windwalker,6,3,3
Пингкин,deathweaver,288,monk,windwalker,6,3,3
Halümeth,ysondre,288,monk,windwalker,6,3,3
Merqurychi,ravencrest,288,monk,windwalker,6,3,3
Патаомальчик,blackscar,288,monk,windwalker,6,3,3
Woushou,outland,288,monk,windwalker,6,3,3
Zelraqt,burning-steppes,288,monk,windwalker,6,3,3
Adewelee,dalaran,288,monk,windwalker,6,3,3
Droozy,silvermoon,288,monk,windwalker,6,3,3
Vøltha,dalaran,288,monk,windwalker,6,3,3
Velduin,dun-modr,288,monk,windwalker,6,3,3
Kungf,twisting-nether,288,monk,windwalker,6,3,3
Soraora,twisting-nether,288,monk,windwalker,6,3,3
Chakkal,twisting-nether,288,monk,windwalker,6,3,3
Mushush,draenor,288,monk,windwalker,6,3,3
Rickymonktwo,ragnaros,288,monk,windwalker,6,3,3
Stonkss,ragnaros,288,monk,windwalker,6,3,3
Kirosan,ragnaros,288,monk,windwalker,6,3,3
Grippen,ragnaros,288,monk,windwalker,6,3,3
Jakfuki,ragnaros,288,monk,windwalker,6,3,3
Suplift,magtheridon,288,monk,windwalker,6,3,3
Zìnko,eredar,288,monk,windwalker,6,3,3
Sharofi,ravencrest,288,monk,windwalker,6,3,3
Dabaws,draenor,288,monk,windwalker,6,3,3
Лавтян,gordunni,288,monk,windwalker,6,3,3
Gangzone,eredar,288,monk,windwalker,6,3,3
Heavensåway,ysondre,288,monk,windwalker,6,3,3
Tshajek,hyjal,288,monk,windwalker,6,3,3
Koot,ragnaros,288,monk,windwalker,6,3,3
Cranecannon,aegwynn,288,monk,windwalker,7,3,4
Balkanbeastt,draenor,288,monk,windwalker,10,4,6
Hellanmonk,stormscale,288,monk,windwalker,8,3,5
Chówmin,silvermoon,288,monk,windwalker,11,4,7
Koreanswap,nordrassil,288,monk,windwalker,9,3,6
Bambøuéqtz,khaz-modan,288,monk,windwalker,9,3,6
Xiæo,moonglade,288,monk,windwalker,12,3,9
Clamps,darkspear,288,monk,windwalker,12,3,9
Geliôs,kazzak,288,monk,windwalker,12,3,9
Cøbrakaï,archimonde,288,monk,windwalker,12,3,9
Orenjis,kazzak,288,monk,windwalker,12,3,9
Yvètte,ravencrest,288,monk,windwalker,12,3,9
Nerrwhind,sylvanas,288,monk,windwalker,12,3,9
Telarîa,blackhand,288,monk,windwalker,12,3,9
Yunxi,stormreaver,288,monk,windwalker,12,3,9
Xingji,antonidas,288,monk,windwalker,12,3,9
Barylen,outland,288,monk,windwalker,12,3,9
Adis,nerathor,288,monk,windwalker,12,3,9
Spoiry,tarren-mill,288,monk,windwalker,12,3,9
Venac,burning-legion,288,monk,windwalker,12,3,9
Rag,burning-legion,288,monk,windwalker,12,3,9
Mönchfatih,blackhand,288,monk,windwalker,12,3,9
Sustanoon,draenor,288,monk,windwalker,12,3,9
Roxmonk,ravencrest,288,monk,windwalker,12,3,9
Ikasama,culte-de-la-rive-noire,288,monk,windwalker,12,3,9
Jihaaz,nemesis,288,monk,windwalker,13,3,10
Amatara,blackrock,288,monk,windwalker,18,3,15
Kalyxx,agamaggan,288,monk,windwalker,18,3,15
Monkwins,turalyon,287,monk,windwalker,6,3,3
Kungfubaby,hyjal,287,monk,windwalker,6,3,3
Baazoka,blackmoore,287,monk,windwalker,6,3,3
Соловьюх,gordunni,286,monk,windwalker,12,3,9
Syaóran,exodar,286,monk,windwalker,12,3,9
Lemaru,kazzak,271,monk,windwalker,11,3,8
Ходячиймонк,gordunni,256,monk,windwalker,10,3,7
Landiiguru,ragnaros,256,monk,windwalker,10,3,7
Madagazsgar,kazzak,256,monk,windwalker,10,3,7
Пкмлкм,gordunni,255,monk,windwalker,11,3,8
Dolkenm,tarren-mill,240,monk,windwalker,9,4,5
Fancyfists,ravencrest,239,monk,windwalker,5,3,2
Zerno,archimonde,239,monk,windwalker,5,3,2
Tbagman,argent-dawn,234,monk,windwalker,9,4,5
Andrah,blackmoore,234,monk,windwalker,14,4,10
Idointcare,ravencrest,192,monk,windwalker,4,3,1
Bignessb,draenor,192,monk,windwalker,4,3,1
Wickly,stormscale,192,monk,windwalker,10,4,6
Kano,burning-legion,192,monk,windwalker,9,3,6
Фистингкоуч,gordunni,192,monk,windwalker,9,3,6
Paykø,antonidas,192,monk,windwalker,6,2,4
Bloodychi,ravencrest,192,monk,windwalker,6,2,4
Niborc,doomhammer,192,monk,windwalker,6,2,4
Friidam,lightbringer,192,monk,windwalker,6,2,4
Stillflow,draenor,192,monk,windwalker,6,2,4
Îreful,tarren-mill,192,monk,windwalker,6,2,4
Mezeko,stormscale,192,monk,windwalker,6,2,4
Nehjo,blackrock,192,monk,windwalker,6,2,4
Пекник,gordunni,192,monk,windwalker,6,2,4
Deniise,kult-der-verdammten,192,monk,windwalker,6,2,4
Charlês,outland,192,monk,windwalker,6,2,4
Dodoglad,hyjal,192,monk,windwalker,6,2,4
Yaevinn,burning-legion,192,monk,windwalker,6,2,4
Sqedi,draenor,192,monk,windwalker,6,2,4
Псилоцибин,gordunni,192,monk,windwalker,6,2,4
Bobthewild,draenor,192,monk,windwalker,6,2,4
Lxq,blackhand,192,monk,windwalker,6,2,4
Panicfist,stormscale,192,monk,windwalker,6,2,4
Слабодян,gordunni,192,monk,windwalker,6,2,4
Freebîrd,shattered-hand,192,monk,windwalker,6,2,4
Wêntô,aegwynn,192,monk,windwalker,6,2,4
Prycch,twisting-nether,192,monk,windwalker,6,2,4
Twinfists,blackmoore,192,monk,windwalker,6,2,4
Akazuki,frostwolf,192,monk,windwalker,6,2,4
Onepunchgal,silvermoon,192,monk,windwalker,6,2,4
Wahrye,hyjal,192,monk,windwalker,6,2,4
Zynex,twisting-nether,192,monk,windwalker,6,2,4
Bludclart,outland,192,monk,windwalker,6,2,4
Savecdfornxt,blackmoore,192,monk,windwalker,6,2,4
Jackonk,eredar,192,monk,windwalker,6,2,4
Пинкомтебя,gordunni,192,monk,windwalker,6,2,4
Popurita,sanguino,192,monk,windwalker,6,2,4
Manniche,kazzak,192,monk,windwalker,6,2,4
Shïma,sargeras,192,monk,windwalker,6,2,4
Kràk,sargeras,192,monk,windwalker,6,2,4
Akkadianx,ravencrest,192,monk,windwalker,6,2,4
Gabbah,blackrock,192,monk,windwalker,6,2,4
Zýru,ragnaros,192,monk,windwalker,6,2,4
Eynodiggity,blackmoore,192,monk,windwalker,6,2,4
Priosia,ragnaros,192,monk,windwalker,6,2,4
Shadopam,zuljin,192,monk,windwalker,6,2,4
Ранки,lich-king,192,monk,windwalker,6,2,4
Bensó,stormscale,192,monk,windwalker,6,2,4
Codimonk,elune,192,monk,windwalker,6,2,4
Chaosmonk,zuljin,192,monk,windwalker,6,2,4
ßájkà,ravencrest,192,monk,windwalker,6,2,4
Канибальный,gordunni,192,monk,windwalker,6,2,4
Mychigun,ravencrest,192,monk,windwalker,6,2,4
Wteg,emerald-dream,192,monk,windwalker,6,2,4
Stenhård,azjolnerub,192,monk,windwalker,6,2,4
Laxnacke,the-maelstrom,192,monk,windwalker,6,2,4
Jintae,deathwing,192,monk,windwalker,6,2,4
Halat,kazzak,192,monk,windwalker,6,2,4
Subsul,sylvanas,192,monk,windwalker,6,2,4
Fístfillet,twisting-nether,192,monk,windwalker,6,2,4
Bamboosnack,kazzak,192,monk,windwalker,6,2,4
Brùcelee,blackmoore,192,monk,windwalker,6,2,4
Грагдораш,soulflayer,192,monk,windwalker,6,2,4
Майамибитч,howling-fjord,192,monk,windwalker,6,2,4
Дедизшишки,soulflayer,192,monk,windwalker,6,2,4
Minfilla,argent-dawn,192,monk,windwalker,6,2,4
Påiñ,silvermoon,192,monk,windwalker,6,2,4
Frajer,auchindoun,192,monk,windwalker,6,2,4
Kukulelee,ragnaros,192,monk,windwalker,6,2,4
Monktadito,sanguino,192,monk,windwalker,6,2,4
Madinsane,thrall,192,monk,windwalker,6,2,4
Bensil,ravencrest,192,monk,windwalker,6,2,4
Baoton,blackmoore,192,monk,windwalker,6,2,4
Jakamstar,ravencrest,192,monk,windwalker,6,2,4
Kazemja,ragnaros,192,monk,windwalker,6,2,4
Panzerfall,hyjal,192,monk,windwalker,6,2,4
Амекиса,deathguard,192,monk,windwalker,6,2,4
Musclorww,ysondre,192,monk,windwalker,6,2,4
Walterwayne,blackrock,192,monk,windwalker,6,2,4
Youruba,dun-modr,192,monk,windwalker,6,2,4
Nql,kazzak,192,monk,windwalker,6,2,4
Brewroll,ravencrest,192,monk,windwalker,6,2,4
Noctaeth,destromath,192,monk,windwalker,6,2,4
Jojitsu,ravencrest,192,monk,windwalker,6,2,4
Icaena,ravencrest,192,monk,windwalker,6,2,4
Deathpùlse,ravencrest,192,monk,windwalker,6,2,4
Føxy,sunstrider,192,monk,windwalker,6,2,4
Lollonko,kazzak,192,monk,windwalker,6,2,4
Khirazim,ysondre,192,monk,windwalker,6,2,4
Nebelpanda,ravencrest,192,monk,windwalker,6,2,4
Loriodas,tarren-mill,192,monk,windwalker,6,2,4
Lildaddymonk,ravencrest,192,monk,windwalker,6,2,4
Entropî,tarren-mill,192,monk,windwalker,6,2,4
Montybrew,tarren-mill,192,monk,windwalker,6,2,4
Mtmonk,tarren-mill,192,monk,windwalker,6,2,4
Píkachuu,ragnaros,192,monk,windwalker,9,2,7
Mysticpaws,kazzak,192,monk,windwalker,16,3,13
Ronkingkong,ravencrest,192,monk,windwalker,12,2,10
Tongat,ravencrest,192,monk,windwalker,12,2,10
Faxxax,draenor,192,monk,windwalker,12,2,10
Pawpipe,ravencrest,192,monk,windwalker,12,2,10
Shaow,hyjal,192,monk,windwalker,12,2,10
Гнидожор,booty-bay,192,monk,windwalker,12,2,10
Rhatid,twisting-nether,192,monk,windwalker,12,2,10
Schneewase,blackrock,192,monk,windwalker,12,2,10
Rolegsweep,arathor,192,monk,windwalker,12,2,10
Jolsey,sunstrider,192,monk,windwalker,12,2,10
Lilotus,ragnaros,192,monk,windwalker,12,2,10
Bo,malorne,192,monk,windwalker,17,2,15
Yianjih,blackmoore,191,monk,windwalker,6,2,4
Mashalar,ravencrest,191,monk,windwalker,6,2,4
Brêwjob,archimonde,180,monk,windwalker,14,6,8
Bruhgdar,silvermoon,175,monk,windwalker,11,2,9
Resinn,ravencrest,169,monk,windwalker,10,4,6
Nefy,antonidas,159,monk,windwalker,5,2,3
Idkfa,sylvanas,159,monk,windwalker,11,2,9
Atrøciøus,ravencrest,138,monk,windwalker,7,3,4
Jweise,tarren-mill,138,monk,windwalker,7,3,4
Räpeltäjä,stormreaver,138,monk,windwalker,11,4,7
Лайтсих,soulflayer,128,monk,windwalker,4,2,2
Uftis,thrall,127,monk,windwalker,8,2,6
Makïi,archimonde,127,monk,windwalker,8,2,6
Fastpawssk,outland,96,monk,windwalker,22,6,16
Chucknøørys,archimonde,96,monk,windwalker,6,1,5
Jakaron,kazzak,96,monk,windwalker,6,1,5
Bâsarä,archimonde,96,monk,windwalker,6,1,5
Elerith,grim-batol,96,monk,windwalker,6,1,5
Sînge,archimonde,96,monk,windwalker,6,1,5
Tooweezé,outland,96,monk,windwalker,6,1,5
Kinføu,hyjal,96,monk,windwalker,6,1,5
Monkenya,kazzak,96,monk,windwalker,6,1,5
Musaya,chamber-of-aspects,96,monk,windwalker,6,1,5
Absølutvødka,outland,96,monk,windwalker,6,1,5
Бумчака,blackscar,96,monk,windwalker,6,1,5
Lîlpumpx,outland,96,monk,windwalker,6,1,5
Jongoatjones,outland,96,monk,windwalker,6,1,5
Родиер,gordunni,96,monk,windwalker,6,1,5
Warkyra,sanguino,96,monk,windwalker,6,1,5
Móz,sylvanas,96,monk,windwalker,6,1,5
Harislkwamk,aegwynn,96,monk,windwalker,6,1,5
Popen,chamber-of-aspects,96,monk,windwalker,6,1,5
Butrinto,hellfire,96,monk,windwalker,6,1,5
Kaizenthor,runetotem,96,monk,windwalker,6,1,5
Zugzuwg,ahnqiraj,96,monk,windwalker,6,1,5
Мэдсол,soulflayer,96,monk,windwalker,6,1,5
Тиронфлакс,soulflayer,96,monk,windwalker,6,1,5
Синнэрли,soulflayer,96,monk,windwalker,6,1,5
Leonww,kazzak,96,monk,windwalker,6,1,5
Shreedmonk,blackmoore,96,monk,windwalker,6,1,5
Cabbagés,outland,96,monk,windwalker,6,1,5
Fistyouslow,kazzak,96,monk,windwalker,6,1,5
Konnîchîwa,kazzak,96,monk,windwalker,6,1,5
Випик,gordunni,96,monk,windwalker,6,1,5
Мефодийкун,howling-fjord,96,monk,windwalker,6,1,5
Radashin,burning-legion,96,monk,windwalker,6,1,5
Chucknørris,blackhand,96,monk,windwalker,6,1,5
Smâsh,blackhand,96,monk,windwalker,6,1,5
Lgndkw,kazzak,96,monk,windwalker,6,1,5
Kickboxer,burning-legion,96,monk,windwalker,6,1,5
Chimail,blackrock,96,monk,windwalker,6,1,5
Мяяумяу,gordunni,96,monk,windwalker,6,1,5
Doneithné,stormscale,96,monk,windwalker,6,1,5
Mjaweaver,stormscale,96,monk,windwalker,6,1,5
Greytalla,silvermoon,96,monk,windwalker,6,1,5
Nsq,ravencrest,96,monk,windwalker,6,1,5
Dreamworkx,draenor,96,monk,windwalker,6,1,5
Munkyjah,eredar,96,monk,windwalker,6,1,5
Rileyweed,hellscream,96,monk,windwalker,6,1,5
Drlightorc,tarren-mill,96,monk,windwalker,6,1,5
Masbrew,ravencrest,96,monk,windwalker,6,1,5
Yuanshi,sporeggar,96,monk,windwalker,6,1,5
Umbrâsyl,ravencrest,96,monk,windwalker,6,1,5
Cumspiller,ravencrest,96,monk,windwalker,6,1,5
Dudulinda,silvermoon,96,monk,windwalker,6,1,5
Zenzí,ravencrest,96,monk,windwalker,6,1,5
Frêakz,blackmoore,96,monk,windwalker,6,1,5
Castrø,argent-dawn,96,monk,windwalker,6,1,5
Mìcrøb,blackmoore,96,monk,windwalker,6,1,5
Entenburch,blackmoore,96,monk,windwalker,6,1,5
Gøsù,antonidas,96,monk,windwalker,6,1,5
Nightninja,drakthul,96,monk,windwalker,6,1,5
Dark,argent-dawn,96,monk,windwalker,6,1,5
Olympeá,silvermoon,96,monk,windwalker,6,1,5
Sheikheric,draenor,96,monk,windwalker,6,1,5
Dìó,tarren-mill,96,monk,windwalker,6,1,5
Schanabi,dun-morogh,96,monk,windwalker,6,1,5
Varanthyra,argent-dawn,96,monk,windwalker,6,1,5
Gilario,silvermoon,96,monk,windwalker,6,1,5
Kazéshini,doomhammer,96,monk,windwalker,6,1,5
Febris,silvermoon,96,monk,windwalker,6,1,5
Faulpelz,onyxia,96,monk,windwalker,6,1,5
Ônlýféédx,burning-blade,96,monk,windwalker,6,1,5
Lazyfellôw,drakthul,96,monk,windwalker,6,1,5
Dadeldo,blackrock,96,monk,windwalker,12,1,11
Tmhamm,ravencrest,96,monk,windwalker,12,1,11
Mindfreaks,stormscale,96,monk,windwalker,12,1,11
Monkacphp,drakthul,96,monk,windwalker,12,1,11
Araey,argent-dawn,89,monk,windwalker,9,3,6
Aennie,zuljin,84,monk,windwalker,13,4,9
Xtcc,kazzak,79,monk,windwalker,5,1,4
Tenzen,dun-modr,79,monk,windwalker,11,1,10
Skailzkrtwo,hyjal,48,monk,windwalker,3,1,2
Xámell,ravencrest,48,monk,windwalker,3,1,2
Cazgur,twisting-nether,42,monk,windwalker,11,3,8
Monkinko,tarren-mill,42,monk,windwalker,10,2,8
Pjetro,draenor,31,monk,windwalker,2,1,1
Zaxxz,bladefist,15,monk,windwalker,1,1,0
Wiriday,draenor,2204,paladin,holy,672,345,327
Pointguard,blackrock,2180,paladin,holy,84,48,36
Åbx,argent-dawn,2147,paladin,holy,131,66,65
Ránchìek,ravencrest,2124,paladin,holy,102,51,51
Crewxdlolz,frostmane,2123,paladin,holy,211,118,93
Jìmjim,ysondre,2122,paladin,holy,251,131,120
Likkik,ravencrest,2121,paladin,holy,86,42,44
Royki,the-maelstrom,2111,paladin,holy,70,38,32
Odrareg,kazzak,2105,paladin,holy,502,251,251
Алексендлер,howling-fjord,2082,paladin,holy,362,198,164
Vaîjin,aegwynn,2042,paladin,holy,487,255,232
Ranchiek,ravencrest,2019,paladin,holy,60,31,29
Lickssi,outland,2001,paladin,holy,94,56,38
Galaxys,blackhand,1990,paladin,holy,205,107,98
Pêacerainer,stormscale,1989,paladin,holy,357,171,186
Pátish,terenas,1978,paladin,holy,97,45,52
Eldorín,blackmoore,1978,paladin,holy,94,41,53
Trusttp,ravencrest,1969,paladin,holy,71,46,25
Nstea,zuljin,1968,paladin,holy,72,37,35
Gloonî,blackmoore,1964,paladin,holy,77,37,40
Goyimslayer,ravencrest,1960,paladin,holy,294,150,144
Nemebotddos,dun-modr,1940,paladin,holy,101,51,50
Wokyo,tarren-mill,1934,paladin,holy,321,184,137
Seabrook,stormscale,1933,paladin,holy,129,59,70
Zabrok,outland,1928,paladin,holy,94,53,41
Reckx,argent-dawn,1927,paladin,holy,113,50,63
Wheelybin,argent-dawn,1924,paladin,holy,105,46,59
Nemesisbot,dun-modr,1923,paladin,holy,120,66,54
Peacerainer,stormscale,1923,paladin,holy,120,55,65
Strûgglebûs,outland,1920,paladin,holy,89,49,40
Insanez,stormscale,1919,paladin,holy,98,49,49
Wontbubblejk,tarren-mill,1918,paladin,holy,72,33,39
Richiks,outland,1916,paladin,holy,96,50,46
Fashiôn,sylvanas,1916,paladin,holy,48,24,24
Rïzé,ravencrest,1911,paladin,holy,54,26,28
Asfhjagwa,stormscale,1907,paladin,holy,59,35,24
Welivewewin,defias-brotherhood,1902,paladin,holy,205,109,96
Áftershøck,ravencrest,1898,paladin,holy,102,51,51
Dbblou,draenor,1879,paladin,holy,90,44,46
Aww,anachronos,1869,paladin,holy,180,91,89
Rickstone,kazzak,1866,paladin,holy,72,35,37
Goodpeace,kazzak,1865,paladin,holy,103,49,54
Макстипчик,howling-fjord,1859,paladin,holy,81,40,41
Tipmax,ravencrest,1856,paladin,holy,61,37,24
Dyslexineef,defias-brotherhood,1856,paladin,holy,106,53,53
Jeø,stormscale,1854,paladin,holy,60,30,30
Niwariel,silvermoon,1852,paladin,holy,60,37,23
Типмакс,howling-fjord,1851,paladin,holy,42,25,17
Dompèrignon,stormscale,1845,paladin,holy,42,22,20
Hetsuki,tarren-mill,1843,paladin,holy,60,27,33
Shufflenjoyr,argent-dawn,1837,paladin,holy,131,67,64
Optîmuslîme,veklor,1835,paladin,holy,42,27,15
Ajani,la-croisade-écarlate,1828,paladin,holy,60,27,33
Pigpiss,ravencrest,1826,paladin,holy,70,31,39
Andûrîl,tarren-mill,1819,paladin,holy,197,106,91
Kianpal,silvermoon,1818,paladin,holy,158,89,69
Neverlostx,ravencrest,1816,paladin,holy,48,31,17
Popecrusade,archimonde,1813,paladin,holy,107,66,41
Callístó,amanthul,1811,paladin,holy,408,209,199
Isøri,antonidas,1807,paladin,holy,168,92,76
Insonia,frostwolf,1804,paladin,holy,177,101,76
Majör,ysondre,1802,paladin,holy,102,51,51
Powertilt,ravencrest,1801,paladin,holy,207,98,109
Narkal,archimonde,1800,paladin,holy,135,74,61
Wøllymølly,draenor,1799,paladin,holy,102,53,49
Danipaladin,tarren-mill,1776,paladin,holy,100,57,43
Holysacx,aegwynn,1772,paladin,holy,84,48,36
Гола,gordunni,1771,paladin,holy,97,44,53
Lexó,ravencrest,1768,paladin,holy,66,30,36
Tyrsa,defias-brotherhood,1767,paladin,holy,71,31,40
Heilbuch,durotan,1765,paladin,holy,272,147,125
Verlinya,archimonde,1765,paladin,holy,54,29,25
Holylightxz,runetotem,1765,paladin,holy,93,46,47
Shamoo,archimonde,1763,paladin,holy,48,28,20
Valia,argent-dawn,1761,paladin,holy,105,57,48
Лайхтни,gordunni,1761,paladin,holy,70,36,34
Lrnz,tarren-mill,1761,paladin,holy,108,48,60
Everflame,blackmoore,1758,paladin,holy,102,60,42
Whothisguy,ravencrest,1757,paladin,holy,72,35,37
Runtheshôw,tarren-mill,1757,paladin,holy,231,110,121
Kyoma,burning-legion,1757,paladin,holy,197,88,109
Måvé,tarren-mill,1754,paladin,holy,163,90,73
Tibælius,ravencrest,1753,paladin,holy,137,70,67
Flouzz,blackmoore,1750,paladin,holy,120,57,63
Wernøw,archimonde,1746,paladin,holy,39,20,19
Arysur,defias-brotherhood,1745,paladin,holy,560,284,276
Rettyfield,blackrock,1744,paladin,holy,42,23,19
Tibelious,ravencrest,1737,paladin,holy,352,174,178
Jüther,pozzo-delleternità,1736,paladin,holy,35,19,16
Небулариум,howling-fjord,1735,paladin,holy,83,35,48
Phalphlingo,stormscale,1734,paladin,holy,132,60,72
Флэшкапро,soulflayer,1731,paladin,holy,322,171,151
Swâpxy,proudmoore,1728,paladin,holy,72,46,26
Dàrckness,ravencrest,1722,paladin,holy,479,254,225
Tyralia,archimonde,1720,paladin,holy,100,61,39
Máttés,antonidas,1720,paladin,holy,71,28,43
Diffay,tarren-mill,1719,paladin,holy,72,39,33
Флэшкапро,blackscar,1719,paladin,holy,58,31,27
Plaeschrmaex,aegwynn,1718,paladin,holy,72,31,41
Dewastor,veklor,1715,paladin,holy,64,37,27
Хегия,gordunni,1713,paladin,holy,168,92,76
Lofé,drakthul,1713,paladin,holy,92,46,46
Kwinn,aggra-português,1713,paladin,holy,36,18,18
Hearten,outland,1712,paladin,holy,28,19,9
Monkeyclass,blackmoore,1709,paladin,holy,60,30,30
Акунделар,gordunni,1706,paladin,holy,125,63,62
Аришалисичка,blackscar,1704,paladin,holy,82,41,41
Voklane,tarren-mill,1704,paladin,holy,62,30,32
Beefcrusher,outland,1704,paladin,holy,42,18,24
Мускатер,gordunni,1702,paladin,holy,118,59,59
Rezvaya,tarren-mill,1700,paladin,holy,54,22,32
Thaderyl,auchindoun,1699,paladin,holy,308,154,154
Рустиктоп,gordunni,1698,paladin,holy,60,25,35
Jerryhârvey,kazzak,1695,paladin,holy,36,18,18
Гигашмяк,howling-fjord,1694,paladin,holy,304,155,149
Vindîcator,defias-brotherhood,1694,paladin,holy,227,107,120
Padisonmeth,blackmoore,1694,paladin,holy,53,19,34
Фьюжндрайв,gordunni,1693,paladin,holy,36,18,18
Chowo,argent-dawn,1693,paladin,holy,113,54,59
Holysac,aegwynn,1692,paladin,holy,72,39,33
Faíren,mugthol,1692,paladin,holy,96,51,45
Gexx,draenor,1692,paladin,holy,119,57,62
Jûliâ,archimonde,1686,paladin,holy,112,57,55
Moeixu,kazzak,1686,paladin,holy,99,41,58
Rejst,drakthul,1686,paladin,holy,71,29,42
Bécasszelium,varimathras,1685,paladin,holy,339,181,158
Babyboink,kazzak,1685,paladin,holy,59,24,35
Haylø,archimonde,1684,paladin,holy,75,35,40
Skånérost,twisting-nether,1683,paladin,holy,42,25,17
Svyata,twisting-nether,1681,paladin,holy,155,70,85
Drohim,aegwynn,1680,paladin,holy,58,28,30
Lycerax,antonidas,1677,paladin,holy,42,24,18
Thaderÿl,auchindoun,1676,paladin,holy,185,95,90
Necrocursed,blackrock,1676,paladin,holy,48,23,25
Powarpufgirl,blackrock,1668,paladin,holy,65,34,31
Yimnotprot,ravencrest,1668,paladin,holy,72,29,43
Mðnsterz,archimonde,1666,paladin,holy,126,62,64
Holylightxz,archimonde,1666,paladin,holy,48,23,25
Мылонеуроних,deathguard,1665,paladin,holy,83,41,42
Лайтпалочка,soulflayer,1663,paladin,holy,370,185,185
Holysac,kazzak,1662,paladin,holy,42,22,20
Бирко,blackscar,1661,paladin,holy,99,51,48
Дарксайгн,gordunni,1659,paladin,holy,72,28,44
Lexolex,ravencrest,1655,paladin,holy,42,19,23
Stidi,frostmane,1646,paladin,holy,202,102,100
Kreutzfeld,argent-dawn,1645,paladin,holy,36,18,18
Kakii,gorgonnash,1645,paladin,holy,59,24,35
Emloses,outland,1644,paladin,holy,366,185,181
Sheroo,rexxar,1642,paladin,holy,36,20,16
Dömötörp,ragnaros,1642,paladin,holy,207,107,100
Spinne,tarren-mill,1642,paladin,holy,142,71,71
Alphaøne,stormscale,1642,paladin,holy,42,20,22
Minalinsky,colinas-pardas,1641,paladin,holy,165,94,71
Nezâ,blackhand,1640,paladin,holy,82,39,43
Profundus,zuluhed,1640,paladin,holy,102,46,56
Jinyssa,silvermoon,1639,paladin,holy,53,32,21
Celébriel,twisting-nether,1638,paladin,holy,131,74,57
Rekieuna,archimonde,1637,paladin,holy,874,436,438
Crucifiction,balnazzar,1637,paladin,holy,78,38,40
Алукартик,deathguard,1631,paladin,holy,101,54,47
Stratarxis,kazzak,1631,paladin,holy,106,52,54
Святстраж,gordunni,1631,paladin,holy,50,23,27
Baazil,ragnaros,1631,paladin,holy,84,38,46
Shabbyy,bronzebeard,1630,paladin,holy,120,66,54
Derpe,hellscream,1628,paladin,holy,30,17,13
Insanevegan,ravencrest,1628,paladin,holy,66,33,33
Pignonn,dalaran,1628,paladin,holy,255,126,129
Marcope,kazzak,1628,paladin,holy,36,17,19
Umirinbruv,zenedar,1628,paladin,holy,86,37,49
Skailzpal,hyjal,1627,paladin,holy,376,205,171
Smightypal,silvermoon,1626,paladin,holy,147,75,72
Fjorhvor,draenor,1625,paladin,holy,724,373,351
Jeromesavile,tarren-mill,1625,paladin,holy,143,68,75
Lovemomx,argent-dawn,1624,paladin,holy,34,19,15
Banglakesh,draenor,1624,paladin,holy,36,20,16
Jambbo,twisting-nether,1622,paladin,holy,148,81,67
Chosenlight,darkspear,1620,paladin,holy,316,153,163
Yzzy,ravencrest,1617,paladin,holy,293,146,147
Athenewins,tarren-mill,1616,paladin,holy,400,210,190
Crankaess,tarren-mill,1616,paladin,holy,73,37,36
Misarosh,drakthul,1616,paladin,holy,60,28,32
Papasito,tarren-mill,1616,paladin,holy,48,17,31
Рэймондх,gordunni,1613,paladin,holy,84,41,43
Faíren,blackrock,1613,paladin,holy,60,27,33
Percocetx,tarren-mill,1613,paladin,holy,54,24,30
Øøbîatch,archimonde,1612,paladin,holy,84,44,40
Astollfo,hyjal,1610,paladin,holy,54,33,21
Astarox,kazzak,1610,paladin,holy,283,133,150
ßestsacjk,kazzak,1610,paladin,holy,54,22,32
Zondãn,blackrock,1608,paladin,holy,101,54,47
Edelarøs,ysondre,1608,paladin,holy,219,104,115
Holeck,aegwynn,1608,paladin,holy,78,31,47
Ironmikë,outland,1607,paladin,holy,60,38,22
Kaputs,twisting-nether,1606,paladin,holy,31,18,13
Klappzi,outland,1606,paladin,holy,41,20,21
Skyf,outland,1606,paladin,holy,299,141,158
Дэнриэль,howling-fjord,1606,paladin,holy,54,25,29
Vxqt,blackrock,1605,paladin,holy,65,30,35
Expander,draenor,1605,paladin,holy,48,20,28
Buntqt,kazzak,1604,paladin,holy,116,61,55
Джонниджага,blackscar,1604,paladin,holy,58,28,30
Spèédyßoi,eldrethalas,1603,paladin,holy,60,34,26
Kfcmanager,archimonde,1603,paladin,holy,60,30,30
Zendæ,archimonde,1602,paladin,holy,45,25,20
Kristelle,argent-dawn,1602,paladin,holy,271,140,131
Braînbug,blackmoore,1602,paladin,holy,36,18,18
Stepsislana,tarren-mill,1601,paladin,holy,30,17,13
Xelqt,draenor,1601,paladin,holy,134,67,67
Потокденег,howling-fjord,1601,paladin,holy,385,190,195
Emlight,kazzak,1600,paladin,holy,95,49,46
Judgejuryexe,kazzak,1600,paladin,holy,92,44,48
Xray,ahnqiraj,1597,paladin,holy,104,53,51
Myssa,uldum,1596,paladin,holy,60,31,29
Bossedin,aszune,1593,paladin,holy,30,17,13
Thaliasword,sylvanas,1593,paladin,holy,72,34,38
Enemylosers,stormscale,1592,paladin,holy,234,127,107
Tuoppi,steamwheedle-cartel,1591,paladin,holy,138,71,67
Xaérulus,draenor,1590,paladin,holy,95,46,49
Аронасхе,blackscar,1589,paladin,holy,149,69,80
Askmy,stormscale,1588,paladin,holy,75,42,33
Brutalmate,burning-blade,1588,paladin,holy,123,57,66
Mchustler,outland,1588,paladin,holy,66,29,37
Сэлфхил,gordunni,1587,paladin,holy,119,53,66
Юмэйнару,deepholm,1586,paladin,holy,48,27,21
Delicztwo,der-rat-von-dalaran,1586,paladin,holy,54,28,26
Holychît,sanguino,1586,paladin,holy,117,54,63
Hawki,blackmoore,1582,paladin,holy,67,40,27
Xenyaa,arygos,1581,paladin,holy,103,53,50
Fannypoo,sylvanas,1581,paladin,holy,251,122,129
Пчелодин,howling-fjord,1581,paladin,holy,36,17,19
Rookbeef,eredar,1580,paladin,holy,72,41,31
Babaluga,blackrock,1580,paladin,holy,30,17,13
Byoß,ravencrest,1580,paladin,holy,38,17,21
Blazerlolz,kazzak,1578,paladin,holy,107,56,51
Ddomi,dun-modr,1578,paladin,holy,54,24,30
Ринэи,howling-fjord,1577,paladin,holy,33,18,15
Holydeals,silvermoon,1577,paladin,holy,84,40,44
Острит,gordunni,1575,paladin,holy,119,64,55
Waynex,twisting-nether,1574,paladin,holy,70,38,32
Foxywild,aszune,1574,paladin,holy,129,64,65
Pooncy,ragnaros,1574,paladin,holy,84,41,43
Sorfalik,silvermoon,1570,paladin,holy,75,43,32
Sorfalinka,silvermoon,1569,paladin,holy,69,42,27
Sorfalix,silvermoon,1568,paladin,holy,42,20,22
Soád,stormscale,1567,paladin,holy,36,18,18
Wíw,kazzak,1567,paladin,holy,184,90,94
Zaphiri,pozzo-delleternità,1567,paladin,holy,61,28,33
Defnotsikaan,blackhand,1565,paladin,holy,90,43,47
Ulumoo,tarren-mill,1564,paladin,holy,36,18,18
Stinkepieet,blackmoore,1563,paladin,holy,251,131,120
Gigaheals,ravencrest,1562,paladin,holy,60,39,21
Luxxorr,outland,1561,paladin,holy,106,62,44
Nîkå,ravencrest,1561,paladin,holy,109,62,47
Femaleelf,eredar,1561,paladin,holy,48,20,28
Dylodin,silvermoon,1560,paladin,holy,49,24,25
Cptlighter,draenor,1559,paladin,holy,53,19,34
Artherius,silvermoon,1558,paladin,holy,103,64,39
Pullheavy,silvermoon,1557,paladin,holy,346,176,170
Arenalena,sylvanas,1555,paladin,holy,217,111,106
Erao,the-maelstrom,1554,paladin,holy,48,24,24
Neverbuble,archimonde,1554,paladin,holy,181,90,91
Padrak,eredar,1554,paladin,holy,39,17,22
Skurly,ragnaros,1551,paladin,holy,42,19,23
Факофф,gordunni,1549,paladin,holy,114,62,52
Obviously,echsenkessel,1549,paladin,holy,75,35,40
Döug,archimonde,1548,paladin,holy,66,34,32
Pablok,minahonda,1548,paladin,holy,48,17,31
Ðelusion,sanguino,1547,paladin,holy,37,19,18
Mistsx,kazzak,1546,paladin,holy,60,27,33
Andronar,blackmoore,1545,paladin,holy,114,54,60
Nåmï,culte-de-la-rive-noire,1543,paladin,holy,72,41,31
Срувтапкизз,blackscar,1543,paladin,holy,89,32,57
Rëtnuhka,drakthul,1542,paladin,holy,99,49,50
Ашкаил,fordragon,1542,paladin,holy,48,20,28
Chryme,thrall,1541,paladin,holy,96,48,48
Зинарэмпейдж,gordunni,1539,paladin,holy,102,51,51
Тошанич,soulflayer,1539,paladin,holy,54,24,30
Ìschtarsdad,blackrock,1538,paladin,holy,228,112,116
Stepsisbro,twisting-nether,1537,paladin,holy,42,25,17
Мифариан,blackscar,1536,paladin,holy,297,151,146
Nimeron,ravencrest,1536,paladin,holy,120,60,60
Louiepal,outland,1535,paladin,holy,53,29,24
Sweestance,minahonda,1531,paladin,holy,364,188,176
Lóde,silvermoon,1530,paladin,holy,148,77,71
Jcbubs,xavius,1528,paladin,holy,234,114,120
Леонящер,gordunni,1527,paladin,holy,323,177,146
Injection,khaz-modan,1527,paladin,holy,181,89,92
Irefutabila,stormscale,1527,paladin,holy,112,51,61
Бадбх,howling-fjord,1527,paladin,holy,90,39,51
Солфф,gordunni,1526,paladin,holy,146,71,75
Böllerbarbie,silvermoon,1525,paladin,holy,94,56,38
Fløcki,blackhand,1525,paladin,holy,232,119,113
Marygueguete,archimonde,1525,paladin,holy,132,66,66
Búbblicioús,ravencrest,1524,paladin,holy,90,52,38
Itsjulie,sylvanas,1523,paladin,holy,130,59,71
Easypala,blackrock,1521,paladin,holy,180,80,100
Холлихэйт,howling-fjord,1520,paladin,holy,273,136,137
Fúrion,burning-blade,1520,paladin,holy,60,26,34
Elsewhere,archimonde,1519,paladin,holy,119,54,65
Crystal,thrall,1517,paladin,holy,54,33,21
Скайлайтх,soulflayer,1515,paladin,holy,48,25,23
Cerinae,tarren-mill,1515,paladin,holy,168,87,81
Cahirs,ravencrest,1514,paladin,holy,66,24,42
Sweetjane,deathwing,1513,paladin,holy,53,28,25
Gasilol,frostwolf,1512,paladin,holy,129,63,66
Nefarius,malganis,1512,paladin,holy,71,34,37
Думгохан,howling-fjord,1512,paladin,holy,159,68,91
Wingcomandêr,aegwynn,1510,paladin,holy,60,27,33
Skinstructor,silvermoon,1509,paladin,holy,114,61,53
Sncx,ravencrest,1508,paladin,holy,95,48,47
Hairybabe,outland,1507,paladin,holy,102,58,44
Holycoomer,silvermoon,1507,paladin,holy,44,22,22
Эндемичный,soulflayer,1506,paladin,holy,90,50,40
Fatmidget,kazzak,1503,paladin,holy,66,43,23
Spårvagn,draenor,1502,paladin,holy,84,41,43
Polixeni,draenor,1502,paladin,holy,54,16,38
Catpoopnacho,blackmoore,1500,paladin,holy,90,52,38
Dathróhán,silvermoon,1499,paladin,holy,451,227,224
Aese,dun-modr,1499,paladin,holy,102,51,51
Вивай,howling-fjord,1499,paladin,holy,47,21,26
Drident,die-nachtwache,1499,paladin,holy,54,24,30
Knoxblue,tarren-mill,1497,paladin,holy,162,84,78
Sübôvîñ,ravencrest,1497,paladin,holy,135,69,66
Pamee,blackrock,1497,paladin,holy,42,20,22
Delmothounet,ysondre,1496,paladin,holy,46,28,18
Konane,drekthar,1495,paladin,holy,49,24,25
Sonil,les-sentinelles,1495,paladin,holy,108,51,57
Curtfizzle,kazzak,1493,paladin,holy,155,74,81
Superalt,archimonde,1490,paladin,holy,48,26,22
Vadomar,emerald-dream,1488,paladin,holy,136,67,69
Hirolde,zenedar,1487,paladin,holy,128,61,67
Shaevira,ravencrest,1487,paladin,holy,66,30,36
Бэнкли,soulflayer,1486,paladin,holy,188,105,83
Deodas,kazzak,1486,paladin,holy,823,405,418
Крусейдор,soulflayer,1486,paladin,holy,165,79,86
Surian,kazzak,1486,paladin,holy,111,51,60
Pisr,draenor,1486,paladin,holy,90,37,53
Холиэвил,gordunni,1485,paladin,holy,96,50,46
Asenae,draenor,1485,paladin,holy,84,33,51
Всехилящий,gordunni,1482,paladin,holy,138,64,74
Relativy,xavius,1482,paladin,holy,84,38,46
Divinetollen,ravencrest,1482,paladin,holy,80,35,45
Drzärc,sanguino,1481,paladin,holy,66,31,35
Aachenbrand,blackhand,1480,paladin,holy,221,105,116
Preyy,eredar,1479,paladin,holy,104,58,46
Снупарь,blackscar,1479,paladin,holy,198,100,98
Nemesi,archimonde,1476,paladin,holy,81,40,41
Ayuwings,ravencrest,1476,paladin,holy,48,22,26
Линвэль,gordunni,1475,paladin,holy,74,37,37
Ауди,howling-fjord,1475,paladin,holy,66,24,42
Эллиарэй,gordunni,1474,paladin,holy,146,71,75
Кизарыч,galakrond,1474,paladin,holy,81,32,49
Дифицит,blackscar,1473,paladin,holy,171,94,77
Ирестли,azuregos,1473,paladin,holy,126,62,64
Screws,dun-modr,1473,paladin,holy,50,18,32
Alessaqas,ravencrest,1471,paladin,holy,107,52,55
Hýpærpøp,ravencrest,1471,paladin,holy,60,25,35
Penth,doomhammer,1471,paladin,holy,44,18,26
Анофарин,gordunni,1470,paladin,holy,90,53,37
Imapala,tarren-mill,1470,paladin,holy,36,19,17
Chocòbon,archimonde,1469,paladin,holy,218,117,101
Alphä,auchindoun,1468,paladin,holy,36,19,17
Wizqy,ravencrest,1468,paladin,holy,108,50,58
Selphii,twisting-nether,1467,paladin,holy,46,23,23
Витёнокь,howling-fjord,1466,paladin,holy,175,99,76
Sofishoida,blackmoore,1466,paladin,holy,120,66,54
Séphiran,hyjal,1464,paladin,holy,65,35,30
Iwillbeing,ragnaros,1464,paladin,holy,84,40,44
Hpal,aegwynn,1464,paladin,holy,135,62,73
Zerafic,sylvanas,1464,paladin,holy,110,41,69
Snigglz,blackhand,1463,paladin,holy,30,16,14
Hezerothys,draenor,1461,paladin,holy,170,89,81
Jajmentx,kazzak,1460,paladin,holy,93,48,45
Эсерпи,gordunni,1460,paladin,holy,389,198,191
Devinèqt,tarren-mill,1459,paladin,holy,121,63,58
Shaleq,cthun,1455,paladin,holy,53,26,27
Xsÿde,archimonde,1455,paladin,holy,160,72,88
Realpalla,ravenholdt,1452,paladin,holy,126,62,64
Archaegis,silvermoon,1452,paladin,holy,48,19,29
Pureballer,twisting-nether,1451,paladin,holy,41,21,20
Judgealdo,sylvanas,1448,paladin,holy,74,44,30
Scrimple,stormscale,1447,paladin,holy,73,35,38
Nsk,sylvanas,1446,paladin,holy,93,43,50
Djspresty,ravencrest,1445,paladin,holy,40,21,19
Powerpufgirl,blackrock,1445,paladin,holy,88,41,47
Jaesa,lordaeron,1445,paladin,holy,97,43,54
Curufin,grim-batol,1444,paladin,holy,205,108,97
Сашафистинг,gordunni,1443,paladin,holy,321,163,158
Trez,blackmoore,1442,paladin,holy,31,18,13
Даниэль,howling-fjord,1442,paladin,holy,211,116,95
Ðenlox,destromath,1442,paladin,holy,157,81,76
Koksinatorx,stormscale,1442,paladin,holy,83,41,42
Ðantey,blackmoore,1441,paladin,holy,43,24,19
Présidential,grim-batol,1441,paladin,holy,59,28,31
Aebî,dalaran,1440,paladin,holy,84,48,36
Коварное,borean-tundra,1440,paladin,holy,52,25,27
Thaifo,silvermoon,1439,paladin,holy,33,20,13
Pokébowl,outland,1439,paladin,holy,213,114,99
Pênnywisee,blackhand,1439,paladin,holy,53,28,25
Maitrelampe,argent-dawn,1439,paladin,holy,96,49,47
Móeixü,silvermoon,1438,paladin,holy,36,16,20
Уретроград,soulflayer,1436,paladin,holy,72,36,36
Lucá,silvermoon,1435,paladin,holy,59,31,28
Lastaid,azshara,1435,paladin,holy,313,157,156
Эвердрим,soulflayer,1435,paladin,holy,70,29,41
Этосальвабро,lich-king,1435,paladin,holy,98,38,60
Ilj,archimonde,1433,paladin,holy,83,50,33
Cameron,taerar,1433,paladin,holy,36,17,19
Louiepalmoo,outland,1433,paladin,holy,52,23,29
Mercedes,arthas,1431,paladin,holy,82,43,39
Elvandara,blackmoore,1431,paladin,holy,149,68,81
Thoarin,blackmoore,1430,paladin,holy,75,36,39
Салфеточник,thermaplugg,1430,paladin,holy,114,53,61
Locofatguy,drakthul,1429,paladin,holy,184,89,95
Tiffanyqt,frostwolf,1428,paladin,holy,24,16,8
Toohotty,archimonde,1428,paladin,holy,53,22,31
Antivírus,eredar,1427,paladin,holy,60,37,23
Sacbøt,stormscale,1427,paladin,holy,259,132,127
Mefistôfeles,dun-modr,1427,paladin,holy,45,16,29
Herzel,argent-dawn,1426,paladin,holy,168,85,83
Goodbit,dentarg,1425,paladin,holy,98,58,40
Kwenu,tarren-mill,1425,paladin,holy,214,110,104
Волнысвета,howling-fjord,1424,paladin,holy,122,64,58
Taiso,alonsus,1422,paladin,holy,132,64,68
Talimañ,kazzak,1421,paladin,holy,90,51,39
Norandel,turalyon,1421,paladin,holy,100,40,60
Wyllian,grim-batol,1420,paladin,holy,125,70,55
Брилз,soulflayer,1420,paladin,holy,202,100,102
Lofotof,silvermoon,1419,paladin,holy,30,17,13
Rullstolen,the-maelstrom,1418,paladin,holy,72,42,30
Aiyäna,argent-dawn,1418,paladin,holy,125,56,69
Cykond,eredar,1417,paladin,holy,34,24,10
Mamporro,dun-modr,1417,paladin,holy,54,28,26
Naylaeh,draenor,1417,paladin,holy,36,18,18
Erathoor,grim-batol,1417,paladin,holy,90,37,53
Phalex,outland,1416,paladin,holy,36,23,13
Глиндес,gordunni,1416,paladin,holy,186,88,98
Demytxx,silvermoon,1416,paladin,holy,49,18,31
Îiî,archimonde,1415,paladin,holy,54,27,27
Holydawnx,kazzak,1415,paladin,holy,128,63,65
Cykadin,dun-modr,1415,paladin,holy,96,43,53
Bhlessings,ravencrest,1415,paladin,holy,92,36,56
Vuup,silvermoon,1414,paladin,holy,199,108,91
Zilu,kazzak,1413,paladin,holy,47,24,23
Wepalapvpbop,ravencrest,1413,paladin,holy,30,15,15
Shivxpal,sanguino,1412,paladin,holy,77,45,32
Wellmet,stormreaver,1412,paladin,holy,48,25,23
Heilgaharald,blackrock,1412,paladin,holy,158,80,78
Uzuriel,chogall,1412,paladin,holy,590,285,305
Juicycheeks,frostwolf,1411,paladin,holy,98,40,58
Nudzolini,tarren-mill,1409,paladin,holy,42,28,14
Coopz,defias-brotherhood,1409,paladin,holy,60,32,28
Åsaruki,emerald-dream,1409,paladin,holy,90,46,44
Эверейс,howling-fjord,1408,paladin,holy,59,29,30
Gzerloth,ragnaros,1407,paladin,holy,36,15,21
Blessedpapi,draenor,1406,paladin,holy,72,32,40
Pb,twilights-hammer,1405,paladin,holy,24,16,8
Ванябублгам,soulflayer,1405,paladin,holy,74,35,39
Diamir,rajaxx,1404,paladin,holy,75,55,20
Dlfî,hyjal,1404,paladin,holy,114,64,50
Lightbrîng,hyjal,1403,paladin,holy,71,38,33
Solazola,blackmoore,1402,paladin,holy,30,16,14
Alciera,silvermoon,1402,paladin,holy,60,27,33
Омнилайт,soulflayer,1402,paladin,holy,61,25,36
Liendry,antonidas,1401,paladin,holy,132,61,71
Honeygodx,antonidas,1399,paladin,holy,57,31,26
Scholzpala,twisting-nether,1398,paladin,holy,72,42,30
Nerdpallyx,tarren-mill,1398,paladin,holy,157,75,82
Aíe,draenor,1397,paladin,holy,157,79,78
Deathsfate,defias-brotherhood,1397,paladin,holy,39,18,21
Emilíá,kazzak,1395,paladin,holy,36,21,15
Gimch,magtheridon,1395,paladin,holy,72,40,32
Fourshaw,ravencrest,1395,paladin,holy,216,109,107
Alithanari,twisting-nether,1394,paladin,holy,89,47,42
Zycqo,silvermoon,1394,paladin,holy,203,100,103
Eline,zenedar,1393,paladin,holy,90,42,48
Pegason,twisting-nether,1391,paladin,holy,89,52,37
Palablaze,sylvanas,1389,paladin,holy,130,66,64
Expot,blackmoore,1387,paladin,holy,60,34,26
Грор,galakrond,1387,paladin,holy,109,50,59
Aerwyna,draenor,1386,paladin,holy,22,15,7
Ondx,silvermoon,1386,paladin,holy,30,15,15
Veléxis,outland,1386,paladin,holy,109,53,56
Fenye,twisting-nether,1386,paladin,holy,68,32,36
Эскейпми,howling-fjord,1385,paladin,holy,35,18,17
Цитология,borean-tundra,1385,paladin,holy,146,74,72
Enyol,stormscale,1384,paladin,holy,98,53,45
Beecq,tarren-mill,1384,paladin,holy,65,35,30
Xenaké,kazzak,1384,paladin,holy,355,166,189
Lightaldo,bladefist,1383,paladin,holy,66,43,23
Noliferx,ravencrest,1383,paladin,holy,82,49,33
Ðuïvel,grim-batol,1382,paladin,holy,52,22,30
Кольт,borean-tundra,1381,paladin,holy,157,81,76
Ekzykes,ravencrest,1379,paladin,holy,85,42,43
Kapigodx,suramar,1378,paladin,holy,241,129,112
Danepala,defias-brotherhood,1378,paladin,holy,59,29,30
Ретриксвета,eversong,1377,paladin,holy,64,37,27
Abroxis,alleria,1377,paladin,holy,69,37,32
Gabriev,twisting-nether,1376,paladin,holy,49,25,24
Mønargøras,blackrock,1375,paladin,holy,96,40,56
Nusbie,argent-dawn,1375,paladin,holy,41,16,25
Mestgone,dalaran,1373,paladin,holy,99,47,52
Badckes,sylvanas,1373,paladin,holy,140,66,74
Lithera,outland,1372,paladin,holy,48,22,26
Kantfyrste,ravencrest,1372,paladin,holy,145,61,84
Сатангодх,gordunni,1372,paladin,holy,144,58,86
Døgstømper,outland,1370,paladin,holy,29,15,14
Mikemyers,blackhand,1370,paladin,holy,48,24,24
Eoox,outland,1370,paladin,holy,48,23,25
Лимфома,goldrinn,1370,paladin,holy,91,39,52
Antragon,nathrezim,1368,paladin,holy,54,21,33
Vivalabeef,stormscale,1367,paladin,holy,60,26,34
Dimetrix,stormscale,1367,paladin,holy,65,26,39
Jackieb,dun-modr,1367,paladin,holy,63,24,39
Listina,twisting-nether,1366,paladin,holy,42,21,21
Claudîax,kazzak,1366,paladin,holy,117,51,66
Клэйсонгодхх,gordunni,1366,paladin,holy,49,21,28
Висперок,soulflayer,1365,paladin,holy,24,16,8
Mecah,hyjal,1365,paladin,holy,42,21,21
Shakalol,dun-modr,1365,paladin,holy,108,48,60
Kîsyhrâ,aegwynn,1365,paladin,holy,42,16,26
Chewwaka,bloodhoof,1362,paladin,holy,47,23,24
Ztiina,tarren-mill,1361,paladin,holy,114,54,60
Ramos,aggra-português,1360,paladin,holy,60,22,38
Ассантийка,deathguard,1358,paladin,holy,45,21,24
Steggeh,argent-dawn,1358,paladin,holy,150,64,86
Ostardo,blackhand,1357,paladin,holy,24,15,9
Wàtchmedánce,blackhand,1356,paladin,holy,42,28,14
Реколори,gordunni,1356,paladin,holy,217,115,102
Рэймета,soulflayer,1356,paladin,holy,48,21,27
Starfula,archimonde,1355,paladin,holy,102,59,43
Keltinne,ysondre,1354,paladin,holy,87,51,36
Cozm,silvermoon,1353,paladin,holy,144,65,79
Arand,blackrock,1352,paladin,holy,139,79,60
Bubblig,silvermoon,1352,paladin,holy,54,24,30
Палуф,deathguard,1351,paladin,holy,47,28,19
Lazyknight,silvermoon,1351,paladin,holy,72,32,40
Паладинас,lich-king,1351,paladin,holy,82,26,56
Инблумхх,blackscar,1350,paladin,holy,48,24,24
Maxôr,norgannon,1349,paladin,holy,124,66,58
Raeven,arygos,1349,paladin,holy,378,179,199
Wize,steamwheedle-cartel,1349,paladin,holy,111,50,61
Rookzter,sylvanas,1348,paladin,holy,132,69,63
Demecir,twisting-nether,1348,paladin,holy,299,151,148
Pennyxx,outland,1346,paladin,holy,23,15,8
Demonskiller,alakir,1346,paladin,holy,89,47,42
Dogmatic,blackmoore,1346,paladin,holy,36,18,18
Superpiniouf,archimonde,1345,paladin,holy,37,15,22
Flavitwink,hyjal,1343,paladin,holy,30,17,13
Grimbold,hellfire,1343,paladin,holy,66,37,29
Gefix,archimonde,1342,paladin,holy,48,18,30
Yonì,thrall,1341,paladin,holy,30,21,9
Lapew,eredar,1341,paladin,holy,51,26,25
Arlette,moonglade,1341,paladin,holy,90,41,49
Холишоок,gordunni,1341,paladin,holy,36,14,22
Bezvakost,thunderhorn,1339,paladin,holy,66,31,35
Rivanii,kazzak,1338,paladin,holy,165,86,79
Itsgossiplol,twisting-nether,1338,paladin,holy,205,104,101
Nano,veknilash,1338,paladin,holy,142,63,79
Plasmádieter,blackrock,1337,paladin,holy,67,30,37
Freaak,dethecus,1337,paladin,holy,60,24,36
Omhz,ravencrest,1336,paladin,holy,38,21,17
Slezz,tarren-mill,1336,paladin,holy,437,221,216
Pârabellum,the-maelstrom,1336,paladin,holy,54,27,27
Holiguy,twisting-nether,1333,paladin,holy,221,123,98
Kocovic,tarren-mill,1333,paladin,holy,54,29,25
Anythíng,kazzak,1333,paladin,holy,121,61,60
Hellphrodite,aegwynn,1332,paladin,holy,96,51,45
Fleshgraft,silvermoon,1332,paladin,holy,85,40,45
Reakan,tarren-mill,1331,paladin,holy,24,14,10
Mitsaklas,grim-batol,1331,paladin,holy,227,104,123
Pappipala,tarren-mill,1330,paladin,holy,66,31,35
Кардеро,gordunni,1329,paladin,holy,171,91,80
Skolisse,kazzak,1328,paladin,holy,262,139,123
Polydeukis,stormscale,1328,paladin,holy,127,56,71
Hamish,boulderfist,1327,paladin,holy,36,19,17
Бэдмэн,deathguard,1327,paladin,holy,53,16,37
Axpala,ragnaros,1326,paladin,holy,46,24,22
Sixtynien,outland,1326,paladin,holy,88,45,43
Thraìn,ravencrest,1325,paladin,holy,107,48,59
Shiøn,zuljin,1325,paladin,holy,64,27,37
Джонигодх,gordunni,1325,paladin,holy,48,19,29
Paiadinho,malganis,1324,paladin,holy,131,57,74
Watras,drakthul,1324,paladin,holy,72,26,46
Mefistofe,sanguino,1323,paladin,holy,48,23,25
Satipal,sargeras,1323,paladin,holy,153,67,86
Aytu,blackmoore,1321,paladin,holy,39,19,20
Palasaadka,dun-modr,1321,paladin,holy,30,14,16
Savalibarx,outland,1320,paladin,holy,42,24,18
Nde,silvermoon,1320,paladin,holy,47,20,27
Holynstuff,auchindoun,1319,paladin,holy,49,32,17
Seinz,talnivarr,1319,paladin,holy,154,79,75
Gucix,sylvanas,1319,paladin,holy,95,42,53
Minouminou,archimonde,1318,paladin,holy,42,26,16
Hîfi,blackmoore,1318,paladin,holy,243,131,112
Bovinequeef,twisting-nether,1318,paladin,holy,48,25,23
Дезоиль,gordunni,1317,paladin,holy,36,14,22
Zodshock,stormscale,1316,paladin,holy,90,43,47
Vonat,outland,1316,paladin,holy,70,29,41
Crusherpala,laughing-skull,1316,paladin,holy,83,33,50
Свээги,gordunni,1315,paladin,holy,68,37,31
Holyfrick,kazzak,1315,paladin,holy,60,28,32
Sangriul,outland,1315,paladin,holy,135,57,78
Ðeswynd,hyjal,1315,paladin,holy,101,42,59
Rorschy,twisting-nether,1314,paladin,holy,24,14,10
Toxicmo,kazzak,1313,paladin,holy,31,21,10
Xila,blackrock,1312,paladin,holy,44,22,22
Hëüss,suramar,1312,paladin,holy,41,19,22
Lugnals,hyjal,1311,paladin,holy,367,179,188
Borndark,stormscale,1311,paladin,holy,144,63,81
Agadin,ysondre,1310,paladin,holy,35,19,16
Minpaladin,aegwynn,1310,paladin,holy,34,15,19
Tohki,darkmoon-faire,1310,paladin,holy,42,17,25
Европпа,soulflayer,1310,paladin,holy,155,61,94
Noskillze,ravencrest,1309,paladin,holy,48,25,23
Gegge,kazzak,1308,paladin,holy,62,26,36
Rookx,stormscale,1308,paladin,holy,66,23,43
Mythsion,blackmoore,1307,paladin,holy,36,16,20
Daizen,blackrock,1306,paladin,holy,67,45,22
Malodos,archimonde,1306,paladin,holy,86,44,42
Skengdaddy,ragnaros,1306,paladin,holy,84,39,45
Holypapa,argent-dawn,1305,paladin,holy,125,60,65
Tyktyk,draenor,1304,paladin,holy,60,33,27
Ginbeam,aegwynn,1304,paladin,holy,190,93,97
Raleknrnr,hyjal,1304,paladin,holy,30,14,16
Alard,sanguino,1303,paladin,holy,168,78,90
Подлыйдим,fordragon,1303,paladin,holy,84,34,50
Иммунитетх,gordunni,1303,paladin,holy,72,29,43
Meldi,dalaran,1302,paladin,holy,36,14,22
Croaton,burning-legion,1301,paladin,holy,24,14,10
Drdeus,kazzak,1301,paladin,holy,189,93,96
Демига,ashenvale,1301,paladin,holy,30,14,16
Evo,drakthul,1301,paladin,holy,55,25,30
Shaggybeard,frostmane,1301,paladin,holy,36,15,21
Truko,frostwolf,1300,paladin,holy,36,16,20
Bladê,kazzak,1299,paladin,holy,66,26,40
Ugolf,kazzak,1298,paladin,holy,162,83,79
Æmiø,blackmoore,1298,paladin,holy,59,27,32
Kiingslayeer,kilrogg,1298,paladin,holy,63,28,35
Rotana,eredar,1297,paladin,holy,45,25,20
Soreser,skullcrusher,1297,paladin,holy,42,22,20
Heimdalen,moonglade,1297,paladin,holy,48,22,26
Ecormcpx,eredar,1297,paladin,holy,44,16,28
Pussdocta,ravencrest,1294,paladin,holy,101,52,49
Rekolon,antonidas,1294,paladin,holy,400,205,195
Ardentlight,quelthalas,1292,paladin,holy,42,23,19
Dovadin,sylvanas,1291,paladin,holy,67,31,36
Paladins,archimonde,1290,paladin,holy,63,35,28
Bloodsoldier,twisting-nether,1290,paladin,holy,135,70,65
Bagull,zuljin,1290,paladin,holy,106,50,56
Archîmondê,marécage-de-zangar,1290,paladin,holy,48,14,34
Mvppaladin,thrall,1289,paladin,holy,30,18,12
Opopoï,dalaran,1289,paladin,holy,42,24,18
Valkhana,draenor,1289,paladin,holy,70,37,33
Slâyerous,draenor,1289,paladin,holy,77,32,45
Зондарк,booty-bay,1289,paladin,holy,77,31,46
Tíep,blackmoore,1288,paladin,holy,103,53,50
Ниссида,blackscar,1286,paladin,holy,77,37,40
Feîxo,ravencrest,1286,paladin,holy,30,14,16
Snajajin,dethecus,1285,paladin,holy,65,26,39
Equablex,argent-dawn,1284,paladin,holy,66,37,29
Beatríx,minahonda,1284,paladin,holy,247,132,115
Dedy,frostwhisper,1284,paladin,holy,96,50,46
Exteron,blackmoore,1284,paladin,holy,32,15,17
Elians,outland,1284,paladin,holy,84,35,49
Cowvid,grim-batol,1284,paladin,holy,60,24,36
Алекхей,gordunni,1282,paladin,holy,66,28,38
Hÿrrøkk,ysondre,1280,paladin,holy,144,83,61
Paellysuir,blackmoore,1280,paladin,holy,38,19,19
Alldo,drakthul,1280,paladin,holy,130,59,71
Necrozi,stormscale,1279,paladin,holy,70,40,30
Ксайлэти,gordunni,1279,paladin,holy,35,15,20
Fearleß,malganis,1278,paladin,holy,30,16,14
Ggiwastheret,kazzak,1277,paladin,holy,23,14,9
Manole,ravencrest,1277,paladin,holy,59,34,25
Veo,sylvanas,1277,paladin,holy,57,31,26
Bigfailure,blackmoore,1277,paladin,holy,71,23,48
Talies,ravencrest,1276,paladin,holy,66,37,29
Perfero,kazzak,1276,paladin,holy,54,22,32
Swungling,outland,1275,paladin,holy,96,48,48
Holyppower,frostmane,1275,paladin,holy,35,14,21
Kapigentil,suramar,1274,paladin,holy,83,42,41
Neithi,twisting-nether,1272,paladin,holy,72,36,36
Taligon,arathor,1272,paladin,holy,42,21,21
Albertina,silvermoon,1271,paladin,holy,38,19,19
Ballantine,thunderhorn,1271,paladin,holy,95,47,48
Кузнейц,borean-tundra,1271,paladin,holy,118,52,66
Mifuttoasort,draenor,1270,paladin,holy,104,51,53
Omegajin,tarren-mill,1269,paladin,holy,45,29,16
Marik,argent-dawn,1269,paladin,holy,65,30,35
Haros,xavius,1268,paladin,holy,89,46,43
Бронеаптечка,soulflayer,1268,paladin,holy,66,33,33
Toradin,thunderhorn,1268,paladin,holy,49,22,27
Делатор,gordunni,1267,paladin,holy,48,22,26
Aahabse,tarren-mill,1263,paladin,holy,95,38,57
Tepowze,twisting-nether,1262,paladin,holy,47,27,20
Гниленький,razuvious,1262,paladin,holy,48,18,30
Adnachiel,blackhand,1261,paladin,holy,80,40,40
Pajtash,doomhammer,1261,paladin,holy,59,29,30
Matagladis,dun-modr,1261,paladin,holy,125,61,64
Arkkipiispa,outland,1260,paladin,holy,78,40,38
Böbble,twisting-nether,1260,paladin,holy,30,15,15
Bimylover,archimonde,1260,paladin,holy,36,16,20
Ragequitter,frostmane,1259,paladin,holy,44,26,18
Ambrosía,alleria,1259,paladin,holy,90,41,49
Alesiah,blackhand,1258,paladin,holy,67,30,37
Keladen,burning-legion,1257,paladin,holy,95,50,45
Bulten,twilights-hammer,1257,paladin,holy,58,18,40
Paliat,silvermoon,1255,paladin,holy,49,25,24
Mccrit,ravencrest,1254,paladin,holy,67,40,27
Kaitlyne,tarren-mill,1254,paladin,holy,97,49,48
Regis,dragonblight,1253,paladin,holy,80,44,36
Анбели,gordunni,1252,paladin,holy,60,24,36
Zuen,nemesis,1251,paladin,holy,48,19,29
Tyrallan,ragnaros,1251,paladin,holy,36,14,22
Moobykin,stormscale,1250,paladin,holy,68,33,35
Нинтендо,grom,1250,paladin,holy,403,191,212
Spankmeproof,kazzak,1250,paladin,holy,54,24,30
Hogma,hyjal,1250,paladin,holy,36,14,22
Ellisdee,kazzak,1249,paladin,holy,36,20,16
Luraa,drakthul,1249,paladin,holy,42,21,21
Hotub,twisting-nether,1248,paladin,holy,153,73,80
Mercuria,dun-modr,1247,paladin,holy,48,25,23
Batallarbb,exodar,1245,paladin,holy,54,26,28
Reeley,drakthul,1244,paladin,holy,231,116,115
Mjabubble,stormscale,1243,paladin,holy,141,78,63
Neyd,hyjal,1243,paladin,holy,138,57,81
Cmelacek,wildhammer,1241,paladin,holy,42,25,17
Holyini,twisting-nether,1241,paladin,holy,157,78,79
Кельдерик,howling-fjord,1241,paladin,holy,133,66,67
Tommoffwarrs,archimonde,1241,paladin,holy,73,35,38
Thranduïl,tarren-mill,1240,paladin,holy,107,58,49
Trisunonvaki,khazgoroth,1240,paladin,holy,150,80,70
Teebxu,outland,1239,paladin,holy,23,14,9
Baixinho,aggra-português,1238,paladin,holy,105,58,47
Sanaha,drakthul,1238,paladin,holy,91,49,42
Wrathlol,ravencrest,1238,paladin,holy,269,131,138
Bloednicht,dentarg,1238,paladin,holy,42,18,24
Aelly,hyjal,1237,paladin,holy,112,56,56
Runtheshow,deathwing,1237,paladin,holy,28,14,14
Lightmachine,kirin-tor,1236,paladin,holy,66,43,23
Blazeberg,tirion,1236,paladin,holy,41,21,20
Sagaruki,emerald-dream,1236,paladin,holy,83,36,47
Naliax,ravencrest,1235,paladin,holy,53,25,28
Voodyy,ravencrest,1234,paladin,holy,24,13,11
Golldy,burning-legion,1234,paladin,holy,65,35,30
Babybeater,outland,1234,paladin,holy,101,49,52
Kerven,doomhammer,1234,paladin,holy,107,47,60
Trîlux,theradras,1233,paladin,holy,36,19,17
Cumprovider,sylvanas,1233,paladin,holy,48,25,23
Jaezlin,tarren-mill,1232,paladin,holy,130,70,60
Fiönä,archimonde,1232,paladin,holy,30,13,17
Faildin,arathor,1231,paladin,holy,131,64,67
Reudi,argent-dawn,1230,paladin,holy,54,28,26
Skrrtsteak,draenor,1230,paladin,holy,43,17,26
Ivailo,outland,1229,paladin,holy,24,13,11
Weserwehr,laughing-skull,1228,paladin,holy,90,46,44
Madlightsxd,dun-modr,1228,paladin,holy,36,13,23
Heldarim,ysondre,1228,paladin,holy,54,13,41
Billkop,silvermoon,1227,paladin,holy,88,52,36
Padraic,scarshield-legion,1227,paladin,holy,24,13,11
Ashbrìnger,aegwynn,1227,paladin,holy,24,13,11
Josefu,blackmoore,1227,paladin,holy,42,21,21
Aéther,quelthalas,1225,paladin,holy,45,25,20
Naenel,dun-modr,1225,paladin,holy,37,16,21
Bobilous,twisting-nether,1225,paladin,holy,36,14,22
Держинский,gordunni,1225,paladin,holy,72,24,48
Paakz,stormscale,1224,paladin,holy,221,111,110
Nobodycanxit,twisting-nether,1223,paladin,holy,72,35,37
Leedspala,tarren-mill,1221,paladin,holy,24,14,10
Slistrash,outland,1221,paladin,holy,185,94,91
Schrikii,archimonde,1221,paladin,holy,66,27,39
Yoshreddi,malganis,1218,paladin,holy,52,25,27
Mcscrigs,stormrage,1218,paladin,holy,57,26,31
Lianndrin,blackhand,1218,paladin,holy,58,25,33
Demytx,burning-legion,1218,paladin,holy,40,14,26
Даняхгод,gordunni,1217,paladin,holy,54,26,28
Focùsheal,archimonde,1217,paladin,holy,42,20,22
Freý,ravencrest,1217,paladin,holy,36,13,23
Kiyam,kelthuzad,1216,paladin,holy,36,20,16
Калекомобиль,gordunni,1216,paladin,holy,25,13,12
Dubstép,blackrock,1216,paladin,holy,48,20,28
Minui,onyxia,1216,paladin,holy,50,20,30
Alastrr,hyjal,1215,paladin,holy,93,52,41
Fleny,thrall,1215,paladin,holy,24,13,11
Dawnforged,stormscale,1215,paladin,holy,118,56,62
Verianer,shadowsong,1213,paladin,holy,112,65,47
Ауё,blackscar,1213,paladin,holy,96,47,49
Môdhân,archimonde,1213,paladin,holy,66,31,35
Ромерл,gordunni,1213,paladin,holy,241,112,129
Fredfuriouss,twisting-nether,1212,paladin,holy,37,22,15
Kilogosa,frostmane,1211,paladin,holy,24,13,11
Pupsihasi,kelthuzad,1211,paladin,holy,61,31,30
Angioh,twisting-nether,1211,paladin,holy,42,20,22
Новирка,deathguard,1210,paladin,holy,108,56,52
Crispydixx,draenor,1210,paladin,holy,102,52,50
Paidi,die-todeskrallen,1210,paladin,holy,121,60,61
Зерегушка,gordunni,1210,paladin,holy,30,13,17
Nikcsy,ragnaros,1210,paladin,holy,78,29,49
Johnnydeeps,blackrock,1210,paladin,holy,35,13,22
Ithealy,twisting-nether,1209,paladin,holy,140,73,67
Johnnÿsins,hyjal,1209,paladin,holy,63,28,35
Baubble,silvermoon,1207,paladin,holy,85,45,40
Xe,kaelthas,1207,paladin,holy,100,48,52
Zeratris,defias-brotherhood,1207,paladin,holy,97,42,55
Holysznajt,burning-legion,1207,paladin,holy,72,30,42
Rébél,argent-dawn,1206,paladin,holy,42,17,25
Ramels,hyjal,1205,paladin,holy,66,28,38
Skarn,pozzo-delleternità,1205,paladin,holy,37,15,22
Нуш,greymane,1203,paladin,holy,36,18,18
Kambood,twisting-nether,1203,paladin,holy,219,103,116
Battosaix,aegwynn,1203,paladin,holy,35,15,20
Hùrikan,hyjal,1202,paladin,holy,66,28,38
Holymax,gorgonnash,1201,paladin,holy,51,29,22
Xastur,rexxar,1201,paladin,holy,33,17,16
Med,malganis,1200,paladin,holy,88,39,49
Skwáru,burning-legion,1200,paladin,holy,112,48,64
Kimmpala,tarren-mill,1200,paladin,holy,42,14,28
Crüedriver,nefarian,1199,paladin,holy,70,24,46
Kirilux,dun-modr,1198,paladin,holy,66,37,29
Longa,kazzak,1198,paladin,holy,56,27,29
Кейлол,soulflayer,1198,paladin,holy,101,47,54
Trastos,wildhammer,1197,paladin,holy,78,40,38
Tucibi,hyjal,1196,paladin,holy,42,24,18
Shenzoo,rajaxx,1196,paladin,holy,65,28,37
Ubiquitous,kazzak,1196,paladin,holy,53,21,32
Edgï,confrérie-du-thorium,1195,paladin,holy,24,14,10
Cowlories,outland,1195,paladin,holy,48,27,21
Brøadway,eredar,1195,paladin,holy,53,24,29
Bjaï,hyjal,1195,paladin,holy,96,36,60
Sepha,eonar,1194,paladin,holy,88,50,38
Warkyria,sanguino,1193,paladin,holy,37,15,22
Farata,ravencrest,1192,paladin,holy,214,104,110
Shoby,silvermoon,1192,paladin,holy,36,17,19
Chunie,ravencrest,1192,paladin,holy,71,25,46
Майдмен,gordunni,1191,paladin,holy,125,67,58
Кукусяшка,gordunni,1191,paladin,holy,71,29,42
Ikbenmani,tarren-mill,1190,paladin,holy,72,38,34
Hazø,silvermoon,1190,paladin,holy,69,34,35
Luminix,ragnaros,1189,paladin,holy,36,17,19
Lightmamba,draenor,1189,paladin,holy,66,24,42
Holdmybible,the-maelstrom,1188,paladin,holy,66,26,40
Eastranspal,ravencrest,1188,paladin,holy,42,14,28
Psycholas,ysondre,1187,paladin,holy,43,24,19
Вертуосгодх,soulflayer,1187,paladin,holy,104,51,53
Taraniah,argent-dawn,1186,paladin,holy,93,48,45
Ninko,sylvanas,1185,paladin,holy,60,31,29
Rhulana,blackrock,1184,paladin,holy,97,57,40
Boric,bloodhoof,1184,paladin,holy,29,16,13
Keryann,argent-dawn,1183,paladin,holy,108,53,55
Vegnar,confrérie-du-thorium,1183,paladin,holy,30,14,16
Zypala,silvermoon,1182,paladin,holy,36,16,20
Thickets,argent-dawn,1181,paladin,holy,56,30,26
Dreamwatcher,outland,1181,paladin,holy,42,20,22
Громобоика,gordunni,1180,paladin,holy,19,13,6
Unpal,ravencrest,1179,paladin,holy,50,20,30
Kayndornek,ravencrest,1178,paladin,holy,78,35,43
Bloodbrook,burning-legion,1177,paladin,holy,35,15,20
Furywithin,veknilash,1176,paladin,holy,23,13,10
Фэрплэйн,gordunni,1175,paladin,holy,92,46,46
Shiidori,aegwynn,1175,paladin,holy,57,23,34
Ланиакеа,deathguard,1174,paladin,holy,63,36,27
Palaadschin,festung-der-stürme,1173,paladin,holy,189,97,92
Amelyé,kazzak,1173,paladin,holy,35,13,22
Неиспоримый,soulflayer,1172,paladin,holy,30,13,17
Strugglebusx,outland,1171,paladin,holy,35,17,18
Опгоп,gordunni,1170,paladin,holy,27,16,11
Leon,veknilash,1170,paladin,holy,290,132,158
Merliphel,burning-legion,1169,paladin,holy,39,22,17
Strudell,terrordar,1169,paladin,holy,90,42,48
Degods,ravencrest,1169,paladin,holy,54,24,30
Masuroc,antonidas,1168,paladin,holy,50,22,28
Iovä,twisting-nether,1167,paladin,holy,308,137,171
Ashebriinger,silvermoon,1166,paladin,holy,40,22,18
Alextrazite,kazzak,1166,paladin,holy,30,13,17
Badasshades,sylvanas,1166,paladin,holy,48,19,29
Guidone,sylvanas,1164,paladin,holy,54,24,30
Puiçanpal,archimonde,1163,paladin,holy,30,15,15
Elohim,echsenkessel,1163,paladin,holy,154,71,83
Hörse,outland,1162,paladin,holy,41,25,16
Firelline,outland,1162,paladin,holy,79,35,44
Stuzzyy,ravencrest,1162,paladin,holy,48,20,28
Nitrous,zuljin,1161,paladin,holy,72,37,35
Pisdez,malganis,1160,paladin,holy,102,46,56
Aldran,les-clairvoyants,1160,paladin,holy,32,13,19
Ýâðæßêæßðæðð,ragnaros,1159,paladin,holy,34,15,19
Ырбис,soulflayer,1159,paladin,holy,34,13,21
Ärinváyá,defias-brotherhood,1157,paladin,holy,121,61,60
Aranael,nemesis,1157,paladin,holy,90,38,52
Brolyadin,dun-modr,1157,paladin,holy,59,22,37
Encod,magtheridon,1156,paladin,holy,53,18,35
Ioras,sunstrider,1156,paladin,holy,40,13,27
Kherathan,argent-dawn,1155,paladin,holy,199,103,96
Ugurpala,sylvanas,1155,paladin,holy,48,24,24
Rerollin,the-maelstrom,1155,paladin,holy,38,13,25
Ðãwën,uldaman,1154,paladin,holy,27,14,13
Nezrus,dun-modr,1154,paladin,holy,48,19,29
Arcanïk,archimonde,1153,paladin,holy,43,16,27
Likkik,tarren-mill,1152,paladin,holy,18,12,6
Kaki,gorgonnash,1151,paladin,holy,18,12,6
Лавъю,gordunni,1151,paladin,holy,26,15,11
Karnwield,kirin-tor,1151,paladin,holy,221,117,104
Wedervärdig,twilights-hammer,1151,paladin,holy,54,23,31
Flowerbud,tarren-mill,1151,paladin,holy,74,27,47
Алексендлерх,soulflayer,1149,paladin,holy,18,12,6
Öbedö,malganis,1149,paladin,holy,93,38,55
Galaxxumi,ragnaros,1148,paladin,holy,86,37,49
Strykar,aggra-português,1147,paladin,holy,60,30,30
Халлейя,gordunni,1147,paladin,holy,24,12,12
Аяпал,blackscar,1147,paladin,holy,105,50,55
Certiorari,draenor,1147,paladin,holy,46,18,28
Flanderspal,ravencrest,1146,paladin,holy,24,12,12
Tukang,kazzak,1146,paladin,holy,73,31,42
Nurleen,twisting-nether,1146,paladin,holy,153,64,89
Daneyholy,ravencrest,1146,paladin,holy,63,21,42
Merigniüs,ysondre,1145,paladin,holy,60,33,27
Ymô,archimonde,1145,paladin,holy,40,17,23
Herrius,ravencrest,1144,paladin,holy,30,12,18
Potatô,twisting-nether,1143,paladin,holy,42,21,21
Eskorbuto,dun-modr,1143,paladin,holy,57,27,30
Ventrue,hyjal,1143,paladin,holy,36,17,19
Mozzie,archimonde,1143,paladin,holy,345,162,183
Johnaggro,outland,1143,paladin,holy,64,29,35
Shívah,auchindoun,1143,paladin,holy,36,12,24
Testrone,twisting-nether,1141,paladin,holy,93,49,44
Cadila,silvermoon,1140,paladin,holy,84,40,44
Debts,aggramar,1140,paladin,holy,82,32,50
Trolladincho,twisting-nether,1137,paladin,holy,102,50,52
Gromezrael,elune,1137,paladin,holy,60,28,32
Мэйр,howling-fjord,1137,paladin,holy,42,17,25
Lezoom,draenor,1136,paladin,holy,79,40,39
Runeington,silvermoon,1135,paladin,holy,30,14,16
Даурия,soulflayer,1135,paladin,holy,46,21,25
Reven,aszune,1135,paladin,holy,29,13,16
Dopadown,blackrock,1135,paladin,holy,30,13,17
Kraajp,stormscale,1135,paladin,holy,81,34,47
Jasiv,draenor,1132,paladin,holy,36,14,22
Palix,dalaran,1132,paladin,holy,36,12,24
Trudi,arthas,1130,paladin,holy,81,37,44
Hellwave,stormscale,1129,paladin,holy,24,13,11
Paliester,stormscale,1128,paladin,holy,42,26,16
Paxiffs,eredar,1128,paladin,holy,36,12,24
Himmelsfuror,proudmoore,1127,paladin,holy,83,36,47
Telarii,die-nachtwache,1126,paladin,holy,30,13,17
Valzyffs,twisting-nether,1123,paladin,holy,71,37,34
Affiicous,silvermoon,1123,paladin,holy,66,20,46
Barundarr,arthas,1122,paladin,holy,39,18,21
Yaj,magtheridon,1122,paladin,holy,59,27,32
Buddy,conseil-des-ombres,1121,paladin,holy,110,60,50
Zebramann,silvermoon,1121,paladin,holy,48,20,28
Unithral,durotan,1120,paladin,holy,36,17,19
Санэрдин,soulflayer,1120,paladin,holy,28,13,15
Ретроградий,howling-fjord,1120,paladin,holy,56,17,39
Echooes,ravencrest,1119,paladin,holy,273,120,153
Zerfleddern,aegwynn,1118,paladin,holy,149,73,76
Альфапушка,soulflayer,1117,paladin,holy,24,12,12
Trístesse,tarren-mill,1117,paladin,holy,231,115,116
Striike,drakthul,1117,paladin,holy,29,12,17
Milesteris,medivh,1116,paladin,holy,72,38,34
Gaskohle,blackmoore,1115,paladin,holy,23,12,11
Tärkan,chogall,1114,paladin,holy,42,18,24
Rôlfzukowzky,guldan,1114,paladin,holy,48,20,28
Riziel,sanguino,1114,paladin,holy,30,12,18
Kanina,outland,1114,paladin,holy,58,23,35
Browario,burning-legion,1113,paladin,holy,23,12,11
Tsomoo,antonidas,1112,paladin,holy,30,15,15
Bàldur,dalaran,1111,paladin,holy,48,27,21
Perpon,exodar,1111,paladin,holy,71,34,37
Mjølnîr,eredar,1111,paladin,holy,72,31,41
Yokurolel,sanguino,1109,paladin,holy,72,42,30
Syfaria,eldrethalas,1109,paladin,holy,59,26,33
Пауэрлайт,blackscar,1109,paladin,holy,64,27,37
Palanolmal,dun-modr,1107,paladin,holy,52,28,24
Míxu,stormreaver,1106,paladin,holy,104,44,60
Kaktuszfüge,ragnaros,1105,paladin,holy,64,40,24
Doomheart,drakthul,1104,paladin,holy,118,57,61
Collinnawin,aegwynn,1104,paladin,holy,36,12,24
Hehesh,silvermoon,1103,paladin,holy,44,19,25
Beavatott,ragnaros,1102,paladin,holy,35,15,20
Smirk,aggra-português,1101,paladin,holy,18,12,6
Atkm,aggramar,1100,paladin,holy,42,14,28
Meive,sanguino,1099,paladin,holy,41,14,27
Truthbearer,darksorrow,1098,paladin,holy,176,82,94
Catsnek,darksorrow,1098,paladin,holy,37,15,22
Cmen,silvermoon,1096,paladin,holy,180,92,88
Dryntee,blackmoore,1095,paladin,holy,21,13,8
Darkironpala,argent-dawn,1095,paladin,holy,65,31,34
Segertåget,tarren-mill,1095,paladin,holy,160,75,85
Darvius,auchindoun,1093,paladin,holy,153,75,78
Галлионн,gordunni,1092,paladin,holy,29,19,10
Feldrøider,nemesis,1092,paladin,holy,100,53,47
Luckies,drakthul,1090,paladin,holy,36,16,20
Superpopa,twisting-nether,1090,paladin,holy,86,36,50
Kuhs,eredar,1089,paladin,holy,95,46,49
Ampoula,ravencrest,1088,paladin,holy,28,12,16
Healslol,aegwynn,1088,paladin,holy,55,20,35
Stonebeard,ahnqiraj,1087,paladin,holy,129,72,57
Nosn,ravencrest,1087,paladin,holy,66,34,32
Tentacruel,dalaran,1087,paladin,holy,24,12,12
Bígpumprz,archimonde,1085,paladin,holy,35,17,18
Skydor,silvermoon,1084,paladin,holy,187,91,96
Serim,dun-modr,1084,paladin,holy,165,77,88
Фломастер,gordunni,1084,paladin,holy,78,36,42
Ragua,tarren-mill,1082,paladin,holy,66,23,43
Paladzor,twisting-nether,1082,paladin,holy,38,13,25
Alphárius,argent-dawn,1081,paladin,holy,69,32,37
Luzcian,zuljin,1081,paladin,holy,115,48,67
Nyryon,ysondre,1081,paladin,holy,84,32,52
Uzrael,hyjal,1080,paladin,holy,53,21,32
Poundcake,stormscale,1079,paladin,holy,120,61,59
Ritiv,stormreaver,1079,paladin,holy,146,61,85
Joakìim,stormscale,1079,paladin,holy,39,12,27
Присвет,blackscar,1078,paladin,holy,44,13,31
Ashmaden,tarren-mill,1077,paladin,holy,87,49,38
Herrmannelig,arthas,1072,paladin,holy,36,15,21
Sanctifiedz,silvermoon,1071,paladin,holy,49,25,24
Æe,blackmoore,1071,paladin,holy,42,19,23
Jessìca,ravenholdt,1070,paladin,holy,60,31,29
Elisiell,turalyon,1070,paladin,holy,36,15,21
Palidi,tarren-mill,1064,paladin,holy,42,16,26
Galadørn,elune,1064,paladin,holy,36,12,24
Молотуля,howling-fjord,1063,paladin,holy,29,12,17
Rákea,blackrock,1063,paladin,holy,66,26,40
Псимедик,gordunni,1062,paladin,holy,68,34,34
Kastiël,hyjal,1062,paladin,holy,52,17,35
Elp,ysondre,1061,paladin,holy,38,14,24
Phiana,blackmoore,1060,paladin,holy,30,18,12
Nicewar,silvermoon,1060,paladin,holy,75,38,37
Droseros,sylvanas,1060,paladin,holy,59,25,34
Rondra,gorgonnash,1059,paladin,holy,36,19,17
Aldas,los-errantes,1059,paladin,holy,30,13,17
Tscheba,kazzak,1058,paladin,holy,118,58,60
Holyfriend,kazzak,1058,paladin,holy,30,14,16
Mowik,archimonde,1056,paladin,holy,78,36,42
Mscrabtree,aggramar,1056,paladin,holy,36,14,22
Gayestpala,ravencrest,1056,paladin,holy,30,11,19
Djaléxx,kazzak,1056,paladin,holy,36,11,25
Flashyplays,silvermoon,1055,paladin,holy,36,26,10
Casmira,blackrock,1055,paladin,holy,18,11,7
Kanketo,korgall,1055,paladin,holy,24,11,13
Безбабла,soulflayer,1055,paladin,holy,36,15,21
Holybom,silvermoon,1054,paladin,holy,44,21,23
Dabstar,antonidas,1054,paladin,holy,100,45,55
Tiltslayer,archimonde,1053,paladin,holy,18,11,7
Ozzuum,twisting-nether,1053,paladin,holy,21,12,9
Ларенси,gordunni,1053,paladin,holy,47,20,27
Zephale,sunstrider,1053,paladin,holy,31,11,20
Mbp,blackmoore,1052,paladin,holy,30,16,14
Burkaal,antonidas,1052,paladin,holy,89,40,49
Flâwless,tarren-mill,1051,paladin,holy,24,11,13
Whatisapalla,ragnaros,1051,paladin,holy,30,11,19
Impro,archimonde,1051,paladin,holy,30,11,19
Pâmê,kazzak,1049,paladin,holy,30,12,18
Missfez,the-maelstrom,1049,paladin,holy,30,11,19
Holyazzwhup,aegwynn,1048,paladin,holy,18,11,7
Pinx,kazzak,1047,paladin,holy,24,15,9
Hèmera,archimonde,1047,paladin,holy,18,11,7
Rdypaladin,ravencrest,1047,paladin,holy,24,11,13
Geesus,eredar,1047,paladin,holy,24,11,13
Inuyashiki,blackmoore,1047,paladin,holy,30,11,19
Thorhum,moonglade,1046,paladin,holy,42,18,24
Wârlørd,sylvanas,1046,paladin,holy,39,12,27
Dimeric,outland,1044,paladin,holy,24,11,13
Edomedo,blackrock,1044,paladin,holy,126,44,82
Паландис,howling-fjord,1042,paladin,holy,54,23,31
Niechepala,grim-batol,1042,paladin,holy,30,11,19
Fract,aggramar,1041,paladin,holy,63,32,31
Lènnja,baelgun,1041,paladin,holy,24,11,13
Churrucuca,minahonda,1040,paladin,holy,57,28,29
Dunka,twisting-nether,1040,paladin,holy,160,78,82
Healìna,hyjal,1038,paladin,holy,24,11,13
Fifisztos,burning-legion,1036,paladin,holy,45,27,18
Holÿbeard,ravencrest,1036,paladin,holy,31,12,19
Grimsz,ysondre,1036,paladin,holy,36,11,25
Гуэргос,gordunni,1034,paladin,holy,24,11,13
Sheldon,sylvanas,1034,paladin,holy,35,14,21
Laniñaa,temple-noir,1033,paladin,holy,24,11,13
Edwín,tichondrius,1033,paladin,holy,36,13,23
Monaatamis,kazzak,1032,paladin,holy,36,11,25
Zetla,khaz-modan,1031,paladin,holy,341,168,173
Загадзуга,howling-fjord,1030,paladin,holy,36,22,14
Satip,archimonde,1030,paladin,holy,72,42,30
Holyknîght,khaz-modan,1028,paladin,holy,30,20,10
Лебоввски,blackscar,1028,paladin,holy,37,14,23
Dragonwingz,kazzak,1027,paladin,holy,24,11,13
Leônidas,kazzak,1027,paladin,holy,63,27,36
Crusadelight,alakir,1026,paladin,holy,134,65,69
Purificatoru,draenor,1024,paladin,holy,54,26,28
Swormp,aggra-português,1024,paladin,holy,38,14,24
Synoh,silvermoon,1024,paladin,holy,36,12,24
Duschwein,aegwynn,1023,paladin,holy,25,13,12
Ударник,soulflayer,1021,paladin,holy,102,56,46
Mirabol,hyjal,1021,paladin,holy,83,33,50
Antisin,kazzak,1019,paladin,holy,154,64,90
Çrúsader,frostmane,1016,paladin,holy,48,23,25
Ylandefaran,frostmane,1016,paladin,holy,117,53,64
Keele,stormscale,1015,paladin,holy,79,33,46
Delilahftw,burning-legion,1015,paladin,holy,32,12,20
Yasmira,frostmourne,1014,paladin,holy,72,41,31
Oscardrei,norgannon,1013,paladin,holy,72,39,33
Øsirix,archimonde,1012,paladin,holy,113,52,61
Darhuun,antonidas,1012,paladin,holy,60,23,37
Syrenia,die-silberne-hand,1012,paladin,holy,87,31,56
Kvea,blackmoore,1011,paladin,holy,90,49,41
Rombi,draenor,1011,paladin,holy,100,41,59
Palir,ysondre,1010,paladin,holy,24,11,13
Santtox,dun-modr,1010,paladin,holy,40,13,27
Stelara,ravencrest,1007,paladin,holy,54,23,31
Сашокс,gordunni,1006,paladin,holy,123,51,72
Saró,ravencrest,1005,paladin,holy,84,22,62
Thiccmixy,stormscale,1003,paladin,holy,29,11,18
Chopdawop,blackmoore,1002,paladin,holy,38,12,26
Necropolis,twisting-nether,1001,paladin,holy,54,32,22
Eledhwen,mannoroth,1000,paladin,holy,72,37,35
Флаила,ashenvale,999,paladin,holy,36,18,18
Battalgazi,azjolnerub,997,paladin,holy,35,14,21
Пегая,soulflayer,994,paladin,holy,24,13,11
Kpunkpam,dun-modr,993,paladin,holy,74,41,33
Palagrom,kazzak,991,paladin,holy,34,11,23
Májór,area-52,990,paladin,holy,78,19,59
Avengilo,silvermoon,989,paladin,holy,36,17,19
Gigantiq,draenor,988,paladin,holy,36,11,25
Peacekeep,stormscale,987,paladin,holy,102,43,59
Mêyra,blackhand,986,paladin,holy,22,11,11
Haavoc,arathor,986,paladin,holy,30,13,17
Ryuzu,khazgoroth,985,paladin,holy,41,20,21
Áfx,blackmoore,985,paladin,holy,44,17,27
Quelthemar,stormscale,982,paladin,holy,111,42,69
Cerseï,frostmane,979,paladin,holy,41,13,28
Ralo,shattrath,978,paladin,holy,54,18,36
Omnimus,draenor,976,paladin,holy,25,14,11
Tömmÿ,draenor,976,paladin,holy,80,41,39
Pölark,archimonde,974,paladin,holy,125,59,66
Razx,draenor,972,paladin,holy,54,24,30
Ирэуль,gordunni,972,paladin,holy,36,13,23
Fleshoflight,arathor,972,paladin,holy,74,26,48
Shakziva,draenor,968,paladin,holy,78,40,38
Odensson,sylvanas,967,paladin,holy,42,15,27
Selenaluna,turalyon,967,paladin,holy,48,17,31
Оберинмартел,blackscar,965,paladin,holy,102,52,50
Holydano,stormscale,965,paladin,holy,33,16,17
Swordlupn,argent-dawn,965,paladin,holy,101,39,62
Rafox,malygos,964,paladin,holy,42,17,25
Zinnia,draenor,963,paladin,holy,23,11,12
Severok,darkspear,962,paladin,holy,29,16,13
Koreanpistol,aegwynn,962,paladin,holy,97,39,58
Rapidforce,kazzak,961,paladin,holy,132,66,66
Ayepal,grim-batol,960,paladin,holy,18,10,8
Bapêe,thrall,960,paladin,holy,18,10,8
Rawshatter,kiljaeden,959,paladin,holy,18,10,8
Albakauz,stormscale,959,paladin,holy,24,10,14
Elracktwo,blackhand,958,paladin,holy,18,10,8
Синрайчик,gordunni,958,paladin,holy,42,20,22
Herayo,aegwynn,958,paladin,holy,24,10,14
Astridx,kazzak,958,paladin,holy,24,10,14
Kapsloch,twisting-nether,958,paladin,holy,36,10,26
Whórainzóne,eredar,958,paladin,holy,36,10,26
Unhittable,draenor,957,paladin,holy,18,10,8
Kcore,blackrock,957,paladin,holy,36,13,23
Ingenuous,draenor,957,paladin,holy,30,10,20
Smeh,outland,957,paladin,holy,36,10,26
Crashband,bronzebeard,956,paladin,holy,18,10,8
Бадъб,howling-fjord,956,paladin,holy,27,10,17
Sneackerz,archimonde,956,paladin,holy,30,10,20
Holyless,draenor,955,paladin,holy,24,10,14
Shockhoe,tarren-mill,955,paladin,holy,24,10,14
Paluladin,turalyon,954,paladin,holy,18,10,8
Darkoulipal,ravencrest,954,paladin,holy,18,10,8
Zymotíx,stormscale,954,paladin,holy,30,10,20
Alearai,ravenholdt,953,paladin,holy,34,15,19
Ugimuji,magtheridon,953,paladin,holy,24,10,14
Roshï,tarren-mill,953,paladin,holy,30,10,20
Kaleto,ragnaros,952,paladin,holy,139,67,72
Cenox,antonidas,952,paladin,holy,30,14,16
Iauna,tarren-mill,952,paladin,holy,30,10,20
Fruitschaal,moonglade,951,paladin,holy,24,10,14
Dánn,outland,950,paladin,holy,18,10,8
Leekai,stormscale,950,paladin,holy,18,10,8
Legenda,grim-batol,950,paladin,holy,54,23,31
Dunutunicorn,argent-dawn,950,paladin,holy,24,10,14
Schaaboowyy,burning-legion,950,paladin,holy,106,38,68
Bcrp,ragnaros,950,paladin,holy,30,10,20
Випанк,howling-fjord,949,paladin,holy,155,60,95
Fotmfactory,burning-blade,949,paladin,holy,36,10,26
Savitri,drakthul,948,paladin,holy,24,10,14
Böömie,blackmoore,948,paladin,holy,51,20,31
Enslar,sanguino,947,paladin,holy,12,10,2
Макспал,lich-king,947,paladin,holy,65,29,36
Tmàc,twisting-nether,946,paladin,holy,36,10,26
Xonika,outland,945,paladin,holy,31,13,18
Aulen,draenor,943,paladin,holy,16,11,5
Datz,nerathor,943,paladin,holy,24,10,14
Pristín,blackhand,942,paladin,holy,24,10,14
Groove,colinas-pardas,941,paladin,holy,40,11,29
Messîah,outland,939,paladin,holy,43,19,24
Colpadeltank,kazzak,939,paladin,holy,54,15,39
Алекссис,blackscar,938,paladin,holy,142,59,83
Wisplol,kazzak,937,paladin,holy,84,45,39
Holyhooves,thrall,936,paladin,holy,18,10,8
Clerik,eredar,936,paladin,holy,88,42,46
Paladons,darksorrow,933,paladin,holy,41,22,19
Catali,sanguino,931,paladin,holy,115,54,61
Elsirosel,dun-modr,930,paladin,holy,24,10,14
Khaerhadur,argent-dawn,930,paladin,holy,89,28,61
Ázot,burning-legion,929,paladin,holy,48,19,29
Djalexx,kazzak,927,paladin,holy,23,10,13
Autyzmterror,silvermoon,927,paladin,holy,92,36,56
Bzuko,draenor,925,paladin,holy,25,10,15
Pepegasensei,ravencrest,924,paladin,holy,57,22,35
Høpé,malganis,923,paladin,holy,120,60,60
Ridethelight,nemesis,922,paladin,holy,30,15,15
Flòope,destromath,922,paladin,holy,45,19,26
Silvers,steamwheedle-cartel,922,paladin,holy,190,80,110
Zeret,twisting-nether,918,paladin,holy,40,16,24
Menagron,tarren-mill,917,paladin,holy,43,19,24
Imaturtle,darksorrow,915,paladin,holy,41,10,31
Revrenaud,magtheridon,913,paladin,holy,42,11,31
Jeyyl,aegwynn,911,paladin,holy,15,11,4
Scumbakitty,ysondre,911,paladin,holy,29,10,19
Crsader,antonidas,908,paladin,holy,84,40,44
Reeceboss,ravencrest,906,paladin,holy,29,12,17
Schukka,azshara,905,paladin,holy,24,10,14
Cøllinz,ragnaros,904,paladin,holy,21,10,11
Heyley,twisting-nether,903,paladin,holy,21,11,10
Ðavai,kazzak,903,paladin,holy,29,10,19
Yeetadin,silvermoon,903,paladin,holy,32,11,21
Vintar,quelthalas,901,paladin,holy,87,46,41
Паблойд,deathguard,897,paladin,holy,81,30,51
Chantal,gilneas,890,paladin,holy,53,26,27
Amolan,drakthul,888,paladin,holy,115,63,52
Яполковник,gordunni,887,paladin,holy,53,30,23
Theisixtus,drakthul,883,paladin,holy,23,12,11
Bjammin,burning-legion,883,paladin,holy,60,25,35
Àkí,blackmoore,883,paladin,holy,35,14,21
Mustangs,archimonde,882,paladin,holy,86,38,48
Nykothpn,ghostlands,881,paladin,holy,59,19,40
Atomics,wildhammer,867,paladin,holy,42,11,31
Neilimeh,marécage-de-zangar,866,paladin,holy,23,11,12
Æffy,nemesis,864,paladin,holy,12,9,3
Криптонитх,blackscar,864,paladin,holy,18,9,9
Payforpvp,draenor,864,paladin,holy,30,9,21
Cunix,draenor,863,paladin,holy,12,9,3
Flavourful,cthun,863,paladin,holy,18,9,9
Язвавгорле,soulflayer,863,paladin,holy,24,9,15
Évo,drakthul,863,paladin,holy,24,9,15
Istani,twisting-nether,863,paladin,holy,30,9,21
Yoanie,draenor,862,paladin,holy,12,9,3
Парквей,deathweaver,861,paladin,holy,15,10,5
Mohamedx,tarren-mill,861,paladin,holy,24,9,15
Fahqmeh,thrall,861,paladin,holy,24,9,15
Firetorch,twisting-nether,861,paladin,holy,30,9,21
Eky,stormreaver,861,paladin,holy,42,9,33
Calipse,outland,860,paladin,holy,24,9,15
Elfaza,uldum,860,paladin,holy,36,9,27
Pallyypower,draenor,859,paladin,holy,151,74,77
Zallehh,draenor,858,paladin,holy,30,9,21
Averagepala,stormscale,858,paladin,holy,30,9,21
Dalfor,aggramar,856,paladin,holy,12,9,3
Elganor,hyjal,856,paladin,holy,18,9,9
Lurdz,sylvanas,855,paladin,holy,20,11,9
Davykuro,medivh,854,paladin,holy,56,18,38
Langibo,malfurion,853,paladin,holy,30,14,16
Holyherb,the-maelstrom,852,paladin,holy,18,9,9
Rubadubskrub,silvermoon,852,paladin,holy,72,21,51
Videogame,twilights-hammer,851,paladin,holy,18,9,9
Kubrat,eredar,850,paladin,holy,331,133,198
Avengers,sylvanas,848,paladin,holy,18,9,9
Clegâne,antonidas,847,paladin,holy,12,9,3
Qyrija,malganis,845,paladin,holy,18,9,9
Vanghelie,doomhammer,843,paladin,holy,24,11,13
Tarhal,guldan,841,paladin,holy,18,9,9
Salubrifie,archimonde,841,paladin,holy,24,10,14
Первыйпал,blackscar,832,paladin,holy,94,49,45
Визавад,goldrinn,832,paladin,holy,18,9,9
Rezilience,archimonde,829,paladin,holy,16,9,7
Óverdóse,nagrand,825,paladin,holy,146,75,71
Arabicbomb,archimonde,819,paladin,holy,23,9,14
Palafrugell,sanguino,817,paladin,holy,68,31,37
Jargot,antonidas,817,paladin,holy,54,23,31
Chuppimuñaño,minahonda,816,paladin,holy,133,48,85
Manetheren,grim-batol,810,paladin,holy,58,24,34
Mýv,archimonde,809,paladin,holy,199,93,106
Stierchen,aegwynn,809,paladin,holy,28,10,18
Veelris,kazzak,806,paladin,holy,82,37,45
Antrapo,khaz-modan,805,paladin,holy,84,27,57
Iñgkara,tarren-mill,805,paladin,holy,92,29,63
Marcosaurio,stormscale,800,paladin,holy,28,9,19
Старыймачо,howling-fjord,800,paladin,holy,78,23,55
Bbcanalyzed,blackmoore,798,paladin,holy,32,10,22
Palolog,burning-legion,796,paladin,holy,67,13,54
Lèonarth,pozzo-delleternità,794,paladin,holy,22,10,12
Миллагрессия,soulflayer,793,paladin,holy,155,62,93
Jorian,burning-legion,790,paladin,holy,66,21,45
Azzael,thrall,786,paladin,holy,54,14,40
Tenac,confrérie-du-thorium,782,paladin,holy,59,18,41
Telninio,ravencrest,778,paladin,holy,48,11,37
Ринрэи,howling-fjord,768,paladin,holy,12,8,4
Brindefolie,ravencrest,768,paladin,holy,18,8,10
Morthiel,burning-blade,768,paladin,holy,18,8,10
Léinãd,kazzak,768,paladin,holy,24,8,16
Otush,blackmoore,767,paladin,holy,12,8,4
Wolfage,aegwynn,767,paladin,holy,12,8,4
Micrøsi,thrall,767,paladin,holy,18,8,10
Ethurospal,tarren-mill,767,paladin,holy,18,8,10
Qpax,twisting-nether,767,paladin,holy,18,8,10
Tyraïa,archimonde,767,paladin,holy,18,8,10
Reinhàrdt,ravencrest,767,paladin,holy,24,8,16
Bjôrnstad,ravencrest,766,paladin,holy,12,8,4
Бебралом,howling-fjord,766,paladin,holy,18,8,10
Tytharion,silvermoon,766,paladin,holy,18,8,10
Thudor,ravencrest,766,paladin,holy,27,9,18
Eggelados,boulderfist,766,paladin,holy,24,8,16
Влажныйбоб,soulflayer,765,paladin,holy,18,8,10
Edyk,silvermoon,765,paladin,holy,18,8,10
Bighammerx,ravencrest,765,paladin,holy,18,8,10
Спэнсэр,gordunni,764,paladin,holy,12,8,4
Vøøtt,ravencrest,764,paladin,holy,24,8,16
Ballefrikase,tarren-mill,764,paladin,holy,24,8,16
Paintdafence,kazzak,763,paladin,holy,36,8,28
Vilcochon,kaelthas,760,paladin,holy,12,8,4
Wrede,the-maelstrom,760,paladin,holy,24,8,16
Radhya,sargeras,757,paladin,holy,24,8,16
Mortalitis,tarren-mill,753,paladin,holy,42,8,34
Foshizzlemyn,sylvanas,751,paladin,holy,18,8,10
Pallydoll,doomhammer,750,paladin,holy,30,8,22
Jeunepadawan,dalaran,744,paladin,holy,22,9,13
Vindorus,archimonde,740,paladin,holy,58,18,40
Palabel,blackrock,740,paladin,holy,78,20,58
Drdeus,silvermoon,734,paladin,holy,16,9,7
Amnésía,twisting-nether,728,paladin,holy,23,8,15
Khalicies,archimonde,727,paladin,holy,40,9,31
Anemonaa,argent-dawn,722,paladin,holy,18,8,10
Sanguiniûs,kirin-tor,720,paladin,holy,20,8,12
Niou,alleria,711,paladin,holy,28,10,18
Jâybee,ravencrest,707,paladin,holy,20,9,11
Lacertosus,nemesis,687,paladin,holy,17,8,9
Аидахо,gordunni,679,paladin,holy,31,12,19
Sínístèr,kazzak,672,paladin,holy,12,7,5
Электрокинг,lich-king,672,paladin,holy,12,7,5
Gtgpiscine,kirin-tor,672,paladin,holy,12,7,5
Mearsheimer,ysondre,672,paladin,holy,12,7,5
Gigajudge,blackrock,672,paladin,holy,12,7,5
Richik,outland,672,paladin,holy,12,7,5
Isprinsessan,twisting-nether,672,paladin,holy,18,7,11
Tharelion,twisting-nether,672,paladin,holy,18,7,11
Нетораре,howling-fjord,672,paladin,holy,18,7,11
Achtfufzig,eredar,672,paladin,holy,18,7,11
Tacodin,blackrock,672,paladin,holy,18,7,11
Dopeé,stormscale,672,paladin,holy,18,7,11
Djalex,kazzak,672,paladin,holy,18,7,11
Katsümï,archimonde,672,paladin,holy,30,7,23
Tejbzx,blackmoore,671,paladin,holy,12,7,5
Rápunzél,blackmoore,671,paladin,holy,12,7,5
Íva,twisting-nether,671,paladin,holy,18,7,11
Хоулик,howling-fjord,671,paladin,holy,18,7,11
Yrony,gorgonnash,671,paladin,holy,18,7,11
Ämkaz,archimonde,671,paladin,holy,18,7,11
Skatiaringos,silvermoon,671,paladin,holy,18,7,11
Цианат,eversong,671,paladin,holy,18,7,11
Hampoof,blackrock,671,paladin,holy,18,7,11
Shredyopala,tarren-mill,671,paladin,holy,22,8,14
Linnea,kazzak,671,paladin,holy,24,7,17
Hølymaid,blackmoore,670,paladin,holy,12,7,5
Thorosus,nathrezim,670,paladin,holy,12,7,5
Ownkas,kazzak,670,paladin,holy,12,7,5
Gilgares,twisting-nether,670,paladin,holy,17,7,10
Lele,kazzak,670,paladin,holy,18,7,11
Сномалк,gordunni,670,paladin,holy,24,7,17
Waldpaladin,malganis,669,paladin,holy,18,7,11
Бладиполи,soulflayer,669,paladin,holy,24,7,17
Kejnen,eredar,668,paladin,holy,18,7,11
Wäsabi,khaz-modan,668,paladin,holy,18,7,11
Митреса,howling-fjord,667,paladin,holy,12,7,5
Rya,drakthul,667,paladin,holy,12,7,5
Divinehàmer,hyjal,667,paladin,holy,12,7,5
Unkillablee,stormscale,667,paladin,holy,24,7,17
Avalus,trollbane,667,paladin,holy,24,7,17
Рамго,grom,665,paladin,holy,12,7,5
Leadfoot,argent-dawn,665,paladin,holy,24,7,17
Juicemachine,silvermoon,663,paladin,holy,12,7,5
Düster,frostwolf,662,paladin,holy,18,7,11
Ракнапали,gordunni,661,paladin,holy,12,7,5
Oswoldio,ravencrest,659,paladin,holy,24,7,17
Slayah,blackmoore,657,paladin,holy,18,7,11
Lumïnescïa,archimonde,652,paladin,holy,18,7,11
Finpála,kul-tiras,648,paladin,holy,13,9,4
Selì,die-aldor,639,paladin,holy,22,7,15
Bubskispala,ravencrest,638,paladin,holy,14,8,6
Tadjmahal,ravencrest,638,paladin,holy,17,7,10
Kansenbass,outland,637,paladin,holy,23,7,16
Soulskin,sylvanas,634,paladin,holy,17,7,10
Торсгард,howling-fjord,622,paladin,holy,15,8,7
Yezel,dalaran,621,paladin,holy,17,7,10
Bonsamedi,garona,620,paladin,holy,27,8,19
Djozeeph,burning-legion,618,paladin,holy,11,7,4
Fluentx,ravencrest,618,paladin,holy,22,8,14
Hølynøøkîé,antonidas,616,paladin,holy,19,9,10
Divinelightz,kazzak,614,paladin,holy,29,14,15
Evillight,antonidas,587,paladin,holy,25,7,18
Дантепаладос,soulflayer,583,paladin,holy,49,7,42
Rane,arthas,576,paladin,holy,12,6,6
Roqu,nathrezim,576,paladin,holy,12,6,6
Жухолова,howling-fjord,576,paladin,holy,12,6,6
Spiritbreak,archimonde,576,paladin,holy,12,6,6
Ajany,blackmoore,576,paladin,holy,12,6,6
Хохахо,howling-fjord,576,paladin,holy,12,6,6
Sebrillant,nemesis,576,paladin,holy,12,6,6
Idontknow,nemesis,576,paladin,holy,12,6,6
Nádrüstál,kazzak,576,paladin,holy,12,6,6
Téssá,sylvanas,576,paladin,holy,12,6,6
Iîvîl,ravencrest,576,paladin,holy,12,6,6
Engerau,drakthul,576,paladin,holy,12,6,6
Tereyan,draenor,576,paladin,holy,12,6,6
Vôltuxx,outland,576,paladin,holy,12,6,6
Ben,ghostlands,576,paladin,holy,12,6,6
Zunis,ravencrest,576,paladin,holy,12,6,6
Holyfuchsia,ravencrest,576,paladin,holy,12,6,6
Kiingen,ragnaros,576,paladin,holy,12,6,6
Westranspal,ravencrest,576,paladin,holy,18,6,12
Zulpharik,ragnaros,576,paladin,holy,18,6,12
Narojj,kazzak,576,paladin,holy,18,6,12
Êzekiel,draenor,576,paladin,holy,18,6,12
Wladimir,stormreaver,576,paladin,holy,18,6,12
Youngkiwi,blackrock,576,paladin,holy,18,6,12
Mingleejr,stormscale,576,paladin,holy,25,7,18
Semtexx,antonidas,576,paladin,holy,24,6,18
Amôn,outland,576,paladin,holy,28,6,22
Vinmoo,deathwing,575,paladin,holy,12,6,6
Omgsoholy,stormscale,575,paladin,holy,12,6,6
Friendadin,chamber-of-aspects,575,paladin,holy,12,6,6
Zarispal,tarren-mill,575,paladin,holy,12,6,6
Ultrabenzo,ravencrest,575,paladin,holy,12,6,6
Taengoo,frostwhisper,575,paladin,holy,12,6,6
Rektalinfekt,malganis,575,paladin,holy,12,6,6
Rohanan,blackrock,575,paladin,holy,12,6,6
Gulyas,tarren-mill,575,paladin,holy,12,6,6
Joypal,tarren-mill,575,paladin,holy,12,6,6
Juliebee,blackmoore,575,paladin,holy,12,6,6
Syco,thrall,575,paladin,holy,12,6,6
Cóól,cthun,575,paladin,holy,12,6,6
Redjager,silvermoon,575,paladin,holy,12,6,6
Pressthere,tarren-mill,575,paladin,holy,18,6,12
Boldi,stormscale,575,paladin,holy,18,6,12
Lichbörnè,outland,575,paladin,holy,18,6,12
Pussas,burning-legion,575,paladin,holy,18,6,12
Lezin,thrall,575,paladin,holy,18,6,12
Ejoz,suramar,575,paladin,holy,18,6,12
Милиуайт,azuregos,575,paladin,holy,24,6,18
Arraw,archimonde,575,paladin,holy,24,6,18
Gardaken,draenor,575,paladin,holy,24,6,18
Jeyløl,antonidas,574,paladin,holy,12,6,6
Wogtrainer,burning-blade,574,paladin,holy,12,6,6
Lgz,outland,574,paladin,holy,18,6,12
Béniima,archimonde,574,paladin,holy,23,6,17
Vulgati,kazzak,574,paladin,holy,24,6,18
Tôra,hyjal,573,paladin,holy,12,6,6
Holyspike,drakthul,573,paladin,holy,18,6,12
Palateh,ysondre,573,paladin,holy,36,6,30
Darthdin,stormscale,572,paladin,holy,12,6,6
Panzzeur,hyjal,572,paladin,holy,12,6,6
Grafes,sanguino,572,paladin,holy,18,6,12
Ромчке,gordunni,572,paladin,holy,18,6,12
Tnkfrank,ravencrest,572,paladin,holy,18,6,12
Averyholycow,the-maelstrom,570,paladin,holy,12,6,6
Rosemary,mugthol,570,paladin,holy,12,6,6
Kytmna,drakthul,568,paladin,holy,12,6,6
Pallnatoke,silvermoon,561,paladin,holy,33,9,24
Giggs,turalyon,539,paladin,holy,14,7,7
Kárlsberg,aegwynn,533,paladin,holy,35,13,22
Kone,drakthul,528,paladin,holy,9,7,2
Nam,culte-de-la-rive-noire,527,paladin,holy,11,6,5
Heavel,thrall,527,paladin,holy,17,6,11
Dragg,kirin-tor,522,paladin,holy,17,8,9
Sinofpride,wrathbringer,520,paladin,holy,17,7,10
Noonebetter,ravencrest,519,paladin,holy,23,7,16
Superp,sanguino,514,paladin,holy,14,7,7
Azælæ,ravencrest,480,paladin,holy,6,5,1
Deliveröö,silvermoon,480,paladin,holy,6,5,1
Vänëssä,sylvanas,480,paladin,holy,6,5,1
Teksor,frostmourne,480,paladin,holy,6,5,1
Leonlasvegas,blackrock,480,paladin,holy,6,5,1
Glymlól,drakthul,480,paladin,holy,6,5,1
Athàs,ysondre,480,paladin,holy,6,5,1
Dimdon,silvermoon,480,paladin,holy,12,5,7
Justix,arathor,480,paladin,holy,12,5,7
Kinesen,defias-brotherhood,480,paladin,holy,12,5,7
Rinfal,kirin-tor,480,paladin,holy,12,5,7
Alennya,dalaran,480,paladin,holy,12,5,7
Docoùla,twisting-nether,480,paladin,holy,12,5,7
Jínnx,outland,480,paladin,holy,12,5,7
Papichuló,aegwynn,480,paladin,holy,12,5,7
Аффикстинка,soulflayer,480,paladin,holy,12,5,7
Chodegobbler,draenor,480,paladin,holy,12,5,7
Glassbaren,draenor,480,paladin,holy,12,5,7
Ornosh,draenor,480,paladin,holy,12,5,7
Shinesalot,kazzak,480,paladin,holy,12,5,7
Jinchúriki,aegwynn,480,paladin,holy,12,5,7
Haterandoms,turalyon,480,paladin,holy,12,5,7
Ljusmys,stormscale,480,paladin,holy,12,5,7
Gijar,ravencrest,480,paladin,holy,12,5,7
Dohmie,twisting-nether,480,paladin,holy,12,5,7
Fluv,ravencrest,480,paladin,holy,12,5,7
Анягэмбл,soulflayer,480,paladin,holy,12,5,7
Kroghct,tarren-mill,480,paladin,holy,12,5,7
Înphy,cthun,480,paladin,holy,12,5,7
Faëndel,hyjal,480,paladin,holy,15,6,9
Snoogléface,grim-batol,480,paladin,holy,14,5,9
Jogging,thrall,480,paladin,holy,16,5,11
Ãgra,hyjal,480,paladin,holy,18,5,13
Дюве,blackscar,480,paladin,holy,18,5,13
Flamabella,argent-dawn,480,paladin,holy,18,5,13
Zonde,kazzak,480,paladin,holy,18,5,13
Zunis,jaedenar,480,paladin,holy,18,5,13
Conker,malganis,480,paladin,holy,18,5,13
Холидугги,howling-fjord,480,paladin,holy,18,5,13
Asmaril,rexxar,480,paladin,holy,18,5,13
Déstructor,mannoroth,480,paladin,holy,18,5,13
Holydhanas,outland,480,paladin,holy,18,5,13
Omgimapala,kazzak,480,paladin,holy,20,5,15
Ague,spinebreaker,480,paladin,holy,28,6,22
Elfaza,dun-modr,480,paladin,holy,24,5,19
Ilikejudge,blackmoore,480,paladin,holy,30,5,25
Joân,mannoroth,479,paladin,holy,6,5,1
Малимон,soulflayer,479,paladin,holy,12,5,7
Spacepal,archimonde,479,paladin,holy,12,5,7
Cabritâ,antonidas,479,paladin,holy,12,5,7
Руслаанеш,soulflayer,479,paladin,holy,12,5,7
Gavril,bloodfeather,479,paladin,holy,12,5,7
Stinkytoes,draenor,479,paladin,holy,12,5,7
Лазуриса,deathguard,479,paladin,holy,12,5,7
Nidaime,zuljin,479,paladin,holy,12,5,7
Kiwia,burning-legion,479,paladin,holy,12,5,7
Daminika,das-syndikat,479,paladin,holy,15,5,10
Erthelios,silvermoon,479,paladin,holy,17,5,12
Bellamy,vashj,479,paladin,holy,18,5,13
Sultaani,ravencrest,479,paladin,holy,18,5,13
Brölin,sanguino,479,paladin,holy,18,5,13
Лакостик,howling-fjord,479,paladin,holy,24,5,19
Ganadorie,twisting-nether,479,paladin,holy,24,5,19
Noukia,ysondre,478,paladin,holy,12,5,7
Âtom,outland,478,paladin,holy,12,5,7
Bubblegum,dentarg,478,paladin,holy,18,5,13
Рюфэнь,howling-fjord,478,paladin,holy,18,5,13
Lianowar,nemesis,478,paladin,holy,24,5,19
Axone,ravencrest,477,paladin,holy,12,5,7
Lionpic,nemesis,477,paladin,holy,18,5,13
Котейкинус,blackscar,477,paladin,holy,18,5,13
Greenléaf,auchindoun,476,paladin,holy,12,5,7
Kaedena,kaelthas,476,paladin,holy,12,5,7
Grayscale,dun-morogh,476,paladin,holy,18,5,13
Styflor,dalaran,476,paladin,holy,18,5,13
Flameshield,turalyon,476,paladin,holy,24,5,19
Alone,sporeggar,473,paladin,holy,12,5,7
Gunshøtx,archimonde,466,paladin,holy,28,10,18
Лералучшая,gordunni,464,paladin,holy,19,7,12
Preamx,blackrock,463,paladin,holy,17,5,12
Harlight,hyjal,462,paladin,holy,11,5,6
Árcangel,minahonda,447,paladin,holy,17,5,12
Émilia,frostwolf,432,paladin,holy,15,5,10
Unstobubblex,burning-blade,431,paladin,holy,11,5,6
Bämbunga,madmortem,426,paladin,holy,16,6,10
Memewings,tarren-mill,426,paladin,holy,23,7,16
Тейдехан,gordunni,426,paladin,holy,21,6,15
Tressðr,dun-modr,426,paladin,holy,27,6,21
Liadry,sylvanas,424,paladin,holy,22,6,16
Exødus,defias-brotherhood,414,paladin,holy,14,5,9
Mcßluz,les-clairvoyants,399,paladin,holy,5,5,0
Eïnï,kazzak,384,paladin,holy,6,4,2
Ñnñnñnñnñnñn,stormscale,384,paladin,holy,6,4,2
Sartorius,hyjal,384,paladin,holy,6,4,2
Suoivbo,echsenkessel,384,paladin,holy,6,4,2
Kesq,ravencrest,384,paladin,holy,6,4,2
Zal,arygos,384,paladin,holy,6,4,2
Denounce,defias-brotherhood,384,paladin,holy,6,4,2
Touchpally,ravencrest,384,paladin,holy,6,4,2
Djcrusade,twisting-nether,384,paladin,holy,6,4,2
Rikiji,ravencrest,384,paladin,holy,6,4,2
Pastabianco,ravencrest,384,paladin,holy,6,4,2
Wiffy,ravencrest,384,paladin,holy,6,4,2
Chopocrisp,dun-modr,384,paladin,holy,12,4,8
Rasmu,kazzak,384,paladin,holy,12,4,8
Хикз,gordunni,384,paladin,holy,12,4,8
Stepmum,stormscale,384,paladin,holy,12,4,8
Fedaikin,stormscale,384,paladin,holy,12,4,8
Riukÿ,nemesis,384,paladin,holy,12,4,8
Mooderna,ravencrest,384,paladin,holy,12,4,8
Tyrø,ravencrest,384,paladin,holy,12,4,8
Bwser,silvermoon,384,paladin,holy,12,4,8
Hammarfall,ravencrest,384,paladin,holy,12,4,8
Gummypala,kazzak,384,paladin,holy,12,4,8
Vânwêêd,thrall,384,paladin,holy,12,4,8
Superkudden,kazzak,384,paladin,holy,12,4,8
Hipokratos,twisting-nether,384,paladin,holy,12,4,8
Brüllt,dun-modr,384,paladin,holy,12,4,8
Экстазируй,howling-fjord,384,paladin,holy,12,4,8
Akazâ,ysondre,384,paladin,holy,12,4,8
Hølyknicks,thrall,384,paladin,holy,12,4,8
Yunax,silvermoon,384,paladin,holy,12,4,8
Arikan,destromath,384,paladin,holy,12,4,8
Gunpowderx,silvermoon,384,paladin,holy,12,4,8
Sebatrøz,ravencrest,384,paladin,holy,12,4,8
Êggsy,grim-batol,384,paladin,holy,12,4,8
Góò,frostmane,384,paladin,holy,12,4,8
Psikatchuu,hyjal,384,paladin,holy,12,4,8
Akako,outland,384,paladin,holy,12,4,8
Jokkepaappa,darksorrow,384,paladin,holy,12,4,8
Flashhèart,draenor,384,paladin,holy,12,4,8
Imitrex,hyjal,384,paladin,holy,12,4,8
Csalóka,bloodscalp,384,paladin,holy,12,4,8
Shockadin,khazgoroth,384,paladin,holy,12,4,8
Zixxo,outland,384,paladin,holy,12,4,8
Hutson,drakthul,384,paladin,holy,12,4,8
Sacredx,tarren-mill,384,paladin,holy,12,4,8
Visersion,tarren-mill,384,paladin,holy,12,4,8
Kairo,dethecus,384,paladin,holy,12,4,8
Sterklight,draenor,384,paladin,holy,12,4,8
Lancelotx,darksorrow,384,paladin,holy,12,4,8
Victwo,burning-legion,384,paladin,holy,12,4,8
Crazyclass,outland,384,paladin,holy,14,4,10
Insomnias,silvermoon,384,paladin,holy,18,4,14
Сакон,borean-tundra,384,paladin,holy,18,4,14
Przemedron,burning-legion,384,paladin,holy,18,4,14
Bigholy,tarren-mill,384,paladin,holy,18,4,14
Breez,die-aldor,384,paladin,holy,18,4,14
Divinemove,stormscale,384,paladin,holy,18,4,14
Лортремар,howling-fjord,384,paladin,holy,18,4,14
Талрэн,howling-fjord,384,paladin,holy,18,4,14
Cykond,aegwynn,384,paladin,holy,18,4,14
Кирюшафридом,gordunni,384,paladin,holy,19,4,15
Taxpayer,aegwynn,384,paladin,holy,24,4,20
Najir,hyjal,383,paladin,holy,6,4,2
Caps,the-venture-co,383,paladin,holy,6,4,2
Steeger,blackhand,383,paladin,holy,6,4,2
Dáìsy,blackmoore,383,paladin,holy,6,4,2
Aggressìon,twisting-nether,383,paladin,holy,12,4,8
Uoloop,kazzak,383,paladin,holy,12,4,8
Ênmâ,archimonde,383,paladin,holy,12,4,8
Caumon,los-errantes,383,paladin,holy,12,4,8
Duine,the-venture-co,383,paladin,holy,12,4,8
Selaphíel,kazzak,383,paladin,holy,12,4,8
Angellinä,ragnaros,383,paladin,holy,12,4,8
Anfe,silvermoon,383,paladin,holy,12,4,8
Nostromus,antonidas,383,paladin,holy,12,4,8
Кэлви,blackscar,383,paladin,holy,12,4,8
Allesandra,antonidas,383,paladin,holy,12,4,8
Abdullach,silvermoon,383,paladin,holy,12,4,8
Scissors,dun-morogh,383,paladin,holy,18,4,14
Superpaladin,draenor,383,paladin,holy,18,4,14
Овахус,soulflayer,382,paladin,holy,12,4,8
Zuryy,archimonde,382,paladin,holy,12,4,8
Nêkro,dun-modr,382,paladin,holy,18,4,14
Theodun,xavius,382,paladin,holy,27,5,22
Maxímoose,defias-brotherhood,381,paladin,holy,12,4,8
Ardyl,drakthul,379,paladin,holy,12,4,8
Pyhälehmä,alakir,377,paladin,holy,18,4,14
Konpala,blackmoore,367,paladin,holy,11,4,7
Handsomeguyx,outland,367,paladin,holy,17,4,13
Nolylight,tarren-mill,365,paladin,holy,11,4,7
Justyowx,archimonde,352,paladin,holy,16,5,11
Vergogne,ysondre,351,paladin,holy,20,5,15
Acongojante,zuljin,330,paladin,holy,27,5,22
Onys,onyxia,329,paladin,holy,16,5,11
Ysnee,sanguino,320,paladin,holy,16,4,12
Holydin,argent-dawn,319,paladin,holy,5,4,1
Arshlicht,frostwolf,296,paladin,holy,21,5,16
Penthxoxo,outland,288,paladin,holy,6,3,3
Fenrixlol,shendralar,288,paladin,holy,6,3,3
Naiconpala,kazzak,288,paladin,holy,6,3,3
Гиркин,ashenvale,288,paladin,holy,6,3,3
Zimxao,ravencrest,288,paladin,holy,6,3,3
Holynoby,kazzak,288,paladin,holy,6,3,3
Pilinhás,aggra-português,288,paladin,holy,6,3,3
Yungboii,kazzak,288,paladin,holy,6,3,3
Amazja,eredar,288,paladin,holy,6,3,3
Хилвиновен,gordunni,288,paladin,holy,6,3,3
Rudirumms,die-aldor,288,paladin,holy,6,3,3
Vashavi,tarren-mill,288,paladin,holy,6,3,3
Solumon,gorgonnash,288,paladin,holy,6,3,3
Thingus,argent-dawn,288,paladin,holy,6,3,3
Lunalovesyou,blackmoore,288,paladin,holy,6,3,3
Âmba,blackrock,288,paladin,holy,6,3,3
Neoz,ravencrest,288,paladin,holy,6,3,3
Kompa,sanguino,288,paladin,holy,6,3,3
Xrayzz,tarren-mill,288,paladin,holy,6,3,3
Bandrogina,shattered-hand,288,paladin,holy,6,3,3
Belzepal,blackrock,288,paladin,holy,6,3,3
Gahar,grim-batol,288,paladin,holy,6,3,3
Killiria,kazzak,288,paladin,holy,6,3,3
Tyn,dragonmaw,288,paladin,holy,6,3,3
Lalli,korgall,288,paladin,holy,6,3,3
Альбусор,galakrond,288,paladin,holy,6,3,3
Mlatimudann,terokkar,288,paladin,holy,6,3,3
Verivertikal,blackmoore,288,paladin,holy,9,4,5
Awdly,draenor,288,paladin,holy,8,3,5
Høbz,outland,288,paladin,holy,8,3,5
Lògàn,pozzo-delleternità,288,paladin,holy,9,3,6
Nÿwa,temple-noir,288,paladin,holy,12,3,9
Баблейми,gordunni,288,paladin,holy,12,3,9
Zerohour,kilrogg,288,paladin,holy,12,3,9
Kolts,ragnaros,288,paladin,holy,12,3,9
Komen,dalaran,288,paladin,holy,12,3,9
Estellar,bronze-dragonflight,288,paladin,holy,12,3,9
Winjina,twisting-nether,288,paladin,holy,12,3,9
Vissticks,nagrand,288,paladin,holy,12,3,9
Redeem,nemesis,288,paladin,holy,12,3,9
Kelmarr,blackmoore,288,paladin,holy,12,3,9
Lifthorn,twisting-nether,288,paladin,holy,12,3,9
Bigdamjudge,argent-dawn,288,paladin,holy,12,3,9
Linxo,argent-dawn,288,paladin,holy,12,3,9
Limy,twisting-nether,288,paladin,holy,12,3,9
Гигаиисус,gordunni,288,paladin,holy,12,3,9
Krayzier,nordrassil,288,paladin,holy,12,3,9
Jctp,ravencrest,288,paladin,holy,12,3,9
Klumie,silvermoon,288,paladin,holy,12,3,9
Vorsip,tarren-mill,288,paladin,holy,12,3,9
Arbuzno,draenor,288,paladin,holy,12,3,9
Dojamoo,twisting-nether,288,paladin,holy,12,3,9
Crunchybeef,tarren-mill,288,paladin,holy,12,3,9
Sâfcon,eredar,288,paladin,holy,12,3,9
Noanoshy,eredar,288,paladin,holy,12,3,9
Azthin,outland,288,paladin,holy,12,3,9
Nhum,destromath,288,paladin,holy,12,3,9
Chusterb,draenor,288,paladin,holy,12,3,9
Rouge,eredar,288,paladin,holy,12,3,9
Glooni,blackmoore,288,paladin,holy,18,3,15
Pallileuka,ravencrest,288,paladin,holy,18,3,15
Màti,burning-legion,288,paladin,holy,18,3,15
Kaelorian,silvermoon,288,paladin,holy,18,3,15
Farquaad,darksorrow,287,paladin,holy,6,3,3
Скрепыш,soulflayer,287,paladin,holy,6,3,3
Drazzill,archimonde,287,paladin,holy,6,3,3
Livspartner,twisting-nether,287,paladin,holy,6,3,3
Kickvandoo,blackmoore,287,paladin,holy,6,3,3
Jellish,argent-dawn,287,paladin,holy,12,3,9
Toxií,argent-dawn,287,paladin,holy,12,3,9
Faustan,rexxar,287,paladin,holy,12,3,9
Järnkroken,tarren-mill,287,paladin,holy,13,3,10
Biót,tarren-mill,287,paladin,holy,18,3,15
Мерасфард,howling-fjord,287,paladin,holy,18,3,15
Auliæ,chogall,287,paladin,holy,18,3,15
Zàrílâ,dun-morogh,286,paladin,holy,6,3,3
Belgblue,ravenholdt,286,paladin,holy,6,3,3
Bkbstormcrow,thrall,286,paladin,holy,12,3,9
Lorithias,sargeras,286,paladin,holy,12,3,9
Hitaki,tarren-mill,256,paladin,holy,10,3,7
Keyla,los-errantes,256,paladin,holy,10,3,7
Nothol,malganis,255,paladin,holy,8,4,4
Ланиева,gordunni,240,paladin,holy,15,4,11
Fiuk,frostwhisper,239,paladin,holy,11,3,8
Holyblast,archimonde,234,paladin,holy,6,4,2
Flamxd,blackmoore,234,paladin,holy,10,5,5
Тамерланх,gordunni,234,paladin,holy,9,4,5
Calimmacil,amanthul,234,paladin,holy,14,5,9
Shivèns,archimonde,234,paladin,holy,17,5,12
Mustardio,tarren-mill,234,paladin,holy,14,4,10
Bvrlyhills,blackrock,234,paladin,holy,14,4,10
Dewastør,blackmoore,234,paladin,holy,15,4,11
Fearclass,hyjal,234,paladin,holy,16,4,12
Хепипал,soulflayer,234,paladin,holy,16,4,12
Zeiserig,antonidas,234,paladin,holy,17,4,13
Pjmoncrack,outland,234,paladin,holy,23,5,18
Faranume,sylvanas,233,paladin,holy,16,4,12
Waltgyubeef,argent-dawn,222,paladin,holy,28,8,20
Realdeal,argent-dawn,192,paladin,holy,6,2,4
Defianze,tarren-mill,192,paladin,holy,6,2,4
Miastenia,tarren-mill,192,paladin,holy,6,2,4
Hezekielh,hyjal,192,paladin,holy,6,2,4
Alisonquínn,argent-dawn,192,paladin,holy,6,2,4
Panomecon,magtheridon,192,paladin,holy,6,2,4
Eim,moonglade,192,paladin,holy,6,2,4
Botaref,kazzak,192,paladin,holy,6,2,4
Nirvanä,drakthul,192,paladin,holy,6,2,4
Pagadi,blackhand,192,paladin,holy,6,2,4
Lxvideoscom,blackrock,192,paladin,holy,6,2,4
Poonky,dun-modr,192,paladin,holy,6,2,4
Skølir,rashgarroth,192,paladin,holy,6,2,4
Twoßiased,kazzak,192,paladin,holy,6,2,4
Bopbacca,stormscale,192,paladin,holy,6,2,4
Wvwwvwvwvwwv,ravencrest,192,paladin,holy,6,2,4
Galadrion,dun-modr,192,paladin,holy,6,2,4
Andokaî,blackrock,192,paladin,holy,6,2,4
Tamarian,frostwhisper,192,paladin,holy,6,2,4
Bubbloseven,archimonde,192,paladin,holy,6,2,4
Dafukx,ragnaros,192,paladin,holy,6,2,4
Lafrogge,culte-de-la-rive-noire,192,paladin,holy,6,2,4
Exploenjoyer,ragnaros,192,paladin,holy,6,2,4
Xirôs,zirkel-des-cenarius,192,paladin,holy,6,2,4
Whiskeyx,lightbringer,192,paladin,holy,6,2,4
Holylight,arathi,192,paladin,holy,6,2,4
Овоссч,soulflayer,192,paladin,holy,6,2,4
Bàrlo,kazzak,192,paladin,holy,6,2,4
Elrack,blackhand,192,paladin,holy,6,2,4
Ladika,turalyon,192,paladin,holy,6,2,4
Прожектор,gordunni,192,paladin,holy,6,2,4
Rulîx,blackmoore,192,paladin,holy,6,2,4
Атомщица,deathguard,192,paladin,holy,6,2,4
Lompe,karazhan,192,paladin,holy,6,2,4
Ришардебюр,soulflayer,192,paladin,holy,6,2,4
Bígmachine,draenor,192,paladin,holy,6,2,4
Pizigoi,ravencrest,192,paladin,holy,6,2,4
Rävnev,twisting-nether,192,paladin,holy,6,2,4
Teflonmagìc,ravencrest,192,paladin,holy,6,2,4
Freijam,ravencrest,192,paladin,holy,6,2,4
Galad,exodar,192,paladin,holy,6,2,4
Palaneuía,antonidas,192,paladin,holy,6,2,4
Palabron,dun-modr,192,paladin,holy,6,2,4
Wtfpalalølz,khaz-modan,192,paladin,holy,6,2,4
Durnell,sylvanas,192,paladin,holy,6,2,4
Bubblenoób,kazzak,192,paladin,holy,6,2,4
Tîk,stormscale,192,paladin,holy,6,2,4
Yuz,archimonde,192,paladin,holy,6,2,4
Benedikt,stormscale,192,paladin,holy,6,2,4
Sulfyra,quelthalas,192,paladin,holy,16,3,13
Faenril,hyjal,192,paladin,holy,11,2,9
Croptol,dun-modr,192,paladin,holy,12,2,10
Aienest,ragnaros,192,paladin,holy,12,2,10
Bala,ravenholdt,192,paladin,holy,12,2,10
Bubbleslxt,blackmoore,192,paladin,holy,12,2,10
Ascendeadqt,kazzak,192,paladin,holy,12,2,10
Eyesore,malganis,192,paladin,holy,12,2,10
Ucu,terokkar,192,paladin,holy,12,2,10
Холидугги,blackscar,192,paladin,holy,12,2,10
Krièr,aggra-português,192,paladin,holy,12,2,10
Pichuflor,sanguino,192,paladin,holy,12,2,10
Égi,azshara,192,paladin,holy,12,2,10
Iamheal,blackhand,192,paladin,holy,12,2,10
Týr,forscherliga,192,paladin,holy,12,2,10
Keft,twisting-nether,192,paladin,holy,12,2,10
Вишенций,howling-fjord,192,paladin,holy,12,2,10
Lazyboo,blackrock,192,paladin,holy,12,2,10
Tsukaima,uldaman,192,paladin,holy,12,2,10
Essina,argent-dawn,192,paladin,holy,12,2,10
Zeleron,darksorrow,192,paladin,holy,12,2,10
Awer,magtheridon,192,paladin,holy,12,2,10
Uldurin,ravencrest,192,paladin,holy,12,2,10
Kÿsse,hyjal,192,paladin,holy,12,2,10
Nornom,antonidas,192,paladin,holy,12,2,10
Bjutiful,silvermoon,192,paladin,holy,15,2,13
Blancucky,kazzak,192,paladin,holy,18,2,16
Mistoflight,sylvanas,192,paladin,holy,18,2,16
Biplas,twisting-nether,192,paladin,holy,18,2,16
Getblessed,rexxar,192,paladin,holy,18,2,16
Harycon,thrall,192,paladin,holy,24,2,22
Tiboeufpéi,archimonde,191,paladin,holy,6,2,4
Zuplex,deathwing,191,paladin,holy,6,2,4
Liilya,pozzo-delleternità,191,paladin,holy,6,2,4
Aodren,varimathras,191,paladin,holy,6,2,4
Secônd,azjolnerub,191,paladin,holy,6,2,4
Akilës,dun-modr,191,paladin,holy,6,2,4
Bulinazor,stormscale,191,paladin,holy,12,2,10
Showjustice,blackmoore,191,paladin,holy,12,2,10
Chasie,antonidas,191,paladin,holy,12,2,10
Yums,tarren-mill,186,paladin,holy,14,5,9
Sharn,ravencrest,159,paladin,holy,5,2,3
Orogerrabbit,archimonde,144,paladin,holy,3,3,0
Lightfoot,kazzak,144,paladin,holy,9,2,7
Freyjä,turalyon,138,paladin,holy,9,4,5
Spizz,dun-modr,138,paladin,holy,8,3,5
Néedbüffs,silvermoon,138,paladin,holy,8,3,5
Dacilez,ravencrest,138,paladin,holy,10,3,7
Drylink,kazzak,138,paladin,holy,11,3,8
Pïñkñætðøðÿ,tarren-mill,138,paladin,holy,14,3,11
Hotchíck,outland,138,paladin,holy,15,3,12
Dayr,sylvanas,96,paladin,holy,6,1,5
Sozzerienpal,kazzak,96,paladin,holy,6,1,5
Playprist,aegwynn,96,paladin,holy,6,1,5
Alisthair,tyrande,96,paladin,holy,6,1,5
Razztafari,tarren-mill,96,paladin,holy,6,1,5
Zapeloni,blackmoore,96,paladin,holy,6,1,5
Bubblebun,kazzak,96,paladin,holy,6,1,5
Andrøiz,dun-modr,96,paladin,holy,6,1,5
Regista,ravencrest,96,paladin,holy,6,1,5
Fugll,ravencrest,96,paladin,holy,6,1,5
Qpala,quelthalas,96,paladin,holy,6,1,5
Switchflip,frostmane,96,paladin,holy,6,1,5
Fükdîscláss,ravencrest,96,paladin,holy,6,1,5
Bubbleheart,ahnqiraj,96,paladin,holy,6,1,5
Whiskeypal,draenor,96,paladin,holy,6,1,5
Fatalism,draenor,96,paladin,holy,6,1,5
Jjlxk,kazzak,96,paladin,holy,6,1,5
Holysheto,sanguino,96,paladin,holy,6,1,5
Agorasieya,frostwolf,96,paladin,holy,6,1,5
Herdekbaba,draenor,96,paladin,holy,6,1,5
Xzarat,kazzak,96,paladin,holy,6,1,5
Hasart,tarren-mill,96,paladin,holy,6,1,5
Mínara,drakthul,96,paladin,holy,6,1,5
Dedicatèd,draenor,96,paladin,holy,6,1,5
Vadheterjag,ravencrest,96,paladin,holy,6,1,5
Синерина,blackscar,96,paladin,holy,6,1,5
Bittersweex,stormscale,96,paladin,holy,6,1,5
Holyfalls,blackmoore,96,paladin,holy,6,1,5
Dobbygotsock,kazzak,96,paladin,holy,6,1,5
Kirane,hyjal,96,paladin,holy,6,1,5
Reøl,blackmoore,96,paladin,holy,6,1,5
Kyarï,culte-de-la-rive-noire,96,paladin,holy,6,1,5
Éxcèlsior,blackmoore,96,paladin,holy,6,1,5
Tønyx,les-clairvoyants,96,paladin,holy,6,1,5
Eàrànël,les-clairvoyants,96,paladin,holy,6,1,5
Stingeryar,terokkar,96,paladin,holy,6,1,5
Пепсекольный,soulflayer,96,paladin,holy,6,1,5
Orphëus,blackhand,96,paladin,holy,6,1,5
Thelvadam,blackhand,96,paladin,holy,6,1,5
Buladin,darkspear,96,paladin,holy,6,1,5
Sèrgàs,blackhand,96,paladin,holy,6,1,5
Enriel,temple-noir,96,paladin,holy,6,1,5
Fumbz,alakir,96,paladin,holy,6,1,5
Nyryaa,archimonde,96,paladin,holy,6,1,5
Vindex,die-nachtwache,96,paladin,holy,6,1,5
Rethus,burning-legion,96,paladin,holy,6,1,5
Shandju,norgannon,96,paladin,holy,6,1,5
Therador,dun-morogh,96,paladin,holy,6,1,5
Palariaan,defias-brotherhood,96,paladin,holy,6,1,5
Негропаладин,soulflayer,96,paladin,holy,6,1,5
Dilly,uldaman,96,paladin,holy,6,1,5
Zeyz,defias-brotherhood,96,paladin,holy,6,1,5
Clarkie,stormscale,96,paladin,holy,6,1,5
Druidinoob,uldaman,96,paladin,holy,6,1,5
Iamyellow,silvermoon,96,paladin,holy,6,1,5
Xephiroxus,the-venture-co,96,paladin,holy,6,1,5
Хочусметанки,howling-fjord,96,paladin,holy,6,1,5
Mg,kul-tiras,96,paladin,holy,6,1,5
Nôxi,garona,96,paladin,holy,6,1,5
Надеко,howling-fjord,96,paladin,holy,6,1,5
Lyciha,blackrock,96,paladin,holy,6,1,5
Wingcomander,aegwynn,96,paladin,holy,6,1,5
Kimozabie,ravencrest,96,paladin,holy,6,1,5
Whatapity,silvermoon,96,paladin,holy,6,1,5
Minirempart,khaz-modan,96,paladin,holy,6,1,5
Goatti,lightnings-blade,96,paladin,holy,6,1,5
Belgradee,silvermoon,96,paladin,holy,6,1,5
Tacita,nazjatar,96,paladin,holy,6,1,5
Shanwipe,thrall,96,paladin,holy,6,1,5
Popeadìn,the-maelstrom,96,paladin,holy,6,1,5
Visaria,twisting-nether,96,paladin,holy,6,1,5
Mybadvibes,tarren-mill,96,paladin,holy,6,1,5
Lommeuld,auchindoun,96,paladin,holy,6,1,5
Thatmook,twisting-nether,96,paladin,holy,6,1,5
Xaldrèk,silvermoon,96,paladin,holy,6,1,5
Водомафия,greymane,96,paladin,holy,6,1,5
Shanik,zuljin,96,paladin,holy,8,1,7
Ксаиотх,blackscar,96,paladin,holy,12,1,11
Mathelac,argent-dawn,96,paladin,holy,12,1,11
Byakkospal,tarren-mill,96,paladin,holy,12,1,11
Ahronius,stormscale,96,paladin,holy,12,1,11
Goldenstern,blackhand,96,paladin,holy,12,1,11
Catali,dalaran,96,paladin,holy,12,1,11
Hasler,drakthul,96,paladin,holy,12,1,11
Светиздырки,howling-fjord,96,paladin,holy,12,1,11
Fonz,ysondre,96,paladin,holy,12,1,11
Лейфи,howling-fjord,96,paladin,holy,12,1,11
Pigma,outland,96,paladin,holy,12,1,11
Lunaary,antonidas,96,paladin,holy,12,1,11
Veest,doomhammer,96,paladin,holy,12,1,11
Trennbolone,outland,96,paladin,holy,12,1,11
Tpaxocvetka,ravencrest,96,paladin,holy,18,1,17
Hancipapa,ragnaros,95,paladin,holy,6,1,5
Callon,das-syndikat,95,paladin,holy,6,1,5
Laidevon,twisting-nether,84,paladin,holy,21,6,15
Защешот,gordunni,79,paladin,holy,5,1,4
Salamaych,ysondre,79,paladin,holy,5,1,4
Shaxxzii,kazzak,79,paladin,holy,5,1,4
Firfiris,twisting-nether,64,paladin,holy,4,1,3
Ashbtw,outland,48,paladin,holy,3,1,2
Champal,hyjal,48,paladin,holy,3,1,2
Sixqti,blackrock,42,paladin,holy,6,2,4
Envli,ragnaros,42,paladin,holy,10,3,7
Holymerda,grim-batol,42,paladin,holy,8,2,6
Spryxx,draenor,42,paladin,holy,8,2,6
Ìu,draenor,42,paladin,holy,9,2,7
Xpurcica,twisting-nether,42,paladin,holy,10,2,8
Veluj,antonidas,16,paladin,holy,1,1,0
Kjn,tarren-mill,2329,paladin,retribution,182,100,82
Syruplol,blackrock,2278,paladin,retribution,237,128,109
Ranitwo,tarren-mill,2271,paladin,retribution,90,53,37
Harridin,ravencrest,2229,paladin,retribution,374,193,181
Drkp,blackrock,2228,paladin,retribution,73,51,22
Stracciatell,archimonde,2227,paladin,retribution,115,85,30
Exolix,archimonde,2221,paladin,retribution,96,52,44
Suprisexd,ravencrest,2215,paladin,retribution,108,56,52
Pïkachû,ravencrest,2213,paladin,retribution,84,45,39
Bakawolf,burning-legion,2213,paladin,retribution,101,54,47
Exolis,archimonde,2193,paladin,retribution,90,49,41
Синодх,eversong,2189,paladin,retribution,166,86,80
Daveboss,dragonblight,2183,paladin,retribution,84,44,40
Ctierpala,ravencrest,2161,paladin,retribution,90,47,43
Opettaja,ravencrest,2157,paladin,retribution,138,74,64
Legodudex,ravencrest,2154,paladin,retribution,198,101,97
Синодушка,blackscar,2152,paladin,retribution,100,53,47
Daybreak,kazzak,2146,paladin,retribution,170,85,85
Kriszi,burning-legion,2141,paladin,retribution,206,104,102
Miilicium,archimonde,2139,paladin,retribution,101,52,49
Lättäkamerus,ravencrest,2135,paladin,retribution,175,89,86
Radeto,outland,2134,paladin,retribution,96,51,45
Cosmicstâr,kazzak,2131,paladin,retribution,234,119,115
Ðâny,elune,2130,paladin,retribution,141,71,70
Galadrion,dun-modr,2129,paladin,retribution,87,47,40
Royki,the-maelstrom,2127,paladin,retribution,186,95,91
Freshreroll,tarren-mill,2125,paladin,retribution,72,43,29
Ёйхйё,blackscar,2124,paladin,retribution,377,213,164
Milipal,hyjal,2123,paladin,retribution,90,48,42
Loratheon,stormscale,2120,paladin,retribution,84,43,41
Tadashì,aegwynn,2120,paladin,retribution,102,51,51
Nedith,pozzo-delleternità,2119,paladin,retribution,240,128,112
Âlßêdø,ravencrest,2118,paladin,retribution,201,102,99
Mcret,ravencrest,2118,paladin,retribution,148,74,74
Ultrabenzo,ravencrest,2117,paladin,retribution,139,68,71
Herrius,ravencrest,2116,paladin,retribution,90,45,45
Insanepvplol,archimonde,2115,paladin,retribution,81,45,36
Swahadon,stormscale,2115,paladin,retribution,132,67,65
Vatix,trollbane,2112,paladin,retribution,90,45,45
Dibzi,argent-dawn,2112,paladin,retribution,84,42,42
Wickedwings,silvermoon,2111,paladin,retribution,118,59,59
Retwar,ravencrest,2110,paladin,retribution,107,63,44
Renaseh,twisting-nether,2108,paladin,retribution,112,57,55
Mcweedy,aegwynn,2108,paladin,retribution,84,42,42
Аеррис,gordunni,2106,paladin,retribution,113,57,56
Matinacc,tarren-mill,2105,paladin,retribution,126,73,53
Mýstíc,ravencrest,2105,paladin,retribution,292,145,147
Соулерт,ashenvale,2103,paladin,retribution,150,82,68
Pog,azshara,2102,paladin,retribution,87,46,41
Eysn,blackrock,2102,paladin,retribution,93,49,44
Pancakee,the-maelstrom,2101,paladin,retribution,95,52,43
Mainôs,ravencrest,2101,paladin,retribution,112,57,55
Steelsuit,argent-dawn,2100,paladin,retribution,290,154,136
Peiker,blackrock,2100,paladin,retribution,244,121,123
Ricexoxo,blackhand,2086,paladin,retribution,134,67,67
Maxes,twisting-nether,2085,paladin,retribution,293,156,137
Shinøaa,wrathbringer,2085,paladin,retribution,263,140,123
Sonne,tarren-mill,2079,paladin,retribution,156,80,76
Flaapz,hyjal,2078,paladin,retribution,497,271,226
Отловщик,gordunni,2069,paladin,retribution,130,63,67
Sacredwrath,burning-legion,2065,paladin,retribution,123,61,62
Альмор,blackscar,2064,paladin,retribution,60,31,29
Elypsia,tarren-mill,2060,paladin,retribution,285,142,143
Стимулин,howling-fjord,2055,paladin,retribution,223,116,107
Drdo,blackrock,2048,paladin,retribution,53,40,13
Блэкхарм,gordunni,2044,paladin,retribution,90,44,46
Pestomp,tarren-mill,2042,paladin,retribution,89,43,46
Vabz,blackrock,2041,paladin,retribution,89,44,45
Qshadow,frostwhisper,2037,paladin,retribution,226,111,115
Perxx,stormscale,2036,paladin,retribution,66,33,33
Rettalius,ravencrest,2035,paladin,retribution,226,119,107
Davewins,dragonblight,2033,paladin,retribution,42,34,8
Rankoneretri,arathor,2032,paladin,retribution,78,42,36
Pallyprinces,dentarg,2030,paladin,retribution,120,56,64
Мэднессх,howling-fjord,2027,paladin,retribution,79,37,42
Zerørespect,ravencrest,2025,paladin,retribution,161,81,80
Gìne,archimonde,2020,paladin,retribution,225,115,110
Bigspin,ravencrest,2020,paladin,retribution,339,171,168
Clessington,die-aldor,2018,paladin,retribution,81,43,38
Мевар,gordunni,2018,paladin,retribution,154,74,80
Holyhäätz,aegwynn,2017,paladin,retribution,129,70,59
Ðeathron,blackmoore,2012,paladin,retribution,182,93,89
Hotchíck,outland,2012,paladin,retribution,120,61,59
Crysania,twisting-nether,2012,paladin,retribution,78,36,42
Модрит,soulflayer,2011,paladin,retribution,133,83,50
Gluttön,tarren-mill,2011,paladin,retribution,89,47,42
Tsunà,antonidas,2011,paladin,retribution,108,55,53
Smirky,silvermoon,2011,paladin,retribution,72,36,36
Milkyavenger,sylvanas,2007,paladin,retribution,139,90,49
Alloüt,outland,2007,paladin,retribution,61,34,27
Ðaegos,blackmoore,2006,paladin,retribution,183,93,90
Марчи,howling-fjord,2005,paladin,retribution,247,123,124
Ufø,magtheridon,2005,paladin,retribution,232,115,117
Mezor,dun-modr,2004,paladin,retribution,309,157,152
Tròth,twisting-nether,2004,paladin,retribution,66,33,33
Saygexx,draenor,2003,paladin,retribution,74,43,31
Bernhoftxd,ravencrest,2003,paladin,retribution,312,152,160
Jinchúriki,aegwynn,1997,paladin,retribution,144,75,69
Bigducc,draenor,1997,paladin,retribution,84,40,44
Jualom,colinas-pardas,1995,paladin,retribution,134,70,64
Unholybeefs,draenor,1994,paladin,retribution,78,47,31
Chyve,tarren-mill,1993,paladin,retribution,192,96,96
Møøgødx,bronzebeard,1993,paladin,retribution,228,110,118
Мрч,howling-fjord,1992,paladin,retribution,66,34,32
Tpainjr,kazzak,1991,paladin,retribution,78,40,38
Franclovis,hyjal,1991,paladin,retribution,81,36,45
Palior,sylvanas,1990,paladin,retribution,84,44,40
Sitekx,burning-legion,1988,paladin,retribution,162,77,85
Ниашес,howling-fjord,1988,paladin,retribution,129,59,70
Ollebala,ravencrest,1987,paladin,retribution,196,115,81
Zarrex,blackrock,1987,paladin,retribution,72,37,35
Ritoru,drekthar,1985,paladin,retribution,58,30,28
Elganor,hyjal,1983,paladin,retribution,163,102,61
Sofhiya,silvermoon,1982,paladin,retribution,72,41,31
Galaadh,archimonde,1981,paladin,retribution,96,44,52
Valkûn,rexxar,1979,paladin,retribution,90,44,46
Tavil,sylvanas,1975,paladin,retribution,95,59,36
Beautýbeast,ravencrest,1975,paladin,retribution,209,108,101
Xourens,twisting-nether,1975,paladin,retribution,139,65,74
Кэйно,soulflayer,1970,paladin,retribution,87,38,49
Skyrose,ravencrest,1969,paladin,retribution,259,141,118
Васапрагиб,howling-fjord,1966,paladin,retribution,156,88,68
Kazuroo,blackmoore,1966,paladin,retribution,132,70,62
Fkadin,kazzak,1966,paladin,retribution,300,156,144
Hornyret,kazzak,1966,paladin,retribution,152,78,74
Elisight,ravencrest,1963,paladin,retribution,108,61,47
Kasualwrath,stormscale,1963,paladin,retribution,72,39,33
Хадакур,howling-fjord,1963,paladin,retribution,201,98,103
Morri,ravencrest,1961,paladin,retribution,231,118,113
Babyboo,aggra-português,1961,paladin,retribution,108,53,55
Fullsendbro,ravencrest,1959,paladin,retribution,149,83,66
Нейтхигерс,howling-fjord,1959,paladin,retribution,92,47,45
Fwb,xavius,1957,paladin,retribution,132,81,51
Brassaren,stormscale,1955,paladin,retribution,78,42,36
Xillindion,blackhand,1955,paladin,retribution,314,158,156
Retbùll,stormscale,1954,paladin,retribution,43,31,12
Argentø,ravencrest,1954,paladin,retribution,299,167,132
Запалтосик,blackscar,1952,paladin,retribution,42,25,17
Greywords,silvermoon,1952,paladin,retribution,53,30,23
Wingsteak,draenor,1952,paladin,retribution,81,44,37
Exolie,archimonde,1950,paladin,retribution,60,32,28
Хохахо,howling-fjord,1950,paladin,retribution,167,89,78
Холиврас,gordunni,1950,paladin,retribution,120,61,59
Prex,dun-modr,1948,paladin,retribution,72,39,33
Анофарин,gordunni,1947,paladin,retribution,279,143,136
Jowanno,stormscale,1944,paladin,retribution,165,84,81
Nîhil,silvermoon,1943,paladin,retribution,118,56,62
Esito,draenor,1938,paladin,retribution,124,63,61
Тардариус,gordunni,1937,paladin,retribution,90,42,48
Агинон,howling-fjord,1936,paladin,retribution,78,46,32
Ibnkrook,archimonde,1936,paladin,retribution,72,35,37
Claymore,ravenholdt,1936,paladin,retribution,77,36,41
Хемминг,gordunni,1935,paladin,retribution,131,81,50
Zscrew,nemesis,1935,paladin,retribution,48,27,21
Kírin,drakthul,1935,paladin,retribution,101,50,51
Bigdblaster,twisting-nether,1935,paladin,retribution,102,49,53
Nyxbane,kazzak,1935,paladin,retribution,72,33,39
Byths,blackmoore,1933,paladin,retribution,210,99,111
Rqd,blackrock,1932,paladin,retribution,60,34,26
Lübu,archimonde,1932,paladin,retribution,78,36,42
Spacknas,blackmoore,1931,paladin,retribution,110,62,48
Granfort,argent-dawn,1930,paladin,retribution,131,67,64
Denastys,nemesis,1930,paladin,retribution,120,59,61
Tj,dun-modr,1930,paladin,retribution,152,70,82
Aetecii,archimonde,1929,paladin,retribution,51,40,11
Азерит,galakrond,1929,paladin,retribution,66,37,29
Pepehands,nazjatar,1929,paladin,retribution,90,48,42
Timmes,blackhand,1927,paladin,retribution,90,42,48
Ноулайфир,eversong,1925,paladin,retribution,72,43,29
Îiî,archimonde,1923,paladin,retribution,104,53,51
Dragonwingz,kazzak,1919,paladin,retribution,64,39,25
Denounce,defias-brotherhood,1919,paladin,retribution,110,53,57
Lightstorm,voljin,1919,paladin,retribution,78,36,42
Xeaa,tarren-mill,1918,paladin,retribution,54,28,26
Йёкипавер,gordunni,1917,paladin,retribution,58,36,22
Yungboii,kazzak,1917,paladin,retribution,209,118,91
Carlá,silvermoon,1917,paladin,retribution,96,48,48
Rmpzeroskill,argent-dawn,1916,paladin,retribution,42,29,13
Réfractio,die-aldor,1916,paladin,retribution,180,91,89
Inkzen,silvermoon,1916,paladin,retribution,124,62,62
Алепос,soulflayer,1914,paladin,retribution,156,71,85
Babaluga,blackrock,1913,paladin,retribution,60,32,28
Pâsla,hyjal,1913,paladin,retribution,306,156,150
Nabbi,ravencrest,1912,paladin,retribution,206,96,110
Агинон,gordunni,1911,paladin,retribution,168,82,86
Nastalia,elune,1910,paladin,retribution,200,104,96
Littlelíght,silvermoon,1910,paladin,retribution,190,95,95
Мегопалл,blackscar,1910,paladin,retribution,236,117,119
ßancu,ragnaros,1910,paladin,retribution,88,40,48
Exolia,archimonde,1909,paladin,retribution,60,33,27
Obackbarama,outland,1909,paladin,retribution,72,37,35
Msharix,kazzak,1909,paladin,retribution,286,143,143
Sorannian,hyjal,1909,paladin,retribution,233,109,124
Tj,sanguino,1908,paladin,retribution,84,40,44
Mélli,eredar,1907,paladin,retribution,105,58,47
Kriszaa,burning-legion,1907,paladin,retribution,126,58,68
Sigmud,turalyon,1906,paladin,retribution,78,46,32
Lazaraat,antonidas,1905,paladin,retribution,125,58,67
Døgpaladin,outland,1903,paladin,retribution,77,39,38
Lorex,grim-batol,1903,paladin,retribution,66,33,33
Krýptø,ravencrest,1903,paladin,retribution,66,26,40
Mekluba,twisting-nether,1900,paladin,retribution,54,27,27
Меварх,howling-fjord,1898,paladin,retribution,48,23,25
Aresdin,blackmoore,1896,paladin,retribution,77,44,33
Nlyrld,magtheridon,1896,paladin,retribution,66,36,30
Yungboihoj,twisting-nether,1896,paladin,retribution,335,168,167
Melantus,eredar,1895,paladin,retribution,111,56,55
Gimly,anachronos,1895,paladin,retribution,332,161,171
Knøp,outland,1895,paladin,retribution,116,56,60
Pappnas,aegwynn,1894,paladin,retribution,60,37,23
Холирайз,gordunni,1894,paladin,retribution,42,21,21
Jedzy,ragnaros,1892,paladin,retribution,48,26,22
Ças,quelthalas,1892,paladin,retribution,84,39,45
Декионзхц,howling-fjord,1892,paladin,retribution,138,61,77
Мува,soulflayer,1891,paladin,retribution,116,60,56
Angryturk,ravencrest,1891,paladin,retribution,54,23,31
Knoxblue,tarren-mill,1890,paladin,retribution,134,67,67
Darkkissret,lightbringer,1889,paladin,retribution,108,54,54
Xòtrios,argent-dawn,1888,paladin,retribution,72,38,34
Smilé,sylvanas,1888,paladin,retribution,150,76,74
Tazken,tarren-mill,1888,paladin,retribution,178,88,90
Doomsoom,kazzak,1885,paladin,retribution,58,37,21
Hódle,silvermoon,1885,paladin,retribution,163,89,74
Ðeusvult,draenor,1885,paladin,retribution,108,57,51
Sonne,kazzak,1885,paladin,retribution,66,30,36
Smirk,aggra-português,1884,paladin,retribution,161,76,85
Askenor,blackrock,1884,paladin,retribution,77,36,41
Hojinson,blackrock,1883,paladin,retribution,60,39,21
Holzer,azshara,1883,paladin,retribution,71,40,31
Biggerspin,ravencrest,1882,paladin,retribution,24,20,4
Kêkbûrâgol,kazzak,1882,paladin,retribution,88,46,42
Phaewingsftw,kazzak,1882,paladin,retribution,60,30,30
Ilealstras,twisting-nether,1882,paladin,retribution,56,23,33
Толвард,gordunni,1881,paladin,retribution,25,21,4
Hammerzemall,tarren-mill,1881,paladin,retribution,71,36,35
Кхабелех,howling-fjord,1880,paladin,retribution,114,50,64
Сотранокинг,soulflayer,1878,paladin,retribution,48,23,25
Iagö,argent-dawn,1877,paladin,retribution,77,37,40
Rikimâro,kazzak,1876,paladin,retribution,30,20,10
Номос,soulflayer,1875,paladin,retribution,84,49,35
Antimov,twisting-nether,1875,paladin,retribution,162,81,81
Riyo,twisting-nether,1875,paladin,retribution,54,24,30
Mouku,stormreaver,1874,paladin,retribution,202,103,99
Vadya,ravencrest,1874,paladin,retribution,617,312,305
Neiiz,ragnaros,1874,paladin,retribution,185,90,95
Ганка,blackscar,1874,paladin,retribution,131,57,74
Hýpærpøp,ravencrest,1873,paladin,retribution,95,48,47
Apolloos,grim-batol,1873,paladin,retribution,89,40,49
Pætter,aggra-português,1872,paladin,retribution,72,40,32
Elbígotes,dun-modr,1870,paladin,retribution,90,51,39
Батллграунд,soulflayer,1870,paladin,retribution,108,61,47
Избиватель,soulflayer,1870,paladin,retribution,262,126,136
Nam,culte-de-la-rive-noire,1869,paladin,retribution,84,41,43
Yuber,ravencrest,1869,paladin,retribution,140,66,74
Малиновыйбох,gordunni,1868,paladin,retribution,213,117,96
Verbrännter,grim-batol,1867,paladin,retribution,130,69,61
Miru,defias-brotherhood,1867,paladin,retribution,114,53,61
Дэнискарз,gordunni,1866,paladin,retribution,48,26,22
Whitebronco,tarren-mill,1866,paladin,retribution,60,29,31
Purgebop,ravencrest,1865,paladin,retribution,116,69,47
Thyrec,blackmoore,1865,paladin,retribution,54,32,22
Mögräine,grim-batol,1865,paladin,retribution,84,42,42
Охоху,gordunni,1864,paladin,retribution,173,96,77
Holymerda,grim-batol,1864,paladin,retribution,65,36,29
Gùtz,xavius,1864,paladin,retribution,86,47,39
Джедай,blackscar,1864,paladin,retribution,108,46,62
Foreskinx,draenor,1863,paladin,retribution,48,28,20
Hammarfall,ravencrest,1863,paladin,retribution,156,88,68
Weekly,outland,1863,paladin,retribution,42,22,20
Tìberias,blackmoore,1863,paladin,retribution,54,25,29
Davoss,outland,1862,paladin,retribution,63,29,34
Nellyrld,stormscale,1862,paladin,retribution,89,38,51
Oliverrar,blackrock,1861,paladin,retribution,90,44,46
Киото,gordunni,1861,paladin,retribution,54,24,30
Terrozina,stormscale,1860,paladin,retribution,53,28,25
Nizzlee,eredar,1860,paladin,retribution,120,59,61
Thedarksteel,ravencrest,1860,paladin,retribution,76,37,39
Umîrînbrah,twisting-nether,1859,paladin,retribution,135,76,59
Baxuz,draenor,1859,paladin,retribution,70,35,35
Günykoloke,blackrock,1859,paladin,retribution,108,52,56
Ruath,xavius,1858,paladin,retribution,196,105,91
Bregowine,doomhammer,1857,paladin,retribution,291,163,128
Gladiator,die-aldor,1857,paladin,retribution,72,36,36
Icekissz,hyjal,1856,paladin,retribution,30,23,7
Kinvqt,tarren-mill,1856,paladin,retribution,130,68,62
Phalex,outland,1855,paladin,retribution,102,53,49
Мэибибэиби,howling-fjord,1855,paladin,retribution,174,90,84
Wickedret,kazzak,1855,paladin,retribution,66,34,32
Kaleyra,argent-dawn,1855,paladin,retribution,89,38,51
Валендил,gordunni,1854,paladin,retribution,72,39,33
Эвангер,gordunni,1854,paladin,retribution,72,35,37
Vanthael,chamber-of-aspects,1853,paladin,retribution,201,115,86
Zóran,kazzak,1852,paladin,retribution,93,46,47
Calaestra,twisting-nether,1852,paladin,retribution,108,53,55
Monaatamis,kazzak,1852,paladin,retribution,66,30,36
Jicob,ravencrest,1851,paladin,retribution,48,30,18
Zion,runetotem,1851,paladin,retribution,42,25,17
Deriøt,dun-modr,1851,paladin,retribution,179,96,83
Elisabeth,kazzak,1851,paladin,retribution,118,61,57
Dízeltekurva,ragnaros,1851,paladin,retribution,69,34,35
Dasar,twisting-nether,1851,paladin,retribution,72,31,41
Súnshìne,blackhand,1850,paladin,retribution,42,29,13
Утипутя,goldrinn,1850,paladin,retribution,102,53,49
Jessrabit,tarren-mill,1850,paladin,retribution,84,40,44
Enîgmä,ravencrest,1850,paladin,retribution,82,33,49
Rùuru,archimonde,1849,paladin,retribution,330,157,173
Mcrunt,ravencrest,1848,paladin,retribution,35,27,8
Yana,blackrock,1848,paladin,retribution,55,32,23
Malapal,hyjal,1848,paladin,retribution,64,37,27
Caladys,silvermoon,1848,paladin,retribution,135,76,59
Muhnnin,archimonde,1848,paladin,retribution,78,41,37
Cheradin,ragnaros,1847,paladin,retribution,73,35,38
Oslopal,stormscale,1847,paladin,retribution,76,36,40
Ксандэр,soulflayer,1846,paladin,retribution,47,27,20
Winkz,rajaxx,1846,paladin,retribution,102,51,51
Jacadin,sunstrider,1845,paladin,retribution,80,47,33
Kaileena,archimonde,1845,paladin,retribution,71,41,30
Беспощадие,gordunni,1844,paladin,retribution,117,67,50
Nutqtgodx,archimonde,1844,paladin,retribution,54,29,25
Chuy,burning-legion,1844,paladin,retribution,72,32,40
Ykzy,hyjal,1843,paladin,retribution,42,28,14
Saedrick,nemesis,1843,paladin,retribution,123,60,63
Misú,ravencrest,1843,paladin,retribution,60,29,31
Karnabahar,twisting-nether,1843,paladin,retribution,42,20,22
Ethurospal,tarren-mill,1843,paladin,retribution,51,21,30
Drhammerdin,antonidas,1842,paladin,retribution,54,25,29
Якунии,blackscar,1841,paladin,retribution,54,30,24
Namapala,silvermoon,1841,paladin,retribution,161,86,75
Alatàríèl,dalaran,1841,paladin,retribution,96,51,45
Стьюпидбой,howling-fjord,1841,paladin,retribution,234,119,115
Courage,stormscale,1841,paladin,retribution,125,62,63
Lïnea,aegwynn,1840,paladin,retribution,48,25,23
Saiyaan,silvermoon,1840,paladin,retribution,114,56,58
Eimaqt,stormscale,1840,paladin,retribution,76,35,41
Retforlife,sylvanas,1839,paladin,retribution,42,26,16
Ijudgeppl,stormscale,1839,paladin,retribution,60,33,27
Lbj,eredar,1839,paladin,retribution,48,26,22
Lecutus,sunstrider,1839,paladin,retribution,149,72,77
Stepakonch,ravencrest,1838,paladin,retribution,96,52,44
Panicmaker,ravencrest,1837,paladin,retribution,90,59,31
Гуэргос,gordunni,1837,paladin,retribution,72,38,34
Lesterqt,thrall,1837,paladin,retribution,156,77,79
Phix,outland,1837,paladin,retribution,231,113,118
Ghosti,festung-der-stürme,1837,paladin,retribution,60,29,31
Actionjack,area-52,1837,paladin,retribution,78,36,42
Ilòvekris,draenor,1836,paladin,retribution,249,126,123
Ophillan,draenor,1835,paladin,retribution,72,34,38
Murkyxd,sanguino,1835,paladin,retribution,66,30,36
Stjeans,kazzak,1834,paladin,retribution,78,55,23
Vankwok,stormscale,1834,paladin,retribution,53,30,23
Bajheeroth,kazzak,1833,paladin,retribution,117,72,45
Инфернох,howling-fjord,1833,paladin,retribution,236,124,112
Netharia,antonidas,1833,paladin,retribution,126,63,63
Магрейм,gordunni,1833,paladin,retribution,83,39,44
Miriokekw,archimonde,1833,paladin,retribution,180,80,100
Darkkissx,lightbringer,1832,paladin,retribution,48,25,23
Miju,blackmoore,1831,paladin,retribution,51,28,23
Aranael,nemesis,1831,paladin,retribution,66,32,34
Sloug,archimonde,1831,paladin,retribution,108,48,60
Blacked,baelgun,1830,paladin,retribution,39,21,18
Lightlogic,ravencrest,1830,paladin,retribution,104,52,52
Skyf,outland,1830,paladin,retribution,102,44,58
Youmistpew,antonidas,1829,paladin,retribution,72,28,44
Аниф,ashenvale,1828,paladin,retribution,240,126,114
Аполодориан,gordunni,1828,paladin,retribution,138,68,70
Лиспорий,gordunni,1828,paladin,retribution,102,48,54
Monkeytm,archimonde,1828,paladin,retribution,98,42,56
Sántouryu,ravencrest,1827,paladin,retribution,448,230,218
Dréamypie,silvermoon,1827,paladin,retribution,65,26,39
Analnydarek,silvermoon,1826,paladin,retribution,198,108,90
Tembe,draenor,1826,paladin,retribution,59,27,32
Tremelay,silvermoon,1825,paladin,retribution,240,122,118
Zazalamel,hyjal,1824,paladin,retribution,102,58,44
Zagwan,ravencrest,1824,paladin,retribution,90,51,39
Alatie,dentarg,1824,paladin,retribution,156,85,71
Wellmetqt,aegwynn,1824,paladin,retribution,146,73,73
Ajani,la-croisade-écarlate,1823,paladin,retribution,45,25,20
Игры,gordunni,1823,paladin,retribution,76,39,37
Zubxp,ravencrest,1823,paladin,retribution,189,96,93
Рикшак,howling-fjord,1823,paladin,retribution,63,31,32
Keinah,silvermoon,1822,paladin,retribution,54,36,18
Retaxx,outland,1822,paladin,retribution,54,33,21
Auriuss,defias-brotherhood,1822,paladin,retribution,237,131,106
Ríppex,kazzak,1822,paladin,retribution,66,33,33
Eskanor,kilrogg,1821,paladin,retribution,56,36,20
Stavrosy,outland,1821,paladin,retribution,107,52,55
Xairo,twisting-nether,1821,paladin,retribution,60,29,31
Posttal,aggra-português,1821,paladin,retribution,48,23,25
Ërzã,outland,1821,paladin,retribution,72,31,41
Coldcuts,sylvanas,1820,paladin,retribution,102,47,55
Aaes,argent-dawn,1819,paladin,retribution,95,65,30
Arígato,argent-dawn,1819,paladin,retribution,173,95,78
Дюрьвючыф,razuvious,1819,paladin,retribution,143,74,69
Zondãn,blackrock,1819,paladin,retribution,54,27,27
Âtlas,ragnaros,1819,paladin,retribution,48,24,24
Kamata,kazzak,1819,paladin,retribution,93,44,49
Воркаллес,gordunni,1818,paladin,retribution,220,130,90
Feelmylight,tarren-mill,1818,paladin,retribution,53,27,26
Wingsgodx,archimonde,1818,paladin,retribution,60,28,32
Astragore,archimonde,1818,paladin,retribution,95,42,53
Кошкотяночка,ashenvale,1818,paladin,retribution,54,23,31
Rullatorsvèn,stormscale,1818,paladin,retribution,66,28,38
Nikkibenzqt,blackmoore,1818,paladin,retribution,84,35,49
Quelän,draenor,1817,paladin,retribution,47,29,18
Odin,silvermoon,1817,paladin,retribution,104,58,46
Bloodaxjr,archimonde,1817,paladin,retribution,232,129,103
Hirako,nemesis,1817,paladin,retribution,72,39,33
Larnbert,argent-dawn,1817,paladin,retribution,66,34,32
Фэйсрол,gordunni,1817,paladin,retribution,93,37,56
Shaniquua,dun-modr,1816,paladin,retribution,84,41,43
Алекхей,gordunni,1816,paladin,retribution,92,38,54
Estellar,bronze-dragonflight,1815,paladin,retribution,177,98,79
Rígel,silvermoon,1815,paladin,retribution,82,44,38
Madmartigane,ysondre,1815,paladin,retribution,114,48,66
Фемдом,blackscar,1814,paladin,retribution,48,27,21
Tepowze,twisting-nether,1814,paladin,retribution,54,30,24
Valnyr,the-maelstrom,1814,paladin,retribution,121,64,57
Hargreeve,ravencrest,1813,paladin,retribution,102,57,45
Déna,draenor,1813,paladin,retribution,52,29,23
Ktk,ravencrest,1813,paladin,retribution,121,67,54
Пинкпуссибой,howling-fjord,1813,paladin,retribution,142,77,65
Bancu,outland,1813,paladin,retribution,59,30,29
Memororo,stormscale,1813,paladin,retribution,92,46,46
ßßæßßæßß,stormscale,1813,paladin,retribution,90,41,49
Honorkill,silvermoon,1812,paladin,retribution,256,144,112
Bangßros,archimonde,1812,paladin,retribution,54,30,24
Archibäld,silvermoon,1812,paladin,retribution,49,27,22
Quasimod,ravencrest,1812,paladin,retribution,138,75,63
Djuwuu,twisting-nether,1812,paladin,retribution,62,30,32
Durenai,aegwynn,1812,paladin,retribution,236,112,124
Losër,ravencrest,1812,paladin,retribution,66,27,39
Halevia,kazzak,1811,paladin,retribution,101,50,51
Wingzy,hyjal,1811,paladin,retribution,116,57,59
Bulkpwders,burning-legion,1811,paladin,retribution,66,31,35
Kreozz,destromath,1811,paladin,retribution,79,33,46
Коварное,borean-tundra,1810,paladin,retribution,66,36,30
Reth,tarren-mill,1810,paladin,retribution,60,32,28
Mythsion,blackmoore,1810,paladin,retribution,96,49,47
Baelwynn,defias-brotherhood,1810,paladin,retribution,59,30,29
Ironquist,doomhammer,1809,paladin,retribution,42,22,20
Io,frostwolf,1809,paladin,retribution,257,133,124
Thun,azjolnerub,1809,paladin,retribution,72,37,35
Nordiusek,drakthul,1809,paladin,retribution,64,31,33
Amburet,kazzak,1809,paladin,retribution,42,19,23
Zayaka,ragnaros,1809,paladin,retribution,120,51,69
Модрес,soulflayer,1808,paladin,retribution,37,24,13
Saintseiya,pozzo-delleternità,1808,paladin,retribution,60,33,27
Djrayk,archimonde,1808,paladin,retribution,42,22,20
Mâttyy,stormscale,1808,paladin,retribution,66,29,37
Tolgerias,twisting-nether,1807,paladin,retribution,72,36,36
Ertheus,argent-dawn,1807,paladin,retribution,72,34,38
Джамбит,howling-fjord,1806,paladin,retribution,72,45,27
Tivv,blackhand,1806,paladin,retribution,53,28,25
Iiwar,silvermoon,1806,paladin,retribution,89,46,43
Kiriel,dun-modr,1806,paladin,retribution,144,65,79
Réaxon,archimonde,1806,paladin,retribution,69,30,39
Тутн,gordunni,1805,paladin,retribution,54,29,25
Ookleb,tarren-mill,1805,paladin,retribution,120,60,60
Matriarchxd,kazzak,1805,paladin,retribution,48,24,24
Vhardan,archimonde,1805,paladin,retribution,209,104,105
Geneundreitt,dethecus,1805,paladin,retribution,54,26,28
Krîstal,aegwynn,1805,paladin,retribution,77,33,44
Taneren,argent-dawn,1804,paladin,retribution,48,29,19
Heiimdal,dun-morogh,1804,paladin,retribution,46,26,20
Tsorig,tarren-mill,1804,paladin,retribution,177,98,79
Летвамар,gordunni,1804,paladin,retribution,162,82,80
Блэканус,blackscar,1804,paladin,retribution,60,28,32
Aqualisse,hyjal,1804,paladin,retribution,66,30,36
Zey,auchindoun,1804,paladin,retribution,66,29,37
Wannabis,twisting-nether,1803,paladin,retribution,179,99,80
Racduck,dunemaul,1803,paladin,retribution,160,85,75
Qpala,quelthalas,1803,paladin,retribution,36,19,17
Crîîngêr,blackhand,1803,paladin,retribution,86,42,44
Breakdøwñ,blackrock,1803,paladin,retribution,196,93,103
Ogpullava,sylvanas,1802,paladin,retribution,60,34,26
Boëndil,ravencrest,1802,paladin,retribution,189,106,83
Атмх,soulflayer,1802,paladin,retribution,54,28,26
Antou,twisting-nether,1802,paladin,retribution,211,108,103
Meruem,blackrock,1802,paladin,retribution,53,26,27
Xsÿde,archimonde,1802,paladin,retribution,128,59,69
Elesmerias,dalaran,1801,paladin,retribution,107,65,42
Shanice,twilights-hammer,1801,paladin,retribution,83,47,36
Thoriz,elune,1801,paladin,retribution,84,43,41
Всеволорд,howling-fjord,1801,paladin,retribution,72,36,36
Brõw,hyjal,1801,paladin,retribution,42,21,21
Martoretard,archimonde,1801,paladin,retribution,430,212,218
Bluehustler,tarren-mill,1801,paladin,retribution,189,90,99
Brudiwinkler,blackrock,1800,paladin,retribution,60,39,21
Nurti,kazzak,1800,paladin,retribution,88,50,38
Retdead,nordrassil,1800,paladin,retribution,60,32,28
Delgato,kazzak,1800,paladin,retribution,152,80,72
Alphaladin,stormscale,1800,paladin,retribution,72,37,35
Лакостик,howling-fjord,1800,paladin,retribution,156,78,78
Zachäus,kirin-tor,1800,paladin,retribution,114,57,57
Råckamoo,emerald-dream,1800,paladin,retribution,100,45,55
Tauskiz,sylvanas,1800,paladin,retribution,48,19,29
Brianxd,tarren-mill,1798,paladin,retribution,163,88,75
Мидэас,gordunni,1798,paladin,retribution,96,44,52
Aylion,blackrock,1797,paladin,retribution,66,45,21
Maybach,onyxia,1797,paladin,retribution,186,100,86
Хашон,gordunni,1797,paladin,retribution,60,32,28
Mbappê,kazzak,1796,paladin,retribution,66,29,37
Телканапалке,blackscar,1795,paladin,retribution,48,35,13
Арморих,gordunni,1795,paladin,retribution,52,28,24
Деленка,gordunni,1795,paladin,retribution,346,183,163
Zïlda,archimonde,1795,paladin,retribution,389,202,187
Papichuló,aegwynn,1794,paladin,retribution,96,45,51
Cappy,twisting-nether,1793,paladin,retribution,85,49,36
Zialo,ravencrest,1792,paladin,retribution,99,44,55
Tanny,kazzak,1791,paladin,retribution,108,51,57
Тельбрук,gordunni,1790,paladin,retribution,67,35,32
Sunhalo,twisting-nether,1789,paladin,retribution,101,51,50
Charcoalman,argent-dawn,1788,paladin,retribution,24,19,5
Pridehammer,stormscale,1788,paladin,retribution,48,31,17
Kayllan,ravencrest,1788,paladin,retribution,182,100,82
Allenn,tarren-mill,1788,paladin,retribution,59,28,31
Risingfi,kult-der-verdammten,1787,paladin,retribution,84,48,36
Nein,blackhand,1787,paladin,retribution,186,87,99
Elitest,hyjal,1787,paladin,retribution,73,34,39
Bubbleteâ,blackhand,1786,paladin,retribution,227,113,114
Mayhemx,ravencrest,1786,paladin,retribution,359,174,185
Bjornulfr,ravencrest,1786,paladin,retribution,154,74,80
Thmas,tarren-mill,1785,paladin,retribution,264,141,123
Menephannt,outland,1785,paladin,retribution,57,28,29
Scillá,aegwynn,1785,paladin,retribution,109,49,60
Serjudge,kazzak,1781,paladin,retribution,99,53,46
Dominikcro,sylvanas,1780,paladin,retribution,78,42,36
Wellick,ravencrest,1779,paladin,retribution,41,20,21
Наспидах,grom,1779,paladin,retribution,114,53,61
Альфазеро,howling-fjord,1778,paladin,retribution,244,129,115
Stazo,drakthul,1778,paladin,retribution,62,31,31
Djstompyamom,stormscale,1778,paladin,retribution,152,71,81
Merkury,sanguino,1778,paladin,retribution,66,30,36
Bobjohnny,bloodfeather,1776,paladin,retribution,48,21,27
Вайлдбебриз,eversong,1775,paladin,retribution,94,58,36
Karadøc,archimonde,1775,paladin,retribution,108,49,59
Lûvmølly,silvermoon,1775,paladin,retribution,60,27,33
Tcret,sanguino,1773,paladin,retribution,53,26,27
Justyowx,archimonde,1772,paladin,retribution,108,50,58
Кухонныйвор,howling-fjord,1771,paladin,retribution,114,58,56
Enlightendz,ravencrest,1771,paladin,retribution,126,62,64
Typhadin,sylvanas,1771,paladin,retribution,60,28,32
Торсгард,howling-fjord,1771,paladin,retribution,231,106,125
Irondawg,rajaxx,1771,paladin,retribution,103,46,57
Bersercute,sylvanas,1770,paladin,retribution,178,83,95
Wingcomandêr,aegwynn,1768,paladin,retribution,60,30,30
Ablaa,blackhand,1766,paladin,retribution,54,27,27
Geilershrimp,blackrock,1764,paladin,retribution,191,96,95
Ezetrol,xavius,1764,paladin,retribution,54,26,28
Nìcky,stormscale,1764,paladin,retribution,101,44,57
Surian,kazzak,1763,paladin,retribution,78,45,33
Dainan,blackmoore,1763,paladin,retribution,169,84,85
Testør,ragnaros,1763,paladin,retribution,256,123,133
Naneno,silvermoon,1763,paladin,retribution,152,71,81
Extremnäsa,outland,1762,paladin,retribution,222,103,119
Holysiah,kazzak,1762,paladin,retribution,114,51,63
Mhehø,hyjal,1760,paladin,retribution,343,169,174
Дезоиль,gordunni,1759,paladin,retribution,72,36,36
Runhexi,silvermoon,1758,paladin,retribution,181,98,83
Опгоп,gordunni,1758,paladin,retribution,89,45,44
Ослепителен,eversong,1758,paladin,retribution,120,54,66
Threathor,outland,1757,paladin,retribution,207,113,94
Riares,darkspear,1757,paladin,retribution,169,86,83
ßlacklight,archimonde,1757,paladin,retribution,72,28,44
Kayback,archimonde,1756,paladin,retribution,142,76,66
Рапсодихх,gordunni,1755,paladin,retribution,152,85,67
Holyinvictus,twisting-nether,1755,paladin,retribution,270,140,130
Kanyewesh,dalaran,1755,paladin,retribution,77,39,38
Sulask,argent-dawn,1754,paladin,retribution,48,21,27
Gilgadlor,stormscale,1754,paladin,retribution,48,20,28
Venepal,eredar,1753,paladin,retribution,42,26,16
Холихит,gordunni,1753,paladin,retribution,154,79,75
Ïdø,hyjal,1753,paladin,retribution,204,100,104
Shorykezu,kazzak,1752,paladin,retribution,52,26,26
Cqt,ravencrest,1752,paladin,retribution,84,36,48
Spiritbreak,archimonde,1751,paladin,retribution,48,24,24
Galenhad,kazzak,1751,paladin,retribution,132,61,71
Bubbloseven,archimonde,1750,paladin,retribution,126,73,53
Asærý,blackmoore,1750,paladin,retribution,105,58,47
Kipperb,kazzak,1750,paladin,retribution,77,41,36
Ревирант,gordunni,1749,paladin,retribution,51,28,23
Братстепина,gordunni,1749,paladin,retribution,112,58,54
Kårnaj,archimonde,1748,paladin,retribution,55,27,28
Реальныйпал,gordunni,1748,paladin,retribution,156,73,83
Roostersucka,stormreaver,1747,paladin,retribution,66,29,37
Биоразлагаем,gordunni,1746,paladin,retribution,204,111,93
Bigbuffdaddy,draenor,1746,paladin,retribution,446,225,221
Rullatôrsven,stormscale,1746,paladin,retribution,54,21,33
Seraphyonhd,blackmoore,1745,paladin,retribution,145,82,63
Starworkal,ragnaros,1745,paladin,retribution,147,77,70
Bigolcritty,silvermoon,1744,paladin,retribution,76,39,37
Сводимиаое,soulflayer,1744,paladin,retribution,58,27,31
Cursedd,sanguino,1742,paladin,retribution,36,23,13
Данхайк,gordunni,1742,paladin,retribution,198,110,88
Shârâs,kazzak,1742,paladin,retribution,90,39,51
Staticdeath,ravencrest,1741,paladin,retribution,276,142,134
Razrpal,tarren-mill,1740,paladin,retribution,56,29,27
Flamabella,argent-dawn,1740,paladin,retribution,42,21,21
Justrhino,kazzak,1740,paladin,retribution,59,25,34
Xinze,ravencrest,1739,paladin,retribution,87,45,42
Gõm,aegwynn,1739,paladin,retribution,45,22,23
Fullflavor,bladefist,1739,paladin,retribution,150,70,80
Бэйгреон,gordunni,1738,paladin,retribution,202,114,88
Taurski,sylvanas,1737,paladin,retribution,83,49,34
Jíyü,blackmoore,1737,paladin,retribution,42,23,19
Торсгад,gordunni,1737,paladin,retribution,66,36,30
Plarbo,blackmoore,1737,paladin,retribution,72,35,37
Peachead,archimonde,1736,paladin,retribution,110,51,59
Zarispal,tarren-mill,1735,paladin,retribution,69,39,30
Niou,alleria,1735,paladin,retribution,116,61,55
Солошафл,howling-fjord,1735,paladin,retribution,48,24,24
Апония,gordunni,1735,paladin,retribution,93,35,58
Korendil,frostmane,1734,paladin,retribution,73,33,40
Лайтфури,gordunni,1734,paladin,retribution,65,29,36
Lightbrîng,hyjal,1733,paladin,retribution,223,116,107
Badpal,blackhand,1732,paladin,retribution,67,38,29
Selina,burning-legion,1732,paladin,retribution,154,78,76
Heavensfang,outland,1732,paladin,retribution,83,42,41
Johannx,tarren-mill,1732,paladin,retribution,240,118,122
Gwynel,argent-dawn,1732,paladin,retribution,96,47,49
Jaegeer,draenor,1732,paladin,retribution,82,38,44
Testør,outland,1731,paladin,retribution,72,40,32
Laaserjörö,outland,1731,paladin,retribution,42,20,22
Vonadams,ysondre,1731,paladin,retribution,60,28,32
Gangb,ravencrest,1730,paladin,retribution,63,34,29
Lightfôrce,blackmoore,1730,paladin,retribution,85,43,42
Vanques,burning-legion,1730,paladin,retribution,59,28,31
Holybubble,stormscale,1730,paladin,retribution,86,37,49
Zuldekk,sanguino,1729,paladin,retribution,124,65,59
Valterus,burning-legion,1729,paladin,retribution,198,96,102
Bovinepope,tarren-mill,1728,paladin,retribution,66,41,25
Arayël,archimonde,1728,paladin,retribution,114,61,53
Чупаа,howling-fjord,1728,paladin,retribution,88,47,41
Krivonis,tarren-mill,1728,paladin,retribution,111,58,53
Loani,dalaran,1728,paladin,retribution,54,28,26
Molgran,defias-brotherhood,1728,paladin,retribution,178,82,96
Nukkss,silvermoon,1727,paladin,retribution,108,48,60
Juicycheeks,frostwolf,1727,paladin,retribution,66,28,38
Lyliananl,outland,1726,paladin,retribution,162,79,83
Mirøku,silvermoon,1726,paladin,retribution,109,53,56
Refuse,blackrock,1726,paladin,retribution,142,68,74
Guilt,aegwynn,1726,paladin,retribution,140,62,78
Ilililì,silvermoon,1725,paladin,retribution,46,27,19
Русэльф,howling-fjord,1725,paladin,retribution,171,89,82
Lostfire,sinstralis,1725,paladin,retribution,96,49,47
Flaweldin,ravencrest,1724,paladin,retribution,112,69,43
Кхарнх,soulflayer,1724,paladin,retribution,60,30,30
Mimð,kazzak,1723,paladin,retribution,42,24,18
Ðivine,stormscale,1723,paladin,retribution,319,172,147
Pârabellum,the-maelstrom,1723,paladin,retribution,185,86,99
Фэрплэйн,gordunni,1722,paladin,retribution,72,41,31
Azryn,kazzak,1722,paladin,retribution,122,68,54
Schukow,blackhand,1722,paladin,retribution,36,18,18
Sübôvîñ,ravencrest,1721,paladin,retribution,71,40,31
Harlequina,argent-dawn,1720,paladin,retribution,93,48,45
Johnnÿsins,hyjal,1719,paladin,retribution,78,38,40
Факофф,gordunni,1718,paladin,retribution,72,46,26
Батллграунт,soulflayer,1718,paladin,retribution,193,113,80
Drownlord,eredar,1718,paladin,retribution,34,19,15
Highfivè,ravencrest,1718,paladin,retribution,90,49,41
Reivah,silvermoon,1718,paladin,retribution,83,36,47
Vanithar,thrall,1717,paladin,retribution,104,51,53
Xinxin,azshara,1717,paladin,retribution,90,44,46
Varioon,antonidas,1717,paladin,retribution,131,63,68
Rubína,aegwynn,1716,paladin,retribution,38,21,17
Athená,baelgun,1715,paladin,retribution,40,26,14
Макракура,gordunni,1715,paladin,retribution,30,18,12
Петуретрик,gordunni,1715,paladin,retribution,244,132,112
Cerfica,drakthul,1715,paladin,retribution,174,92,82
Pallygân,thrall,1715,paladin,retribution,54,25,29
Beigerbala,blackrock,1715,paladin,retribution,42,18,24
Schôck,eredar,1714,paladin,retribution,87,45,42
Витурус,howling-fjord,1714,paladin,retribution,114,48,66
Mûhkûh,blackrock,1713,paladin,retribution,36,18,18
Trølled,aegwynn,1713,paladin,retribution,239,116,123
Нижмубабл,soulflayer,1713,paladin,retribution,69,31,38
Répo,twisting-nether,1712,paladin,retribution,48,23,25
Мизуриэль,howling-fjord,1711,paladin,retribution,78,48,30
Dacilez,ravencrest,1711,paladin,retribution,266,130,136
Enviniv,tarren-mill,1711,paladin,retribution,84,37,47
Иев,howling-fjord,1710,paladin,retribution,127,62,65
Thesavage,magtheridon,1709,paladin,retribution,77,42,35
Bigdamjudgee,outland,1709,paladin,retribution,41,22,19
Ayylmeow,tarren-mill,1709,paladin,retribution,56,28,28
Менетиил,galakrond,1709,paladin,retribution,136,65,71
Deidâra,blackhand,1709,paladin,retribution,42,18,24
Noxaer,archimonde,1708,paladin,retribution,24,18,6
Yourredead,shadowsong,1708,paladin,retribution,90,45,45
Асканиэль,howling-fjord,1708,paladin,retribution,319,158,161
Делимнаноль,blackscar,1708,paladin,retribution,396,196,200
Ryxxii,ravencrest,1708,paladin,retribution,138,64,74
Dornu,tarren-mill,1708,paladin,retribution,48,22,26
Reito,eredar,1707,paladin,retribution,102,51,51
Шакиори,gordunni,1707,paladin,retribution,82,40,42
Eiennoai,argent-dawn,1706,paladin,retribution,62,39,23
Lifepower,nemesis,1706,paladin,retribution,45,27,18
Elendor,shadowsong,1706,paladin,retribution,66,38,28
Palwig,tarren-mill,1706,paladin,retribution,178,95,83
Shenwarr,twisting-nether,1706,paladin,retribution,76,40,36
Anesthesiax,ravencrest,1706,paladin,retribution,77,36,41
Ттиаматт,howling-fjord,1706,paladin,retribution,58,25,33
Blakethorn,silvermoon,1705,paladin,retribution,48,23,25
Tastán,aegwynn,1704,paladin,retribution,33,21,12
Zeackzs,rajaxx,1704,paladin,retribution,42,26,16
Crascch,blackmoore,1704,paladin,retribution,48,25,23
Ngel,marécage-de-zangar,1704,paladin,retribution,42,21,21
Rafflesia,sanguino,1704,paladin,retribution,65,25,40
Bubblebuttx,ghostlands,1703,paladin,retribution,113,66,47
Joekickass,madmortem,1703,paladin,retribution,52,27,25
Яидваклоуна,soulflayer,1703,paladin,retribution,36,18,18
Unschúld,blackrock,1702,paladin,retribution,193,107,86
Tyristrum,kilrogg,1702,paladin,retribution,72,36,36
Limitles,nemesis,1702,paladin,retribution,87,37,50
Azrpal,ravencrest,1701,paladin,retribution,56,26,30
Baraya,archimonde,1701,paladin,retribution,41,19,22
Scarabeus,ravencrest,1700,paladin,retribution,137,81,56
Thórvaldr,argent-dawn,1700,paladin,retribution,54,30,24
Ливх,blackscar,1700,paladin,retribution,121,65,56
Lílou,blackmoore,1700,paladin,retribution,99,52,47
Holyhannes,blackmoore,1699,paladin,retribution,77,39,38
Goofymits,twisting-nether,1699,paladin,retribution,96,48,48
Wingsmode,kazzak,1699,paladin,retribution,106,44,62
Ðenlox,destromath,1699,paladin,retribution,72,29,43
Xëlâ,archimonde,1698,paladin,retribution,103,58,45
Laptop,aegwynn,1698,paladin,retribution,48,27,21
Bubbls,laughing-skull,1698,paladin,retribution,36,20,16
Астта,fordragon,1698,paladin,retribution,96,46,50
Lydriana,die-aldor,1698,paladin,retribution,58,27,31
Salladín,stormscale,1697,paladin,retribution,63,37,26
Simjon,defias-brotherhood,1697,paladin,retribution,199,108,91
Hojacat,ravencrest,1697,paladin,retribution,42,22,20
Зондарк,booty-bay,1697,paladin,retribution,106,49,57
Xciepo,rexxar,1697,paladin,retribution,96,44,52
Cardedeu,zuljin,1696,paladin,retribution,66,30,36
Lorthaél,karazhan,1695,paladin,retribution,147,75,72
Qarak,argent-dawn,1695,paladin,retribution,71,32,39
Pawelinus,blackrock,1694,paladin,retribution,42,25,17
Pingla,argent-dawn,1694,paladin,retribution,139,75,64
Таптыгин,gordunni,1694,paladin,retribution,96,45,51
Salti,magtheridon,1693,paladin,retribution,142,77,65
Mordar,ravencrest,1693,paladin,retribution,115,57,58
Azûl,archimonde,1692,paladin,retribution,234,121,113
Sharn,ravencrest,1692,paladin,retribution,112,56,56
Retlikeme,ravencrest,1692,paladin,retribution,52,23,29
Skoopey,twisting-nether,1691,paladin,retribution,133,64,69
Nerrona,silvermoon,1691,paladin,retribution,60,25,35
Коссандра,greymane,1691,paladin,retribution,88,35,53
Biqmac,mugthol,1690,paladin,retribution,45,25,20
Koly,dun-modr,1690,paladin,retribution,134,70,64
Вэндрик,azuregos,1690,paladin,retribution,100,45,55
Ingenuous,draenor,1689,paladin,retribution,81,42,39
Waneis,ravencrest,1689,paladin,retribution,60,31,29
Käyle,alakir,1689,paladin,retribution,60,29,31
Lisma,bloodfeather,1688,paladin,retribution,71,40,31
Mommyret,draenor,1688,paladin,retribution,107,59,48
Akoumb,twisting-nether,1688,paladin,retribution,180,93,87
Djandja,blackrock,1688,paladin,retribution,119,61,58
Адвакаад,soulflayer,1688,paladin,retribution,66,33,33
Lightsaint,kazzak,1687,paladin,retribution,66,37,29
Rekktadin,grim-batol,1687,paladin,retribution,191,93,98
Vvsdiamonds,archimonde,1687,paladin,retribution,65,29,36
Toxií,argent-dawn,1687,paladin,retribution,100,43,57
Holyshet,blackrock,1686,paladin,retribution,79,44,35
Строу,blackscar,1686,paladin,retribution,67,36,31
Хилерскийхил,soulflayer,1685,paladin,retribution,140,71,69
Matchstick,defias-brotherhood,1685,paladin,retribution,53,23,30
Ceccil,dun-modr,1684,paladin,retribution,162,93,69
Yo,azshara,1684,paladin,retribution,66,34,32
Арагонис,howling-fjord,1684,paladin,retribution,84,43,41
Llya,blackrock,1683,paladin,retribution,72,47,25
Silverglaze,defias-brotherhood,1683,paladin,retribution,54,30,24
Eniste,silvermoon,1683,paladin,retribution,178,89,89
Evelisyze,twisting-nether,1683,paladin,retribution,138,65,73
Blademasteer,jaedenar,1683,paladin,retribution,60,27,33
Refléx,zirkel-des-cenarius,1683,paladin,retribution,54,23,31
Curt,sanguino,1683,paladin,retribution,72,29,43
Budgetcara,stormscale,1682,paladin,retribution,41,22,19
Otsutsuki,darkspear,1682,paladin,retribution,62,33,29
Guskey,draenor,1682,paladin,retribution,138,71,67
Tyrael,darksorrow,1682,paladin,retribution,251,127,124
Данбро,borean-tundra,1682,paladin,retribution,108,53,55
Аилерия,howling-fjord,1681,paladin,retribution,436,230,206
Milkadìn,twisting-nether,1681,paladin,retribution,138,72,66
Libertum,silvermoon,1681,paladin,retribution,54,28,26
Vpl,ravencrest,1681,paladin,retribution,38,19,19
Tekåpal,tarren-mill,1680,paladin,retribution,90,41,49
Starcker,sanguino,1680,paladin,retribution,98,36,62
Slapmedaddy,die-ewige-wacht,1679,paladin,retribution,60,31,29
Arear,kazzak,1679,paladin,retribution,245,124,121
Varunyyo,blackrock,1679,paladin,retribution,82,40,42
Dalemiar,ravencrest,1679,paladin,retribution,153,70,83
Cloudlight,argent-dawn,1678,paladin,retribution,86,47,39
Дракула,howling-fjord,1678,paladin,retribution,138,71,67
Varathraz,ravencrest,1678,paladin,retribution,162,75,87
Tîrana,ysondre,1677,paladin,retribution,133,65,68
Blademàster,twisting-nether,1676,paladin,retribution,96,40,56
Bsepal,silvermoon,1675,paladin,retribution,206,112,94
Arkk,blackrock,1675,paladin,retribution,60,25,35
Кинбул,ashenvale,1674,paladin,retribution,77,36,41
Diccari,stormreaver,1674,paladin,retribution,90,41,49
Kayøz,aegwynn,1673,paladin,retribution,108,56,52
Mistérion,archimonde,1673,paladin,retribution,86,37,49
Kedaris,antonidas,1672,paladin,retribution,143,77,66
Саймум,blackscar,1672,paladin,retribution,143,73,70
Wootschi,arthas,1672,paladin,retribution,59,30,29
Eldrial,argent-dawn,1672,paladin,retribution,65,32,33
Daddypal,ravencrest,1671,paladin,retribution,36,20,16
Pav,eredar,1671,paladin,retribution,95,52,43
Tyri,silvermoon,1671,paladin,retribution,114,59,55
Сынбогов,gordunni,1671,paladin,retribution,66,31,35
Грайндсет,galakrond,1671,paladin,retribution,41,18,23
Imaturtle,darksorrow,1671,paladin,retribution,133,58,75
Мяумяухх,soulflayer,1670,paladin,retribution,284,151,133
Kíamhalifa,twisting-nether,1670,paladin,retribution,36,18,18
Letharen,argent-dawn,1669,paladin,retribution,74,36,38
Vylnoa,twisting-nether,1669,paladin,retribution,163,76,87
Astilia,sylvanas,1669,paladin,retribution,132,61,71
Korneta,sanguino,1669,paladin,retribution,78,36,42
Frutte,malganis,1668,paladin,retribution,90,56,34
Testament,antonidas,1668,paladin,retribution,128,65,63
Хаспадин,gordunni,1668,paladin,retribution,77,39,38
Ruehlsbestes,silvermoon,1667,paladin,retribution,61,43,18
Néero,defias-brotherhood,1667,paladin,retribution,51,30,21
Темплеар,gordunni,1667,paladin,retribution,208,98,110
Scralet,tarren-mill,1667,paladin,retribution,41,19,22
Bätïk,blackmoore,1667,paladin,retribution,126,58,68
Almighty,ravencrest,1667,paladin,retribution,90,39,51
Uliko,twisting-nether,1666,paladin,retribution,90,50,40
Mefrandie,frostwolf,1666,paladin,retribution,48,26,22
Vivike,silvermoon,1666,paladin,retribution,130,66,64
Tirral,ravencrest,1666,paladin,retribution,198,100,98
Hèllkeepêr,archimonde,1666,paladin,retribution,41,20,21
Ashbi,dun-modr,1666,paladin,retribution,60,25,35
Dd,blackmoore,1665,paladin,retribution,193,104,89
Shuukz,blackmoore,1665,paladin,retribution,102,48,54
Rli,twisting-nether,1664,paladin,retribution,90,45,45
Akaasix,stormscale,1663,paladin,retribution,106,57,49
Zeggayodax,nemesis,1663,paladin,retribution,42,22,20
Fisslol,kazzak,1663,paladin,retribution,105,53,52
Ivarladin,draenor,1663,paladin,retribution,66,30,36
Neverdeath,stormscale,1663,paladin,retribution,72,32,40
Odisea,burning-blade,1662,paladin,retribution,42,26,16
Deadholland,ravencrest,1662,paladin,retribution,140,73,67
Jout,tarren-mill,1662,paladin,retribution,150,75,75
Liendry,antonidas,1662,paladin,retribution,77,37,40
Meìster,blackmoore,1661,paladin,retribution,93,45,48
Pruntadin,silvermoon,1661,paladin,retribution,78,36,42
Qpalax,outland,1661,paladin,retribution,74,33,41
Аргонис,gordunni,1661,paladin,retribution,54,24,30
Jannene,draenor,1661,paladin,retribution,66,29,37
Blaîzer,archimonde,1661,paladin,retribution,106,45,61
Nórman,blackhand,1660,paladin,retribution,150,78,72
Fløcki,blackhand,1660,paladin,retribution,60,30,30
Lezira,ravencrest,1660,paladin,retribution,48,20,28
Facerøll,silvermoon,1659,paladin,retribution,61,39,22
Bumaye,tarren-mill,1659,paladin,retribution,42,24,18
Wlåð,archimonde,1659,paladin,retribution,51,27,24
Âyasê,blackhand,1659,paladin,retribution,100,49,51
Кельритос,soulflayer,1659,paladin,retribution,103,49,54
Wakke,outland,1658,paladin,retribution,38,26,12
Xyzl,argent-dawn,1658,paladin,retribution,192,106,86
Slump,ravencrest,1658,paladin,retribution,91,50,41
Drakingsang,blackhand,1658,paladin,retribution,102,44,58
Seductîve,kazzak,1657,paladin,retribution,162,93,69
Zuveron,the-maelstrom,1657,paladin,retribution,78,35,43
Fordragon,twisting-nether,1657,paladin,retribution,60,24,36
Tapsgg,silvermoon,1656,paladin,retribution,111,54,57
Armas,stormscale,1656,paladin,retribution,64,27,37
Elastuc,silvermoon,1655,paladin,retribution,71,40,31
Лаунесса,gordunni,1655,paladin,retribution,36,20,16
Toschapala,blackmoore,1655,paladin,retribution,84,43,41
Telionrootan,die-aldor,1655,paladin,retribution,58,29,29
Sünlight,nemesis,1655,paladin,retribution,186,89,97
Novania,perenolde,1655,paladin,retribution,69,32,37
Wingsuit,eredar,1655,paladin,retribution,86,35,51
Harbiter,ravencrest,1655,paladin,retribution,78,31,47
Onevr,tarren-mill,1654,paladin,retribution,172,94,78
Willmot,stormscale,1654,paladin,retribution,64,33,31
Malthred,ravenholdt,1654,paladin,retribution,267,134,133
Сёмаигрок,soulflayer,1654,paladin,retribution,54,26,28
Erasdin,silvermoon,1653,paladin,retribution,36,21,15
Zynuwu,blackmoore,1653,paladin,retribution,42,22,20
Ruotollo,ravencrest,1653,paladin,retribution,51,23,28
Wohx,archimonde,1652,paladin,retribution,54,30,24
Райтивуд,howling-fjord,1652,paladin,retribution,110,58,52
Pesso,blackrock,1652,paladin,retribution,69,35,34
Karyouka,archimonde,1651,paladin,retribution,66,40,26
Denlow,silvermoon,1651,paladin,retribution,162,90,72
Ratklng,ravencrest,1650,paladin,retribution,102,61,41
Ruggero,stormscale,1650,paladin,retribution,43,24,19
Kraakz,sanguino,1650,paladin,retribution,71,34,37
Ilikejudge,blackmoore,1650,paladin,retribution,192,89,103
Kæycc,blackmoore,1650,paladin,retribution,51,21,30
Screws,dun-modr,1650,paladin,retribution,54,22,32
Aederec,argent-dawn,1649,paladin,retribution,78,42,36
Килмонгир,gordunni,1649,paladin,retribution,42,21,21
Сиаобэла,gordunni,1649,paladin,retribution,90,44,46
Duno,archimonde,1648,paladin,retribution,37,21,16
Andrejz,sylvanas,1648,paladin,retribution,42,21,21
Deltapower,archimonde,1648,paladin,retribution,97,46,51
Холивеник,gordunni,1648,paladin,retribution,48,22,26
Draìgo,nemesis,1648,paladin,retribution,79,35,44
Jst,twisting-nether,1647,paladin,retribution,36,24,12
Llighthand,ravencrest,1647,paladin,retribution,61,30,31
Baxxster,blackhand,1647,paladin,retribution,94,44,50
Relius,outland,1647,paladin,retribution,109,47,62
Exoblade,twisting-nether,1646,paladin,retribution,72,40,32
Trenvendor,ravencrest,1646,paladin,retribution,43,23,20
Júdger,twisting-nether,1646,paladin,retribution,173,90,83
Tuppo,argent-dawn,1646,paladin,retribution,404,206,198
Serratus,thunderhorn,1646,paladin,retribution,56,25,31
Rimva,alleria,1645,paladin,retribution,72,45,27
Jugga,durotan,1645,paladin,retribution,52,29,23
Eazybubble,blackhand,1645,paladin,retribution,42,22,20
Gilet,argent-dawn,1645,paladin,retribution,60,31,29
Mcfëë,ysondre,1645,paladin,retribution,150,77,73
Xila,blackrock,1645,paladin,retribution,90,39,51
Защешот,gordunni,1645,paladin,retribution,48,18,30
Keladen,burning-legion,1644,paladin,retribution,84,51,33
Cîzzar,burning-legion,1644,paladin,retribution,153,85,68
Bubbledøtcøm,blackmoore,1644,paladin,retribution,66,32,34
Spegepølse,silvermoon,1643,paladin,retribution,86,48,38
Emíly,dun-morogh,1643,paladin,retribution,42,23,19
Wadey,tarren-mill,1643,paladin,retribution,165,87,78
Retstaar,draenor,1643,paladin,retribution,60,30,30
Râkim,malganis,1643,paladin,retribution,42,21,21
Muuclear,twisting-nether,1643,paladin,retribution,87,42,45
Guidone,sylvanas,1642,paladin,retribution,30,20,10
Zarelie,tarren-mill,1642,paladin,retribution,84,50,34
Ysell,sargeras,1642,paladin,retribution,74,37,37
Диманватикан,howling-fjord,1642,paladin,retribution,140,67,73
Grìmmjøw,silvermoon,1642,paladin,retribution,51,22,29
Bikkuz,kazzak,1641,paladin,retribution,42,28,14
Gigasack,ravencrest,1641,paladin,retribution,36,23,13
Mercuria,dun-modr,1641,paladin,retribution,58,26,32
Briman,neptulon,1640,paladin,retribution,66,41,25
Powerpuffret,antonidas,1640,paladin,retribution,72,40,32
Йосяфлексер,howling-fjord,1640,paladin,retribution,200,108,92
Cilise,bronzebeard,1640,paladin,retribution,102,50,52
Vakaza,cthun,1639,paladin,retribution,72,37,35
Neithi,twisting-nether,1639,paladin,retribution,42,19,23
Sinclo,hyjal,1639,paladin,retribution,95,42,53
Димасгачи,gordunni,1638,paladin,retribution,42,32,10
Ajkulaa,kazzak,1638,paladin,retribution,92,45,47
Måxrajoy,dun-modr,1638,paladin,retribution,42,20,22
Dreamwatcher,outland,1638,paladin,retribution,51,23,28
Møg,blackrock,1638,paladin,retribution,65,24,41
Screâm,eredar,1638,paladin,retribution,84,31,53
Splendida,festung-der-stürme,1637,paladin,retribution,35,23,12
Donwone,aegwynn,1637,paladin,retribution,33,21,12
Ryuzu,khazgoroth,1637,paladin,retribution,72,42,30
Lawtõn,argent-dawn,1637,paladin,retribution,191,102,89
Brabop,zirkel-des-cenarius,1637,paladin,retribution,42,22,20
Shakkur,varimathras,1637,paladin,retribution,82,42,40
Дохлаяженах,gordunni,1637,paladin,retribution,54,27,27
Yséria,kirin-tor,1637,paladin,retribution,228,112,116
Nanisunda,thrall,1637,paladin,retribution,154,75,79
Instaquez,stormscale,1636,paladin,retribution,163,81,82
Amix,darksorrow,1636,paladin,retribution,68,33,35
Bobilous,twisting-nether,1636,paladin,retribution,66,30,36
Badbuññy,sylvanas,1636,paladin,retribution,54,24,30
Ashleigh,stormscale,1636,paladin,retribution,78,30,48
Mácá,outland,1635,paladin,retribution,30,20,10
Báldür,silvermoon,1635,paladin,retribution,126,65,61
Graeme,ysondre,1635,paladin,retribution,114,58,56
Hydrolic,blackrock,1635,paladin,retribution,42,21,21
Naexea,archimonde,1635,paladin,retribution,60,28,32
Hornybìlly,stormscale,1635,paladin,retribution,48,21,27
Байстр,soulflayer,1635,paladin,retribution,94,40,54
Addwyr,blackrock,1634,paladin,retribution,78,42,36
Римидал,howling-fjord,1634,paladin,retribution,42,22,20
Arturius,ravencrest,1634,paladin,retribution,60,30,30
Ragen,kazzak,1634,paladin,retribution,72,33,39
Ædrenn,archimonde,1634,paladin,retribution,60,24,36
Zneeks,shattered-hand,1633,paladin,retribution,83,48,35
Palagray,blackmoore,1633,paladin,retribution,173,100,73
Justivo,tarren-mill,1633,paladin,retribution,97,49,48
Shockashy,stormscale,1633,paladin,retribution,90,45,45
Misako,sanguino,1633,paladin,retribution,184,91,93
Xestie,twisting-nether,1633,paladin,retribution,68,32,36
Тайронх,soulflayer,1633,paladin,retribution,42,18,24
Bagok,drakthul,1632,paladin,retribution,54,34,20
Ojn,tarren-mill,1632,paladin,retribution,134,80,54
Галиор,soulflayer,1632,paladin,retribution,52,31,21
Tawaraa,archimonde,1632,paladin,retribution,36,21,15
Цитология,borean-tundra,1632,paladin,retribution,186,108,78
Pinx,kazzak,1632,paladin,retribution,78,39,39
Theladrie,blackhand,1632,paladin,retribution,48,24,24
Mavesauce,blackrock,1631,paladin,retribution,26,18,8
Копаю,gordunni,1631,paladin,retribution,150,88,62
Олегсудья,howling-fjord,1631,paladin,retribution,76,43,33
Earendìl,blackmoore,1631,paladin,retribution,66,37,29
Needel,argent-dawn,1631,paladin,retribution,59,32,27
Litaren,ragnaros,1631,paladin,retribution,66,35,31
Кавайнекс,azuregos,1631,paladin,retribution,134,67,67
Нормвал,gordunni,1631,paladin,retribution,61,29,32
Draizor,twisting-nether,1631,paladin,retribution,89,42,47
Fîzè,blackmoore,1631,paladin,retribution,46,21,25
Adiútrix,silvermoon,1630,paladin,retribution,96,59,37
Stille,blackrock,1630,paladin,retribution,30,18,12
Ibuc,blackrock,1630,paladin,retribution,36,21,15
Djcurry,archimonde,1630,paladin,retribution,30,17,13
Antsh,nemesis,1629,paladin,retribution,36,22,14
Holyhi,silvermoon,1629,paladin,retribution,90,54,36
Bobiwan,ravencrest,1629,paladin,retribution,30,17,13
Синерина,blackscar,1629,paladin,retribution,119,67,52
Моррзито,soulflayer,1629,paladin,retribution,78,37,41
Фатумм,howling-fjord,1629,paladin,retribution,42,19,23
Ønlyfâns,dragonblight,1629,paladin,retribution,78,34,44
Саламанлдрыч,soulflayer,1629,paladin,retribution,125,54,71
Neijih,blackrock,1629,paladin,retribution,74,29,45
Mudos,burning-legion,1628,paladin,retribution,24,18,6
Swäagg,hyjal,1628,paladin,retribution,41,25,16
Stelanâal,archimonde,1628,paladin,retribution,170,90,80
Wyllian,grim-batol,1628,paladin,retribution,48,23,25
Pikoman,hellfire,1628,paladin,retribution,89,42,47
Clamjam,sylvanas,1628,paladin,retribution,126,59,67
Хилоретка,blackscar,1627,paladin,retribution,30,21,9
Gulinborsti,aegwynn,1627,paladin,retribution,78,50,28
Boomboomciao,draenor,1627,paladin,retribution,123,74,49
Lightsguard,outland,1627,paladin,retribution,54,30,24
Násty,twisting-nether,1627,paladin,retribution,221,114,107
Válé,silvermoon,1627,paladin,retribution,295,149,146
Сандалар,gordunni,1627,paladin,retribution,138,64,74
Tabriz,rexxar,1627,paladin,retribution,70,32,38
Ласковыйкуфа,howling-fjord,1626,paladin,retribution,27,18,9
Yæø,archimonde,1626,paladin,retribution,84,49,35
Soossi,silvermoon,1626,paladin,retribution,30,17,13
Serim,dun-modr,1626,paladin,retribution,60,32,28
Шандарм,howling-fjord,1626,paladin,retribution,54,28,26
Deloréane,archimonde,1626,paladin,retribution,130,67,63
Оззмо,howling-fjord,1626,paladin,retribution,195,99,96
Zeusp,archimonde,1626,paladin,retribution,42,21,21
Naenel,dun-modr,1626,paladin,retribution,54,26,28
Zarron,blackrock,1626,paladin,retribution,42,20,22
Maloumnik,stormscale,1625,paladin,retribution,24,17,7
Redex,tarren-mill,1625,paladin,retribution,120,64,56
Skippadin,ravencrest,1625,paladin,retribution,107,55,52
Атикинс,gordunni,1625,paladin,retribution,298,149,149
Strykar,aggra-português,1625,paladin,retribution,48,22,26
Konardos,burning-legion,1625,paladin,retribution,48,21,27
Анстапблх,gordunni,1624,paladin,retribution,48,27,21
Jay,arathor,1624,paladin,retribution,54,29,25
Danrock,ravencrest,1624,paladin,retribution,42,21,21
Zeroeffect,blackhand,1624,paladin,retribution,90,44,46
Dudjaw,stormscale,1624,paladin,retribution,154,66,88
Рипкарт,gordunni,1623,paladin,retribution,67,42,25
Valarians,nemesis,1623,paladin,retribution,48,28,20
Blazeer,pozzo-delleternità,1623,paladin,retribution,42,23,19
Waltgyubeef,argent-dawn,1623,paladin,retribution,33,18,15
Notpitball,kazzak,1623,paladin,retribution,48,23,25
Brecs,frostmourne,1623,paladin,retribution,84,36,48
Неиспоримый,soulflayer,1622,paladin,retribution,30,20,10
Hetrox,silvermoon,1622,paladin,retribution,42,23,19
Blader,darksorrow,1622,paladin,retribution,158,80,78
Лакоста,ashenvale,1622,paladin,retribution,122,61,61
Anatollia,silvermoon,1622,paladin,retribution,36,17,19
Modeladin,ragnaros,1622,paladin,retribution,124,58,66
Gøretterøg,archimonde,1621,paladin,retribution,30,18,12
Layonpants,twisting-nether,1621,paladin,retribution,30,17,13
Disadin,sylvanas,1620,paladin,retribution,42,25,17
Ultret,silvermoon,1620,paladin,retribution,79,44,35
Trisunonvaki,khazgoroth,1620,paladin,retribution,205,112,93
Kreselia,ravencrest,1620,paladin,retribution,160,79,81
Валькирия,grom,1620,paladin,retribution,36,17,19
Salelol,ravencrest,1620,paladin,retribution,158,72,86
Häppïhïppø,ambossar,1620,paladin,retribution,50,19,31
Zzloud,darksorrow,1619,paladin,retribution,42,23,19
Jaro,alleria,1619,paladin,retribution,75,40,35
Holyblast,archimonde,1619,paladin,retribution,48,25,23
Combinecka,chamber-of-aspects,1619,paladin,retribution,118,60,58
Azlaya,sargeras,1619,paladin,retribution,255,127,128
Jiricech,tarren-mill,1619,paladin,retribution,42,17,25
Nillenkäse,antonidas,1618,paladin,retribution,36,22,14
Charmxx,stormscale,1618,paladin,retribution,30,18,12
Kobleda,ravencrest,1618,paladin,retribution,41,23,18
Lonesolo,sylvanas,1618,paladin,retribution,36,20,16
Leoxander,outland,1618,paladin,retribution,134,69,65
Crohnox,nemesis,1618,paladin,retribution,82,41,41
Nataii,argent-dawn,1618,paladin,retribution,66,32,34
Bìzzan,ravencrest,1618,paladin,retribution,59,22,37
Novania,teldrassil,1617,paladin,retribution,60,39,21
Bloodsworn,stormrage,1617,paladin,retribution,90,58,32
Gucix,sylvanas,1617,paladin,retribution,75,42,33
Bâbass,sargeras,1617,paladin,retribution,48,25,23
Яправ,borean-tundra,1617,paladin,retribution,161,83,78
Ichimaru,burning-legion,1617,paladin,retribution,35,18,17
Эмилиялавс,gordunni,1617,paladin,retribution,116,52,64
Okcså,ragnaros,1617,paladin,retribution,64,25,39
Lerîan,dun-modr,1616,paladin,retribution,157,88,69
Sytharel,sylvanas,1616,paladin,retribution,84,46,38
Superhick,veknilash,1616,paladin,retribution,42,22,20
Эледвен,howling-fjord,1616,paladin,retribution,104,49,55
Mezokist,silvermoon,1616,paladin,retribution,48,22,26
Sharkayne,anubarak,1616,paladin,retribution,130,59,71
Найдэкер,gordunni,1616,paladin,retribution,54,22,32
Shabbyy,bronzebeard,1616,paladin,retribution,54,21,33
Дорогаснега,gordunni,1615,paladin,retribution,68,38,30
Shénggi,kazzak,1615,paladin,retribution,78,41,37
Shufflee,drakthul,1615,paladin,retribution,84,44,40
Katanaclówn,eredar,1615,paladin,retribution,347,175,172
Batteldin,blackmoore,1614,paladin,retribution,158,91,67
Váliant,tarren-mill,1614,paladin,retribution,42,24,18
Rexare,blackhand,1614,paladin,retribution,46,23,23
Aurasis,archimonde,1614,paladin,retribution,83,41,42
Прожектор,gordunni,1614,paladin,retribution,60,29,31
Proximo,burning-legion,1614,paladin,retribution,48,23,25
Scorebit,draenor,1614,paladin,retribution,71,30,41
Blâzer,hyjal,1614,paladin,retribution,54,22,32
Funchö,grim-batol,1614,paladin,retribution,56,21,35
Dragon,zenedar,1613,paladin,retribution,48,27,21
Aflogistina,sylvanas,1613,paladin,retribution,36,20,16
Борссалино,gordunni,1613,paladin,retribution,163,84,79
Apokalipsnik,drakthul,1613,paladin,retribution,66,34,32
Bloodyret,outland,1613,paladin,retribution,89,45,44
Nazjra,twisting-nether,1613,paladin,retribution,36,18,18
Bullsy,kazzak,1613,paladin,retribution,123,61,62
Nøvå,ravencrest,1613,paladin,retribution,108,50,58
Ассайоу,soulflayer,1613,paladin,retribution,138,58,80
Ðox,frostmane,1612,paladin,retribution,24,17,7
Holyzero,ravencrest,1612,paladin,retribution,24,17,7
Mangz,ysondre,1612,paladin,retribution,36,25,11
Topzin,argent-dawn,1612,paladin,retribution,49,30,19
Astolfia,silvermoon,1612,paladin,retribution,73,44,29
Davidas,drakthul,1612,paladin,retribution,127,67,60
Puers,burning-blade,1612,paladin,retribution,41,21,20
Blickyman,arathor,1612,paladin,retribution,96,49,47
Сангвиний,howling-fjord,1612,paladin,retribution,322,158,164
Nergigante,drekthar,1612,paladin,retribution,48,23,25
Paradoxiâ,thrall,1612,paladin,retribution,60,28,32
Кизарыч,galakrond,1612,paladin,retribution,48,17,31
Vâlkyrîe,outland,1611,paladin,retribution,55,32,23
Santaclaus,zuljin,1611,paladin,retribution,139,79,60
Hempodius,silvermoon,1611,paladin,retribution,57,31,26
Ришардебюр,soulflayer,1611,paladin,retribution,157,80,77
Focuspally,outland,1611,paladin,retribution,113,57,56
Hito,sylvanas,1611,paladin,retribution,159,73,86
Madman,drakthul,1611,paladin,retribution,72,33,39
Bidulemachin,chogall,1610,paladin,retribution,30,19,11
Файнпал,howling-fjord,1610,paladin,retribution,78,44,34
Thaldrael,colinas-pardas,1610,paladin,retribution,59,31,28
Discølove,blackmoore,1610,paladin,retribution,43,21,22
Vorber,darksorrow,1610,paladin,retribution,53,23,30
Biggboii,twisting-nether,1610,paladin,retribution,54,21,33
Zebramann,silvermoon,1609,paladin,retribution,117,69,48
Promise,dun-modr,1609,paladin,retribution,60,32,28
Medieh,ravencrest,1609,paladin,retribution,86,45,41
Bíceron,sanguino,1609,paladin,retribution,76,38,38
Lazone,ysondre,1609,paladin,retribution,46,22,24
Mystixd,talnivarr,1608,paladin,retribution,42,31,11
Hølypowah,tarren-mill,1608,paladin,retribution,24,17,7
Glückskreuza,die-aldor,1608,paladin,retribution,54,33,21
Alammar,burning-legion,1608,paladin,retribution,30,18,12
Leköngen,ravencrest,1608,paladin,retribution,50,29,21
Oldsurehand,blackmoore,1608,paladin,retribution,68,36,32
Колсет,soulflayer,1608,paladin,retribution,91,48,43
Swânn,sanguino,1608,paladin,retribution,127,65,62
Dragonlancer,silvermoon,1608,paladin,retribution,288,143,145
Elohim,echsenkessel,1608,paladin,retribution,75,36,39
Wordup,senjin,1608,paladin,retribution,48,17,31
Тьёрн,gordunni,1607,paladin,retribution,90,52,38
Anmila,anetheron,1607,paladin,retribution,30,17,13
Legitpower,silvermoon,1607,paladin,retribution,82,41,41
Zala,culte-de-la-rive-noire,1607,paladin,retribution,76,37,39
Эллесар,blackscar,1607,paladin,retribution,132,62,70
Гоудин,razuvious,1607,paladin,retribution,66,30,36
Meliödas,sylvanas,1607,paladin,retribution,46,20,26
Kewell,dun-modr,1607,paladin,retribution,42,17,25
Hippiehuman,darkspear,1606,paladin,retribution,36,23,13
Милликсайс,howling-fjord,1606,paladin,retribution,51,29,22
Ямыч,ashenvale,1606,paladin,retribution,97,55,42
Melior,skullcrusher,1606,paladin,retribution,284,151,133
Dollicia,outland,1606,paladin,retribution,60,25,35
Raoun,archimonde,1605,paladin,retribution,66,33,33
ßean,dun-modr,1605,paladin,retribution,46,23,23
Стальгор,ashenvale,1605,paladin,retribution,48,23,25
Akrobatka,sanguino,1605,paladin,retribution,114,52,62
Bázer,antonidas,1605,paladin,retribution,46,18,28
Riskha,archimonde,1604,paladin,retribution,82,52,30
Taiiki,archimonde,1604,paladin,retribution,156,92,64
Poohsie,ravencrest,1604,paladin,retribution,102,59,43
Stfortt,ragnaros,1604,paladin,retribution,178,102,76
Taytay,dentarg,1604,paladin,retribution,66,37,29
Tìtan,ravencrest,1604,paladin,retribution,48,25,23
Toxxor,die-arguswacht,1604,paladin,retribution,54,28,26
Кронкс,howling-fjord,1604,paladin,retribution,141,73,68
Keft,twisting-nether,1604,paladin,retribution,53,26,27
Ваэлин,deathweaver,1604,paladin,retribution,64,29,35
Tinyandy,blackrock,1604,paladin,retribution,48,21,27
Valiscar,antonidas,1604,paladin,retribution,42,17,25
Tavyy,sylvanas,1603,paladin,retribution,107,81,26
Релаин,gordunni,1603,paladin,retribution,150,66,84
Joniopala,stormreaver,1603,paladin,retribution,83,34,49
Mistyweavey,grim-batol,1602,paladin,retribution,66,43,23
Palabrüx,dun-modr,1602,paladin,retribution,48,30,18
Overgeared,twisting-nether,1602,paladin,retribution,283,158,125
Neicha,trollbane,1602,paladin,retribution,108,60,48
Ferlen,nagrand,1602,paladin,retribution,72,39,33
Beefdaddyy,kazzak,1602,paladin,retribution,94,50,44
Crimq,twisting-nether,1602,paladin,retribution,102,50,52
Neverdiex,blackrock,1602,paladin,retribution,54,20,34
Nfxx,argent-dawn,1601,paladin,retribution,81,49,32
Quééfwemust,outland,1601,paladin,retribution,59,33,26
Gymly,kazzak,1601,paladin,retribution,244,136,108
Wingsbtw,archimonde,1601,paladin,retribution,36,20,16
Artal,tarren-mill,1601,paladin,retribution,48,26,22
Timal,eitrigg,1601,paladin,retribution,157,82,75
Zwergicus,alexstrasza,1601,paladin,retribution,71,33,38
Далходж,soulflayer,1601,paladin,retribution,134,62,72
Xealyy,ravencrest,1600,paladin,retribution,36,22,14
Guccishock,twisting-nether,1600,paladin,retribution,85,48,37
Bartelemeus,draenor,1600,paladin,retribution,48,25,23
Elyox,ravencrest,1600,paladin,retribution,42,21,21
Vereth,tarren-mill,1600,paladin,retribution,156,77,79
Bormann,burning-legion,1600,paladin,retribution,53,26,27
Zader,ravencrest,1600,paladin,retribution,48,23,25
Кузькинамать,greymane,1600,paladin,retribution,161,74,87
Carlash,draenor,1599,paladin,retribution,96,53,43
Kouyhalaide,hyjal,1599,paladin,retribution,80,38,42
Рамзеса,soulflayer,1599,paladin,retribution,48,22,26
Djcrusade,twisting-nether,1598,paladin,retribution,183,98,85
Jorhall,antonidas,1598,paladin,retribution,127,68,59
Knôp,outland,1598,paladin,retribution,48,19,29
Demsi,ravencrest,1597,paladin,retribution,38,24,14
Wuzzle,azshara,1597,paladin,retribution,36,22,14
Милостьрока,gordunni,1597,paladin,retribution,128,70,58
Хитвэйв,soulflayer,1597,paladin,retribution,41,20,21
Justyferr,nemesis,1597,paladin,retribution,176,77,99
Eldrack,defias-brotherhood,1597,paladin,retribution,47,20,27
Kptayn,archimonde,1596,paladin,retribution,79,44,35
Анастэриан,thermaplugg,1596,paladin,retribution,120,59,61
Окилан,gordunni,1596,paladin,retribution,50,19,31
Yaldly,dun-modr,1595,paladin,retribution,42,21,21
Valeantz,draenor,1595,paladin,retribution,77,30,47
Serenityxo,twisting-nether,1594,paladin,retribution,29,22,7
Saabnaab,outland,1594,paladin,retribution,233,133,100
Íbossít,doomhammer,1594,paladin,retribution,84,43,41
Каштоуны,soulflayer,1594,paladin,retribution,121,59,62
Asfen,archimonde,1593,paladin,retribution,42,24,18
Veejxo,silvermoon,1593,paladin,retribution,42,24,18
Paakz,stormscale,1593,paladin,retribution,202,101,101
Swàyz,archimonde,1593,paladin,retribution,197,94,103
Runhil,nemesis,1593,paladin,retribution,42,20,22
Реализатор,howling-fjord,1593,paladin,retribution,73,29,44
Siorraidh,archimonde,1592,paladin,retribution,48,26,22
Opsyoudie,kazzak,1592,paladin,retribution,173,83,90
Gîn,aszune,1592,paladin,retribution,66,30,36
Holmat,twisting-nether,1591,paladin,retribution,72,35,37
Imtheßoss,pozzo-delleternità,1591,paladin,retribution,42,20,22
Kjobergen,tarren-mill,1591,paladin,retribution,48,21,27
Dabeefchief,outland,1590,paladin,retribution,28,21,7
Omaw,ragnaros,1590,paladin,retribution,36,20,16
Lightwitcher,silvermoon,1590,paladin,retribution,215,103,112
Hülä,antonidas,1590,paladin,retribution,84,38,46
Pallidino,antonidas,1590,paladin,retribution,47,20,27
Mearsheimer,ysondre,1590,paladin,retribution,48,19,29
Бладиполи,soulflayer,1589,paladin,retribution,114,63,51
Sstalowy,silvermoon,1589,paladin,retribution,151,74,77
Ahpoual,archimonde,1588,paladin,retribution,64,39,25
Майлайт,gordunni,1588,paladin,retribution,129,73,56
Hipo,zuljin,1588,paladin,retribution,36,19,17
Supergallows,shattered-hand,1588,paladin,retribution,129,62,67
Девствениица,gordunni,1587,paladin,retribution,95,52,43
Shaylaru,tarren-mill,1587,paladin,retribution,41,22,19
Jimrogier,argent-dawn,1587,paladin,retribution,210,106,104
Tibirius,outland,1586,paladin,retribution,36,22,14
Vleisboom,ravencrest,1586,paladin,retribution,90,48,42
Eruth,ravencrest,1586,paladin,retribution,66,35,31
Романтик,deathweaver,1586,paladin,retribution,164,83,81
Pxæn,archimonde,1586,paladin,retribution,41,17,24
Whiskeyx,lightbringer,1585,paladin,retribution,42,29,13
Blookedaro,sanguino,1585,paladin,retribution,36,19,17
Хентайбогиня,ashenvale,1585,paladin,retribution,74,38,36
Trixbunny,arathor,1585,paladin,retribution,35,17,18
Painshield,outland,1585,paladin,retribution,53,19,34
Антрасс,soulflayer,1584,paladin,retribution,42,24,18
Limitlez,blackhand,1584,paladin,retribution,36,19,17
Komen,dalaran,1583,paladin,retribution,36,19,17
Horran,archimonde,1583,paladin,retribution,35,18,17
Fufth,pozzo-delleternità,1583,paladin,retribution,42,20,22
Nocleanse,argent-dawn,1582,paladin,retribution,59,41,18
Ramro,magtheridon,1582,paladin,retribution,70,45,25
Aerieon,draenor,1582,paladin,retribution,42,21,21
Талрэн,howling-fjord,1582,paladin,retribution,66,32,34
Retenki,silvermoon,1582,paladin,retribution,54,25,29
Irenita,kazzak,1582,paladin,retribution,54,23,31
Илонка,gordunni,1581,paladin,retribution,64,37,27
Ashmight,outland,1581,paladin,retribution,42,24,18
Zaaen,burning-legion,1580,paladin,retribution,96,49,47
Retstarr,draenor,1580,paladin,retribution,114,57,57
Palarïns,dalaran,1580,paladin,retribution,36,18,18
Аскеттх,gordunni,1580,paladin,retribution,90,43,47
Brinkz,argent-dawn,1580,paladin,retribution,48,20,28
Eosan,argent-dawn,1579,paladin,retribution,39,27,12
Ampxd,ravencrest,1579,paladin,retribution,72,38,34
Mimsy,dalaran,1579,paladin,retribution,217,111,106
Apolytos,laughing-skull,1579,paladin,retribution,195,94,101
Эйзенхорн,grom,1579,paladin,retribution,126,60,66
Grimstark,argent-dawn,1578,paladin,retribution,42,25,17
Remthas,argent-dawn,1578,paladin,retribution,323,174,149
Paellysuir,blackmoore,1578,paladin,retribution,258,130,128
Emostylex,draenor,1578,paladin,retribution,143,61,82
Lyraestra,hyjal,1578,paladin,retribution,78,33,45
Sorkohoho,silvermoon,1577,paladin,retribution,42,25,17
Пурджпал,soulflayer,1577,paladin,retribution,101,58,43
Xtekz,tarren-mill,1577,paladin,retribution,85,41,44
Aguerx,alleria,1577,paladin,retribution,72,34,38
Elektek,archimonde,1576,paladin,retribution,30,18,12
Bullstorm,burning-legion,1576,paladin,retribution,57,31,26
Athain,sanguino,1576,paladin,retribution,48,26,22
Búbbles,nerathor,1576,paladin,retribution,72,38,34
Yngild,antonidas,1576,paladin,retribution,48,23,25
Maltazar,arygos,1575,paladin,retribution,36,24,12
Rimlod,saurfang,1575,paladin,retribution,218,114,104
Тэлматос,soulflayer,1575,paladin,retribution,155,79,76
Nollieflip,tarren-mill,1575,paladin,retribution,42,21,21
Truebeliever,ravencrest,1574,paladin,retribution,60,35,25
Emìnem,kazzak,1574,paladin,retribution,152,77,75
Robdob,kazzak,1574,paladin,retribution,132,66,66
Glàdiator,outland,1574,paladin,retribution,182,84,98
Darkdeal,tarren-mill,1574,paladin,retribution,56,25,31
Angelisho,zuljin,1574,paladin,retribution,145,64,81
Крутикрит,goldrinn,1574,paladin,retribution,101,41,60
Vodax,argent-dawn,1573,paladin,retribution,86,43,43
Nashret,kazzak,1573,paladin,retribution,60,30,30
Ретриксвета,eversong,1573,paladin,retribution,42,19,23
Heallgodxx,ragnaros,1572,paladin,retribution,30,17,13
Daoht,ysondre,1571,paladin,retribution,60,30,30
Гневнебес,howling-fjord,1571,paladin,retribution,96,44,52
Wyzpal,archimonde,1570,paladin,retribution,59,31,28
Somixd,ragnaros,1570,paladin,retribution,350,178,172
Dankin,pozzo-delleternità,1570,paladin,retribution,100,47,53
Vuup,silvermoon,1570,paladin,retribution,90,41,49
Ønyxqt,archimonde,1569,paladin,retribution,41,22,19
Hammerofmilk,drakthul,1569,paladin,retribution,66,32,34
Socx,outland,1569,paladin,retribution,101,36,65
Irhoy,dalaran,1568,paladin,retribution,34,23,11
Luhae,archimonde,1568,paladin,retribution,72,44,28
Sâfcon,eredar,1568,paladin,retribution,49,28,21
Andocay,das-syndikat,1568,paladin,retribution,155,84,71
Splasher,grim-batol,1568,paladin,retribution,180,93,87
Mïnnîe,ysondre,1567,paladin,retribution,78,42,36
Crusshqt,silvermoon,1567,paladin,retribution,174,85,89
Истенен,blackscar,1567,paladin,retribution,120,56,64
Аностазия,ashenvale,1567,paladin,retribution,150,65,85
Erthelios,silvermoon,1566,paladin,retribution,30,19,11
Lumosboy,archimonde,1566,paladin,retribution,105,58,47
Zayonix,amanthul,1565,paladin,retribution,49,32,17
Aethelwold,ragnaros,1565,paladin,retribution,132,56,76
Okroschka,blackrock,1564,paladin,retribution,30,18,12
Forja,silvermoon,1564,paladin,retribution,110,55,55
Saht,silvermoon,1564,paladin,retribution,76,38,38
Hssn,stormscale,1564,paladin,retribution,62,29,33
Hýox,malganis,1564,paladin,retribution,133,60,73
Kathí,kazzak,1563,paladin,retribution,24,18,6
Warmâchiine,burning-legion,1563,paladin,retribution,155,78,77
Trixzie,blackhand,1563,paladin,retribution,36,18,18
Сэдвиг,gordunni,1563,paladin,retribution,35,17,18
Vickdicator,stormscale,1563,paladin,retribution,153,70,83
Llaynn,argent-dawn,1563,paladin,retribution,84,36,48
Ralphias,tarren-mill,1562,paladin,retribution,127,62,65
Lynndora,outland,1561,paladin,retribution,132,78,54
Qïkarï,antonidas,1561,paladin,retribution,61,35,26
Hideinlight,hellscream,1560,paladin,retribution,57,31,26
Decain,twisting-nether,1560,paladin,retribution,96,46,50
Lysander,antonidas,1560,paladin,retribution,36,17,19
Mufuqa,ragnaros,1558,paladin,retribution,79,39,40
Хексали,soulflayer,1558,paladin,retribution,63,29,34
Tosá,antonidas,1558,paladin,retribution,48,19,29
Néméssisx,ravencrest,1558,paladin,retribution,48,18,30
Farata,ravencrest,1557,paladin,retribution,166,88,78
Ranish,aegwynn,1557,paladin,retribution,51,18,33
Teahero,doomhammer,1556,paladin,retribution,36,21,15
Kalanthor,outland,1556,paladin,retribution,64,27,37
Akâshi,dalaran,1555,paladin,retribution,60,36,24
Fishnchips,twisting-nether,1555,paladin,retribution,42,24,18
Kawabanga,the-maelstrom,1555,paladin,retribution,70,38,32
Giroud,dalaran,1555,paladin,retribution,36,17,19
Rulîx,blackmoore,1555,paladin,retribution,173,80,93
Destroyer,archimonde,1555,paladin,retribution,40,17,23
Palladain,draenor,1554,paladin,retribution,112,68,44
Спидфрик,blackscar,1554,paladin,retribution,62,35,27
Ùthér,sylvanas,1554,paladin,retribution,79,40,39
Kaitlyne,tarren-mill,1554,paladin,retribution,555,277,278
Trendragon,argent-dawn,1554,paladin,retribution,77,33,44
Deadlydawn,kazzak,1554,paladin,retribution,72,23,49
Kuhfleisch,eredar,1553,paladin,retribution,132,75,57
Alë,sanguino,1553,paladin,retribution,47,23,24
Blvckshxc,kazzak,1553,paladin,retribution,90,42,48
Arethos,twisting-nether,1553,paladin,retribution,54,19,35
Пивняк,eversong,1552,paladin,retribution,135,78,57
Kyrokonserve,blackmoore,1552,paladin,retribution,133,73,60
Taiso,alonsus,1552,paladin,retribution,59,30,29
Spéos,archimonde,1552,paladin,retribution,106,51,55
Torvik,eredar,1552,paladin,retribution,107,50,57
Cianna,shattered-hand,1552,paladin,retribution,52,19,33
Drylands,ravencrest,1551,paladin,retribution,54,28,26
Eldrielle,culte-de-la-rive-noire,1551,paladin,retribution,71,35,36
Valin,frostmane,1551,paladin,retribution,189,91,98
Rhyvar,outland,1551,paladin,retribution,42,19,23
Dantrag,eredar,1551,paladin,retribution,72,31,41
Àræs,archimonde,1550,paladin,retribution,119,57,62
Blecheímer,blackrock,1549,paladin,retribution,33,18,15
Джагадаптер,gordunni,1549,paladin,retribution,206,112,94
Ficsuur,ragnaros,1549,paladin,retribution,467,240,227
Хельдотер,howling-fjord,1549,paladin,retribution,55,27,28
Ämÿcüs,zuljin,1548,paladin,retribution,96,51,45
Кериас,gordunni,1548,paladin,retribution,42,22,20
Deresos,anetheron,1548,paladin,retribution,48,21,27
Destrutkorka,burning-legion,1547,paladin,retribution,67,39,28
Sulfuroloyd,hyjal,1547,paladin,retribution,145,81,64
Avalindro,wrathbringer,1547,paladin,retribution,108,52,56
Piti,burning-legion,1547,paladin,retribution,72,29,43
Цитрон,blackscar,1546,paladin,retribution,24,17,7
Nexzz,outland,1546,paladin,retribution,41,28,13
Лаитнем,gordunni,1546,paladin,retribution,66,40,26
Jonquiillee,dalaran,1546,paladin,retribution,83,43,40
Günselsen,antonidas,1545,paladin,retribution,409,213,196
Osïrïs,kazzak,1545,paladin,retribution,180,86,94
Ксамо,howling-fjord,1544,paladin,retribution,35,22,13
Fítzgerald,antonidas,1544,paladin,retribution,107,57,50
Медверус,gordunni,1544,paladin,retribution,89,47,42
Afhvahj,tichondrius,1544,paladin,retribution,218,108,110
Doubtfire,tarren-mill,1544,paladin,retribution,88,43,45
Herrod,hyjal,1544,paladin,retribution,50,24,26
Dalbo,aegwynn,1543,paladin,retribution,34,24,10
Howard,dalaran,1543,paladin,retribution,54,25,29
Móóñý,silvermoon,1542,paladin,retribution,116,64,52
Arosyr,alleria,1542,paladin,retribution,75,41,34
Kènpachî,blackrock,1542,paladin,retribution,48,22,26
Itsgossiplol,twisting-nether,1542,paladin,retribution,98,39,59
Interop,tarren-mill,1541,paladin,retribution,54,30,24
Nîcolascage,stormscale,1541,paladin,retribution,42,19,23
Zeldalòl,outland,1541,paladin,retribution,59,25,34
Rapwnzel,sylvanas,1540,paladin,retribution,66,34,32
Altundrdel,ravencrest,1540,paladin,retribution,95,48,47
Zaatar,stormscale,1539,paladin,retribution,119,62,57
Krakr,ravencrest,1538,paladin,retribution,96,48,48
Dijkie,boulderfist,1537,paladin,retribution,42,22,20
Pný,silvermoon,1537,paladin,retribution,72,35,37
Diaéna,kirin-tor,1537,paladin,retribution,72,33,39
Sletlana,burning-blade,1537,paladin,retribution,110,48,62
Lycasia,hyjal,1537,paladin,retribution,84,36,48
Johnßlake,dun-modr,1536,paladin,retribution,117,59,58
Lavawraith,argent-dawn,1536,paladin,retribution,34,17,17
Eleuterus,bloodfeather,1536,paladin,retribution,84,38,46
Blagori,blackhand,1535,paladin,retribution,30,20,10
Catar,arathor,1535,paladin,retribution,169,95,74
Enolaer,ragnaros,1535,paladin,retribution,95,49,46
Cauze,ravencrest,1535,paladin,retribution,204,105,99
Gökbörû,blackmoore,1535,paladin,retribution,65,33,32
Shrôômîê,silvermoon,1535,paladin,retribution,81,41,40
Byakkospal,tarren-mill,1534,paladin,retribution,114,58,56
Бордюрчег,howling-fjord,1533,paladin,retribution,30,16,14
Ephialtis,hyjal,1532,paladin,retribution,30,24,6
Хоулик,howling-fjord,1532,paladin,retribution,87,50,37
Sikthorlan,ravencrest,1532,paladin,retribution,42,22,20
Theodór,antonidas,1532,paladin,retribution,107,48,59
Retrehsacul,blackrock,1532,paladin,retribution,36,16,20
Ashe,burning-legion,1531,paladin,retribution,24,16,8
Kunam,gorgonnash,1531,paladin,retribution,47,26,21
Gigajudge,ravencrest,1531,paladin,retribution,60,29,31
Лантана,howling-fjord,1530,paladin,retribution,30,17,13
Proletardk,draenor,1530,paladin,retribution,138,76,62
Sralana,malfurion,1530,paladin,retribution,42,23,19
Orti,sanguino,1530,paladin,retribution,95,51,44
Ромерл,gordunni,1530,paladin,retribution,486,239,247
Râoh,arathi,1529,paladin,retribution,96,49,47
Румоур,gordunni,1529,paladin,retribution,48,19,29
Baebe,silvermoon,1529,paladin,retribution,42,16,26
Liadrineá,burning-blade,1528,paladin,retribution,30,16,14
Blooregard,nathrezim,1528,paladin,retribution,54,25,29
Thàø,chants-éternels,1528,paladin,retribution,88,40,48
Mathrixo,silvermoon,1528,paladin,retribution,48,20,28
Snowife,drakthul,1528,paladin,retribution,54,22,32
Unkillablee,stormscale,1527,paladin,retribution,82,48,34
Diviney,twisting-nether,1527,paladin,retribution,59,29,30
Lynaé,blackhand,1527,paladin,retribution,37,18,19
Strätholme,drakthul,1527,paladin,retribution,42,18,24
Pappnas,blackmoore,1526,paladin,retribution,30,16,14
Андерлайт,azuregos,1526,paladin,retribution,53,28,25
Мётод,howling-fjord,1526,paladin,retribution,42,22,20
Esdras,sanguino,1526,paladin,retribution,354,183,171
Юкамилайт,howling-fjord,1526,paladin,retribution,60,28,32
Flawx,blackmoore,1525,paladin,retribution,77,44,33
Bailleya,drakthul,1525,paladin,retribution,120,53,67
Lightstrike,stormrage,1524,paladin,retribution,42,26,16
Gllorya,ragnaros,1524,paladin,retribution,70,31,39
Slipoj,blackhand,1523,paladin,retribution,78,44,34
Juliea,aegwynn,1523,paladin,retribution,144,75,69
Moodý,ragnaros,1523,paladin,retribution,132,67,65
Kurøneko,hyjal,1523,paladin,retribution,58,29,29
Valkyrjai,silvermoon,1523,paladin,retribution,71,32,39
Бигшор,soulflayer,1523,paladin,retribution,48,19,29
Jobsu,defias-brotherhood,1522,paladin,retribution,38,21,17
Celiath,draenor,1522,paladin,retribution,48,24,24
Dadoog,kazzak,1521,paladin,retribution,24,16,8
Jiniboy,garrosh,1521,paladin,retribution,74,47,27
Deathlyblaze,draenor,1521,paladin,retribution,60,33,27
Valunajhnwar,azuremyst,1521,paladin,retribution,152,75,77
Blegret,antonidas,1521,paladin,retribution,78,36,42
Кливерти,gordunni,1521,paladin,retribution,96,43,53
Rudî,sanguino,1520,paladin,retribution,64,45,19
Imreallybadx,blackrock,1520,paladin,retribution,55,31,24
Hanksolos,drakthul,1520,paladin,retribution,70,37,33
Havefunzqt,archimonde,1520,paladin,retribution,203,101,102
Скадих,soulflayer,1520,paladin,retribution,46,21,25
Brorgustav,doomhammer,1520,paladin,retribution,36,16,20
Sunforged,bloodhoof,1520,paladin,retribution,56,23,33
Keógh,kazzak,1519,paladin,retribution,36,26,10
Buyamazon,kazzak,1519,paladin,retribution,36,17,19
Obsidyen,outland,1519,paladin,retribution,56,25,31
Nikibrahboi,outland,1519,paladin,retribution,47,16,31
Холишокович,deathweaver,1518,paladin,retribution,120,58,62
Vitacé,burning-legion,1518,paladin,retribution,132,63,69
Nexo,bloodscalp,1518,paladin,retribution,38,18,20
Cowwithspell,stormscale,1518,paladin,retribution,206,96,110
Acepally,antonidas,1518,paladin,retribution,90,35,55
Emprò,kazzak,1517,paladin,retribution,48,27,21
Wize,steamwheedle-cartel,1517,paladin,retribution,141,76,65
Fauel,burning-legion,1517,paladin,retribution,160,82,78
Codindio,silvermoon,1517,paladin,retribution,112,57,55
Shroomez,frostmane,1517,paladin,retribution,51,25,26
Greko,ysera,1517,paladin,retribution,35,16,19
Stinkytoes,draenor,1516,paladin,retribution,36,20,16
Zatoxi,frostmane,1516,paladin,retribution,30,16,14
Celerius,trollbane,1516,paladin,retribution,60,24,36
Mytet,burning-legion,1515,paladin,retribution,30,16,14
Windsor,argent-dawn,1515,paladin,retribution,147,78,69
Mâterîa,antonidas,1515,paladin,retribution,166,83,83
Mansoureagle,kazzak,1515,paladin,retribution,42,21,21
Waks,dalaran,1515,paladin,retribution,48,21,27
Zeffêx,stormscale,1515,paladin,retribution,42,18,24
Ague,spinebreaker,1515,paladin,retribution,96,38,58
Thormentâ,sanguino,1514,paladin,retribution,54,31,23
Jøøs,sargeras,1514,paladin,retribution,123,68,55
Hys,stormscale,1514,paladin,retribution,42,23,19
Владыкасвета,borean-tundra,1514,paladin,retribution,129,67,62
Chelan,thrall,1514,paladin,retribution,66,28,38
Эеомли,blackscar,1513,paladin,retribution,131,64,67
Ярослэйв,howling-fjord,1513,paladin,retribution,140,64,76
Gashqx,hyjal,1512,paladin,retribution,74,46,28
Wrathlight,nemesis,1512,paladin,retribution,66,36,30
Заххо,howling-fjord,1512,paladin,retribution,30,16,14
Росиель,soulflayer,1512,paladin,retribution,148,74,74
Lìdspridaren,xavius,1512,paladin,retribution,36,18,18
Shatar,culte-de-la-rive-noire,1512,paladin,retribution,85,35,50
Phorios,agamaggan,1512,paladin,retribution,90,35,55
Zaelija,antonidas,1511,paladin,retribution,24,16,8
Evililz,kazzak,1511,paladin,retribution,157,82,75
Gunpowderx,silvermoon,1511,paladin,retribution,36,16,20
Balderstomp,jaedenar,1510,paladin,retribution,63,32,31
Slipmax,eredar,1510,paladin,retribution,54,26,28
Gaalarr,burning-legion,1510,paladin,retribution,154,74,80
Dodgerwilly,outland,1510,paladin,retribution,36,16,20
Impaross,shattrath,1509,paladin,retribution,159,87,72
Lestaf,the-maelstrom,1509,paladin,retribution,80,40,40
Holyshied,silvermoon,1509,paladin,retribution,78,38,40
Myridan,bloodhoof,1509,paladin,retribution,72,35,37
Aroyul,silvermoon,1509,paladin,retribution,36,17,19
Vedaar,dun-modr,1508,paladin,retribution,30,24,6
Lawlight,frostmane,1508,paladin,retribution,111,57,54
Blekadin,ragnaros,1508,paladin,retribution,134,68,66
Поласс,gordunni,1508,paladin,retribution,58,29,29
Iljanaqt,blackrock,1508,paladin,retribution,111,52,59
Jaq,karazhan,1507,paladin,retribution,31,17,14
Ксенджин,gordunni,1507,paladin,retribution,64,32,32
Igrael,argent-dawn,1507,paladin,retribution,96,47,49
Thazyru,frostmane,1506,paladin,retribution,74,44,30
Викиллер,grom,1506,paladin,retribution,114,63,51
Vaako,blackrock,1506,paladin,retribution,98,54,44
Hajzlbaba,outland,1506,paladin,retribution,32,17,15
Tharizod,nagrand,1506,paladin,retribution,87,43,44
Mommy,darksorrow,1506,paladin,retribution,108,49,59
Blazehammer,drakthul,1506,paladin,retribution,69,31,38
Падаетслезаа,howling-fjord,1506,paladin,retribution,54,24,30
Ulrhik,nemesis,1506,paladin,retribution,81,33,48
Murodin,twisting-nether,1506,paladin,retribution,42,16,26
Rèmi,pozzo-delleternità,1505,paladin,retribution,63,36,27
Exirtius,haomarush,1505,paladin,retribution,128,69,59
Paradoax,quelthalas,1505,paladin,retribution,30,16,14
Kytonic,silvermoon,1505,paladin,retribution,76,37,39
Tazkaz,archimonde,1505,paladin,retribution,68,33,35
Danaklies,dragonblight,1505,paladin,retribution,42,19,23
Lucyd,stormscale,1505,paladin,retribution,60,23,37
Kaarakartall,silvermoon,1504,paladin,retribution,36,24,12
Lovetospoonn,ravencrest,1504,paladin,retribution,72,44,28
Samueel,blackmoore,1504,paladin,retribution,128,70,58
Rînedaman,ysondre,1504,paladin,retribution,42,21,21
Ретридор,soulflayer,1504,paladin,retribution,36,17,19
Mílkme,antonidas,1503,paladin,retribution,24,16,8
Мизиола,galakrond,1503,paladin,retribution,161,88,73
Séanors,archimonde,1502,paladin,retribution,22,17,5
Barakisback,silvermoon,1502,paladin,retribution,86,52,34
Irini,sylvanas,1502,paladin,retribution,43,26,17
Daerthe,twisting-nether,1502,paladin,retribution,42,16,26
Elrandil,kazzak,1501,paladin,retribution,78,35,43
Enveador,garrosh,1500,paladin,retribution,78,44,34
Svetijuju,kazzak,1500,paladin,retribution,113,61,52
Veckra,kazzak,1500,paladin,retribution,170,89,81
Blówout,tarren-mill,1500,paladin,retribution,54,27,27
Sîlversun,grim-batol,1500,paladin,retribution,78,35,43
Dìe,silvermoon,1500,paladin,retribution,47,19,28
Zehnya,grim-batol,1499,paladin,retribution,375,195,180
Çronus,tarren-mill,1498,paladin,retribution,44,30,14
Swan,chogall,1498,paladin,retribution,60,32,28
Divinenoob,ravencrest,1498,paladin,retribution,60,32,28
Arrious,frostmane,1498,paladin,retribution,64,33,31
Logikoma,tarren-mill,1497,paladin,retribution,60,35,25
Диваин,gordunni,1497,paladin,retribution,372,193,179
Mattiesko,kazzak,1497,paladin,retribution,151,78,73
Амнон,goldrinn,1497,paladin,retribution,57,28,29
Хеллкик,howling-fjord,1497,paladin,retribution,103,46,57
Lamperos,eonar,1497,paladin,retribution,37,16,21
Эезекииль,howling-fjord,1496,paladin,retribution,169,95,74
Shmndr,kazzak,1496,paladin,retribution,46,25,21
Galevar,argent-dawn,1496,paladin,retribution,174,88,86
Níthag,ragnaros,1496,paladin,retribution,72,35,37
Eärendil,drakthul,1496,paladin,retribution,72,32,40
Dananas,draenor,1496,paladin,retribution,72,27,45
Варблэйз,gordunni,1495,paladin,retribution,30,16,14
Azhrei,archimonde,1495,paladin,retribution,36,16,20
Lamohru,argent-dawn,1495,paladin,retribution,72,31,41
Armadamadrid,outland,1494,paladin,retribution,44,22,22
Snackzy,twisting-nether,1494,paladin,retribution,174,84,90
Saintys,sylvanas,1494,paladin,retribution,116,55,61
Nobo,hellfire,1494,paladin,retribution,47,20,27
Skittlespala,twisting-nether,1493,paladin,retribution,47,33,14
Arfeniel,stormscale,1493,paladin,retribution,150,70,80
Gaveren,ravencrest,1493,paladin,retribution,56,26,30
Ксаиотх,blackscar,1493,paladin,retribution,84,34,50
Milkâ,burning-legion,1492,paladin,retribution,40,25,15
Волатбай,gordunni,1492,paladin,retribution,90,50,40
Блуудс,howling-fjord,1492,paladin,retribution,115,59,56
Hângôrlo,blackrock,1491,paladin,retribution,30,16,14
Riukÿ,nemesis,1491,paladin,retribution,71,37,34
Kaliano,twisting-nether,1491,paladin,retribution,89,43,46
Unohana,shattered-halls,1491,paladin,retribution,124,58,66
Créo,draenor,1491,paladin,retribution,90,42,48
Sieghard,aegwynn,1490,paladin,retribution,229,115,114
Антитеррор,greymane,1490,paladin,retribution,36,17,19
Baé,drakthul,1490,paladin,retribution,76,34,42
Ketherian,blutkessel,1490,paladin,retribution,64,23,41
Cos,stormscale,1489,paladin,retribution,58,30,28
Aurroraa,doomhammer,1489,paladin,retribution,93,46,47
Ilovemylay,area-52,1489,paladin,retribution,69,34,35
Camembert,sanguino,1489,paladin,retribution,48,23,25
Wolluna,frostwolf,1489,paladin,retribution,94,44,50
Traýan,blackmoore,1488,paladin,retribution,30,18,12
Sonarix,blackrock,1488,paladin,retribution,51,26,25
Blokeedaro,sanguino,1488,paladin,retribution,104,46,58
Alextrazite,kazzak,1488,paladin,retribution,60,23,37
Paulìe,draenor,1487,paladin,retribution,48,24,24
Valhella,stormscale,1487,paladin,retribution,345,171,174
Doxynator,silvermoon,1487,paladin,retribution,83,40,43
Sheleftyou,stormreaver,1486,paladin,retribution,59,34,25
Morniarn,argent-dawn,1486,paladin,retribution,96,54,42
Yumhi,dun-modr,1486,paladin,retribution,99,50,49
Draeymora,thrall,1486,paladin,retribution,145,72,73
Nînaninja,silvermoon,1486,paladin,retribution,121,60,61
Exley,blackmoore,1485,paladin,retribution,28,18,10
Mataleo,archimonde,1485,paladin,retribution,129,79,50
Dufftroll,kazzak,1485,paladin,retribution,36,19,17
Ландри,greymane,1484,paladin,retribution,30,17,13
Rent,sylvanas,1484,paladin,retribution,46,22,24
Мистеравадон,gordunni,1484,paladin,retribution,158,71,87
Síndorí,frostwolf,1484,paladin,retribution,96,41,55
Cenie,dunemaul,1484,paladin,retribution,102,38,64
Holÿbeard,ravencrest,1483,paladin,retribution,77,46,31
Sacredlol,blackmoore,1483,paladin,retribution,57,21,36
Savitri,drakthul,1482,paladin,retribution,72,39,33
Ауё,blackscar,1482,paladin,retribution,47,22,25
Unzufrieden,silvermoon,1482,paladin,retribution,90,41,49
Koami,blackmoore,1481,paladin,retribution,108,56,52
Spartain,draenor,1481,paladin,retribution,72,37,35
Bjaï,hyjal,1481,paladin,retribution,57,25,32
Frankostyle,sanguino,1481,paladin,retribution,79,33,46
Holymunt,sylvanas,1480,paladin,retribution,24,16,8
Runcarsnwpen,kazzak,1480,paladin,retribution,53,31,22
Endar,drakthul,1480,paladin,retribution,112,60,52
Кветирон,soulflayer,1480,paladin,retribution,150,73,77
Némesis,frostmane,1480,paladin,retribution,42,18,24
Uxxer,sanguino,1479,paladin,retribution,41,23,18
Ëlësilf,sanguino,1479,paladin,retribution,110,61,49
Zélix,bronzebeard,1479,paladin,retribution,141,73,68
Rugila,ragnaros,1479,paladin,retribution,344,178,166
Kýríl,antonidas,1479,paladin,retribution,152,63,89
Indye,hyjal,1478,paladin,retribution,60,34,26
Névér,steamwheedle-cartel,1478,paladin,retribution,83,45,38
Belnadris,eredar,1478,paladin,retribution,118,60,58
Лусейд,howling-fjord,1477,paladin,retribution,65,40,25
Sunrazor,kazzak,1477,paladin,retribution,132,67,65
Салутан,thermaplugg,1477,paladin,retribution,323,155,168
Fatâl,antonidas,1477,paladin,retribution,69,32,37
Thrinea,blackrock,1476,paladin,retribution,74,40,34
Itiswhatitis,blackmoore,1476,paladin,retribution,32,17,15
Эсканор,galakrond,1476,paladin,retribution,61,31,30
Zoltes,twisting-nether,1476,paladin,retribution,184,91,93
Bloodpaly,silvermoon,1476,paladin,retribution,76,33,43
Aisnil,twilights-hammer,1475,paladin,retribution,149,78,71
Ínvi,aegwynn,1475,paladin,retribution,75,37,38
Pliscken,kazzak,1475,paladin,retribution,95,45,50
Pak,amanthul,1475,paladin,retribution,57,24,33
Tobzin,argent-dawn,1474,paladin,retribution,72,37,35
Mograine,die-aldor,1474,paladin,retribution,192,97,95
Quaterbâck,antonidas,1474,paladin,retribution,80,40,40
Prelates,argent-dawn,1474,paladin,retribution,34,16,18
Melverti,kazzak,1473,paladin,retribution,30,17,13
Selaphíel,kazzak,1473,paladin,retribution,203,104,99
Шоринг,gordunni,1473,paladin,retribution,66,33,33
Snibsxpala,silvermoon,1473,paladin,retribution,47,23,24
Essenz,eredar,1473,paladin,retribution,87,36,51
Синдикатх,soulflayer,1472,paladin,retribution,155,85,70
Aisolôn,thrall,1471,paladin,retribution,80,45,35
Грузор,gordunni,1471,paladin,retribution,124,66,58
Gazïel,kaelthas,1471,paladin,retribution,117,61,56
Emet,twisting-nether,1471,paladin,retribution,55,27,28
Romfis,arathor,1470,paladin,retribution,90,51,39
Sebatrøz,ravencrest,1470,paladin,retribution,48,26,22
Valerionn,blackmoore,1470,paladin,retribution,107,56,51
Brightgrove,silvermoon,1470,paladin,retribution,41,16,25
Kalkandelen,silvermoon,1469,paladin,retribution,55,35,20
Жэж,howling-fjord,1469,paladin,retribution,150,83,67
Luzmortal,zuljin,1469,paladin,retribution,102,54,48
Greyeyed,kazzak,1469,paladin,retribution,86,45,41
Palarezz,ysondre,1469,paladin,retribution,70,33,37
Morninnstaar,kazzak,1469,paladin,retribution,66,31,35
Myrieni,silvermoon,1469,paladin,retribution,48,22,26
Benzimus,ragnaros,1469,paladin,retribution,93,35,58
Tscheba,kazzak,1468,paladin,retribution,93,49,44
Ippî,blackmoore,1467,paladin,retribution,37,23,14
Exiztant,ravencrest,1467,paladin,retribution,153,89,64
Petitê,blackmoore,1467,paladin,retribution,161,91,70
Aumium,sunstrider,1467,paladin,retribution,130,61,69
Devilsangel,antonidas,1467,paladin,retribution,106,47,59
Stocks,burning-blade,1466,paladin,retribution,42,22,20
Syracx,blackhand,1466,paladin,retribution,120,61,59
Йзериль,howling-fjord,1465,paladin,retribution,46,27,19
Neêsoldr,blackmoore,1465,paladin,retribution,146,73,73
Palstarr,malorne,1465,paladin,retribution,64,32,32
Mazekiel,archimonde,1465,paladin,retribution,60,30,30
Bubblefett,ysera,1465,paladin,retribution,36,18,18
Tracsiee,twisting-nether,1465,paladin,retribution,38,17,21
Paladiodinos,hyjal,1464,paladin,retribution,90,48,42
Rethardz,grim-batol,1464,paladin,retribution,40,21,19
Hugins,chamber-of-aspects,1464,paladin,retribution,75,35,40
Olivaresx,ravencrest,1464,paladin,retribution,72,30,42
Æfhm,blackrock,1463,paladin,retribution,54,32,22
Leeroyjinks,twisting-nether,1463,paladin,retribution,48,27,21
Røck,aggra-português,1463,paladin,retribution,207,107,100
Neltix,blackrock,1463,paladin,retribution,88,42,46
Tarenath,aegwynn,1463,paladin,retribution,35,16,19
Majk,hellscream,1463,paladin,retribution,97,42,55
Uøx,blackrock,1462,paladin,retribution,30,16,14
Loscar,silvermoon,1462,paladin,retribution,36,17,19
Mustach,aggra-português,1461,paladin,retribution,95,51,44
Жанож,gordunni,1461,paladin,retribution,80,42,38
Wälläce,sanguino,1461,paladin,retribution,41,16,25
Stellartois,thunderhorn,1461,paladin,retribution,49,17,32
Khouvec,tarren-mill,1460,paladin,retribution,30,19,11
Malemanlad,silvermoon,1460,paladin,retribution,132,67,65
Blakkjack,xavius,1460,paladin,retribution,107,51,56
Paladiaz,blackhand,1460,paladin,retribution,42,20,22
Жёстиксхилер,howling-fjord,1460,paladin,retribution,94,44,50
Naree,stormreaver,1460,paladin,retribution,96,44,52
Альбусор,galakrond,1460,paladin,retribution,48,22,26
Teryanna,ragnaros,1460,paladin,retribution,74,29,45
Karthvitall,kaelthas,1459,paladin,retribution,42,23,19
Slayfer,dun-modr,1459,paladin,retribution,102,45,57
Goüstà,ysondre,1459,paladin,retribution,58,23,35
Humphry,vashj,1458,paladin,retribution,72,35,37
Deathlaf,argent-dawn,1458,paladin,retribution,42,19,23
Baldivar,silvermoon,1457,paladin,retribution,107,58,49
Leroya,blackrock,1457,paladin,retribution,35,18,17
Jeriiret,khaz-modan,1457,paladin,retribution,92,46,46
Frequencer,ragnaros,1457,paladin,retribution,66,28,38
Toompaa,ravencrest,1456,paladin,retribution,51,32,19
Jiraaqi,silvermoon,1456,paladin,retribution,137,67,70
Tóxicpaladín,kazzak,1456,paladin,retribution,139,66,73
Бинур,eversong,1455,paladin,retribution,62,34,28
Drivenlight,twisting-nether,1455,paladin,retribution,54,27,27
Gojesi,silvermoon,1455,paladin,retribution,141,70,71
Elinmogz,kazzak,1454,paladin,retribution,26,16,10
Pastaflwras,twisting-nether,1454,paladin,retribution,39,21,18
Серёжблондин,gordunni,1454,paladin,retribution,72,38,34
Crooswijk,doomhammer,1454,paladin,retribution,57,27,30
Atemes,malorne,1453,paladin,retribution,27,17,10
Dopämine,tarren-mill,1453,paladin,retribution,154,74,80
Lycíus,outland,1453,paladin,retribution,36,16,20
Galath,drakthul,1453,paladin,retribution,42,18,24
Snødunkern,outland,1453,paladin,retribution,140,59,81
Æthëlflæd,ravencrest,1452,paladin,retribution,141,82,59
Крода,deepholm,1452,paladin,retribution,72,37,35
Вэис,borean-tundra,1452,paladin,retribution,65,33,32
Kreyvin,argent-dawn,1452,paladin,retribution,142,71,71
Nessùm,hyjal,1452,paladin,retribution,114,57,57
Paladinguy,argent-dawn,1452,paladin,retribution,92,45,47
Obé,argent-dawn,1451,paladin,retribution,329,180,149
Сенлеида,gordunni,1451,paladin,retribution,103,52,51
Yømø,antonidas,1451,paladin,retribution,125,63,62
Ðøñe,draenor,1451,paladin,retribution,64,32,32
Snottybrat,draenor,1450,paladin,retribution,116,66,50
Wrappers,archimonde,1450,paladin,retribution,54,29,25
Nalaea,arathor,1450,paladin,retribution,48,24,24
Айэмбомб,howling-fjord,1450,paladin,retribution,40,20,20
Portgas,hyjal,1450,paladin,retribution,54,26,28
Неффко,howling-fjord,1449,paladin,retribution,106,52,54
Albz,laughing-skull,1449,paladin,retribution,48,22,26
Yaoiri,argent-dawn,1448,paladin,retribution,71,39,32
Raerion,ragnaros,1447,paladin,retribution,94,61,33
Hanknpank,quelthalas,1447,paladin,retribution,40,24,16
Вессори,blackscar,1447,paladin,retribution,61,31,30
Dimes,argent-dawn,1446,paladin,retribution,25,18,7
Boabux,draenor,1446,paladin,retribution,104,55,49
Хиккудоджер,eversong,1446,paladin,retribution,256,134,122
Finñ,sylvanas,1446,paladin,retribution,89,44,45
Teìltaus,eredar,1446,paladin,retribution,60,28,32
Сакермвп,howling-fjord,1445,paladin,retribution,36,23,13
Блатш,greymane,1445,paladin,retribution,91,32,59
Fryl,quelthalas,1444,paladin,retribution,96,53,43
Наваляка,deathguard,1444,paladin,retribution,36,19,17
Grobididi,malygos,1444,paladin,retribution,359,183,176
Pyscys,dun-modr,1444,paladin,retribution,36,17,19
Shrøømz,antonidas,1443,paladin,retribution,60,33,27
Støøk,shendralar,1443,paladin,retribution,124,67,57
Raerk,dalaran,1443,paladin,retribution,226,122,104
Serethor,blackrock,1442,paladin,retribution,36,20,16
Neverknõw,draenor,1442,paladin,retribution,38,21,17
Кариил,blackscar,1442,paladin,retribution,29,16,13
Dvouklik,burning-blade,1442,paladin,retribution,97,53,44
Nothonnest,archimonde,1440,paladin,retribution,34,23,11
Overheals,blackmoore,1440,paladin,retribution,24,16,8
Palyx,cthun,1440,paladin,retribution,36,20,16
Lééroÿ,sylvanas,1440,paladin,retribution,132,67,65
Alithyra,earthen-ring,1440,paladin,retribution,97,49,48
Mííss,silvermoon,1440,paladin,retribution,84,42,42
Kerstyxd,blackrock,1440,paladin,retribution,114,55,59
Малоко,thermaplugg,1440,paladin,retribution,72,33,39
Naethan,malganis,1439,paladin,retribution,48,24,24
Twomog,ravencrest,1438,paladin,retribution,18,15,3
Hogan,blackmoore,1438,paladin,retribution,42,23,19
Mofawilli,blackrock,1438,paladin,retribution,95,51,44
Unogym,dragonblight,1438,paladin,retribution,60,31,29
Onyr,hyjal,1438,paladin,retribution,78,40,38
Inkuboss,nemesis,1438,paladin,retribution,90,46,44
Dinønuggets,ravencrest,1438,paladin,retribution,30,15,15
Hydrath,ysondre,1438,paladin,retribution,114,54,60
Шэйкер,blackscar,1438,paladin,retribution,157,69,88
Aury,mannoroth,1437,paladin,retribution,60,36,24
Jojomann,stormscale,1437,paladin,retribution,66,35,31
Zenfret,kazzak,1437,paladin,retribution,40,21,19
Ben,ghostlands,1437,paladin,retribution,42,22,20
Mezzí,aegwynn,1436,paladin,retribution,48,27,21
Suge,azjolnerub,1436,paladin,retribution,82,44,38
Cùpìdstunt,draenor,1436,paladin,retribution,30,15,15
Exceed,blackmoore,1436,paladin,retribution,30,15,15
Джибути,soulflayer,1436,paladin,retribution,105,51,54
Enanon,zuljin,1436,paladin,retribution,58,25,33
Chíllpills,silvermoon,1436,paladin,retribution,72,31,41
Cornfalke,silvermoon,1435,paladin,retribution,30,19,11
Thyrna,alleria,1435,paladin,retribution,44,25,19
Storpixpala,drakthul,1435,paladin,retribution,114,63,51
Teho,dragonblight,1435,paladin,retribution,282,146,136
Viivox,draenor,1435,paladin,retribution,125,60,65
Buddabob,antonidas,1435,paladin,retribution,162,68,94
Gallifreya,archimonde,1435,paladin,retribution,36,15,21
Holycide,twisting-nether,1434,paladin,retribution,36,21,15
Nowitzki,sanguino,1434,paladin,retribution,48,25,23
Lìadrin,nemesis,1434,paladin,retribution,42,19,23
Yull,twisting-nether,1433,paladin,retribution,95,51,44
Lipsvirgin,kazzak,1433,paladin,retribution,30,15,15
Shtaladin,sylvanas,1433,paladin,retribution,173,83,90
Izolated,aegwynn,1433,paladin,retribution,96,44,52
Paterymon,ravencrest,1433,paladin,retribution,36,15,21
Unleashed,antonidas,1433,paladin,retribution,37,15,22
Notdeadfred,silvermoon,1432,paladin,retribution,78,40,38
Cassandrina,kazzak,1432,paladin,retribution,65,33,32
Moraru,neptulon,1432,paladin,retribution,139,67,72
Eazyé,twisting-nether,1432,paladin,retribution,50,24,26
Reinas,sanguino,1432,paladin,retribution,42,18,24
Jathx,silvermoon,1431,paladin,retribution,121,64,57
Keele,stormscale,1431,paladin,retribution,36,18,18
Sacramento,tarren-mill,1431,paladin,retribution,30,15,15
Твойвайб,gordunni,1431,paladin,retribution,153,76,77
Quordthor,sanguino,1431,paladin,retribution,66,32,34
Aston,sylvanas,1431,paladin,retribution,66,28,38
Khoping,silvermoon,1430,paladin,retribution,24,15,9
Stratarxis,kazzak,1430,paladin,retribution,24,15,9
Cästiël,arathor,1430,paladin,retribution,179,95,84
Anathena,twisting-nether,1430,paladin,retribution,36,17,19
Zethadin,kazzak,1429,paladin,retribution,63,34,29
Гигаиисус,gordunni,1429,paladin,retribution,39,21,18
Zanreti,outland,1429,paladin,retribution,134,68,66
Pøpz,kilrogg,1429,paladin,retribution,83,40,43
Тюрр,lich-king,1429,paladin,retribution,91,43,48
Brigholm,argent-dawn,1429,paladin,retribution,80,36,44
Тейдерган,soulflayer,1428,paladin,retribution,135,73,62
Ветрум,gordunni,1428,paladin,retribution,48,23,25
Kelore,hyjal,1428,paladin,retribution,48,17,31
Garthoronir,antonidas,1427,paladin,retribution,69,29,40
Æxiroa,antonidas,1426,paladin,retribution,36,19,17
Velikor,dun-modr,1426,paladin,retribution,42,22,20
Vangottwald,drakthul,1426,paladin,retribution,102,51,51
Сазар,gordunni,1426,paladin,retribution,51,21,30
Ùthër,silvermoon,1425,paladin,retribution,105,57,48
Вэйсспал,howling-fjord,1425,paladin,retribution,30,15,15
Turskah,shattered-hand,1425,paladin,retribution,30,15,15
Clementine,spinebreaker,1425,paladin,retribution,45,19,26
Retenki,draenor,1425,paladin,retribution,42,17,25
Csvepanszul,ragnaros,1424,paladin,retribution,24,15,9
Malianterø,ravencrest,1424,paladin,retribution,149,65,84
Delishious,twisting-nether,1423,paladin,retribution,24,16,8
Рэгнволд,deathguard,1423,paladin,retribution,70,37,33
Brøkên,archimonde,1423,paladin,retribution,78,40,38
Тирлас,gordunni,1423,paladin,retribution,120,58,62
Roxter,burning-legion,1423,paladin,retribution,78,37,41
Hammertom,stormscale,1423,paladin,retribution,34,16,18
Ruftadin,ragnaros,1423,paladin,retribution,72,32,40
Autrup,defias-brotherhood,1422,paladin,retribution,24,15,9
Hehtmonghour,sanguino,1422,paladin,retribution,65,34,31
Jâybee,ravencrest,1422,paladin,retribution,66,34,32
Cracish,ragnaros,1422,paladin,retribution,30,15,15
Malagat,die-todeskrallen,1422,paladin,retribution,102,50,52
Palacetámol,gorgonnash,1422,paladin,retribution,82,40,42
Pratt,deathwing,1422,paladin,retribution,117,56,61
Knigh,draenor,1422,paladin,retribution,126,60,66
Feelinara,blackmoore,1421,paladin,retribution,66,36,30
Asunea,silvermoon,1421,paladin,retribution,130,70,60
Xalthan,defias-brotherhood,1421,paladin,retribution,54,27,27
Rodakinos,outland,1420,paladin,retribution,76,44,32
Софилион,gordunni,1420,paladin,retribution,93,49,44
Ventsi,kazzak,1419,paladin,retribution,369,192,177
Асшура,howling-fjord,1419,paladin,retribution,58,28,30
Sheaps,les-sentinelles,1419,paladin,retribution,42,18,24
Kerchal,dalaran,1418,paladin,retribution,48,26,22
Лотранир,gordunni,1418,paladin,retribution,30,16,14
Wøømy,hyjal,1418,paladin,retribution,100,49,51
Yuri,voljin,1418,paladin,retribution,40,17,23
Wankerjim,ghostlands,1418,paladin,retribution,54,17,37
Veriø,dun-modr,1417,paladin,retribution,52,22,30
Diamir,rajaxx,1417,paladin,retribution,51,20,31
Nomercyl,suramar,1416,paladin,retribution,40,25,15
Bèéf,kazzak,1416,paladin,retribution,24,15,9
Uraraka,burning-blade,1416,paladin,retribution,54,33,21
Holydhanas,outland,1416,paladin,retribution,30,15,15
Offa,draenor,1416,paladin,retribution,48,23,25
Ljumá,kazzak,1416,paladin,retribution,114,54,60
Kaelthir,bladefist,1415,paladin,retribution,80,46,34
Goldhand,vashj,1415,paladin,retribution,121,60,61
Notsomuch,alakir,1414,paladin,retribution,69,39,30
Hutimeni,turalyon,1413,paladin,retribution,30,17,13
Primle,thrall,1413,paladin,retribution,88,49,39
Sangiorgio,nemesis,1413,paladin,retribution,100,48,52
Maegli,thrall,1412,paladin,retribution,30,15,15
Xawier,ghostlands,1412,paladin,retribution,90,42,48
Киръпич,grom,1412,paladin,retribution,36,15,21
Синфуледи,gordunni,1412,paladin,retribution,66,23,43
Wigsnatcher,argent-dawn,1411,paladin,retribution,36,19,17
Раффаэло,borean-tundra,1411,paladin,retribution,150,73,77
Lakster,blackmoore,1411,paladin,retribution,48,20,28
Whatapity,silvermoon,1411,paladin,retribution,60,24,36
Pállis,ravencrest,1410,paladin,retribution,24,16,8
Dmascus,blackrock,1410,paladin,retribution,36,19,17
Hàsbulla,khaz-modan,1410,paladin,retribution,190,96,94
Tehacê,blackrock,1410,paladin,retribution,38,17,21
Demecir,twisting-nether,1409,paladin,retribution,24,16,8
Asteriia,frostwolf,1409,paladin,retribution,201,101,100
Slageth,argent-dawn,1409,paladin,retribution,68,34,34
Держимордва,razuvious,1409,paladin,retribution,59,26,33
Freedomwinds,kazzak,1409,paladin,retribution,36,15,21
Квемсис,ashenvale,1408,paladin,retribution,214,120,94
Atanasum,dun-modr,1408,paladin,retribution,60,32,28
Puré,festung-der-stürme,1408,paladin,retribution,119,55,64
Doomgape,alakir,1408,paladin,retribution,132,58,74
Vlodthar,uldum,1407,paladin,retribution,42,25,17
Sanduciorba,chamber-of-aspects,1407,paladin,retribution,71,39,32
Вандиир,soulflayer,1407,paladin,retribution,64,34,30
Wingdude,ysera,1407,paladin,retribution,30,15,15
Animouse,drakthul,1406,paladin,retribution,52,33,19
Grapaladin,sanguino,1406,paladin,retribution,44,23,21
Eken,hyjal,1406,paladin,retribution,48,23,25
Hammertime,guldan,1406,paladin,retribution,72,33,39
Oldsqlmofu,blackrock,1406,paladin,retribution,42,17,25
Синодушка,howling-fjord,1406,paladin,retribution,48,17,31
Quuri,frostwolf,1405,paladin,retribution,24,15,9
Darnero,blackrock,1405,paladin,retribution,48,29,19
Burstyléz,silvermoon,1405,paladin,retribution,59,34,25
Veliios,silvermoon,1405,paladin,retribution,68,33,35
Torpala,burning-legion,1405,paladin,retribution,58,27,31
Ryaz,blackrock,1404,paladin,retribution,24,15,9
Fleshoflight,arathor,1404,paladin,retribution,45,27,18
Ashent,stormscale,1404,paladin,retribution,76,38,38
Noxxiê,blackmoore,1404,paladin,retribution,42,21,21
Pwnyú,aegwynn,1404,paladin,retribution,102,49,53
Lìmier,ysondre,1404,paladin,retribution,36,17,19
Azovstal,terokkar,1403,paladin,retribution,80,42,38
Hurmôk,tarren-mill,1403,paladin,retribution,115,58,57
Наолина,gordunni,1403,paladin,retribution,94,45,49
Craaw,archimonde,1403,paladin,retribution,106,44,62
Molenko,rexxar,1403,paladin,retribution,90,37,53
Whipyohead,burning-blade,1403,paladin,retribution,40,16,24
Øsgar,dun-modr,1403,paladin,retribution,43,17,26
Jcpd,drakthul,1403,paladin,retribution,70,25,45
Oûtplâyêd,blackmoore,1402,paladin,retribution,30,19,11
Holycowe,kazzak,1402,paladin,retribution,30,15,15
Aleixodolphi,argent-dawn,1402,paladin,retribution,209,93,116
Blubbajoe,blackmoore,1402,paladin,retribution,48,21,27
Goosybumpy,draenor,1402,paladin,retribution,60,26,34
Хоулишит,blackscar,1401,paladin,retribution,89,53,36
Lukeus,the-maelstrom,1401,paladin,retribution,108,57,51
Argonak,sanguino,1401,paladin,retribution,96,49,47
Ковбаскаа,gordunni,1401,paladin,retribution,38,18,20
Ruben,kirin-tor,1401,paladin,retribution,36,16,20
Liett,archimonde,1401,paladin,retribution,36,15,21
Pyronort,eredar,1400,paladin,retribution,42,24,18
Fizzyy,ragnaros,1400,paladin,retribution,38,20,18
Annyaiva,outland,1400,paladin,retribution,108,46,62
Хочучерешни,lich-king,1399,paladin,retribution,93,50,43
Rîex,alleria,1399,paladin,retribution,77,36,41
Proxypala,silvermoon,1399,paladin,retribution,89,41,48
Ллосла,howling-fjord,1399,paladin,retribution,48,15,33
Маркант,gordunni,1398,paladin,retribution,222,113,109
Crêuyf,elune,1398,paladin,retribution,55,27,28
Crazzylight,kazzak,1398,paladin,retribution,86,41,45
Reiwyn,archimonde,1398,paladin,retribution,87,38,49
Aderos,sylvanas,1397,paladin,retribution,24,15,9
Ekzykes,ravencrest,1397,paladin,retribution,24,15,9
Nyren,guldan,1397,paladin,retribution,31,18,13
Serawyn,twisting-nether,1397,paladin,retribution,37,21,16
Leomealux,pozzo-delleternità,1397,paladin,retribution,30,17,13
Wingedtruck,draenor,1397,paladin,retribution,30,15,15
Rosallyn,argent-dawn,1397,paladin,retribution,89,35,54
Schaaboowyy,burning-legion,1396,paladin,retribution,31,17,14
Monkeylight,ambossar,1396,paladin,retribution,76,39,37
Vendikor,nemesis,1396,paladin,retribution,156,69,87
Duron,dragonblight,1396,paladin,retribution,45,19,26
Akelad,arathor,1396,paladin,retribution,84,31,53
Jackub,draenor,1395,paladin,retribution,50,27,23
Harycon,thrall,1395,paladin,retribution,42,20,22
Баблспула,soulflayer,1395,paladin,retribution,133,63,70
Eulion,burning-legion,1394,paladin,retribution,18,15,3
Crest,frostwolf,1394,paladin,retribution,48,29,19
Logossh,dun-modr,1394,paladin,retribution,44,22,22
Palantex,drakthul,1394,paladin,retribution,150,72,78
Холигор,deathguard,1394,paladin,retribution,84,40,44
Кадаврициан,howling-fjord,1394,paladin,retribution,72,32,40
Hydarr,twisting-nether,1393,paladin,retribution,86,48,38
Ocgynle,alonsus,1392,paladin,retribution,334,178,156
Загошслакер,howling-fjord,1392,paladin,retribution,42,22,20
Valerner,argent-dawn,1392,paladin,retribution,60,31,29
Whitebreeze,sanguino,1392,paladin,retribution,88,44,44
Lowsonzretri,doomhammer,1392,paladin,retribution,90,41,49
Isora,twisting-nether,1392,paladin,retribution,159,67,92
Dragonous,darkmoon-faire,1391,paladin,retribution,181,89,92
Palaradis,doomhammer,1391,paladin,retribution,35,17,18
Leoniidas,cthun,1391,paladin,retribution,65,30,35
Humangüy,kazzak,1391,paladin,retribution,47,15,32
Trefino,blackrock,1390,paladin,retribution,24,15,9
Gélan,stormscale,1390,paladin,retribution,170,85,85
Booyaahh,ravencrest,1389,paladin,retribution,60,32,28
Lerie,ravencrest,1389,paladin,retribution,102,49,53
Kolts,ragnaros,1388,paladin,retribution,39,23,16
Arkiol,marécage-de-zangar,1388,paladin,retribution,60,29,31
Dramaking,the-maelstrom,1388,paladin,retribution,46,22,24
Адирон,booty-bay,1387,paladin,retribution,24,19,5
Wisupl,silvermoon,1387,paladin,retribution,42,29,13
Йенфира,gordunni,1387,paladin,retribution,30,18,12
Røse,argent-dawn,1387,paladin,retribution,30,16,14
Revinox,silvermoon,1386,paladin,retribution,71,42,29
Fumaça,dun-modr,1386,paladin,retribution,119,66,53
Zandorath,argent-dawn,1386,paladin,retribution,54,24,30
Áramor,blackmoore,1385,paladin,retribution,47,26,21
Kaelron,sanguino,1384,paladin,retribution,33,21,12
Элавин,gordunni,1384,paladin,retribution,31,16,15
Tomkü,burning-legion,1384,paladin,retribution,69,32,37
Mareshki,outland,1384,paladin,retribution,72,32,40
Myxas,tarren-mill,1383,paladin,retribution,32,17,15
Цвандр,gordunni,1383,paladin,retribution,182,95,87
Notingvar,doomhammer,1383,paladin,retribution,87,39,48
Kirikoro,blackmoore,1383,paladin,retribution,42,16,26
Iklohz,sanguino,1382,paladin,retribution,82,45,37
Lògàn,pozzo-delleternità,1382,paladin,retribution,38,16,22
Vörtëx,tarren-mill,1381,paladin,retribution,77,43,34
Singedth,defias-brotherhood,1381,paladin,retribution,97,53,44
Ylzik,archimonde,1381,paladin,retribution,75,38,37
Hordiienko,silvermoon,1381,paladin,retribution,82,39,43
Тромбб,soulflayer,1381,paladin,retribution,89,39,50
Кольт,borean-tundra,1381,paladin,retribution,40,17,23
Nishe,earthen-ring,1380,paladin,retribution,30,17,13
Манддалорец,howling-fjord,1380,paladin,retribution,229,113,116
Teenage,colinas-pardas,1379,paladin,retribution,29,15,14
Holycowqt,eredar,1379,paladin,retribution,45,18,27
Вартэгпал,blackscar,1379,paladin,retribution,54,21,33
Càrláßrùní,hyjal,1378,paladin,retribution,48,29,19
Protos,ambossar,1378,paladin,retribution,62,28,34
Cherenpetur,neptulon,1377,paladin,retribution,56,30,26
Mooses,stormscale,1377,paladin,retribution,154,74,80
Blodin,silvermoon,1377,paladin,retribution,42,16,26
Artplex,ravencrest,1376,paladin,retribution,143,86,57
Yuopps,draenor,1376,paladin,retribution,66,35,31
Bezúziusz,ragnaros,1376,paladin,retribution,86,45,41
Juozas,argent-dawn,1376,paladin,retribution,36,16,20
Vendrick,silvermoon,1376,paladin,retribution,52,18,34
Straxotia,twisting-nether,1375,paladin,retribution,48,26,22
Walladin,stormscale,1375,paladin,retribution,93,45,48
Гримгалл,soulflayer,1375,paladin,retribution,54,25,29
Angelcore,tarren-mill,1374,paladin,retribution,193,95,98
Perrinaybull,magtheridon,1374,paladin,retribution,62,27,35
Xavios,eredar,1373,paladin,retribution,75,35,40
Блейзерфайт,eversong,1373,paladin,retribution,58,26,32
Dmytropal,draenor,1372,paladin,retribution,57,24,33
Telredor,rexxar,1372,paladin,retribution,42,15,27
Hella,dunemaul,1371,paladin,retribution,73,39,34
Shröömïë,silvermoon,1371,paladin,retribution,164,80,84
Hazorarh,argent-dawn,1370,paladin,retribution,31,17,14
Olaghkan,dun-modr,1370,paladin,retribution,70,37,33
Mexou,la-croisade-écarlate,1370,paladin,retribution,42,20,22
Badtrip,bloodscalp,1370,paladin,retribution,48,15,33
Dodu,vashj,1369,paladin,retribution,35,20,15
Майдмен,gordunni,1369,paladin,retribution,72,35,37
Вэйзмон,gordunni,1368,paladin,retribution,65,36,29
Beyma,twisting-nether,1368,paladin,retribution,29,15,14
Holydeath,aegwynn,1368,paladin,retribution,54,26,28
Uwelist,arathor,1368,paladin,retribution,85,40,45
Nomurabeta,naxxramas,1368,paladin,retribution,62,29,33
Judgement,the-maelstrom,1367,paladin,retribution,48,25,23
Lothacia,blackmoore,1367,paladin,retribution,36,17,19
Архэла,gordunni,1367,paladin,retribution,65,29,36
Nozgot,chromaggus,1367,paladin,retribution,42,18,24
Террорх,blackscar,1366,paladin,retribution,72,29,43
Bladê,kazzak,1365,paladin,retribution,33,19,14
Uragan,blackmoore,1365,paladin,retribution,122,64,58
Balthassar,kirin-tor,1365,paladin,retribution,202,100,102
Prosteprazak,ragnaros,1365,paladin,retribution,63,29,34
Розовыйужас,howling-fjord,1365,paladin,retribution,36,16,20
Mozg,silvermoon,1365,paladin,retribution,35,15,20
Tuplavv,dunemaul,1365,paladin,retribution,48,20,28
Gxdéon,hyjal,1364,paladin,retribution,117,67,50
Артреал,blackscar,1364,paladin,retribution,132,72,60
Zalandy,aggra-português,1364,paladin,retribution,65,35,30
Acp,twisting-nether,1364,paladin,retribution,42,22,20
Sagittaxx,kazzak,1364,paladin,retribution,170,87,83
Curtwizz,silvermoon,1364,paladin,retribution,45,22,23
Dhb,darksorrow,1364,paladin,retribution,37,16,21
Mbp,blackmoore,1363,paladin,retribution,36,18,18
Лефша,soulflayer,1362,paladin,retribution,47,32,15
Азов,thermaplugg,1362,paladin,retribution,77,36,41
Panthalassá,argent-dawn,1361,paladin,retribution,70,36,34
Foxcroft,argent-dawn,1360,paladin,retribution,30,15,15
Pascual,magtheridon,1360,paladin,retribution,56,27,29
Paajaxd,drakthul,1360,paladin,retribution,48,22,26
Нэксти,howling-fjord,1360,paladin,retribution,95,43,52
Fluppy,the-maelstrom,1360,paladin,retribution,126,57,69
Orzix,sylvanas,1359,paladin,retribution,53,30,23
Эзарх,gordunni,1359,paladin,retribution,58,29,29
Sixqti,blackrock,1359,paladin,retribution,205,101,104
Crawladin,eonar,1359,paladin,retribution,208,100,108
Юримия,blackscar,1359,paladin,retribution,47,21,26
Licht,sanguino,1358,paladin,retribution,24,15,9
Кенториус,soulflayer,1358,paladin,retribution,78,48,30
Ayàhuazka,ysondre,1358,paladin,retribution,156,72,84
Holaa,blackrock,1358,paladin,retribution,81,34,47
Ханпаладин,howling-fjord,1357,paladin,retribution,101,56,45
Caps,the-venture-co,1357,paladin,retribution,40,15,25
Эльбабло,lich-king,1356,paladin,retribution,63,33,30
Icearth,pozzo-delleternità,1355,paladin,retribution,320,160,160
Дджаб,booty-bay,1355,paladin,retribution,127,60,67
Limbik,silvermoon,1355,paladin,retribution,69,30,39
Гучив,howling-fjord,1354,paladin,retribution,48,27,21
Apolomaeuz,blackhand,1354,paladin,retribution,36,20,16
Âlßêdø,silvermoon,1354,paladin,retribution,84,43,41
Bloodlord,twisting-nether,1354,paladin,retribution,67,30,37
Bullight,archimonde,1354,paladin,retribution,36,15,21
Ludø,ysondre,1353,paladin,retribution,68,36,32
Aasimar,twilights-hammer,1353,paladin,retribution,260,132,128
Mughena,kazzak,1353,paladin,retribution,54,27,27
Brightening,kazzak,1353,paladin,retribution,96,46,50
Мистерху,gordunni,1352,paladin,retribution,208,111,97
Kyríé,tarren-mill,1352,paladin,retribution,60,31,29
Tríbunus,blackmoore,1352,paladin,retribution,37,19,18
Ahnaa,argent-dawn,1352,paladin,retribution,160,81,79
Илюшагодх,gordunni,1351,paladin,retribution,60,32,28
Lilles,argent-dawn,1351,paladin,retribution,42,21,21
Iamnami,earthen-ring,1351,paladin,retribution,58,23,35
Horgar,nagrand,1350,paladin,retribution,124,61,63
Troublebuble,silvermoon,1350,paladin,retribution,68,30,38
Auryel,nemesis,1350,paladin,retribution,96,42,54
Elaidja,illidan,1350,paladin,retribution,48,20,28
Sukinsin,aegwynn,1350,paladin,retribution,37,15,22
Thyalon,ragnaros,1349,paladin,retribution,96,52,44
Muradun,aegwynn,1349,paladin,retribution,48,24,24
Chimurei,silvermoon,1349,paladin,retribution,83,40,43
Sixtêên,silvermoon,1348,paladin,retribution,29,15,14
Бэдбой,howling-fjord,1347,paladin,retribution,120,58,62
Hegazy,darkmoon-faire,1347,paladin,retribution,96,39,57
Tønyx,les-clairvoyants,1346,paladin,retribution,38,16,22
Mosih,bloodfeather,1345,paladin,retribution,103,63,40
Zeyz,defias-brotherhood,1345,paladin,retribution,78,39,39
Кранштейн,gordunni,1345,paladin,retribution,96,46,50
Zerad,quelthalas,1345,paladin,retribution,126,48,78
Questos,burning-legion,1344,paladin,retribution,117,69,48
Диджейнобабл,howling-fjord,1344,paladin,retribution,24,14,10
Hemdâl,kirin-tor,1344,paladin,retribution,102,55,47
Ljusbågen,silvermoon,1344,paladin,retribution,34,18,16
Боевикс,ashenvale,1344,paladin,retribution,108,57,51
Hèmera,archimonde,1344,paladin,retribution,30,15,15
Тарйья,gordunni,1344,paladin,retribution,53,24,29
Хамили,gordunni,1344,paladin,retribution,126,55,71
Budweison,silvermoon,1344,paladin,retribution,54,22,32
Smackhammer,tarren-mill,1343,paladin,retribution,30,14,16
Ixøne,kazzak,1343,paladin,retribution,30,14,16
Goodfail,sanguino,1343,paladin,retribution,61,28,33
Djmontana,archimonde,1343,paladin,retribution,36,14,22
Хен,blackscar,1342,paladin,retribution,92,49,43
Duckiboy,ragnaros,1342,paladin,retribution,162,85,77
Arien,zuljin,1342,paladin,retribution,120,60,60
Penknife,ravencrest,1342,paladin,retribution,98,46,52
Израф,borean-tundra,1342,paladin,retribution,36,14,22
Hislifelmao,kazzak,1342,paladin,retribution,36,14,22
Evölution,frostmane,1342,paladin,retribution,36,14,22
Nurix,dun-modr,1342,paladin,retribution,42,14,28
Нажим,howling-fjord,1341,paladin,retribution,126,65,61
Sylazz,blackrock,1341,paladin,retribution,329,166,163
Белкоксю,booty-bay,1341,paladin,retribution,120,57,63
Chocbear,tarren-mill,1341,paladin,retribution,30,14,16
Tibiscovus,silvermoon,1341,paladin,retribution,101,47,54
Dioxius,stormscale,1341,paladin,retribution,36,14,22
Alus,blackmoore,1341,paladin,retribution,42,16,26
Brölin,sanguino,1340,paladin,retribution,48,22,26
Dwangl,silvermoon,1339,paladin,retribution,36,18,18
Panzerberg,blackrock,1339,paladin,retribution,30,15,15
Adnachiel,blackhand,1339,paladin,retribution,61,30,31
Lighteousnes,blackmoore,1339,paladin,retribution,30,14,16
Ashernos,tarren-mill,1339,paladin,retribution,89,41,48
Платинум,blackscar,1339,paladin,retribution,36,14,22
Destya,eredar,1339,paladin,retribution,36,14,22
Kotnusher,blackrock,1338,paladin,retribution,24,14,10
Aryza,hellfire,1338,paladin,retribution,57,29,28
Беймикс,gordunni,1338,paladin,retribution,132,67,65
Morsadin,burning-legion,1338,paladin,retribution,30,14,16
Gindolon,blackhand,1338,paladin,retribution,48,21,27
Kaní,eredar,1338,paladin,retribution,36,14,22
Mendril,malorne,1337,paladin,retribution,42,27,15
Shuraé,blackmoore,1337,paladin,retribution,24,14,10
Ahzut,rashgarroth,1337,paladin,retribution,30,15,15
Syrkxion,silvermoon,1337,paladin,retribution,30,14,16
Джекадамс,gordunni,1337,paladin,retribution,249,105,144
Lightmyst,outland,1336,paladin,retribution,24,14,10
Töphuria,silvermoon,1336,paladin,retribution,89,44,45
Rustig,talnivarr,1335,paladin,retribution,26,16,10
Tecknó,ragnaros,1335,paladin,retribution,36,19,17
Azaël,illidan,1335,paladin,retribution,46,22,24
Hølypwnjk,forscherliga,1335,paladin,retribution,30,14,16
Arkura,nozdormu,1334,paladin,retribution,30,18,12
Zipoohun,arathor,1334,paladin,retribution,97,52,45
Serkunkoira,emeriss,1334,paladin,retribution,36,19,17
Легейнда,soulflayer,1334,paladin,retribution,30,14,16
Юлец,galakrond,1334,paladin,retribution,71,32,39
Vaníos,nazjatar,1333,paladin,retribution,34,19,15
Tomiris,twisting-nether,1333,paladin,retribution,59,29,30
Ironhide,echsenkessel,1333,paladin,retribution,36,15,21
Víii,outland,1332,paladin,retribution,73,33,40
Judgemented,turalyon,1331,paladin,retribution,152,78,74
Strongman,twilights-hammer,1331,paladin,retribution,30,15,15
Vanyon,malganis,1331,paladin,retribution,50,24,26
Негропаладин,soulflayer,1330,paladin,retribution,26,15,11
Arrens,silvermoon,1330,paladin,retribution,32,16,16
Aegend,antonidas,1330,paladin,retribution,189,91,98
Amnell,marécage-de-zangar,1330,paladin,retribution,77,37,40
Malbi,kazzak,1330,paladin,retribution,53,23,30
Lightheartx,argent-dawn,1330,paladin,retribution,67,28,39
Imoss,hyjal,1329,paladin,retribution,36,22,14
Hisblade,emerald-dream,1329,paladin,retribution,57,30,27
Thebestpala,tarren-mill,1329,paladin,retribution,50,21,29
Ridethelight,nemesis,1328,paladin,retribution,27,15,12
Egx,draenor,1328,paladin,retribution,36,15,21
Paliax,outland,1327,paladin,retribution,30,14,16
Зольвинталь,deathguard,1327,paladin,retribution,33,15,18
Lukinio,silvermoon,1326,paladin,retribution,169,79,90
Uweósas,aegwynn,1326,paladin,retribution,66,28,38
Milojcica,kazzak,1325,paladin,retribution,22,15,7
Jebenatreba,sporeggar,1325,paladin,retribution,41,21,20
Nissesolsken,outland,1325,paladin,retribution,29,14,15
Arthuriân,outland,1325,paladin,retribution,48,21,27
Xinti,silvermoon,1324,paladin,retribution,23,14,9
Enriel,temple-noir,1324,paladin,retribution,30,16,14
Érléuchtas,kazzak,1324,paladin,retribution,58,30,28
Yasuomid,sanguino,1324,paladin,retribution,30,14,16
Nëphilim,arakarahm,1324,paladin,retribution,54,25,29
Bâby,arathi,1324,paladin,retribution,65,28,37
Udimir,pozzo-delleternità,1324,paladin,retribution,36,14,22
Эйтэр,howling-fjord,1324,paladin,retribution,48,14,34
Fëanôr,tarren-mill,1323,paladin,retribution,404,212,192
Starr,confrérie-du-thorium,1323,paladin,retribution,44,20,24
Valaeryanae,nemesis,1323,paladin,retribution,62,28,34
Этокомедия,howling-fjord,1323,paladin,retribution,36,14,22
Thëone,exodar,1322,paladin,retribution,64,36,28
Servius,ragnaros,1322,paladin,retribution,83,39,44
Sienna,kazzak,1322,paladin,retribution,36,15,21
Mantinel,hellfire,1321,paladin,retribution,38,24,14
Neîlyô,dalaran,1321,paladin,retribution,24,14,10
Baddaddy,stormscale,1321,paladin,retribution,30,14,16
Nicolae,colinas-pardas,1321,paladin,retribution,71,31,40
Assyr,blackmoore,1320,paladin,retribution,83,43,40
Hagën,minahonda,1320,paladin,retribution,71,35,36
Sweetkick,archimonde,1320,paladin,retribution,30,14,16
Ibntaymiyyah,ravencrest,1320,paladin,retribution,30,14,16
Ironstealman,shattered-hand,1320,paladin,retribution,102,43,59
Ustnivkusni,kazzak,1319,paladin,retribution,25,15,10
Kirlight,blackrock,1318,paladin,retribution,24,14,10
Merkurial,sylvanas,1318,paladin,retribution,30,17,13
Таурусс,booty-bay,1318,paladin,retribution,102,47,55
Авараан,galakrond,1318,paladin,retribution,36,14,22
Wtfudo,sylvanas,1317,paladin,retribution,41,21,20
Gigap,ragnaros,1317,paladin,retribution,52,21,31
Вэлвэлвэл,soulflayer,1316,paladin,retribution,122,63,59
Tidus,conseil-des-ombres,1316,paladin,retribution,72,35,37
Benno,dun-modr,1316,paladin,retribution,157,70,87
Skieras,draenor,1315,paladin,retribution,24,14,10
Edwards,sanguino,1315,paladin,retribution,36,18,18
Gaizilla,burning-blade,1314,paladin,retribution,57,33,24
Yrgin,ravencrest,1314,paladin,retribution,316,159,157
Æïs,blackrock,1313,paladin,retribution,75,40,35
Irinor,rashgarroth,1313,paladin,retribution,60,32,28
Дэвсон,greymane,1313,paladin,retribution,36,14,22
Faventu,ragnaros,1312,paladin,retribution,36,21,15
Foxare,burning-legion,1312,paladin,retribution,53,29,24
Пепсекольный,soulflayer,1312,paladin,retribution,48,25,23
Gaab,aggra-português,1312,paladin,retribution,166,85,81
Мильфорд,eversong,1312,paladin,retribution,156,78,78
Demool,the-maelstrom,1312,paladin,retribution,65,29,36
Derian,antonidas,1312,paladin,retribution,66,29,37
Pornado,ragnaros,1312,paladin,retribution,42,16,26
Mashijudge,blackhand,1311,paladin,retribution,84,42,42
Bärghest,sanguino,1310,paladin,retribution,66,40,26
Sparrda,dun-modr,1310,paladin,retribution,72,36,36
Нероблр,gordunni,1310,paladin,retribution,37,15,22
Äthénâ,archimonde,1310,paladin,retribution,53,19,34
Doomsaw,alexstrasza,1309,paladin,retribution,20,15,5
Amberkå,burning-legion,1309,paladin,retribution,30,16,14
Nardindindou,ysondre,1309,paladin,retribution,170,86,84
Vâskt,dun-modr,1309,paladin,retribution,291,146,145
Варасса,grom,1309,paladin,retribution,48,22,26
Ôrus,minahonda,1309,paladin,retribution,81,36,45
Barqin,ragnaros,1308,paladin,retribution,85,44,41
Bonzai,blackrock,1308,paladin,retribution,229,114,115
Hogsy,malfurion,1308,paladin,retribution,118,56,62
Saró,ravencrest,1307,paladin,retribution,41,22,19
Эррор,azuregos,1307,paladin,retribution,36,19,17
Erin,wildhammer,1307,paladin,retribution,56,28,28
Jelcz,burning-legion,1307,paladin,retribution,48,23,25
Pitusá,dun-modr,1307,paladin,retribution,105,49,56
Ryozupala,frostwolf,1306,paladin,retribution,24,15,9
Молотоборец,gordunni,1306,paladin,retribution,110,60,50
Hypothalamus,silvermoon,1306,paladin,retribution,66,36,30
Khrotos,draenor,1306,paladin,retribution,144,74,70
Kaizêr,silvermoon,1306,paladin,retribution,97,46,51
Miqee,burning-legion,1306,paladin,retribution,75,35,40
Palangel,eldrethalas,1306,paladin,retribution,132,61,71
Émilia,frostwolf,1306,paladin,retribution,58,23,35
Vorsip,tarren-mill,1305,paladin,retribution,48,20,28
Celsia,blackrock,1304,paladin,retribution,30,16,14
Købìtø,archimonde,1304,paladin,retribution,88,41,47
Klittsurf,bloodhoof,1303,paladin,retribution,78,45,33
Skrýmir,marécage-de-zangar,1303,paladin,retribution,30,16,14
Nazdarvole,drakthul,1302,paladin,retribution,110,58,52
Forneus,nemesis,1302,paladin,retribution,198,103,95
Karnage,zenedar,1302,paladin,retribution,157,80,77
Patriok,moonglade,1300,paladin,retribution,51,29,22
Ymersa,stormscale,1300,paladin,retribution,97,49,48
Лейфи,howling-fjord,1300,paladin,retribution,54,27,27
Jagen,tyrande,1300,paladin,retribution,111,55,56
Pianiste,sinstralis,1300,paladin,retribution,42,20,22
Prínce,blackmoore,1300,paladin,retribution,56,26,30
Nelasson,eredar,1299,paladin,retribution,32,18,14
Jac,nemesis,1299,paladin,retribution,259,123,136
Shiëld,khaz-modan,1299,paladin,retribution,42,15,27
Jackypala,ravencrest,1298,paladin,retribution,48,25,23
Siphi,frostwolf,1298,paladin,retribution,76,36,40
Timôro,archimonde,1298,paladin,retribution,78,36,42
Маразоточка,howling-fjord,1298,paladin,retribution,65,29,36
Daminika,das-syndikat,1298,paladin,retribution,54,22,32
Truezero,draenor,1297,paladin,retribution,42,23,19
Artorya,outland,1297,paladin,retribution,36,17,19
Депреседмодх,soulflayer,1296,paladin,retribution,72,39,33
Rothmans,aggra-português,1296,paladin,retribution,65,34,31
Radamanthes,ysondre,1296,paladin,retribution,128,61,67
Alâkir,kazzak,1296,paladin,retribution,44,18,26
Ретриванлав,gordunni,1296,paladin,retribution,72,24,48
Парсефон,soulflayer,1295,paladin,retribution,36,20,16
Тэмплари,galakrond,1295,paladin,retribution,111,56,55
Zoomzoom,sylvanas,1295,paladin,retribution,75,36,39
Gustavus,emeriss,1295,paladin,retribution,76,28,48
Raweo,kilrogg,1294,paladin,retribution,78,47,31
Iqso,argent-dawn,1294,paladin,retribution,30,16,14
Retroon,doomhammer,1294,paladin,retribution,36,19,17
Teliriyon,blackrock,1294,paladin,retribution,44,19,25
Plésmo,blackmoore,1293,paladin,retribution,53,27,26
Bettemý,tarren-mill,1292,paladin,retribution,24,15,9
Масачусетсс,gordunni,1290,paladin,retribution,84,44,40
Gerin,ulduar,1290,paladin,retribution,66,32,34
Suavé,ravencrest,1290,paladin,retribution,50,20,30
Инидор,blackscar,1290,paladin,retribution,42,16,26
Ahramanyu,blackrock,1289,paladin,retribution,48,23,25
Чотут,howling-fjord,1287,paladin,retribution,54,22,32
Patsani,twilights-hammer,1286,paladin,retribution,80,46,34
Sødaz,hyjal,1286,paladin,retribution,140,67,73
Светонносец,gordunni,1286,paladin,retribution,221,102,119
Reticles,ravencrest,1286,paladin,retribution,47,21,26
Святорусс,gordunni,1286,paladin,retribution,142,61,81
Taptreus,antonidas,1286,paladin,retribution,45,19,26
Proteiin,drakthul,1285,paladin,retribution,30,17,13
Catsnek,darksorrow,1285,paladin,retribution,30,16,14
Valoren,todeswache,1285,paladin,retribution,35,17,18
Blessmedaddy,tarren-mill,1285,paladin,retribution,76,36,40
Tpaktopuct,kazzak,1284,paladin,retribution,44,22,22
Dayr,sylvanas,1284,paladin,retribution,75,36,39
Anndersen,aszune,1284,paladin,retribution,36,17,19
Jameshowlett,archimonde,1284,paladin,retribution,42,16,26
Holylimx,draenor,1283,paladin,retribution,114,56,58
Eagleone,shattrath,1282,paladin,retribution,80,40,40
Aipal,silvermoon,1282,paladin,retribution,36,14,22
Línke,sanguino,1281,paladin,retribution,102,58,44
Vvaarok,blackmoore,1281,paladin,retribution,83,35,48
Alcadeias,nefarian,1281,paladin,retribution,36,14,22
Mootaindew,tarren-mill,1280,paladin,retribution,54,34,20
Snobypala,onyxia,1280,paladin,retribution,73,36,37
Bjoorrn,hyjal,1280,paladin,retribution,31,15,16
Enary,zuljin,1280,paladin,retribution,44,20,24
Dieversity,stormscale,1280,paladin,retribution,41,16,25
Хепипал,soulflayer,1279,paladin,retribution,67,34,33
Hekta,wildhammer,1279,paladin,retribution,60,30,30
Dehanath,draenor,1279,paladin,retribution,201,98,103
Krullfar,ravencrest,1279,paladin,retribution,86,37,49
Mindoxlawlz,sanguino,1279,paladin,retribution,60,25,35
Öwai,dun-modr,1278,paladin,retribution,65,39,26
Bagarlisa,silvermoon,1278,paladin,retribution,41,23,18
Edyk,silvermoon,1278,paladin,retribution,131,72,59
Shädyss,hyjal,1278,paladin,retribution,129,67,62
Furmund,stormscale,1277,paladin,retribution,44,25,19
Gatsßy,archimonde,1277,paladin,retribution,42,21,21
Lagaminë,dalaran,1277,paladin,retribution,153,76,77
Algoric,suramar,1277,paladin,retribution,78,29,49
Chuntterz,shadowsong,1276,paladin,retribution,33,16,17
Zulem,grim-batol,1276,paladin,retribution,36,17,19
Ïnata,khaz-modan,1276,paladin,retribution,50,22,28
Snowydin,tarren-mill,1275,paladin,retribution,36,22,14
Gavril,bloodfeather,1274,paladin,retribution,132,63,69
Holypurger,shattered-hand,1274,paladin,retribution,79,33,46
Халва,deathguard,1273,paladin,retribution,32,14,18
Хеллпанч,howling-fjord,1272,paladin,retribution,119,68,51
Kaljir,archimonde,1272,paladin,retribution,27,15,12
Миссйеллоу,gordunni,1272,paladin,retribution,29,14,15
Palladia,rexxar,1272,paladin,retribution,42,16,26
Lightmonger,drakthul,1271,paladin,retribution,30,17,13
Westplays,turalyon,1271,paladin,retribution,201,105,96
Angarx,draenor,1271,paladin,retribution,145,72,73
Hammexõr,sylvanas,1271,paladin,retribution,87,39,48
Giglix,twisting-nether,1271,paladin,retribution,48,15,33
Hellschwert,hyjal,1270,paladin,retribution,36,15,21
Santafuu,blackhand,1270,paladin,retribution,59,23,36
Powerphally,outland,1270,paladin,retribution,44,16,28
Gotra,stormscale,1268,paladin,retribution,57,25,32
Айронс,ashenvale,1267,paladin,retribution,42,27,15
Перизкопец,gordunni,1267,paladin,retribution,32,17,15
Lóyal,kazzak,1267,paladin,retribution,30,14,16
Auditõr,argent-dawn,1267,paladin,retribution,85,32,53
Alard,sanguino,1267,paladin,retribution,66,24,42
Флаила,ashenvale,1266,paladin,retribution,101,53,48
Vhredny,burning-legion,1266,paladin,retribution,54,26,28
Antón,dun-modr,1266,paladin,retribution,36,16,20
Thallear,thrall,1266,paladin,retribution,35,15,20
Mirithaz,stormscale,1265,paladin,retribution,23,14,9
Hardliquor,blades-edge,1265,paladin,retribution,77,36,41
Syng,garona,1265,paladin,retribution,42,18,24
Spizz,dun-modr,1265,paladin,retribution,36,14,22
Nykothpn,ghostlands,1264,paladin,retribution,29,24,5
Retgaffeooku,conseil-des-ombres,1264,paladin,retribution,84,40,44
Redeem,nemesis,1264,paladin,retribution,38,14,24
Sufrion,outland,1263,paladin,retribution,81,42,39
Кс,greymane,1263,paladin,retribution,54,27,27
Froxies,drakthul,1263,paladin,retribution,32,14,18
Holycow,temple-noir,1263,paladin,retribution,66,22,44
Valpen,veknilash,1262,paladin,retribution,48,25,23
Belight,burning-legion,1262,paladin,retribution,93,36,57
Stepamusicz,stormreaver,1261,paladin,retribution,72,39,33
Shuler,silvermoon,1260,paladin,retribution,106,58,48
Thoorval,silvermoon,1260,paladin,retribution,123,60,63
Savaara,argent-dawn,1259,paladin,retribution,54,26,28
Soulglo,ragnaros,1259,paladin,retribution,72,29,43
Лурири,gordunni,1258,paladin,retribution,24,15,9
Owiganowi,ulduar,1258,paladin,retribution,66,37,29
Takaret,hyjal,1258,paladin,retribution,262,126,136
Maýlin,das-konsortium,1258,paladin,retribution,30,14,16
Alexii,azjolnerub,1257,paladin,retribution,42,18,24
Rafistor,khaz-modan,1257,paladin,retribution,59,19,40
Viiri,burning-legion,1256,paladin,retribution,113,59,54
Olwie,argent-dawn,1256,paladin,retribution,47,24,23
Daicic,kazzak,1256,paladin,retribution,31,15,16
Dildodin,ravencrest,1255,paladin,retribution,24,14,10
Platanid,doomhammer,1255,paladin,retribution,98,55,43
Хэппипала,soulflayer,1255,paladin,retribution,25,14,11
Jeyløl,antonidas,1255,paladin,retribution,34,15,19
Carpetcummer,ravencrest,1255,paladin,retribution,36,15,21
Руказакона,deathguard,1255,paladin,retribution,121,50,71
Миоцуки,gordunni,1254,paladin,retribution,82,37,45
Рионор,soulflayer,1253,paladin,retribution,48,24,24
Fredas,hyjal,1253,paladin,retribution,119,57,62
Sherulz,sylvanas,1252,paladin,retribution,42,25,17
Myralions,burning-legion,1251,paladin,retribution,53,33,20
Hollylady,outland,1251,paladin,retribution,42,25,17
Troj,ahnqiraj,1251,paladin,retribution,95,51,44
Pytha,nozdormu,1251,paladin,retribution,136,73,63
Legendaryxw,drakthul,1251,paladin,retribution,94,45,49
Faithsmemory,silvermoon,1251,paladin,retribution,92,40,52
Onishu,blackhand,1249,paladin,retribution,36,14,22
Galodina,blackmoore,1248,paladin,retribution,29,16,13
Yanisx,burning-legion,1248,paladin,retribution,82,41,41
Swagged,kazzak,1248,paladin,retribution,58,28,30
Elení,thrall,1248,paladin,retribution,43,16,27
Kazui,lordaeron,1247,paladin,retribution,18,13,5
Retdream,nemesis,1247,paladin,retribution,18,13,5
Kaedena,kaelthas,1247,paladin,retribution,48,27,21
Gonhilda,kazzak,1247,paladin,retribution,54,27,27
Leyawin,sanguino,1247,paladin,retribution,48,24,24
Leelemon,frostmane,1247,paladin,retribution,38,17,21
Ezbonk,kazzak,1247,paladin,retribution,36,13,23
Umirinbruv,zenedar,1247,paladin,retribution,36,13,23
Lôrelei,blackrock,1247,paladin,retribution,36,13,23
Нурти,gordunni,1246,paladin,retribution,18,13,5
Luckyman,aszune,1246,paladin,retribution,24,13,11
Taeran,dun-modr,1246,paladin,retribution,24,13,11
Nzmamba,burning-legion,1246,paladin,retribution,24,13,11
Ziggyz,kul-tiras,1246,paladin,retribution,49,26,23
Mooriel,burning-legion,1246,paladin,retribution,27,14,13
Trollarage,confrérie-du-thorium,1246,paladin,retribution,90,45,45
Belldog,tarren-mill,1246,paladin,retribution,66,28,38
Styxpl,blackhand,1246,paladin,retribution,36,13,23
Daddyret,ravencrest,1245,paladin,retribution,18,13,5
Cinderlight,aszune,1245,paladin,retribution,42,25,17
Ahreesh,blackrock,1245,paladin,retribution,36,18,18
Mohamedx,tarren-mill,1245,paladin,retribution,30,13,17
Тевеон,gordunni,1245,paladin,retribution,30,13,17
Gromzed,ravencrest,1245,paladin,retribution,30,13,17
Gljeto,tarren-mill,1244,paladin,retribution,24,17,7
Angeal,ysondre,1244,paladin,retribution,25,14,11
Anamary,ravencrest,1244,paladin,retribution,87,46,41
Deathzinger,aszune,1244,paladin,retribution,84,40,44
Skullreaper,mannoroth,1244,paladin,retribution,36,17,19
Toruk,burning-legion,1244,paladin,retribution,60,26,34
Marthawise,eredar,1244,paladin,retribution,30,13,17
Gulyas,tarren-mill,1244,paladin,retribution,30,13,17
Proxidus,blackmoore,1244,paladin,retribution,41,16,25
Зена,gordunni,1244,paladin,retribution,36,13,23
Perícles,the-maelstrom,1243,paladin,retribution,30,14,16
Dêadgame,aegwynn,1243,paladin,retribution,37,14,23
Mattüsälëmm,sanguino,1242,paladin,retribution,33,22,11
Meltrox,runetotem,1242,paladin,retribution,24,13,11
Juicyhammers,ragnaros,1242,paladin,retribution,24,13,11
Quennten,grim-batol,1242,paladin,retribution,24,13,11
Lonesoul,tarren-mill,1242,paladin,retribution,24,13,11
Círuq,eredar,1242,paladin,retribution,30,13,17
Kríssu,burning-legion,1242,paladin,retribution,30,13,17
Littlenight,emerald-dream,1242,paladin,retribution,30,13,17
Sileria,kazzak,1242,paladin,retribution,30,13,17
Razzim,eredar,1242,paladin,retribution,36,13,23
Helmed,tarren-mill,1241,paladin,retribution,63,35,28
Blessedpapi,draenor,1241,paladin,retribution,24,13,11
Rangorian,defias-brotherhood,1241,paladin,retribution,36,15,21
Pipiczek,outland,1241,paladin,retribution,41,16,25
Lightsbreath,ragnaros,1240,paladin,retribution,24,13,11
Рашенс,gordunni,1240,paladin,retribution,96,42,54
Marnaø,ysondre,1240,paladin,retribution,38,16,22
Zefirin,ragnaros,1240,paladin,retribution,36,13,23
Saucisse,archimonde,1239,paladin,retribution,24,13,11
Jdizzy,tarren-mill,1239,paladin,retribution,24,13,11
Jezrien,khazgoroth,1239,paladin,retribution,78,37,41
Ashmaker,khaz-modan,1239,paladin,retribution,36,13,23
Carï,ravencrest,1239,paladin,retribution,48,13,35
Yunax,silvermoon,1238,paladin,retribution,70,36,34
Methires,burning-legion,1238,paladin,retribution,89,45,44
Steakenstein,nathrezim,1238,paladin,retribution,152,76,76
Taylerr,drakthul,1238,paladin,retribution,30,15,15
Dàrkùsh,archimonde,1238,paladin,retribution,89,44,45
Baltyros,thrall,1238,paladin,retribution,36,16,20
Purjolöken,tarren-mill,1238,paladin,retribution,44,18,26
Nála,boulderfist,1237,paladin,retribution,147,84,63
Talyâh,dalaran,1237,paladin,retribution,24,13,11
Кэшбэкер,fordragon,1237,paladin,retribution,42,21,21
Powericius,drakthul,1237,paladin,retribution,30,13,17
Sházen,silvermoon,1237,paladin,retribution,30,13,17
Peterholy,hyjal,1237,paladin,retribution,30,13,17
Ulderoth,dun-modr,1237,paladin,retribution,74,32,42
Æe,blackmoore,1236,paladin,retribution,37,22,15
Zhroomxx,blackmoore,1236,paladin,retribution,24,13,11
Khaelor,frostwolf,1235,paladin,retribution,24,13,11
Sorciex,blackmoore,1235,paladin,retribution,24,13,11
Greald,argent-dawn,1235,paladin,retribution,116,56,60
Nevermoore,doomhammer,1235,paladin,retribution,75,33,42
Lewp,tarren-mill,1234,paladin,retribution,18,13,5
Bashanger,boulderfist,1234,paladin,retribution,24,13,11
Anatorka,drakthul,1234,paladin,retribution,78,39,39
Armani,ysera,1234,paladin,retribution,65,32,33
Angrykorean,blackmoore,1234,paladin,retribution,82,38,44
Skénder,kazzak,1234,paladin,retribution,78,29,49
Liardin,draenor,1233,paladin,retribution,30,14,16
Shebapaladin,silvermoon,1233,paladin,retribution,30,13,17
Jerremia,silvermoon,1233,paladin,retribution,31,13,18
Dragg,kirin-tor,1233,paladin,retribution,34,14,20
Paillasson,nerzhul,1232,paladin,retribution,92,54,38
Lightppl,outland,1232,paladin,retribution,119,60,59
Fintros,silvermoon,1232,paladin,retribution,72,34,38
Zhaz,blackmoore,1232,paladin,retribution,84,38,46
Kanot,outland,1231,paladin,retribution,108,60,48
Fannypoo,sylvanas,1231,paladin,retribution,24,13,11
Ragnarük,khaz-modan,1231,paladin,retribution,84,41,43
Baxteria,dun-modr,1231,paladin,retribution,96,40,56
Liana,alexstrasza,1231,paladin,retribution,42,16,26
Palafurax,hyjal,1229,paladin,retribution,36,16,20
Methiv,magtheridon,1229,paladin,retribution,30,13,17
Wtyou,blackhand,1228,paladin,retribution,18,13,5
Palaur,silvermoon,1228,paladin,retribution,48,17,31
Walorez,ragnaros,1227,paladin,retribution,23,13,10
Tillak,draenor,1227,paladin,retribution,24,13,11
Bitether,burning-legion,1227,paladin,retribution,42,19,23
Émøùki,dalaran,1227,paladin,retribution,47,21,26
Tripani,twisting-nether,1226,paladin,retribution,54,29,25
Kompot,dun-morogh,1226,paladin,retribution,30,14,16
Veest,doomhammer,1226,paladin,retribution,34,15,19
Paraðox,ysondre,1226,paladin,retribution,30,13,17
Тайела,gordunni,1226,paladin,retribution,76,31,45
Zâre,sanguino,1225,paladin,retribution,175,86,89
Atomicbubble,balnazzar,1225,paladin,retribution,54,26,28
Legenda,grim-batol,1224,paladin,retribution,36,18,18
Ðarkjøjø,hyjal,1224,paladin,retribution,36,17,19
Крусейд,deathguard,1224,paladin,retribution,101,47,54
Ènyalius,silvermoon,1224,paladin,retribution,48,20,28
Biermaxx,blackmoore,1224,paladin,retribution,36,13,23
Bootybanger,thrall,1223,paladin,retribution,24,13,11
Cyclope,frostmane,1223,paladin,retribution,100,45,55
Shorella,malganis,1222,paladin,retribution,71,38,33
Watie,thunderhorn,1222,paladin,retribution,58,31,27
Ратомир,howling-fjord,1222,paladin,retribution,65,32,33
Aikm,tarren-mill,1222,paladin,retribution,80,37,43
Uthelf,ragnaros,1222,paladin,retribution,53,24,29
Åriel,uldum,1222,paladin,retribution,32,13,19
Holyblast,shattered-hand,1221,paladin,retribution,63,33,30
Velkar,frostmane,1221,paladin,retribution,56,29,27
Keith,dragonmaw,1221,paladin,retribution,54,24,30
Stahlmann,argent-dawn,1221,paladin,retribution,48,21,27
Trefata,kazzak,1221,paladin,retribution,35,13,22
Larialaya,thrall,1221,paladin,retribution,42,15,27
Энилейт,lich-king,1220,paladin,retribution,70,44,26
Monchéri,stormscale,1220,paladin,retribution,24,13,11
Keol,sanguino,1220,paladin,retribution,37,19,18
Hornox,ragnaros,1220,paladin,retribution,71,34,37
Blechdøse,onyxia,1220,paladin,retribution,72,32,40
Акерсарин,gordunni,1219,paladin,retribution,43,24,19
Dinøx,archimonde,1218,paladin,retribution,152,73,79
Wumbo,sinstralis,1217,paladin,retribution,66,34,32
Alvagur,zirkel-des-cenarius,1217,paladin,retribution,55,28,27
Dorian,durotan,1217,paladin,retribution,48,20,28
Boaz,norgannon,1217,paladin,retribution,36,14,22
Rokaur,ragnaros,1217,paladin,retribution,48,18,30
Bierkapítän,blackrock,1216,paladin,retribution,30,21,9
Гацкан,gordunni,1216,paladin,retribution,40,21,19
Аракиль,gordunni,1216,paladin,retribution,28,13,15
Chúm,the-maelstrom,1216,paladin,retribution,48,22,26
Pallyman,arthas,1216,paladin,retribution,36,15,21
Bubblemama,aegwynn,1215,paladin,retribution,48,28,20
Авроравайт,gordunni,1215,paladin,retribution,88,51,37
Melnes,draenor,1215,paladin,retribution,41,21,20
Гарраж,howling-fjord,1215,paladin,retribution,36,14,22
Бьюттасттл,howling-fjord,1215,paladin,retribution,35,13,22
Rilledread,stormscale,1214,paladin,retribution,114,57,57
Kuelzar,kazzak,1214,paladin,retribution,30,15,15
Джагашарага,soulflayer,1214,paladin,retribution,29,13,16
Doban,shattered-hand,1213,paladin,retribution,51,31,20
Mystíque,die-todeskrallen,1213,paladin,retribution,101,55,46
Ghallandre,khaz-modan,1213,paladin,retribution,48,25,23
Øybiornz,stormscale,1212,paladin,retribution,61,34,27
Ayoitsme,twisting-nether,1210,paladin,retribution,30,15,15
Darhuun,antonidas,1210,paladin,retribution,111,50,61
Princépretty,frostwolf,1210,paladin,retribution,139,61,78
Retribuser,tarren-mill,1208,paladin,retribution,24,14,10
Yasfy,stormscale,1208,paladin,retribution,36,13,23
Didtaras,terokkar,1208,paladin,retribution,42,13,29
Palabido,nemesis,1207,paladin,retribution,541,264,277
Krustenkaese,kelthuzad,1207,paladin,retribution,30,14,16
Bagolt,quelthalas,1207,paladin,retribution,56,22,34
Kýrp,stormreaver,1207,paladin,retribution,43,16,27
Diøstemplar,dun-modr,1206,paladin,retribution,70,36,34
Joelosteen,neptulon,1206,paladin,retribution,99,50,49
Asorte,chants-éternels,1206,paladin,retribution,137,59,78
Mírato,blackhand,1205,paladin,retribution,75,40,35
Aleksandor,kazzak,1203,paladin,retribution,42,23,19
Hylion,kirin-tor,1203,paladin,retribution,60,28,32
Jamdog,sylvanas,1203,paladin,retribution,30,13,17
Ликанн,soulflayer,1203,paladin,retribution,104,44,60
Heinzdwise,ravencrest,1203,paladin,retribution,42,14,28
Thorold,earthen-ring,1202,paladin,retribution,63,36,27
Lightstormi,norgannon,1202,paladin,retribution,101,54,47
Beiluoshimen,archimonde,1202,paladin,retribution,50,23,27
Salsarr,spinebreaker,1201,paladin,retribution,24,15,9
Ramsay,arthas,1201,paladin,retribution,61,31,30
Ночнаябуря,gordunni,1201,paladin,retribution,66,33,33
Seigi,tarren-mill,1201,paladin,retribution,104,51,53
Deyvan,dalaran,1201,paladin,retribution,36,17,19
Ralfx,ragnaros,1201,paladin,retribution,30,14,16
Sinnerknight,silvermoon,1201,paladin,retribution,38,17,21
Allucere,blackmoore,1201,paladin,retribution,70,30,40
Кетран,howling-fjord,1201,paladin,retribution,67,27,40
Ukey,sanguino,1200,paladin,retribution,118,70,48
Rayshield,tarren-mill,1200,paladin,retribution,53,28,25
Windîr,draenor,1200,paladin,retribution,41,21,20
Unboostable,archimonde,1200,paladin,retribution,72,36,36
Saraanneline,tarren-mill,1200,paladin,retribution,29,13,16
Kóternoga,burning-legion,1200,paladin,retribution,54,19,35
Qzoveca,steamwheedle-cartel,1199,paladin,retribution,78,28,50
Сапфирия,galakrond,1198,paladin,retribution,129,59,70
Saltletts,thrall,1197,paladin,retribution,55,25,30
Goatti,lightnings-blade,1196,paladin,retribution,112,53,59
Deldrina,nozdormu,1196,paladin,retribution,78,34,44
Freyjä,turalyon,1195,paladin,retribution,180,86,94
Davairabotai,kazzak,1195,paladin,retribution,32,14,18
Sorâ,archimonde,1195,paladin,retribution,36,15,21
Ustex,argent-dawn,1195,paladin,retribution,35,13,22
Siuras,blackmoore,1194,paladin,retribution,23,13,10
Leith,neptulon,1194,paladin,retribution,82,40,42
Caleel,nemesis,1193,paladin,retribution,27,14,13
Matharr,kazzak,1193,paladin,retribution,174,83,91
Bucaxin,cthun,1192,paladin,retribution,24,14,10
Vhalkur,dun-modr,1192,paladin,retribution,25,14,11
Bulina,stormscale,1190,paladin,retribution,30,14,16
Mirauda,nemesis,1190,paladin,retribution,136,59,77
Hïto,dun-modr,1189,paladin,retribution,24,14,10
Morrpheus,darkspear,1188,paladin,retribution,24,14,10
Ararion,tarren-mill,1188,paladin,retribution,30,14,16
Блэквилл,howling-fjord,1188,paladin,retribution,155,71,84
Rondel,dalaran,1187,paladin,retribution,30,15,15
Spánkit,stormscale,1187,paladin,retribution,44,20,24
Michele,skullcrusher,1187,paladin,retribution,57,25,32
Lurbo,neptulon,1187,paladin,retribution,36,15,21
Bonvivant,ragnaros,1186,paladin,retribution,21,14,7
Baddibubble,argent-dawn,1186,paladin,retribution,34,19,15
Groelin,frostmane,1185,paladin,retribution,152,74,78
Whuarro,cthun,1185,paladin,retribution,42,14,28
Malodos,archimonde,1184,paladin,retribution,23,13,10
Mma,sylvanas,1184,paladin,retribution,97,47,50
Маефис,gordunni,1184,paladin,retribution,36,16,20
Palantyna,kazzak,1183,paladin,retribution,41,16,25
Nözderg,archimonde,1183,paladin,retribution,36,14,22
Perfectum,burning-legion,1182,paladin,retribution,28,13,15
Moløk,ysondre,1181,paladin,retribution,113,54,59
Bornir,khaz-modan,1181,paladin,retribution,89,40,49
Hàppy,malfurion,1180,paladin,retribution,35,14,21
Trainingdumy,aszune,1179,paladin,retribution,30,16,14
Geak,tarren-mill,1179,paladin,retribution,32,13,19
Conserva,jaedenar,1178,paladin,retribution,82,44,38
Ylvannka,blackmoore,1177,paladin,retribution,48,23,25
Nauriell,blackmoore,1176,paladin,retribution,24,16,8
Cigyal,hyjal,1176,paladin,retribution,86,45,41
Calìa,hyjal,1176,paladin,retribution,59,25,34
Daríon,silvermoon,1176,paladin,retribution,48,15,33
Teogrim,blackmoore,1175,paladin,retribution,84,44,40
Styrke,sanguino,1175,paladin,retribution,34,13,21
Zvirblis,chamber-of-aspects,1173,paladin,retribution,63,31,32
Flashyplays,silvermoon,1172,paladin,retribution,48,27,21
Markomir,frostmourne,1172,paladin,retribution,31,14,17
Каридин,galakrond,1172,paladin,retribution,42,13,29
Beefix,blackmoore,1171,paladin,retribution,36,21,15
Ilanyll,silvermoon,1171,paladin,retribution,30,16,14
Veshnu,blackrock,1170,paladin,retribution,162,78,84
Æternäl,arathor,1170,paladin,retribution,90,42,48
Servillo,outland,1170,paladin,retribution,60,23,37
Pelaghia,tarren-mill,1169,paladin,retribution,50,32,18
Valaudu,stormscale,1169,paladin,retribution,23,13,10
Epoke,archimonde,1169,paladin,retribution,96,46,50
Kurtjosef,draenor,1169,paladin,retribution,54,21,33
Janky,draenor,1169,paladin,retribution,54,20,34
Gredain,argent-dawn,1168,paladin,retribution,24,16,8
Vell,bronze-dragonflight,1168,paladin,retribution,23,13,10
Duris,drakthul,1167,paladin,retribution,30,15,15
Lumino,twilights-hammer,1167,paladin,retribution,59,26,33
Bellùm,archimonde,1166,paladin,retribution,68,38,30
Luridity,argent-dawn,1166,paladin,retribution,60,22,38
Sunsaiy,doomhammer,1165,paladin,retribution,152,81,71
Msammus,kazzak,1165,paladin,retribution,34,13,21
Holyreckonin,silvermoon,1164,paladin,retribution,197,98,99
Knoppix,antonidas,1164,paladin,retribution,48,19,29
Cpsuper,azuremyst,1163,paladin,retribution,36,20,16
Sertoli,frostwhisper,1163,paladin,retribution,54,26,28
Таурмакус,howling-fjord,1163,paladin,retribution,66,31,35
Orseis,anubarak,1163,paladin,retribution,100,43,57
Meljipson,kazzak,1163,paladin,retribution,52,13,39
Janie,dalaran,1162,paladin,retribution,41,23,18
Baldarlyset,tarren-mill,1162,paladin,retribution,51,17,34
Glarcouf,eldrethalas,1161,paladin,retribution,71,38,33
Holybubo,tarren-mill,1160,paladin,retribution,72,37,35
Runkpaladin,kazzak,1159,paladin,retribution,80,44,36
Askimo,twisting-nether,1159,paladin,retribution,24,13,11
Djpalacinka,drakthul,1159,paladin,retribution,48,21,27
Judgement,quelthalas,1158,paladin,retribution,30,20,10
Altrazel,archimonde,1158,paladin,retribution,32,15,17
Gryan,stormscale,1157,paladin,retribution,35,16,19
Сильвернайт,soulflayer,1157,paladin,retribution,47,15,32
Kaezerg,khaz-modan,1155,paladin,retribution,44,26,18
Järnkroken,tarren-mill,1154,paladin,retribution,31,19,12
Адептустер,gordunni,1154,paladin,retribution,56,27,29
Matuth,arthas,1154,paladin,retribution,56,19,37
Светлыйкит,blackscar,1153,paladin,retribution,84,41,43
Шаларион,borean-tundra,1153,paladin,retribution,39,14,25
Necorínex,silvermoon,1152,paladin,retribution,18,12,6
Kilô,sylvanas,1152,paladin,retribution,24,12,12
Noreturn,kazzak,1152,paladin,retribution,24,12,12
Bighugg,draenor,1152,paladin,retribution,30,12,18
Vorthir,khaz-modan,1151,paladin,retribution,32,16,16
Валандор,gordunni,1151,paladin,retribution,24,12,12
Tdchopa,ravencrest,1151,paladin,retribution,24,12,12
Fabsy,frostwolf,1151,paladin,retribution,24,12,12
Jaing,magtheridon,1151,paladin,retribution,24,12,12
Rizzdaddy,outland,1151,paladin,retribution,30,12,18
Бэкворд,soulflayer,1151,paladin,retribution,30,12,18
Jâuche,blackhand,1151,paladin,retribution,30,12,18
Memeadinxx,ravencrest,1151,paladin,retribution,30,12,18
Небестворлд,gordunni,1150,paladin,retribution,18,12,6
Holzkern,blackmoore,1150,paladin,retribution,24,12,12
Kelaiah,argent-dawn,1150,paladin,retribution,24,12,12
Navayo,frostmourne,1150,paladin,retribution,24,12,12
Herô,drakthul,1150,paladin,retribution,30,12,18
Knusern,dunemaul,1150,paladin,retribution,30,12,18
Missoii,khaz-modan,1149,paladin,retribution,18,12,6
Лайсен,gordunni,1149,paladin,retribution,42,22,20
Фантаззер,soulflayer,1149,paladin,retribution,24,12,12
Jkøø,sanguino,1149,paladin,retribution,24,12,12
Akakaboto,draenor,1149,paladin,retribution,54,25,29
Alersia,twisting-nether,1149,paladin,retribution,30,12,18
Redmoo,tarren-mill,1149,paladin,retribution,36,12,24
Lagrops,chants-éternels,1149,paladin,retribution,36,12,24
Mìssaahh,archimonde,1148,paladin,retribution,19,13,6
Даракар,deathguard,1148,paladin,retribution,18,12,6
Badjake,stormscale,1148,paladin,retribution,18,12,6
Spooder,xavius,1148,paladin,retribution,29,12,17
Шульц,borean-tundra,1148,paladin,retribution,30,12,18
Annurra,quelthalas,1148,paladin,retribution,36,12,24
Knockz,zuluhed,1148,paladin,retribution,42,13,29
Pressthere,tarren-mill,1147,paladin,retribution,21,13,8
Themlstake,kazzak,1147,paladin,retribution,30,18,12
Paidien,twisting-nether,1147,paladin,retribution,23,12,11
Parléxd,auchindoun,1147,paladin,retribution,24,12,12
Durnell,sylvanas,1147,paladin,retribution,24,12,12
Думклиф,gordunni,1147,paladin,retribution,36,12,24
Mythorpala,dun-modr,1147,paladin,retribution,36,12,24
Nebrii,doomhammer,1146,paladin,retribution,36,19,17
Dyöw,elune,1146,paladin,retribution,24,12,12
Lovexhate,archimonde,1146,paladin,retribution,24,12,12
Judgedude,stormscale,1146,paladin,retribution,24,12,12
Иродиада,gordunni,1146,paladin,retribution,30,12,18
Teefex,stormscale,1145,paladin,retribution,21,13,8
Thardran,ravencrest,1145,paladin,retribution,102,53,49
Bannedchild,drakthul,1144,paladin,retribution,22,13,9
Цабля,gordunni,1144,paladin,retribution,44,24,20
Kevinprime,malfurion,1144,paladin,retribution,30,14,16
Nwnwnwnwnwnw,blackrock,1144,paladin,retribution,48,19,29
Asgardietis,kazzak,1144,paladin,retribution,33,13,20
Стиивоо,gordunni,1143,paladin,retribution,18,12,6
Kawakii,outland,1143,paladin,retribution,30,16,14
Vetron,drakthul,1143,paladin,retribution,24,12,12
Woodygamer,chamber-of-aspects,1143,paladin,retribution,24,12,12
Eleiktra,suramar,1143,paladin,retribution,36,15,21
Aeyalana,ragnaros,1143,paladin,retribution,42,17,25
Sfantull,spinebreaker,1143,paladin,retribution,30,12,18
Xersys,draenor,1143,paladin,retribution,30,12,18
Maycel,hyjal,1143,paladin,retribution,33,13,20
Bigdamjudge,argent-dawn,1142,paladin,retribution,18,12,6
Fatique,twisting-nether,1142,paladin,retribution,120,62,58
Pupperz,defias-brotherhood,1141,paladin,retribution,24,12,12
Séntúrús,kazzak,1141,paladin,retribution,53,23,30
Eywinn,silvermoon,1141,paladin,retribution,30,12,18
Rinocerb,ravencrest,1141,paladin,retribution,36,12,24
Retrystyle,ragnaros,1140,paladin,retribution,83,41,42
Spanzer,dun-modr,1139,paladin,retribution,157,79,78
Snowlyi,stormscale,1139,paladin,retribution,30,12,18
Yúlía,ravencrest,1138,paladin,retribution,30,15,15
Solarouz,draenor,1138,paladin,retribution,83,41,42
Vymer,ravencrest,1138,paladin,retribution,29,14,15
Sànguinius,silvermoon,1138,paladin,retribution,36,12,24
Summachos,kul-tiras,1137,paladin,retribution,39,20,19
Coralinê,sanguino,1137,paladin,retribution,24,12,12
Самерваль,borean-tundra,1137,paladin,retribution,127,63,64
Whiffy,silvermoon,1137,paladin,retribution,66,26,40
Sickbolt,eredar,1136,paladin,retribution,124,60,64
Myradur,burning-legion,1136,paladin,retribution,83,39,44
Évert,twisting-nether,1135,paladin,retribution,18,12,6
Böb,garona,1135,paladin,retribution,60,28,32
Palitard,turalyon,1134,paladin,retribution,107,55,52
Хампал,howling-fjord,1134,paladin,retribution,29,12,17
Lightbreaker,alleria,1133,paladin,retribution,27,14,13
Pzdr,tarren-mill,1133,paladin,retribution,60,30,30
Dovel,kazzak,1133,paladin,retribution,24,12,12
Корсаро,deepholm,1133,paladin,retribution,113,54,59
Raptasenda,archimonde,1133,paladin,retribution,156,74,82
Iñgkara,tarren-mill,1133,paladin,retribution,35,13,22
Donttaskwhy,sylvanas,1133,paladin,retribution,48,17,31
Vrgingamer,kazzak,1133,paladin,retribution,60,21,39
Krïstâlùlz,archimonde,1132,paladin,retribution,64,33,31
Agelmar,zuluhed,1132,paladin,retribution,27,13,14
Kriteus,pozzo-delleternità,1131,paladin,retribution,18,12,6
Asshhbringer,burning-legion,1131,paladin,retribution,18,12,6
Kalaraja,dunemaul,1131,paladin,retribution,30,12,18
Mimkoo,wildhammer,1130,paladin,retribution,27,16,11
Goldmamax,stormscale,1130,paladin,retribution,24,13,11
Atreyu,stormscale,1130,paladin,retribution,30,16,14
Flòope,destromath,1130,paladin,retribution,72,37,35
Asthellis,kazzak,1130,paladin,retribution,90,41,49
Rady,neptulon,1130,paladin,retribution,38,17,21
Гервалт,blackscar,1128,paladin,retribution,30,12,18
Messîah,outland,1127,paladin,retribution,266,135,131
Azlan,nagrand,1127,paladin,retribution,46,23,23
Palahôlika,antonidas,1127,paladin,retribution,24,12,12
Whoopzie,stormscale,1127,paladin,retribution,58,25,33
Arndt,lightbringer,1126,paladin,retribution,46,14,32
Liléa,hyjal,1125,paladin,retribution,34,13,21
Bulle,the-venture-co,1125,paladin,retribution,41,15,26
Цитри,borean-tundra,1123,paladin,retribution,36,22,14
Duralyon,marécage-de-zangar,1123,paladin,retribution,48,23,25
Notholy,defias-brotherhood,1123,paladin,retribution,30,14,16
Neytana,blackmoore,1123,paladin,retribution,98,45,53
Thærõck,thrall,1123,paladin,retribution,36,13,23
Пропала,greymane,1122,paladin,retribution,119,56,63
Сенторин,borean-tundra,1122,paladin,retribution,39,14,25
Buckfizz,ysondre,1121,paladin,retribution,36,22,14
Palladinz,ravencrest,1121,paladin,retribution,36,19,17
Äalith,arathor,1120,paladin,retribution,24,13,11
Kirkmeister,terokkar,1120,paladin,retribution,55,24,31
Âchîle,garona,1119,paladin,retribution,110,61,49
Joti,proudmoore,1119,paladin,retribution,30,12,18
Notorious,antonidas,1118,paladin,retribution,24,12,12
Nollieflipx,tarren-mill,1118,paladin,retribution,29,12,17
Vallorum,ravencrest,1118,paladin,retribution,47,14,33
Spóntaneous,ravencrest,1116,paladin,retribution,26,13,13
Òlymp,blackhand,1116,paladin,retribution,24,12,12
Judgearnold,kul-tiras,1116,paladin,retribution,30,12,18
Fremuduin,argent-dawn,1114,paladin,retribution,24,12,12
Goungokuhrbo,doomhammer,1112,paladin,retribution,52,31,21
Gnarlds,doomhammer,1112,paladin,retribution,48,28,20
Babarush,nozdormu,1111,paladin,retribution,30,13,17
Valentianus,ravencrest,1110,paladin,retribution,24,12,12
Immortalkrux,archimonde,1110,paladin,retribution,157,74,83
Fumatelo,tyrande,1108,paladin,retribution,79,47,32
Палуф,deathguard,1108,paladin,retribution,24,12,12
Сверхпаладин,howling-fjord,1104,paladin,retribution,24,15,9
Helloim,tarren-mill,1104,paladin,retribution,21,13,8
Konst,argent-dawn,1104,paladin,retribution,57,28,29
Pery,malganis,1103,paladin,retribution,86,45,41
Ayba,defias-brotherhood,1103,paladin,retribution,95,47,48
Фокспро,lich-king,1103,paladin,retribution,29,13,16
Raê,hyjal,1103,paladin,retribution,139,60,79
Palädörette,dalaran,1102,paladin,retribution,66,39,27
Neuverse,tarren-mill,1100,paladin,retribution,59,29,30
Javalie,sanguino,1099,paladin,retribution,21,12,9
Akeemys,ragnaros,1099,paladin,retribution,23,12,11
Paxillustral,twisting-nether,1098,paladin,retribution,36,20,16
Quoque,turalyon,1098,paladin,retribution,69,37,32
Beastyblodne,sylvanas,1098,paladin,retribution,54,25,29
Eldelapala,zuljin,1098,paladin,retribution,60,27,33
Xflye,khaz-modan,1096,paladin,retribution,41,22,19
Ashreaver,burning-legion,1096,paladin,retribution,36,17,19
Toshvarak,turalyon,1096,paladin,retribution,94,43,51
Dronora,silvermoon,1096,paladin,retribution,60,22,38
Rêmo,blackrock,1094,paladin,retribution,76,43,33
Dewios,silvermoon,1094,paladin,retribution,67,31,36
Durwin,mazrigos,1094,paladin,retribution,98,41,57
Tharis,burning-legion,1093,paladin,retribution,23,13,10
Torím,draenor,1092,paladin,retribution,23,12,11
Paladie,dalaran,1091,paladin,retribution,328,168,160
Paladson,burning-blade,1089,paladin,retribution,97,39,58
Lliissaa,kazzak,1087,paladin,retribution,72,41,31
Aistor,burning-legion,1086,paladin,retribution,84,34,50
Emlo,thrall,1085,paladin,retribution,20,12,8
Atírpákja,doomhammer,1085,paladin,retribution,78,38,40
Azzael,thrall,1085,paladin,retribution,95,35,60
Arhu,stormscale,1084,paladin,retribution,67,37,30
Apoffis,burning-legion,1084,paladin,retribution,53,28,25
Fexulï,outland,1083,paladin,retribution,16,12,4
Thehuish,blades-edge,1083,paladin,retribution,59,29,30
Rivela,bloodhoof,1083,paladin,retribution,37,17,20
Pàlàthor,khaz-modan,1082,paladin,retribution,42,24,18
Valgar,ragnaros,1081,paladin,retribution,17,12,5
Donfilippo,burning-legion,1081,paladin,retribution,36,16,20
Aerathil,nethersturm,1079,paladin,retribution,41,22,19
Nisepise,argent-dawn,1078,paladin,retribution,68,31,37
Crazypits,silvermoon,1077,paladin,retribution,54,26,28
Tressah,silvermoon,1077,paladin,retribution,156,74,82
Cattelsaan,hyjal,1076,paladin,retribution,27,12,15
Zemoss,kazzak,1075,paladin,retribution,40,22,18
Ghostfacê,khaz-modan,1074,paladin,retribution,48,22,26
Coelslaw,azjolnerub,1074,paladin,retribution,35,12,23
Келлен,gordunni,1073,paladin,retribution,41,23,18
Danneris,sanguino,1073,paladin,retribution,95,50,45
Starstríder,aszune,1073,paladin,retribution,24,12,12
Aryabarzan,draenor,1073,paladin,retribution,74,29,45
Amoxapine,hyjal,1071,paladin,retribution,142,61,81
Pepsimaxpvp,blackmoore,1071,paladin,retribution,31,12,19
Êxood,archimonde,1071,paladin,retribution,47,18,29
Modf,draenor,1070,paladin,retribution,51,29,22
Evilerpaly,stormscale,1069,paladin,retribution,75,43,32
Morhgain,kazzak,1069,paladin,retribution,60,32,28
Leilak,draenor,1068,paladin,retribution,95,53,42
Hazeman,colinas-pardas,1067,paladin,retribution,18,14,4
Dabstar,antonidas,1066,paladin,retribution,30,14,16
Crynó,blackmoore,1065,paladin,retribution,42,20,22
Bryllks,die-todeskrallen,1063,paladin,retribution,208,110,98
Аркрум,gordunni,1063,paladin,retribution,57,22,35
Antidrasi,turalyon,1062,paladin,retribution,75,30,45
Bàroo,twisting-nether,1061,paladin,retribution,118,46,72
Bandaga,sanguino,1060,paladin,retribution,20,13,7
Lytza,frostwolf,1059,paladin,retribution,30,15,15
Dekabik,tarren-mill,1059,paladin,retribution,78,29,49
Gerannan,kirin-tor,1058,paladin,retribution,96,49,47
Lightpal,dentarg,1058,paladin,retribution,40,20,20
Chidorengan,burning-legion,1057,paladin,retribution,42,21,21
Бунча,gordunni,1057,paladin,retribution,138,63,75
Sølitude,kazzak,1056,paladin,retribution,18,11,7
Camusax,kazzak,1056,paladin,retribution,18,11,7
Injustice,chamber-of-aspects,1056,paladin,retribution,55,27,28
Сакон,borean-tundra,1056,paladin,retribution,24,11,13
Lightham,nemesis,1056,paladin,retribution,24,11,13
Franzîskûs,blackmoore,1056,paladin,retribution,24,11,13
Pia,twisting-nether,1056,paladin,retribution,24,11,13
Lindrone,aggra-português,1056,paladin,retribution,30,11,19
Dadyolimp,kazzak,1056,paladin,retribution,30,11,19
Blindhoj,ravencrest,1055,paladin,retribution,18,11,7
Eléndrên,blackrock,1055,paladin,retribution,18,11,7
Starkgaryen,dun-modr,1055,paladin,retribution,18,11,7
Dje,taerar,1055,paladin,retribution,18,11,7
Neqt,ravencrest,1055,paladin,retribution,24,11,13
Tyranius,bronzebeard,1055,paladin,retribution,24,11,13
Takezop,dun-modr,1055,paladin,retribution,24,11,13
Palandiade,draenor,1055,paladin,retribution,24,11,13
Stukker,silvermoon,1055,paladin,retribution,24,11,13
Kalimgor,theradras,1055,paladin,retribution,24,11,13
Mîakhalîfa,tarren-mill,1055,paladin,retribution,24,11,13
Dafe,zuluhed,1055,paladin,retribution,56,22,34
Vazayo,ravencrest,1055,paladin,retribution,30,11,19
Ranelly,blackmoore,1055,paladin,retribution,30,11,19
Âtom,outland,1055,paladin,retribution,36,11,25
Tylaerion,magtheridon,1054,paladin,retribution,18,11,7
Покаяние,howling-fjord,1054,paladin,retribution,18,11,7
Negash,archimonde,1054,paladin,retribution,18,11,7
Диндинь,howling-fjord,1054,paladin,retribution,24,11,13
Palidos,blackrock,1054,paladin,retribution,24,11,13
Hazura,blackmoore,1054,paladin,retribution,30,11,19
Fleckige,nethersturm,1054,paladin,retribution,30,11,19
Lancelotas,defias-brotherhood,1054,paladin,retribution,30,11,19
Cheesus,argent-dawn,1054,paladin,retribution,33,12,21
Хэймердингер,howling-fjord,1054,paladin,retribution,39,12,27
Vendil,tarren-mill,1053,paladin,retribution,18,11,7
Moarcry,outland,1053,paladin,retribution,24,11,13
Tikkiraj,guldan,1053,paladin,retribution,24,11,13
Defeero,das-syndikat,1053,paladin,retribution,24,11,13
Trollilolz,eredar,1053,paladin,retribution,24,11,13
Deceneü,kazzak,1053,paladin,retribution,24,11,13
Mickeyvorace,archimonde,1053,paladin,retribution,66,30,36
Óldgreg,magtheridon,1053,paladin,retribution,30,12,18
Giggs,turalyon,1052,paladin,retribution,16,12,4
Mcnnuggets,ravencrest,1052,paladin,retribution,18,11,7
Duragon,khaz-modan,1052,paladin,retribution,55,27,28
Kÿsse,hyjal,1052,paladin,retribution,24,11,13
Souzzi,kazzak,1052,paladin,retribution,24,11,13
Lelight,ravencrest,1051,paladin,retribution,18,11,7
Liliane,eitrigg,1051,paladin,retribution,18,11,7
Watermans,azjolnerub,1051,paladin,retribution,18,11,7
Widj,silvermoon,1051,paladin,retribution,24,11,13
Uoloop,kazzak,1051,paladin,retribution,48,21,27
Омникнайтх,howling-fjord,1051,paladin,retribution,36,11,25
Ratedge,hyjal,1050,paladin,retribution,18,11,7
Buldras,zuljin,1050,paladin,retribution,18,11,7
Voyén,tarren-mill,1050,paladin,retribution,18,11,7
Люфтер,gordunni,1050,paladin,retribution,35,18,17
Pallachyrk,kazzak,1050,paladin,retribution,24,11,13
Angelynor,ysondre,1050,paladin,retribution,24,11,13
Jøløz,hyjal,1050,paladin,retribution,24,11,13
Fettàrm,blackrock,1050,paladin,retribution,24,11,13
Palamanyaka,kazzak,1050,paladin,retribution,24,11,13
Oepabakkez,burning-legion,1050,paladin,retribution,24,11,13
Gabe,aggra-português,1050,paladin,retribution,27,12,15
Plato,arthas,1049,paladin,retribution,30,16,14
Holytrol,kazzak,1049,paladin,retribution,90,41,49
Grundgron,burning-legion,1049,paladin,retribution,57,25,32
Freetimer,norgannon,1049,paladin,retribution,30,11,19
Justïce,twisting-nether,1049,paladin,retribution,30,11,19
Malleius,ravencrest,1049,paladin,retribution,30,11,19
Trondalohr,ambossar,1048,paladin,retribution,24,14,10
Rdmhrvojehr,tarren-mill,1048,paladin,retribution,43,22,21
Dadpally,shattered-hand,1048,paladin,retribution,114,56,58
Torhamiir,outland,1048,paladin,retribution,24,11,13
Huhuu,outland,1048,paladin,retribution,24,11,13
Masgan,eredar,1048,paladin,retribution,24,11,13
Cliffordd,doomhammer,1048,paladin,retribution,51,20,31
Gropleindsup,ysondre,1048,paladin,retribution,54,21,33
Yournoboddy,turalyon,1048,paladin,retribution,30,11,19
Vonryan,defias-brotherhood,1047,paladin,retribution,115,53,62
Merliphel,burning-legion,1046,paladin,retribution,24,11,13
Timesover,doomhammer,1046,paladin,retribution,42,19,23
Hargo,ravencrest,1046,paladin,retribution,27,12,15
Calluk,turalyon,1046,paladin,retribution,47,18,29
Бомберович,howling-fjord,1046,paladin,retribution,36,11,25
Håmmer,hellfire,1045,paladin,retribution,18,11,7
Saszca,burning-legion,1045,paladin,retribution,21,12,9
Jpally,ravencrest,1045,paladin,retribution,24,11,13
Fannii,ravencrest,1045,paladin,retribution,33,15,18
Kishijoten,archimonde,1044,paladin,retribution,18,11,7
Jooki,drakthul,1044,paladin,retribution,18,11,7
Palladxx,twilights-hammer,1044,paladin,retribution,40,24,16
Traqnbilkarq,stormscale,1044,paladin,retribution,24,12,12
Мраскор,howling-fjord,1044,paladin,retribution,30,12,18
Sprited,twisting-nether,1044,paladin,retribution,30,11,19
Atrexie,lightbringer,1043,paladin,retribution,18,11,7
Aégon,archimonde,1043,paladin,retribution,109,51,58
Mjoky,the-maelstrom,1043,paladin,retribution,24,11,13
Himmelsfuror,proudmoore,1043,paladin,retribution,36,11,25
Rocaviva,sanguino,1042,paladin,retribution,24,12,12
Täntra,cthun,1042,paladin,retribution,43,19,24
Shadderkpal,draenor,1042,paladin,retribution,30,11,19
Dildotbagins,argent-dawn,1041,paladin,retribution,70,40,30
Даркхолмь,howling-fjord,1040,paladin,retribution,22,12,10
Summuno,eredar,1040,paladin,retribution,209,90,119
Palazs,ravencrest,1039,paladin,retribution,24,15,9
Sinalia,shattrath,1039,paladin,retribution,24,11,13
Matikosik,steamwheedle-cartel,1039,paladin,retribution,51,21,30
Kaatha,archimonde,1039,paladin,retribution,77,27,50
Izrak,stormscale,1038,paladin,retribution,24,15,9
Hatrius,ravencrest,1038,paladin,retribution,18,11,7
Meliodas,alleria,1038,paladin,retribution,60,30,30
Killa,stormrage,1038,paladin,retribution,24,11,13
Kollak,dun-modr,1038,paladin,retribution,63,25,38
Labier,tarren-mill,1038,paladin,retribution,36,11,25
Fortplus,pozzo-delleternità,1037,paladin,retribution,58,28,30
Wingzodoom,turalyon,1037,paladin,retribution,30,11,19
Lowen,deathwing,1037,paladin,retribution,41,11,30
Tydrix,magtheridon,1036,paladin,retribution,18,11,7
Эллессар,howling-fjord,1036,paladin,retribution,30,12,18
Denathar,draenor,1036,paladin,retribution,36,12,24
Celdrin,silvermoon,1035,paladin,retribution,23,12,11
Ananasdaq,silvermoon,1034,paladin,retribution,18,11,7
Taomeba,runetotem,1033,paladin,retribution,27,14,13
Auxiliary,doomhammer,1031,paladin,retribution,46,28,18
Gôdfâthér,kazzak,1031,paladin,retribution,23,11,12
Glotzkowski,kelthuzad,1031,paladin,retribution,48,21,27
Шелволк,eversong,1030,paladin,retribution,27,14,13
Rileys,turalyon,1029,paladin,retribution,174,80,94
Zanathos,onyxia,1027,paladin,retribution,66,38,28
Vardin,sanguino,1027,paladin,retribution,24,11,13
Gundahar,das-syndikat,1026,paladin,retribution,82,45,37
Drizuc,bloodhoof,1026,paladin,retribution,72,22,50
Khveasir,argent-dawn,1026,paladin,retribution,36,11,25
Pallido,exodar,1025,paladin,retribution,39,21,18
Царьзверей,fordragon,1025,paladin,retribution,24,11,13
Лютыйчпок,fordragon,1025,paladin,retribution,148,64,84
Makiwara,emeriss,1024,paladin,retribution,208,99,109
Hateless,tarren-mill,1024,paladin,retribution,28,11,17
Умберто,howling-fjord,1022,paladin,retribution,54,30,24
Zelphyr,pozzo-delleternità,1021,paladin,retribution,87,46,41
Sandorr,area-52,1021,paladin,retribution,36,18,18
Góò,frostmane,1021,paladin,retribution,26,12,14
Mhorcain,silvermoon,1020,paladin,retribution,36,17,19
Гермесиус,deepholm,1020,paladin,retribution,108,47,61
Aelthir,kazzak,1019,paladin,retribution,25,13,12
Антисеептик,gordunni,1019,paladin,retribution,92,41,51
Stefàn,sylvanas,1017,paladin,retribution,26,12,14
Jesophar,archimonde,1017,paladin,retribution,36,15,21
Mikipaki,tarren-mill,1016,paladin,retribution,29,11,18
Quasimotto,turalyon,1014,paladin,retribution,36,13,23
Mechoka,auchindoun,1013,paladin,retribution,25,14,11
Käylä,silvermoon,1013,paladin,retribution,24,11,13
Vibeer,ravencrest,1011,paladin,retribution,146,75,71
Omixlis,ragnaros,1010,paladin,retribution,36,14,22
Derbrècher,azshara,1009,paladin,retribution,40,20,20
Neftys,aegwynn,1009,paladin,retribution,48,20,28
Хйуго,soulflayer,1008,paladin,retribution,27,16,11
Макстипчик,howling-fjord,1008,paladin,retribution,21,12,9
Ункаль,ashenvale,1008,paladin,retribution,229,110,119
Kaioss,argent-dawn,1008,paladin,retribution,29,11,18
Bomsamdi,draenor,1007,paladin,retribution,85,37,48
Leifleur,silvermoon,1006,paladin,retribution,51,21,30
Коклюш,ashenvale,1004,paladin,retribution,30,14,16
Moodypala,doomhammer,1003,paladin,retribution,24,15,9
Thuurs,nerathor,1003,paladin,retribution,27,13,14
Flyingsnow,dunemaul,1003,paladin,retribution,36,12,24
Phaenre,pozzo-delleternità,1002,paladin,retribution,76,35,41
Харт,fordragon,1001,paladin,retribution,21,15,6
Монбиин,soulflayer,1001,paladin,retribution,24,12,12
Melissasee,wrathbringer,1001,paladin,retribution,42,19,23
Sheïkka,hyjal,1001,paladin,retribution,68,30,38
Samail,malganis,1001,paladin,retribution,94,40,54
Loire,blackmoore,1000,paladin,retribution,17,11,6
Nizo,uldum,1000,paladin,retribution,30,15,15
Asclepïos,sanguino,998,paladin,retribution,18,12,6
Killtauren,kazzak,998,paladin,retribution,132,63,69
Crazybones,marécage-de-zangar,998,paladin,retribution,53,22,31
Briggybomb,outland,998,paladin,retribution,37,15,22
Legiønr,ravencrest,997,paladin,retribution,18,11,7
Эксвайп,howling-fjord,997,paladin,retribution,23,11,12
Dathea,aegwynn,997,paladin,retribution,97,38,59
Refjâsk,drekthar,994,paladin,retribution,50,13,37
Актевс,grom,993,paladin,retribution,48,27,21
Meneth,elune,993,paladin,retribution,166,73,93
Eltruite,archimonde,991,paladin,retribution,66,29,37
Virusee,doomhammer,990,paladin,retribution,23,12,11
Deworld,tarren-mill,988,paladin,retribution,20,11,9
Titteii,tarren-mill,988,paladin,retribution,20,11,9
Sinthoràs,shattered-hand,988,paladin,retribution,60,30,30
Avgudaren,draenor,988,paladin,retribution,26,11,15
Zerohour,kilrogg,987,paladin,retribution,34,11,23
Legâin,twisting-nether,987,paladin,retribution,48,11,37
Mckellen,antonidas,986,paladin,retribution,21,12,9
Jenyu,sanguino,986,paladin,retribution,29,13,16
Milisha,the-maelstrom,985,paladin,retribution,38,12,26
Âgreë,frostwhisper,984,paladin,retribution,32,11,21
Arathorin,ravencrest,983,paladin,retribution,36,17,19
Pörriäinen,ragnaros,983,paladin,retribution,26,11,15
Kealen,nemesis,982,paladin,retribution,91,36,55
Palakag,blackhand,982,paladin,retribution,77,25,52
Titoturixd,dun-modr,981,paladin,retribution,17,11,6
Klikas,twisting-nether,981,paladin,retribution,60,32,28
Схемас,gordunni,981,paladin,retribution,48,22,26
Kauto,aggra-português,981,paladin,retribution,48,19,29
Твилайд,gordunni,976,paladin,retribution,24,12,12
Dràgón,dethecus,976,paladin,retribution,31,11,20
Диканс,ashenvale,975,paladin,retribution,23,11,12
Светлаясторо,gordunni,974,paladin,retribution,31,11,20
Nazaninez,tarren-mill,973,paladin,retribution,72,35,37
Танси,fordragon,972,paladin,retribution,38,22,16
Noforgivenes,kazzak,972,paladin,retribution,22,11,11
Conviction,silvermoon,972,paladin,retribution,69,34,35
Имраил,gordunni,972,paladin,retribution,48,17,31
Supou,twisting-nether,970,paladin,retribution,33,18,15
Antrapo,khaz-modan,970,paladin,retribution,42,15,27
Tyirel,blackmoore,968,paladin,retribution,89,36,53
Bellatthrix,draenor,965,paladin,retribution,33,14,19
Snaty,khaz-modan,963,paladin,retribution,157,78,79
Roklim,blackhand,960,paladin,retribution,18,10,8
Abukasol,kazzak,960,paladin,retribution,18,10,8
Teamchelsey,outland,960,paladin,retribution,18,10,8
Heldarim,ysondre,960,paladin,retribution,18,10,8
Blazerlolz,kazzak,960,paladin,retribution,18,10,8
Serberen,ravencrest,960,paladin,retribution,24,10,14
Smithx,kazzak,960,paladin,retribution,24,10,14
Kanollaras,tarren-mill,960,paladin,retribution,24,10,14
Artaxiad,sylvanas,960,paladin,retribution,24,10,14
Sucsii,outland,960,paladin,retribution,24,10,14
Cheerrios,arathor,960,paladin,retribution,24,10,14
Kaarsius,defias-brotherhood,960,paladin,retribution,24,10,14
Атласс,gordunni,960,paladin,retribution,30,10,20
Садистка,soulflayer,960,paladin,retribution,30,10,20
Saulencio,zuljin,960,paladin,retribution,36,10,26
Ðoømhammer,kazzak,960,paladin,retribution,42,10,32
Zenfuki,draenor,959,paladin,retribution,15,11,4
Bunurata,silvermoon,959,paladin,retribution,18,10,8
Âkäshi,khaz-modan,959,paladin,retribution,18,10,8
Kamî,sanguino,959,paladin,retribution,18,10,8
Vindicatê,stormscale,959,paladin,retribution,18,10,8
Daizen,blackrock,959,paladin,retribution,18,10,8
Makakí,twisting-nether,959,paladin,retribution,18,10,8
Hesitated,kazzak,959,paladin,retribution,18,10,8
Sweyz,archimonde,959,paladin,retribution,18,10,8
Chocòbon,archimonde,959,paladin,retribution,18,10,8
Davè,blackmoore,959,paladin,retribution,18,10,8
Kilogosa,frostmane,959,paladin,retribution,18,10,8
Sashä,tarren-mill,959,paladin,retribution,18,10,8
Базапал,fordragon,959,paladin,retribution,18,10,8
Zacharis,drakthul,959,paladin,retribution,18,10,8
Xoriun,norgannon,959,paladin,retribution,18,10,8
Ragnàr,aggra-português,959,paladin,retribution,120,60,60
Palamauka,kazzak,959,paladin,retribution,24,10,14
Milkzaddy,kazzak,959,paladin,retribution,24,10,14
Croptol,dun-modr,959,paladin,retribution,24,10,14
Thaddios,burning-blade,959,paladin,retribution,24,10,14
Dohmoo,kazzak,959,paladin,retribution,24,10,14
Dàk,grim-batol,959,paladin,retribution,24,10,14
Rushtank,dragonmaw,959,paladin,retribution,24,10,14
Mullinsilmä,stormreaver,959,paladin,retribution,24,10,14
Valarïs,outland,959,paladin,retribution,30,10,20
Teshkipowa,kazzak,959,paladin,retribution,30,10,20
Джейкл,gordunni,959,paladin,retribution,36,10,26
Violetex,blackmoore,958,paladin,retribution,12,10,2
Valanysa,blackmoore,958,paladin,retribution,18,10,8
Líghtmare,sylvanas,958,paladin,retribution,18,10,8
Arcardi,dun-morogh,958,paladin,retribution,18,10,8
Søal,blackrock,958,paladin,retribution,18,10,8
Shailwo,ysondre,958,paladin,retribution,18,10,8
Funshinè,thrall,958,paladin,retribution,18,10,8
Béhèlit,sargeras,958,paladin,retribution,18,10,8
Sheldon,sylvanas,958,paladin,retribution,18,10,8
Bobshock,twisting-nether,958,paladin,retribution,18,10,8
Faiella,argent-dawn,958,paladin,retribution,18,10,8
Myû,die-aldor,958,paladin,retribution,18,10,8
Леаркус,blackscar,958,paladin,retribution,24,10,14
Skinriper,stormscale,958,paladin,retribution,24,10,14
Mudan,stormscale,958,paladin,retribution,24,10,14
Harnêlia,marécage-de-zangar,958,paladin,retribution,95,34,61
Axone,ravencrest,958,paladin,retribution,30,10,20
Retdemption,ravencrest,957,paladin,retribution,18,10,8
Dimdon,silvermoon,957,paladin,retribution,24,10,14
Ligthe,archimonde,957,paladin,retribution,24,10,14
Winterwall,sylvanas,957,paladin,retribution,24,10,14
Добегуубью,thermaplugg,957,paladin,retribution,27,11,16
Septèmber,draenor,957,paladin,retribution,30,10,20
Feenux,drakthul,956,paladin,retribution,16,11,5
Dagôn,sanguino,956,paladin,retribution,18,10,8
Selerin,draenor,956,paladin,retribution,18,10,8
Wingz,trollbane,956,paladin,retribution,18,10,8
Ëhra,hyjal,956,paladin,retribution,18,10,8
Ayoub,argent-dawn,956,paladin,retribution,18,10,8
Nydilol,sylvanas,956,paladin,retribution,18,10,8
Almohalhil,tarren-mill,956,paladin,retribution,54,28,26
Szaporító,ragnaros,956,paladin,retribution,24,10,14
Mugraine,ravencrest,956,paladin,retribution,24,10,14
Tykki,stormreaver,956,paladin,retribution,27,10,17
Unrealight,blackrock,956,paladin,retribution,36,10,26
Shemoistdoe,tarren-mill,955,paladin,retribution,16,11,5
Enkir,sanguino,955,paladin,retribution,18,10,8
Løøktår,ysondre,955,paladin,retribution,18,10,8
Sneptica,draenor,955,paladin,retribution,19,10,9
Ббормотуха,thermaplugg,955,paladin,retribution,24,10,14
Pappipala,tarren-mill,955,paladin,retribution,24,10,14
Dasvidania,uldum,955,paladin,retribution,30,11,19
Kayle,khaz-modan,954,paladin,retribution,18,10,8
Phlakorn,blackhand,954,paladin,retribution,24,10,14
Vicirius,doomhammer,954,paladin,retribution,24,10,14
Paladikt,teldrassil,954,paladin,retribution,24,10,14
Schoolbus,blackrock,954,paladin,retribution,24,10,14
Yoggbaton,tarren-mill,954,paladin,retribution,36,10,26
Velóx,eredar,953,paladin,retribution,12,10,2
Roostei,shattered-hand,953,paladin,retribution,18,10,8
Palatarlouze,khaz-modan,952,paladin,retribution,24,10,14
Immortality,outland,952,paladin,retribution,27,11,16
Xrules,blackhand,952,paladin,retribution,61,23,38
Бронепоест,gordunni,951,paladin,retribution,12,10,2
Buddy,conseil-des-ombres,951,paladin,retribution,21,11,10
Nenenita,cthun,951,paladin,retribution,243,118,125
Kreathor,eredar,951,paladin,retribution,54,23,31
Inquîsîtor,bronze-dragonflight,951,paladin,retribution,24,10,14
Grynd,blackmoore,949,paladin,retribution,12,10,2
Gottfrid,sunstrider,949,paladin,retribution,18,10,8
Cáli,forscherliga,949,paladin,retribution,18,10,8
Mettã,hyjal,949,paladin,retribution,104,39,65
Aïzo,archimonde,948,paladin,retribution,30,13,17
Lighttitan,ravencrest,948,paladin,retribution,24,10,14
Xemoth,kazzak,947,paladin,retribution,18,10,8
Vuzetevacabo,doomhammer,947,paladin,retribution,301,149,152
Tomales,aggramar,944,paladin,retribution,75,36,39
Космонафт,howling-fjord,943,paladin,retribution,30,10,20
Sessian,bronze-dragonflight,942,paladin,retribution,82,42,40
Nitay,blades-edge,942,paladin,retribution,34,10,24
Thòòr,blackmoore,940,paladin,retribution,18,10,8
Vuuduux,twisting-nether,940,paladin,retribution,18,10,8
Лонса,soulflayer,940,paladin,retribution,29,10,19
Gathalia,blackhand,939,paladin,retribution,24,14,10
Bafbaf,arathi,939,paladin,retribution,71,22,49
Святойбас,gordunni,936,paladin,retribution,18,10,8
Stêx,anubarak,936,paladin,retribution,18,10,8
Moriex,drakthul,936,paladin,retribution,30,10,20
Nicopala,khaz-modan,934,paladin,retribution,42,20,22
Cydor,khaz-modan,934,paladin,retribution,54,20,34
Tirifal,voljin,933,paladin,retribution,18,10,8
Bugo,drakthul,933,paladin,retribution,23,10,13
Benø,malganis,933,paladin,retribution,30,10,20
Opgezwolle,draenor,932,paladin,retribution,91,47,44
Ruffus,magtheridon,931,paladin,retribution,18,11,7
Varreran,argent-dawn,931,paladin,retribution,30,12,18
Quantox,frostwolf,930,paladin,retribution,42,21,21
Choppychop,defias-brotherhood,930,paladin,retribution,42,15,27
Haquiles,shendralar,929,paladin,retribution,68,31,37
Wolya,blackrock,927,paladin,retribution,21,11,10
Ghéttørèt,das-konsortium,927,paladin,retribution,26,11,15
Healmacan,thrall,926,paladin,retribution,17,10,7
Josuaa,ragnaros,924,paladin,retribution,110,51,59
Lightblaze,doomhammer,924,paladin,retribution,60,21,39
Eatfasteatas,doomhammer,923,paladin,retribution,12,10,2
Kabusmassey,outland,923,paladin,retribution,16,10,6
Моррдочка,soulflayer,921,paladin,retribution,72,31,41
Леруся,eversong,921,paladin,retribution,87,28,59
Zingler,norgannon,920,paladin,retribution,30,16,14
Atacan,twisting-nether,920,paladin,retribution,48,23,25
Ressler,tichondrius,919,paladin,retribution,27,12,15
Methynox,khaz-modan,915,paladin,retribution,30,12,18
Azherok,archimonde,912,paladin,retribution,24,13,11
Tiæ,archimonde,911,paladin,retribution,17,10,7
Snakedubaby,blackrock,910,paladin,retribution,41,10,31
Vexxus,blackrock,909,paladin,retribution,60,29,31
Шестьводных,galakrond,909,paladin,retribution,50,15,35
Platronix,aegwynn,906,paladin,retribution,21,11,10
Milicos,sylvanas,906,paladin,retribution,108,55,53
Tsopunisherr,ravencrest,904,paladin,retribution,29,11,18
Hurrier,outland,902,paladin,retribution,27,11,16
Lieris,twisting-nether,901,paladin,retribution,20,11,9
Thiccfreak,tarren-mill,901,paladin,retribution,48,23,25
Dreadadin,silvermoon,900,paladin,retribution,34,15,19
Ârthâstrâs,terrordar,899,paladin,retribution,78,38,40
Patzi,die-todeskrallen,897,paladin,retribution,109,52,57
Benkenoah,ragnaros,897,paladin,retribution,78,34,44
Gurutze,ragnaros,896,paladin,retribution,16,10,6
Óoc,outland,895,paladin,retribution,17,10,7
Krisbull,kazzak,895,paladin,retribution,22,10,12
Tigerherz,antonidas,895,paladin,retribution,28,10,18
Dunarella,chogall,894,paladin,retribution,24,12,12
Lolladin,blackmoore,894,paladin,retribution,26,10,16
Meýra,aegwynn,893,paladin,retribution,20,10,10
Ordain,senjin,891,paladin,retribution,92,47,45
Scrambler,grim-batol,890,paladin,retribution,26,10,16
Luxor,sporeggar,888,paladin,retribution,39,20,19
Tánk,twilights-hammer,888,paladin,retribution,48,22,26
Romkaq,silvermoon,884,paladin,retribution,18,11,7
Рэдиенс,howling-fjord,878,paladin,retribution,13,10,3
Windwings,drakthul,878,paladin,retribution,19,10,9
Celébriel,twisting-nether,877,paladin,retribution,19,10,9
Fardahr,ravencrest,877,paladin,retribution,24,10,14
Nomeel,twisting-nether,871,paladin,retribution,359,176,183
Ressurection,outland,869,paladin,retribution,182,85,97
Aludra,twisting-nether,868,paladin,retribution,136,71,65
Chocodin,drakthul,864,paladin,retribution,12,9,3
Greymagic,argent-dawn,864,paladin,retribution,12,9,3
Îs,draenor,864,paladin,retribution,12,9,3
Kuski,stormreaver,864,paladin,retribution,12,9,3
Ранрика,blackscar,864,paladin,retribution,12,9,3
Preamx,blackrock,864,paladin,retribution,12,9,3
Milowalens,ravencrest,864,paladin,retribution,12,9,3
Holysnickers,tarren-mill,864,paladin,retribution,12,9,3
Camusa,kazzak,864,paladin,retribution,12,9,3
Subzie,archimonde,864,paladin,retribution,12,9,3
Joeybananaa,blackhand,864,paladin,retribution,12,9,3
Kìngeh,tarren-mill,864,paladin,retribution,12,9,3
Фэнон,gordunni,864,paladin,retribution,12,9,3
Reckonin,nagrand,864,paladin,retribution,18,9,9
Skycraft,kazzak,864,paladin,retribution,18,9,9
Ollepala,draenor,864,paladin,retribution,18,9,9
Pesterci,draenor,864,paladin,retribution,18,9,9
Ilpreside,nemesis,864,paladin,retribution,18,9,9
Palahuakbar,sylvanas,864,paladin,retribution,18,9,9
Extasey,ravencrest,864,paladin,retribution,18,9,9
Retgodx,eredar,864,paladin,retribution,18,9,9
Andriâ,blackhand,864,paladin,retribution,18,9,9
Divinemove,stormscale,864,paladin,retribution,18,9,9
Punlac,draenor,864,paladin,retribution,18,9,9
Askmy,stormscale,864,paladin,retribution,18,9,9
Noxy,thrall,864,paladin,retribution,18,9,9
Püshup,archimonde,864,paladin,retribution,18,9,9
Notnerb,outland,864,paladin,retribution,18,9,9
Veldora,zuljin,864,paladin,retribution,24,9,15
Jicekaa,archimonde,864,paladin,retribution,24,9,15
Fluffyowo,argent-dawn,864,paladin,retribution,24,9,15
Ritaora,aggramar,864,paladin,retribution,24,9,15
Onlyfanuser,stormscale,864,paladin,retribution,24,9,15
Arrakkis,ravencrest,864,paladin,retribution,24,9,15
Mitsoû,archimonde,864,paladin,retribution,24,9,15
Сэйберх,gordunni,864,paladin,retribution,24,9,15
Святстраж,gordunni,864,paladin,retribution,27,10,17
Koltop,ravencrest,863,paladin,retribution,12,9,3
Ohmega,defias-brotherhood,863,paladin,retribution,12,9,3
Vootele,draenor,863,paladin,retribution,12,9,3
Aksios,kazzak,863,paladin,retribution,12,9,3
Azanah,turalyon,863,paladin,retribution,12,9,3
Nakedholy,draenor,863,paladin,retribution,12,9,3
Fenrixlol,shendralar,863,paladin,retribution,12,9,3
Nordkreuz,aegwynn,863,paladin,retribution,18,9,9
Slyper,dun-modr,863,paladin,retribution,18,9,9
Darkmetal,draenor,863,paladin,retribution,18,9,9
Bonkkar,antonidas,863,paladin,retribution,18,9,9
Rinjepeyet,rexxar,863,paladin,retribution,18,9,9
Bramonier,blackmoore,863,paladin,retribution,18,9,9
Dälaghetto,kilrogg,863,paladin,retribution,18,9,9
Badckes,sylvanas,863,paladin,retribution,18,9,9
Fujszi,arathor,863,paladin,retribution,18,9,9
Азмарио,gordunni,863,paladin,retribution,18,9,9
Astralz,aegwynn,863,paladin,retribution,18,9,9
Ramese,outland,863,paladin,retribution,18,9,9
Roflemente,bladefist,863,paladin,retribution,18,9,9
Sildrit,draenor,863,paladin,retribution,18,9,9
Furiös,ysondre,863,paladin,retribution,18,9,9
Паверармор,howling-fjord,863,paladin,retribution,18,9,9
Steínsgate,ravencrest,863,paladin,retribution,18,9,9
Títanîa,blackmoore,863,paladin,retribution,24,9,15
Khantaro,twisting-nether,863,paladin,retribution,24,9,15
Blauerwürger,blackmoore,863,paladin,retribution,24,9,15
Galerian,twilights-hammer,863,paladin,retribution,24,9,15
Getpawned,rexxar,863,paladin,retribution,24,9,15
Myrmidan,magtheridon,863,paladin,retribution,30,9,21
Гташник,gordunni,863,paladin,retribution,30,9,21
Атмта,razuvious,863,paladin,retribution,30,9,21
Paduj,kazzak,862,paladin,retribution,12,9,3
Kabóm,kazzak,862,paladin,retribution,12,9,3
Atkm,aggramar,862,paladin,retribution,12,9,3
Blatrix,kazzak,862,paladin,retribution,12,9,3
Dáimion,defias-brotherhood,862,paladin,retribution,18,9,9
Elendíl,azjolnerub,862,paladin,retribution,18,9,9
Darkenorr,silvermoon,862,paladin,retribution,18,9,9
Køllegah,ragnaros,862,paladin,retribution,18,9,9
Shakati,twisting-nether,862,paladin,retribution,18,9,9
Londonn,silvermoon,862,paladin,retribution,18,9,9
Sunwalker,bronzebeard,862,paladin,retribution,18,9,9
Редрот,gordunni,862,paladin,retribution,18,9,9
Arthane,frostmane,862,paladin,retribution,22,10,12
Роллита,gordunni,862,paladin,retribution,24,9,15
Fízzybubble,blackmoore,862,paladin,retribution,24,9,15
Elyrax,nemesis,862,paladin,retribution,24,9,15
Quarrel,kul-tiras,862,paladin,retribution,24,9,15
Boyard,silvermoon,862,paladin,retribution,30,9,21
Scoundrell,the-maelstrom,862,paladin,retribution,36,9,27
Viffi,darkspear,861,paladin,retribution,12,9,3
Karnator,eldrethalas,861,paladin,retribution,18,9,9
Saviourself,silvermoon,861,paladin,retribution,18,9,9
Retributon,madmortem,861,paladin,retribution,18,9,9
Sytrexxer,frostwolf,861,paladin,retribution,24,9,15
Dideta,colinas-pardas,861,paladin,retribution,24,9,15
Sölaria,silvermoon,860,paladin,retribution,18,9,9
Humungus,sylvanas,860,paladin,retribution,18,9,9
Ráikou,sylvanas,860,paladin,retribution,18,9,9
Ysunna,magtheridon,860,paladin,retribution,18,9,9
Mustaach,grim-batol,860,paladin,retribution,18,9,9
Ericpala,turalyon,860,paladin,retribution,22,10,12
Destroyér,blackmoore,860,paladin,retribution,24,9,15
Banister,eredar,860,paladin,retribution,24,9,15
Ezcanôr,archimonde,860,paladin,retribution,26,9,17
Гераций,howling-fjord,860,paladin,retribution,30,9,21
Tnkfrank,ravencrest,859,paladin,retribution,18,9,9
Câillou,hyjal,859,paladin,retribution,22,10,12
Jêzus,blackrock,858,paladin,retribution,12,9,3
Алланор,fordragon,858,paladin,retribution,19,11,8
Rètbull,blackhand,858,paladin,retribution,18,9,9
Doomhornqt,outland,857,paladin,retribution,18,9,9
ßrav,hyjal,857,paladin,retribution,32,15,17
Kathly,madmortem,857,paladin,retribution,24,9,15
Thallion,grim-batol,857,paladin,retribution,33,10,23
Cesarius,les-sentinelles,853,paladin,retribution,18,9,9
Fortination,suramar,853,paladin,retribution,18,9,9
Uriziel,the-shatar,853,paladin,retribution,42,19,23
Palatak,outland,851,paladin,retribution,30,9,21
Paladoon,ravencrest,850,paladin,retribution,24,9,15
Fløki,blackrock,848,paladin,retribution,20,10,10
Secônd,azjolnerub,847,paladin,retribution,12,9,3
Явства,grom,847,paladin,retribution,30,9,21
Сашок,gordunni,846,paladin,retribution,18,10,8
Ericafontës,kazzak,846,paladin,retribution,23,9,14
Bariel,lordaeron,845,paladin,retribution,18,9,9
Draarks,archimonde,845,paladin,retribution,18,9,9
Knygnesys,silvermoon,844,paladin,retribution,21,11,10
Missybugla,turalyon,844,paladin,retribution,29,9,20
Lunarrider,ravencrest,844,paladin,retribution,30,9,21
Lgbtqlover,kazzak,841,paladin,retribution,18,11,7
Othersideof,twisting-nether,841,paladin,retribution,24,10,14
Choyoki,blackmoore,837,paladin,retribution,38,14,24
Sunfather,twilights-hammer,836,paladin,retribution,233,115,118
Psykoosi,defias-brotherhood,834,paladin,retribution,52,24,28
Bebcho,turalyon,833,paladin,retribution,38,15,23
Влажныйбоб,soulflayer,830,paladin,retribution,22,9,13
Dôrä,ysondre,830,paladin,retribution,23,9,14
Nakkii,outland,829,paladin,retribution,17,9,8
Баблыч,borean-tundra,829,paladin,retribution,60,28,32
Куоширо,goldrinn,829,paladin,retribution,66,27,39
Guckzu,malganis,823,paladin,retribution,49,22,27
Årés,sanguino,815,paladin,retribution,36,16,20
Bôomayé,archimonde,815,paladin,retribution,23,9,14
Sàbèr,blackmoore,815,paladin,retribution,29,9,20
Frankdux,archimonde,814,paladin,retribution,17,10,7
Naru,ravenholdt,814,paladin,retribution,17,9,8
Sunsera,blackrock,809,paladin,retribution,20,10,10
Tràktor,antonidas,809,paladin,retribution,20,10,10
Khadet,draenor,809,paladin,retribution,22,10,12
Fufenzee,stormscale,807,paladin,retribution,258,111,147
Авереон,gordunni,806,paladin,retribution,35,10,25
Сакирий,gordunni,805,paladin,retribution,17,9,8
Orelius,guldan,803,paladin,retribution,80,33,47
Boaka,outland,803,paladin,retribution,30,9,21
Luciiano,malygos,802,paladin,retribution,65,25,40
Eufenia,tarren-mill,800,paladin,retribution,18,9,9
Neopleyadess,dun-modr,799,paladin,retribution,17,9,8
Ultravíolett,kargath,799,paladin,retribution,23,9,14
Alroxya,blackrock,799,paladin,retribution,23,9,14
Retriot,silvermoon,798,paladin,retribution,26,9,17
Maffko,kazzak,796,paladin,retribution,14,9,5
Farriborz,silvermoon,794,paladin,retribution,20,9,11
Bizin,drakthul,787,paladin,retribution,18,9,9
Tosuro,sunstrider,780,paladin,retribution,25,9,16
Jïncks,anachronos,768,paladin,retribution,12,8,4
Ðiëu,culte-de-la-rive-noire,768,paladin,retribution,12,8,4
Sanzar,twisting-nether,768,paladin,retribution,12,8,4
Balvir,kazzak,768,paladin,retribution,12,8,4
Эксона,gordunni,768,paladin,retribution,12,8,4
Øttøø,outland,768,paladin,retribution,12,8,4
Vérdugo,quelthalas,768,paladin,retribution,12,8,4
Solntsepek,ravencrest,768,paladin,retribution,12,8,4
Khyleancbum,sanguino,768,paladin,retribution,12,8,4
Øñyxßß,ravencrest,768,paladin,retribution,12,8,4
Touch,vashj,768,paladin,retribution,12,8,4
Niyahnie,kazzak,768,paladin,retribution,12,8,4
Pakór,blackrock,768,paladin,retribution,12,8,4
Xephys,argent-dawn,768,paladin,retribution,12,8,4
Minpala,kazzak,768,paladin,retribution,12,8,4
Lightleon,kazzak,768,paladin,retribution,12,8,4
Classicheroo,stormscale,768,paladin,retribution,12,8,4
Sariäza,argent-dawn,768,paladin,retribution,12,8,4
Эйнис,goldrinn,768,paladin,retribution,18,8,10
Sekztokio,blackmoore,768,paladin,retribution,18,8,10
Ббпп,howling-fjord,768,paladin,retribution,18,8,10
Yîînkz,blackmoore,768,paladin,retribution,18,8,10
Bigdaddypump,ravencrest,768,paladin,retribution,18,8,10
Jÿnxx,hyjal,768,paladin,retribution,18,8,10
Søulréaper,stormscale,768,paladin,retribution,18,8,10
Enmà,archimonde,768,paladin,retribution,18,8,10
Lechita,darksorrow,768,paladin,retribution,18,8,10
Vikingensven,silvermoon,768,paladin,retribution,18,8,10
Bloodbeard,twisting-nether,768,paladin,retribution,18,8,10
Postî,eredar,768,paladin,retribution,18,8,10
Кисаммэ,howling-fjord,768,paladin,retribution,18,8,10
Stîp,sanguino,768,paladin,retribution,18,8,10
Madeofsteel,silvermoon,768,paladin,retribution,18,8,10
Камверин,soulflayer,768,paladin,retribution,18,8,10
Gala,archimonde,768,paladin,retribution,18,8,10
Hijh,tarren-mill,768,paladin,retribution,18,8,10
Amycus,zuljin,768,paladin,retribution,18,8,10
Palamag,grim-batol,768,paladin,retribution,18,8,10
Holyinstinct,bronze-dragonflight,768,paladin,retribution,18,8,10
Bubblor,ravencrest,768,paladin,retribution,18,8,10
Phazio,twisting-nether,768,paladin,retribution,18,8,10
Morggann,drakthul,768,paladin,retribution,18,8,10
Synexy,kazzak,768,paladin,retribution,18,8,10
Témpézt,ravencrest,768,paladin,retribution,18,8,10
Endavour,ravencrest,768,paladin,retribution,18,8,10
Piratalpha,thrall,768,paladin,retribution,18,8,10
Чемеряк,gordunni,768,paladin,retribution,18,8,10
Retrigodx,ragnaros,768,paladin,retribution,18,8,10
Пчелодин,howling-fjord,768,paladin,retribution,18,8,10
Alvinzinho,aggra-português,768,paladin,retribution,18,8,10
Rétalin,blackhand,768,paladin,retribution,18,8,10
Neldöwn,dalaran,768,paladin,retribution,18,8,10
Энжел,soulflayer,768,paladin,retribution,18,8,10
Qotro,ravencrest,768,paladin,retribution,19,8,11
Caithlyne,ravencrest,768,paladin,retribution,23,8,15
Рудиар,lich-king,768,paladin,retribution,24,8,16
Zhidria,twisting-nether,768,paladin,retribution,24,8,16
Abbendis,twisting-nether,768,paladin,retribution,24,8,16
Retpala,eitrigg,768,paladin,retribution,24,8,16
Bóokah,blackhand,768,paladin,retribution,24,8,16
Retisfine,silvermoon,768,paladin,retribution,24,8,16
Obahtwerk,nemesis,768,paladin,retribution,24,8,16
Mâgnùs,ravencrest,768,paladin,retribution,24,8,16
Shownómercy,stormscale,768,paladin,retribution,24,8,16
Dàrì,archimonde,768,paladin,retribution,24,8,16
Vilayesyo,ravencrest,768,paladin,retribution,24,8,16
Frazyl,kilrogg,768,paladin,retribution,24,8,16
Tjabo,burning-blade,768,paladin,retribution,24,8,16
Tressðr,dun-modr,768,paladin,retribution,30,8,22
Aliceredlips,dun-modr,768,paladin,retribution,30,8,22
Évo,drakthul,768,paladin,retribution,30,8,22
Mêyra,blackhand,768,paladin,retribution,32,8,24
Zycqo,silvermoon,768,paladin,retribution,37,8,29
Anathiel,khaz-modan,767,paladin,retribution,15,11,4
Dawnnslayer,kazzak,767,paladin,retribution,12,8,4
Spinzr,draenor,767,paladin,retribution,12,8,4
Szelena,outland,767,paladin,retribution,12,8,4
Crossfaded,azjolnerub,767,paladin,retribution,12,8,4
Lightblaster,argent-dawn,767,paladin,retribution,12,8,4
Justicebuktu,thrall,767,paladin,retribution,12,8,4
Пьющая,gordunni,767,paladin,retribution,12,8,4
Unforsakenx,silvermoon,767,paladin,retribution,12,8,4
Neckcheese,spinebreaker,767,paladin,retribution,12,8,4
Jungergot,aegwynn,767,paladin,retribution,15,9,6
Pitux,dun-modr,767,paladin,retribution,16,9,7
Shoogle,alonsus,767,paladin,retribution,15,8,7
Retgrets,kazzak,767,paladin,retribution,18,8,10
Sämaelia,ysondre,767,paladin,retribution,18,8,10
Atabaí,antonidas,767,paladin,retribution,18,8,10
Xsali,kazzak,767,paladin,retribution,18,8,10
Selvich,darksorrow,767,paladin,retribution,18,8,10
Baldrheim,culte-de-la-rive-noire,767,paladin,retribution,18,8,10
Noåh,kazzak,767,paladin,retribution,18,8,10
Halldvan,silvermoon,767,paladin,retribution,18,8,10
Yerosoc,burning-legion,767,paladin,retribution,18,8,10
One,grim-batol,767,paladin,retribution,18,8,10
Бальтазёрыч,soulflayer,767,paladin,retribution,18,8,10
Шалайка,soulflayer,767,paladin,retribution,18,8,10
Samuel,ahnqiraj,767,paladin,retribution,18,8,10
Яшкино,soulflayer,767,paladin,retribution,18,8,10
Фуллбастэр,gordunni,767,paladin,retribution,18,8,10
Lynéssa,twisting-nether,767,paladin,retribution,18,8,10
Spikiz,kazzak,767,paladin,retribution,18,8,10
Assÿria,ravencrest,767,paladin,retribution,18,8,10
Feliora,magtheridon,767,paladin,retribution,18,8,10
Kuhreligion,blackmoore,767,paladin,retribution,18,8,10
Плётка,howling-fjord,767,paladin,retribution,18,8,10
Banderovez,silvermoon,767,paladin,retribution,18,8,10
Lôrdjp,blackmoore,767,paladin,retribution,18,8,10
Hôrrible,ravencrest,767,paladin,retribution,18,8,10
Artonus,sylvanas,767,paladin,retribution,20,8,12
Saath,malfurion,767,paladin,retribution,24,8,16
Thoreas,perenolde,767,paladin,retribution,24,8,16
Lusugo,alakir,767,paladin,retribution,24,8,16
Freeloliipop,darksorrow,767,paladin,retribution,24,8,16
Jámesy,ravencrest,767,paladin,retribution,24,8,16
Тевтонец,goldrinn,767,paladin,retribution,24,8,16
Slainer,zuljin,767,paladin,retribution,24,8,16
Hermmes,alakir,767,paladin,retribution,24,8,16
Dáìsy,blackmoore,767,paladin,retribution,34,9,25
Elovie,dun-modr,767,paladin,retribution,34,8,26
Laugan,ysondre,766,paladin,retribution,12,8,4
Konithis,doomhammer,766,paladin,retribution,12,8,4
Shandju,norgannon,766,paladin,retribution,46,23,23
Chuckbass,blackmoore,766,paladin,retribution,18,8,10
Митзефиста,soulflayer,766,paladin,retribution,18,8,10
Méény,archimonde,766,paladin,retribution,18,8,10
Beefbombs,blackmoore,766,paladin,retribution,18,8,10
Athomos,pozzo-delleternità,766,paladin,retribution,18,8,10
Bpontes,aggra-português,766,paladin,retribution,18,8,10
Sheynä,hyjal,766,paladin,retribution,18,8,10
Sephirøth,thrall,766,paladin,retribution,24,8,16
Dominiq,argent-dawn,766,paladin,retribution,24,8,16
Thawn,dun-modr,765,paladin,retribution,12,8,4
Ôpheliâ,blackmoore,765,paladin,retribution,12,8,4
Kimberveils,blackrock,765,paladin,retribution,18,8,10
Darhz,garona,765,paladin,retribution,18,8,10
Disconnector,aegwynn,765,paladin,retribution,24,8,16
Flokié,blackrock,764,paladin,retribution,12,8,4
Trøllørd,shattrath,764,paladin,retribution,18,8,10
Werepala,drakthul,764,paladin,retribution,18,8,10
Leam,bronze-dragonflight,764,paladin,retribution,24,8,16
Ahritea,blackrock,763,paladin,retribution,12,8,4
Lewanor,tarren-mill,763,paladin,retribution,12,8,4
Wingedguard,ragnaros,763,paladin,retribution,12,8,4
Skimer,outland,763,paladin,retribution,13,8,5
Labadin,darkspear,763,paladin,retribution,18,8,10
Aramedes,eredar,763,paladin,retribution,18,8,10
Ньюзеропал,howling-fjord,763,paladin,retribution,18,8,10
Nécromåncien,khaz-modan,763,paladin,retribution,24,8,16
Русскийяя,gordunni,762,paladin,retribution,13,9,4
Syldor,eredar,762,paladin,retribution,12,8,4
Tank,uldum,762,paladin,retribution,12,8,4
Стекловатный,gordunni,762,paladin,retribution,12,8,4
Mjukadin,ravencrest,762,paladin,retribution,18,8,10
Nasgar,nemesis,762,paladin,retribution,18,8,10
Vondarkmoor,magtheridon,761,paladin,retribution,18,8,10
Mámmon,arthas,761,paladin,retribution,24,8,16
Torczy,frostwhisper,760,paladin,retribution,12,8,4
Maxelx,doomhammer,760,paladin,retribution,12,8,4
Драгун,gordunni,759,paladin,retribution,91,39,52
Mormazor,outland,758,paladin,retribution,18,8,10
Curélien,argent-dawn,758,paladin,retribution,30,8,22
Oheiligster,kult-der-verdammten,755,paladin,retribution,18,8,10
Jily,suramar,755,paladin,retribution,18,8,10
Pyrogon,malorne,754,paladin,retribution,219,98,121
Stealop,malfurion,752,paladin,retribution,24,8,16
Francos,cthun,751,paladin,retribution,33,8,25
Ryüü,uldaman,748,paladin,retribution,48,16,32
Lawrence,deathwing,748,paladin,retribution,24,8,16
Helvirya,defias-brotherhood,744,paladin,retribution,330,139,191
Ukbling,steamwheedle-cartel,744,paladin,retribution,50,12,38
Grayparser,silvermoon,735,paladin,retribution,14,9,5
Ayunagodx,archimonde,733,paladin,retribution,23,8,15
Drestaen,drakthul,731,paladin,retribution,28,8,20
Ragnarauc,elune,720,paladin,retribution,15,8,7
Kelianna,drakthul,719,paladin,retribution,18,9,9
Cøygonne,archimonde,719,paladin,retribution,27,8,19
Unbreakable,eredar,717,paladin,retribution,15,8,7
Darkironpala,argent-dawn,717,paladin,retribution,21,8,13
Esköll,hyjal,713,paladin,retribution,15,9,6
Pastabianco,ravencrest,713,paladin,retribution,18,9,9
Aldèbaràn,pozzo-delleternità,713,paladin,retribution,24,10,14
Marikido,archimonde,713,paladin,retribution,27,9,18
Aue,blackmoore,703,paladin,retribution,20,10,10
Pigma,outland,702,paladin,retribution,21,10,11
Angelepetit,hyjal,701,paladin,retribution,16,8,8
Kubrat,eredar,700,paladin,retribution,54,18,36
Bubbelish,doomhammer,697,paladin,retribution,27,9,18
Smackthepony,sylvanas,697,paladin,retribution,48,15,33
Hanterus,antonidas,691,paladin,retribution,20,8,12
Sawier,ragnaros,688,paladin,retribution,19,8,11
Luveria,der-rat-von-dalaran,687,paladin,retribution,13,8,5
Gradepal,drakthul,687,paladin,retribution,19,8,11
Barbarul,draenor,685,paladin,retribution,19,8,11
Kralenko,archimonde,672,paladin,retribution,12,7,5
Azzaelea,tarren-mill,672,paladin,retribution,12,7,5
Vircy,outland,672,paladin,retribution,12,7,5
Pâlâpâm,blackmoore,672,paladin,retribution,12,7,5
Ljubav,ravencrest,672,paladin,retribution,12,7,5
Ginka,blackrock,672,paladin,retribution,12,7,5
Bämschi,blackrock,672,paladin,retribution,12,7,5
Percocetx,tarren-mill,672,paladin,retribution,12,7,5
Лиривель,howling-fjord,672,paladin,retribution,12,7,5
Corrâ,blackmoore,672,paladin,retribution,12,7,5
Блудиз,howling-fjord,672,paladin,retribution,12,7,5
Ufø,thrall,672,paladin,retribution,12,7,5
Matsuna,blackrock,672,paladin,retribution,12,7,5
Pratiarch,kazzak,672,paladin,retribution,12,7,5
Noskillxd,kragjin,672,paladin,retribution,12,7,5
Torvela,ravencrest,672,paladin,retribution,12,7,5
Megashafted,ravencrest,672,paladin,retribution,12,7,5
Vulence,the-shatar,672,paladin,retribution,12,7,5
Christina,silvermoon,672,paladin,retribution,12,7,5
Palapouffe,khaz-modan,672,paladin,retribution,12,7,5
Миллиционер,razuvious,672,paladin,retribution,12,7,5
Naylaeh,draenor,672,paladin,retribution,12,7,5
Fatherabdul,ravencrest,672,paladin,retribution,12,7,5
Xônia,sylvanas,672,paladin,retribution,12,7,5
Leónardo,kazzak,672,paladin,retribution,12,7,5
Troposin,thrall,672,paladin,retribution,12,7,5
Ellünca,ravencrest,672,paladin,retribution,12,7,5
Нефростинг,gordunni,672,paladin,retribution,12,7,5
Fetichistlov,drekthar,672,paladin,retribution,12,7,5
Pssddgg,ragnaros,672,paladin,retribution,12,7,5
Mâlâk,dun-modr,672,paladin,retribution,12,7,5
Arkhàn,ravencrest,672,paladin,retribution,12,7,5
Petsadin,ravencrest,672,paladin,retribution,12,7,5
Solanarion,burning-legion,672,paladin,retribution,12,7,5
Kamas,antonidas,672,paladin,retribution,12,7,5
Megadef,twisting-nether,672,paladin,retribution,12,7,5
Uriens,zuljin,672,paladin,retribution,12,7,5
Miriem,twisting-nether,672,paladin,retribution,12,7,5
Deathzzaky,zuljin,672,paladin,retribution,12,7,5
Kikipoti,ravenholdt,672,paladin,retribution,12,7,5
Проверялка,thermaplugg,672,paladin,retribution,12,7,5
Catfordinner,silvermoon,672,paladin,retribution,12,7,5
Decive,outland,672,paladin,retribution,12,7,5
Veganbeefman,draenor,672,paladin,retribution,12,7,5
Layonthese,alleria,672,paladin,retribution,12,7,5
Noiwings,sanguino,672,paladin,retribution,12,7,5
Sunblazer,draenor,672,paladin,retribution,12,7,5
Шефлион,soulflayer,672,paladin,retribution,12,7,5
Дикийчёрт,gordunni,672,paladin,retribution,12,7,5
Röcc,draenor,672,paladin,retribution,12,7,5
Ceca,lightnings-blade,672,paladin,retribution,12,7,5
Nøradin,argent-dawn,672,paladin,retribution,12,7,5
Henklord,jaedenar,672,paladin,retribution,12,7,5
Deckardpain,shattered-hand,672,paladin,retribution,12,7,5
Xiliath,bloodfeather,672,paladin,retribution,12,7,5
Shjami,rexxar,672,paladin,retribution,12,7,5
Sismast,argent-dawn,672,paladin,retribution,12,7,5
Рэйног,gordunni,672,paladin,retribution,12,7,5
Tizeo,thunderhorn,672,paladin,retribution,15,8,7
Тазикчая,soulflayer,672,paladin,retribution,16,8,8
Holymolee,blackmoore,672,paladin,retribution,15,7,8
Zeramur,malygos,672,paladin,retribution,18,7,11
Himboqueenxo,argent-dawn,672,paladin,retribution,18,7,11
Lommeuld,auchindoun,672,paladin,retribution,18,7,11
Calliopes,tarren-mill,672,paladin,retribution,18,7,11
Seekêr,tarren-mill,672,paladin,retribution,18,7,11
Prâtox,blackmoore,672,paladin,retribution,18,7,11
Melyntholdra,argent-dawn,672,paladin,retribution,18,7,11
Elonmuskett,ysondre,672,paladin,retribution,18,7,11
Apocalypsé,twisting-nether,672,paladin,retribution,18,7,11
Divineovic,ravencrest,672,paladin,retribution,18,7,11
Ênma,archimonde,672,paladin,retribution,18,7,11
Norganpala,die-aldor,672,paladin,retribution,18,7,11
Arbuzno,draenor,672,paladin,retribution,18,7,11
Pìnkyy,draenor,672,paladin,retribution,18,7,11
Mawrâ,twisting-nether,672,paladin,retribution,18,7,11
Tezmodian,antonidas,672,paladin,retribution,18,7,11
Plasmadieter,blackrock,672,paladin,retribution,18,7,11
Vaalé,aegwynn,672,paladin,retribution,18,7,11
Lotheirid,antonidas,672,paladin,retribution,18,7,11
Jinxdadmilk,twisting-nether,672,paladin,retribution,18,7,11
Miscodepala,twisting-nether,672,paladin,retribution,18,7,11
Hännó,malganis,672,paladin,retribution,18,7,11
Fróstíp,blackrock,672,paladin,retribution,18,7,11
Fahrèl,hyjal,672,paladin,retribution,18,7,11
Мериатас,soulflayer,672,paladin,retribution,18,7,11
Yakuron,blackhand,672,paladin,retribution,18,7,11
Алепос,gordunni,672,paladin,retribution,18,7,11
Smutty,frostmane,672,paladin,retribution,18,7,11
Drident,die-nachtwache,672,paladin,retribution,18,7,11
Eleånor,archimonde,672,paladin,retribution,18,7,11
Azapala,kazzak,672,paladin,retribution,18,7,11
Destaen,kazzak,672,paladin,retribution,18,7,11
Scairtin,ravencrest,672,paladin,retribution,18,7,11
Trýhærd,ragnaros,672,paladin,retribution,18,7,11
Nicklovsofia,silvermoon,672,paladin,retribution,18,7,11
Rocheford,silvermoon,672,paladin,retribution,18,7,11
Evilhoof,thrall,672,paladin,retribution,18,7,11
Tinia,azjolnerub,672,paladin,retribution,18,7,11
Arshiaa,ravencrest,672,paladin,retribution,21,8,13
Глаймис,gordunni,672,paladin,retribution,22,8,14
Chiriner,drakthul,672,paladin,retribution,21,7,14
Npkk,outland,672,paladin,retribution,22,7,15
Nôva,stormscale,672,paladin,retribution,23,7,16
Ашилолпро,soulflayer,672,paladin,retribution,24,7,17
ßlitzkrieg,blackmoore,672,paladin,retribution,24,7,17
Ящеры,gordunni,672,paladin,retribution,24,7,17
Астарин,gordunni,672,paladin,retribution,24,7,17
Ramhal,stormscale,672,paladin,retribution,24,7,17
Zerlat,twisting-nether,672,paladin,retribution,24,7,17
Manole,ravencrest,672,paladin,retribution,24,7,17
Iquny,frostwolf,672,paladin,retribution,24,7,17
Cáranthír,draenor,672,paladin,retribution,24,7,17
Boscho,argent-dawn,672,paladin,retribution,24,7,17
Adalric,silvermoon,672,paladin,retribution,24,7,17
Kareliaxd,tarren-mill,672,paladin,retribution,24,7,17
Yaloh,sylvanas,672,paladin,retribution,24,7,17
Ерфати,gordunni,672,paladin,retribution,24,7,17
Каншеом,gordunni,671,paladin,retribution,12,7,5
Granadir,doomhammer,671,paladin,retribution,12,7,5
Isotun,kazzak,671,paladin,retribution,12,7,5
Gbejr,xavius,671,paladin,retribution,12,7,5
Retzzo,ravencrest,671,paladin,retribution,12,7,5
Bryelle,dalaran,671,paladin,retribution,12,7,5
Vultrix,tarren-mill,671,paladin,retribution,12,7,5
Amatar,ravencrest,671,paladin,retribution,12,7,5
Раикерс,gordunni,671,paladin,retribution,12,7,5
Kambarius,antonidas,671,paladin,retribution,12,7,5
Bronan,draenor,671,paladin,retribution,12,7,5
Kardinalos,drakthul,671,paladin,retribution,12,7,5
Roskof,archimonde,671,paladin,retribution,12,7,5
Wolfpala,drakthul,671,paladin,retribution,12,7,5
Gavain,blackhand,671,paladin,retribution,12,7,5
Lightbinders,ragnaros,671,paladin,retribution,12,7,5
Киэрсис,howling-fjord,671,paladin,retribution,12,7,5
Lanny,blackhand,671,paladin,retribution,12,7,5
Liamisi,blackhand,671,paladin,retribution,12,7,5
Zpock,archimonde,671,paladin,retribution,12,7,5
Gigaqueenie,karazhan,671,paladin,retribution,12,7,5
Timoxas,kazzak,671,paladin,retribution,12,7,5
Liliána,ragnaros,671,paladin,retribution,12,7,5
Mýv,archimonde,671,paladin,retribution,12,7,5
Реснитеплес,gordunni,671,paladin,retribution,12,7,5
Bahamamama,ambossar,671,paladin,retribution,12,7,5
Sakred,hellscream,671,paladin,retribution,12,7,5
Архемор,ashenvale,671,paladin,retribution,12,7,5
Odregon,draenor,671,paladin,retribution,12,7,5
Infería,blackhand,671,paladin,retribution,15,8,7
Arator,terenas,671,paladin,retribution,16,8,8
Тешеус,gordunni,671,paladin,retribution,17,7,10
Danierrs,burning-legion,671,paladin,retribution,18,7,11
Rifzy,kazzak,671,paladin,retribution,18,7,11
Patrice,blutkessel,671,paladin,retribution,18,7,11
Uhtrèd,turalyon,671,paladin,retribution,18,7,11
Ardalìon,archimonde,671,paladin,retribution,18,7,11
Slaaneesh,zuljin,671,paladin,retribution,18,7,11
Tunaonion,draenor,671,paladin,retribution,18,7,11
Necadin,ravencrest,671,paladin,retribution,18,7,11
Zeturius,draenor,671,paladin,retribution,18,7,11
Рогафайти,goldrinn,671,paladin,retribution,18,7,11
Nézuko,frostwhisper,671,paladin,retribution,18,7,11
Alvíss,sanguino,671,paladin,retribution,18,7,11
Grzegzolnik,twisting-nether,671,paladin,retribution,18,7,11
Кесару,goldrinn,671,paladin,retribution,18,7,11
Erethes,magtheridon,671,paladin,retribution,18,7,11
Headflúx,argent-dawn,671,paladin,retribution,18,7,11
Konori,mannoroth,671,paladin,retribution,18,7,11
Allepro,bronze-dragonflight,671,paladin,retribution,18,7,11
Äggmackor,ravencrest,671,paladin,retribution,18,7,11
Laenira,nemesis,671,paladin,retribution,18,7,11
Qtek,draenor,671,paladin,retribution,18,7,11
Cameron,taerar,671,paladin,retribution,18,7,11
Darkenkel,kazzak,671,paladin,retribution,18,7,11
Testovasara,ravencrest,671,paladin,retribution,18,7,11
Öbedö,malganis,671,paladin,retribution,24,7,17
Zyklôn,antonidas,671,paladin,retribution,30,7,23
Onestone,wrathbringer,671,paladin,retribution,30,7,23
Quelthemar,stormscale,671,paladin,retribution,30,7,23
Edb,silvermoon,670,paladin,retribution,12,7,5
Låncelot,sylvanas,670,paladin,retribution,12,7,5
Retxmode,ravencrest,670,paladin,retribution,12,7,5
Greifenstein,rexxar,670,paladin,retribution,18,7,11
Thandoro,amanthul,670,paladin,retribution,18,7,11
Ракнапали,gordunni,670,paladin,retribution,18,7,11
Dalaly,kazzak,670,paladin,retribution,18,7,11
Halldòr,ravencrest,670,paladin,retribution,24,7,17
Holyshd,stormscale,670,paladin,retribution,24,7,17
Babajõ,twisting-nether,669,paladin,retribution,12,7,5
Baymanda,tarren-mill,669,paladin,retribution,18,7,11
Tåke,defias-brotherhood,669,paladin,retribution,18,7,11
Nuvadaima,kazzak,669,paladin,retribution,24,7,17
Гёрди,fordragon,668,paladin,retribution,13,7,6
Tobebryant,eonar,667,paladin,retribution,12,7,5
Shennzo,wildhammer,667,paladin,retribution,12,7,5
Megara,bronze-dragonflight,667,paladin,retribution,12,7,5
Willmasmashn,blackmoore,667,paladin,retribution,18,7,11
Woezel,draenor,667,paladin,retribution,18,7,11
Cúraga,ravencrest,667,paladin,retribution,24,7,17
Bedrock,kirin-tor,666,paladin,retribution,12,7,5
Ксинем,howling-fjord,666,paladin,retribution,16,8,8
Paladinslaye,dun-modr,666,paladin,retribution,30,7,23
Kentarø,eldrethalas,665,paladin,retribution,12,7,5
Zealotic,doomhammer,664,paladin,retribution,12,7,5
Malzj,garrosh,664,paladin,retribution,12,7,5
Chikaz,archimonde,664,paladin,retribution,20,10,10
Blinklys,ragnaros,664,paladin,retribution,18,7,11
Halimox,terokkar,664,paladin,retribution,18,7,11
Purpledurple,twisting-nether,663,paladin,retribution,18,7,11
Nhum,destromath,663,paladin,retribution,18,7,11
Роклэс,gordunni,662,paladin,retribution,12,7,5
Sarinise,draenor,662,paladin,retribution,12,7,5
Thebøss,blackmoore,662,paladin,retribution,18,7,11
Belzed,draenor,660,paladin,retribution,15,8,7
Helm,emerald-dream,658,paladin,retribution,36,7,29
Ядб,gordunni,655,paladin,retribution,18,7,11
Izri,hellscream,655,paladin,retribution,18,7,11
Raluz,kazzak,655,paladin,retribution,23,7,16
Bogrács,silvermoon,655,paladin,retribution,23,7,16
Sindur,perenolde,651,paladin,retribution,18,7,11
Shawn,archimonde,640,paladin,retribution,16,7,9
Gfugh,shadowsong,639,paladin,retribution,11,7,4
Çhè,blackmoore,639,paladin,retribution,11,7,4
Саймэл,soulflayer,639,paladin,retribution,16,7,9
Breezpal,twisting-nether,639,paladin,retribution,17,7,10
Trístesse,tarren-mill,639,paladin,retribution,23,7,16
Suri,shattrath,637,paladin,retribution,16,8,8
Bellight,sinstralis,634,paladin,retribution,25,7,18
Samànta,nemesis,623,paladin,retribution,11,7,4
Эвони,gordunni,623,paladin,retribution,17,7,10
Нимбоо,soulflayer,623,paladin,retribution,17,7,10
Gwynbleyd,twisting-nether,622,paladin,retribution,11,7,4
Belapala,tarren-mill,622,paladin,retribution,17,7,10
Nybrash,sanguino,620,paladin,retribution,15,7,8
Séphiran,hyjal,618,paladin,retribution,15,9,6
Narkománen,shattered-hand,618,paladin,retribution,16,9,7
Goofyaf,ravencrest,618,paladin,retribution,16,9,7
Alïstia,archimonde,618,paladin,retribution,31,9,22
Pelbo,ravencrest,617,paladin,retribution,21,8,13
Mariaremarc,silvermoon,617,paladin,retribution,25,8,17
Ренегадер,thermaplugg,615,paladin,retribution,12,8,4
Shrelia,eredar,615,paladin,retribution,21,9,12
Stonebeard,ahnqiraj,613,paladin,retribution,31,8,23
Leouric,argent-dawn,607,paladin,retribution,20,7,13
Lightswrath,thunderhorn,606,paladin,retribution,12,7,5
Jockker,sinstralis,606,paladin,retribution,19,8,11
Teksor,frostmourne,592,paladin,retribution,19,7,12
Enoh,the-maelstrom,590,paladin,retribution,16,7,9
Purpleháze,drekthar,581,paladin,retribution,85,41,44
Piiskaaja,argent-dawn,576,paladin,retribution,6,6,0
Toffíczq,burning-legion,576,paladin,retribution,6,6,0
Кенриэль,howling-fjord,576,paladin,retribution,6,6,0
Nesquikudder,kazzak,576,paladin,retribution,12,6,6
Госпелька,blackscar,576,paladin,retribution,12,6,6
Raleknrnr,hyjal,576,paladin,retribution,12,6,6
Vuutnëx,twisting-nether,576,paladin,retribution,12,6,6
Båbyløn,outland,576,paladin,retribution,12,6,6
Superieur,kazzak,576,paladin,retribution,12,6,6
Mingyao,sanguino,576,paladin,retribution,12,6,6
Crusxder,kazzak,576,paladin,retribution,12,6,6
Holyshêêt,draenor,576,paladin,retribution,12,6,6
Drekio,blackrock,576,paladin,retribution,12,6,6
Lévrone,alexstrasza,576,paladin,retribution,12,6,6
Ineffable,dun-modr,576,paladin,retribution,12,6,6
Käiser,shendralar,576,paladin,retribution,12,6,6
Retqt,eredar,576,paladin,retribution,12,6,6
Aalbringer,blackmoore,576,paladin,retribution,12,6,6
Fâlli,hyjal,576,paladin,retribution,12,6,6
Vysavo,draenor,576,paladin,retribution,12,6,6
Sàtos,hyjal,576,paladin,retribution,12,6,6
Texxi,blackrock,576,paladin,retribution,12,6,6
Xanesha,archimonde,576,paladin,retribution,12,6,6
Ibanez,lightnings-blade,576,paladin,retribution,12,6,6
Yurinovsky,aggra-português,576,paladin,retribution,12,6,6
Milner,stormreaver,576,paladin,retribution,12,6,6
Raceper,the-maelstrom,576,paladin,retribution,12,6,6
Джараксисс,soulflayer,576,paladin,retribution,12,6,6
Arilend,grim-batol,576,paladin,retribution,12,6,6
Stève,ravencrest,576,paladin,retribution,12,6,6
Téralus,ravencrest,576,paladin,retribution,12,6,6
Wishram,frostmane,576,paladin,retribution,12,6,6
Luciter,silvermoon,576,paladin,retribution,12,6,6
Éllé,der-rat-von-dalaran,576,paladin,retribution,12,6,6
Pabló,azshara,576,paladin,retribution,12,6,6
Скварлетх,howling-fjord,576,paladin,retribution,12,6,6
Alciera,silvermoon,576,paladin,retribution,12,6,6
Plaguepal,quelthalas,576,paladin,retribution,12,6,6
Упругийтуз,gordunni,576,paladin,retribution,12,6,6
Cilodin,blackrock,576,paladin,retribution,12,6,6
Moossolin,tarren-mill,576,paladin,retribution,12,6,6
Tereth,kazzak,576,paladin,retribution,12,6,6
Argeltal,auchindoun,576,paladin,retribution,12,6,6
Rømpelukt,auchindoun,576,paladin,retribution,12,6,6
Tamarian,frostwhisper,576,paladin,retribution,12,6,6
Escanør,anetheron,576,paladin,retribution,12,6,6
Nouhada,archimonde,576,paladin,retribution,12,6,6
Стифаний,booty-bay,576,paladin,retribution,12,6,6
Skengdaddy,ragnaros,576,paladin,retribution,12,6,6
Reyhann,ravencrest,576,paladin,retribution,12,6,6
Локопоезд,greymane,576,paladin,retribution,12,6,6
Таймкил,gordunni,576,paladin,retribution,12,6,6
Sureklunker,silvermoon,576,paladin,retribution,12,6,6
Mouncake,archimonde,576,paladin,retribution,12,6,6
Зебхан,thermaplugg,576,paladin,retribution,12,6,6
Skålf,outland,576,paladin,retribution,12,6,6
Gothec,darksorrow,576,paladin,retribution,12,6,6
Plainrage,blackrock,576,paladin,retribution,12,6,6
Paladoom,magtheridon,576,paladin,retribution,12,6,6
Udrik,proudmoore,576,paladin,retribution,12,6,6
Seothor,argent-dawn,576,paladin,retribution,12,6,6
Gabrîel,sanguino,576,paladin,retribution,12,6,6
Kamaska,antonidas,576,paladin,retribution,12,6,6
Quasarxx,ravencrest,576,paladin,retribution,12,6,6
Elrondyl,magtheridon,576,paladin,retribution,12,6,6
Aldio,pozzo-delleternità,576,paladin,retribution,12,6,6
Ðos,ravencrest,576,paladin,retribution,12,6,6
Иомос,soulflayer,576,paladin,retribution,12,6,6
Pöm,khaz-modan,576,paladin,retribution,12,6,6
Бляля,gordunni,576,paladin,retribution,12,6,6
Arsinel,blackhand,576,paladin,retribution,12,6,6
Calibretto,khaz-modan,576,paladin,retribution,12,6,6
Alekks,silvermoon,576,paladin,retribution,12,6,6
Vandergrift,archimonde,576,paladin,retribution,12,6,6
Наладчикк,howling-fjord,576,paladin,retribution,12,6,6
Stankow,kazzak,576,paladin,retribution,12,6,6
Holyjugs,outland,576,paladin,retribution,12,6,6
Rözum,burning-legion,576,paladin,retribution,12,6,6
Ауди,howling-fjord,576,paladin,retribution,12,6,6
Ultimatix,stormscale,576,paladin,retribution,12,6,6
Waaynejudgeu,blackhand,576,paladin,retribution,12,6,6
Vnti,outland,576,paladin,retribution,12,6,6
Tharduk,outland,576,paladin,retribution,12,6,6
Nanduil,stormscale,576,paladin,retribution,12,6,6
Athoman,nagrand,576,paladin,retribution,12,6,6
Сэдриш,howling-fjord,576,paladin,retribution,12,6,6
Drdax,wildhammer,576,paladin,retribution,12,6,6
Shockadiin,grim-batol,576,paladin,retribution,12,6,6
Akcope,thunderhorn,576,paladin,retribution,12,6,6
Eletha,senjin,576,paladin,retribution,12,6,6
Cildan,talnivarr,576,paladin,retribution,12,6,6
Hollypala,stormscale,576,paladin,retribution,12,6,6
Ashery,elune,576,paladin,retribution,12,6,6
Rothus,bronze-dragonflight,576,paladin,retribution,12,6,6
Rokarón,blackhand,576,paladin,retribution,12,6,6
Frâncoforte,blackmoore,576,paladin,retribution,12,6,6
Ærîo,dalaran,576,paladin,retribution,12,6,6
Керантий,gordunni,576,paladin,retribution,12,6,6
Kjellus,tarren-mill,576,paladin,retribution,12,6,6
Darnito,blackmoore,576,paladin,retribution,15,7,8
Aimee,draenor,576,paladin,retribution,16,7,9
Stooti,ragnaros,576,paladin,retribution,14,6,8
Blackthorne,azuremyst,576,paladin,retribution,15,6,9
Cpthøjaløt,eredar,576,paladin,retribution,18,6,12
Cycodin,garrosh,576,paladin,retribution,18,6,12
Aschenpuddl,blackmoore,576,paladin,retribution,18,6,12
Анфлераж,gordunni,576,paladin,retribution,18,6,12
Tödelbröt,eredar,576,paladin,retribution,18,6,12
Dobbygotsock,kazzak,576,paladin,retribution,18,6,12
Verix,thrall,576,paladin,retribution,18,6,12
Valzyffs,twisting-nether,576,paladin,retribution,18,6,12
Phannelle,ysondre,576,paladin,retribution,18,6,12
Czachadymii,defias-brotherhood,576,paladin,retribution,18,6,12
Эрогот,gordunni,576,paladin,retribution,18,6,12
Aleya,arathor,576,paladin,retribution,18,6,12
Dunklerzwerg,the-maelstrom,576,paladin,retribution,18,6,12
Exfire,daggerspine,576,paladin,retribution,18,6,12
Izelv,dalaran,576,paladin,retribution,18,6,12
Bierstierr,blackrock,576,paladin,retribution,18,6,12
Sonil,les-sentinelles,576,paladin,retribution,18,6,12
Byczorek,turalyon,576,paladin,retribution,18,6,12
Armion,stormscale,576,paladin,retribution,18,6,12
Thickets,argent-dawn,576,paladin,retribution,18,6,12
Генатрамбон,howling-fjord,576,paladin,retribution,18,6,12
Bopstar,tarren-mill,576,paladin,retribution,18,6,12
Bothways,stormscale,576,paladin,retribution,18,6,12
Keineshoe,argent-dawn,576,paladin,retribution,18,6,12
Hiloqtpala,blackmoore,576,paladin,retribution,18,6,12
Obelliskapd,doomhammer,576,paladin,retribution,18,6,12
Mozaiczna,burning-legion,576,paladin,retribution,18,6,12
Ironkra,stormscale,576,paladin,retribution,18,6,12
Meldø,drakthul,576,paladin,retribution,18,6,12
Goatmode,echsenkessel,576,paladin,retribution,18,6,12
Glorfindel,tarren-mill,576,paladin,retribution,18,6,12
Retríciusz,ragnaros,576,paladin,retribution,18,6,12
Wìndy,stormreaver,576,paladin,retribution,18,6,12
Amadeo,genjuros,576,paladin,retribution,18,6,12
Kelduril,draenor,576,paladin,retribution,18,6,12
Mooderna,ravencrest,576,paladin,retribution,18,6,12
Mâêdhrøsx,ravencrest,576,paladin,retribution,18,6,12
Topoholy,tarren-mill,576,paladin,retribution,18,6,12
Esebenjamin,dun-modr,576,paladin,retribution,18,6,12
Illythia,anachronos,576,paladin,retribution,18,6,12
Bigfatpig,ravencrest,576,paladin,retribution,18,6,12
Teebxu,outland,576,paladin,retribution,18,6,12
Fortasec,aggra-português,576,paladin,retribution,18,6,12
Darkoo,hyjal,576,paladin,retribution,18,6,12
Dyna,outland,576,paladin,retribution,18,6,12
Mîskine,archimonde,576,paladin,retribution,18,6,12
Îshybî,archimonde,576,paladin,retribution,24,6,18
Lacrossé,kazzak,576,paladin,retribution,24,6,18
Vokesh,silvermoon,576,paladin,retribution,24,6,18
Mirihi,ungoro,576,paladin,retribution,24,6,18
Mylilholy,twisting-nether,576,paladin,retribution,24,6,18
Huevo,frostmane,576,paladin,retribution,24,6,18
Paladiume,drekthar,575,paladin,retribution,6,6,0
Berethas,darksorrow,575,paladin,retribution,6,6,0
Tehdark,outland,575,paladin,retribution,12,6,6
Eyebluee,tarren-mill,575,paladin,retribution,12,6,6
Luxeliel,zuljin,575,paladin,retribution,12,6,6
Protson,burning-legion,575,paladin,retribution,12,6,6
Justsush,hyjal,575,paladin,retribution,12,6,6
Naxvrim,antonidas,575,paladin,retribution,12,6,6
Eldivin,hyjal,575,paladin,retribution,12,6,6
Kendomendo,ravencrest,575,paladin,retribution,12,6,6
Pewpews,twisting-nether,575,paladin,retribution,12,6,6
Helson,draenor,575,paladin,retribution,12,6,6
Isess,nozdormu,575,paladin,retribution,12,6,6
Greatme,frostmane,575,paladin,retribution,12,6,6
Blazix,kazzak,575,paladin,retribution,12,6,6
Bcrp,ragnaros,575,paladin,retribution,12,6,6
Illusio,defias-brotherhood,575,paladin,retribution,12,6,6
Rohb,blackmoore,575,paladin,retribution,12,6,6
Sæsh,die-aldor,575,paladin,retribution,12,6,6
Vandorin,dun-morogh,575,paladin,retribution,12,6,6
Тамплиир,gordunni,575,paladin,retribution,12,6,6
Retornot,silvermoon,575,paladin,retribution,12,6,6
Phillipe,illidan,575,paladin,retribution,12,6,6
Yourholyness,darksorrow,575,paladin,retribution,12,6,6
Runeington,silvermoon,575,paladin,retribution,12,6,6
Poutoux,archimonde,575,paladin,retribution,12,6,6
Phystos,culte-de-la-rive-noire,575,paladin,retribution,12,6,6
Andrõs,argent-dawn,575,paladin,retribution,15,7,8
Sudija,ravencrest,575,paladin,retribution,18,6,12
Szuberto,silvermoon,575,paladin,retribution,18,6,12
Бритыйносок,grom,575,paladin,retribution,18,6,12
Crsader,antonidas,575,paladin,retribution,18,6,12
Ragonas,mannoroth,575,paladin,retribution,18,6,12
Palaska,hyjal,575,paladin,retribution,18,6,12
Câlon,twisting-nether,575,paladin,retribution,18,6,12
Solcustos,tarren-mill,575,paladin,retribution,18,6,12
Vhestas,dun-modr,575,paladin,retribution,18,6,12
Héphàïstøs,dalaran,575,paladin,retribution,18,6,12
Pålegg,emerald-dream,575,paladin,retribution,18,6,12
Ippex,silvermoon,575,paladin,retribution,18,6,12
Edathar,argent-dawn,575,paladin,retribution,24,6,18
Edons,exodar,574,paladin,retribution,12,6,6
Roxian,burning-blade,574,paladin,retribution,12,6,6
Легионор,galakrond,574,paladin,retribution,12,6,6
Nelieltu,dragonmaw,574,paladin,retribution,12,6,6
Dönki,hyjal,574,paladin,retribution,12,6,6
Goouse,marécage-de-zangar,574,paladin,retribution,12,6,6
Zeex,darksorrow,574,paladin,retribution,18,6,12
Humaladi,draenor,574,paladin,retribution,18,6,12
Areiia,antonidas,574,paladin,retribution,24,6,18
Sèrgàs,blackhand,573,paladin,retribution,30,6,24
Nasrudan,ravenholdt,573,paladin,retribution,30,6,24
Renalex,ravencrest,572,paladin,retribution,12,6,6
Munuin,silvermoon,572,paladin,retribution,18,6,12
Туларион,grom,572,paladin,retribution,18,6,12
Aggipala,blackhand,572,paladin,retribution,18,6,12
Hrubo,drakthul,570,paladin,retribution,12,6,6
Dreadlyn,bloodhoof,570,paladin,retribution,24,6,18
Elannor,sylvanas,569,paladin,retribution,12,6,6
Marcelinin,khaz-modan,569,paladin,retribution,33,7,26
Nicgr,nemesis,566,paladin,retribution,12,6,6
Vengryn,turalyon,566,paladin,retribution,37,8,29
Shendis,uldaman,565,paladin,retribution,12,6,6
Севенола,galakrond,565,paladin,retribution,18,6,12
Dunedaym,cthun,562,paladin,retribution,18,6,12
Иусто,howling-fjord,559,paladin,retribution,17,6,11
Tofrus,kazzak,559,paladin,retribution,23,6,17
Ràwx,twisting-nether,559,paladin,retribution,23,6,17
Hegolas,terrordar,557,paladin,retribution,23,6,17
Élion,les-clairvoyants,543,paladin,retribution,11,6,5
Ретроградий,howling-fjord,543,paladin,retribution,16,6,10
Darkliight,kazzak,542,paladin,retribution,14,7,7
Yornoc,argent-dawn,528,paladin,retribution,15,6,9
Optì,eredar,527,paladin,retribution,11,6,5
Droidlle,kult-der-verdammten,527,paladin,retribution,11,6,5
Ragunav,draenor,527,paladin,retribution,11,6,5
Kurasame,eredar,527,paladin,retribution,11,6,5
Abellá,silvermoon,527,paladin,retribution,23,6,17
Brunhildd,blackrock,526,paladin,retribution,15,6,9
Theodun,xavius,524,paladin,retribution,17,6,11
Plsdøntusemd,ravencrest,522,paladin,retribution,17,8,9
Purrifire,sylvanas,522,paladin,retribution,16,7,9
Grafleopold,lothar,522,paladin,retribution,23,8,15
Митахо,gordunni,522,paladin,retribution,21,7,14
Тошши,soulflayer,522,paladin,retribution,28,8,20
Uriel,scarshield-legion,520,paladin,retribution,16,8,8
Bulladin,silvermoon,512,paladin,retribution,10,6,4
Ярлд,gordunni,511,paladin,retribution,11,6,5
Faldrinx,hyjal,511,paladin,retribution,14,6,8
Babypic,ambossar,511,paladin,retribution,14,6,8
Selfix,silvermoon,509,paladin,retribution,28,6,22
Shinka,blutkessel,507,paladin,retribution,23,6,17
Rockymarcian,hyjal,506,paladin,retribution,16,6,10
Prínce,earthen-ring,495,paladin,retribution,13,6,7
Paradok,thrall,480,paladin,retribution,6,5,1
Palapix,tarren-mill,480,paladin,retribution,6,5,1
Bountyrider,kazzak,480,paladin,retribution,6,5,1
Tryggt,the-shatar,480,paladin,retribution,6,5,1
Rallerexi,silvermoon,480,paladin,retribution,6,5,1
Antajesús,thrall,480,paladin,retribution,6,5,1
Zygerpal,outland,480,paladin,retribution,6,5,1
Sabríel,ragnaros,480,paladin,retribution,6,5,1
Ravnz,ragnaros,480,paladin,retribution,6,5,1
Mörkepisod,tarren-mill,480,paladin,retribution,6,5,1
Budás,sanguino,480,paladin,retribution,6,5,1
Holypowerr,ragnaros,480,paladin,retribution,6,5,1
Zïons,hyjal,480,paladin,retribution,6,5,1
Luzdosol,blackrock,480,paladin,retribution,6,5,1
Ryven,stormscale,480,paladin,retribution,6,5,1
Espada,anachronos,480,paladin,retribution,6,5,1
Кеймордор,soulflayer,480,paladin,retribution,6,5,1
Mlws,ravencrest,480,paladin,retribution,6,5,1
Vangerot,ravencrest,480,paladin,retribution,6,5,1
Sossiqt,silvermoon,480,paladin,retribution,6,5,1
Daj,draenor,480,paladin,retribution,6,5,1
Mclovinn,hyjal,480,paladin,retribution,6,5,1
Holyfatherr,draenor,480,paladin,retribution,6,5,1
Nobodyyx,stormscale,480,paladin,retribution,6,5,1
Тенькопыт,howling-fjord,480,paladin,retribution,6,5,1
Мультас,gordunni,480,paladin,retribution,6,5,1
Yezitzme,blackrock,480,paladin,retribution,6,5,1
Voycetwo,frostwolf,480,paladin,retribution,6,5,1
Vickolaïvïs,dun-modr,480,paladin,retribution,6,5,1
Röland,sanguino,480,paladin,retribution,6,5,1
Feaná,silvermoon,480,paladin,retribution,6,5,1
Zûrry,arthas,480,paladin,retribution,6,5,1
Matoxin,silvermoon,480,paladin,retribution,6,5,1
Taurantes,garona,480,paladin,retribution,6,5,1
Ralphwiggum,stormrage,480,paladin,retribution,9,6,3
Melvòó,blackrock,480,paladin,retribution,9,6,3
Dykron,rexxar,480,paladin,retribution,9,6,3
Финэдин,gordunni,480,paladin,retribution,9,6,3
Sunzi,alakir,480,paladin,retribution,10,6,4
Ryanretnolds,stormscale,480,paladin,retribution,10,6,4
Prd,grim-batol,480,paladin,retribution,12,5,7
Pompée,dalaran,480,paladin,retribution,12,5,7
Демопал,fordragon,480,paladin,retribution,12,5,7
Mauly,kazzak,480,paladin,retribution,12,5,7
Partolina,twisting-nether,480,paladin,retribution,12,5,7
Docoùla,twisting-nether,480,paladin,retribution,12,5,7
Hifyve,kazzak,480,paladin,retribution,12,5,7
Himèji,pozzo-delleternità,480,paladin,retribution,12,5,7
Ашурыч,gordunni,480,paladin,retribution,12,5,7
Bloodpala,malganis,480,paladin,retribution,12,5,7
Рукибудды,soulflayer,480,paladin,retribution,12,5,7
Обиронн,howling-fjord,480,paladin,retribution,12,5,7
Zaopink,blackhand,480,paladin,retribution,12,5,7
Arakir,ragnaros,480,paladin,retribution,12,5,7
Сладупся,gordunni,480,paladin,retribution,12,5,7
Ascendeadqt,kazzak,480,paladin,retribution,12,5,7
Poporfour,archimonde,480,paladin,retribution,12,5,7
Бортовский,ashenvale,480,paladin,retribution,12,5,7
Ньюфи,deathguard,480,paladin,retribution,12,5,7
Smygelicous,ragnaros,480,paladin,retribution,12,5,7
Shanderhilo,pozzo-delleternità,480,paladin,retribution,12,5,7
Нойззмс,gordunni,480,paladin,retribution,12,5,7
Gambá,stormscale,480,paladin,retribution,12,5,7
Chillmachine,stormscale,480,paladin,retribution,12,5,7
Holyrock,grim-batol,480,paladin,retribution,12,5,7
Минорусс,gordunni,480,paladin,retribution,12,5,7
Гниленький,razuvious,480,paladin,retribution,12,5,7
Хикано,gordunni,480,paladin,retribution,12,5,7
Zetnic,kazzak,480,paladin,retribution,12,5,7
Хам,razuvious,480,paladin,retribution,12,5,7
Blazkowicz,twisting-nether,480,paladin,retribution,12,5,7
Pallajalla,the-maelstrom,480,paladin,retribution,12,5,7
Fotmfactory,stormscale,480,paladin,retribution,12,5,7
Emloses,outland,480,paladin,retribution,12,5,7
Свётаякорова,thermaplugg,480,paladin,retribution,12,5,7
Malakbel,ragnaros,480,paladin,retribution,12,5,7
Sérajón,ravencrest,480,paladin,retribution,12,5,7
Bacilla,archimonde,480,paladin,retribution,12,5,7
Роллерблэйд,gordunni,480,paladin,retribution,12,5,7
Fotoniy,kazzak,480,paladin,retribution,12,5,7
Cølalight,aegwynn,480,paladin,retribution,12,5,7
Пашштет,gordunni,480,paladin,retribution,12,5,7
Боремир,borean-tundra,480,paladin,retribution,12,5,7
Биллирэй,gordunni,480,paladin,retribution,12,5,7
Swapxyr,aegwynn,480,paladin,retribution,12,5,7
Скидульф,blackscar,480,paladin,retribution,12,5,7
Milenia,nemesis,480,paladin,retribution,12,5,7
Shirts,ravencrest,480,paladin,retribution,12,5,7
Greckoe,blackhand,480,paladin,retribution,12,5,7
Seráphím,ravencrest,480,paladin,retribution,12,5,7
Ðesolace,twisting-nether,480,paladin,retribution,12,5,7
Trixiee,twisting-nether,480,paladin,retribution,12,5,7
Eldhana,archimonde,480,paladin,retribution,12,5,7
Høj,archimonde,480,paladin,retribution,12,5,7
Goofyret,ravencrest,480,paladin,retribution,12,5,7
Karatus,ravencrest,480,paladin,retribution,12,5,7
Sìlver,conseil-des-ombres,480,paladin,retribution,12,5,7
Heihåå,ravencrest,480,paladin,retribution,12,5,7
Gomadin,azuremyst,480,paladin,retribution,12,5,7
Yuvile,destromath,480,paladin,retribution,12,5,7
Dêstî,silvermoon,480,paladin,retribution,12,5,7
Lyan,archimonde,480,paladin,retribution,12,5,7
Ðarcy,ravencrest,480,paladin,retribution,12,5,7
Retzrik,kazzak,480,paladin,retribution,12,5,7
Mikalia,aegwynn,480,paladin,retribution,12,5,7
Soupra,silvermoon,480,paladin,retribution,12,5,7
Tiduqt,antonidas,480,paladin,retribution,12,5,7
Deathseekerv,saurfang,480,paladin,retribution,12,5,7
Quelly,das-syndikat,480,paladin,retribution,12,5,7
Vladium,argent-dawn,480,paladin,retribution,12,5,7
Kylaz,die-ewige-wacht,480,paladin,retribution,12,5,7
Retina,antonidas,480,paladin,retribution,12,5,7
Palá,dun-modr,480,paladin,retribution,12,5,7
Syjinora,teldrassil,480,paladin,retribution,12,5,7
Clubpaladin,kazzak,480,paladin,retribution,12,5,7
Bascelik,outland,480,paladin,retribution,12,5,7
Pawlouf,hyjal,480,paladin,retribution,12,5,7
Holysznajt,burning-legion,480,paladin,retribution,12,5,7
Valintor,burning-legion,480,paladin,retribution,12,5,7
Kaähz,archimonde,480,paladin,retribution,12,5,7
Karabas,thrall,480,paladin,retribution,12,5,7
Eisenbiaga,blackmoore,480,paladin,retribution,12,5,7
Harakiri,kargath,480,paladin,retribution,12,5,7
Evohammer,silvermoon,480,paladin,retribution,12,5,7
Purplepotato,tarren-mill,480,paladin,retribution,12,5,7
Ichessepopel,blackrock,480,paladin,retribution,12,5,7
Takálus,eredar,480,paladin,retribution,12,5,7
Truman,draenor,480,paladin,retribution,12,5,7
Cêa,blackrock,480,paladin,retribution,12,5,7
Oldo,eredar,480,paladin,retribution,12,5,7
Strangerx,blackrock,480,paladin,retribution,12,5,7
Bvrlyhills,blackrock,480,paladin,retribution,12,5,7
Ksama,ysondre,480,paladin,retribution,12,5,7
Héphäistos,silvermoon,480,paladin,retribution,12,5,7
Miøura,medivh,480,paladin,retribution,12,5,7
Equityy,burning-legion,480,paladin,retribution,12,5,7
Greebless,draenor,480,paladin,retribution,12,5,7
Zanzito,hyjal,480,paladin,retribution,12,5,7
Petrzajonc,outland,480,paladin,retribution,12,5,7
Crupth,outland,480,paladin,retribution,12,5,7
Èternus,blackmoore,480,paladin,retribution,12,5,7
Mikank,dun-modr,480,paladin,retribution,12,5,7
Mecah,hyjal,480,paladin,retribution,12,5,7
Heile,silvermoon,480,paladin,retribution,12,5,7
Zynk,magtheridon,480,paladin,retribution,12,5,7
Ðelusion,sanguino,480,paladin,retribution,12,5,7
Scoobywooby,sanguino,480,paladin,retribution,12,5,7
Instaraid,blackmoore,480,paladin,retribution,12,5,7
Skølir,rashgarroth,480,paladin,retribution,12,5,7
Bassutei,outland,480,paladin,retribution,12,5,7
Hatoms,hyjal,480,paladin,retribution,12,5,7
Valonforth,magtheridon,480,paladin,retribution,12,5,7
Timias,silvermoon,480,paladin,retribution,12,5,7
Palafrugell,sanguino,480,paladin,retribution,12,5,7
Danielbróck,argent-dawn,480,paladin,retribution,12,5,7
Scörpia,sanguino,480,paladin,retribution,12,5,7
Bootysmasher,silvermoon,480,paladin,retribution,12,5,7
Aresian,burning-legion,480,paladin,retribution,13,5,8
Buddala,aerie-peak,480,paladin,retribution,14,5,9
Coome,argent-dawn,480,paladin,retribution,17,5,12
Alliencookie,elune,480,paladin,retribution,21,6,15
Adevald,silvermoon,480,paladin,retribution,18,5,13
Spouny,archimonde,480,paladin,retribution,18,5,13
Roshtrade,stormscale,480,paladin,retribution,18,5,13
Shassera,ravencrest,480,paladin,retribution,18,5,13
Zethhx,stormscale,480,paladin,retribution,18,5,13
Fatalism,draenor,480,paladin,retribution,18,5,13
Meriween,ravencrest,480,paladin,retribution,18,5,13
Aal,eredar,480,paladin,retribution,18,5,13
Diggs,draenor,480,paladin,retribution,18,5,13
Xiuya,dun-modr,480,paladin,retribution,18,5,13
Babyboink,kazzak,480,paladin,retribution,18,5,13
Touchpally,ravencrest,480,paladin,retribution,18,5,13
Cøctab,kirin-tor,480,paladin,retribution,18,5,13
Зеппели,gordunni,480,paladin,retribution,18,5,13
Bildaum,pozzo-delleternità,480,paladin,retribution,18,5,13
Maravena,nazjatar,480,paladin,retribution,18,5,13
Onedayplay,blackmoore,480,paladin,retribution,18,5,13
Trainors,chamber-of-aspects,480,paladin,retribution,18,5,13
Ijego,silvermoon,480,paladin,retribution,18,5,13
Мэркес,fordragon,480,paladin,retribution,18,5,13
Lionie,grim-batol,480,paladin,retribution,18,5,13
Копранесса,soulflayer,480,paladin,retribution,18,5,13
Бладриус,howling-fjord,480,paladin,retribution,18,5,13
Daskel,sanguino,480,paladin,retribution,18,5,13
Teronk,terokkar,480,paladin,retribution,18,5,13
Turbopal,burning-blade,480,paladin,retribution,18,5,13
Legiuneax,darkspear,480,paladin,retribution,18,5,13
Wrathènal,darksorrow,480,paladin,retribution,18,5,13
Светочпок,howling-fjord,480,paladin,retribution,18,5,13
Ywrow,burning-blade,480,paladin,retribution,18,5,13
Eîon,argent-dawn,480,paladin,retribution,18,5,13
Anaùtra,twisting-nether,480,paladin,retribution,24,5,19
Skemfar,sanguino,480,paladin,retribution,24,5,19
Cadearas,antonidas,480,paladin,retribution,24,5,19
Shuiwang,outland,480,paladin,retribution,24,5,19
Exobyte,stormscale,480,paladin,retribution,24,5,19
Korgant,burning-legion,480,paladin,retribution,30,5,25
Amediell,silvermoon,479,paladin,retribution,6,5,1
Phlek,drakthul,479,paladin,retribution,6,5,1
Necroz,madmortem,479,paladin,retribution,6,5,1
Nosliw,frostwolf,479,paladin,retribution,6,5,1
Gødee,silvermoon,479,paladin,retribution,6,5,1
Funtle,kazzak,479,paladin,retribution,12,5,7
Solyra,blackhand,479,paladin,retribution,12,5,7
Angelwings,nefarian,479,paladin,retribution,12,5,7
Brammers,doomhammer,479,paladin,retribution,12,5,7
Bakasnoop,hyjal,479,paladin,retribution,12,5,7
Teuterix,drakthul,479,paladin,retribution,12,5,7
Missti,azjolnerub,479,paladin,retribution,12,5,7
Dykopala,doomhammer,479,paladin,retribution,12,5,7
Grannybash,silvermoon,479,paladin,retribution,12,5,7
Lightsblood,outland,479,paladin,retribution,12,5,7
Taffz,burning-legion,479,paladin,retribution,12,5,7
Сасмен,blackscar,479,paladin,retribution,12,5,7
Rettarded,draenor,479,paladin,retribution,12,5,7
Tomforøl,aggramar,479,paladin,retribution,12,5,7
Bullser,anubarak,479,paladin,retribution,12,5,7
Zelenskiy,ravencrest,479,paladin,retribution,12,5,7
Subzerox,ravenholdt,479,paladin,retribution,12,5,7
Майнстер,gordunni,479,paladin,retribution,12,5,7
Hadthur,ragnaros,479,paladin,retribution,12,5,7
Ibus,silvermoon,479,paladin,retribution,12,5,7
Minervre,confrérie-du-thorium,479,paladin,retribution,12,5,7
Pyhälehmä,alakir,479,paladin,retribution,12,5,7
Nemestörp,silvermoon,479,paladin,retribution,12,5,7
Aion,chamber-of-aspects,479,paladin,retribution,18,5,13
Eriesh,cthun,479,paladin,retribution,18,5,13
Aelaris,dunemaul,479,paladin,retribution,18,5,13
Azhodiir,the-maelstrom,479,paladin,retribution,24,5,19
Klumie,silvermoon,479,paladin,retribution,24,5,19
Mysticlight,sylvanas,478,paladin,retribution,18,8,10
Aluken,nemesis,478,paladin,retribution,12,5,7
Shrékhead,hellfire,478,paladin,retribution,12,5,7
Nerdcore,blackrock,478,paladin,retribution,12,5,7
Mirelaw,drakthul,478,paladin,retribution,12,5,7
Holydaybro,doomhammer,478,paladin,retribution,12,5,7
Четкийчервь,soulflayer,478,paladin,retribution,18,5,13
Holyfriend,kazzak,478,paladin,retribution,18,5,13
Luminix,ragnaros,477,paladin,retribution,12,5,7
Chofre,thunderhorn,477,paladin,retribution,18,5,13
Zantria,alleria,476,paladin,retribution,12,5,7
ßell,antonidas,475,paladin,retribution,12,5,7
Magott,doomhammer,475,paladin,retribution,12,5,7
Lysân,eredar,475,paladin,retribution,12,5,7
Palabrïsa,sanguino,474,paladin,retribution,15,6,9
Parkla,twisting-nether,473,paladin,retribution,12,5,7
Корвинхорн,soulflayer,473,paladin,retribution,24,8,16
Hateze,kazzak,472,paladin,retribution,12,5,7
Yeretria,krasus,472,paladin,retribution,12,5,7
Yeohinyiu,khaz-modan,472,paladin,retribution,12,5,7
Stunheallol,blackrock,448,paladin,retribution,10,5,5
Чиленикс,soulflayer,447,paladin,retribution,8,6,2
Гкм,howling-fjord,447,paladin,retribution,11,5,6
Sacro,quelthalas,447,paladin,retribution,11,5,6
Slayton,twisting-nether,447,paladin,retribution,11,5,6
Seirén,grim-batol,447,paladin,retribution,11,5,6
Kevlar,frostmane,446,paladin,retribution,18,6,12
Emîly,blackrock,432,paladin,retribution,15,5,10
Åvra,ysondre,432,paladin,retribution,15,5,10
Påladinmamma,sunstrider,431,paladin,retribution,11,5,6
Sunnyboy,tarren-mill,431,paladin,retribution,11,5,6
Baazza,chamber-of-aspects,430,paladin,retribution,15,5,10
Siirrinna,tarren-mill,426,paladin,retribution,12,6,6
Бэнсон,ashenvale,426,paladin,retribution,15,6,9
Mipendz,draenor,426,paladin,retribution,22,6,16
Zell,silvermoon,414,paladin,retribution,16,5,11
Kûlu,alakir,410,paladin,retribution,10,5,5
Паланр,fordragon,400,paladin,retribution,7,5,2
Zouppis,ravencrest,400,paladin,retribution,7,5,2
Dunksunk,draenor,399,paladin,retribution,13,5,8
Pilowpallo,kazzak,398,paladin,retribution,13,5,8
Nikodemus,stormreaver,398,paladin,retribution,13,5,8
Célésté,ravencrest,393,paladin,retribution,16,7,9
Virdis,tarren-mill,384,paladin,retribution,6,4,2
Baradus,ragnaros,384,paladin,retribution,6,4,2
Dagren,arathor,384,paladin,retribution,6,4,2
Yasuö,argent-dawn,384,paladin,retribution,6,4,2
Morgoth,daggerspine,384,paladin,retribution,6,4,2
Sukársugár,silvermoon,384,paladin,retribution,6,4,2
Wertre,sanguino,384,paladin,retribution,6,4,2
Haldeimau,argent-dawn,384,paladin,retribution,6,4,2
Palatitude,archimonde,384,paladin,retribution,6,4,2
Mariahuana,sanguino,384,paladin,retribution,6,4,2
Naweed,kazzak,384,paladin,retribution,6,4,2
Axpala,ragnaros,384,paladin,retribution,6,4,2
Tigurius,zuljin,384,paladin,retribution,6,4,2
Volkai,zuljin,384,paladin,retribution,6,4,2
Хегр,soulflayer,384,paladin,retribution,6,4,2
Colpadeltank,kazzak,384,paladin,retribution,6,4,2
Synnas,hyjal,384,paladin,retribution,6,4,2
Malcolmx,sanguino,384,paladin,retribution,6,4,2
Kraco,tarren-mill,384,paladin,retribution,6,4,2
Windtwoo,tarren-mill,384,paladin,retribution,6,4,2
Лиадринель,howling-fjord,384,paladin,retribution,6,4,2
Eorzea,auchindoun,384,paladin,retribution,6,4,2
Judercy,kaelthas,384,paladin,retribution,6,4,2
Diran,sanguino,384,paladin,retribution,6,4,2
Blessingtits,sylvanas,384,paladin,retribution,6,4,2
Utherion,ysera,384,paladin,retribution,6,4,2
Sabriaña,silvermoon,384,paladin,retribution,6,4,2
Akamis,drakthul,384,paladin,retribution,6,4,2
Zùlka,krasus,384,paladin,retribution,6,4,2
Támìndòr,alleria,384,paladin,retribution,6,4,2
Драгмитухел,gordunni,384,paladin,retribution,6,4,2
Nezgrôs,hyjal,384,paladin,retribution,6,4,2
Бабичпал,soulflayer,384,paladin,retribution,6,4,2
Léona,hyjal,384,paladin,retribution,6,4,2
Tauràdin,blackhand,384,paladin,retribution,6,4,2
Cake,alakir,384,paladin,retribution,6,4,2
Marmotaxx,dun-modr,384,paladin,retribution,6,4,2
Thrillhouse,dun-morogh,384,paladin,retribution,6,4,2
Madarä,arathi,384,paladin,retribution,6,4,2
Serafini,doomhammer,384,paladin,retribution,6,4,2
Shadoopala,silvermoon,384,paladin,retribution,6,4,2
Elenia,baelgun,384,paladin,retribution,6,4,2
Rektardin,quelthalas,384,paladin,retribution,6,4,2
Lightbreak,quelthalas,384,paladin,retribution,6,4,2
Sunstrider,quelthalas,384,paladin,retribution,6,4,2
Kkrrh,kragjin,384,paladin,retribution,6,4,2
Jaime,magtheridon,384,paladin,retribution,6,4,2
Égi,azshara,384,paladin,retribution,6,4,2
Arcillus,stormscale,384,paladin,retribution,6,4,2
Lightmachine,kirin-tor,384,paladin,retribution,6,4,2
Wiither,argent-dawn,384,paladin,retribution,6,4,2
Paínzy,blackmoore,384,paladin,retribution,6,4,2
Phiana,blackmoore,384,paladin,retribution,6,4,2
Johnyb,stormscale,384,paladin,retribution,6,4,2
Knobgreaser,silvermoon,384,paladin,retribution,6,4,2
Кукусяшка,gordunni,384,paladin,retribution,6,4,2
Unhittable,draenor,384,paladin,retribution,6,4,2
Ajany,blackmoore,384,paladin,retribution,6,4,2
Haudrupp,blackmoore,384,paladin,retribution,6,4,2
Æmiø,blackmoore,384,paladin,retribution,6,4,2
Соргосош,gordunni,384,paladin,retribution,6,4,2
Veléxis,outland,384,paladin,retribution,6,4,2
Toratoratora,blackmoore,384,paladin,retribution,6,4,2
Gérin,blackmoore,384,paladin,retribution,6,4,2
Dragongîrl,lothar,384,paladin,retribution,6,4,2
Whiteflash,archimonde,384,paladin,retribution,6,4,2
Ballefrikase,tarren-mill,384,paladin,retribution,6,4,2
Джиблэйд,gordunni,384,paladin,retribution,6,4,2
Jamzypaladin,kazzak,384,paladin,retribution,6,4,2
Клэйсонгодхх,gordunni,384,paladin,retribution,6,4,2
Peacekeep,stormscale,384,paladin,retribution,6,4,2
Унаги,borean-tundra,384,paladin,retribution,6,4,2
Gunnhilde,stormscale,384,paladin,retribution,6,4,2
Raratina,draenor,384,paladin,retribution,6,4,2
Позабытый,deathweaver,384,paladin,retribution,6,4,2
Oriath,draenor,384,paladin,retribution,6,4,2
Raek,stormscale,384,paladin,retribution,6,4,2
Naaruda,kazzak,384,paladin,retribution,6,4,2
Keem,aszune,384,paladin,retribution,6,4,2
Судья,greymane,384,paladin,retribution,6,4,2
Babycoomer,draenor,384,paladin,retribution,6,4,2
Âmroth,blackrock,384,paladin,retribution,6,4,2
Фоггихохо,gordunni,384,paladin,retribution,6,4,2
Tritôn,draenor,384,paladin,retribution,6,4,2
Malaquè,blackrock,384,paladin,retribution,6,4,2
Heatace,blackrock,384,paladin,retribution,6,4,2
Любитель,azuregos,384,paladin,retribution,6,4,2
Zhàø,ysondre,384,paladin,retribution,6,4,2
Hulkebulle,silvermoon,384,paladin,retribution,6,4,2
Zeggayoda,nemesis,384,paladin,retribution,6,4,2
Buffoon,twisting-nether,384,paladin,retribution,6,4,2
Referee,blackrock,384,paladin,retribution,6,4,2
Gotrehk,nemesis,384,paladin,retribution,6,4,2
Idin,nemesis,384,paladin,retribution,6,4,2
Elwenepal,archimonde,384,paladin,retribution,6,4,2
Bearwlkn,ravencrest,384,paladin,retribution,6,4,2
Hølyspit,nemesis,384,paladin,retribution,6,4,2
Aprânax,twisting-nether,384,paladin,retribution,6,4,2
Slowjob,eredar,384,paladin,retribution,6,4,2
Rölfchen,frostwolf,384,paladin,retribution,6,4,2
Melastra,thrall,384,paladin,retribution,6,4,2
Chobb,thunderhorn,384,paladin,retribution,6,4,2
Tigér,ravencrest,384,paladin,retribution,6,4,2
Baldcvnt,ravencrest,384,paladin,retribution,6,4,2
Miskok,twisting-nether,384,paladin,retribution,6,4,2
Qouart,antonidas,384,paladin,retribution,6,4,2
Spartacøn,kazzak,384,paladin,retribution,6,4,2
Daddyolimpp,kazzak,384,paladin,retribution,6,4,2
Shevøçk,ravencrest,384,paladin,retribution,6,4,2
Naizem,dun-modr,384,paladin,retribution,6,4,2
Grymä,archimonde,384,paladin,retribution,6,4,2
Firfiris,twisting-nether,384,paladin,retribution,6,4,2
Zeportpala,archimonde,384,paladin,retribution,6,4,2
Tyarel,aegwynn,384,paladin,retribution,6,4,2
Missmyhoj,archimonde,384,paladin,retribution,6,4,2
Crussaden,stormscale,384,paladin,retribution,7,4,3
Lotarios,tarren-mill,384,paladin,retribution,9,5,4
Ashengelm,silvermoon,384,paladin,retribution,9,5,4
Vondab,ravencrest,384,paladin,retribution,10,5,5
Knugadin,stormscale,384,paladin,retribution,12,5,7
Erebir,burning-blade,384,paladin,retribution,11,4,7
Palnox,blackrock,384,paladin,retribution,11,4,7
Хилвкд,blackscar,384,paladin,retribution,11,4,7
Athênâ,azjolnerub,384,paladin,retribution,15,5,10
Bugohoss,nathrezim,384,paladin,retribution,12,4,8
Enkidu,guldan,384,paladin,retribution,12,4,8
Nicolae,saurfang,384,paladin,retribution,12,4,8
Ivarlordbroc,hyjal,384,paladin,retribution,12,4,8
Санзар,howling-fjord,384,paladin,retribution,12,4,8
Cartell,dun-morogh,384,paladin,retribution,12,4,8
Celilinda,kiljaeden,384,paladin,retribution,12,4,8
Bubatzine,dun-morogh,384,paladin,retribution,12,4,8
Kyrín,onyxia,384,paladin,retribution,12,4,8
Stoneð,antonidas,384,paladin,retribution,12,4,8
Elyeasia,silvermoon,384,paladin,retribution,12,4,8
Xirôs,zirkel-des-cenarius,384,paladin,retribution,12,4,8
ßellstarz,archimonde,384,paladin,retribution,12,4,8
Mystràs,khaz-modan,384,paladin,retribution,12,4,8
Palapaye,archimonde,384,paladin,retribution,12,4,8
Tjú,mannoroth,384,paladin,retribution,12,4,8
Trumputin,ravencrest,384,paladin,retribution,12,4,8
Justífiéd,kazzak,384,paladin,retribution,12,4,8
Dennyboy,sylvanas,384,paladin,retribution,12,4,8
Yeetholy,ragnaros,384,paladin,retribution,12,4,8
Stjusmussel,ragnaros,384,paladin,retribution,12,4,8
Lionknight,sylvanas,384,paladin,retribution,12,4,8
Brolaf,drakthul,384,paladin,retribution,12,4,8
Bundagains,silvermoon,384,paladin,retribution,12,4,8
Mjjolnir,doomhammer,384,paladin,retribution,12,4,8
Rahhem,burning-legion,384,paladin,retribution,12,4,8
Cafa,turalyon,384,paladin,retribution,12,4,8
Arkkipiispa,outland,384,paladin,retribution,12,4,8
Øazimutø,archimonde,384,paladin,retribution,12,4,8
Reedaa,shattered-hand,384,paladin,retribution,12,4,8
Sgiach,draenor,384,paladin,retribution,12,4,8
Ildarian,kazzak,384,paladin,retribution,12,4,8
Thaemónd,draenor,384,paladin,retribution,12,4,8
Lightwimer,zuljin,384,paladin,retribution,12,4,8
Chïefen,twisting-nether,384,paladin,retribution,12,4,8
Heidfield,draenor,384,paladin,retribution,12,4,8
Calarion,thrall,384,paladin,retribution,12,4,8
Gahar,grim-batol,384,paladin,retribution,12,4,8
Decroma,dalaran,384,paladin,retribution,12,4,8
Cyban,twisting-nether,384,paladin,retribution,12,4,8
Popelarr,burning-blade,384,paladin,retribution,12,4,8
Raudo,stormscale,384,paladin,retribution,12,4,8
Etzann,draenor,384,paladin,retribution,12,4,8
Светиздырки,howling-fjord,384,paladin,retribution,12,4,8
Takopa,twisting-nether,384,paladin,retribution,12,4,8
Thiccdeeps,aegwynn,384,paladin,retribution,12,4,8
Shealby,thrall,384,paladin,retribution,12,4,8
Trainer,madmortem,384,paladin,retribution,12,4,8
Héraclèss,marécage-de-zangar,384,paladin,retribution,12,4,8
Pansarplåt,argent-dawn,384,paladin,retribution,12,4,8
Crowdev,zuljin,384,paladin,retribution,12,4,8
Lástchaos,madmortem,384,paladin,retribution,12,4,8
Mehighlaw,chamber-of-aspects,384,paladin,retribution,12,4,8
Ревирант,howling-fjord,384,paladin,retribution,12,4,8
Бойкийкот,eversong,384,paladin,retribution,12,4,8
Drugin,amanthul,384,paladin,retribution,12,4,8
Rèdjàck,nemesis,384,paladin,retribution,12,4,8
Катсес,eversong,384,paladin,retribution,12,4,8
Cyborg,ysondre,384,paladin,retribution,12,4,8
Hasart,tarren-mill,384,paladin,retribution,12,4,8
Kimozabie,ravencrest,384,paladin,retribution,12,4,8
Astamye,ysondre,384,paladin,retribution,12,4,8
Димаходж,blackscar,384,paladin,retribution,12,4,8
Alawdi,ysondre,384,paladin,retribution,12,4,8
Sorkara,argent-dawn,384,paladin,retribution,12,4,8
Lazorx,eredar,384,paladin,retribution,12,4,8
Highcrown,argent-dawn,384,paladin,retribution,12,4,8
Eddiefanboy,eredar,384,paladin,retribution,12,4,8
Jericcho,dun-modr,384,paladin,retribution,12,4,8
Failhammer,tarren-mill,384,paladin,retribution,12,4,8
Киилаа,gordunni,384,paladin,retribution,12,4,8
Эсмория,gordunni,384,paladin,retribution,12,4,8
Поддыхдам,gordunni,384,paladin,retribution,12,4,8
Granberg,twisting-nether,384,paladin,retribution,12,4,8
Lopal,silvermoon,384,paladin,retribution,12,4,8
Powerking,ragnaros,384,paladin,retribution,12,4,8
Турбобит,gordunni,384,paladin,retribution,12,4,8
Prómetheus,malygos,384,paladin,retribution,12,4,8
Ðrisk,defias-brotherhood,384,paladin,retribution,12,4,8
Рокстум,gordunni,384,paladin,retribution,12,4,8
Cørleena,eredar,384,paladin,retribution,12,4,8
Эвирглайт,gordunni,384,paladin,retribution,12,4,8
Зираэлис,gordunni,384,paladin,retribution,12,4,8
Louxoxo,ravencrest,384,paladin,retribution,12,4,8
Розовыйбабл,gordunni,384,paladin,retribution,12,4,8
Zlatniq,kazzak,384,paladin,retribution,12,4,8
Divinetoll,argent-dawn,384,paladin,retribution,12,4,8
Ambîorix,dun-modr,384,paladin,retribution,12,4,8
Hyduriak,lightnings-blade,384,paladin,retribution,12,4,8
Xerya,dun-modr,384,paladin,retribution,12,4,8
Æternal,arathor,384,paladin,retribution,12,4,8
Gellmar,the-maelstrom,384,paladin,retribution,12,4,8
Zarifence,ragnaros,384,paladin,retribution,12,4,8
Somaxpala,burning-legion,384,paladin,retribution,12,4,8
Isyllë,dalaran,384,paladin,retribution,12,4,8
Beefdaddykuu,ravencrest,384,paladin,retribution,12,4,8
Скруддж,howling-fjord,384,paladin,retribution,12,4,8
Pecar,stormscale,384,paladin,retribution,12,4,8
Avengence,dragonblight,384,paladin,retribution,12,4,8
Beefcake,bladefist,384,paladin,retribution,12,4,8
Karsini,arathor,384,paladin,retribution,12,4,8
Ríék,lightbringer,384,paladin,retribution,12,4,8
Kielonpala,kazzak,384,paladin,retribution,12,4,8
Artoriaz,ravencrest,384,paladin,retribution,12,4,8
Lucretius,kilrogg,384,paladin,retribution,12,4,8
Encoreret,kilrogg,384,paladin,retribution,12,4,8
Lullabye,runetotem,384,paladin,retribution,12,4,8
Dishla,stormscale,384,paladin,retribution,12,4,8
Flashycactús,azjolnerub,384,paladin,retribution,12,4,8
Blockitp,stormscale,384,paladin,retribution,12,4,8
Ekber,ravencrest,384,paladin,retribution,12,4,8
Grymbol,boulderfist,384,paladin,retribution,12,4,8
Meatslice,boulderfist,384,paladin,retribution,12,4,8
Jiby,twisting-nether,384,paladin,retribution,12,4,8
Дрейв,soulflayer,384,paladin,retribution,12,4,8
Бронеаптечка,soulflayer,384,paladin,retribution,12,4,8
Caedîs,antonidas,384,paladin,retribution,13,4,9
Douglazz,tarren-mill,384,paladin,retribution,13,4,9
Garzad,ravencrest,384,paladin,retribution,18,4,14
Pepegasensei,ravencrest,384,paladin,retribution,18,4,14
Vacalistarr,los-errantes,384,paladin,retribution,18,4,14
Retfull,sylvanas,384,paladin,retribution,18,4,14
Franciscø,conseil-des-ombres,384,paladin,retribution,18,4,14
Notnding,draenor,384,paladin,retribution,18,4,14
Palafis,doomhammer,384,paladin,retribution,18,4,14
Forthy,drakthul,384,paladin,retribution,18,4,14
Caribbean,outland,384,paladin,retribution,18,4,14
Masuroc,antonidas,384,paladin,retribution,18,4,14
Kretheus,argent-dawn,384,paladin,retribution,18,4,14
Отчо,gordunni,384,paladin,retribution,18,4,14
Sánexe,blackrock,384,paladin,retribution,18,4,14
Neyd,hyjal,384,paladin,retribution,18,4,14
Wftw,draenor,384,paladin,retribution,18,4,14
Synáx,blackhand,384,paladin,retribution,18,4,14
Orbia,draenor,384,paladin,retribution,18,4,14
Galaerøn,elune,384,paladin,retribution,18,4,14
Thoryel,ravencrest,384,paladin,retribution,18,4,14
Trismegistos,bloodhoof,384,paladin,retribution,18,4,14
Minfa,argent-dawn,384,paladin,retribution,18,4,14
Ruttodidio,outland,384,paladin,retribution,18,4,14
Erïn,rexxar,384,paladin,retribution,23,4,19
Ibubbleqt,outland,384,paladin,retribution,24,4,20
Elisun,twisting-nether,384,paladin,retribution,24,4,20
Zerosixsix,silvermoon,384,paladin,retribution,24,4,20
Hadok,uldaman,383,paladin,retribution,6,4,2
Sphïnx,dun-modr,383,paladin,retribution,6,4,2
Рукаф,soulflayer,383,paladin,retribution,6,4,2
Lancelhot,archimonde,383,paladin,retribution,6,4,2
Микацури,howling-fjord,383,paladin,retribution,6,4,2
Toküt,elune,383,paladin,retribution,6,4,2
Одиннадцатый,ashenvale,383,paladin,retribution,6,4,2
Krögerelf,garrosh,383,paladin,retribution,6,4,2
Supersnubben,grim-batol,383,paladin,retribution,6,4,2
Purometa,silvermoon,383,paladin,retribution,6,4,2
Haseldin,dun-modr,383,paladin,retribution,15,5,10
Chunpala,silvermoon,383,paladin,retribution,12,4,8
Elvyri,silvermoon,383,paladin,retribution,12,4,8
Syrenia,die-silberne-hand,383,paladin,retribution,12,4,8
Haggís,blackrock,383,paladin,retribution,12,4,8
Giuliagirod,kazzak,383,paladin,retribution,12,4,8
Hélls,sargeras,383,paladin,retribution,12,4,8
Faragevult,defias-brotherhood,383,paladin,retribution,12,4,8
Hilkisen,ragnaros,383,paladin,retribution,12,4,8
Schmetterlin,aszune,383,paladin,retribution,12,4,8
Ságé,thrall,383,paladin,retribution,16,4,12
Lavacalistar,turalyon,383,paladin,retribution,21,5,16
Shurikèn,khaz-modan,382,paladin,retribution,6,4,2
Larth,the-maelstrom,382,paladin,retribution,6,4,2
Zuklaus,hyjal,380,paladin,retribution,10,5,5
Naiirah,aegwynn,380,paladin,retribution,12,4,8
Kulgan,aerie-peak,380,paladin,retribution,12,4,8
Anyhra,forscherliga,380,paladin,retribution,12,4,8
Palastratos,turalyon,379,paladin,retribution,12,4,8
Errn,ragnaros,367,paladin,retribution,11,4,7
Бомбящая,howling-fjord,367,paladin,retribution,11,4,7
Quietus,archimonde,352,paladin,retribution,10,4,6
Emakk,darksorrow,351,paladin,retribution,8,5,3
Holyfristy,ragnaros,351,paladin,retribution,11,4,7
Taigetos,draenor,351,paladin,retribution,11,4,7
Kantfyrste,ravencrest,351,paladin,retribution,11,4,7
Madzy,archimonde,351,paladin,retribution,11,4,7
Lorellion,burning-legion,351,paladin,retribution,11,4,7
Joeintkaa,ragnaros,351,paladin,retribution,11,4,7
Alerorn,kazzak,351,paladin,retribution,11,4,7
Freemain,doomhammer,336,paladin,retribution,9,4,5
Strcker,sylvanas,336,paladin,retribution,9,4,5
Methoss,ravencrest,336,paladin,retribution,19,5,14
Aufstapelnx,hyjal,335,paladin,retribution,11,4,7
Alanore,tarren-mill,330,paladin,retribution,13,6,7
Каплясвета,gordunni,330,paladin,retribution,15,5,10
Vcd,kazzak,329,paladin,retribution,15,6,9
Paladore,chogall,329,paladin,retribution,41,6,35
Tharión,thrall,320,paladin,retribution,10,4,6
Glâdiatør,blackrock,320,paladin,retribution,10,4,6
Qpax,twisting-nether,320,paladin,retribution,10,4,6
Pétaìn,archimonde,320,paladin,retribution,16,4,12
Kyazar,sylvanas,319,paladin,retribution,5,4,1
Jadest,krasus,319,paladin,retribution,5,4,1
Bossit,skullcrusher,319,paladin,retribution,5,4,1
Donkahonk,argent-dawn,319,paladin,retribution,5,4,1
Vermilia,blackmoore,319,paladin,retribution,8,4,4
Strìke,ragnaros,319,paladin,retribution,8,4,4
Артуроэльф,eversong,318,paladin,retribution,11,4,7
Брюхатая,howling-fjord,288,paladin,retribution,6,3,3
Vîdelle,eldrethalas,288,paladin,retribution,6,3,3
Ærøn,temple-noir,288,paladin,retribution,6,3,3
Skullangel,illidan,288,paladin,retribution,6,3,3
Белоус,howling-fjord,288,paladin,retribution,6,3,3
Кокрыж,fordragon,288,paladin,retribution,6,3,3
Laycie,kazzak,288,paladin,retribution,6,3,3
Rômtone,dalaran,288,paladin,retribution,6,3,3
Minirempart,khaz-modan,288,paladin,retribution,6,3,3
Yalen,ragnaros,288,paladin,retribution,6,3,3
Ragehuf,malganis,288,paladin,retribution,6,3,3
Ownädin,ragnaros,288,paladin,retribution,6,3,3
Amq,blackhand,288,paladin,retribution,6,3,3
Quelth,kazzak,288,paladin,retribution,6,3,3
Aoldur,ragnaros,288,paladin,retribution,6,3,3
Bigtasty,malganis,288,paladin,retribution,6,3,3
Fourside,ragnaros,288,paladin,retribution,6,3,3
Moolurk,stormscale,288,paladin,retribution,6,3,3
Sírväs,stormscale,288,paladin,retribution,6,3,3
Animegifx,ragnaros,288,paladin,retribution,6,3,3
Nubalas,kazzak,288,paladin,retribution,6,3,3
Môôses,kazzak,288,paladin,retribution,6,3,3
Joakìim,stormscale,288,paladin,retribution,6,3,3
Chilipala,stormscale,288,paladin,retribution,6,3,3
Thunderwoman,ragnaros,288,paladin,retribution,6,3,3
Illmindofyou,twisting-nether,288,paladin,retribution,6,3,3
Dolleboy,twisting-nether,288,paladin,retribution,6,3,3
Împala,twisting-nether,288,paladin,retribution,6,3,3
Kagarottx,kazzak,288,paladin,retribution,6,3,3
Heyley,twisting-nether,288,paladin,retribution,6,3,3
Deadpally,twisting-nether,288,paladin,retribution,6,3,3
Stibons,twisting-nether,288,paladin,retribution,6,3,3
Freakks,twisting-nether,288,paladin,retribution,6,3,3
Kapsloch,twisting-nether,288,paladin,retribution,6,3,3
Senteha,stormscale,288,paladin,retribution,6,3,3
Baconhammer,ravencrest,288,paladin,retribution,6,3,3
Nosn,ravencrest,288,paladin,retribution,6,3,3
Sérath,twisting-nether,288,paladin,retribution,6,3,3
Grozdanus,ravencrest,288,paladin,retribution,6,3,3
Muieiulica,twisting-nether,288,paladin,retribution,6,3,3
Quiçkér,kazzak,288,paladin,retribution,6,3,3
Drstomp,ravencrest,288,paladin,retribution,6,3,3
Natso,kazzak,288,paladin,retribution,6,3,3
Oodödlig,twisting-nether,288,paladin,retribution,6,3,3
Novà,ravencrest,288,paladin,retribution,6,3,3
Fogell,ravencrest,288,paladin,retribution,6,3,3
Синтел,eversong,288,paladin,retribution,6,3,3
Sarunan,ravencrest,288,paladin,retribution,6,3,3
Cowmanman,kazzak,288,paladin,retribution,6,3,3
Shaká,ravencrest,288,paladin,retribution,6,3,3
Taukkï,kazzak,288,paladin,retribution,6,3,3
Skìðåððlè,antonidas,288,paladin,retribution,6,3,3
Зои,lich-king,288,paladin,retribution,6,3,3
Cucla,the-maelstrom,288,paladin,retribution,6,3,3
Мортлайт,soulflayer,288,paladin,retribution,6,3,3
Баблвгкд,soulflayer,288,paladin,retribution,6,3,3
Neoz,ravencrest,288,paladin,retribution,6,3,3
Sekoran,sunstrider,288,paladin,retribution,6,3,3
Paladus,laughing-skull,288,paladin,retribution,6,3,3
Perseusz,trollbane,288,paladin,retribution,6,3,3
Hebegebe,runetotem,288,paladin,retribution,6,3,3
Bolondpali,arathor,288,paladin,retribution,6,3,3
Veo,sylvanas,288,paladin,retribution,6,3,3
Hurtwhenipee,ravencrest,288,paladin,retribution,6,3,3
Faté,madmortem,288,paladin,retribution,6,3,3
Holyshot,sylvanas,288,paladin,retribution,6,3,3
Dominoeffect,sylvanas,288,paladin,retribution,6,3,3
Foichtgebet,silvermoon,288,paladin,retribution,6,3,3
Cyberdaddy,sylvanas,288,paladin,retribution,6,3,3
Dadsa,antonidas,288,paladin,retribution,6,3,3
Xirac,antonidas,288,paladin,retribution,6,3,3
Jonkeer,kazzak,288,paladin,retribution,6,3,3
Daemøs,antonidas,288,paladin,retribution,6,3,3
Valiena,sylvanas,288,paladin,retribution,6,3,3
Nakariâ,antonidas,288,paladin,retribution,6,3,3
Моринингстар,howling-fjord,288,paladin,retribution,6,3,3
Londrette,kazzak,288,paladin,retribution,6,3,3
Sakulchan,antonidas,288,paladin,retribution,6,3,3
Nympa,sylvanas,288,paladin,retribution,6,3,3
Guko,frostwolf,288,paladin,retribution,6,3,3
Khredo,eredar,288,paladin,retribution,6,3,3
Thomususholy,silvermoon,288,paladin,retribution,6,3,3
Бигтедо,gordunni,288,paladin,retribution,6,3,3
Рамстафарай,gordunni,288,paladin,retribution,6,3,3
Noanoshy,eredar,288,paladin,retribution,6,3,3
Лидрезера,gordunni,288,paladin,retribution,6,3,3
Sakùrâ,eredar,288,paladin,retribution,6,3,3
Хилвиновен,gordunni,288,paladin,retribution,6,3,3
Grial,eredar,288,paladin,retribution,6,3,3
Баблодинх,gordunni,288,paladin,retribution,6,3,3
Rhadamentes,ysondre,288,paladin,retribution,6,3,3
Кузнейц,borean-tundra,288,paladin,retribution,6,3,3
Маллинка,blackscar,288,paladin,retribution,6,3,3
Ashalanor,kazzak,288,paladin,retribution,6,3,3
Lyrïcs,ysondre,288,paladin,retribution,6,3,3
Belåkor,silvermoon,288,paladin,retribution,6,3,3
Milesteris,medivh,288,paladin,retribution,6,3,3
Woolylight,draenor,288,paladin,retribution,6,3,3
Watchmestomp,draenor,288,paladin,retribution,6,3,3
Sparckqt,nemesis,288,paladin,retribution,6,3,3
Kelsumi,draenor,288,paladin,retribution,6,3,3
Isgarot,pozzo-delleternità,288,paladin,retribution,6,3,3
Vaciusta,silvermoon,288,paladin,retribution,6,3,3
Aimeé,chamber-of-aspects,288,paladin,retribution,6,3,3
Kristalos,aegwynn,288,paladin,retribution,6,3,3
Trovlie,aegwynn,288,paladin,retribution,6,3,3
Frostygar,draenor,288,paladin,retribution,6,3,3
Ñusret,aegwynn,288,paladin,retribution,6,3,3
Exero,frostmane,288,paladin,retribution,6,3,3
Epipheny,frostmane,288,paladin,retribution,6,3,3
Movalli,silvermoon,288,paladin,retribution,6,3,3
Turbotommie,draenor,288,paladin,retribution,6,3,3
Clamjamm,draenor,288,paladin,retribution,6,3,3
Seriosman,grim-batol,288,paladin,retribution,6,3,3
Sheytanâ,archimonde,288,paladin,retribution,6,3,3
Bigbosschou,draenor,288,paladin,retribution,6,3,3
Tørque,archimonde,288,paladin,retribution,6,3,3
Hyroshima,archimonde,288,paladin,retribution,6,3,3
Urshaky,silvermoon,288,paladin,retribution,6,3,3
Tartifume,kirin-tor,288,paladin,retribution,6,3,3
Myrtîllê,archimonde,288,paladin,retribution,6,3,3
Dyonisøs,archimonde,288,paladin,retribution,6,3,3
Tooko,archimonde,288,paladin,retribution,6,3,3
Røllßàck,archimonde,288,paladin,retribution,6,3,3
Reptoglad,archimonde,288,paladin,retribution,6,3,3
Hidån,archimonde,288,paladin,retribution,6,3,3
Édéssá,turalyon,288,paladin,retribution,6,3,3
Dédoniste,archimonde,288,paladin,retribution,6,3,3
Ashbringher,turalyon,288,paladin,retribution,6,3,3
Golgel,turalyon,288,paladin,retribution,6,3,3
Kùrylolz,archimonde,288,paladin,retribution,6,3,3
Ênmâ,archimonde,288,paladin,retribution,6,3,3
Grinchman,outland,288,paladin,retribution,6,3,3
Tonynox,hyjal,288,paladin,retribution,6,3,3
Astralenigma,hyjal,288,paladin,retribution,6,3,3
Saintjustice,hyjal,288,paladin,retribution,6,3,3
Lixîa,hyjal,288,paladin,retribution,6,3,3
Blackevill,outland,288,paladin,retribution,6,3,3
Bashx,outland,288,paladin,retribution,6,3,3
Garundel,outland,288,paladin,retribution,6,3,3
Zeltose,uldaman,288,paladin,retribution,6,3,3
Bertolt,emerald-dream,288,paladin,retribution,6,3,3
Stárchy,terenas,288,paladin,retribution,6,3,3
Sangriul,outland,288,paladin,retribution,6,3,3
Trokas,theradras,288,paladin,retribution,6,3,3
Vaillants,throkferoth,288,paladin,retribution,6,3,3
Scärlette,sargeras,288,paladin,retribution,6,3,3
Sixtynien,outland,288,paladin,retribution,6,3,3
Crazydiamond,garona,288,paladin,retribution,6,3,3
Mayhem,area-52,288,paladin,retribution,6,3,3
Karligolas,arygos,288,paladin,retribution,6,3,3
Meezu,ravencrest,288,paladin,retribution,6,3,3
Synthesis,uldum,288,paladin,retribution,6,3,3
Vhaine,kult-der-verdammten,288,paladin,retribution,6,3,3
Drwings,drakthul,288,paladin,retribution,6,3,3
Dathrohan,sanguino,288,paladin,retribution,6,3,3
Evenja,ambossar,288,paladin,retribution,6,3,3
Anniangel,sanguino,288,paladin,retribution,6,3,3
Dömö,burning-blade,288,paladin,retribution,6,3,3
Ïrönhämmër,argent-dawn,288,paladin,retribution,6,3,3
Paidi,die-todeskrallen,288,paladin,retribution,6,3,3
Raketenreiko,blackrock,288,paladin,retribution,6,3,3
Ozen,blackrock,288,paladin,retribution,6,3,3
Krístjan,silvermoon,288,paladin,retribution,6,3,3
Juicydips,blackrock,288,paladin,retribution,6,3,3
Khrogan,bronzebeard,288,paladin,retribution,6,3,3
Lyann,bronzebeard,288,paladin,retribution,6,3,3
Crashband,bronzebeard,288,paladin,retribution,6,3,3
Xdìa,silvermoon,288,paladin,retribution,6,3,3
Partysyster,defias-brotherhood,288,paladin,retribution,6,3,3
Goldarthas,silvermoon,288,paladin,retribution,6,3,3
Thalyia,neptulon,288,paladin,retribution,6,3,3
Hampilights,blackmoore,288,paladin,retribution,6,3,3
Reliquiem,quelthalas,288,paladin,retribution,6,3,3
Reøl,blackmoore,288,paladin,retribution,6,3,3
Roshï,tarren-mill,288,paladin,retribution,6,3,3
Hondur,blackmoore,288,paladin,retribution,6,3,3
Blessbabe,tarren-mill,288,paladin,retribution,6,3,3
Buckinfubble,tarren-mill,288,paladin,retribution,6,3,3
Myfacehurtz,blackmoore,288,paladin,retribution,6,3,3
Aklime,blackmoore,288,paladin,retribution,6,3,3
Razztafari,tarren-mill,288,paladin,retribution,6,3,3
Volsen,blackmoore,288,paladin,retribution,6,3,3
Séphïröth,cthun,288,paladin,retribution,6,3,3
Xaldrèk,silvermoon,288,paladin,retribution,6,3,3
Dezaster,dentarg,288,paladin,retribution,6,3,3
Hojacat,tarren-mill,288,paladin,retribution,6,3,3
Annø,magtheridon,288,paladin,retribution,6,3,3
Svipdag,quelthalas,288,paladin,retribution,6,3,3
Retroxy,stormreaver,288,paladin,retribution,6,3,3
Tyn,dragonmaw,288,paladin,retribution,6,3,3
Gipas,quelthalas,288,paladin,retribution,6,3,3
Lobofka,spinebreaker,288,paladin,retribution,6,3,3
Partur,stormreaver,288,paladin,retribution,6,3,3
Véngeance,twilights-hammer,288,paladin,retribution,6,3,3
Archangel,bloodhoof,288,paladin,retribution,6,3,3
Akarui,dun-modr,288,paladin,retribution,6,3,3
Batteque,silvermoon,288,paladin,retribution,6,3,3
Kräms,cthun,288,paladin,retribution,6,3,3
Holythore,shadowsong,288,paladin,retribution,6,3,3
Ráydrax,dun-modr,288,paladin,retribution,6,3,3
Fumbz,alakir,288,paladin,retribution,6,3,3
Èrebos,lothar,288,paladin,retribution,6,3,3
Ashsmiley,kazzak,288,paladin,retribution,6,3,3
Reinvigorate,alleria,288,paladin,retribution,6,3,3
Artasia,kul-tiras,288,paladin,retribution,6,3,3
Lóde,silvermoon,288,paladin,retribution,6,3,3
Riziel,sanguino,288,paladin,retribution,6,3,3
Hium,zuljin,288,paladin,retribution,6,3,3
Yoggsaron,dun-modr,288,paladin,retribution,6,3,3
Henrolos,sanguino,288,paladin,retribution,6,3,3
Retron,tichondrius,288,paladin,retribution,6,3,3
Rockyll,bloodfeather,288,paladin,retribution,6,3,3
Grievous,sporeggar,288,paladin,retribution,6,3,3
Hione,burning-legion,288,paladin,retribution,6,3,3
Léks,arathi,288,paladin,retribution,9,4,5
Kiingslayeer,kilrogg,288,paladin,retribution,9,4,5
Reven,aszune,288,paladin,retribution,7,3,4
Weyline,naxxramas,288,paladin,retribution,7,3,4
Dorlen,argent-dawn,288,paladin,retribution,10,4,6
Songg,zuljin,288,paladin,retribution,8,3,5
Кельдерик,howling-fjord,288,paladin,retribution,8,3,5
Aenhel,zuljin,288,paladin,retribution,11,4,7
Flegma,argent-dawn,288,paladin,retribution,10,3,7
Liquesco,draenor,288,paladin,retribution,12,3,9
Sobolanu,ravencrest,288,paladin,retribution,12,3,9
Fuyúrí,burning-legion,288,paladin,retribution,12,3,9
Táurax,frostwolf,288,paladin,retribution,12,3,9
Sangaro,ragnaros,288,paladin,retribution,12,3,9
Vakoslav,burning-legion,288,paladin,retribution,12,3,9
Stonetide,argent-dawn,288,paladin,retribution,12,3,9
Staturos,burning-legion,288,paladin,retribution,12,3,9
Calesen,draenor,288,paladin,retribution,12,3,9
Ldyliadrin,sanguino,288,paladin,retribution,12,3,9
Dumbala,ravencrest,288,paladin,retribution,12,3,9
Traptaman,xavius,288,paladin,retribution,12,3,9
Xzpal,silvermoon,288,paladin,retribution,12,3,9
Holyispro,kazzak,288,paladin,retribution,12,3,9
Çolette,silvermoon,288,paladin,retribution,12,3,9
Thurnberg,blackhand,288,paladin,retribution,12,3,9
Inmortality,sanguino,288,paladin,retribution,12,3,9
Azmocore,blackhand,288,paladin,retribution,12,3,9
Proskillver,twisting-nether,288,paladin,retribution,12,3,9
Kerplonk,burning-legion,288,paladin,retribution,12,3,9
Devastation,blackhand,288,paladin,retribution,12,3,9
Popolelo,dun-modr,288,paladin,retribution,12,3,9
Artemes,malorne,288,paladin,retribution,12,3,9
Jámíe,kul-tiras,288,paladin,retribution,12,3,9
Flogiston,burning-legion,288,paladin,retribution,12,3,9
Healsgoodman,twisting-nether,288,paladin,retribution,12,3,9
Zodshock,stormscale,288,paladin,retribution,12,3,9
Стопкаст,ashenvale,288,paladin,retribution,12,3,9
Svåger,stormscale,288,paladin,retribution,12,3,9
Светлолик,eversong,288,paladin,retribution,12,3,9
Каадзуто,eversong,288,paladin,retribution,12,3,9
Socalija,stormscale,288,paladin,retribution,12,3,9
Стэнтон,soulflayer,288,paladin,retribution,12,3,9
Xrilled,stormreaver,288,paladin,retribution,12,3,9
Hollyshiit,tarren-mill,288,paladin,retribution,12,3,9
Агранна,soulflayer,288,paladin,retribution,12,3,9
Melitta,stormscale,288,paladin,retribution,12,3,9
Simsaii,stormscale,288,paladin,retribution,12,3,9
Palabrux,colinas-pardas,288,paladin,retribution,12,3,9
Mandingbull,stormscale,288,paladin,retribution,12,3,9
Bjorg,exodar,288,paladin,retribution,12,3,9
Japsee,runetotem,288,paladin,retribution,12,3,9
Brightboy,bronze-dragonflight,288,paladin,retribution,12,3,9
Souror,blackmoore,288,paladin,retribution,12,3,9
Puffington,tarren-mill,288,paladin,retribution,12,3,9
Steelrose,auchindoun,288,paladin,retribution,12,3,9
Trollpaladin,blackmoore,288,paladin,retribution,12,3,9
Trwwsano,stormscale,288,paladin,retribution,12,3,9
Kiytrew,ravencrest,288,paladin,retribution,12,3,9
Mathetiger,blackmoore,288,paladin,retribution,12,3,9
Ranishkah,tarren-mill,288,paladin,retribution,12,3,9
Daveskylark,ravencrest,288,paladin,retribution,12,3,9
Kypamop,argent-dawn,288,paladin,retribution,12,3,9
Gigaheals,ravencrest,288,paladin,retribution,12,3,9
Arthàs,blackmoore,288,paladin,retribution,12,3,9
Shneéz,blackmoore,288,paladin,retribution,12,3,9
Cigoveth,sylvanas,288,paladin,retribution,12,3,9
Dejairr,argent-dawn,288,paladin,retribution,12,3,9
Whórainzóne,eredar,288,paladin,retribution,12,3,9
Iradiues,defias-brotherhood,288,paladin,retribution,12,3,9
Kafura,eredar,288,paladin,retribution,12,3,9
Аладушок,gordunni,288,paladin,retribution,12,3,9
Тайронх,gordunni,288,paladin,retribution,12,3,9
Deholyloa,frostwhisper,288,paladin,retribution,12,3,9
Ультравишня,howling-fjord,288,paladin,retribution,12,3,9
Lylennâ,argent-dawn,288,paladin,retribution,12,3,9
Ахелеззик,gordunni,288,paladin,retribution,12,3,9
Иретис,gordunni,288,paladin,retribution,12,3,9
Hitomíe,blackrock,288,paladin,retribution,12,3,9
Бетте,gordunni,288,paladin,retribution,12,3,9
Галлионн,gordunni,288,paladin,retribution,12,3,9
Стасятко,grom,288,paladin,retribution,12,3,9
Ардел,grom,288,paladin,retribution,12,3,9
Kicksnare,drakthul,288,paladin,retribution,12,3,9
Forder,drakthul,288,paladin,retribution,12,3,9
Liquêdor,blackrock,288,paladin,retribution,12,3,9
Burzìk,draenor,288,paladin,retribution,12,3,9
Darkham,nemesis,288,paladin,retribution,12,3,9
Ilaris,amanthul,288,paladin,retribution,12,3,9
Shinonorba,draenor,288,paladin,retribution,12,3,9
Blecheîmer,aegwynn,288,paladin,retribution,12,3,9
Koreanpistol,aegwynn,288,paladin,retribution,12,3,9
Karljohan,grim-batol,288,paladin,retribution,12,3,9
Skuzee,archimonde,288,paladin,retribution,12,3,9
Bloodfaith,arthas,288,paladin,retribution,12,3,9
Pokexx,ragnaros,288,paladin,retribution,12,3,9
Cilla,kult-der-verdammten,288,paladin,retribution,12,3,9
Hyggë,sanguino,288,paladin,retribution,12,3,9
Palaxus,archimonde,288,paladin,retribution,12,3,9
Sacrémounf,archimonde,288,paladin,retribution,12,3,9
Môdhân,archimonde,288,paladin,retribution,12,3,9
Leseume,archimonde,288,paladin,retribution,12,3,9
Samewórld,hyjal,288,paladin,retribution,12,3,9
Acction,outland,288,paladin,retribution,12,3,9
Harvel,outland,288,paladin,retribution,12,3,9
Lightpath,stormrage,288,paladin,retribution,12,3,9
Strikè,stormscale,288,paladin,retribution,12,3,9
Damelu,frostwhisper,288,paladin,retribution,14,3,11
Althalanor,drekthar,288,paladin,retribution,15,3,12
Xvoodoo,antonidas,288,paladin,retribution,17,3,14
Agrkan,defias-brotherhood,288,paladin,retribution,17,3,14
Herdekbaba,draenor,288,paladin,retribution,18,3,15
Paintdafence,kazzak,288,paladin,retribution,18,3,15
Blutpaladin,antonidas,288,paladin,retribution,18,3,15
Datrohan,burning-legion,288,paladin,retribution,18,3,15
Sztat,burning-legion,288,paladin,retribution,18,3,15
Símp,grim-batol,288,paladin,retribution,18,3,15
Fenik,dun-modr,288,paladin,retribution,18,3,15
Sadhappyz,ravencrest,288,paladin,retribution,26,4,22
Arbuzno,draenor,1971,paladin,protection,114,90,24
Maximumtaste,ravencrest,1874,paladin,protection,42,33,9
Hoodnachoz,outland,1842,paladin,protection,36,30,6
Sterben,aegwynn,1805,paladin,protection,101,57,44
Sonnywalkman,twisting-nether,1799,paladin,protection,42,32,10
Sartshield,aerie-peak,1772,paladin,protection,102,57,45
Âmba,blackrock,1766,paladin,protection,143,99,44
Vivalabeef,stormscale,1723,paladin,protection,53,34,19
Гниленький,razuvious,1712,paladin,protection,29,20,9
Zireth,silvermoon,1678,paladin,protection,42,26,16
Leotheron,boulderfist,1667,paladin,protection,973,656,317
Collinnawin,aegwynn,1656,paladin,protection,298,142,156
Mørfi,antonidas,1654,paladin,protection,64,34,30
Justífiéd,kazzak,1640,paladin,protection,48,22,26
Arkhàn,ravencrest,1634,paladin,protection,202,116,86
Statscowski,thrall,1624,paladin,protection,64,33,31
Фабийвальдор,soulflayer,1621,paladin,protection,72,48,24
Толинель,soulflayer,1610,paladin,protection,29,18,11
Timbadin,frostwolf,1608,paladin,protection,47,32,15
Eåsy,argent-dawn,1603,paladin,protection,175,96,79
Craft,frostwolf,1584,paladin,protection,148,65,83
Bariy,auchindoun,1579,paladin,protection,124,68,56
Tippressure,ravencrest,1572,paladin,protection,76,47,29
Elitest,hyjal,1550,paladin,protection,219,84,135
Phlakorn,blackhand,1542,paladin,protection,90,50,40
Schrikii,archimonde,1538,paladin,protection,84,49,35
Savión,silvermoon,1528,paladin,protection,53,32,21
Sutbeyaz,twisting-nether,1524,paladin,protection,31,21,10
Uswieconyra,silvermoon,1523,paladin,protection,83,42,41
Neopronouns,minahonda,1513,paladin,protection,48,31,17
Palan,cthun,1505,paladin,protection,59,23,36
Kurøneko,hyjal,1496,paladin,protection,41,19,22
Маиэр,gordunni,1494,paladin,protection,65,31,34
Supremerage,silvermoon,1474,paladin,protection,86,46,40
Силугор,soulflayer,1470,paladin,protection,107,53,54
Broolaf,antonidas,1469,paladin,protection,185,99,86
Galevar,argent-dawn,1464,paladin,protection,140,69,71
Sìlver,conseil-des-ombres,1461,paladin,protection,42,21,21
Haringoth,argent-dawn,1453,paladin,protection,78,42,36
Mocnyreka,silvermoon,1450,paladin,protection,89,48,41
Youness,ysondre,1440,paladin,protection,321,164,157
Ðizzmo,bloodfeather,1438,paladin,protection,238,120,118
Oldsqlmofu,blackrock,1437,paladin,protection,40,24,16
Gabubex,tarren-mill,1435,paladin,protection,176,101,75
Whiteraven,rexxar,1431,paladin,protection,89,43,46
Leadfoot,argent-dawn,1430,paladin,protection,98,66,32
Eriellè,kazzak,1403,paladin,protection,111,59,52
Бранв,gordunni,1401,paladin,protection,96,55,41
Шмыгапал,eversong,1389,paladin,protection,38,20,18
Dolff,argent-dawn,1379,paladin,protection,59,30,29
Баибар,soulflayer,1378,paladin,protection,162,89,73
Jûstice,kirin-tor,1378,paladin,protection,175,86,89
Swiatlomiecz,silvermoon,1366,paladin,protection,60,23,37
Medium,frostwolf,1362,paladin,protection,29,15,14
Krispce,bloodhoof,1360,paladin,protection,66,40,26
Ðivine,stormscale,1359,paladin,protection,130,60,70
Casstiel,anetheron,1356,paladin,protection,48,22,26
Helladin,haomarush,1346,paladin,protection,134,48,86
Ponce,los-errantes,1345,paladin,protection,48,20,28
Линвэль,gordunni,1342,paladin,protection,18,14,4
Lóu,hyjal,1340,paladin,protection,92,45,47
Unbesiegbar,malfurion,1340,paladin,protection,48,15,33
Хэбит,soulflayer,1336,paladin,protection,136,61,75
Vangorn,burning-legion,1334,paladin,protection,58,29,29
Shybia,kirin-tor,1327,paladin,protection,35,19,16
Thrinea,blackrock,1324,paladin,protection,48,22,26
Galadrion,dun-modr,1321,paladin,protection,23,14,9
Ichbin,sanguino,1318,paladin,protection,308,123,185
Maeltesar,kult-der-verdammten,1312,paladin,protection,28,18,10
Bobilous,twisting-nether,1310,paladin,protection,23,14,9
Velkar,frostmane,1310,paladin,protection,124,63,61
Trufetteuh,hyjal,1303,paladin,protection,195,98,97
Hermodir,kargath,1303,paladin,protection,41,19,22
Zerhakz,ysondre,1302,paladin,protection,102,49,53
Gaffel,dethecus,1296,paladin,protection,64,28,36
Sikaniska,stormscale,1294,paladin,protection,108,45,63
Rudra,kiljaeden,1288,paladin,protection,87,35,52
Ragonas,mannoroth,1276,paladin,protection,48,20,28
Flakkson,stormscale,1275,paladin,protection,304,126,178
Valeriu,stormreaver,1271,paladin,protection,42,17,25
Manupierre,ysondre,1270,paladin,protection,48,22,26
Yunalêsca,mugthol,1268,paladin,protection,137,59,78
Celyne,kirin-tor,1265,paladin,protection,54,21,33
Milliemaître,elune,1253,paladin,protection,90,41,49
Augroni,antonidas,1227,paladin,protection,117,50,67
Lotheriem,argent-dawn,1203,paladin,protection,54,20,34
Xrules,blackhand,1201,paladin,protection,47,21,26
Elkka,azjolnerub,1199,paladin,protection,110,38,72
Butchertom,ravencrest,1184,paladin,protection,23,14,9
Проц,soulflayer,1178,paladin,protection,72,26,46
Derendil,ysondre,1177,paladin,protection,83,25,58
Quantox,frostwolf,1153,paladin,protection,40,14,26
Babaluga,blackrock,1151,paladin,protection,18,12,6
Vader,arygos,1151,paladin,protection,51,17,34
Антоним,gordunni,1143,paladin,protection,18,12,6
Kawakai,blackrock,1138,paladin,protection,76,28,48
Ciralia,chants-éternels,1137,paladin,protection,21,12,9
Arkera,blackrock,1134,paladin,protection,61,22,39
Tíríón,nethersturm,1124,paladin,protection,24,12,12
Furiosio,ysondre,1115,paladin,protection,27,13,14
Aarrb,sylvanas,1065,paladin,protection,51,15,36
Yruqrem,ravencrest,1055,paladin,protection,18,11,7
Fumbz,alakir,1050,paladin,protection,18,11,7
Vladium,argent-dawn,1046,paladin,protection,24,11,13
Такуан,fordragon,1035,paladin,protection,24,11,13
Faranume,sylvanas,1028,paladin,protection,35,18,17
Strahladin,blackhand,1013,paladin,protection,53,12,41
Emakk,darksorrow,958,paladin,protection,18,10,8
Stahlkeule,antonidas,890,paladin,protection,23,10,13
Divinebeans,kazzak,863,paladin,protection,12,9,3
Testos,ulduar,862,paladin,protection,12,9,3
Rushtank,dragonmaw,861,paladin,protection,36,9,27
Kîpôune,dalaran,860,paladin,protection,24,9,15
Ìu,draenor,809,paladin,protection,14,10,4
Thraliss,hyjal,767,paladin,protection,12,8,4
Dkfdevil,ravencrest,767,paladin,protection,18,8,10
Garjzla,chamber-of-aspects,727,paladin,protection,22,8,14
Lägolas,thrall,701,paladin,protection,17,8,9
Comic,frostwolf,672,paladin,protection,12,7,5
Kraljevic,silvermoon,672,paladin,protection,12,7,5
Ванябублгам,soulflayer,672,paladin,protection,18,7,11
Romfis,arathor,671,paladin,protection,18,7,11
Retríciusz,ragnaros,622,paladin,protection,15,8,7
Figustyle,archimonde,605,paladin,protection,16,7,9
Pingouin,hyjal,576,paladin,protection,10,7,3
Blechdøse,onyxia,576,paladin,protection,12,6,6
Uners,hyjal,576,paladin,protection,12,6,6
Marihuána,ragnaros,576,paladin,protection,18,6,12
Ekenpala,kazzak,575,paladin,protection,12,6,6
Thrormund,defias-brotherhood,575,paladin,protection,12,6,6
Дадух,gordunni,575,paladin,protection,12,6,6
Книгс,gordunni,575,paladin,protection,18,6,12
Exion,ravenholdt,543,paladin,protection,11,6,5
Palmeretes,zuljin,480,paladin,protection,6,5,1
Кельдерик,howling-fjord,480,paladin,protection,6,5,1
Moløk,ysondre,480,paladin,protection,6,5,1
Lightian,twisting-nether,480,paladin,protection,12,5,7
Jorrel,bladefist,480,paladin,protection,12,5,7
Кооениксз,blackscar,480,paladin,protection,18,5,13
Telninio,ravencrest,480,paladin,protection,18,5,13
Lithera,outland,480,paladin,protection,24,5,19
Xairios,blackhand,479,paladin,protection,12,5,7
Onefrostyboi,defias-brotherhood,479,paladin,protection,12,5,7
Duxbellorum,the-maelstrom,479,paladin,protection,18,5,13
Biffle,korgall,479,paladin,protection,30,5,25
Ilseparatzio,turalyon,477,paladin,protection,18,5,13
Brudiwinkler,blackrock,384,paladin,protection,6,4,2
Fleshoflight,arathor,384,paladin,protection,6,4,2
Escort,frostwolf,384,paladin,protection,6,4,2
Bbroblem,blackmoore,384,paladin,protection,6,4,2
Akelad,arathor,384,paladin,protection,6,4,2
Hgaming,kazzak,384,paladin,protection,6,4,2
Снайпик,azuregos,384,paladin,protection,12,4,8
Røse,argent-dawn,384,paladin,protection,12,4,8
Æåæxâëæ,dun-modr,384,paladin,protection,12,4,8
Inqontrol,burning-legion,384,paladin,protection,12,4,8
Astragore,archimonde,384,paladin,protection,18,4,14
Дюве,blackscar,351,paladin,protection,11,4,7
Valädar,sanguino,351,paladin,protection,16,4,12
Bloodynox,dentarg,288,paladin,protection,6,3,3
Swäagg,hyjal,288,paladin,protection,6,3,3
Palaplaya,zuljin,288,paladin,protection,6,3,3
Estellar,bronze-dragonflight,288,paladin,protection,6,3,3
Davykuro,medivh,288,paladin,protection,6,3,3
Aümagad,confrérie-du-thorium,288,paladin,protection,6,3,3
Æero,blackhand,288,paladin,protection,6,3,3
Рустиктоп,gordunni,288,paladin,protection,6,3,3
Zuplex,deathwing,288,paladin,protection,6,3,3
Crimsons,draenor,288,paladin,protection,12,3,9
Ламберинн,goldrinn,288,paladin,protection,12,3,9
Slainer,zuljin,288,paladin,protection,12,3,9
Meneth,elune,240,paladin,protection,9,3,6
Yourmomz,kazzak,239,paladin,protection,5,3,2
Deathicâ,outland,239,paladin,protection,5,3,2
Kryvex,nemesis,192,paladin,protection,6,2,4
Синерина,blackscar,192,paladin,protection,6,2,4
Saró,ravencrest,192,paladin,protection,6,2,4
Djakninn,ragnaros,192,paladin,protection,6,2,4
Derina,silvermoon,192,paladin,protection,6,2,4
Paladuns,burning-legion,192,paladin,protection,6,2,4
Zinetp,tarren-mill,192,paladin,protection,6,2,4
Gornim,die-nachtwache,192,paladin,protection,6,2,4
Khrak,conseil-des-ombres,192,paladin,protection,12,2,10
Palacaplaca,cthun,175,paladin,protection,11,2,9
Angeal,ysondre,175,paladin,protection,11,2,9
Cutebabe,twisting-nether,159,paladin,protection,5,2,3
Soxsnort,twisting-nether,159,paladin,protection,5,2,3
Barbarul,draenor,96,paladin,protection,6,1,5
Bugo,drakthul,96,paladin,protection,6,1,5
Чиксапомойка,gordunni,96,paladin,protection,6,1,5
Taptreus,antonidas,96,paladin,protection,6,1,5
Monkeyhoffi,blackrock,96,paladin,protection,6,1,5
Olydig,argent-dawn,96,paladin,protection,6,1,5
Kathly,madmortem,96,paladin,protection,6,1,5
Лебоввски,blackscar,96,paladin,protection,6,1,5
Lokinder,pozzo-delleternità,96,paladin,protection,12,1,11
Thôrwald,les-sentinelles,96,paladin,protection,12,1,11
Солошафл,howling-fjord,42,paladin,protection,12,4,8
Numberô,kazzak,42,paladin,protection,16,3,13
Candrä,archimonde,2213,priest,holy,96,52,44
Itsmeminglee,ravencrest,2213,priest,holy,216,116,100
Køzukï,ravencrest,2167,priest,holy,281,147,134
Servey,twisting-nether,2166,priest,holy,78,43,35
Peisetti,stormscale,2139,priest,holy,102,54,48
Tenpointone,kazzak,2127,priest,holy,171,90,81
Lmnsqzy,ravencrest,2107,priest,holy,148,79,69
Leadeur,kazzak,2103,priest,holy,489,245,244
Tangent,ravencrest,2101,priest,holy,317,178,139
Jtî,ravencrest,2096,priest,holy,54,36,18
Ladá,stormscale,2088,priest,holy,291,154,137
Yötönyö,ravencrest,2072,priest,holy,66,34,32
Feararenaone,outland,2055,priest,holy,122,67,55
Weezing,ysondre,2050,priest,holy,318,167,151
Yhoundey,blackrock,2046,priest,holy,135,67,68
Lylska,stormreaver,2041,priest,holy,66,31,35
Grafius,stormscale,2038,priest,holy,72,36,36
Tmnstrtw,alakir,2026,priest,holy,155,83,72
Boonlai,ravencrest,2023,priest,holy,199,103,96
Rébörn,tarren-mill,2016,priest,holy,204,119,85
Còsmo,ravencrest,2010,priest,holy,60,34,26
Carlitastock,eredar,2003,priest,holy,107,56,51
Кальвейт,deathweaver,1998,priest,holy,245,125,120
Dotzey,outland,1996,priest,holy,60,32,28
Tëst,ravencrest,1994,priest,holy,103,59,44
Найтингеилл,gordunni,1990,priest,holy,174,96,78
Møhammed,wrathbringer,1988,priest,holy,1218,616,602
Bigwik,tarren-mill,1985,priest,holy,206,111,95
Cosines,ravencrest,1972,priest,holy,356,185,171
Jaisuu,ravencrest,1967,priest,holy,60,31,29
Testdeath,ravencrest,1963,priest,holy,90,52,38
Лоаресс,gordunni,1952,priest,holy,262,135,127
Pandakhlys,ysondre,1950,priest,holy,100,54,46
Jiffie,twisting-nether,1948,priest,holy,131,70,61
Гопикзашквар,blackscar,1946,priest,holy,143,73,70
Tmnstr,alakir,1946,priest,holy,66,33,33
Jaytî,ravencrest,1944,priest,holy,48,33,15
Fleischesser,ravencrest,1941,priest,holy,110,59,51
Ltmp,ravencrest,1932,priest,holy,143,78,65
Basilette,hyjal,1930,priest,holy,72,38,34
Zuniya,tarren-mill,1930,priest,holy,90,47,43
Piwi,blackrock,1926,priest,holy,66,43,23
Rippertmepls,ravencrest,1924,priest,holy,166,97,69
Hélp,stormscale,1922,priest,holy,132,80,52
Wåtrux,alakir,1922,priest,holy,602,327,275
Шотыказау,blackscar,1921,priest,holy,317,162,155
Výra,der-rat-von-dalaran,1916,priest,holy,107,63,44
Stanyú,tarren-mill,1914,priest,holy,66,32,34
Siign,ravencrest,1912,priest,holy,314,158,156
Pierrebourne,blackmoore,1911,priest,holy,78,42,36
Разрухаз,gordunni,1899,priest,holy,66,40,26
Лайхтни,howling-fjord,1890,priest,holy,155,85,70
Lîrana,ravencrest,1889,priest,holy,160,98,62
Gokumødex,outland,1886,priest,holy,160,86,74
Nakkenils,tarren-mill,1886,priest,holy,64,30,34
Dmnz,blackrock,1885,priest,holy,117,56,61
Lolylights,tarren-mill,1883,priest,holy,195,107,88
Myste,nemesis,1875,priest,holy,238,129,109
Holyholy,stormscale,1871,priest,holy,210,101,109
Dmnz,antonidas,1870,priest,holy,58,33,25
Soyloverjuan,auchindoun,1865,priest,holy,54,38,16
Катккат,soulflayer,1864,priest,holy,53,30,23
Drillin,ravencrest,1853,priest,holy,193,111,82
Beatrixz,twisting-nether,1852,priest,holy,384,199,185
Muchos,blackrock,1852,priest,holy,415,205,210
Flongoletta,xavius,1850,priest,holy,189,102,87
Lenyp,sanguino,1850,priest,holy,300,151,149
Rehnstek,wildhammer,1848,priest,holy,132,69,63
Eriónd,ravencrest,1848,priest,holy,144,74,70
Reflector,sunstrider,1847,priest,holy,48,27,21
Çhéåtçødé,ravencrest,1847,priest,holy,185,103,82
Qzrx,draenor,1847,priest,holy,72,38,34
Servêy,twisting-nether,1845,priest,holy,42,22,20
Ladderpolice,blackmoore,1844,priest,holy,36,21,15
Nxbo,kazzak,1841,priest,holy,154,80,74
Kaiikoo,ravencrest,1840,priest,holy,60,32,28
Finizkram,sylvanas,1840,priest,holy,48,25,23
Ryna,the-maelstrom,1838,priest,holy,58,37,21
Brigittë,ravencrest,1838,priest,holy,78,46,32
Thelunara,sanguino,1838,priest,holy,98,53,45
Jim,saurfang,1838,priest,holy,292,150,142
Charlotten,shattered-hand,1836,priest,holy,179,94,85
Гоплзнекст,gordunni,1835,priest,holy,502,254,248
Pharli,stormscale,1833,priest,holy,66,40,26
Gøkumodex,tarren-mill,1833,priest,holy,140,77,63
Kæzm,blackrock,1833,priest,holy,54,29,25
Gigamind,blackrock,1832,priest,holy,126,71,55
Obeng,tarren-mill,1829,priest,holy,48,23,25
Ysun,tarren-mill,1825,priest,holy,96,49,47
Wextroth,arathor,1824,priest,holy,42,28,14
Yateh,blackmoore,1824,priest,holy,62,32,30
Yugata,archimonde,1824,priest,holy,53,26,27
Pradrak,eredar,1823,priest,holy,40,23,17
Квваззар,gordunni,1822,priest,holy,72,34,38
Limeslayerx,veklor,1818,priest,holy,135,83,52
Dranbor,argent-dawn,1818,priest,holy,290,158,132
Ancientalien,khadgar,1817,priest,holy,66,29,37
Celliapriest,antonidas,1816,priest,holy,74,40,34
Jagardoden,stormscale,1816,priest,holy,36,19,17
Dogshtpriest,ravencrest,1815,priest,holy,126,74,52
Sayne,arathor,1815,priest,holy,168,91,77
Кодис,gordunni,1813,priest,holy,153,91,62
Yamai,thrall,1813,priest,holy,60,28,32
Maruh,malganis,1812,priest,holy,113,60,53
Kaalu,frostmane,1809,priest,holy,254,131,123
Deneris,ravencrest,1807,priest,holy,51,29,22
Vaerath,argent-dawn,1803,priest,holy,90,49,41
Lupinx,terokkar,1802,priest,holy,177,105,72
Soulwordpain,ragnaros,1802,priest,holy,60,29,31
Verycute,argent-dawn,1801,priest,holy,36,24,12
Sausageboy,tarren-mill,1801,priest,holy,246,122,124
Teatime,aegwynn,1800,priest,holy,84,42,42
Ssjx,ravencrest,1791,priest,holy,96,58,38
Kunen,sanguino,1789,priest,holy,138,77,61
Infamoussftw,drakthul,1789,priest,holy,206,93,113
Psi,hakkar,1788,priest,holy,526,275,251
Fotmrerollrz,draenor,1787,priest,holy,48,34,14
Друмги,gordunni,1787,priest,holy,173,80,93
Shmoly,stormscale,1786,priest,holy,95,51,44
Эльдиремонт,gordunni,1786,priest,holy,305,154,151
Depridolens,argent-dawn,1783,priest,holy,66,39,27
Kirobreika,twisting-nether,1779,priest,holy,42,26,16
Seanoob,turalyon,1779,priest,holy,72,38,34
Sisko,stormscale,1778,priest,holy,168,89,79
Sod,dun-morogh,1776,priest,holy,66,39,27
Zêlestia,antonidas,1774,priest,holy,58,34,24
Alchemïst,ravencrest,1772,priest,holy,58,28,30
Fízwow,stormscale,1771,priest,holy,117,57,60
Сказочки,gordunni,1770,priest,holy,111,55,56
Sehlia,kazzak,1766,priest,holy,382,203,179
Weezïng,ysondre,1765,priest,holy,114,64,50
Разрухаовнз,gordunni,1763,priest,holy,137,70,67
Casic,lordaeron,1762,priest,holy,38,24,14
Gigotdagneau,dalaran,1753,priest,holy,71,35,36
Gloomkesh,draenor,1751,priest,holy,30,20,10
Ivÿx,ravencrest,1749,priest,holy,101,57,44
Jukester,stormscale,1747,priest,holy,98,57,41
Кэрия,blackscar,1737,priest,holy,245,128,117
Ðês,ravencrest,1735,priest,holy,76,37,39
Штанга,blackscar,1734,priest,holy,202,106,96
Pigdestroyin,frostmane,1730,priest,holy,77,45,32
Преттисмайл,gordunni,1730,priest,holy,283,139,144
Anníng,tarren-mill,1729,priest,holy,216,124,92
Wèèzing,ysondre,1728,priest,holy,113,65,48
Zên,argent-dawn,1726,priest,holy,27,19,8
Applepiez,ravencrest,1726,priest,holy,58,30,28
Scartay,outland,1723,priest,holy,53,24,29
Skyggedyret,tarren-mill,1721,priest,holy,59,31,28
Sàweetie,archimonde,1721,priest,holy,54,27,27
Makkesfil,stormscale,1720,priest,holy,52,34,18
Fjonnski,blackmoore,1717,priest,holy,121,71,50
Zeflol,malganis,1717,priest,holy,185,101,84
Gnomemonk,stormscale,1716,priest,holy,217,113,104
Shizzlol,silvermoon,1716,priest,holy,614,304,310
Jinxa,draenor,1716,priest,holy,84,36,48
Marcopp,kazzak,1713,priest,holy,66,28,38
Notdan,stormscale,1712,priest,holy,386,206,180
Alpháømegá,outland,1712,priest,holy,224,118,106
Tabaç,stormscale,1711,priest,holy,42,22,20
Stinkydog,kazzak,1711,priest,holy,406,205,201
Ksn,argent-dawn,1710,priest,holy,66,37,29
Tazn,thrall,1708,priest,holy,36,21,15
Troedelsuppe,destromath,1703,priest,holy,276,143,133
Duqes,stormreaver,1702,priest,holy,18,18,0
Rafaled,ravencrest,1701,priest,holy,53,33,20
Malaki,ysondre,1700,priest,holy,209,110,99
Ålúñãh,azjolnerub,1699,priest,holy,42,27,15
Azulâ,eredar,1699,priest,holy,59,35,24
Dolens,argent-dawn,1699,priest,holy,112,55,57
Oide,area-52,1697,priest,holy,159,83,76
Rankonejames,silvermoon,1696,priest,holy,87,45,42
Xianxia,twisting-nether,1695,priest,holy,196,101,95
Anaqt,silvermoon,1694,priest,holy,673,347,326
Calithria,kazzak,1693,priest,holy,280,148,132
Ilenna,dun-morogh,1692,priest,holy,135,75,60
Инзора,gordunni,1692,priest,holy,242,130,112
Câlyr,ragnaros,1692,priest,holy,54,24,30
Jâde,bloodhoof,1690,priest,holy,138,78,60
Discomelk,stormscale,1690,priest,holy,48,23,25
Vui,kelthuzad,1689,priest,holy,72,46,26
Shanya,thrall,1688,priest,holy,285,144,141
Макстин,howling-fjord,1687,priest,holy,42,24,18
Bzzdontplay,ravencrest,1687,priest,holy,225,116,109
Affro,drakthul,1687,priest,holy,149,76,73
Maikzky,stormreaver,1686,priest,holy,42,26,16
Joeasaurs,ragnaros,1686,priest,holy,118,61,57
Vitae,gorgonnash,1684,priest,holy,56,32,24
Meanbabe,argent-dawn,1683,priest,holy,48,22,26
Angelsdust,stormscale,1682,priest,holy,52,30,22
Enoriya,blackrock,1682,priest,holy,252,141,111
Løøney,kazzak,1680,priest,holy,60,38,22
Chechenkata,ravencrest,1678,priest,holy,54,29,25
Zoophobîa,stormscale,1677,priest,holy,61,34,27
Ghettothug,darksorrow,1677,priest,holy,120,58,62
Kahir,ravencrest,1676,priest,holy,54,28,26
Darkyos,azshara,1675,priest,holy,54,28,26
Каткааткат,soulflayer,1674,priest,holy,48,23,25
Zen,talnivarr,1672,priest,holy,42,19,23
Drunkshufler,stormscale,1671,priest,holy,171,94,77
Просодик,blackscar,1667,priest,holy,48,26,22
Highn,anetheron,1666,priest,holy,83,49,34
Djmeld,ravencrest,1664,priest,holy,107,56,51
Flyffi,tarren-mill,1661,priest,holy,28,19,9
Eox,kazzak,1661,priest,holy,66,38,28
Sehrhübsch,malygos,1661,priest,holy,66,35,31
Stickpas,ysondre,1661,priest,holy,41,18,23
Labuchette,archimonde,1660,priest,holy,42,23,19
Eddíémorphin,kazzak,1660,priest,holy,66,35,31
Kÿokó,ravencrest,1659,priest,holy,84,46,38
Womanwonderf,ravencrest,1658,priest,holy,143,76,67
Shanny,kazzak,1658,priest,holy,132,70,62
Æäõ,turalyon,1657,priest,holy,64,28,36
Kolto,ravencrest,1655,priest,holy,64,36,28
Gladíator,blackhand,1655,priest,holy,114,63,51
Alizeé,nazjatar,1655,priest,holy,245,134,111
Sïxsïxsïx,ravencrest,1651,priest,holy,73,37,36
Ainadaxz,ravencrest,1650,priest,holy,42,26,16
Swd,burning-blade,1650,priest,holy,40,18,22
Heilop,kazzak,1650,priest,holy,53,23,30
Syalis,kazzak,1647,priest,holy,144,71,73
Нубстрим,gordunni,1646,priest,holy,286,141,145
Iiamx,antonidas,1645,priest,holy,41,24,17
Adare,sanguino,1644,priest,holy,96,46,50
Vregoa,twisting-nether,1644,priest,holy,78,37,41
Мамкалол,soulflayer,1643,priest,holy,588,293,295
Ангеланика,gordunni,1640,priest,holy,113,75,38
Caihla,silvermoon,1639,priest,holy,42,22,20
Penvon,ravencrest,1638,priest,holy,207,101,106
Xïâ,hyjal,1638,priest,holy,176,83,93
Shinesomnya,aegwynn,1637,priest,holy,54,32,22
Jellypie,blackrock,1637,priest,holy,60,31,29
Seeyae,archimonde,1636,priest,holy,54,27,27
Wernou,archimonde,1635,priest,holy,44,25,19
Acronix,the-maelstrom,1635,priest,holy,54,28,26
Bilbobanging,aggramar,1635,priest,holy,108,53,55
Xzklolz,twisting-nether,1634,priest,holy,185,95,90
Massbimba,tarren-mill,1633,priest,holy,66,32,34
Scrxppe,twisting-nether,1630,priest,holy,283,155,128
Кввазаар,gordunni,1630,priest,holy,48,21,27
Eliíah,outland,1629,priest,holy,54,31,23
Camina,shattered-hand,1629,priest,holy,279,146,133
Chrysos,argent-dawn,1629,priest,holy,102,47,55
Pøsæ,uldaman,1627,priest,holy,78,44,34
Simpadisco,ravencrest,1627,priest,holy,72,35,37
Kyokaze,silvermoon,1626,priest,holy,118,64,54
Ankî,aegwynn,1626,priest,holy,68,36,32
Boomixed,twisting-nether,1623,priest,holy,60,29,31
Jedimind,kazzak,1621,priest,holy,66,33,33
Elmaestrø,aegwynn,1620,priest,holy,96,52,44
Cølï,ravencrest,1620,priest,holy,96,48,48
Rankoneprazt,stormscale,1620,priest,holy,131,63,68
Melzas,the-shatar,1619,priest,holy,60,31,29
Xxmybaxxo,archimonde,1617,priest,holy,30,21,9
Smïlë,ravencrest,1616,priest,holy,210,105,105
Èlysium,grim-batol,1615,priest,holy,117,67,50
Grindgames,pozzo-delleternità,1615,priest,holy,44,22,22
Jawjie,tarren-mill,1615,priest,holy,86,36,50
Penitent,anachronos,1614,priest,holy,60,34,26
Coolwnbnamex,ravencrest,1614,priest,holy,36,19,17
Hwren,auchindoun,1612,priest,holy,430,229,201
Karpiest,stormscale,1611,priest,holy,208,116,92
Isadriel,madmortem,1610,priest,holy,64,40,24
Xzklol,twisting-nether,1610,priest,holy,92,48,44
Harmónia,outland,1610,priest,holy,283,140,143
Pasqualz,ravencrest,1609,priest,holy,192,105,87
Ysalute,sylvanas,1608,priest,holy,33,18,15
Xnda,ravencrest,1608,priest,holy,120,59,61
Adonallsium,sylvanas,1607,priest,holy,90,58,32
Gratcrug,stormrage,1607,priest,holy,66,36,30
Alphacub,ragnaros,1607,priest,holy,149,76,73
Eleutheria,grim-batol,1607,priest,holy,228,113,115
Salvatíon,sanguino,1607,priest,holy,106,46,60
Usw,outland,1606,priest,holy,164,74,90
Gonker,malganis,1605,priest,holy,41,21,20
Slakkieslak,archimonde,1604,priest,holy,126,77,49
Anabananaa,ravencrest,1604,priest,holy,88,50,38
Theythem,stormscale,1602,priest,holy,30,17,13
Росвэнд,gordunni,1601,priest,holy,89,51,38
Zxø,ravencrest,1601,priest,holy,160,88,72
Sak,uldaman,1601,priest,holy,315,161,154
Budgetdp,archimonde,1601,priest,holy,153,69,84
Imbitterx,stormscale,1600,priest,holy,41,26,15
Malphesto,sunstrider,1599,priest,holy,29,19,10
Vídel,cthun,1598,priest,holy,60,35,25
Flensu,stormscale,1597,priest,holy,36,24,12
Dazé,ravencrest,1596,priest,holy,141,76,65
Catstretch,ravencrest,1596,priest,holy,281,150,131
Ünique,alakir,1595,priest,holy,36,19,17
Pínacoladáqt,stormscale,1593,priest,holy,94,50,44
Striderz,outland,1592,priest,holy,38,21,17
Goytka,tarren-mill,1591,priest,holy,114,55,59
Dìsclol,draenor,1586,priest,holy,247,125,122
Lanmarie,sylvanas,1585,priest,holy,84,46,38
Dairox,blackrock,1584,priest,holy,143,77,66
Zelzeari,sylvanas,1583,priest,holy,36,22,14
Altarboy,dun-modr,1583,priest,holy,36,18,18
Диматеу,galakrond,1583,priest,holy,96,46,50
Mewdi,outland,1579,priest,holy,146,78,68
Aethanira,ravencrest,1579,priest,holy,104,51,53
Poulet,sylvanas,1578,priest,holy,54,34,20
Yzïam,ravencrest,1575,priest,holy,36,17,19
Icybae,archimonde,1572,priest,holy,48,34,14
Велост,gordunni,1570,priest,holy,149,86,63
Ranevskiy,kazzak,1569,priest,holy,106,60,46
Prëdz,stormscale,1569,priest,holy,280,149,131
Ksn,silvermoon,1567,priest,holy,212,108,104
Solacé,frostmourne,1566,priest,holy,182,95,87
Avelynn,ravencrest,1565,priest,holy,207,106,101
Fakeshield,aegwynn,1564,priest,holy,131,67,64
Goofdookie,outland,1563,priest,holy,48,26,22
Fomstable,outland,1562,priest,holy,182,104,78
Overdosedtw,die-aldor,1561,priest,holy,36,24,12
Kathja,outland,1561,priest,holy,46,26,20
Rozå,argent-dawn,1560,priest,holy,84,48,36
Hotforus,silvermoon,1560,priest,holy,51,26,25
Nastylex,magtheridon,1559,priest,holy,36,21,15
Immortalled,twisting-nether,1556,priest,holy,42,20,22
Døtgdx,archimonde,1555,priest,holy,88,51,37
Touddixz,blackrock,1555,priest,holy,44,18,26
Aykò,blackmoore,1554,priest,holy,204,98,106
Hadis,tarren-mill,1553,priest,holy,80,49,31
Dokkaebì,kazzak,1552,priest,holy,153,78,75
Неймхичгодх,gordunni,1548,priest,holy,88,46,42
Capslk,ravencrest,1547,priest,holy,78,43,35
Phobò,antonidas,1545,priest,holy,170,79,91
Tazlii,dalaran,1543,priest,holy,30,17,13
Dény,ravencrest,1539,priest,holy,156,83,73
Koíré,defias-brotherhood,1539,priest,holy,458,236,222
Смайткен,gordunni,1538,priest,holy,117,52,65
Sonyl,les-sentinelles,1537,priest,holy,48,27,21
Evabae,the-maelstrom,1537,priest,holy,54,29,25
Карпинчо,soulflayer,1537,priest,holy,36,19,17
Cleoana,blackhand,1537,priest,holy,66,31,35
Glaedahr,blackmoore,1536,priest,holy,42,21,21
Lisk,argent-dawn,1535,priest,holy,30,17,13
Vickepriest,stormreaver,1532,priest,holy,78,49,29
Holzí,frostmourne,1528,priest,holy,50,24,26
Priewyn,ragnaros,1528,priest,holy,40,19,21
Omnimento,blackrock,1526,priest,holy,60,34,26
Fléxed,burning-legion,1526,priest,holy,30,17,13
Badguymike,ragnaros,1526,priest,holy,64,33,31
Aïmée,ravencrest,1525,priest,holy,107,60,47
Mayalolz,chogall,1525,priest,holy,80,43,37
Astralscare,outland,1525,priest,holy,48,23,25
Saceerdot,sanguino,1522,priest,holy,132,78,54
Rixis,la-croisade-écarlate,1522,priest,holy,62,35,27
Kubbarn,stormscale,1522,priest,holy,331,178,153
Justheal,stormscale,1522,priest,holy,102,49,53
Çhåstîsëfèár,dun-modr,1521,priest,holy,18,16,2
Swdommeil,aegwynn,1521,priest,holy,42,18,24
Rägà,archimonde,1520,priest,holy,149,84,65
Alaelis,burning-legion,1520,priest,holy,197,99,98
Malkàv,hyjal,1519,priest,holy,90,47,43
Insaner,ahnqiraj,1519,priest,holy,83,42,41
Dorisdiesel,ravencrest,1517,priest,holy,45,28,17
Jeanlumina,stormscale,1516,priest,holy,36,16,20
Exoduz,stormscale,1515,priest,holy,150,75,75
Snåttabaias,stormscale,1510,priest,holy,74,41,33
Tromah,archimonde,1509,priest,holy,117,65,52
Msmsmsm,frostwhisper,1508,priest,holy,95,51,44
Tyrhaa,blackmoore,1508,priest,holy,616,322,294
Ptiteminette,archimonde,1504,priest,holy,68,38,30
Иннерон,soulflayer,1504,priest,holy,469,248,221
Bougetonboul,archimonde,1504,priest,holy,123,65,58
Ozmik,twisting-nether,1504,priest,holy,44,23,21
Hyonra,kazzak,1504,priest,holy,78,39,39
Cyabish,twisting-nether,1503,priest,holy,203,108,95
Géèk,alakir,1503,priest,holy,62,32,30
Wilby,archimonde,1503,priest,holy,48,21,27
Маквиэлла,howling-fjord,1500,priest,holy,66,37,29
Dbp,tarren-mill,1500,priest,holy,120,60,60
Шанэкс,howling-fjord,1499,priest,holy,36,21,15
Ðrugslol,aegwynn,1498,priest,holy,30,17,13
Phobò,blackrock,1498,priest,holy,123,57,66
Hiimgreen,blackhand,1497,priest,holy,194,93,101
Kotipope,silvermoon,1496,priest,holy,86,43,43
Dzoo,kazzak,1496,priest,holy,42,21,21
Hoeneygodx,antonidas,1495,priest,holy,42,21,21
Velence,ravencrest,1494,priest,holy,48,31,17
Заволончик,blackscar,1494,priest,holy,102,48,54
Эилинг,gordunni,1492,priest,holy,234,127,107
Xytael,burning-legion,1492,priest,holy,268,143,125
Fatherliam,emerald-dream,1492,priest,holy,72,34,38
Elëkträ,dalaran,1491,priest,holy,79,46,33
Целитель,gordunni,1491,priest,holy,142,74,68
Angrk,kazzak,1490,priest,holy,114,68,46
Draster,blackrock,1490,priest,holy,53,28,25
Boostpriest,archimonde,1490,priest,holy,42,19,23
Mctastý,outland,1488,priest,holy,42,29,13
Cartøøns,ravencrest,1488,priest,holy,84,47,37
Daftî,twisting-nether,1488,priest,holy,199,105,94
Meshia,antonidas,1488,priest,holy,42,19,23
Øtîs,aegwynn,1487,priest,holy,78,39,39
Reiko,ravencrest,1485,priest,holy,54,33,21
Superdude,stormscale,1484,priest,holy,36,16,20
Пингзеро,soulflayer,1482,priest,holy,238,120,118
Hydraximus,garrosh,1481,priest,holy,843,422,421
Senkín,aegwynn,1479,priest,holy,221,107,114
Sebekklawl,wrathbringer,1478,priest,holy,96,48,48
Еврейк,soulflayer,1478,priest,holy,66,31,35
Mêduse,ravencrest,1476,priest,holy,81,39,42
Cøvu,draenor,1475,priest,holy,189,95,94
Grandpatea,silvermoon,1472,priest,holy,23,16,7
Sïlvëräzz,drekthar,1472,priest,holy,53,25,28
Pprxd,ysondre,1472,priest,holy,54,25,29
Maah,defias-brotherhood,1471,priest,holy,80,46,34
Nou,aegwynn,1471,priest,holy,99,52,47
Divinetouch,ravencrest,1471,priest,holy,96,42,54
Piprikas,draenor,1470,priest,holy,48,25,23
Tripjob,hyjal,1470,priest,holy,76,38,38
Yuhé,elune,1469,priest,holy,38,23,15
Fabs,laughing-skull,1468,priest,holy,119,72,47
Weedony,hyjal,1468,priest,holy,112,58,54
Canoftuna,outland,1465,priest,holy,104,63,41
Symbolofhope,ravencrest,1464,priest,holy,231,121,110
Sixtyseven,blackhand,1464,priest,holy,78,39,39
Выдокбля,soulflayer,1462,priest,holy,141,78,63
Painlêss,eredar,1461,priest,holy,41,22,19
Isilros,dalaran,1460,priest,holy,52,28,24
Liquoriced,tarren-mill,1460,priest,holy,43,23,20
Delphina,archimonde,1459,priest,holy,311,166,145
Zeitgeíst,archimonde,1458,priest,holy,102,36,66
Rines,thrall,1457,priest,holy,206,102,104
Motoripräst,stormreaver,1457,priest,holy,148,73,75
Jappsolut,outland,1456,priest,holy,101,56,45
Sebbepriest,twisting-nether,1455,priest,holy,34,19,15
Zrada,dalaran,1455,priest,holy,66,36,30
Suxino,stormscale,1455,priest,holy,185,94,91
Рилия,howling-fjord,1455,priest,holy,70,34,36
Dãrkmedic,silvermoon,1454,priest,holy,83,42,41
Mcdeady,tarren-mill,1454,priest,holy,42,19,23
Dùsty,archimonde,1453,priest,holy,74,41,33
Ceraghk,tichondrius,1453,priest,holy,52,23,29
Алеброн,gordunni,1452,priest,holy,123,65,58
Køzøxîä,dalaran,1452,priest,holy,60,20,40
Momopriesto,draenor,1450,priest,holy,89,41,48
Taksus,alexstrasza,1450,priest,holy,42,19,23
Mezegis,draenor,1449,priest,holy,48,26,22
Learning,ysondre,1449,priest,holy,194,99,95
Stigmátá,ravencrest,1449,priest,holy,54,26,28
Djdesha,tarren-mill,1447,priest,holy,41,19,22
Onixa,tarren-mill,1447,priest,holy,60,22,38
Нейроблум,soulflayer,1446,priest,holy,42,24,18
Mylini,silvermoon,1444,priest,holy,359,192,167
Åzjol,magtheridon,1443,priest,holy,85,39,46
Nýkah,antonidas,1441,priest,holy,42,20,22
Voodoo,the-maelstrom,1441,priest,holy,129,55,74
Discxqt,ysondre,1438,priest,holy,26,18,8
Бредяка,gordunni,1438,priest,holy,84,50,34
Juco,draenor,1438,priest,holy,342,175,167
Sqwabblepee,stormscale,1438,priest,holy,53,27,26
Ròka,ysondre,1438,priest,holy,72,34,38
Katleiya,ysondre,1437,priest,holy,23,16,7
Краббожий,greymane,1437,priest,holy,123,55,68
Thalane,das-konsortium,1437,priest,holy,66,29,37
Arianell,stormscale,1436,priest,holy,45,28,17
Sadgepriest,draenor,1435,priest,holy,132,68,64
Maerlene,nemesis,1433,priest,holy,54,31,23
Åluneth,kazzak,1432,priest,holy,336,172,164
Bobitä,ravencrest,1430,priest,holy,54,32,22
Mindconrol,twisting-nether,1430,priest,holy,64,36,28
Cellia,antonidas,1430,priest,holy,42,15,27
Vespîrâ,onyxia,1429,priest,holy,782,398,384
Lasuora,nemesis,1429,priest,holy,84,42,42
Bierbändiger,blackhand,1427,priest,holy,366,181,185
Battleground,defias-brotherhood,1427,priest,holy,36,17,19
Beecn,tarren-mill,1426,priest,holy,72,40,32
Dathanosx,outland,1426,priest,holy,34,17,17
Tavra,stormscale,1426,priest,holy,172,80,92
Jannolapin,ysondre,1425,priest,holy,48,25,23
Fizzlesp,tarren-mill,1425,priest,holy,30,15,15
Seladine,ravencrest,1423,priest,holy,212,109,103
Imaut,emerald-dream,1422,priest,holy,89,43,46
Cånniekekw,tarren-mill,1422,priest,holy,45,21,24
Rezzurrectum,doomhammer,1421,priest,holy,81,47,34
Бустержиесть,soulflayer,1421,priest,holy,54,25,29
Ittei,stormscale,1420,priest,holy,34,16,18
Dogfacex,ravencrest,1419,priest,holy,142,70,72
Kbakå,kazzak,1419,priest,holy,78,37,41
Arithon,blackrock,1417,priest,holy,30,18,12
Emipriest,tarren-mill,1417,priest,holy,269,136,133
Chosayomoine,elune,1417,priest,holy,57,28,29
Geilerheiler,dalvengyr,1416,priest,holy,24,15,9
Lómesilme,dun-modr,1416,priest,holy,235,122,113
Davìna,sunstrider,1416,priest,holy,127,65,62
Penitence,drekthar,1416,priest,holy,56,24,32
Virginmaris,sanguino,1415,priest,holy,113,64,49
Filthyzx,argent-dawn,1415,priest,holy,30,15,15
Lirych,the-maelstrom,1414,priest,holy,42,25,17
Smoree,malganis,1414,priest,holy,225,118,107
Willxzz,silvermoon,1414,priest,holy,88,36,52
Eazzyy,kazzak,1413,priest,holy,116,60,56
Lilianboss,stormscale,1412,priest,holy,47,25,22
Markianos,silvermoon,1412,priest,holy,114,58,56
Zufâllig,blackhand,1409,priest,holy,36,17,19
Judâspriest,twisting-nether,1408,priest,holy,107,52,55
Najglavniji,tarren-mill,1407,priest,holy,92,49,43
Balin,veklor,1407,priest,holy,77,35,42
Bifs,blackmoore,1405,priest,holy,50,32,18
Eedazap,argent-dawn,1405,priest,holy,33,16,17
Dwoa,silvermoon,1404,priest,holy,138,79,59
Gertie,blackhand,1404,priest,holy,94,49,45
Prinki,tarren-mill,1404,priest,holy,42,19,23
Kusé,anubarak,1404,priest,holy,36,15,21
Blacklemons,thrall,1403,priest,holy,48,26,22
Feelmypainn,kazzak,1402,priest,holy,119,66,53
Bochonok,stormrage,1402,priest,holy,45,18,27
Ezechiel,twisting-nether,1401,priest,holy,83,49,34
Adallon,blackmoore,1401,priest,holy,65,34,31
Dødy,hyjal,1400,priest,holy,24,15,9
Góldfinger,norgannon,1400,priest,holy,402,197,205
Byzzi,draenor,1398,priest,holy,317,162,155
Casconero,nemesis,1397,priest,holy,119,56,63
Aráko,blackhand,1396,priest,holy,50,28,22
Iwl,sanguino,1394,priest,holy,159,81,78
Sopsy,stormscale,1391,priest,holy,54,34,20
Pakmopriest,ragnaros,1391,priest,holy,36,19,17
Spikoui,uldaman,1391,priest,holy,72,31,41
Chaerii,blackmoore,1390,priest,holy,54,26,28
Lenara,kult-der-verdammten,1389,priest,holy,42,24,18
Tyene,voljin,1389,priest,holy,182,101,81
Hara,elune,1389,priest,holy,106,49,57
Melodyn,silvermoon,1389,priest,holy,56,23,33
Lädi,ravencrest,1388,priest,holy,108,58,50
Noxxill,eredar,1388,priest,holy,30,16,14
Exaneo,ragnaros,1387,priest,holy,33,18,15
Возхд,soulflayer,1387,priest,holy,84,44,40
Sannti,twisting-nether,1384,priest,holy,66,33,33
Novella,kult-der-verdammten,1383,priest,holy,82,50,32
Jaz,ysondre,1383,priest,holy,108,53,55
Nbeewwannabe,silvermoon,1382,priest,holy,179,99,80
Qzrx,outland,1382,priest,holy,30,15,15
Холихэйт,howling-fjord,1381,priest,holy,29,15,14
Adenisia,hyjal,1380,priest,holy,43,20,23
Aleanna,dalaran,1379,priest,holy,50,24,26
Letmehêal,archimonde,1377,priest,holy,96,47,49
Ikaa,wrathbringer,1377,priest,holy,59,28,31
Иссатея,galakrond,1377,priest,holy,84,39,45
Neoark,archimonde,1376,priest,holy,176,88,88
Veurjin,uldaman,1376,priest,holy,89,43,46
Annise,kazzak,1373,priest,holy,49,26,23
Bubbleup,defias-brotherhood,1373,priest,holy,162,85,77
Åshlol,ravencrest,1373,priest,holy,33,17,16
Mianxpriest,tarren-mill,1373,priest,holy,138,69,69
Madcole,blackhand,1371,priest,holy,85,43,42
Demonhunt,stormscale,1370,priest,holy,88,48,40
Мектран,gordunni,1369,priest,holy,66,31,35
Konstigadan,twisting-nether,1369,priest,holy,56,26,30
Chrishyp,blackrock,1368,priest,holy,70,49,21
Cagedforlife,draenor,1368,priest,holy,52,21,31
Eurydike,blackrock,1367,priest,holy,152,84,68
Vibby,moonglade,1364,priest,holy,41,20,21
Elessee,the-maelstrom,1364,priest,holy,172,82,90
Meatyshaft,doomhammer,1363,priest,holy,69,34,35
Discobrill,silvermoon,1362,priest,holy,60,36,24
Nomakprst,sanguino,1362,priest,holy,60,31,29
Pleistex,sylvanas,1362,priest,holy,99,47,52
Midycine,ysondre,1360,priest,holy,322,164,158
Draconux,terenas,1359,priest,holy,105,51,54
Chibrausorus,archimonde,1358,priest,holy,181,93,88
Elunos,blackrock,1358,priest,holy,130,65,65
Tëmärï,ravencrest,1356,priest,holy,72,46,26
Zorea,twisting-nether,1356,priest,holy,153,76,77
Маракеда,soulflayer,1356,priest,holy,65,32,33
Rustyroll,stormscale,1356,priest,holy,48,23,25
Ábomínatíøn,ravencrest,1354,priest,holy,36,18,18
Zyrusen,sanguino,1354,priest,holy,48,21,27
Hyonzy,silvermoon,1353,priest,holy,339,170,169
Stk,outland,1353,priest,holy,47,17,30
Nino,gorgonnash,1349,priest,holy,114,55,59
Bigpinkballs,tarren-mill,1347,priest,holy,48,26,22
Speltmor,stormscale,1347,priest,holy,95,47,48
Pridepriest,twisting-nether,1346,priest,holy,84,42,42
Prencø,sanguino,1345,priest,holy,34,16,18
Certe,twisting-nether,1344,priest,holy,139,67,72
Surge,drakthul,1343,priest,holy,39,22,17
Papadrak,kazzak,1343,priest,holy,101,55,46
Zlejkadlec,drakthul,1342,priest,holy,103,52,51
Pleadz,tarren-mill,1342,priest,holy,60,27,33
Azoran,dentarg,1341,priest,holy,24,14,10
Kiralinia,eredar,1341,priest,holy,162,83,79
Zellita,ravencrest,1340,priest,holy,114,45,69
Haineko,burning-legion,1339,priest,holy,135,65,70
Nykah,antonidas,1339,priest,holy,109,51,58
Ørdø,antonidas,1338,priest,holy,74,34,40
Аринэко,howling-fjord,1338,priest,holy,87,39,48
Calïxløve,der-rat-von-dalaran,1337,priest,holy,31,20,11
Xzarion,nozdormu,1336,priest,holy,41,19,22
Nálá,nethersturm,1335,priest,holy,115,59,56
Kolsäck,twilights-hammer,1334,priest,holy,30,14,16
Soloria,twisting-nether,1334,priest,holy,35,15,20
Húlda,auchindoun,1331,priest,holy,140,67,73
Ayess,aegwynn,1330,priest,holy,65,37,28
Sücre,dalaran,1330,priest,holy,166,93,73
Fedorah,ragnaros,1330,priest,holy,114,63,51
Migam,kazzak,1330,priest,holy,255,127,128
Stàrlîght,chants-éternels,1329,priest,holy,48,27,21
Avp,the-maelstrom,1329,priest,holy,66,36,30
Spamplague,stormscale,1329,priest,holy,98,47,51
Wedoburgers,ravencrest,1329,priest,holy,30,14,16
Orcid,chogall,1327,priest,holy,146,75,71
Alú,draenor,1327,priest,holy,153,73,80
Ageo,sanguino,1326,priest,holy,71,36,35
Luxtrii,blackrock,1326,priest,holy,48,20,28
Prîestitute,twisting-nether,1325,priest,holy,36,18,18
Excó,burning-legion,1324,priest,holy,73,40,33
Talie,frostmourne,1323,priest,holy,36,21,15
Isalvation,stormscale,1321,priest,holy,30,14,16
Элдерле,gordunni,1320,priest,holy,41,21,20
Elynä,silvermoon,1318,priest,holy,78,50,28
Alros,elune,1318,priest,holy,84,40,44
Runbaberun,hyjal,1317,priest,holy,52,30,22
Tolteck,ravencrest,1317,priest,holy,144,77,67
Ebolaidman,ravencrest,1317,priest,holy,54,26,28
Navi,emerald-dream,1316,priest,holy,69,38,31
Budgetinfa,draenor,1315,priest,holy,24,14,10
Atiyesh,arthas,1315,priest,holy,285,149,136
Owait,tarren-mill,1312,priest,holy,60,27,33
Soapie,defias-brotherhood,1311,priest,holy,60,34,26
Lazheal,khaz-modan,1311,priest,holy,186,104,82
Sepa,stormreaver,1311,priest,holy,30,14,16
Devot,outland,1311,priest,holy,30,14,16
Velenthan,ragnaros,1308,priest,holy,36,18,18
Szelén,ragnaros,1307,priest,holy,24,14,10
Mashimaro,blackhand,1307,priest,holy,198,102,96
Чёбушек,gordunni,1306,priest,holy,53,27,26
Cherron,argent-dawn,1305,priest,holy,61,27,34
Tomassur,drakthul,1304,priest,holy,132,67,65
Brodoswaginz,the-maelstrom,1300,priest,holy,65,29,36
Асггард,borean-tundra,1299,priest,holy,91,57,34
Idisck,kazzak,1299,priest,holy,62,30,32
Ten,haomarush,1298,priest,holy,30,16,14
Makkalisser,kazzak,1298,priest,holy,41,20,21
Lulubel,argent-dawn,1294,priest,holy,24,14,10
Hmanco,burning-legion,1293,priest,holy,466,236,230
Redpök,hyjal,1292,priest,holy,42,23,19
Vrêth,blackmoore,1289,priest,holy,35,21,14
Mikasaa,frostwolf,1286,priest,holy,48,19,29
Phénylanine,khaz-modan,1285,priest,holy,474,243,231
Rrpriest,silvermoon,1282,priest,holy,51,27,24
Josephr,blackmoore,1282,priest,holy,64,31,33
Vocolieth,argent-dawn,1281,priest,holy,214,103,111
Dètox,twisting-nether,1280,priest,holy,92,44,48
Evílz,tarren-mill,1280,priest,holy,39,14,25
Kayia,bloodfeather,1279,priest,holy,37,16,21
Sickheals,doomhammer,1278,priest,holy,146,89,57
Вакидзачи,gordunni,1278,priest,holy,269,130,139
Síuu,kazzak,1277,priest,holy,72,35,37
Iljas,kelthuzad,1276,priest,holy,116,68,48
Alloktonos,ravencrest,1276,priest,holy,122,60,62
Nemista,hyjal,1276,priest,holy,124,58,66
Nerfnerf,kazzak,1275,priest,holy,93,51,42
Lavidu,antonidas,1274,priest,holy,42,15,27
Skryllette,archimonde,1272,priest,holy,54,25,29
Wintercurse,twisting-nether,1272,priest,holy,52,24,28
Zakhun,stormrage,1271,priest,holy,82,42,40
Neeyø,blackhand,1271,priest,holy,42,16,26
Misscure,draenor,1270,priest,holy,136,63,73
Êfnân,twisting-nether,1269,priest,holy,30,18,12
Angelsdust,ravencrest,1269,priest,holy,43,19,24
Umayyaa,sylvanas,1268,priest,holy,86,35,51
Хасгерион,gordunni,1267,priest,holy,100,42,58
Ethery,argent-dawn,1266,priest,holy,65,33,32
Selfcontrol,blackhand,1266,priest,holy,38,16,22
Yinyangyø,eredar,1266,priest,holy,42,16,26
Lianzo,kazzak,1265,priest,holy,36,16,20
Mîssandé,blackhand,1264,priest,holy,82,36,46
Tépinette,chogall,1262,priest,holy,36,19,17
Tudiiheals,frostwolf,1261,priest,holy,91,48,43
Köküshibö,draenor,1261,priest,holy,27,14,13
Elf,tarren-mill,1259,priest,holy,54,21,33
Piizzdiica,twisting-nether,1258,priest,holy,30,16,14
Blazekk,sylvanas,1258,priest,holy,62,25,37
Disturbdtwo,archimonde,1257,priest,holy,35,16,19
Dôppler,archimonde,1256,priest,holy,23,14,9
Rostá,drakthul,1256,priest,holy,53,27,26
Sohryø,drekthar,1254,priest,holy,115,59,56
Ludriel,turalyon,1254,priest,holy,78,40,38
Асах,gordunni,1252,priest,holy,120,59,61
Peg,talnivarr,1252,priest,holy,31,15,16
Antiexhile,kazzak,1251,priest,holy,35,21,14
Shalalalalaè,outland,1251,priest,holy,70,39,31
Lhyria,baelgun,1251,priest,holy,67,33,34
Gloxina,argent-dawn,1250,priest,holy,114,56,58
Daubulaieipl,hellfire,1249,priest,holy,42,25,17
Morîana,les-sentinelles,1249,priest,holy,59,30,29
Gudóngmae,ravencrest,1248,priest,holy,24,13,11
Prästera,draenor,1247,priest,holy,36,18,18
Like,frostwolf,1247,priest,holy,30,15,15
Emilysister,kazzak,1247,priest,holy,201,98,103
Dathlight,argent-dawn,1246,priest,holy,125,65,60
Фирец,howling-fjord,1246,priest,holy,36,13,23
Sloee,kazzak,1245,priest,holy,18,13,5
Judgementdaý,kazzak,1245,priest,holy,24,13,11
Maybelline,ravencrest,1245,priest,holy,48,23,25
Nakali,the-maelstrom,1245,priest,holy,77,36,41
Suili,twisting-nether,1243,priest,holy,24,13,11
Skíps,sylvanas,1242,priest,holy,103,48,55
Sodatsu,cthun,1242,priest,holy,60,26,34
Døgfîsh,stormscale,1241,priest,holy,18,13,5
Wraithtrippz,stormscale,1241,priest,holy,24,13,11
Kasualoix,stormscale,1241,priest,holy,36,14,22
Azeeza,stormscale,1240,priest,holy,18,13,5
Ashrod,stormscale,1240,priest,holy,67,34,33
Ÿolo,nemesis,1240,priest,holy,30,13,17
Zerotalent,stormscale,1238,priest,holy,18,13,5
Danglar,defias-brotherhood,1237,priest,holy,18,13,5
Moirgana,minahonda,1235,priest,holy,87,39,48
Elián,silvermoon,1234,priest,holy,75,39,36
Morrydin,stormreaver,1233,priest,holy,108,48,60
Amorune,twilights-hammer,1233,priest,holy,30,13,17
Enaches,twisting-nether,1231,priest,holy,92,53,39
Forsetî,archimonde,1230,priest,holy,48,25,23
Fuloo,stormscale,1230,priest,holy,197,96,101
Gummi,blackhand,1230,priest,holy,72,31,41
Elvorfidia,silvermoon,1229,priest,holy,96,44,52
Mabz,defias-brotherhood,1229,priest,holy,36,13,23
Ihavewings,kazzak,1228,priest,holy,30,13,17
Swdjack,blackrock,1225,priest,holy,36,13,23
Nicksiz,silvermoon,1224,priest,holy,46,19,27
Drdiscospec,tarren-mill,1222,priest,holy,36,20,16
Ичисанчик,howling-fjord,1222,priest,holy,26,13,13
Lykarion,argent-dawn,1221,priest,holy,78,38,40
Madnasty,azshara,1220,priest,holy,36,20,16
Sapphos,ravencrest,1216,priest,holy,47,23,24
Hølýðéåthjçç,tarren-mill,1215,priest,holy,94,44,50
Neenä,ravencrest,1214,priest,holy,50,25,25
Голнар,deathguard,1213,priest,holy,58,26,32
Dúréx,sanguino,1212,priest,holy,42,28,14
Lobogaust,kargath,1211,priest,holy,284,159,125
Gaijins,tyrande,1211,priest,holy,36,18,18
Libetha,ysondre,1211,priest,holy,95,46,49
Pryna,dunemaul,1210,priest,holy,78,38,40
Anateoris,turalyon,1208,priest,holy,269,121,148
Asare,outland,1207,priest,holy,383,192,191
Shannywen,nemesis,1207,priest,holy,60,18,42
Slimemarther,nordrassil,1206,priest,holy,130,57,73
Rhäenÿra,hyjal,1204,priest,holy,82,46,36
Proteco,antonidas,1204,priest,holy,42,22,20
Crimatoriá,rajaxx,1203,priest,holy,114,64,50
Omnissiiah,silvermoon,1203,priest,holy,30,13,17
Скартэикс,howling-fjord,1202,priest,holy,72,33,39
Хилтихон,howling-fjord,1200,priest,holy,42,26,16
Góli,argent-dawn,1200,priest,holy,30,13,17
Testdeex,ravencrest,1197,priest,holy,23,13,10
Unchainedz,twisting-nether,1196,priest,holy,88,39,49
Nashidara,frostmane,1195,priest,holy,33,14,19
Keskiyö,ravencrest,1193,priest,holy,27,14,13
Benificent,argent-dawn,1192,priest,holy,76,38,38
Sokolado,silvermoon,1187,priest,holy,54,28,26
Бенигана,soulflayer,1187,priest,holy,70,35,35
Ripjuice,sylvanas,1186,priest,holy,84,44,40
Dotterin,draenor,1185,priest,holy,35,19,16
Holydolly,doomhammer,1184,priest,holy,108,55,53
Kímbérléy,argent-dawn,1183,priest,holy,181,92,89
Bowie,frostwhisper,1183,priest,holy,96,41,55
Холимыша,blackscar,1182,priest,holy,63,32,31
Карнотит,howling-fjord,1182,priest,holy,48,16,32
Dwano,balnazzar,1181,priest,holy,30,18,12
Insicompany,antonidas,1179,priest,holy,80,44,36
Berrylee,twisting-nether,1177,priest,holy,28,14,14
Zloop,tarren-mill,1175,priest,holy,36,17,19
Mandzukic,stormscale,1175,priest,holy,83,36,47
Ниеса,lich-king,1174,priest,holy,110,52,58
Jarnary,blackmoore,1171,priest,holy,75,33,42
Fareeya,thrall,1171,priest,holy,48,20,28
Nosgot,earthen-ring,1169,priest,holy,78,34,44
Mugyu,antonidas,1169,priest,holy,47,19,28
Matdd,arthas,1168,priest,holy,60,29,31
Torcena,garrosh,1166,priest,holy,141,70,71
Killtrew,ravencrest,1165,priest,holy,39,13,26
Ashesnéy,thrall,1164,priest,holy,81,39,42
Cóòkie,silvermoon,1163,priest,holy,36,16,20
Kbakå,stormscale,1162,priest,holy,71,29,42
Voreno,alonsus,1160,priest,holy,65,24,41
Avtarra,ravencrest,1159,priest,holy,174,84,90
Drypri,twisting-nether,1158,priest,holy,26,13,13
Eîslotus,blackrock,1156,priest,holy,119,53,66
Annebonny,lightnings-blade,1155,priest,holy,71,32,39
Kiånå,teldrassil,1152,priest,holy,257,119,138
Jmp,tarren-mill,1151,priest,holy,18,12,6
Nenku,minahonda,1151,priest,holy,18,12,6
Xxanthos,ysondre,1151,priest,holy,394,207,187
Lúthien,outland,1150,priest,holy,18,12,6
Satins,silvermoon,1150,priest,holy,21,13,8
Swdömmel,aegwynn,1150,priest,holy,24,12,12
Seeyae,ravencrest,1149,priest,holy,24,12,12
Tansk,stormscale,1147,priest,holy,24,12,12
Sambiel,antonidas,1147,priest,holy,36,13,23
Ertruski,exodar,1146,priest,holy,54,28,26
Ilerya,hyjal,1145,priest,holy,70,35,35
Nancey,draenor,1145,priest,holy,24,12,12
Vaenor,durotan,1145,priest,holy,30,12,18
Fjems,ravencrest,1144,priest,holy,44,22,22
Hepakko,stormscale,1143,priest,holy,24,12,12
Libido,outland,1142,priest,holy,36,17,19
Healthebeast,kazzak,1141,priest,holy,18,12,6
Ðoxy,frostmane,1141,priest,holy,24,12,12
Venomrush,ravencrest,1141,priest,holy,24,12,12
Ахмох,gordunni,1139,priest,holy,30,13,17
Leyrie,draenor,1138,priest,holy,69,25,44
Lyla,frostwolf,1137,priest,holy,76,41,35
Domerick,outland,1136,priest,holy,30,12,18
Brigied,turalyon,1135,priest,holy,351,166,185
Kaleycuoco,blackhand,1133,priest,holy,24,12,12
Rastafaja,doomhammer,1133,priest,holy,83,34,49
Athissa,draenor,1133,priest,holy,36,14,22
Deltapriest,shadowsong,1132,priest,holy,24,12,12
Andreel,ravencrest,1131,priest,holy,24,12,12
Morphuz,tarren-mill,1130,priest,holy,186,86,100
Cazzîe,eredar,1129,priest,holy,18,12,6
Meowcakes,stormscale,1127,priest,holy,54,30,24
Asraje,eredar,1121,priest,holy,68,39,29
Холреин,gordunni,1120,priest,holy,48,13,35
Hampådenbååd,kazzak,1119,priest,holy,22,13,9
Vouhza,turalyon,1119,priest,holy,72,38,34
Senbønzakùra,khaz-modan,1119,priest,holy,72,34,38
Copperplume,ravenholdt,1116,priest,holy,264,124,140
Türapea,draenor,1114,priest,holy,66,37,29
Mindgame,anachronos,1112,priest,holy,48,19,29
Akwah,dalaran,1111,priest,holy,42,15,27
Voelvah,ragnaros,1108,priest,holy,48,18,30
Mundwerk,malganis,1107,priest,holy,60,22,38
Каятль,gordunni,1105,priest,holy,53,21,32
Beatla,khaz-modan,1104,priest,holy,75,40,35
Pristerline,antonidas,1104,priest,holy,31,12,19
Elîsyø,blackmoore,1103,priest,holy,30,12,18
Anàriel,elune,1100,priest,holy,48,19,29
Thingsy,draenor,1099,priest,holy,104,54,50
Itstooney,doomhammer,1093,priest,holy,36,19,17
Shaniqua,saurfang,1093,priest,holy,104,53,51
Miniluk,zuljin,1092,priest,holy,116,62,54
Cheeséd,ravencrest,1090,priest,holy,28,13,15
Åme,kirin-tor,1089,priest,holy,54,19,35
Holypowér,twisting-nether,1088,priest,holy,30,17,13
Grausami,zuluhed,1083,priest,holy,35,12,23
Naieli,antonidas,1079,priest,holy,92,49,43
Киторик,blackscar,1078,priest,holy,77,37,40
Ulrach,hyjal,1077,priest,holy,27,13,14
Quatorze,voljin,1074,priest,holy,40,20,20
Ломаюключики,gordunni,1073,priest,holy,90,44,46
Deeforce,argent-dawn,1072,priest,holy,97,53,44
Larisä,uldum,1070,priest,holy,201,96,105
Drràcø,hyjal,1068,priest,holy,39,17,22
Sáro,ravencrest,1066,priest,holy,50,21,29
Kæos,blackrock,1065,priest,holy,129,58,71
Vampiro,blackhand,1062,priest,holy,20,12,8
Nightwemet,kirin-tor,1058,priest,holy,48,23,25
Eile,doomhammer,1058,priest,holy,36,17,19
Neems,twisting-nether,1056,priest,holy,24,11,13
Миррен,gordunni,1055,priest,holy,18,11,7
Arianaglandé,hyjal,1055,priest,holy,18,11,7
Æbe,tarren-mill,1055,priest,holy,18,11,7
Луилэнс,howling-fjord,1055,priest,holy,18,11,7
Øbz,sylvanas,1055,priest,holy,24,11,13
Åçrû,dun-modr,1055,priest,holy,24,11,13
Cãlyr,ragnaros,1055,priest,holy,30,11,19
Dreê,hyjal,1054,priest,holy,18,11,7
Тевтонка,goldrinn,1054,priest,holy,80,38,42
Сонлия,gordunni,1054,priest,holy,24,11,13
Рейеан,soulflayer,1054,priest,holy,24,11,13
Duskojar,kazzak,1054,priest,holy,24,11,13
Uro,tirion,1053,priest,holy,30,11,19
Арингол,howling-fjord,1052,priest,holy,58,27,31
Wurstpriest,silvermoon,1052,priest,holy,30,11,19
Mgx,defias-brotherhood,1052,priest,holy,30,11,19
Крайл,blackscar,1051,priest,holy,111,37,74
Leyea,kazzak,1050,priest,holy,55,28,27
Elinaa,die-aldor,1050,priest,holy,24,11,13
Peelz,uldaman,1050,priest,holy,30,11,19
Syhndel,draenor,1049,priest,holy,24,11,13
Murmaiderrx,draenor,1048,priest,holy,24,11,13
Aureï,khaz-modan,1047,priest,holy,30,12,18
Overdøz,archimonde,1047,priest,holy,30,11,19
Bamboleon,blackrock,1046,priest,holy,24,11,13
Tákú,blackmoore,1045,priest,holy,116,55,61
Lindp,stormreaver,1045,priest,holy,24,11,13
Sâtânica,kelthuzad,1044,priest,holy,141,64,77
Harlemsfnest,blackrock,1042,priest,holy,24,13,11
Pretzioso,nemesis,1042,priest,holy,87,39,48
Qazar,draenor,1036,priest,holy,18,11,7
Астит,soulflayer,1035,priest,holy,54,18,36
Orcü,tarren-mill,1033,priest,holy,78,36,42
Fratio,krasus,1033,priest,holy,42,18,24
Wildjaevel,grim-batol,1033,priest,holy,30,11,19
Laewen,die-aldor,1032,priest,holy,82,39,43
Nathamo,archimonde,1028,priest,holy,24,11,13
Juicedmaboi,tarren-mill,1028,priest,holy,24,11,13
Valdos,hyjal,1026,priest,holy,48,16,32
Priestxx,twilights-hammer,1021,priest,holy,23,11,12
Onnovq,ravencrest,1017,priest,holy,23,11,12
Epona,terrordar,1017,priest,holy,24,11,13
Haregnor,gorgonnash,1016,priest,holy,54,22,32
Moriou,dun-morogh,1015,priest,holy,24,13,11
Noroelle,drakthul,1015,priest,holy,24,12,12
Baabaak,frostmane,1014,priest,holy,87,49,38
Edvardy,stormreaver,1014,priest,holy,23,11,12
Ankhepope,outland,1013,priest,holy,56,33,23
Ivaldur,antonidas,1012,priest,holy,36,17,19
Hegg,ghostlands,1010,priest,holy,60,17,43
Sugarush,ravencrest,1008,priest,holy,32,12,20
Narwarion,die-aldor,1006,priest,holy,90,42,48
Docmercy,dun-morogh,1004,priest,holy,78,32,46
Tezzi,azjolnerub,1003,priest,holy,79,35,44
Valtessian,medivh,1000,priest,holy,75,37,38
Spoc,blackrock,1000,priest,holy,30,11,19
Tiphanie,kazzak,999,priest,holy,89,39,50
Gød,magtheridon,999,priest,holy,40,12,28
Hipnotika,nemesis,997,priest,holy,76,29,47
Båbak,frostmane,994,priest,holy,51,24,27
Areonas,alleria,994,priest,holy,99,40,59
Diszi,norgannon,992,priest,holy,26,12,14
Loordïngue,eldrethalas,992,priest,holy,24,11,13
Zerula,outland,990,priest,holy,42,21,21
Covidios,twisting-nether,990,priest,holy,93,43,50
Zakkonnik,burning-legion,989,priest,holy,24,14,10
Applecrumßle,ragnaros,983,priest,holy,65,32,33
Рикимарочка,gordunni,977,priest,holy,54,20,34
Dampfwalze,nozdormu,969,priest,holy,67,33,34
Voidsoul,blackmoore,965,priest,holy,19,11,8
Amemiya,ragnaros,961,priest,holy,28,12,16
Artístx,twisting-nether,960,priest,holy,24,10,14
Десемин,deathguard,960,priest,holy,47,18,29
Marôs,antonidas,959,priest,holy,12,10,2
Mcmuffin,runetotem,959,priest,holy,21,13,8
Sucukpriest,blackrock,959,priest,holy,20,12,8
Рагзел,howling-fjord,959,priest,holy,18,10,8
Maryjanè,twisting-nether,959,priest,holy,18,10,8
Dqt,ragnaros,959,priest,holy,18,10,8
Iirina,draenor,959,priest,holy,18,10,8
Padisonpain,blackmoore,959,priest,holy,18,10,8
Eilene,pozzo-delleternità,959,priest,holy,24,10,14
Nûtqt,archimonde,958,priest,holy,18,10,8
Lâughing,ravencrest,958,priest,holy,24,10,14
Lenneyqt,blackmoore,958,priest,holy,24,10,14
Stinkynoob,kazzak,958,priest,holy,24,10,14
Vänskap,kazzak,958,priest,holy,24,10,14
Mesticore,nethersturm,958,priest,holy,24,10,14
Bebwaz,kazzak,958,priest,holy,24,10,14
Azrella,ravencrest,957,priest,holy,18,10,8
Byebee,stormscale,956,priest,holy,12,10,2
Ilsebill,nerathor,956,priest,holy,47,26,21
Nøfear,tarren-mill,956,priest,holy,35,10,25
Rennic,stormscale,955,priest,holy,18,10,8
Нёрфмили,soulflayer,955,priest,holy,24,10,14
Bacardii,blackmoore,954,priest,holy,18,10,8
Arkkupiispa,stormreaver,954,priest,holy,24,10,14
Nannymcfee,stormscale,953,priest,holy,23,11,12
Vengigodxx,ravencrest,952,priest,holy,18,10,8
Melancholly,thunderhorn,951,priest,holy,41,19,22
Hilerki,draenor,951,priest,holy,24,10,14
Avïlia,dalaran,950,priest,holy,30,10,20
Smø,kazzak,949,priest,holy,30,10,20
Hegêan,argent-dawn,945,priest,holy,83,40,43
Cemiing,drakthul,944,priest,holy,24,10,14
Hodza,frostmane,941,priest,holy,114,64,50
Meenaye,hyjal,940,priest,holy,18,10,8
Siarai,pozzo-delleternità,937,priest,holy,73,33,40
Priincess,ragnaros,936,priest,holy,68,23,45
Priestyo,blackrock,934,priest,holy,39,14,25
Addison,die-aldor,933,priest,holy,24,10,14
Majdas,ravencrest,927,priest,holy,14,11,3
Noukeé,blackrock,927,priest,holy,29,10,19
Jitters,lightnings-blade,925,priest,holy,18,11,7
Isiriah,archimonde,925,priest,holy,18,10,8
Maxý,ravencrest,924,priest,holy,60,25,35
Brightharp,argent-dawn,919,priest,holy,28,10,18
Archangel,terokkar,916,priest,holy,60,30,30
Chaendral,darkmoon-faire,911,priest,holy,32,11,21
Kanki,haomarush,908,priest,holy,96,48,48
Nyygalease,burning-legion,905,priest,holy,23,12,11
Unborkenn,ragnaros,905,priest,holy,30,12,18
Ламедрис,gordunni,904,priest,holy,41,10,31
Infinitiy,sylvanas,900,priest,holy,53,25,28
Rahela,sanguino,897,priest,holy,23,11,12
Пристотян,gordunni,894,priest,holy,20,10,10
Xlhealscptn,arathor,889,priest,holy,66,19,47
Sîanah,archimonde,886,priest,holy,28,11,17
Fivequeens,tarren-mill,883,priest,holy,60,25,35
Protegee,draenor,879,priest,holy,87,30,57
Monetaria,das-syndikat,874,priest,holy,148,62,86
Авэнсис,howling-fjord,869,priest,holy,54,21,33
Chimplordx,argent-dawn,864,priest,holy,12,9,3
Aeqüitas,tarren-mill,864,priest,holy,15,10,5
Zeraphïn,eredar,864,priest,holy,18,9,9
Rhæveth,ravencrest,864,priest,holy,18,9,9
Crowny,ysondre,864,priest,holy,18,9,9
Ømegagødx,outland,864,priest,holy,30,9,21
Neverque,defias-brotherhood,863,priest,holy,12,9,3
Âlolexx,archimonde,863,priest,holy,12,9,3
Tyog,khazgoroth,863,priest,holy,12,9,3
Resuscitator,spinebreaker,863,priest,holy,18,9,9
Ashp,shattered-halls,863,priest,holy,24,9,15
Narinelepen,culte-de-la-rive-noire,863,priest,holy,24,9,15
Другподруг,soulflayer,862,priest,holy,18,9,9
Kalkudis,blackmoore,862,priest,holy,18,9,9
Viroxian,outland,862,priest,holy,18,9,9
Oxiièmort,khaz-modan,862,priest,holy,24,9,15
Exola,outland,862,priest,holy,30,9,21
Faelvirin,aegwynn,861,priest,holy,18,9,9
Arezou,ravencrest,861,priest,holy,24,9,15
Didntlos,aegwynn,861,priest,holy,24,9,15
Hónòr,sylvanas,861,priest,holy,30,9,21
Marey,blackmoore,860,priest,holy,24,9,15
Azaza,burning-legion,851,priest,holy,55,25,30
Centauria,burning-legion,851,priest,holy,60,17,43
Widok,kazzak,848,priest,holy,113,58,55
Xver,dun-morogh,848,priest,holy,24,9,15
Ayahuascarli,ravencrest,847,priest,holy,17,9,8
Jbte,silvermoon,845,priest,holy,36,9,27
Лалуса,gordunni,844,priest,holy,28,11,17
Xal,drekthar,833,priest,holy,306,132,174
Sosûke,archimonde,830,priest,holy,23,9,14
Cherrih,argent-dawn,829,priest,holy,23,9,14
Eglantinna,ravencrest,809,priest,holy,14,10,4
Vyràn,onyxia,809,priest,holy,23,10,13
Пейлон,howling-fjord,807,priest,holy,43,14,29
Safiira,argent-dawn,798,priest,holy,132,64,68
Nokizzle,antonidas,795,priest,holy,14,9,5
Zongiz,azjolnerub,786,priest,holy,22,9,13
Zargathx,kazzak,778,priest,holy,19,10,9
Lloreen,ravencrest,768,priest,holy,12,8,4
Whitemask,kazzak,768,priest,holy,12,8,4
Vyrá,der-rat-von-dalaran,768,priest,holy,12,8,4
Dès,ravencrest,768,priest,holy,12,8,4
Джулибуба,borean-tundra,768,priest,holy,18,8,10
Gimeurgold,destromath,768,priest,holy,18,8,10
Legitha,blackmoore,768,priest,holy,18,8,10
Randomxdisc,draenor,767,priest,holy,12,8,4
Experimentix,silvermoon,767,priest,holy,12,8,4
Artés,suramar,767,priest,holy,18,8,10
Lovely,silvermoon,767,priest,holy,18,8,10
Neagica,kazzak,767,priest,holy,18,8,10
Glyss,draenor,767,priest,holy,18,8,10
Hannïri,archimonde,767,priest,holy,18,8,10
Arits,tarren-mill,767,priest,holy,18,8,10
Sayash,chamber-of-aspects,766,priest,holy,18,8,10
Priesless,sylvanas,766,priest,holy,18,8,10
Malizia,ragnaros,766,priest,holy,18,8,10
Drêäms,archimonde,766,priest,holy,24,8,16
Helerys,archimonde,766,priest,holy,24,8,16
Knóld,draenor,766,priest,holy,24,8,16
Elenie,frostwolf,766,priest,holy,30,8,22
Frednshield,tarren-mill,765,priest,holy,12,8,4
Stranger,thunderhorn,765,priest,holy,18,8,10
Krilight,sargeras,765,priest,holy,24,8,16
Aladra,archimonde,765,priest,holy,30,8,22
Nargøff,tarren-mill,764,priest,holy,18,8,10
Anyea,dalaran,764,priest,holy,24,8,16
Hellhámmer,azshara,763,priest,holy,18,8,10
Taint,khadgar,762,priest,holy,12,8,4
Lasanka,sylvanas,761,priest,holy,24,8,16
Melissasky,ragnaros,760,priest,holy,60,22,38
Chyen,kult-der-verdammten,758,priest,holy,18,8,10
Avinci,blackrock,757,priest,holy,18,8,10
Piddá,twisting-nether,755,priest,holy,18,8,10
Lockmold,tarren-mill,755,priest,holy,27,11,16
Nevermd,blackrock,755,priest,holy,43,11,32
Spàgno,nemesis,750,priest,holy,24,8,16
Phelesto,ysera,749,priest,holy,104,46,58
Besmrtna,saurfang,749,priest,holy,23,8,15
Waycrest,ravencrest,746,priest,holy,23,11,12
Eternitiy,auchindoun,744,priest,holy,18,8,10
Blaulienchen,proudmoore,736,priest,holy,36,11,25
Salzholy,malygos,735,priest,holy,17,8,9
Englishheart,auchindoun,734,priest,holy,17,8,9
Mønsterx,kazzak,732,priest,holy,16,9,7
Kirvane,outland,724,priest,holy,20,10,10
Popå,aerie-peak,724,priest,holy,36,8,28
Fatherted,nagrand,722,priest,holy,64,17,47
Felvytwo,stormscale,714,priest,holy,24,9,15
Aspertina,outland,714,priest,holy,27,9,18
Iliridan,pozzo-delleternità,708,priest,holy,194,62,132
Valentinus,dragonmaw,702,priest,holy,26,8,18
Mélínâ,blackmoore,691,priest,holy,28,9,19
Senga,kazzak,672,priest,holy,12,7,5
Burnesenbois,chogall,672,priest,holy,12,7,5
Verti,outland,672,priest,holy,12,7,5
Jaytï,ravencrest,672,priest,holy,12,7,5
Willzah,outland,672,priest,holy,12,7,5
Môrtïciâ,tarren-mill,672,priest,holy,12,7,5
Ibunnyqt,aegwynn,672,priest,holy,12,7,5
Arabpriest,draenor,672,priest,holy,12,7,5
Namîxoxo,ysondre,672,priest,holy,12,7,5
Nelakya,blackmoore,672,priest,holy,12,7,5
Ботхесатва,deepholm,672,priest,holy,12,7,5
Artìst,ravencrest,672,priest,holy,12,7,5
Гшд,gordunni,672,priest,holy,12,7,5
Darkoul,conseil-des-ombres,672,priest,holy,12,7,5
Fxd,talnivarr,672,priest,holy,12,7,5
Mythasz,archimonde,672,priest,holy,16,8,8
Ticklypriest,outland,672,priest,holy,18,7,11
Valinoru,silvermoon,672,priest,holy,18,7,11
Naïcos,dun-modr,672,priest,holy,18,7,11
Nooblygaming,nemesis,672,priest,holy,18,7,11
Fabulicious,blackrock,672,priest,holy,18,7,11
Missbarbados,blackmoore,672,priest,holy,18,7,11
Westfalen,tichondrius,672,priest,holy,18,7,11
Russianpvp,outland,672,priest,holy,18,7,11
Synexia,sylvanas,671,priest,holy,12,7,5
Gujjax,doomhammer,671,priest,holy,12,7,5
Jajada,kazzak,671,priest,holy,18,7,11
Systerstål,twisting-nether,671,priest,holy,18,7,11
Egozyp,kazzak,671,priest,holy,20,7,13
Kineila,dun-morogh,671,priest,holy,24,7,17
Smolbøi,tarren-mill,670,priest,holy,24,7,17
Luffly,draenor,669,priest,holy,12,7,5
Asmila,die-nachtwache,669,priest,holy,18,7,11
Zinary,silvermoon,667,priest,holy,18,7,11
Datek,silvermoon,667,priest,holy,18,7,11
Lovestruck,kazzak,665,priest,holy,18,7,11
Ларуса,gordunni,662,priest,holy,15,8,7
Yayaxoxo,archimonde,660,priest,holy,26,10,16
Ledarz,dun-morogh,658,priest,holy,18,7,11
Sarafîsthole,ysondre,655,priest,holy,18,7,11
Kaliboom,archimonde,654,priest,holy,23,7,16
Naid,exodar,654,priest,holy,24,7,17
Níghty,ravencrest,639,priest,holy,11,7,4
Killtrewerty,stormscale,638,priest,holy,17,7,10
Branmer,silvermoon,627,priest,holy,29,7,22
Sinetrax,tarren-mill,624,priest,holy,17,8,9
Winilo,ravencrest,622,priest,holy,17,7,10
Svakkanxd,kazzak,618,priest,holy,19,8,11
Fréecaster,ravencrest,607,priest,holy,11,7,4
Tiphereth,blackmoore,607,priest,holy,14,8,6
Valves,saurfang,604,priest,holy,164,70,94
Blâdes,gorgonnash,589,priest,holy,17,7,10
Babá,argent-dawn,576,priest,holy,6,6,0
Ahilarry,tarren-mill,576,priest,holy,12,6,6
Swiftdemise,sylvanas,576,priest,holy,12,6,6
Anthonyn,ravencrest,576,priest,holy,12,6,6
Eoraoierai,ragnaros,576,priest,holy,12,6,6
Azymi,ravencrest,576,priest,holy,12,6,6
Redy,drakthul,576,priest,holy,12,6,6
Bij,outland,576,priest,holy,12,6,6
Darkoul,ravencrest,576,priest,holy,12,6,6
Schattenface,blackmoore,576,priest,holy,12,6,6
Shadowkym,blackrock,576,priest,holy,12,6,6
Tsuser,blackrock,576,priest,holy,12,6,6
Crinji,blackmoore,576,priest,holy,12,6,6
Drée,hyjal,576,priest,holy,12,6,6
Ixxmp,blackrock,576,priest,holy,12,6,6
Xblanque,kazzak,576,priest,holy,12,6,6
Priestok,archimonde,576,priest,holy,12,6,6
Danina,outland,576,priest,holy,12,6,6
Aevery,onyxia,576,priest,holy,12,6,6
Múixi,dun-modr,576,priest,holy,12,6,6
Tribz,kargath,576,priest,holy,12,6,6
Brûshie,kazzak,576,priest,holy,12,6,6
Pwsx,draenor,576,priest,holy,12,6,6
Jhaazx,nemesis,576,priest,holy,14,6,8
Baldracca,shendralar,576,priest,holy,18,6,12
Мотд,gordunni,576,priest,holy,18,6,12
Amambo,chamber-of-aspects,576,priest,holy,18,6,12
Ckxd,ravencrest,576,priest,holy,18,6,12
Батлджес,gordunni,576,priest,holy,18,6,12
Sinf,sanguino,576,priest,holy,18,6,12
Patatå,sanguino,576,priest,holy,18,6,12
Старлайтх,gordunni,576,priest,holy,18,6,12
Джагонх,soulflayer,576,priest,holy,24,6,18
Lifeisgg,draenor,576,priest,holy,24,6,18
Guddie,saurfang,575,priest,holy,12,6,6
Níbbz,twisting-nether,575,priest,holy,12,6,6
Carðinal,dentarg,575,priest,holy,12,6,6
Wasfürsaft,tarren-mill,575,priest,holy,12,6,6
Dusktildawn,ragnaros,575,priest,holy,12,6,6
Injured,bronzebeard,575,priest,holy,12,6,6
Бояка,soulflayer,575,priest,holy,12,6,6
Waters,lightbringer,575,priest,holy,12,6,6
Wavelength,stormscale,575,priest,holy,18,6,12
Healiea,outland,575,priest,holy,18,6,12
Tikama,aegwynn,575,priest,holy,18,6,12
Phasmofobia,ragnaros,575,priest,holy,18,6,12
Dokurochan,tarren-mill,575,priest,holy,24,6,18
Holybomba,blackmoore,574,priest,holy,12,6,6
Wortgottes,blackrock,574,priest,holy,12,6,6
Saara,daggerspine,574,priest,holy,18,6,12
Кинвартиль,gordunni,574,priest,holy,18,6,12
Mingyue,thrall,574,priest,holy,24,6,18
Skatman,aggramar,574,priest,holy,27,6,21
Cayden,bloodfeather,573,priest,holy,12,6,6
Dinma,argent-dawn,573,priest,holy,18,6,12
Satyâ,kult-der-verdammten,571,priest,holy,12,6,6
Люцифиэль,ashenvale,571,priest,holy,12,6,6
Meladorable,elune,571,priest,holy,18,6,12
Proxypriest,the-maelstrom,571,priest,holy,20,6,14
Drop,los-errantes,569,priest,holy,12,6,6
Carbonic,khaz-modan,568,priest,holy,20,10,10
Aliyaah,conseil-des-ombres,568,priest,holy,12,6,6
Lunne,les-clairvoyants,567,priest,holy,12,6,6
Bloodelfoula,draenor,563,priest,holy,18,6,12
Kyderr,blackrock,543,priest,holy,17,6,11
Fuzzymerge,ravencrest,528,priest,holy,21,7,14
Psychoboris,outland,521,priest,holy,19,7,12
Dotreveal,ravencrest,521,priest,holy,20,7,13
Madvortexe,kazzak,496,priest,holy,25,6,19
Ralek,hyjal,495,priest,holy,17,6,11
Deliriumxd,ravencrest,480,priest,holy,6,5,1
Toasttrii,outland,480,priest,holy,6,5,1
Holdmyfear,proudmoore,480,priest,holy,6,5,1
Lucksy,antonidas,480,priest,holy,6,5,1
Эйттёрналинь,fordragon,480,priest,holy,6,5,1
Mariahcarry,rexxar,480,priest,holy,6,5,1
Felaenna,argent-dawn,480,priest,holy,6,5,1
Priestazie,madmortem,480,priest,holy,7,5,2
Krematorio,twisting-nether,480,priest,holy,12,5,7
Darkoulito,dalaran,480,priest,holy,12,5,7
Selëne,blackrock,480,priest,holy,12,5,7
Shâru,frostmourne,480,priest,holy,12,5,7
Tygstycke,tarren-mill,480,priest,holy,12,5,7
Shaquíloheal,blackrock,480,priest,holy,12,5,7
Wíft,argent-dawn,480,priest,holy,12,5,7
Quiwzx,blackrock,480,priest,holy,12,5,7
Teengirl,ravencrest,480,priest,holy,12,5,7
Pirkkapriest,stormreaver,480,priest,holy,12,5,7
Razamdi,drakthul,480,priest,holy,12,5,7
Релакз,soulflayer,480,priest,holy,12,5,7
Hodnkobold,kazzak,480,priest,holy,12,5,7
Mikò,blackmoore,480,priest,holy,12,5,7
Mneme,aggramar,480,priest,holy,12,5,7
Nicolovato,draenor,480,priest,holy,12,5,7
Insânity,kazzak,480,priest,holy,12,5,7
Velfchurch,draenor,480,priest,holy,12,5,7
Holymamba,silvermoon,480,priest,holy,12,5,7
Sayala,dalaran,480,priest,holy,12,5,7
Ogiez,sylvanas,480,priest,holy,12,5,7
Purist,arthas,480,priest,holy,12,5,7
Königlich,kiljaeden,480,priest,holy,12,5,7
Enèr,hyjal,480,priest,holy,12,5,7
Mazeari,sylvanas,480,priest,holy,12,5,7
Caz,cthun,480,priest,holy,12,5,7
Mönster,cthun,480,priest,holy,13,5,8
Drmacmoo,kazzak,480,priest,holy,18,5,13
Minimalist,ravencrest,480,priest,holy,18,5,13
Hugerage,stormreaver,480,priest,holy,18,5,13
Kardínal,darkspear,480,priest,holy,18,5,13
Vannax,arygos,479,priest,holy,6,5,1
Двакамня,soulflayer,479,priest,holy,12,5,7
Inzané,doomhammer,479,priest,holy,12,5,7
Chabbe,ragnaros,479,priest,holy,12,5,7
Grøums,blackmoore,479,priest,holy,12,5,7
Árcadoom,quelthalas,479,priest,holy,12,5,7
Cocolasticot,garona,479,priest,holy,12,5,7
Гидранист,soulflayer,479,priest,holy,18,5,13
Cazuky,malganis,479,priest,holy,18,5,13
Blaumeaux,eredar,479,priest,holy,18,5,13
Alaeddin,kazzak,479,priest,holy,24,5,19
Ларуся,soulflayer,478,priest,holy,12,5,7
Laxara,arthas,478,priest,holy,12,5,7
Barbiemeth,silvermoon,478,priest,holy,23,7,16
Priestdahl,ravencrest,478,priest,holy,18,5,13
Xaeo,burning-legion,477,priest,holy,26,5,21
Mazeari,tarren-mill,448,priest,holy,10,6,4
Secundis,silvermoon,425,priest,holy,14,6,8
Кариелла,fordragon,425,priest,holy,17,7,10
Tavaera,antonidas,400,priest,holy,13,5,8
Shnookfour,agamaggan,392,priest,holy,26,7,19
Holypoppa,ravencrest,384,priest,holy,6,4,2
Mainhunter,aegwynn,384,priest,holy,6,4,2
Velluspriest,burning-legion,384,priest,holy,6,4,2
Trankilisimo,sanguino,384,priest,holy,6,4,2
Nevx,blackmoore,384,priest,holy,6,4,2
Jingling,kazzak,384,priest,holy,6,4,2
Свэпи,blackscar,384,priest,holy,6,4,2
Beyal,tarren-mill,384,priest,holy,6,4,2
Zymai,ravencrest,384,priest,holy,6,4,2
Indrades,blackmoore,384,priest,holy,6,4,2
Mainputa,pozzo-delleternità,384,priest,holy,6,4,2
Æsthëtìçgødx,exodar,384,priest,holy,6,4,2
Ltrxo,twisting-nether,384,priest,holy,6,4,2
Даймэн,gordunni,384,priest,holy,6,4,2
Êliten,tarren-mill,384,priest,holy,6,4,2
Abomïnàtîon,ysondre,384,priest,holy,6,4,2
Yanclown,tarren-mill,384,priest,holy,6,4,2
Mvce,outland,384,priest,holy,6,4,2
Yredias,dalaran,384,priest,holy,6,4,2
Egi,lothar,384,priest,holy,6,4,2
Stazia,ravencrest,384,priest,holy,6,4,2
Trowe,tarren-mill,384,priest,holy,6,4,2
Cløwnn,tarren-mill,384,priest,holy,6,4,2
Gepeitschter,frostwolf,384,priest,holy,6,4,2
Shadowlander,dun-modr,384,priest,holy,6,4,2
Lostmybibles,twisting-nether,384,priest,holy,6,4,2
Frenchpriest,archimonde,384,priest,holy,6,4,2
Shyoû,blackmoore,384,priest,holy,7,4,3
Zeratwo,eredar,384,priest,holy,9,5,4
Shinjicum,kazzak,384,priest,holy,9,5,4
Aladriela,exodar,384,priest,holy,12,4,8
Alterlight,twisting-nether,384,priest,holy,12,4,8
Бэнэльф,soulflayer,384,priest,holy,12,4,8
Massasax,kazzak,384,priest,holy,12,4,8
Mydicine,ysondre,384,priest,holy,12,4,8
Menda,eredar,384,priest,holy,12,4,8
Salzgehalt,antonidas,384,priest,holy,12,4,8
Ashuramaru,drakthul,384,priest,holy,12,4,8
Alshah,emerald-dream,384,priest,holy,12,4,8
Psychout,ravencrest,384,priest,holy,12,4,8
Adäm,grim-batol,384,priest,holy,12,4,8
Sablo,blackrock,384,priest,holy,12,4,8
Naomi,ragnaros,384,priest,holy,12,4,8
Bloodie,drakthul,384,priest,holy,12,4,8
Ivysaurus,ravencrest,384,priest,holy,12,4,8
Clergy,hellfire,384,priest,holy,12,4,8
Fabuliciøus,blackrock,384,priest,holy,12,4,8
Ripperdepip,magtheridon,384,priest,holy,12,4,8
Chrisdorner,archimonde,384,priest,holy,12,4,8
Zarez,stormscale,384,priest,holy,12,4,8
Gehrke,silvermoon,384,priest,holy,12,4,8
Flurri,tarren-mill,384,priest,holy,12,4,8
Disillusíon,tarren-mill,384,priest,holy,12,4,8
Príêstjklól,stormscale,384,priest,holy,12,4,8
Skytheory,eredar,384,priest,holy,13,4,9
Eihran,stormscale,384,priest,holy,18,4,14
Ðlcz,blackrock,384,priest,holy,18,4,14
Missdemerè,nemesis,384,priest,holy,18,4,14
Кэндимен,gordunni,384,priest,holy,18,4,14
Virgosenpai,silvermoon,384,priest,holy,18,4,14
Hemmiz,archimonde,383,priest,holy,6,4,2
Kasimette,garona,383,priest,holy,6,4,2
Allwhitte,confrérie-du-thorium,383,priest,holy,6,4,2
Kheenah,argent-dawn,383,priest,holy,6,4,2
Dîakon,antonidas,383,priest,holy,12,4,8
Harukaa,aggra-português,383,priest,holy,12,4,8
Ynnaria,blackmoore,383,priest,holy,12,4,8
Blackwidow,chromaggus,383,priest,holy,12,4,8
Ruebi,blackmoore,383,priest,holy,12,4,8
Danklindots,silvermoon,383,priest,holy,12,4,8
Popé,steamwheedle-cartel,382,priest,holy,6,4,2
Yasminelopez,tarren-mill,381,priest,holy,18,4,14
Silverfate,outland,367,priest,holy,11,4,7
Эгнерия,eversong,367,priest,holy,17,4,13
Nxtlvl,stormscale,352,priest,holy,10,5,5
Apuessii,dun-modr,351,priest,holy,11,4,7
Enviro,argent-dawn,351,priest,holy,14,5,9
Lyndorien,argent-dawn,336,priest,holy,9,4,5
Buffholy,kazzak,330,priest,holy,17,6,11
Shyvi,ravencrest,319,priest,holy,5,4,1
Shadowdae,outland,319,priest,holy,8,4,4
Ostrogami,silvermoon,319,priest,holy,8,4,4
Zahadoom,stormscale,319,priest,holy,12,5,7
Amanthus,draenor,308,priest,holy,35,12,23
Аполонио,soulflayer,288,priest,holy,6,3,3
Valío,stormreaver,288,priest,holy,6,3,3
Sneboldìs,sylvanas,288,priest,holy,6,3,3
Egî,azshara,288,priest,holy,6,3,3
Atremius,dragonmaw,288,priest,holy,6,3,3
Vanadii,blackhand,288,priest,holy,6,3,3
Inà,thrall,288,priest,holy,6,3,3
Хексорик,howling-fjord,288,priest,holy,6,3,3
Inthemoöd,twisting-nether,288,priest,holy,6,3,3
Burningheatx,kazzak,288,priest,holy,6,3,3
Kimlie,baelgun,288,priest,holy,6,3,3
Гленнис,gordunni,288,priest,holy,6,3,3
Fsnx,sylvanas,288,priest,holy,6,3,3
Mcx,stormscale,288,priest,holy,6,3,3
Äliénør,khaz-modan,288,priest,holy,6,3,3
Monataamis,kazzak,288,priest,holy,6,3,3
Ejoz,khaz-modan,288,priest,holy,6,3,3
Pulverpadder,stormscale,288,priest,holy,6,3,3
Suzziee,silvermoon,288,priest,holy,6,3,3
Ðøntßetøxic,kazzak,288,priest,holy,6,3,3
Wonderdispel,ragnaros,288,priest,holy,6,3,3
Йефа,gordunni,288,priest,holy,6,3,3
Kekkonh,sylvanas,288,priest,holy,6,3,3
Verweven,twisting-nether,288,priest,holy,6,3,3
Discmachinex,stormscale,288,priest,holy,6,3,3
Carnacia,tarren-mill,288,priest,holy,6,3,3
Abusalt,stormscale,288,priest,holy,6,3,3
Jaykerlordx,kazzak,288,priest,holy,6,3,3
Подчинись,ashenvale,288,priest,holy,6,3,3
Фионыч,blackscar,288,priest,holy,6,3,3
Vitapriest,silvermoon,288,priest,holy,6,3,3
Cilletbang,blackmoore,288,priest,holy,6,3,3
Holyheartx,argent-dawn,288,priest,holy,6,3,3
Pyropenance,twisting-nether,288,priest,holy,6,3,3
Аржан,soulflayer,288,priest,holy,6,3,3
Menecare,blackhand,288,priest,holy,6,3,3
Namsolo,kazzak,288,priest,holy,6,3,3
Asolan,drakthul,288,priest,holy,6,3,3
Priesterious,blackrock,288,priest,holy,6,3,3
Liviúss,draenor,288,priest,holy,6,3,3
Heyská,eredar,288,priest,holy,6,3,3
Runay,draenor,288,priest,holy,6,3,3
Shdetrzyx,outland,288,priest,holy,6,3,3
ßestworld,draenor,288,priest,holy,6,3,3
Xelivia,draenor,288,priest,holy,6,3,3
Dathanosp,outland,288,priest,holy,6,3,3
Voidflash,blackmoore,288,priest,holy,6,3,3
Fadex,argent-dawn,288,priest,holy,6,3,3
Ainsely,alakir,288,priest,holy,6,3,3
Adssdfhjgh,outland,288,priest,holy,6,3,3
Aiewn,elune,288,priest,holy,6,3,3
Jp,gorgonnash,288,priest,holy,6,3,3
Madsmadkas,kazzak,288,priest,holy,6,3,3
Atenuviel,norgannon,288,priest,holy,6,3,3
ßabylexa,ravencrest,288,priest,holy,6,3,3
Erzis,silvermoon,288,priest,holy,6,3,3
Scaryolol,blackmoore,288,priest,holy,6,3,3
Nyxtovia,ravencrest,288,priest,holy,6,3,3
Psylurker,die-nachtwache,288,priest,holy,6,3,3
Seum,ravencrest,288,priest,holy,6,3,3
Zeruhphin,eredar,288,priest,holy,6,3,3
Thundertwo,ravencrest,288,priest,holy,6,3,3
Páuse,nefarian,288,priest,holy,6,3,3
Catrex,draenor,288,priest,holy,6,3,3
Kevinsorbo,destromath,288,priest,holy,6,3,3
Bambus,shattered-hand,288,priest,holy,6,3,3
Yaiva,antonidas,288,priest,holy,6,3,3
Perrý,archimonde,288,priest,holy,6,3,3
Badhêalz,aegwynn,288,priest,holy,6,3,3
Noova,defias-brotherhood,288,priest,holy,6,3,3
Ariyia,argent-dawn,288,priest,holy,6,3,3
Jeboc,ravencrest,288,priest,holy,6,3,3
Prisht,ravencrest,288,priest,holy,6,3,3
Lynéssa,silvermoon,288,priest,holy,6,3,3
Rewinqt,blackmoore,288,priest,holy,6,3,3
Nimsi,ravencrest,288,priest,holy,6,3,3
Smiteweaver,drakthul,288,priest,holy,6,3,3
Tebzy,ravencrest,288,priest,holy,6,3,3
Aruna,ravencrest,288,priest,holy,6,3,3
Skiplegday,blackrock,288,priest,holy,8,3,5
Snooglefacé,grim-batol,288,priest,holy,12,3,9
Royalty,aerie-peak,288,priest,holy,12,3,9
Parzivál,argent-dawn,288,priest,holy,12,3,9
Singularity,ravencrest,288,priest,holy,12,3,9
Omegamegaman,blackrock,288,priest,holy,12,3,9
Alentissar,nemesis,288,priest,holy,12,3,9
Мущмущ,howling-fjord,288,priest,holy,12,3,9
Quami,dun-modr,288,priest,holy,12,3,9
Trashpriest,blackrock,288,priest,holy,12,3,9
Faol,the-venture-co,288,priest,holy,12,3,9
Daenaerys,dun-morogh,288,priest,holy,12,3,9
Люблюкофе,deathguard,288,priest,holy,12,3,9
Javvi,sylvanas,288,priest,holy,12,3,9
Míscode,twisting-nether,288,priest,holy,12,3,9
Shutyi,arathor,288,priest,holy,12,3,9
Nswqt,kazzak,288,priest,holy,12,3,9
Drminduskâ,ysondre,288,priest,holy,12,3,9
Lurri,tarren-mill,288,priest,holy,12,3,9
Vaporfly,deathwing,288,priest,holy,12,3,9
Bzets,jaedenar,288,priest,holy,12,3,9
Madpad,tarren-mill,288,priest,holy,18,3,15
Farae,arathor,288,priest,holy,24,3,21
Ralaya,ravencrest,287,priest,holy,6,3,3
Ansaniâ,antonidas,287,priest,holy,12,3,9
Виатрикс,goldrinn,287,priest,holy,18,3,15
Spoggle,kazzak,256,priest,holy,4,4,0
Equitalia,pozzo-delleternità,255,priest,holy,14,4,10
Clerìc,argent-dawn,255,priest,holy,11,3,8
Emessary,scarshield-legion,240,priest,holy,9,4,5
Elthrone,kazzak,240,priest,holy,9,4,5
Lr,aszune,240,priest,holy,9,3,6
Azrpr,ravencrest,239,priest,holy,5,3,2
Danema,blackrock,239,priest,holy,9,4,5
Wixzyx,ravencrest,234,priest,holy,8,4,4
ßest,archimonde,234,priest,holy,15,5,10
Azsem,arathor,234,priest,holy,18,4,14
Outcast,korgall,224,priest,holy,16,3,13
Rexxár,aszune,223,priest,holy,14,3,11
Sumiyaki,ravencrest,207,priest,holy,8,3,5
Олегстразза,howling-fjord,192,priest,holy,6,2,4
Runkkar,defias-brotherhood,192,priest,holy,6,2,4
Gendzsó,ragnaros,192,priest,holy,6,2,4
Moonmaster,tarren-mill,192,priest,holy,6,2,4
Кожетс,galakrond,192,priest,holy,6,2,4
Pollution,ragnaros,192,priest,holy,6,2,4
Dertar,archimonde,192,priest,holy,6,2,4
Priestmond,magtheridon,192,priest,holy,6,2,4
Cheefto,blackmoore,192,priest,holy,6,2,4
Scynthia,ravencrest,192,priest,holy,6,2,4
Thoryän,ragnaros,192,priest,holy,6,2,4
Луножрец,gordunni,192,priest,holy,6,2,4
Bríta,veknilash,192,priest,holy,6,2,4
Absórb,quelthalas,192,priest,holy,6,2,4
Shidolah,antonidas,192,priest,holy,6,2,4
Nathyxqt,archimonde,192,priest,holy,6,2,4
Lusîa,echsenkessel,192,priest,holy,6,2,4
Fluxyqt,ravencrest,192,priest,holy,6,2,4
Beliar,azshara,192,priest,holy,6,2,4
Nightstyle,nethersturm,192,priest,holy,6,2,4
Cidrea,saurfang,192,priest,holy,6,2,4
Sáruky,blackrock,192,priest,holy,6,2,4
Tudp,tarren-mill,192,priest,holy,6,2,4
Johen,terenas,192,priest,holy,6,2,4
Yukirito,drakthul,192,priest,holy,6,2,4
Burnex,thrall,192,priest,holy,6,2,4
Ihefyehvjrm,ravencrest,192,priest,holy,6,2,4
Dami,defias-brotherhood,192,priest,holy,6,2,4
Ammirrandus,aszune,192,priest,holy,6,2,4
Корбюратор,blackscar,192,priest,holy,6,2,4
Buzzy,twisting-nether,192,priest,holy,6,2,4
Secrethealer,frostmane,192,priest,holy,6,2,4
Jinxies,twisting-nether,192,priest,holy,6,2,4
Юлечка,blackscar,192,priest,holy,6,2,4
Egxo,blackrock,192,priest,holy,6,2,4
Semagdnim,aggra-português,192,priest,holy,6,2,4
Daria,teldrassil,192,priest,holy,6,2,4
Wyez,blackmoore,192,priest,holy,6,2,4
Micix,tarren-mill,192,priest,holy,6,2,4
Karoopi,ysondre,192,priest,holy,6,2,4
Dimentions,sylvanas,192,priest,holy,6,2,4
Kanketopries,korgall,192,priest,holy,6,2,4
Redders,sylvanas,192,priest,holy,6,2,4
Solaclypsa,destromath,192,priest,holy,6,2,4
Djingischan,twisting-nether,192,priest,holy,6,2,4
Effot,twisting-nether,192,priest,holy,6,2,4
Raeratwo,archimonde,192,priest,holy,6,2,4
Scooterkid,tarren-mill,192,priest,holy,6,2,4
Marrisa,khaz-modan,192,priest,holy,6,2,4
Soül,sylvanas,192,priest,holy,6,2,4
Kolinamenus,dun-morogh,192,priest,holy,6,2,4
Fùkøff,stormscale,192,priest,holy,6,2,4
Supervillain,draenor,192,priest,holy,6,2,4
Frvrfridayy,stormscale,192,priest,holy,6,2,4
Hunfall,stormscale,192,priest,holy,6,2,4
Plåtpriest,twisting-nether,192,priest,holy,6,2,4
Gullys,drakthul,192,priest,holy,6,2,4
Dameyo,argent-dawn,192,priest,holy,6,2,4
Utsuro,stormscale,192,priest,holy,6,2,4
Buskisis,tarren-mill,192,priest,holy,6,2,4
Zèl,blackmoore,192,priest,holy,6,2,4
Neverswap,blackmoore,192,priest,holy,6,2,4
Sînálà,antonidas,192,priest,holy,6,2,4
Lovly,antonidas,192,priest,holy,6,2,4
Sathie,ravencrest,192,priest,holy,6,2,4
Haxxøn,die-nachtwache,192,priest,holy,6,2,4
Shkzz,hyjal,192,priest,holy,6,2,4
Sigor,hellfire,192,priest,holy,6,2,4
Merkabah,azjolnerub,192,priest,holy,6,2,4
Flào,draenor,192,priest,holy,6,2,4
Dangerfred,stormscale,192,priest,holy,6,2,4
Курчатовский,gordunni,192,priest,holy,6,2,4
Breana,arathor,192,priest,holy,6,2,4
Meliodasa,outland,192,priest,holy,6,2,4
Lutzki,the-maelstrom,192,priest,holy,6,2,4
Келебриана,deepholm,192,priest,holy,6,2,4
Schnullehupê,blackmoore,192,priest,holy,6,2,4
Асуартхас,gordunni,192,priest,holy,6,2,4
Ronk,outland,192,priest,holy,6,2,4
Eyllise,ragnaros,192,priest,holy,6,2,4
Таяш,soulflayer,192,priest,holy,6,2,4
Crackbär,blackmoore,192,priest,holy,6,2,4
Prästpojken,frostwhisper,192,priest,holy,6,2,4
Apes,frostmourne,192,priest,holy,6,2,4
Korzec,dun-modr,192,priest,holy,6,2,4
Halysion,ravencrest,192,priest,holy,6,2,4
Notatrap,outland,192,priest,holy,6,2,4
Ðøìßåx,silvermoon,192,priest,holy,6,2,4
Fogz,kazzak,192,priest,holy,6,2,4
Llounal,silvermoon,192,priest,holy,6,2,4
Vandansk,kazzak,192,priest,holy,6,2,4
Dehydratia,silvermoon,192,priest,holy,6,2,4
Blazingad,kazzak,192,priest,holy,6,2,4
Yunico,kazzak,192,priest,holy,6,2,4
Zenholy,kazzak,192,priest,holy,6,2,4
Schizophrens,outland,192,priest,holy,6,2,4
Dotsin,kazzak,192,priest,holy,6,2,4
Niightstorm,silvermoon,192,priest,holy,6,2,4
Tinypump,silvermoon,192,priest,holy,6,2,4
Akhz,silvermoon,192,priest,holy,6,2,4
Lahammy,kazzak,192,priest,holy,6,2,4
Бранлор,howling-fjord,192,priest,holy,8,2,6
Twh,outland,192,priest,holy,12,2,10
Yxazil,silvermoon,192,priest,holy,12,2,10
Злыденькая,gordunni,192,priest,holy,12,2,10
Authentic,dalaran,192,priest,holy,12,2,10
Daedarkis,twisting-nether,192,priest,holy,12,2,10
Brøs,blackmoore,192,priest,holy,12,2,10
Prigart,sylvanas,192,priest,holy,12,2,10
Caojialedebi,zuljin,191,priest,holy,6,2,4
Yacrablo,medivh,191,priest,holy,6,2,4
Meynola,ysondre,191,priest,holy,6,2,4
Bianchi,los-errantes,191,priest,holy,6,2,4
Riogas,khaz-modan,191,priest,holy,12,2,10
Fídme,ragnaros,160,priest,holy,10,2,8
Shadowzrip,twilights-hammer,159,priest,holy,5,2,3
Broksigar,the-maelstrom,159,priest,holy,5,2,3
Chrì,argent-dawn,159,priest,holy,5,2,3
Batschmoar,shattrath,144,priest,holy,3,3,0
Consümed,draenor,144,priest,holy,9,2,7
Dekarapriest,ravencrest,138,priest,holy,6,3,3
Xet,outland,138,priest,holy,6,3,3
Discisiipeli,sylvanas,138,priest,holy,11,5,6
Pristern,tarren-mill,138,priest,holy,9,4,5
Pinkfloydx,lightbringer,138,priest,holy,9,4,5
Spae,twisting-nether,138,priest,holy,11,4,7
Alicewhydel,blackhand,138,priest,holy,9,3,6
Paterlurki,blackhand,138,priest,holy,10,3,7
Dayno,draenor,128,priest,holy,4,2,2
Cptmoigx,antonidas,96,priest,holy,3,2,1
Ûñrêpørtablë,outland,96,priest,holy,3,2,1
Anòther,the-maelstrom,96,priest,holy,3,2,1
Zeythz,ravencrest,96,priest,holy,10,2,8
Yaoshih,draenor,96,priest,holy,6,1,5
Eloundir,dalaran,96,priest,holy,6,1,5
Pattie,ragnaros,96,priest,holy,6,1,5
Симпоз,howling-fjord,96,priest,holy,6,1,5
Нуннчи,howling-fjord,96,priest,holy,6,1,5
Hanniel,kazzak,96,priest,holy,6,1,5
Нитровина,howling-fjord,96,priest,holy,6,1,5
Draobwýn,blackrock,96,priest,holy,6,1,5
Тоориал,howling-fjord,96,priest,holy,6,1,5
Jaesabøyx,twisting-nether,96,priest,holy,6,1,5
Эллвинг,howling-fjord,96,priest,holy,6,1,5
Wísp,die-aldor,96,priest,holy,6,1,5
Robiee,twisting-nether,96,priest,holy,6,1,5
Ylenae,twisting-nether,96,priest,holy,6,1,5
Elvedâ,blackhand,96,priest,holy,6,1,5
Borá,twisting-nether,96,priest,holy,6,1,5
Laadyybirkee,blackhand,96,priest,holy,6,1,5
Herwin,twisting-nether,96,priest,holy,6,1,5
Flokè,stormscale,96,priest,holy,6,1,5
Ovrpwr,stormscale,96,priest,holy,6,1,5
Miralou,ravencrest,96,priest,holy,6,1,5
Daskemaskinx,the-maelstrom,96,priest,holy,6,1,5
Elfhelp,ravencrest,96,priest,holy,6,1,5
Lãnat,ravencrest,96,priest,holy,6,1,5
Enzyme,drakthul,96,priest,holy,6,1,5
Myrrha,les-sentinelles,96,priest,holy,6,1,5
Nuph,ravencrest,96,priest,holy,6,1,5
Simbaone,scarshield-legion,96,priest,holy,6,1,5
Jaatjak,ravencrest,96,priest,holy,6,1,5
Blastor,ravencrest,96,priest,holy,6,1,5
Remkoja,blackrock,96,priest,holy,6,1,5
Чтоподелать,soulflayer,96,priest,holy,6,1,5
Flugame,ravencrest,96,priest,holy,6,1,5
Lujka,outland,96,priest,holy,6,1,5
Saheila,defias-brotherhood,96,priest,holy,6,1,5
Angusbeêf,blackrock,96,priest,holy,6,1,5
Яестькенни,soulflayer,96,priest,holy,6,1,5
Drë,daggerspine,96,priest,holy,6,1,5
Soonako,antonidas,96,priest,holy,6,1,5
Slêq,antonidas,96,priest,holy,6,1,5
Ieav,frostwolf,96,priest,holy,6,1,5
Rzkp,eredar,96,priest,holy,6,1,5
Vierfingerjo,eredar,96,priest,holy,6,1,5
Ximenia,eredar,96,priest,holy,6,1,5
Isendriel,outland,96,priest,holy,6,1,5
Shicu,blackmoore,96,priest,holy,6,1,5
Healpower,aggramar,96,priest,holy,6,1,5
Helpmeheal,sylvanas,96,priest,holy,6,1,5
Shadowgeek,sylvanas,96,priest,holy,6,1,5
Decimerad,kazzak,96,priest,holy,6,1,5
Kijul,ragnaros,96,priest,holy,6,1,5
Сакредлайв,gordunni,96,priest,holy,6,1,5
Мишатемный,gordunni,96,priest,holy,6,1,5
Morîdîn,kazzak,96,priest,holy,6,1,5
Pappipappa,draenor,96,priest,holy,6,1,5
Тёмафиргвард,blackscar,96,priest,holy,6,1,5
Zthul,draenor,96,priest,holy,6,1,5
Wrongwrong,draenor,96,priest,holy,6,1,5
Ramy,sporeggar,96,priest,holy,6,1,5
Mauralin,zirkel-des-cenarius,96,priest,holy,6,1,5
Johnblack,dun-morogh,96,priest,holy,6,1,5
Kakuzuke,nemesis,96,priest,holy,6,1,5
Valyreon,outland,96,priest,holy,6,1,5
Fadchod,outland,96,priest,holy,6,1,5
Kipnuggetz,burning-legion,96,priest,holy,6,1,5
Snotknuckle,gorgonnash,96,priest,holy,6,1,5
Bragokexx,tarren-mill,96,priest,holy,6,1,5
Galpriest,tarren-mill,96,priest,holy,6,1,5
Retardé,tarren-mill,96,priest,holy,6,1,5
Aviz,tarren-mill,96,priest,holy,6,1,5
Trickyteè,tarren-mill,96,priest,holy,6,1,5
Chybrozzør,archimonde,96,priest,holy,6,1,5
Rcxd,silvermoon,96,priest,holy,6,1,5
Radiance,emeriss,96,priest,holy,6,1,5
Goupillou,hyjal,96,priest,holy,6,1,5
Blúefox,malfurion,96,priest,holy,6,1,5
Healoisious,alonsus,96,priest,holy,6,1,5
Antibiotike,hyjal,96,priest,holy,6,1,5
Tigrok,burning-legion,96,priest,holy,6,1,5
Buan,outland,96,priest,holy,6,1,5
Lyssa,saurfang,96,priest,holy,6,1,5
Malzzara,outland,96,priest,holy,6,1,5
Sebiah,darksorrow,96,priest,holy,6,1,5
Elya,hyjal,96,priest,holy,6,1,5
Chê,sanguino,96,priest,holy,6,1,5
Goodsonja,sanguino,96,priest,holy,6,1,5
Disz,zuljin,96,priest,holy,6,1,5
Healêl,sanguino,96,priest,holy,6,1,5
Xodze,outland,96,priest,holy,6,1,5
Tÿona,hyjal,96,priest,holy,6,1,5
Kasáya,thrall,96,priest,holy,14,2,12
Quackies,ravencrest,96,priest,holy,7,1,6
Gisborn,laughing-skull,96,priest,holy,8,1,7
Downtrone,blackrock,96,priest,holy,9,1,8
Doublehealix,argent-dawn,96,priest,holy,12,1,11
Plaguestrike,darkspear,96,priest,holy,12,1,11
Onlyfans,burning-steppes,96,priest,holy,12,1,11
Demora,ysondre,96,priest,holy,12,1,11
Lunabärchi,ravencrest,96,priest,holy,12,1,11
Quinlanx,quelthalas,96,priest,holy,12,1,11
Yuuvi,ravencrest,96,priest,holy,12,1,11
Takros,blackrock,96,priest,holy,12,1,11
Frékiatya,ravenholdt,95,priest,holy,6,1,5
Mswagner,outland,79,priest,holy,5,1,4
Sdk,archimonde,79,priest,holy,5,1,4
Looó,los-errantes,79,priest,holy,5,1,4
Xaey,ravencrest,48,priest,holy,3,1,2
Freshpope,ravencrest,48,priest,holy,3,1,2
Sos,nethersturm,42,priest,holy,9,3,6
Баптисто,gordunni,42,priest,holy,7,2,5
Maxyox,ragnaros,42,priest,holy,8,2,6
Tabítha,blackrock,42,priest,holy,9,2,7
Bøij,pozzo-delleternità,42,priest,holy,10,2,8
Hemmis,ravencrest,2279,priest,discipline,131,78,53
Keijuñâ,tarren-mill,2261,priest,discipline,102,59,43
Prêtresacré,archimonde,2244,priest,discipline,89,52,37
Gaalonikus,blackmoore,2235,priest,discipline,92,54,38
Vanostsp,kazzak,2231,priest,discipline,104,57,47
Døppëlápfèl,tarren-mill,2220,priest,discipline,108,59,49
Moonriver,archimonde,2210,priest,discipline,90,54,36
Jidammy,ravencrest,2207,priest,discipline,128,68,60
Jid,ravencrest,2206,priest,discipline,113,68,45
Jayti,ravencrest,2205,priest,discipline,115,65,50
Vengefulmaze,ravencrest,2205,priest,discipline,156,85,71
Hukkuvahirvi,ravencrest,2187,priest,discipline,123,66,57
Jaywie,twisting-nether,2186,priest,discipline,214,110,104
Primayodbain,archimonde,2184,priest,discipline,112,60,52
Rlyeh,argent-dawn,2181,priest,discipline,89,49,40
Jackiqt,nemesis,2180,priest,discipline,125,81,44
Flao,ravencrest,2180,priest,discipline,88,47,41
Secø,sylvanas,2177,priest,discipline,78,43,35
Èfflux,ravencrest,2172,priest,discipline,86,54,32
Kêkwshádêzz,blackmoore,2165,priest,discipline,84,44,40
Saentainen,kazzak,2164,priest,discipline,113,78,35
Còsmo,ravencrest,2157,priest,discipline,125,61,64
Rñd,ravencrest,2155,priest,discipline,84,45,39
Jtî,ravencrest,2149,priest,discipline,120,74,46
Gudóngmae,ravencrest,2144,priest,discipline,60,36,24
Ananous,hyjal,2144,priest,discipline,356,195,161
Villagebike,shadowsong,2142,priest,discipline,60,33,27
Rébörn,tarren-mill,2134,priest,discipline,77,47,30
Cylizx,stormscale,2133,priest,discipline,114,62,52
Ltr,tarren-mill,2132,priest,discipline,61,39,22
Thelïght,ravencrest,2132,priest,discipline,195,100,95
Aist,ragnaros,2132,priest,discipline,132,67,65
Artle,sanguino,2131,priest,discipline,83,44,39
Izzý,antonidas,2129,priest,discipline,90,57,33
Prådâshådëzz,blackmoore,2129,priest,discipline,95,51,44
Efflúx,ravencrest,2128,priest,discipline,124,71,53
Azrpr,ravencrest,2128,priest,discipline,82,45,37
Антошашвп,gordunni,2128,priest,discipline,98,51,47
Cringê,ravencrest,2124,priest,discipline,89,46,43
Asanti,die-aldor,2122,priest,discipline,252,145,107
Unréål,ravencrest,2122,priest,discipline,198,102,96
Kangaroogodx,ravencrest,2122,priest,discipline,149,75,74
Duckiethot,twisting-nether,2121,priest,discipline,226,115,111
Ilumiinatrix,dun-modr,2121,priest,discipline,797,400,397
Nasdaq,ravencrest,2120,priest,discipline,120,63,57
Mentalboom,emerald-dream,2120,priest,discipline,215,112,103
Tremrfinger,dun-modr,2119,priest,discipline,427,244,183
Bedfirez,ravencrest,2119,priest,discipline,235,134,101
Hampådenbååd,kazzak,2119,priest,discipline,147,81,66
Jawake,twisting-nether,2119,priest,discipline,108,54,54
Mond,eredar,2118,priest,discipline,171,84,87
Fatyoyo,frostwolf,2117,priest,discipline,89,56,33
Blessedmix,korgall,2117,priest,discipline,280,143,137
Teengirl,ravencrest,2115,priest,discipline,498,280,218
Sologrifer,sylvanas,2114,priest,discipline,87,47,40
Mercilégion,sargeras,2113,priest,discipline,84,43,41
Holypoppa,ravencrest,2112,priest,discipline,498,257,241
Деадхостх,soulflayer,2110,priest,discipline,90,53,37
Summerfinn,ravencrest,2110,priest,discipline,235,120,115
Råcòøñ,ravencrest,2110,priest,discipline,109,55,54
Dermaul,kazzak,2109,priest,discipline,144,76,68
Superbianka,stormscale,2109,priest,discipline,252,129,123
Pheen,kazzak,2108,priest,discipline,506,265,241
Фейнриприст,soulflayer,2107,priest,discipline,167,107,60
Coldyxz,blackrock,2107,priest,discipline,132,74,58
Nevercared,aegwynn,2106,priest,discipline,63,48,15
Swd,dun-morogh,2106,priest,discipline,72,43,29
Swdswdswdswd,blackmoore,2105,priest,discipline,106,58,48
Spìrít,ghostlands,2105,priest,discipline,192,93,99
Lloreen,ravencrest,2104,priest,discipline,215,120,95
Mshield,blackmoore,2103,priest,discipline,130,62,68
Neverdome,ravencrest,2100,priest,discipline,405,218,187
Øbserverx,stormscale,2100,priest,discipline,114,61,53
Mshieldo,blackmoore,2100,priest,discipline,118,59,59
Гопикзашквар,blackscar,2100,priest,discipline,182,88,94
Dripcheck,draenor,2096,priest,discipline,397,204,193
Fearxyz,aegwynn,2094,priest,discipline,96,51,45
Duckiethotx,ragnaros,2091,priest,discipline,166,84,82
Lunatique,shadowsong,2090,priest,discipline,92,45,47
Voxtwo,blackrock,2083,priest,discipline,72,42,30
Klonyaryk,ravencrest,2082,priest,discipline,230,118,112
Faithz,ragnaros,2079,priest,discipline,96,46,50
Prästpåven,stormscale,2078,priest,discipline,84,50,34
Luxurygirl,nemesis,2076,priest,discipline,54,35,19
Shmoly,stormscale,2073,priest,discipline,157,81,76
Chasx,ravencrest,2071,priest,discipline,177,85,92
Ñya,sylvanas,2069,priest,discipline,270,148,122
Sèco,sylvanas,2068,priest,discipline,156,77,79
Bonzuu,ravencrest,2067,priest,discipline,125,72,53
Ðontargueok,blackmoore,2066,priest,discipline,138,76,62
Flào,draenor,2064,priest,discipline,113,56,57
Donpedrila,kazzak,2063,priest,discipline,66,34,32
Фастэксп,razuvious,2059,priest,discipline,355,183,172
Nicebeam,ravencrest,2058,priest,discipline,84,44,40
Buan,outland,2058,priest,discipline,78,39,39
Deadsloth,hyjal,2051,priest,discipline,203,106,97
Skyrojo,ravencrest,2050,priest,discipline,103,49,54
Crinji,blackmoore,2049,priest,discipline,365,183,182
Светжрец,blackscar,2047,priest,discipline,84,52,32
Artístx,twisting-nether,2047,priest,discipline,98,52,46
Kâiøxx,outland,2046,priest,discipline,336,175,161
Looney,shadowsong,2045,priest,discipline,72,46,26
Twinkboyx,ragnaros,2040,priest,discipline,171,86,85
Plsdontnerf,onyxia,2039,priest,discipline,95,55,40
Imprøved,outland,2036,priest,discipline,102,70,32
Kekkons,sylvanas,2035,priest,discipline,149,80,69
Meganxx,ravencrest,2031,priest,discipline,78,47,31
Cluelesstwo,ravencrest,2030,priest,discipline,366,199,167
Reflector,sunstrider,2025,priest,discipline,99,47,52
Arthezz,ravencrest,2023,priest,discipline,282,148,134
Dakystepmom,stormreaver,2017,priest,discipline,119,57,62
Jagardoden,stormscale,2016,priest,discipline,141,80,61
Priestqtx,kelthuzad,2016,priest,discipline,60,34,26
Gerryqt,draenor,2016,priest,discipline,78,41,37
Sacerdotini,outland,2016,priest,discipline,49,23,26
Fleetways,draenor,2015,priest,discipline,76,51,25
Morphics,silvermoon,2013,priest,discipline,83,41,42
Loaffeh,ragnaros,2012,priest,discipline,88,47,41
Megxnx,ravencrest,2011,priest,discipline,125,74,51
Soloshuffle,draenor,2011,priest,discipline,184,99,85
Разрухаз,gordunni,2011,priest,discipline,95,48,47
Synxii,ravencrest,2010,priest,discipline,100,50,50
Donvyto,blackmoore,2010,priest,discipline,77,38,39
Trialight,ravencrest,2009,priest,discipline,89,57,32
Abdcefgihljk,tarren-mill,2008,priest,discipline,66,41,25
Shinjicum,kazzak,2008,priest,discipline,392,217,175
Petitogré,silvermoon,2007,priest,discipline,236,124,112
Smiteweaver,drakthul,2006,priest,discipline,78,45,33
Youngfade,twisting-nether,2005,priest,discipline,117,57,60
Snuskong,kazzak,2005,priest,discipline,117,56,61
Фанпау,soulflayer,2005,priest,discipline,84,39,45
Stavfel,stormscale,2004,priest,discipline,201,107,94
Donipriest,ravencrest,2002,priest,discipline,312,179,133
Underdogx,eredar,2002,priest,discipline,551,282,269
Билетлолпро,borean-tundra,2000,priest,discipline,347,169,178
Vajadisc,twisting-nether,2000,priest,discipline,136,59,77
Tjackpanda,kazzak,1999,priest,discipline,66,38,28
Lidlpriest,frostwolf,1997,priest,discipline,48,28,20
Lyrvanax,ravencrest,1995,priest,discipline,324,162,162
Rhâpsødy,ravencrest,1994,priest,discipline,155,89,66
Wetnpuffy,ravencrest,1993,priest,discipline,292,149,143
Porkhunt,stormscale,1989,priest,discipline,96,57,39
Limerençe,ravencrest,1989,priest,discipline,98,50,48
Hamsicam,frostwolf,1989,priest,discipline,260,132,128
Rankonebabe,stormscale,1988,priest,discipline,118,65,53
Notnøw,silvermoon,1988,priest,discipline,475,248,227
Acondisc,ravencrest,1987,priest,discipline,251,130,121
Gerrylol,draenor,1987,priest,discipline,108,55,53
Shøy,nemesis,1986,priest,discipline,246,122,124
Заак,howling-fjord,1986,priest,discipline,66,30,36
Ävbmârsík,kazzak,1985,priest,discipline,149,82,67
Dabalthazar,ravencrest,1985,priest,discipline,163,83,80
Malfredx,draenor,1983,priest,discipline,51,31,20
Stormmyy,kazzak,1983,priest,discipline,118,56,62
Timbsheal,tarren-mill,1982,priest,discipline,156,79,77
Tanlytwo,ravencrest,1982,priest,discipline,112,55,57
Kenzah,ysondre,1981,priest,discipline,60,34,26
Azoran,dentarg,1981,priest,discipline,96,47,49
Nolnilian,archimonde,1980,priest,discipline,84,46,38
Dpriesta,aegwynn,1979,priest,discipline,88,52,36
Kàrèm,blutkessel,1979,priest,discipline,72,39,33
Asyncx,ravencrest,1979,priest,discipline,116,60,56
Арейша,gordunni,1979,priest,discipline,77,39,38
Ðårkìnlol,ravencrest,1978,priest,discipline,65,42,23
Pricemg,thrall,1978,priest,discipline,78,43,35
Dayno,draenor,1974,priest,discipline,127,67,60
ßlinkytwinky,outland,1974,priest,discipline,78,38,40
Tobadforglad,khaz-modan,1973,priest,discipline,41,26,15
Artist,outland,1973,priest,discipline,84,42,42
Oioiio,kazzak,1973,priest,discipline,174,84,90
Boltygnome,blades-edge,1972,priest,discipline,123,66,57
Убикрофт,soulflayer,1971,priest,discipline,85,52,33
Tweely,drakthul,1971,priest,discipline,200,104,96
Релакз,soulflayer,1971,priest,discipline,150,75,75
Tazn,thrall,1971,priest,discipline,66,33,33
Sleepypriest,frostmane,1970,priest,discipline,60,34,26
Хомячпочка,gordunni,1970,priest,discipline,82,42,40
Trashedd,outland,1970,priest,discipline,206,105,101
Infamoussftw,drakthul,1968,priest,discipline,450,221,229
Ziknait,sargeras,1967,priest,discipline,54,34,20
Comedii,blackmoore,1965,priest,discipline,477,247,230
Eukmassus,archimonde,1964,priest,discipline,82,43,39
Mindblown,arthas,1964,priest,discipline,137,70,67
Wernou,archimonde,1963,priest,discipline,60,36,24
Kripteksx,ravencrest,1963,priest,discipline,107,57,50
Psychout,ravencrest,1963,priest,discipline,141,71,70
Spinebuster,frostwolf,1963,priest,discipline,132,66,66
Sharkouly,blackmoore,1963,priest,discipline,66,33,33
Ayoutbt,ravencrest,1961,priest,discipline,114,63,51
Eestpr,tarren-mill,1961,priest,discipline,81,43,38
Líluqt,sanguino,1961,priest,discipline,102,50,52
Flongoletta,xavius,1960,priest,discipline,306,156,150
Nalakis,archimonde,1959,priest,discipline,130,79,51
Uncreative,ravencrest,1958,priest,discipline,48,34,14
Alexsmite,twisting-nether,1957,priest,discipline,59,29,30
Nêxt,ravencrest,1956,priest,discipline,114,71,43
Павук,gordunni,1956,priest,discipline,102,63,39
Painchampion,draenor,1956,priest,discipline,94,45,49
Ashenflexj,draenor,1955,priest,discipline,268,142,126
Mazikeen,stormscale,1954,priest,discipline,54,32,22
Georgeshxx,ravencrest,1954,priest,discipline,406,210,196
Cener,ravencrest,1953,priest,discipline,146,90,56
Klered,ragnaros,1953,priest,discipline,94,57,37
Fsnx,sylvanas,1953,priest,discipline,180,103,77
Krawnz,dun-modr,1953,priest,discipline,54,29,25
Aiwass,twisting-nether,1952,priest,discipline,84,45,39
Finiskram,sylvanas,1952,priest,discipline,90,46,44
Sfÿ,ysondre,1952,priest,discipline,108,48,60
Холиэирлайнс,howling-fjord,1951,priest,discipline,39,22,17
Arendt,blackhand,1951,priest,discipline,174,90,84
Mainputa,pozzo-delleternità,1951,priest,discipline,119,57,62
Невертрикахд,gordunni,1951,priest,discipline,119,56,63
Shadothat,turalyon,1950,priest,discipline,203,106,97
Sathie,ravencrest,1949,priest,discipline,138,71,67
Fabzen,grim-batol,1949,priest,discipline,117,60,57
Bindw,tarren-mill,1949,priest,discipline,65,29,36
Ekman,twisting-nether,1948,priest,discipline,152,78,74
Factorywrkr,silvermoon,1946,priest,discipline,30,25,5
Stazqt,conseil-des-ombres,1946,priest,discipline,497,256,241
Çiione,archimonde,1946,priest,discipline,107,55,52
Artle,dun-modr,1945,priest,discipline,88,61,27
Dâhyun,ravencrest,1944,priest,discipline,275,163,112
Karmev,twisting-nether,1944,priest,discipline,71,36,35
Бенджаминлол,deathguard,1944,priest,discipline,114,57,57
Elsuzette,hyjal,1943,priest,discipline,64,35,29
Kekkonh,sylvanas,1943,priest,discipline,315,159,156
Loví,twisting-nether,1942,priest,discipline,155,71,84
Soziy,silvermoon,1941,priest,discipline,51,28,23
Галюхах,soulflayer,1941,priest,discipline,72,38,34
Мамкалол,soulflayer,1941,priest,discipline,468,233,235
Próxs,ravencrest,1940,priest,discipline,60,32,28
Bølzer,blackrock,1940,priest,discipline,450,228,222
Mentalist,dun-modr,1940,priest,discipline,273,130,143
Concetto,nazjatar,1939,priest,discipline,48,27,21
Oldnbad,archimonde,1939,priest,discipline,54,28,26
Puckhorde,outland,1938,priest,discipline,96,59,37
Lyrvatwo,ravencrest,1938,priest,discipline,55,33,22
Seankingkong,ravencrest,1938,priest,discipline,60,35,25
Scortie,blackrock,1938,priest,discipline,78,41,37
Yânux,aegwynn,1937,priest,discipline,276,140,136
Sheelah,ravencrest,1937,priest,discipline,148,74,74
Senga,kazzak,1937,priest,discipline,78,38,40
Mysterymucus,draenor,1934,priest,discipline,170,94,76
Eau,quelthalas,1934,priest,discipline,359,177,182
Вакариия,soulflayer,1934,priest,discipline,73,33,40
Soyloverjuan,auchindoun,1933,priest,discipline,64,33,31
Flugame,ravencrest,1933,priest,discipline,123,63,60
Zularia,rexxar,1932,priest,discipline,132,70,62
Justyø,archimonde,1927,priest,discipline,345,196,149
Indulgence,eredar,1927,priest,discipline,427,215,212
Místerbiceps,outland,1927,priest,discipline,152,75,77
Mswagner,outland,1926,priest,discipline,65,36,29
Salvinia,kelthuzad,1926,priest,discipline,144,71,73
Лёнятреппер,blackscar,1925,priest,discipline,183,102,81
Traicklebron,antonidas,1924,priest,discipline,57,35,22
Xutira,silvermoon,1924,priest,discipline,222,128,94
Kavrack,sargeras,1923,priest,discipline,77,41,36
Jâde,bloodhoof,1923,priest,discipline,480,246,234
Expert,blackrock,1923,priest,discipline,99,49,50
Ebuglatatrov,ravencrest,1922,priest,discipline,174,83,91
Akaria,kelthuzad,1922,priest,discipline,66,30,36
Filthyzx,argent-dawn,1921,priest,discipline,114,58,56
Depridolens,argent-dawn,1920,priest,discipline,100,57,43
Aêalama,argent-dawn,1919,priest,discipline,90,45,45
Батлджес,gordunni,1918,priest,discipline,140,76,64
Azpr,ravencrest,1917,priest,discipline,48,26,22
Semagdnim,aggra-português,1917,priest,discipline,198,99,99
Sokratina,ragnaros,1916,priest,discipline,124,84,40
Алинкалол,howling-fjord,1916,priest,discipline,192,110,82
Xraid,blackmoore,1916,priest,discipline,146,78,68
Tacochrist,kazzak,1916,priest,discipline,358,190,168
Xians,alakir,1915,priest,discipline,48,27,21
Nothappy,ragnaros,1915,priest,discipline,84,37,47
Делреона,blackscar,1914,priest,discipline,102,58,44
Nirvz,silvermoon,1913,priest,discipline,78,56,22
Indrades,blackmoore,1912,priest,discipline,63,36,27
Deneris,ravencrest,1912,priest,discipline,59,27,32
Rxquiem,archimonde,1912,priest,discipline,100,44,56
Lánî,blackmoore,1911,priest,discipline,56,30,26
Sinetrax,tarren-mill,1910,priest,discipline,114,63,51
Xghj,sylvanas,1910,priest,discipline,96,52,44
Listrix,frostmane,1910,priest,discipline,394,199,195
Ifeared,stormscale,1909,priest,discipline,51,26,25
Rhauru,tyrande,1909,priest,discipline,331,159,172
Lovdisc,ysondre,1908,priest,discipline,148,84,64
Кв,blackscar,1908,priest,discipline,114,48,66
Priestdos,sanguino,1907,priest,discipline,61,39,22
Чилюотферала,eversong,1907,priest,discipline,114,51,63
Mend,tarren-mill,1906,priest,discipline,95,46,49
Nyàh,stormscale,1905,priest,discipline,89,47,42
Ingelosi,eredar,1904,priest,discipline,262,142,120
Výra,der-rat-von-dalaran,1904,priest,discipline,80,41,39
Wangewover,ravencrest,1903,priest,discipline,177,98,79
Noserenity,outland,1902,priest,discipline,77,48,29
Jeanprêtre,ysondre,1902,priest,discipline,156,75,81
Savta,ravencrest,1901,priest,discipline,102,55,47
Georgesheenx,ravencrest,1901,priest,discipline,326,163,163
Sovereignp,aegwynn,1900,priest,discipline,66,33,33
Поднялбабки,deathguard,1900,priest,discipline,89,37,52
Çhåosgòddess,kazzak,1899,priest,discipline,48,28,20
Alsalty,stormscale,1899,priest,discipline,113,52,61
Faderfarbror,tarren-mill,1898,priest,discipline,133,81,52
Райлоу,azuregos,1898,priest,discipline,132,70,62
Djsüssi,frostwolf,1898,priest,discipline,192,88,104
Rîeka,antonidas,1897,priest,discipline,83,40,43
Miraña,kazzak,1896,priest,discipline,30,24,6
Vallstwo,zuljin,1895,priest,discipline,84,43,41
Хомяктьмы,gordunni,1895,priest,discipline,144,71,73
Мефодийприст,howling-fjord,1894,priest,discipline,120,72,48
Citadelle,blackmoore,1894,priest,discipline,83,48,35
Shadiè,sylvanas,1894,priest,discipline,50,28,22
Wyroofear,ragnaros,1894,priest,discipline,77,37,40
Discishârd,ravencrest,1893,priest,discipline,117,60,57
Hélp,stormscale,1892,priest,discipline,114,75,39
Trevorlahey,draenor,1892,priest,discipline,380,203,177
Bigextendo,blackmoore,1892,priest,discipline,153,80,73
Dendegodx,kazzak,1891,priest,discipline,150,82,68
Разорлайтх,gordunni,1890,priest,discipline,29,21,8
Poulet,sylvanas,1889,priest,discipline,244,127,117
Önnÿ,dun-modr,1889,priest,discipline,161,79,82
Unfaithful,twisting-nether,1888,priest,discipline,76,48,28
Yzïam,ravencrest,1887,priest,discipline,165,87,78
Uwuslayerx,stormscale,1887,priest,discipline,149,74,75
Dieterdose,tarren-mill,1886,priest,discipline,62,39,23
Betatasty,dalaran,1886,priest,discipline,102,54,48
Wet,twisting-nether,1886,priest,discipline,194,85,109
Sûzy,ravencrest,1885,priest,discipline,42,24,18
Лайбаси,howling-fjord,1885,priest,discipline,272,136,136
Aprilfalls,blackmoore,1885,priest,discipline,72,34,38
Menarille,kazzak,1882,priest,discipline,48,37,11
Duelistfied,blackrock,1882,priest,discipline,110,53,57
Бенджаминлол,blackscar,1882,priest,discipline,120,52,68
Abomïnàtîon,ysondre,1881,priest,discipline,73,56,17
Voideffsucks,stormscale,1881,priest,discipline,60,32,28
Niniell,blackmoore,1880,priest,discipline,120,68,52
Jconnelly,antonidas,1880,priest,discipline,86,44,42
Merylle,ragnaros,1880,priest,discipline,60,29,31
Spodermen,ravencrest,1879,priest,discipline,109,60,49
Eavy,argent-dawn,1879,priest,discipline,54,28,26
Ilovelily,antonidas,1879,priest,discipline,84,42,42
Neffty,aegwynn,1878,priest,discipline,313,163,150
Пэрдёж,howling-fjord,1878,priest,discipline,41,21,20
Luvdisc,ysondre,1878,priest,discipline,74,37,37
Nedex,thrall,1877,priest,discipline,61,32,29
Fitu,drakthul,1877,priest,discipline,173,90,83
Phyxiusx,stormscale,1876,priest,discipline,120,68,52
Смотривнебоь,soulflayer,1875,priest,discipline,224,119,105
Таравера,soulflayer,1875,priest,discipline,220,113,107
Laurens,tarren-mill,1875,priest,discipline,66,33,33
Свэпи,blackscar,1875,priest,discipline,77,38,39
Numa,stormscale,1875,priest,discipline,76,37,39
Alpháømegá,outland,1874,priest,discipline,166,85,81
Alèxy,tarren-mill,1874,priest,discipline,66,33,33
Yeetedmycat,stormscale,1873,priest,discipline,72,37,35
Падлез,howling-fjord,1873,priest,discipline,72,32,40
Wóllo,stormscale,1872,priest,discipline,72,42,30
Elethia,blackmoore,1872,priest,discipline,38,21,17
Луилэнс,howling-fjord,1872,priest,discipline,148,80,68
ßrb,sylvanas,1872,priest,discipline,258,138,120
Potatojuicer,argent-dawn,1872,priest,discipline,602,301,301
Menecare,blackhand,1871,priest,discipline,42,24,18
Поршкаенн,gordunni,1871,priest,discipline,66,37,29
Måzikeen,stormscale,1870,priest,discipline,42,29,13
Cdïs,tyrande,1870,priest,discipline,54,36,18
Rpriest,outland,1870,priest,discipline,60,34,26
Тёмныйвид,soulflayer,1870,priest,discipline,410,203,207
Egî,azshara,1870,priest,discipline,42,20,22
Bindww,tarren-mill,1869,priest,discipline,42,23,19
Immortalled,twisting-nether,1869,priest,discipline,156,85,71
Интеллиджент,gordunni,1868,priest,discipline,42,24,18
Zhadow,outland,1868,priest,discipline,150,78,72
Двачх,soulflayer,1868,priest,discipline,72,35,37
Wyrofear,ragnaros,1867,priest,discipline,75,34,41
Williamz,ravencrest,1866,priest,discipline,79,44,35
Zychopriest,antonidas,1866,priest,discipline,105,53,52
Incaflamesex,sanguino,1866,priest,discipline,191,96,95
Karmasmom,kazzak,1866,priest,discipline,132,63,69
Saniqt,kazzak,1865,priest,discipline,57,35,22
Phosdia,festung-der-stürme,1864,priest,discipline,36,24,12
Ilovecala,ravencrest,1864,priest,discipline,54,31,23
Sinfulmaze,outland,1864,priest,discipline,54,28,26
Negativeapm,archimonde,1863,priest,discipline,41,24,17
Ssjfoxyo,sylvanas,1863,priest,discipline,433,220,213
Аркада,blackscar,1863,priest,discipline,78,37,41
Kaori,zenedar,1861,priest,discipline,71,38,33
Artìst,ravencrest,1860,priest,discipline,36,23,13
Doublefreak,draenor,1860,priest,discipline,102,63,39
Shínx,illidan,1860,priest,discipline,96,57,39
Кошечка,deathguard,1860,priest,discipline,41,21,20
Sakulus,malganis,1860,priest,discipline,72,34,38
Thalanas,ravencrest,1859,priest,discipline,158,90,68
Sublab,kazzak,1859,priest,discipline,60,33,27
Imahipstaqt,eredar,1859,priest,discipline,129,69,60
Furtnajebany,tarren-mill,1858,priest,discipline,93,47,46
Monopolygoat,arathor,1858,priest,discipline,181,84,97
Chochoo,argent-dawn,1858,priest,discipline,78,35,43
Фрайонель,gordunni,1857,priest,discipline,42,32,10
Iloveilka,madmortem,1857,priest,discipline,41,25,16
Cedifanboyx,archimonde,1857,priest,discipline,102,57,45
Frida,blackrock,1857,priest,discipline,119,57,62
Ssjx,ravencrest,1856,priest,discipline,102,55,47
Гоплзнекст,gordunni,1855,priest,discipline,119,63,56
Reckxp,twisting-nether,1855,priest,discipline,186,91,95
Feedergodx,dun-modr,1854,priest,discipline,54,31,23
Lîke,shattrath,1854,priest,discipline,60,31,29
Zyzx,blackrock,1854,priest,discipline,114,53,61
Bloodhealer,draenor,1853,priest,discipline,34,22,12
Ýbëzz,ravencrest,1853,priest,discipline,42,27,15
Ranocchio,the-maelstrom,1853,priest,discipline,55,30,25
Vardogz,tirion,1853,priest,discipline,305,160,145
Healseri,defias-brotherhood,1853,priest,discipline,252,126,126
Crushmyballs,ravencrest,1852,priest,discipline,60,36,24
Chéry,archimonde,1852,priest,discipline,84,46,38
Джагонх,soulflayer,1852,priest,discipline,123,61,62
Кисашвд,gordunni,1851,priest,discipline,72,42,30
Yamai,thrall,1851,priest,discipline,48,26,22
Djswdgodx,twisting-nether,1851,priest,discipline,108,55,53
Ranchikswp,ravencrest,1850,priest,discipline,42,24,18
Anabølix,ravencrest,1850,priest,discipline,65,33,32
Enilion,draenor,1850,priest,discipline,71,34,37
Fandac,sylvanas,1849,priest,discipline,90,55,35
Echonic,aegwynn,1849,priest,discipline,875,444,431
Rngånxiety,ravencrest,1849,priest,discipline,160,78,82
Bockx,ragnaros,1849,priest,discipline,134,65,69
Brainerror,outland,1849,priest,discipline,69,32,37
Stola,archimonde,1849,priest,discipline,137,61,76
Rynnegan,zuljin,1849,priest,discipline,72,31,41
Padisonfire,blackmoore,1849,priest,discipline,78,33,45
Pâww,kazzak,1848,priest,discipline,72,39,33
Asdfghqwezxc,twisting-nether,1848,priest,discipline,77,40,37
Shonsized,argent-dawn,1847,priest,discipline,154,88,66
Remkoja,blackrock,1847,priest,discipline,108,57,51
Kianprie,silvermoon,1847,priest,discipline,125,58,67
Aédeira,blackhand,1847,priest,discipline,83,34,49
Noukeé,blackrock,1847,priest,discipline,113,46,67
Assiduous,stormreaver,1846,priest,discipline,46,27,19
Cæsifer,blackrock,1846,priest,discipline,124,71,53
Andaar,ravencrest,1846,priest,discipline,66,35,31
Judine,kazzak,1846,priest,discipline,70,35,35
Andrë,ragnaros,1845,priest,discipline,46,29,17
Chabi,stormscale,1845,priest,discipline,45,25,20
Waafa,kazzak,1845,priest,discipline,93,50,43
Pradrak,eredar,1845,priest,discipline,60,32,28
Skjelett,stormscale,1845,priest,discipline,68,36,32
Exola,outland,1845,priest,discipline,60,31,29
Tingoess,silvermoon,1845,priest,discipline,174,89,85
Frenchpriest,archimonde,1845,priest,discipline,65,30,35
Sadsadsad,ravencrest,1845,priest,discipline,102,41,61
Gothicpriest,blackrock,1844,priest,discipline,65,41,24
Lanata,blackrock,1844,priest,discipline,114,60,54
Rezzdar,lightnings-blade,1844,priest,discipline,199,100,99
Tanly,outland,1844,priest,discipline,220,109,111
Jimpah,outland,1844,priest,discipline,189,89,100
Møelester,antonidas,1843,priest,discipline,66,36,30
Nerfthat,thunderhorn,1843,priest,discipline,59,30,29
Аэтпио,soulflayer,1843,priest,discipline,126,64,62
Onyoureyebal,vashj,1843,priest,discipline,249,118,131
Лэсивэснэс,soulflayer,1843,priest,discipline,227,107,120
Bæsts,ravencrest,1842,priest,discipline,47,35,12
Jellypie,blackrock,1842,priest,discipline,60,36,24
Vyrá,der-rat-von-dalaran,1842,priest,discipline,51,30,21
Maulerion,tarren-mill,1842,priest,discipline,92,53,39
Schattenface,blackmoore,1842,priest,discipline,374,192,182
Maxfly,archimonde,1842,priest,discipline,104,53,51
Smallsmilesx,blackrock,1842,priest,discipline,78,33,45
Trolldý,outland,1841,priest,discipline,54,33,21
Twinkerz,ravencrest,1841,priest,discipline,120,73,47
Discoqt,aegwynn,1841,priest,discipline,66,32,34
Дезминд,howling-fjord,1840,priest,discipline,41,23,18
Rngamer,silvermoon,1839,priest,discipline,42,33,9
Akzar,blackrock,1839,priest,discipline,735,375,360
Sdlman,nemesis,1839,priest,discipline,419,213,206
Shîn,zirkel-des-cenarius,1839,priest,discipline,72,32,40
Brigittë,ravencrest,1839,priest,discipline,78,31,47
Paterfisl,ragnaros,1838,priest,discipline,108,64,44
Goky,kazzak,1838,priest,discipline,108,50,58
Kolerps,ravencrest,1838,priest,discipline,54,25,29
Tia,mannoroth,1838,priest,discipline,70,31,39
Lunærÿ,hyjal,1838,priest,discipline,66,28,38
ßçøûzýìñ,ravencrest,1837,priest,discipline,40,29,11
Kappa,darksorrow,1837,priest,discipline,132,86,46
Xíøn,draenor,1837,priest,discipline,48,28,20
Src,ravencrest,1837,priest,discipline,155,84,71
Jp,gorgonnash,1837,priest,discipline,69,36,33
Rogeron,blackrock,1837,priest,discipline,118,57,61
Dogfx,blackhand,1837,priest,discipline,78,36,42
Mcpriestgodx,blackrock,1837,priest,discipline,108,48,60
Duqes,stormreaver,1836,priest,discipline,57,44,13
Cyabish,twisting-nether,1836,priest,discipline,293,157,136
Hyonra,kazzak,1836,priest,discipline,66,34,32
Aspertina,outland,1836,priest,discipline,48,22,26
Aeogon,kazzak,1836,priest,discipline,179,79,100
Некронево,howling-fjord,1835,priest,discipline,51,30,21
Helalolsun,archimonde,1835,priest,discipline,308,167,141
Kathigitis,stormscale,1835,priest,discipline,89,48,41
Lexìì,archimonde,1835,priest,discipline,66,35,31
Прощайдуде,gordunni,1835,priest,discipline,71,36,35
Yourholynes,nemesis,1835,priest,discipline,72,35,37
Ishkà,stormscale,1835,priest,discipline,105,51,54
Видзар,blackscar,1834,priest,discipline,42,27,15
Анстахоуп,grom,1834,priest,discipline,210,131,79
Rêstlêss,blackrock,1834,priest,discipline,161,88,73
Eliana,blackrock,1834,priest,discipline,175,92,83
Ксенонх,gordunni,1834,priest,discipline,66,30,36
Scarylol,blackmoore,1833,priest,discipline,60,33,27
Vemix,ravencrest,1832,priest,discipline,126,85,41
Anabananaa,ravencrest,1832,priest,discipline,106,65,41
Azaciúx,sylvanas,1832,priest,discipline,48,29,19
Flensu,stormscale,1832,priest,discipline,112,63,49
Feeqamikka,ragnaros,1832,priest,discipline,61,32,29
Nakenhäst,ravencrest,1832,priest,discipline,84,39,45
Holytopp,aegwynn,1831,priest,discipline,60,36,24
Seherbazqt,twisting-nether,1831,priest,discipline,232,124,108
Jøjmenejøj,ravencrest,1831,priest,discipline,197,101,96
Ðènnis,argent-dawn,1831,priest,discipline,145,73,72
Notnowelf,silvermoon,1831,priest,discipline,108,49,59
Sazuki,sylvanas,1830,priest,discipline,119,71,48
Discberg,kazzak,1830,priest,discipline,54,29,25
Лизагодх,howling-fjord,1830,priest,discipline,306,161,145
Monsterzx,outland,1830,priest,discipline,203,102,101
Soreboners,stormscale,1830,priest,discipline,42,21,21
Psyheea,stormscale,1830,priest,discipline,165,77,88
Deadandugly,eredar,1830,priest,discipline,114,52,62
Deviön,blackrock,1829,priest,discipline,60,32,28
Женяшилд,howling-fjord,1829,priest,discipline,402,210,192
Aliciaiscute,ravencrest,1829,priest,discipline,52,27,25
Bijaqt,blackmoore,1829,priest,discipline,54,27,27
Akeno,sylvanas,1829,priest,discipline,70,31,39
Discipleotl,stormscale,1828,priest,discipline,143,96,47
Ðæððysgïrl,ravencrest,1828,priest,discipline,90,60,30
Парадайси,gordunni,1828,priest,discipline,53,35,18
Zisch,silvermoon,1828,priest,discipline,184,109,75
Illuminarexo,sylvanas,1828,priest,discipline,145,82,63
Sosabgd,azjolnerub,1828,priest,discipline,211,117,94
Chivalryy,argent-dawn,1828,priest,discipline,119,64,55
Ayije,ravencrest,1828,priest,discipline,180,94,86
Itayyxd,doomhammer,1828,priest,discipline,66,34,32
Ostrogami,silvermoon,1828,priest,discipline,777,382,395
Асверай,howling-fjord,1827,priest,discipline,96,58,38
Feardotexe,frostwolf,1827,priest,discipline,275,146,129
Кирюшасэмпай,gordunni,1827,priest,discipline,262,139,123
Noelretsof,jaedenar,1827,priest,discipline,68,34,34
Ltmp,ravencrest,1827,priest,discipline,48,24,24
Nakenhäst,stormscale,1827,priest,discipline,80,37,43
Mobcal,twisting-nether,1827,priest,discipline,108,48,60
Oesterput,stormscale,1827,priest,discipline,48,21,27
Talbyslegacý,blackmoore,1826,priest,discipline,126,70,56
Øxxgodx,blackrock,1826,priest,discipline,162,88,74
Holytop,aegwynn,1826,priest,discipline,60,31,29
Nadøney,hyjal,1826,priest,discipline,172,87,85
Snutz,draenor,1826,priest,discipline,94,46,48
Fønss,sanguino,1826,priest,discipline,89,41,48
Krematorio,twisting-nether,1826,priest,discipline,65,28,37
Jimski,stormscale,1826,priest,discipline,77,33,44
Sinetrax,draenor,1825,priest,discipline,48,30,18
Theythem,stormscale,1825,priest,discipline,42,25,17
Luphriest,ravencrest,1825,priest,discipline,42,25,17
Hyw,hyjal,1825,priest,discipline,45,26,19
Manuelakanji,outland,1825,priest,discipline,98,56,42
Bebydaniwey,eredar,1825,priest,discipline,48,27,21
Moglimeister,blackrock,1825,priest,discipline,72,40,32
Nothic,blackmoore,1825,priest,discipline,196,105,91
Optiprime,ravencrest,1825,priest,discipline,60,30,30
Gimeurgold,destromath,1825,priest,discipline,66,32,34
Reign,ragnaros,1825,priest,discipline,64,31,33
Chechenkata,ravencrest,1825,priest,discipline,57,27,30
Deoxx,kazzak,1825,priest,discipline,150,71,79
Йефа,gordunni,1824,priest,discipline,124,71,53
Ronnyvandamm,destromath,1824,priest,discipline,325,177,148
Zarez,stormscale,1824,priest,discipline,95,47,48
Xoxogg,burning-blade,1823,priest,discipline,156,102,54
Flokè,stormscale,1823,priest,discipline,84,46,38
Tjackmackann,kazzak,1823,priest,discipline,54,29,25
Ðiiez,ysondre,1823,priest,discipline,129,69,60
Virulence,twisting-nether,1823,priest,discipline,413,216,197
Мухаглот,soulflayer,1823,priest,discipline,71,37,34
Krautfunding,blackrock,1823,priest,discipline,66,33,33
Mamaa,stormscale,1822,priest,discipline,78,43,35
Mald,ravencrest,1822,priest,discipline,276,146,130
Élsias,blackmoore,1822,priest,discipline,69,35,34
Tecc,draenor,1822,priest,discipline,136,68,68
Xandrial,blackmoore,1822,priest,discipline,66,30,36
Mèlindra,draenor,1821,priest,discipline,35,28,7
Estelle,silvermoon,1821,priest,discipline,151,95,56
Билет,borean-tundra,1821,priest,discipline,42,26,16
Aâraks,khaz-modan,1821,priest,discipline,134,82,52
Tribz,kargath,1821,priest,discipline,36,22,14
Roylian,ravencrest,1821,priest,discipline,51,28,23
Mautiya,blackrock,1821,priest,discipline,120,65,55
Felaenna,argent-dawn,1821,priest,discipline,151,81,70
Miklós,die-aldor,1821,priest,discipline,54,28,26
Samaya,blackrock,1821,priest,discipline,195,98,97
Neurozx,ravencrest,1821,priest,discipline,66,32,34
Moyoo,kazzak,1821,priest,discipline,188,88,100
Skyland,emeriss,1820,priest,discipline,36,20,16
Dotzey,outland,1820,priest,discipline,101,43,58
Rihx,ysondre,1819,priest,discipline,115,78,37
Yunusgødx,kazzak,1819,priest,discipline,102,65,37
Силесттиль,gordunni,1819,priest,discipline,77,49,28
Noskillx,burning-legion,1819,priest,discipline,106,66,40
Legitha,blackmoore,1819,priest,discipline,51,31,20
Dribbler,ragnaros,1819,priest,discipline,70,42,28
Striderz,outland,1819,priest,discipline,126,72,54
Омилая,gordunni,1819,priest,discipline,42,24,18
Изишвд,gordunni,1819,priest,discipline,59,33,26
Ayõu,ravencrest,1819,priest,discipline,114,63,51
Дорогасмеха,howling-fjord,1819,priest,discipline,72,39,33
Kristianburn,arathi,1819,priest,discipline,60,31,29
Vibéz,outland,1819,priest,discipline,54,27,27
Lucyx,antonidas,1818,priest,discipline,36,25,11
Tylér,stormscale,1818,priest,discipline,144,88,56
Jaesabøyx,twisting-nether,1818,priest,discipline,168,100,68
Smitemachine,ysondre,1818,priest,discipline,60,35,25
Kimspriest,ragnaros,1818,priest,discipline,42,24,18
Fems,tarren-mill,1818,priest,discipline,90,49,41
Imsaltyxd,tarren-mill,1818,priest,discipline,96,52,44
Egi,lothar,1818,priest,discipline,51,27,24
Cæsífer,senjin,1818,priest,discipline,78,41,37
Prayxlol,outland,1818,priest,discipline,42,22,20
Blerd,eredar,1818,priest,discipline,267,139,128
Spatzdom,malygos,1818,priest,discipline,297,151,146
Spiritina,darkmoon-faire,1817,priest,discipline,76,52,24
Holycuddles,ysondre,1817,priest,discipline,78,47,31
Hanniri,archimonde,1817,priest,discipline,54,31,23
Cellia,antonidas,1817,priest,discipline,60,32,28
Отклонен,soulflayer,1817,priest,discipline,84,43,41
Rexzuwe,eredar,1817,priest,discipline,60,30,30
Шатолюгран,soulflayer,1816,priest,discipline,166,105,61
Saygg,ysondre,1816,priest,discipline,120,63,57
Приствалера,howling-fjord,1816,priest,discipline,488,249,239
Flowstate,sylvanas,1816,priest,discipline,52,26,26
Thaeres,stormscale,1816,priest,discipline,65,31,34
Ferpy,ragnaros,1816,priest,discipline,84,40,44
Оченьнеочень,howling-fjord,1816,priest,discipline,72,33,39
Hængøver,blackmoore,1816,priest,discipline,78,33,45
Jowaba,ravencrest,1815,priest,discipline,60,38,22
Tricavla,frostmane,1815,priest,discipline,132,74,58
Milamati,kazzak,1815,priest,discipline,90,50,40
Flanderspri,ravencrest,1815,priest,discipline,54,30,24
Виллавелл,blackscar,1815,priest,discipline,48,24,24
Løs,argent-dawn,1815,priest,discipline,108,53,55
Mgx,defias-brotherhood,1815,priest,discipline,105,49,56
Flax,the-maelstrom,1814,priest,discipline,53,37,16
Jannejanne,ravencrest,1814,priest,discipline,30,19,11
Casic,blackhand,1814,priest,discipline,65,41,24
Alexpriest,twisting-nether,1814,priest,discipline,539,283,256
Spaanseslof,silvermoon,1814,priest,discipline,240,117,123
Asdfgfhtjy,stormscale,1814,priest,discipline,148,72,76
Шкурюклады,gordunni,1814,priest,discipline,146,71,75
Уэйнестелл,booty-bay,1814,priest,discipline,72,35,37
Aridarpriest,silvermoon,1814,priest,discipline,176,83,93
Charlotten,shattered-hand,1814,priest,discipline,268,123,145
Daniweyy,eredar,1813,priest,discipline,30,19,11
Dzyxx,ravencrest,1813,priest,discipline,66,37,29
Brownhammer,ravencrest,1813,priest,discipline,100,56,44
Efeslol,dun-modr,1813,priest,discipline,255,133,122
Jesster,sylvanas,1813,priest,discipline,81,41,40
Architectx,ravencrest,1813,priest,discipline,131,66,65
Cæsifer,area-52,1813,priest,discipline,54,27,27
Dhassy,sanguino,1812,priest,discipline,71,44,27
Viiu,eredar,1812,priest,discipline,45,25,20
Eedazap,argent-dawn,1812,priest,discipline,58,32,26
Skynoxx,ragnaros,1812,priest,discipline,221,121,100
Leahx,dalvengyr,1812,priest,discipline,76,40,36
Isalvation,stormscale,1812,priest,discipline,78,38,40
Faenei,draenor,1812,priest,discipline,66,32,34
Mïserygødx,nemesis,1811,priest,discipline,84,57,27
Eyesønyou,nemesis,1811,priest,discipline,51,33,18
Антошашвп,azuregos,1811,priest,discipline,42,25,17
Holysjodin,tarren-mill,1811,priest,discipline,42,23,19
Ohlinsqt,outland,1811,priest,discipline,78,42,36
Deluxgodx,kazzak,1811,priest,discipline,81,43,38
Hellhammer,stormreaver,1811,priest,discipline,310,162,148
Фалд,gordunni,1811,priest,discipline,117,61,56
Scaday,sanguino,1811,priest,discipline,54,28,26
Arythc,ahnqiraj,1811,priest,discipline,101,52,49
Neska,antonidas,1811,priest,discipline,53,23,30
Infamous,stormscale,1810,priest,discipline,51,36,15
Muncett,dun-modr,1810,priest,discipline,113,67,46
Türsteherxxl,mannoroth,1810,priest,discipline,126,74,52
Vinopure,turalyon,1810,priest,discipline,72,39,33
Gaussqt,ravencrest,1810,priest,discipline,120,62,58
Numatrash,stormscale,1810,priest,discipline,68,32,36
Mythasz,archimonde,1810,priest,discipline,76,35,41
Undeathy,ravencrest,1810,priest,discipline,90,39,51
Xrq,stormscale,1809,priest,discipline,36,27,9
Delftware,tarren-mill,1809,priest,discipline,36,27,9
Thedisco,kazzak,1809,priest,discipline,84,56,28
Discisiipeli,sylvanas,1809,priest,discipline,96,55,41
Pny,outland,1809,priest,discipline,114,62,52
Danglar,defias-brotherhood,1809,priest,discipline,126,67,59
Qzrx,draenor,1809,priest,discipline,90,47,43
Røylian,ravencrest,1809,priest,discipline,54,28,26
Kuxk,stormscale,1809,priest,discipline,48,24,24
Незерхэвэн,soulflayer,1809,priest,discipline,59,29,30
Fearsleba,stormreaver,1809,priest,discipline,66,30,36
Ðøñtårmørýmë,der-abyssische-rat,1809,priest,discipline,56,23,33
Sikaanyo,blackhand,1808,priest,discipline,119,68,51
Niagarafalls,ragnaros,1808,priest,discipline,231,128,103
Tudp,tarren-mill,1808,priest,discipline,283,150,133
Nstp,zuljin,1808,priest,discipline,36,19,17
Prips,bladefist,1808,priest,discipline,223,117,106
Lethalhealz,outland,1808,priest,discipline,458,240,218
Blackbertha,ravencrest,1808,priest,discipline,162,81,81
Jamienism,ravencrest,1808,priest,discipline,94,39,55
Ÿolo,nemesis,1807,priest,discipline,80,47,33
Cucurulla,sanguino,1807,priest,discipline,92,48,44
Emryth,blackhand,1807,priest,discipline,300,156,144
Mirupriest,sanguino,1807,priest,discipline,66,34,32
Raw,dragonblight,1807,priest,discipline,72,36,36
Evpisces,archimonde,1807,priest,discipline,601,296,305
Verti,outland,1807,priest,discipline,226,108,118
Seasonf,tarren-mill,1807,priest,discipline,60,28,32
Supervillain,draenor,1806,priest,discipline,407,224,183
Zarahard,draenor,1806,priest,discipline,120,65,55
Níghty,ravencrest,1806,priest,discipline,144,75,69
Zeruhphin,eredar,1806,priest,discipline,54,28,26
Vigoria,stormreaver,1806,priest,discipline,294,150,144
Svenmagnus,tarren-mill,1806,priest,discipline,101,49,52
Mïxa,eitrigg,1805,priest,discipline,42,28,14
Urizal,defias-brotherhood,1805,priest,discipline,54,31,23
Артфуул,howling-fjord,1805,priest,discipline,78,43,35
Unbangable,draenor,1805,priest,discipline,261,134,127
Сандейрейн,gordunni,1805,priest,discipline,71,36,35
Ipâ,hyjal,1805,priest,discipline,417,207,210
Neems,twisting-nether,1805,priest,discipline,42,19,23
Ïcön,ravencrest,1804,priest,discipline,60,43,17
Ljusmor,silvermoon,1804,priest,discipline,99,62,37
Bennyjamin,kazzak,1804,priest,discipline,74,45,29
Floyyd,kazzak,1804,priest,discipline,42,24,18
Tynsxd,silvermoon,1804,priest,discipline,481,267,214
Needsboorst,ravencrest,1804,priest,discipline,66,36,30
Nooxid,eredar,1804,priest,discipline,159,86,73
Krokkete,hyjal,1804,priest,discipline,54,29,25
Sebbi,ragnaros,1804,priest,discipline,96,46,50
Fogel,turalyon,1803,priest,discipline,96,82,14
Niíall,skullcrusher,1803,priest,discipline,42,27,15
Laonar,silvermoon,1803,priest,discipline,181,115,66
Ecrisis,twisting-nether,1803,priest,discipline,243,127,116
Gehrke,silvermoon,1803,priest,discipline,117,59,58
Uivi,azjolnerub,1803,priest,discipline,80,40,40
Chekkó,blackrock,1803,priest,discipline,128,61,67
Ebiso,ravencrest,1803,priest,discipline,90,41,49
Rainbowroll,kazzak,1803,priest,discipline,82,37,45
Zsg,draenor,1802,priest,discipline,150,88,62
Ледикрис,blackscar,1802,priest,discipline,125,73,52
Zoophobîa,stormscale,1802,priest,discipline,96,54,42
Lekken,kazzak,1802,priest,discipline,123,69,54
Amysantiàgo,sylvanas,1802,priest,discipline,432,231,201
Bassepriest,tarren-mill,1802,priest,discipline,101,53,48
Squishylol,tarren-mill,1802,priest,discipline,66,34,32
Smilézz,eredar,1802,priest,discipline,266,136,130
Montarone,archimonde,1802,priest,discipline,102,52,50
Свдпро,soulflayer,1802,priest,discipline,186,86,100
Brainbadly,aegwynn,1802,priest,discipline,48,22,26
Карбонит,fordragon,1802,priest,discipline,54,24,30
Mythaaz,archimonde,1802,priest,discipline,57,23,34
Кошкаенот,blackscar,1802,priest,discipline,83,33,50
Cx,mazrigos,1801,priest,discipline,65,42,23
Aski,blackhand,1801,priest,discipline,30,19,11
Mopriest,eredar,1801,priest,discipline,110,68,42
Aelisendi,draenor,1801,priest,discipline,89,51,38
Nintendó,sylvanas,1801,priest,discipline,120,68,52
Reclue,silvermoon,1801,priest,discipline,48,27,21
Rabbai,twisting-nether,1801,priest,discipline,66,37,29
Holyshiiet,stormscale,1801,priest,discipline,275,151,124
Raesd,argent-dawn,1801,priest,discipline,148,80,68
Naivah,dun-modr,1801,priest,discipline,229,122,107
Bekznfiend,ragnaros,1801,priest,discipline,71,33,38
Melphixia,stormscale,1801,priest,discipline,112,50,62
Yameru,stormreaver,1801,priest,discipline,78,34,44
Зулфар,razuvious,1800,priest,discipline,48,36,12
Wardshield,ravencrest,1800,priest,discipline,29,20,9
Felwy,stormscale,1800,priest,discipline,48,31,17
Hasnoaim,dun-morogh,1800,priest,discipline,66,41,25
Nazzghul,silvermoon,1800,priest,discipline,188,105,83
Умом,gordunni,1800,priest,discipline,66,36,30
Нтти,soulflayer,1800,priest,discipline,128,68,60
Twizl,hyjal,1800,priest,discipline,227,118,109
Mantra,blackmoore,1800,priest,discipline,351,179,172
Zuniqa,die-aldor,1800,priest,discipline,221,112,109
Некрогуро,gordunni,1800,priest,discipline,54,27,27
Lazyx,tarren-mill,1800,priest,discipline,59,29,30
Шэвэпэ,deathguard,1800,priest,discipline,69,32,37
Ilovebenji,antonidas,1800,priest,discipline,54,25,29
Dimsim,kazzak,1799,priest,discipline,60,34,26
Дефаенс,soulflayer,1798,priest,discipline,82,45,37
Susaj,tarren-mill,1798,priest,discipline,77,42,35
Debeo,ragnaros,1798,priest,discipline,169,91,78
Azymi,ravencrest,1798,priest,discipline,53,27,26
Skitspill,ravencrest,1798,priest,discipline,228,109,119
Фенджидисплх,blackscar,1798,priest,discipline,114,54,60
Kirtarah,aegwynn,1797,priest,discipline,244,126,118
Dokwhite,blackrock,1797,priest,discipline,41,20,21
Sùzy,ravencrest,1797,priest,discipline,72,30,42
Milderyp,kazzak,1796,priest,discipline,162,98,64
Reticlel,kazzak,1796,priest,discipline,206,118,88
Idisck,kazzak,1796,priest,discipline,241,129,112
Collinna,aegwynn,1796,priest,discipline,153,81,72
Lakeworth,argent-dawn,1796,priest,discipline,164,76,88
Siezlababo,blackrock,1795,priest,discipline,35,21,14
Bigballer,stormscale,1795,priest,discipline,51,26,25
Kevinsorbo,destromath,1795,priest,discipline,90,42,48
Kèvin,das-syndikat,1794,priest,discipline,130,77,53
Пристижнаяя,gordunni,1794,priest,discipline,116,65,51
Shuya,archimonde,1794,priest,discipline,64,34,30
Cdplz,archimonde,1794,priest,discipline,143,68,75
Йеэгер,soulflayer,1794,priest,discipline,171,74,97
Шэлиэл,soulflayer,1793,priest,discipline,131,71,60
Entenpanda,kazzak,1793,priest,discipline,138,72,66
Саммерфинн,gordunni,1793,priest,discipline,98,49,49
Lolylights,tarren-mill,1793,priest,discipline,270,131,139
Fainttnt,stormscale,1793,priest,discipline,102,49,53
Cnqz,archimonde,1793,priest,discipline,126,60,66
Неприст,ashenvale,1793,priest,discipline,66,31,35
Dumbasf,sporeggar,1792,priest,discipline,96,56,40
Abømination,hyjal,1792,priest,discipline,182,102,80
Cpzach,tarren-mill,1792,priest,discipline,312,163,149
Inhibitor,tarren-mill,1792,priest,discipline,125,65,60
Сайдвиндер,blackscar,1792,priest,discipline,115,59,56
Racecar,executus,1792,priest,discipline,144,71,73
Maxmoto,blackrock,1791,priest,discipline,104,61,43
Demora,ysondre,1791,priest,discipline,428,213,215
Discusting,anachronos,1790,priest,discipline,84,42,42
Pb,stormscale,1789,priest,discipline,209,109,100
Morgíon,azshara,1788,priest,discipline,71,51,20
Ðézø,twisting-nether,1787,priest,discipline,114,73,41
Dîàna,archimonde,1787,priest,discipline,59,35,24
Chnechnechne,outland,1787,priest,discipline,82,44,38
Elataqt,silvermoon,1786,priest,discipline,97,53,44
Altruistx,ravencrest,1786,priest,discipline,84,41,43
Stargal,blackmoore,1785,priest,discipline,48,31,17
Iwariel,blackmoore,1785,priest,discipline,138,72,66
Dès,ravencrest,1785,priest,discipline,182,90,92
Svakkanxd,kazzak,1785,priest,discipline,147,68,79
Drillin,ravencrest,1785,priest,discipline,135,59,76
Milchzáhn,frostwolf,1784,priest,discipline,265,134,131
Sdn,twisting-nether,1784,priest,discipline,286,143,143
Øk,draenor,1783,priest,discipline,143,81,62
Iòól,veknilash,1783,priest,discipline,89,41,48
Wérrýxs,kazzak,1782,priest,discipline,184,105,79
Minipõppy,ravencrest,1782,priest,discipline,262,136,126
Slovak,stormscale,1782,priest,discipline,54,26,28
Wodpriest,ravencrest,1781,priest,discipline,106,59,47
Mqsx,stormscale,1781,priest,discipline,48,23,25
Swallowship,twisting-nether,1781,priest,discipline,60,28,32
Втильте,blackscar,1780,priest,discipline,191,101,90
Maikzky,stormreaver,1780,priest,discipline,36,19,17
Blâdéira,ravencrest,1780,priest,discipline,540,269,271
Drlovke,stormscale,1780,priest,discipline,207,98,109
Bonzu,ravencrest,1780,priest,discipline,78,34,44
Drillinx,tarren-mill,1779,priest,discipline,113,54,59
Keypo,khaz-modan,1779,priest,discipline,125,58,67
Bubblebuddy,draenor,1779,priest,discipline,84,30,54
Leahuwu,ravencrest,1778,priest,discipline,132,65,67
Kirà,nemesis,1778,priest,discipline,83,40,43
Ihefyehvjrm,ravencrest,1778,priest,discipline,137,66,71
Whýççpèrx,ravencrest,1778,priest,discipline,88,42,46
Lasêr,kazzak,1777,priest,discipline,183,95,88
Ilovepmr,outland,1777,priest,discipline,44,21,23
Refrenn,kazzak,1776,priest,discipline,138,75,63
Апититька,soulflayer,1776,priest,discipline,359,192,167
Ballepresten,outland,1776,priest,discipline,54,27,27
Zêxy,stormscale,1776,priest,discipline,155,77,78
Rafaled,ravencrest,1776,priest,discipline,48,23,25
Gødsfåvørite,blackrock,1775,priest,discipline,327,168,159
Mndvx,sylvanas,1775,priest,discipline,140,70,70
Prsx,ravencrest,1775,priest,discipline,132,65,67
Lifebygunzz,archimonde,1775,priest,discipline,42,20,22
Migaz,runetotem,1774,priest,discipline,239,139,100
Nadoreille,hyjal,1774,priest,discipline,516,266,250
Gød,magtheridon,1774,priest,discipline,341,172,169
Vespbruv,kazzak,1773,priest,discipline,36,25,11
Jempi,argent-dawn,1773,priest,discipline,177,103,74
Lyllirock,varimathras,1773,priest,discipline,54,27,27
Jpucciù,ysondre,1773,priest,discipline,78,36,42
Cestrial,sylvanas,1772,priest,discipline,227,121,106
Djplay,aegwynn,1772,priest,discipline,66,31,35
Tmnetwo,ravencrest,1772,priest,discipline,76,35,41
Эмжи,howling-fjord,1771,priest,discipline,66,37,29
Ohiofromntty,ravencrest,1770,priest,discipline,30,23,7
Yllaenia,twisting-nether,1770,priest,discipline,50,29,21
Obito,outland,1770,priest,discipline,53,26,27
Mcdodgens,auchindoun,1770,priest,discipline,257,123,134
Sørcedote,dun-modr,1770,priest,discipline,72,30,42
Holyblóod,kazzak,1769,priest,discipline,110,62,48
Леддигага,gordunni,1769,priest,discipline,48,27,21
Qhub,sylvanas,1769,priest,discipline,249,132,117
Hopesallgone,stormscale,1768,priest,discipline,140,80,60
Ðàx,stormscale,1768,priest,discipline,58,26,32
Teatime,aegwynn,1767,priest,discipline,45,26,19
Cctw,archimonde,1767,priest,discipline,328,167,161
Jaytï,ravencrest,1766,priest,discipline,42,26,16
Øxx,blackrock,1766,priest,discipline,92,51,41
Sheeash,kazzak,1766,priest,discipline,126,65,61
Xianstwo,alakir,1766,priest,discipline,78,36,42
Trickyteè,tarren-mill,1766,priest,discipline,60,25,35
Kovexpulthul,sunstrider,1765,priest,discipline,47,34,13
Sosûke,archimonde,1765,priest,discipline,66,38,28
Kuusistöö,kazzak,1765,priest,discipline,182,92,90
Grouptherpst,draenor,1765,priest,discipline,594,293,301
Justdänce,hyjal,1763,priest,discipline,79,38,41
Nameit,eredar,1763,priest,discipline,194,91,103
Tattum,ragnaros,1762,priest,discipline,102,65,37
Miyà,sylvanas,1762,priest,discipline,66,38,28
Tyreha,ravencrest,1762,priest,discipline,135,74,61
Cätälin,twisting-nether,1762,priest,discipline,452,226,226
Wiguwigu,blackrock,1762,priest,discipline,114,51,63
Needskîll,drakthul,1762,priest,discipline,84,37,47
Gajos,frostwolf,1761,priest,discipline,179,99,80
Bizqit,tarren-mill,1761,priest,discipline,647,335,312
Destinychild,norgannon,1761,priest,discipline,94,48,46
Ladderpolice,blackmoore,1761,priest,discipline,54,26,28
Opprist,ragnaros,1761,priest,discipline,84,36,48
Gailiugà,kazzak,1760,priest,discipline,52,33,19
Alicanx,silvermoon,1760,priest,discipline,135,80,55
Manäka,hyjal,1760,priest,discipline,42,22,20
Utrd,kazzak,1760,priest,discipline,388,189,199
Loarderonx,stormscale,1760,priest,discipline,59,28,31
Imnoukee,blackrock,1760,priest,discipline,42,19,23
Старлайтх,gordunni,1759,priest,discipline,59,34,25
Jallahrud,stormscale,1759,priest,discipline,87,50,37
Sonics,antonidas,1759,priest,discipline,216,120,96
Legiondisc,blackmoore,1758,priest,discipline,157,71,86
Rmpriest,blackhand,1757,priest,discipline,54,23,31
Swdommeil,blackrock,1756,priest,discipline,48,27,21
Eliriya,thrall,1756,priest,discipline,338,169,169
Декорий,soulflayer,1756,priest,discipline,78,36,42
Holó,stormscale,1756,priest,discipline,120,52,68
Abusalt,stormscale,1756,priest,discipline,84,36,48
Bursthilda,blackmoore,1755,priest,discipline,215,120,95
Capslk,ravencrest,1755,priest,discipline,54,27,27
Roshmanoff,stormscale,1755,priest,discipline,54,27,27
Ytsal,stormscale,1755,priest,discipline,102,46,56
Flaynbones,tarren-mill,1754,priest,discipline,47,28,19
Pureàngel,ravencrest,1754,priest,discipline,53,26,27
Syntaria,pozzo-delleternità,1753,priest,discipline,60,33,27
Yroe,gorgonnash,1753,priest,discipline,54,26,28
Khristo,illidan,1753,priest,discipline,84,36,48
Luxør,blackrock,1752,priest,discipline,54,22,32
Merylle,outland,1751,priest,discipline,41,27,14
Nätrix,tarren-mill,1751,priest,discipline,42,26,16
Devotedape,draenor,1751,priest,discipline,101,57,44
Sekker,silvermoon,1751,priest,discipline,321,171,150
Brutapriestx,stormscale,1751,priest,discipline,53,23,30
Ödriaell,the-venture-co,1750,priest,discipline,228,117,111
Kîlo,sylvanas,1750,priest,discipline,42,19,23
Isuckmattsd,aggramar,1749,priest,discipline,30,21,9
Фотосз,soulflayer,1749,priest,discipline,47,28,19
Enzineum,twisting-nether,1749,priest,discipline,84,39,45
Goldensp,sanguino,1748,priest,discipline,117,60,57
Amtoxic,stormscale,1748,priest,discipline,503,256,247
Аскеронх,howling-fjord,1748,priest,discipline,99,48,51
Pikaboom,the-maelstrom,1747,priest,discipline,48,27,21
Hoses,twisting-nether,1747,priest,discipline,248,124,124
Elvibeast,twisting-nether,1747,priest,discipline,54,27,27
Дъикиймвп,deepholm,1747,priest,discipline,48,24,24
Heavensfire,twisting-nether,1747,priest,discipline,53,25,28
Shdwxy,blackrock,1746,priest,discipline,147,81,66
Krolox,blackhand,1746,priest,discipline,252,125,127
Lucksy,antonidas,1746,priest,discipline,72,34,38
Aphroditê,blackrock,1745,priest,discipline,88,49,39
Candrä,archimonde,1745,priest,discipline,47,22,25
Шайтсунг,soulflayer,1744,priest,discipline,86,48,38
Rippertmepls,ravencrest,1744,priest,discipline,101,52,49
Lorimac,dun-modr,1744,priest,discipline,231,118,113
Preme,blackhand,1744,priest,discipline,84,41,43
Zeröone,silvermoon,1743,priest,discipline,227,110,117
Zéntius,twisting-nether,1743,priest,discipline,53,25,28
Tabaç,stormscale,1742,priest,discipline,56,33,23
Kaizza,burning-legion,1742,priest,discipline,83,43,40
Nitroze,stormscale,1742,priest,discipline,94,47,47
Cvp,twisting-nether,1742,priest,discipline,90,37,53
Sloee,kazzak,1741,priest,discipline,48,28,20
Areyqt,ravencrest,1741,priest,discipline,60,34,26
Hodscha,aegwynn,1740,priest,discipline,237,112,125
Emopunkgodx,draenor,1739,priest,discipline,190,115,75
Xeldrania,azshara,1739,priest,discipline,41,22,19
Nancey,draenor,1739,priest,discipline,60,29,31
Trixtrex,aegwynn,1739,priest,discipline,84,39,45
Свдпрох,soulflayer,1739,priest,discipline,95,44,51
Pinipom,kazzak,1738,priest,discipline,93,54,39
Frëija,ravencrest,1738,priest,discipline,95,52,43
Lyrina,twisting-nether,1738,priest,discipline,364,199,165
Waffur,twisting-nether,1738,priest,discipline,119,63,56
Kuraimb,the-maelstrom,1738,priest,discipline,117,58,59
Goldeagle,archimonde,1738,priest,discipline,72,34,38
Verweven,twisting-nether,1737,priest,discipline,101,56,45
Skyfish,archimonde,1737,priest,discipline,62,32,30
Вашачесть,gordunni,1737,priest,discipline,231,118,113
Rqx,stormscale,1736,priest,discipline,35,23,12
Holyholy,stormscale,1736,priest,discipline,66,41,25
Traxtoor,tarren-mill,1736,priest,discipline,389,206,183
Lauriinda,culte-de-la-rive-noire,1736,priest,discipline,365,191,174
Андерприст,soulflayer,1736,priest,discipline,198,100,98
Bride,burning-legion,1735,priest,discipline,66,38,28
Judgementdaý,kazzak,1735,priest,discipline,47,27,20
Gepeitschter,frostwolf,1735,priest,discipline,462,241,221
Aruna,ravencrest,1735,priest,discipline,120,60,60
Sydnex,blackmoore,1734,priest,discipline,77,45,32
Leffie,outland,1734,priest,discipline,102,49,53
Lasyran,outland,1734,priest,discipline,59,25,34
Goodra,sylvanas,1733,priest,discipline,42,28,14
Yö,stormscale,1733,priest,discipline,36,21,15
Blazingad,kazzak,1733,priest,discipline,283,143,140
Enteja,outland,1733,priest,discipline,1287,645,642
Aetas,hyjal,1732,priest,discipline,72,41,31
Shieldyman,silvermoon,1732,priest,discipline,54,27,27
Holymoly,talnivarr,1732,priest,discipline,234,114,120
Skaliq,tarren-mill,1731,priest,discipline,390,209,181
Lavendertown,tarren-mill,1731,priest,discipline,192,101,91
Карпинчо,soulflayer,1731,priest,discipline,438,212,226
Teradros,blackhand,1731,priest,discipline,71,33,38
Dankopriest,drakthul,1730,priest,discipline,149,91,58
Tÿona,hyjal,1730,priest,discipline,182,104,78
Zthul,draenor,1730,priest,discipline,98,56,42
Tallyby,blackmoore,1730,priest,discipline,58,33,25
Remlos,der-rat-von-dalaran,1730,priest,discipline,196,105,91
Pflanzenmann,nozdormu,1730,priest,discipline,137,73,64
Wasnezov,blackhand,1730,priest,discipline,108,55,53
Mafakor,ravencrest,1730,priest,discipline,651,321,330
Sîena,ravencrest,1729,priest,discipline,135,73,62
Lexojam,ravencrest,1729,priest,discipline,41,21,20
Waaqa,outland,1729,priest,discipline,182,89,93
Stahpit,twisting-nether,1729,priest,discipline,83,37,46
Nyù,kazzak,1728,priest,discipline,203,115,88
Obnoxious,sunstrider,1728,priest,discipline,202,101,101
Veethene,kazzak,1728,priest,discipline,242,118,124
Midzoado,ragnaros,1728,priest,discipline,111,52,59
Mamabeer,draenor,1727,priest,discipline,150,91,59
Sausageboy,tarren-mill,1727,priest,discipline,90,47,43
Deliriumxd,ravencrest,1727,priest,discipline,68,33,35
Bunnydisc,outland,1727,priest,discipline,116,55,61
Kaldhor,ysondre,1726,priest,discipline,119,54,65
Kirobreika,twisting-nether,1725,priest,discipline,36,25,11
Savagex,dun-modr,1725,priest,discipline,256,136,120
Aenon,argent-dawn,1725,priest,discipline,141,74,67
Felvytwo,stormscale,1725,priest,discipline,48,24,24
Bandulskii,twisting-nether,1725,priest,discipline,487,240,247
Eladri,silvermoon,1724,priest,discipline,30,19,11
Yadif,tarren-mill,1724,priest,discipline,42,24,18
Qpapi,quelthalas,1724,priest,discipline,48,24,24
Ellinha,tarren-mill,1724,priest,discipline,124,59,65
Nazhara,hyjal,1724,priest,discipline,78,37,41
Lucìanà,blackmoore,1723,priest,discipline,30,18,12
Anabølixx,ravencrest,1722,priest,discipline,60,37,23
Ynys,dentarg,1722,priest,discipline,48,27,21
Angemir,nemesis,1722,priest,discipline,133,71,62
Denunciation,argent-dawn,1722,priest,discipline,239,125,114
Plsdontcry,blackrock,1722,priest,discipline,54,27,27
Galpriest,tarren-mill,1722,priest,discipline,68,32,36
Chrïskz,archimonde,1722,priest,discipline,84,35,49
Splf,blackrock,1721,priest,discipline,96,60,36
Irefutåbil,stormscale,1721,priest,discipline,162,91,71
Skevitche,hyjal,1721,priest,discipline,208,108,100
Øbz,sylvanas,1721,priest,discipline,124,62,62
Ависи,soulflayer,1721,priest,discipline,36,18,18
Chaxxpriest,blackrock,1721,priest,discipline,161,73,88
Tori,marécage-de-zangar,1720,priest,discipline,56,35,21
Gwinzy,blackmoore,1720,priest,discipline,36,22,14
Holydreed,ragnaros,1720,priest,discipline,221,123,98
Waina,defias-brotherhood,1720,priest,discipline,670,348,322
Folelli,ysondre,1720,priest,discipline,113,58,55
Cáss,archimonde,1720,priest,discipline,36,18,18
Bengtas,ravencrest,1720,priest,discipline,304,150,154
Жентельмен,deathguard,1720,priest,discipline,135,62,73
Taslight,stormscale,1719,priest,discipline,299,165,134
Chîllipriest,draenor,1719,priest,discipline,139,74,65
Lesse,ravencrest,1719,priest,discipline,72,38,34
Scurrp,aegwynn,1719,priest,discipline,96,50,46
Abudhabi,blackhand,1719,priest,discipline,489,248,241
Schwypsvnr,garona,1719,priest,discipline,42,21,21
Haveboorst,twisting-nether,1719,priest,discipline,42,21,21
Ninxy,sylvanas,1719,priest,discipline,126,60,66
Swiftdemise,sylvanas,1719,priest,discipline,250,116,134
Tsipaz,outland,1719,priest,discipline,71,30,41
Trashpriest,blackrock,1719,priest,discipline,65,27,38
Magetrainer,tarren-mill,1718,priest,discipline,78,50,28
Unstopp,blackhand,1718,priest,discipline,41,25,16
Danina,outland,1718,priest,discipline,87,52,35
Jarvinia,blackmoore,1718,priest,discipline,187,93,94
Awcute,kazzak,1718,priest,discipline,521,258,263
Jämar,archimonde,1718,priest,discipline,89,44,45
Yungblessing,stormscale,1718,priest,discipline,77,38,39
Déàthtuna,kazzak,1718,priest,discipline,96,46,50
Baptized,baelgun,1718,priest,discipline,150,71,79
Разрухаовнз,gordunni,1717,priest,discipline,42,24,18
Seemedotin,aegwynn,1717,priest,discipline,65,37,28
Уровеньб,soulflayer,1717,priest,discipline,208,106,102
Найтингеилл,gordunni,1717,priest,discipline,48,24,24
Brutalmaze,archimonde,1717,priest,discipline,42,21,21
Awön,stormscale,1717,priest,discipline,106,51,55
Tsumu,archimonde,1716,priest,discipline,69,40,29
Windywendy,blackrock,1716,priest,discipline,147,79,68
Йуп,ashenvale,1716,priest,discipline,94,48,46
Parzivál,argent-dawn,1716,priest,discipline,265,134,131
Smiteyoudown,blackrock,1716,priest,discipline,42,21,21
Бонзайка,blackscar,1716,priest,discipline,100,49,51
Tridus,eitrigg,1715,priest,discipline,30,19,11
Verjin,kazzak,1715,priest,discipline,138,61,77
Flipflops,kirin-tor,1714,priest,discipline,42,25,17
Fåye,ravencrest,1714,priest,discipline,82,43,39
Naphell,outland,1714,priest,discipline,235,120,115
Zoe,aegwynn,1713,priest,discipline,270,149,121
Títarie,aegwynn,1713,priest,discipline,48,26,22
Ascendedpwnz,silvermoon,1713,priest,discipline,167,86,81
Хербоб,howling-fjord,1713,priest,discipline,339,174,165
Watchmedark,ravencrest,1713,priest,discipline,48,24,24
Mpßx,tarren-mill,1713,priest,discipline,93,45,48
Hadis,tarren-mill,1713,priest,discipline,174,83,91
Lótus,outland,1713,priest,discipline,134,63,71
Céira,malganis,1712,priest,discipline,102,54,48
Sinnestrike,tarren-mill,1712,priest,discipline,64,33,31
Mommymilkrx,argent-dawn,1712,priest,discipline,883,440,443
Gòldfinger,norgannon,1712,priest,discipline,210,101,109
Keryin,draenor,1712,priest,discipline,285,135,150
Søb,silvermoon,1712,priest,discipline,47,20,27
Джастха,soulflayer,1711,priest,discipline,30,18,12
Premierex,stormscale,1711,priest,discipline,66,38,28
Mautijr,blackrock,1711,priest,discipline,343,186,157
Decimerad,kazzak,1711,priest,discipline,42,22,20
Scaryolol,blackmoore,1711,priest,discipline,191,94,97
Aelíth,archimonde,1711,priest,discipline,120,58,62
Priestqt,kelthuzad,1710,priest,discipline,99,58,41
Ðarkan,kaelthas,1710,priest,discipline,162,92,70
Ðeep,archimonde,1710,priest,discipline,72,35,37
Yro,gorgonnash,1710,priest,discipline,119,57,62
Cosmicfaith,kazzak,1709,priest,discipline,40,28,12
Lowhealing,kazzak,1709,priest,discipline,78,45,33
Drë,daggerspine,1709,priest,discipline,159,82,77
Dorkama,silvermoon,1709,priest,discipline,89,44,45
Нз,soulflayer,1709,priest,discipline,77,37,40
Gurgaue,argent-dawn,1709,priest,discipline,140,67,73
Dimsan,aegwynn,1709,priest,discipline,121,51,70
Assacine,aegwynn,1708,priest,discipline,146,77,69
Såra,ravencrest,1708,priest,discipline,260,132,128
Ptrspriest,twisting-nether,1708,priest,discipline,364,184,180
Kàalyx,archimonde,1708,priest,discipline,174,85,89
Obie,exodar,1707,priest,discipline,46,19,27
Nyxoqtxd,ravencrest,1706,priest,discipline,100,57,43
Alexuwu,kazzak,1705,priest,discipline,24,18,6
Baksa,das-konsortium,1705,priest,discipline,78,48,30
Leåh,ravencrest,1705,priest,discipline,108,58,50
Kæzm,blackrock,1705,priest,discipline,131,70,61
Wraithtrippz,stormscale,1705,priest,discipline,320,164,156
Brilho,frostmane,1705,priest,discipline,636,318,318
Hurtless,ravencrest,1705,priest,discipline,71,34,37
Dqt,ragnaros,1705,priest,discipline,83,37,46
Yukasa,silvermoon,1705,priest,discipline,78,34,44
Ruñaa,argent-dawn,1705,priest,discipline,144,62,82
Smitelay,alleria,1704,priest,discipline,42,27,15
Drée,hyjal,1704,priest,discipline,54,28,26
Gladíator,blackhand,1703,priest,discipline,48,30,18
Rivíía,drakthul,1703,priest,discipline,112,63,49
Файкахохо,soulflayer,1703,priest,discipline,109,49,60
Aureliones,drakthul,1702,priest,discipline,84,55,29
Gladiav,hyjal,1702,priest,discipline,72,39,33
Kaksel,blackrock,1702,priest,discipline,132,69,63
Pshan,blackmoore,1702,priest,discipline,340,177,163
Virdeo,aegwynn,1702,priest,discipline,66,34,32
Healêl,sanguino,1702,priest,discipline,87,41,46
Прристуха,gordunni,1702,priest,discipline,132,58,74
Lmnsqzy,ravencrest,1701,priest,discipline,36,24,12
Xulgarath,silvermoon,1701,priest,discipline,95,58,37
Darkshdwbrst,malorne,1701,priest,discipline,295,159,136
Ruckusxz,ravencrest,1701,priest,discipline,53,28,25
Xaey,ravencrest,1701,priest,discipline,293,152,141
Monataamis,kazzak,1701,priest,discipline,82,37,45
Noxr,ravencrest,1701,priest,discipline,68,28,40
Yânùx,aegwynn,1700,priest,discipline,36,24,12
Kapts,twisting-nether,1700,priest,discipline,30,18,12
Healbotmvp,ravencrest,1700,priest,discipline,42,24,18
Saniss,tarren-mill,1700,priest,discipline,90,48,42
Myggsparv,stormscale,1700,priest,discipline,125,60,65
Ampara,thrall,1699,priest,discipline,120,59,61
Presspainsup,tarren-mill,1699,priest,discipline,66,26,40
Holycrapx,chromaggus,1698,priest,discipline,237,127,110
Neftul,blackrock,1698,priest,discipline,54,26,28
Закс,blackscar,1698,priest,discipline,48,22,26
Kevokko,silvermoon,1698,priest,discipline,60,25,35
Twirlylocks,emerald-dream,1698,priest,discipline,59,21,38
Painxd,stormscale,1697,priest,discipline,93,54,39
Fkitweball,argent-dawn,1697,priest,discipline,36,20,16
Plåtpriest,twisting-nether,1697,priest,discipline,348,185,163
Jumby,outland,1697,priest,discipline,46,24,22
Justys,twisting-nether,1697,priest,discipline,72,37,35
Deathblind,blackmoore,1697,priest,discipline,42,21,21
Neverlandx,bladefist,1696,priest,discipline,100,57,43
Kahir,ravencrest,1696,priest,discipline,98,52,46
Mitas,ravencrest,1696,priest,discipline,59,29,30
Sikola,ragnaros,1696,priest,discipline,90,40,50
Cptisus,draenor,1696,priest,discipline,72,31,41
Mixoo,throkferoth,1696,priest,discipline,95,40,55
Sickboy,nordrassil,1695,priest,discipline,121,66,55
Оналкин,gordunni,1695,priest,discipline,54,28,26
Fizzy,arthas,1695,priest,discipline,82,42,40
Swdommeil,aegwynn,1695,priest,discipline,48,24,24
Kenobai,kazzak,1695,priest,discipline,89,41,48
Эвэргарден,eversong,1695,priest,discipline,108,45,63
Jumpaxx,archimonde,1695,priest,discipline,53,20,33
Glyss,draenor,1694,priest,discipline,97,53,44
Gehrketwo,silvermoon,1694,priest,discipline,48,26,22
Tassivemits,sylvanas,1694,priest,discipline,60,28,32
Angrypiex,stormscale,1694,priest,discipline,83,38,45
Theblank,pozzo-delleternità,1694,priest,discipline,42,18,24
Fiskpung,draenor,1693,priest,discipline,72,49,23
Arlekin,ravencrest,1693,priest,discipline,114,70,44
Sponpriest,ravencrest,1693,priest,discipline,271,156,115
Dreifearfünf,arygos,1693,priest,discipline,114,63,51
Deki,outland,1693,priest,discipline,120,66,54
Missright,ragnaros,1693,priest,discipline,36,18,18
Rixfoulah,ysondre,1693,priest,discipline,36,18,18
Saturno,chogall,1693,priest,discipline,90,44,46
Awien,kazzak,1693,priest,discipline,111,47,64
Diszis,blackhand,1692,priest,discipline,78,43,35
Kavrack,dalaran,1692,priest,discipline,41,22,19
Naomirussell,sylvanas,1692,priest,discipline,66,34,32
Scaryblapel,ravencrest,1692,priest,discipline,607,309,298
Pierrebourne,blackmoore,1692,priest,discipline,48,23,25
Valnor,pozzo-delleternità,1691,priest,discipline,152,81,71
Coqa,blackrock,1691,priest,discipline,72,37,35
Owrly,bladefist,1691,priest,discipline,196,94,102
ßøunty,dun-modr,1691,priest,discipline,48,23,25
Nidetha,draenor,1691,priest,discipline,42,18,24
Hannirï,archimonde,1690,priest,discipline,112,72,40
Dealtime,ysondre,1690,priest,discipline,49,27,22
Nàlak,archimonde,1690,priest,discipline,116,51,65
Klugzy,silvermoon,1690,priest,discipline,167,72,95
Eitukaeitai,outland,1690,priest,discipline,66,27,39
Djleffe,stormscale,1689,priest,discipline,45,27,18
Шестьнадцать,gordunni,1689,priest,discipline,107,60,47
Аая,blackscar,1689,priest,discipline,144,76,68
Yörüichi,kazzak,1689,priest,discipline,42,22,20
Zèl,blackmoore,1689,priest,discipline,61,29,32
Pixe,argent-dawn,1689,priest,discipline,66,27,39
Pouffi,garona,1688,priest,discipline,36,21,15
Alesthion,silvermoon,1688,priest,discipline,194,106,88
Дцевгений,gordunni,1688,priest,discipline,54,25,29
Tryhàrdx,stormscale,1688,priest,discipline,66,30,36
Wonderdispel,ragnaros,1688,priest,discipline,95,41,54
Sjhzzkl,blackrock,1687,priest,discipline,342,183,159
Voidbone,stormscale,1687,priest,discipline,42,22,20
Purplex,aggra-português,1687,priest,discipline,81,42,39
Rickerstrike,stormscale,1687,priest,discipline,161,79,82
Berseenreikä,the-venture-co,1687,priest,discipline,60,29,31
Шаастраха,gordunni,1687,priest,discipline,121,56,65
Suxino,stormscale,1686,priest,discipline,316,178,138
Dispelgodxx,eredar,1686,priest,discipline,60,27,33
Fractu,tarren-mill,1686,priest,discipline,94,42,52
Pstech,ravencrest,1685,priest,discipline,69,38,31
Dállas,ravencrest,1685,priest,discipline,92,50,42
Yugemilkers,kazzak,1685,priest,discipline,233,119,114
Ew,shattered-halls,1685,priest,discipline,70,33,37
Zelyxoxo,blackrock,1685,priest,discipline,60,27,33
Neliica,silvermoon,1684,priest,discipline,138,59,79
Zzbleh,stormscale,1683,priest,discipline,96,53,43
Pieceoftrash,stormscale,1683,priest,discipline,191,97,94
Barackomana,blackrock,1683,priest,discipline,120,56,64
Ârth,kirin-tor,1683,priest,discipline,48,22,26
Yassjr,archimonde,1682,priest,discipline,62,35,27
Kleot,ragnaros,1682,priest,discipline,844,428,416
Shììnx,hyjal,1682,priest,discipline,48,24,24
Papoopepoo,sanguino,1682,priest,discipline,132,64,68
Prc,stormscale,1681,priest,discipline,60,41,19
Belkanf,draenor,1681,priest,discipline,48,30,18
Iyannà,blackrock,1681,priest,discipline,83,49,34
Jeanshield,varimathras,1681,priest,discipline,226,112,114
Kaleycuoco,blackrock,1681,priest,discipline,114,55,59
Рнкх,lich-king,1681,priest,discipline,58,27,31
Mojoo,aggramar,1681,priest,discipline,48,22,26
Nuriva,frostmane,1681,priest,discipline,66,25,41
Deathgodx,archimonde,1680,priest,discipline,154,85,69
Артжрец,soulflayer,1680,priest,discipline,82,45,37
Westfalen,tichondrius,1680,priest,discipline,85,45,40
Zingeling,ravencrest,1680,priest,discipline,60,31,29
Соникида,gordunni,1680,priest,discipline,130,61,69
Aestina,silvermoon,1679,priest,discipline,299,155,144
Beabanane,aegwynn,1679,priest,discipline,233,120,113
Eliverax,outland,1679,priest,discipline,134,66,68
Fancytrash,ravencrest,1679,priest,discipline,169,83,86
ßrûm,archimonde,1679,priest,discipline,48,23,25
Анклфрост,gordunni,1679,priest,discipline,72,34,38
Jetlw,ravencrest,1678,priest,discipline,234,133,101
Eolîn,draenor,1678,priest,discipline,96,46,50
Randmbare,nemesis,1677,priest,discipline,42,23,19
Csúforck,ragnaros,1677,priest,discipline,122,63,59
Bibilamuerte,archimonde,1677,priest,discipline,36,18,18
Iløvelena,ravencrest,1676,priest,discipline,98,55,43
Clownspec,twisting-nether,1676,priest,discipline,54,26,28
Flurri,tarren-mill,1675,priest,discipline,195,111,84
Senkín,aegwynn,1675,priest,discipline,255,138,117
Iirina,draenor,1675,priest,discipline,42,22,20
Pentøs,archimonde,1675,priest,discipline,42,21,21
Hôt,archimonde,1675,priest,discipline,47,23,24
Apuessii,dun-modr,1675,priest,discipline,83,36,47
Nyxém,blackmoore,1674,priest,discipline,72,36,36
Meltmvp,thrall,1674,priest,discipline,66,33,33
Zýgzäg,hyjal,1674,priest,discipline,226,111,115
Geforcès,archimonde,1674,priest,discipline,113,45,68
Ticklypriest,outland,1673,priest,discipline,64,39,25
Forcedtoheal,sylvanas,1673,priest,discipline,85,51,34
Insânity,kazzak,1673,priest,discipline,36,20,16
Шэдоура,gordunni,1673,priest,discipline,327,169,158
Dreythan,alakir,1673,priest,discipline,96,48,48
Aviex,twisting-nether,1673,priest,discipline,84,38,46
Splís,ravencrest,1673,priest,discipline,75,30,45
Alyzzé,blackhand,1672,priest,discipline,42,26,16
Babadriver,kazzak,1672,priest,discipline,71,43,28
Onaltnoqs,silvermoon,1672,priest,discipline,76,39,37
Flygar,outland,1672,priest,discipline,120,61,59
Jasty,nemesis,1672,priest,discipline,59,23,36
Bawsy,blackrock,1671,priest,discipline,226,134,92
Byef,kazzak,1671,priest,discipline,56,31,25
Rankoneprazt,stormscale,1671,priest,discipline,251,127,124
Owpex,outland,1670,priest,discipline,36,22,14
Qtdorr,ravencrest,1670,priest,discipline,178,103,75
Dêrbómbêr,guldan,1670,priest,discipline,96,54,42
Babybelle,arakarahm,1670,priest,discipline,88,49,39
Санггвиний,soulflayer,1670,priest,discipline,258,138,120
Swoptoplong,blackhand,1670,priest,discipline,503,263,240
Pepeflex,draenor,1670,priest,discipline,257,128,129
Xzep,archimonde,1670,priest,discipline,482,239,243
Сосиска,deathguard,1670,priest,discipline,41,20,21
Wikpriest,ravencrest,1670,priest,discipline,88,41,47
Apeminister,nemesis,1670,priest,discipline,42,19,23
Euthenia,twilights-hammer,1669,priest,discipline,48,27,21
Tmnewho,outland,1669,priest,discipline,130,70,60
Ridskeyx,archimonde,1669,priest,discipline,66,34,32
Littlehelper,shendralar,1669,priest,discipline,81,41,40
Mcdeady,tarren-mill,1669,priest,discipline,86,41,45
Namîxoxo,ysondre,1669,priest,discipline,106,49,57
Mástermínd,kazzak,1668,priest,discipline,99,64,35
Corrâ,aegwynn,1668,priest,discipline,42,24,18
Шмэтар,gordunni,1668,priest,discipline,96,53,43
Skycity,silvermoon,1668,priest,discipline,69,35,34
Bilbobanging,aggramar,1668,priest,discipline,60,30,30
Машура,grom,1668,priest,discipline,48,22,26
Devastris,ravencrest,1668,priest,discipline,102,43,59
Jesslol,archimonde,1667,priest,discipline,40,23,17
Calling,nozdormu,1667,priest,discipline,125,66,59
Kygodisc,ravencrest,1667,priest,discipline,219,114,105
Ronlimonkek,dun-modr,1667,priest,discipline,246,123,123
Daskemaskinx,the-maelstrom,1667,priest,discipline,42,20,22
Aòo,twisting-nether,1667,priest,discipline,103,49,54
Romei,tarren-mill,1667,priest,discipline,42,18,24
Velyrium,tarren-mill,1666,priest,discipline,30,22,8
Tygstycke,tarren-mill,1666,priest,discipline,50,30,20
Vregoa,twisting-nether,1666,priest,discipline,113,63,50
Solaçe,antonidas,1666,priest,discipline,120,64,56
Thanatae,kazzak,1666,priest,discipline,54,26,28
Touchmypink,ragnaros,1666,priest,discipline,519,248,271
Doorix,nethersturm,1666,priest,discipline,80,36,44
Matmonp,hyjal,1666,priest,discipline,59,25,34
Fortítude,draenor,1665,priest,discipline,30,20,10
Trntypr,senjin,1665,priest,discipline,84,48,36
Mentaldeadp,draenor,1665,priest,discipline,183,103,80
Зетш,soulflayer,1665,priest,discipline,41,22,19
Возрождающее,soulflayer,1665,priest,discipline,481,248,233
Isuckpriest,aegwynn,1665,priest,discipline,162,83,79
Pehmoinen,korgall,1665,priest,discipline,201,99,102
Jezaja,sylvanas,1665,priest,discipline,84,37,47
Frígídhealz,outland,1665,priest,discipline,48,20,28
Yeatsnu,blackmoore,1664,priest,discipline,29,19,10
Kintsugí,ragnaros,1664,priest,discipline,60,39,21
Deadthicc,hyjal,1664,priest,discipline,104,67,37
Дардж,blackscar,1664,priest,discipline,102,54,48
Anotu,tarren-mill,1664,priest,discipline,102,53,49
Botstyleswdx,ravencrest,1664,priest,discipline,312,153,159
Märlborö,aggra-português,1664,priest,discipline,197,94,103
Kolinamenuss,dun-morogh,1664,priest,discipline,90,40,50
Alessana,antonidas,1663,priest,discipline,53,31,22
Fricia,zuljin,1663,priest,discipline,100,57,43
Luckystar,grim-batol,1663,priest,discipline,153,78,75
Афганский,gordunni,1663,priest,discipline,88,44,44
Nimb,blackrock,1663,priest,discipline,78,37,41
Elsieexø,ravencrest,1663,priest,discipline,102,47,55
Alahkazam,alakir,1663,priest,discipline,56,24,32
Burnesenbois,chogall,1663,priest,discipline,101,41,60
Icepoint,aggra-português,1663,priest,discipline,48,18,30
Quïzzler,ragnaros,1662,priest,discipline,77,40,37
Cizer,kazzak,1662,priest,discipline,182,92,90
Enzysama,sanguino,1662,priest,discipline,97,49,48
Ислейн,howling-fjord,1662,priest,discipline,59,24,35
Лилтёрти,soulflayer,1661,priest,discipline,52,31,21
Kijhun,uldaman,1661,priest,discipline,90,47,43
Thiela,ravencrest,1661,priest,discipline,94,48,46
Tinypump,silvermoon,1661,priest,discipline,47,24,23
Сонясоукьют,gordunni,1661,priest,discipline,60,28,32
Cnqx,archimonde,1661,priest,discipline,54,23,31
Indîcâ,outland,1661,priest,discipline,150,61,89
Неох,gordunni,1660,priest,discipline,58,32,26
Jesper,outland,1660,priest,discipline,34,18,16
Фокусшвд,soulflayer,1660,priest,discipline,180,90,90
Alicewhydel,blackhand,1660,priest,discipline,52,25,27
Ahun,taerar,1660,priest,discipline,54,25,29
Stórmén,kazzak,1660,priest,discipline,52,19,33
Galadríel,malganis,1659,priest,discipline,71,43,28
Boogereater,kazzak,1659,priest,discipline,30,18,12
Ripperdepip,magtheridon,1659,priest,discipline,510,272,238
Faintly,emeriss,1659,priest,discipline,66,33,33
Shaneya,silvermoon,1659,priest,discipline,70,33,37
Lilypalmer,stormscale,1659,priest,discipline,102,48,54
Sills,twisting-nether,1659,priest,discipline,82,38,44
Freezeage,stormscale,1658,priest,discipline,60,36,24
Babydark,ravencrest,1658,priest,discipline,32,19,13
Touddixz,blackrock,1658,priest,discipline,59,35,24
Finalprayer,silvermoon,1658,priest,discipline,149,87,62
Изилол,soulflayer,1658,priest,discipline,88,51,37
Valfore,eldrethalas,1658,priest,discipline,175,94,81
Pristern,tarren-mill,1658,priest,discipline,144,74,70
Veryfine,draenor,1658,priest,discipline,154,77,77
Hinorist,kazzak,1658,priest,discipline,208,99,109
Undeadpriest,aegwynn,1658,priest,discipline,54,21,33
Nwo,twisting-nether,1657,priest,discipline,48,29,19
Floorpovx,blackmoore,1657,priest,discipline,42,25,17
Myrmz,archimonde,1657,priest,discipline,123,71,52
Twosugars,sylvanas,1657,priest,discipline,180,95,85
Krokkete,archimonde,1657,priest,discipline,36,19,17
Kolinamenus,dun-morogh,1657,priest,discipline,263,134,129
Mystz,dun-modr,1657,priest,discipline,81,39,42
Djokui,uldum,1657,priest,discipline,54,22,32
Nyrziâ,archimonde,1656,priest,discipline,36,23,13
Богколтрэйн,fordragon,1656,priest,discipline,74,40,34
Atothéèx,outland,1656,priest,discipline,95,51,44
Feniyxa,die-aldor,1656,priest,discipline,42,22,20
Violentha,kazzak,1656,priest,discipline,244,126,118
Splintplays,zuljin,1656,priest,discipline,455,225,230
Dreê,hyjal,1656,priest,discipline,114,53,61
Ровк,soulflayer,1656,priest,discipline,46,20,26
Devoura,sylvanas,1656,priest,discipline,87,37,50
Seeyae,ravencrest,1655,priest,discipline,28,19,9
Strawhât,eredar,1655,priest,discipline,65,38,27
Tifa,ravencrest,1655,priest,discipline,175,95,80
Aéríthx,ravencrest,1655,priest,discipline,285,151,134
Bromine,twisting-nether,1654,priest,discipline,75,53,22
Gumer,antonidas,1654,priest,discipline,36,21,15
Xaeroow,archimonde,1654,priest,discipline,79,43,36
Nihpolz,ragnaros,1654,priest,discipline,152,79,73
Syreet,silvermoon,1654,priest,discipline,484,244,240
Prästmåns,tarren-mill,1654,priest,discipline,102,48,54
Zërøx,ysondre,1654,priest,discipline,271,123,148
Xarac,eredar,1654,priest,discipline,60,27,33
Bammerr,stormscale,1653,priest,discipline,28,19,9
Aloegarten,ravencrest,1653,priest,discipline,145,70,75
Lowery,argent-dawn,1653,priest,discipline,48,22,26
Redempt,nemesis,1653,priest,discipline,47,21,26
Sutenör,kazzak,1653,priest,discipline,162,69,93
Alusiepriest,ravencrest,1652,priest,discipline,175,106,69
Tarellia,argent-dawn,1652,priest,discipline,317,182,135
Winnever,dun-modr,1652,priest,discipline,456,246,210
Азмоддан,azuregos,1652,priest,discipline,215,103,112
Rylpriest,blackmoore,1651,priest,discipline,61,36,25
Daddydisc,tarren-mill,1651,priest,discipline,58,34,24
Kyderr,blackrock,1651,priest,discipline,120,63,57
Mythrixia,draenor,1651,priest,discipline,193,100,93
Тоориал,howling-fjord,1651,priest,discipline,386,195,191
Gødsmack,blackhand,1651,priest,discipline,131,65,66
Yeahr,kazzak,1651,priest,discipline,214,97,117
Chabih,ravencrest,1651,priest,discipline,120,54,66
Covidisc,outland,1651,priest,discipline,78,33,45
Yungmazikeen,archimonde,1650,priest,discipline,29,18,11
Danucd,ragnaros,1650,priest,discipline,206,124,82
Melord,thunderhorn,1650,priest,discipline,102,57,45
Oxiièmort,khaz-modan,1650,priest,discipline,42,23,19
Notpoulet,sylvanas,1650,priest,discipline,89,45,44
Mindx,sylvanas,1650,priest,discipline,215,105,110
Voleck,aegwynn,1650,priest,discipline,54,25,29
Bochonok,stormrage,1650,priest,discipline,54,23,31
Krecik,deathwing,1650,priest,discipline,59,25,34
Kâîri,ragnaros,1649,priest,discipline,39,26,13
Bestinuk,kazzak,1649,priest,discipline,82,54,28
Пеппаслав,soulflayer,1649,priest,discipline,246,134,112
Jeez,twilights-hammer,1649,priest,discipline,283,151,132
Dathanosp,outland,1649,priest,discipline,48,25,23
Blindmymind,malganis,1649,priest,discipline,153,79,74
Rhæveth,ravencrest,1648,priest,discipline,48,31,17
Reäzx,archimonde,1648,priest,discipline,126,78,48
Chèéks,kazzak,1648,priest,discipline,72,43,29
Drlight,stormscale,1648,priest,discipline,170,91,79
Doyun,kazzak,1648,priest,discipline,84,43,41
Эридия,soulflayer,1648,priest,discipline,126,63,63
Jumpàxx,archimonde,1648,priest,discipline,60,26,34
Joeelz,blackmoore,1647,priest,discipline,36,25,11
Mydianá,aegwynn,1647,priest,discipline,32,22,10
Ðæððÿsgïrl,ravencrest,1647,priest,discipline,171,89,82
Eyllise,ragnaros,1647,priest,discipline,606,314,292
Healdeal,stormscale,1647,priest,discipline,518,259,259
Алеброн,gordunni,1647,priest,discipline,66,32,34
Anvena,elune,1647,priest,discipline,60,26,34
Выдокбля,soulflayer,1646,priest,discipline,58,41,17
Tøxicboy,ravencrest,1646,priest,discipline,89,48,41
Erfofthesop,chants-éternels,1646,priest,discipline,40,21,19
Наглыйприст,gordunni,1646,priest,discipline,248,130,118
Wencis,kazzak,1646,priest,discipline,126,66,60
Auroree,stormscale,1646,priest,discipline,54,23,31
Discxqt,ysondre,1645,priest,discipline,92,56,36
Мастди,ashenvale,1645,priest,discipline,47,23,24
Pestmorran,sylvanas,1645,priest,discipline,515,249,266
Shdetrzyx,outland,1645,priest,discipline,56,21,35
Gødisc,blackrock,1644,priest,discipline,36,23,13
Árî,dun-modr,1644,priest,discipline,174,99,75
Malapriest,dalaran,1644,priest,discipline,102,56,46
Layster,chants-éternels,1644,priest,discipline,42,23,19
Patriamore,jaedenar,1644,priest,discipline,106,46,60
Donvasco,kazzak,1644,priest,discipline,65,28,37
Zeiphe,kargath,1643,priest,discipline,69,40,29
Nocdsusage,draenor,1643,priest,discipline,268,134,134
Mêduse,ravencrest,1643,priest,discipline,135,62,73
Muradawg,nemesis,1643,priest,discipline,53,23,30
Discmoo,kazzak,1642,priest,discipline,32,22,10
Japral,blackhand,1642,priest,discipline,48,31,17
Xtracheesy,ragnaros,1642,priest,discipline,90,54,36
Нед,greymane,1642,priest,discipline,297,160,137
Wawreks,drakthul,1642,priest,discipline,47,25,22
Tashziehn,blackrock,1642,priest,discipline,348,182,166
Lobbygriefer,ravencrest,1642,priest,discipline,1058,535,523
Cinnamoroll,ravencrest,1642,priest,discipline,60,29,31
Mazzekeen,burning-legion,1641,priest,discipline,122,69,53
Kuqezi,archimonde,1641,priest,discipline,96,53,43
Zurlyne,ravencrest,1641,priest,discipline,135,71,64
Интенси,gordunni,1641,priest,discipline,278,141,137
Репабликуес,gordunni,1641,priest,discipline,36,18,18
Carë,anubarak,1641,priest,discipline,101,44,57
Fluvnidi,ravencrest,1640,priest,discipline,66,38,28
Priéstitude,kazzak,1640,priest,discipline,42,24,18
Prästbaazil,ragnaros,1640,priest,discipline,72,40,32
Gobblestick,draenor,1640,priest,discipline,191,93,98
Slowinmotion,twisting-nether,1639,priest,discipline,42,25,17
Сенсис,gordunni,1639,priest,discipline,362,192,170
Shadowburst,archimonde,1639,priest,discipline,60,31,29
Sicknp,sylvanas,1639,priest,discipline,90,46,44
Xaerroow,archimonde,1638,priest,discipline,70,42,28
Hrtbrxkn,ravencrest,1638,priest,discipline,82,47,35
Réquell,twisting-nether,1638,priest,discipline,66,37,29
Vigodis,alleria,1638,priest,discipline,150,83,67
Slimcharles,ravencrest,1638,priest,discipline,219,116,103
Ggbenis,ragnaros,1638,priest,discipline,59,30,29
Hialdo,bladefist,1638,priest,discipline,84,36,48
Ltrxo,twisting-nether,1637,priest,discipline,59,40,19
Zanshin,ravencrest,1637,priest,discipline,29,18,11
Psjk,blackrock,1637,priest,discipline,182,99,83
Shalvy,aegwynn,1637,priest,discipline,242,123,119
Toxp,kazzak,1637,priest,discipline,244,119,125
Sláin,outland,1637,priest,discipline,376,183,193
Ðês,ravencrest,1637,priest,discipline,196,93,103
Rytmusqt,outland,1637,priest,discipline,156,73,83
Schlämpie,blackmoore,1637,priest,discipline,73,32,41
Pewpewpew,krasus,1636,priest,discipline,127,73,54
Limeslayerx,veklor,1636,priest,discipline,111,62,49
Aerael,auchindoun,1636,priest,discipline,42,23,19
Voidtouched,drakthul,1636,priest,discipline,41,21,20
Hodgins,bloodscalp,1636,priest,discipline,88,45,43
Animalrescue,draenor,1636,priest,discipline,78,39,39
Ванальная,soulflayer,1636,priest,discipline,42,21,21
Nooblygaming,nemesis,1636,priest,discipline,250,124,126
Thaykza,blackmoore,1636,priest,discipline,45,22,23
Milania,ravencrest,1636,priest,discipline,118,57,61
Légít,argent-dawn,1636,priest,discipline,132,60,72
Remøørsêlês,outland,1635,priest,discipline,135,85,50
Garbins,stormscale,1635,priest,discipline,53,30,23
Izanamì,ragnaros,1635,priest,discipline,47,23,24
Shadowzrip,twilights-hammer,1635,priest,discipline,90,42,48
Tiphereth,blackmoore,1635,priest,discipline,119,52,67
Balboa,archimonde,1634,priest,discipline,30,18,12
Waramoly,eredar,1634,priest,discipline,143,84,59
Noodlesoup,daggerspine,1634,priest,discipline,343,187,156
Xxoo,antonidas,1634,priest,discipline,41,22,19
Hamati,blackhand,1634,priest,discipline,246,131,115
Yuukiilove,kult-der-verdammten,1633,priest,discipline,30,21,9
Byebee,stormscale,1633,priest,discipline,90,56,34
Jhaazx,nemesis,1633,priest,discipline,272,144,128
Eyecry,sylvanas,1633,priest,discipline,93,49,44
Raerâ,archimonde,1633,priest,discipline,40,21,19
Boukàry,illidan,1633,priest,discipline,42,22,20
Anzee,tarren-mill,1633,priest,discipline,72,35,37
Yzina,archimonde,1633,priest,discipline,114,51,63
Misántropo,dun-modr,1632,priest,discipline,59,38,21
Sebikpri,ravencrest,1632,priest,discipline,90,51,39
Иоона,gordunni,1632,priest,discipline,36,20,16
Eagrh,ravencrest,1632,priest,discipline,450,244,206
Lilyrosemary,arathor,1632,priest,discipline,55,29,26
Hydroxizine,ragnaros,1632,priest,discipline,66,34,32
Runay,draenor,1632,priest,discipline,58,27,31
Jezuz,blackhand,1632,priest,discipline,66,28,38
Fäke,dunemaul,1631,priest,discipline,481,258,223
Supfamskrrt,stormscale,1631,priest,discipline,84,43,41
Anheduanna,outland,1631,priest,discipline,2240,1123,1117
Sneboldìs,sylvanas,1630,priest,discipline,48,30,18
Angelofdeàth,kazzak,1630,priest,discipline,180,105,75
Leckpriest,sanguino,1630,priest,discipline,265,145,120
Kaelena,steamwheedle-cartel,1630,priest,discipline,42,21,21
Chizu,alakir,1630,priest,discipline,132,63,69
Zyrean,bronzebeard,1630,priest,discipline,76,36,40
Choron,kult-der-verdammten,1630,priest,discipline,113,53,60
Oscoolytb,archimonde,1630,priest,discipline,154,69,85
Biscuits,ravencrest,1630,priest,discipline,132,54,78
Лютаяшиза,gordunni,1629,priest,discipline,83,51,32
Lucîd,ravencrest,1629,priest,discipline,185,106,79
Anticorona,twisting-nether,1629,priest,discipline,36,20,16
Симпоз,howling-fjord,1629,priest,discipline,110,53,57
Pyion,antonidas,1629,priest,discipline,108,51,57
Frojka,outland,1629,priest,discipline,42,19,23
Salvatíon,sanguino,1629,priest,discipline,272,122,150
Olurin,rajaxx,1629,priest,discipline,108,48,60
Superdude,stormscale,1629,priest,discipline,59,26,33
Shadowkym,blackrock,1628,priest,discipline,84,53,31
Satzuki,sylvanas,1628,priest,discipline,39,24,15
Liviúss,draenor,1628,priest,discipline,457,235,222
Pokahonta,silvermoon,1628,priest,discipline,363,186,177
Ømñyx,outland,1628,priest,discipline,54,26,28
Sadoxy,kult-der-verdammten,1628,priest,discipline,48,22,26
Leviakerman,blackrock,1628,priest,discipline,42,18,24
Otuschpriest,blackmoore,1627,priest,discipline,164,91,73
Prezica,stormscale,1627,priest,discipline,258,140,118
Nilera,frostwolf,1627,priest,discipline,116,61,55
Nzothapostle,baelgun,1627,priest,discipline,548,269,279
Kaiikoo,ravencrest,1627,priest,discipline,36,17,19
Ankus,tarren-mill,1627,priest,discipline,72,33,39
Xsydepriest,archimonde,1627,priest,discipline,54,22,32
Kizmy,archimonde,1627,priest,discipline,54,22,32
Dush,draenor,1626,priest,discipline,68,39,29
Lïnkz,kazzak,1626,priest,discipline,150,83,67
Fendoly,thrall,1626,priest,discipline,71,39,32
Nerfy,tarren-mill,1626,priest,discipline,354,190,164
Inoru,stormreaver,1626,priest,discipline,198,104,94
Lerdameur,arakarahm,1626,priest,discipline,302,146,156
Seanoob,turalyon,1626,priest,discipline,43,18,25
Marôs,antonidas,1626,priest,discipline,96,40,56
Asgà,stormscale,1625,priest,discipline,30,17,13
Ñíò,archimonde,1625,priest,discipline,72,39,33
Roxeal,archimonde,1625,priest,discipline,228,121,107
Narinelepen,culte-de-la-rive-noire,1625,priest,discipline,54,26,28
Nissha,stormscale,1625,priest,discipline,123,54,69
Jeboc,ravencrest,1625,priest,discipline,95,40,55
Fearadelia,thrall,1624,priest,discipline,48,31,17
Labadudala,aegwynn,1624,priest,discipline,84,54,30
Артекриожрец,gordunni,1624,priest,discipline,36,21,15
Garsdal,tarren-mill,1624,priest,discipline,78,43,35
Syntara,twisting-nether,1624,priest,discipline,466,242,224
Darktheu,sanguino,1624,priest,discipline,39,20,19
Пальтишко,howling-fjord,1624,priest,discipline,102,51,51
Remkojatwo,blackrock,1624,priest,discipline,42,21,21
Lindvorm,tarren-mill,1624,priest,discipline,180,89,91
Farae,arathor,1624,priest,discipline,44,19,25
Elfarity,tarren-mill,1623,priest,discipline,69,44,25
Seeyae,archimonde,1623,priest,discipline,30,17,13
Alwaysøøm,kazzak,1623,priest,discipline,198,108,90
Menda,eredar,1623,priest,discipline,309,167,142
Farnese,archimonde,1623,priest,discipline,484,259,225
Grautesk,chogall,1623,priest,discipline,72,38,34
Kedrack,draenor,1623,priest,discipline,78,41,37
Meganx,ravencrest,1623,priest,discipline,48,25,23
Péntagón,festung-der-stürme,1623,priest,discipline,78,40,38
Carnegi,burning-legion,1623,priest,discipline,314,158,156
Yîrâ,antonidas,1623,priest,discipline,227,114,113
Riptile,outland,1623,priest,discipline,100,50,50
Nelielto,stormscale,1622,priest,discipline,28,21,7
Nelyø,destromath,1622,priest,discipline,30,21,9
Mnu,blackrock,1622,priest,discipline,52,30,22
Lerión,ravencrest,1622,priest,discipline,108,62,46
Feed,burning-legion,1622,priest,discipline,84,45,39
Кролс,gordunni,1622,priest,discipline,42,22,20
Dnsxx,thrall,1622,priest,discipline,1099,559,540
Nooway,kazzak,1622,priest,discipline,205,103,102
Vhim,hyjal,1622,priest,discipline,64,31,33
Pmake,ravencrest,1621,priest,discipline,42,24,18
Pandalulz,turalyon,1621,priest,discipline,311,173,138
Фыбра,soulflayer,1621,priest,discipline,36,20,16
Sicarium,aegwynn,1621,priest,discipline,102,56,46
Babywayn,onyxia,1621,priest,discipline,242,129,113
Wiwzi,outland,1621,priest,discipline,136,68,68
Elswêyr,blackmoore,1621,priest,discipline,54,27,27
Sotriggered,sylvanas,1621,priest,discipline,36,17,19
Mainhunter,aegwynn,1621,priest,discipline,36,17,19
Mindfiend,stormscale,1621,priest,discipline,81,37,44
Dêmôn,stormscale,1620,priest,discipline,24,17,7
Iiamx,antonidas,1620,priest,discipline,90,55,35
Mønsterx,kazzak,1620,priest,discipline,70,40,30
Zlejkadlec,drakthul,1620,priest,discipline,214,118,96
Bercxu,ragnaros,1620,priest,discipline,126,66,60
Hónòr,sylvanas,1620,priest,discipline,101,51,50
Dìsclol,draenor,1620,priest,discipline,61,29,32
Jesuispasbon,hyjal,1620,priest,discipline,48,22,26
Soloqbob,kazzak,1620,priest,discipline,48,22,26
Denarne,blackrock,1620,priest,discipline,48,21,27
Wifta,ravencrest,1619,priest,discipline,54,30,24
Roxxes,kazzak,1619,priest,discipline,42,23,19
Chimara,eredar,1619,priest,discipline,254,139,115
Szelén,ragnaros,1619,priest,discipline,54,29,25
Uo,kilrogg,1619,priest,discipline,189,100,89
Jerzay,hyjal,1619,priest,discipline,200,105,95
Olio,outland,1619,priest,discipline,124,65,59
Maryjanè,twisting-nether,1619,priest,discipline,59,29,30
Teyna,alakir,1619,priest,discipline,36,17,19
Naripriest,eredar,1619,priest,discipline,48,22,26
Fatalx,grim-batol,1619,priest,discipline,142,64,78
Rptr,ravencrest,1618,priest,discipline,24,17,7
Yoii,nemesis,1618,priest,discipline,64,38,26
Zehakky,tarren-mill,1618,priest,discipline,157,90,67
Fixelfax,defias-brotherhood,1618,priest,discipline,60,33,27
Sweetxq,tarren-mill,1618,priest,discipline,364,196,168
Шадия,ashenvale,1618,priest,discipline,49,26,23
Soraal,argent-dawn,1618,priest,discipline,109,57,52
Melisoula,stormscale,1618,priest,discipline,48,25,23
Fatherlou,outland,1618,priest,discipline,60,31,29
Pilgram,twilights-hammer,1618,priest,discipline,156,78,78
Фриерли,howling-fjord,1617,priest,discipline,54,38,16
Prost,aerie-peak,1617,priest,discipline,71,47,24
Fartsponge,ragnaros,1617,priest,discipline,67,38,29
Рувид,gordunni,1617,priest,discipline,100,50,50
Пустотность,gordunni,1617,priest,discipline,489,239,250
Alexsmite,tarren-mill,1617,priest,discipline,42,20,22
Ритуалист,deepholm,1617,priest,discipline,102,47,55
Mikeypi,laughing-skull,1616,priest,discipline,36,25,11
Følísh,hyjal,1616,priest,discipline,66,43,23
Chimpanzoo,kazzak,1616,priest,discipline,42,23,19
Holyasprin,sylvanas,1616,priest,discipline,102,54,48
Eluveitieq,kazzak,1616,priest,discipline,238,123,115
Wynda,outland,1616,priest,discipline,76,38,38
Mindgames,the-maelstrom,1616,priest,discipline,54,26,28
Lymhk,blackrock,1616,priest,discipline,60,28,32
Binder,tarren-mill,1616,priest,discipline,60,26,34
Illiest,ravencrest,1615,priest,discipline,48,34,14
Funkátiko,cthun,1615,priest,discipline,85,56,29
Massasax,kazzak,1615,priest,discipline,126,74,52
Rher,blackmoore,1615,priest,discipline,139,81,58
Mtbalt,tarren-mill,1615,priest,discipline,180,103,77
Epa,zuljin,1615,priest,discipline,66,37,29
Èightsix,draenor,1615,priest,discipline,161,88,73
Äliénør,khaz-modan,1615,priest,discipline,159,85,74
Máia,twisting-nether,1615,priest,discipline,109,55,54
Mysticmäc,aegwynn,1615,priest,discipline,90,43,47
Zackher,dun-modr,1615,priest,discipline,59,23,36
Вилайф,galakrond,1614,priest,discipline,94,51,43
Jmp,tarren-mill,1614,priest,discipline,40,21,19
Mitha,tarren-mill,1614,priest,discipline,110,55,55
Sebiarchie,lightnings-blade,1614,priest,discipline,74,36,38
Cøvu,draenor,1613,priest,discipline,39,25,14
Aêbi,dalaran,1613,priest,discipline,78,45,33
Микаса,howling-fjord,1613,priest,discipline,30,17,13
Appuesi,dun-modr,1613,priest,discipline,30,17,13
Freddyprinze,ravencrest,1613,priest,discipline,119,63,56
Dîablø,eredar,1613,priest,discipline,147,74,73
Giesix,frostwolf,1613,priest,discipline,42,21,21
Lizka,kazzak,1613,priest,discipline,144,67,77
Безрассудица,howling-fjord,1612,priest,discipline,24,17,7
Pankp,kazzak,1612,priest,discipline,28,18,10
Tifrahat,the-maelstrom,1612,priest,discipline,64,39,25
Lyndorien,argent-dawn,1612,priest,discipline,120,73,47
Ryuuzaki,stormscale,1612,priest,discipline,101,53,48
Nomakprst,sanguino,1612,priest,discipline,283,148,135
Achardia,argent-dawn,1612,priest,discipline,35,18,17
Seranà,hyjal,1612,priest,discipline,108,55,53
Badorange,kazzak,1612,priest,discipline,65,33,32
Znàdix,silvermoon,1612,priest,discipline,276,140,136
Raawri,blackmoore,1612,priest,discipline,101,50,51
Kaltasar,guldan,1612,priest,discipline,105,48,57
Deazypriest,blackrock,1612,priest,discipline,66,28,38
Carolyna,ravencrest,1612,priest,discipline,42,17,25
Matwucss,outland,1611,priest,discipline,48,28,20
Obeng,tarren-mill,1611,priest,discipline,35,20,15
Lanfear,shadowsong,1611,priest,discipline,72,40,32
Диспайзх,gordunni,1611,priest,discipline,204,97,107
Acidrops,hyjal,1611,priest,discipline,66,30,36
Pøcketsåge,blackrock,1610,priest,discipline,24,17,7
Sméctà,marécage-de-zangar,1610,priest,discipline,55,32,23
Anarame,silvermoon,1610,priest,discipline,75,42,33
Steelbird,ravencrest,1610,priest,discipline,36,20,16
Jibrael,draenor,1610,priest,discipline,84,40,44
Ivÿx,ravencrest,1610,priest,discipline,113,52,61
Zaak,kazzak,1610,priest,discipline,117,52,65
Viu,eredar,1610,priest,discipline,51,22,29
Ptipotam,archimonde,1610,priest,discipline,96,37,59
Holyshiz,stormrage,1609,priest,discipline,42,24,18
Kdot,drakthul,1609,priest,discipline,86,48,38
Fazzy,nagrand,1609,priest,discipline,76,41,35
Alinone,uldum,1609,priest,discipline,141,76,65
Greedyaf,stormscale,1609,priest,discipline,274,145,129
Майти,gordunni,1609,priest,discipline,321,168,153
Gulch,blackmoore,1609,priest,discipline,114,59,55
Egî,lothar,1609,priest,discipline,42,21,21
Fishler,tarren-mill,1609,priest,discipline,58,28,30
Santyel,blackrock,1609,priest,discipline,60,27,33
Patoon,ravencrest,1608,priest,discipline,24,18,6
Dotreveal,ravencrest,1608,priest,discipline,113,58,55
Caramello,stormscale,1608,priest,discipline,228,117,111
Kuki,tarren-mill,1608,priest,discipline,240,122,118
Stepmama,kazzak,1608,priest,discipline,36,18,18
Avenara,blackrock,1608,priest,discipline,123,60,63
Fakecats,sargeras,1608,priest,discipline,51,22,29
Rmp,stormscale,1608,priest,discipline,75,30,45
Zymai,ravencrest,1608,priest,discipline,54,21,33
Pohja,veknilash,1607,priest,discipline,30,20,10
Pipperxp,ravencrest,1607,priest,discipline,91,54,37
Mightnáre,tarren-mill,1607,priest,discipline,36,21,15
Absôlutvôdka,twisting-nether,1607,priest,discipline,96,53,43
Phøènix,twisting-nether,1607,priest,discipline,46,24,22
Evõmax,sylvanas,1607,priest,discipline,533,276,257
Licktheheal,outland,1607,priest,discipline,410,208,202
Krazuk,theradras,1607,priest,discipline,60,29,31
Zloyvrach,ravencrest,1607,priest,discipline,126,60,66
Киллус,ashenvale,1607,priest,discipline,155,70,85
Dxî,ysondre,1607,priest,discipline,102,46,56
Phorno,ragnaros,1607,priest,discipline,68,30,38
Omahelga,blackrock,1606,priest,discipline,196,110,86
Saturnqt,archimonde,1606,priest,discipline,36,20,16
Psíquica,sanguino,1606,priest,discipline,131,66,65
Towelie,stormscale,1606,priest,discipline,96,48,48
Purip,stormscale,1606,priest,discipline,49,24,25
Óói,outland,1606,priest,discipline,61,29,32
Laceylol,anubarak,1606,priest,discipline,36,17,19
Babibayle,arakarahm,1606,priest,discipline,123,51,72
Dtpe,kazzak,1605,priest,discipline,93,59,34
Halysis,chamber-of-aspects,1605,priest,discipline,52,28,24
Jupiter,silvermoon,1605,priest,discipline,340,179,161
Mèix,ysondre,1605,priest,discipline,120,63,57
Pollution,ragnaros,1605,priest,discipline,54,27,27
Mjamc,stormscale,1605,priest,discipline,157,78,79
Krottus,antonidas,1605,priest,discipline,89,44,45
Nidrana,drakthul,1605,priest,discipline,84,41,43
Drwlad,archimonde,1605,priest,discipline,126,61,65
Tárget,frostwolf,1605,priest,discipline,48,22,26
Polymonkey,stormscale,1605,priest,discipline,47,18,29
Troedel,destromath,1604,priest,discipline,103,62,41
Thylstra,ravencrest,1604,priest,discipline,88,51,37
Tritíana,blackrock,1604,priest,discipline,192,110,82
Whipped,ravencrest,1604,priest,discipline,62,34,28
Horrðr,kazzak,1604,priest,discipline,114,61,53
Dameyo,argent-dawn,1604,priest,discipline,77,41,36
Loldisc,arthas,1604,priest,discipline,120,63,57
Leictreach,draenor,1604,priest,discipline,42,22,20
Maquivel,aggra-português,1604,priest,discipline,96,50,46
Няжик,azuregos,1604,priest,discipline,136,68,68
Azrella,ravencrest,1604,priest,discipline,84,40,44
Ostberger,twisting-nether,1603,priest,discipline,227,130,97
Acidpills,hyjal,1603,priest,discipline,124,67,57
Амберис,gordunni,1603,priest,discipline,72,37,35
Lendoril,blackhand,1603,priest,discipline,118,59,59
Sacerdosan,quelthalas,1603,priest,discipline,66,32,34
Góldfinger,norgannon,1603,priest,discipline,39,18,21
Troedelsuppe,destromath,1603,priest,discipline,282,130,152
Хилботгодикс,borean-tundra,1602,priest,discipline,42,32,10
Syniixp,aegwynn,1602,priest,discipline,30,20,10
Мидэрка,howling-fjord,1602,priest,discipline,363,199,164
Хеликси,gordunni,1602,priest,discipline,235,127,108
Tansk,stormscale,1602,priest,discipline,270,144,126
Cultaken,kazzak,1602,priest,discipline,94,48,46
Obbdasknob,ravencrest,1602,priest,discipline,112,55,57
Krystynal,archimonde,1602,priest,discipline,113,54,59
Asherá,kazzak,1602,priest,discipline,160,74,86
Kathja,outland,1602,priest,discipline,48,22,26
Aldebrand,dun-modr,1602,priest,discipline,72,29,43
Hannïri,archimonde,1601,priest,discipline,78,48,30
Jpjp,gorgonnash,1601,priest,discipline,108,66,42
Pumpinghard,twisting-nether,1601,priest,discipline,68,39,29
Sanuki,stormscale,1601,priest,discipline,41,23,18
Kamiyasa,blackmoore,1601,priest,discipline,241,125,116
Shadowboness,twisting-nether,1601,priest,discipline,115,59,56
Makkesfil,stormscale,1601,priest,discipline,60,29,31
Smitebone,tarren-mill,1601,priest,discipline,90,40,50
Ironqt,malfurion,1601,priest,discipline,139,61,78
Lgbtgodx,archimonde,1600,priest,discipline,61,45,16
Kitågåwå,ravencrest,1600,priest,discipline,24,17,7
Romero,sylvanas,1600,priest,discipline,30,19,11
Девственен,soulflayer,1600,priest,discipline,131,78,53
Trì,thrall,1600,priest,discipline,35,20,15
Elosen,darkspear,1600,priest,discipline,216,122,94
Blaelel,dun-modr,1600,priest,discipline,90,49,41
Praywingsebb,nazjatar,1600,priest,discipline,54,29,25
Sinîra,frostwolf,1600,priest,discipline,110,59,51
Valossa,ravencrest,1600,priest,discipline,53,28,25
Jumperlawl,khaz-modan,1600,priest,discipline,366,191,175
Neverswap,blackmoore,1600,priest,discipline,97,50,47
Ojh,defias-brotherhood,1600,priest,discipline,100,51,49
Xangha,burning-legion,1600,priest,discipline,264,133,131
Foh,antonidas,1600,priest,discipline,36,17,19
Stvilde,ragnaros,1600,priest,discipline,42,19,23
Stepsisstuck,ragnaros,1600,priest,discipline,80,36,44
Еврейк,soulflayer,1600,priest,discipline,117,52,65
Shento,blackhand,1600,priest,discipline,48,21,27
Andhoras,dalaran,1600,priest,discipline,53,22,31
Marícanqt,tarren-mill,1599,priest,discipline,30,23,7
Shallteár,doomhammer,1599,priest,discipline,274,136,138
Ahpøual,archimonde,1599,priest,discipline,186,90,96
Stampo,draenor,1599,priest,discipline,77,35,42
Magicdisco,nemesis,1598,priest,discipline,41,27,14
Norganp,die-aldor,1598,priest,discipline,124,64,60
Bebwaz,kazzak,1598,priest,discipline,183,94,89
Zwu,antonidas,1598,priest,discipline,106,51,55
Jackyl,kazzak,1598,priest,discipline,73,35,38
Fästrak,dalaran,1598,priest,discipline,60,25,35
Massbimba,tarren-mill,1597,priest,discipline,427,224,203
Blackbox,burning-legion,1597,priest,discipline,268,134,134
Cinri,argent-dawn,1597,priest,discipline,316,156,160
Raffá,blackhand,1597,priest,discipline,124,56,68
Mohammedx,tarren-mill,1597,priest,discipline,131,59,72
Padregianni,nemesis,1597,priest,discipline,107,46,61
Phucme,deathwing,1597,priest,discipline,60,24,36
Holineß,burning-blade,1596,priest,discipline,114,66,48
Babambaba,sylvanas,1596,priest,discipline,46,23,23
Yore,ravencrest,1596,priest,discipline,42,19,23
Баблби,soulflayer,1596,priest,discipline,169,73,96
Yaoz,sanguino,1595,priest,discipline,30,17,13
Systerstål,twisting-nether,1595,priest,discipline,154,86,68
Hentaigirls,ravencrest,1595,priest,discipline,36,20,16
Cylantharia,eredar,1595,priest,discipline,171,87,84
Lqd,blackrock,1595,priest,discipline,42,21,21
Шимату,howling-fjord,1595,priest,discipline,101,44,57
Эскирия,gordunni,1595,priest,discipline,48,17,31
Spbosse,aszune,1594,priest,discipline,60,35,25
Eördög,ragnaros,1594,priest,discipline,216,118,98
Maâti,kazzak,1594,priest,discipline,217,111,106
Clergin,argent-dawn,1594,priest,discipline,129,65,64
Haakon,tarren-mill,1593,priest,discipline,30,17,13
Bleedingeyes,tarren-mill,1593,priest,discipline,104,58,46
Goosebot,stormscale,1593,priest,discipline,84,46,38
Nevor,nemesis,1593,priest,discipline,266,134,132
Exoduz,stormscale,1593,priest,discipline,419,211,208
Swdjack,blackrock,1593,priest,discipline,232,110,122
Серью,booty-bay,1592,priest,discipline,47,28,19
Whopzi,blackmoore,1592,priest,discipline,48,28,20
Scràppy,malganis,1592,priest,discipline,42,20,22
Zhenni,ravencrest,1592,priest,discipline,69,32,37
Сашадвасм,gordunni,1591,priest,discipline,171,96,75
Verminous,ravencrest,1591,priest,discipline,87,47,40
Fatishcribe,twisting-nether,1591,priest,discipline,339,180,159
Piperxp,ravencrest,1591,priest,discipline,96,49,47
Träskfarfar,tarren-mill,1591,priest,discipline,60,30,30
Мэдмод,gordunni,1591,priest,discipline,319,159,160
Peign,eredar,1590,priest,discipline,48,29,19
Caboon,silvermoon,1590,priest,discipline,96,55,41
Hérune,outland,1590,priest,discipline,140,74,66
Itsdiscobaby,auchindoun,1590,priest,discipline,112,51,61
Cadierna,argent-dawn,1590,priest,discipline,75,34,41
Jàckîe,aegwynn,1590,priest,discipline,52,22,30
Burningheatx,kazzak,1589,priest,discipline,89,56,33
Chîlliz,draenor,1589,priest,discipline,82,51,31
Nomorelight,stormscale,1589,priest,discipline,205,116,89
Vulreth,culte-de-la-rive-noire,1589,priest,discipline,36,20,16
Oecgreg,ysondre,1589,priest,discipline,82,44,38
Shadowbread,tarren-mill,1589,priest,discipline,192,96,96
Biggestpass,kazzak,1588,priest,discipline,24,19,5
Shikibu,sylvanas,1588,priest,discipline,29,22,7
Luvdeluxe,kazzak,1588,priest,discipline,90,52,38
Dashxzz,silvermoon,1588,priest,discipline,42,23,19
Enimao,tarren-mill,1588,priest,discipline,111,59,52
Discgodx,ravencrest,1588,priest,discipline,168,88,80
Hélgå,kazzak,1588,priest,discipline,66,33,33
Yacine,blackrock,1588,priest,discipline,138,67,71
Aurosa,argent-dawn,1587,priest,discipline,141,72,69
Radiancekey,sanguino,1587,priest,discipline,72,36,36
Vänskap,kazzak,1587,priest,discipline,132,65,67
Imdeadxd,twisting-nether,1586,priest,discipline,63,36,27
Grêy,dun-modr,1586,priest,discipline,140,74,66
Shyria,argent-dawn,1586,priest,discipline,103,52,51
Voided,nemesis,1586,priest,discipline,126,62,64
Nexìan,ravencrest,1586,priest,discipline,78,37,41
Teedye,ravencrest,1585,priest,discipline,41,26,15
Toba,hellscream,1585,priest,discipline,113,65,48
Ishande,los-errantes,1585,priest,discipline,507,273,234
Sølvfox,stormscale,1585,priest,discipline,66,35,31
Senpumara,malganis,1585,priest,discipline,408,211,197
Athelsta,alleria,1585,priest,discipline,123,63,60
Весёлыйкоил,gordunni,1584,priest,discipline,33,25,8
Beatzeps,tarren-mill,1584,priest,discipline,56,32,24
Gnzysan,blackrock,1584,priest,discipline,108,60,48
Anyndra,twisting-nether,1584,priest,discipline,167,90,77
Arvonpenaali,defias-brotherhood,1584,priest,discipline,95,51,44
Chigreru,uldum,1584,priest,discipline,52,27,25
Copperpriest,draenor,1584,priest,discipline,80,41,39
Laërhia,archimonde,1584,priest,discipline,326,165,161
Necronidas,burning-legion,1584,priest,discipline,171,86,85
Walkmydome,twisting-nether,1584,priest,discipline,357,177,180
Swkunz,dun-modr,1584,priest,discipline,424,202,222
Zooster,pozzo-delleternità,1583,priest,discipline,84,54,30
Sadkitten,sylvanas,1583,priest,discipline,355,197,158
Gravebrain,draenor,1583,priest,discipline,441,220,221
Shadowlander,dun-modr,1583,priest,discipline,159,78,81
Scarletstory,ravencrest,1583,priest,discipline,187,86,101
Ecg,silvermoon,1583,priest,discipline,120,55,65
Wolferr,outland,1583,priest,discipline,42,19,23
Whattson,colinas-pardas,1583,priest,discipline,41,18,23
Соулвардинг,soulflayer,1583,priest,discipline,60,26,34
Anaqt,silvermoon,1582,priest,discipline,447,228,219
Elwing,darkmoon-faire,1582,priest,discipline,78,36,42
Nerul,twisting-nether,1581,priest,discipline,347,185,162
Boostpriest,archimonde,1581,priest,discipline,306,161,145
Фастдед,howling-fjord,1581,priest,discipline,209,109,100
Chafrufru,kazzak,1581,priest,discipline,60,31,29
Alterlight,twisting-nether,1581,priest,discipline,869,431,438
Эсминза,gordunni,1581,priest,discipline,48,19,29
Чилюнахиле,gordunni,1581,priest,discipline,71,23,48
Mindfreakxx,twisting-nether,1580,priest,discipline,72,44,28
Appraiser,draenor,1580,priest,discipline,36,21,15
Данягантеля,gordunni,1580,priest,discipline,84,45,39
Impecabllo,outland,1580,priest,discipline,54,28,26
Dunderprälle,outland,1580,priest,discipline,91,47,44
Estrecho,sanguino,1580,priest,discipline,53,26,27
Ijzerehenk,outland,1580,priest,discipline,385,184,201
Slikjar,stormscale,1580,priest,discipline,58,24,34
Antainis,silvermoon,1579,priest,discipline,233,128,105
Colèy,blackhand,1579,priest,discipline,204,111,93
Велост,gordunni,1579,priest,discipline,140,76,64
Xanthe,ravencrest,1579,priest,discipline,35,18,17
Uppiediscyo,ravencrest,1579,priest,discipline,664,337,327
Missandeí,frostmane,1579,priest,discipline,42,21,21
Acrio,die-ewige-wacht,1579,priest,discipline,114,56,58
Кхарли,howling-fjord,1579,priest,discipline,122,56,66
Vate,aszune,1579,priest,discipline,66,29,37
Ínsäníty,outland,1578,priest,discipline,36,27,9
Bambus,shattered-hand,1578,priest,discipline,54,29,25
Nêlumar,aegwynn,1578,priest,discipline,105,54,51
Valadaris,outland,1578,priest,discipline,216,107,109
Флафика,deathguard,1577,priest,discipline,84,48,36
Jóhnnybravó,kazzak,1577,priest,discipline,102,54,48
Acosp,sylvanas,1577,priest,discipline,36,19,17
Johen,terenas,1577,priest,discipline,224,116,108
Phamy,antonidas,1577,priest,discipline,76,38,38
Bloodanglee,outland,1577,priest,discipline,66,33,33
Tâmshi,dun-modr,1577,priest,discipline,54,26,28
Maccz,hyjal,1577,priest,discipline,68,32,36
Jackboss,draenor,1577,priest,discipline,140,63,77
Miileys,arthas,1576,priest,discipline,127,74,53
Rennic,stormscale,1576,priest,discipline,78,44,34
Discomacka,twisting-nether,1576,priest,discipline,83,46,37
Макимасама,gordunni,1576,priest,discipline,49,26,23
Pjuww,outland,1576,priest,discipline,51,27,24
Kanî,eredar,1576,priest,discipline,111,56,55
Luziaa,outland,1576,priest,discipline,101,48,53
Maise,stormreaver,1575,priest,discipline,46,29,17
Misspingle,sunstrider,1575,priest,discipline,54,32,22
Toiga,lightnings-blade,1575,priest,discipline,72,41,31
Шарадин,gordunni,1575,priest,discipline,169,95,74
Skyløl,dun-modr,1575,priest,discipline,36,19,17
Bænzoni,pozzo-delleternità,1575,priest,discipline,92,41,51
Eustâche,suramar,1574,priest,discipline,24,17,7
Интердиктх,gordunni,1574,priest,discipline,30,20,10
Vqny,archimonde,1574,priest,discipline,177,98,79
Babloche,archimonde,1574,priest,discipline,125,68,57
Floodey,defias-brotherhood,1574,priest,discipline,84,42,42
Cleancf,blackhand,1574,priest,discipline,415,207,208
Aleluia,alonsus,1574,priest,discipline,153,68,85
Gbpjr,xavius,1573,priest,discipline,278,142,136
Grzmocillaa,burning-legion,1573,priest,discipline,108,55,53
Arjak,stormscale,1573,priest,discipline,75,37,38
Yhraeliaegh,defias-brotherhood,1573,priest,discipline,344,169,175
Aia,tyrande,1573,priest,discipline,88,41,47
Эззи,soulflayer,1573,priest,discipline,66,29,37
Biophyzix,aegwynn,1573,priest,discipline,41,18,23
Bloodie,drakthul,1572,priest,discipline,48,30,18
Ellfle,kazzak,1572,priest,discipline,48,28,20
Drmwow,kazzak,1572,priest,discipline,137,74,63
Эски,howling-fjord,1572,priest,discipline,251,133,118
Acik,bladefist,1572,priest,discipline,101,53,48
Meanazer,antonidas,1572,priest,discipline,145,76,69
Nyarlatothep,boulderfist,1572,priest,discipline,148,77,71
Мплехибои,gordunni,1572,priest,discipline,66,34,32
Scréam,eredar,1572,priest,discipline,114,58,56
Loreleì,sylvanas,1571,priest,discipline,60,36,24
Shadowmend,aegwynn,1571,priest,discipline,65,34,31
Axla,stormscale,1571,priest,discipline,83,43,40
Pvpalt,argent-dawn,1571,priest,discipline,152,75,77
Goodgirl,frostmane,1570,priest,discipline,70,46,24
Eshania,frostwolf,1570,priest,discipline,102,60,42
Zinzor,archimonde,1570,priest,discipline,118,62,56
Люблюкофе,deathguard,1570,priest,discipline,112,56,56
Miikkap,blackhand,1570,priest,discipline,60,29,31
Mysticforces,silvermoon,1570,priest,discipline,114,54,60
Bubbelchên,blackhand,1570,priest,discipline,72,32,40
Îwi,archimonde,1570,priest,discipline,48,20,28
Caliadan,kazzak,1569,priest,discipline,36,21,15
Pxescalol,aegwynn,1569,priest,discipline,58,29,29
Nercøtic,antonidas,1569,priest,discipline,94,44,50
Хэвидрим,soulflayer,1569,priest,discipline,66,28,38
Vrêth,blackmoore,1569,priest,discipline,51,21,30
Isendth,archimonde,1569,priest,discipline,78,27,51
Hèmera,tichondrius,1568,priest,discipline,55,41,14
Paìnz,blackhand,1568,priest,discipline,146,82,64
Nightreaver,argent-dawn,1568,priest,discipline,105,57,48
Heilerharry,blackmoore,1568,priest,discipline,87,47,40
Ledxpri,twisting-nether,1568,priest,discipline,114,61,53
Holynelph,kazzak,1568,priest,discipline,56,28,28
Mercîlezz,eredar,1567,priest,discipline,59,39,20
Xaerah,blackmoore,1567,priest,discipline,90,48,42
Priestin,dun-modr,1567,priest,discipline,176,90,86
Beocca,sanguino,1567,priest,discipline,48,20,28
Черныйсписок,gordunni,1566,priest,discipline,454,236,218
Loliheal,blackmoore,1566,priest,discipline,93,47,46
Целитель,gordunni,1566,priest,discipline,292,145,147
Discih,ragnaros,1566,priest,discipline,87,40,47
Disconight,kazzak,1566,priest,discipline,54,22,32
Svistis,ravencrest,1565,priest,discipline,58,39,19
Этотьмадетка,howling-fjord,1565,priest,discipline,42,26,16
Aternia,draenor,1565,priest,discipline,89,48,41
Soupriest,ysondre,1565,priest,discipline,217,115,102
Holygustavo,blackmoore,1565,priest,discipline,48,25,23
Cajolîne,archimonde,1565,priest,discipline,222,109,113
Franciscus,bladefist,1565,priest,discipline,91,44,47
Ftiersp,ravencrest,1565,priest,discipline,60,27,33
Valyreon,outland,1565,priest,discipline,60,20,40
Крэкслингер,howling-fjord,1564,priest,discipline,142,71,71
Простосори,gordunni,1564,priest,discipline,616,302,314
Gojó,outland,1564,priest,discipline,117,57,60
Cringelørd,alakir,1564,priest,discipline,42,17,25
Yënâs,hyjal,1563,priest,discipline,114,65,49
Darkprofit,aegwynn,1563,priest,discipline,197,101,96
Orophar,antonidas,1563,priest,discipline,481,246,235
Boostedidot,tarren-mill,1563,priest,discipline,58,29,29
Alicanx,twisting-nether,1563,priest,discipline,90,40,50
Tobijara,proudmoore,1563,priest,discipline,42,18,24
Craquylx,hyjal,1563,priest,discipline,47,17,30
Unfaker,drakthul,1562,priest,discipline,36,23,13
Talbädar,draenor,1562,priest,discipline,54,32,22
Ypsi,defias-brotherhood,1562,priest,discipline,48,27,21
Надийя,gordunni,1562,priest,discipline,150,84,66
Kiropap,silvermoon,1562,priest,discipline,464,243,221
Nastynina,frostwhisper,1562,priest,discipline,98,51,47
Raeratwo,archimonde,1562,priest,discipline,36,18,18
Louiepr,outland,1562,priest,discipline,92,38,54
Okeymokey,malganis,1561,priest,discipline,267,140,127
Frednshield,tarren-mill,1561,priest,discipline,162,82,80
Mindgamez,tarren-mill,1561,priest,discipline,66,33,33
Dangerfred,stormscale,1561,priest,discipline,36,18,18
Averagenoob,ragnaros,1561,priest,discipline,224,111,113
Макстин,howling-fjord,1561,priest,discipline,201,96,105
Soloqhero,chamber-of-aspects,1561,priest,discipline,60,25,35
Saintpri,twisting-nether,1560,priest,discipline,123,67,56
Raezi,defias-brotherhood,1560,priest,discipline,196,105,91
Lyim,stormscale,1560,priest,discipline,47,25,22
Vicønia,tarren-mill,1560,priest,discipline,41,17,24
Maerlene,nemesis,1560,priest,discipline,122,50,72
Бониклайтх,gordunni,1559,priest,discipline,30,18,12
Shafela,sanguino,1559,priest,discipline,36,21,15
Ðæthshaðow,dalaran,1559,priest,discipline,59,32,27
Føxy,emerald-dream,1559,priest,discipline,53,27,26
Ичисанчик,howling-fjord,1559,priest,discipline,91,45,46
Toxicx,aegwynn,1559,priest,discipline,48,19,29
Khomic,archimonde,1558,priest,discipline,59,35,24
Fuzzybae,ravencrest,1558,priest,discipline,120,59,61
Ectria,ravencrest,1558,priest,discipline,149,71,78
Touchmé,blackmoore,1558,priest,discipline,47,18,29
Аркприст,gordunni,1557,priest,discipline,48,32,16
Лин,howling-fjord,1557,priest,discipline,34,21,13
Bigbootyheal,silvermoon,1557,priest,discipline,174,103,71
Morerespect,lothar,1557,priest,discipline,50,29,21
Юлечка,blackscar,1557,priest,discipline,147,80,67
Ilostmybible,runetotem,1557,priest,discipline,198,104,94
Lishado,twisting-nether,1557,priest,discipline,108,55,53
Олдмэнсэйд,soulflayer,1557,priest,discipline,134,68,66
Ashuramaru,drakthul,1557,priest,discipline,71,34,37
Shielddanke,blackmoore,1557,priest,discipline,84,40,44
Æbe,tarren-mill,1557,priest,discipline,76,36,40
Dreythan,stormrage,1557,priest,discipline,120,55,65
Lanthypriest,hyjal,1557,priest,discipline,60,25,35
Freeguzmán,ragnaros,1556,priest,discipline,58,35,23
Anetalol,zuluhed,1556,priest,discipline,66,35,31
Giggidee,tarren-mill,1556,priest,discipline,220,115,105
Darkprist,sanguino,1556,priest,discipline,124,64,60
Шпангл,gordunni,1556,priest,discipline,316,163,153
Hexonite,burning-legion,1556,priest,discipline,94,47,47
Heílsuse,antonidas,1556,priest,discipline,48,18,30
Woid,aegwynn,1555,priest,discipline,48,28,20
Блексебет,soulflayer,1555,priest,discipline,172,92,80
Treen,silvermoon,1555,priest,discipline,177,94,83
Skallya,ysondre,1555,priest,discipline,36,17,19
Shockpriest,grim-batol,1555,priest,discipline,72,27,45
Mvce,outland,1554,priest,discipline,54,37,17
Cathocrasty,draenor,1554,priest,discipline,123,69,54
Pubis,silvermoon,1554,priest,discipline,66,35,31
Incorporeal,eredar,1554,priest,discipline,41,21,20
Dyliz,stormscale,1554,priest,discipline,477,243,234
Eßola,silvermoon,1554,priest,discipline,88,44,44
Fulgus,sanguino,1554,priest,discipline,400,194,206
Cresellia,twisting-nether,1554,priest,discipline,182,87,95
Mustatomi,stormreaver,1554,priest,discipline,39,17,22
Labopriest,blackmoore,1554,priest,discipline,48,20,28
Алуан,blackscar,1554,priest,discipline,90,36,54
Walúpe,draenor,1553,priest,discipline,70,45,25
Poxqt,thrall,1553,priest,discipline,190,111,79
Psnextxp,eredar,1553,priest,discipline,135,76,59
Хахеха,gordunni,1553,priest,discipline,66,37,29
Kaliboom,archimonde,1553,priest,discipline,232,126,106
Jagersmite,twisting-nether,1553,priest,discipline,486,259,227
Sháady,ravencrest,1553,priest,discipline,78,41,37
Foobi,the-maelstrom,1553,priest,discipline,650,336,314
Рэйкар,razuvious,1553,priest,discipline,65,33,32
Могулас,soulflayer,1553,priest,discipline,756,383,373
Pøwêr,hyjal,1553,priest,discipline,90,45,45
Zíria,outland,1553,priest,discipline,314,156,158
Mêmphìs,twisting-nether,1553,priest,discipline,149,72,77
Khâléd,kazzak,1553,priest,discipline,36,17,19
Рейсина,gordunni,1553,priest,discipline,79,35,44
Armward,twisting-nether,1552,priest,discipline,58,35,23
Nielar,onyxia,1552,priest,discipline,74,41,33
Laceylee,anubarak,1552,priest,discipline,36,18,18
Húlda,auchindoun,1552,priest,discipline,202,100,102
Yøløswagg,silvermoon,1552,priest,discipline,157,75,82
Dazzlee,rajaxx,1552,priest,discipline,180,84,96
Deathspren,stormscale,1552,priest,discipline,42,19,23
Shacoat,draenor,1552,priest,discipline,78,29,49
Wedoburgers,ravencrest,1551,priest,discipline,24,17,7
Outtloor,twisting-nether,1551,priest,discipline,86,46,40
Rtang,outland,1551,priest,discipline,98,52,46
Hâlez,antonidas,1551,priest,discipline,481,245,236
Srakabot,burning-legion,1551,priest,discipline,275,137,138
Anotherdisc,aegwynn,1551,priest,discipline,467,231,236
Расспутана,howling-fjord,1551,priest,discipline,326,161,165
Ronk,outland,1551,priest,discipline,39,19,20
Blutleid,malfurion,1551,priest,discipline,42,20,22
Holyarnold,silvermoon,1551,priest,discipline,212,93,119
Afrøjack,tarren-mill,1550,priest,discipline,61,35,26
Furosam,eredar,1550,priest,discipline,66,37,29
Zìzz,hyjal,1550,priest,discipline,42,23,19
Vexadow,kazzak,1550,priest,discipline,90,49,41
Sinnzz,ysondre,1550,priest,discipline,126,68,58
Makesnosense,kilrogg,1550,priest,discipline,78,42,36
Zône,hyjal,1550,priest,discipline,69,37,32
Selfcontrol,blackhand,1550,priest,discipline,66,25,41
Dùsty,archimonde,1549,priest,discipline,135,79,56
Rizzlerx,blackmoore,1549,priest,discipline,156,85,71
Smellypotato,kazzak,1549,priest,discipline,135,73,62
Jcnun,xavius,1549,priest,discipline,180,94,86
Alz,rashgarroth,1549,priest,discipline,195,99,96
Soraløl,stormscale,1549,priest,discipline,130,66,64
Prayforme,lightbringer,1549,priest,discipline,71,36,35
Chenandler,aggra-português,1549,priest,discipline,53,26,27
Alysial,silvermoon,1549,priest,discipline,42,20,22
Arkkinunna,outland,1549,priest,discipline,124,59,65
Faouzia,argent-dawn,1549,priest,discipline,59,27,32
Denyz,blackrock,1549,priest,discipline,66,26,40
Cainactor,drakthul,1548,priest,discipline,119,64,55
Марабудх,soulflayer,1548,priest,discipline,123,66,57
Ckxd,ravencrest,1548,priest,discipline,42,22,20
Sctheal,outland,1548,priest,discipline,75,37,38
Runekpriest,tarren-mill,1548,priest,discipline,51,25,26
Shadowfishey,grim-batol,1548,priest,discipline,170,78,92
Usee,kazzak,1547,priest,discipline,72,45,27
Säeneris,hyjal,1547,priest,discipline,127,69,58
Avaichquirit,tarren-mill,1547,priest,discipline,142,75,67
Zennen,ragnaros,1547,priest,discipline,88,46,42
Chuckline,eredar,1547,priest,discipline,132,68,64
Sundæ,antonidas,1547,priest,discipline,95,46,49
Bejud,tarren-mill,1547,priest,discipline,54,26,28
Тыкофка,gordunni,1547,priest,discipline,480,231,249
Pøsæ,uldaman,1546,priest,discipline,89,46,43
Èzì,burning-legion,1546,priest,discipline,173,89,84
Poonies,silvermoon,1546,priest,discipline,124,61,63
Wìklüñd,ravencrest,1546,priest,discipline,170,72,98
Элхолейн,gordunni,1545,priest,discipline,41,28,13
Iljvjll,blackrock,1545,priest,discipline,31,18,13
Sapholie,kirin-tor,1545,priest,discipline,36,20,16
Аидкабтв,gordunni,1545,priest,discipline,85,45,40
Themistia,kazzak,1545,priest,discipline,253,126,127
Хомие,soulflayer,1545,priest,discipline,121,58,63
Heindl,ravencrest,1545,priest,discipline,72,34,38
Amun,blackmoore,1545,priest,discipline,85,38,47
Badballs,doomhammer,1545,priest,discipline,53,22,31
Twh,outland,1544,priest,discipline,71,42,29
Noobpriest,blackrock,1544,priest,discipline,184,93,91
Geesuz,outland,1544,priest,discipline,151,76,75
Akeejprix,ravencrest,1544,priest,discipline,84,42,42
Mæzen,sylvanas,1544,priest,discipline,60,29,31
Prencø,sanguino,1543,priest,discipline,36,23,13
Zaluri,blackrock,1543,priest,discipline,47,27,20
Sahorie,archimonde,1543,priest,discipline,159,89,70
Валифа,gordunni,1543,priest,discipline,110,61,49
Spiochpr,burning-legion,1543,priest,discipline,224,123,101
Mapples,antonidas,1543,priest,discipline,320,172,148
Tjat,silvermoon,1543,priest,discipline,114,58,56
Burtarul,argent-dawn,1542,priest,discipline,74,44,30
Cursedme,blackrock,1542,priest,discipline,55,32,23
Менестрели,gordunni,1542,priest,discipline,345,188,157
Spirítbox,argent-dawn,1542,priest,discipline,315,164,151
Vicwix,draenor,1542,priest,discipline,71,36,35
Terno,sylvanas,1542,priest,discipline,954,476,478
Nithraw,kazzak,1542,priest,discipline,291,143,148
Admiration,eredar,1542,priest,discipline,47,23,24
Hopepriest,magtheridon,1542,priest,discipline,96,46,50
Intentoso,nemesis,1542,priest,discipline,60,28,32
Tyraedrel,nemesis,1542,priest,discipline,104,45,59
Jamii,kazzak,1541,priest,discipline,137,85,52
Батямелднул,blackscar,1541,priest,discipline,60,36,24
Buan,blackmoore,1541,priest,discipline,104,59,45
Deadwen,stormscale,1541,priest,discipline,290,157,133
Bublelicious,silvermoon,1541,priest,discipline,90,48,42
Tazting,stormscale,1541,priest,discipline,139,74,65
Nightsøul,ragnaros,1541,priest,discipline,373,192,181
Yonkerz,frostmane,1541,priest,discipline,269,128,141
Loverxz,dun-modr,1540,priest,discipline,90,46,44
Khazidhea,frostwolf,1540,priest,discipline,135,68,67
Whiskie,twisting-nether,1540,priest,discipline,60,30,30
Psi,hakkar,1540,priest,discipline,36,18,18
Gooflord,ravencrest,1540,priest,discipline,126,61,65
Skinandbones,sylvanas,1540,priest,discipline,185,81,104
Nnaoy,ysondre,1539,priest,discipline,44,26,18
Xayrin,thrall,1539,priest,discipline,162,91,71
Lahammy,kazzak,1539,priest,discipline,68,36,32
Ranevskiy,kazzak,1539,priest,discipline,305,153,152
Джулибуба,borean-tundra,1539,priest,discipline,93,46,47
Wurstpriest,silvermoon,1539,priest,discipline,84,41,43
Notpetya,kazzak,1539,priest,discipline,46,20,26
Léandrä,magtheridon,1538,priest,discipline,36,18,18
Tepevelf,dun-modr,1538,priest,discipline,565,271,294
Zastyx,drakthul,1538,priest,discipline,62,28,34
Chokmâh,sanguino,1537,priest,discipline,30,19,11
Mòly,archimonde,1537,priest,discipline,33,20,13
Priestadorie,ravencrest,1537,priest,discipline,37,20,17
Tgz,ravencrest,1537,priest,discipline,241,123,118
Pleadz,tarren-mill,1537,priest,discipline,137,61,76
Gannendor,blackhand,1537,priest,discipline,45,19,26
Ache,defias-brotherhood,1536,priest,discipline,30,17,13
Redpriestess,kazzak,1536,priest,discipline,77,43,34
Natapriest,antonidas,1536,priest,discipline,266,145,121
Géèk,alakir,1536,priest,discipline,337,170,167
Styilepriest,twisting-nether,1536,priest,discipline,36,18,18
Effectx,ravencrest,1536,priest,discipline,126,60,66
Interrupted,kazzak,1536,priest,discipline,132,61,71
Shellpop,stormscale,1535,priest,discipline,47,25,22
Åzjol,magtheridon,1535,priest,discipline,36,19,17
Yûnalescá,blackmoore,1535,priest,discipline,147,74,73
Sonyl,les-sentinelles,1535,priest,discipline,54,27,27
Giggí,malganis,1535,priest,discipline,183,88,95
Yuukii,kult-der-verdammten,1535,priest,discipline,36,17,19
Berstkraft,blackmoore,1535,priest,discipline,155,73,82
Goblex,hyjal,1535,priest,discipline,63,28,35
Cydira,eredar,1534,priest,discipline,78,46,32
Pricé,blackmoore,1534,priest,discipline,66,37,29
Tyrial,outland,1534,priest,discipline,86,47,39
Logath,archimonde,1534,priest,discipline,79,41,38
Partyanimal,blackrock,1534,priest,discipline,95,49,46
Pmh,kazzak,1534,priest,discipline,120,60,60
Truthspeaker,outland,1534,priest,discipline,44,22,22
Nøitra,blackrock,1534,priest,discipline,47,23,24
Pakmopriest,ragnaros,1534,priest,discipline,84,39,45
Fuzzymerge,ravencrest,1534,priest,discipline,100,46,54
Kineo,frostwolf,1534,priest,discipline,60,27,33
Джоега,grom,1534,priest,discipline,65,21,44
Deadlyhealer,draenor,1533,priest,discipline,48,22,26
Kotipope,silvermoon,1532,priest,discipline,175,103,72
Mahraxyr,hyjal,1532,priest,discipline,43,22,21
Sxl,ysondre,1532,priest,discipline,54,27,27
Baloopriest,grim-batol,1532,priest,discipline,71,35,36
Mvuu,kazzak,1531,priest,discipline,71,45,26
Sebbepriest,twisting-nether,1531,priest,discipline,72,45,27
Володябигуди,howling-fjord,1531,priest,discipline,64,36,28
Sílvana,nordrassil,1531,priest,discipline,307,168,139
Хилкорлеоне,soulflayer,1531,priest,discipline,126,65,61
Softie,zuljin,1531,priest,discipline,317,163,154
Mandarinee,blackmoore,1531,priest,discipline,456,233,223
Trénboloné,tarren-mill,1531,priest,discipline,120,58,62
Darktemplarx,magtheridon,1531,priest,discipline,375,179,196
Dexodus,sylvanas,1531,priest,discipline,36,17,19
Glaedahr,blackmoore,1531,priest,discipline,66,26,40
Asmodeux,alakir,1530,priest,discipline,24,19,5
Ønliie,ravencrest,1530,priest,discipline,48,29,19
Sangububblu,silvermoon,1530,priest,discipline,94,55,39
Xvpr,trollbane,1530,priest,discipline,71,40,31
Zordochpräst,ravencrest,1530,priest,discipline,72,39,33
Swdömmel,aegwynn,1530,priest,discipline,30,16,14
Jakeow,auchindoun,1530,priest,discipline,129,68,61
Gûardianwisp,ravencrest,1530,priest,discipline,271,137,134
Skylar,xavius,1529,priest,discipline,84,47,37
ßlinkywinky,outland,1529,priest,discipline,30,16,14
Wortmonster,malganis,1529,priest,discipline,54,28,26
Mojmir,drakthul,1529,priest,discipline,120,58,62
Onelovexx,thrall,1529,priest,discipline,60,28,32
Mírá,burning-blade,1528,priest,discipline,108,66,42
Akingodxz,twisting-nether,1528,priest,discipline,48,27,21
Djchinoix,archimonde,1528,priest,discipline,159,86,73
Undeabniss,nathrezim,1528,priest,discipline,54,29,25
Grishnat,ragnaros,1528,priest,discipline,42,22,20
Sentryward,silvermoon,1528,priest,discipline,66,27,39
Zackshock,sanguino,1528,priest,discipline,102,39,63
Delarus,perenolde,1527,priest,discipline,96,58,38
Verzeichnis,thrall,1527,priest,discipline,182,102,80
Papynou,garona,1526,priest,discipline,37,23,14
Redøm,stormreaver,1526,priest,discipline,57,28,29
Tanjaspano,twisting-nether,1526,priest,discipline,66,32,34
Budwéisér,ravencrest,1526,priest,discipline,122,58,64
Sethp,hyjal,1525,priest,discipline,30,21,9
Ivysaurus,ravencrest,1525,priest,discipline,168,94,74
Вайфими,gordunni,1525,priest,discipline,148,71,77
Лилатэль,blackscar,1525,priest,discipline,203,94,109
Syrell,sanguino,1525,priest,discipline,83,37,46
Hellmipriest,antonidas,1525,priest,discipline,72,28,44
Crimsõn,kazzak,1524,priest,discipline,78,45,33
Twisty,malganis,1524,priest,discipline,151,76,75
Экспл,lich-king,1524,priest,discipline,82,41,41
Szentpap,ravencrest,1524,priest,discipline,82,38,44
Vendorqt,twisting-nether,1524,priest,discipline,36,16,20
Nelakya,blackmoore,1523,priest,discipline,30,16,14
Utsuro,stormscale,1523,priest,discipline,96,49,47
Kyseki,ravencrest,1523,priest,discipline,514,262,252
Phobica,frostmane,1523,priest,discipline,52,26,26
Laurent,sanguino,1523,priest,discipline,47,22,25
Виспх,eversong,1523,priest,discipline,269,120,149
Satins,silvermoon,1523,priest,discipline,36,16,20
Бархомелфой,gordunni,1522,priest,discipline,113,61,52
Stepsisterr,ravencrest,1522,priest,discipline,251,133,118
Burnex,thrall,1522,priest,discipline,165,83,82
Cptatonement,draenor,1522,priest,discipline,142,68,74
Карбираторх,gordunni,1522,priest,discipline,54,23,31
Kaazaam,eredar,1522,priest,discipline,66,21,45
Ruhe,silvermoon,1521,priest,discipline,48,29,19
Diva,malfurion,1521,priest,discipline,82,44,38
Prioheal,hyjal,1521,priest,discipline,120,64,56
Mezan,tarren-mill,1521,priest,discipline,113,50,63
Бэнжэминг,gordunni,1521,priest,discipline,179,79,100
Localmadlad,draenor,1520,priest,discipline,91,57,34
Yesdaddypls,draenor,1520,priest,discipline,54,33,21
Voidwaffel,blackmoore,1520,priest,discipline,144,79,65
Шруня,howling-fjord,1520,priest,discipline,309,153,156
Toratorap,burning-legion,1520,priest,discipline,132,65,67
Artì,kazzak,1520,priest,discipline,309,147,162
Babybeyle,arakarahm,1520,priest,discipline,322,151,171
Benau,aegwynn,1519,priest,discipline,60,38,22
Calyah,kazzak,1519,priest,discipline,35,20,15
Crowdd,turalyon,1519,priest,discipline,330,174,156
Sorrybowtdat,tarren-mill,1519,priest,discipline,144,70,74
Castpenance,blackrock,1519,priest,discipline,342,165,177
Noviriel,argent-dawn,1519,priest,discipline,264,123,141
Sixeus,outland,1519,priest,discipline,45,19,26
Verxalas,stormscale,1517,priest,discipline,40,29,11
Телоури,galakrond,1517,priest,discipline,291,146,145
Insekta,ragnaros,1517,priest,discipline,421,211,210
Viroz,blackmoore,1517,priest,discipline,82,41,41
Grimdream,ragnaros,1517,priest,discipline,573,284,289
Øpra,nemesis,1517,priest,discipline,246,111,135
Synnestra,antonidas,1516,priest,discipline,59,34,25
Хальтэнис,gordunni,1516,priest,discipline,83,45,38
Shymouni,norgannon,1516,priest,discipline,65,35,30
Mukake,burning-legion,1516,priest,discipline,479,251,228
Arkkupiispa,stormreaver,1516,priest,discipline,740,372,368
Valforexd,ravencrest,1516,priest,discipline,36,18,18
Mikò,blackmoore,1516,priest,discipline,90,43,47
Bornxgood,kazzak,1516,priest,discipline,78,36,42
Dench,azjolnerub,1516,priest,discipline,84,38,46
Josva,sanguino,1516,priest,discipline,48,21,27
Taanu,quelthalas,1515,priest,discipline,133,75,58
Makrophage,mannoroth,1515,priest,discipline,34,18,16
Openyoureyes,blackrock,1515,priest,discipline,48,25,23
Hötchick,outland,1515,priest,discipline,216,107,109
Nerfpriest,tarren-mill,1515,priest,discipline,400,198,202
Hateyeleison,burning-legion,1515,priest,discipline,108,52,56
Элишана,deathguard,1515,priest,discipline,230,108,122
Kryzenn,hyjal,1515,priest,discipline,129,55,74
Valmar,twisting-nether,1514,priest,discipline,102,60,42
Elyra,the-shatar,1514,priest,discipline,146,84,62
Amnesztia,ragnaros,1514,priest,discipline,141,77,64
Pumpmenow,drakthul,1514,priest,discipline,72,36,36
Lukéy,silvermoon,1514,priest,discipline,66,33,33
Hiddenhealz,blackrock,1514,priest,discipline,60,25,35
Ciqua,frostmane,1513,priest,discipline,66,40,26
Ayumcd,ravencrest,1513,priest,discipline,109,63,46
Ssol,tarren-mill,1513,priest,discipline,126,68,58
Ggsus,outland,1513,priest,discipline,148,77,71
Mâdowk,los-errantes,1513,priest,discipline,570,293,277
Lurri,tarren-mill,1513,priest,discipline,228,116,112
Bottemg,defias-brotherhood,1513,priest,discipline,66,33,33
Mactub,frostwolf,1513,priest,discipline,88,37,51
Лэрикус,howling-fjord,1513,priest,discipline,60,25,35
Ðøìßåx,silvermoon,1512,priest,discipline,96,53,43
Dabzp,twisting-nether,1512,priest,discipline,47,25,22
Prisell,die-aldor,1512,priest,discipline,139,73,66
Göblinpriest,the-maelstrom,1512,priest,discipline,87,45,42
Вутитути,howling-fjord,1512,priest,discipline,132,62,70
Babyx,stormscale,1512,priest,discipline,98,45,53
Bärgarn,tarren-mill,1512,priest,discipline,48,22,26
Büssi,blackrock,1511,priest,discipline,30,19,11
Ciri,die-aldor,1511,priest,discipline,31,18,13
Letmehêal,archimonde,1511,priest,discipline,96,55,41
Astralscare,outland,1511,priest,discipline,163,90,73
Zxèlá,tarren-mill,1511,priest,discipline,149,82,67
Lirou,archimonde,1511,priest,discipline,53,29,24
Kuivatmaat,ravencrest,1511,priest,discipline,30,16,14
Rmt,darksorrow,1511,priest,discipline,75,38,37
Priestlol,outland,1511,priest,discipline,217,107,110
Worldgamer,blackrock,1511,priest,discipline,310,150,160
Mandipriest,aggra-português,1511,priest,discipline,108,50,58
Khrtp,silvermoon,1511,priest,discipline,84,38,46
Blazekk,sylvanas,1511,priest,discipline,127,56,71
Woukitos,drekthar,1511,priest,discipline,60,24,36
Chujzvychodu,drakthul,1510,priest,discipline,42,23,19
Kirchhoffina,die-nachtwache,1510,priest,discipline,49,26,23
Khaag,korgall,1510,priest,discipline,90,47,43
Voidwalkz,kazzak,1510,priest,discipline,41,20,21
Alliora,dalaran,1510,priest,discipline,236,115,121
Исусиприст,deepholm,1510,priest,discipline,54,26,28
Aurorä,burning-legion,1510,priest,discipline,69,33,36
Колдрексх,deathguard,1510,priest,discipline,120,55,65
Alros,elune,1510,priest,discipline,42,18,24
Pumpkin,aggramar,1509,priest,discipline,30,19,11
Discomarcel,burning-legion,1509,priest,discipline,48,27,21
Nûttz,stormscale,1509,priest,discipline,126,69,57
Zïn,silvermoon,1509,priest,discipline,103,55,48
Майндоф,howling-fjord,1509,priest,discipline,90,48,42
Ghoul,destromath,1509,priest,discipline,30,16,14
Lilpi,rexxar,1509,priest,discipline,129,67,62
Priewyn,ragnaros,1509,priest,discipline,351,177,174
Nimbtwink,silvermoon,1508,priest,discipline,83,50,33
Retardé,tarren-mill,1508,priest,discipline,135,76,59
Двелегитоп,howling-fjord,1508,priest,discipline,50,28,22
Healinrbglol,blackmoore,1508,priest,discipline,77,43,34
Knazh,twisting-nether,1508,priest,discipline,38,21,17
Arkatina,outland,1508,priest,discipline,70,38,32
Fabuliciøus,blackrock,1508,priest,discipline,30,16,14
Ethaz,twisting-nether,1508,priest,discipline,30,16,14
Xaeron,eredar,1508,priest,discipline,84,44,40
Isweariheal,twisting-nether,1508,priest,discipline,154,80,74
Healurnanny,aegwynn,1508,priest,discipline,143,72,71
Watchmedeath,sargeras,1508,priest,discipline,73,36,37
Eleatros,blackrock,1508,priest,discipline,112,54,58
Mcdced,archimonde,1508,priest,discipline,141,67,74
Zzoska,burning-legion,1508,priest,discipline,118,51,67
Hoppa,stormscale,1507,priest,discipline,72,48,24
Аришвд,gordunni,1507,priest,discipline,110,65,45
Ledania,aegwynn,1507,priest,discipline,91,52,39
Healicious,teldrassil,1507,priest,discipline,30,16,14
Champp,drakthul,1507,priest,discipline,275,145,130
Goldgot,tarren-mill,1507,priest,discipline,54,28,26
Shînnøk,silvermoon,1507,priest,discipline,289,148,141
Scade,kazzak,1507,priest,discipline,104,52,52
Aguerran,spinebreaker,1507,priest,discipline,132,63,69
Voidsnitch,antonidas,1507,priest,discipline,144,67,77
Hwren,auchindoun,1507,priest,discipline,242,108,134
Mindhøven,veklor,1507,priest,discipline,42,16,26
Cyliaa,aegwynn,1506,priest,discipline,36,20,16
Enoriya,blackrock,1506,priest,discipline,268,143,125
Lianny,sylvanas,1506,priest,discipline,117,61,56
Edoran,ragnaros,1506,priest,discipline,115,59,56
Æxø,draenor,1506,priest,discipline,83,42,41
Rtfmx,outland,1506,priest,discipline,46,23,23
Shrshbilah,kazzak,1506,priest,discipline,138,62,76
Jandice,blackrock,1506,priest,discipline,71,31,40
Stiflersmum,doomhammer,1505,priest,discipline,30,18,12
Carnacia,tarren-mill,1505,priest,discipline,137,81,56
Lasebeak,ravencrest,1505,priest,discipline,115,66,49
Imoz,antonidas,1505,priest,discipline,30,17,13
Yvaini,xavius,1505,priest,discipline,132,72,60
Marymisery,blackhand,1505,priest,discipline,152,81,71
Tutoress,stormscale,1505,priest,discipline,54,25,29
Xîz,silvermoon,1505,priest,discipline,96,43,53
Aexlius,silvermoon,1504,priest,discipline,29,20,9
Ixdeadxl,stormscale,1504,priest,discipline,99,58,41
Têhïcâ,dun-modr,1504,priest,discipline,168,91,77
Ghostroller,pozzo-delleternità,1504,priest,discipline,126,68,58
Staj,blackrock,1504,priest,discipline,30,16,14
Elämäntypy,stormscale,1504,priest,discipline,144,70,74
Supernal,twisting-nether,1504,priest,discipline,72,34,38
Banshzz,ragnaros,1504,priest,discipline,143,67,76
Dotingshadow,tarren-mill,1503,priest,discipline,53,38,15
Рвотка,gordunni,1503,priest,discipline,184,96,88
Eîkro,blackmoore,1503,priest,discipline,96,47,49
Sodomizing,kazzak,1503,priest,discipline,77,37,40
Jacksonz,blackmoore,1503,priest,discipline,42,17,25
Deicidex,blackrock,1503,priest,discipline,78,28,50
Icutebiker,nagrand,1502,priest,discipline,101,61,40
Thejambura,ragnaros,1502,priest,discipline,157,87,70
Ximya,kazzak,1502,priest,discipline,139,75,64
Sebekklawl,wrathbringer,1502,priest,discipline,103,54,49
Spoggle,kazzak,1502,priest,discipline,131,67,64
Lipoatrofia,sanguino,1502,priest,discipline,214,104,110
Tiragosaure,arakarahm,1502,priest,discipline,105,51,54
Chamelthoe,the-maelstrom,1502,priest,discipline,126,59,67
Saénna,burning-legion,1502,priest,discipline,62,26,36
Maskinjundre,bronzebeard,1502,priest,discipline,51,21,30
Dreadx,antonidas,1501,priest,discipline,157,83,74
Alphabreyf,tarren-mill,1501,priest,discipline,161,82,79
Greyanna,twisting-nether,1501,priest,discipline,231,112,119
Preachyjeg,ravencrest,1501,priest,discipline,269,130,139
Nometalol,drakthul,1501,priest,discipline,36,16,20
Дюшапинанс,soulflayer,1500,priest,discipline,92,54,38
Malyzion,draenor,1500,priest,discipline,253,142,111
Rasha,kazzak,1500,priest,discipline,117,64,53
Мьюсх,deathguard,1500,priest,discipline,77,42,35
Priesticchi,stormscale,1500,priest,discipline,222,119,103
Sbeecha,argent-dawn,1500,priest,discipline,180,87,93
Dreamhatcher,deathwing,1500,priest,discipline,42,18,24
Arya,dunemaul,1500,priest,discipline,48,20,28
Dapope,drakthul,1500,priest,discipline,107,43,64
Selëne,blackrock,1499,priest,discipline,51,29,22
Mzpriest,dalaran,1499,priest,discipline,106,57,49
Tintapri,aszune,1499,priest,discipline,152,81,71
Sensor,kazzak,1499,priest,discipline,127,67,60
Nandezpriest,blackrock,1499,priest,discipline,214,111,103
Snoopqt,dalaran,1499,priest,discipline,296,151,145
Byzzi,draenor,1499,priest,discipline,221,107,114
Merkabrah,sylvanas,1499,priest,discipline,98,47,51
Disillusíon,tarren-mill,1499,priest,discipline,156,74,82
Holyxqt,blackrock,1498,priest,discipline,114,68,46
Sîarra,eredar,1498,priest,discipline,156,89,67
Holywann,argent-dawn,1498,priest,discipline,89,50,39
Crims,twisting-nether,1498,priest,discipline,150,83,67
Safemode,ravencrest,1498,priest,discipline,83,45,38
Shagan,archimonde,1498,priest,discipline,72,39,33
Shenkt,ravenholdt,1498,priest,discipline,30,16,14
Squidlicker,twisting-nether,1498,priest,discipline,112,58,54
Boarheals,blackmoore,1498,priest,discipline,107,54,53
Ascindra,ravencrest,1498,priest,discipline,36,18,18
Tuitio,blackmoore,1498,priest,discipline,132,65,67
Darknun,aggra-português,1498,priest,discipline,195,90,105
Vanillahaze,sylvanas,1497,priest,discipline,81,53,28
Klemi,dun-modr,1497,priest,discipline,72,42,30
Diarolz,sanguino,1497,priest,discipline,81,46,35
Чтоподелать,soulflayer,1497,priest,discipline,89,49,40
Holysheett,magtheridon,1497,priest,discipline,156,82,74
Chocoly,tarren-mill,1497,priest,discipline,137,70,67
Viì,ravencrest,1497,priest,discipline,69,35,34
Prästpojken,frostwhisper,1497,priest,discipline,222,107,115
Arctoczax,ravencrest,1497,priest,discipline,102,46,56
Wiildsy,tarren-mill,1497,priest,discipline,65,29,36
Hìld,blackmoore,1497,priest,discipline,36,16,20
Cbsad,madmortem,1496,priest,discipline,135,72,63
Juco,draenor,1496,priest,discipline,153,80,73
Huffinctus,tarren-mill,1496,priest,discipline,118,61,57
Atax,kazzak,1496,priest,discipline,474,238,236
Saitani,stormscale,1496,priest,discipline,59,28,31
Lokíe,ragnaros,1496,priest,discipline,48,19,29
Creigmorg,sanguino,1495,priest,discipline,96,50,46
Madkes,ravencrest,1495,priest,discipline,371,192,179
Badhêalz,aegwynn,1495,priest,discipline,181,92,89
Chôrdi,aegwynn,1495,priest,discipline,249,125,124
Døgfîsh,stormscale,1495,priest,discipline,148,72,76
Ihaveibs,doomhammer,1495,priest,discipline,163,79,84
Rezzurrectum,doomhammer,1495,priest,discipline,111,52,59
Aïezn,culte-de-la-rive-noire,1495,priest,discipline,206,93,113
Zealtron,darksorrow,1495,priest,discipline,98,44,54
Onetwo,silvermoon,1494,priest,discipline,30,18,12
Drawun,burning-legion,1494,priest,discipline,116,67,49
Enzyme,drakthul,1494,priest,discipline,84,48,36
Ballsbrawlz,sylvanas,1494,priest,discipline,48,27,21
Dairox,blackrock,1494,priest,discipline,175,94,81
Lolipopheal,blackmoore,1494,priest,discipline,60,32,28
Juggster,bloodhoof,1494,priest,discipline,186,95,91
Атэистотбога,gordunni,1494,priest,discipline,124,63,61
Subha,drakthul,1493,priest,discipline,71,46,25
Oldkaiz,shattered-hand,1493,priest,discipline,111,66,45
Levimm,turalyon,1493,priest,discipline,598,312,286
Hexenmeister,laughing-skull,1493,priest,discipline,69,36,33
Keimohansío,draenor,1493,priest,discipline,117,60,57
Huzlin,kazzak,1493,priest,discipline,262,134,128
Makemyday,dun-modr,1493,priest,discipline,107,53,54
Invexx,tarren-mill,1493,priest,discipline,492,241,251
Avgenjoyer,kazzak,1493,priest,discipline,281,136,145
Nubso,aegwynn,1493,priest,discipline,66,31,35
Chrispriest,argent-dawn,1493,priest,discipline,62,28,34
Myrann,ravencrest,1492,priest,discipline,36,21,15
Levinson,zuljin,1492,priest,discipline,275,153,122
Ylivoima,stormscale,1492,priest,discipline,182,100,82
Shadowsig,silvermoon,1492,priest,discipline,311,163,148
Khâlîa,archimonde,1492,priest,discipline,162,81,81
Zofiiee,tarren-mill,1492,priest,discipline,167,78,89
Tinpr,sanguino,1492,priest,discipline,111,50,61
Dezó,stormscale,1491,priest,discipline,23,16,7
Ursela,tarren-mill,1491,priest,discipline,66,41,25
Остроухх,howling-fjord,1491,priest,discipline,180,93,87
Zuigen,lightbringer,1491,priest,discipline,122,60,62
Niketn,aegwynn,1491,priest,discipline,36,17,19
Nimsi,ravencrest,1491,priest,discipline,36,16,20
Quintanaro,thrall,1491,priest,discipline,51,19,32
Ysharrj,hyjal,1490,priest,discipline,105,57,48
Aasgard,frostwolf,1490,priest,discipline,134,67,67
Hunfall,stormscale,1490,priest,discipline,148,73,75
Keyfear,kazzak,1490,priest,discipline,99,48,51
Kurt,blackrock,1490,priest,discipline,154,74,80
Dadheal,dalaran,1490,priest,discipline,54,24,30
Eagleess,silvermoon,1489,priest,discipline,72,43,29
Holydisease,tarren-mill,1489,priest,discipline,36,21,15
Jaatjak,ravencrest,1489,priest,discipline,114,61,53
Meiyah,draenor,1489,priest,discipline,95,49,46
Олегстразза,howling-fjord,1489,priest,discipline,426,216,210
Leyasu,eredar,1489,priest,discipline,81,40,41
Lâughing,ravencrest,1488,priest,discipline,129,72,57
Ceraghk,tichondrius,1488,priest,discipline,144,76,68
Kinkykaren,kazzak,1488,priest,discipline,139,72,67
Auntbessy,outland,1488,priest,discipline,91,47,44
Targolina,argent-dawn,1488,priest,discipline,796,399,397
ßøpe,khaz-modan,1488,priest,discipline,42,21,21
Priszt,arathor,1488,priest,discipline,85,42,43
Disturbdtwo,archimonde,1488,priest,discipline,72,35,37
Cav,archimonde,1488,priest,discipline,194,94,100
Mamis,anetheron,1488,priest,discipline,84,39,45
Rîhanna,sanguino,1487,priest,discipline,51,31,20
Jodge,ravencrest,1487,priest,discipline,102,59,43
Vdwayne,argent-dawn,1487,priest,discipline,149,76,73
Bøts,ravencrest,1487,priest,discipline,841,424,417
Marryisme,twisting-nether,1487,priest,discipline,271,135,136
Ptsd,argent-dawn,1487,priest,discipline,114,53,61
Çelph,silvermoon,1487,priest,discipline,80,35,45
Kobri,gilneas,1486,priest,discipline,251,131,120
Wakeybakey,tarren-mill,1486,priest,discipline,338,173,165
Гизамуррис,howling-fjord,1486,priest,discipline,48,24,24
Triuna,sylvanas,1486,priest,discipline,41,20,21
Yugata,archimonde,1486,priest,discipline,121,53,68
Lythi,eredar,1486,priest,discipline,126,55,71
Mewpew,azjolnerub,1486,priest,discipline,54,23,31
Merrysmiting,ravencrest,1486,priest,discipline,42,16,26
Eotlin,shattered-hand,1485,priest,discipline,60,34,26
Shedzinty,tarren-mill,1485,priest,discipline,124,68,56
Ðiscobiscuit,argent-dawn,1485,priest,discipline,116,62,54
Saintsense,outland,1485,priest,discipline,120,64,56
Elegosht,sanguino,1485,priest,discipline,143,75,68
Senosaurus,tarren-mill,1485,priest,discipline,147,71,76
Äkvä,ragnaros,1485,priest,discipline,78,32,46
Erikssan,stormscale,1485,priest,discipline,55,22,33
Sàvia,pozzo-delleternità,1485,priest,discipline,54,18,36
Hölykiwi,silvermoon,1484,priest,discipline,29,17,12
Nightfearqt,outland,1484,priest,discipline,134,72,62
Diszi,norgannon,1484,priest,discipline,78,35,43
Лоео,ashenvale,1484,priest,discipline,114,51,63
Coldsigil,argent-dawn,1483,priest,discipline,63,32,31
Strahle,frostwolf,1483,priest,discipline,44,17,27
Justrebeccap,kazzak,1482,priest,discipline,30,20,10
Пристяо,howling-fjord,1482,priest,discipline,231,131,100
Cäandy,dalaran,1482,priest,discipline,70,39,31
Dalylla,aggra-português,1482,priest,discipline,123,65,58
Nuraschka,antonidas,1482,priest,discipline,36,18,18
Vaßpera,tarren-mill,1481,priest,discipline,39,19,20
Unheal,thrall,1481,priest,discipline,69,33,36
Inzàné,kazzak,1481,priest,discipline,101,47,54
Laxímink,sylvanas,1481,priest,discipline,119,51,68
Deadmous,sanguino,1480,priest,discipline,60,43,17
Êvîlêvê,blackmoore,1480,priest,discipline,100,57,43
Холишитс,gordunni,1480,priest,discipline,190,107,83
Derylium,kazzak,1480,priest,discipline,152,84,68
Southyz,stormscale,1480,priest,discipline,129,67,62
Spiriman,zuljin,1480,priest,discipline,132,67,65
Angelic,ragnaros,1480,priest,discipline,213,105,108
Healiröva,stormscale,1480,priest,discipline,44,21,23
Mortarz,ragnaros,1480,priest,discipline,101,45,56
Noxth,blackmoore,1480,priest,discipline,42,18,24
Ehther,dun-modr,1479,priest,discipline,64,38,26
Lapinvicieux,archimonde,1479,priest,discipline,84,48,36
Mylox,blackrock,1479,priest,discipline,93,48,45
Blackheall,nemesis,1479,priest,discipline,46,23,23
Phipham,frostwolf,1479,priest,discipline,36,17,19
Джелесана,gordunni,1479,priest,discipline,99,45,54
Tech,shattered-hand,1479,priest,discipline,59,24,35
Snylia,blackrock,1479,priest,discipline,66,25,41
Rwaphouu,ysondre,1478,priest,discipline,99,59,40
Cidrea,saurfang,1478,priest,discipline,30,17,13
Annisa,kazzak,1478,priest,discipline,201,112,89
Thaiboimby,veknilash,1478,priest,discipline,481,251,230
Zøid,ysondre,1478,priest,discipline,58,30,28
Hardcode,twisting-nether,1478,priest,discipline,132,67,65
Ihealzem,tarren-mill,1478,priest,discipline,48,23,25
Shkzz,hyjal,1477,priest,discipline,217,124,93
Synoé,la-croisade-écarlate,1477,priest,discipline,119,61,58
Kollis,twilights-hammer,1477,priest,discipline,251,125,126
Pretee,nemesis,1477,priest,discipline,54,25,29
Deesy,aegwynn,1476,priest,discipline,30,22,8
Rikipope,ravencrest,1476,priest,discipline,89,48,41
Vogelfrau,ravencrest,1476,priest,discipline,143,74,69
Mahalik,blackhand,1476,priest,discipline,53,27,26
Lhh,blackmoore,1476,priest,discipline,127,64,63
Фруктовыйса,gordunni,1476,priest,discipline,134,63,71
Xytael,burning-legion,1476,priest,discipline,66,31,35
Pöppers,ysondre,1476,priest,discipline,127,44,83
Gorti,ravencrest,1475,priest,discipline,30,16,14
Крутосанка,blackscar,1475,priest,discipline,72,38,34
Soulreapper,blackhand,1475,priest,discipline,301,158,143
Happyprocs,dun-modr,1475,priest,discipline,77,40,37
Keewix,ysondre,1475,priest,discipline,95,46,49
Lydîâ,blackhand,1475,priest,discipline,35,16,19
Isadian,kazzak,1475,priest,discipline,57,24,33
Ninetzz,tarren-mill,1474,priest,discipline,48,34,14
Barnicha,grim-batol,1474,priest,discipline,42,26,16
Hailor,blackmoore,1474,priest,discipline,54,32,22
Bubidiblumpr,twisting-nether,1474,priest,discipline,126,72,54
Kratzîgel,blackmoore,1474,priest,discipline,137,76,61
Battra,argent-dawn,1474,priest,discipline,84,45,39
Buzzy,twisting-nether,1474,priest,discipline,144,75,69
Phasmöphobia,zuljin,1474,priest,discipline,249,120,129
Zoose,silvermoon,1474,priest,discipline,78,36,42
Aeritha,blackmoore,1473,priest,discipline,53,32,21
Jána,argent-dawn,1473,priest,discipline,96,57,39
Adonallsium,sylvanas,1473,priest,discipline,75,44,31
Decísíon,aegwynn,1473,priest,discipline,150,85,65
Luuña,ravencrest,1473,priest,discipline,214,112,102
Vilanae,hyjal,1473,priest,discipline,361,188,173
Sànká,ysondre,1472,priest,discipline,48,27,21
Гшд,gordunni,1472,priest,discipline,128,71,57
Mercies,kazzak,1472,priest,discipline,63,34,29
Dartheon,twisting-nether,1472,priest,discipline,348,175,173
Niholie,sinstralis,1472,priest,discipline,96,43,53
Жариха,gordunni,1471,priest,discipline,120,66,54
Wâneis,stormscale,1471,priest,discipline,279,142,137
Спсчтоживой,blackscar,1471,priest,discipline,189,93,96
Purebollox,twisting-nether,1471,priest,discipline,78,35,43
Omgitshuux,blackmoore,1471,priest,discipline,126,56,70
Волия,gordunni,1471,priest,discipline,41,16,25
Вичкрафт,howling-fjord,1471,priest,discipline,60,23,37
Porklifer,tarren-mill,1470,priest,discipline,54,32,22
Xeay,blackrock,1470,priest,discipline,42,24,18
Maneipriest,drakthul,1470,priest,discipline,65,35,30
Dêxter,hyjal,1470,priest,discipline,144,72,72
Ruly,ragnaros,1470,priest,discipline,69,33,36
Axxul,blackrock,1470,priest,discipline,97,46,51
Vorynax,silvermoon,1470,priest,discipline,92,42,50
Virulent,nemesis,1470,priest,discipline,60,27,33
Luuniisboost,blackmoore,1470,priest,discipline,42,16,26
Warm,auchindoun,1469,priest,discipline,45,32,13
Hypernym,eredar,1469,priest,discipline,38,25,13
Joojee,tarren-mill,1469,priest,discipline,138,77,61
Housty,chamber-of-aspects,1469,priest,discipline,36,19,17
Bløøððåñçé,ragnaros,1469,priest,discipline,42,22,20
Влажныйшп,soulflayer,1469,priest,discipline,78,40,38
Leerzeichen,aegwynn,1469,priest,discipline,95,47,48
Madrobert,outland,1469,priest,discipline,65,32,33
Abdibio,twisting-nether,1469,priest,discipline,48,23,25
Архиэрей,soulflayer,1469,priest,discipline,80,37,43
Okfartpå,ravencrest,1468,priest,discipline,30,22,8
Атинка,gordunni,1468,priest,discipline,60,35,25
Jazzmind,stormscale,1468,priest,discipline,180,93,87
Klituriis,twisting-nether,1468,priest,discipline,113,58,55
Pewkz,draenor,1468,priest,discipline,164,83,81
Marllen,twisting-nether,1468,priest,discipline,443,220,223
Nàvy,archimonde,1468,priest,discipline,39,19,20
Lucidluke,blackmoore,1468,priest,discipline,103,49,54
Scarified,aggramar,1468,priest,discipline,89,40,49
Cptmoigx,antonidas,1468,priest,discipline,69,27,42
Kalisya,ravencrest,1468,priest,discipline,63,24,39
Фикспрайз,gordunni,1467,priest,discipline,30,16,14
Вишнях,soulflayer,1467,priest,discipline,48,24,24
Sadgepriest,draenor,1467,priest,discipline,36,18,18
Jimmymcgill,ravencrest,1467,priest,discipline,34,16,18
Aurunea,blackrock,1466,priest,discipline,69,40,29
Fluba,thrall,1466,priest,discipline,89,50,39
Hellsaya,ysondre,1466,priest,discipline,126,69,57
Argaar,burning-legion,1466,priest,discipline,179,98,81
Txz,kazzak,1466,priest,discipline,120,65,55
Cárith,nemesis,1466,priest,discipline,74,40,34
Alakkiria,ravencrest,1466,priest,discipline,129,66,63
Sameec,drakthul,1466,priest,discipline,147,72,75
Gingerflexay,archimonde,1466,priest,discipline,66,32,34
Yákizå,darksorrow,1466,priest,discipline,72,30,42
Бленди,howling-fjord,1466,priest,discipline,65,27,38
Massdispell,silvermoon,1465,priest,discipline,70,40,30
Myxeh,ravencrest,1465,priest,discipline,73,39,34
Morenetä,dun-modr,1465,priest,discipline,72,38,34
Тэтэшник,ashenvale,1465,priest,discipline,230,117,113
Willenskraft,outland,1465,priest,discipline,54,26,28
Zatón,dun-modr,1465,priest,discipline,66,31,35
Sherbanger,argent-dawn,1465,priest,discipline,48,22,26
Reeta,stormscale,1464,priest,discipline,55,31,24
Viagrà,outland,1464,priest,discipline,138,63,75
Injured,bronzebeard,1464,priest,discipline,42,19,23
Ziemkentiss,kazzak,1464,priest,discipline,51,23,28
Ragelogoouut,draenor,1464,priest,discipline,84,37,47
Geierlol,blackrock,1464,priest,discipline,42,17,25
Cezzar,kazzak,1463,priest,discipline,83,48,35
Viroxian,outland,1463,priest,discipline,199,112,87
Getötet,blackrock,1463,priest,discipline,138,76,62
Швдвшип,deathweaver,1463,priest,discipline,45,24,21
Diskogoblin,drakthul,1463,priest,discipline,36,19,17
Arrlina,magtheridon,1463,priest,discipline,131,64,67
Hombre,anetheron,1463,priest,discipline,39,19,20
Рмпим,howling-fjord,1463,priest,discipline,54,17,37
Ецци,howling-fjord,1462,priest,discipline,68,37,31
Anniegelic,ravencrest,1462,priest,discipline,184,91,93
Boysa,earthen-ring,1462,priest,discipline,126,58,68
Ботхесатва,deepholm,1462,priest,discipline,77,35,42
Amoxkys,nemesis,1462,priest,discipline,86,39,47
Eompriest,magtheridon,1462,priest,discipline,48,21,27
Dubai,silvermoon,1462,priest,discipline,52,17,35
Yomominmedm,draenor,1461,priest,discipline,72,41,31
Zoose,defias-brotherhood,1461,priest,discipline,44,25,19
Tallzoné,ravencrest,1461,priest,discipline,213,113,100
Noany,ravencrest,1461,priest,discipline,128,67,61
Celiara,argent-dawn,1461,priest,discipline,183,95,88
Spánkproof,kazzak,1461,priest,discipline,60,30,30
Suaakypriest,tyrande,1461,priest,discipline,48,24,24
Нэстикус,gordunni,1461,priest,discipline,78,38,40
Tarîs,archimonde,1461,priest,discipline,144,66,78
Painkillrz,twisting-nether,1461,priest,discipline,60,25,35
Elizabéth,blackrock,1460,priest,discipline,43,26,17
Nurbanu,ravencrest,1460,priest,discipline,83,50,33
Вайтбласт,howling-fjord,1460,priest,discipline,36,21,15
Evilangèl,ravenholdt,1460,priest,discipline,139,76,63
Алуриэлия,gordunni,1460,priest,discipline,135,67,68
Урголиафа,howling-fjord,1460,priest,discipline,111,54,57
Дармирэль,gordunni,1460,priest,discipline,87,42,45
Трихоманиаз,ashenvale,1460,priest,discipline,96,45,51
Пнух,soulflayer,1460,priest,discipline,150,70,80
Cúrt,sanguino,1460,priest,discipline,78,36,42
Rzkp,eredar,1460,priest,discipline,39,17,22
Deadonmyscrn,ravencrest,1459,priest,discipline,60,46,14
Mamoltte,draenor,1459,priest,discipline,30,23,7
Joseantuan,sanguino,1459,priest,discipline,72,41,31
Kijul,ragnaros,1459,priest,discipline,154,85,69
Ocepriest,twisting-nether,1459,priest,discipline,86,45,41
Yukíø,antonidas,1459,priest,discipline,305,158,147
Zenholy,kazzak,1459,priest,discipline,114,59,55
Maeline,archimonde,1459,priest,discipline,224,115,109
Fetmeister,drakthul,1459,priest,discipline,72,36,36
Nÿpô,hyjal,1459,priest,discipline,89,40,49
Stàrlîght,chants-éternels,1458,priest,discipline,30,19,11
Damnatíon,ravencrest,1458,priest,discipline,46,29,17
Dømini,tarren-mill,1458,priest,discipline,88,52,36
Justkorèan,stormscale,1458,priest,discipline,54,29,25
Marylin,senjin,1458,priest,discipline,725,373,352
Änf,silvermoon,1458,priest,discipline,132,67,65
Gobie,sunstrider,1458,priest,discipline,80,38,42
Doktoritca,kazzak,1458,priest,discipline,90,38,52
Мдзшка,gordunni,1457,priest,discipline,1559,779,780
Jesuita,dun-modr,1457,priest,discipline,143,70,73
Faíht,blackrock,1457,priest,discipline,78,36,42
Jetlìfe,ysondre,1457,priest,discipline,48,20,28
Holymöly,archimonde,1457,priest,discipline,61,25,36
Dwel,bloodfeather,1457,priest,discipline,59,22,37
Amanojakü,ravencrest,1456,priest,discipline,78,50,28
Deadpxlz,ravencrest,1456,priest,discipline,42,25,17
Ysaril,archimonde,1456,priest,discipline,36,20,16
Yuuvi,ravencrest,1456,priest,discipline,335,173,162
Selenee,scarshield-legion,1456,priest,discipline,180,89,91
Sedu,draenor,1456,priest,discipline,66,32,34
Рокрон,galakrond,1456,priest,discipline,114,53,61
Лизота,gordunni,1456,priest,discipline,93,42,51
Sémi,twisting-nether,1455,priest,discipline,60,34,26
Kåstå,archimonde,1455,priest,discipline,92,51,41
Nestiah,hyjal,1455,priest,discipline,42,22,20
Taiyöshin,silvermoon,1455,priest,discipline,112,58,54
Teladorne,ravencrest,1455,priest,discipline,36,17,19
Clapclap,frostmourne,1455,priest,discipline,99,46,53
Dènna,eldrethalas,1455,priest,discipline,66,30,36
Xaizn,arthas,1454,priest,discipline,116,66,50
Helikipope,kazzak,1454,priest,discipline,48,25,23
Докторпэйн,howling-fjord,1454,priest,discipline,257,133,124
Moustafaz,archimonde,1454,priest,discipline,45,22,23
Holyshart,magtheridon,1454,priest,discipline,119,58,61
Ralph,kazzak,1454,priest,discipline,78,29,49
Burka,aegwynn,1453,priest,discipline,27,20,7
Yusepmikel,cthun,1453,priest,discipline,62,40,22
Джахия,soulflayer,1453,priest,discipline,331,169,162
Pedopräst,stormscale,1453,priest,discipline,83,42,41
Sînálà,antonidas,1453,priest,discipline,86,43,43
ßabylexa,ravencrest,1453,priest,discipline,224,107,117
Øtîs,aegwynn,1453,priest,discipline,74,35,39
Xerxsiss,frostwolf,1453,priest,discipline,96,45,51
Doomey,ravencrest,1452,priest,discipline,59,33,26
Ræpriestx,ragnaros,1452,priest,discipline,167,90,77
Sickwill,blackrock,1452,priest,discipline,58,30,28
Zedrus,azshara,1452,priest,discipline,147,72,75
Fearmongerer,tarren-mill,1451,priest,discipline,29,19,10
Strikérlayá,aegwynn,1451,priest,discipline,107,52,55
Aviz,tarren-mill,1451,priest,discipline,36,17,19
Dotdotggwp,stormscale,1451,priest,discipline,120,56,64
Netherp,twisting-nether,1450,priest,discipline,42,26,16
Halastrâ,tarren-mill,1450,priest,discipline,86,53,33
Alianza,hellfire,1450,priest,discipline,84,50,34
Krayziest,tarren-mill,1450,priest,discipline,51,30,21
Thorhammer,turalyon,1450,priest,discipline,72,42,30
Maidie,stormscale,1450,priest,discipline,107,62,45
Kyri,stormscale,1450,priest,discipline,210,119,91
Jimmbosmite,stormscale,1450,priest,discipline,95,52,43
Joyfu,archimonde,1450,priest,discipline,113,61,52
Rustyroll,stormscale,1450,priest,discipline,135,72,63
Reól,blackmoore,1450,priest,discipline,54,28,26
Holyfussell,antonidas,1450,priest,discipline,110,57,53
Skuhlx,blackrock,1450,priest,discipline,175,89,86
Relaxmom,bloodhoof,1450,priest,discipline,60,30,30
Холиблэк,blackscar,1450,priest,discipline,96,40,56
Kozmopi,blackhand,1449,priest,discipline,35,24,11
Exorcizamus,khaz-modan,1449,priest,discipline,30,18,12
Seinaruki,emerald-dream,1449,priest,discipline,100,57,43
Nhaisu,silvermoon,1449,priest,discipline,30,16,14
Sheshan,destromath,1449,priest,discipline,111,57,54
Akemmì,sylvanas,1449,priest,discipline,180,89,91
Сатанчикгод,howling-fjord,1449,priest,discipline,256,121,135
Kopperuud,stormscale,1449,priest,discipline,66,30,36
Ebashuvkashu,stormscale,1448,priest,discipline,94,50,44
Vanadii,blackhand,1448,priest,discipline,96,51,45
Baybe,ravencrest,1448,priest,discipline,266,138,128
Vanillå,silvermoon,1448,priest,discipline,84,41,43
Deepsea,kazzak,1448,priest,discipline,583,284,299
Clodet,dun-modr,1448,priest,discipline,49,19,30
ßøjèñkâ,ravencrest,1447,priest,discipline,32,21,11
Cring,kirin-tor,1447,priest,discipline,150,85,65
Palaniax,outland,1447,priest,discipline,48,26,22
Rightx,outland,1447,priest,discipline,371,192,179
Minsie,silvermoon,1447,priest,discipline,104,52,52
Djvoodoo,ahnqiraj,1447,priest,discipline,60,23,37
Raphyx,blackhand,1447,priest,discipline,54,16,38
Ingvár,blackrock,1446,priest,discipline,24,16,8
Daddyfinger,argent-dawn,1446,priest,discipline,139,76,63
Aesyla,drakthul,1446,priest,discipline,69,37,32
Starnote,auchindoun,1446,priest,discipline,151,80,71
Тенсаи,howling-fjord,1446,priest,discipline,92,48,44
Floory,twisting-nether,1446,priest,discipline,347,181,166
Friskï,silvermoon,1446,priest,discipline,60,31,29
Stahj,sanguino,1446,priest,discipline,88,45,43
Cé,magtheridon,1446,priest,discipline,137,69,68
Ilovedisc,kazzak,1446,priest,discipline,62,31,31
Papkalácss,hellfire,1446,priest,discipline,104,51,53
Меинбиг,gordunni,1446,priest,discipline,70,34,36
Аматури,soulflayer,1446,priest,discipline,54,26,28
Líín,hyjal,1446,priest,discipline,97,46,51
Absinthamos,eredar,1446,priest,discipline,70,30,40
Flaskandeux,tarren-mill,1446,priest,discipline,248,104,144
Ромиопвп,gordunni,1446,priest,discipline,57,22,35
Gâmeøvr,sanguino,1445,priest,discipline,93,53,40
ßlowska,hyjal,1445,priest,discipline,91,50,41
Klosso,anachronos,1445,priest,discipline,78,42,36
Wizmek,silvermoon,1445,priest,discipline,144,75,69
Chrì,argent-dawn,1445,priest,discipline,84,43,41
Kimozabi,ravencrest,1445,priest,discipline,74,37,37
Dreamscapez,tarren-mill,1445,priest,discipline,127,61,66
Reivno,ravencrest,1444,priest,discipline,54,33,21
Radulfus,stormrage,1444,priest,discipline,42,25,17
Deluuxelawl,ysondre,1444,priest,discipline,64,38,26
Серыйлог,galakrond,1444,priest,discipline,90,49,41
Syro,defias-brotherhood,1444,priest,discipline,150,77,73
Toorree,stormscale,1444,priest,discipline,161,82,79
Comple,kazzak,1444,priest,discipline,54,27,27
Пэйтен,deathguard,1444,priest,discipline,42,21,21
Luziz,blackmoore,1444,priest,discipline,69,34,35
Fåtkidx,ravencrest,1444,priest,discipline,126,62,64
Antibiotike,hyjal,1443,priest,discipline,46,27,19
Fakebob,draenor,1443,priest,discipline,72,42,30
Юлих,booty-bay,1443,priest,discipline,394,196,198
Tamy,draenor,1443,priest,discipline,122,59,63
Hellmione,blackmoore,1443,priest,discipline,112,44,68
Cinjá,thrall,1443,priest,discipline,67,26,41
Sombralúz,sanguino,1442,priest,discipline,36,20,16
Aizakku,frostmane,1442,priest,discipline,36,19,17
Fericul,argent-dawn,1442,priest,discipline,280,147,133
Schmetter,tarren-mill,1442,priest,discipline,31,16,15
Gotikaa,blackrock,1442,priest,discipline,168,84,84
Xet,outland,1442,priest,discipline,165,81,84
Shanny,kazzak,1442,priest,discipline,89,43,46
Ёджих,blackscar,1442,priest,discipline,145,70,75
Krasawìtch,onyxia,1442,priest,discipline,117,54,63
Chibrausorus,archimonde,1442,priest,discipline,66,30,36
Randomm,shadowsong,1442,priest,discipline,78,33,45
Oneheal,rexxar,1442,priest,discipline,55,23,32
Мачя,gordunni,1441,priest,discipline,50,39,11
Щявыхилим,howling-fjord,1441,priest,discipline,139,82,57
Endlin,silvermoon,1441,priest,discipline,78,46,32
Hyggêê,sanguino,1441,priest,discipline,53,31,22
Ðotgød,nemesis,1441,priest,discipline,42,24,18
Troublemaker,durotan,1441,priest,discipline,126,68,58
Arize,dun-modr,1441,priest,discipline,440,221,219
Fxd,talnivarr,1441,priest,discipline,98,48,50
Arima,kargath,1441,priest,discipline,186,91,95
Käji,silvermoon,1441,priest,discipline,93,44,49
Manethø,twisting-nether,1441,priest,discipline,36,16,20
Søkariss,elune,1440,priest,discipline,48,28,20
Garfriest,aggra-português,1440,priest,discipline,117,67,50
Mylini,silvermoon,1440,priest,discipline,201,104,97
Смегмачет,soulflayer,1440,priest,discipline,122,63,59
Sordag,lordaeron,1440,priest,discipline,108,48,60
Lyés,uldaman,1439,priest,discipline,247,141,106
Гачибунта,blackscar,1439,priest,discipline,213,117,96
Eros,illidan,1439,priest,discipline,126,67,59
Bedkara,ravencrest,1439,priest,discipline,30,15,15
Zeraphïn,eredar,1439,priest,discipline,30,15,15
Voxqt,blackrock,1439,priest,discipline,30,15,15
Зонкк,thermaplugg,1439,priest,discipline,180,87,93
Мненосина,goldrinn,1439,priest,discipline,186,88,98
Zeslash,suramar,1439,priest,discipline,99,45,54
Moarein,twisting-nether,1439,priest,discipline,89,39,50
Jackyz,tarren-mill,1439,priest,discipline,96,35,61
Blackchrist,uldum,1438,priest,discipline,159,85,74
Roskva,archimonde,1438,priest,discipline,33,17,16
Bandgap,antonidas,1438,priest,discipline,235,118,117
Тодохил,gordunni,1438,priest,discipline,232,113,119
Miraev,argent-dawn,1438,priest,discipline,60,29,31
Ascendare,tarren-mill,1438,priest,discipline,149,69,80
Lastchance,ravencrest,1438,priest,discipline,36,15,21
Shakalol,kazzak,1438,priest,discipline,39,16,23
Åshbé,archimonde,1437,priest,discipline,18,15,3
Hopeso,silvermoon,1437,priest,discipline,18,15,3
Fakéy,draenor,1437,priest,discipline,35,26,9
Cazã,archimonde,1437,priest,discipline,24,15,9
Causa,blackhand,1437,priest,discipline,85,51,34
Thanil,bloodfeather,1437,priest,discipline,148,78,70
Zulcas,outland,1437,priest,discipline,48,25,23
Трезида,gordunni,1437,priest,discipline,102,53,49
Властьтени,gordunni,1437,priest,discipline,274,136,138
Fotmape,stormscale,1437,priest,discipline,36,15,21
Yaaoz,dun-modr,1437,priest,discipline,36,15,21
Carzn,blackmoore,1436,priest,discipline,96,51,45
Shavog,stormscale,1436,priest,discipline,42,22,20
Фейкай,blackscar,1436,priest,discipline,66,33,33
Oxborn,thrall,1436,priest,discipline,167,83,84
Dotdeath,ravencrest,1436,priest,discipline,189,92,97
Nyah,dun-modr,1436,priest,discipline,36,17,19
Kbakå,stormscale,1436,priest,discipline,84,37,47
Fraydo,argent-dawn,1436,priest,discipline,48,21,27
Schockerjr,blackmoore,1436,priest,discipline,80,34,46
Voldream,ravencrest,1436,priest,discipline,73,29,44
Divinekat,tarren-mill,1435,priest,discipline,76,48,28
Lushipri,blackhand,1435,priest,discipline,113,63,50
Anbish,burning-legion,1435,priest,discipline,401,204,197
Nahni,teldrassil,1435,priest,discipline,307,142,165
Tinre,ravenholdt,1435,priest,discipline,96,43,53
Orkanwal,ravencrest,1434,priest,discipline,24,15,9
Bynd,blackrock,1434,priest,discipline,56,33,23
Бэнэльф,soulflayer,1434,priest,discipline,69,36,33
Pristess,thrall,1434,priest,discipline,123,64,59
Голубчикпро,lich-king,1434,priest,discipline,30,15,15
Kæyc,blackmoore,1434,priest,discipline,71,35,36
Zarozina,pozzo-delleternità,1434,priest,discipline,102,48,54
Rhäenÿra,hyjal,1433,priest,discipline,30,18,12
Negmatoda,ravencrest,1433,priest,discipline,27,16,11
Galadrielkä,drakthul,1433,priest,discipline,166,89,77
Dunkelseele,ahnqiraj,1433,priest,discipline,30,16,14
Simplesam,ravencrest,1433,priest,discipline,94,49,45
Onicolla,terokkar,1433,priest,discipline,192,99,93
Schmatzy,blackmoore,1433,priest,discipline,78,40,38
Berrylee,twisting-nether,1433,priest,discipline,95,46,49
Баптисто,gordunni,1433,priest,discipline,59,26,33
Bigwik,tarren-mill,1433,priest,discipline,42,15,27
Ghostee,twisting-nether,1432,priest,discipline,35,24,11
Junglepls,burning-blade,1432,priest,discipline,24,15,9
Brênos,blackmoore,1432,priest,discipline,47,29,18
Ashérs,ravencrest,1432,priest,discipline,201,110,91
Diddlefiddle,stormscale,1432,priest,discipline,88,48,40
Мэдсанван,howling-fjord,1432,priest,discipline,364,194,170
Dragthal,malganis,1432,priest,discipline,74,32,42
Healysith,archimonde,1432,priest,discipline,36,15,21
Altargirl,defias-brotherhood,1432,priest,discipline,78,32,46
Swera,twisting-nether,1431,priest,discipline,24,15,9
Mcgodx,argent-dawn,1431,priest,discipline,48,28,20
Ilovechildrn,silvermoon,1431,priest,discipline,36,21,15
Myrmeen,silvermoon,1431,priest,discipline,223,120,103
Phreyst,draenor,1431,priest,discipline,189,97,92
Shttygame,nazjatar,1431,priest,discipline,30,15,15
Sáshagrey,arathor,1431,priest,discipline,79,38,41
Cherrih,argent-dawn,1431,priest,discipline,96,39,57
Micoup,ysondre,1431,priest,discipline,78,29,49
Agorasii,frostwolf,1430,priest,discipline,72,43,29
Unckus,defias-brotherhood,1430,priest,discipline,54,30,24
Mediumheals,tarren-mill,1430,priest,discipline,214,113,101
Golletz,twisting-nether,1430,priest,discipline,120,63,57
Karoopi,ysondre,1430,priest,discipline,239,121,118
Metadot,ravencrest,1430,priest,discipline,53,24,29
Lanaineuwu,archimonde,1429,priest,discipline,32,22,10
Willzah,outland,1429,priest,discipline,24,15,9
Hlyhoe,silvermoon,1429,priest,discipline,84,48,36
Chilie,ravencrest,1429,priest,discipline,56,30,26
Shæzè,antonidas,1429,priest,discipline,174,91,83
Pennywïse,kargath,1429,priest,discipline,159,83,76
Olereo,blackhand,1429,priest,discipline,198,103,95
ßrain,garona,1429,priest,discipline,30,15,15
Yurrij,thrall,1428,priest,discipline,39,23,16
Navis,burning-blade,1428,priest,discipline,76,43,33
Sunfire,twisting-nether,1428,priest,discipline,41,23,18
Whiskeyhaze,burning-legion,1428,priest,discipline,90,48,42
Æsia,archimonde,1428,priest,discipline,75,39,36
Xypri,nordrassil,1428,priest,discipline,173,87,86
Proteinsnack,auchindoun,1428,priest,discipline,30,15,15
Alshah,emerald-dream,1428,priest,discipline,108,48,60
Artymox,sylvanas,1428,priest,discipline,78,33,45
Nèvertrust,ragnaros,1427,priest,discipline,77,43,34
Amelìa,doomhammer,1427,priest,discipline,112,61,51
Энвиньяттар,howling-fjord,1427,priest,discipline,132,66,66
Azarseth,exodar,1427,priest,discipline,48,24,24
Ylenae,twisting-nether,1427,priest,discipline,42,15,27
Whîs,stormscale,1426,priest,discipline,72,44,28
Joeasaurs,ragnaros,1426,priest,discipline,33,16,17
Ìstarï,sylvanas,1426,priest,discipline,137,66,71
Косн,razuvious,1426,priest,discipline,40,19,21
Emala,hyjal,1426,priest,discipline,35,15,20
Luciferase,sylvanas,1425,priest,discipline,24,22,2
Arashana,hyjal,1425,priest,discipline,48,30,18
Биркох,blackscar,1425,priest,discipline,137,83,54
Sytrix,frostwolf,1425,priest,discipline,116,69,47
Zickzak,destromath,1425,priest,discipline,70,40,30
Tntbigheal,silvermoon,1425,priest,discipline,91,51,40
Морикаа,lich-king,1425,priest,discipline,42,23,19
Carlye,stormreaver,1425,priest,discipline,120,62,58
Sâtânica,kelthuzad,1425,priest,discipline,314,155,159
Jael,frostmane,1425,priest,discipline,62,30,32
Savylolsz,ravencrest,1425,priest,discipline,45,20,25
Дыффян,gordunni,1424,priest,discipline,54,30,24
Кэндимен,gordunni,1424,priest,discipline,351,180,171
Anadyia,aegwynn,1424,priest,discipline,36,16,20
Марина,howling-fjord,1424,priest,discipline,132,58,74
Affalterbach,blackrock,1424,priest,discipline,36,15,21
Sphero,kazzak,1423,priest,discipline,100,57,43
Extralite,stormscale,1423,priest,discipline,281,148,133
Выхилютебя,galakrond,1423,priest,discipline,141,73,68
Werita,frostmane,1423,priest,discipline,239,120,119
Aevery,onyxia,1423,priest,discipline,105,51,54
Acarru,stormscale,1423,priest,discipline,36,15,21
Dizpel,stormscale,1423,priest,discipline,59,24,35
Nswqt,kazzak,1422,priest,discipline,110,68,42
Tech,draenor,1422,priest,discipline,60,35,25
Noreal,twisting-nether,1422,priest,discipline,72,41,31
Eowins,blackmoore,1422,priest,discipline,184,101,83
Kangkong,ravencrest,1422,priest,discipline,51,27,24
Nyxalia,silvermoon,1422,priest,discipline,36,19,17
Cryksî,blackhand,1422,priest,discipline,120,60,60
Spèrman,frostwolf,1422,priest,discipline,117,58,59
Adolin,onyxia,1422,priest,discipline,59,29,30
Stevep,tarren-mill,1422,priest,discipline,84,40,44
Pìkachù,stormscale,1422,priest,discipline,60,28,32
Slight,aggra-português,1421,priest,discipline,36,24,12
Ximenia,eredar,1421,priest,discipline,55,35,20
Fiilaaja,stormreaver,1421,priest,discipline,126,69,57
Nattramnone,blackmoore,1421,priest,discipline,156,82,74
Xubeqi,kazzak,1421,priest,discipline,258,135,123
Морисгринх,gordunni,1421,priest,discipline,75,39,36
Kemari,aegwynn,1421,priest,discipline,30,15,15
Prellish,draenor,1421,priest,discipline,119,59,60
Snuffanious,ragnaros,1421,priest,discipline,131,63,68
Mackópriest,ragnaros,1421,priest,discipline,199,91,108
Discobrill,silvermoon,1421,priest,discipline,96,43,53
Nudavbrne,drakthul,1420,priest,discipline,53,33,20
Simza,azuremyst,1420,priest,discipline,30,18,12
Sciophobia,defias-brotherhood,1420,priest,discipline,76,45,31
Зиибак,soulflayer,1420,priest,discipline,80,47,33
Vynie,antonidas,1420,priest,discipline,73,38,35
Buerak,tarren-mill,1420,priest,discipline,80,40,40
Rafikii,eredar,1420,priest,discipline,36,17,19
Elnîa,conseil-des-ombres,1420,priest,discipline,110,51,59
Baristolth,archimonde,1420,priest,discipline,108,47,61
Holykebab,defias-brotherhood,1420,priest,discipline,54,23,31
Agatioxd,dun-modr,1419,priest,discipline,102,57,45
Aiewn,elune,1419,priest,discipline,170,92,78
Хидека,howling-fjord,1419,priest,discipline,101,52,49
Сафири,blackscar,1419,priest,discipline,30,15,15
Joex,arathor,1419,priest,discipline,54,24,30
Panoio,aggra-português,1419,priest,discipline,117,50,67
Avázàr,stormscale,1419,priest,discipline,48,20,28
Holybeef,kirin-tor,1419,priest,discipline,66,24,42
Cooriolis,sylvanas,1418,priest,discipline,41,27,14
Ezcobar,twilights-hammer,1418,priest,discipline,24,15,9
Kayeen,tarren-mill,1418,priest,discipline,273,141,132
Wynkx,zuljin,1418,priest,discipline,170,86,84
Apostas,ragnaros,1418,priest,discipline,30,15,15
Lemontea,frostwolf,1418,priest,discipline,60,29,31
Эйвиг,blackscar,1418,priest,discipline,122,57,65
Írelia,amanthul,1418,priest,discipline,60,25,35
Arasos,drakthul,1417,priest,discipline,107,72,35
Rosalina,ravencrest,1417,priest,discipline,371,194,177
Тучанх,greymane,1417,priest,discipline,49,24,25
Щещенская,gordunni,1417,priest,discipline,60,29,31
Ovrpwr,stormscale,1417,priest,discipline,46,22,24
Варинган,howling-fjord,1416,priest,discipline,64,37,27
Holybunny,blackrock,1416,priest,discipline,122,69,53
Shilôz,hyjal,1416,priest,discipline,237,123,114
Hanniel,kazzak,1416,priest,discipline,102,50,52
Mysticks,kirin-tor,1416,priest,discipline,119,57,62
Luxumbra,quelthalas,1416,priest,discipline,68,31,37
Stk,outland,1416,priest,discipline,85,37,48
Zivy,silvermoon,1415,priest,discipline,122,67,55
Mertérésa,hyjal,1415,priest,discipline,67,36,31
Smilyface,sylvanas,1415,priest,discipline,115,57,58
Xdthe,tarren-mill,1415,priest,discipline,234,115,119
Bakony,ravencrest,1414,priest,discipline,60,41,19
Lucéa,antonidas,1414,priest,discipline,44,29,15
Praybro,blackmoore,1414,priest,discipline,41,24,17
Cottyx,outland,1414,priest,discipline,196,109,87
Doctep,sargeras,1414,priest,discipline,100,54,46
Kiieevv,blackrock,1414,priest,discipline,427,219,208
Aisha,rajaxx,1414,priest,discipline,129,64,65
Rachelsz,ravencrest,1414,priest,discipline,78,36,42
Ohnedich,zuljin,1414,priest,discipline,59,27,32
Blagovesta,ravencrest,1414,priest,discipline,61,26,35
Îlkari,hyjal,1413,priest,discipline,35,22,13
Kaeldara,ysondre,1413,priest,discipline,24,15,9
Cöpahue,sanguino,1413,priest,discipline,60,35,25
Priesturz,aggramar,1413,priest,discipline,72,38,34
Apøcalypso,antonidas,1413,priest,discipline,216,108,108
Adägïo,dun-modr,1413,priest,discipline,84,41,43
Indicta,darksorrow,1413,priest,discipline,33,16,17
Gæxelademad,draenor,1412,priest,discipline,48,27,21
Maistuu,tarren-mill,1412,priest,discipline,49,27,22
Потёртый,borean-tundra,1412,priest,discipline,48,26,22
Terstyana,hyjal,1412,priest,discipline,30,15,15
Wreniwreni,stormscale,1412,priest,discipline,30,15,15
Sarkamer,auchindoun,1412,priest,discipline,69,33,36
Castalia,ravencrest,1412,priest,discipline,101,48,53
Hashoko,draenor,1411,priest,discipline,42,29,13
Slitenprest,kazzak,1411,priest,discipline,89,54,35
Мерседулька,howling-fjord,1411,priest,discipline,76,40,36
Pristel,twisting-nether,1411,priest,discipline,30,15,15
Thesunbeam,silvermoon,1411,priest,discipline,139,67,72
Sannti,twisting-nether,1411,priest,discipline,66,31,35
Vynivan,korgall,1411,priest,discipline,66,30,36
Sebatröz,ravencrest,1410,priest,discipline,54,30,24
Villagegirlx,stormscale,1410,priest,discipline,42,23,19
Bomzhik,silvermoon,1410,priest,discipline,301,164,137
Faelvirin,aegwynn,1410,priest,discipline,41,21,20
Shanya,thrall,1410,priest,discipline,42,20,22
Miliane,twisting-nether,1410,priest,discipline,37,16,21
Гленнис,gordunni,1410,priest,discipline,36,15,21
Èlysium,grim-batol,1410,priest,discipline,60,24,36
Бомжскадилом,gordunni,1409,priest,discipline,237,125,112
Vadhänder,the-maelstrom,1409,priest,discipline,66,32,34
Пакетикдот,gordunni,1408,priest,discipline,297,163,134
Асади,gordunni,1408,priest,discipline,154,84,70
Tony,agamaggan,1408,priest,discipline,107,55,52
Illüminaty,sylvanas,1408,priest,discipline,135,69,66
Ashbee,drakthul,1408,priest,discipline,30,15,15
Knøw,ravencrest,1408,priest,discipline,141,69,72
Давалкасвета,gordunni,1408,priest,discipline,92,44,48
Nextvbestapp,ravencrest,1408,priest,discipline,142,62,80
Xyal,outland,1407,priest,discipline,36,20,16
Elternya,hyjal,1407,priest,discipline,146,79,67
Korzec,dun-modr,1407,priest,discipline,114,60,54
Дядяврач,howling-fjord,1407,priest,discipline,224,112,112
Bialun,argent-dawn,1407,priest,discipline,175,86,89
Solaqt,tarren-mill,1407,priest,discipline,60,23,37
Diszis,antonidas,1406,priest,discipline,42,23,19
Medipack,khaz-modan,1406,priest,discipline,112,57,55
Drumont,kelthuzad,1406,priest,discipline,48,24,24
Imda,ravencrest,1406,priest,discipline,188,93,95
Miris,ysondre,1406,priest,discipline,66,29,37
Henaë,archimonde,1405,priest,discipline,48,27,21
Voidtrix,blackrock,1405,priest,discipline,256,140,116
Kroa,ragnaros,1405,priest,discipline,36,19,17
Perdítá,thrall,1405,priest,discipline,473,247,226
Menjo,silvermoon,1405,priest,discipline,72,37,35
Grezzy,eredar,1405,priest,discipline,36,16,20
Holysquirt,twisting-nether,1405,priest,discipline,42,18,24
Strygah,die-nachtwache,1405,priest,discipline,59,25,34
Snusprällen,sylvanas,1405,priest,discipline,89,36,53
Xepetas,tarren-mill,1405,priest,discipline,51,20,31
Ремкомплект,soulflayer,1404,priest,discipline,90,54,36
Medivs,blackmoore,1404,priest,discipline,42,22,20
Holymøly,earthen-ring,1404,priest,discipline,93,46,47
Giily,archimonde,1404,priest,discipline,103,45,58
Дэйвора,ashenvale,1403,priest,discipline,60,36,24
Yuki,trollbane,1403,priest,discipline,49,28,21
Злюкыч,gordunni,1403,priest,discipline,147,82,65
Таяш,soulflayer,1403,priest,discipline,243,133,110
Veltrag,sanguino,1403,priest,discipline,68,37,31
Vaewyn,ravencrest,1403,priest,discipline,85,46,39
Kenzaiq,aegwynn,1403,priest,discipline,94,50,44
Nikotyna,doomhammer,1403,priest,discipline,191,97,94
Nemrtvaa,draenor,1403,priest,discipline,30,15,15
Eileengu,silvermoon,1402,priest,discipline,70,42,28
Asprine,kazzak,1402,priest,discipline,222,121,101
Vaetrilla,doomhammer,1402,priest,discipline,79,40,39
Laadyybirkee,blackhand,1402,priest,discipline,182,91,91
Элизабетшорт,soulflayer,1402,priest,discipline,201,100,101
Putinkuilo,outland,1402,priest,discipline,59,29,30
Kbakå,kazzak,1402,priest,discipline,32,15,17
Kätsulol,ysondre,1402,priest,discipline,77,36,41
Undertaken,arathi,1402,priest,discipline,75,34,41
Zeroskillz,outland,1401,priest,discipline,59,35,24
Chuckbarry,kazzak,1401,priest,discipline,42,24,18
Paine,pozzo-delleternità,1401,priest,discipline,104,58,46
Earnzy,outland,1401,priest,discipline,101,56,45
Ciordel,draenor,1401,priest,discipline,101,53,48
Lunegrise,archimonde,1401,priest,discipline,88,44,44
Dysko,alakir,1401,priest,discipline,30,15,15
Idontknow,sanguino,1401,priest,discipline,61,28,33
Feriant,argent-dawn,1400,priest,discipline,65,42,23
Glärë,burning-legion,1400,priest,discipline,123,76,47
Phèbz,archimonde,1400,priest,discipline,60,36,24
Táliss,arthas,1400,priest,discipline,30,17,13
Ichpvpeuch,eredar,1400,priest,discipline,79,42,37
Veecna,the-maelstrom,1400,priest,discipline,192,102,90
Lalgorithme,hyjal,1400,priest,discipline,54,28,26
Ahmnesia,archimonde,1400,priest,discipline,353,178,175
Flyingdutch,tarren-mill,1400,priest,discipline,320,161,159
Radegast,jaedenar,1400,priest,discipline,294,142,152
Healvendor,darkmoon-faire,1400,priest,discipline,52,24,28
Darkest,ysondre,1400,priest,discipline,95,43,52
Вурти,howling-fjord,1400,priest,discipline,65,28,37
Evølét,kazzak,1399,priest,discipline,33,21,12
Broer,twisting-nether,1399,priest,discipline,30,18,12
Freshpope,ravencrest,1399,priest,discipline,113,66,47
Mindcrackr,stormscale,1399,priest,discipline,54,30,24
Pestaso,shendralar,1399,priest,discipline,102,56,46
Barracuda,burning-legion,1399,priest,discipline,197,103,94
Vocolieth,argent-dawn,1399,priest,discipline,105,53,52
Забейка,howling-fjord,1399,priest,discipline,60,30,30
Сайларс,howling-fjord,1399,priest,discipline,126,61,65
Labella,tarren-mill,1398,priest,discipline,28,16,12
Gothixs,draenor,1398,priest,discipline,100,55,45
Ahree,sargeras,1398,priest,discipline,363,183,180
Hidary,ysondre,1398,priest,discipline,85,40,45
Tsunê,ysondre,1398,priest,discipline,34,16,18
Hiereia,khadgar,1398,priest,discipline,211,99,112
Llamamepadre,dun-modr,1398,priest,discipline,95,44,51
Guerilagusto,draenor,1398,priest,discipline,72,33,39
Jeuhy,talnivarr,1397,priest,discipline,181,96,85
Tyrhaa,blackmoore,1397,priest,discipline,42,22,20
Ylvanna,arthas,1397,priest,discipline,277,133,144
Yunggoth,eredar,1397,priest,discipline,50,24,26
Janclod,pozzo-delleternità,1396,priest,discipline,60,38,22
Amambo,chamber-of-aspects,1396,priest,discipline,90,53,37
Symeria,sylvanas,1396,priest,discipline,96,53,43
Vrynna,kazzak,1396,priest,discipline,156,83,73
Hellscon,kazzak,1396,priest,discipline,48,24,24
Benificent,argent-dawn,1396,priest,discipline,255,126,129
Летиин,gordunni,1396,priest,discipline,117,57,60
Rixis,la-croisade-écarlate,1396,priest,discipline,72,32,40
Rokocrazy,aggra-português,1396,priest,discipline,41,18,23
Nayro,blackrock,1396,priest,discipline,48,19,29
Dionegativ,draenor,1396,priest,discipline,66,24,42
Calisé,argent-dawn,1395,priest,discipline,24,15,9
Sâmba,pozzo-delleternità,1395,priest,discipline,24,15,9
Германий,deathguard,1395,priest,discipline,59,36,23
Iluras,thunderhorn,1395,priest,discipline,55,29,26
Vornexp,sporeggar,1395,priest,discipline,80,37,43
Ohbenji,ravencrest,1395,priest,discipline,182,82,100
Tirendor,burning-legion,1395,priest,discipline,48,21,27
Celestias,sanguino,1395,priest,discipline,39,16,23
Pixr,defias-brotherhood,1394,priest,discipline,30,15,15
Drxz,twilights-hammer,1393,priest,discipline,58,30,28
Littleheal,ghostlands,1393,priest,discipline,49,24,25
Chankilolx,dun-modr,1393,priest,discipline,205,94,111
Сегуната,howling-fjord,1393,priest,discipline,48,19,29
Borrex,sanguino,1392,priest,discipline,61,38,23
Bolflo,khaz-modan,1392,priest,discipline,147,79,68
Холигард,grom,1392,priest,discipline,78,40,38
Adev,drakthul,1392,priest,discipline,83,42,41
Tellmestory,outland,1392,priest,discipline,54,27,27
Codeincindy,blackhand,1392,priest,discipline,206,102,104
Woodywoodpkr,senjin,1392,priest,discipline,124,60,64
Aliciakeys,twilights-hammer,1392,priest,discipline,46,18,28
Skarnir,uldaman,1392,priest,discipline,105,40,65
Salyisra,draenor,1391,priest,discipline,137,71,66
Æisa,blackmoore,1391,priest,discipline,349,178,171
Exila,rashgarroth,1391,priest,discipline,37,18,19
Evolís,blackmoore,1391,priest,discipline,102,49,53
Animepfp,stormreaver,1391,priest,discipline,140,67,73
Trasslarn,tarren-mill,1391,priest,discipline,107,51,56
Vierforvier,aegwynn,1391,priest,discipline,132,61,71
Смайтвайфу,howling-fjord,1391,priest,discipline,90,41,49
Иннрей,soulflayer,1391,priest,discipline,42,19,23
Штецель,howling-fjord,1391,priest,discipline,44,17,27
Voltáren,blackmoore,1390,priest,discipline,56,35,21
Killerkende,ragnaros,1390,priest,discipline,110,59,51
Kojee,blackrock,1390,priest,discipline,96,44,52
Zombîe,draenor,1390,priest,discipline,42,16,26
Salzgehalt,antonidas,1389,priest,discipline,176,98,78
Dreampriest,frostmane,1389,priest,discipline,31,17,14
Healmebaby,kiljaeden,1389,priest,discipline,30,16,14
Pàndoràh,nemesis,1389,priest,discipline,78,38,40
Tarana,mannoroth,1389,priest,discipline,38,18,20
Vexxdd,outland,1389,priest,discipline,78,36,42
Fapfapjohn,sylvanas,1389,priest,discipline,41,15,26
Aaron,aegwynn,1388,priest,discipline,31,20,11
Kâmy,archimonde,1388,priest,discipline,120,65,55
Ruderali,blackmoore,1388,priest,discipline,434,221,213
Psyhov,ragnaros,1388,priest,discipline,46,21,25
Aperture,kelthuzad,1388,priest,discipline,42,18,24
Hidr,nemesis,1387,priest,discipline,108,58,50
Pètunia,ravencrest,1387,priest,discipline,397,206,191
Scodây,blackmoore,1387,priest,discipline,331,171,160
Emon,nemesis,1387,priest,discipline,84,43,41
Filtro,eredar,1387,priest,discipline,588,296,292
Rahan,stormscale,1387,priest,discipline,149,73,76
Unholyfield,draenor,1387,priest,discipline,191,91,100
Anzil,dun-modr,1387,priest,discipline,176,82,94
Eviscerätor,draenor,1387,priest,discipline,33,15,18
Clæude,tarren-mill,1387,priest,discipline,78,31,47
Xarxis,twisting-nether,1387,priest,discipline,76,30,46
Captnawesome,blackrock,1386,priest,discipline,60,34,26
Lothyf,archimonde,1386,priest,discipline,87,48,39
Gothandor,der-rat-von-dalaran,1386,priest,discipline,90,48,42
Tylorswift,ravencrest,1386,priest,discipline,48,25,23
Cheja,ravencrest,1386,priest,discipline,198,103,95
Альфреска,gordunni,1386,priest,discipline,94,48,46
Созвонимся,gordunni,1386,priest,discipline,121,61,60
Kalestharia,blackmoore,1386,priest,discipline,305,146,159
Pyropenance,twisting-nether,1386,priest,discipline,83,35,48
Matsipri,sylvanas,1385,priest,discipline,155,82,73
Dooga,draenor,1385,priest,discipline,48,25,23
Munchies,scarshield-legion,1385,priest,discipline,54,28,26
Pvpriestess,silvermoon,1385,priest,discipline,269,138,131
Stambuff,ragnaros,1385,priest,discipline,36,18,18
Lighttorch,burning-legion,1385,priest,discipline,52,24,28
Tosspot,ragnaros,1385,priest,discipline,37,17,20
Pinkyladdy,argent-dawn,1385,priest,discipline,95,42,53
Physical,jaedenar,1385,priest,discipline,71,31,40
Céph,sylvanas,1385,priest,discipline,66,28,38
Sehek,sanguino,1385,priest,discipline,96,39,57
Barcodes,kazzak,1384,priest,discipline,175,91,84
Köftemcc,blackrock,1384,priest,discipline,47,24,23
Æøí,blackmoore,1384,priest,discipline,55,26,29
Dragovic,chogall,1384,priest,discipline,86,40,46
Gegzlol,twisting-nether,1384,priest,discipline,41,17,24
Pristerline,antonidas,1383,priest,discipline,67,35,32
Cutename,burning-blade,1383,priest,discipline,54,28,26
Valythria,blackhand,1383,priest,discipline,183,93,90
Rodshun,dun-modr,1383,priest,discipline,164,81,83
Synteria,gilneas,1383,priest,discipline,163,73,90
Ykiotonegawa,twisting-nether,1383,priest,discipline,189,79,110
Docpower,twisting-nether,1383,priest,discipline,66,27,39
Predpriest,twisting-nether,1383,priest,discipline,43,16,27
Juuco,draenor,1382,priest,discipline,31,18,13
Froboz,the-venture-co,1382,priest,discipline,31,17,14
Ebolaidman,ravencrest,1382,priest,discipline,132,72,60
Shãdowlãght,antonidas,1382,priest,discipline,83,45,38
Shomäre,ysondre,1382,priest,discipline,202,108,94
Батлграунтт,soulflayer,1382,priest,discipline,288,150,138
Grausami,zuluhed,1382,priest,discipline,96,49,47
Manuba,antonidas,1382,priest,discipline,63,32,31
Radizzel,tichondrius,1382,priest,discipline,46,20,26
Tinteolo,blackrock,1382,priest,discipline,81,35,46
Talyie,argent-dawn,1381,priest,discipline,27,18,9
Oikus,minahonda,1381,priest,discipline,66,36,30
Lekadolplusc,doomhammer,1381,priest,discipline,420,222,198
Некроликон,grom,1381,priest,discipline,145,75,70
Dejica,kult-der-verdammten,1381,priest,discipline,108,48,60
Dibelo,eredar,1381,priest,discipline,47,20,27
Peersh,ahnqiraj,1380,priest,discipline,24,15,9
Dosentti,ragnaros,1380,priest,discipline,54,33,21
Keppas,doomhammer,1380,priest,discipline,103,57,46
Bekareth,archimonde,1380,priest,discipline,139,74,65
Psyfir,outland,1380,priest,discipline,260,135,125
Holyblóod,ravencrest,1380,priest,discipline,122,57,65
Priesterious,blackrock,1380,priest,discipline,36,16,20
Эстрогенс,gordunni,1380,priest,discipline,66,25,41
Deathchicka,draenor,1379,priest,discipline,94,50,44
Трэй,deathguard,1379,priest,discipline,211,106,105
Sneed,moonglade,1379,priest,discipline,102,47,55
Paulinka,auchindoun,1379,priest,discipline,114,51,63
Птист,azuregos,1379,priest,discipline,54,20,34
Tripsdrill,blackmoore,1378,priest,discipline,57,40,17
Outcast,korgall,1378,priest,discipline,95,52,43
Apeist,outland,1378,priest,discipline,146,77,69
Амбракадабра,blackscar,1378,priest,discipline,102,53,49
Slasherh,ravencrest,1378,priest,discipline,237,116,121
Медиив,deepholm,1378,priest,discipline,180,88,92
Убийцаорчат,lich-king,1378,priest,discipline,36,16,20
Гандболист,soulflayer,1377,priest,discipline,66,33,33
Haffination,frostmane,1377,priest,discipline,33,16,17
Plsenjoygame,kazzak,1376,priest,discipline,44,25,19
Vædan,drakthul,1376,priest,discipline,36,20,16
Азотод,gordunni,1376,priest,discipline,187,100,87
Eksel,silvermoon,1376,priest,discipline,155,80,75
Litera,silvermoon,1376,priest,discipline,104,48,56
Höfi,ragnaros,1376,priest,discipline,146,66,80
Brobert,nerathor,1376,priest,discipline,54,22,32
Теньраа,soulflayer,1376,priest,discipline,78,31,47
Jerichó,blackmoore,1375,priest,discipline,76,48,28
Dolifrius,dalaran,1375,priest,discipline,50,30,20
Zzero,kazzak,1375,priest,discipline,73,40,33
Ompala,shattered-hand,1375,priest,discipline,43,23,20
Devot,outland,1375,priest,discipline,156,79,77
Skardumi,blackmoore,1375,priest,discipline,52,26,26
Wish,blackmoore,1375,priest,discipline,200,98,102
Ментэс,gordunni,1374,priest,discipline,66,41,25
Ùçù,dalaran,1374,priest,discipline,94,51,43
Qïx,ravencrest,1374,priest,discipline,45,24,21
Challengepro,burning-legion,1374,priest,discipline,30,16,14
Летириен,gordunni,1374,priest,discipline,54,28,26
Imhotép,anubarak,1374,priest,discipline,71,34,37
Absórb,quelthalas,1374,priest,discipline,66,31,35
Otheym,the-maelstrom,1374,priest,discipline,39,18,21
Rhin,zuljin,1374,priest,discipline,42,16,26
Санёквиртуоз,soulflayer,1374,priest,discipline,42,16,26
Pocketissue,ravencrest,1373,priest,discipline,32,21,11
Wortgottes,blackrock,1373,priest,discipline,70,41,29
Деривация,grom,1373,priest,discipline,146,78,68
Calani,zirkel-des-cenarius,1373,priest,discipline,36,17,19
Iqr,blackmoore,1373,priest,discipline,72,30,42
Knikkerbaas,outland,1372,priest,discipline,30,26,4
Peacke,ravencrest,1372,priest,discipline,72,38,34
Majinme,kazzak,1372,priest,discipline,60,31,29
Rabbît,stormscale,1372,priest,discipline,82,42,40
Brickles,thrall,1372,priest,discipline,98,50,48
Alexnator,malganis,1372,priest,discipline,96,48,48
Ahbe,stormscale,1372,priest,discipline,87,43,44
Svevo,ravencrest,1372,priest,discipline,147,71,76
Híppokrates,dethecus,1372,priest,discipline,119,55,64
Blkp,archimonde,1371,priest,discipline,18,17,1
Bilgecan,silvermoon,1371,priest,discipline,61,39,22
Xodze,outland,1371,priest,discipline,72,45,27
Qulpri,blackmoore,1371,priest,discipline,49,25,24
Jenelle,thrall,1371,priest,discipline,48,21,27
Skarn,blackmoore,1370,priest,discipline,77,51,26
Ventorina,die-aldor,1370,priest,discipline,80,40,40
Mamaoh,ravencrest,1370,priest,discipline,81,40,41
Cronershadow,stormscale,1370,priest,discipline,63,31,32
Grímes,draenor,1370,priest,discipline,123,60,63
Fireflowers,silvermoon,1370,priest,discipline,132,64,68
Elusivv,blackhand,1370,priest,discipline,42,19,23
Glimpseofus,ragnaros,1370,priest,discipline,84,35,49
Jijin,stormscale,1370,priest,discipline,36,15,21
Nûwa,draenor,1369,priest,discipline,83,48,35
Svartylol,outland,1369,priest,discipline,112,64,48
Yukîna,eredar,1369,priest,discipline,103,53,50
Micobra,dalaran,1369,priest,discipline,76,39,37
Pocketsimp,stormscale,1369,priest,discipline,190,96,94
Aroghul,eredar,1369,priest,discipline,186,92,94
Psychîc,twisting-nether,1368,priest,discipline,52,33,19
Tigrok,burning-legion,1368,priest,discipline,166,88,78
Bandäid,ravencrest,1368,priest,discipline,112,59,53
Hugerage,stormreaver,1368,priest,discipline,166,76,90
Johnblack,dun-morogh,1368,priest,discipline,42,18,24
Domspitz,malygos,1367,priest,discipline,89,51,38
Elyradp,dun-modr,1367,priest,discipline,132,75,57
Lunatrix,sanguino,1367,priest,discipline,48,24,24
Nirvs,kazzak,1367,priest,discipline,42,21,21
Freaki,blackrock,1367,priest,discipline,78,37,41
Speltmor,stormscale,1367,priest,discipline,42,18,24
Høiy,antonidas,1366,priest,discipline,26,16,10
Nashára,defias-brotherhood,1366,priest,discipline,232,119,113
Violentha,silvermoon,1366,priest,discipline,42,21,21
Sprutch,kazzak,1366,priest,discipline,93,46,47
Chénony,ravencrest,1366,priest,discipline,250,123,127
Valtalor,ragnaros,1366,priest,discipline,41,18,23
Erupyks,archimonde,1366,priest,discipline,103,45,58
Unerfedsp,archimonde,1366,priest,discipline,77,32,45
Saikoo,stormscale,1365,priest,discipline,48,27,21
Mädmän,draenor,1365,priest,discipline,207,116,91
Yinyangyø,eredar,1365,priest,discipline,72,37,35
Vipimp,blackrock,1365,priest,discipline,429,215,214
Kaémon,twisting-nether,1365,priest,discipline,298,144,154
Mindrouf,burning-legion,1365,priest,discipline,247,119,128
Siliçia,aegwynn,1365,priest,discipline,54,25,29
Nyxara,outland,1365,priest,discipline,45,19,26
Calah,frostwhisper,1365,priest,discipline,48,20,28
Pl,sunstrider,1364,priest,discipline,84,46,38
Elûnä,ysondre,1364,priest,discipline,340,179,161
Carcaz,blackmoore,1364,priest,discipline,59,27,32
Vatizinium,veklor,1364,priest,discipline,34,15,19
Lysium,sylvanas,1364,priest,discipline,48,20,28
Deshaz,tarren-mill,1363,priest,discipline,153,78,75
Durness,argent-dawn,1363,priest,discipline,84,42,42
Joxdox,archimonde,1363,priest,discipline,96,46,50
Trekztwo,archimonde,1363,priest,discipline,84,39,45
Lezz,ragnaros,1363,priest,discipline,54,24,30
Drêäms,archimonde,1362,priest,discipline,46,27,19
Lehava,archimonde,1362,priest,discipline,44,23,21
ßowforme,aegwynn,1362,priest,discipline,96,50,46
Hekro,thrall,1362,priest,discipline,118,61,57
Elreâ,blackrock,1362,priest,discipline,36,18,18
Jordí,darkspear,1362,priest,discipline,245,120,125
Sppid,sanguino,1362,priest,discipline,356,171,185
Joniop,stormreaver,1362,priest,discipline,72,33,39
Dzoo,kazzak,1362,priest,discipline,70,30,40
Тэслос,howling-fjord,1362,priest,discipline,35,15,20
Bjornqt,ragnaros,1362,priest,discipline,86,35,51
Creepa,area-52,1361,priest,discipline,30,18,12
Лифик,blackscar,1361,priest,discipline,53,30,23
Luznywiesiek,burning-legion,1361,priest,discipline,116,57,59
Уноханагодх,howling-fjord,1361,priest,discipline,98,48,50
Dstars,archimonde,1361,priest,discipline,88,40,48
Подорваный,gordunni,1361,priest,discipline,60,26,34
Imbadancer,turalyon,1360,priest,discipline,137,78,59
Motoripräst,stormreaver,1360,priest,discipline,32,17,15
Thrakoun,twilights-hammer,1360,priest,discipline,356,176,180
Аферона,soulflayer,1360,priest,discipline,72,29,43
Celrin,chamber-of-aspects,1359,priest,discipline,24,17,7
Naïlu,hyjal,1359,priest,discipline,72,40,32
Paars,outland,1359,priest,discipline,36,16,20
Mxcey,ravencrest,1359,priest,discipline,36,15,21
Ÿë,stormreaver,1359,priest,discipline,37,15,22
Aykò,blackmoore,1359,priest,discipline,56,20,36
Декстерадей,howling-fjord,1358,priest,discipline,30,18,12
Csimpacsento,ragnaros,1358,priest,discipline,30,18,12
Várósh,blackmoore,1358,priest,discipline,93,50,43
Pwjetlifelol,grim-batol,1358,priest,discipline,151,79,72
Valeriana,stormreaver,1358,priest,discipline,239,123,116
Shidori,dalaran,1358,priest,discipline,96,49,47
Ryazz,blackrock,1358,priest,discipline,78,33,45
Priesless,sylvanas,1357,priest,discipline,34,20,14
Sasabsi,malorne,1357,priest,discipline,60,33,27
Bösenboris,aegwynn,1357,priest,discipline,119,63,56
Вегельдэрс,gordunni,1357,priest,discipline,66,30,36
Esüna,ysondre,1356,priest,discipline,48,26,22
Assyrïa,ravencrest,1356,priest,discipline,48,25,23
Byxoph,sanguino,1356,priest,discipline,113,56,57
Весенняя,gordunni,1356,priest,discipline,117,57,60
Скумизарг,gordunni,1356,priest,discipline,36,17,19
Gibbons,chogall,1356,priest,discipline,36,15,21
Dànè,defias-brotherhood,1355,priest,discipline,30,21,9
Cntrl,frostmane,1355,priest,discipline,179,95,84
Tryingtomc,archimonde,1355,priest,discipline,46,21,25
Goodwin,draenor,1355,priest,discipline,125,57,68
Dìsc,ravencrest,1355,priest,discipline,107,48,59
Juliane,trollbane,1355,priest,discipline,147,63,84
Paterpaisios,kazzak,1355,priest,discipline,54,20,34
Shawfour,ravencrest,1354,priest,discipline,24,15,9
Parishealtón,ragnaros,1354,priest,discipline,42,26,16
Makariotatos,xavius,1354,priest,discipline,76,42,34
Miabelle,argent-dawn,1354,priest,discipline,58,27,31
Lèviåthån,stormscale,1354,priest,discipline,94,32,62
Hydrôlic,blackrock,1353,priest,discipline,48,31,17
Shadowzen,darkspear,1353,priest,discipline,79,45,34
Therezzer,burning-legion,1353,priest,discipline,66,36,30
Bublies,silvermoon,1353,priest,discipline,67,35,32
Teyranamin,defias-brotherhood,1353,priest,discipline,67,34,33
Thehealer,twisting-nether,1353,priest,discipline,66,30,36
Solarïah,garona,1352,priest,discipline,32,19,13
Priestige,spinebreaker,1352,priest,discipline,36,21,15
Noibe,chogall,1352,priest,discipline,30,16,14
Epifis,silvermoon,1352,priest,discipline,349,181,168
Chocopríest,blackmoore,1352,priest,discipline,117,60,57
Sulla,draenor,1352,priest,discipline,54,27,27
Chaosweavèr,outland,1352,priest,discipline,60,28,32
Fathermaxii,stormrage,1351,priest,discipline,104,59,45
Allotment,silvermoon,1351,priest,discipline,90,50,40
Мариона,gordunni,1351,priest,discipline,48,26,22
Darkweed,twilights-hammer,1351,priest,discipline,195,104,91
Phórkys,kazzak,1351,priest,discipline,1134,570,564
Widöw,cthun,1351,priest,discipline,126,62,64
Shîn,aegwynn,1351,priest,discipline,90,44,46
Cyberlunatic,antonidas,1351,priest,discipline,256,115,141
Brelett,the-maelstrom,1351,priest,discipline,36,16,20
Marilya,dalvengyr,1351,priest,discipline,42,15,27
Маимморта,howling-fjord,1350,priest,discipline,72,39,33
Frekio,eitrigg,1350,priest,discipline,248,123,125
Орбит,blackscar,1350,priest,discipline,251,118,133
Fluffymuh,blackrock,1349,priest,discipline,24,15,9
Bigpinkballs,tarren-mill,1349,priest,discipline,25,15,10
Sytawa,blackmoore,1349,priest,discipline,104,55,49
Anubisones,uldum,1349,priest,discipline,89,43,46
Farleys,draenor,1349,priest,discipline,59,26,33
Amanojaku,archimonde,1348,priest,discipline,59,31,28
Obeliskprist,kazzak,1348,priest,discipline,212,111,101
Akril,silvermoon,1348,priest,discipline,198,101,97
Conzequ,kazzak,1348,priest,discipline,62,29,33
Крашдайс,soulflayer,1348,priest,discipline,115,53,62
Jazty,sanguino,1348,priest,discipline,42,19,23
Anotherlife,stormscale,1347,priest,discipline,24,15,9
Nabira,pozzo-delleternità,1347,priest,discipline,67,40,27
Ginebra,archimonde,1347,priest,discipline,138,75,63
Holydörte,aegwynn,1347,priest,discipline,456,232,224
Dirtydoc,area-52,1347,priest,discipline,138,70,68
Рискаль,borean-tundra,1347,priest,discipline,212,105,107
Xyfas,azshara,1347,priest,discipline,78,37,41
Adrodda,kazzak,1347,priest,discipline,89,42,47
Vividots,draenor,1347,priest,discipline,53,23,30
Yazh,argent-dawn,1347,priest,discipline,77,32,45
Хаварь,gordunni,1346,priest,discipline,134,71,63
Blasfemo,nemesis,1346,priest,discipline,87,43,44
Enduring,darksorrow,1346,priest,discipline,138,65,73
Тлэц,gordunni,1346,priest,discipline,164,75,89
Bacberon,skullcrusher,1345,priest,discipline,102,56,46
Söultaker,ravencrest,1345,priest,discipline,75,41,34
Spoc,blackrock,1345,priest,discipline,155,82,73
Senorvåc,ravencrest,1345,priest,discipline,388,193,195
Nejgr,tarren-mill,1345,priest,discipline,89,39,50
Hauntzer,veknilash,1345,priest,discipline,101,44,57
Ratapain,argent-dawn,1344,priest,discipline,18,14,4
Hugeaf,antonidas,1344,priest,discipline,43,27,16
Rzpa,blackhand,1344,priest,discipline,142,72,70
Carrhyks,archimonde,1344,priest,discipline,174,87,87
Soed,defias-brotherhood,1344,priest,discipline,36,17,19
Удзумукец,howling-fjord,1344,priest,discipline,124,57,67
Veilon,defias-brotherhood,1344,priest,discipline,150,64,86
Monstretpr,dragonblight,1344,priest,discipline,104,43,61
Ríeka,proudmoore,1343,priest,discipline,18,14,4
Чупатаявошь,soulflayer,1343,priest,discipline,120,70,50
Nëw,los-errantes,1343,priest,discipline,24,14,10
Asýnc,ravencrest,1343,priest,discipline,24,14,10
Freeve,outland,1343,priest,discipline,90,51,39
Aayzsx,ysondre,1343,priest,discipline,102,54,48
Koíré,defias-brotherhood,1343,priest,discipline,171,90,81
Sabaxdxd,dun-modr,1343,priest,discipline,248,122,126
Freepriest,darksorrow,1343,priest,discipline,69,33,36
Ikaa,wrathbringer,1343,priest,discipline,45,21,24
Ранзерот,soulflayer,1343,priest,discipline,30,14,16
Джесу,soulflayer,1343,priest,discipline,67,29,38
Capheny,ravencrest,1343,priest,discipline,68,29,39
Swpain,argent-dawn,1342,priest,discipline,18,14,4
Nicetomeatu,darksorrow,1342,priest,discipline,60,35,25
Лайхтни,howling-fjord,1342,priest,discipline,24,14,10
Adeeva,ravencrest,1342,priest,discipline,105,60,45
Dtqs,grim-batol,1342,priest,discipline,42,24,18
Ultimécya,eldrethalas,1342,priest,discipline,30,17,13
Amädeuss,tarren-mill,1342,priest,discipline,84,42,42
Иварэкзарх,gordunni,1342,priest,discipline,76,38,38
Holypepper,outland,1342,priest,discipline,173,85,88
Bakër,dalaran,1342,priest,discipline,75,36,39
Keltalador,zuljin,1342,priest,discipline,65,31,34
Terakes,kiljaeden,1342,priest,discipline,30,14,16
Карбонит,gordunni,1342,priest,discipline,30,14,16
Hans,thrall,1342,priest,discipline,66,30,36
Aeternuz,tarren-mill,1342,priest,discipline,91,39,52
Svetozarov,wildhammer,1341,priest,discipline,24,14,10
Fùkøff,stormscale,1341,priest,discipline,62,36,26
Manî,quelthalas,1341,priest,discipline,54,28,26
Velles,nazjatar,1341,priest,discipline,899,455,444
Faol,the-venture-co,1341,priest,discipline,54,27,27
Arthyria,archimonde,1341,priest,discipline,90,44,46
Spankulere,stormscale,1341,priest,discipline,54,26,28
Maiel,die-aldor,1341,priest,discipline,50,24,26
Nietzsche,area-52,1341,priest,discipline,128,59,69
Сендрагон,blackscar,1340,priest,discipline,72,41,31
Nirvánabang,sylvanas,1340,priest,discipline,60,30,30
Neoni,blackmoore,1340,priest,discipline,381,187,194
Flagman,silvermoon,1340,priest,discipline,52,25,27
Solerona,blackmoore,1340,priest,discipline,30,14,16
Lithiux,kazzak,1340,priest,discipline,45,18,27
Далайна,galakrond,1340,priest,discipline,36,14,22
Hardbowl,teldrassil,1339,priest,discipline,32,20,12
Vírtue,draenor,1339,priest,discipline,42,25,17
Moisboi,blackrock,1339,priest,discipline,24,14,10
Nuloa,ravencrest,1339,priest,discipline,78,45,33
Drioz,ysondre,1339,priest,discipline,183,102,81
Darkoze,kazzak,1339,priest,discipline,84,41,43
Chicofickfak,eredar,1339,priest,discipline,106,50,56
Tabbed,kazzak,1338,priest,discipline,24,16,8
Nuvie,ravencrest,1338,priest,discipline,96,51,45
Reynze,silvermoon,1338,priest,discipline,48,25,23
Dímension,ragnaros,1338,priest,discipline,158,82,76
Zellia,frostmane,1338,priest,discipline,155,74,81
Mungam,draenor,1338,priest,discipline,122,54,68
Torî,blackrock,1338,priest,discipline,102,43,59
Durinko,thunderhorn,1338,priest,discipline,102,43,59
Меесть,soulflayer,1338,priest,discipline,77,30,47
Дошутилась,gordunni,1338,priest,discipline,42,14,28
Slemso,stormscale,1337,priest,discipline,18,14,4
Skelica,ragnaros,1337,priest,discipline,24,14,10
Flickos,twisting-nether,1337,priest,discipline,24,14,10
Døtgdx,archimonde,1337,priest,discipline,24,14,10
Tumlaa,ravencrest,1337,priest,discipline,56,31,25
Mércíless,ravencrest,1337,priest,discipline,112,58,54
Taksí,tarren-mill,1337,priest,discipline,109,55,54
Kitanai,silvermoon,1337,priest,discipline,73,35,38
Vrazorth,archimonde,1337,priest,discipline,60,28,32
Monin,kazzak,1337,priest,discipline,30,14,16
Varrês,kazzak,1337,priest,discipline,160,72,88
Dfourc,blackhand,1337,priest,discipline,42,18,24
Chrisdorner,archimonde,1337,priest,discipline,33,14,19
Tezqt,ravencrest,1336,priest,discipline,24,14,10
Sariss,ravencrest,1336,priest,discipline,24,14,10
Nylee,stormscale,1336,priest,discipline,65,33,32
Ufos,stormscale,1336,priest,discipline,110,52,58
Mewdi,outland,1336,priest,discipline,30,14,16
Junglepriest,ravencrest,1336,priest,discipline,36,15,21
Хъи,gordunni,1335,priest,discipline,60,37,23
Kizzorde,ragnaros,1335,priest,discipline,254,135,119
Quetraxz,chogall,1335,priest,discipline,66,31,35
Fótmheroqtx,ravencrest,1335,priest,discipline,30,14,16
Héinékén,ravencrest,1335,priest,discipline,216,96,120
Derathon,eredar,1334,priest,discipline,36,22,14
Luthsha,sylvanas,1334,priest,discipline,32,17,15
Phoskitos,sanguino,1334,priest,discipline,52,27,25
Мегакастиэль,gordunni,1334,priest,discipline,136,68,68
Convulsiveq,silvermoon,1334,priest,discipline,317,156,161
Streety,nethersturm,1334,priest,discipline,185,90,95
Exorcitador,shendralar,1334,priest,discipline,88,37,51
Samerika,tarren-mill,1334,priest,discipline,72,28,44
Felanris,blackmoore,1333,priest,discipline,60,40,20
Ремидемс,howling-fjord,1333,priest,discipline,24,15,9
Xyret,blackmoore,1333,priest,discipline,37,23,14
Курумничек,gordunni,1333,priest,discipline,65,40,25
Noneedpriest,stormscale,1333,priest,discipline,24,14,10
Memoniia,ravencrest,1333,priest,discipline,48,27,21
Nioubèy,archimonde,1333,priest,discipline,89,49,40
Råin,draenor,1333,priest,discipline,33,18,15
Psychoboris,outland,1333,priest,discipline,169,91,78
Makimaqt,ravencrest,1333,priest,discipline,108,52,56
Yorap,blackrock,1333,priest,discipline,86,39,47
Atremius,dragonmaw,1333,priest,discipline,84,37,47
Radiance,emeriss,1333,priest,discipline,40,15,25
Fabs,laughing-skull,1332,priest,discipline,28,17,11
Buszeekk,outland,1332,priest,discipline,52,28,24
Орклекарь,soulflayer,1332,priest,discipline,96,49,47
Марджелла,howling-fjord,1332,priest,discipline,70,34,36
Florey,ragnaros,1331,priest,discipline,24,14,10
Velenthan,stormrage,1331,priest,discipline,105,58,47
Nynren,doomhammer,1331,priest,discipline,312,168,144
Doncamïllo,blackrock,1331,priest,discipline,113,58,55
Holycrit,aszune,1331,priest,discipline,95,40,55
Лакукарача,howling-fjord,1331,priest,discipline,82,34,48
Washinomiya,ravencrest,1330,priest,discipline,43,27,16
Dshara,the-maelstrom,1330,priest,discipline,24,14,10
Rûbyien,drakthul,1330,priest,discipline,24,14,10
Valaç,turalyon,1330,priest,discipline,149,76,73
Hòllymèdx,blackmoore,1330,priest,discipline,30,14,16
Baldracca,shendralar,1330,priest,discipline,90,35,55
Osteograhm,eldrethalas,1330,priest,discipline,42,16,26
Herapeutic,argent-dawn,1329,priest,discipline,102,57,45
Altar,grim-batol,1329,priest,discipline,167,89,78
Tyog,khazgoroth,1329,priest,discipline,31,16,15
Marypops,outland,1329,priest,discipline,30,14,16
Svartochelak,stormscale,1329,priest,discipline,54,24,30
Trolar,zuljin,1329,priest,discipline,60,26,34
Freyalas,dun-morogh,1328,priest,discipline,18,14,4
Гомотряс,howling-fjord,1328,priest,discipline,179,104,75
Elfdarkholme,stormscale,1328,priest,discipline,97,55,42
Скизма,gordunni,1328,priest,discipline,92,50,42
Lovely,silvermoon,1328,priest,discipline,72,35,37
Olqp,tarren-mill,1328,priest,discipline,39,16,23
Chealsey,thrall,1327,priest,discipline,63,38,25
Роа,soulflayer,1327,priest,discipline,35,20,15
Hakima,thrall,1327,priest,discipline,78,44,34
Tiktokdancér,kazzak,1327,priest,discipline,150,79,71
Libido,outland,1327,priest,discipline,257,134,123
Juîcycheeks,frostwolf,1327,priest,discipline,179,87,92
Livster,chamber-of-aspects,1327,priest,discipline,30,14,16
Jävlarottá,ravencrest,1327,priest,discipline,30,14,16
Prinyatel,tarren-mill,1327,priest,discipline,30,14,16
Nou,aegwynn,1327,priest,discipline,36,14,22
Ørrak,hyjal,1326,priest,discipline,54,30,24
Youkounkoun,garona,1326,priest,discipline,254,126,128
Jediminds,tarren-mill,1326,priest,discipline,52,25,27
Evangelyne,tarren-mill,1326,priest,discipline,36,15,21
Скорлупкина,gordunni,1325,priest,discipline,59,34,25
Seum,ravencrest,1325,priest,discipline,134,74,60
Fimor,die-nachtwache,1325,priest,discipline,185,101,84
Sochnaochen,outland,1325,priest,discipline,142,77,65
Texstil,blackmoore,1325,priest,discipline,84,45,39
Genthus,kazzak,1325,priest,discipline,208,103,105
Clapa,ravencrest,1325,priest,discipline,51,25,26
Baddly,silvermoon,1325,priest,discipline,304,147,157
Ministry,tirion,1325,priest,discipline,141,66,75
Jokaël,ysondre,1325,priest,discipline,162,75,87
Toljénpr,twisting-nether,1325,priest,discipline,42,19,23
Skrnz,turalyon,1325,priest,discipline,59,26,33
Chodia,silvermoon,1324,priest,discipline,89,48,41
Kalisy,ravencrest,1324,priest,discipline,52,27,25
Nésha,dun-modr,1324,priest,discipline,77,39,38
Viridaé,blackmoore,1324,priest,discipline,48,24,24
Benedicktus,hyjal,1324,priest,discipline,30,15,15
Overhealzz,blackmoore,1324,priest,discipline,153,75,78
Шэпахан,soulflayer,1324,priest,discipline,66,29,37
Calsote,sanguino,1324,priest,discipline,60,25,35
Qoryn,ravencrest,1324,priest,discipline,36,14,22
Góli,argent-dawn,1324,priest,discipline,36,14,22
Vandansk,kazzak,1323,priest,discipline,18,14,4
Konantenshi,doomhammer,1323,priest,discipline,48,28,20
Darkoulito,dalaran,1323,priest,discipline,24,14,10
Discoprillan,twisting-nether,1323,priest,discipline,73,42,31
Kyrédan,dalaran,1323,priest,discipline,301,162,139
Reìdood,stormscale,1323,priest,discipline,110,59,51
Salves,blackmoore,1323,priest,discipline,117,61,56
Mortex,nemesis,1323,priest,discipline,80,41,39
Elderiel,turalyon,1323,priest,discipline,419,212,207
Ulfsarkaom,turalyon,1323,priest,discipline,165,79,86
Вальдемарс,howling-fjord,1323,priest,discipline,65,30,35
Avengëd,nagrand,1323,priest,discipline,54,24,30
Chilltcaster,blackrock,1323,priest,discipline,38,15,23
Eclaír,blackhand,1323,priest,discipline,48,18,30
Adlareg,silvermoon,1322,priest,discipline,26,16,10
Darkpræcher,hyjal,1322,priest,discipline,141,82,59
Buttafly,archimonde,1322,priest,discipline,42,23,19
Alfaböna,outland,1322,priest,discipline,180,96,84
Aíushtha,frostmane,1322,priest,discipline,136,72,64
Лимоняшечка,soulflayer,1322,priest,discipline,116,59,57
Haligato,archimonde,1322,priest,discipline,142,71,71
Lenanitro,blackrock,1322,priest,discipline,101,49,52
Rollpaper,ragnaros,1322,priest,discipline,30,14,16
Sqizz,antonidas,1322,priest,discipline,54,24,30
Resheff,thrall,1321,priest,discipline,71,43,28
Miriàl,outland,1321,priest,discipline,62,37,25
Idora,aegwynn,1321,priest,discipline,24,14,10
Flayin,kazzak,1321,priest,discipline,80,42,38
Pulttipiispa,ravencrest,1321,priest,discipline,89,46,43
Fantästic,kazzak,1321,priest,discipline,272,139,133
Breez,nozdormu,1321,priest,discipline,42,21,21
Crazyname,outland,1321,priest,discipline,241,119,122
Дэкспрут,soulflayer,1321,priest,discipline,60,29,31
Étesech,zuljin,1321,priest,discipline,84,34,50
Uanna,ravencrest,1321,priest,discipline,36,14,22
Raintime,shattrath,1320,priest,discipline,24,14,10
Arlic,silvermoon,1320,priest,discipline,119,63,56
Voidvania,drakthul,1320,priest,discipline,59,31,28
Priestouner,khaz-modan,1320,priest,discipline,160,82,78
Дюрэкс,soulflayer,1320,priest,discipline,84,42,42
Carlolol,blackmoore,1320,priest,discipline,88,43,45
Нэилшери,gordunni,1320,priest,discipline,114,54,60
Punkrockgirl,destromath,1320,priest,discipline,84,39,45
Whicked,outland,1320,priest,discipline,53,24,29
Labbépîerre,hyjal,1320,priest,discipline,90,38,52
Calonex,kazzak,1320,priest,discipline,85,35,50
Шкуропльот,gordunni,1319,priest,discipline,106,56,50
Mukkin,tarren-mill,1319,priest,discipline,44,23,21
Shalnorei,drakthul,1319,priest,discipline,90,47,43
Nakrga,twisting-nether,1319,priest,discipline,29,15,14
Jaheim,tarren-mill,1319,priest,discipline,146,70,76
Chuntriest,shadowsong,1319,priest,discipline,48,23,25
Priesong,blackrock,1318,priest,discipline,41,24,17
Gimcho,magtheridon,1318,priest,discipline,96,50,46
Heandil,doomhammer,1318,priest,discipline,30,15,15
Шадоухоррор,gordunni,1318,priest,discipline,123,59,64
Garvul,stormscale,1318,priest,discipline,30,14,16
Babbúb,tarren-mill,1318,priest,discipline,35,14,21
Lynû,frostwolf,1318,priest,discipline,60,23,37
Ødelia,anubarak,1317,priest,discipline,24,15,9
Neremin,argent-dawn,1317,priest,discipline,124,72,52
Shdwmeld,ravencrest,1317,priest,discipline,48,27,21
Shieldyblaze,frostwolf,1317,priest,discipline,149,78,71
Простойа,deathguard,1317,priest,discipline,193,98,95
Neagica,kazzak,1317,priest,discipline,354,177,177
Murmaiderrx,draenor,1317,priest,discipline,141,70,71
Mers,eredar,1317,priest,discipline,53,26,27
Coldxzera,tarren-mill,1317,priest,discipline,52,23,29
Paulina,auchindoun,1317,priest,discipline,89,37,52
Adallon,blackmoore,1317,priest,discipline,42,14,28
Доминантрикс,soulflayer,1316,priest,discipline,96,50,46
Aeo,twisting-nether,1316,priest,discipline,156,80,76
Rickermortis,defias-brotherhood,1316,priest,discipline,82,40,42
Zhritsa,blackhand,1316,priest,discipline,35,14,21
Lizium,kazzak,1316,priest,discipline,42,16,26
Akadras,blackmoore,1315,priest,discipline,45,26,19
Maxhima,defias-brotherhood,1315,priest,discipline,204,111,93
Microwaave,kazzak,1315,priest,discipline,72,38,34
Джиннекс,gordunni,1315,priest,discipline,206,107,99
Gromalia,hyjal,1315,priest,discipline,54,27,27
Siemenspvp,drakthul,1315,priest,discipline,57,28,29
Ziaz,the-maelstrom,1315,priest,discipline,58,28,30
Evilmagic,illidan,1315,priest,discipline,41,17,24
Flokz,archimonde,1314,priest,discipline,30,18,12
Vokuheala,tarren-mill,1314,priest,discipline,71,40,31
Brunestùd,pozzo-delleternità,1314,priest,discipline,107,60,47
Hewwo,sylvanas,1314,priest,discipline,162,83,79
Soupana,darksorrow,1314,priest,discipline,133,68,65
Aboû,archimonde,1314,priest,discipline,51,26,25
Sickz,blackrock,1314,priest,discipline,84,41,43
Døline,hyjal,1314,priest,discipline,44,21,23
Vendormeq,darkspear,1314,priest,discipline,127,60,67
Stíckÿ,sanguino,1314,priest,discipline,108,49,59
Yugo,outland,1314,priest,discipline,41,15,26
Lethaldot,silvermoon,1313,priest,discipline,18,14,4
Фрустрациия,soulflayer,1313,priest,discipline,93,49,44
Ensamstående,twisting-nether,1313,priest,discipline,422,211,211
Grravehheart,kazzak,1313,priest,discipline,103,51,52
Gabu,dalaran,1313,priest,discipline,132,61,71
Танасир,eversong,1313,priest,discipline,57,25,32
Boulotpas,hyjal,1312,priest,discipline,286,157,129
Ragwitch,draenor,1312,priest,discipline,66,35,31
Гальционна,gordunni,1312,priest,discipline,84,43,41
Тесира,blackscar,1312,priest,discipline,114,56,58
Izêr,draenor,1312,priest,discipline,84,36,48
Momomomomomo,blackrock,1312,priest,discipline,54,20,34
Киборн,deathweaver,1311,priest,discipline,72,42,30
Kelsy,zuljin,1311,priest,discipline,24,14,10
Lovly,antonidas,1311,priest,discipline,24,14,10
Rúbý,tarren-mill,1311,priest,discipline,360,190,170
Alaeddin,kazzak,1311,priest,discipline,592,288,304
Ульзана,soulflayer,1311,priest,discipline,60,29,31
Tgarden,frostwhisper,1311,priest,discipline,94,44,50
Matiagmenh,stormscale,1311,priest,discipline,54,25,29
Dtgs,grim-batol,1311,priest,discipline,44,16,28
Gïanna,archimonde,1310,priest,discipline,205,99,106
Артэта,blackscar,1310,priest,discipline,48,23,25
Düina,tyrande,1309,priest,discipline,108,61,47
Darknëss,malganis,1309,priest,discipline,51,27,24
Emmenenza,pozzo-delleternità,1309,priest,discipline,112,55,57
Nirsis,dun-modr,1309,priest,discipline,231,108,123
Rotzpippn,blackhand,1309,priest,discipline,69,26,43
Æç,malganis,1308,priest,discipline,53,37,16
Wundervoid,silvermoon,1308,priest,discipline,60,34,26
Votiqt,tarren-mill,1308,priest,discipline,30,17,13
Chikzy,thrall,1308,priest,discipline,29,14,15
Overshadowed,kazzak,1308,priest,discipline,211,99,112
Shadowgeek,sylvanas,1308,priest,discipline,52,24,28
Лимью,soulflayer,1308,priest,discipline,73,30,43
Leyrie,draenor,1308,priest,discipline,44,18,26
Bossku,kazzak,1308,priest,discipline,38,15,23
Glaces,archimonde,1307,priest,discipline,107,58,49
Mirelaw,stormscale,1307,priest,discipline,125,65,60
Smålbenör,stormreaver,1307,priest,discipline,66,32,34
Filit,hyjal,1307,priest,discipline,48,22,26
Garevar,antonidas,1307,priest,discipline,88,39,49
Chukapi,stormscale,1306,priest,discipline,54,31,23
Stígmata,sanguino,1306,priest,discipline,120,60,60
Saintalfonzo,twisting-nether,1306,priest,discipline,48,24,24
Gîpsyjoe,ragnaros,1306,priest,discipline,42,21,21
Juiccyluccy,ravencrest,1306,priest,discipline,35,14,21
Slimshadyi,burning-legion,1305,priest,discipline,48,29,19
Linara,frostmane,1305,priest,discipline,48,28,20
Утьуть,gordunni,1305,priest,discipline,67,34,33
Styrbjörn,shattered-hand,1305,priest,discipline,115,58,57
Xieen,outland,1305,priest,discipline,210,105,105
Jeryss,tarren-mill,1305,priest,discipline,202,98,104
Zakuula,burning-legion,1305,priest,discipline,52,24,28
Skottlez,ravencrest,1304,priest,discipline,49,34,15
Ангеланика,gordunni,1304,priest,discipline,42,22,20
Stargóddess,kazzak,1304,priest,discipline,254,132,122
Kutjeskopper,silvermoon,1304,priest,discipline,96,46,50
Møldark,silvermoon,1304,priest,discipline,182,83,99
Eldrathir,burning-legion,1304,priest,discipline,132,60,72
Nøheall,ysondre,1304,priest,discipline,168,74,94
Evangíline,stormreaver,1303,priest,discipline,41,23,18
Selenar,neptulon,1303,priest,discipline,105,56,49
Tephutes,ravencrest,1303,priest,discipline,39,20,19
Saiki,sanguino,1303,priest,discipline,118,59,59
Zászàsmaster,kazzak,1303,priest,discipline,42,21,21
Yojoyo,draenor,1303,priest,discipline,195,97,98
Ezechiel,twisting-nether,1303,priest,discipline,117,56,61
Ivabenzo,stormscale,1303,priest,discipline,159,76,83
Zârvâjh,aszune,1303,priest,discipline,48,20,28
Floofz,auchindoun,1302,priest,discipline,57,33,24
Fkup,twisting-nether,1302,priest,discipline,36,20,16
Silvdarr,hyjal,1302,priest,discipline,186,97,89
Джороко,howling-fjord,1302,priest,discipline,108,54,54
Тварьгосподя,gordunni,1302,priest,discipline,410,204,206
Albibak,hyjal,1302,priest,discipline,64,31,33
Appox,amanthul,1302,priest,discipline,36,16,20
Саня,razuvious,1302,priest,discipline,54,23,31
Лиэся,gordunni,1302,priest,discipline,36,15,21
Tritonis,draenor,1301,priest,discipline,53,28,25
Feelmypainn,kazzak,1301,priest,discipline,102,51,51
Ryanis,nemesis,1301,priest,discipline,37,17,20
Vysajapolkni,burning-blade,1301,priest,discipline,37,14,23
Gaisa,die-todeskrallen,1301,priest,discipline,51,17,34
Puddypri,eredar,1300,priest,discipline,30,17,13
Quisira,aegwynn,1300,priest,discipline,48,27,21
Missdreavus,draenor,1300,priest,discipline,108,58,50
Aszneê,proudmoore,1300,priest,discipline,131,64,67
Curlo,ravencrest,1300,priest,discipline,42,20,22
Batsu,hyjal,1300,priest,discipline,106,47,59
Sophoula,silvermoon,1299,priest,discipline,64,32,32
Zofa,sunstrider,1299,priest,discipline,211,105,106
Chaosxo,draenor,1299,priest,discipline,288,140,148
Dotterin,draenor,1299,priest,discipline,192,89,103
Holyrage,frostwhisper,1299,priest,discipline,78,36,42
Kâltak,aegwynn,1299,priest,discipline,114,52,62
Fatherliam,emerald-dream,1299,priest,discipline,54,24,30
Jerolol,sanguino,1299,priest,discipline,92,40,52
Юпиубивает,soulflayer,1299,priest,discipline,47,16,31
Clergy,hellfire,1298,priest,discipline,125,78,47
Kidri,kilrogg,1298,priest,discipline,36,20,16
Katrynax,ravencrest,1298,priest,discipline,201,100,101
Whitepitch,doomhammer,1298,priest,discipline,148,73,75
Nimuëh,ragnaros,1298,priest,discipline,52,24,28
Lalock,grim-batol,1298,priest,discipline,36,14,22
Zathada,twisting-nether,1297,priest,discipline,105,58,47
Veýýon,blackmoore,1297,priest,discipline,84,45,39
Sietrum,draenor,1297,priest,discipline,59,30,29
Tropfacil,archimonde,1297,priest,discipline,84,41,43
Adriana,los-errantes,1297,priest,discipline,95,44,51
Tackerjoè,eredar,1297,priest,discipline,54,25,29
Quecum,draenor,1297,priest,discipline,42,19,23
Nolsrcp,outland,1297,priest,discipline,106,46,60
Хенели,blackscar,1297,priest,discipline,61,26,35
Трахмэйстер,gordunni,1296,priest,discipline,119,77,42
Nuph,ravencrest,1296,priest,discipline,71,33,38
Unpsofablé,outland,1296,priest,discipline,97,42,55
Eloapriest,blackhand,1295,priest,discipline,24,14,10
Nâmîz,blackrock,1295,priest,discipline,27,14,13
Aeternethy,ravencrest,1295,priest,discipline,185,88,97
Vannax,arygos,1295,priest,discipline,78,35,43
Nixxan,arthas,1295,priest,discipline,54,24,30
Nirvänah,ysondre,1295,priest,discipline,65,28,37
Uzü,ysondre,1294,priest,discipline,24,16,8
Никорете,soulflayer,1294,priest,discipline,62,34,28
Confusedleaf,ragnaros,1294,priest,discipline,48,24,24
Shzuna,archimonde,1294,priest,discipline,141,67,74
Nahrzgrein,blackmoore,1294,priest,discipline,101,47,54
Асуартхас,gordunni,1294,priest,discipline,259,118,141
Nhajÿ,hyjal,1294,priest,discipline,42,17,25
Powerless,blackmoore,1293,priest,discipline,33,22,11
Ðæßi,hyjal,1293,priest,discipline,103,57,46
Thimble,blackhand,1293,priest,discipline,49,27,22
Henreita,darksorrow,1293,priest,discipline,71,39,32
Oohopeoo,blackmoore,1293,priest,discipline,42,23,19
Æternadead,nemesis,1293,priest,discipline,233,119,114
Robiee,twisting-nether,1293,priest,discipline,75,37,38
Naberus,ragnaros,1293,priest,discipline,221,104,117
Credor,blackrock,1293,priest,discipline,42,19,23
Goofdookie,outland,1293,priest,discipline,36,14,22
Faderken,tarren-mill,1292,priest,discipline,78,48,30
Slavpriest,outland,1292,priest,discipline,23,14,9
Maetena,archimonde,1292,priest,discipline,60,36,24
Freazi,burning-blade,1292,priest,discipline,126,67,59
Biblebabe,tarren-mill,1292,priest,discipline,72,37,35
Ассарх,lich-king,1292,priest,discipline,132,66,66
Khoria,drakthul,1292,priest,discipline,30,14,16
Иванпугачев,soulflayer,1292,priest,discipline,60,26,34
Charmebolzen,blackrock,1291,priest,discipline,74,53,21
Pure,kazzak,1291,priest,discipline,42,25,17
Фурлена,blackscar,1291,priest,discipline,109,56,53
Clescy,ravencrest,1291,priest,discipline,77,39,38
Priestpvp,dun-modr,1291,priest,discipline,119,59,60
Centaurio,nemesis,1291,priest,discipline,249,121,128
Praizejeebus,auchindoun,1291,priest,discipline,54,26,28
Purityn,blackhand,1291,priest,discipline,54,20,34
Xyliqa,aegwynn,1291,priest,discipline,59,21,38
Nygel,kazzak,1290,priest,discipline,81,45,36
Aká,kazzak,1290,priest,discipline,54,25,29
Blúefox,malfurion,1290,priest,discipline,38,17,21
Iamfrosty,draenor,1290,priest,discipline,72,32,40
Grimor,talnivarr,1290,priest,discipline,36,16,20
Ezea,blackmoore,1290,priest,discipline,72,27,45
Ryverox,dun-modr,1289,priest,discipline,74,42,32
Navid,ravencrest,1289,priest,discipline,45,24,21
Landø,ravencrest,1289,priest,discipline,315,150,165
Эннхэтэуэй,soulflayer,1289,priest,discipline,115,54,61
Littleflash,lightbringer,1289,priest,discipline,198,91,107
Аполонио,soulflayer,1289,priest,discipline,108,48,60
Whysomady,stormscale,1289,priest,discipline,107,47,60
Brainwash,darksorrow,1289,priest,discipline,53,18,35
Chris,laughing-skull,1288,priest,discipline,18,16,2
Devîlcry,nordrassil,1288,priest,discipline,146,85,61
Nerfnerf,kazzak,1288,priest,discipline,696,353,343
Дэтметал,grom,1288,priest,discipline,381,188,193
Averye,kazzak,1287,priest,discipline,48,27,21
Ghøstyx,blackrock,1287,priest,discipline,123,62,61
Gangreana,kazzak,1287,priest,discipline,155,76,79
Voidlekir,sanguino,1287,priest,discipline,50,24,26
Oversole,kazzak,1287,priest,discipline,54,23,31
Bonzux,dethecus,1287,priest,discipline,36,14,22
Reizer,argent-dawn,1286,priest,discipline,27,15,12
Duaijhutari,outland,1286,priest,discipline,60,33,27
Ysharg,sinstralis,1286,priest,discipline,53,29,24
Dotctor,ysondre,1286,priest,discipline,131,70,61
Lydrian,argent-dawn,1286,priest,discipline,44,21,23
Roosy,malganis,1286,priest,discipline,50,23,27
Upo,kazzak,1286,priest,discipline,42,18,24
Waru,argent-dawn,1286,priest,discipline,76,26,50
Рейаста,howling-fjord,1285,priest,discipline,56,31,25
Sissi,blackmoore,1285,priest,discipline,171,85,86
Битуну,fordragon,1285,priest,discipline,84,40,44
Токсичка,howling-fjord,1284,priest,discipline,42,22,20
Nestélle,drakthul,1284,priest,discipline,299,149,150
Pregrip,twisting-nether,1284,priest,discipline,236,116,120
Ilvia,antonidas,1283,priest,discipline,40,25,15
Кейсия,fordragon,1283,priest,discipline,36,22,14
Rexáíny,blackrock,1283,priest,discipline,65,35,30
Sykra,magtheridon,1283,priest,discipline,190,99,91
Nukksch,antonidas,1283,priest,discipline,349,168,181
Lankydoc,blackmoore,1283,priest,discipline,34,15,19
Proféssor,ravencrest,1283,priest,discipline,74,32,42
Kikoke,sanguino,1282,priest,discipline,63,36,27
Jessrabbit,drakthul,1282,priest,discipline,105,58,47
Поглощу,gordunni,1282,priest,discipline,119,61,58
Suchetto,kazzak,1282,priest,discipline,130,63,67
Форсибучи,soulflayer,1282,priest,discipline,193,93,100
Claudefrollo,the-maelstrom,1282,priest,discipline,133,59,74
Mynameisebe,twisting-nether,1282,priest,discipline,42,18,24
Shadowgov,ravencrest,1281,priest,discipline,29,17,12
Венжифул,soulflayer,1281,priest,discipline,24,14,10
Mcnuuggets,ravencrest,1281,priest,discipline,28,16,12
Skyggepraest,stormscale,1281,priest,discipline,44,24,20
Chryses,teldrassil,1281,priest,discipline,111,52,59
Elderath,eredar,1281,priest,discipline,180,82,98
Ноатоэль,gordunni,1281,priest,discipline,67,29,38
Инстенли,howling-fjord,1281,priest,discipline,60,25,35
Shalalalalaè,outland,1280,priest,discipline,42,22,20
Eremit,silvermoon,1280,priest,discipline,163,85,78
Mithralas,doomhammer,1280,priest,discipline,60,29,31
Xelivia,draenor,1280,priest,discipline,197,94,103
Nérôck,frostwolf,1280,priest,discipline,51,24,27
Curanders,sanguino,1280,priest,discipline,66,31,35
Hïstërïä,silvermoon,1280,priest,discipline,68,31,37
Delinsx,outland,1280,priest,discipline,39,15,24
Япараноик,howling-fjord,1279,priest,discipline,65,41,24
Leja,darkspear,1279,priest,discipline,24,14,10
Liliashet,sanguino,1279,priest,discipline,105,57,48
Keimohansio,twisting-nether,1279,priest,discipline,138,74,64
Ûbér,darksorrow,1279,priest,discipline,28,15,13
Nicku,nerathor,1279,priest,discipline,79,42,37
Elasund,silvermoon,1279,priest,discipline,30,15,15
Norlyset,silvermoon,1279,priest,discipline,150,74,76
Samtig,malganis,1279,priest,discipline,132,63,69
Levy,azuremyst,1279,priest,discipline,53,25,28
Tôto,stormreaver,1279,priest,discipline,48,19,29
Authorized,azshara,1279,priest,discipline,54,21,33
Gagai,ravencrest,1279,priest,discipline,36,14,22
Dayu,blackrock,1279,priest,discipline,48,18,30
Mournus,defias-brotherhood,1278,priest,discipline,155,89,66
Dinma,argent-dawn,1278,priest,discipline,225,120,105
Wildjaevel,grim-batol,1278,priest,discipline,68,32,36
Soltum,eredar,1278,priest,discipline,54,22,32
Spaghettoni,tarren-mill,1278,priest,discipline,35,14,21
Judâspriest,twisting-nether,1277,priest,discipline,66,37,29
Manita,archimonde,1277,priest,discipline,38,21,17
Smitey,terenas,1277,priest,discipline,269,138,131
Clua,draenor,1277,priest,discipline,102,52,50
Энлинна,soulflayer,1277,priest,discipline,40,20,20
Anaalipeura,stormreaver,1277,priest,discipline,135,58,77
Pändöræ,archimonde,1277,priest,discipline,54,18,36
Chuwbakka,kazzak,1276,priest,discipline,142,77,65
Fullymetalz,defias-brotherhood,1276,priest,discipline,64,34,30
Ästûr,sanguino,1276,priest,discipline,102,54,48
Catvrix,ravencrest,1276,priest,discipline,106,56,50
Brainðead,aegwynn,1276,priest,discipline,64,33,31
Îndura,drakthul,1276,priest,discipline,123,62,61
Squirpox,outland,1276,priest,discipline,48,24,24
Smooky,arakarahm,1276,priest,discipline,89,41,48
Zenoo,argent-dawn,1275,priest,discipline,36,22,14
Zerotorone,stormscale,1275,priest,discipline,116,58,58
Healy,blackrock,1275,priest,discipline,199,97,102
Durmadanbas,ravencrest,1275,priest,discipline,163,74,89
Disz,zuljin,1275,priest,discipline,71,31,40
Capriestun,hellfire,1274,priest,discipline,34,20,14
Mallkie,ysondre,1274,priest,discipline,42,24,18
Jezlung,frostmane,1274,priest,discipline,105,59,46
Топчикс,gordunni,1274,priest,discipline,100,51,49
Xyrël,blackrock,1274,priest,discipline,30,15,15
Вартэг,blackscar,1274,priest,discipline,72,35,37
Dhed,turalyon,1274,priest,discipline,49,22,27
Harume,argent-dawn,1273,priest,discipline,24,14,10
Voidjutsu,draenor,1273,priest,discipline,182,92,90
Vedina,bronze-dragonflight,1273,priest,discipline,96,46,50
Koskice,moonglade,1272,priest,discipline,18,15,3
Méla,pozzo-delleternità,1272,priest,discipline,77,44,33
Ksiadzrydzyk,draenor,1272,priest,discipline,72,41,31
Svetidjordje,tarren-mill,1272,priest,discipline,39,19,20
Мазка,galakrond,1272,priest,discipline,90,43,47
Sørney,aegwynn,1271,priest,discipline,27,18,9
Chowhone,archimonde,1271,priest,discipline,198,99,99
Liaru,aegwynn,1271,priest,discipline,114,43,71
Шпалкоклоб,soulflayer,1270,priest,discipline,30,18,12
Mishas,draenor,1270,priest,discipline,42,24,18
Schrêiwa,aegwynn,1270,priest,discipline,30,16,14
Holyswift,dun-morogh,1270,priest,discipline,230,121,109
Lilycat,silvermoon,1270,priest,discipline,71,37,34
Aggresivdisc,hyjal,1270,priest,discipline,49,24,25
Стромъяр,gordunni,1270,priest,discipline,29,14,15
Theunknown,stormscale,1270,priest,discipline,35,15,20
Noncuro,tarren-mill,1270,priest,discipline,36,15,21
Seniya,argent-dawn,1270,priest,discipline,51,19,32
Ðøð,dalaran,1269,priest,discipline,123,70,53
Enigam,alakir,1269,priest,discipline,92,48,44
Joebando,ravencrest,1269,priest,discipline,338,171,167
Mitø,ravencrest,1269,priest,discipline,39,17,22
Kreador,twisting-nether,1269,priest,discipline,96,40,56
Sçumbåg,sylvanas,1269,priest,discipline,72,30,42
Battleprey,the-maelstrom,1268,priest,discipline,36,23,13
Vzã,krasus,1268,priest,discipline,596,297,299
Bigfnatlund,silvermoon,1268,priest,discipline,59,29,30
Taiz,los-errantes,1268,priest,discipline,106,45,61
Letsrock,aggra-português,1268,priest,discipline,42,15,27
Howaya,la-croisade-écarlate,1267,priest,discipline,78,42,36
Fixyou,aggra-português,1267,priest,discipline,161,79,82
Brronxx,frostwolf,1267,priest,discipline,30,14,16
Blaçkout,ravencrest,1267,priest,discipline,130,54,76
Tryqi,drakthul,1267,priest,discipline,48,18,30
Мерго,grom,1267,priest,discipline,74,26,48
Сорвиголов,howling-fjord,1266,priest,discipline,46,31,15
Маскона,howling-fjord,1266,priest,discipline,46,30,16
Skyliné,blackhand,1266,priest,discipline,98,52,46
Montane,wrathbringer,1266,priest,discipline,36,16,20
Свапмиплиз,gordunni,1265,priest,discipline,250,121,129
Nightstyle,nethersturm,1265,priest,discipline,113,54,59
Obscurus,kaelthas,1265,priest,discipline,119,56,63
Shaydi,todeswache,1264,priest,discipline,30,22,8
Lighter,dragonblight,1264,priest,discipline,106,64,42
Shadowpeste,aggra-português,1264,priest,discipline,156,86,70
Alreadylost,ragnaros,1264,priest,discipline,30,14,16
Nieudolny,ravencrest,1264,priest,discipline,44,19,25
Mental,stormscale,1264,priest,discipline,42,18,24
Maylà,aegwynn,1264,priest,discipline,106,43,63
Jeanpipe,khaz-modan,1263,priest,discipline,47,29,18
Techipriest,ravencrest,1263,priest,discipline,30,18,12
Palitox,kazzak,1263,priest,discipline,54,30,24
Madilim,kazzak,1263,priest,discipline,53,28,25
Liaril,sanguino,1263,priest,discipline,42,22,20
Ruîzz,sanguino,1263,priest,discipline,212,102,110
Donbas,tarren-mill,1263,priest,discipline,42,20,22
Kertith,argent-dawn,1263,priest,discipline,91,43,48
Haysér,frostmane,1263,priest,discipline,34,15,19
Seneth,twisting-nether,1263,priest,discipline,41,16,25
Mandzukic,stormscale,1262,priest,discipline,42,24,18
Deneye,thunderhorn,1262,priest,discipline,108,61,47
Gutfroy,conseil-des-ombres,1262,priest,discipline,75,42,33
Khato,rexxar,1262,priest,discipline,75,39,36
Íhðly,silvermoon,1262,priest,discipline,231,114,117
Дайбчик,gordunni,1261,priest,discipline,80,45,35
Vainry,argent-dawn,1261,priest,discipline,90,46,44
Chane,blackmoore,1261,priest,discipline,187,91,96
Suseetha,sylvanas,1261,priest,discipline,75,35,40
Rhåenyra,ravencrest,1260,priest,discipline,36,23,13
Xkv,blackmoore,1260,priest,discipline,66,39,27
Virgosenpai,silvermoon,1260,priest,discipline,57,28,29
Тэвиель,gordunni,1260,priest,discipline,144,61,83
Liasanya,kelthuzad,1259,priest,discipline,30,18,12
Oncooldown,thrall,1259,priest,discipline,164,80,84
Fuditth,aggra-português,1259,priest,discipline,41,20,21
Coolestguy,ravencrest,1259,priest,discipline,83,38,45
Popelings,twisting-nether,1259,priest,discipline,54,20,34
Qyi,the-maelstrom,1258,priest,discipline,54,31,23
Сюрпрайзик,gordunni,1258,priest,discipline,36,20,16
Romelu,archimonde,1258,priest,discipline,102,56,46
Badgirlterri,hyjal,1258,priest,discipline,88,45,43
Pindakong,dragonblight,1258,priest,discipline,142,72,70
Holyguys,twisting-nether,1258,priest,discipline,125,61,64
Ernyos,anubarak,1258,priest,discipline,54,24,30
Утяути,ashenvale,1258,priest,discipline,34,14,20
Priztar,nazjatar,1257,priest,discipline,60,35,25
Capriéstsun,ravencrest,1257,priest,discipline,40,23,17
Акктуальная,deepholm,1257,priest,discipline,90,47,43
Añgêl,ravencrest,1257,priest,discipline,195,99,96
Gudrinieks,shattered-halls,1257,priest,discipline,93,41,52
Kïmbo,kazzak,1257,priest,discipline,71,28,43
Prooph,tarren-mill,1256,priest,discipline,42,23,19
Numi,blackmoore,1256,priest,discipline,191,104,87
Asnur,argent-dawn,1256,priest,discipline,96,50,46
Øwlsoo,confrérie-du-thorium,1256,priest,discipline,136,70,66
Sephìrøth,malganis,1256,priest,discipline,114,53,61
Siphall,kirin-tor,1256,priest,discipline,59,27,32
Lothbruke,twisting-nether,1256,priest,discipline,170,77,93
Schlúckunweg,antonidas,1256,priest,discipline,102,46,56
Saltfeskball,tarren-mill,1255,priest,discipline,38,18,20
Mwxz,ravencrest,1255,priest,discipline,36,17,19
Zergo,karazhan,1255,priest,discipline,235,110,125
Míllerzz,ragnaros,1255,priest,discipline,54,22,32
Praystatîon,dragonblight,1254,priest,discipline,132,80,52
Headieone,kazzak,1254,priest,discipline,30,18,12
Гантелявухо,eversong,1254,priest,discipline,30,17,13
Renesmè,archimonde,1254,priest,discipline,42,20,22
Piixld,aegwynn,1253,priest,discipline,24,14,10
Zranda,magtheridon,1253,priest,discipline,192,96,96
Chrissirr,culte-de-la-rive-noire,1253,priest,discipline,36,18,18
Suzziee,silvermoon,1253,priest,discipline,118,58,60
Attenna,ravencrest,1253,priest,discipline,99,44,55
Zikár,kazzak,1253,priest,discipline,39,15,24
Ожившийприст,soulflayer,1252,priest,discipline,165,91,74
Superfelyn,ragnaros,1252,priest,discipline,57,29,28
Angusbeêf,blackrock,1252,priest,discipline,314,159,155
Pillian,nordrassil,1252,priest,discipline,28,14,14
Discokuken,outland,1252,priest,discipline,77,35,42
Blackheal,sanguino,1252,priest,discipline,179,79,100
Azazzel,nathrezim,1252,priest,discipline,82,34,48
Torcena,garrosh,1252,priest,discipline,48,16,32
Zolfiqar,tarren-mill,1251,priest,discipline,60,37,23
Juhduss,tarren-mill,1251,priest,discipline,41,22,19
Даркфолс,soulflayer,1251,priest,discipline,59,30,29
Leprie,draenor,1251,priest,discipline,63,29,34
Джаджафирз,howling-fjord,1251,priest,discipline,50,22,28
Nazo,sylvanas,1250,priest,discipline,113,63,50
Болътвоя,gordunni,1250,priest,discipline,54,30,24
Малмортис,soulflayer,1250,priest,discipline,107,58,49
Zentro,turalyon,1250,priest,discipline,145,70,75
Tristessê,tarren-mill,1250,priest,discipline,432,203,229
Estarôn,antonidas,1250,priest,discipline,54,23,31
Compact,blackrock,1250,priest,discipline,90,37,53
Insicompany,antonidas,1250,priest,discipline,46,18,28
Szeky,ragnaros,1250,priest,discipline,54,21,33
Popegoat,ragnaros,1249,priest,discipline,150,92,58
Sdw,kargath,1249,priest,discipline,33,19,14
Isoris,hyjal,1249,priest,discipline,58,29,29
Crazypablito,burning-legion,1249,priest,discipline,71,32,39
Cartøøns,ravencrest,1249,priest,discipline,88,39,49
Arklim,burning-blade,1249,priest,discipline,119,51,68
Iskáral,frostmourne,1249,priest,discipline,78,26,52
Cbbigbape,thrall,1248,priest,discipline,18,13,5
Pixelpriest,argent-dawn,1248,priest,discipline,186,109,77
Suprenext,draenor,1248,priest,discipline,24,13,11
Одинокаягора,gordunni,1248,priest,discipline,93,46,47
Gacoo,silvermoon,1248,priest,discipline,245,119,126
Desmile,eredar,1248,priest,discipline,60,28,32
Proxsjr,ravencrest,1248,priest,discipline,30,13,17
Stmichael,silvermoon,1248,priest,discipline,38,15,23
Skillir,der-abyssische-rat,1247,priest,discipline,18,13,5
Litenbitbifx,twisting-nether,1247,priest,discipline,18,13,5
Wontdispel,ravencrest,1247,priest,discipline,24,13,11
Finizkram,sylvanas,1247,priest,discipline,24,13,11
Scammers,argent-dawn,1247,priest,discipline,24,13,11
Плут,blackscar,1247,priest,discipline,82,44,38
Lalola,tarren-mill,1247,priest,discipline,203,104,99
Stilnðx,nemesis,1247,priest,discipline,119,52,67
Malíficent,draenor,1247,priest,discipline,36,15,21
Xourin,blackrock,1247,priest,discipline,34,14,20
Niwothethird,ravencrest,1246,priest,discipline,16,14,2
Zenfangirlx,kazzak,1246,priest,discipline,18,13,5
Bottom,blackmoore,1246,priest,discipline,24,13,11
Bowellpriest,magtheridon,1246,priest,discipline,45,23,22
Nixxaa,drakthul,1246,priest,discipline,48,22,26
Quepimquepam,tarren-mill,1246,priest,discipline,41,18,23
Boniesmack,stormscale,1246,priest,discipline,48,21,27
Frikitouna,uldum,1246,priest,discipline,30,13,17
Gloffoló,ragnaros,1246,priest,discipline,30,13,17
Muant,twisting-nether,1246,priest,discipline,30,13,17
Luilos,twisting-nether,1246,priest,discipline,120,50,70
Golthog,rashgarroth,1245,priest,discipline,24,16,8
Dade,nemesis,1245,priest,discipline,24,13,11
Søînx,archimonde,1245,priest,discipline,61,32,29
Smellypecker,argent-dawn,1245,priest,discipline,78,40,38
Shaquíloheal,blackrock,1245,priest,discipline,30,13,17
Prestigé,vashj,1245,priest,discipline,30,13,17
Têmplârx,stormscale,1245,priest,discipline,30,13,17
Divaz,eredar,1245,priest,discipline,78,33,45
Drïxit,illidan,1245,priest,discipline,36,13,23
Theycmedotin,blackhand,1245,priest,discipline,42,13,29
Moonacky,bronze-dragonflight,1244,priest,discipline,18,13,5
Hotdog,kult-der-verdammten,1244,priest,discipline,30,17,13
Kovács,tarren-mill,1244,priest,discipline,105,59,46
Ulalume,ravencrest,1244,priest,discipline,72,40,32
Lykster,blackrock,1244,priest,discipline,50,27,23
Килфлэш,howling-fjord,1244,priest,discipline,53,28,25
Styleexdd,ragnaros,1244,priest,discipline,104,54,50
Nomps,stormscale,1244,priest,discipline,52,27,25
Asuriyan,ravenholdt,1244,priest,discipline,112,55,57
Имудонка,gordunni,1244,priest,discipline,139,66,73
Doombrew,blackmoore,1244,priest,discipline,30,13,17
Пропитал,booty-bay,1244,priest,discipline,42,17,25
Takeoff,dun-morogh,1243,priest,discipline,36,23,13
Nogz,rashgarroth,1243,priest,discipline,95,56,39
Chalecø,dun-modr,1243,priest,discipline,24,13,11
Tjackballé,tarren-mill,1243,priest,discipline,24,13,11
Новокшан,soulflayer,1243,priest,discipline,45,23,22
Officinalis,hyjal,1243,priest,discipline,104,52,52
Priestagon,azjolnerub,1243,priest,discipline,30,15,15
Déspaír,silvermoon,1243,priest,discipline,221,110,111
Jazzek,burning-legion,1243,priest,discipline,92,42,50
Luxor,outland,1243,priest,discipline,30,13,17
Xälis,ysondre,1243,priest,discipline,66,23,43
Haileybailey,stormreaver,1242,priest,discipline,46,33,13
Negcntsm,aegwynn,1242,priest,discipline,47,27,20
Ultraviojung,kazzak,1242,priest,discipline,72,39,33
Мсикатана,gordunni,1242,priest,discipline,24,13,11
Jessijones,gorgonnash,1242,priest,discipline,24,13,11
Thundiz,archimonde,1242,priest,discipline,24,13,11
Novilas,thrall,1242,priest,discipline,54,29,25
Magnificito,silvermoon,1242,priest,discipline,60,32,28
Lévention,stormscale,1242,priest,discipline,40,21,19
Imnotep,dun-modr,1242,priest,discipline,83,41,42
Facemelterx,azjolnerub,1242,priest,discipline,42,19,23
Verrottênd,frostwolf,1242,priest,discipline,118,52,66
Zìrkâ,drekthar,1242,priest,discipline,75,30,45
Captaìncrazy,tarren-mill,1242,priest,discipline,62,23,39
Grandpatea,silvermoon,1241,priest,discipline,18,13,5
Toasttwo,kazzak,1241,priest,discipline,18,13,5
Pownme,blackmoore,1241,priest,discipline,60,36,24
Deyxq,lothar,1241,priest,discipline,24,13,11
Rog,norgannon,1241,priest,discipline,36,19,17
Buckless,kazzak,1241,priest,discipline,77,40,37
Áphrodite,outland,1241,priest,discipline,53,26,27
Velerana,silvermoon,1241,priest,discipline,30,14,16
Thielaxx,ravencrest,1241,priest,discipline,39,13,26
Yves,malygos,1240,priest,discipline,24,14,10
Stryymm,bloodhoof,1240,priest,discipline,29,16,13
Trimégiste,hyjal,1240,priest,discipline,196,103,93
Tutenhamonek,outland,1240,priest,discipline,120,62,58
Kellen,burning-blade,1240,priest,discipline,162,82,80
Zamurak,outland,1240,priest,discipline,119,59,60
Kiesp,tarren-mill,1240,priest,discipline,147,71,76
Æzy,burning-blade,1240,priest,discipline,54,26,28
Карнотит,howling-fjord,1240,priest,discipline,216,100,116
Petshopboi,sylvanas,1240,priest,discipline,33,15,18
Krìnzy,illidan,1240,priest,discipline,138,59,79
Gilfir,stormscale,1240,priest,discipline,113,48,65
Aptz,twisting-nether,1240,priest,discipline,36,13,23
Zul,nemesis,1239,priest,discipline,24,14,10
Druzhok,sylvanas,1239,priest,discipline,24,13,11
Ðyøx,ravencrest,1239,priest,discipline,24,13,11
Стиллх,blackscar,1239,priest,discipline,97,49,48
Lightwøød,khaz-modan,1239,priest,discipline,281,141,140
Vèrcs,silvermoon,1239,priest,discipline,71,35,36
Idjut,kazzak,1239,priest,discipline,42,20,22
Noyxz,frostmourne,1239,priest,discipline,44,20,24
Madreöscura,cthun,1239,priest,discipline,75,32,43
Melitelle,ravencrest,1239,priest,discipline,38,14,24
Ünholy,burning-legion,1238,priest,discipline,63,38,25
Ezrox,neptulon,1238,priest,discipline,87,45,42
Apèx,blackrock,1238,priest,discipline,78,40,38
Türapea,draenor,1238,priest,discipline,122,61,61
Griniel,marécage-de-zangar,1238,priest,discipline,46,22,24
Moonsalt,doomhammer,1238,priest,discipline,36,17,19
Crop,nemesis,1238,priest,discipline,54,21,33
Бичиотаке,azuregos,1238,priest,discipline,36,13,23
Mandible,aggramar,1237,priest,discipline,42,26,16
Fingerblast,sanguino,1237,priest,discipline,60,36,24
Javvi,sylvanas,1237,priest,discipline,100,59,41
Hygîa,ravencrest,1237,priest,discipline,24,14,10
Rollingpork,burning-legion,1237,priest,discipline,30,16,14
Serach,ravencrest,1237,priest,discipline,36,19,17
Csiillux,ragnaros,1237,priest,discipline,72,37,35
Potatø,antonidas,1237,priest,discipline,114,58,56
Aléhyl,la-croisade-écarlate,1237,priest,discipline,388,194,194
Sazo,drakthul,1237,priest,discipline,38,16,22
Mcbooee,outland,1236,priest,discipline,115,61,54
Piotrek,hyjal,1236,priest,discipline,40,20,20
Sahu,kult-der-verdammten,1236,priest,discipline,44,21,23
Velix,outland,1235,priest,discipline,18,13,5
Odysseuz,nazjatar,1235,priest,discipline,51,28,23
Nelvor,silvermoon,1235,priest,discipline,65,35,30
Holycowheals,the-maelstrom,1235,priest,discipline,149,80,69
Щакактрахнем,gordunni,1235,priest,discipline,132,63,69
Nemista,hyjal,1235,priest,discipline,78,37,41
Fiftyfives,hyjal,1235,priest,discipline,30,13,17
Plzhealme,stormscale,1234,priest,discipline,18,15,3
Mivale,aszune,1234,priest,discipline,26,15,11
Itchzi,alonsus,1234,priest,discipline,102,53,49
Neytirinqt,doomhammer,1234,priest,discipline,218,110,108
Dapristes,silvermoon,1234,priest,discipline,47,23,24
Tlc,dragonmaw,1234,priest,discipline,163,77,86
Lousp,tarren-mill,1234,priest,discipline,69,32,37
Zubrowkâ,kazzak,1234,priest,discipline,104,48,56
Jakner,nemesis,1234,priest,discipline,60,27,33
Preoteasa,kazzak,1234,priest,discipline,120,52,68
Skiplegday,blackrock,1234,priest,discipline,49,21,28
Karanas,archimonde,1234,priest,discipline,121,47,74
Séfaron,blackmoore,1233,priest,discipline,93,51,42
Somai,aegwynn,1233,priest,discipline,24,13,11
Felï,tichondrius,1233,priest,discipline,33,17,16
Brach,nazjatar,1233,priest,discipline,138,70,68
Kangkong,burning-legion,1233,priest,discipline,45,22,23
Hêsêkiêl,eredar,1233,priest,discipline,96,46,50
Addickted,defias-brotherhood,1232,priest,discipline,36,20,16
Napriest,kazzak,1232,priest,discipline,24,13,11
Temril,aegwynn,1232,priest,discipline,228,117,111
Seras,bloodfeather,1232,priest,discipline,266,132,134
Janinw,sylvanas,1232,priest,discipline,30,13,17
Relöaded,kazzak,1232,priest,discipline,144,60,84
Mythsionx,blackmoore,1232,priest,discipline,66,26,40
Alisíria,sylvanas,1231,priest,discipline,95,52,43
Galilea,sanguino,1231,priest,discipline,24,13,11
Jimmyhoffa,stormscale,1231,priest,discipline,108,57,51
Ticklebell,ravencrest,1231,priest,discipline,279,147,132
Whitehusky,antonidas,1231,priest,discipline,72,37,35
Héternel,ysondre,1231,priest,discipline,120,59,61
Залупский,gordunni,1231,priest,discipline,60,29,31
Blondi,darksorrow,1231,priest,discipline,118,55,63
Holykaka,tarren-mill,1231,priest,discipline,90,41,49
Мерсициглер,gordunni,1231,priest,discipline,55,24,31
Brøwney,blackmoore,1231,priest,discipline,77,33,44
Whiteshadöw,archimonde,1231,priest,discipline,66,25,41
Jaydeenxd,ravencrest,1231,priest,discipline,42,13,29
Абсорберша,gordunni,1230,priest,discipline,36,21,15
Tokushiro,sylvanas,1230,priest,discipline,48,25,23
Зашохэйт,soulflayer,1230,priest,discipline,79,40,39
Bolíngbroke,argent-dawn,1230,priest,discipline,149,74,75
Sacerfull,sanguino,1230,priest,discipline,165,80,85
Omnissiiah,silvermoon,1230,priest,discipline,42,14,28
Ailishaa,blackmoore,1229,priest,discipline,163,94,69
Джейнкелли,borean-tundra,1229,priest,discipline,325,177,148
Downtrone,blackrock,1229,priest,discipline,308,154,154
Soehzz,khaz-modan,1229,priest,discipline,132,66,66
Ellianore,les-sentinelles,1229,priest,discipline,112,54,58
Walotar,chamber-of-aspects,1229,priest,discipline,78,37,41
Holydoughnut,stormscale,1229,priest,discipline,66,31,35
Grimveil,sylvanas,1229,priest,discipline,107,50,57
Пенансиня,gordunni,1229,priest,discipline,36,13,23
Epsxy,ysondre,1228,priest,discipline,80,41,39
Natsuki,illidan,1228,priest,discipline,136,67,69
Nostramo,kirin-tor,1228,priest,discipline,60,23,37
Felerman,kazzak,1228,priest,discipline,36,13,23
Anthamonn,drakthul,1228,priest,discipline,36,13,23
Дракулесса,gordunni,1227,priest,discipline,75,38,37
Sinatra,sylvanas,1227,priest,discipline,163,80,83
Héntai,argent-dawn,1227,priest,discipline,42,19,23
Discönnect,kazzak,1226,priest,discipline,18,13,5
Волкерия,howling-fjord,1226,priest,discipline,124,70,54
Dopemine,ragnaros,1226,priest,discipline,73,38,35
Xidrin,antonidas,1226,priest,discipline,46,23,23
Euphorius,blackmoore,1226,priest,discipline,84,39,45
Sprife,ragnaros,1226,priest,discipline,52,22,30
Vishnia,defias-brotherhood,1226,priest,discipline,52,22,30
Sanbucone,pozzo-delleternità,1225,priest,discipline,96,53,43
Aquillon,outland,1225,priest,discipline,24,13,11
Índica,stormreaver,1225,priest,discipline,113,59,54
Netomv,kazzak,1225,priest,discipline,53,27,26
Хавейл,gordunni,1225,priest,discipline,119,60,59
Tüddelmôrs,eredar,1225,priest,discipline,58,29,29
Snucki,eredar,1225,priest,discipline,30,15,15
Discovery,aggra-português,1225,priest,discipline,91,45,46
Жрицазла,soulflayer,1225,priest,discipline,84,41,43
Saat,dalaran,1224,priest,discipline,32,21,11
Baglet,ravencrest,1224,priest,discipline,24,13,11
Krakjak,twisting-nether,1224,priest,discipline,80,39,41
Bananensuppe,kult-der-verdammten,1224,priest,discipline,120,56,64
Garie,thrall,1224,priest,discipline,122,55,67
Elfhelp,ravencrest,1224,priest,discipline,140,62,78
Рукатёмная,soulflayer,1224,priest,discipline,90,39,51
Pharli,stormscale,1224,priest,discipline,30,13,17
Nøwénna,ravencrest,1224,priest,discipline,48,13,35
Pontifex,baelgun,1223,priest,discipline,329,174,155
Baihoi,twilights-hammer,1223,priest,discipline,60,31,29
Nupzie,stormscale,1223,priest,discipline,111,57,54
Huhu,defias-brotherhood,1223,priest,discipline,41,21,20
Critikal,dun-modr,1223,priest,discipline,90,35,55
Dizzaer,terokkar,1223,priest,discipline,36,14,22
Elenyel,thunderhorn,1222,priest,discipline,18,13,5
Cherrycat,doomhammer,1222,priest,discipline,331,167,164
Kafrine,kaelthas,1222,priest,discipline,81,38,43
Diçkhëad,ravencrest,1221,priest,discipline,133,67,66
Sandaal,drakthul,1221,priest,discipline,119,59,60
Annéfetamine,ragnaros,1221,priest,discipline,54,19,35
Stigy,auchindoun,1220,priest,discipline,120,62,58
Aetherah,outland,1220,priest,discipline,150,75,75
Aerosoll,drakthul,1220,priest,discipline,42,21,21
Nicnacz,stormscale,1220,priest,discipline,142,67,75
Самурайко,booty-bay,1220,priest,discipline,97,45,52
Gullys,drakthul,1220,priest,discipline,42,17,25
Myskou,ragnaros,1219,priest,discipline,24,19,5
Hopsalopsa,argent-dawn,1219,priest,discipline,18,13,5
Talonjean,conseil-des-ombres,1218,priest,discipline,24,13,11
Loetharion,archimonde,1218,priest,discipline,82,44,38
Ehrmantràut,draenor,1218,priest,discipline,47,25,22
Anethron,ragnaros,1218,priest,discipline,254,133,121
Arenarooky,eredar,1218,priest,discipline,72,35,37
Монесса,howling-fjord,1218,priest,discipline,68,32,36
Eduaro,silvermoon,1218,priest,discipline,34,15,19
Thakjing,bladefist,1218,priest,discipline,52,20,32
Kaleshiry,kazzak,1218,priest,discipline,54,20,34
Tiïnstrument,khaz-modan,1217,priest,discipline,94,51,43
Pleistras,magtheridon,1217,priest,discipline,264,142,122
Сеферота,howling-fjord,1217,priest,discipline,30,15,15
Simbaba,archimonde,1217,priest,discipline,197,98,99
Drennaria,draenor,1217,priest,discipline,83,40,43
Nìak,ysondre,1217,priest,discipline,100,39,61
Søs,eldrethalas,1216,priest,discipline,96,55,41
Аэрэта,deathguard,1216,priest,discipline,135,73,62
Healsquad,draenor,1216,priest,discipline,128,64,64
Шадоулайтлол,soulflayer,1216,priest,discipline,54,26,28
Shadoomed,kazzak,1216,priest,discipline,78,32,46
Frauheilung,blackmoore,1216,priest,discipline,71,27,44
Osyrîss,garona,1216,priest,discipline,48,16,32
Rngq,burning-blade,1215,priest,discipline,23,13,10
Gooldan,draenor,1215,priest,discipline,198,108,90
Patoroch,terokkar,1215,priest,discipline,54,29,25
Лолиэль,soulflayer,1215,priest,discipline,93,49,44
Orbea,sinstralis,1214,priest,discipline,28,23,5
Диери,soulflayer,1214,priest,discipline,40,24,16
Feydottir,draenor,1214,priest,discipline,36,19,17
Valnaya,draenor,1214,priest,discipline,146,77,69
Nimako,silvermoon,1214,priest,discipline,160,78,82
Аквариусс,gordunni,1214,priest,discipline,94,45,49
Флэнсер,soulflayer,1214,priest,discipline,276,131,145
Тонкаявишня,howling-fjord,1214,priest,discipline,94,38,56
Leahlimit,kazzak,1214,priest,discipline,36,13,23
Nymrasus,ravencrest,1213,priest,discipline,24,13,11
Makrit,outland,1213,priest,discipline,158,79,79
Raî,durotan,1213,priest,discipline,62,31,31
Littleabs,the-maelstrom,1213,priest,discipline,77,38,39
Enerpriest,ysondre,1213,priest,discipline,96,46,50
Darkheall,sanguino,1213,priest,discipline,107,48,59
Santinix,drakthul,1213,priest,discipline,108,48,60
Tîwele,dalvengyr,1213,priest,discipline,79,31,48
Javiér,dun-modr,1213,priest,discipline,48,18,30
Вреднючая,gordunni,1212,priest,discipline,42,29,13
Eslo,outland,1212,priest,discipline,48,26,22
Gertie,blackhand,1212,priest,discipline,106,57,49
Healeurway,dalaran,1212,priest,discipline,319,163,156
Dotsin,kazzak,1212,priest,discipline,311,157,154
Свежага,howling-fjord,1212,priest,discipline,123,58,65
Ziraclès,archimonde,1212,priest,discipline,54,25,29
Nolosme,blackrock,1212,priest,discipline,96,39,57
Neosix,sanguino,1211,priest,discipline,66,36,30
Gsync,drakthul,1211,priest,discipline,24,13,11
Allisandre,hellscream,1211,priest,discipline,36,18,18
Кравос,soulflayer,1211,priest,discipline,47,21,26
Beliar,azshara,1211,priest,discipline,42,13,29
Izaa,silvermoon,1210,priest,discipline,60,26,34
Swaggerboy,alakir,1210,priest,discipline,41,13,28
Sayto,kaelthas,1209,priest,discipline,48,26,22
Jeuwls,argent-dawn,1209,priest,discipline,121,64,57
Mmh,haomarush,1209,priest,discipline,33,13,20
Гуляль,howling-fjord,1208,priest,discipline,124,70,54
Arondir,defias-brotherhood,1208,priest,discipline,112,60,52
Dúréx,sanguino,1208,priest,discipline,45,22,23
Iømÿnudir,archimonde,1208,priest,discipline,199,97,102
Nossn,ravencrest,1208,priest,discipline,60,29,31
Milfelina,ravencrest,1208,priest,discipline,63,26,37
Soleyy,outland,1208,priest,discipline,44,14,30
Voodoo,the-maelstrom,1207,priest,discipline,24,13,11
Могвайи,soulflayer,1207,priest,discipline,72,38,34
Duem,kazzak,1207,priest,discipline,62,31,31
Nëophytë,zuljin,1207,priest,discipline,78,38,40
Vilda,argent-dawn,1207,priest,discipline,60,27,33
Detlaff,kazzak,1207,priest,discipline,48,19,29
Zerula,outland,1206,priest,discipline,500,252,248
Holymoni,ragnaros,1206,priest,discipline,60,30,30
Elanura,blackrock,1206,priest,discipline,31,15,16
Bòóni,ravencrest,1206,priest,discipline,53,23,30
Опрометчивый,soulflayer,1206,priest,discipline,56,24,32
Thyrandis,dragonblight,1206,priest,discipline,34,14,20
Sluttyfåk,aszune,1205,priest,discipline,29,19,10
Crazyhemsire,twisting-nether,1205,priest,discipline,54,31,23
Джузеппо,soulflayer,1205,priest,discipline,60,33,27
Eïtham,sanguino,1205,priest,discipline,139,69,70
Nethenielle,malganis,1205,priest,discipline,42,20,22
Hysteç,ragnaros,1205,priest,discipline,57,26,31
Kenderke,ragnaros,1205,priest,discipline,53,24,29
Madvortexe,kazzak,1205,priest,discipline,48,21,27
Illcomback,archimonde,1204,priest,discipline,47,28,19
Siionova,antonidas,1204,priest,discipline,57,31,26
Tira,darksorrow,1204,priest,discipline,24,13,11
Demorog,stormscale,1204,priest,discipline,36,19,17
Тосибоська,gordunni,1204,priest,discipline,29,15,14
Sisdenna,doomhammer,1204,priest,discipline,296,153,143
Asolan,drakthul,1204,priest,discipline,192,98,94
Worldjudge,kazzak,1204,priest,discipline,200,100,100
Pénancé,defias-brotherhood,1204,priest,discipline,59,28,31
Natsukie,gorgonnash,1204,priest,discipline,60,27,33
Deppara,twisting-nether,1203,priest,discipline,69,40,29
Забвениеждёт,gordunni,1203,priest,discipline,89,41,48
Pôl,tarren-mill,1203,priest,discipline,45,20,25
Aragona,tarren-mill,1203,priest,discipline,56,23,33
Pleshiv,sanguino,1203,priest,discipline,39,14,25
Beaglep,blackrock,1203,priest,discipline,53,13,40
Wozix,blackhand,1202,priest,discipline,24,14,10
Педаньтяйка,gordunni,1202,priest,discipline,288,158,130
Lzmad,archimonde,1202,priest,discipline,72,38,34
Grabenkrieg,blackrock,1202,priest,discipline,159,67,92
Pbwser,silvermoon,1202,priest,discipline,42,13,29
Feoss,kaelthas,1201,priest,discipline,86,43,43
Adssdfhjgh,outland,1201,priest,discipline,30,15,15
Брожрец,gordunni,1201,priest,discipline,78,38,40
Infínite,emeriss,1201,priest,discipline,79,38,41
Shadowhawke,argent-dawn,1201,priest,discipline,97,43,54
Shelyndra,doomhammer,1201,priest,discipline,149,66,83
Hardloker,ravencrest,1201,priest,discipline,96,41,55
Холисайра,gordunni,1201,priest,discipline,48,16,32
Mjölkpelle,twisting-nether,1200,priest,discipline,30,23,7
Pasalacabra,zuljin,1200,priest,discipline,30,15,15
Chooser,stormscale,1200,priest,discipline,32,14,18
Balhlin,argent-dawn,1200,priest,discipline,88,38,50
Cøøbrà,hyjal,1199,priest,discipline,106,58,48
Réborn,tarren-mill,1199,priest,discipline,111,59,52
Невальнеш,howling-fjord,1199,priest,discipline,36,15,21
Kaktosz,ragnaros,1199,priest,discipline,84,32,52
Highpriestqt,pozzo-delleternità,1198,priest,discipline,24,13,11
Khai,tarren-mill,1198,priest,discipline,145,77,68
Pebbles,antonidas,1198,priest,discipline,42,21,21
Hensynsløs,draenor,1198,priest,discipline,97,47,50
Alptoxlôl,blackhand,1198,priest,discipline,66,31,35
Disconsick,vashj,1198,priest,discipline,209,86,123
Deliâz,aegwynn,1197,priest,discipline,84,33,51
Celina,quelthalas,1197,priest,discipline,42,13,29
Slyntan,ragnaros,1196,priest,discipline,30,16,14
Borgamor,frostmane,1196,priest,discipline,32,14,18
Drnoob,tarren-mill,1195,priest,discipline,56,29,27
Unleet,sylvanas,1195,priest,discipline,124,61,63
Äncient,ragnaros,1195,priest,discipline,60,28,32
Elclasico,blackrock,1195,priest,discipline,86,39,47
Rrdisc,kazzak,1195,priest,discipline,90,39,51
Oernzz,frostmane,1195,priest,discipline,35,13,22
Raptichou,hyjal,1194,priest,discipline,24,14,10
Ishvar,wildhammer,1194,priest,discipline,72,36,36
Drsmort,blackrock,1194,priest,discipline,159,78,81
Swdscript,drakthul,1194,priest,discipline,29,14,15
Æphix,outland,1194,priest,discipline,44,21,23
Lãwh,hyjal,1194,priest,discipline,95,45,50
Nigellä,azjolnerub,1194,priest,discipline,66,25,41
Bicepvein,sylvanas,1193,priest,discipline,21,13,8
Barbiemeth,silvermoon,1193,priest,discipline,379,187,192
Побьюкадилом,gordunni,1193,priest,discipline,49,21,28
Лилсейнтс,gordunni,1193,priest,discipline,48,14,34
Шуали,grom,1192,priest,discipline,106,54,52
Hòlymoly,stormscale,1192,priest,discipline,202,102,100
Vès,stormscale,1192,priest,discipline,114,56,58
Якакиисус,gordunni,1192,priest,discipline,136,65,71
Achillesheal,alakir,1192,priest,discipline,30,13,17
Tiefergelegt,arthas,1192,priest,discipline,66,27,39
Príester,rexxar,1191,priest,discipline,70,38,32
Rukiä,chogall,1191,priest,discipline,26,14,12
Pugnatorius,archimonde,1191,priest,discipline,87,41,46
Huljin,stormscale,1191,priest,discipline,68,32,36
Пофанчику,gordunni,1190,priest,discipline,107,49,58
Akhi,dun-morogh,1190,priest,discipline,34,14,20
Uro,tirion,1190,priest,discipline,41,14,27
Staatsfeind,blackmoore,1189,priest,discipline,81,44,37
Kochepri,archimonde,1189,priest,discipline,42,22,20
Zabajona,burning-legion,1189,priest,discipline,48,22,26
Piitixd,burning-legion,1189,priest,discipline,94,42,52
Aethana,ravencrest,1189,priest,discipline,52,23,29
Botoxo,zirkel-des-cenarius,1189,priest,discipline,30,13,17
Pínx,nerathor,1189,priest,discipline,36,15,21
Ewolet,silvermoon,1189,priest,discipline,36,14,22
Medycus,blackrock,1188,priest,discipline,110,50,60
Drtickomaru,drakthul,1188,priest,discipline,44,20,24
Lauvcraft,outland,1188,priest,discipline,42,19,23
Zùt,ysondre,1187,priest,discipline,122,62,60
Kiygokaya,blackmoore,1187,priest,discipline,30,15,15
Merkabah,azjolnerub,1187,priest,discipline,246,116,130
Shadowpope,frostmane,1187,priest,discipline,52,24,28
Megalodön,draenor,1187,priest,discipline,45,17,28
Telpriest,blackrock,1186,priest,discipline,43,20,23
Sastry,drakthul,1186,priest,discipline,54,23,31
Lillthya,kazzak,1186,priest,discipline,58,24,34
Shädøwn,chogall,1185,priest,discipline,24,19,5
Zhyn,turalyon,1185,priest,discipline,30,18,12
Nyuu,aggra-português,1185,priest,discipline,30,18,12
Gendzsó,ragnaros,1185,priest,discipline,30,18,12
Necromania,cthun,1185,priest,discipline,274,137,137
Cupcakes,ahnqiraj,1185,priest,discipline,78,36,42
Юкич,soulflayer,1185,priest,discipline,40,14,26
Lucianßk,sanguino,1184,priest,discipline,54,28,26
Tristar,nethersturm,1184,priest,discipline,47,21,26
Freezydot,silvermoon,1183,priest,discipline,87,49,38
Aprima,culte-de-la-rive-noire,1183,priest,discipline,84,44,40
Vempress,neptulon,1183,priest,discipline,251,121,130
Ghorfindel,kaelthas,1183,priest,discipline,107,49,58
Rizeup,darksorrow,1182,priest,discipline,50,31,19
Isore,culte-de-la-rive-noire,1182,priest,discipline,221,105,116
Athelstann,aegwynn,1182,priest,discipline,36,17,19
Nekros,agamaggan,1182,priest,discipline,32,15,17
Chaerii,blackmoore,1182,priest,discipline,96,42,54
Axewound,neptulon,1182,priest,discipline,30,13,17
Taili,ysondre,1182,priest,discipline,38,14,24
Biierlip,twisting-nether,1182,priest,discipline,83,28,55
Hasnaa,silvermoon,1181,priest,discipline,27,17,10
Leonard,nemesis,1181,priest,discipline,34,17,17
Dafúq,draenor,1181,priest,discipline,64,29,35
Healheal,outland,1180,priest,discipline,238,124,114
Confess,archimonde,1180,priest,discipline,48,25,23
Gesucristò,pozzo-delleternità,1180,priest,discipline,48,25,23
Swtt,sanguino,1180,priest,discipline,84,41,43
Iloa,dun-morogh,1178,priest,discipline,113,63,50
Wärtheur,sanguino,1178,priest,discipline,434,209,225
Wandéline,arathi,1178,priest,discipline,71,30,41
Kekwlel,sanguino,1178,priest,discipline,48,19,29
Vésph,draenor,1178,priest,discipline,111,42,69
Jaimeê,der-rat-von-dalaran,1177,priest,discipline,31,16,15
Капляболи,gordunni,1177,priest,discipline,106,54,52
Lightz,veklor,1177,priest,discipline,68,33,35
Güldbaék,silvermoon,1177,priest,discipline,48,23,25
Neddeadlius,outland,1177,priest,discipline,104,48,56
Amaloo,ravencrest,1177,priest,discipline,120,53,67
Джеиня,goldrinn,1177,priest,discipline,35,13,22
Вейтарен,gordunni,1177,priest,discipline,39,14,25
Kinn,kaelthas,1176,priest,discipline,84,44,40
Karellian,silvermoon,1176,priest,discipline,83,42,41
Nondi,frostmane,1175,priest,discipline,60,29,31
Úntrust,ravencrest,1175,priest,discipline,30,13,17
Malîken,silvermoon,1174,priest,discipline,48,29,19
Zaradana,tarren-mill,1174,priest,discipline,99,51,48
Wilem,sanguino,1174,priest,discipline,60,25,35
Рыск,grom,1173,priest,discipline,45,31,14
Templanzaa,cthun,1173,priest,discipline,71,36,35
Aladorius,la-croisade-écarlate,1172,priest,discipline,108,53,55
Ancium,silvermoon,1172,priest,discipline,30,13,17
Ландриала,howling-fjord,1172,priest,discipline,60,21,39
Парикнахер,soulflayer,1171,priest,discipline,36,23,13
Whysomadx,stormscale,1171,priest,discipline,163,72,91
Captn,draenor,1171,priest,discipline,54,22,32
Pohyoloo,turalyon,1170,priest,discipline,51,28,23
Gøðlìke,aegwynn,1170,priest,discipline,250,124,126
Мегаствол,howling-fjord,1170,priest,discipline,78,33,45
Àri,magtheridon,1170,priest,discipline,41,15,26
Diff,thrall,1169,priest,discipline,237,115,122
Сайннз,howling-fjord,1169,priest,discipline,180,86,94
Ноубадди,howling-fjord,1169,priest,discipline,67,32,35
Eludiya,silvermoon,1169,priest,discipline,122,55,67
Miséricordïe,dalaran,1169,priest,discipline,35,15,20
Vysevis,silvermoon,1169,priest,discipline,36,13,23
Bimbax,dun-modr,1169,priest,discipline,47,16,31
Mari,die-aldor,1168,priest,discipline,21,13,8
Aurea,deathwing,1168,priest,discipline,32,16,16
Kínson,the-maelstrom,1167,priest,discipline,97,53,44
Prognosis,frostwhisper,1167,priest,discipline,77,42,35
Hugokatt,silvermoon,1167,priest,discipline,25,13,12
Яестькенни,soulflayer,1167,priest,discipline,102,51,51
Healige,kazzak,1166,priest,discipline,46,21,25
Айболитова,grom,1166,priest,discipline,33,15,18
Byshadow,silvermoon,1166,priest,discipline,42,19,23
Dannebrog,eonar,1166,priest,discipline,71,32,39
Sòsò,archimonde,1165,priest,discipline,113,56,57
Dementzia,argent-dawn,1165,priest,discipline,143,68,75
Hambol,tarren-mill,1165,priest,discipline,60,27,33
Zugly,antonidas,1164,priest,discipline,36,19,17
Скорояпомощь,gordunni,1164,priest,discipline,161,84,77
Fragilex,uldaman,1164,priest,discipline,96,50,46
Blååb,draenor,1164,priest,discipline,25,13,12
Saru,uldaman,1164,priest,discipline,105,54,51
Пофанчику,soulflayer,1164,priest,discipline,101,51,50
Undeadv,twisting-nether,1164,priest,discipline,64,25,39
Redblue,onyxia,1163,priest,discipline,42,26,16
Bojestvena,neptulon,1163,priest,discipline,107,59,48
Tyto,drakthul,1163,priest,discipline,24,13,11
Xghazo,sylvanas,1163,priest,discipline,88,42,46
Biigy,hyjal,1163,priest,discipline,30,14,16
Olîra,hyjal,1163,priest,discipline,30,14,16
Brøs,blackmoore,1163,priest,discipline,64,26,38
Galâdríel,outland,1163,priest,discipline,67,22,45
Firstkiss,rexxar,1162,priest,discipline,66,35,31
Lísan,ravencrest,1162,priest,discipline,117,60,57
Klaura,blackmoore,1161,priest,discipline,30,15,15
Desperion,ragnaros,1161,priest,discipline,195,93,102
Lílíana,thrall,1161,priest,discipline,150,69,81
Латрам,greymane,1161,priest,discipline,130,58,72
Briareax,auchindoun,1160,priest,discipline,190,97,93
Jeus,malganis,1160,priest,discipline,77,36,41
Shaov,archimonde,1160,priest,discipline,48,22,26
Saveyourassl,dalaran,1160,priest,discipline,30,13,17
Miralou,ravencrest,1159,priest,discipline,664,333,331
Таймыр,gordunni,1159,priest,discipline,179,83,96
Акимбопушка,howling-fjord,1159,priest,discipline,74,27,47
Korvmoj,ravencrest,1158,priest,discipline,97,54,43
Holybestie,eredar,1158,priest,discipline,53,27,26
Vebbysor,sylvanas,1158,priest,discipline,30,15,15
Bepbepp,archimonde,1158,priest,discipline,44,21,23
Chega,malganis,1158,priest,discipline,126,56,70
Fîoras,blackrock,1157,priest,discipline,72,42,30
Johnnypleb,blackrock,1157,priest,discipline,126,65,61
Voidßringer,argent-dawn,1157,priest,discipline,136,68,68
Xeni,silvermoon,1157,priest,discipline,47,20,27
Dâhliá,blackmoore,1156,priest,discipline,43,20,23
Eník,blackrock,1156,priest,discipline,127,59,68
Nuklash,burning-legion,1156,priest,discipline,64,28,36
Arttos,antonidas,1156,priest,discipline,42,16,26
Vecaya,blackrock,1155,priest,discipline,42,22,20
Zelensky,stormscale,1155,priest,discipline,34,14,20
Silë,auchindoun,1155,priest,discipline,38,14,24
Подчинись,ashenvale,1154,priest,discipline,176,93,83
Sebiah,darksorrow,1154,priest,discipline,36,17,19
Umbraya,blackhand,1154,priest,discipline,90,30,60
Frittê,anetheron,1153,priest,discipline,99,51,48
Sildane,kirin-tor,1153,priest,discipline,84,42,42
Prstenskråka,ragnaros,1153,priest,discipline,48,22,26
Xakala,cthun,1152,priest,discipline,131,70,61
Heab,aegwynn,1152,priest,discipline,24,12,12
Djros,magtheridon,1152,priest,discipline,24,12,12
Feyerz,tarren-mill,1152,priest,discipline,24,12,12
Djrussia,tarren-mill,1152,priest,discipline,30,12,18
Yarok,anubarak,1151,priest,discipline,18,12,6
Entropý,blackrock,1151,priest,discipline,18,12,6
Bellrøck,nemesis,1151,priest,discipline,18,12,6
Ragnour,ysondre,1151,priest,discipline,79,44,35
Starzzovic,eredar,1151,priest,discipline,24,12,12
Bebsenpai,hyjal,1151,priest,discipline,24,12,12
Bigbishop,kazzak,1151,priest,discipline,24,12,12
Пусясвета,gordunni,1151,priest,discipline,24,12,12
Spëctre,archimonde,1151,priest,discipline,46,21,25
Shadeblaze,draenor,1151,priest,discipline,38,16,22
Debbski,tarren-mill,1151,priest,discipline,29,12,17
Ykwah,kazzak,1151,priest,discipline,30,12,18
Narisia,alakir,1151,priest,discipline,30,12,18
Hanic,kazzak,2421,priest,shadow,133,83,50
Huï,kazzak,2402,priest,shadow,78,58,20
Permafeetup,aegwynn,2386,priest,shadow,108,64,44
Даняпампгодх,soulflayer,2355,priest,shadow,295,153,142
Tentoumushi,ravencrest,2342,priest,shadow,108,64,44
Syedi,drakthul,2329,priest,shadow,462,240,222
Медовыедотки,soulflayer,2312,priest,shadow,173,93,80
Dianaxd,dun-modr,2294,priest,shadow,154,87,67
Raikup,ravencrest,2281,priest,shadow,125,67,58
Deathlý,blackrock,2254,priest,shadow,161,89,72
Ekkfwiedrice,ragnaros,2247,priest,shadow,126,73,53
Хедмэнмвп,gordunni,2246,priest,shadow,395,202,193
Yuzuflex,hyjal,2244,priest,shadow,147,77,70
Froffzy,tarren-mill,2239,priest,shadow,96,53,43
Даняпимпгадх,soulflayer,2239,priest,shadow,375,199,176
Pu,outland,2237,priest,shadow,229,119,110
Swdjkbad,kazzak,2233,priest,shadow,90,54,36
Yggdra,ragnaros,2229,priest,shadow,66,44,22
Польскийбуль,gordunni,2229,priest,shadow,113,62,51
Vilayetko,ravencrest,2224,priest,shadow,102,56,46
Standtall,blackrock,2218,priest,shadow,150,82,68
Dbeezy,tarren-mill,2217,priest,shadow,128,68,60
Ilovemycat,silvermoon,2214,priest,shadow,102,61,41
Bluxon,kazzak,2213,priest,shadow,425,232,193
Тоних,deathguard,2213,priest,shadow,117,62,55
Èxtêrmìnätör,kazzak,2209,priest,shadow,114,65,49
Mérce,kazzak,2204,priest,shadow,108,60,48
Shåmssv,kazzak,2181,priest,shadow,108,57,51
Cheesecake,defias-brotherhood,2174,priest,shadow,144,78,66
Bidraget,ravencrest,2169,priest,shadow,166,96,70
Akibom,drakthul,2167,priest,shadow,149,89,60
Tekdogx,blackmoore,2167,priest,shadow,268,136,132
Хьёх,blackscar,2166,priest,shadow,107,65,42
Randyrhoads,kazzak,2166,priest,shadow,95,53,42
Xsß,dun-modr,2164,priest,shadow,113,63,50
Rrj,ravencrest,2156,priest,shadow,130,75,55
Devoura,sylvanas,2156,priest,shadow,99,57,42
Notsoholy,blackmoore,2156,priest,shadow,192,102,90
Infuséd,aegwynn,2155,priest,shadow,90,50,40
Darthlie,draenor,2155,priest,shadow,412,205,207
Dollyboo,tarren-mill,2152,priest,shadow,125,77,48
Bensherman,dalaran,2152,priest,shadow,90,51,39
Djalex,ravencrest,2152,priest,shadow,209,116,93
Безрассудица,howling-fjord,2150,priest,shadow,108,57,51
Prøphetx,thrall,2145,priest,shadow,296,158,138
Genjutzux,kazzak,2138,priest,shadow,84,48,36
Liptonolda,blackhand,2138,priest,shadow,528,273,255
Slimcharles,ravencrest,2137,priest,shadow,185,107,78
Crainoo,ravencrest,2137,priest,shadow,158,80,78
Stopcatabuse,silvermoon,2136,priest,shadow,537,274,263
Sphero,earthen-ring,2131,priest,shadow,142,80,62
Cornflays,outland,2130,priest,shadow,102,54,48
Синфал,blackscar,2128,priest,shadow,340,173,167
Ondskabsfuld,kazzak,2125,priest,shadow,120,60,60
Milania,ravencrest,2124,priest,shadow,89,59,30
Tankeløs,kazzak,2120,priest,shadow,72,42,30
Felaenna,argent-dawn,2119,priest,shadow,156,82,74
Walterwhite,stormscale,2117,priest,shadow,138,70,68
Bréézee,ravencrest,2116,priest,shadow,119,64,55
Луисвиттон,gordunni,2114,priest,shadow,179,96,83
Drarianna,nemesis,2112,priest,shadow,63,40,23
Blacktrain,burning-blade,2112,priest,shadow,140,70,70
Clori,argent-dawn,2110,priest,shadow,66,50,16
Rzkp,eredar,2110,priest,shadow,93,50,43
Manyus,archimonde,2109,priest,shadow,90,53,37
Evazhang,outland,2108,priest,shadow,72,42,30
Melábufeis,dun-modr,2108,priest,shadow,144,81,63
Zodzín,ragnaros,2106,priest,shadow,72,36,36
Thanatae,kazzak,2105,priest,shadow,85,50,35
Cutepangolin,khaz-modan,2103,priest,shadow,96,55,41
Knútx,stormscale,2103,priest,shadow,114,63,51
Cizer,kazzak,2103,priest,shadow,233,125,108
Pepeshadow,twisting-nether,2102,priest,shadow,194,101,93
Amtoxic,stormscale,2100,priest,shadow,89,48,41
Uselessxasel,sanguino,2098,priest,shadow,102,57,45
Voidgodx,blackrock,2092,priest,shadow,59,38,21
Voidfi,kult-der-verdammten,2085,priest,shadow,120,66,54
Purpl,tarren-mill,2083,priest,shadow,174,93,81
Newkidx,draenor,2079,priest,shadow,114,61,53
Voideffsucks,stormscale,2075,priest,shadow,54,32,22
Voidlink,kazzak,2075,priest,shadow,101,57,44
Manofonéway,outland,2074,priest,shadow,184,99,85
Сделайсам,gordunni,2074,priest,shadow,219,115,104
Infernión,tarren-mill,2074,priest,shadow,113,58,55
Deternity,stormscale,2073,priest,shadow,123,60,63
Lovelessp,stormscale,2070,priest,shadow,78,46,32
Heffer,outland,2069,priest,shadow,224,131,93
Stjärtsten,tarren-mill,2066,priest,shadow,267,148,119
Depridolens,argent-dawn,2065,priest,shadow,188,106,82
Nukyo,blackmoore,2060,priest,shadow,68,39,29
Nabøøbies,blackmoore,2058,priest,shadow,136,73,63
Hansmaul,thrall,2054,priest,shadow,60,33,27
Talbatex,blackmoore,2054,priest,shadow,168,82,86
Billybay,argent-dawn,2051,priest,shadow,170,103,67
Shadowirl,ravencrest,2046,priest,shadow,54,38,16
Zerovision,nemesis,2044,priest,shadow,185,108,77
Shadowvoice,outland,2043,priest,shadow,102,55,47
Iodjsaiojoij,kazzak,2040,priest,shadow,72,39,33
Dippy,blackrock,2037,priest,shadow,106,54,52
Миладиель,gordunni,2037,priest,shadow,228,116,112
Lâughing,ravencrest,2036,priest,shadow,255,137,118
Ninjajane,sylvanas,2033,priest,shadow,155,93,62
Rzktwo,eredar,2027,priest,shadow,125,68,57
Minblock,sanguino,2025,priest,shadow,304,155,149
Sinthaa,mannoroth,2023,priest,shadow,132,65,67
Voldemort,blackrock,2021,priest,shadow,48,30,18
Waltergoblin,sylvanas,2020,priest,shadow,90,55,35
Skillmåsterx,ravencrest,2018,priest,shadow,77,42,35
Facemeltina,kiljaeden,2016,priest,shadow,72,41,31
Rýzera,aegwynn,2015,priest,shadow,42,28,14
Vülemuv,silvermoon,2013,priest,shadow,60,44,16
Lostcause,alakir,2011,priest,shadow,150,90,60
Некрозмх,soulflayer,2009,priest,shadow,80,44,36
Yaboyboompie,blackrock,2009,priest,shadow,123,61,62
Destinyhero,aegwynn,2007,priest,shadow,93,47,46
Бвонсаамди,soulflayer,2006,priest,shadow,200,107,93
Ðanilox,dun-modr,2004,priest,shadow,88,45,43
Moonword,archimonde,2003,priest,shadow,48,28,20
Léandrä,magtheridon,2003,priest,shadow,165,86,79
Jynii,eredar,2001,priest,shadow,84,46,38
Птумерианец,gordunni,2001,priest,shadow,203,110,93
Zhadum,stormscale,2000,priest,shadow,136,72,64
Sethÿr,sanguino,2000,priest,shadow,204,106,98
Huffle,argent-dawn,1998,priest,shadow,45,30,15
Mcdced,archimonde,1998,priest,shadow,187,113,74
Dhurza,shendralar,1998,priest,shadow,138,77,61
Genjutzu,kazzak,1997,priest,shadow,54,29,25
Vaccineboost,silvermoon,1997,priest,shadow,154,77,77
Айсиоу,howling-fjord,1996,priest,shadow,60,33,27
Fishler,tarren-mill,1994,priest,shadow,59,33,26
Duzurîx,burning-blade,1994,priest,shadow,72,40,32
Demølishes,ravencrest,1990,priest,shadow,117,66,51
Mímou,kazzak,1990,priest,shadow,240,130,110
Sonah,der-abyssische-rat,1987,priest,shadow,68,39,29
Maedhrós,ravencrest,1981,priest,shadow,48,36,12
Invoid,stormreaver,1980,priest,shadow,126,68,58
Kujiua,ravencrest,1979,priest,shadow,185,106,79
Asträlaws,archimonde,1976,priest,shadow,264,148,116
Shádówý,kazzak,1973,priest,shadow,48,26,22
Енотхд,soulflayer,1972,priest,shadow,126,67,59
Shåmssp,kazzak,1971,priest,shadow,42,34,8
Donenigma,stormscale,1970,priest,shadow,246,137,109
Rýzera,tarren-mill,1970,priest,shadow,47,26,21
Drynte,blackmoore,1969,priest,shadow,72,47,25
Carmechanic,defias-brotherhood,1967,priest,shadow,166,93,73
Önnÿ,dun-modr,1965,priest,shadow,96,48,48
Satin,twilights-hammer,1963,priest,shadow,117,69,48
Dingopriest,blackrock,1962,priest,shadow,108,65,43
Реврос,gordunni,1962,priest,shadow,108,61,47
Ikaytsym,ravencrest,1961,priest,shadow,254,142,112
Криптика,soulflayer,1958,priest,shadow,90,54,36
Nousey,twisting-nether,1958,priest,shadow,292,149,143
Ðrßøtÿcûs,la-croisade-écarlate,1956,priest,shadow,63,33,30
Animesenpai,kazzak,1955,priest,shadow,132,71,61
Snoopý,dun-modr,1954,priest,shadow,219,123,96
Moretti,ravencrest,1953,priest,shadow,54,32,22
Ktulsotum,twisting-nether,1952,priest,shadow,72,42,30
Tenebraes,kazzak,1951,priest,shadow,112,62,50
Xayona,argent-dawn,1951,priest,shadow,77,38,39
Zoodiacp,blackrock,1950,priest,shadow,191,92,99
Velence,ravencrest,1946,priest,shadow,210,116,94
Alexwinkwink,kazzak,1946,priest,shadow,114,60,54
Шадоупуз,soulflayer,1946,priest,shadow,253,123,130
Perché,silvermoon,1945,priest,shadow,66,48,18
Гоплзнекст,gordunni,1944,priest,shadow,216,116,100
Холихэйт,howling-fjord,1943,priest,shadow,69,43,26
Rnkz,sanguino,1943,priest,shadow,102,57,45
Covidisc,outland,1943,priest,shadow,168,89,79
Умора,razuvious,1942,priest,shadow,83,51,32
Ká,outland,1941,priest,shadow,84,56,28
Sÿrax,ysondre,1941,priest,shadow,109,62,47
Physxd,blackrock,1939,priest,shadow,66,44,22
Smxkÿÿ,eredar,1939,priest,shadow,59,36,23
Yoe,twisting-nether,1939,priest,shadow,78,40,38
Jaimë,ravencrest,1938,priest,shadow,54,31,23
Quezaris,kazzak,1937,priest,shadow,44,37,7
Vajainap,outland,1936,priest,shadow,48,27,21
Räke,blackrock,1935,priest,shadow,126,63,63
Томрэдл,blackscar,1933,priest,shadow,176,98,78
Rãpidi,hyjal,1932,priest,shadow,89,56,33
Tbs,sylvanas,1932,priest,shadow,189,109,80
Dogstav,kazzak,1932,priest,shadow,60,32,28
Heal,hyjal,1931,priest,shadow,284,156,128
Cathrix,kazzak,1929,priest,shadow,78,49,29
Tacøgxd,ravencrest,1929,priest,shadow,120,72,48
Массаракъш,razuvious,1929,priest,shadow,81,47,34
Dakotapriest,ravencrest,1929,priest,shadow,102,55,47
Бхонсамди,blackscar,1926,priest,shadow,101,60,41
Talbatexx,blackmoore,1926,priest,shadow,72,32,40
Эсдаль,howling-fjord,1920,priest,shadow,150,88,62
Пристатеист,howling-fjord,1920,priest,shadow,90,47,43
Justtpro,twisting-nether,1919,priest,shadow,211,119,92
Sonâkî,archimonde,1914,priest,shadow,57,33,24
Rrobaqepesi,twisting-nether,1912,priest,shadow,79,49,30
Insanious,skullcrusher,1912,priest,shadow,226,119,107
Elnyashka,ravencrest,1911,priest,shadow,162,92,70
Weekfortyone,blackhand,1909,priest,shadow,152,74,78
Akolyte,blackmoore,1906,priest,shadow,48,28,20
Ezlife,blackrock,1906,priest,shadow,84,48,36
Shiannâ,malganis,1905,priest,shadow,55,33,22
Sadgepriest,draenor,1905,priest,shadow,42,23,19
Seijobaesuzy,archimonde,1904,priest,shadow,54,32,22
Ottii,thrall,1904,priest,shadow,179,93,86
Pandacore,frostmane,1904,priest,shadow,60,30,30
Been,ravencrest,1902,priest,shadow,77,41,36
Milkysmite,twisting-nether,1901,priest,shadow,82,48,34
Gymbró,kazzak,1900,priest,shadow,72,39,33
Wérrýxs,kazzak,1899,priest,shadow,181,109,72
Ымц,gordunni,1899,priest,shadow,132,68,64
Darthmantle,silvermoon,1898,priest,shadow,77,43,34
Erenndriel,twisting-nether,1898,priest,shadow,255,138,117
Петушшара,gordunni,1897,priest,shadow,81,43,38
Shadowmate,silvermoon,1895,priest,shadow,68,35,33
Alfredosauce,ravencrest,1894,priest,shadow,100,55,45
Physx,blackrock,1894,priest,shadow,42,23,19
Keypo,khaz-modan,1894,priest,shadow,181,96,85
Qoryn,ravencrest,1893,priest,shadow,114,60,54
Лайфстилх,blackscar,1892,priest,shadow,132,68,64
Dümbledore,aggra-português,1891,priest,shadow,148,81,67
Nanna,agamaggan,1891,priest,shadow,382,194,188
Rakamain,ravencrest,1890,priest,shadow,72,45,27
Døubtful,kazzak,1890,priest,shadow,36,20,16
Estragon,quelthalas,1890,priest,shadow,117,60,57
Sakuyasp,blackrock,1888,priest,shadow,375,196,179
ßrb,sylvanas,1887,priest,shadow,82,42,40
Salkerer,stormscale,1882,priest,shadow,36,23,13
Zeawee,frostmane,1881,priest,shadow,78,51,27
Dreamhatcher,deathwing,1879,priest,shadow,179,97,82
Lløthx,ravencrest,1878,priest,shadow,131,70,61
Steckî,blackmoore,1877,priest,shadow,42,27,15
Morseeii,baelgun,1877,priest,shadow,72,40,32
Angsty,blackrock,1877,priest,shadow,195,97,98
Vitapriest,silvermoon,1876,priest,shadow,134,68,66
Ктулсотум,soulflayer,1874,priest,shadow,85,49,36
Crowny,ysondre,1873,priest,shadow,60,31,29
Sqwabblepee,stormscale,1872,priest,shadow,167,99,68
Мистериум,howling-fjord,1872,priest,shadow,194,106,88
Miraçlê,kazzak,1871,priest,shadow,96,61,35
Magicalme,kult-der-verdammten,1871,priest,shadow,48,30,18
Kwolinger,norgannon,1871,priest,shadow,128,74,54
Gana,twisting-nether,1871,priest,shadow,166,84,82
Stümpý,ravencrest,1870,priest,shadow,79,44,35
Røst,ravencrest,1869,priest,shadow,47,29,18
Ølle,ravencrest,1869,priest,shadow,90,54,36
Actionjezuz,shattered-hand,1869,priest,shadow,108,59,49
Shuturmouth,ravencrest,1868,priest,shadow,144,81,63
Râvyn,silvermoon,1866,priest,shadow,44,35,9
Нинаврач,howling-fjord,1865,priest,shadow,54,28,26
Buøbuarns,sanguino,1865,priest,shadow,146,70,76
Sepharis,runetotem,1863,priest,shadow,209,124,85
Lësstat,hyjal,1862,priest,shadow,60,37,23
Бомжскадилом,gordunni,1862,priest,shadow,322,175,147
Shucks,stormscale,1862,priest,shadow,68,34,34
Gumayusi,ravencrest,1860,priest,shadow,39,25,14
Bownsamdi,tarren-mill,1859,priest,shadow,97,54,43
Slimshadey,malganis,1857,priest,shadow,48,27,21
Gladinbedirl,ravencrest,1856,priest,shadow,48,33,15
Бархомелфой,gordunni,1856,priest,shadow,95,56,39
Rockness,blackmoore,1854,priest,shadow,137,91,46
Tradeforheal,hyjal,1854,priest,shadow,247,136,111
Fläschheal,aegwynn,1853,priest,shadow,48,33,15
Ataraxia,ravencrest,1853,priest,shadow,48,31,17
Framesxøxø,ravencrest,1853,priest,shadow,124,73,51
Тарренмилл,gordunni,1853,priest,shadow,98,57,41
Oddarne,twisting-nether,1853,priest,shadow,81,44,37
Sudeki,blackmoore,1853,priest,shadow,66,35,31
Аликслинкс,howling-fjord,1851,priest,shadow,36,22,14
Raspberrypíe,silvermoon,1850,priest,shadow,120,73,47
Zabpriest,blackhand,1850,priest,shadow,70,41,29
Shukhêvych,kazzak,1850,priest,shadow,59,30,29
Пурпле,soulflayer,1849,priest,shadow,180,92,88
Ageyr,ragnaros,1848,priest,shadow,95,60,35
Onlycans,tarren-mill,1848,priest,shadow,48,30,18
Hòllymèdx,blackmoore,1848,priest,shadow,63,38,25
Keijuna,kazzak,1848,priest,shadow,42,24,18
Either,kazzak,1848,priest,shadow,65,36,29
Iessei,outland,1848,priest,shadow,175,93,82
Mafiasnipers,ravencrest,1847,priest,shadow,36,21,15
Blindöts,tarren-mill,1847,priest,shadow,47,27,20
Unicycle,emerald-dream,1847,priest,shadow,60,32,28
Versio,dalvengyr,1847,priest,shadow,54,28,26
Garycash,outland,1847,priest,shadow,288,148,140
Djzerøgodx,frostwolf,1847,priest,shadow,109,56,53
Hiddenhealz,blackrock,1846,priest,shadow,158,89,69
Qwertyuioasd,ravencrest,1845,priest,shadow,48,27,21
Mojoo,aggramar,1845,priest,shadow,56,31,25
Adub,tarren-mill,1845,priest,shadow,72,39,33
Ecquidozx,ravencrest,1845,priest,shadow,53,27,26
Pipf,blackmoore,1844,priest,shadow,65,41,24
Trisks,ravencrest,1843,priest,shadow,34,20,14
Staljon,burning-legion,1843,priest,shadow,155,86,69
Astolfo,blackrock,1841,priest,shadow,150,91,59
Absolution,stormscale,1841,priest,shadow,281,156,125
Holyshadów,azjolnerub,1841,priest,shadow,262,144,118
Liloz,eredar,1841,priest,shadow,65,35,30
Cyrená,ravencrest,1840,priest,shadow,66,34,32
Celdoria,eredar,1839,priest,shadow,54,30,24
Vibéz,outland,1839,priest,shadow,54,28,26
Lebronjay,ravencrest,1838,priest,shadow,136,74,62
Jeppehpräst,stormscale,1837,priest,shadow,84,50,34
Ансор,lich-king,1837,priest,shadow,165,87,78
Amazingame,tarren-mill,1837,priest,shadow,59,27,32
Goodsuck,tarren-mill,1836,priest,shadow,101,59,42
Statìk,outland,1836,priest,shadow,421,223,198
Cruncher,ravencrest,1836,priest,shadow,60,31,29
Simôc,eredar,1836,priest,shadow,96,48,48
Johnnybanana,argent-dawn,1835,priest,shadow,41,26,15
Sadix,ravencrest,1835,priest,shadow,66,38,28
Mentax,kazzak,1835,priest,shadow,113,65,48
Maryhugette,archimonde,1835,priest,shadow,338,168,170
Mýxir,burning-legion,1834,priest,shadow,89,45,44
Hoesfavorite,onyxia,1833,priest,shadow,163,94,69
Najany,archimonde,1833,priest,shadow,54,31,23
Magicstarss,the-maelstrom,1833,priest,shadow,96,52,44
Shøana,archimonde,1833,priest,shadow,107,50,57
Tupal,ysondre,1829,priest,shadow,78,43,35
Schmetter,tarren-mill,1829,priest,shadow,65,29,36
Найтингеилл,gordunni,1828,priest,shadow,83,45,38
Nøwmäck,archimonde,1828,priest,shadow,66,33,33
Fionsacré,archimonde,1827,priest,shadow,58,39,19
Æßsåløønå,la-croisade-écarlate,1827,priest,shadow,36,24,12
Buan,blackmoore,1827,priest,shadow,95,60,35
Mørphics,ravencrest,1827,priest,shadow,42,26,16
Kagarr,kazzak,1827,priest,shadow,155,94,61
Selëne,blackrock,1827,priest,shadow,72,43,29
Термидор,booty-bay,1827,priest,shadow,131,75,56
Rexonaqq,kazzak,1827,priest,shadow,72,35,37
Шадоуприст,blackscar,1826,priest,shadow,42,31,11
Сариандра,gordunni,1826,priest,shadow,345,195,150
Mond,eredar,1826,priest,shadow,83,46,37
Anateoris,turalyon,1825,priest,shadow,76,43,33
Mirill,tarren-mill,1825,priest,shadow,211,116,95
Офелла,howling-fjord,1825,priest,shadow,599,316,283
Quezaris,stormscale,1825,priest,shadow,48,23,25
Babarøga,blackrock,1824,priest,shadow,124,67,57
Cantsqell,silvermoon,1823,priest,shadow,48,34,14
Cnsnn,ysondre,1823,priest,shadow,114,76,38
Христианин,gordunni,1823,priest,shadow,156,91,65
Трейдарк,blackscar,1823,priest,shadow,60,31,29
Whynolove,ragnaros,1822,priest,shadow,101,69,32
Waina,defias-brotherhood,1822,priest,shadow,207,105,102
Диспайзи,gordunni,1821,priest,shadow,30,22,8
Sandcastles,ravencrest,1821,priest,shadow,140,88,52
Nyotux,blackrock,1821,priest,shadow,140,82,58
Yirico,argent-dawn,1820,priest,shadow,47,31,16
Virtualworld,ragnaros,1820,priest,shadow,30,19,11
Dreadest,blackhand,1820,priest,shadow,90,52,38
Edoran,ragnaros,1820,priest,shadow,59,31,28
Pljoe,ravencrest,1819,priest,shadow,81,46,35
Helín,hellfire,1819,priest,shadow,150,85,65
Blóódfart,kazzak,1819,priest,shadow,89,43,46
Xangha,burning-legion,1818,priest,shadow,168,99,69
Энмунд,borean-tundra,1818,priest,shadow,243,141,102
Önlyfans,draenor,1818,priest,shadow,84,48,36
Voidshuffle,laughing-skull,1818,priest,shadow,42,24,18
Диспайзх,gordunni,1817,priest,shadow,66,38,28
Divinetouch,ravencrest,1817,priest,shadow,77,42,35
Violatio,aegwynn,1817,priest,shadow,318,171,147
Ahle,darkspear,1816,priest,shadow,47,26,21
Дикаях,gordunni,1816,priest,shadow,159,84,75
Omedo,stormscale,1816,priest,shadow,36,19,17
Xiä,archimonde,1816,priest,shadow,180,93,87
Akroama,archimonde,1816,priest,shadow,158,80,78
Chokipoki,twisting-nether,1815,priest,shadow,194,113,81
Øctawtöuch,kazzak,1814,priest,shadow,88,53,35
Êvil,ravencrest,1814,priest,shadow,41,24,17
Barthólomew,doomhammer,1814,priest,shadow,158,86,72
Klosso,anachronos,1814,priest,shadow,435,216,219
Wortmonster,malganis,1813,priest,shadow,53,31,22
Stèálth,sylvanas,1812,priest,shadow,24,19,5
Kobiden,stormreaver,1812,priest,shadow,89,50,39
Gyom,sargeras,1811,priest,shadow,38,27,11
Zërøx,ysondre,1811,priest,shadow,30,19,11
Heilsarmee,blackhand,1811,priest,shadow,129,68,61
Kozou,tarren-mill,1810,priest,shadow,54,33,21
Hellscon,kazzak,1810,priest,shadow,197,103,94
Шпх,howling-fjord,1810,priest,shadow,60,31,29
Muyhuman,eredar,1809,priest,shadow,36,25,11
Minaegi,aegwynn,1809,priest,shadow,78,50,28
Drvoidit,blackrock,1809,priest,shadow,48,28,20
Ounxx,blackrock,1809,priest,shadow,149,84,65
Becknarbritt,stormscale,1809,priest,shadow,352,193,159
Scade,kazzak,1809,priest,shadow,130,66,64
Фростингшп,goldrinn,1808,priest,shadow,42,31,11
Luvlyrah,draenor,1808,priest,shadow,105,64,41
Spklooril,hyjal,1808,priest,shadow,372,195,177
Yoii,nemesis,1808,priest,shadow,66,34,32
Meatyshaft,doomhammer,1807,priest,shadow,99,64,35
Spinggwin,burning-legion,1807,priest,shadow,245,153,92
Driptoohard,archimonde,1807,priest,shadow,52,29,23
Theoniss,draenor,1807,priest,shadow,215,115,100
Адскийприст,gordunni,1807,priest,shadow,63,32,31
Príêstjklòl,stormscale,1807,priest,shadow,65,31,34
Lr,aszune,1806,priest,shadow,36,25,11
Синатро,deathguard,1806,priest,shadow,190,119,71
Debbski,tarren-mill,1806,priest,shadow,48,30,18
Snarks,sylvanas,1806,priest,shadow,36,20,16
Kiesp,tarren-mill,1806,priest,shadow,210,115,95
Syntara,twisting-nether,1805,priest,shadow,80,50,30
Claritycraft,twisting-nether,1805,priest,shadow,36,22,14
Theunknown,thrall,1805,priest,shadow,83,49,34
Arendt,blackhand,1805,priest,shadow,60,34,26
Zahadoom,stormscale,1805,priest,shadow,220,121,99
Azæriø,rashgarroth,1804,priest,shadow,118,68,50
Solaclypsa,destromath,1803,priest,shadow,36,26,10
Sikola,ragnaros,1803,priest,shadow,52,32,20
Mataî,kazzak,1803,priest,shadow,84,49,35
Jpd,outland,1803,priest,shadow,48,25,23
Stazia,ravencrest,1802,priest,shadow,36,22,14
Нед,greymane,1802,priest,shadow,82,49,33
Margots,kazzak,1802,priest,shadow,42,22,20
Phucu,the-maelstrom,1801,priest,shadow,78,48,30
Клаима,soulflayer,1801,priest,shadow,124,72,52
Всезнайка,soulflayer,1801,priest,shadow,150,82,68
Sleypriest,draenor,1800,priest,shadow,48,32,16
Pórt,kazzak,1800,priest,shadow,63,39,24
Erdine,ravencrest,1800,priest,shadow,96,53,43
Lindp,stormreaver,1795,priest,shadow,96,59,37
Papie,kazzak,1795,priest,shadow,54,30,24
Zindrix,silvermoon,1794,priest,shadow,90,52,38
Homxcxde,ravencrest,1793,priest,shadow,48,26,22
Zultor,ragnaros,1792,priest,shadow,55,32,23
Raisedbyrap,blackrock,1791,priest,shadow,60,33,27
Extralite,stormscale,1790,priest,shadow,117,67,50
Cometopastor,skullcrusher,1786,priest,shadow,73,39,34
Tosem,antonidas,1784,priest,shadow,54,34,20
Sevtwo,tarren-mill,1783,priest,shadow,84,56,28
Makethemstop,bronzebeard,1783,priest,shadow,154,97,57
Свдпрох,soulflayer,1781,priest,shadow,57,29,28
Agotax,outland,1780,priest,shadow,66,42,24
Староезло,gordunni,1780,priest,shadow,138,65,73
Yêl,thrall,1779,priest,shadow,283,153,130
Прыст,howling-fjord,1778,priest,shadow,69,40,29
Megajuicy,blackmoore,1777,priest,shadow,264,145,119
Galatea,les-sentinelles,1777,priest,shadow,90,49,41
Spamplague,stormscale,1776,priest,shadow,90,49,41
Shroomza,blackmoore,1776,priest,shadow,60,27,33
Ptxd,alakir,1775,priest,shadow,138,72,66
Luphriest,ravencrest,1774,priest,shadow,54,25,29
Geløpr,eredar,1771,priest,shadow,167,92,75
Tremrfinger,dun-modr,1769,priest,shadow,98,53,45
Ftiersp,ravencrest,1768,priest,shadow,77,42,35
Schizophrens,outland,1766,priest,shadow,48,28,20
Syniixp,aegwynn,1765,priest,shadow,36,25,11
Jaimee,zirkel-des-cenarius,1765,priest,shadow,48,31,17
Boluclac,archimonde,1765,priest,shadow,42,24,18
Flexzpriest,destromath,1764,priest,shadow,132,71,61
Elishîa,ragnaros,1763,priest,shadow,106,52,54
Häst,the-maelstrom,1762,priest,shadow,49,32,17
Sebbepriest,twisting-nether,1762,priest,shadow,308,167,141
Шандресса,deepholm,1761,priest,shadow,48,31,17
Miruh,malganis,1759,priest,shadow,203,123,80
Anabølix,ravencrest,1758,priest,shadow,54,28,26
Фримекс,soulflayer,1756,priest,shadow,42,28,14
Awatør,ysondre,1756,priest,shadow,35,19,16
Алурелис,blackscar,1755,priest,shadow,42,25,17
Õðæßìùa,kazzak,1753,priest,shadow,35,22,13
Mèöw,argent-dawn,1753,priest,shadow,149,84,65
Biøhazard,tarren-mill,1752,priest,shadow,64,32,32
Иннрей,soulflayer,1752,priest,shadow,87,38,49
Namsolo,kazzak,1751,priest,shadow,84,43,41
Shadowyx,dun-modr,1749,priest,shadow,112,63,49
Wtrix,stormscale,1748,priest,shadow,48,28,20
Ephara,outland,1746,priest,shadow,155,86,69
Kylähullu,ravencrest,1746,priest,shadow,134,71,63
Andreel,ravencrest,1746,priest,shadow,118,62,56
Mindtyson,dun-morogh,1745,priest,shadow,108,61,47
Сёдзира,gordunni,1745,priest,shadow,150,83,67
Скайвэйуокер,howling-fjord,1743,priest,shadow,101,58,43
Spherics,ravencrest,1743,priest,shadow,54,27,27
Morgá,draenor,1740,priest,shadow,54,32,22
Fakecastguru,ravencrest,1738,priest,shadow,90,48,42
Fabulicious,blackrock,1737,priest,shadow,54,26,28
Iløvescärlet,khaz-modan,1736,priest,shadow,127,76,51
Oniakusa,outland,1736,priest,shadow,36,20,16
Mehtz,ravencrest,1736,priest,shadow,434,217,217
Øxytøcin,ravencrest,1735,priest,shadow,216,114,102
Zuhä,twisting-nether,1734,priest,shadow,78,38,40
Atahalni,argent-dawn,1734,priest,shadow,232,113,119
Joeqt,stormscale,1734,priest,shadow,227,109,118
Чикхоп,blackscar,1733,priest,shadow,144,91,53
Basxcbxtchx,ravencrest,1733,priest,shadow,48,29,19
Brûshie,kazzak,1732,priest,shadow,78,45,33
Wixzyx,ravencrest,1732,priest,shadow,48,26,22
Tarantos,uldum,1732,priest,shadow,216,116,100
Jonig,blackmoore,1732,priest,shadow,142,76,66
Qzrx,outland,1731,priest,shadow,75,42,33
Necrofeel,silvermoon,1731,priest,shadow,47,26,21
Megamann,dun-morogh,1731,priest,shadow,96,46,50
Dezerta,nozdormu,1730,priest,shadow,100,55,45
Hasa,stormreaver,1730,priest,shadow,66,36,30
Ayhuasca,blackmoore,1730,priest,shadow,256,134,122
Priestfive,stormscale,1728,priest,shadow,78,46,32
Shdwfizk,ravencrest,1727,priest,shadow,48,30,18
Ризорпанда,soulflayer,1727,priest,shadow,59,33,26
Казуямисима,gordunni,1727,priest,shadow,194,105,89
Víppe,stormreaver,1726,priest,shadow,119,66,53
Joniop,stormreaver,1725,priest,shadow,95,57,38
Adaseth,tarren-mill,1725,priest,shadow,216,129,87
Príêstjklól,stormscale,1725,priest,shadow,36,19,17
Ilunfabilffa,argent-dawn,1724,priest,shadow,31,20,11
Juxtapose,argent-dawn,1722,priest,shadow,66,50,16
Aereza,darkspear,1722,priest,shadow,208,114,94
Strvnge,stormreaver,1721,priest,shadow,65,30,35
Kharòn,grim-batol,1719,priest,shadow,89,55,34
Кломми,gordunni,1718,priest,shadow,84,45,39
Cielavinja,aszune,1718,priest,shadow,62,33,29
Drë,daggerspine,1717,priest,shadow,98,48,50
Anabølixx,ravencrest,1716,priest,shadow,24,18,6
Vaßpera,tarren-mill,1716,priest,shadow,159,87,72
Lzopyec,outland,1715,priest,shadow,30,21,9
Knoffp,blackhand,1715,priest,shadow,138,78,60
Settemsen,tarren-mill,1714,priest,shadow,42,29,13
Sweetepi,blackmoore,1714,priest,shadow,54,32,22
Филяфан,gordunni,1714,priest,shadow,135,73,62
Báh,tarren-mill,1714,priest,shadow,66,32,34
Zhyn,turalyon,1712,priest,shadow,127,73,54
Marbellexd,pozzo-delleternità,1712,priest,shadow,306,164,142
Seneth,twisting-nether,1712,priest,shadow,208,111,97
Bizzlebabe,lightbringer,1711,priest,shadow,24,18,6
Ревентонх,howling-fjord,1706,priest,shadow,266,143,123
Игорянатакуе,eversong,1706,priest,shadow,333,173,160
Naronas,drakthul,1705,priest,shadow,72,45,27
Taeraz,archimonde,1705,priest,shadow,30,18,12
Флэшх,soulflayer,1705,priest,shadow,207,111,96
Spriestisbad,hyjal,1704,priest,shadow,30,18,12
Йоййо,gordunni,1703,priest,shadow,342,180,162
Dpyo,ravencrest,1703,priest,shadow,36,18,18
Файерин,soulflayer,1701,priest,shadow,114,55,59
Рэнфан,fordragon,1700,priest,shadow,94,61,33
Ittei,stormscale,1700,priest,shadow,123,77,46
Onlyfansp,ravencrest,1699,priest,shadow,48,22,26
Fandac,sylvanas,1697,priest,shadow,53,32,21
Фиброз,blackscar,1697,priest,shadow,120,68,52
Daspyen,silvermoon,1697,priest,shadow,85,46,39
Targolina,argent-dawn,1697,priest,shadow,158,83,75
Bigblackdot,grim-batol,1697,priest,shadow,54,27,27
Verbs,kazzak,1697,priest,shadow,70,33,37
Craquylx,hyjal,1696,priest,shadow,36,27,9
Undefined,chamber-of-aspects,1694,priest,shadow,52,36,16
Malaíka,silvermoon,1694,priest,shadow,99,56,43
Dazé,ravencrest,1694,priest,shadow,77,42,35
Peaksp,stormscale,1692,priest,shadow,66,40,26
Rasha,kazzak,1691,priest,shadow,80,45,35
Rekson,alleria,1690,priest,shadow,60,33,27
Påsøk,stormscale,1690,priest,shadow,64,35,29
Ankî,aegwynn,1689,priest,shadow,132,67,65
Drakzx,kazzak,1687,priest,shadow,36,24,12
Tamy,draenor,1687,priest,shadow,165,103,62
Миссклик,goldrinn,1687,priest,shadow,148,90,58
Lolapalula,tarren-mill,1687,priest,shadow,159,85,74
Kamish,twisting-nether,1687,priest,shadow,186,98,88
Emala,hyjal,1686,priest,shadow,42,20,22
Tùcøcø,archimonde,1684,priest,shadow,54,26,28
Rubín,sylvanas,1683,priest,shadow,44,28,16
Voodkaa,drakthul,1683,priest,shadow,141,76,65
Déép,nazjatar,1682,priest,shadow,32,18,14
Llothx,ravencrest,1682,priest,shadow,112,62,50
Nadoreille,hyjal,1681,priest,shadow,115,63,52
Sleeg,tarren-mill,1681,priest,shadow,35,19,16
Cooldgreyjoy,archimonde,1681,priest,shadow,76,39,37
Anexxia,outland,1681,priest,shadow,48,23,25
Kuddles,hyjal,1680,priest,shadow,200,117,83
Jacep,kazzak,1679,priest,shadow,54,30,24
Shadowsig,silvermoon,1679,priest,shadow,223,118,105
Распутинова,galakrond,1677,priest,shadow,54,31,23
Reapzbolt,blackrock,1677,priest,shadow,120,58,62
Jóhnnybravó,kazzak,1675,priest,shadow,123,68,55
Ankus,tarren-mill,1675,priest,shadow,191,105,86
Priesless,sylvanas,1675,priest,shadow,73,39,34
Cthultist,dun-modr,1675,priest,shadow,108,52,56
Because,nemesis,1674,priest,shadow,48,28,20
Пампнавечерх,blackscar,1674,priest,shadow,65,35,30
Zeythz,ravencrest,1674,priest,shadow,281,149,132
Skeida,bloodhoof,1674,priest,shadow,107,51,56
Mórok,silvermoon,1673,priest,shadow,108,60,48
Waruum,outland,1673,priest,shadow,94,52,42
Galadrielkä,drakthul,1673,priest,shadow,60,33,27
Yngp,blackmoore,1673,priest,shadow,66,36,30
Ðrwiz,ravencrest,1671,priest,shadow,42,23,19
Mizulol,ravencrest,1671,priest,shadow,215,105,110
Fueguchi,anubarak,1670,priest,shadow,113,59,54
Hypnocat,blackrock,1670,priest,shadow,106,54,52
Khålyst,archimonde,1670,priest,shadow,54,25,29
Mojibien,burning-legion,1669,priest,shadow,161,88,73
Hîlaryduff,dun-modr,1668,priest,shadow,42,25,17
Tsunadesaama,silvermoon,1668,priest,shadow,63,32,31
Svettvrede,sylvanas,1668,priest,shadow,89,44,45
Lenneyqt,blackmoore,1667,priest,shadow,54,31,23
Niketn,aegwynn,1667,priest,shadow,60,32,28
Levitation,alakir,1665,priest,shadow,78,45,33
Vavulya,blackhand,1665,priest,shadow,389,206,183
Ûñrêpørtablë,outland,1663,priest,shadow,29,21,8
Аркприст,gordunni,1662,priest,shadow,56,33,23
Aleetheia,silvermoon,1662,priest,shadow,225,124,101
Daisyduke,veknilash,1661,priest,shadow,81,41,40
Rházael,blackrock,1661,priest,shadow,65,31,34
Eupz,argent-dawn,1659,priest,shadow,79,42,37
Киндзер,blackscar,1658,priest,shadow,54,29,25
Equalìzer,ravencrest,1657,priest,shadow,25,22,3
Acosp,sylvanas,1657,priest,shadow,42,21,21
Moodzlol,eredar,1656,priest,shadow,48,28,20
Dotreveal,ravencrest,1656,priest,shadow,48,26,22
Shreedx,stormscale,1655,priest,shadow,66,39,27
Youguessedit,twisting-nether,1654,priest,shadow,106,55,51
Chas,argent-dawn,1654,priest,shadow,93,45,48
Виталябард,gordunni,1654,priest,shadow,66,30,36
Ihu,nazjatar,1653,priest,shadow,161,79,82
Essumies,stormreaver,1651,priest,shadow,44,30,14
Jim,saurfang,1651,priest,shadow,48,27,21
Финдовский,gordunni,1649,priest,shadow,102,54,48
Plogic,tarren-mill,1648,priest,shadow,36,22,14
Ruhe,silvermoon,1648,priest,shadow,48,27,21
Sypnos,zuljin,1647,priest,shadow,78,47,31
Zârvâjh,aszune,1647,priest,shadow,60,33,27
Rubzler,ravencrest,1647,priest,shadow,42,20,22
Shendilka,drakthul,1645,priest,shadow,45,30,15
Akris,ragnaros,1645,priest,shadow,154,85,69
Трубишоп,howling-fjord,1645,priest,shadow,152,77,75
Discknight,kazzak,1645,priest,shadow,60,24,36
Jegred,draenor,1644,priest,shadow,54,36,18
Дзинкз,howling-fjord,1644,priest,shadow,52,29,23
Djariisimp,tarren-mill,1643,priest,shadow,36,21,15
Kêrrýgold,blackrock,1643,priest,shadow,157,85,72
Djops,outland,1642,priest,shadow,168,81,87
Backpedaling,kazzak,1642,priest,shadow,150,69,81
Foxiekitten,tarren-mill,1640,priest,shadow,34,23,11
Chinko,blackmoore,1640,priest,shadow,92,58,34
Milo,argent-dawn,1640,priest,shadow,102,61,41
Gødsmack,blackhand,1640,priest,shadow,38,19,19
Äiri,blackmoore,1639,priest,shadow,82,48,34
ßelfy,twisting-nether,1639,priest,shadow,97,55,42
Asterixsu,sylvanas,1638,priest,shadow,48,31,17
Рейвор,gordunni,1638,priest,shadow,137,74,63
Aaj,twisting-nether,1638,priest,shadow,57,29,28
Mikizu,die-aldor,1638,priest,shadow,42,21,21
Ксерф,soulflayer,1638,priest,shadow,138,67,71
Zinxe,ravencrest,1636,priest,shadow,121,73,48
Belialzs,blackrock,1636,priest,shadow,45,24,21
Mackings,the-maelstrom,1636,priest,shadow,172,89,83
Turah,the-maelstrom,1635,priest,shadow,36,22,14
Syreet,silvermoon,1635,priest,shadow,35,20,15
Toesxcker,stormscale,1635,priest,shadow,59,32,27
Díspelbot,ravencrest,1634,priest,shadow,33,21,12
Kättare,stormscale,1633,priest,shadow,96,53,43
Хелектро,deathweaver,1633,priest,shadow,65,35,30
Bigdogone,arathor,1632,priest,shadow,52,29,23
Milamati,kazzak,1632,priest,shadow,78,39,39
Rynsym,ravencrest,1632,priest,shadow,72,36,36
Waycrest,ravencrest,1631,priest,shadow,83,52,31
Sosûke,archimonde,1631,priest,shadow,36,22,14
Мишатемный,gordunni,1631,priest,shadow,84,50,34
Toxxjq,sylvanas,1631,priest,shadow,135,75,60
Smiles,burning-steppes,1630,priest,shadow,83,50,33
Yrr,draenor,1630,priest,shadow,47,24,23
Sadskîx,dun-modr,1629,priest,shadow,68,41,27
Мисатэ,gordunni,1629,priest,shadow,202,114,88
Iamthebarbie,sanguino,1629,priest,shadow,49,27,22
Ахаххааха,gordunni,1628,priest,shadow,60,32,28
Амбрелка,fordragon,1628,priest,shadow,612,307,305
Cederpriest,tarren-mill,1628,priest,shadow,145,69,76
Høly,chogall,1627,priest,shadow,78,45,33
Rippeep,emerald-dream,1627,priest,shadow,30,17,13
Билетлолпро,borean-tundra,1627,priest,shadow,30,17,13
Ðòóm,archimonde,1627,priest,shadow,156,85,71
Флавех,gordunni,1627,priest,shadow,48,26,22
Rumbo,lightnings-blade,1627,priest,shadow,95,50,45
Valadaris,outland,1626,priest,shadow,105,58,47
Педрец,howling-fjord,1626,priest,shadow,120,62,58
Mohapriest,kazzak,1626,priest,shadow,77,34,43
Xuzilul,antonidas,1624,priest,shadow,72,40,32
Pbwser,silvermoon,1624,priest,shadow,42,22,20
Apèx,blackrock,1624,priest,shadow,99,50,49
Arima,kargath,1623,priest,shadow,52,36,16
Skypez,blackhand,1623,priest,shadow,277,147,130
Jønnybanana,blackrock,1623,priest,shadow,39,20,19
Wivienne,defias-brotherhood,1623,priest,shadow,56,25,31
Affex,tarren-mill,1622,priest,shadow,30,18,12
Sûzy,ravencrest,1622,priest,shadow,70,41,29
Дэспира,howling-fjord,1622,priest,shadow,70,37,33
Thrakoun,twilights-hammer,1622,priest,shadow,114,60,54
Aliocha,dalaran,1622,priest,shadow,58,27,31
Imaut,emerald-dream,1621,priest,shadow,86,44,42
Axelbre,blackrock,1621,priest,shadow,42,21,21
Lightform,twisting-nether,1620,priest,shadow,81,52,29
Shyasianpr,area-52,1620,priest,shadow,48,26,22
Wingufreebrø,sanguino,1620,priest,shadow,129,68,61
Selaria,magtheridon,1620,priest,shadow,60,28,32
Марриаза,blackscar,1620,priest,shadow,60,28,32
Cdplz,archimonde,1619,priest,shadow,42,24,18
Zetapp,argent-dawn,1619,priest,shadow,42,22,20
Afrophobia,archimonde,1617,priest,shadow,214,116,98
Prällan,darksorrow,1616,priest,shadow,24,17,7
Darkfreak,malygos,1616,priest,shadow,36,23,13
Priestazie,madmortem,1616,priest,shadow,96,57,39
Shyvi,ravencrest,1616,priest,shadow,36,21,15
Appraiser,draenor,1616,priest,shadow,36,18,18
Otecduchovny,burning-blade,1615,priest,shadow,30,17,13
Nálá,nethersturm,1615,priest,shadow,175,97,78
Yoggies,tarren-mill,1615,priest,shadow,62,33,29
Mukkin,tarren-mill,1614,priest,shadow,60,35,25
Mindseven,emeriss,1614,priest,shadow,30,17,13
Ансарм,gordunni,1614,priest,shadow,288,148,140
Malip,ragnaros,1614,priest,shadow,93,46,47
Neitter,zuljin,1613,priest,shadow,78,43,35
Tøm,silvermoon,1613,priest,shadow,36,19,17
Nûtqt,archimonde,1613,priest,shadow,139,71,68
Widdlprest,sylvanas,1613,priest,shadow,36,17,19
Отчепадре,gordunni,1611,priest,shadow,54,30,24
Sturepräst,kazzak,1611,priest,shadow,36,20,16
Îndura,drakthul,1611,priest,shadow,218,119,99
Dingqt,chogall,1611,priest,shadow,42,21,21
Deriont,argent-dawn,1610,priest,shadow,54,32,22
Fearocity,outland,1609,priest,shadow,42,23,19
Baldracca,shendralar,1608,priest,shadow,178,93,85
Xbeau,bronze-dragonflight,1607,priest,shadow,96,55,41
Khäñ,ravencrest,1607,priest,shadow,197,99,98
Tweediertie,argent-dawn,1607,priest,shadow,59,25,34
Quen,baelgun,1606,priest,shadow,66,39,27
Lowisa,sylvanas,1606,priest,shadow,106,61,45
Iamfrosty,draenor,1606,priest,shadow,204,111,93
Pennywïse,kargath,1606,priest,shadow,174,81,93
Kervalainen,outland,1605,priest,shadow,49,34,15
Вайзмейстер,blackscar,1605,priest,shadow,48,27,21
Lynseanna,ravencrest,1605,priest,shadow,99,55,44
Supahot,sylvanas,1605,priest,shadow,155,86,69
Nairima,argent-dawn,1605,priest,shadow,152,81,71
Skypray,burning-legion,1605,priest,shadow,179,95,84
Raitwo,kazzak,1605,priest,shadow,119,62,57
Zayden,ragnaros,1605,priest,shadow,145,74,71
Dexploit,frostwolf,1604,priest,shadow,30,19,11
Mohammedx,tarren-mill,1604,priest,shadow,36,21,15
Beasteaksx,thrall,1604,priest,shadow,117,63,54
Peprama,stormscale,1604,priest,shadow,132,70,62
Æäõ,turalyon,1604,priest,shadow,36,19,17
Ларчшп,gordunni,1604,priest,shadow,64,28,36
Bubbleup,defias-brotherhood,1603,priest,shadow,61,40,21
Putríd,sylvanas,1603,priest,shadow,77,45,32
Brìtneyfears,ravencrest,1602,priest,shadow,30,20,10
Trancemaster,dun-modr,1602,priest,shadow,30,18,12
Jonesy,blackmoore,1602,priest,shadow,82,46,36
Rakkha,ravencrest,1602,priest,shadow,111,55,56
Brobox,blackmoore,1602,priest,shadow,42,20,22
Niecheqt,tarren-mill,1601,priest,shadow,125,71,54
Momomomomomo,blackrock,1601,priest,shadow,124,63,61
Caera,blackrock,1600,priest,shadow,36,21,15
Toba,hellscream,1600,priest,shadow,42,23,19
Cifhilis,ravencrest,1600,priest,shadow,66,32,34
Syam,dun-morogh,1600,priest,shadow,42,17,25
Willzah,outland,1598,priest,shadow,44,22,22
Энвиньяттар,howling-fjord,1597,priest,shadow,47,32,15
Valirda,twisting-nether,1597,priest,shadow,205,106,99
Àæn,blackrock,1596,priest,shadow,48,29,19
Zapreyy,kazzak,1596,priest,shadow,30,17,13
Sateruxs,burning-legion,1596,priest,shadow,113,63,50
Babarøqa,blackmoore,1596,priest,shadow,310,165,145
Horrðr,kazzak,1595,priest,shadow,73,40,33
Мизостигма,gordunni,1594,priest,shadow,47,23,24
Sopsy,stormscale,1593,priest,shadow,60,32,28
Перекованный,soulflayer,1592,priest,shadow,189,94,95
Флпрст,soulflayer,1591,priest,shadow,30,21,9
Саксесфул,howling-fjord,1591,priest,shadow,121,67,54
Elenie,frostwolf,1590,priest,shadow,45,24,21
Brøwnyez,zuljin,1590,priest,shadow,96,45,51
Buffholy,dun-modr,1589,priest,shadow,78,43,35
Genthus,kazzak,1589,priest,shadow,108,56,52
Inferius,shadowsong,1589,priest,shadow,76,31,45
Даркфолс,soulflayer,1588,priest,shadow,48,29,19
Aenon,argent-dawn,1588,priest,shadow,53,30,23
Morsy,alleria,1588,priest,shadow,80,44,36
Stepmama,kazzak,1588,priest,shadow,42,21,21
Vøîdgødx,antonidas,1588,priest,shadow,40,20,20
Pombär,ragnaros,1587,priest,shadow,54,36,18
Wrathful,terokkar,1585,priest,shadow,30,20,10
Priestgrade,darkspear,1585,priest,shadow,58,30,28
Discmaskinen,aggramar,1585,priest,shadow,36,17,19
Sadsongs,twisting-nether,1584,priest,shadow,100,55,45
Faminé,outland,1584,priest,shadow,65,29,36
Dïesel,blackhand,1583,priest,shadow,36,19,17
Vilhiil,darksorrow,1582,priest,shadow,128,69,59
Cykdwojeczka,burning-legion,1582,priest,shadow,139,71,68
Charmebolzen,blackrock,1582,priest,shadow,132,67,65
Babydark,ravencrest,1582,priest,shadow,36,18,18
Darkangél,forscherliga,1582,priest,shadow,72,34,38
Galilea,sanguino,1581,priest,shadow,60,34,26
Gooflord,ravencrest,1581,priest,shadow,52,29,23
Thawx,stormscale,1581,priest,shadow,54,29,25
Zyzzforever,ragnaros,1580,priest,shadow,30,17,13
Lothlórien,dun-modr,1579,priest,shadow,48,35,13
Imøteph,ragnaros,1579,priest,shadow,83,47,36
Cryptoflame,silvermoon,1579,priest,shadow,45,25,20
Narutosifort,archimonde,1579,priest,shadow,49,25,24
Ialoricha,dun-modr,1579,priest,shadow,176,89,87
Pewkz,draenor,1578,priest,shadow,84,50,34
Sakanade,twisting-nether,1576,priest,shadow,48,37,11
Dùsty,archimonde,1575,priest,shadow,47,27,20
Loldawg,stormscale,1574,priest,shadow,36,18,18
Brycen,silvermoon,1574,priest,shadow,52,25,27
Fumiiko,stormscale,1574,priest,shadow,84,38,46
Kightz,twisting-nether,1572,priest,shadow,128,66,62
Shreedz,blackmoore,1572,priest,shadow,68,31,37
Terrored,ravencrest,1572,priest,shadow,66,28,38
Castêr,silvermoon,1571,priest,shadow,132,71,61
Brighty,sylvanas,1571,priest,shadow,159,84,75
Corruptx,ysondre,1571,priest,shadow,68,35,33
Giruga,eredar,1570,priest,shadow,36,20,16
Lênax,arthas,1570,priest,shadow,69,34,35
Амгар,galakrond,1568,priest,shadow,131,73,58
Diapösitiv,draenor,1566,priest,shadow,108,61,47
Beonin,tarren-mill,1565,priest,shadow,67,40,27
Азотод,gordunni,1565,priest,shadow,168,96,72
Øhlø,ysondre,1564,priest,shadow,94,51,43
Shavog,stormscale,1564,priest,shadow,42,22,20
Reincarnate,tarren-mill,1563,priest,shadow,36,21,15
Hinorist,kazzak,1563,priest,shadow,41,22,19
Azsaryn,magtheridon,1562,priest,shadow,42,22,20
Insaniro,argent-dawn,1562,priest,shadow,66,34,32
Ankhh,bloodscalp,1560,priest,shadow,142,69,73
Shadowsister,burning-blade,1559,priest,shadow,112,63,49
Kimosabee,kazzak,1559,priest,shadow,54,27,27
Соргоху,gordunni,1557,priest,shadow,72,41,31
Lethaa,twisting-nether,1556,priest,shadow,30,19,11
Marsheil,blackhand,1556,priest,shadow,60,32,28
Meshen,ysondre,1556,priest,shadow,588,306,282
Simorflay,kazzak,1556,priest,shadow,44,22,22
Пристаболик,gordunni,1555,priest,shadow,30,19,11
Flyvoz,burning-legion,1555,priest,shadow,30,18,12
Shivaja,aegwynn,1555,priest,shadow,30,17,13
Callmegød,archimonde,1555,priest,shadow,102,54,48
Divledann,lightnings-blade,1554,priest,shadow,104,60,44
Pãst,pozzo-delleternità,1554,priest,shadow,76,43,33
Poposy,hyjal,1554,priest,shadow,54,30,24
Вэйворс,blackscar,1554,priest,shadow,166,89,77
Фастдед,howling-fjord,1553,priest,shadow,66,34,32
Bubidiblumpr,twisting-nether,1552,priest,shadow,96,60,36
Эззи,soulflayer,1552,priest,shadow,120,65,55
Strunkiin,defias-brotherhood,1552,priest,shadow,328,167,161
Bigdogs,archimonde,1552,priest,shadow,42,21,21
Brainwash,darksorrow,1552,priest,shadow,50,22,28
Tweenitopg,les-clairvoyants,1551,priest,shadow,36,20,16
Exörcíst,outland,1550,priest,shadow,81,53,28
Hemaplex,dun-modr,1550,priest,shadow,95,52,43
Astangia,nemesis,1550,priest,shadow,337,182,155
Chaerii,blackmoore,1550,priest,shadow,68,36,32
Ðotgød,nemesis,1549,priest,shadow,98,60,38
Aladra,archimonde,1549,priest,shadow,60,29,31
Vøidtheorem,ragnaros,1549,priest,shadow,72,31,41
Hecaté,blackhand,1548,priest,shadow,173,98,75
Desperion,ragnaros,1547,priest,shadow,77,48,29
Cannapriest,frostwolf,1547,priest,shadow,72,40,32
Kisala,kazzak,1546,priest,shadow,82,52,30
Vatikanet,ravencrest,1546,priest,shadow,135,75,60
Говорун,grom,1546,priest,shadow,36,20,16
Everdark,twisting-nether,1546,priest,shadow,181,96,85
Jerolol,sanguino,1546,priest,shadow,54,28,26
Valdiona,tarren-mill,1545,priest,shadow,94,55,39
Dejica,kult-der-verdammten,1545,priest,shadow,37,20,17
Weebi,silvermoon,1544,priest,shadow,101,53,48
Grainbames,sylvanas,1543,priest,shadow,30,17,13
Зонкк,thermaplugg,1543,priest,shadow,189,102,87
Malisna,argent-dawn,1543,priest,shadow,47,25,22
Coupdekaraté,sylvanas,1543,priest,shadow,36,18,18
Thmas,outland,1543,priest,shadow,92,43,49
Xooxl,ragnaros,1542,priest,shadow,102,60,42
Ladouce,archimonde,1541,priest,shadow,70,39,31
Moschadow,blackrock,1541,priest,shadow,65,27,38
Lathas,bloodfeather,1540,priest,shadow,88,57,31
Chaddius,stormscale,1540,priest,shadow,198,104,94
Vo,dentarg,1540,priest,shadow,120,59,61
Kantar,ragnaros,1539,priest,shadow,118,63,55
Zászàsmaster,kazzak,1537,priest,shadow,114,65,49
Ormarn,twisting-nether,1536,priest,shadow,92,51,41
Moontear,ravencrest,1536,priest,shadow,51,26,25
Инсэшбл,blackscar,1536,priest,shadow,60,30,30
Лостспейс,gordunni,1535,priest,shadow,34,25,9
Nahtod,blackmoore,1535,priest,shadow,30,19,11
Frv,tarren-mill,1535,priest,shadow,39,23,16
Kìckurâss,aegwynn,1535,priest,shadow,59,34,25
Danri,ravencrest,1535,priest,shadow,42,24,18
Vietzan,zuljin,1535,priest,shadow,72,36,36
Elreâ,blackrock,1535,priest,shadow,88,42,46
Solaní,antonidas,1534,priest,shadow,190,101,89
Shdwmeld,ravencrest,1533,priest,shadow,112,55,57
Sheto,burning-legion,1533,priest,shadow,458,224,234
Xelathor,twisting-nether,1532,priest,shadow,144,74,70
Zekonja,doomhammer,1532,priest,shadow,82,42,40
Arkkupiispa,stormreaver,1531,priest,shadow,30,19,11
Cringelørd,alakir,1531,priest,shadow,91,55,36
Baihoi,twilights-hammer,1531,priest,shadow,156,88,68
Massbimba,tarren-mill,1531,priest,shadow,71,36,35
Heavyhalo,ragnaros,1530,priest,shadow,36,22,14
Basicpr,ravencrest,1530,priest,shadow,87,48,39
Varjomies,ragnaros,1530,priest,shadow,132,69,63
Alanar,ragnaros,1527,priest,shadow,42,19,23
Fosil,xavius,1526,priest,shadow,78,43,35
Draryanna,nemesis,1526,priest,shadow,30,16,14
Mightyfool,aegwynn,1526,priest,shadow,126,63,63
Dionegativ,draenor,1525,priest,shadow,42,18,24
Littlefräu,ravencrest,1524,priest,shadow,28,17,11
Varta,arthas,1524,priest,shadow,53,29,24
Loaofanal,stormscale,1524,priest,shadow,48,26,22
Baptizer,nemesis,1523,priest,shadow,185,110,75
Psycos,kazzak,1523,priest,shadow,66,33,33
Boniesmack,stormscale,1521,priest,shadow,78,44,34
Ryik,ravencrest,1521,priest,shadow,119,64,55
Fnúggí,kazzak,1519,priest,shadow,72,40,32
Cinaedus,stormreaver,1519,priest,shadow,105,57,48
Carlogambino,dethecus,1519,priest,shadow,42,16,26
Deadspace,hyjal,1518,priest,shadow,95,56,39
Волкановская,eversong,1518,priest,shadow,66,34,32
Nahyra,dalaran,1518,priest,shadow,290,147,143
Gerase,blackrock,1517,priest,shadow,54,34,20
Leckpriest,sanguino,1517,priest,shadow,100,49,51
Ciqua,frostmane,1516,priest,shadow,46,27,19
Abjure,silvermoon,1516,priest,shadow,48,25,23
Êttân,ravencrest,1516,priest,shadow,148,77,71
Whocare,tarren-mill,1516,priest,shadow,82,41,41
Shadowplay,theradras,1516,priest,shadow,208,103,105
ßest,archimonde,1515,priest,shadow,78,40,38
Lavidu,antonidas,1515,priest,shadow,78,38,40
Stölpen,ravencrest,1515,priest,shadow,60,28,32
Maskinjundre,bronzebeard,1515,priest,shadow,54,24,30
Stinkycreep,executus,1514,priest,shadow,102,60,42
Flyp,stormscale,1514,priest,shadow,75,37,38
Umbralx,ragnaros,1513,priest,shadow,77,45,32
Greyford,blackhand,1512,priest,shadow,46,24,22
Jinkuzo,outland,1512,priest,shadow,40,17,23
Enprästjävel,tarren-mill,1511,priest,shadow,36,20,16
Experimentix,silvermoon,1510,priest,shadow,36,21,15
Skûggpräst,silvermoon,1510,priest,shadow,118,61,57
Jingling,kazzak,1509,priest,shadow,24,16,8
Абсорб,gordunni,1508,priest,shadow,66,41,25
Nemw,chamber-of-aspects,1508,priest,shadow,170,93,77
Grompriest,echsenkessel,1508,priest,shadow,158,84,74
Деплитфофан,gordunni,1506,priest,shadow,125,71,54
Cylantharia,eredar,1506,priest,shadow,30,16,14
Smålbenör,stormreaver,1505,priest,shadow,59,31,28
Scynthia,ravencrest,1505,priest,shadow,47,22,25
Namire,thrall,1505,priest,shadow,54,24,30
Адария,booty-bay,1504,priest,shadow,35,22,13
Aiewn,elune,1503,priest,shadow,46,26,20
Dyshexia,bronze-dragonflight,1503,priest,shadow,78,39,39
Nygel,kazzak,1502,priest,shadow,170,90,80
Xîneâ,outland,1502,priest,shadow,36,18,18
Саиленто,howling-fjord,1501,priest,shadow,119,59,60
Pressplz,archimonde,1500,priest,shadow,42,21,21
Puresaint,the-maelstrom,1499,priest,shadow,42,19,23
Sakyra,blackmoore,1498,priest,shadow,98,62,36
Chrønös,hyjal,1498,priest,shadow,222,113,109
Юбизумо,gordunni,1498,priest,shadow,116,59,57
Spideypap,ragnaros,1496,priest,shadow,75,42,33
Nicorøbin,uldum,1496,priest,shadow,169,94,75
Кхэрри,goldrinn,1496,priest,shadow,47,26,21
Pehmoinen,korgall,1496,priest,shadow,61,32,29
Zeto,blackmoore,1495,priest,shadow,79,46,33
Voidjeanzqt,blackmoore,1495,priest,shadow,238,127,111
Duppduppjr,ravencrest,1494,priest,shadow,36,20,16
Mozahn,ragnaros,1494,priest,shadow,69,36,33
Urfkncringe,sylvanas,1494,priest,shadow,42,19,23
Lainie,burning-legion,1493,priest,shadow,40,25,15
Hasnaa,silvermoon,1493,priest,shadow,88,50,38
Hiyahen,silvermoon,1493,priest,shadow,90,50,40
Ниикола,booty-bay,1493,priest,shadow,94,49,45
Txypii,dun-modr,1493,priest,shadow,48,20,28
Blasphemiia,outland,1491,priest,shadow,72,44,28
Healiea,outland,1491,priest,shadow,119,51,68
Kajifoxi,frostmane,1490,priest,shadow,60,38,22
Ragwitch,draenor,1490,priest,shadow,82,48,34
Ðizzi,dun-modr,1490,priest,shadow,42,23,19
Stiankrokås,silvermoon,1490,priest,shadow,60,30,30
Miruvai,tarren-mill,1490,priest,shadow,54,27,27
Hâicu,antonidas,1489,priest,shadow,66,39,27
Даняпампх,soulflayer,1489,priest,shadow,212,112,100
Kertith,argent-dawn,1489,priest,shadow,231,120,111
Khalix,frostwolf,1489,priest,shadow,36,18,18
Crâzycatlady,blackmoore,1488,priest,shadow,30,17,13
Seras,bloodfeather,1488,priest,shadow,227,125,102
Bercxu,ragnaros,1487,priest,shadow,60,34,26
Bierbändiger,blackhand,1487,priest,shadow,30,17,13
Elysium,darkspear,1487,priest,shadow,171,91,80
Vittelk,stormscale,1487,priest,shadow,84,44,40
Дюрэкс,soulflayer,1487,priest,shadow,46,24,22
Fiftyfives,hyjal,1487,priest,shadow,60,30,30
Shaaq,stormscale,1486,priest,shadow,24,19,5
Nomorelight,stormscale,1486,priest,shadow,54,27,27
Virdeo,aegwynn,1485,priest,shadow,61,30,31
Токиото,gordunni,1485,priest,shadow,84,40,44
Voidkäfer,ravencrest,1484,priest,shadow,36,18,18
Phplaravel,tarren-mill,1484,priest,shadow,129,62,67
Purplex,aggra-português,1484,priest,shadow,48,23,25
Lilakaii,chamber-of-aspects,1483,priest,shadow,194,98,96
Cynthi,arthas,1483,priest,shadow,36,17,19
Slepa,silvermoon,1482,priest,shadow,48,26,22
Grapemachine,dentarg,1482,priest,shadow,36,17,19
Elderath,eredar,1482,priest,shadow,47,18,29
Unreal,nagrand,1480,priest,shadow,48,22,26
Veryssra,archimonde,1479,priest,shadow,114,72,42
Shinesomnya,aegwynn,1478,priest,shadow,40,23,17
Yixi,blackmoore,1478,priest,shadow,78,42,36
Bøts,ravencrest,1478,priest,shadow,73,34,39
Бравер,soulflayer,1477,priest,shadow,84,47,37
Belìal,thrall,1477,priest,shadow,35,16,19
Pregrip,twisting-nether,1475,priest,shadow,67,34,33
ßumbleßeeqt,frostmane,1475,priest,shadow,67,31,36
Celz,kazzak,1474,priest,shadow,60,35,25
Симпоз,howling-fjord,1473,priest,shadow,42,26,16
Anathemas,draenor,1473,priest,shadow,100,57,43
Nbayoungboy,the-maelstrom,1473,priest,shadow,32,18,14
Джианитто,borean-tundra,1473,priest,shadow,52,28,24
Hælmenøw,archimonde,1472,priest,shadow,54,28,26
Deadlymoda,zenedar,1471,priest,shadow,44,24,20
Warplague,argent-dawn,1471,priest,shadow,103,48,55
Psycoscream,blackmoore,1469,priest,shadow,88,44,44
Haregnor,gorgonnash,1468,priest,shadow,37,21,16
Lëgolux,chogall,1468,priest,shadow,90,49,41
Superdude,stormscale,1467,priest,shadow,49,23,26
Sháady,ravencrest,1466,priest,shadow,60,29,31
Umayyaa,sylvanas,1466,priest,shadow,42,18,24
Sunehxp,blackrock,1465,priest,shadow,83,32,51
Dardinio,ravencrest,1463,priest,shadow,68,31,37
Isusgaspodi,argent-dawn,1461,priest,shadow,181,99,82
Старкстрим,gordunni,1461,priest,shadow,78,41,37
Люблюкофе,deathguard,1458,priest,shadow,128,69,59
Dotterin,draenor,1457,priest,shadow,141,85,56
Zildjiana,archimonde,1457,priest,shadow,138,73,65
Дикрия,eversong,1456,priest,shadow,114,59,55
Darkyy,alleria,1456,priest,shadow,42,21,21
Xyo,alleria,1456,priest,shadow,194,94,100
Daltheria,daggerspine,1455,priest,shadow,113,66,47
Hemovoid,nagrand,1454,priest,shadow,24,17,7
Badprïestx,twisting-nether,1454,priest,shadow,36,19,17
Slagatron,ragnaros,1454,priest,shadow,79,41,38
Øxyzën,marécage-de-zangar,1453,priest,shadow,85,48,37
Tyene,voljin,1453,priest,shadow,106,58,48
Vedina,bronze-dragonflight,1453,priest,shadow,105,49,56
Ансин,azuregos,1452,priest,shadow,72,47,25
Damyo,eredar,1451,priest,shadow,108,58,50
Shinígamí,frostmane,1451,priest,shadow,126,66,60
Элдерле,gordunni,1451,priest,shadow,60,31,29
Voidpbody,nerathor,1451,priest,shadow,47,24,23
Deekon,argent-dawn,1450,priest,shadow,36,20,16
Roseanne,ragnaros,1450,priest,shadow,42,17,25
Ammp,outland,1448,priest,shadow,243,128,115
Самаэльз,blackscar,1448,priest,shadow,62,31,31
Шанэкс,howling-fjord,1447,priest,shadow,24,17,7
Kurzik,zuljin,1447,priest,shadow,46,30,16
Dípp,ravencrest,1447,priest,shadow,36,18,18
Хоозяин,blackscar,1446,priest,shadow,92,54,38
Galle,frostmane,1445,priest,shadow,38,23,15
Drakharys,dun-modr,1445,priest,shadow,40,20,20
Meloo,dalaran,1444,priest,shadow,139,77,62
Broncos,twisting-nether,1443,priest,shadow,124,69,55
Styxpr,blackhand,1442,priest,shadow,31,16,15
Fuggordel,argent-dawn,1441,priest,shadow,75,36,39
Søcrax,blackrock,1440,priest,shadow,90,50,40
Odium,alakir,1440,priest,shadow,140,76,64
Kendea,silvermoon,1440,priest,shadow,211,111,100
Rätzah,silvermoon,1440,priest,shadow,90,45,45
Anastasiä,archimonde,1440,priest,shadow,69,34,35
Peep,emerald-dream,1439,priest,shadow,24,15,9
Gambetto,sanguino,1439,priest,shadow,24,15,9
Palitox,kazzak,1439,priest,shadow,70,38,32
Velenthan,stormrage,1438,priest,shadow,60,38,22
Jarz,kazzak,1438,priest,shadow,24,15,9
Singularity,ravencrest,1437,priest,shadow,120,65,55
Ariyáh,antonidas,1437,priest,shadow,162,83,79
Unpretetroll,nemesis,1436,priest,shadow,168,90,78
Даркхон,howling-fjord,1436,priest,shadow,100,53,47
Pedopräst,stormscale,1435,priest,shadow,106,59,47
Nekemtenee,magtheridon,1434,priest,shadow,53,32,21
Gesees,ravencrest,1433,priest,shadow,55,29,26
Jlox,stormscale,1433,priest,shadow,39,16,23
Prillen,kazzak,1432,priest,shadow,41,22,19
Mylini,silvermoon,1432,priest,shadow,110,59,51
Narshina,onyxia,1432,priest,shadow,48,20,28
Jcewrld,blackhand,1431,priest,shadow,72,28,44
Lagbugdcx,ravencrest,1430,priest,shadow,36,21,15
Olïfä,aggra-português,1429,priest,shadow,36,23,13
Lëshder,sanguino,1429,priest,shadow,119,59,60
Kumpi,azjolnerub,1428,priest,shadow,30,19,11
Tigrok,burning-legion,1428,priest,shadow,68,35,33
Thudre,ravencrest,1428,priest,shadow,139,70,69
Wundervoid,silvermoon,1426,priest,shadow,83,48,35
Viroz,blackmoore,1426,priest,shadow,30,16,14
Карбираторх,gordunni,1426,priest,shadow,65,32,33
Blonded,antonidas,1426,priest,shadow,42,19,23
Johnnysp,eredar,1425,priest,shadow,48,31,17
Stac,hyjal,1425,priest,shadow,24,15,9
Psystorm,frostmane,1425,priest,shadow,69,40,29
Forhandleren,draenor,1425,priest,shadow,157,75,82
Apfelrisotta,outland,1425,priest,shadow,93,43,50
Bâllí,blackmoore,1425,priest,shadow,60,27,33
Lamess,drakthul,1424,priest,shadow,55,34,21
Leythan,hyjal,1423,priest,shadow,42,22,20
Squîzz,archimonde,1422,priest,shadow,133,67,66
Липоскай,howling-fjord,1422,priest,shadow,48,23,25
Темняк,gordunni,1422,priest,shadow,60,27,33
Evna,chogall,1421,priest,shadow,54,26,28
Shaydi,todeswache,1420,priest,shadow,36,21,15
Marerittet,draenor,1420,priest,shadow,73,31,42
Henaheals,ragnaros,1419,priest,shadow,24,15,9
Evypriest,draenor,1419,priest,shadow,36,20,16
Claudefrollo,the-maelstrom,1418,priest,shadow,49,26,23
Devilcry,ravencrest,1416,priest,shadow,41,17,24
Gorali,the-venture-co,1413,priest,shadow,67,34,33
Qsandria,ravencrest,1413,priest,shadow,54,26,28
Voidis,hyjal,1413,priest,shadow,66,25,41
Dopey,kazzak,1412,priest,shadow,74,41,33
Prøfesor,nemesis,1412,priest,shadow,53,27,26
Shopify,nagrand,1412,priest,shadow,30,15,15
Simplesam,ravencrest,1412,priest,shadow,76,35,41
Venomspawn,ragnaros,1412,priest,shadow,48,22,26
Rédjohn,archimonde,1411,priest,shadow,24,16,8
Smâshëd,stormscale,1411,priest,shadow,126,62,64
Izêr,draenor,1411,priest,shadow,141,69,72
Lapinvicieux,archimonde,1411,priest,shadow,88,43,45
Diha,argent-dawn,1411,priest,shadow,36,17,19
Corpsemaw,silvermoon,1411,priest,shadow,41,19,22
Saintethérez,archimonde,1410,priest,shadow,45,30,15
Erkay,kazzak,1410,priest,shadow,95,49,46
Superböck,aggra-português,1409,priest,shadow,24,15,9
Thoryän,ragnaros,1409,priest,shadow,108,53,55
Kirrako,tarren-mill,1409,priest,shadow,42,17,25
Aliasus,archimonde,1408,priest,shadow,52,25,27
Шаасит,soulflayer,1407,priest,shadow,44,26,18
Kayeen,tarren-mill,1406,priest,shadow,142,68,74
Boostedandy,darksorrow,1405,priest,shadow,24,15,9
Clergy,hellfire,1405,priest,shadow,79,48,31
Simularcum,tarren-mill,1405,priest,shadow,78,34,44
Hörror,twisting-nether,1404,priest,shadow,96,47,49
Atsio,dun-modr,1404,priest,shadow,34,16,18
Рбгсамка,blackscar,1404,priest,shadow,64,29,35
Phïljr,ravencrest,1403,priest,shadow,78,51,27
Piixld,aegwynn,1403,priest,shadow,107,59,48
Preodek,kazzak,1403,priest,shadow,30,15,15
Unerfedsp,archimonde,1403,priest,shadow,148,69,79
Voidbro,grim-batol,1401,priest,shadow,29,15,14
Eriezel,shattered-halls,1401,priest,shadow,30,15,15
Wewo,drakthul,1401,priest,shadow,57,28,29
Eytrhfb,stormscale,1400,priest,shadow,42,27,15
Alaeddin,kazzak,1400,priest,shadow,362,187,175
Skerduddle,stormscale,1400,priest,shadow,137,68,69
Mahist,ravencrest,1398,priest,shadow,74,37,37
Dotsin,kazzak,1398,priest,shadow,178,88,90
Shidoya,tarren-mill,1398,priest,shadow,41,17,24
Nagatary,blackmoore,1397,priest,shadow,104,58,46
Xíøn,draenor,1397,priest,shadow,35,16,19
Radenox,stormscale,1397,priest,shadow,42,16,26
Lousp,tarren-mill,1395,priest,shadow,48,18,30
Tazera,boulderfist,1394,priest,shadow,128,63,65
Абервуд,soulflayer,1394,priest,shadow,56,27,29
Tschacoo,malganis,1393,priest,shadow,76,39,37
Mjamc,stormscale,1392,priest,shadow,97,55,42
Chibz,twisting-nether,1392,priest,shadow,48,21,27
Voidlord,hyjal,1391,priest,shadow,114,62,52
Iamreaper,outland,1391,priest,shadow,72,35,37
Zlejkadlec,drakthul,1390,priest,shadow,24,16,8
Fish,arathor,1390,priest,shadow,88,38,50
Terenal,ysondre,1389,priest,shadow,70,44,26
Vhayna,kazzak,1389,priest,shadow,107,58,49
Lamaovic,archimonde,1388,priest,shadow,73,37,36
Lashana,die-aldor,1388,priest,shadow,83,40,43
Hoon,destromath,1387,priest,shadow,105,56,49
Oblivita,twisting-nether,1386,priest,shadow,83,39,44
Blàze,tarren-mill,1385,priest,shadow,48,26,22
Hek,sylvanas,1384,priest,shadow,72,36,36
Daenie,elune,1383,priest,shadow,54,27,27
Ohboy,eredar,1383,priest,shadow,64,30,34
Lichtl,ysera,1382,priest,shadow,96,47,49
Kilmmiis,defias-brotherhood,1381,priest,shadow,60,32,28
Hans,thrall,1380,priest,shadow,30,18,12
Plimpi,blackmoore,1379,priest,shadow,30,16,14
Ulquiørra,blackmoore,1379,priest,shadow,96,50,46
Averagenoob,ragnaros,1378,priest,shadow,98,56,42
Bonifacio,la-croisade-écarlate,1377,priest,shadow,42,20,22
Xceliann,stormscale,1376,priest,shadow,48,23,25
Kourroucé,archimonde,1374,priest,shadow,184,94,90
Îzî,sanguino,1372,priest,shadow,114,58,56
Fleshcraft,ravencrest,1370,priest,shadow,26,15,11
Holypowér,twisting-nether,1369,priest,shadow,30,16,14
Coffíndodger,magtheridon,1367,priest,shadow,26,16,10
Низара,deathguard,1367,priest,shadow,60,24,36
Saviour,spinebreaker,1366,priest,shadow,60,34,26
Kellen,burning-blade,1366,priest,shadow,432,221,211
Ðivinà,archimonde,1366,priest,shadow,80,39,41
Zathada,twisting-nether,1365,priest,shadow,42,25,17
Весенняя,gordunni,1365,priest,shadow,50,29,21
Syntára,blackhand,1365,priest,shadow,42,20,22
Eryxial,antonidas,1365,priest,shadow,47,22,25
Dyliz,stormscale,1364,priest,shadow,66,33,33
Держимоепиво,blackscar,1364,priest,shadow,42,19,23
Mortyfer,kazzak,1364,priest,shadow,66,25,41
Synexia,sylvanas,1363,priest,shadow,111,62,49
Xanelor,tarren-mill,1362,priest,shadow,94,55,39
Brunestùd,pozzo-delleternità,1361,priest,shadow,30,20,10
Zevulós,ravencrest,1360,priest,shadow,95,37,58
Bonbonici,sylvanas,1359,priest,shadow,66,43,23
Наярда,howling-fjord,1359,priest,shadow,33,15,18
Shadowpræst,argent-dawn,1359,priest,shadow,69,31,38
Pæìn,malganis,1359,priest,shadow,42,17,25
Hexmon,tarren-mill,1356,priest,shadow,86,53,33
Fordöbroo,ragnaros,1355,priest,shadow,284,146,138
Seehz,ysondre,1355,priest,shadow,83,33,50
Имморталрё,galakrond,1354,priest,shadow,42,29,13
Thebesp,ravencrest,1354,priest,shadow,54,21,33
Офинсия,deathguard,1354,priest,shadow,47,18,29
Вексион,goldrinn,1353,priest,shadow,36,19,17
Priztar,nazjatar,1353,priest,shadow,43,22,21
Силесттиль,gordunni,1353,priest,shadow,58,29,29
Gódmic,tarren-mill,1353,priest,shadow,37,15,22
Oöm,hyjal,1352,priest,shadow,72,45,27
Голдратт,soulflayer,1352,priest,shadow,60,37,23
Nolsrcp,outland,1352,priest,shadow,36,18,18
Lunatica,stormscale,1351,priest,shadow,33,20,13
Arwen,azjolnerub,1350,priest,shadow,36,19,17
Сашашвд,howling-fjord,1350,priest,shadow,48,23,25
Seenoend,neptulon,1350,priest,shadow,48,23,25
Zappinellaa,ravencrest,1348,priest,shadow,22,15,7
Tyhjäsuoja,hyjal,1348,priest,shadow,162,83,79
Atheniss,drakthul,1347,priest,shadow,120,63,57
Eslo,outland,1347,priest,shadow,59,30,29
Кибержрица,soulflayer,1347,priest,shadow,30,15,15
Voina,ravencrest,1346,priest,shadow,40,24,16
Fåith,twilights-hammer,1346,priest,shadow,155,81,74
Slenderdoom,stormscale,1346,priest,shadow,36,18,18
Mellandoh,tarren-mill,1345,priest,shadow,167,90,77
Nyróx,malganis,1345,priest,shadow,122,59,63
Бранлор,howling-fjord,1345,priest,shadow,46,21,25
Meshield,draenor,1345,priest,shadow,48,19,29
Prìestìalìty,draenor,1344,priest,shadow,29,17,12
Flayin,kazzak,1344,priest,shadow,114,60,54
Voidgasm,kazzak,1344,priest,shadow,29,15,14
Achára,ravencrest,1343,priest,shadow,24,14,10
Sanebassoff,kazzak,1343,priest,shadow,226,117,109
Kasyrra,sylvanas,1342,priest,shadow,146,78,68
Нефрида,gordunni,1342,priest,shadow,56,28,28
Возрождающее,soulflayer,1342,priest,shadow,30,14,16
Maysiex,twisting-nether,1341,priest,shadow,24,14,10
Vtspam,stormscale,1341,priest,shadow,24,14,10
Зайчатинка,soulflayer,1341,priest,shadow,92,42,50
Shizo,blutkessel,1340,priest,shadow,59,34,25
Apuessii,dun-modr,1340,priest,shadow,59,31,28
Gauge,frostmane,1339,priest,shadow,210,108,102
Oikus,minahonda,1339,priest,shadow,114,57,57
Velenthøs,argent-dawn,1338,priest,shadow,41,23,18
Sodomix,tarren-mill,1337,priest,shadow,271,142,129
Emilyvvillis,outland,1337,priest,shadow,36,14,22
Rajip,azjolnerub,1336,priest,shadow,51,30,21
Khireeboubou,hyjal,1336,priest,shadow,30,14,16
Gød,magtheridon,1335,priest,shadow,30,14,16
Nìrtus,thrall,1334,priest,shadow,24,14,10
Morgoh,die-arguswacht,1334,priest,shadow,193,100,93
Powna,blackrock,1333,priest,shadow,72,40,32
Triuna,sylvanas,1333,priest,shadow,41,22,19
Goodison,outland,1333,priest,shadow,30,14,16
Bromiaris,dun-morogh,1333,priest,shadow,72,33,39
Deethraa,argent-dawn,1332,priest,shadow,24,14,10
Sleepyshadow,drakthul,1332,priest,shadow,80,39,41
Inei,doomhammer,1331,priest,shadow,48,25,23
Sucukpriest,blackrock,1331,priest,shadow,48,25,23
Donkyrobert,tarren-mill,1331,priest,shadow,30,14,16
Maxhima,defias-brotherhood,1330,priest,shadow,125,61,64
Söörpriest,the-maelstrom,1328,priest,shadow,84,50,34
Scaremonger,thunderhorn,1328,priest,shadow,30,14,16
Изэрвил,howling-fjord,1327,priest,shadow,66,30,36
Sai,draenor,1327,priest,shadow,97,42,55
Dumámày,silvermoon,1326,priest,shadow,24,17,7
Dysko,alakir,1326,priest,shadow,30,17,13
Kdot,drakthul,1324,priest,shadow,48,27,21
Daretox,turalyon,1324,priest,shadow,40,18,22
Grouptherpst,draenor,1323,priest,shadow,24,14,10
Bimboxo,argent-dawn,1323,priest,shadow,143,80,63
Míjagí,blackhand,1323,priest,shadow,70,36,34
Simisimi,twisting-nether,1322,priest,shadow,24,14,10
Nannostar,draenor,1321,priest,shadow,54,26,28
Сэлунна,goldrinn,1321,priest,shadow,36,14,22
Fathedead,stormreaver,1320,priest,shadow,48,18,30
Kristiflicka,kazzak,1319,priest,shadow,108,61,47
Дроус,borean-tundra,1318,priest,shadow,59,30,29
Акциуми,howling-fjord,1317,priest,shadow,210,118,92
Mistaké,the-maelstrom,1317,priest,shadow,227,120,107
Littlebugger,argent-dawn,1317,priest,shadow,63,28,35
Несущийсерп,soulflayer,1316,priest,shadow,81,36,45
Haxxøn,die-nachtwache,1315,priest,shadow,68,37,31
Цитамин,deathguard,1314,priest,shadow,120,57,63
Gaidemar,blackmoore,1312,priest,shadow,76,42,34
Prästpojken,frostwhisper,1311,priest,shadow,36,19,17
Keystoned,blackmoore,1310,priest,shadow,52,32,20
Hëllokitty,sanguino,1309,priest,shadow,174,88,86
Tremblè,outland,1309,priest,shadow,68,32,36
Haspela,silvermoon,1308,priest,shadow,30,14,16
Kíssme,archimonde,1307,priest,shadow,42,28,14
Xxede,dun-modr,1307,priest,shadow,111,52,59
Shíàpríést,kazzak,1306,priest,shadow,47,16,31
Secundis,silvermoon,1305,priest,shadow,30,16,14
Comptonzity,outland,1305,priest,shadow,36,16,20
Missadventur,skullcrusher,1304,priest,shadow,30,18,12
Kåstå,archimonde,1304,priest,shadow,35,17,18
Medovina,silvermoon,1302,priest,shadow,72,37,35
Darkconx,silvermoon,1301,priest,shadow,90,45,45
Stevenfly,outland,1301,priest,shadow,34,16,18
Абракабра,howling-fjord,1301,priest,shadow,60,28,32
Itenja,frostmourne,1299,priest,shadow,39,19,20
Yaoshih,draenor,1299,priest,shadow,107,50,57
Shadowchunks,argent-dawn,1299,priest,shadow,48,21,27
Aerith,kazzak,1298,priest,shadow,83,39,44
Kåz,argent-dawn,1295,priest,shadow,71,39,32
Lurmus,outland,1295,priest,shadow,59,29,30
Aíushtha,frostmane,1295,priest,shadow,36,14,22
Zák,sylvanas,1293,priest,shadow,78,49,29
Zolfiqar,tarren-mill,1292,priest,shadow,27,14,13
Exstinctio,nemesis,1292,priest,shadow,39,18,21
Byzzi,draenor,1291,priest,shadow,30,21,9
Boomboxk,darksorrow,1290,priest,shadow,24,15,9
Абасали,howling-fjord,1290,priest,shadow,54,22,32
Ехереу,blackscar,1286,priest,shadow,24,15,9
Jhaazx,nemesis,1286,priest,shadow,48,28,20
Aeo,twisting-nether,1285,priest,shadow,41,22,19
Otheym,the-maelstrom,1283,priest,shadow,42,20,22
Outofsoul,blackhand,1281,priest,shadow,30,22,8
Jawoflash,antonidas,1281,priest,shadow,33,15,18
Ggdoll,twisting-nether,1280,priest,shadow,205,103,102
Annubishadow,zuljin,1280,priest,shadow,48,21,27
Bigorna,frostmane,1279,priest,shadow,60,31,29
Battlefog,turalyon,1279,priest,shadow,72,37,35
Sxynix,thrall,1279,priest,shadow,59,29,30
Dântro,kult-der-verdammten,1277,priest,shadow,24,16,8
Неймхичгодх,gordunni,1277,priest,shadow,28,15,13
Nerfnerf,kazzak,1277,priest,shadow,58,27,31
Chowhone,archimonde,1277,priest,shadow,42,14,28
Chillx,blackmoore,1274,priest,shadow,197,108,89
Osvoid,draenor,1272,priest,shadow,38,19,19
Лапушок,borean-tundra,1271,priest,shadow,96,59,37
Faroz,shadowsong,1271,priest,shadow,54,28,26
Majestíc,blackmoore,1271,priest,shadow,36,17,19
Зукеро,thermaplugg,1270,priest,shadow,30,16,14
Inzàné,kazzak,1269,priest,shadow,106,57,49
Kuusistöö,kazzak,1268,priest,shadow,25,15,10
Нудная,galakrond,1268,priest,shadow,58,25,33
Harukaa,aggra-português,1267,priest,shadow,60,41,19
Calor,nemesis,1267,priest,shadow,28,17,11
Tøucher,silvermoon,1267,priest,shadow,42,22,20
Qalis,twisting-nether,1267,priest,shadow,30,14,16
Нимрана,deathguard,1267,priest,shadow,79,33,46
Nûwa,draenor,1265,priest,shadow,24,18,6
Farilight,draenor,1265,priest,shadow,84,53,31
Rétestészta,arathor,1265,priest,shadow,30,16,14
Слышуфонк,howling-fjord,1265,priest,shadow,30,16,14
Adssdfhjgh,outland,1264,priest,shadow,44,25,19
Oggiz,archimonde,1264,priest,shadow,35,18,17
Enemypriest,argent-dawn,1263,priest,shadow,93,48,45
Adägïo,dun-modr,1263,priest,shadow,144,63,81
Icyîce,kazzak,1261,priest,shadow,25,15,10
Evilspel,ravencrest,1261,priest,shadow,33,18,15
Phycobabe,sylvanas,1261,priest,shadow,88,39,49
Mundwerk,malganis,1260,priest,shadow,153,70,83
Frèreroger,hyjal,1260,priest,shadow,54,21,33
Alterspflege,eredar,1258,priest,shadow,38,15,23
Priestyo,blackrock,1257,priest,shadow,48,20,28
Laná,twisting-nether,1256,priest,shadow,56,38,18
Ylaya,garrosh,1256,priest,shadow,64,31,33
Sangububblu,silvermoon,1253,priest,shadow,17,14,3
Delaiya,antonidas,1253,priest,shadow,120,58,62
Seni,gilneas,1252,priest,shadow,84,38,46
Ewolet,silvermoon,1251,priest,shadow,30,16,14
Onskansmoder,shattered-hand,1251,priest,shadow,107,51,56
Nostramu,argent-dawn,1251,priest,shadow,102,44,58
Veshania,blackhand,1250,priest,shadow,86,42,44
Тэтсу,greymane,1249,priest,shadow,60,39,21
Mariosee,wrathbringer,1249,priest,shadow,72,37,35
Balthe,defias-brotherhood,1248,priest,shadow,18,13,5
Nda,stormscale,1248,priest,shadow,24,13,11
Gbc,emerald-dream,1248,priest,shadow,24,13,11
Umbrazoid,sanguino,1248,priest,shadow,66,27,39
Xktr,aggra-português,1247,priest,shadow,18,13,5
Nøskillzz,nemesis,1247,priest,shadow,18,13,5
Elfriede,twisting-nether,1247,priest,shadow,24,17,7
Sacreth,ragnaros,1247,priest,shadow,68,35,33
Døtgdx,archimonde,1246,priest,shadow,18,13,5
Shmoly,stormscale,1245,priest,shadow,18,13,5
Chamelthoe,the-maelstrom,1245,priest,shadow,18,13,5
Testorwp,ragnaros,1245,priest,shadow,54,33,21
Dellarien,stormscale,1245,priest,shadow,24,13,11
Shadoxx,malganis,1245,priest,shadow,24,13,11
Majinmadara,ravencrest,1245,priest,shadow,28,14,14
Скизма,gordunni,1243,priest,shadow,18,13,5
Lasdrael,dun-modr,1243,priest,shadow,99,54,45
Halysion,ravencrest,1243,priest,shadow,30,13,17
Brrghhfghf,tarren-mill,1242,priest,shadow,18,13,5
Fairylite,outland,1242,priest,shadow,24,13,11
Shîn,aegwynn,1242,priest,shadow,139,68,71
Ruojatar,stormreaver,1241,priest,shadow,18,13,5
Wàks,dalaran,1240,priest,shadow,34,19,15
Peikkousva,twisting-nether,1240,priest,shadow,24,13,11
Ваккарий,gordunni,1240,priest,shadow,166,84,82
Divinefilth,kazzak,1240,priest,shadow,58,27,31
Lilyrosemary,arathor,1239,priest,shadow,24,13,11
Sephìrøth,malganis,1239,priest,shadow,42,21,21
Sayash,chamber-of-aspects,1239,priest,shadow,32,14,18
Karnatia,burning-legion,1238,priest,shadow,60,27,33
ßeastx,nethersturm,1237,priest,shadow,75,36,39
Shokkapriest,draenor,1237,priest,shadow,30,14,16
Septembér,draenor,1236,priest,shadow,18,13,5
Каспера,galakrond,1236,priest,shadow,24,13,11
Xxon,blackrock,1233,priest,shadow,42,21,21
Zedrus,azshara,1233,priest,shadow,41,14,27
Rehpotsirhc,blackrock,1232,priest,shadow,30,18,12
Omnissiiah,silvermoon,1232,priest,shadow,54,24,30
Диградейшен,gordunni,1232,priest,shadow,65,22,43
Prodan,frostmane,1231,priest,shadow,18,13,5
Shifune,blackhand,1231,priest,shadow,66,29,37
Spwin,silvermoon,1230,priest,shadow,48,26,22
Didinini,outland,1229,priest,shadow,24,13,11
Pharli,stormscale,1227,priest,shadow,30,13,17
Лайкшеди,soulflayer,1226,priest,shadow,78,44,34
Hârlequin,draenor,1226,priest,shadow,477,242,235
Rogmisa,cthun,1226,priest,shadow,96,46,50
Dívíne,ravenholdt,1225,priest,shadow,18,13,5
Morteous,twisting-nether,1225,priest,shadow,303,151,152
Denzory,ysondre,1224,priest,shadow,36,22,14
Nightchime,silvermoon,1224,priest,shadow,87,46,41
Angleka,argent-dawn,1223,priest,shadow,137,67,70
Controlled,tarren-mill,1223,priest,shadow,176,86,90
Blååb,draenor,1220,priest,shadow,30,13,17
Gimcho,magtheridon,1219,priest,shadow,24,13,11
Ænchantress,sylvanas,1219,priest,shadow,46,21,25
Marío,moonglade,1218,priest,shadow,24,13,11
Seum,ravencrest,1218,priest,shadow,30,13,17
Ahgnus,silvermoon,1218,priest,shadow,46,19,27
Tesz,perenolde,1217,priest,shadow,36,16,20
Árìáne,khaz-modan,1216,priest,shadow,209,105,104
Bozia,chamber-of-aspects,1216,priest,shadow,48,22,26
Yonaka,amanthul,1216,priest,shadow,102,44,58
Skuggzter,outland,1215,priest,shadow,42,26,16
Soulsuckerr,silvermoon,1215,priest,shadow,53,25,28
Khalphus,argent-dawn,1213,priest,shadow,51,23,28
Holybestie,eredar,1212,priest,shadow,34,19,15
Damnedangel,drakthul,1212,priest,shadow,30,13,17
Тлбк,soulflayer,1211,priest,shadow,42,21,21
Éclípsé,stormscale,1211,priest,shadow,30,13,17
Mirelaw,stormscale,1210,priest,shadow,84,53,31
Reptika,tichondrius,1210,priest,shadow,28,17,11
Caballococo,dun-modr,1210,priest,shadow,222,107,115
Neychen,blackrock,1209,priest,shadow,30,13,17
Calsote,sanguino,1208,priest,shadow,43,27,16
Шамамба,blackscar,1208,priest,shadow,24,13,11
Antigospa,kazzak,1208,priest,shadow,48,20,28
Ziglinde,shattrath,1207,priest,shadow,52,30,22
Szalsza,arathor,1207,priest,shadow,53,23,30
Giblets,aszune,1206,priest,shadow,24,15,9
Sigor,hellfire,1204,priest,shadow,58,29,29
Дикосвет,howling-fjord,1203,priest,shadow,138,61,77
Ayuntamiento,proudmoore,1202,priest,shadow,36,23,13
Æxey,antonidas,1202,priest,shadow,99,49,50
Tiinia,hyjal,1202,priest,shadow,46,17,29
Вегельдэрс,gordunni,1201,priest,shadow,48,23,25
Mylox,blackrock,1200,priest,shadow,22,14,8
Seâky,blackmoore,1198,priest,shadow,128,63,65
Youkounkoun,garona,1195,priest,shadow,36,22,14
Montane,wrathbringer,1195,priest,shadow,63,30,33
Ruad,blackrock,1193,priest,shadow,30,17,13
Zanjiya,kazzak,1193,priest,shadow,35,13,22
Ënmâ,archimonde,1191,priest,shadow,67,41,26
Madizuluka,aggra-português,1191,priest,shadow,45,22,23
Jyncs,auchindoun,1191,priest,shadow,30,13,17
Cptnahab,blackmoore,1190,priest,shadow,85,52,33
Powergodz,exodar,1190,priest,shadow,36,16,20
Милотанин,gordunni,1188,priest,shadow,89,46,43
Looó,los-errantes,1188,priest,shadow,72,37,35
Mydianá,aegwynn,1187,priest,shadow,29,16,13
Avatars,kirin-tor,1185,priest,shadow,94,48,46
Рикимарочка,gordunni,1185,priest,shadow,70,30,40
Supermacy,eredar,1184,priest,shadow,30,14,16
Phue,ragnaros,1183,priest,shadow,44,25,19
Багбери,eversong,1182,priest,shadow,504,252,252
Classy,drakthul,1182,priest,shadow,45,15,30
Crishroc,stormreaver,1180,priest,shadow,141,73,68
Praizejeebus,auchindoun,1180,priest,shadow,29,13,16
Wulfgahr,argent-dawn,1177,priest,shadow,48,28,20
Дитеприста,greymane,1176,priest,shadow,42,25,17
Cottyx,outland,1176,priest,shadow,22,13,9
Cronershadow,stormscale,1176,priest,shadow,32,15,17
Ocastia,antonidas,1173,priest,shadow,42,22,20
Булькозавр,razuvious,1172,priest,shadow,60,32,28
Grimgodx,ravencrest,1172,priest,shadow,28,14,14
Bòóny,ravencrest,1171,priest,shadow,36,14,22
Darkprïest,kazzak,1170,priest,shadow,56,32,24
Azade,silvermoon,1168,priest,shadow,18,13,5
Liliashet,sanguino,1166,priest,shadow,36,18,18
Løxi,blackmoore,1165,priest,shadow,25,14,11
Nyathen,baelgun,1165,priest,shadow,25,13,12
Velanrous,kazzak,1164,priest,shadow,54,32,22
Mynithir,chants-éternels,1163,priest,shadow,36,18,18
Санятруу,blackscar,1159,priest,shadow,102,58,44
Garock,archimonde,1159,priest,shadow,59,25,34
Scaryman,ravencrest,1157,priest,shadow,23,14,9
Ælîta,blackhand,1155,priest,shadow,48,28,20
Уртримас,gordunni,1154,priest,shadow,80,39,41
Sebrøk,nemesis,1152,priest,shadow,18,12,6
Portvin,terenas,1152,priest,shadow,111,56,55
Hampådenbååd,kazzak,1152,priest,shadow,24,12,12
Aritrosp,kargath,1152,priest,shadow,24,12,12
Hotdog,kult-der-verdammten,1152,priest,shadow,42,20,22
Redoubtablee,kazzak,1152,priest,shadow,72,25,47
Julîane,aegwynn,1151,priest,shadow,18,12,6
Мсикатана,gordunni,1151,priest,shadow,18,12,6
Extazia,ravencrest,1151,priest,shadow,18,12,6
Grayraven,azjolnerub,1151,priest,shadow,36,12,24
Tailjob,silvermoon,1150,priest,shadow,18,12,6
Sinsofmany,ragnaros,1150,priest,shadow,18,12,6
Pretòn,nemesis,1150,priest,shadow,30,12,18
Boefjé,outland,1149,priest,shadow,96,49,47
Sîçkzømßiê,kazzak,1149,priest,shadow,24,12,12
Psychø,kazzak,1149,priest,shadow,24,12,12
Hellena,neptulon,1148,priest,shadow,78,41,37
Sethp,hyjal,1148,priest,shadow,24,12,12
Zakkonnik,burning-legion,1148,priest,shadow,30,14,16
Xuhu,azshara,1147,priest,shadow,24,12,12
Xerxsiss,frostwolf,1146,priest,shadow,54,32,22
Tartaroula,twisting-nether,1146,priest,shadow,24,12,12
Turbosucc,burning-blade,1146,priest,shadow,30,12,18
Cabalist,silvermoon,1145,priest,shadow,150,77,73
Vogthon,aggra-português,1145,priest,shadow,24,12,12
Bhutyolo,azjolnerub,1145,priest,shadow,57,28,29
Smõke,tarren-mill,1145,priest,shadow,80,36,44
Роуп,gordunni,1144,priest,shadow,41,18,23
Smilyface,sylvanas,1144,priest,shadow,30,12,18
Cahira,argent-dawn,1144,priest,shadow,36,12,24
Shädøwn,chogall,1142,priest,shadow,12,12,0
Othu,quelthalas,1142,priest,shadow,60,26,34
Efrava,dun-modr,1141,priest,shadow,78,41,37
Ràthaløs,sanguino,1141,priest,shadow,24,12,12
Васпохилить,howling-fjord,1141,priest,shadow,156,67,89
Erfofthesop,chants-éternels,1141,priest,shadow,30,12,18
Ravnica,nemesis,1140,priest,shadow,24,12,12
Томба,ashenvale,1139,priest,shadow,18,12,6
Каратэк,howling-fjord,1139,priest,shadow,42,22,20
Pangoffy,burning-legion,1138,priest,shadow,18,12,6
Sacher,shendralar,1138,priest,shadow,96,48,48
Eliana,blackrock,1136,priest,shadow,18,12,6
Амфетаминная,howling-fjord,1136,priest,shadow,137,73,64
Suurona,die-aldor,1136,priest,shadow,60,29,31
Fuzzydude,ravencrest,1135,priest,shadow,36,12,24
Energyfreaxi,aegwynn,1134,priest,shadow,29,13,16
Maximandreic,kazzak,1133,priest,shadow,48,14,34
Некросиний,eversong,1130,priest,shadow,31,18,13
Thergozar,stormscale,1130,priest,shadow,97,55,42
Holymonstah,sanguino,1130,priest,shadow,58,29,29
Cerbero,doomhammer,1128,priest,shadow,18,12,6
Kizzorde,ragnaros,1127,priest,shadow,32,12,20
Moogie,archimonde,1126,priest,shadow,36,12,24
Farseerx,ravencrest,1125,priest,shadow,150,84,66
Rastuvius,twisting-nether,1125,priest,shadow,54,24,30
Tacko,tarren-mill,1123,priest,shadow,30,12,18
Eosar,blackhand,1120,priest,shadow,24,12,12
Tarissa,ravenholdt,1116,priest,shadow,60,32,28
Valdemar,alakir,1115,priest,shadow,39,21,18
Notcute,the-maelstrom,1111,priest,shadow,29,12,17
Shikamarudmx,burning-legion,1105,priest,shadow,27,13,14
Fanberra,the-venture-co,1105,priest,shadow,30,14,16
Nasurans,ravencrest,1105,priest,shadow,50,18,32
Druska,ragnaros,1103,priest,shadow,47,25,22
Nellytaa,dalaran,1103,priest,shadow,35,18,17
Zennen,ragnaros,1101,priest,shadow,25,13,12
Sáro,ravencrest,1099,priest,shadow,24,13,11
Mattá,stormscale,1097,priest,shadow,27,15,12
Orochimaruh,pozzo-delleternità,1096,priest,shadow,30,15,15
Семмэр,gordunni,1096,priest,shadow,116,52,64
Смотривнебоь,soulflayer,1094,priest,shadow,23,14,9
Bonka,sanguino,1093,priest,shadow,24,13,11
Ixdeadxl,stormscale,1093,priest,shadow,30,13,17
Ðarcø,archimonde,1093,priest,shadow,95,39,56
Harkøn,draenor,1087,priest,shadow,28,14,14
Ravenbell,chamber-of-aspects,1087,priest,shadow,27,13,14
Arunp,magtheridon,1086,priest,shadow,32,12,20
Kraanocska,outland,1085,priest,shadow,21,13,8
Narafalia,malygos,1076,priest,shadow,33,13,20
Yuhé,elune,1072,priest,shadow,54,30,24
Vanzl,ravencrest,1070,priest,shadow,36,16,20
Собакедруг,borean-tundra,1069,priest,shadow,59,23,36
Ниомана,gordunni,1067,priest,shadow,34,19,15
Beellzo,sylvanas,1065,priest,shadow,129,59,70
Atelstan,drakthul,1062,priest,shadow,144,66,78
Rèd,antonidas,1062,priest,shadow,42,12,30
Syfl,defias-brotherhood,1060,priest,shadow,30,13,17
Alsyidan,khaz-modan,1059,priest,shadow,25,19,6
Brainmuscle,ravencrest,1057,priest,shadow,24,14,10
Фейсслоу,galakrond,1057,priest,shadow,36,17,19
Kishoengi,ravencrest,1056,priest,shadow,12,11,1
Noskillzz,nemesis,1056,priest,shadow,18,11,7
Cskgbénébéné,garona,1056,priest,shadow,18,11,7
Hanyk,kazzak,1056,priest,shadow,18,11,7
Mindboorst,kazzak,1056,priest,shadow,18,11,7
Spurge,ravencrest,1056,priest,shadow,24,11,13
Wizsp,tarren-mill,1055,priest,shadow,18,11,7
Noyam,dun-morogh,1055,priest,shadow,24,11,13
Laradiel,dun-modr,1054,priest,shadow,18,11,7
Elyziz,tarren-mill,1054,priest,shadow,24,11,13
Мэдмод,gordunni,1054,priest,shadow,24,11,13
Buttbob,ravencrest,1054,priest,shadow,24,11,13
Uzü,ysondre,1054,priest,shadow,28,12,16
Umyqt,ragnaros,1053,priest,shadow,18,11,7
Fluffedup,twisting-nether,1053,priest,shadow,24,11,13
Bombastoz,kazzak,1053,priest,shadow,24,11,13
Блэксикер,greymane,1053,priest,shadow,118,49,69
Jadæ,ragnaros,1052,priest,shadow,24,11,13
Holineß,burning-blade,1051,priest,shadow,18,11,7
Vardrium,antonidas,1050,priest,shadow,24,11,13
Phobò,blackrock,1050,priest,shadow,24,11,13
Gstah,taerar,1049,priest,shadow,24,11,13
Deshaz,tarren-mill,1049,priest,shadow,30,11,19
Sundae,nemesis,1048,priest,shadow,30,11,19
Phêq,ravencrest,1048,priest,shadow,30,11,19
Darettii,blackrock,1047,priest,shadow,27,14,13
Xatori,arthas,1047,priest,shadow,24,11,13
Despéri,ysondre,1047,priest,shadow,30,11,19
Scorbute,conseil-des-ombres,1046,priest,shadow,18,11,7
Netsojsp,blackmoore,1046,priest,shadow,18,11,7
Сергиоо,soulflayer,1046,priest,shadow,24,11,13
Найтлолла,blackscar,1045,priest,shadow,24,11,13
Lexivenera,silvermoon,1044,priest,shadow,18,11,7
Boomhilde,aegwynn,1044,priest,shadow,35,15,20
Zubrowkâ,kazzak,1043,priest,shadow,24,11,13
Irrtum,nozdormu,1041,priest,shadow,30,20,10
Мараес,howling-fjord,1040,priest,shadow,26,16,10
Nightyqt,blackrock,1038,priest,shadow,23,11,12
Mimox,kaelthas,1033,priest,shadow,36,20,16
Akroz,sanguino,1033,priest,shadow,30,11,19
Nextdawn,kazzak,1032,priest,shadow,24,12,12
Trencharse,draenor,1030,priest,shadow,29,11,18
Phasmofobia,ragnaros,1028,priest,shadow,86,43,43
Asdaprice,hellfire,1027,priest,shadow,29,18,11
Блюмсик,blackscar,1025,priest,shadow,36,20,16
Festiz,tichondrius,1024,priest,shadow,30,14,16
Chïefpapi,twisting-nether,1022,priest,shadow,23,11,12
Alreadylost,ragnaros,1020,priest,shadow,18,11,7
Xaeroow,archimonde,1017,priest,shadow,20,12,8
Iceys,stormscale,1005,priest,shadow,17,11,6
Leishmania,darkspear,1005,priest,shadow,24,13,11
Chevappi,turalyon,1004,priest,shadow,32,14,18
Szpinx,stormscale,1003,priest,shadow,42,16,26
Paìn,sanguino,1001,priest,shadow,22,13,9
Gwyneth,archimonde,1000,priest,shadow,60,33,27
Марвелс,soulflayer,1000,priest,shadow,39,12,27
Raiponceanus,ysondre,998,priest,shadow,15,11,4
Pneumay,tarren-mill,996,priest,shadow,26,15,11
Arbata,doomhammer,996,priest,shadow,30,16,14
Nuger,tarren-mill,995,priest,shadow,60,35,25
Серебрия,gordunni,991,priest,shadow,99,53,46
Намдандар,howling-fjord,991,priest,shadow,90,44,46
Minabonxx,silvermoon,991,priest,shadow,95,36,59
Zypriest,silvermoon,990,priest,shadow,14,11,3
Cpcxmpany,aegwynn,990,priest,shadow,106,48,58
Pipen,stormscale,990,priest,shadow,29,11,18
Zargoss,sylvanas,974,priest,shadow,19,11,8
Мргорсан,eversong,974,priest,shadow,30,16,14
Stoffig,aggramar,974,priest,shadow,89,46,43
Theythem,stormscale,960,priest,shadow,12,10,2
Reimagined,sylvanas,960,priest,shadow,12,10,2
Temtem,ravencrest,960,priest,shadow,15,10,5
Secretagentx,kazzak,960,priest,shadow,18,10,8
Flüttër,ravencrest,960,priest,shadow,18,10,8
Кинраналь,eversong,960,priest,shadow,48,24,24
Swl,blackrock,960,priest,shadow,22,11,11
Tribz,kargath,959,priest,shadow,12,10,2
Uria,moonglade,959,priest,shadow,18,10,8
Seankingkong,ravencrest,959,priest,shadow,18,10,8
Хастла,goldrinn,959,priest,shadow,18,10,8
Merlinis,ravencrest,959,priest,shadow,18,10,8
Hilerki,draenor,959,priest,shadow,24,10,14
Dëpt,nemesis,959,priest,shadow,25,10,15
Munisgagis,twisting-nether,959,priest,shadow,30,10,20
Deadzy,moonglade,958,priest,shadow,12,10,2
Conzequ,kazzak,958,priest,shadow,18,10,8
Teradros,blackhand,958,priest,shadow,18,10,8
Shadowleech,ragnaros,958,priest,shadow,18,10,8
Qiandra,argent-dawn,958,priest,shadow,24,10,14
Rngånxiety,ravencrest,957,priest,shadow,18,10,8
Dunkelseele,ahnqiraj,957,priest,shadow,18,10,8
Bîgmac,ravencrest,957,priest,shadow,18,10,8
Hoca,ravencrest,957,priest,shadow,18,10,8
Genjorss,pozzo-delleternità,956,priest,shadow,12,10,2
Taxthepoor,blackhand,955,priest,shadow,24,10,14
Above,hyjal,954,priest,shadow,27,12,15
Våfflán,silvermoon,954,priest,shadow,25,10,15
Bodeeney,hellfire,954,priest,shadow,74,29,45
Twisty,malganis,953,priest,shadow,26,15,11
Voldemör,zuljin,952,priest,shadow,30,11,19
Хароки,howling-fjord,950,priest,shadow,12,10,2
Caluna,aegwynn,950,priest,shadow,18,10,8
Priëstitute,stormscale,949,priest,shadow,18,10,8
Lisua,blackmoore,949,priest,shadow,82,30,52
Ixxl,der-rat-von-dalaran,949,priest,shadow,50,16,34
Иннй,howling-fjord,947,priest,shadow,24,11,13
Pollution,ragnaros,942,priest,shadow,19,11,8
Sulgyto,kazzak,941,priest,shadow,32,11,21
Papadiax,twilights-hammer,938,priest,shadow,18,10,8
Ruhoniy,ysondre,934,priest,shadow,30,17,13
Даркпул,gordunni,933,priest,shadow,36,10,26
Abrakahudder,tarren-mill,927,priest,shadow,17,10,7
Умом,gordunni,927,priest,shadow,26,11,15
Daria,teldrassil,927,priest,shadow,42,16,26
Xartasfen,archimonde,926,priest,shadow,20,11,9
Aezef,ysondre,926,priest,shadow,26,11,15
Vregoa,twisting-nether,926,priest,shadow,29,10,19
Kunc,drakthul,924,priest,shadow,18,10,8
Karabin,culte-de-la-rive-noire,923,priest,shadow,54,28,26
Breathing,ragnaros,922,priest,shadow,110,49,61
Dayowe,antonidas,921,priest,shadow,273,135,138
Føxy,emerald-dream,920,priest,shadow,18,12,6
Satànâs,twisting-nether,919,priest,shadow,17,10,7
Andorelya,blackhand,919,priest,shadow,42,23,19
Húlda,auchindoun,912,priest,shadow,22,11,11
Csksablanca,sargeras,911,priest,shadow,17,10,7
Fârge,elune,911,priest,shadow,17,10,7
Thunderbluff,xavius,911,priest,shadow,29,15,14
Priestoll,draenor,911,priest,shadow,21,10,11
Valaç,turalyon,910,priest,shadow,21,10,11
Arondir,defias-brotherhood,910,priest,shadow,21,10,11
Эсттелла,gordunni,908,priest,shadow,142,67,75
Treasons,tarren-mill,908,priest,shadow,54,16,38
Kasimobbel,alexstrasza,907,priest,shadow,167,72,95
Cthulou,tarren-mill,903,priest,shadow,250,123,127
Helheïm,chants-éternels,896,priest,shadow,22,10,12
Lildiggy,outland,894,priest,shadow,20,10,10
Anshes,draenor,893,priest,shadow,28,14,14
Reckpump,twisting-nether,891,priest,shadow,23,10,13
Силабездны,deathguard,889,priest,shadow,132,66,66
Maayhem,blackrock,888,priest,shadow,30,12,18
Kloown,conseil-des-ombres,886,priest,shadow,72,37,35
Triinkett,doomhammer,881,priest,shadow,75,31,44
Endchor,eredar,879,priest,shadow,126,59,67
Raffá,blackhand,864,priest,shadow,12,9,3
Iamsadstory,sylvanas,864,priest,shadow,12,9,3
Tylb,tarren-mill,864,priest,shadow,12,9,3
Alinfinito,ravencrest,864,priest,shadow,12,9,3
Honeydots,ravencrest,864,priest,shadow,12,9,3
Maxonos,blackmoore,864,priest,shadow,12,9,3
Niogtreds,kazzak,864,priest,shadow,12,9,3
Potatomoto,kazzak,864,priest,shadow,12,9,3
Romero,sylvanas,864,priest,shadow,12,9,3
Inavea,hyjal,864,priest,shadow,18,9,9
Nätrix,tarren-mill,864,priest,shadow,18,9,9
Spyrono,kazzak,864,priest,shadow,18,9,9
Svagis,draenor,864,priest,shadow,18,9,9
Шучунекошмар,soulflayer,864,priest,shadow,18,9,9
Truckysp,sanguino,864,priest,shadow,18,9,9
Memphistô,thrall,864,priest,shadow,18,9,9
Fjonnski,blackmoore,864,priest,shadow,21,10,11
Sheerzo,twisting-nether,864,priest,shadow,24,9,15
Schmatzy,blackmoore,864,priest,shadow,24,9,15
Ok,blackrock,864,priest,shadow,24,9,15
Starzzovic,eredar,864,priest,shadow,24,9,15
Æåeåeåé,twisting-nether,864,priest,shadow,24,9,15
Vorramir,blackmoore,864,priest,shadow,24,9,15
Lilsayx,blackrock,864,priest,shadow,30,9,21
Klayjamin,draenor,863,priest,shadow,12,9,3
Quintanaro,thrall,863,priest,shadow,12,9,3
Späxxi,amanthul,863,priest,shadow,12,9,3
Hollywoôd,draenor,863,priest,shadow,12,9,3
Potati,defias-brotherhood,863,priest,shadow,12,9,3
Lailá,blackmoore,863,priest,shadow,12,9,3
Hoomanpri,ravencrest,863,priest,shadow,12,9,3
Viánná,sylvanas,863,priest,shadow,16,10,6
Tygstycke,tarren-mill,863,priest,shadow,18,9,9
Talandra,drakthul,863,priest,shadow,18,9,9
Bragokexx,tarren-mill,863,priest,shadow,18,9,9
Thami,aegwynn,863,priest,shadow,18,9,9
Sàlexz,ysondre,863,priest,shadow,18,9,9
Cloudfactory,ravencrest,863,priest,shadow,18,9,9
Maiiko,dun-modr,863,priest,shadow,18,9,9
Balan,argent-dawn,863,priest,shadow,18,9,9
Truereligion,tarren-mill,863,priest,shadow,24,9,15
Cythie,antonidas,863,priest,shadow,24,9,15
Lerión,ravencrest,863,priest,shadow,24,9,15
Konklebär,twisting-nether,863,priest,shadow,24,9,15
Clubhavana,blackrock,863,priest,shadow,65,21,44
Kaleycuoco,blackrock,862,priest,shadow,12,9,3
Shacoat,draenor,862,priest,shadow,12,9,3
Skaliq,tarren-mill,862,priest,shadow,12,9,3
Holyshart,magtheridon,862,priest,shadow,18,9,9
Prayypray,eredar,862,priest,shadow,18,9,9
Ximenia,eredar,862,priest,shadow,18,9,9
Ronlimonkek,dun-modr,862,priest,shadow,18,9,9
Treadlightly,aggra-português,862,priest,shadow,18,9,9
Ilostmybible,runetotem,862,priest,shadow,24,9,15
Aelwïn,ysondre,861,priest,shadow,12,9,3
Kavie,ravencrest,861,priest,shadow,18,9,9
Lubudu,burning-legion,861,priest,shadow,18,9,9
Dutchstuff,karazhan,861,priest,shadow,18,9,9
Qiguai,outland,861,priest,shadow,18,9,9
Stòkkè,stormscale,861,priest,shadow,18,9,9
Dementois,magtheridon,861,priest,shadow,24,9,15
Ztrolol,archimonde,861,priest,shadow,24,9,15
Pristara,bloodhoof,860,priest,shadow,12,9,3
Etherialis,kazzak,860,priest,shadow,24,9,15
Saintless,azuremyst,859,priest,shadow,30,9,21
Howlscastie,stormscale,858,priest,shadow,18,9,9
Paînswîft,blackhand,857,priest,shadow,18,9,9
Лиройгеморой,gordunni,857,priest,shadow,18,9,9
Grimer,talnivarr,856,priest,shadow,18,9,9
Orcpriest,hellfire,856,priest,shadow,24,9,15
Ethalia,kirin-tor,849,priest,shadow,18,9,9
Alesdia,eredar,843,priest,shadow,23,9,14
Asob,tarren-mill,830,priest,shadow,17,9,8
Shaddyr,thrall,828,priest,shadow,17,9,8
Шадовприст,soulflayer,818,priest,shadow,22,11,11
Happychap,stormreaver,815,priest,shadow,21,9,12
Moonliswd,blackrock,810,priest,shadow,21,10,11
Imdeadxd,twisting-nether,809,priest,shadow,18,10,8
Sliey,blackrock,809,priest,shadow,17,9,8
Supriest,alakir,809,priest,shadow,27,10,17
Oltranza,sylvanas,808,priest,shadow,20,10,10
Darkerx,silvermoon,808,priest,shadow,23,10,13
Avowed,stormscale,803,priest,shadow,31,10,21
Bäckay,silvermoon,799,priest,shadow,16,9,7
Raylinae,die-aldor,799,priest,shadow,16,9,7
Jaanny,defias-brotherhood,799,priest,shadow,20,9,11
Alicanx,silvermoon,798,priest,shadow,17,9,8
Jeannedârk,archimonde,797,priest,shadow,17,9,8
Grootts,burning-blade,797,priest,shadow,20,9,11
Жруля,ashenvale,793,priest,shadow,42,11,31
Pycasso,tarren-mill,777,priest,shadow,60,25,35
Shankszz,argent-dawn,771,priest,shadow,16,9,7
Alavéa,frostmourne,768,priest,shadow,12,8,4
Lílgoblin,draenor,768,priest,shadow,12,8,4
Notthatbad,draenor,768,priest,shadow,12,8,4
Êfx,ravencrest,768,priest,shadow,12,8,4
Djstache,tarren-mill,768,priest,shadow,12,8,4
Drákxo,kazzak,768,priest,shadow,12,8,4
Raëkon,nemesis,768,priest,shadow,12,8,4
Happyfeis,sanguino,768,priest,shadow,12,8,4
Cornflayz,outland,768,priest,shadow,12,8,4
Aliy,aegwynn,768,priest,shadow,12,8,4
Убикрофт,soulflayer,768,priest,shadow,12,8,4
Evílshadows,tarren-mill,768,priest,shadow,12,8,4
Gomor,mannoroth,768,priest,shadow,18,8,10
Kamoripriest,blackhand,768,priest,shadow,18,8,10
Jellypie,blackrock,768,priest,shadow,18,8,10
Slack,azjolnerub,768,priest,shadow,18,8,10
Westminster,tarren-mill,768,priest,shadow,18,8,10
Khâlÿst,archimonde,768,priest,shadow,18,8,10
Svenskabarn,twisting-nether,768,priest,shadow,18,8,10
Zalupaxgood,outland,768,priest,shadow,18,8,10
Эшараджа,howling-fjord,767,priest,shadow,12,8,4
Холиспирт,deathguard,767,priest,shadow,12,8,4
Dóubt,draenor,767,priest,shadow,12,8,4
Zappikpriest,silvermoon,767,priest,shadow,12,8,4
Leleg,blackhand,767,priest,shadow,15,9,6
Strapo,archimonde,767,priest,shadow,18,8,10
Дакимакурах,gordunni,767,priest,shadow,18,8,10
Luminex,marécage-de-zangar,767,priest,shadow,18,8,10
Maela,uldum,767,priest,shadow,18,8,10
Marcellina,argent-dawn,767,priest,shadow,18,8,10
Созвонимся,gordunni,767,priest,shadow,18,8,10
Bigdumber,kazzak,767,priest,shadow,18,8,10
Nagashizzar,arathor,767,priest,shadow,18,8,10
Phetaari,argent-dawn,767,priest,shadow,18,8,10
Dimorinny,silvermoon,767,priest,shadow,18,8,10
Priestlolx,aegwynn,767,priest,shadow,24,8,16
Zaqsn,blackrock,767,priest,shadow,30,8,22
Greatest,defias-brotherhood,766,priest,shadow,12,8,4
Mavaai,burning-legion,766,priest,shadow,12,8,4
Csúforck,ragnaros,766,priest,shadow,12,8,4
Sheshan,destromath,766,priest,shadow,12,8,4
Berrylee,twisting-nether,766,priest,shadow,12,8,4
Aducanpea,blackmoore,766,priest,shadow,12,8,4
Valkyråe,ravencrest,766,priest,shadow,15,9,6
Ihaveibs,doomhammer,766,priest,shadow,19,9,10
Kwhy,twisting-nether,766,priest,shadow,18,8,10
Dvärg,ravencrest,766,priest,shadow,18,8,10
Darkmayham,silvermoon,766,priest,shadow,18,8,10
Мистеняшко,gordunni,766,priest,shadow,18,8,10
Ичисанчик,howling-fjord,766,priest,shadow,24,8,16
Enduring,darksorrow,766,priest,shadow,30,8,22
Derl,pozzo-delleternità,765,priest,shadow,12,8,4
Shiekma,norgannon,765,priest,shadow,18,8,10
Géèk,alakir,765,priest,shadow,19,8,11
Shalnorei,drakthul,764,priest,shadow,12,8,4
Holyface,twisting-nether,764,priest,shadow,12,8,4
Silverfate,outland,764,priest,shadow,18,8,10
Sammel,moonglade,763,priest,shadow,18,8,10
Никорете,soulflayer,759,priest,shadow,18,8,10
Святаятряпка,fordragon,754,priest,shadow,18,8,10
Vídel,cthun,751,priest,shadow,17,9,8
Barcodes,kazzak,749,priest,shadow,20,9,11
Волотт,borean-tundra,749,priest,shadow,18,8,10
Teleriah,blackmoore,735,priest,shadow,17,8,9
Toljénpr,twisting-nether,735,priest,shadow,22,8,14
Xavyos,eredar,734,priest,shadow,22,8,14
Smoothiejoe,stormscale,733,priest,shadow,10,9,1
Herro,thrall,719,priest,shadow,11,8,3
Aureï,khaz-modan,716,priest,shadow,18,9,9
Raetwo,stormscale,703,priest,shadow,14,8,6
Hanfur,twisting-nether,703,priest,shadow,16,8,8
Манддалорец,gordunni,702,priest,shadow,22,8,14
Shendiva,nathrezim,681,priest,shadow,13,8,5
Jinxk,anachronos,672,priest,shadow,12,7,5
Миррен,gordunni,672,priest,shadow,12,7,5
Dolens,argent-dawn,672,priest,shadow,12,7,5
Lerissea,argent-dawn,672,priest,shadow,12,7,5
Deform,argent-dawn,672,priest,shadow,12,7,5
Snoopydawgs,blackmoore,672,priest,shadow,12,7,5
Laxanes,ravencrest,672,priest,shadow,12,7,5
Medtner,stormscale,672,priest,shadow,12,7,5
Teríyaki,blackrock,672,priest,shadow,12,7,5
Aesyla,drakthul,672,priest,shadow,12,7,5
Mcdutchy,arygos,672,priest,shadow,12,7,5
Libstik,hyjal,672,priest,shadow,12,7,5
Systerstål,twisting-nether,672,priest,shadow,12,7,5
Mshield,blackmoore,672,priest,shadow,12,7,5
Azazoth,sylvanas,672,priest,shadow,12,7,5
Viperbites,tarren-mill,672,priest,shadow,12,7,5
Nordrenalin,tarren-mill,672,priest,shadow,12,7,5
Mørøk,dun-modr,672,priest,shadow,12,7,5
Xùÿø,culte-de-la-rive-noire,672,priest,shadow,12,7,5
Vladï,conseil-des-ombres,672,priest,shadow,12,7,5
Зоргдаркнесс,howling-fjord,672,priest,shadow,12,7,5
Roastie,frostmane,672,priest,shadow,12,7,5
Linara,frostmane,672,priest,shadow,12,7,5
Teengirl,ravencrest,672,priest,shadow,12,7,5
Kaydenkross,eredar,672,priest,shadow,12,7,5
Fogess,aegwynn,672,priest,shadow,12,7,5
Desti,darkmoon-faire,672,priest,shadow,12,7,5
Kíguwu,draenor,672,priest,shadow,12,7,5
Awator,ysondre,672,priest,shadow,12,7,5
Leggat,draenor,672,priest,shadow,15,8,7
Arratør,ysondre,672,priest,shadow,18,7,11
Madrobert,outland,672,priest,shadow,18,7,11
Majinbuù,sargeras,672,priest,shadow,18,7,11
Crazyname,outland,672,priest,shadow,18,7,11
Memelordqt,silvermoon,672,priest,shadow,18,7,11
Lilnazx,twisting-nether,672,priest,shadow,18,7,11
Korzec,dun-modr,672,priest,shadow,18,7,11
Heygoogle,ravencrest,672,priest,shadow,18,7,11
Tolqen,stormscale,672,priest,shadow,18,7,11
Рэйам,fordragon,672,priest,shadow,18,7,11
Клаенз,fordragon,672,priest,shadow,18,7,11
Irlfatguy,ravencrest,672,priest,shadow,20,7,13
Iamshadow,blackrock,672,priest,shadow,23,7,16
Serayhx,blackrock,672,priest,shadow,24,7,17
Wílmàgødx,ravencrest,671,priest,shadow,12,7,5
Kogarrashi,aegwynn,671,priest,shadow,12,7,5
Badomens,draenor,671,priest,shadow,12,7,5
Elivn,kazzak,671,priest,shadow,12,7,5
Elarya,zenedar,671,priest,shadow,12,7,5
Cryptoniite,kazzak,671,priest,shadow,12,7,5
Allanna,talnivarr,671,priest,shadow,12,7,5
Xæe,blackrock,671,priest,shadow,12,7,5
Hölyfans,ravencrest,671,priest,shadow,12,7,5
Мариаглорум,gordunni,671,priest,shadow,12,7,5
Neeyø,blackhand,671,priest,shadow,12,7,5
Bazazath,thrall,671,priest,shadow,15,8,7
Freshpope,ravencrest,671,priest,shadow,16,8,8
Игшайл,eversong,671,priest,shadow,18,7,11
Whitfield,cthun,671,priest,shadow,18,7,11
Трихоманиаз,ashenvale,671,priest,shadow,18,7,11
Neggan,chamber-of-aspects,671,priest,shadow,18,7,11
Fùkøff,stormscale,671,priest,shadow,18,7,11
Gagai,ravencrest,671,priest,shadow,18,7,11
Leyra,burning-blade,671,priest,shadow,18,7,11
Calypsa,aegwynn,671,priest,shadow,18,7,11
Chaarronn,drakthul,671,priest,shadow,18,7,11
Idontmind,eredar,671,priest,shadow,18,7,11
Elfer,dalaran,671,priest,shadow,18,7,11
Ascendedpwnz,silvermoon,671,priest,shadow,18,7,11
Lêavis,kazzak,671,priest,shadow,18,7,11
Getitoffme,auchindoun,671,priest,shadow,19,7,12
Zileena,argent-dawn,671,priest,shadow,24,7,17
Alexpriest,twisting-nether,671,priest,shadow,24,7,17
Barbiemeth,silvermoon,671,priest,shadow,24,7,17
Solanaelle,archimonde,671,priest,shadow,24,7,17
Hiela,outland,670,priest,shadow,12,7,5
Chayz,thrall,670,priest,shadow,12,7,5
Kitasia,tarren-mill,670,priest,shadow,12,7,5
Copperplume,ravenholdt,670,priest,shadow,12,7,5
Nahrzgrein,blackmoore,670,priest,shadow,14,7,7
Nesar,stormscale,670,priest,shadow,18,7,11
Kavius,kazzak,670,priest,shadow,23,8,15
Infliction,auchindoun,670,priest,shadow,24,7,17
Nonka,azjolnerub,670,priest,shadow,24,7,17
Deathornot,blackrock,669,priest,shadow,12,7,5
Vríemel,silvermoon,669,priest,shadow,15,8,7
Husqvarnasåg,tarren-mill,669,priest,shadow,27,8,19
Hotsanddots,auchindoun,668,priest,shadow,12,7,5
Hoouro,ysondre,668,priest,shadow,18,7,11
Newik,burning-legion,667,priest,shadow,12,7,5
Hulluh,tarren-mill,665,priest,shadow,12,7,5
Trînìty,kazzak,665,priest,shadow,18,7,11
Nadora,sanguino,663,priest,shadow,29,9,20
Redfield,frostmane,663,priest,shadow,24,7,17
Spaghettoni,tarren-mill,662,priest,shadow,12,7,5
Potatø,antonidas,654,priest,shadow,17,7,10
Swarzie,outland,653,priest,shadow,17,7,10
Szelén,ragnaros,640,priest,shadow,16,7,9
Solaqt,tarren-mill,639,priest,shadow,11,7,4
Devoid,aggra-português,639,priest,shadow,26,8,18
Llounal,silvermoon,637,priest,shadow,17,7,10
Viperaxe,stormscale,623,priest,shadow,11,7,4
Seniya,argent-dawn,623,priest,shadow,11,7,4
Voidtrix,blackrock,623,priest,shadow,17,7,10
Eliyssa,ragnaros,623,priest,shadow,17,7,10
Фьюриреидж,soulflayer,617,priest,shadow,14,8,6
Jyugins,alonsus,617,priest,shadow,18,8,10
Viridaé,blackmoore,607,priest,shadow,11,7,4
Reeflix,blackmoore,607,priest,shadow,17,8,9
Voilencia,kazzak,592,priest,shadow,13,7,6
Mysticks,kirin-tor,592,priest,shadow,13,7,6
Ilovesumecx,aegwynn,591,priest,shadow,11,7,4
Lipzip,twisting-nether,591,priest,shadow,19,7,12
Deadandugly,eredar,576,priest,shadow,6,6,0
Noggorran,teldrassil,576,priest,shadow,10,7,3
Dakystepmom,stormreaver,576,priest,shadow,12,6,6
Englestøv,stormreaver,576,priest,shadow,12,6,6
Farotep,tarren-mill,576,priest,shadow,12,6,6
Iqr,blackmoore,576,priest,shadow,12,6,6
Dboi,tarren-mill,576,priest,shadow,12,6,6
Shacka,tarren-mill,576,priest,shadow,12,6,6
Madpandax,blackmoore,576,priest,shadow,12,6,6
Karyx,blackmoore,576,priest,shadow,12,6,6
Vyø,tarren-mill,576,priest,shadow,12,6,6
Yazh,argent-dawn,576,priest,shadow,12,6,6
Saliâ,blackmoore,576,priest,shadow,12,6,6
Свдпро,soulflayer,576,priest,shadow,12,6,6
Nometalol,drakthul,576,priest,shadow,12,6,6
Bedevil,twisting-nether,576,priest,shadow,12,6,6
Mindbomb,defias-brotherhood,576,priest,shadow,12,6,6
Noreal,twisting-nether,576,priest,shadow,12,6,6
Shadowpdots,sargeras,576,priest,shadow,12,6,6
Cocolasticot,garona,576,priest,shadow,12,6,6
Ragaril,kaelthas,576,priest,shadow,12,6,6
Cultist,defias-brotherhood,576,priest,shadow,12,6,6
Sselycrem,dun-morogh,576,priest,shadow,12,6,6
Holydark,forscherliga,576,priest,shadow,12,6,6
Skyfour,blackmoore,576,priest,shadow,12,6,6
Enimao,tarren-mill,576,priest,shadow,12,6,6
Chîllipriest,draenor,576,priest,shadow,12,6,6
Nomarak,drakthul,576,priest,shadow,12,6,6
Vizzek,eredar,576,priest,shadow,12,6,6
Kunayu,ravencrest,576,priest,shadow,12,6,6
Skillmåster,ravencrest,576,priest,shadow,12,6,6
Fluffieh,ravencrest,576,priest,shadow,12,6,6
Lirrydoz,ravencrest,576,priest,shadow,12,6,6
Lysium,sylvanas,576,priest,shadow,12,6,6
Ralaya,ravencrest,576,priest,shadow,12,6,6
Cluelêss,blackrock,576,priest,shadow,12,6,6
Wakizashi,ravencrest,576,priest,shadow,12,6,6
Wasgehtjungs,blackrock,576,priest,shadow,12,6,6
Mephiras,kult-der-verdammten,576,priest,shadow,12,6,6
Prästjäväln,stormscale,576,priest,shadow,12,6,6
Herlloomprie,stormscale,576,priest,shadow,12,6,6
Siquisha,stormscale,576,priest,shadow,12,6,6
Сакта,howling-fjord,576,priest,shadow,12,6,6
Submeplz,stormscale,576,priest,shadow,12,6,6
Ilostmybibíe,silvermoon,576,priest,shadow,12,6,6
Ellfle,kazzak,576,priest,shadow,12,6,6
Pepitzaftw,sylvanas,576,priest,shadow,12,6,6
Poonies,silvermoon,576,priest,shadow,12,6,6
Cyberlin,nemesis,576,priest,shadow,12,6,6
Tonyxfor,nemesis,576,priest,shadow,12,6,6
Torpedobæver,silvermoon,576,priest,shadow,12,6,6
Landliebe,outland,576,priest,shadow,12,6,6
Lilannah,archimonde,576,priest,shadow,12,6,6
Wonkä,archimonde,576,priest,shadow,12,6,6
Старлайтх,gordunni,576,priest,shadow,12,6,6
Ursela,tarren-mill,576,priest,shadow,18,6,12
Ràvèn,dun-modr,576,priest,shadow,18,6,12
Averye,kazzak,576,priest,shadow,18,6,12
Ezea,blackmoore,576,priest,shadow,18,6,12
Extrasa,daggerspine,576,priest,shadow,24,6,18
ßåßåýågå,ysondre,576,priest,shadow,24,6,18
Øro,ysondre,576,priest,shadow,24,6,18
Princéssà,aegwynn,575,priest,shadow,12,6,6
Вартэг,blackscar,575,priest,shadow,12,6,6
Goldenapples,ravencrest,575,priest,shadow,12,6,6
Torquemad,sunstrider,575,priest,shadow,12,6,6
Арабески,galakrond,575,priest,shadow,12,6,6
Нитровина,howling-fjord,575,priest,shadow,12,6,6
Kadèn,ysondre,575,priest,shadow,12,6,6
Drmwow,kazzak,575,priest,shadow,12,6,6
Attaxx,dragonmaw,575,priest,shadow,12,6,6
Scastro,silvermoon,575,priest,shadow,12,6,6
Prepodobna,ravencrest,575,priest,shadow,18,6,12
Cåtie,sylvanas,575,priest,shadow,18,6,12
Wintercurse,twisting-nether,575,priest,shadow,18,6,12
Siemenspvp,drakthul,575,priest,shadow,18,6,12
Sanctimo,stormscale,574,priest,shadow,12,6,6
Luxumbra,pozzo-delleternità,574,priest,shadow,12,6,6
Azshanna,argent-dawn,574,priest,shadow,12,6,6
Alycya,mannoroth,574,priest,shadow,12,6,6
Tronixcs,boulderfist,574,priest,shadow,18,6,12
Zerim,blackmoore,574,priest,shadow,30,6,24
Primurä,hyjal,573,priest,shadow,18,6,12
Zagazag,ragnaros,573,priest,shadow,18,6,12
Gammelkörper,perenolde,573,priest,shadow,18,6,12
Словаболь,gordunni,572,priest,shadow,12,6,6
Сендрагон,blackscar,572,priest,shadow,18,6,12
Dayu,blackrock,572,priest,shadow,24,6,18
Karmapollys,silvermoon,570,priest,shadow,12,6,6
Pretronbre,hyjal,570,priest,shadow,18,6,12
Raeratwo,archimonde,569,priest,shadow,17,8,9
Yvaru,der-mithrilorden,543,priest,shadow,11,6,5
Reallittle,kazzak,522,priest,shadow,16,7,9
Ginithepope,ragnaros,511,priest,shadow,11,6,5
Aratorass,malganis,510,priest,shadow,11,6,5
Kagera,argent-dawn,480,priest,shadow,6,5,1
Sântamuerte,blackrock,480,priest,shadow,6,5,1
Gíìh,ravencrest,480,priest,shadow,6,5,1
Jøa,tarren-mill,480,priest,shadow,6,5,1
Dìscìplìned,ravencrest,480,priest,shadow,6,5,1
Attilerg,stormscale,480,priest,shadow,6,5,1
Gladíator,blackhand,480,priest,shadow,6,5,1
Fredschen,blackrock,480,priest,shadow,6,5,1
Azrpr,ravencrest,480,priest,shadow,6,5,1
Lestrangé,emerald-dream,480,priest,shadow,6,5,1
Eilísh,tarren-mill,480,priest,shadow,6,5,1
Absôû,khaz-modan,480,priest,shadow,6,5,1
Easyc,gorgonnash,480,priest,shadow,6,5,1
Disillusíon,tarren-mill,480,priest,shadow,6,5,1
Ralph,kazzak,480,priest,shadow,6,5,1
Рукатёмная,soulflayer,480,priest,shadow,6,5,1
Shadowkenia,ysondre,480,priest,shadow,6,5,1
Discórdian,twisting-nether,480,priest,shadow,6,5,1
Rinkahands,silvermoon,480,priest,shadow,6,5,1
Tylandrill,draenor,480,priest,shadow,6,5,1
Pâww,kazzak,480,priest,shadow,6,5,1
Endead,stormscale,480,priest,shadow,6,5,1
Graveyards,tarren-mill,480,priest,shadow,6,5,1
Nicany,blackmoore,480,priest,shadow,6,5,1
Dárkun,kazzak,480,priest,shadow,6,5,1
Darkqt,ravencrest,480,priest,shadow,6,5,1
Алуриэлия,gordunni,480,priest,shadow,6,5,1
Darthbussy,twisting-nether,480,priest,shadow,6,5,1
Winnable,blackmoore,480,priest,shadow,6,5,1
Gpêchépaire,archimonde,480,priest,shadow,8,5,3
Qúetee,silvermoon,480,priest,shadow,10,6,4
Slitenprest,kazzak,480,priest,shadow,12,6,6
Speedfraek,kazzak,480,priest,shadow,12,5,7
Elixier,frostmane,480,priest,shadow,12,5,7
Cmonbro,hyjal,480,priest,shadow,12,5,7
Haiduka,burning-legion,480,priest,shadow,12,5,7
Zolupno,kazzak,480,priest,shadow,12,5,7
Taikki,stormreaver,480,priest,shadow,12,5,7
Шуддзуми,gordunni,480,priest,shadow,12,5,7
Mondiie,drakthul,480,priest,shadow,12,5,7
Lillclubbina,stormscale,480,priest,shadow,12,5,7
Wizarxmentar,stormscale,480,priest,shadow,12,5,7
Remkojatwo,blackrock,480,priest,shadow,12,5,7
Lèviåthån,stormscale,480,priest,shadow,12,5,7
Darkmus,quelthalas,480,priest,shadow,12,5,7
Rokil,ravencrest,480,priest,shadow,12,5,7
Yaloxyz,blackmoore,480,priest,shadow,12,5,7
Megadima,norgannon,480,priest,shadow,12,5,7
Blackout,nemesis,480,priest,shadow,12,5,7
Môrtïciâ,tarren-mill,480,priest,shadow,12,5,7
Амбракадабра,blackscar,480,priest,shadow,12,5,7
Yukasa,silvermoon,480,priest,shadow,12,5,7
Ompala,shattered-hand,480,priest,shadow,12,5,7
Unhollymarie,culte-de-la-rive-noire,480,priest,shadow,12,5,7
Bonsoin,kirin-tor,480,priest,shadow,12,5,7
Dirtydoc,area-52,480,priest,shadow,12,5,7
Rovensin,ravencrest,480,priest,shadow,12,5,7
Löspajen,stormscale,480,priest,shadow,12,5,7
Xpy,kazzak,480,priest,shadow,12,5,7
Хенели,blackscar,480,priest,shadow,12,5,7
Bromerzhus,drakthul,480,priest,shadow,12,5,7
Ölümsüz,blackmoore,480,priest,shadow,12,5,7
Jarkk,ysondre,480,priest,shadow,12,5,7
Stickyjamxx,frostmane,480,priest,shadow,12,5,7
Kidkuddo,blackmoore,480,priest,shadow,12,5,7
Loweysp,arathor,480,priest,shadow,12,5,7
Lyssandre,stormreaver,480,priest,shadow,12,5,7
Shadowful,drakthul,480,priest,shadow,12,5,7
Tarboba,tarren-mill,480,priest,shadow,12,5,7
Neverfade,dun-modr,480,priest,shadow,12,5,7
Tokz,eredar,480,priest,shadow,12,5,7
Xotz,thrall,480,priest,shadow,12,5,7
Salzgehalt,antonidas,480,priest,shadow,12,5,7
Shadowlia,blackrock,480,priest,shadow,12,5,7
Pleshiv,sanguino,480,priest,shadow,12,5,7
Rickermortis,defias-brotherhood,480,priest,shadow,12,5,7
Darrianna,outland,480,priest,shadow,12,5,7
Крэкслингер,howling-fjord,480,priest,shadow,13,5,8
Soyzanahôria,zuljin,480,priest,shadow,21,6,15
Inanitas,tichondrius,480,priest,shadow,18,5,13
Rishar,ragnaros,480,priest,shadow,18,5,13
Winar,tarren-mill,480,priest,shadow,18,5,13
Fögel,twisting-nether,480,priest,shadow,18,5,13
Hellzie,darkspear,480,priest,shadow,18,5,13
Tryagain,ravencrest,480,priest,shadow,18,5,13
Nôtt,tarren-mill,479,priest,shadow,6,5,1
Heinricht,ragnaros,479,priest,shadow,12,5,7
Chandria,veknilash,479,priest,shadow,12,5,7
Olivaress,ravencrest,479,priest,shadow,12,5,7
Fráncess,twisting-nether,479,priest,shadow,12,5,7
Biierlip,twisting-nether,479,priest,shadow,12,5,7
Балзик,blackscar,479,priest,shadow,12,5,7
Xieraxe,ravencrest,479,priest,shadow,12,5,7
Scalptor,blackhand,479,priest,shadow,12,5,7
Лейля,goldrinn,479,priest,shadow,18,5,13
Xrystal,wrathbringer,479,priest,shadow,24,5,19
Yhullgord,nazjatar,478,priest,shadow,18,5,13
Falbäla,suramar,473,priest,shadow,12,5,7
Дэнипампх,gordunni,463,priest,shadow,11,5,6
Luthsha,sylvanas,448,priest,shadow,10,5,5
Immurrtal,arathor,447,priest,shadow,8,6,2
Oscoolytb,archimonde,447,priest,shadow,8,6,2
Sàd,thrall,447,priest,shadow,11,5,6
Exila,rashgarroth,432,priest,shadow,17,6,11
Celina,quelthalas,432,priest,shadow,21,6,15
Disz,zuljin,431,priest,shadow,9,6,3
Turf,drakthul,431,priest,shadow,11,5,6
Безмездная,gordunni,426,priest,shadow,16,6,10
Bloodimand,terenas,422,priest,shadow,12,6,6
Chaddý,blackrock,416,priest,shadow,10,5,5
Zepesch,dalvengyr,409,priest,shadow,21,6,15
Alucardiiog,shattered-hand,399,priest,shadow,5,5,0
Ulalume,ravencrest,393,priest,shadow,14,7,7
Beástyqt,thrall,384,priest,shadow,6,4,2
Elunnes,the-maelstrom,384,priest,shadow,6,4,2
Дюшапинанс,soulflayer,384,priest,shadow,6,4,2
Rutah,the-maelstrom,384,priest,shadow,6,4,2
Инфесия,deathweaver,384,priest,shadow,6,4,2
Djvoodoo,ahnqiraj,384,priest,shadow,6,4,2
Ranzael,blackrock,384,priest,shadow,6,4,2
Mysticforces,silvermoon,384,priest,shadow,6,4,2
Мамкалол,soulflayer,384,priest,shadow,6,4,2
Suqmyx,ragnaros,384,priest,shadow,6,4,2
Daftî,twisting-nether,384,priest,shadow,6,4,2
Spae,twisting-nether,384,priest,shadow,6,4,2
Níbbz,twisting-nether,384,priest,shadow,6,4,2
Lxz,twisting-nether,384,priest,shadow,6,4,2
Shadowboness,twisting-nether,384,priest,shadow,6,4,2
Alicanx,twisting-nether,384,priest,shadow,6,4,2
Вэстервилли,howling-fjord,384,priest,shadow,6,4,2
Олдмэнсэйд,soulflayer,384,priest,shadow,6,4,2
Trac,twisting-nether,384,priest,shadow,6,4,2
Ylenae,twisting-nether,384,priest,shadow,6,4,2
Nebunia,twisting-nether,384,priest,shadow,6,4,2
Jpxoxo,blackhand,384,priest,shadow,6,4,2
Floodey,defias-brotherhood,384,priest,shadow,6,4,2
Jesuispasbon,hyjal,384,priest,shadow,6,4,2
Torino,kazzak,384,priest,shadow,6,4,2
Ozmandius,ravencrest,384,priest,shadow,6,4,2
Dokurochan,tarren-mill,384,priest,shadow,6,4,2
Текл,blackscar,384,priest,shadow,6,4,2
Dairox,blackrock,384,priest,shadow,6,4,2
Tuitio,blackmoore,384,priest,shadow,6,4,2
Éxomil,archimonde,384,priest,shadow,6,4,2
Holypwo,draenor,384,priest,shadow,6,4,2
Rankoneprazt,stormscale,384,priest,shadow,6,4,2
Coqa,blackrock,384,priest,shadow,6,4,2
Syrïal,hyjal,384,priest,shadow,6,4,2
Prådâshådëzz,blackmoore,384,priest,shadow,6,4,2
Mamaa,stormscale,384,priest,shadow,6,4,2
Mshieldo,blackmoore,384,priest,shadow,6,4,2
Edgybro,kazzak,384,priest,shadow,6,4,2
Døgfîsh,stormscale,384,priest,shadow,6,4,2
Kapaloinsut,draenor,384,priest,shadow,6,4,2
Thogrey,archimonde,384,priest,shadow,6,4,2
Pinkfloydx,lightbringer,384,priest,shadow,6,4,2
Shaquíloheal,blackrock,384,priest,shadow,6,4,2
Kenzah,ysondre,384,priest,shadow,6,4,2
Luuña,ravencrest,384,priest,shadow,6,4,2
Mønzie,stormscale,384,priest,shadow,6,4,2
Keylythia,blackmoore,384,priest,shadow,6,4,2
Vqny,archimonde,384,priest,shadow,6,4,2
Shóxi,blackmoore,384,priest,shadow,6,4,2
Éllipses,kazzak,384,priest,shadow,6,4,2
Korvmoj,ravencrest,384,priest,shadow,6,4,2
Kyokaze,silvermoon,384,priest,shadow,6,4,2
Ifearnoone,outland,384,priest,shadow,6,4,2
Darkmìstress,nemesis,384,priest,shadow,6,4,2
Spleen,archimonde,384,priest,shadow,6,4,2
Danekshadow,turalyon,384,priest,shadow,6,4,2
Zul,nemesis,384,priest,shadow,6,4,2
Metabeta,shattered-hand,384,priest,shadow,6,4,2
Hotdoge,zenedar,384,priest,shadow,6,4,2
Kazorn,argent-dawn,384,priest,shadow,6,4,2
Glaedahr,blackmoore,384,priest,shadow,6,4,2
Cheryli,alleria,384,priest,shadow,6,4,2
Êlectron,ravencrest,384,priest,shadow,6,4,2
Usw,outland,384,priest,shadow,6,4,2
Idisck,kazzak,384,priest,shadow,6,4,2
Fericul,argent-dawn,384,priest,shadow,6,4,2
Jimbób,malygos,384,priest,shadow,6,4,2
Buomap,kazzak,384,priest,shadow,6,4,2
Doyun,kazzak,384,priest,shadow,6,4,2
Galadrïel,dragonmaw,384,priest,shadow,6,4,2
Sîarra,eredar,384,priest,shadow,6,4,2
Massivbeton,blackmoore,384,priest,shadow,6,4,2
Holymood,aegwynn,384,priest,shadow,6,4,2
Alusiepriest,ravencrest,384,priest,shadow,6,4,2
Stonymontana,ravencrest,384,priest,shadow,6,4,2
Lorthonor,silvermoon,384,priest,shadow,6,4,2
Spum,ravencrest,384,priest,shadow,6,4,2
Yellenna,argent-dawn,384,priest,shadow,6,4,2
Napriest,kazzak,384,priest,shadow,6,4,2
Sheid,zuljin,384,priest,shadow,6,4,2
Víxie,frostmane,384,priest,shadow,6,4,2
Surx,silvermoon,384,priest,shadow,6,4,2
Lumex,aegwynn,384,priest,shadow,6,4,2
Darqmatter,drakthul,384,priest,shadow,6,4,2
Fetaagneta,grim-batol,384,priest,shadow,6,4,2
Tekrs,tarren-mill,384,priest,shadow,6,4,2
Vantek,antonidas,384,priest,shadow,6,4,2
Shizophrenia,aggra-português,384,priest,shadow,6,4,2
Djsnook,ravencrest,384,priest,shadow,6,4,2
Jdotp,silvermoon,384,priest,shadow,6,4,2
Sekeios,sanguino,384,priest,shadow,6,4,2
Madreöscura,cthun,384,priest,shadow,6,4,2
Ýbëzz,ravencrest,384,priest,shadow,6,4,2
Clungeslag,argent-dawn,384,priest,shadow,6,4,2
Психоз,gordunni,384,priest,shadow,10,5,5
Necronidas,burning-legion,384,priest,shadow,10,5,5
Nìak,ysondre,384,priest,shadow,15,5,10
Darkoze,kazzak,384,priest,shadow,12,4,8
Xalgâzor,zuljin,384,priest,shadow,12,4,8
Zaoza,dentarg,384,priest,shadow,12,4,8
Bacovia,tarren-mill,384,priest,shadow,12,4,8
Hanniel,kazzak,384,priest,shadow,12,4,8
Zzoska,burning-legion,384,priest,shadow,12,4,8
Elpsycongoro,aegwynn,384,priest,shadow,12,4,8
Voidknight,darkspear,384,priest,shadow,12,4,8
Dpriesta,aegwynn,384,priest,shadow,12,4,8
Amonrah,blutkessel,384,priest,shadow,12,4,8
Râây,blackrock,384,priest,shadow,12,4,8
Залакджин,howling-fjord,384,priest,shadow,12,4,8
Skilled,stormscale,384,priest,shadow,12,4,8
Crimatoriá,rajaxx,384,priest,shadow,12,4,8
Swoptoplong,blackhand,384,priest,shadow,12,4,8
Lfgarcatraz,aegwynn,384,priest,shadow,12,4,8
Арлектакль,blackscar,384,priest,shadow,12,4,8
Adamàntium,sanguino,384,priest,shadow,12,4,8
Neryl,alleria,384,priest,shadow,12,4,8
Niikki,blackrock,384,priest,shadow,12,4,8
Entenpanda,kazzak,384,priest,shadow,12,4,8
Mindcrackr,stormscale,384,priest,shadow,12,4,8
Jojipriest,tarren-mill,384,priest,shadow,12,4,8
Halysis,chamber-of-aspects,384,priest,shadow,12,4,8
Obscurity,burning-steppes,384,priest,shadow,12,4,8
Æro,malganis,384,priest,shadow,12,4,8
Самоэль,gordunni,384,priest,shadow,12,4,8
Gonorreolga,tarren-mill,384,priest,shadow,12,4,8
Necrolooz,ragnaros,384,priest,shadow,12,4,8
Célaz,blackmoore,384,priest,shadow,12,4,8
Miradil,argent-dawn,384,priest,shadow,12,4,8
Thyrena,twisting-nether,384,priest,shadow,12,4,8
Baubsy,ghostlands,384,priest,shadow,12,4,8
Nynaehve,archimonde,384,priest,shadow,12,4,8
Bilalhassâni,archimonde,384,priest,shadow,12,4,8
Kirtách,dun-modr,384,priest,shadow,12,4,8
Datscrazi,ravencrest,384,priest,shadow,12,4,8
Dotmaster,darkspear,384,priest,shadow,12,4,8
Dælirium,antonidas,384,priest,shadow,12,4,8
Soupriest,ysondre,384,priest,shadow,12,4,8
Gendzsó,ragnaros,384,priest,shadow,12,4,8
Айдеус,lich-king,384,priest,shadow,12,4,8
Ferhur,defias-brotherhood,384,priest,shadow,12,4,8
Morzâr,outland,384,priest,shadow,12,4,8
Xaphen,kirin-tor,384,priest,shadow,12,4,8
Shadøwz,grim-batol,384,priest,shadow,12,4,8
Chlorohhkine,chogall,384,priest,shadow,13,4,9
Tobirama,stormscale,384,priest,shadow,17,4,13
Nukksch,antonidas,384,priest,shadow,18,4,14
Shadowdex,frostwolf,384,priest,shadow,18,4,14
Шкуропльот,gordunni,384,priest,shadow,18,4,14
Абрасд,gordunni,384,priest,shadow,18,4,14
Muromachi,kirin-tor,383,priest,shadow,6,4,2
Abnórmus,tarren-mill,383,priest,shadow,6,4,2
Pepicka,turalyon,383,priest,shadow,6,4,2
Ðex,chromaggus,383,priest,shadow,12,4,8
Sphard,ysondre,383,priest,shadow,12,4,8
Adlareg,silvermoon,383,priest,shadow,12,4,8
Sýmo,kazzak,383,priest,shadow,12,4,8
Нечавкай,deathweaver,383,priest,shadow,18,4,14
Kyol,colinas-pardas,383,priest,shadow,18,4,14
Mâverick,nemesis,383,priest,shadow,18,4,14
Anglaran,hellscream,383,priest,shadow,24,4,20
Blyatman,tarren-mill,382,priest,shadow,6,4,2
Quinlanx,quelthalas,381,priest,shadow,18,4,14
Perchédue,silvermoon,367,priest,shadow,11,4,7
Împðøg,stormscale,352,priest,shadow,10,4,6
Topshop,vashj,351,priest,shadow,11,4,7
Phaedisc,defias-brotherhood,351,priest,shadow,11,4,7
Shilôz,hyjal,351,priest,shadow,11,4,7
Levitating,argent-dawn,336,priest,shadow,9,5,4
Prästisjag,kazzak,330,priest,shadow,20,10,10
Zetara,archimonde,320,priest,shadow,10,4,6
Mindgames,the-maelstrom,319,priest,shadow,5,4,1
Runbaberun,hyjal,319,priest,shadow,8,4,4
Shagoku,blackmoore,319,priest,shadow,8,4,4
Whýççpèrx,ravencrest,304,priest,shadow,7,4,3
Ondaman,ravencrest,288,priest,shadow,6,3,3
Jusmitework,silvermoon,288,priest,shadow,6,3,3
Маталор,gordunni,288,priest,shadow,6,3,3
Proteco,antonidas,288,priest,shadow,6,3,3
Ephraziel,defias-brotherhood,288,priest,shadow,6,3,3
Veie,ravencrest,288,priest,shadow,6,3,3
Selfcontrol,blackhand,288,priest,shadow,6,3,3
Prastas,archimonde,288,priest,shadow,6,3,3
Mgx,defias-brotherhood,288,priest,shadow,6,3,3
Narwarion,die-aldor,288,priest,shadow,6,3,3
Croose,ravencrest,288,priest,shadow,6,3,3
Haàdes,blackrock,288,priest,shadow,6,3,3
Tobijara,proudmoore,288,priest,shadow,6,3,3
Kallsen,ravencrest,288,priest,shadow,6,3,3
Zøid,ysondre,288,priest,shadow,6,3,3
Zooling,aegwynn,288,priest,shadow,6,3,3
Momet,defias-brotherhood,288,priest,shadow,6,3,3
Dévas,aegwynn,288,priest,shadow,6,3,3
Nàstyx,ravencrest,288,priest,shadow,6,3,3
Truta,ravencrest,288,priest,shadow,6,3,3
Roxfer,ysondre,288,priest,shadow,6,3,3
Soonako,antonidas,288,priest,shadow,6,3,3
Runristad,ravencrest,288,priest,shadow,6,3,3
Морпехжнец,gordunni,288,priest,shadow,6,3,3
Eloapriest,blackhand,288,priest,shadow,6,3,3
Hélp,stormscale,288,priest,shadow,6,3,3
Eiqu,eredar,288,priest,shadow,6,3,3
Chuckbarry,kazzak,288,priest,shadow,6,3,3
Xaviá,blackrock,288,priest,shadow,6,3,3
Shomäre,ysondre,288,priest,shadow,6,3,3
Деняприст,gordunni,288,priest,shadow,6,3,3
Skyrïpa,ysondre,288,priest,shadow,6,3,3
Søînx,archimonde,288,priest,shadow,6,3,3
Bhlad,silvermoon,288,priest,shadow,6,3,3
Bîngle,ragnaros,288,priest,shadow,6,3,3
Швдяра,gordunni,288,priest,shadow,6,3,3
Tåbðøtgøðx,archimonde,288,priest,shadow,6,3,3
Milfed,ragnaros,288,priest,shadow,6,3,3
Fryp,blackrock,288,priest,shadow,6,3,3
Synaxia,blackrock,288,priest,shadow,6,3,3
Злыденькая,gordunni,288,priest,shadow,6,3,3
Skycity,silvermoon,288,priest,shadow,6,3,3
Reapersark,draenor,288,priest,shadow,6,3,3
Vividots,draenor,288,priest,shadow,6,3,3
Thimble,blackhand,288,priest,shadow,6,3,3
Spankulere,stormscale,288,priest,shadow,6,3,3
Arrhenia,blackrock,288,priest,shadow,6,3,3
Rafikii,eredar,288,priest,shadow,6,3,3
Resgan,archimonde,288,priest,shadow,6,3,3
Chocopríest,blackmoore,288,priest,shadow,6,3,3
Nødhjelp,kazzak,288,priest,shadow,6,3,3
Copperpriest,draenor,288,priest,shadow,6,3,3
Miikkap,blackhand,288,priest,shadow,6,3,3
Blynde,draenor,288,priest,shadow,6,3,3
Imadîa,dalaran,288,priest,shadow,6,3,3
Ternary,draenor,288,priest,shadow,6,3,3
Neopriest,stormscale,288,priest,shadow,6,3,3
Пристотян,gordunni,288,priest,shadow,6,3,3
Gúinness,pozzo-delleternità,288,priest,shadow,6,3,3
Wkid,draenor,288,priest,shadow,6,3,3
Notra,shattrath,288,priest,shadow,6,3,3
Shannannanna,darkspear,288,priest,shadow,6,3,3
Pries,eitrigg,288,priest,shadow,6,3,3
Grocx,kazzak,288,priest,shadow,6,3,3
Eldrathir,burning-legion,288,priest,shadow,6,3,3
Флэнсер,soulflayer,288,priest,shadow,6,3,3
Vampiro,blackhand,288,priest,shadow,6,3,3
Taklamakan,alakir,288,priest,shadow,6,3,3
Zdpsexde,draenor,288,priest,shadow,6,3,3
Slerpdaddy,ragnaros,288,priest,shadow,6,3,3
Lutzki,the-maelstrom,288,priest,shadow,6,3,3
Ksiadzrydzyk,draenor,288,priest,shadow,6,3,3
Sàyaa,draenor,288,priest,shadow,6,3,3
Aisha,rajaxx,288,priest,shadow,6,3,3
Wåtrux,alakir,288,priest,shadow,6,3,3
Забвениеждёт,gordunni,288,priest,shadow,6,3,3
Buszeekk,outland,288,priest,shadow,6,3,3
Sharmidix,kazzak,288,priest,shadow,6,3,3
Freezydot,silvermoon,288,priest,shadow,6,3,3
Hachiroku,terokkar,288,priest,shadow,6,3,3
Banedps,the-maelstrom,288,priest,shadow,6,3,3
Uivi,azjolnerub,288,priest,shadow,6,3,3
Tropicpriest,tarren-mill,288,priest,shadow,6,3,3
Неприст,ashenvale,288,priest,shadow,6,3,3
Stepsisstuck,ragnaros,288,priest,shadow,6,3,3
Sofuny,neptulon,288,priest,shadow,6,3,3
Abyssonmind,dun-modr,288,priest,shadow,6,3,3
Aéltess,kirin-tor,288,priest,shadow,6,3,3
Vildhjärtat,kazzak,288,priest,shadow,6,3,3
Plagegeist,blutkessel,288,priest,shadow,6,3,3
Róse,anachronos,288,priest,shadow,6,3,3
Cheryl,alleria,288,priest,shadow,6,3,3
Skymning,tarren-mill,288,priest,shadow,6,3,3
Kaius,mannoroth,288,priest,shadow,6,3,3
Cé,magtheridon,288,priest,shadow,6,3,3
Nhajÿ,hyjal,288,priest,shadow,6,3,3
Смегмачет,soulflayer,288,priest,shadow,6,3,3
Trinnity,drakthul,288,priest,shadow,6,3,3
Eyvvah,twisting-nether,288,priest,shadow,6,3,3
Alaarys,hyjal,288,priest,shadow,6,3,3
Дисайплес,gordunni,288,priest,shadow,6,3,3
Presbyter,mazrigos,288,priest,shadow,6,3,3
Følísh,hyjal,288,priest,shadow,6,3,3
Cðsima,blackmoore,288,priest,shadow,6,3,3
Spanpriest,kazzak,288,priest,shadow,6,3,3
Nitza,silvermoon,288,priest,shadow,6,3,3
Matrus,arthas,288,priest,shadow,6,3,3
Úbercharge,kazzak,288,priest,shadow,6,3,3
Nirsis,dun-modr,288,priest,shadow,6,3,3
Leffie,outland,288,priest,shadow,6,3,3
Canthms,twisting-nether,288,priest,shadow,6,3,3
Jilizjiliz,blackmoore,288,priest,shadow,6,3,3
Shasdöw,hyjal,288,priest,shadow,6,3,3
Susaj,tarren-mill,288,priest,shadow,6,3,3
Doctep,sargeras,288,priest,shadow,6,3,3
Worwp,burning-blade,288,priest,shadow,6,3,3
Joë,tarren-mill,288,priest,shadow,6,3,3
Papynou,garona,288,priest,shadow,6,3,3
Wollebimsen,arthas,288,priest,shadow,6,3,3
Smerenia,tarren-mill,288,priest,shadow,6,3,3
Ggsus,outland,288,priest,shadow,6,3,3
Némonix,outland,288,priest,shadow,6,3,3
Goldensp,sanguino,288,priest,shadow,6,3,3
Sweedensp,hyjal,288,priest,shadow,6,3,3
Kbdp,outland,288,priest,shadow,6,3,3
Jarnary,blackmoore,288,priest,shadow,9,4,5
Kopfsache,blackmoore,288,priest,shadow,7,3,4
Paytopray,the-maelstrom,288,priest,shadow,7,3,4
Thundiz,archimonde,288,priest,shadow,7,3,4
Tronixxcs,argent-dawn,288,priest,shadow,9,3,6
Shadowmourn,archimonde,288,priest,shadow,11,3,8
Nathalio,twisting-nether,288,priest,shadow,12,3,9
Priestouchme,blackrock,288,priest,shadow,12,3,9
Painxsup,kazzak,288,priest,shadow,12,3,9
Декомпиляция,blackscar,288,priest,shadow,12,3,9
Elumi,the-maelstrom,288,priest,shadow,12,3,9
Hmp,thrall,288,priest,shadow,12,3,9
Goldische,dun-morogh,288,priest,shadow,12,3,9
Beckett,outland,288,priest,shadow,12,3,9
Anariell,ravencrest,288,priest,shadow,12,3,9
Aaluvor,blackmoore,288,priest,shadow,12,3,9
Kaleshiry,kazzak,288,priest,shadow,12,3,9
Preast,aegwynn,288,priest,shadow,12,3,9
Hâstur,ravencrest,288,priest,shadow,12,3,9
Voluptass,ragnaros,288,priest,shadow,12,3,9
Stolenlight,dun-morogh,288,priest,shadow,12,3,9
Atiyesh,arthas,288,priest,shadow,12,3,9
Vès,stormscale,288,priest,shadow,12,3,9
Binar,baelgun,288,priest,shadow,12,3,9
Øzya,kirin-tor,288,priest,shadow,12,3,9
Iílíth,draenor,288,priest,shadow,12,3,9
Adizeww,kazzak,288,priest,shadow,12,3,9
Purpleshadow,twisting-nether,288,priest,shadow,12,3,9
Iordjahmilli,blackmoore,288,priest,shadow,12,3,9
Sorshan,marécage-de-zangar,288,priest,shadow,12,3,9
Kaenlin,the-maelstrom,288,priest,shadow,18,3,15
Jês,thrall,287,priest,shadow,6,3,3
Sìire,ravencrest,287,priest,shadow,6,3,3
Батзона,eversong,287,priest,shadow,8,3,5
Rulna,die-aldor,287,priest,shadow,12,3,9
Nikomus,argent-dawn,286,priest,shadow,6,3,3
Spookyi,blackrock,271,priest,shadow,17,3,14
Alligatores,kazzak,270,priest,shadow,17,3,14
Czikibriki,ravenholdt,256,priest,shadow,4,4,0
Shadepencoin,silvermoon,256,priest,shadow,10,3,7
Бледноват,ashenvale,255,priest,shadow,8,4,4
Ксержик,gordunni,255,priest,shadow,11,3,8
Пристытутка,gordunni,255,priest,shadow,11,3,8
Syxx,blackmoore,255,priest,shadow,11,3,8
Achesita,sylvanas,240,priest,shadow,9,3,6
Slasherh,ravencrest,239,priest,shadow,5,3,2
Guccimaane,twisting-nether,239,priest,shadow,5,3,2
Thargunitøth,antonidas,239,priest,shadow,5,3,2
Caski,stormreaver,239,priest,shadow,5,3,2
Deeforce,argent-dawn,234,priest,shadow,6,4,2
Ainoa,grim-batol,234,priest,shadow,9,4,5
Cöpahue,sanguino,208,priest,shadow,7,3,4
Shadowflamè,outland,192,priest,shadow,4,3,1
Szycho,burning-legion,192,priest,shadow,9,3,6
Discbabe,outland,192,priest,shadow,6,2,4
Aruna,ravencrest,192,priest,shadow,6,2,4
Eavy,argent-dawn,192,priest,shadow,6,2,4
Funstopshere,ravencrest,192,priest,shadow,6,2,4
Huyasy,argent-dawn,192,priest,shadow,6,2,4
Mugenshotto,outland,192,priest,shadow,6,2,4
Виатрикс,goldrinn,192,priest,shadow,6,2,4
Blesschrist,tarren-mill,192,priest,shadow,6,2,4
Dreadx,antonidas,192,priest,shadow,6,2,4
Æbe,tarren-mill,192,priest,shadow,6,2,4
Lúthien,outland,192,priest,shadow,6,2,4
Докчай,gordunni,192,priest,shadow,6,2,4
Акктуальная,deepholm,192,priest,shadow,6,2,4
Wsp,tarren-mill,192,priest,shadow,6,2,4
Химмеллия,azuregos,192,priest,shadow,6,2,4
Pliagonosic,drakthul,192,priest,shadow,6,2,4
Vengigodxx,ravencrest,192,priest,shadow,6,2,4
Badhêalz,aegwynn,192,priest,shadow,6,2,4
Alpharîus,argent-dawn,192,priest,shadow,6,2,4
Шарадин,gordunni,192,priest,shadow,6,2,4
Fèä,argent-dawn,192,priest,shadow,6,2,4
Сайннз,howling-fjord,192,priest,shadow,6,2,4
Сеферота,howling-fjord,192,priest,shadow,6,2,4
Phobò,antonidas,192,priest,shadow,6,2,4
Piizzdiica,twisting-nether,192,priest,shadow,6,2,4
Unhealing,tarren-mill,192,priest,shadow,6,2,4
Сорвиголов,howling-fjord,192,priest,shadow,6,2,4
Debiloid,ravencrest,192,priest,shadow,6,2,4
Velansera,argent-dawn,192,priest,shadow,6,2,4
Встанислав,gordunni,192,priest,shadow,6,2,4
Artist,outland,192,priest,shadow,6,2,4
Omejan,frostmane,192,priest,shadow,6,2,4
Reïny,tarren-mill,192,priest,shadow,6,2,4
Lollithu,argent-dawn,192,priest,shadow,6,2,4
Шиписс,soulflayer,192,priest,shadow,6,2,4
Dombili,frostmane,192,priest,shadow,6,2,4
Prigart,sylvanas,192,priest,shadow,6,2,4
Sïfën,tarren-mill,192,priest,shadow,6,2,4
Ilvia,antonidas,192,priest,shadow,6,2,4
Âlígés,outland,192,priest,shadow,6,2,4
Stàrlîght,chants-éternels,192,priest,shadow,6,2,4
Ejoz,khaz-modan,192,priest,shadow,6,2,4
Abî,frostwolf,192,priest,shadow,6,2,4
Pwjetlifelol,grim-batol,192,priest,shadow,6,2,4
Nyxoqtxd,ravencrest,192,priest,shadow,6,2,4
Putoeinstein,sylvanas,192,priest,shadow,6,2,4
Storemanager,tarren-mill,192,priest,shadow,6,2,4
Jeanshield,varimathras,192,priest,shadow,6,2,4
Tuljan,twisting-nether,192,priest,shadow,6,2,4
Darendur,die-aldor,192,priest,shadow,6,2,4
Goblingøs,ravencrest,192,priest,shadow,6,2,4
Livster,chamber-of-aspects,192,priest,shadow,6,2,4
Joezero,the-maelstrom,192,priest,shadow,6,2,4
Шестьнадцать,gordunni,192,priest,shadow,6,2,4
Wiglere,argent-dawn,192,priest,shadow,6,2,4
Imahipstaqt,eredar,192,priest,shadow,6,2,4
Elëctra,vashj,192,priest,shadow,6,2,4
Badboypanna,twisting-nether,192,priest,shadow,6,2,4
Ðyøx,ravencrest,192,priest,shadow,6,2,4
Beatrixz,twisting-nether,192,priest,shadow,6,2,4
Аполонио,soulflayer,192,priest,shadow,6,2,4
Calïxløve,der-rat-von-dalaran,192,priest,shadow,6,2,4
Banishee,shadowsong,192,priest,shadow,6,2,4
Дашажмитучу,howling-fjord,192,priest,shadow,6,2,4
Magnusson,the-shatar,192,priest,shadow,6,2,4
Maxý,ravencrest,192,priest,shadow,6,2,4
Холисайра,gordunni,192,priest,shadow,6,2,4
Evillshadow,archimonde,192,priest,shadow,6,2,4
Hadsup,stormscale,192,priest,shadow,6,2,4
Kiralinia,eredar,192,priest,shadow,6,2,4
Nemüs,pozzo-delleternità,192,priest,shadow,6,2,4
Tosspot,ragnaros,192,priest,shadow,6,2,4
Мемфисминни,blackscar,192,priest,shadow,6,2,4
Holycrapx,chromaggus,192,priest,shadow,6,2,4
Периссвет,thermaplugg,192,priest,shadow,6,2,4
Daven,ysondre,192,priest,shadow,6,2,4
Mømmymilkers,archimonde,192,priest,shadow,6,2,4
Voidreaver,stormscale,192,priest,shadow,6,2,4
Жрецдуши,gordunni,192,priest,shadow,6,2,4
Bandgap,antonidas,192,priest,shadow,6,2,4
Yunamd,blackhand,192,priest,shadow,6,2,4
Sadira,malganis,192,priest,shadow,6,2,4
Rustyroll,stormscale,192,priest,shadow,6,2,4
Lythra,burning-legion,192,priest,shadow,6,2,4
Grimor,talnivarr,192,priest,shadow,6,2,4
Zaylem,ravencrest,192,priest,shadow,6,2,4
Clemexyo,stormscale,192,priest,shadow,6,2,4
Zaop,blackhand,192,priest,shadow,6,2,4
Emilie,jaedenar,192,priest,shadow,6,2,4
Azèm,archimonde,192,priest,shadow,6,2,4
Illordz,nemesis,192,priest,shadow,6,2,4
Elthrone,kazzak,192,priest,shadow,6,2,4
Nõlîfer,archimonde,192,priest,shadow,6,2,4
Chabbe,ragnaros,192,priest,shadow,6,2,4
Ørbänvîktôrx,ragnaros,192,priest,shadow,6,2,4
Esthea,malganis,192,priest,shadow,6,2,4
Purplereign,stormscale,192,priest,shadow,6,2,4
Lugburzz,draenor,192,priest,shadow,6,2,4
Rallzken,stormscale,192,priest,shadow,6,2,4
Brin,archimonde,192,priest,shadow,6,2,4
Baaliz,senjin,192,priest,shadow,6,2,4
Ilaènel,burning-legion,192,priest,shadow,6,2,4
Dispelbotx,sylvanas,192,priest,shadow,6,2,4
Holyshiët,sylvanas,192,priest,shadow,6,2,4
Repples,draenor,192,priest,shadow,6,2,4
Sotriggered,sylvanas,192,priest,shadow,6,2,4
Yugata,archimonde,192,priest,shadow,6,2,4
Gidy,blackmoore,192,priest,shadow,6,2,4
Cto,gorgonnash,192,priest,shadow,6,2,4
Jamii,kazzak,192,priest,shadow,6,2,4
Arithon,blackrock,192,priest,shadow,6,2,4
Priath,magtheridon,192,priest,shadow,6,2,4
Crzzy,dun-modr,192,priest,shadow,6,2,4
Fqú,wrathbringer,192,priest,shadow,6,2,4
Cokezeroo,thrall,192,priest,shadow,6,2,4
Badgirxl,kargath,192,priest,shadow,6,2,4
Psychobutter,blackmoore,192,priest,shadow,6,2,4
Chekkó,blackrock,192,priest,shadow,6,2,4
Shalacho,blackrock,192,priest,shadow,6,2,4
Noobpriest,blackrock,192,priest,shadow,6,2,4
Exçi,blackrock,192,priest,shadow,6,2,4
Mayhemqt,silvermoon,192,priest,shadow,6,2,4
Siezlababo,blackrock,192,priest,shadow,6,2,4
Ostrogami,silvermoon,192,priest,shadow,6,2,4
Madclownz,blackrock,192,priest,shadow,6,2,4
Andérsón,magtheridon,192,priest,shadow,6,2,4
Makemyday,dun-modr,192,priest,shadow,6,2,4
Notdespo,kazzak,192,priest,shadow,6,2,4
Smø,kazzak,192,priest,shadow,6,2,4
Nattramnone,blackmoore,192,priest,shadow,6,2,4
Oknelim,blackmoore,192,priest,shadow,6,2,4
Daykenp,kazzak,192,priest,shadow,6,2,4
Gühnikologe,blackmoore,192,priest,shadow,6,2,4
Misántropo,dun-modr,192,priest,shadow,6,2,4
Goky,kazzak,192,priest,shadow,6,2,4
Zootx,magtheridon,192,priest,shadow,6,2,4
Ehresha,kazzak,192,priest,shadow,6,2,4
Гундяй,soulflayer,192,priest,shadow,7,2,5
Sadkitten,sylvanas,192,priest,shadow,7,2,5
Indrades,blackmoore,192,priest,shadow,9,2,7
Бихар,gordunni,192,priest,shadow,10,2,8
Simpsmasher,kazzak,192,priest,shadow,11,2,9
Harmónia,outland,192,priest,shadow,12,2,10
Nefertum,alakir,192,priest,shadow,12,2,10
Awcute,kazzak,192,priest,shadow,12,2,10
Painlêss,eredar,192,priest,shadow,12,2,10
Ajcz,draenor,192,priest,shadow,12,2,10
Obbdasknob,ravencrest,192,priest,shadow,12,2,10
Lemalötz,silvermoon,192,priest,shadow,12,2,10
Господствуй,gordunni,192,priest,shadow,12,2,10
Zilania,ragnaros,192,priest,shadow,12,2,10
Helerys,archimonde,192,priest,shadow,12,2,10
Chibrausorus,archimonde,192,priest,shadow,12,2,10
Hûndling,blackrock,192,priest,shadow,12,2,10
Unworthy,twisting-nether,192,priest,shadow,12,2,10
Noir,nemesis,192,priest,shadow,12,2,10
Marcianoroc,dalaran,192,priest,shadow,12,2,10
Nelpriest,hyjal,192,priest,shadow,12,2,10
Adev,drakthul,192,priest,shadow,12,2,10
Эйттёрналинь,fordragon,192,priest,shadow,12,2,10
Poc,burning-legion,192,priest,shadow,12,2,10
Miniøndëëps,hyjal,192,priest,shadow,12,2,10
Rxwkii,hellscream,192,priest,shadow,18,2,16
Tatewaki,drakthul,191,priest,shadow,4,3,1
Cypherz,kazzak,191,priest,shadow,12,2,10
Luziz,blackmoore,159,priest,shadow,5,2,3
Girlidlion,twisting-nether,159,priest,shadow,5,2,3
Tabítha,blackrock,159,priest,shadow,5,2,3
Holykaka,tarren-mill,159,priest,shadow,5,2,3
Puzzles,laughing-skull,159,priest,shadow,5,2,3
Mephîsto,anubarak,159,priest,shadow,5,2,3
Randdy,silvermoon,159,priest,shadow,11,2,9
Qku,ravencrest,144,priest,shadow,9,3,6
Miivanmii,ragnaros,138,priest,shadow,10,4,6
Slight,aggra-português,138,priest,shadow,10,3,7
Yukíø,antonidas,138,priest,shadow,10,3,7
Alswynn,draenor,138,priest,shadow,13,3,10
Heeyø,drakthul,128,priest,shadow,4,2,2
Onixa,tarren-mill,128,priest,shadow,4,2,2
Yologrumples,tarren-mill,128,priest,shadow,4,2,2
Shalvy,aegwynn,96,priest,shadow,3,2,1
Кошнеок,deathguard,96,priest,shadow,3,2,1
Idén,quelthalas,96,priest,shadow,3,2,1
Vampirski,kazzak,96,priest,shadow,3,2,1
Infâme,culte-de-la-rive-noire,96,priest,shadow,6,1,5
Åme,kirin-tor,96,priest,shadow,6,1,5
Aruman,norgannon,96,priest,shadow,6,1,5
Jimipalais,blackmoore,96,priest,shadow,6,1,5
Dunderprälle,outland,96,priest,shadow,6,1,5
Gobblestick,draenor,96,priest,shadow,6,1,5
Caliadan,kazzak,96,priest,shadow,6,1,5
Prostamolle,conseil-des-ombres,96,priest,shadow,6,1,5
Elfouf,rashgarroth,96,priest,shadow,6,1,5
Ulrach,hyjal,96,priest,shadow,6,1,5
Cthuulu,tarren-mill,96,priest,shadow,6,1,5
Gæxelademad,draenor,96,priest,shadow,6,1,5
Jamioz,draenor,96,priest,shadow,6,1,5
Löô,archimonde,96,priest,shadow,6,1,5
Arliston,draenor,96,priest,shadow,6,1,5
Soulmedic,draenor,96,priest,shadow,6,1,5
Barbïelolz,sargeras,96,priest,shadow,6,1,5
Vexxdd,outland,96,priest,shadow,6,1,5
Moondúst,blackmoore,96,priest,shadow,6,1,5
Rdot,dun-modr,96,priest,shadow,6,1,5
Vtqt,outland,96,priest,shadow,6,1,5
Disturbd,archimonde,96,priest,shadow,6,1,5
Winstõn,sanguino,96,priest,shadow,6,1,5
Gòldfinger,norgannon,96,priest,shadow,6,1,5
Sabakk,archimonde,96,priest,shadow,6,1,5
Gromalia,hyjal,96,priest,shadow,6,1,5
Whitezetsu,outland,96,priest,shadow,6,1,5
Zukatana,tarren-mill,96,priest,shadow,6,1,5
Lurxya,ysondre,96,priest,shadow,6,1,5
Drioz,ysondre,96,priest,shadow,6,1,5
Nitalima,outland,96,priest,shadow,6,1,5
Nestélle,drakthul,96,priest,shadow,6,1,5
Bij,outland,96,priest,shadow,6,1,5
Stola,archimonde,96,priest,shadow,6,1,5
Izarath,outland,96,priest,shadow,6,1,5
Chimara,eredar,96,priest,shadow,6,1,5
Nérôck,frostwolf,96,priest,shadow,6,1,5
Faol,the-venture-co,96,priest,shadow,6,1,5
Fictus,tarren-mill,96,priest,shadow,6,1,5
Learntohealz,outland,96,priest,shadow,6,1,5
Râdouan,archimonde,96,priest,shadow,6,1,5
Higgle,argent-dawn,96,priest,shadow,6,1,5
Fillî,antonidas,96,priest,shadow,6,1,5
Piarir,azjolnerub,96,priest,shadow,6,1,5
Psyfiend,argent-dawn,96,priest,shadow,6,1,5
Haffination,frostmane,96,priest,shadow,6,1,5
Koíré,defias-brotherhood,96,priest,shadow,6,1,5
Evilspook,silvermoon,96,priest,shadow,6,1,5
Kales,grim-batol,96,priest,shadow,6,1,5
Shonsized,argent-dawn,96,priest,shadow,6,1,5
Harrydøtter,ysondre,96,priest,shadow,6,1,5
Serach,ravencrest,96,priest,shadow,6,1,5
Arvia,outland,96,priest,shadow,6,1,5
Baltrom,ravencrest,96,priest,shadow,6,1,5
Aerîs,veknilash,96,priest,shadow,6,1,5
Spárrowhawk,silvermoon,96,priest,shadow,6,1,5
Tinypump,silvermoon,96,priest,shadow,6,1,5
Jäckassmd,ravencrest,96,priest,shadow,6,1,5
Nothanksman,haomarush,96,priest,shadow,6,1,5
Zodos,ravencrest,96,priest,shadow,6,1,5
Valfore,eldrethalas,96,priest,shadow,6,1,5
Milfelina,ravencrest,96,priest,shadow,6,1,5
Dìsc,ravencrest,96,priest,shadow,6,1,5
Holytoad,ravencrest,96,priest,shadow,6,1,5
Míllerzz,ragnaros,96,priest,shadow,6,1,5
Ноубадди,howling-fjord,96,priest,shadow,6,1,5
Splís,ravencrest,96,priest,shadow,6,1,5
Deicidex,blackrock,96,priest,shadow,6,1,5
Gisborn,laughing-skull,96,priest,shadow,6,1,5
Sbubbi,ravencrest,96,priest,shadow,6,1,5
Daphne,thunderhorn,96,priest,shadow,6,1,5
Ghostroller,pozzo-delleternità,96,priest,shadow,6,1,5
Scrotoepalle,nemesis,96,priest,shadow,6,1,5
Nicnacz,stormscale,96,priest,shadow,6,1,5
Aretiel,the-maelstrom,96,priest,shadow,6,1,5
Dörti,rajaxx,96,priest,shadow,6,1,5
Uwucatgir,silvermoon,96,priest,shadow,6,1,5
Zevs,sanguino,96,priest,shadow,6,1,5
Mârcwel,burning-legion,96,priest,shadow,6,1,5
Macroman,stormscale,96,priest,shadow,6,1,5
Kopperuud,stormscale,96,priest,shadow,6,1,5
Corefusion,blackrock,96,priest,shadow,6,1,5
Катранасс,eversong,96,priest,shadow,6,1,5
Noonex,hakkar,96,priest,shadow,6,1,5
Чупатаявошь,soulflayer,96,priest,shadow,6,1,5
Abudhabi,blackhand,96,priest,shadow,6,1,5
Endlin,silvermoon,96,priest,shadow,6,1,5
Maddøc,die-aldor,96,priest,shadow,6,1,5
Фаталих,soulflayer,96,priest,shadow,6,1,5
Абсорбиболь,howling-fjord,96,priest,shadow,6,1,5
Bädx,silvermoon,96,priest,shadow,6,1,5
Мегаствол,howling-fjord,96,priest,shadow,6,1,5
Асуартхас,gordunni,96,priest,shadow,6,1,5
Gríffin,anachronos,96,priest,shadow,6,1,5
Jakepriest,twisting-nether,96,priest,shadow,6,1,5
Virulence,twisting-nether,96,priest,shadow,6,1,5
Шатолюгран,soulflayer,96,priest,shadow,6,1,5
Kianprie,silvermoon,96,priest,shadow,6,1,5
Gobie,sunstrider,96,priest,shadow,6,1,5
Skitcy,ghostlands,96,priest,shadow,6,1,5
Oktavian,ysera,96,priest,shadow,6,1,5
Øbz,sylvanas,96,priest,shadow,6,1,5
Kasáya,thrall,96,priest,shadow,6,1,5
Попячебрило,gordunni,96,priest,shadow,6,1,5
Keo,anachronos,96,priest,shadow,6,1,5
Chê,sanguino,96,priest,shadow,6,1,5
Popelings,twisting-nether,96,priest,shadow,6,1,5
Rines,thrall,96,priest,shadow,6,1,5
Darknun,aggra-português,96,priest,shadow,12,1,11
Darkspeech,arygos,96,priest,shadow,12,1,11
Råin,draenor,96,priest,shadow,12,1,11
Dispellmg,ravencrest,96,priest,shadow,12,1,11
Healshurts,kazzak,96,priest,shadow,12,1,11
Jannire,dun-modr,96,priest,shadow,12,1,11
Câtryona,sylvanas,96,priest,shadow,12,1,11
Tiras,argent-dawn,96,priest,shadow,12,1,11
Kde,burning-legion,96,priest,shadow,12,1,11
Néfarius,forscherliga,95,priest,shadow,3,2,1
Malorbian,blackhand,79,priest,shadow,5,1,4
Peesussy,kazzak,79,priest,shadow,5,1,4
Gandals,shadowsong,64,priest,shadow,4,1,3
Xharyo,ravencrest,64,priest,shadow,4,1,3
Bellumsana,frostmane,64,priest,shadow,10,1,9
Benighted,nerathor,48,priest,shadow,3,1,2
Møldark,silvermoon,48,priest,shadow,3,1,2
Xail,blackrock,48,priest,shadow,3,1,2
Amáni,die-aldor,42,priest,shadow,6,2,4
Zikár,kazzak,42,priest,shadow,10,3,7
Psyp,kazzak,42,priest,shadow,8,2,6
Yshaarjy,silvermoon,42,priest,shadow,8,2,6
Dvy,azjolnerub,42,priest,shadow,9,2,7
Hayvo,blackmoore,42,priest,shadow,11,2,9
Lexartin,argent-dawn,31,priest,shadow,2,1,1
Holyhigh,baelgun,31,priest,shadow,2,1,1
Jimcarre,eredar,16,priest,shadow,1,1,0
Goldenmuda,stormscale,16,priest,shadow,1,1,0
Bloodanglee,outland,16,priest,shadow,1,1,0
Mjuk,tarren-mill,16,priest,shadow,1,1,0
Rãz,stormscale,2303,rogue,outlaw,132,71,61
Sneakysteve,bloodfeather,1949,rogue,outlaw,42,22,20
Kreayx,ysondre,1929,rogue,outlaw,108,51,57
Kreay,ysondre,1921,rogue,outlaw,66,35,31
Krixor,ravencrest,1850,rogue,outlaw,223,110,113
Kreay,tarren-mill,1838,rogue,outlaw,178,108,70
Zbojník,ravencrest,1837,rogue,outlaw,72,32,40
Макевин,gordunni,1832,rogue,outlaw,144,70,74
Dêlaral,der-rat-von-dalaran,1814,rogue,outlaw,52,31,21
Drdaggerstwo,outland,1802,rogue,outlaw,44,26,18
Rivso,auchindoun,1784,rogue,outlaw,76,29,47
Kekuriix,vashj,1744,rogue,outlaw,154,77,77
Déjávu,ravencrest,1732,rogue,outlaw,60,32,28
Yessa,argent-dawn,1721,rogue,outlaw,36,18,18
Banaulikode,twisting-nether,1715,rogue,outlaw,66,34,32
Rogiko,twisting-nether,1715,rogue,outlaw,54,26,28
Дизелюжн,howling-fjord,1693,rogue,outlaw,527,260,267
Koopa,argent-dawn,1668,rogue,outlaw,140,69,71
Феинт,galakrond,1654,rogue,outlaw,70,26,44
Gerzy,drakthul,1632,rogue,outlaw,41,21,20
Spiike,culte-de-la-rive-noire,1625,rogue,outlaw,28,19,9
Radiogodx,stormscale,1622,rogue,outlaw,219,106,113
Lidiaubaro,ravencrest,1614,rogue,outlaw,404,202,202
Jalsket,tarren-mill,1606,rogue,outlaw,54,27,27
Ålûñàhlulz,kilrogg,1604,rogue,outlaw,48,30,18
Izzmonab,blackmoore,1604,rogue,outlaw,36,21,15
Estriil,dalaran,1603,rogue,outlaw,42,24,18
Delrøq,draenor,1601,rogue,outlaw,172,94,78
Alizwood,aegwynn,1597,rogue,outlaw,60,34,26
Фораст,gordunni,1596,rogue,outlaw,42,21,21
Syrn,ravencrest,1579,rogue,outlaw,78,38,40
Terya,ragnaros,1575,rogue,outlaw,122,59,63
Scotlander,argent-dawn,1569,rogue,outlaw,72,38,34
Ранконх,lich-king,1566,rogue,outlaw,95,40,55
Bannedfrigid,outland,1528,rogue,outlaw,141,64,77
Зувер,blackscar,1523,rogue,outlaw,160,85,75
Flogue,area-52,1512,rogue,outlaw,36,19,17
Metabender,blackmoore,1507,rogue,outlaw,36,23,13
Åråmsëß,grim-batol,1487,rogue,outlaw,87,51,36
Nèwt,aggramar,1481,rogue,outlaw,190,95,95
Deevoll,tarren-mill,1481,rogue,outlaw,102,45,57
Shinõbikék,outland,1478,rogue,outlaw,51,24,27
Sigleif,argent-dawn,1471,rogue,outlaw,111,57,54
Rogass,auchindoun,1471,rogue,outlaw,66,29,37
Джулт,soulflayer,1448,rogue,outlaw,120,56,64
Loubina,silvermoon,1446,rogue,outlaw,36,16,20
Xsanji,kazzak,1433,rogue,outlaw,48,22,26
Röguetönerö,dun-modr,1429,rogue,outlaw,77,28,49
Carvyn,defias-brotherhood,1425,rogue,outlaw,153,80,73
Arathir,ravencrest,1422,rogue,outlaw,62,29,33
Cipusan,kazzak,1416,rogue,outlaw,42,24,18
Johnnyblazex,azjolnerub,1413,rogue,outlaw,36,16,20
Veil,ravencrest,1405,rogue,outlaw,133,69,64
Chillo,ravencrest,1396,rogue,outlaw,101,45,56
Louisv,ravencrest,1383,rogue,outlaw,164,93,71
Akirã,blackmoore,1379,rogue,outlaw,76,33,43
Aurellix,argent-dawn,1371,rogue,outlaw,30,16,14
Bonelesschic,silvermoon,1357,rogue,outlaw,321,163,158
Zerocell,kazzak,1354,rogue,outlaw,33,16,17
Kirby,kaelthas,1351,rogue,outlaw,90,42,48
Ðaegr,ravencrest,1348,rogue,outlaw,104,55,49
Pistolpete,grim-batol,1343,rogue,outlaw,30,14,16
Callmerose,ravencrest,1334,rogue,outlaw,24,14,10
Dritzdourden,dun-modr,1333,rogue,outlaw,30,15,15
Zep,auchindoun,1332,rogue,outlaw,24,14,10
Murkyy,gilneas,1329,rogue,outlaw,32,16,16
Shredfngrz,garona,1326,rogue,outlaw,97,44,53
Djeud,archimonde,1325,rogue,outlaw,64,34,30
Tidløs,dun-morogh,1325,rogue,outlaw,77,33,44
Miiløx,silvermoon,1319,rogue,outlaw,30,14,16
Villainx,blackrock,1313,rogue,outlaw,30,14,16
Mol,defias-brotherhood,1311,rogue,outlaw,24,15,9
Faoil,defias-brotherhood,1311,rogue,outlaw,60,28,32
Маллестар,ashenvale,1292,rogue,outlaw,97,50,47
Pasarelo,dun-modr,1291,rogue,outlaw,83,39,44
Örog,hyjal,1288,rogue,outlaw,47,26,21
Rasponi,ragnaros,1279,rogue,outlaw,100,53,47
Jasolo,silvermoon,1269,rogue,outlaw,408,212,196
Vinziboo,hyjal,1264,rogue,outlaw,62,31,31
Dimmu,haomarush,1260,rogue,outlaw,147,71,76
Badabôôm,wrathbringer,1257,rogue,outlaw,116,57,59
Mawrat,mazrigos,1248,rogue,outlaw,30,13,17
Weworog,drakthul,1229,rogue,outlaw,101,56,45
Alena,arathi,1226,rogue,outlaw,54,32,22
Omgjkgtfo,ravencrest,1225,rogue,outlaw,60,25,35
Sqz,archimonde,1222,rogue,outlaw,30,18,12
Zapunk,argent-dawn,1221,rogue,outlaw,59,22,37
Шторкаа,gordunni,1216,rogue,outlaw,45,25,20
Jinzou,blackmoore,1214,rogue,outlaw,75,39,36
Tîru,ravencrest,1209,rogue,outlaw,42,25,17
Mirajen,archimonde,1201,rogue,outlaw,61,29,32
Odingg,dun-modr,1194,rogue,outlaw,36,17,19
Velvíe,turalyon,1175,rogue,outlaw,36,19,17
Nocrath,blades-edge,1175,rogue,outlaw,66,33,33
Kussiee,chromaggus,1165,rogue,outlaw,59,26,33
Drunks,aegwynn,1145,rogue,outlaw,50,20,30
Thyrosi,shattered-halls,1133,rogue,outlaw,24,12,12
Pidroseus,argent-dawn,1133,rogue,outlaw,30,13,17
Aldorick,kirin-tor,1114,rogue,outlaw,36,17,19
Génn,silvermoon,1066,rogue,outlaw,86,42,44
Lättja,hyjal,1060,rogue,outlaw,41,19,22
Alatheril,argent-dawn,1060,rogue,outlaw,89,40,49
Mycki,voljin,1055,rogue,outlaw,44,17,27
Тимареканец,eversong,1048,rogue,outlaw,84,38,46
Bxtchslayer,blackmoore,1045,rogue,outlaw,71,39,32
Rã,archimonde,1039,rogue,outlaw,30,13,17
Svddendeath,ragnaros,1034,rogue,outlaw,24,11,13
Oriaxx,ragnaros,1024,rogue,outlaw,33,15,18
Spiochrr,burning-legion,1020,rogue,outlaw,84,35,49
Оа,soulflayer,1017,rogue,outlaw,42,11,31
Haewhi,kazzak,1007,rogue,outlaw,54,20,34
Zind,dalaran,1000,rogue,outlaw,23,11,12
Neolamer,pozzo-delleternità,994,rogue,outlaw,168,81,87
Melahl,kazzak,967,rogue,outlaw,89,47,42
Soothinqq,emerald-dream,963,rogue,outlaw,23,15,8
Lïke,frostwolf,960,rogue,outlaw,18,10,8
Foulsteel,stormscale,951,rogue,outlaw,18,10,8
Cigarette,emeriss,950,rogue,outlaw,18,10,8
Riviele,argent-dawn,913,rogue,outlaw,20,11,9
Masteez,ahnqiraj,897,rogue,outlaw,135,68,67
Tipok,tarren-mill,897,rogue,outlaw,51,20,31
Donchichi,archimonde,894,rogue,outlaw,20,10,10
Yoghurtx,ravencrest,863,rogue,outlaw,12,9,3
Backstabjr,blackmoore,863,rogue,outlaw,18,9,9
Practicex,blackhand,863,rogue,outlaw,18,9,9
Knifeyknifey,ravencrest,862,rogue,outlaw,18,9,9
Nasíapamatar,colinas-pardas,862,rogue,outlaw,42,12,30
Пондимониум,azuregos,860,rogue,outlaw,24,9,15
Жижель,howling-fjord,859,rogue,outlaw,18,9,9
Слишкомданя,galakrond,854,rogue,outlaw,24,9,15
Yoruichì,kazzak,853,rogue,outlaw,18,9,9
Cornvus,burning-legion,836,rogue,outlaw,48,22,26
Mcgora,doomhammer,822,rogue,outlaw,36,15,21
Kedrus,turalyon,812,rogue,outlaw,24,10,14
Omuspan,magtheridon,803,rogue,outlaw,87,36,51
Фофламидзе,gordunni,802,rogue,outlaw,21,10,11
Aaronblade,aggra-português,795,rogue,outlaw,30,12,18
Blàckbèàrd,silvermoon,788,rogue,outlaw,42,17,25
Bikrut,hyjal,768,rogue,outlaw,12,8,4
Redfinshadow,stormrage,768,rogue,outlaw,35,16,19
Vokhun,outland,768,rogue,outlaw,18,8,10
Swaeard,ravencrest,767,rogue,outlaw,18,8,10
Wxlf,ravencrest,767,rogue,outlaw,18,8,10
Gotfrey,darkspear,762,rogue,outlaw,18,8,10
Okani,hyjal,761,rogue,outlaw,18,8,10
Dredge,kaelthas,761,rogue,outlaw,24,8,16
Hânnäh,hyjal,756,rogue,outlaw,48,20,28
Shichi,archimonde,751,rogue,outlaw,23,8,15
Хасби,grom,748,rogue,outlaw,32,10,22
Viligar,kazzak,687,rogue,outlaw,21,8,13
Shåggy,vashj,672,rogue,outlaw,12,7,5
Dían,ravencrest,672,rogue,outlaw,12,7,5
Kidneyou,ragnaros,672,rogue,outlaw,18,7,11
Matheeus,hyjal,672,rogue,outlaw,24,8,16
Trixnaz,silvermoon,671,rogue,outlaw,18,7,11
Afareo,ragnaros,671,rogue,outlaw,18,7,11
Skygann,burning-legion,670,rogue,outlaw,12,7,5
Kodlak,silvermoon,669,rogue,outlaw,12,7,5
Enthuque,draenor,668,rogue,outlaw,12,7,5
Ilovearena,eredar,668,rogue,outlaw,24,7,17
Shåð,zuljin,576,rogue,outlaw,12,6,6
Ðeathdream,stormscale,576,rogue,outlaw,12,6,6
Noodlegoose,tarren-mill,575,rogue,outlaw,12,6,6
Anom,kargath,575,rogue,outlaw,12,6,6
Ружнуар,gordunni,575,rogue,outlaw,18,6,12
Кингксу,gordunni,575,rogue,outlaw,24,6,18
Necrott,blackhand,572,rogue,outlaw,24,6,18
Helax,turalyon,569,rogue,outlaw,24,6,18
Shirasz,silvermoon,557,rogue,outlaw,18,6,12
Biefstuk,burning-blade,556,rogue,outlaw,30,6,24
Gloomykenny,tarren-mill,543,rogue,outlaw,17,6,11
Геопанк,howling-fjord,528,rogue,outlaw,15,7,8
Barisso,burning-legion,511,rogue,outlaw,14,6,8
Zômbiê,blackrock,491,rogue,outlaw,13,6,7
Tåxic,sylvanas,480,rogue,outlaw,6,5,1
Акаарикс,gordunni,480,rogue,outlaw,6,5,1
Featfawkes,ragnaros,480,rogue,outlaw,12,5,7
Хайденстрайк,gordunni,480,rogue,outlaw,12,5,7
Fivepoint,blackmoore,480,rogue,outlaw,12,5,7
Cox,nagrand,480,rogue,outlaw,12,5,7
Therazer,burning-legion,480,rogue,outlaw,12,5,7
Ладжо,gordunni,480,rogue,outlaw,18,5,13
Coolbassoff,kazzak,480,rogue,outlaw,18,5,13
Vyze,blackmoore,480,rogue,outlaw,18,5,13
Xaen,hellscream,480,rogue,outlaw,18,5,13
Toxîne,archimonde,479,rogue,outlaw,12,5,7
Rujo,magtheridon,479,rogue,outlaw,12,5,7
Djsapblindx,archimonde,479,rogue,outlaw,18,5,13
Hosenpinkler,lordaeron,478,rogue,outlaw,12,5,7
Wøølfgang,archimonde,477,rogue,outlaw,12,5,7
Feucht,argent-dawn,472,rogue,outlaw,36,5,31
Nhea,twisting-nether,447,rogue,outlaw,14,6,8
Razaah,ravencrest,431,rogue,outlaw,11,5,6
Tommywright,stormscale,384,rogue,outlaw,6,4,2
Darkchomeur,archimonde,384,rogue,outlaw,6,4,2
Аквик,howling-fjord,384,rogue,outlaw,6,4,2
Yoyoei,blackmoore,384,rogue,outlaw,6,4,2
Purpleskies,hyjal,384,rogue,outlaw,6,4,2
Clavikule,elune,384,rogue,outlaw,6,4,2
Synexo,sylvanas,384,rogue,outlaw,12,4,8
Кортикос,gordunni,384,rogue,outlaw,12,4,8
Machmacan,thrall,384,rogue,outlaw,12,4,8
Anokir,sylvanas,384,rogue,outlaw,18,4,14
Slaach,khaz-modan,384,rogue,outlaw,18,4,14
Minimælk,saurfang,383,rogue,outlaw,6,4,2
Mïta,blackmoore,383,rogue,outlaw,6,4,2
Джоллиан,gordunni,383,rogue,outlaw,8,4,4
Groendienst,quelthalas,381,rogue,outlaw,12,4,8
Azzerue,ysondre,367,rogue,outlaw,17,4,13
Trímønâ,gorgonnash,351,rogue,outlaw,11,4,7
Skeevy,stormscale,351,rogue,outlaw,20,5,15
Zyreanxy,blackrock,330,rogue,outlaw,16,5,11
Evit,frostwolf,330,rogue,outlaw,17,5,12
Афтикс,howling-fjord,319,rogue,outlaw,5,4,1
Rouge,der-rat-von-dalaran,288,rogue,outlaw,6,3,3
Coldsummer,drakthul,288,rogue,outlaw,6,3,3
Ékhö,argent-dawn,288,rogue,outlaw,6,3,3
Shadxwstep,ravencrest,288,rogue,outlaw,6,3,3
Onlyluvhurt,dun-modr,288,rogue,outlaw,6,3,3
Играючестно,howling-fjord,288,rogue,outlaw,6,3,3
Роророл,gordunni,288,rogue,outlaw,6,3,3
Kuribo,gorgonnash,288,rogue,outlaw,6,3,3
Cobaka,blackrock,288,rogue,outlaw,12,3,9
Daraco,hyjal,288,rogue,outlaw,12,3,9
Heulleise,die-ewige-wacht,288,rogue,outlaw,12,3,9
Marrit,die-aldor,288,rogue,outlaw,12,3,9
Finisher,sanguino,288,rogue,outlaw,12,3,9
Szpachela,burning-legion,288,rogue,outlaw,12,3,9
Ванэйти,gordunni,287,rogue,outlaw,6,3,3
Golixledur,archimonde,287,rogue,outlaw,12,3,9
Blackmetall,aegwynn,286,rogue,outlaw,12,3,9
Ceule,sanguino,255,rogue,outlaw,11,3,8
Сереф,gordunni,239,rogue,outlaw,11,3,8
Cardsharkjoe,argent-dawn,223,rogue,outlaw,14,3,11
Cheapshotwin,nethersturm,192,rogue,outlaw,6,2,4
Tômmixi,dragonmaw,192,rogue,outlaw,6,2,4
Rotbite,defias-brotherhood,192,rogue,outlaw,6,2,4
Rashaz,blackhand,192,rogue,outlaw,6,2,4
Invisage,grim-batol,192,rogue,outlaw,6,2,4
Оргельна,gordunni,192,rogue,outlaw,6,2,4
Salakelmi,sylvanas,192,rogue,outlaw,6,2,4
Dawnsaber,argent-dawn,192,rogue,outlaw,6,2,4
Израф,lich-king,192,rogue,outlaw,6,2,4
Nyxal,argent-dawn,192,rogue,outlaw,6,2,4
Zyhmø,archimonde,192,rogue,outlaw,6,2,4
Paralisis,zuljin,192,rogue,outlaw,6,2,4
Stunlock,silvermoon,192,rogue,outlaw,6,2,4
Zlash,doomhammer,192,rogue,outlaw,6,2,4
Nomota,sanguino,192,rogue,outlaw,6,2,4
Berneo,burning-legion,192,rogue,outlaw,6,2,4
Djjake,outland,192,rogue,outlaw,6,2,4
Snøv,outland,192,rogue,outlaw,6,2,4
Lefthook,argent-dawn,192,rogue,outlaw,6,2,4
Angelbeats,outland,192,rogue,outlaw,6,2,4
Alvoriace,hyjal,192,rogue,outlaw,12,2,10
Daelilthron,blackmoore,192,rogue,outlaw,12,2,10
Stabkanta,antonidas,192,rogue,outlaw,12,2,10
Elydriel,khaz-modan,192,rogue,outlaw,12,2,10
Kassondra,ragnaros,192,rogue,outlaw,12,2,10
Kausa,dun-modr,191,rogue,outlaw,6,2,4
Valtesse,medivh,159,rogue,outlaw,5,2,3
Piperx,ravencrest,159,rogue,outlaw,11,2,9
Crípplé,ravencrest,128,rogue,outlaw,4,2,2
Ñøway,archimonde,96,rogue,outlaw,3,2,1
Аутянин,soulflayer,96,rogue,outlaw,6,1,5
Døgrogue,outland,96,rogue,outlaw,6,1,5
Stepx,uldaman,96,rogue,outlaw,6,1,5
Ciaordel,sylvanas,96,rogue,outlaw,6,1,5
Akira,outland,96,rogue,outlaw,6,1,5
Yüm,burning-blade,96,rogue,outlaw,6,1,5
Sty,aerie-peak,96,rogue,outlaw,6,1,5
Ninjaops,ravencrest,96,rogue,outlaw,6,1,5
Sneekster,ravencrest,96,rogue,outlaw,6,1,5
Ótsutsukí,kazzak,96,rogue,outlaw,6,1,5
Леронда,deepholm,96,rogue,outlaw,6,1,5
Øníxßtw,eitrigg,96,rogue,outlaw,6,1,5
Natillaa,dun-modr,96,rogue,outlaw,6,1,5
Mallaurya,dalaran,96,rogue,outlaw,6,1,5
Goodwin,sanguino,96,rogue,outlaw,7,1,6
Vaze,ravencrest,96,rogue,outlaw,12,1,11
Jester,bladefist,96,rogue,outlaw,12,1,11
Tiltman,dun-morogh,79,rogue,outlaw,5,1,4
Maieva,frostmane,64,rogue,outlaw,4,1,3
Nabatean,magtheridon,48,rogue,outlaw,3,1,2
Getbleeded,stormscale,31,rogue,outlaw,2,1,1
Rãz,stormscale,2428,rogue,subtlety,135,84,51
Howton,archimonde,2424,rogue,subtlety,86,57,29
Lollelt,ravencrest,2415,rogue,subtlety,158,106,52
Ncroxd,ravencrest,2410,rogue,subtlety,120,84,36
Pridå,thrall,2380,rogue,subtlety,126,73,53
Aythusha,twisting-nether,2373,rogue,subtlety,342,184,158
Shoxy,ravencrest,2361,rogue,subtlety,106,63,43
Ewynarog,silvermoon,2348,rogue,subtlety,101,57,44
Nàsklolz,hyjal,2325,rogue,subtlety,236,128,108
Ncrø,aszune,2290,rogue,subtlety,211,119,92
Asumah,ravencrest,2270,rogue,subtlety,174,100,74
Whaazlysnipz,tarren-mill,2261,rogue,subtlety,60,40,20
Smøkyyx,eredar,2238,rogue,subtlety,201,107,94
Naláa,ravencrest,2232,rogue,subtlety,230,123,107
Sunø,archimonde,2221,rogue,subtlety,270,139,131
Pridå,ravencrest,2219,rogue,subtlety,136,71,65
Sapécomejaja,archimonde,2218,rogue,subtlety,62,41,21
Loznah,outland,2209,rogue,subtlety,96,52,44
Cazzette,ravencrest,2204,rogue,subtlety,81,48,33
Vulkos,lightbringer,2195,rogue,subtlety,153,82,71
Nasklagattv,hyjal,2193,rogue,subtlety,114,57,57
Troxerboxer,tarren-mill,2165,rogue,subtlety,78,43,35
Xzr,stormscale,2155,rogue,subtlety,160,105,55
Tracersxrude,ravencrest,2153,rogue,subtlety,344,176,168
Brensø,nemesis,2152,rogue,subtlety,201,122,79
Chatdisabled,drakthul,2151,rogue,subtlety,345,181,164
Keeke,outland,2137,rogue,subtlety,70,50,20
Nothingleft,draenor,2137,rogue,subtlety,197,111,86
Critmakër,outland,2135,rogue,subtlety,160,93,67
Zuqzwang,outland,2132,rogue,subtlety,84,51,33
Axelaz,ravencrest,2131,rogue,subtlety,66,42,24
Лолелт,borean-tundra,2131,rogue,subtlety,104,53,51
Çvß,kazzak,2130,rogue,subtlety,107,57,50
Elnyasha,ravencrest,2129,rogue,subtlety,87,46,41
Wítchblades,ravencrest,2127,rogue,subtlety,48,41,7
Пожилойпупь,gordunni,2126,rogue,subtlety,77,48,29
Máül,ravencrest,2122,rogue,subtlety,85,47,38
Lkzx,archimonde,2121,rogue,subtlety,323,163,160
Magepèt,tarren-mill,2118,rogue,subtlety,184,106,78
Baboonx,burning-legion,2118,rogue,subtlety,204,115,89
Naiikaii,antonidas,2117,rogue,subtlety,89,50,39
Lfgenjoyer,tarren-mill,2114,rogue,subtlety,126,77,49
Социалистсс,gordunni,2114,rogue,subtlety,145,84,61
Xìaó,kazzak,2110,rogue,subtlety,106,67,39
Pulvèr,dalaran,2109,rogue,subtlety,138,74,64
Iqws,ravencrest,2108,rogue,subtlety,114,64,50
Denjinx,culte-de-la-rive-noire,2107,rogue,subtlety,78,43,35
Løre,blackrock,2105,rogue,subtlety,138,72,66
Rímen,archimonde,2101,rogue,subtlety,95,48,47
Эмилилавс,galakrond,2100,rogue,subtlety,224,131,93
Babøønx,burning-legion,2100,rogue,subtlety,96,54,42
Смертьвсмоке,gordunni,2094,rogue,subtlety,401,204,197
Stealthi,stormscale,2093,rogue,subtlety,107,53,54
Sátyrícon,ravencrest,2083,rogue,subtlety,84,47,37
Plebxar,arathor,2081,rogue,subtlety,125,67,58
Asm,the-maelstrom,2080,rogue,subtlety,166,84,82
Лолелт,howling-fjord,2074,rogue,subtlety,89,51,38
Physic,silvermoon,2053,rogue,subtlety,145,81,64
Chatbann,blackrock,2047,rogue,subtlety,399,215,184
Anr,burning-legion,2044,rogue,subtlety,184,108,76
Làekz,archimonde,2043,rogue,subtlety,87,42,45
Xiro,dalaran,2041,rogue,subtlety,172,91,81
Rinj,antonidas,2040,rogue,subtlety,262,141,121
Änanké,outland,2032,rogue,subtlety,136,69,67
Badmy,stormscale,2030,rogue,subtlety,66,34,32
Xyúmopjoßblú,ravencrest,2021,rogue,subtlety,78,40,38
Nahj,ravencrest,2012,rogue,subtlety,60,38,22
Terrorman,ravencrest,1988,rogue,subtlety,72,42,30
Lilbubblegum,emerald-dream,1986,rogue,subtlety,179,92,87
Plsðõntcry,ravencrest,1983,rogue,subtlety,355,194,161
Clawdíte,blackrock,1980,rogue,subtlety,114,57,57
Brunhityx,ravencrest,1973,rogue,subtlety,44,29,15
Иждолк,gordunni,1970,rogue,subtlety,289,155,134
Supremacy,sylvanas,1969,rogue,subtlety,141,82,59
Флексити,soulflayer,1968,rogue,subtlety,150,78,72
Lówskill,outland,1967,rogue,subtlety,259,137,122
Престиж,greymane,1966,rogue,subtlety,54,29,25
Guççí,blackrock,1960,rogue,subtlety,167,90,77
Denjastwo,archimonde,1956,rogue,subtlety,54,34,20
Máuul,ravencrest,1956,rogue,subtlety,78,36,42
Dødgez,cthun,1953,rogue,subtlety,100,61,39
Vensq,drakthul,1950,rogue,subtlety,137,71,66
Phøñkðånçér,ravencrest,1948,rogue,subtlety,76,37,39
Såj,tarren-mill,1946,rogue,subtlety,54,29,25
Rnghero,blackmoore,1935,rogue,subtlety,60,25,35
Çhimaev,ravencrest,1934,rogue,subtlety,46,29,17
Kallelelel,tarren-mill,1933,rogue,subtlety,42,26,16
Ålleyézonme,ravencrest,1930,rogue,subtlety,570,285,285
Traickorogue,antonidas,1925,rogue,subtlety,29,21,8
Deevoll,tarren-mill,1924,rogue,subtlety,249,139,110
Drydamage,kazzak,1920,rogue,subtlety,167,86,81
Nøctürnë,archimonde,1919,rogue,subtlety,48,32,16
Dfagódx,outland,1918,rogue,subtlety,231,128,103
Shadezlöl,ravencrest,1916,rogue,subtlety,310,158,152
Byebyé,ravencrest,1911,rogue,subtlety,192,104,88
Knoffchad,blackhand,1908,rogue,subtlety,271,147,124
Çåñçér,sylvanas,1907,rogue,subtlety,114,56,58
Unìque,sylvanas,1905,rogue,subtlety,131,69,62
Waluuz,silvermoon,1903,rogue,subtlety,103,52,51
Лайнэл,deathweaver,1898,rogue,subtlety,138,79,59
Dêlaral,blackhand,1896,rogue,subtlety,96,47,49
Meowkek,kazzak,1895,rogue,subtlety,551,280,271
Тохуо,lich-king,1894,rogue,subtlety,60,32,28
Moroz,ravencrest,1893,rogue,subtlety,212,112,100
Illmatíc,ravencrest,1892,rogue,subtlety,62,32,30
Rmp,khaz-modan,1888,rogue,subtlety,102,49,53
Subzerõ,archimonde,1885,rogue,subtlety,594,291,303
Røper,blackmoore,1882,rogue,subtlety,60,28,32
Rylie,garona,1879,rogue,subtlety,188,100,88
Whøråcle,tarren-mill,1878,rogue,subtlety,255,132,123
Amén,sanguino,1876,rogue,subtlety,102,49,53
Getschwîfty,ravencrest,1875,rogue,subtlety,110,65,45
Párbajkároj,ragnaros,1875,rogue,subtlety,71,33,38
Famous,blackhand,1871,rogue,subtlety,60,34,26
Radiogodx,stormscale,1866,rogue,subtlety,142,73,69
Sábros,ravencrest,1863,rogue,subtlety,204,104,100
Sunøbrain,archimonde,1861,rogue,subtlety,58,31,27
Liquidité,azuremyst,1860,rogue,subtlety,236,128,108
Погибайдуде,gordunni,1857,rogue,subtlety,47,38,9
Gløøm,ravencrest,1857,rogue,subtlety,80,40,40
Abej,malygos,1856,rogue,subtlety,66,33,33
Denjas,archimonde,1855,rogue,subtlety,67,34,33
Âkame,argent-dawn,1853,rogue,subtlety,59,32,27
Мейсадисс,gordunni,1853,rogue,subtlety,72,33,39
Buffassa,ravencrest,1852,rogue,subtlety,108,61,47
Teskes,tyrande,1851,rogue,subtlety,132,73,59
Zîky,dun-modr,1850,rogue,subtlety,100,69,31
Нойсеен,gordunni,1849,rogue,subtlety,54,32,22
Rindar,dun-modr,1849,rogue,subtlety,465,245,220
Kénzos,silvermoon,1849,rogue,subtlety,87,41,46
Leanadle,hyjal,1848,rogue,subtlety,70,44,26
Морхалл,gordunni,1848,rogue,subtlety,132,74,58
Sodarogue,blackrock,1847,rogue,subtlety,68,38,30
Zerotyluv,silvermoon,1846,rogue,subtlety,48,34,14
Kickcake,ravencrest,1846,rogue,subtlety,156,88,68
Slapshot,das-konsortium,1845,rogue,subtlety,54,28,26
Dagyhy,the-maelstrom,1843,rogue,subtlety,60,29,31
Xdd,frostmane,1842,rogue,subtlety,103,55,48
Thirdrogue,blackhand,1841,rogue,subtlety,96,61,35
Krida,archimonde,1841,rogue,subtlety,102,54,48
Lilaven,turalyon,1841,rogue,subtlety,156,80,76
Deadraw,aegwynn,1840,rogue,subtlety,84,45,39
Susquehanna,ragnaros,1838,rogue,subtlety,198,107,91
Avidance,wrathbringer,1837,rogue,subtlety,42,23,19
Ладжо,gordunni,1837,rogue,subtlety,216,109,107
Dàgé,twisting-nether,1836,rogue,subtlety,178,106,72
Dêlaral,der-mithrilorden,1835,rogue,subtlety,120,60,60
Fîññ,ravencrest,1835,rogue,subtlety,132,64,68
Oczku,burning-legion,1833,rogue,subtlety,54,31,23
Xoxoxoxoxoxö,archimonde,1832,rogue,subtlety,94,52,42
Cheapshotwin,nethersturm,1831,rogue,subtlety,88,50,38
Shuo,blackrock,1830,rogue,subtlety,143,86,57
Knutten,wildhammer,1830,rogue,subtlety,153,88,65
Bahi,ysondre,1830,rogue,subtlety,264,138,126
Bleakhøuse,ravencrest,1829,rogue,subtlety,58,29,29
Izzyb,auchindoun,1828,rogue,subtlety,76,44,32
Lízåriñ,ravencrest,1827,rogue,subtlety,48,38,10
Locgog,argent-dawn,1827,rogue,subtlety,138,79,59
Slimshadyqt,terokkar,1825,rogue,subtlety,95,55,40
Exiv,ragnaros,1825,rogue,subtlety,140,73,67
Roguanal,hyjal,1825,rogue,subtlety,58,30,28
Chizué,sylvanas,1824,rogue,subtlety,54,34,20
Makethemrog,archimonde,1824,rogue,subtlety,304,144,160
Mortecieca,ravencrest,1824,rogue,subtlety,60,27,33
Fatnutsac,eredar,1823,rogue,subtlety,48,29,19
Asterisyup,silvermoon,1823,rogue,subtlety,119,67,52
Scørp,ravencrest,1823,rogue,subtlety,64,35,29
Cortzy,stormscale,1823,rogue,subtlety,120,60,60
Noraex,silvermoon,1822,rogue,subtlety,81,47,34
Nippzy,twisting-nether,1821,rogue,subtlety,239,140,99
Sbx,alakir,1820,rogue,subtlety,194,105,89
Rlwlwlwrogue,twisting-nether,1819,rogue,subtlety,103,62,41
Râpidø,elune,1819,rogue,subtlety,185,93,92
Rmp,outland,1818,rogue,subtlety,30,19,11
Disturbdx,archimonde,1818,rogue,subtlety,129,76,53
Slonerbrah,ravencrest,1818,rogue,subtlety,60,32,28
Smílèy,ravencrest,1818,rogue,subtlety,114,51,63
Ålùnæh,azjolnerub,1817,rogue,subtlety,126,71,55
Holaszemed,ragnaros,1816,rogue,subtlety,183,96,87
Wrathlolz,terokkar,1815,rogue,subtlety,105,61,44
Mâêl,blackmoore,1815,rogue,subtlety,245,130,115
Salakelmi,sylvanas,1814,rogue,subtlety,113,65,48
Старллесс,gordunni,1814,rogue,subtlety,553,295,258
Kekful,defias-brotherhood,1811,rogue,subtlety,36,26,10
Nevolav,turalyon,1811,rogue,subtlety,60,39,21
Анми,gordunni,1811,rogue,subtlety,66,40,26
Ipøuli,quelthalas,1811,rogue,subtlety,54,29,25
Venom,stormscale,1809,rogue,subtlety,90,48,42
Randomidiot,ravencrest,1809,rogue,subtlety,126,66,60
Keeganx,tarren-mill,1808,rogue,subtlety,71,39,32
Ropedrink,stormscale,1805,rogue,subtlety,71,47,24
Bumaqt,silvermoon,1805,rogue,subtlety,66,41,25
Dancex,kazzak,1805,rogue,subtlety,126,76,50
Azirios,kazzak,1805,rogue,subtlety,233,124,109
Ooqu,silvermoon,1804,rogue,subtlety,30,23,7
Læffgøðx,stormscale,1804,rogue,subtlety,63,38,25
Deadlybrew,twisting-nether,1804,rogue,subtlety,76,43,33
Rhayesh,silvermoon,1804,rogue,subtlety,136,70,66
Kenjí,silvermoon,1804,rogue,subtlety,291,148,143
Jugalos,ravencrest,1804,rogue,subtlety,59,30,29
Rogxy,blackrock,1803,rogue,subtlety,54,32,22
Noxxy,archimonde,1803,rogue,subtlety,121,66,55
Monero,thrall,1802,rogue,subtlety,121,75,46
Killvision,kul-tiras,1801,rogue,subtlety,90,53,37
Jeruna,veklor,1801,rogue,subtlety,98,57,41
Calestrian,tarren-mill,1800,rogue,subtlety,202,108,94
Sfyr,ysondre,1799,rogue,subtlety,232,123,109
Тира,grom,1798,rogue,subtlety,36,19,17
Эдкенуэй,gordunni,1796,rogue,subtlety,213,123,90
Sâybyëbæ,dun-modr,1796,rogue,subtlety,157,86,71
Crøweta,argent-dawn,1796,rogue,subtlety,84,42,42
Clickbaitx,blackmoore,1795,rogue,subtlety,281,140,141
Åluñahtøpg,azjolnerub,1794,rogue,subtlety,150,78,72
Nightnelly,archimonde,1792,rogue,subtlety,51,34,17
Lânnïster,kazzak,1792,rogue,subtlety,156,82,74
Ënd,ravencrest,1791,rogue,subtlety,96,47,49
Nyzx,blackhand,1789,rogue,subtlety,57,37,20
Kasualaf,stormscale,1788,rogue,subtlety,55,32,23
Quq,kazzak,1787,rogue,subtlety,298,163,135
Fibpatrool,ravencrest,1786,rogue,subtlety,125,70,55
Màrto,archimonde,1783,rogue,subtlety,113,69,44
Márto,archimonde,1782,rogue,subtlety,238,127,111
Путьказаха,gordunni,1779,rogue,subtlety,78,45,33
Läêkz,archimonde,1779,rogue,subtlety,48,21,27
Voldaxd,blackhand,1777,rogue,subtlety,45,28,17
Releaserage,draenor,1777,rogue,subtlety,61,31,30
Øptì,ravencrest,1774,rogue,subtlety,59,29,30
Bursthilde,blackmoore,1772,rogue,subtlety,117,68,49
Ratirl,kult-der-verdammten,1771,rogue,subtlety,93,57,36
Critys,drakthul,1770,rogue,subtlety,36,21,15
Botsrogue,kazzak,1769,rogue,subtlety,36,22,14
Namelless,twisting-nether,1769,rogue,subtlety,255,131,124
Renhri,burning-legion,1766,rogue,subtlety,450,230,220
Jáckz,twisting-nether,1764,rogue,subtlety,86,48,38
Евриклол,soulflayer,1764,rogue,subtlety,59,27,32
Eiscreme,blackmoore,1763,rogue,subtlety,36,19,17
Simsub,tarren-mill,1761,rogue,subtlety,60,31,29
Hidéfromnooß,twisting-nether,1759,rogue,subtlety,102,54,48
Saanka,eredar,1759,rogue,subtlety,56,28,28
Jljr,twisting-nether,1757,rogue,subtlety,66,33,33
Tazzae,draenor,1756,rogue,subtlety,213,114,99
Featfawkes,ragnaros,1756,rogue,subtlety,116,59,57
Bruckmann,ragnaros,1756,rogue,subtlety,177,88,89
Sapco,ravencrest,1754,rogue,subtlety,54,29,25
Malasap,archimonde,1754,rogue,subtlety,566,288,278
Stråwberrý,archimonde,1753,rogue,subtlety,69,34,35
Tïnderhoe,dalaran,1752,rogue,subtlety,41,28,13
Tanssy,ragnaros,1752,rogue,subtlety,80,48,32
Sÿkz,hyjal,1751,rogue,subtlety,89,47,42
Memphismp,drakthul,1750,rogue,subtlety,41,23,18
Xtoyo,zuljin,1748,rogue,subtlety,179,89,90
Cntrlld,ravencrest,1747,rogue,subtlety,42,27,15
Trîçk,aegwynn,1747,rogue,subtlety,78,43,35
Naïmitsu,hyjal,1747,rogue,subtlety,132,69,63
Dópamine,hyjal,1746,rogue,subtlety,214,113,101
Воронкхал,ashenvale,1745,rogue,subtlety,66,35,31
Xyzonk,kazzak,1745,rogue,subtlety,42,22,20
Stabmaster,outland,1742,rogue,subtlety,102,58,44
Инфера,lich-king,1741,rogue,subtlety,72,33,39
Keophz,tarren-mill,1740,rogue,subtlety,185,110,75
Axroa,blackmoore,1740,rogue,subtlety,60,24,36
Insomnla,silvermoon,1738,rogue,subtlety,132,68,64
Imaginesub,blackmoore,1735,rogue,subtlety,49,36,13
Asukabed,ravencrest,1732,rogue,subtlety,36,19,17
Sly,emerald-dream,1732,rogue,subtlety,84,43,41
Skimpy,stormscale,1731,rogue,subtlety,65,38,27
Sêrgi,minahonda,1731,rogue,subtlety,48,28,20
Zilemjr,stormscale,1731,rogue,subtlety,176,101,75
Ccedox,stormscale,1729,rogue,subtlety,30,20,10
Lemaroxd,tarren-mill,1729,rogue,subtlety,42,27,15
Synergize,stormreaver,1729,rogue,subtlety,173,94,79
Akwaaba,ravencrest,1729,rogue,subtlety,189,100,89
Cheapshôt,archimonde,1728,rogue,subtlety,225,120,105
Johnnyprep,ravencrest,1726,rogue,subtlety,95,59,36
Starfighter,pozzo-delleternità,1726,rogue,subtlety,216,114,102
Pavlo,nathrezim,1726,rogue,subtlety,73,32,41
Брайнз,gordunni,1725,rogue,subtlety,227,129,98
Sariena,sylvanas,1725,rogue,subtlety,304,154,150
Snøv,outland,1723,rogue,subtlety,130,72,58
Azziinoth,ragnaros,1723,rogue,subtlety,104,48,56
Хавиа,gordunni,1721,rogue,subtlety,71,44,27
Kasualasf,stormscale,1721,rogue,subtlety,43,25,18
Dìsørderx,ravencrest,1721,rogue,subtlety,130,72,58
Ач,gordunni,1718,rogue,subtlety,114,61,53
Кишмякх,howling-fjord,1716,rogue,subtlety,186,85,101
Hoodrogue,blackrock,1715,rogue,subtlety,110,64,46
Dáydreamín,draenor,1715,rogue,subtlety,36,18,18
Eltitoedu,dun-modr,1714,rogue,subtlety,89,44,45
Zygzåg,hyjal,1712,rogue,subtlety,29,19,10
Amuini,magtheridon,1712,rogue,subtlety,50,26,24
Nephology,ravencrest,1712,rogue,subtlety,48,23,25
Nerfalliance,ravencrest,1709,rogue,subtlety,48,27,21
Fivepoint,blackmoore,1708,rogue,subtlety,84,49,35
Ziqqi,thrall,1708,rogue,subtlety,120,64,56
Gøldzahn,antonidas,1707,rogue,subtlety,100,54,46
Saptrinket,stormscale,1707,rogue,subtlety,445,222,223
Бладстейн,blackscar,1706,rogue,subtlety,324,168,156
Zzemzza,kazzak,1705,rogue,subtlety,107,58,49
Kleptomancy,sylvanas,1702,rogue,subtlety,42,26,16
Architeggt,eredar,1700,rogue,subtlety,102,47,55
Whoton,archimonde,1699,rogue,subtlety,40,24,16
Bizzarerogue,tarren-mill,1698,rogue,subtlety,54,32,22
Trapstar,stormscale,1697,rogue,subtlety,225,119,106
Ÿøßø,archimonde,1695,rogue,subtlety,144,78,66
Shôka,dalaran,1694,rogue,subtlety,52,25,27
Machmacan,thrall,1693,rogue,subtlety,125,67,58
Киу,howling-fjord,1693,rogue,subtlety,96,48,48
Ámbush,sylvanas,1691,rogue,subtlety,159,80,79
Stormhardt,stormscale,1690,rogue,subtlety,69,29,40
Whîspyr,blackmoore,1689,rogue,subtlety,54,28,26
Meccura,silvermoon,1687,rogue,subtlety,153,86,67
Cucumber,laughing-skull,1687,rogue,subtlety,42,23,19
Nihilix,dalaran,1687,rogue,subtlety,197,101,96
Fawkkes,la-croisade-écarlate,1686,rogue,subtlety,65,39,26
Wasp,twisting-nether,1686,rogue,subtlety,72,35,37
Strangeboy,ravencrest,1685,rogue,subtlety,30,19,11
Роземсти,gordunni,1685,rogue,subtlety,210,105,105
Mfx,arathi,1681,rogue,subtlety,49,33,16
Рели,blackscar,1681,rogue,subtlety,78,39,39
Пусякиллерх,gordunni,1680,rogue,subtlety,105,62,43
Zayøn,outland,1680,rogue,subtlety,60,33,27
Хасилей,booty-bay,1680,rogue,subtlety,140,74,66
Subisfun,ravencrest,1678,rogue,subtlety,52,33,19
Røgger,ragnaros,1677,rogue,subtlety,190,94,96
Skullboy,blackmoore,1676,rogue,subtlety,42,23,19
Inyria,outland,1674,rogue,subtlety,265,143,122
Søllek,culte-de-la-rive-noire,1674,rogue,subtlety,74,36,38
Whiteløtûs,dun-modr,1671,rogue,subtlety,42,19,23
Ogc,draenor,1670,rogue,subtlety,62,43,19
Grifika,outland,1670,rogue,subtlety,121,71,50
Exi,elune,1670,rogue,subtlety,62,26,36
Augustina,draenor,1669,rogue,subtlety,102,55,47
Nitelite,outland,1669,rogue,subtlety,72,35,37
Misttrogue,hyjal,1668,rogue,subtlety,48,26,22
Yumiee,arygos,1668,rogue,subtlety,325,166,159
Notôríous,ravencrest,1667,rogue,subtlety,72,38,34
Ccedolol,stormscale,1666,rogue,subtlety,71,38,33
Nasklagatv,rashgarroth,1666,rogue,subtlety,42,22,20
Reezr,stormscale,1666,rogue,subtlety,132,64,68
Röguetönerö,dun-modr,1664,rogue,subtlety,48,25,23
Aläen,ravencrest,1663,rogue,subtlety,138,78,60
Ennvi,defias-brotherhood,1663,rogue,subtlety,137,69,68
Panigalex,veknilash,1662,rogue,subtlety,141,81,60
Кишмякх,gordunni,1662,rogue,subtlety,93,50,43
Rantie,eredar,1662,rogue,subtlety,54,28,26
Элисандресса,gordunni,1662,rogue,subtlety,72,37,35
Sinterklaas,earthen-ring,1661,rogue,subtlety,54,33,21
Jussylol,stormscale,1656,rogue,subtlety,45,27,18
Nîllá,blackmoore,1656,rogue,subtlety,72,33,39
Rakzena,ravencrest,1655,rogue,subtlety,60,33,27
Сильфитт,gordunni,1655,rogue,subtlety,152,72,80
Ðjczx,twisting-nether,1654,rogue,subtlety,115,62,53
Кеонетво,howling-fjord,1653,rogue,subtlety,70,39,31
Appatras,tarren-mill,1652,rogue,subtlety,86,49,37
Lhitriân,saurfang,1652,rogue,subtlety,145,71,74
Subsònik,tarren-mill,1650,rogue,subtlety,76,43,33
Vizifyx,ravencrest,1649,rogue,subtlety,36,21,15
Served,twisting-nether,1647,rogue,subtlety,34,20,14
Handuil,blackmoore,1647,rogue,subtlety,205,108,97
Ryvz,ravencrest,1647,rogue,subtlety,95,47,48
Exanimu,ravencrest,1647,rogue,subtlety,392,193,199
Сармонн,howling-fjord,1646,rogue,subtlety,84,56,28
Ibizå,ravencrest,1646,rogue,subtlety,138,75,63
Shivx,tarren-mill,1644,rogue,subtlety,234,118,116
Calpic,sanguino,1643,rogue,subtlety,217,121,96
Txm,argent-dawn,1643,rogue,subtlety,42,22,20
Aaze,kazzak,1643,rogue,subtlety,201,101,100
Ripuli,alakir,1640,rogue,subtlety,36,21,15
Kafross,silvermoon,1640,rogue,subtlety,36,18,18
Dancebar,silvermoon,1640,rogue,subtlety,290,141,149
Vennomous,darkspear,1639,rogue,subtlety,58,38,20
Xlums,archimonde,1639,rogue,subtlety,98,55,43
Форсгодх,gordunni,1639,rogue,subtlety,83,37,46
Xzo,stormscale,1637,rogue,subtlety,25,21,4
Vâleera,kazzak,1637,rogue,subtlety,36,18,18
Dawnsaber,argent-dawn,1635,rogue,subtlety,54,31,23
Zourkan,archimonde,1635,rogue,subtlety,553,297,256
Momíne,stormscale,1635,rogue,subtlety,41,18,23
Lechatbotté,tarren-mill,1633,rogue,subtlety,101,64,37
Злойкиллер,howling-fjord,1630,rogue,subtlety,371,189,182
Bloodsmell,outland,1629,rogue,subtlety,254,138,116
Doritomix,dun-modr,1628,rogue,subtlety,50,29,21
Mns,drakthul,1627,rogue,subtlety,68,38,30
Myønlyfans,hyjal,1627,rogue,subtlety,46,23,23
Luciferx,stormscale,1626,rogue,subtlety,42,31,11
Roguestuff,silvermoon,1626,rogue,subtlety,30,18,12
Freemode,outland,1625,rogue,subtlety,36,26,10
Геопанк,howling-fjord,1625,rogue,subtlety,66,43,23
Солевыегубки,gordunni,1625,rogue,subtlety,73,43,30
Shoamunj,archimonde,1625,rogue,subtlety,36,21,15
Lotorr,burning-legion,1625,rogue,subtlety,150,77,73
Skitzo,ravencrest,1624,rogue,subtlety,36,17,19
Pcessleia,twisting-nether,1622,rogue,subtlety,30,17,13
Ðoppex,blackmoore,1620,rogue,subtlety,30,17,13
Donchichi,archimonde,1620,rogue,subtlety,66,31,35
Nâzaar,antonidas,1619,rogue,subtlety,149,88,61
Isucu,burning-legion,1619,rogue,subtlety,242,136,106
Nojdobra,tarren-mill,1619,rogue,subtlety,147,80,67
Ramses,onyxia,1619,rogue,subtlety,120,60,60
Filiduttpvp,ravencrest,1617,rogue,subtlety,66,42,24
Энтерсэндман,blackscar,1617,rogue,subtlety,35,20,15
Shadowprank,ravencrest,1617,rogue,subtlety,87,45,42
Stonyhavana,ravencrest,1617,rogue,subtlety,126,64,62
Villain,aegwynn,1617,rogue,subtlety,71,35,36
Kerim,antonidas,1614,rogue,subtlety,36,22,14
Syniel,conseil-des-ombres,1614,rogue,subtlety,46,25,21
Tinylol,dun-morogh,1614,rogue,subtlety,115,62,53
Zep,auchindoun,1613,rogue,subtlety,77,46,31
Ömme,archimonde,1613,rogue,subtlety,153,84,69
ßênz,archimonde,1612,rogue,subtlety,94,52,42
Ðelvin,dalaran,1612,rogue,subtlety,48,21,27
Hollowized,silvermoon,1611,rogue,subtlety,30,20,10
Huprâ,ravencrest,1611,rogue,subtlety,30,17,13
Ândrey,ravencrest,1611,rogue,subtlety,116,63,53
Akyô,archimonde,1609,rogue,subtlety,30,17,13
Krsty,antonidas,1609,rogue,subtlety,36,20,16
Rexore,ravencrest,1609,rogue,subtlety,87,47,40
Ilrunne,silvermoon,1609,rogue,subtlety,184,97,87
Carvyn,defias-brotherhood,1608,rogue,subtlety,54,31,23
Jaydeeñ,ravencrest,1608,rogue,subtlety,54,29,25
Fivepointx,blackmoore,1608,rogue,subtlety,98,52,46
Billgatez,blackrock,1607,rogue,subtlety,45,23,22
Râáy,blackrock,1607,rogue,subtlety,187,95,92
Meldee,burning-legion,1606,rogue,subtlety,60,32,28
Zømbië,kazzak,1606,rogue,subtlety,284,141,143
Гэнт,soulflayer,1605,rogue,subtlety,84,45,39
Gamezcorex,aegwynn,1604,rogue,subtlety,234,122,112
Mecu,ravencrest,1604,rogue,subtlety,126,64,62
Buú,kazzak,1604,rogue,subtlety,42,20,22
Зорго,deathguard,1603,rogue,subtlety,89,50,39
Skýfire,ravencrest,1603,rogue,subtlety,72,37,35
Shreddera,ravencrest,1602,rogue,subtlety,90,51,39
Местьбучи,howling-fjord,1602,rogue,subtlety,162,90,72
Абисиан,soulflayer,1602,rogue,subtlety,126,70,56
Sénsorium,draenor,1601,rogue,subtlety,255,138,117
Madisonivyqt,blackmoore,1601,rogue,subtlety,106,56,50
Redcutter,silvermoon,1601,rogue,subtlety,78,41,37
Альназир,howling-fjord,1601,rogue,subtlety,149,78,71
Weird,blackmoore,1600,rogue,subtlety,46,29,17
Sunå,archimonde,1600,rogue,subtlety,36,19,17
Insidióus,sylvanas,1597,rogue,subtlety,150,75,75
Killnoobs,kazzak,1596,rogue,subtlety,24,17,7
Beefboss,neptulon,1596,rogue,subtlety,29,17,12
Redork,twisting-nether,1595,rogue,subtlety,30,17,13
Бэрнии,howling-fjord,1594,rogue,subtlety,210,109,101
Doomdagger,chamber-of-aspects,1593,rogue,subtlety,59,31,28
Onlyluvhurt,dun-modr,1592,rogue,subtlety,130,73,57
Энбонни,gordunni,1591,rogue,subtlety,60,34,26
Ishízu,exodar,1591,rogue,subtlety,162,76,86
Icekisstv,hyjal,1590,rogue,subtlety,30,18,12
Súpremé,ravencrest,1590,rogue,subtlety,169,96,73
Kohakugawa,kazzak,1590,rogue,subtlety,36,19,17
Ambuh,ragnaros,1589,rogue,subtlety,59,32,27
Smo,kargath,1588,rogue,subtlety,68,38,30
Vganzgptx,ravencrest,1587,rogue,subtlety,71,38,33
Baldoh,kazzak,1584,rogue,subtlety,36,24,12
Морзо,howling-fjord,1584,rogue,subtlety,95,53,42
Jëllyxøxø,twisting-nether,1584,rogue,subtlety,176,94,82
Jèlly,outland,1583,rogue,subtlety,99,64,35
Rogueas,stormscale,1583,rogue,subtlety,65,40,25
Intrix,draenor,1583,rogue,subtlety,54,31,23
Вр,blackscar,1582,rogue,subtlety,30,18,12
Aszaryn,magtheridon,1580,rogue,subtlety,78,43,35
Oxyrog,ravencrest,1580,rogue,subtlety,42,22,20
Rukiia,blackrock,1580,rogue,subtlety,42,21,21
Yörgs,eredar,1579,rogue,subtlety,42,24,18
Xdxdxdxdxdxd,drakthul,1578,rogue,subtlety,42,28,14
Режупополам,howling-fjord,1577,rogue,subtlety,36,24,12
Стеллакокс,howling-fjord,1577,rogue,subtlety,58,32,26
Bendegúzz,ravencrest,1576,rogue,subtlety,81,43,38
Amazindante,burning-legion,1576,rogue,subtlety,66,31,35
Дэмайо,gordunni,1575,rogue,subtlety,48,26,22
Háttori,twisting-nether,1575,rogue,subtlety,48,26,22
Sniiky,kazzak,1575,rogue,subtlety,327,170,157
Liarø,archimonde,1575,rogue,subtlety,157,80,77
Chimmee,draenor,1575,rogue,subtlety,96,42,54
Leepz,outland,1574,rogue,subtlety,102,62,40
Flares,ravencrest,1574,rogue,subtlety,35,19,16
Mortnoïre,naxxramas,1574,rogue,subtlety,136,72,64
Артимидушка,gordunni,1573,rogue,subtlety,30,18,12
Ninjaassasin,aegwynn,1573,rogue,subtlety,261,135,126
Shyy,dun-modr,1572,rogue,subtlety,54,26,28
Lalice,argent-dawn,1569,rogue,subtlety,66,44,22
Pheq,ravencrest,1569,rogue,subtlety,195,96,99
Dôlf,hyjal,1568,rogue,subtlety,120,70,50
Sshaka,tarren-mill,1566,rogue,subtlety,176,90,86
Djswaghetti,stormscale,1566,rogue,subtlety,36,18,18
Haikyu,blackhand,1566,rogue,subtlety,72,33,39
Danori,grim-batol,1565,rogue,subtlety,30,17,13
Tonaxstab,ragnaros,1565,rogue,subtlety,104,56,48
Sicariø,argent-dawn,1565,rogue,subtlety,243,128,115
Sombredagues,ysondre,1565,rogue,subtlety,316,162,154
Säxnthecrity,blackmoore,1565,rogue,subtlety,360,183,177
Кумоо,gordunni,1565,rogue,subtlety,48,23,25
Gane,sanguino,1564,rogue,subtlety,65,42,23
Adskydroch,ravencrest,1564,rogue,subtlety,60,31,29
Sapperinö,sylvanas,1563,rogue,subtlety,423,219,204
Onlyrogue,ragnaros,1562,rogue,subtlety,48,23,25
Vögue,burning-legion,1561,rogue,subtlety,151,75,76
Хайдвей,ashenvale,1560,rogue,subtlety,42,18,24
Omeger,thrall,1559,rogue,subtlety,65,24,41
Ouvrebwate,archimonde,1558,rogue,subtlety,89,43,46
Deok,tarren-mill,1556,rogue,subtlety,54,31,23
Grindz,ravencrest,1556,rogue,subtlety,692,357,335
Zanaken,stormscale,1555,rogue,subtlety,340,182,158
Kãlí,blackmoore,1555,rogue,subtlety,517,263,254
Îüçkÿmêñ,outland,1554,rogue,subtlety,208,109,99
Триплсап,howling-fjord,1553,rogue,subtlety,53,23,30
Spykee,culte-de-la-rive-noire,1552,rogue,subtlety,42,24,18
Jqmie,ravencrest,1551,rogue,subtlety,80,47,33
Rîzer,ravencrest,1551,rogue,subtlety,112,50,62
Allchatoff,drakthul,1550,rogue,subtlety,23,17,6
Ripcurll,grim-batol,1549,rogue,subtlety,115,60,55
Frequenzalfa,silvermoon,1549,rogue,subtlety,52,26,26
Ddhelpra,blackrock,1549,rogue,subtlety,94,45,49
Ayatsuji,nemesis,1549,rogue,subtlety,42,18,24
Зеротулав,gordunni,1549,rogue,subtlety,42,17,25
Hookäh,chants-éternels,1548,rogue,subtlety,48,23,25
Pfourtwenty,eredar,1547,rogue,subtlety,36,18,18
Shabu,nemesis,1546,rogue,subtlety,95,42,53
Monstermads,kazzak,1545,rogue,subtlety,54,25,29
Свёклапро,gordunni,1544,rogue,subtlety,126,77,49
Mega,nordrassil,1543,rogue,subtlety,27,17,10
Helloimjohn,darksorrow,1543,rogue,subtlety,77,43,34
Roanz,stormreaver,1543,rogue,subtlety,67,35,32
Bamsejuicee,kazzak,1542,rogue,subtlety,30,20,10
Grzech,burning-legion,1542,rogue,subtlety,217,111,106
Xkebyzlobg,outland,1540,rogue,subtlety,47,26,21
Cander,kazzak,1540,rogue,subtlety,85,45,40
Silesi,kazzak,1538,rogue,subtlety,24,17,7
Spky,ravencrest,1538,rogue,subtlety,41,26,15
Venøøm,eredar,1537,rogue,subtlety,170,92,78
Ayami,blackhand,1537,rogue,subtlety,42,18,24
Chipicaua,silvermoon,1537,rogue,subtlety,78,33,45
Cøntrøl,stormreaver,1535,rogue,subtlety,144,77,67
Ванэйти,gordunni,1535,rogue,subtlety,519,267,252
Сабик,howling-fjord,1534,rogue,subtlety,95,57,38
Лэйап,soulflayer,1534,rogue,subtlety,30,16,14
Reyzumi,antonidas,1533,rogue,subtlety,36,21,15
Nitroxygen,outland,1533,rogue,subtlety,213,108,105
Jaffar,mannoroth,1533,rogue,subtlety,106,52,54
Johnyqt,hyjal,1532,rogue,subtlety,66,39,27
Cataleýa,outland,1532,rogue,subtlety,128,75,53
Unsullièd,kazzak,1532,rogue,subtlety,60,31,29
Veronkierto,stormreaver,1531,rogue,subtlety,119,64,55
Sinist,twisting-nether,1531,rogue,subtlety,50,23,27
Südh,sanguino,1530,rogue,subtlety,90,43,47
Subzy,burning-legion,1529,rogue,subtlety,253,140,113
Дракакула,blackscar,1528,rogue,subtlety,33,22,11
Iowlq,outland,1528,rogue,subtlety,36,22,14
Yourexwifey,ravencrest,1528,rogue,subtlety,121,68,53
Нэйлио,deepholm,1527,rogue,subtlety,24,16,8
Kidneyou,ragnaros,1527,rogue,subtlety,82,43,39
Isseen,burning-legion,1527,rogue,subtlety,41,19,22
Ziqqiqt,thrall,1526,rogue,subtlety,94,48,46
Miiløx,silvermoon,1526,rogue,subtlety,159,78,81
Kiwiganker,argent-dawn,1526,rogue,subtlety,58,27,31
Belwarx,darksorrow,1526,rogue,subtlety,220,100,120
Fragmint,aggra-português,1525,rogue,subtlety,36,18,18
Jeanklanche,archimonde,1525,rogue,subtlety,84,41,43
Stâr,archimonde,1524,rogue,subtlety,117,72,45
Zoodiac,khazgoroth,1523,rogue,subtlety,47,19,28
Droomprins,stormscale,1522,rogue,subtlety,142,73,69
Royalflüx,grim-batol,1522,rogue,subtlety,81,41,40
Kidknee,outland,1522,rogue,subtlety,36,18,18
Akira,outland,1521,rogue,subtlety,272,151,121
Nécrømåncy,ravencrest,1520,rogue,subtlety,30,16,14
Kyssme,archimonde,1520,rogue,subtlety,48,21,27
Pottomzola,ragnaros,1520,rogue,subtlety,66,28,38
Faytun,kult-der-verdammten,1519,rogue,subtlety,54,34,20
Sumiftw,drakthul,1519,rogue,subtlety,30,16,14
Gvcci,aegwynn,1517,rogue,subtlety,24,16,8
Шадовкилер,blackscar,1517,rogue,subtlety,90,48,42
Críppléz,ravencrest,1517,rogue,subtlety,120,63,57
Zujàz,frostwhisper,1515,rogue,subtlety,90,48,42
Röguelol,outland,1515,rogue,subtlety,138,70,68
Sykin,eredar,1514,rogue,subtlety,89,51,38
Nìghtwalker,ravencrest,1514,rogue,subtlety,278,144,134
Morgan,argent-dawn,1511,rogue,subtlety,144,80,64
Subzhero,draenor,1511,rogue,subtlety,36,17,19
Roguecow,tarren-mill,1510,rogue,subtlety,326,169,157
Zappsarap,onyxia,1510,rogue,subtlety,48,22,26
Xãwé,kazzak,1509,rogue,subtlety,45,26,19
Shinzaoh,khaz-modan,1509,rogue,subtlety,64,33,31
Adwl,archimonde,1508,rogue,subtlety,367,189,178
Кверест,howling-fjord,1506,rogue,subtlety,36,20,16
Psychørogue,antonidas,1506,rogue,subtlety,42,22,20
Arathir,ravencrest,1505,rogue,subtlety,86,47,39
Сенямбус,gordunni,1504,rogue,subtlety,66,36,30
Sìhaya,outland,1504,rogue,subtlety,55,29,26
Falewyn,ragnaros,1503,rogue,subtlety,24,16,8
Zënø,ragnaros,1503,rogue,subtlety,260,142,118
Stayhumble,turalyon,1502,rogue,subtlety,58,32,26
Sumsarx,ravencrest,1501,rogue,subtlety,137,72,65
Neirdà,hyjal,1498,rogue,subtlety,49,23,26
Tripletwenty,ravencrest,1497,rogue,subtlety,30,19,11
Spr,malfurion,1496,rogue,subtlety,118,65,53
Murkyy,gilneas,1496,rogue,subtlety,58,29,29
Mishøna,kazzak,1495,rogue,subtlety,167,96,71
Izanamî,tarren-mill,1495,rogue,subtlety,132,66,66
Msweasel,sylvanas,1494,rogue,subtlety,48,28,20
Arkblenderx,silvermoon,1494,rogue,subtlety,187,92,95
Kiiby,ravencrest,1494,rogue,subtlety,60,21,39
Fakekick,blackrock,1493,rogue,subtlety,42,25,17
Kidneyqt,thrall,1493,rogue,subtlety,73,41,32
Эвисирейт,gordunni,1493,rogue,subtlety,77,42,35
Paxmortem,silvermoon,1493,rogue,subtlety,120,62,58
Buffdh,eredar,1493,rogue,subtlety,48,23,25
Letmeplay,ravencrest,1492,rogue,subtlety,53,28,25
Nightq,tarren-mill,1491,rogue,subtlety,84,48,36
Doperog,antonidas,1491,rogue,subtlety,228,123,105
Catthief,ravencrest,1489,rogue,subtlety,104,57,47
Stealthb,ravencrest,1489,rogue,subtlety,59,32,27
Shízzel,blackhand,1489,rogue,subtlety,141,73,68
Chratoo,blackmoore,1489,rogue,subtlety,109,53,56
Redewolf,argent-dawn,1488,rogue,subtlety,30,18,12
Winwin,silvermoon,1488,rogue,subtlety,236,134,102
Neyloa,kazzak,1487,rogue,subtlety,31,18,13
Dölf,archimonde,1487,rogue,subtlety,170,92,78
Лютьер,soulflayer,1487,rogue,subtlety,222,115,107
Xok,draenor,1487,rogue,subtlety,52,26,26
Шпилля,gordunni,1487,rogue,subtlety,77,38,39
Kneiv,frostwhisper,1487,rogue,subtlety,36,16,20
Lilrookie,argent-dawn,1486,rogue,subtlety,164,93,71
Mînz,twisting-nether,1486,rogue,subtlety,59,26,33
Ddhelpra,ravencrest,1485,rogue,subtlety,34,18,16
Эйфуча,gordunni,1484,rogue,subtlety,229,121,108
Txf,aegwynn,1484,rogue,subtlety,90,46,44
Vanquishz,arathor,1484,rogue,subtlety,78,36,42
Ruck,madmortem,1483,rogue,subtlety,114,61,53
Bekkz,todeswache,1483,rogue,subtlety,60,30,30
Diagnoze,twisting-nether,1481,rogue,subtlety,29,16,13
Ghøstkid,blackrock,1481,rogue,subtlety,194,98,96
Jenz,blackmoore,1481,rogue,subtlety,60,29,31
Текин,howling-fjord,1480,rogue,subtlety,162,85,77
Stoff,archimonde,1479,rogue,subtlety,153,76,77
Kire,daggerspine,1478,rogue,subtlety,65,30,35
Cýphia,amanthul,1477,rogue,subtlety,54,29,25
Войенх,gordunni,1477,rogue,subtlety,111,55,56
Лэйкиро,gordunni,1476,rogue,subtlety,30,16,14
Mocarta,draenor,1476,rogue,subtlety,78,41,37
Zôuloulou,archimonde,1476,rogue,subtlety,86,45,41
Maxrizzx,ravencrest,1476,rogue,subtlety,39,17,22
Peechiyy,blackmoore,1475,rogue,subtlety,75,43,32
Прошмандэ,gordunni,1474,rogue,subtlety,64,38,26
Shnuppah,sylvanas,1474,rogue,subtlety,72,39,33
Doxxei,draenor,1474,rogue,subtlety,231,122,109
Вагнеса,howling-fjord,1474,rogue,subtlety,95,48,47
Счастливое,howling-fjord,1471,rogue,subtlety,116,58,58
Shâdowfreeze,onyxia,1469,rogue,subtlety,114,59,55
Thelones,antonidas,1469,rogue,subtlety,76,39,37
Zodracir,scarshield-legion,1469,rogue,subtlety,66,29,37
Мипракн,fordragon,1468,rogue,subtlety,66,47,19
Tason,argent-dawn,1468,rogue,subtlety,42,25,17
Givilwtf,eredar,1468,rogue,subtlety,126,66,60
Зенофар,soulflayer,1467,rogue,subtlety,293,143,150
Senzus,twisting-nether,1466,rogue,subtlety,36,19,17
Yasu,outland,1465,rogue,subtlety,235,122,113
Veryscaryguý,twisting-nether,1464,rogue,subtlety,54,33,21
Вейлинс,gordunni,1464,rogue,subtlety,48,23,25
Diazz,aegwynn,1462,rogue,subtlety,103,54,49
Chipson,kazzak,1462,rogue,subtlety,96,50,46
Decoyed,sylvanas,1462,rogue,subtlety,53,27,26
Rêve,the-maelstrom,1461,rogue,subtlety,46,27,19
Funhinten,blackmoore,1461,rogue,subtlety,54,30,24
Ipresskidney,tarren-mill,1461,rogue,subtlety,164,85,79
Rekki,terokkar,1461,rogue,subtlety,42,21,21
Tripleníne,silvermoon,1460,rogue,subtlety,132,75,57
Azovrouge,terokkar,1460,rogue,subtlety,279,149,130
Бллейз,gordunni,1460,rogue,subtlety,36,16,20
Bízkit,stormscale,1459,rogue,subtlety,42,27,15
Chazsakaï,chogall,1458,rogue,subtlety,34,23,11
Bodhibombx,arthas,1458,rogue,subtlety,58,33,25
Джокэссиди,blackscar,1458,rogue,subtlety,43,24,19
Ænutz,ysondre,1458,rogue,subtlety,33,18,15
Sashikorosu,archimonde,1457,rogue,subtlety,116,65,51
Faptastíc,blackmoore,1457,rogue,subtlety,49,27,22
Ryxanâ,blackrock,1457,rogue,subtlety,96,48,48
Schníttchen,antonidas,1455,rogue,subtlety,29,19,10
Sheldowws,tarren-mill,1455,rogue,subtlety,63,34,29
Shadystabby,stormscale,1455,rogue,subtlety,155,80,75
Spyzie,hyjal,1455,rogue,subtlety,45,21,24
Norlix,ravencrest,1455,rogue,subtlety,66,30,36
Ganker,antonidas,1455,rogue,subtlety,54,24,30
Voki,dalaran,1454,rogue,subtlety,135,70,65
Wraithh,minahonda,1453,rogue,subtlety,132,72,60
Neskagrall,aegwynn,1453,rogue,subtlety,48,23,25
Jaikka,archimonde,1452,rogue,subtlety,56,31,25
Jaqenhghar,pozzo-delleternità,1452,rogue,subtlety,145,76,69
Ibizà,ravencrest,1452,rogue,subtlety,306,154,152
Snusbusen,ravencrest,1452,rogue,subtlety,42,21,21
Sacrehptit,naxxramas,1450,rogue,subtlety,42,26,16
Lastkiss,aggramar,1450,rogue,subtlety,77,41,36
Getbleeded,stormscale,1449,rogue,subtlety,78,44,34
Critmaker,outland,1448,rogue,subtlety,24,16,8
Songoro,tirion,1447,rogue,subtlety,57,29,28
Sapstunlol,tarren-mill,1446,rogue,subtlety,30,16,14
Bandèra,ragnaros,1446,rogue,subtlety,65,28,37
Pidroseus,argent-dawn,1445,rogue,subtlety,99,53,46
Drpiper,twisting-nether,1445,rogue,subtlety,43,22,21
Bountyhunter,malygos,1445,rogue,subtlety,36,16,20
Oboejoe,burning-legion,1444,rogue,subtlety,207,111,96
Pérplèxîty,thrall,1443,rogue,subtlety,73,39,34
Mont,nemesis,1443,rogue,subtlety,72,36,36
Knifez,ravencrest,1441,rogue,subtlety,54,26,28
Darkxenojiva,blackmoore,1441,rogue,subtlety,87,39,48
Rat,mazrigos,1440,rogue,subtlety,24,15,9
Daggerdashx,ravencrest,1440,rogue,subtlety,698,366,332
Ворейн,howling-fjord,1440,rogue,subtlety,277,140,137
Xulem,silvermoon,1439,rogue,subtlety,64,38,26
Takenòtes,nemesis,1438,rogue,subtlety,24,15,9
Stabbingpunk,ravencrest,1438,rogue,subtlety,90,44,46
Распяздяй,gordunni,1437,rogue,subtlety,108,59,49
Shaeni,silvermoon,1437,rogue,subtlety,320,164,156
Coolbassoff,kazzak,1437,rogue,subtlety,104,49,55
Jrj,hyjal,1437,rogue,subtlety,34,16,18
Slayered,burning-legion,1436,rogue,subtlety,36,15,21
Lïke,frostwolf,1435,rogue,subtlety,24,15,9
Mutoeksi,twisting-nether,1435,rogue,subtlety,30,16,14
Aznare,silvermoon,1435,rogue,subtlety,83,44,39
Fugly,ragnaros,1435,rogue,subtlety,61,28,33
Asdfqwerty,ravencrest,1435,rogue,subtlety,48,21,27
Akazuki,alleria,1434,rogue,subtlety,66,31,35
Swayzii,hyjal,1433,rogue,subtlety,47,26,21
ßrklynprnc,blackrock,1433,rogue,subtlety,30,15,15
Ambushgirl,ravencrest,1433,rogue,subtlety,89,44,45
Evasión,aegwynn,1432,rogue,subtlety,101,55,46
Orestes,pozzo-delleternità,1432,rogue,subtlety,87,45,42
Ypoxthonius,silvermoon,1432,rogue,subtlety,36,18,18
Trashbàg,alakir,1432,rogue,subtlety,30,15,15
Achterom,tarren-mill,1432,rogue,subtlety,128,59,69
Jahseh,blackmoore,1430,rogue,subtlety,42,20,22
Eáz,ravencrest,1429,rogue,subtlety,48,31,17
Zrka,hyjal,1429,rogue,subtlety,24,15,9
Выебузадницу,soulflayer,1429,rogue,subtlety,54,28,26
Crípplé,ravencrest,1428,rogue,subtlety,30,19,11
Mâtâtâ,die-ewige-wacht,1428,rogue,subtlety,77,42,35
Sùbzerø,archimonde,1428,rogue,subtlety,48,24,24
Aschoni,dethecus,1428,rogue,subtlety,41,20,21
Zx,frostmane,1428,rogue,subtlety,54,26,28
Grris,stormscale,1428,rogue,subtlety,78,28,50
Муфдшы,gordunni,1427,rogue,subtlety,72,47,25
Zobrak,twisting-nether,1427,rogue,subtlety,102,55,47
Edaniel,draenor,1427,rogue,subtlety,135,72,63
Bakalan,dun-modr,1427,rogue,subtlety,42,19,23
Shipshot,blackrock,1426,rogue,subtlety,24,15,9
Aahz,tarren-mill,1425,rogue,subtlety,54,27,27
Reprouvette,dalaran,1424,rogue,subtlety,51,29,22
Jimaal,stormscale,1424,rogue,subtlety,67,38,29
Bizcochondo,sanguino,1424,rogue,subtlety,66,36,30
Grimdoll,tarren-mill,1423,rogue,subtlety,255,139,116
Daggerz,outland,1423,rogue,subtlety,54,28,26
Evivalarte,burning-legion,1423,rogue,subtlety,113,54,59
Mxx,stormscale,1422,rogue,subtlety,319,169,150
Jkrx,draenor,1421,rogue,subtlety,36,18,18
Бейнс,howling-fjord,1420,rogue,subtlety,36,20,16
Jøwy,archimonde,1420,rogue,subtlety,106,55,51
Ритор,deathguard,1420,rogue,subtlety,65,33,32
Zeiden,sanguino,1420,rogue,subtlety,90,45,45
Raewyn,teldrassil,1419,rogue,subtlety,44,24,20
Actualcarry,dentarg,1419,rogue,subtlety,100,54,46
Automutilate,outland,1419,rogue,subtlety,54,23,31
Nairobii,tarren-mill,1417,rogue,subtlety,54,30,24
Jechijr,silvermoon,1417,rogue,subtlety,48,24,24
Tinyshank,drakthul,1416,rogue,subtlety,122,63,59
Морнер,howling-fjord,1416,rogue,subtlety,65,33,32
Дэ,blackscar,1416,rogue,subtlety,30,15,15
Midoa,nerathor,1415,rogue,subtlety,98,56,42
Жабоклик,gordunni,1414,rogue,subtlety,146,74,72
Nomota,sanguino,1413,rogue,subtlety,54,32,22
Dahlin,stormscale,1413,rogue,subtlety,47,24,23
Nopzs,outland,1413,rogue,subtlety,147,73,74
Лиргенвард,deathguard,1412,rogue,subtlety,167,83,84
Самерон,howling-fjord,1411,rogue,subtlety,36,24,12
Янигугулак,soulflayer,1411,rogue,subtlety,24,15,9
Nínjutsu,ravencrest,1410,rogue,subtlety,56,25,31
Decrios,outland,1409,rogue,subtlety,50,20,30
Royalflux,grim-batol,1405,rogue,subtlety,30,17,13
Ассаин,gordunni,1405,rogue,subtlety,55,31,24
Jamzyrogue,emerald-dream,1405,rogue,subtlety,36,19,17
Дамаскус,booty-bay,1404,rogue,subtlety,36,20,16
Teba,cthun,1404,rogue,subtlety,40,19,21
Dägorath,dun-modr,1403,rogue,subtlety,34,21,13
Бэтх,soulflayer,1402,rogue,subtlety,60,36,24
Fullblind,tarren-mill,1402,rogue,subtlety,209,106,103
Cerrian,argent-dawn,1401,rogue,subtlety,65,37,28
Erenyeagerx,kazzak,1401,rogue,subtlety,137,71,66
Ææçæçæçæ,twisting-nether,1401,rogue,subtlety,78,39,39
Svartesven,auchindoun,1401,rogue,subtlety,90,43,47
Zelìx,frostmane,1400,rogue,subtlety,120,72,48
Exine,sanguino,1400,rogue,subtlety,30,17,13
Альназир,gordunni,1400,rogue,subtlety,42,22,20
Killthatmage,shattered-hand,1400,rogue,subtlety,42,21,21
Arachni,ravencrest,1400,rogue,subtlety,63,29,34
Xalupa,dun-modr,1400,rogue,subtlety,117,53,64
Banginghard,dunemaul,1399,rogue,subtlety,72,37,35
Hazero,frostmane,1399,rogue,subtlety,36,16,20
Maitrefurtif,argent-dawn,1398,rogue,subtlety,29,19,10
Floorjansen,sylvanas,1398,rogue,subtlety,42,25,17
Zélla,twisting-nether,1398,rogue,subtlety,122,61,61
Nîmaj,hyjal,1398,rogue,subtlety,48,21,27
Freemmr,draenor,1396,rogue,subtlety,172,88,84
Deathcvlt,hyjal,1396,rogue,subtlety,292,145,147
Sajina,kazzak,1396,rogue,subtlety,48,23,25
Mercyã,outland,1395,rogue,subtlety,107,59,48
Lenani,blackrock,1395,rogue,subtlety,48,20,28
Skitstöveln,stormscale,1394,rogue,subtlety,24,15,9
Смекрус,soulflayer,1394,rogue,subtlety,165,83,82
Evi,korgall,1394,rogue,subtlety,60,27,33
Robersillo,sanguino,1393,rogue,subtlety,54,23,31
Dàwn,boulderfist,1391,rogue,subtlety,88,48,40
Dimidimi,wildhammer,1391,rogue,subtlety,48,21,27
Эбиб,soulflayer,1390,rogue,subtlety,52,24,28
Guiseppe,grim-batol,1389,rogue,subtlety,105,57,48
Hidinginash,twisting-nether,1388,rogue,subtlety,50,25,25
Xblackhole,tarren-mill,1387,rogue,subtlety,170,86,84
Âtrâlês,azshara,1386,rogue,subtlety,33,16,17
Knivparty,draenor,1384,rogue,subtlety,76,41,35
Óoo,outland,1384,rogue,subtlety,72,37,35
Технорэйв,gordunni,1384,rogue,subtlety,78,35,43
Feinted,kazzak,1383,rogue,subtlety,109,56,53
Althieves,ravencrest,1382,rogue,subtlety,132,72,60
Opaska,ravencrest,1382,rogue,subtlety,188,95,93
Deathwalkxr,silvermoon,1381,rogue,subtlety,111,59,52
Roguebot,draenor,1381,rogue,subtlety,136,71,65
Shadowgraph,eredar,1381,rogue,subtlety,60,31,29
Kryptonite,nemesis,1381,rogue,subtlety,147,75,72
Rikdy,kazzak,1381,rogue,subtlety,30,15,15
Mmrmmxmm,turalyon,1381,rogue,subtlety,65,28,37
Subhub,ragnaros,1380,rogue,subtlety,96,46,50
Dredge,kaelthas,1379,rogue,subtlety,44,22,22
Дакоока,soulflayer,1378,rogue,subtlety,24,16,8
Käz,argent-dawn,1376,rogue,subtlety,42,16,26
Ванябигпуш,blackscar,1374,rogue,subtlety,132,66,66
Syrio,nemesis,1374,rogue,subtlety,57,26,31
Trímønâ,gorgonnash,1374,rogue,subtlety,36,16,20
Фалвир,howling-fjord,1372,rogue,subtlety,65,38,27
Binbág,draenor,1372,rogue,subtlety,108,62,46
Mpß,tarren-mill,1372,rogue,subtlety,29,15,14
Juuzou,outland,1372,rogue,subtlety,35,15,20
Lilsalad,ravencrest,1371,rogue,subtlety,89,43,46
Анивиана,howling-fjord,1371,rogue,subtlety,134,64,70
Lêmon,argent-dawn,1370,rogue,subtlety,52,31,21
Utis,kazzak,1369,rogue,subtlety,24,15,9
Рестинписер,soulflayer,1369,rogue,subtlety,449,229,220
Elfreyja,archimonde,1369,rogue,subtlety,111,53,58
Bloodwraith,stormscale,1369,rogue,subtlety,99,44,55
Daterx,ravencrest,1369,rogue,subtlety,36,15,21
Tripx,ravencrest,1368,rogue,subtlety,151,80,71
Sableye,arathor,1368,rogue,subtlety,35,15,20
Boornys,burning-legion,1367,rogue,subtlety,94,50,44
Unreallx,silvermoon,1367,rogue,subtlety,518,268,250
Zavebe,nathrezim,1367,rogue,subtlety,53,26,27
Usainßreak,chogall,1366,rogue,subtlety,82,47,35
Ykw,tarren-mill,1366,rogue,subtlety,147,81,66
Hashlund,stormscale,1366,rogue,subtlety,86,46,40
Neymar,ysondre,1365,rogue,subtlety,108,58,50
Jáyjay,antonidas,1365,rogue,subtlety,90,39,51
Verk,twilights-hammer,1365,rogue,subtlety,42,18,24
Bárathrum,stormscale,1364,rogue,subtlety,30,23,7
Exbandit,sanguino,1364,rogue,subtlety,72,44,28
Ibz,kazzak,1364,rogue,subtlety,42,20,22
Behiq,aggramar,1363,rogue,subtlety,48,31,17
Vexior,argent-dawn,1363,rogue,subtlety,93,44,49
Gankbang,frostmane,1363,rogue,subtlety,78,35,43
Dedka,hyjal,1361,rogue,subtlety,103,49,54
Rngkillaz,archimonde,1360,rogue,subtlety,37,20,17
Кэйтлис,howling-fjord,1360,rogue,subtlety,48,20,28
Sedái,twisting-nether,1359,rogue,subtlety,38,16,22
Illyan,jaedenar,1358,rogue,subtlety,30,17,13
Cenvadois,blackmoore,1358,rogue,subtlety,54,26,28
Mulu,defias-brotherhood,1358,rogue,subtlety,50,23,27
Venominom,aegwynn,1357,rogue,subtlety,30,17,13
Qiiss,stormscale,1357,rogue,subtlety,78,43,35
Schering,frostwolf,1357,rogue,subtlety,36,18,18
Эквалири,gordunni,1357,rogue,subtlety,94,45,49
Csak,defias-brotherhood,1357,rogue,subtlety,42,18,24
Артимидушка,soulflayer,1356,rogue,subtlety,22,15,7
Aikaza,blackmoore,1356,rogue,subtlety,51,23,28
Søsaboy,nemesis,1355,rogue,subtlety,24,15,9
Helcof,emerald-dream,1353,rogue,subtlety,30,15,15
Zerozsub,tarren-mill,1352,rogue,subtlety,184,102,82
Galathea,turalyon,1352,rogue,subtlety,167,83,84
Trimøná,gorgonnash,1351,rogue,subtlety,24,15,9
Taniwa,archimonde,1351,rogue,subtlety,132,70,62
Øníxßtw,eitrigg,1350,rogue,subtlety,30,15,15
Дернирог,howling-fjord,1350,rogue,subtlety,127,62,65
Иннхотеп,howling-fjord,1349,rogue,subtlety,66,39,27
Maybeok,twisting-nether,1349,rogue,subtlety,96,56,40
Behindü,frostmane,1349,rogue,subtlety,138,68,70
Shadowspike,sanguino,1348,rogue,subtlety,47,22,25
Hahårry,ravencrest,1347,rogue,subtlety,48,24,24
Zappdead,frostwolf,1347,rogue,subtlety,52,22,30
Ултра,gordunni,1344,rogue,subtlety,261,131,130
Later,saurfang,1344,rogue,subtlety,34,16,18
Crimatoria,rajaxx,1344,rogue,subtlety,57,25,32
Urthël,culte-de-la-rive-noire,1343,rogue,subtlety,24,14,10
Akroshalolz,outland,1343,rogue,subtlety,24,14,10
Yokze,ravencrest,1343,rogue,subtlety,148,73,75
Scrumptious,darksorrow,1343,rogue,subtlety,96,47,49
Rúckus,ravencrest,1342,rogue,subtlety,24,14,10
Djeud,archimonde,1342,rogue,subtlety,136,79,57
Vanisha,outland,1342,rogue,subtlety,126,58,68
Pschítt,archimonde,1342,rogue,subtlety,116,51,65
Gingahboy,doomhammer,1340,rogue,subtlety,215,118,97
Maløcøxysse,dalaran,1340,rogue,subtlety,126,68,58
Vorsix,tarren-mill,1340,rogue,subtlety,195,103,92
Timesneak,stormscale,1340,rogue,subtlety,72,32,40
Erx,ragnaros,1339,rogue,subtlety,36,20,16
Аренамастерх,blackscar,1339,rogue,subtlety,30,15,15
Xenara,argent-dawn,1339,rogue,subtlety,81,39,42
Iwashíding,draenor,1338,rogue,subtlety,36,18,18
Zordochrog,kazzak,1338,rogue,subtlety,32,16,16
Изифаза,deathguard,1338,rogue,subtlety,30,14,16
Æsthaetic,silvermoon,1337,rogue,subtlety,529,260,269
Neverdyingx,ragnaros,1337,rogue,subtlety,54,18,36
Ракфорн,howling-fjord,1336,rogue,subtlety,185,91,94
Lookbehîndu,aegwynn,1336,rogue,subtlety,73,35,38
Anklash,blackrock,1336,rogue,subtlety,73,31,42
Ryzem,archimonde,1335,rogue,subtlety,770,393,377
Сайгакк,galakrond,1334,rogue,subtlety,51,29,22
Кайсити,gordunni,1334,rogue,subtlety,36,14,22
Behêmoth,hyjal,1333,rogue,subtlety,24,14,10
Moprogue,twisting-nether,1333,rogue,subtlety,24,14,10
Masanari,die-nachtwache,1333,rogue,subtlety,62,28,34
Ruckusxx,ravencrest,1332,rogue,subtlety,21,15,6
Tàazz,ysondre,1332,rogue,subtlety,24,14,10
Tootskie,outland,1332,rogue,subtlety,163,91,72
Daekrun,argent-dawn,1332,rogue,subtlety,98,49,49
Ñavy,archimonde,1332,rogue,subtlety,86,37,49
Yakio,silvermoon,1332,rogue,subtlety,60,25,35
Maam,ravencrest,1331,rogue,subtlety,48,26,22
Gavranovski,ravencrest,1330,rogue,subtlety,24,14,10
Йаяга,soulflayer,1330,rogue,subtlety,36,19,17
Duzhel,kazzak,1329,rogue,subtlety,71,36,35
Jdç,tarren-mill,1327,rogue,subtlety,24,14,10
Meshay,kazzak,1327,rogue,subtlety,43,24,19
Luckeri,antonidas,1327,rogue,subtlety,74,37,37
Cørek,blackhand,1327,rogue,subtlety,30,14,16
Kiksi,ravencrest,1326,rogue,subtlety,107,57,50
Азунайт,ashenvale,1325,rogue,subtlety,29,15,14
Andrizle,blackmoore,1325,rogue,subtlety,30,14,16
Yamajinzu,blackmoore,1324,rogue,subtlety,317,159,158
Sparrowxd,aegwynn,1324,rogue,subtlety,33,15,18
Lesyria,blackrock,1323,rogue,subtlety,46,25,21
Hasansabbah,twisting-nether,1323,rogue,subtlety,66,22,44
Nekhâ,hyjal,1322,rogue,subtlety,24,14,10
Cowmbat,tarren-mill,1322,rogue,subtlety,62,30,32
Pierrè,draenor,1322,rogue,subtlety,30,14,16
Nopz,outland,1321,rogue,subtlety,48,24,24
Рюджик,soulflayer,1321,rogue,subtlety,30,14,16
Kuttunga,ravencrest,1320,rogue,subtlety,63,32,31
Bonelesschic,silvermoon,1320,rogue,subtlety,30,14,16
Xyfer,azshara,1319,rogue,subtlety,48,26,22
Tripoid,draenor,1319,rogue,subtlety,78,35,43
Suikastman,silvermoon,1318,rogue,subtlety,94,48,46
Rbgdowngrade,ravencrest,1318,rogue,subtlety,30,15,15
Pøpsmoke,outland,1318,rogue,subtlety,140,69,71
Мариалолз,gordunni,1318,rogue,subtlety,30,14,16
Dreamt,twisting-nether,1317,rogue,subtlety,66,36,30
Ðàrx,archimonde,1317,rogue,subtlety,77,35,42
Billybang,outland,1316,rogue,subtlety,112,58,54
Dåjjal,ravencrest,1316,rogue,subtlety,87,45,42
Ultraviølett,gorgonnash,1316,rogue,subtlety,73,34,39
Alltaïr,ravencrest,1315,rogue,subtlety,177,96,81
Poughkeepsie,outland,1315,rogue,subtlety,36,17,19
Tonu,sanguino,1315,rogue,subtlety,30,14,16
Caská,blackhand,1315,rogue,subtlety,72,32,40
Snack,burning-legion,1314,rogue,subtlety,57,27,30
Тучёна,soulflayer,1313,rogue,subtlety,90,51,39
Furky,blackmoore,1312,rogue,subtlety,36,22,14
Zkyy,ravencrest,1312,rogue,subtlety,24,14,10
Aati,the-maelstrom,1312,rogue,subtlety,128,64,64
Kouru,outland,1312,rogue,subtlety,48,24,24
Strangeboyxx,ravencrest,1312,rogue,subtlety,36,14,22
Jakes,aerie-peak,1311,rogue,subtlety,30,14,16
Shiverbane,sargeras,1310,rogue,subtlety,46,26,20
Mealy,auchindoun,1310,rogue,subtlety,126,65,61
Ultriz,twisting-nether,1310,rogue,subtlety,35,15,20
Andayn,shattered-hand,1309,rogue,subtlety,59,34,25
Boorza,silvermoon,1309,rogue,subtlety,30,16,14
Trulor,wildhammer,1308,rogue,subtlety,89,45,44
Absol,hellscream,1308,rogue,subtlety,118,59,59
Ланароудсс,gordunni,1307,rogue,subtlety,54,25,29
Ханджии,soulflayer,1306,rogue,subtlety,60,35,25
Levíeus,blackrock,1305,rogue,subtlety,132,73,59
Knifeparty,silvermoon,1305,rogue,subtlety,56,28,28
Lupos,anubarak,1305,rogue,subtlety,70,32,38
Eriksonn,drakthul,1304,rogue,subtlety,79,40,39
Rhûlf,ravencrest,1304,rogue,subtlety,115,53,62
Lyroth,silvermoon,1304,rogue,subtlety,77,34,43
Zindally,dalaran,1304,rogue,subtlety,36,15,21
Lînkos,aegwynn,1303,rogue,subtlety,30,14,16
Horvathzu,ravencrest,1303,rogue,subtlety,57,26,31
Káji,frostmane,1302,rogue,subtlety,18,14,4
Hajdit,frostmourne,1301,rogue,subtlety,39,23,16
Loopermann,silvermoon,1301,rogue,subtlety,200,94,106
Tsvetomir,doomhammer,1298,rogue,subtlety,32,16,16
Hérat,silvermoon,1298,rogue,subtlety,60,26,34
Johncéná,stormscale,1297,rogue,subtlety,42,22,20
Эремми,gordunni,1297,rogue,subtlety,122,61,61
Лофиан,gordunni,1297,rogue,subtlety,140,69,71
Лаленвин,gordunni,1295,rogue,subtlety,85,43,42
Bleeds,thrall,1295,rogue,subtlety,53,26,27
Løuvees,archimonde,1294,rogue,subtlety,42,22,20
Снэйк,blackscar,1294,rogue,subtlety,30,15,15
Soukalamink,tarren-mill,1294,rogue,subtlety,48,17,31
Ilikesap,blackmoore,1293,rogue,subtlety,60,32,28
Grimv,frostmane,1293,rogue,subtlety,30,15,15
Expositiv,blackmoore,1292,rogue,subtlety,24,14,10
Niapro,dun-morogh,1292,rogue,subtlety,72,36,36
Viltraxus,twisting-nether,1292,rogue,subtlety,100,43,57
Вишнуизм,gordunni,1291,rogue,subtlety,48,19,29
Hittzer,archimonde,1290,rogue,subtlety,42,18,24
Swiftshank,grim-batol,1290,rogue,subtlety,72,29,43
Kaleigh,grim-batol,1289,rogue,subtlety,24,14,10
Somaliapirat,eredar,1289,rogue,subtlety,30,15,15
Kilabre,twisting-nether,1288,rogue,subtlety,31,16,15
Nexieane,ravencrest,1288,rogue,subtlety,166,84,82
Envenoman,ravencrest,1287,rogue,subtlety,65,27,38
Guiltythief,stormscale,1286,rogue,subtlety,43,22,21
Rhytmic,drakthul,1286,rogue,subtlety,30,14,16
Cnac,stormscale,1286,rogue,subtlety,52,21,31
Kïdney,stormscale,1285,rogue,subtlety,78,43,35
Chïnaski,sargeras,1285,rogue,subtlety,37,19,18
Buttonsfly,silvermoon,1284,rogue,subtlety,132,81,51
Йзвинись,howling-fjord,1284,rogue,subtlety,42,21,21
Guzirogue,azshara,1284,rogue,subtlety,58,22,36
Chïefkeef,twisting-nether,1283,rogue,subtlety,28,15,13
Rogioz,outland,1283,rogue,subtlety,60,23,37
Svddendeath,ragnaros,1281,rogue,subtlety,84,38,46
Swâggerino,kazzak,1280,rogue,subtlety,62,32,30
Pixelrogue,argent-dawn,1278,rogue,subtlety,83,44,39
Misantropia,nemesis,1278,rogue,subtlety,138,64,74
Dræmz,twisting-nether,1277,rogue,subtlety,30,18,12
Zhadowên,outland,1276,rogue,subtlety,72,34,38
Дангерр,gordunni,1275,rogue,subtlety,114,54,60
Mizoy,blackmoore,1274,rogue,subtlety,52,19,33
Vanéry,ravencrest,1272,rogue,subtlety,30,15,15
Petsakos,ravencrest,1272,rogue,subtlety,33,15,18
Asine,boulderfist,1271,rogue,subtlety,127,59,68
Янимагу,soulflayer,1271,rogue,subtlety,55,24,31
Garriw,nemesis,1269,rogue,subtlety,84,38,46
Audiotronic,blackmoore,1268,rogue,subtlety,161,81,80
Bartolomew,hellscream,1268,rogue,subtlety,147,72,75
Шикорро,soulflayer,1266,rogue,subtlety,36,18,18
Sambä,sanguino,1265,rogue,subtlety,90,44,46
Skillissuex,tarren-mill,1264,rogue,subtlety,545,280,265
Smeyra,magtheridon,1262,rogue,subtlety,114,63,51
Jinxy,outland,1261,rogue,subtlety,22,15,7
Фордрэн,deathguard,1260,rogue,subtlety,40,21,19
Shiréz,blackmoore,1260,rogue,subtlety,151,76,75
Monoxid,eredar,1260,rogue,subtlety,125,61,64
Gansull,nemesis,1260,rogue,subtlety,131,63,68
Интерфи,blackscar,1260,rogue,subtlety,140,66,74
Huffim,tarren-mill,1259,rogue,subtlety,158,79,79
Qylu,argent-dawn,1259,rogue,subtlety,30,15,15
Nacknschelle,thrall,1259,rogue,subtlety,41,15,26
Bizkitz,argent-dawn,1258,rogue,subtlety,84,36,48
Joyfulundead,frostwolf,1257,rogue,subtlety,78,43,35
Késs,aegwynn,1257,rogue,subtlety,36,14,22
Coaraze,eldrethalas,1256,rogue,subtlety,119,58,61
Sánkà,ysondre,1255,rogue,subtlety,66,33,33
Rogueseanne,blackrock,1255,rogue,subtlety,120,58,62
Stin,blackrock,1255,rogue,subtlety,137,62,75
Vrederun,blackrock,1254,rogue,subtlety,30,15,15
Maláika,silvermoon,1254,rogue,subtlety,149,74,75
Xaiko,baelgun,1253,rogue,subtlety,44,28,16
Фирмиана,howling-fjord,1253,rogue,subtlety,66,35,31
Weìrdelle,silvermoon,1253,rogue,subtlety,130,67,63
Chãøs,silvermoon,1253,rogue,subtlety,72,37,35
Heskmad,kazzak,1252,rogue,subtlety,64,33,31
Elbrønkas,sanguino,1252,rogue,subtlety,35,14,21
Ambushmike,gorgonnash,1249,rogue,subtlety,190,96,94
Heulleise,die-ewige-wacht,1248,rogue,subtlety,81,42,39
Backcracker,thunderhorn,1248,rogue,subtlety,36,16,20
Freý,twisting-nether,1247,rogue,subtlety,65,30,35
Jrexx,silvermoon,1247,rogue,subtlety,42,16,26
Missesinvis,blackmoore,1246,rogue,subtlety,18,13,5
Xeggy,turalyon,1246,rogue,subtlety,202,109,93
Optoo,ragnaros,1246,rogue,subtlety,41,21,20
Káríc,draenor,1246,rogue,subtlety,52,23,29
Woishi,hyjal,1246,rogue,subtlety,36,14,22
Sneakysáp,ravencrest,1245,rogue,subtlety,18,13,5
Neoly,outland,1245,rogue,subtlety,48,31,17
Narar,stormscale,1245,rogue,subtlety,66,42,24
Lesbinan,kazzak,1245,rogue,subtlety,24,13,11
Zvarka,drakthul,1244,rogue,subtlety,30,21,9
Трикстэд,soulflayer,1244,rogue,subtlety,102,55,47
Зити,blackscar,1243,rogue,subtlety,24,13,11
Purexrogue,dragonblight,1243,rogue,subtlety,78,38,40
Smoothiè,twisting-nether,1242,rogue,subtlety,129,63,66
Xhtzn,ysondre,1240,rogue,subtlety,24,13,11
Arrzhan,silvermoon,1239,rogue,subtlety,104,60,44
Takeitèásy,blackrock,1238,rogue,subtlety,50,20,30
Darkral,nemesis,1238,rogue,subtlety,72,28,44
Валанбалас,soulflayer,1237,rogue,subtlety,60,33,27
Мипанка,gordunni,1237,rogue,subtlety,24,13,11
Darkveil,xavius,1236,rogue,subtlety,59,22,37
Егоист,howling-fjord,1235,rogue,subtlety,54,33,21
Mokey,boulderfist,1234,rogue,subtlety,27,18,9
Revelith,nemesis,1234,rogue,subtlety,36,15,21
Vexia,twisting-nether,1233,rogue,subtlety,24,13,11
Thehand,eonar,1232,rogue,subtlety,96,53,43
Kusgag,ragnaros,1232,rogue,subtlety,24,13,11
Шмарамышь,soulflayer,1231,rogue,subtlety,133,67,66
Alekkush,silvermoon,1231,rogue,subtlety,30,13,17
Sylvershade,kazzak,1231,rogue,subtlety,34,14,20
Rïmr,haomarush,1231,rogue,subtlety,36,13,23
Соважь,soulflayer,1229,rogue,subtlety,60,24,36
Silnce,outland,1227,rogue,subtlety,78,36,42
Darkenough,outland,1227,rogue,subtlety,30,13,17
Deprress,silvermoon,1226,rogue,subtlety,42,25,17
Чернабаев,soulflayer,1226,rogue,subtlety,28,15,13
Тирниса,gordunni,1225,rogue,subtlety,39,23,16
Mckk,tarren-mill,1225,rogue,subtlety,77,41,36
Kylìemirogue,blackrock,1224,rogue,subtlety,95,40,55
Cesar,blackhand,1223,rogue,subtlety,236,128,108
Chetnik,illidan,1222,rogue,subtlety,24,13,11
Sozokujin,ysondre,1222,rogue,subtlety,74,37,37
Wøølfgang,archimonde,1222,rogue,subtlety,83,39,44
Slashendash,outland,1222,rogue,subtlety,53,22,31
Gpóínt,blackmoore,1221,rogue,subtlety,46,24,22
Theriaeu,ravencrest,1221,rogue,subtlety,86,44,42
Vexsis,kazzak,1220,rogue,subtlety,18,13,5
Jimzopf,eredar,1220,rogue,subtlety,53,26,27
Cantseeme,anachronos,1220,rogue,subtlety,54,22,32
Souldreader,draenor,1218,rogue,subtlety,54,30,24
Siktiritos,malganis,1218,rogue,subtlety,84,38,46
Dígga,nemesis,1218,rogue,subtlety,186,83,103
Neyokqt,blackrock,1217,rogue,subtlety,24,13,11
Grope,alonsus,1217,rogue,subtlety,154,75,79
Makerrx,tarren-mill,1216,rogue,subtlety,18,13,5
Галиновна,soulflayer,1215,rogue,subtlety,268,132,136
Ézzah,blackhand,1215,rogue,subtlety,140,60,80
Benvagin,hyjal,1215,rogue,subtlety,44,16,28
Rámiel,ragnaros,1214,rogue,subtlety,53,24,29
Bzuco,tarren-mill,1213,rogue,subtlety,42,24,18
Snýz,darksorrow,1213,rogue,subtlety,23,13,10
Richardjerry,stormscale,1213,rogue,subtlety,24,13,11
Outofstuns,earthen-ring,1213,rogue,subtlety,42,19,23
Instealth,draenor,1213,rogue,subtlety,156,70,86
Jäshin,hyjal,1213,rogue,subtlety,42,13,29
Ксионас,gordunni,1212,rogue,subtlety,82,36,46
Stabymoose,draenor,1210,rogue,subtlety,128,60,68
Катягоудж,gordunni,1210,rogue,subtlety,30,13,17
Mojojina,theradras,1209,rogue,subtlety,64,36,28
Abovz,ragnaros,1209,rogue,subtlety,30,13,17
Sneakypuss,sylvanas,1209,rogue,subtlety,52,21,31
Zergroidz,kazzak,1208,rogue,subtlety,169,82,87
Evadeez,tarren-mill,1208,rogue,subtlety,42,15,27
Теньглуши,gordunni,1206,rogue,subtlety,65,29,36
Коффемолка,ashenvale,1205,rogue,subtlety,96,43,53
Tez,malganis,1204,rogue,subtlety,24,13,11
Jomoama,norgannon,1203,rogue,subtlety,48,21,27
Paveli,ravencrest,1202,rogue,subtlety,120,58,62
Тарний,gordunni,1202,rogue,subtlety,36,17,19
Shrèéd,blackmoore,1202,rogue,subtlety,83,38,45
Firekry,stormscale,1202,rogue,subtlety,39,16,23
Sussulto,nemesis,1202,rogue,subtlety,36,13,23
Сладкийперец,borean-tundra,1200,rogue,subtlety,64,31,33
Byonics,durotan,1199,rogue,subtlety,24,16,8
Pikanother,dalaran,1199,rogue,subtlety,167,86,81
Sokillu,nemesis,1199,rogue,subtlety,66,28,38
Ôzzi,draenor,1198,rogue,subtlety,48,26,22
Mozzart,ragnaros,1198,rogue,subtlety,54,26,28
Elizaya,eredar,1198,rogue,subtlety,54,24,30
Paranoiaqt,outland,1197,rogue,subtlety,33,13,20
Скримшейд,gordunni,1196,rogue,subtlety,48,21,27
Envyss,stormscale,1195,rogue,subtlety,23,13,10
Baldim,silvermoon,1195,rogue,subtlety,31,16,15
Mysies,ysondre,1195,rogue,subtlety,41,19,22
Digmore,drakthul,1192,rogue,subtlety,23,13,10
Lêgòlàs,blackmoore,1192,rogue,subtlety,119,66,53
Nineball,frostmane,1192,rogue,subtlety,29,13,16
Эрихард,howling-fjord,1191,rogue,subtlety,41,18,23
Чайрлайн,blackscar,1190,rogue,subtlety,40,17,23
Inextricabil,stormscale,1189,rogue,subtlety,48,21,27
Бигсмурф,gordunni,1187,rogue,subtlety,68,28,40
Rayukalolz,dun-modr,1187,rogue,subtlety,42,13,29
Rálvius,blackrock,1186,rogue,subtlety,30,19,11
Darkan,kaelthas,1186,rogue,subtlety,102,57,45
Fopi,sanguino,1186,rogue,subtlety,78,34,44
Celadríe,argent-dawn,1184,rogue,subtlety,36,24,12
Soulpanic,draenor,1184,rogue,subtlety,76,46,30
Tidløs,dun-morogh,1184,rogue,subtlety,46,18,28
Djinnx,malganis,1181,rogue,subtlety,54,22,32
Попочке,soulflayer,1175,rogue,subtlety,36,23,13
Эренх,gordunni,1175,rogue,subtlety,212,107,105
Houston,aegwynn,1175,rogue,subtlety,46,23,23
Linglel,blackhand,1175,rogue,subtlety,36,14,22
Tjockolocø,tarren-mill,1174,rogue,subtlety,18,13,5
Syneth,drakthul,1174,rogue,subtlety,25,16,9
Crixor,blackrock,1170,rogue,subtlety,24,13,11
Zakarïa,draenor,1170,rogue,subtlety,59,30,29
Jisz,doomhammer,1170,rogue,subtlety,96,48,48
Blades,blackmoore,1168,rogue,subtlety,66,36,30
Gìngèr,kazzak,1168,rogue,subtlety,24,13,11
Varne,les-sentinelles,1168,rogue,subtlety,42,16,26
Моямайя,eversong,1166,rogue,subtlety,101,46,55
Киржик,soulflayer,1163,rogue,subtlety,48,23,25
Yoninja,turalyon,1163,rogue,subtlety,114,53,61
Blantek,defias-brotherhood,1161,rogue,subtlety,58,33,25
Turrok,ravencrest,1161,rogue,subtlety,42,21,21
Пораменяться,gordunni,1156,rogue,subtlety,186,84,102
Bayanista,draenor,1156,rogue,subtlety,30,13,17
Hersuub,blackmoore,1155,rogue,subtlety,94,48,46
Shuffeyrt,frostmane,1154,rogue,subtlety,51,26,25
Flambî,dalaran,1153,rogue,subtlety,82,41,41
Knivestikker,twisting-nether,1153,rogue,subtlety,64,29,35
Ilovefanny,archimonde,1152,rogue,subtlety,12,12,0
Dexaqt,ravencrest,1152,rogue,subtlety,18,12,6
Скорпеон,deathguard,1152,rogue,subtlety,54,35,19
Dmfd,darksorrow,1152,rogue,subtlety,172,92,80
Melfîce,blackhand,1152,rogue,subtlety,48,20,28
Finkle,blackmoore,1152,rogue,subtlety,36,14,22
Озхоггер,gordunni,1151,rogue,subtlety,18,12,6
Чипшотина,azuregos,1151,rogue,subtlety,18,12,6
Jayjayklobsn,antonidas,1151,rogue,subtlety,24,12,12
Гаротка,razuvious,1150,rogue,subtlety,18,12,6
Stepdancer,blackmoore,1150,rogue,subtlety,24,12,12
Altramoulaga,archimonde,1150,rogue,subtlety,30,12,18
Hængøvèr,antonidas,1150,rogue,subtlety,30,12,18
Devourswine,argent-dawn,1149,rogue,subtlety,18,12,6
Daichi,onyxia,1149,rogue,subtlety,32,13,19
Menajerie,outland,1147,rogue,subtlety,24,12,12
Schärrehänd,blackrock,1147,rogue,subtlety,53,21,32
Radgaa,draenor,1147,rogue,subtlety,65,22,43
Mercìles,kazzak,1146,rogue,subtlety,97,57,40
Teralala,kazzak,1146,rogue,subtlety,24,12,12
Wraiith,chogall,1146,rogue,subtlety,24,12,12
Nínjantiz,antonidas,1145,rogue,subtlety,24,12,12
Niinim,draenor,1144,rogue,subtlety,359,194,165
Nexzr,outland,1144,rogue,subtlety,24,12,12
Huro,aggramar,1143,rogue,subtlety,18,12,6
Hemorhoid,outland,1141,rogue,subtlety,222,121,101
Fodepalmas,sanguino,1141,rogue,subtlety,89,44,45
Mitaktika,silvermoon,1140,rogue,subtlety,18,12,6
Lovetospoon,ravencrest,1140,rogue,subtlety,43,22,21
Lånaya,sylvanas,1140,rogue,subtlety,137,65,72
Roguegutten,quelthalas,1140,rogue,subtlety,35,15,20
Читэри,soulflayer,1139,rogue,subtlety,26,13,13
Tíxoz,archimonde,1139,rogue,subtlety,24,12,12
Unbanmepls,ravencrest,1139,rogue,subtlety,30,12,18
Факюселф,gordunni,1138,rogue,subtlety,24,13,11
Baklava,uldaman,1137,rogue,subtlety,40,15,25
Kuribo,gorgonnash,1136,rogue,subtlety,30,14,16
Duo,karazhan,1136,rogue,subtlety,198,89,109
Gihan,the-shatar,1135,rogue,subtlety,18,12,6
Zhopsy,nemesis,1135,rogue,subtlety,48,18,30
Thenotorious,shadowsong,1134,rogue,subtlety,122,52,70
Ithilyien,blackmoore,1134,rogue,subtlety,62,21,41
Ðarëk,dun-modr,1133,rogue,subtlety,100,44,56
Shdlens,argent-dawn,1133,rogue,subtlety,95,39,56
Bxtchslayer,blackmoore,1133,rogue,subtlety,36,14,22
Maxtnulaujeu,archimonde,1132,rogue,subtlety,71,33,38
Nirvána,outland,1130,rogue,subtlety,146,74,72
Eightball,frostmane,1128,rogue,subtlety,24,12,12
Nodps,zuljin,1126,rogue,subtlety,18,12,6
Prøven,archimonde,1126,rogue,subtlety,117,55,62
Kruuv,dun-morogh,1125,rogue,subtlety,24,12,12
Vulneraan,nemesis,1125,rogue,subtlety,42,17,25
Anala,stormreaver,1123,rogue,subtlety,24,14,10
Badsap,ravencrest,1123,rogue,subtlety,186,90,96
Hyrule,onyxia,1123,rogue,subtlety,131,63,68
Cuckboy,chogall,1122,rogue,subtlety,77,46,31
Faelylanea,argent-dawn,1122,rogue,subtlety,36,16,20
Gradedmg,drakthul,1122,rogue,subtlety,83,36,47
Berneo,burning-legion,1121,rogue,subtlety,42,13,29
Mïta,blackmoore,1119,rogue,subtlety,54,23,31
Sebik,ravencrest,1118,rogue,subtlety,23,12,11
Yamoshí,sanguino,1118,rogue,subtlety,70,36,34
Zyklvn,zuljin,1118,rogue,subtlety,30,12,18
Underarmor,kul-tiras,1117,rogue,subtlety,125,56,69
Вайлиция,ashenvale,1115,rogue,subtlety,57,34,23
Сабанутый,howling-fjord,1112,rogue,subtlety,122,67,55
Coronababy,argent-dawn,1111,rogue,subtlety,24,13,11
Пузэн,howling-fjord,1108,rogue,subtlety,210,112,98
Spinetapper,ravencrest,1108,rogue,subtlety,24,12,12
Kodlak,silvermoon,1108,rogue,subtlety,30,13,17
Niceplan,frostmane,1106,rogue,subtlety,31,16,15
Jiraishin,blackmoore,1105,rogue,subtlety,42,18,24
Злайа,blackscar,1105,rogue,subtlety,82,32,50
Тоб,soulflayer,1104,rogue,subtlety,23,12,11
Graymyst,outland,1103,rogue,subtlety,30,14,16
Murzel,antonidas,1103,rogue,subtlety,30,13,17
Cesârion,antonidas,1102,rogue,subtlety,335,163,172
Lqueespack,kazzak,1101,rogue,subtlety,45,14,31
Понниваиз,gordunni,1100,rogue,subtlety,56,28,28
Kurichu,archimonde,1100,rogue,subtlety,59,22,37
Райан,fordragon,1100,rogue,subtlety,44,13,31
Calyon,hyjal,1099,rogue,subtlety,75,26,49
ßøß,ysondre,1098,rogue,subtlety,104,50,54
Deceitfull,stormscale,1096,rogue,subtlety,42,20,22
Mantîs,tarren-mill,1095,rogue,subtlety,81,41,40
Knifeex,ravencrest,1094,rogue,subtlety,32,13,19
Avøry,antonidas,1094,rogue,subtlety,107,43,64
Jailkaz,thrall,1093,rogue,subtlety,29,13,16
Omêrta,blackmoore,1093,rogue,subtlety,54,19,35
Swiftyfan,silvermoon,1091,rogue,subtlety,29,13,16
Prky,doomhammer,1090,rogue,subtlety,23,12,11
Cusmos,twisting-nether,1088,rogue,subtlety,30,17,13
Twinkyzzö,archimonde,1088,rogue,subtlety,81,43,38
Беточка,gordunni,1087,rogue,subtlety,54,31,23
Tøxykø,archimonde,1086,rogue,subtlety,46,21,25
Latscholol,malorne,1085,rogue,subtlety,236,121,115
Copoka,dun-morogh,1084,rogue,subtlety,51,27,24
Yüm,burning-blade,1084,rogue,subtlety,71,31,40
Pummra,kul-tiras,1083,rogue,subtlety,88,44,44
Fumai,blackmoore,1082,rogue,subtlety,30,13,17
Dallrend,stormscale,1081,rogue,subtlety,84,40,44
Roóty,ravencrest,1080,rogue,subtlety,36,17,19
Fastspectre,ravencrest,1077,rogue,subtlety,109,57,52
Sênsus,antonidas,1076,rogue,subtlety,150,65,85
Psajcho,ragnaros,1076,rogue,subtlety,29,12,17
Pepperbox,twisting-nether,1074,rogue,subtlety,30,15,15
Зацеп,gordunni,1073,rogue,subtlety,36,22,14
Zenajlz,outland,1073,rogue,subtlety,22,12,10
Löka,amanthul,1071,rogue,subtlety,117,59,58
Псиихооз,eversong,1070,rogue,subtlety,25,13,12
Gsi,hyjal,1067,rogue,subtlety,71,28,43
Stuxothug,silvermoon,1066,rogue,subtlety,91,47,44
Nerfexpected,silvermoon,1066,rogue,subtlety,29,12,17
Grinfester,stormscale,1066,rogue,subtlety,55,19,36
Малиноф,borean-tundra,1066,rogue,subtlety,50,17,33
Ithru,twisting-nether,1065,rogue,subtlety,319,160,159
Kucheenstab,blackrock,1065,rogue,subtlety,30,13,17
Mídnight,khaz-modan,1065,rogue,subtlety,45,16,29
Spnzr,draenor,1063,rogue,subtlety,36,21,15
Kalstab,silvermoon,1062,rogue,subtlety,26,13,13
Йолк,galakrond,1061,rogue,subtlety,36,19,17
Розбэйник,gordunni,1061,rogue,subtlety,90,47,43
Batsu,alleria,1061,rogue,subtlety,48,24,24
Lizwi,ragnaros,1058,rogue,subtlety,51,20,31
Bultars,argent-dawn,1058,rogue,subtlety,78,29,49
Ichiegoichie,draenor,1056,rogue,subtlety,12,11,1
Zkittlez,blackhand,1056,rogue,subtlety,18,11,7
Obsçuritý,ragnaros,1056,rogue,subtlety,103,58,45
Whaiipy,ravencrest,1056,rogue,subtlety,167,90,77
Roundrobin,ravencrest,1056,rogue,subtlety,30,11,19
Kopka,draenor,1055,rogue,subtlety,18,11,7
Mollyperph,ravencrest,1055,rogue,subtlety,18,11,7
Like,aegwynn,1055,rogue,subtlety,21,12,9
Aouron,archimonde,1055,rogue,subtlety,25,13,12
Zygzäg,hyjal,1055,rogue,subtlety,24,11,13
Флеймсфорт,gordunni,1055,rogue,subtlety,35,16,19
Gigasoyboy,auchindoun,1054,rogue,subtlety,18,11,7
Oshä,dalaran,1054,rogue,subtlety,30,18,12
Ohdaesu,aegwynn,1054,rogue,subtlety,24,11,13
Rhotmir,silvermoon,1054,rogue,subtlety,24,11,13
Natillaa,dun-modr,1053,rogue,subtlety,18,11,7
Dubfey,silvermoon,1052,rogue,subtlety,24,11,13
Awaaylol,stormscale,1052,rogue,subtlety,24,11,13
Azg,chogall,1052,rogue,subtlety,31,14,17
Abéj,malygos,1052,rogue,subtlety,30,11,19
Pinipiniizz,archimonde,1050,rogue,subtlety,12,11,1
Jorppe,kazzak,1050,rogue,subtlety,80,45,35
Shinõbikék,outland,1050,rogue,subtlety,30,11,19
Oguru,eredar,1050,rogue,subtlety,30,11,19
Missàh,archimonde,1049,rogue,subtlety,18,11,7
Shirá,hyjal,1049,rogue,subtlety,18,11,7
Ucg,twisting-nether,1049,rogue,subtlety,24,11,13
Энвитио,gordunni,1048,rogue,subtlety,24,15,9
Йованов,gordunni,1048,rogue,subtlety,18,11,7
Silence,burning-blade,1048,rogue,subtlety,96,38,58
Thedarkness,sylvanas,1047,rogue,subtlety,27,15,12
Shëîk,hyjal,1047,rogue,subtlety,49,24,25
Greshnak,blackhand,1047,rogue,subtlety,50,20,30
Johnnyblazex,azjolnerub,1047,rogue,subtlety,30,11,19
Celendyl,ravencrest,1045,rogue,subtlety,24,13,11
Allurinea,silvermoon,1044,rogue,subtlety,111,61,50
Vampor,sylvanas,1043,rogue,subtlety,175,78,97
Rearmer,burning-legion,1043,rogue,subtlety,30,11,19
Кийян,howling-fjord,1042,rogue,subtlety,23,12,11
Lenwe,blackmoore,1042,rogue,subtlety,35,17,18
Mndx,sylvanas,1042,rogue,subtlety,24,11,13
Sæqq,blackmoore,1042,rogue,subtlety,125,57,68
Sicario,aegwynn,1041,rogue,subtlety,24,11,13
Koteczka,burning-legion,1040,rogue,subtlety,18,11,7
Fluctuosap,dun-modr,1040,rogue,subtlety,30,11,19
Goldenblitz,blackmoore,1040,rogue,subtlety,42,13,29
Vyllaftw,hyjal,1039,rogue,subtlety,24,11,13
Умбрен,lich-king,1038,rogue,subtlety,54,31,23
Rudyghb,doomhammer,1038,rogue,subtlety,59,31,28
Vathié,twisting-nether,1037,rogue,subtlety,25,11,14
Nanary,blackrock,1037,rogue,subtlety,38,14,24
Akiy,blackrock,1037,rogue,subtlety,36,12,24
Kabloingus,tarren-mill,1035,rogue,subtlety,24,11,13
Ccrogue,nemesis,1034,rogue,subtlety,66,34,32
Geroge,sylvanas,1033,rogue,subtlety,33,22,11
Hade,azjolnerub,1033,rogue,subtlety,24,11,13
Тайнушка,soulflayer,1032,rogue,subtlety,132,62,70
Drakaess,archimonde,1032,rogue,subtlety,24,11,13
Горланг,ashenvale,1031,rogue,subtlety,29,15,14
Sutisong,dun-modr,1031,rogue,subtlety,24,11,13
Acronia,ragnaros,1030,rogue,subtlety,29,11,18
Аутянин,soulflayer,1030,rogue,subtlety,78,24,54
Freddybst,twisting-nether,1028,rogue,subtlety,38,20,18
Lylestra,neptulon,1028,rogue,subtlety,30,11,19
Shanos,ravencrest,1026,rogue,subtlety,24,12,12
Leylaris,argent-dawn,1026,rogue,subtlety,36,16,20
Sît,twisting-nether,1026,rogue,subtlety,42,14,28
Рэйбэк,howling-fjord,1024,rogue,subtlety,30,11,19
Onemine,sanguino,1023,rogue,subtlety,84,46,38
Pitmaster,burning-legion,1020,rogue,subtlety,97,48,49
Streîk,hyjal,1020,rogue,subtlety,161,75,86
Malfeasance,argent-dawn,1019,rogue,subtlety,24,11,13
Stabwøund,the-maelstrom,1018,rogue,subtlety,18,11,7
Vanquish,laughing-skull,1018,rogue,subtlety,39,23,16
Iznögød,uldaman,1018,rogue,subtlety,36,11,25
Liquidgaba,ravencrest,1016,rogue,subtlety,156,81,75
Greendager,cthun,1016,rogue,subtlety,59,18,41
Madnessbg,tarren-mill,1013,rogue,subtlety,50,28,22
Pis,nagrand,1008,rogue,subtlety,32,12,20
Пупичудо,howling-fjord,1008,rogue,subtlety,59,15,44
Mordis,outland,1007,rogue,subtlety,23,11,12
Gobygoby,naxxramas,1007,rogue,subtlety,30,14,16
Chuppay,kazzak,1007,rogue,subtlety,24,11,13
Снарки,booty-bay,1006,rogue,subtlety,118,61,57
Koutzai,stormscale,1006,rogue,subtlety,88,35,53
Ratolí,dun-modr,1005,rogue,subtlety,24,16,8
Idrîl,rashgarroth,1002,rogue,subtlety,113,55,58
Valiéna,dun-morogh,1002,rogue,subtlety,76,27,49
Angelbeats,outland,1002,rogue,subtlety,52,17,35
Unpelrogue,blackmoore,1001,rogue,subtlety,39,16,23
Katarïnä,khaz-modan,1000,rogue,subtlety,58,31,27
Refundlands,kazzak,999,rogue,subtlety,29,11,18
Rookierook,draenor,998,rogue,subtlety,60,27,33
Axeldarq,draenor,998,rogue,subtlety,39,11,28
Sentaria,argent-dawn,996,rogue,subtlety,72,39,33
Azn,anubarak,996,rogue,subtlety,131,55,76
Surinamort,voljin,996,rogue,subtlety,114,44,70
Drakhez,sanguino,995,rogue,subtlety,18,12,6
Reginlief,argent-dawn,995,rogue,subtlety,101,50,51
Clinz,ravencrest,992,rogue,subtlety,32,12,20
Зебол,howling-fjord,990,rogue,subtlety,96,46,50
Outofnowhere,ravencrest,990,rogue,subtlety,23,11,12
Kosmonaut,pozzo-delleternità,988,rogue,subtlety,17,11,6
Danjiki,ravencrest,988,rogue,subtlety,20,11,9
Neverdie,tarren-mill,987,rogue,subtlety,30,11,19
Charbiya,silvermoon,986,rogue,subtlety,24,12,12
Sheyrrà,aegwynn,980,rogue,subtlety,54,18,36
Thicck,twisting-nether,980,rogue,subtlety,48,13,35
Незн,howling-fjord,978,rogue,subtlety,24,15,9
Mishana,thrall,978,rogue,subtlety,40,19,21
Gartham,tarren-mill,977,rogue,subtlety,22,13,9
Raglaron,draenor,977,rogue,subtlety,33,13,20
Sycko,alakir,976,rogue,subtlety,48,28,20
Laxer,burning-legion,976,rogue,subtlety,34,13,21
Dudemar,ravencrest,975,rogue,subtlety,24,11,13
Mallaurya,dalaran,971,rogue,subtlety,24,14,10
Shababe,tirion,971,rogue,subtlety,54,28,26
Rifinou,archimonde,970,rogue,subtlety,24,14,10
Protolink,zuljin,969,rogue,subtlety,82,32,50
Mannheim,kazzak,968,rogue,subtlety,42,23,19
Roguevatar,quelthalas,968,rogue,subtlety,60,29,31
Jacktripper,blackrock,966,rogue,subtlety,72,26,46
Puge,norgannon,966,rogue,subtlety,59,17,42
Shíey,antonidas,963,rogue,subtlety,59,21,38
Shibaii,archimonde,961,rogue,subtlety,244,111,133
Hàze,sargeras,960,rogue,subtlety,18,10,8
Naazki,stormscale,960,rogue,subtlety,24,10,14
Proilas,draenor,960,rogue,subtlety,24,10,14
Звиздаттый,blackscar,960,rogue,subtlety,24,10,14
Mestarikélmi,ravencrest,960,rogue,subtlety,27,10,17
Noboorstsub,ravencrest,959,rogue,subtlety,12,10,2
Chliapacka,burning-blade,959,rogue,subtlety,18,10,8
Rantie,onyxia,959,rogue,subtlety,24,10,14
Reichy,ravencrest,959,rogue,subtlety,36,10,26
Mamutyo,kazzak,958,rogue,subtlety,12,10,2
Theshining,stormscale,958,rogue,subtlety,42,24,18
Djdillá,kazzak,958,rogue,subtlety,18,10,8
Shythairogue,area-52,957,rogue,subtlety,18,10,8
Kolto,argent-dawn,957,rogue,subtlety,24,10,14
Ilyrya,azuremyst,955,rogue,subtlety,18,10,8
Øê,ravencrest,955,rogue,subtlety,21,10,11
Снэйк,ashenvale,955,rogue,subtlety,24,10,14
Psg,argent-dawn,955,rogue,subtlety,25,10,15
Madmann,ravencrest,955,rogue,subtlety,30,10,20
Lurked,kazzak,955,rogue,subtlety,36,10,26
Zëkke,sanguino,954,rogue,subtlety,16,11,5
Shaadowz,ragnaros,954,rogue,subtlety,68,36,32
Amhaia,twisting-nether,954,rogue,subtlety,24,10,14
Сбертяночка,gordunni,953,rogue,subtlety,24,10,14
Hertyso,outland,953,rogue,subtlety,24,10,14
Tyzla,blackrock,953,rogue,subtlety,24,10,14
Sødø,silvermoon,952,rogue,subtlety,99,51,48
Zervi,silvermoon,949,rogue,subtlety,53,24,29
Грема,howling-fjord,948,rogue,subtlety,27,11,16
Babyrogy,aggra-português,947,rogue,subtlety,18,10,8
Lolblizard,gorgonnash,946,rogue,subtlety,27,15,12
Garretygdar,nazjatar,946,rogue,subtlety,90,42,48
Oazo,ysondre,946,rogue,subtlety,125,57,68
Digmorre,drakthul,943,rogue,subtlety,17,10,7
Dainhek,gilneas,943,rogue,subtlety,85,45,40
Синграйм,soulflayer,942,rogue,subtlety,48,26,22
Gravestam,sunstrider,942,rogue,subtlety,30,10,20
Thiranor,cthun,940,rogue,subtlety,18,12,6
Bückdichdoch,blackhand,940,rogue,subtlety,30,10,20
Valdemort,uldum,939,rogue,subtlety,24,10,14
Кизо,blackscar,939,rogue,subtlety,48,19,29
Básmaith,draenor,937,rogue,subtlety,30,10,20
Ramone,ravencrest,935,rogue,subtlety,19,11,8
Theroles,ravencrest,934,rogue,subtlety,33,10,23
Mestepping,draenor,928,rogue,subtlety,32,11,21
Скрытнаярога,ashenvale,927,rogue,subtlety,62,15,47
Owoaho,eonar,926,rogue,subtlety,24,14,10
Ридлли,soulflayer,926,rogue,subtlety,22,11,11
Amerzy,ravencrest,926,rogue,subtlety,23,10,13
Kalona,ravencrest,926,rogue,subtlety,24,10,14
Drakusus,azshara,924,rogue,subtlety,37,16,21
Strikes,eredar,923,rogue,subtlety,42,22,20
Zambiealex,doomhammer,920,rogue,subtlety,44,19,25
Bset,zuljin,920,rogue,subtlety,24,10,14
Gegitka,burning-blade,914,rogue,subtlety,18,10,8
Gimliwitdega,doomhammer,914,rogue,subtlety,332,167,165
Alvoriace,hyjal,911,rogue,subtlety,33,17,16
Shadowstrìke,silvermoon,910,rogue,subtlety,17,10,7
Sensule,darkspear,908,rogue,subtlety,23,10,13
Skankky,ragnaros,904,rogue,subtlety,37,18,19
Fizgaroth,argent-dawn,902,rogue,subtlety,115,58,57
Shurkan,antonidas,902,rogue,subtlety,48,22,26
Теньвора,howling-fjord,902,rogue,subtlety,47,20,27
Rêdbello,dun-morogh,901,rogue,subtlety,81,41,40
Nuttcracker,ragnaros,900,rogue,subtlety,60,18,42
Whitestabber,thunderhorn,900,rogue,subtlety,35,10,25
Trinchö,sanguino,898,rogue,subtlety,105,50,55
Marwyn,laughing-skull,894,rogue,subtlety,20,10,10
Haregan,gorgonnash,891,rogue,subtlety,18,10,8
Saroumani,eitrigg,891,rogue,subtlety,30,16,14
Øks,culte-de-la-rive-noire,891,rogue,subtlety,22,10,12
Бекро,gordunni,885,rogue,subtlety,18,10,8
Yenzie,dragonblight,883,rogue,subtlety,45,20,25
Davshadows,magtheridon,876,rogue,subtlety,48,22,26
Ракельяр,blackscar,875,rogue,subtlety,15,11,4
Rizzardx,ravencrest,875,rogue,subtlety,18,10,8
Kikkshifter,zuluhed,874,rogue,subtlety,36,17,19
Sephika,chants-éternels,871,rogue,subtlety,55,13,42
Zarlen,argent-dawn,870,rogue,subtlety,108,41,67
Mortdorei,argent-dawn,866,rogue,subtlety,97,47,50
Youcrymydear,outland,864,rogue,subtlety,12,9,3
Hængøver,antonidas,864,rogue,subtlety,12,9,3
Фрозенденс,gordunni,864,rogue,subtlety,12,9,3
Penetrantos,eredar,864,rogue,subtlety,12,9,3
Фейкрогуех,soulflayer,864,rogue,subtlety,12,9,3
Kostik,ravencrest,864,rogue,subtlety,12,9,3
Ðéstr,ravencrest,864,rogue,subtlety,18,9,9
Irugä,dun-modr,864,rogue,subtlety,18,9,9
Qwqrxyz,ravencrest,864,rogue,subtlety,18,9,9
Geá,ravencrest,864,rogue,subtlety,18,9,9
Хищницагодх,gordunni,864,rogue,subtlety,18,9,9
Draytonlove,nemesis,864,rogue,subtlety,18,9,9
Cortyup,ravencrest,864,rogue,subtlety,18,9,9
Gserog,chamber-of-aspects,863,rogue,subtlety,12,9,3
Astereex,sylvanas,863,rogue,subtlety,12,9,3
Vganzyborg,ravencrest,863,rogue,subtlety,12,9,3
Ambulances,kazzak,863,rogue,subtlety,12,9,3
Visegrád,aggra-português,863,rogue,subtlety,12,9,3
Hidefromnooß,twisting-nether,863,rogue,subtlety,18,9,9
Síns,runetotem,863,rogue,subtlety,18,9,9
Whitedolphin,turalyon,863,rogue,subtlety,18,9,9
Taistelu,outland,863,rogue,subtlety,18,9,9
Alleyezonme,stormscale,863,rogue,subtlety,18,9,9
Сэвенлайф,soulflayer,863,rogue,subtlety,18,9,9
Рэкрейвон,gordunni,863,rogue,subtlety,18,9,9
Sølølvlîng,dun-modr,863,rogue,subtlety,30,9,21
Бонястелс,gordunni,862,rogue,subtlety,12,9,3
Nícks,tarren-mill,862,rogue,subtlety,18,9,9
Leanderrisin,ragnaros,862,rogue,subtlety,18,9,9
Imrat,stormscale,862,rogue,subtlety,18,9,9
Oldschool,sanguino,862,rogue,subtlety,18,9,9
Zkn,archimonde,862,rogue,subtlety,18,9,9
Únk,dalaran,862,rogue,subtlety,20,9,11
Isodad,kazzak,861,rogue,subtlety,18,9,9
Lêvi,outland,861,rogue,subtlety,18,9,9
Duffbeer,silvermoon,861,rogue,subtlety,18,9,9
Fwizk,twisting-nether,861,rogue,subtlety,18,9,9
Хоткиннс,soulflayer,861,rogue,subtlety,24,9,15
Shinkillua,archimonde,860,rogue,subtlety,18,9,9
Kaizero,tarren-mill,860,rogue,subtlety,18,9,9
Stepbrogue,tarren-mill,860,rogue,subtlety,18,9,9
Kødäy,hyjal,860,rogue,subtlety,24,9,15
Nighteshift,silvermoon,860,rogue,subtlety,32,10,22
Bagirä,sylvanas,859,rogue,subtlety,21,9,12
Invisage,grim-batol,859,rogue,subtlety,24,9,15
Siegderliebe,nemesis,859,rogue,subtlety,24,9,15
Красаа,soulflayer,859,rogue,subtlety,24,9,15
Куцитар,gordunni,858,rogue,subtlety,18,9,9
Emìlia,tarren-mill,858,rogue,subtlety,18,9,9
Asmodal,die-nachtwache,858,rogue,subtlety,24,9,15
Sequoja,blackrock,858,rogue,subtlety,24,9,15
Aluneran,silvermoon,857,rogue,subtlety,24,9,15
Эльфайнити,gordunni,856,rogue,subtlety,24,9,15
Антиппод,razuvious,854,rogue,subtlety,15,10,5
Cramzes,defias-brotherhood,854,rogue,subtlety,24,9,15
Hellboo,uldaman,853,rogue,subtlety,18,9,9
Тучс,gordunni,853,rogue,subtlety,19,9,10
Wìzléy,ravencrest,852,rogue,subtlety,81,39,42
Doga,ravencrest,851,rogue,subtlety,24,9,15
Sanarah,marécage-de-zangar,851,rogue,subtlety,47,16,31
Ungcharmør,ravencrest,850,rogue,subtlety,18,9,9
Rouge,der-rat-von-dalaran,849,rogue,subtlety,18,9,9
Sassasine,amanthul,849,rogue,subtlety,130,58,72
Coshmar,tarren-mill,845,rogue,subtlety,24,9,15
Snogri,burning-legion,845,rogue,subtlety,54,20,34
Jabbo,silvermoon,845,rogue,subtlety,36,11,25
Badfjodr,argent-dawn,844,rogue,subtlety,23,9,14
Sanykrugo,ragnaros,842,rogue,subtlety,24,9,15
Фогус,greymane,841,rogue,subtlety,38,17,21
Пандафей,deathweaver,831,rogue,subtlety,24,9,15
Aeønaxx,hyjal,827,rogue,subtlety,76,32,44
Snake,nethersturm,827,rogue,subtlety,89,30,59
Dezirae,silvermoon,826,rogue,subtlety,22,9,13
Watchurstep,stormscale,825,rogue,subtlety,23,9,14
Haelkil,kazzak,824,rogue,subtlety,16,9,7
Ecray,burning-legion,821,rogue,subtlety,104,50,54
Tnk,twisting-nether,817,rogue,subtlety,18,10,8
Røxxilly,blackmoore,817,rogue,subtlety,22,10,12
Rafax,cthun,814,rogue,subtlety,48,18,30
Prda,aegwynn,810,rogue,subtlety,78,31,47
Wurzelzepp,blackrock,810,rogue,subtlety,23,9,14
Dellya,twisting-nether,806,rogue,subtlety,24,9,15
Tukie,blackhand,803,rogue,subtlety,55,14,41
Cabalion,draenor,800,rogue,subtlety,54,24,30
Тираэлюшка,thermaplugg,799,rogue,subtlety,16,9,7
Ashâa,hyjal,799,rogue,subtlety,18,9,9
Loax,archimonde,799,rogue,subtlety,23,9,14
Grousie,ravencrest,798,rogue,subtlety,22,9,13
Wedgyrog,stormscale,798,rogue,subtlety,28,11,17
Auarg,argent-dawn,797,rogue,subtlety,18,9,9
Grikra,argent-dawn,792,rogue,subtlety,74,34,40
Gizr,haomarush,791,rogue,subtlety,108,47,61
Roxley,der-mithrilorden,786,rogue,subtlety,46,18,28
Cozu,stormrage,781,rogue,subtlety,145,70,75
Ergaviota,colinas-pardas,775,rogue,subtlety,88,28,60
Singularität,silvermoon,774,rogue,subtlety,163,80,83
Robtherobber,kazzak,768,rogue,subtlety,12,8,4
Rannec,der-rat-von-dalaran,768,rogue,subtlety,12,8,4
Sheepmycheap,draenor,768,rogue,subtlety,12,8,4
Tilikum,pozzo-delleternità,768,rogue,subtlety,12,8,4
Фрозенблейдс,gordunni,768,rogue,subtlety,12,8,4
Lastsight,burning-legion,768,rogue,subtlety,12,8,4
Джеанит,gordunni,768,rogue,subtlety,12,8,4
Dêlaral,zirkel-des-cenarius,768,rogue,subtlety,12,8,4
Майндтрикс,blackscar,768,rogue,subtlety,12,8,4
Disembowel,ravencrest,768,rogue,subtlety,18,8,10
Chavidancerr,twisting-nether,767,rogue,subtlety,12,8,4
Ferrãof,aggra-português,767,rogue,subtlety,12,8,4
Ðrxy,outland,767,rogue,subtlety,18,8,10
Xuìalol,blackmoore,767,rogue,subtlety,18,8,10
Mdadx,stormreaver,767,rogue,subtlety,18,8,10
Sanzoo,blackmoore,767,rogue,subtlety,18,8,10
Yunalescax,outland,767,rogue,subtlety,18,8,10
Cirell,tarren-mill,767,rogue,subtlety,18,8,10
Shinti,eredar,767,rogue,subtlety,18,8,10
Smètso,stormscale,767,rogue,subtlety,21,9,12
Whîspêr,ravencrest,767,rogue,subtlety,24,8,16
Kleptomaniac,aggra-português,767,rogue,subtlety,24,8,16
Backstabjr,blackmoore,767,rogue,subtlety,30,8,22
Хаймох,gordunni,767,rogue,subtlety,30,8,22
Batskcab,blackmoore,767,rogue,subtlety,30,8,22
Falciparum,bladefist,766,rogue,subtlety,12,8,4
Baradiir,defias-brotherhood,766,rogue,subtlety,12,8,4
Ytaku,stormscale,766,rogue,subtlety,13,8,5
Liix,ravencrest,766,rogue,subtlety,18,8,10
Lurk,saurfang,766,rogue,subtlety,18,8,10
Apuñalá,cthun,766,rogue,subtlety,18,8,10
Tênsion,silvermoon,765,rogue,subtlety,12,8,4
Люняшка,booty-bay,765,rogue,subtlety,18,8,10
Kppz,burning-legion,765,rogue,subtlety,18,8,10
Ytz,hyjal,765,rogue,subtlety,18,8,10
Лоулайф,soulflayer,765,rogue,subtlety,18,8,10
Neero,outland,765,rogue,subtlety,28,10,18
Rogftw,blackmoore,765,rogue,subtlety,30,8,22
Pirry,sanguino,764,rogue,subtlety,12,8,4
Клоуняша,gordunni,764,rogue,subtlety,18,8,10
Chuckloriss,garona,764,rogue,subtlety,18,8,10
Wingobear,ysondre,764,rogue,subtlety,18,8,10
Ojisanx,outland,764,rogue,subtlety,24,8,16
Zaliria,sanguino,763,rogue,subtlety,24,8,16
Akcell,silvermoon,762,rogue,subtlety,12,8,4
Sayy,nemesis,759,rogue,subtlety,24,8,16
Jénny,sylvanas,751,rogue,subtlety,222,102,120
Câ,outland,750,rogue,subtlety,16,9,7
Revanious,kazzak,749,rogue,subtlety,18,8,10
Всечтобыло,howling-fjord,748,rogue,subtlety,12,8,4
Berruskaa,drakthul,745,rogue,subtlety,18,8,10
Rushhd,exodar,745,rogue,subtlety,81,21,60
Faded,terokkar,744,rogue,subtlety,30,8,22
Vëo,grim-batol,738,rogue,subtlety,18,8,10
Kindwurm,blackmoore,736,rogue,subtlety,16,8,8
Nyreslag,stormreaver,734,rogue,subtlety,14,9,5
Iceyspicey,outland,721,rogue,subtlety,36,8,28
Skene,sanguino,719,rogue,subtlety,85,29,56
Biggut,khadgar,719,rogue,subtlety,27,9,18
Raveshaw,argent-dawn,717,rogue,subtlety,23,8,15
Nemesiis,blackmoore,716,rogue,subtlety,26,10,16
Nesä,hyjal,716,rogue,subtlety,21,8,13
Briggo,silvermoon,714,rogue,subtlety,23,9,14
Natekoti,kazzak,714,rogue,subtlety,42,10,32
Nakli,antonidas,713,rogue,subtlety,21,9,12
Leÿji,archimonde,713,rogue,subtlety,23,9,14
Akamee,temple-noir,713,rogue,subtlety,27,10,17
Faable,silvermoon,709,rogue,subtlety,59,19,40
Abomïñatïøñ,ravencrest,704,rogue,subtlety,108,39,69
Raneya,antonidas,704,rogue,subtlety,41,9,32
Khorvus,ragnaros,702,rogue,subtlety,20,8,12
Venomate,draenor,702,rogue,subtlety,22,8,14
Deave,kazzak,702,rogue,subtlety,22,8,14
Yakku,drakthul,701,rogue,subtlety,26,8,18
Naiikaii,aegwynn,688,rogue,subtlety,14,8,6
Olivares,ravencrest,686,rogue,subtlety,19,8,11
Erepthor,the-maelstrom,686,rogue,subtlety,25,8,17
Owlcat,argent-dawn,681,rogue,subtlety,24,8,16
Menos,draenor,672,rogue,subtlety,12,7,5
Benh,ysondre,672,rogue,subtlety,12,7,5
Jincksrogue,argent-dawn,672,rogue,subtlety,12,7,5
Skipperr,blackmoore,672,rogue,subtlety,12,7,5
Groobii,area-52,672,rogue,subtlety,12,7,5
Zyx,ravencrest,672,rogue,subtlety,12,7,5
Corpsbeau,ysondre,672,rogue,subtlety,12,7,5
Lorinthel,argent-dawn,672,rogue,subtlety,12,7,5
Lovethighs,argent-dawn,672,rogue,subtlety,12,7,5
Qira,burning-blade,672,rogue,subtlety,12,7,5
Rmprockstar,blackrock,672,rogue,subtlety,12,7,5
Jakam,ravencrest,672,rogue,subtlety,12,7,5
Имисида,howling-fjord,672,rogue,subtlety,12,7,5
Charanka,sanguino,672,rogue,subtlety,12,7,5
Троджегард,gordunni,672,rogue,subtlety,12,7,5
Tagaichi,silvermoon,672,rogue,subtlety,12,7,5
Steal,nemesis,672,rogue,subtlety,12,7,5
Shreya,blackrock,672,rogue,subtlety,12,7,5
Bladeage,nazjatar,672,rogue,subtlety,12,7,5
Izisra,draenor,672,rogue,subtlety,12,7,5
Zygzaag,hyjal,672,rogue,subtlety,12,7,5
Lôre,blackrock,672,rogue,subtlety,18,7,11
Darkesthonor,silvermoon,672,rogue,subtlety,18,7,11
Inviseriu,nordrassil,672,rogue,subtlety,18,7,11
Селемена,gordunni,672,rogue,subtlety,18,7,11
Zappdaddy,frostwolf,672,rogue,subtlety,18,7,11
Caípi,frostwolf,672,rogue,subtlety,18,7,11
Nirùút,blackrock,672,rogue,subtlety,27,8,19
Ic,frostmane,672,rogue,subtlety,24,7,17
Codens,kazzak,671,rogue,subtlety,12,7,5
Zyhmø,archimonde,671,rogue,subtlety,12,7,5
Cøntfarmer,stormscale,671,rogue,subtlety,12,7,5
Soulshank,ragnaros,671,rogue,subtlety,12,7,5
Heartripper,ravencrest,671,rogue,subtlety,12,7,5
Hyake,zuljin,671,rogue,subtlety,12,7,5
Odrey,aegwynn,671,rogue,subtlety,12,7,5
Казутора,lich-king,671,rogue,subtlety,12,7,5
Stabs,frostmourne,671,rogue,subtlety,12,7,5
Epi,stormrage,671,rogue,subtlety,12,7,5
Wtbmeld,tarren-mill,671,rogue,subtlety,15,8,7
Elysm,stormscale,671,rogue,subtlety,18,7,11
Achterom,outland,671,rogue,subtlety,18,7,11
Róquet,eredar,671,rogue,subtlety,18,7,11
Tybiereus,argent-dawn,671,rogue,subtlety,18,7,11
Totentánz,silvermoon,671,rogue,subtlety,18,7,11
Backstabbín,kazzak,671,rogue,subtlety,18,7,11
Karomox,blackmoore,671,rogue,subtlety,18,7,11
Сабстил,soulflayer,671,rogue,subtlety,18,7,11
Bibiavie,hyjal,671,rogue,subtlety,18,7,11
Shènz,ysondre,671,rogue,subtlety,18,7,11
Lanewuquvi,alonsus,671,rogue,subtlety,18,7,11
Nargun,archimonde,671,rogue,subtlety,18,7,11
Katara,antonidas,671,rogue,subtlety,18,7,11
Khazren,ravencrest,671,rogue,subtlety,18,7,11
Roronao,sanguino,671,rogue,subtlety,18,7,11
Ellira,stormscale,671,rogue,subtlety,18,7,11
Smörkniven,argent-dawn,671,rogue,subtlety,18,7,11
Sneakypeakii,ravencrest,671,rogue,subtlety,24,7,17
Toketje,sylvanas,671,rogue,subtlety,24,7,17
Princip,drakthul,671,rogue,subtlety,24,7,17
Daggoth,kiljaeden,671,rogue,subtlety,24,7,17
Nøtiçe,kazzak,671,rogue,subtlety,24,7,17
Bluto,stormscale,671,rogue,subtlety,30,7,23
Xenakeuh,kazzak,670,rogue,subtlety,12,7,5
Pièro,burning-legion,670,rogue,subtlety,12,7,5
Кайфутдин,soulflayer,670,rogue,subtlety,12,7,5
Rekaens,sylvanas,670,rogue,subtlety,18,7,11
Yämura,sanguino,670,rogue,subtlety,18,7,11
Hallogenic,silvermoon,670,rogue,subtlety,18,7,11
Jeryss,sylvanas,670,rogue,subtlety,24,7,17
Shâdow,ravenholdt,670,rogue,subtlety,24,7,17
Sharlay,drakthul,670,rogue,subtlety,30,7,23
Unkempt,argent-dawn,669,rogue,subtlety,12,7,5
Пникекс,soulflayer,669,rogue,subtlety,12,7,5
Lepreuchan,archimonde,669,rogue,subtlety,12,7,5
Аникет,howling-fjord,669,rogue,subtlety,18,7,11
Drbackstab,hellfire,669,rogue,subtlety,18,7,11
Nullname,ragnaros,669,rogue,subtlety,24,7,17
Dabo,archimonde,669,rogue,subtlety,24,7,17
Qxes,kazzak,669,rogue,subtlety,24,7,17
Elnos,conseil-des-ombres,668,rogue,subtlety,12,7,5
Путаюсь,gordunni,667,rogue,subtlety,12,7,5
Kunigunde,shattered-hand,667,rogue,subtlety,18,7,11
Jackcoupeber,dalaran,667,rogue,subtlety,24,7,17
Kamagrajelly,blackrock,667,rogue,subtlety,24,7,17
Disagre,kazzak,667,rogue,subtlety,31,7,24
Cacucoxpahu,kazzak,666,rogue,subtlety,12,7,5
Posaydon,malorne,664,rogue,subtlety,18,7,11
Liirja,twisting-nether,664,rogue,subtlety,36,7,29
Azkiel,archimonde,663,rogue,subtlety,18,7,11
Eagleyetr,karazhan,662,rogue,subtlety,12,7,5
Misscash,ragnaros,661,rogue,subtlety,12,7,5
Brancovich,magtheridon,638,rogue,subtlety,17,7,10
Ladona,kazzak,632,rogue,subtlety,34,7,27
Drspectres,tarren-mill,626,rogue,subtlety,78,20,58
Notlikethis,twisting-nether,624,rogue,subtlety,15,8,7
Книфек,howling-fjord,622,rogue,subtlety,11,7,4
Raulo,tarren-mill,622,rogue,subtlety,21,7,14
Vound,tarren-mill,621,rogue,subtlety,30,8,22
Найсгодх,gordunni,618,rogue,subtlety,17,7,10
Ripye,shattered-hand,617,rogue,subtlety,11,7,4
Biianca,sylvanas,608,rogue,subtlety,16,7,9
Sýn,eredar,607,rogue,subtlety,8,7,1
Alyannå,culte-de-la-rive-noire,607,rogue,subtlety,11,7,4
Stekfläsk,argent-dawn,607,rogue,subtlety,14,7,7
Aprroo,ragnaros,607,rogue,subtlety,20,7,13
Szmergla,burning-legion,606,rogue,subtlety,20,7,13
Цилана,gordunni,604,rogue,subtlety,14,7,7
Imnotnice,terenas,592,rogue,subtlety,16,8,8
Logicalxy,ravencrest,576,rogue,subtlety,6,6,0
Pistolpete,grim-batol,576,rogue,subtlety,6,6,0
Dixylebanit,outland,576,rogue,subtlety,6,6,0
Flexibedo,archimonde,576,rogue,subtlety,10,7,3
Unluckythen,ravencrest,576,rogue,subtlety,12,6,6
Nightboyz,kazzak,576,rogue,subtlety,12,6,6
Tebzr,ravencrest,576,rogue,subtlety,12,6,6
Ciosy,blackrock,576,rogue,subtlety,12,6,6
Уммиикк,goldrinn,576,rogue,subtlety,12,6,6
Msrogue,eredar,576,rogue,subtlety,12,6,6
Killmani,ravencrest,576,rogue,subtlety,12,6,6
Элайджигроу,howling-fjord,576,rogue,subtlety,12,6,6
Vixene,burning-legion,576,rogue,subtlety,12,6,6
Stepsan,tarren-mill,576,rogue,subtlety,12,6,6
Ghøßt,outland,576,rogue,subtlety,12,6,6
Herétìc,silvermoon,576,rogue,subtlety,12,6,6
Truesilver,deathwing,576,rogue,subtlety,12,6,6
Zenone,marécage-de-zangar,576,rogue,subtlety,12,6,6
Àlleyezonme,ravencrest,576,rogue,subtlety,12,6,6
Deceptionz,ravencrest,576,rogue,subtlety,12,6,6
Rogerg,dun-morogh,576,rogue,subtlety,12,6,6
Harinef,silvermoon,576,rogue,subtlety,12,6,6
Lynczi,stormscale,576,rogue,subtlety,12,6,6
Morphicsxd,silvermoon,576,rogue,subtlety,12,6,6
Mokmok,frostwolf,576,rogue,subtlety,12,6,6
Jabbz,blackhand,576,rogue,subtlety,12,6,6
Marcel,blackrock,576,rogue,subtlety,12,6,6
Feradelia,thrall,576,rogue,subtlety,12,6,6
Ewlynaisbad,ragnaros,576,rogue,subtlety,12,6,6
Рогадачери,gordunni,576,rogue,subtlety,12,6,6
Elyndri,archimonde,576,rogue,subtlety,12,6,6
Røguøross,archimonde,576,rogue,subtlety,12,6,6
Soulriver,kelthuzad,576,rogue,subtlety,15,7,8
Haigø,archimonde,576,rogue,subtlety,18,6,12
Грустныйрог,gordunni,576,rogue,subtlety,18,6,12
Kerìon,nemesis,576,rogue,subtlety,18,6,12
Tashunkosapa,xavius,576,rogue,subtlety,18,6,12
Isteria,sylvanas,576,rogue,subtlety,18,6,12
Celadrie,kazzak,576,rogue,subtlety,18,6,12
Dîspatchx,defias-brotherhood,576,rogue,subtlety,18,6,12
Cobrâk,archimonde,576,rogue,subtlety,18,6,12
Donowan,stormscale,576,rogue,subtlety,18,6,12
Øzs,argent-dawn,576,rogue,subtlety,24,6,18
Shînka,tyrande,576,rogue,subtlety,24,6,18
Åvírøñgðd,ravencrest,576,rogue,subtlety,24,6,18
Blihhubba,silvermoon,576,rogue,subtlety,24,6,18
Ðarkbleeds,ravencrest,576,rogue,subtlety,24,6,18
Cêline,silvermoon,576,rogue,subtlety,30,6,24
Igel,antonidas,575,rogue,subtlety,12,6,6
Arydir,quelthalas,575,rogue,subtlety,12,6,6
Breuss,elune,575,rogue,subtlety,12,6,6
Føxyy,blackrock,575,rogue,subtlety,12,6,6
Throatslash,twisting-nether,575,rogue,subtlety,12,6,6
Nóre,kazzak,575,rogue,subtlety,12,6,6
Candyshot,thrall,575,rogue,subtlety,12,6,6
Crispflake,frostwolf,575,rogue,subtlety,12,6,6
Thatsdmg,blackmoore,575,rogue,subtlety,12,6,6
Bananashow,aegwynn,575,rogue,subtlety,12,6,6
Eup,outland,575,rogue,subtlety,12,6,6
Kheledon,frostwolf,575,rogue,subtlety,12,6,6
Kalix,agamaggan,575,rogue,subtlety,12,6,6
Snustjuven,stormscale,575,rogue,subtlety,12,6,6
Navysëäls,dun-modr,575,rogue,subtlety,12,6,6
Botnet,blackmoore,575,rogue,subtlety,12,6,6
Meliä,ravencrest,575,rogue,subtlety,16,7,9
Coolspot,archimonde,575,rogue,subtlety,18,6,12
Messene,hellscream,575,rogue,subtlety,18,6,12
Шторкаа,gordunni,575,rogue,subtlety,18,6,12
Girlname,the-maelstrom,575,rogue,subtlety,18,6,12
Aviarumata,draenor,575,rogue,subtlety,18,6,12
Corpzy,ragnaros,575,rogue,subtlety,18,6,12
Soshady,spinebreaker,574,rogue,subtlety,12,6,6
Zëd,draenor,574,rogue,subtlety,12,6,6
Trenbeast,tarren-mill,574,rogue,subtlety,15,7,8
Raiyqyu,archimonde,574,rogue,subtlety,16,7,9
Mass,chogall,574,rogue,subtlety,18,6,12
Rojiel,die-todeskrallen,574,rogue,subtlety,24,6,18
Töbïï,sylvanas,573,rogue,subtlety,12,6,6
Sylvielle,azshara,573,rogue,subtlety,12,6,6
Eviroz,culte-de-la-rive-noire,573,rogue,subtlety,12,6,6
Sneakachu,thunderhorn,573,rogue,subtlety,18,6,12
Misamia,nemesis,573,rogue,subtlety,24,6,18
Shïbarï,ysondre,572,rogue,subtlety,12,6,6
Sundae,arthas,572,rogue,subtlety,24,6,18
Kaynasi,hyjal,572,rogue,subtlety,104,23,81
Wolffgang,dalaran,571,rogue,subtlety,12,6,6
Xargonis,blackrock,571,rogue,subtlety,18,6,12
Darkolive,defias-brotherhood,571,rogue,subtlety,19,6,13
Leukhra,dun-modr,570,rogue,subtlety,12,6,6
Demonrok,stormscale,569,rogue,subtlety,12,6,6
Lêvî,sanguino,569,rogue,subtlety,12,6,6
Frézzer,tirion,566,rogue,subtlety,12,6,6
Rhaacvar,magtheridon,566,rogue,subtlety,12,6,6
Cinimimi,magtheridon,560,rogue,subtlety,18,6,12
Grekén,bronze-dragonflight,558,rogue,subtlety,17,6,11
Sizzurp,kargath,555,rogue,subtlety,36,6,30
Lolstarrogue,ambossar,544,rogue,subtlety,10,6,4
Kathagô,antonidas,543,rogue,subtlety,17,6,11
Ежикх,soulflayer,543,rogue,subtlety,17,6,11
Roguy,wildhammer,543,rogue,subtlety,17,6,11
Marryhim,blackhand,543,rogue,subtlety,17,6,11
Килларан,howling-fjord,539,rogue,subtlety,8,7,1
Notwhaazz,ravencrest,528,rogue,subtlety,9,7,2
Hellborne,alakir,527,rogue,subtlety,15,6,9
Jaramshaela,cthun,521,rogue,subtlety,28,7,21
Forgettme,kazzak,511,rogue,subtlety,11,6,5
Malignance,drakthul,511,rogue,subtlety,14,7,7
Marcnk,stormscale,511,rogue,subtlety,16,6,10
Viiltäjäjack,stormscale,510,rogue,subtlety,14,6,8
Vanthir,drakthul,510,rogue,subtlety,31,7,24
Stepbaack,silvermoon,504,rogue,subtlety,18,6,12
Stealthr,silvermoon,495,rogue,subtlety,11,6,5
Ripinpiece,outland,494,rogue,subtlety,19,6,13
Scorpina,tarren-mill,483,rogue,subtlety,19,6,13
Deadrâw,aegwynn,480,rogue,subtlety,6,5,1
Dreltharius,burning-blade,480,rogue,subtlety,6,5,1
Rnkx,dun-modr,480,rogue,subtlety,6,5,1
Mastrmind,twisting-nether,480,rogue,subtlety,6,5,1
Deinorsin,outland,480,rogue,subtlety,6,5,1
Kongjemen,quelthalas,480,rogue,subtlety,6,5,1
Araniana,kazzak,480,rogue,subtlety,6,5,1
Rightplay,outland,480,rogue,subtlety,6,5,1
Фэйкуои,gordunni,480,rogue,subtlety,6,5,1
Equiper,silvermoon,480,rogue,subtlety,6,5,1
Аренатрюки,soulflayer,480,rogue,subtlety,6,5,1
Tinwee,ravencrest,480,rogue,subtlety,6,5,1
Stun,festung-der-stürme,480,rogue,subtlety,6,5,1
Storsnasen,frostmane,480,rogue,subtlety,6,5,1
Rvogue,draenor,480,rogue,subtlety,15,7,8
Mâriejânee,nozdormu,480,rogue,subtlety,12,5,7
Кмска,soulflayer,480,rogue,subtlety,12,5,7
Ingesa,blackhand,480,rogue,subtlety,12,5,7
Prseven,blackmoore,480,rogue,subtlety,12,5,7
Ра,gordunni,480,rogue,subtlety,12,5,7
Juxtapose,ravencrest,480,rogue,subtlety,12,5,7
Фрозеншедов,gordunni,480,rogue,subtlety,12,5,7
Орижигало,borean-tundra,480,rogue,subtlety,12,5,7
Notsuitable,blackhand,480,rogue,subtlety,12,5,7
Pyridoxin,blackmoore,480,rogue,subtlety,12,5,7
Iöny,silvermoon,480,rogue,subtlety,12,5,7
Poizen,steamwheedle-cartel,480,rogue,subtlety,12,5,7
Blazestórm,stormscale,480,rogue,subtlety,12,5,7
Mzaa,ravencrest,480,rogue,subtlety,12,5,7
Киднитучер,fordragon,480,rogue,subtlety,12,5,7
Xatra,hyjal,480,rogue,subtlety,12,5,7
Beyzqt,antonidas,480,rogue,subtlety,12,5,7
Mírai,sylvanas,480,rogue,subtlety,12,5,7
Okiboo,silvermoon,480,rogue,subtlety,12,5,7
Меттерз,gordunni,480,rogue,subtlety,12,5,7
Mesyo,blackhand,480,rogue,subtlety,12,5,7
Fabì,argent-dawn,480,rogue,subtlety,12,5,7
Srtumor,zuljin,480,rogue,subtlety,12,5,7
Snurry,tarren-mill,480,rogue,subtlety,12,5,7
Khepaso,sanguino,480,rogue,subtlety,12,5,7
Roguefarm,hyjal,480,rogue,subtlety,12,5,7
Ghrøm,hyjal,480,rogue,subtlety,12,5,7
Травметх,deathguard,480,rogue,subtlety,12,5,7
Soufraki,tarren-mill,480,rogue,subtlety,12,5,7
Chokee,blackrock,480,rogue,subtlety,12,5,7
ßuha,stormscale,480,rogue,subtlety,12,5,7
Protpaladin,sylvanas,480,rogue,subtlety,12,5,7
Thriva,blackmoore,480,rogue,subtlety,12,5,7
Nhonhonho,silvermoon,480,rogue,subtlety,12,5,7
Ticklzepickl,silvermoon,480,rogue,subtlety,12,5,7
Waakø,todeswache,480,rogue,subtlety,12,5,7
Rsksrb,tarren-mill,480,rogue,subtlety,12,5,7
Madboo,kazzak,480,rogue,subtlety,12,5,7
Radious,thrall,480,rogue,subtlety,12,5,7
Janx,aegwynn,480,rogue,subtlety,12,5,7
Xahl,ysondre,480,rogue,subtlety,12,5,7
Slicéndicé,wildhammer,480,rogue,subtlety,12,5,7
Gosleep,stormscale,480,rogue,subtlety,12,5,7
Obstechhawi,argent-dawn,480,rogue,subtlety,12,5,7
Кашеварить,gordunni,480,rogue,subtlety,12,5,7
Icdeadpixelz,ravencrest,480,rogue,subtlety,12,5,7
Muzkek,argent-dawn,480,rogue,subtlety,12,5,7
Альтушкаа,gordunni,480,rogue,subtlety,12,5,7
Aronie,stormreaver,480,rogue,subtlety,15,6,9
Loydleretour,hyjal,480,rogue,subtlety,15,5,10
Ajwenx,ravencrest,480,rogue,subtlety,18,5,13
Nohks,blackmoore,480,rogue,subtlety,18,5,13
Youngdolph,frostwolf,480,rogue,subtlety,18,5,13
Alyana,eldrethalas,480,rogue,subtlety,18,5,13
Ðefsmøkêz,tyrande,480,rogue,subtlety,18,5,13
Новиччокк,gordunni,480,rogue,subtlety,24,5,19
Skaúr,malganis,480,rogue,subtlety,24,5,19
Typhoo,ravencrest,480,rogue,subtlety,30,5,25
Инвесторша,gordunni,479,rogue,subtlety,6,5,1
Ruthraz,outland,479,rogue,subtlety,6,5,1
Conspirace,silvermoon,479,rogue,subtlety,12,5,7
Deadchivalry,argent-dawn,479,rogue,subtlety,12,5,7
Raizø,argent-dawn,479,rogue,subtlety,12,5,7
Grocco,doomhammer,479,rogue,subtlety,12,5,7
Giftdolken,outland,479,rogue,subtlety,12,5,7
Smorcoolio,stormscale,479,rogue,subtlety,12,5,7
Ryxon,arathor,479,rogue,subtlety,12,5,7
Tsakaloss,doomhammer,479,rogue,subtlety,12,5,7
Nøxia,hyjal,479,rogue,subtlety,12,5,7
Abrhykoo,hyjal,479,rogue,subtlety,12,5,7
Rydéordie,blackrock,479,rogue,subtlety,12,5,7
Smøth,ysondre,479,rogue,subtlety,15,6,9
Eléya,blackhand,479,rogue,subtlety,13,5,8
Пусирога,soulflayer,479,rogue,subtlety,18,5,13
Скэлд,ashenvale,479,rogue,subtlety,18,5,13
Zeroshadow,burning-legion,479,rogue,subtlety,18,5,13
Чекдесаута,gordunni,478,rogue,subtlety,12,5,7
Yuunr,kazzak,478,rogue,subtlety,12,5,7
Shadowstern,daggerspine,478,rogue,subtlety,12,5,7
Soulreapeer,twisting-nether,478,rogue,subtlety,21,6,15
Mozenn,draenor,478,rogue,subtlety,19,5,14
Delenor,stormscale,478,rogue,subtlety,24,5,19
Закраска,gordunni,478,rogue,subtlety,24,5,19
Эльтаэрон,gordunni,477,rogue,subtlety,12,5,7
Приколдэсса,gordunni,477,rogue,subtlety,18,5,13
Batonrouge,kazzak,476,rogue,subtlety,12,5,7
Injux,blackmoore,476,rogue,subtlety,12,5,7
Skeeto,blackmoore,476,rogue,subtlety,18,5,13
Drpsykose,tarren-mill,472,rogue,subtlety,12,5,7
Иордани,gordunni,467,rogue,subtlety,30,8,22
Scratcheye,twisting-nether,465,rogue,subtlety,24,5,19
Seltharion,outland,463,rogue,subtlety,11,5,6
Mamus,tarren-mill,461,rogue,subtlety,24,5,19
Кумаме,howling-fjord,447,rogue,subtlety,11,5,6
Foruu,tarren-mill,447,rogue,subtlety,11,5,6
Leselenrmax,archimonde,432,rogue,subtlety,15,5,10
Effitwo,nagrand,431,rogue,subtlety,11,5,6
Сексикаесу,soulflayer,431,rogue,subtlety,11,5,6
Iwillberone,ravencrest,431,rogue,subtlety,17,5,12
Gødmõdë,outland,426,rogue,subtlety,13,6,7
Asäp,archimonde,426,rogue,subtlety,21,7,14
Phaîne,outland,424,rogue,subtlety,16,7,9
Nastêe,archimonde,416,rogue,subtlety,10,5,5
Shalorai,ravencrest,416,rogue,subtlety,16,5,11
Itsforme,kazzak,415,rogue,subtlety,14,5,9
Xôár,aegwynn,400,rogue,subtlety,13,5,8
Bystroscy,silvermoon,398,rogue,subtlety,10,5,5
Algopyrin,ragnaros,396,rogue,subtlety,13,5,8
Мейнкеректер,gordunni,384,rogue,subtlety,6,4,2
Lilmort,ravencrest,384,rogue,subtlety,6,4,2
Stabbs,balnazzar,384,rogue,subtlety,6,4,2
Aneza,sylvanas,384,rogue,subtlety,6,4,2
Joelbiten,auchindoun,384,rogue,subtlety,6,4,2
Grens,kazzak,384,rogue,subtlety,6,4,2
Тенероби,soulflayer,384,rogue,subtlety,6,4,2
Néithyl,the-maelstrom,384,rogue,subtlety,6,4,2
Rakuwata,the-maelstrom,384,rogue,subtlety,6,4,2
Darx,sunstrider,384,rogue,subtlety,6,4,2
Jutsu,argent-dawn,384,rogue,subtlety,6,4,2
Краулен,blackscar,384,rogue,subtlety,6,4,2
Choclatéosol,archimonde,384,rogue,subtlety,6,4,2
Мум,blackscar,384,rogue,subtlety,6,4,2
Hook,malganis,384,rogue,subtlety,6,4,2
Áppíé,hellfire,384,rogue,subtlety,6,4,2
Xayý,der-rat-von-dalaran,384,rogue,subtlety,6,4,2
Rm,archimonde,384,rogue,subtlety,6,4,2
Blckrogue,bloodfeather,384,rogue,subtlety,6,4,2
Thefiller,ravencrest,384,rogue,subtlety,6,4,2
Seeralex,anetheron,384,rogue,subtlety,6,4,2
Ронаис,soulflayer,384,rogue,subtlety,6,4,2
Siele,twisting-nether,384,rogue,subtlety,6,4,2
Kushino,pozzo-delleternità,384,rogue,subtlety,6,4,2
Elegánt,ravencrest,384,rogue,subtlety,6,4,2
Cawzi,silvermoon,384,rogue,subtlety,6,4,2
Nøcturas,ambossar,384,rogue,subtlety,6,4,2
Sickbratan,aegwynn,384,rogue,subtlety,6,4,2
Лолнайт,blackscar,384,rogue,subtlety,6,4,2
Kazgaròth,draenor,384,rogue,subtlety,6,4,2
Echilly,tarren-mill,384,rogue,subtlety,6,4,2
Crystallake,dun-morogh,384,rogue,subtlety,6,4,2
Takiya,ysondre,384,rogue,subtlety,6,4,2
Freijasap,ravencrest,384,rogue,subtlety,6,4,2
Ipshero,ragnaros,384,rogue,subtlety,6,4,2
Lulune,frostmane,384,rogue,subtlety,6,4,2
Camora,aegwynn,384,rogue,subtlety,6,4,2
Ðazzrog,archimonde,384,rogue,subtlety,6,4,2
Rubberducky,argent-dawn,384,rogue,subtlety,6,4,2
Killcraft,anachronos,384,rogue,subtlety,6,4,2
Rîze,blackrock,384,rogue,subtlety,6,4,2
Mateew,drakthul,384,rogue,subtlety,6,4,2
Jaykerx,stormscale,384,rogue,subtlety,6,4,2
Крредоубийца,howling-fjord,384,rogue,subtlety,6,4,2
Pirateboi,blades-edge,384,rogue,subtlety,6,4,2
Møgzu,blackmoore,384,rogue,subtlety,6,4,2
Djnelly,stormreaver,384,rogue,subtlety,6,4,2
Tsuyoi,silvermoon,384,rogue,subtlety,6,4,2
Wrestlér,sylvanas,384,rogue,subtlety,6,4,2
Talayr,argent-dawn,384,rogue,subtlety,6,4,2
Nxnja,silvermoon,384,rogue,subtlety,6,4,2
Flygspark,tarren-mill,384,rogue,subtlety,6,4,2
Rogee,tarren-mill,384,rogue,subtlety,6,4,2
Körtel,tarren-mill,384,rogue,subtlety,6,4,2
Mentthe,hyjal,384,rogue,subtlety,6,4,2
Cleancl,blackhand,384,rogue,subtlety,6,4,2
Mol,defias-brotherhood,384,rogue,subtlety,6,4,2
Çløåk,outland,384,rogue,subtlety,6,4,2
Havitýx,ravencrest,384,rogue,subtlety,9,5,4
Yellowbanana,argent-dawn,384,rogue,subtlety,9,5,4
Zeelyx,ragnaros,384,rogue,subtlety,10,4,6
Pomstaa,tarren-mill,384,rogue,subtlety,12,4,8
Møve,blackhand,384,rogue,subtlety,12,4,8
Skaterboy,stormscale,384,rogue,subtlety,12,4,8
Макимак,howling-fjord,384,rogue,subtlety,12,4,8
Fusei,turalyon,384,rogue,subtlety,12,4,8
Rawbérry,aggramar,384,rogue,subtlety,12,4,8
Le,stormreaver,384,rogue,subtlety,12,4,8
Selecta,bloodhoof,384,rogue,subtlety,12,4,8
Jsprxo,stormscale,384,rogue,subtlety,12,4,8
Senorino,tarren-mill,384,rogue,subtlety,12,4,8
Ýýçyka,kazzak,384,rogue,subtlety,12,4,8
Enafdehvide,stormscale,384,rogue,subtlety,12,4,8
Saryotv,silvermoon,384,rogue,subtlety,12,4,8
Szabina,outland,384,rogue,subtlety,12,4,8
Noshivz,ragnaros,384,rogue,subtlety,12,4,8
Vaenerys,nemesis,384,rogue,subtlety,12,4,8
Аязлаая,blackscar,384,rogue,subtlety,12,4,8
Izzmonab,blackmoore,384,rogue,subtlety,12,4,8
Xanders,draenor,384,rogue,subtlety,12,4,8
Zèph,outland,384,rogue,subtlety,12,4,8
Hiddenbovine,twisting-nether,384,rogue,subtlety,12,4,8
Dévi,twisting-nether,384,rogue,subtlety,12,4,8
Ylidel,silvermoon,384,rogue,subtlety,12,4,8
Zedinger,azjolnerub,384,rogue,subtlety,12,4,8
Даняпрекринж,azuregos,384,rogue,subtlety,12,4,8
Retardèad,darksorrow,384,rogue,subtlety,12,4,8
Goblindrill,blackmoore,384,rogue,subtlety,12,4,8
Jokis,uldum,384,rogue,subtlety,12,4,8
Нунас,soulflayer,384,rogue,subtlety,12,4,8
Thesia,archimonde,384,rogue,subtlety,12,4,8
Puyopop,archimonde,384,rogue,subtlety,12,4,8
Милеса,soulflayer,384,rogue,subtlety,12,4,8
Taishani,thrall,384,rogue,subtlety,12,4,8
Lillajc,tarren-mill,384,rogue,subtlety,12,4,8
Вуцз,gordunni,384,rogue,subtlety,12,4,8
Rezhuloxov,silvermoon,384,rogue,subtlety,12,4,8
Kami,frostmane,384,rogue,subtlety,12,4,8
Fálke,dun-modr,384,rogue,subtlety,12,4,8
Battousai,burning-legion,384,rogue,subtlety,12,4,8
Fatedancer,outland,384,rogue,subtlety,12,4,8
Cringefemboy,blackrock,384,rogue,subtlety,12,4,8
Жорий,borean-tundra,384,rogue,subtlety,12,4,8
Klynatzz,draenor,384,rogue,subtlety,12,4,8
Очч,blackscar,384,rogue,subtlety,18,4,14
Plot,zenedar,384,rogue,subtlety,18,4,14
Galore,azjolnerub,384,rogue,subtlety,18,4,14
Vaelaestra,argent-dawn,384,rogue,subtlety,18,4,14
Undy,chromaggus,384,rogue,subtlety,18,4,14
Líl,outland,384,rogue,subtlety,18,4,14
Damiian,colinas-pardas,384,rogue,subtlety,24,4,20
Öz,sylvanas,383,rogue,subtlety,6,4,2
Vanishdotcom,blackrock,383,rogue,subtlety,6,4,2
Penita,aegwynn,383,rogue,subtlety,6,4,2
Tiemyrópe,outland,383,rogue,subtlety,6,4,2
Alovina,stormscale,383,rogue,subtlety,6,4,2
Ven,frostmane,383,rogue,subtlety,6,4,2
Саулите,deathguard,383,rogue,subtlety,10,4,6
Fintex,ravencrest,383,rogue,subtlety,12,4,8
Slicendicex,turalyon,383,rogue,subtlety,12,4,8
Helsperd,draenor,383,rogue,subtlety,12,4,8
Rayven,teldrassil,383,rogue,subtlety,12,4,8
Cangrë,dun-modr,383,rogue,subtlety,12,4,8
Vaipen,outland,383,rogue,subtlety,12,4,8
Berreboy,tarren-mill,383,rogue,subtlety,12,4,8
Clownshow,eredar,383,rogue,subtlety,12,4,8
Alyzon,ravencrest,383,rogue,subtlety,18,4,14
Grenouillard,chogall,383,rogue,subtlety,18,4,14
Bîgbîzeps,thrall,383,rogue,subtlety,30,4,26
Stabither,twisting-nether,382,rogue,subtlety,6,4,2
Sødï,khaz-modan,382,rogue,subtlety,6,4,2
Khatarshis,sanguino,382,rogue,subtlety,6,4,2
Belina,draenor,382,rogue,subtlety,6,4,2
Adelr,onyxia,382,rogue,subtlety,12,4,8
Zlash,doomhammer,381,rogue,subtlety,30,4,26
Nekros,chromaggus,379,rogue,subtlety,12,4,8
Чернаясоска,eversong,352,rogue,subtlety,10,4,6
Jinêxo,shattrath,351,rogue,subtlety,11,4,7
Korppari,draenor,335,rogue,subtlety,11,4,7
Xeløe,hyjal,330,rogue,subtlety,14,5,9
Lëmönhäzë,dun-modr,330,rogue,subtlety,17,5,12
Ronyarattig,tarren-mill,319,rogue,subtlety,8,4,4
Vinlol,blackrock,319,rogue,subtlety,8,4,4
Kanilol,eredar,319,rogue,subtlety,8,4,4
Стэйм,gordunni,303,rogue,subtlety,7,4,3
Opiïum,ysondre,303,rogue,subtlety,7,4,3
Tzc,argent-dawn,288,rogue,subtlety,6,3,3
Sporkieh,tarren-mill,288,rogue,subtlety,6,3,3
Кейнилин,gordunni,288,rogue,subtlety,6,3,3
Dumámày,kazzak,288,rogue,subtlety,6,3,3
Stælf,argent-dawn,288,rogue,subtlety,6,3,3
Загляденье,gordunni,288,rogue,subtlety,6,3,3
Imacelebrity,ravencrest,288,rogue,subtlety,6,3,3
Томасмразь,blackscar,288,rogue,subtlety,6,3,3
Hàly,ravencrest,288,rogue,subtlety,6,3,3
Checkormate,ravencrest,288,rogue,subtlety,6,3,3
Scythetwo,ravencrest,288,rogue,subtlety,6,3,3
Erised,ravencrest,288,rogue,subtlety,6,3,3
Zasty,drakthul,288,rogue,subtlety,6,3,3
Emilymeow,silvermoon,288,rogue,subtlety,6,3,3
Runár,proudmoore,288,rogue,subtlety,6,3,3
Gakha,draenor,288,rogue,subtlety,6,3,3
Flogue,area-52,288,rogue,subtlety,6,3,3
Крошувсалат,gordunni,288,rogue,subtlety,6,3,3
Scotlander,argent-dawn,288,rogue,subtlety,6,3,3
Shadxwstep,ravencrest,288,rogue,subtlety,6,3,3
Natsukage,blackmoore,288,rogue,subtlety,6,3,3
Хвангер,gordunni,288,rogue,subtlety,6,3,3
Finanzamtlg,blackrock,288,rogue,subtlety,6,3,3
Elsieboo,ravencrest,288,rogue,subtlety,6,3,3
Djpiglet,outland,288,rogue,subtlety,6,3,3
Nezukóchan,ravencrest,288,rogue,subtlety,6,3,3
Фуфломет,gordunni,288,rogue,subtlety,6,3,3
Вентури,borean-tundra,288,rogue,subtlety,6,3,3
Seregolas,argent-dawn,288,rogue,subtlety,6,3,3
Meel,dun-modr,288,rogue,subtlety,6,3,3
Triggersap,blackmoore,288,rogue,subtlety,6,3,3
Waakie,frostmane,288,rogue,subtlety,6,3,3
Cylizr,stormscale,288,rogue,subtlety,6,3,3
Exodian,aegwynn,288,rogue,subtlety,6,3,3
Киришима,blackscar,288,rogue,subtlety,6,3,3
Plshalpme,dun-modr,288,rogue,subtlety,6,3,3
Háhàháhàháhà,kazzak,288,rogue,subtlety,6,3,3
Vultzy,draenor,288,rogue,subtlety,6,3,3
Xhemil,tarren-mill,288,rogue,subtlety,6,3,3
Fredge,stormscale,288,rogue,subtlety,6,3,3
Corleoonee,archimonde,288,rogue,subtlety,6,3,3
Friyie,stormscale,288,rogue,subtlety,6,3,3
Smäshiboy,blackrock,288,rogue,subtlety,6,3,3
Geegeenoree,kazzak,288,rogue,subtlety,6,3,3
Goshîmoshî,stormscale,288,rogue,subtlety,6,3,3
Flêxô,antonidas,288,rogue,subtlety,6,3,3
Sethr,blackmoore,288,rogue,subtlety,6,3,3
Madita,frostmourne,288,rogue,subtlety,6,3,3
Nhèl,stormscale,288,rogue,subtlety,6,3,3
Sánta,tarren-mill,288,rogue,subtlety,6,3,3
Cimitir,kazzak,288,rogue,subtlety,6,3,3
Garou,blackhand,288,rogue,subtlety,6,3,3
Koopa,argent-dawn,288,rogue,subtlety,6,3,3
Crû,silvermoon,288,rogue,subtlety,6,3,3
Noxxra,blackhand,288,rogue,subtlety,6,3,3
Sholace,blackrock,288,rogue,subtlety,6,3,3
Macmurloc,hyjal,288,rogue,subtlety,6,3,3
Checkormate,aegwynn,288,rogue,subtlety,6,3,3
Barkai,kazzak,288,rogue,subtlety,6,3,3
Sâitama,zuljin,288,rogue,subtlety,6,3,3
Skrbke,tarren-mill,288,rogue,subtlety,6,3,3
Vanisshh,hyjal,288,rogue,subtlety,6,3,3
Pocketpaw,stormreaver,288,rogue,subtlety,6,3,3
Darkchomeur,archimonde,288,rogue,subtlety,6,3,3
Lycosidae,doomhammer,288,rogue,subtlety,6,3,3
Cigarette,emeriss,288,rogue,subtlety,6,3,3
Klexor,sylvanas,288,rogue,subtlety,6,3,3
Jhx,antonidas,288,rogue,subtlety,6,3,3
Stonecold,twilights-hammer,288,rogue,subtlety,6,3,3
Nerica,kazzak,288,rogue,subtlety,6,3,3
Rubjerg,blackrock,288,rogue,subtlety,6,3,3
Peeon,drakthul,288,rogue,subtlety,6,3,3
Sempya,archimonde,288,rogue,subtlety,6,3,3
Brzlik,stormscale,288,rogue,subtlety,6,3,3
Vxb,hyjal,288,rogue,subtlety,6,3,3
Mekóz,draenor,288,rogue,subtlety,6,3,3
Vexxey,magtheridon,288,rogue,subtlety,6,3,3
Pretylo,marécage-de-zangar,288,rogue,subtlety,6,3,3
Stepbro,kelthuzad,288,rogue,subtlety,6,3,3
Bumstuff,kilrogg,288,rogue,subtlety,6,3,3
Tiredpurple,dalaran,288,rogue,subtlety,6,3,3
Årtist,sanguino,288,rogue,subtlety,6,3,3
Flôky,twisting-nether,288,rogue,subtlety,6,3,3
Wizzo,onyxia,288,rogue,subtlety,6,3,3
Appelschorlê,eredar,288,rogue,subtlety,6,3,3
Ãkz,hyjal,288,rogue,subtlety,6,3,3
Sweetcc,amanthul,288,rogue,subtlety,6,3,3
Kejú,alleria,288,rogue,subtlety,6,3,3
Sáp,blackmoore,288,rogue,subtlety,6,3,3
Vïn,anachronos,288,rogue,subtlety,6,3,3
Vxgas,ragnaros,288,rogue,subtlety,6,3,3
Nìghtstørm,ravencrest,288,rogue,subtlety,6,3,3
Кеспул,soulflayer,288,rogue,subtlety,6,3,3
Cotta,silvermoon,288,rogue,subtlety,6,3,3
Altaux,nordrassil,288,rogue,subtlety,6,3,3
Deathfather,kazzak,288,rogue,subtlety,6,3,3
Келгар,soulflayer,288,rogue,subtlety,6,3,3
Neilyo,thrall,288,rogue,subtlety,6,3,3
Mótu,frostwolf,288,rogue,subtlety,6,3,3
Zaelÿ,archimonde,288,rogue,subtlety,6,3,3
Modzsz,zenedar,288,rogue,subtlety,6,3,3
Jawen,silvermoon,288,rogue,subtlety,6,3,3
Rontoxd,ragnaros,288,rogue,subtlety,6,3,3
Reawakened,darksorrow,288,rogue,subtlety,6,3,3
Sadgexd,draenor,288,rogue,subtlety,6,3,3
Shazam,zenedar,288,rogue,subtlety,6,3,3
Ezk,eredar,288,rogue,subtlety,6,3,3
Synthaetic,draenor,288,rogue,subtlety,6,3,3
Renyth,argent-dawn,288,rogue,subtlety,9,4,5
Ssjblacklolz,kaelthas,288,rogue,subtlety,9,4,5
Kaizaro,hyjal,288,rogue,subtlety,17,6,11
Babysteps,the-maelstrom,288,rogue,subtlety,12,4,8
Uareincombat,drakthul,288,rogue,subtlety,11,3,8
Shadowcraft,the-maelstrom,288,rogue,subtlety,12,3,9
Burdel,nemesis,288,rogue,subtlety,12,3,9
Монтанатони,eversong,288,rogue,subtlety,12,3,9
Xéshon,tarren-mill,288,rogue,subtlety,12,3,9
Nithrea,ravencrest,288,rogue,subtlety,12,3,9
Drunks,aegwynn,288,rogue,subtlety,12,3,9
Highestapm,archimonde,288,rogue,subtlety,12,3,9
Volyavolume,ravencrest,288,rogue,subtlety,12,3,9
Razcallz,arthas,288,rogue,subtlety,12,3,9
Kenchio,elune,288,rogue,subtlety,12,3,9
Pestctrl,argent-dawn,288,rogue,subtlety,12,3,9
Ñú,ravencrest,288,rogue,subtlety,12,3,9
Genesiz,sylvanas,288,rogue,subtlety,12,3,9
Schleichor,aegwynn,288,rogue,subtlety,12,3,9
Dayanir,aggra-português,288,rogue,subtlety,12,3,9
Luigitama,dun-modr,288,rogue,subtlety,12,3,9
Trytocapnoob,stormscale,288,rogue,subtlety,12,3,9
Boky,baelgun,288,rogue,subtlety,12,3,9
Hellhydra,draenor,288,rogue,subtlety,12,3,9
Vancleéf,sylvanas,288,rogue,subtlety,12,3,9
Thebestrogue,tarren-mill,288,rogue,subtlety,12,3,9
Louier,outland,288,rogue,subtlety,12,3,9
Hikorust,drakthul,288,rogue,subtlety,12,3,9
Savoie,kazzak,288,rogue,subtlety,12,3,9
Carnagè,dentarg,288,rogue,subtlety,12,3,9
Skíll,sanguino,288,rogue,subtlety,12,3,9
Воробнальщик,soulflayer,288,rogue,subtlety,12,3,9
Oczkune,burning-legion,288,rogue,subtlety,12,3,9
Bennyweth,argent-dawn,288,rogue,subtlety,12,3,9
Rufinol,twisting-nether,288,rogue,subtlety,12,3,9
Дзендэр,soulflayer,288,rogue,subtlety,12,3,9
Cabbagerolls,argent-dawn,288,rogue,subtlety,12,3,9
Rallzkens,stormscale,288,rogue,subtlety,12,3,9
Ragroh,burning-legion,288,rogue,subtlety,12,3,9
Durret,aggra-português,288,rogue,subtlety,12,3,9
Jawdropper,blackmoore,288,rogue,subtlety,12,3,9
Cbrook,sylvanas,288,rogue,subtlety,12,3,9
Ристоврация,gordunni,288,rogue,subtlety,12,3,9
Chililôl,dun-modr,288,rogue,subtlety,12,3,9
Zoldyck,bloodhoof,288,rogue,subtlety,12,3,9
Flaycesap,blackmoore,288,rogue,subtlety,12,3,9
Daunt,antonidas,288,rogue,subtlety,12,3,9
Romiel,ravencrest,288,rogue,subtlety,12,3,9
Kongnognog,ragnaros,288,rogue,subtlety,12,3,9
Remnus,silvermoon,288,rogue,subtlety,12,3,9
Apexpreditar,doomhammer,288,rogue,subtlety,12,3,9
Kïbs,dalaran,288,rogue,subtlety,12,3,9
Izame,archimonde,288,rogue,subtlety,12,3,9
Nÿst,khaz-modan,288,rogue,subtlety,12,3,9
Byaow,ravencrest,288,rogue,subtlety,12,3,9
Тимкок,soulflayer,288,rogue,subtlety,12,3,9
Alexius,kazzak,288,rogue,subtlety,13,3,10
Sinxgødx,outland,288,rogue,subtlety,18,3,15
Мутина,galakrond,288,rogue,subtlety,18,3,15
Lambine,mannoroth,288,rogue,subtlety,18,3,15
Мадарец,howling-fjord,288,rogue,subtlety,18,3,15
Etro,argent-dawn,288,rogue,subtlety,18,3,15
Silvano,zuljin,288,rogue,subtlety,24,3,21
Bú,nemesis,288,rogue,subtlety,24,3,21
Téhashcéé,archimonde,287,rogue,subtlety,6,3,3
Shåkø,tarren-mill,287,rogue,subtlety,6,3,3
Azhothz,argent-dawn,287,rogue,subtlety,6,3,3
Stabsy,stormscale,287,rogue,subtlety,6,3,3
Hëather,confrérie-du-thorium,287,rogue,subtlety,6,3,3
Icècôld,blackmoore,287,rogue,subtlety,6,3,3
Ilailafruit,quelthalas,287,rogue,subtlety,9,4,5
Styggvanas,tarren-mill,287,rogue,subtlety,15,4,11
Boxxo,dun-modr,287,rogue,subtlety,15,4,11
Котуй,borean-tundra,287,rogue,subtlety,12,3,9
Боузи,howling-fjord,287,rogue,subtlety,12,3,9
Djsapblindx,archimonde,287,rogue,subtlety,18,3,15
Furrooscuro,sanguino,287,rogue,subtlety,18,3,15
Celenium,chogall,287,rogue,subtlety,24,3,21
Kausa,dun-modr,286,rogue,subtlety,6,3,3
Sombrafina,tyrande,286,rogue,subtlety,6,3,3
Jontor,deathwing,286,rogue,subtlety,12,3,9
Killboom,rexxar,286,rogue,subtlety,18,3,15
Fatzaky,turalyon,274,rogue,subtlety,31,7,24
Iuun,hyjal,271,rogue,subtlety,17,3,14
Strayda,kazzak,265,rogue,subtlety,18,5,13
Deded,argent-dawn,256,rogue,subtlety,10,3,7
Madlain,jaedenar,255,rogue,subtlety,8,4,4
Domiqs,blackhand,255,rogue,subtlety,8,4,4
Jimlostson,dun-modr,239,rogue,subtlety,5,3,2
Trinketeflag,archimonde,239,rogue,subtlety,5,3,2
Pinnar,blackmoore,234,rogue,subtlety,8,4,4
Shadôwcraft,outland,234,rogue,subtlety,8,4,4
Köna,archimonde,234,rogue,subtlety,15,6,9
Vii,defias-brotherhood,234,rogue,subtlety,13,5,8
Nïhal,suramar,234,rogue,subtlety,14,4,10
Persës,ravencrest,223,rogue,subtlety,8,3,5
Piperx,ravencrest,223,rogue,subtlety,8,3,5
Ggyoulowbro,blackmoore,208,rogue,subtlety,7,3,4
Rhaiku,tarren-mill,192,rogue,subtlety,9,4,5
Loom,sylvanas,192,rogue,subtlety,9,3,6
Совечица,gordunni,192,rogue,subtlety,9,3,6
Rhaaxx,hyjal,192,rogue,subtlety,6,2,4
Nbzz,hyjal,192,rogue,subtlety,6,2,4
Voices,dentarg,192,rogue,subtlety,6,2,4
Ksunq,hyjal,192,rogue,subtlety,6,2,4
Lyaà,dun-morogh,192,rogue,subtlety,6,2,4
Elthalulz,illidan,192,rogue,subtlety,6,2,4
Sqc,ravencrest,192,rogue,subtlety,6,2,4
Alacarda,draenor,192,rogue,subtlety,6,2,4
Flynnzer,hyjal,192,rogue,subtlety,6,2,4
Malvaxxs,tarren-mill,192,rogue,subtlety,6,2,4
Namw,draenor,192,rogue,subtlety,6,2,4
Bleix,sanguino,192,rogue,subtlety,6,2,4
Yugi,zuljin,192,rogue,subtlety,6,2,4
Øoøoøoø,drakthul,192,rogue,subtlety,6,2,4
Rumbling,stormreaver,192,rogue,subtlety,6,2,4
Meÿ,archimonde,192,rogue,subtlety,6,2,4
Censørd,steamwheedle-cartel,192,rogue,subtlety,6,2,4
Redwinter,sylvanas,192,rogue,subtlety,6,2,4
Brazi,dalaran,192,rogue,subtlety,6,2,4
Sohnisch,azshara,192,rogue,subtlety,6,2,4
Latravia,blackhand,192,rogue,subtlety,6,2,4
Heraa,kaelthas,192,rogue,subtlety,6,2,4
Rehab,draenor,192,rogue,subtlety,6,2,4
Stealthyist,darkmoon-faire,192,rogue,subtlety,6,2,4
Kyupi,hyjal,192,rogue,subtlety,6,2,4
Navaton,sanguino,192,rogue,subtlety,6,2,4
Blackrabbít,azshara,192,rogue,subtlety,6,2,4
Рогаупорога,howling-fjord,192,rogue,subtlety,6,2,4
Watzoqt,archimonde,192,rogue,subtlety,6,2,4
Blóodless,stormscale,192,rogue,subtlety,6,2,4
Fonss,sanguino,192,rogue,subtlety,6,2,4
Lenây,blackmoore,192,rogue,subtlety,6,2,4
Miisterkaka,stormscale,192,rogue,subtlety,6,2,4
Wrathed,stormreaver,192,rogue,subtlety,6,2,4
Sapyøu,tarren-mill,192,rogue,subtlety,6,2,4
Brinvilliers,aegwynn,192,rogue,subtlety,6,2,4
Schadostep,archimonde,192,rogue,subtlety,6,2,4
Колстар,howling-fjord,192,rogue,subtlety,6,2,4
Рикимартини,gordunni,192,rogue,subtlety,6,2,4
Блимкинг,soulflayer,192,rogue,subtlety,6,2,4
Chéat,stormscale,192,rogue,subtlety,6,2,4
Ackyrogue,ysondre,192,rogue,subtlety,6,2,4
Голадриель,gordunni,192,rogue,subtlety,6,2,4
Вэндиго,deathweaver,192,rogue,subtlety,6,2,4
Xwb,sanguino,192,rogue,subtlety,6,2,4
Venomblood,sanguino,192,rogue,subtlety,6,2,4
Mimorion,blackhand,192,rogue,subtlety,6,2,4
Sethrevenn,ragnaros,192,rogue,subtlety,6,2,4
Sizzla,die-nachtwache,192,rogue,subtlety,6,2,4
Tinkié,stormscale,192,rogue,subtlety,6,2,4
Qoxinyohas,stormscale,192,rogue,subtlety,6,2,4
Каверзати,howling-fjord,192,rogue,subtlety,6,2,4
Subaslaw,ravencrest,192,rogue,subtlety,6,2,4
Mdvmachines,nemesis,192,rogue,subtlety,6,2,4
Rasponi,ragnaros,192,rogue,subtlety,6,2,4
Nefqq,stormscale,192,rogue,subtlety,6,2,4
Jpi,ragnaros,192,rogue,subtlety,6,2,4
Epidemic,stormscale,192,rogue,subtlety,6,2,4
Скиррона,gordunni,192,rogue,subtlety,6,2,4
Скивс,soulflayer,192,rogue,subtlety,6,2,4
Ît,stormscale,192,rogue,subtlety,6,2,4
Lucifas,antonidas,192,rogue,subtlety,6,2,4
Pøggerhontas,antonidas,192,rogue,subtlety,6,2,4
Гамбиит,gordunni,192,rogue,subtlety,6,2,4
Madivy,ragnaros,192,rogue,subtlety,6,2,4
Canelitae,minahonda,192,rogue,subtlety,6,2,4
Middlesneak,outland,192,rogue,subtlety,6,2,4
Asasina,los-errantes,192,rogue,subtlety,6,2,4
Stepdead,tarren-mill,192,rogue,subtlety,6,2,4
Hade,stormscale,192,rogue,subtlety,6,2,4
Phantazma,ravencrest,192,rogue,subtlety,6,2,4
Poerta,burning-blade,192,rogue,subtlety,6,2,4
Fakeroguex,outland,192,rogue,subtlety,6,2,4
Tipsydagger,twisting-nether,192,rogue,subtlety,6,2,4
Zuckmicekoc,ravencrest,192,rogue,subtlety,6,2,4
Brojenson,ravencrest,192,rogue,subtlety,6,2,4
Grvvxyvrd,sanguino,192,rogue,subtlety,6,2,4
Czêro,grim-batol,192,rogue,subtlety,6,2,4
Creepydude,burning-legion,192,rogue,subtlety,6,2,4
Múgala,outland,192,rogue,subtlety,6,2,4
Stigh,twisting-nether,192,rogue,subtlety,6,2,4
Фораст,gordunni,192,rogue,subtlety,6,2,4
Zte,frostmane,192,rogue,subtlety,6,2,4
Feylia,terenas,192,rogue,subtlety,6,2,4
Cptnyac,tarren-mill,192,rogue,subtlety,6,2,4
Harmawz,archimonde,192,rogue,subtlety,6,2,4
Медиивэл,deepholm,192,rogue,subtlety,6,2,4
Enoìla,blackmoore,192,rogue,subtlety,6,2,4
Juutalainen,tarren-mill,192,rogue,subtlety,6,2,4
Sháde,zuljin,192,rogue,subtlety,6,2,4
Mècr,outland,192,rogue,subtlety,6,2,4
Yulitz,dun-modr,192,rogue,subtlety,6,2,4
Ноумингод,gordunni,192,rogue,subtlety,6,2,4
Снэбак,soulflayer,192,rogue,subtlety,6,2,4
Хамарсон,gordunni,192,rogue,subtlety,6,2,4
Яматсуми,gordunni,192,rogue,subtlety,6,2,4
Inviscuz,draenor,192,rogue,subtlety,6,2,4
Jæto,ravencrest,192,rogue,subtlety,6,2,4
Shepotunzxc,ravencrest,192,rogue,subtlety,6,2,4
Flexberg,the-maelstrom,192,rogue,subtlety,6,2,4
Turbocandle,ravencrest,192,rogue,subtlety,6,2,4
Brainwash,the-maelstrom,192,rogue,subtlety,6,2,4
Унижака,deathguard,192,rogue,subtlety,6,2,4
Trixster,aggramar,192,rogue,subtlety,6,2,4
Sigleif,argent-dawn,192,rogue,subtlety,6,2,4
Evilbiscuit,quelthalas,192,rogue,subtlety,6,2,4
Jinzuto,outland,192,rogue,subtlety,6,2,4
Excelsiôr,blackmoore,192,rogue,subtlety,6,2,4
Medievh,sanguino,192,rogue,subtlety,6,2,4
Бигидипс,eversong,192,rogue,subtlety,6,2,4
Webouge,blackmoore,192,rogue,subtlety,6,2,4
Kìnsley,archimonde,192,rogue,subtlety,6,2,4
Stepkickgodx,blackmoore,192,rogue,subtlety,6,2,4
Голдмак,eversong,192,rogue,subtlety,6,2,4
Azulérà,elune,192,rogue,subtlety,6,2,4
Rilöded,ravencrest,192,rogue,subtlety,6,2,4
Bambuso,ravencrest,192,rogue,subtlety,6,2,4
Niha,ravencrest,192,rogue,subtlety,6,2,4
Gameøvr,sanguino,192,rogue,subtlety,6,2,4
Revisiôn,tarren-mill,192,rogue,subtlety,6,2,4
Misimisi,sanguino,192,rogue,subtlety,6,2,4
Dròól,kazzak,192,rogue,subtlety,6,2,4
Dhayna,shendralar,192,rogue,subtlety,6,2,4
Lictilsmulic,kirin-tor,192,rogue,subtlety,6,2,4
Valyona,silvermoon,192,rogue,subtlety,6,2,4
Nichrome,silvermoon,192,rogue,subtlety,6,2,4
Striçken,silvermoon,192,rogue,subtlety,6,2,4
Luccea,silvermoon,192,rogue,subtlety,6,2,4
Knezr,silvermoon,192,rogue,subtlety,6,2,4
Cowwithknife,silvermoon,192,rogue,subtlety,6,2,4
Giftknirps,silvermoon,192,rogue,subtlety,6,2,4
Enthuque,draenor,192,rogue,subtlety,6,2,4
Steálth,silvermoon,192,rogue,subtlety,6,2,4
Ssoeyjrjr,kazzak,192,rogue,subtlety,6,2,4
Xyil,kazzak,192,rogue,subtlety,6,2,4
Leviathann,doomhammer,192,rogue,subtlety,6,2,4
Aëlynn,la-croisade-écarlate,192,rogue,subtlety,6,2,4
Recondite,doomhammer,192,rogue,subtlety,6,2,4
Pxsquals,kazzak,192,rogue,subtlety,6,2,4
Ratkebab,silvermoon,192,rogue,subtlety,11,3,8
Greiskull,cthun,192,rogue,subtlety,15,3,12
Acheravar,antonidas,192,rogue,subtlety,12,2,10
Strit,outland,192,rogue,subtlety,12,2,10
Shaklyn,antonidas,192,rogue,subtlety,12,2,10
Sylaba,burning-legion,192,rogue,subtlety,12,2,10
Jackpot,sargeras,192,rogue,subtlety,12,2,10
Découpeur,hyjal,192,rogue,subtlety,12,2,10
Cøsmøz,dalaran,192,rogue,subtlety,12,2,10
Câptcâp,twisting-nether,192,rogue,subtlety,12,2,10
Könän,dalaran,192,rogue,subtlety,12,2,10
Thurgodd,silvermoon,192,rogue,subtlety,12,2,10
Милкаа,deathguard,192,rogue,subtlety,12,2,10
Килрилон,lich-king,192,rogue,subtlety,12,2,10
Kateria,sanguino,192,rogue,subtlety,12,2,10
Weworog,drakthul,192,rogue,subtlety,12,2,10
Mirekk,silvermoon,192,rogue,subtlety,12,2,10
Pandagonstab,shadowsong,192,rogue,subtlety,12,2,10
Zongshroud,archimonde,192,rogue,subtlety,12,2,10
Падинайди,howling-fjord,192,rogue,subtlety,12,2,10
Bauwten,ravencrest,192,rogue,subtlety,12,2,10
Кингксу,gordunni,192,rogue,subtlety,12,2,10
Gorkamorki,stormscale,192,rogue,subtlety,12,2,10
Shènzo,tarren-mill,192,rogue,subtlety,12,2,10
Tàazz,archimonde,192,rogue,subtlety,12,2,10
Deróthus,arathor,192,rogue,subtlety,12,2,10
Wxlf,ravencrest,192,rogue,subtlety,12,2,10
Verstopt,azjolnerub,192,rogue,subtlety,12,2,10
Erèlenn,draenor,192,rogue,subtlety,12,2,10
Waistêd,ravencrest,192,rogue,subtlety,12,2,10
Ordwin,silvermoon,192,rogue,subtlety,12,2,10
Destrektor,kazzak,192,rogue,subtlety,12,2,10
Nomad,sylvanas,192,rogue,subtlety,12,2,10
Shacopaco,zuljin,192,rogue,subtlety,12,2,10
Snupzy,kazzak,192,rogue,subtlety,12,2,10
Monster,kazzak,192,rogue,subtlety,12,2,10
Grogun,tyrande,192,rogue,subtlety,14,2,12
Antomen,sylvanas,192,rogue,subtlety,18,2,16
Afrodittan,dun-modr,192,rogue,subtlety,22,2,20
Jõsi,dalaran,192,rogue,subtlety,24,2,22
Fenrirsson,stormscale,191,rogue,subtlety,6,2,4
Moustache,outland,191,rogue,subtlety,6,2,4
Geomy,minahonda,191,rogue,subtlety,12,2,10
Røsenstërn,ravencrest,191,rogue,subtlety,12,2,10
Deathrow,nethersturm,191,rogue,subtlety,18,2,16
Cutscene,argent-dawn,159,rogue,subtlety,5,2,3
Julekos,ravenholdt,159,rogue,subtlety,5,2,3
Гароона,blackscar,159,rogue,subtlety,5,2,3
Shlaifa,ragnaros,144,rogue,subtlety,9,2,7
Dawz,malganis,138,rogue,subtlety,10,4,6
Projectindex,malganis,138,rogue,subtlety,10,4,6
Bacheline,antonidas,138,rogue,subtlety,9,3,6
Omegacry,dun-modr,138,rogue,subtlety,10,3,7
Macon,arthas,138,rogue,subtlety,18,4,14
Núb,burning-blade,138,rogue,subtlety,15,3,12
Earnedblood,kazzak,128,rogue,subtlety,4,2,2
Zaintsas,tarren-mill,128,rogue,subtlety,4,2,2
Quînox,archimonde,128,rogue,subtlety,4,2,2
Эвенгорн,gordunni,128,rogue,subtlety,10,2,8
Pâzlîght,perenolde,127,rogue,subtlety,8,2,6
Cälisto,drakthul,121,rogue,subtlety,13,5,8
Cornvus,burning-legion,112,rogue,subtlety,7,2,5
Pzylol,anetheron,96,rogue,subtlety,3,2,1
Krippie,thunderhorn,96,rogue,subtlety,3,2,1
Penetrantwo,eredar,96,rogue,subtlety,3,2,1
Behemothr,kazzak,96,rogue,subtlety,6,1,5
Элонли,gordunni,96,rogue,subtlety,6,1,5
Maedyv,magtheridon,96,rogue,subtlety,6,1,5
Гриксон,blackscar,96,rogue,subtlety,6,1,5
Kâyato,ysondre,96,rogue,subtlety,6,1,5
Unshaken,dun-modr,96,rogue,subtlety,6,1,5
Persecution,nemesis,96,rogue,subtlety,6,1,5
Outride,outland,96,rogue,subtlety,6,1,5
Seihend,zuljin,96,rogue,subtlety,6,1,5
Гламурятина,gordunni,96,rogue,subtlety,6,1,5
Faso,thunderhorn,96,rogue,subtlety,6,1,5
Àrléngødx,kazzak,96,rogue,subtlety,6,1,5
Gögel,draenor,96,rogue,subtlety,6,1,5
Theone,sanguino,96,rogue,subtlety,6,1,5
Satlol,outland,96,rogue,subtlety,6,1,5
Ótsutsukí,kazzak,96,rogue,subtlety,6,1,5
Urbanck,kazzak,96,rogue,subtlety,6,1,5
Ålûñàhlulz,kilrogg,96,rogue,subtlety,6,1,5
Niceflmqt,thrall,96,rogue,subtlety,6,1,5
Настябэкстаб,gordunni,96,rogue,subtlety,6,1,5
Skruffles,grim-batol,96,rogue,subtlety,6,1,5
Une,quelthalas,96,rogue,subtlety,6,1,5
Кикбезкд,gordunni,96,rogue,subtlety,6,1,5
Grimson,kazzak,96,rogue,subtlety,6,1,5
Оптимально,soulflayer,96,rogue,subtlety,6,1,5
Qikerip,drekthar,96,rogue,subtlety,6,1,5
Bloogue,silvermoon,96,rogue,subtlety,6,1,5
Бамболейлоо,grom,96,rogue,subtlety,6,1,5
Søn,draenor,96,rogue,subtlety,6,1,5
Стронг,soulflayer,96,rogue,subtlety,6,1,5
Lefugitif,archimonde,96,rogue,subtlety,6,1,5
Allydede,blackmoore,96,rogue,subtlety,6,1,5
Théyzha,kazzak,96,rogue,subtlety,6,1,5
Lixht,the-maelstrom,96,rogue,subtlety,6,1,5
Selfcut,blackmoore,96,rogue,subtlety,6,1,5
Nuguri,blackrock,96,rogue,subtlety,6,1,5
Кишкумэн,ashenvale,96,rogue,subtlety,6,1,5
Targram,hyjal,96,rogue,subtlety,6,1,5
Førtñîtégøðx,eredar,96,rogue,subtlety,6,1,5
Sephirøthh,hyjal,96,rogue,subtlety,6,1,5
Mattyc,bronze-dragonflight,96,rogue,subtlety,6,1,5
Loulina,outland,96,rogue,subtlety,6,1,5
Nyhana,blackmoore,96,rogue,subtlety,6,1,5
Arishem,burning-legion,96,rogue,subtlety,6,1,5
Deccosneak,defias-brotherhood,96,rogue,subtlety,6,1,5
Bellarìa,hyjal,96,rogue,subtlety,6,1,5
Coldbloodxx,twisting-nether,96,rogue,subtlety,6,1,5
Depleter,outland,96,rogue,subtlety,6,1,5
Klingo,defias-brotherhood,96,rogue,subtlety,6,1,5
Lättja,hyjal,96,rogue,subtlety,6,1,5
Amý,grim-batol,96,rogue,subtlety,6,1,5
Grinchfurtif,hyjal,96,rogue,subtlety,6,1,5
Korteina,darkmoon-faire,96,rogue,subtlety,6,1,5
Shirike,kirin-tor,96,rogue,subtlety,6,1,5
Trxë,twisting-nether,96,rogue,subtlety,6,1,5
Casp,gorgonnash,96,rogue,subtlety,6,1,5
Kolbass,ragnaros,96,rogue,subtlety,6,1,5
Sunyshahko,doomhammer,96,rogue,subtlety,6,1,5
Nerkmind,ragnaros,96,rogue,subtlety,6,1,5
Sørä,ragnaros,96,rogue,subtlety,6,1,5
Knockyz,khaz-modan,96,rogue,subtlety,6,1,5
Vellira,khaz-modan,96,rogue,subtlety,6,1,5
Dancewithme,arthas,96,rogue,subtlety,6,1,5
Nurycho,twisting-nether,96,rogue,subtlety,6,1,5
Sumcrit,ravencrest,96,rogue,subtlety,6,1,5
Xlover,silvermoon,96,rogue,subtlety,6,1,5
Zerøskil,antonidas,96,rogue,subtlety,6,1,5
Félblade,outland,96,rogue,subtlety,6,1,5
Ôrígìnälnezo,drakthul,96,rogue,subtlety,6,1,5
Clownsap,blackhand,96,rogue,subtlety,6,1,5
Toskle,drakthul,96,rogue,subtlety,6,1,5
Cutegirlxx,outland,96,rogue,subtlety,6,1,5
Kkraken,dalaran,96,rogue,subtlety,6,1,5
Proesis,ravencrest,96,rogue,subtlety,6,1,5
Drkidney,malfurion,96,rogue,subtlety,6,1,5
Szybkora,silvermoon,96,rogue,subtlety,6,1,5
Synsinte,silvermoon,96,rogue,subtlety,6,1,5
Ñøøß,tarren-mill,96,rogue,subtlety,6,1,5
Røcket,festung-der-stürme,96,rogue,subtlety,6,1,5
Orcrogue,khadgar,96,rogue,subtlety,6,1,5
Naizo,doomhammer,96,rogue,subtlety,6,1,5
Рэйзакх,howling-fjord,96,rogue,subtlety,6,1,5
Impostér,tarren-mill,96,rogue,subtlety,6,1,5
Аквик,howling-fjord,96,rogue,subtlety,6,1,5
Cinque,das-konsortium,96,rogue,subtlety,6,1,5
Тварьебаная,howling-fjord,96,rogue,subtlety,6,1,5
Ôeuf,ravencrest,96,rogue,subtlety,6,1,5
Щасбудетвайп,howling-fjord,96,rogue,subtlety,6,1,5
Lavanda,outland,96,rogue,subtlety,6,1,5
Rûniç,draenor,96,rogue,subtlety,6,1,5
Aasy,silvermoon,96,rogue,subtlety,6,1,5
Teldruil,illidan,96,rogue,subtlety,6,1,5
Chøsen,stormscale,96,rogue,subtlety,6,1,5
Retaya,draenor,96,rogue,subtlety,6,1,5
Menzo,ravencrest,96,rogue,subtlety,6,1,5
Yaelynn,argent-dawn,96,rogue,subtlety,6,1,5
Tzsub,blackhand,96,rogue,subtlety,6,1,5
Letheus,stormscale,96,rogue,subtlety,6,1,5
Llamiryl,ravencrest,96,rogue,subtlety,6,1,5
Tyranoxoth,stormscale,96,rogue,subtlety,6,1,5
Øpti,ravencrest,96,rogue,subtlety,6,1,5
Lookbehindu,stormscale,96,rogue,subtlety,6,1,5
Malborko,ravencrest,96,rogue,subtlety,6,1,5
Azryel,tarren-mill,96,rogue,subtlety,6,1,5
Nixze,tarren-mill,96,rogue,subtlety,6,1,5
Maybejaydeen,ravencrest,96,rogue,subtlety,6,1,5
Lotthbrok,uldum,96,rogue,subtlety,12,1,11
Azzineth,silvermoon,96,rogue,subtlety,12,1,11
Sprayze,doomhammer,96,rogue,subtlety,12,1,11
Nønchalan,twisting-nether,96,rogue,subtlety,12,1,11
Critneyspear,runetotem,96,rogue,subtlety,12,1,11
Taniks,cthun,96,rogue,subtlety,12,1,11
Bhabì,uldaman,96,rogue,subtlety,12,1,11
Darkkstep,blackmoore,96,rogue,subtlety,12,1,11
Альдинг,howling-fjord,96,rogue,subtlety,12,1,11
Sanguinea,minahonda,96,rogue,subtlety,12,1,11
Gífti,norgannon,96,rogue,subtlety,12,1,11
Alefon,sanguino,96,rogue,subtlety,12,1,11
Stabie,twisting-nether,96,rogue,subtlety,12,1,11
Calmrusgirl,ravenholdt,96,rogue,subtlety,12,1,11
Imbazed,azshara,96,rogue,subtlety,12,1,11
Дивеас,blackscar,96,rogue,subtlety,12,1,11
Velouría,silvermoon,96,rogue,subtlety,12,1,11
Gassenjunge,blackhand,96,rogue,subtlety,18,1,17
Xý,ysondre,96,rogue,subtlety,18,1,17
Swexlairone,outland,95,rogue,subtlety,12,1,11
Deadpull,shadowsong,95,rogue,subtlety,24,1,23
Howhigh,stormscale,89,rogue,subtlety,7,3,4
Swifty,frostmourne,84,rogue,subtlety,24,6,18
Chabelita,ravencrest,79,rogue,subtlety,5,1,4
Coopér,argent-dawn,79,rogue,subtlety,5,1,4
Ulaküí,zuljin,79,rogue,subtlety,5,1,4
Nesth,silvermoon,79,rogue,subtlety,5,1,4
Ssebii,terokkar,64,rogue,subtlety,4,1,3
Wenok,kazzak,64,rogue,subtlety,4,1,3
Kneebiter,darkmoon-faire,64,rogue,subtlety,10,1,9
Shurký,blackmoore,63,rogue,subtlety,2,2,0
Vanishkey,dun-modr,63,rogue,subtlety,2,2,0
Failtastic,defias-brotherhood,63,rogue,subtlety,2,2,0
Albumx,archimonde,58,rogue,subtlety,8,3,5
Glebels,burning-legion,48,rogue,subtlety,3,1,2
Ddlcmg,drakthul,48,rogue,subtlety,3,1,2
Uùr,burning-legion,48,rogue,subtlety,5,1,4
Secaboo,eredar,42,rogue,subtlety,6,2,4
Hz,marécage-de-zangar,42,rogue,subtlety,10,2,8
Kaylonetc,kazzak,42,rogue,subtlety,10,2,8
Strânge,tarren-mill,41,rogue,subtlety,7,2,5
Danmoretti,drakthul,31,rogue,subtlety,2,1,1
Defrieder,ravencrest,31,rogue,subtlety,2,1,1
Shadowhelm,silvermoon,31,rogue,subtlety,8,1,7
Nællya,archimonde,16,rogue,subtlety,1,1,0
Vlkyria,silvermoon,16,rogue,subtlety,13,1,12
Mortecieca,ravencrest,2281,rogue,assassination,209,110,99
Ewyna,silvermoon,2280,rogue,assassination,147,81,66
Mentol,stormscale,2229,rogue,assassination,113,78,35
Asàd,draenor,2197,rogue,assassination,111,57,54
Aæ,stormscale,2196,rogue,assassination,143,77,66
Sub,kazzak,2192,rogue,assassination,236,119,117
Shadenax,ravencrest,2149,rogue,assassination,78,42,36
Rãz,stormscale,2148,rogue,assassination,84,44,40
Rightplay,outland,2143,rogue,assassination,96,49,47
Shadeniz,ravencrest,2137,rogue,assassination,113,57,56
Fánsly,silvermoon,2120,rogue,assassination,102,53,49
Shadenox,ravencrest,2113,rogue,assassination,592,294,298
Heavý,argent-dawn,2111,rogue,assassination,157,82,75
Naláa,ravencrest,2107,rogue,assassination,88,45,43
Bestjkbetter,ravencrest,2093,rogue,assassination,141,70,71
Blindlol,emerald-dream,2086,rogue,assassination,307,168,139
Томасмразь,blackscar,2046,rogue,assassination,114,54,60
Shadekin,ravencrest,2004,rogue,assassination,135,72,63
Tyreall,drakthul,1991,rogue,assassination,190,96,94
Icdeadpixelz,ysondre,1980,rogue,assassination,78,37,41
Pyridoxin,blackmoore,1978,rogue,assassination,270,134,136
Chínerox,thunderhorn,1948,rogue,assassination,636,318,318
Visuáls,antonidas,1939,rogue,assassination,93,41,52
Shadeco,ravencrest,1938,rogue,assassination,108,49,59
Watchmeyoe,ravencrest,1918,rogue,assassination,83,47,36
Lookåtme,ravencrest,1911,rogue,assassination,187,93,94
Aknana,vashj,1911,rogue,assassination,89,43,46
Venomblood,sanguino,1907,rogue,assassination,119,57,62
Vulrin,argent-dawn,1899,rogue,assassination,77,44,33
Buffassa,ravencrest,1887,rogue,assassination,143,81,62
Myk,xavius,1883,rogue,assassination,34,21,13
Bytoku,chants-éternels,1882,rogue,assassination,116,59,57
Botsrogue,kazzak,1868,rogue,assassination,42,24,18
Årtist,sanguino,1866,rogue,assassination,72,37,35
Pøóçhgøðx,archimonde,1857,rogue,assassination,59,31,28
Rivia,stormscale,1850,rogue,assassination,102,51,51
Civarea,blackrock,1849,rogue,assassination,63,29,34
Vayyel,silvermoon,1846,rogue,assassination,379,187,192
Hèffer,outland,1839,rogue,assassination,180,96,84
Prei,hyjal,1839,rogue,assassination,96,49,47
Baboonx,burning-legion,1839,rogue,assassination,72,31,41
Grøax,ragnaros,1837,rogue,assassination,89,42,47
Ohdaesu,aegwynn,1837,rogue,assassination,162,74,88
Oggish,tarren-mill,1832,rogue,assassination,90,35,55
Cntrlld,ravencrest,1829,rogue,assassination,66,30,36
Yepuwuyepowo,defias-brotherhood,1827,rogue,assassination,90,47,43
Snøv,outland,1826,rogue,assassination,151,65,86
Stepchildx,uldum,1818,rogue,assassination,194,121,73
Скварлет,howling-fjord,1818,rogue,assassination,66,30,36
Sadgexd,draenor,1814,rogue,assassination,52,26,26
Redcutter,silvermoon,1813,rogue,assassination,52,25,27
Rubberducky,argent-dawn,1811,rogue,assassination,36,25,11
Изифаза,deathguard,1811,rogue,assassination,97,47,50
Пожилойпуп,gordunni,1811,rogue,assassination,54,26,28
Shipshot,blackrock,1809,rogue,assassination,62,37,25
Lildretch,dun-morogh,1808,rogue,assassination,63,35,28
Çhïñêsémøñkè,argent-dawn,1808,rogue,assassination,244,131,113
Afto,argent-dawn,1804,rogue,assassination,114,51,63
Getownédyo,aggramar,1803,rogue,assassination,139,63,76
Deadlybrew,twisting-nether,1803,rogue,assassination,90,39,51
Eiscreme,blackmoore,1802,rogue,assassination,95,50,45
Kidneyou,ragnaros,1801,rogue,assassination,54,33,21
Inly,ysondre,1800,rogue,assassination,140,72,68
Слаадкий,gordunni,1799,rogue,assassination,159,78,81
Ålùnæh,azjolnerub,1797,rogue,assassination,126,61,65
Babøønx,burning-legion,1794,rogue,assassination,119,54,65
Wasp,twisting-nether,1791,rogue,assassination,120,63,57
Trashcarlitâ,eredar,1783,rogue,assassination,41,19,22
Dáydreamín,draenor,1772,rogue,assassination,60,27,33
Иллвилл,soulflayer,1769,rogue,assassination,42,23,19
Gamer,aggramar,1768,rogue,assassination,78,42,36
Dnee,ravencrest,1766,rogue,assassination,29,24,5
Pheq,ravencrest,1765,rogue,assassination,83,33,50
Tsoupoma,tarren-mill,1762,rogue,assassination,90,47,43
Роземсти,gordunni,1758,rogue,assassination,272,156,116
Ру,galakrond,1754,rogue,assassination,60,33,27
Ридлли,soulflayer,1751,rogue,assassination,71,34,37
Naiikaii,antonidas,1751,rogue,assassination,54,23,31
Мирайх,howling-fjord,1733,rogue,assassination,57,26,31
Sussulto,nemesis,1732,rogue,assassination,65,37,28
Пашавернись,gordunni,1730,rogue,assassination,109,40,69
Twitchful,kazzak,1728,rogue,assassination,72,36,36
Sadgebanned,draenor,1727,rogue,assassination,49,19,30
Sumiftw,drakthul,1723,rogue,assassination,96,44,52
Kreamy,tarren-mill,1721,rogue,assassination,107,49,58
Jeruna,veklor,1719,rogue,assassination,114,48,66
Stråt,ysondre,1718,rogue,assassination,112,47,65
Rajigagi,silvermoon,1717,rogue,assassination,61,33,28
Precious,sylvanas,1717,rogue,assassination,386,191,195
Gorgeousred,aegwynn,1717,rogue,assassination,42,18,24
Gorgeousréd,aegwynn,1716,rogue,assassination,42,18,24
Kynra,culte-de-la-rive-noire,1714,rogue,assassination,35,20,15
Goshîmoshî,stormscale,1713,rogue,assassination,126,56,70
Мастдаггер,goldrinn,1703,rogue,assassination,268,141,127
Limítless,tarren-mill,1702,rogue,assassination,66,39,27
Røler,ravencrest,1702,rogue,assassination,84,37,47
Lôre,blackrock,1700,rogue,assassination,59,23,36
Dían,ravencrest,1698,rogue,assassination,94,48,46
Moneylake,stormscale,1693,rogue,assassination,48,28,20
Rinj,antonidas,1693,rogue,assassination,89,37,52
Акиоми,gordunni,1691,rogue,assassination,102,57,45
Кайсити,gordunni,1689,rogue,assassination,84,46,38
Lastsight,burning-legion,1688,rogue,assassination,163,81,82
Fìíp,drakthul,1688,rogue,assassination,104,45,59
Mazeken,kazzak,1688,rogue,assassination,53,21,32
Tommywright,stormscale,1687,rogue,assassination,44,24,20
Играючестно,howling-fjord,1686,rogue,assassination,30,19,11
Meldbroken,tarren-mill,1683,rogue,assassination,66,32,34
Killnoobs,kazzak,1675,rogue,assassination,48,24,24
Stunco,ravencrest,1674,rogue,assassination,48,23,25
Ноумингод,gordunni,1673,rogue,assassination,78,36,42
Drenched,turalyon,1672,rogue,assassination,330,163,167
Gøldzahn,antonidas,1672,rogue,assassination,184,85,99
Ockzy,archimonde,1668,rogue,assassination,126,68,58
Awakeaf,outland,1666,rogue,assassination,146,67,79
Emergence,ravencrest,1665,rogue,assassination,54,23,31
Droomprins,stormscale,1664,rogue,assassination,54,22,32
Fíìp,drakthul,1663,rogue,assassination,305,145,160
Ripgore,sylvanas,1663,rogue,assassination,76,33,43
Trollmeat,twisting-nether,1663,rogue,assassination,66,25,41
Brunhityx,ravencrest,1661,rogue,assassination,29,18,11
Monski,ravencrest,1661,rogue,assassination,66,28,38
Dådyr,silvermoon,1660,rogue,assassination,36,23,13
Peeon,drakthul,1659,rogue,assassination,73,26,47
Ândrey,ravencrest,1657,rogue,assassination,54,31,23
Youcrymydear,outland,1654,rogue,assassination,78,35,43
Azzmodia,aegwynn,1653,rogue,assassination,48,20,28
Незблах,gordunni,1652,rogue,assassination,138,75,63
Wâter,silvermoon,1645,rogue,assassination,60,23,37
Семёнтус,gordunni,1644,rogue,assassination,96,46,50
Shøz,kazzak,1643,rogue,assassination,265,128,137
Капитанпитон,howling-fjord,1643,rogue,assassination,54,24,30
Warbell,ravencrest,1643,rogue,assassination,150,64,86
Painkeeper,stormscale,1641,rogue,assassination,54,32,22
Justkiddning,blackmoore,1641,rogue,assassination,102,60,42
Форсгодх,gordunni,1640,rogue,assassination,95,38,57
Skali,tarren-mill,1639,rogue,assassination,92,45,47
Ocktwo,archimonde,1639,rogue,assassination,128,55,73
Варэль,borean-tundra,1638,rogue,assassination,405,203,202
Richï,outland,1638,rogue,assassination,274,128,146
Netreck,dun-modr,1638,rogue,assassination,53,23,30
Гесху,eversong,1636,rogue,assassination,53,30,23
Асиксх,blackscar,1636,rogue,assassination,221,119,102
Saboteur,antonidas,1636,rogue,assassination,76,33,43
Altaár,dun-modr,1635,rogue,assassination,65,21,44
Совечица,gordunni,1633,rogue,assassination,54,29,25
Ghðst,stormscale,1633,rogue,assassination,41,20,21
Fatnutsac,eredar,1633,rogue,assassination,60,23,37
Загляденье,gordunni,1632,rogue,assassination,78,34,44
Yanlu,ysondre,1630,rogue,assassination,60,23,37
Kannibalex,blackrock,1627,rogue,assassination,75,35,40
Juxtapose,ravencrest,1627,rogue,assassination,66,28,38
Кэпс,blackscar,1625,rogue,assassination,66,39,27
Blawann,argent-dawn,1625,rogue,assassination,48,23,25
Zerocell,kazzak,1624,rogue,assassination,218,121,97
Howfastiam,ravencrest,1624,rogue,assassination,108,55,53
Мистеркрэпс,howling-fjord,1624,rogue,assassination,47,19,28
Erdin,ravencrest,1623,rogue,assassination,36,20,16
Костялом,howling-fjord,1623,rogue,assassination,36,17,19
Lacusdark,draenor,1622,rogue,assassination,179,86,93
Uzrigu,tarren-mill,1621,rogue,assassination,54,29,25
Sid,dentarg,1621,rogue,assassination,209,111,98
Ваася,gordunni,1620,rogue,assassination,177,83,94
Awaaylol,stormscale,1619,rogue,assassination,243,115,128
Yopti,tarren-mill,1616,rogue,assassination,167,70,97
Keeke,outland,1615,rogue,assassination,90,46,44
Shookyz,zuljin,1615,rogue,assassination,54,27,27
Iwillcapyou,twisting-nether,1614,rogue,assassination,54,25,29
Axlrows,doomhammer,1613,rogue,assassination,107,58,49
Войенх,gordunni,1612,rogue,assassination,319,155,164
Vâleera,kazzak,1612,rogue,assassination,78,36,42
Lelíth,ravencrest,1611,rogue,assassination,131,74,57
Únk,dalaran,1611,rogue,assassination,63,32,31
Мипанка,gordunni,1611,rogue,assassination,76,25,51
Amý,grim-batol,1610,rogue,assassination,75,36,39
Orcrogue,khadgar,1609,rogue,assassination,35,21,14
Hopejé,ravencrest,1608,rogue,assassination,228,121,107
Ooqu,silvermoon,1607,rogue,assassination,54,30,24
Hanzo,vashj,1607,rogue,assassination,178,82,96
Cander,kazzak,1607,rogue,assassination,107,49,58
Quoicoubeh,drekthar,1606,rogue,assassination,53,27,26
Саэрас,howling-fjord,1604,rogue,assassination,54,24,30
Ач,gordunni,1602,rogue,assassination,78,37,41
Sadìra,echsenkessel,1602,rogue,assassination,75,35,40
Tiazx,outland,1600,rogue,assassination,36,19,17
Nîllá,blackmoore,1600,rogue,assassination,42,18,24
Wayñe,ravencrest,1600,rogue,assassination,48,19,29
Soulshank,ragnaros,1598,rogue,assassination,30,19,11
Мелеша,blackscar,1595,rogue,assassination,59,21,38
Defiasrogue,blackmoore,1593,rogue,assassination,116,63,53
Lanewuquvi,alonsus,1593,rogue,assassination,53,25,28
Shikamouflé,archimonde,1591,rogue,assassination,178,88,90
Liøø,antonidas,1586,rogue,assassination,125,64,61
Ândrey,stormscale,1584,rogue,assassination,64,34,30
Piperx,ravencrest,1583,rogue,assassination,66,21,45
Dé,ragnaros,1582,rogue,assassination,107,54,53
Hoodrogue,blackrock,1580,rogue,assassination,59,32,27
Misttrogue,hyjal,1576,rogue,assassination,72,33,39
ßênz,archimonde,1572,rogue,assassination,126,65,61
Kãlí,blackmoore,1570,rogue,assassination,271,135,136
Zlah,ravencrest,1570,rogue,assassination,58,22,36
Ladixy,archimonde,1568,rogue,assassination,62,21,41
Artésia,archimonde,1566,rogue,assassination,105,58,47
Stepbrogue,tarren-mill,1564,rogue,assassination,136,68,68
Стеллакокс,howling-fjord,1564,rogue,assassination,92,44,48
Рэкрейвон,gordunni,1562,rogue,assassination,48,21,27
Miiløx,silvermoon,1560,rogue,assassination,96,51,45
Knutten,wildhammer,1556,rogue,assassination,144,69,75
Ридх,soulflayer,1556,rogue,assassination,48,18,30
Minjeaca,silvermoon,1552,rogue,assassination,150,72,78
Sotro,dun-modr,1549,rogue,assassination,114,46,68
Åd,stormreaver,1543,rogue,assassination,60,24,36
Редфилд,blackscar,1542,rogue,assassination,89,49,40
Synergize,stormreaver,1542,rogue,assassination,281,138,143
Vaze,ravencrest,1541,rogue,assassination,47,24,23
Crenx,draenor,1540,rogue,assassination,53,17,36
Köna,archimonde,1539,rogue,assassination,42,17,25
Silesi,kazzak,1538,rogue,assassination,154,81,73
Ритор,deathguard,1536,rogue,assassination,72,36,36
Cloak,blackrock,1536,rogue,assassination,48,22,26
Myk,frostmane,1534,rogue,assassination,30,16,14
Шмарамышь,soulflayer,1532,rogue,assassination,160,80,80
Schníttchen,antonidas,1527,rogue,assassination,47,21,26
Зоти,lich-king,1525,rogue,assassination,56,27,29
Shaokiz,sylvanas,1523,rogue,assassination,54,29,25
Lannon,sylvanas,1522,rogue,assassination,129,58,71
Reáper,frostwolf,1521,rogue,assassination,124,65,59
Somaliapirat,eredar,1520,rogue,assassination,36,17,19
Фуллблайнд,gordunni,1518,rogue,assassination,62,23,39
Ilrunne,silvermoon,1515,rogue,assassination,132,62,70
Flogue,area-52,1514,rogue,assassination,79,30,49
Dirtyz,dun-modr,1512,rogue,assassination,129,72,57
Obstechhawi,argent-dawn,1510,rogue,assassination,72,28,44
Винестрий,soulflayer,1509,rogue,assassination,89,39,50
Weakrat,kult-der-verdammten,1508,rogue,assassination,36,22,14
Ñerøblacks,dun-modr,1507,rogue,assassination,30,16,14
Stèálth,twisting-nether,1507,rogue,assassination,48,25,23
Йа,gordunni,1506,rogue,assassination,80,41,39
Ethèrnal,twisting-nether,1506,rogue,assassination,153,73,80
Путьказаха,gordunni,1505,rogue,assassination,42,25,17
Belsazar,azshara,1501,rogue,assassination,180,91,89
Nùgz,area-52,1498,rogue,assassination,119,65,54
Пусякиллерх,gordunni,1497,rogue,assassination,127,54,73
Deathlix,haomarush,1494,rogue,assassination,72,30,42
Unshaken,dun-modr,1493,rogue,assassination,60,25,35
Heartripper,ravencrest,1486,rogue,assassination,105,50,55
Argapu,stormscale,1486,rogue,assassination,138,61,77
Vicxx,ravencrest,1483,rogue,assassination,60,23,37
Mascarpone,sanguino,1482,rogue,assassination,131,64,67
Лестреа,goldrinn,1481,rogue,assassination,42,21,21
Zence,blackrock,1478,rogue,assassination,113,59,54
Трисися,gordunni,1478,rogue,assassination,66,32,34
Lipschitz,outland,1477,rogue,assassination,78,29,49
Xeeana,ravencrest,1476,rogue,assassination,294,150,144
Lefthook,argent-dawn,1473,rogue,assassination,52,19,33
Alnaddafrog,outland,1470,rogue,assassination,70,43,27
Mâriejânee,nozdormu,1469,rogue,assassination,90,52,38
Zaintsas,tarren-mill,1468,rogue,assassination,98,48,50
Diazz,aegwynn,1464,rogue,assassination,136,64,72
Nevagonagiv,archimonde,1462,rogue,assassination,36,17,19
Npkx,outland,1460,rogue,assassination,72,30,42
Zizmo,deathwing,1458,rogue,assassination,118,54,64
Soxo,dun-modr,1457,rogue,assassination,116,51,65
Czêro,grim-batol,1456,rogue,assassination,47,22,25
Yvÿ,archimonde,1455,rogue,assassination,154,85,69
Волнорес,eversong,1451,rogue,assassination,124,62,62
Zajiielf,eredar,1447,rogue,assassination,52,23,29
Nitröx,tarren-mill,1446,rogue,assassination,83,31,52
Negrim,dun-modr,1444,rogue,assassination,167,81,86
Sneakypeeki,sylvanas,1444,rogue,assassination,41,18,23
Grzech,burning-legion,1443,rogue,assassination,82,44,38
Luftpumpe,blackrock,1438,rogue,assassination,69,39,30
Arkblenderx,silvermoon,1438,rogue,assassination,123,63,60
Intrix,draenor,1438,rogue,assassination,48,16,32
Intecto,twisting-nether,1437,rogue,assassination,154,82,72
Axoic,ravencrest,1433,rogue,assassination,48,23,25
Tmpkboo,stormscale,1433,rogue,assassination,36,15,21
Ppollito,hyjal,1430,rogue,assassination,132,67,65
Reyzumi,antonidas,1430,rogue,assassination,66,31,35
Hidinginash,twisting-nether,1428,rogue,assassination,68,35,33
Nìghtwalker,ravencrest,1426,rogue,assassination,70,34,36
Rnghero,blackmoore,1426,rogue,assassination,54,15,39
Madiv,kazzak,1423,rogue,assassination,60,28,32
Кайдарра,eversong,1422,rogue,assassination,132,69,63
Poerta,burning-blade,1421,rogue,assassination,96,37,59
Teseiga,aegwynn,1420,rogue,assassination,238,110,128
Yokze,ravencrest,1417,rogue,assassination,169,85,84
Nællya,archimonde,1416,rogue,assassination,95,54,41
Nâtaz,eredar,1416,rogue,assassination,30,15,15
Лёнтролль,blackscar,1415,rogue,assassination,135,65,70
Vennomous,darkspear,1414,rogue,assassination,231,115,116
Ракфорн,howling-fjord,1413,rogue,assassination,127,71,56
Элирэй,fordragon,1413,rogue,assassination,129,61,68
Recondite,doomhammer,1412,rogue,assassination,71,40,31
Kuribo,gorgonnash,1411,rogue,assassination,36,18,18
Ropedrink,stormscale,1409,rogue,assassination,36,22,14
Fálke,dun-modr,1408,rogue,assassination,66,23,43
Koreanrogue,archimonde,1406,rogue,assassination,24,15,9
Caská,blackhand,1405,rogue,assassination,89,39,50
Finanzamtlg,blackrock,1404,rogue,assassination,78,40,38
Piñotxo,sanguino,1404,rogue,assassination,47,21,26
Аренамастерх,blackscar,1402,rogue,assassination,24,15,9
Synthaetic,draenor,1401,rogue,assassination,130,69,61
Ephalia,draenor,1397,rogue,assassination,279,136,143
Ванэйти,gordunni,1396,rogue,assassination,108,54,54
Sneakysloth,ravencrest,1396,rogue,assassination,93,42,51
Бонасера,blackscar,1393,rogue,assassination,195,95,100
Breuss,elune,1393,rogue,assassination,36,16,20
Freemmr,draenor,1391,rogue,assassination,118,61,57
Stellaä,ragnaros,1390,rogue,assassination,54,18,36
Wardrin,twisting-nether,1389,rogue,assassination,51,16,35
Траста,fordragon,1388,rogue,assassination,132,56,76
Lírìa,argent-dawn,1387,rogue,assassination,53,25,28
Givewallet,ravencrest,1385,rogue,assassination,48,25,23
Yassu,archimonde,1385,rogue,assassination,36,18,18
Erion,silvermoon,1384,rogue,assassination,210,99,111
Vanisha,outland,1381,rogue,assassination,153,76,77
Umciz,archimonde,1381,rogue,assassination,42,15,27
Roguening,tarren-mill,1381,rogue,assassination,65,23,42
Effectz,ravencrest,1377,rogue,assassination,155,81,74
Мечтавелена,howling-fjord,1377,rogue,assassination,195,96,99
Вудстер,blackscar,1377,rogue,assassination,41,17,24
Crroustibat,dalaran,1376,rogue,assassination,48,23,25
Ciaordel,sylvanas,1372,rogue,assassination,75,36,39
Bambush,bronze-dragonflight,1371,rogue,assassination,136,70,66
Zeuzo,xavius,1371,rogue,assassination,185,94,91
Ynohtna,blackhand,1371,rogue,assassination,128,62,66
Pizzayamyam,aegwynn,1371,rogue,assassination,78,36,42
Хулиганнчег,galakrond,1370,rogue,assassination,39,18,21
Jsprxo,stormscale,1369,rogue,assassination,42,23,19
Crípplé,ravencrest,1369,rogue,assassination,30,15,15
Винерджи,gordunni,1369,rogue,assassination,103,51,52
Protpaladin,sylvanas,1369,rogue,assassination,123,60,63
Éllen,outland,1369,rogue,assassination,138,63,75
Lycosidae,doomhammer,1366,rogue,assassination,36,16,20
Trollohlol,malganis,1365,rogue,assassination,96,51,45
Zobrak,twisting-nether,1362,rogue,assassination,128,64,64
Candycc,burning-legion,1361,rogue,assassination,159,80,79
Nuguri,blackrock,1360,rogue,assassination,51,26,25
Síns,runetotem,1359,rogue,assassination,49,27,22
Haikyu,blackhand,1354,rogue,assassination,72,31,41
Pieksig,blackmoore,1352,rogue,assassination,125,56,69
Dreathefox,drakthul,1352,rogue,assassination,48,20,28
Watodoo,kazzak,1351,rogue,assassination,116,57,59
Cýphia,amanthul,1351,rogue,assassination,69,32,37
Education,aegwynn,1350,rogue,assassination,48,18,30
Гарднэр,soulflayer,1349,rogue,assassination,107,57,50
Sáinz,malganis,1349,rogue,assassination,70,34,36
Djnelly,stormreaver,1345,rogue,assassination,81,48,33
Axelaz,ravencrest,1344,rogue,assassination,18,14,4
Zyrogue,silvermoon,1341,rogue,assassination,24,15,9
Yoruichì,kazzak,1337,rogue,assassination,42,23,19
Pathicus,stormreaver,1336,rogue,assassination,160,82,78
Skrbke,tarren-mill,1335,rogue,assassination,210,110,100
Soukalamink,tarren-mill,1334,rogue,assassination,64,21,43
Ambushgirl,ravencrest,1333,rogue,assassination,153,68,85
Zèph,outland,1332,rogue,assassination,54,28,26
Stabbinu,burning-legion,1332,rogue,assassination,30,14,16
Skiff,argent-dawn,1332,rogue,assassination,41,16,25
Nightnelly,archimonde,1331,rogue,assassination,30,14,16
Rindar,dun-modr,1330,rogue,assassination,24,14,10
Tarox,eredar,1330,rogue,assassination,131,65,66
Bensollo,tarren-mill,1330,rogue,assassination,35,16,19
Koopa,argent-dawn,1330,rogue,assassination,54,14,40
Shadôwcraft,outland,1329,rogue,assassination,81,42,39
Кэзам,soulflayer,1325,rogue,assassination,31,15,16
Xãwé,kazzak,1324,rogue,assassination,35,16,19
Gutter,sylvanas,1320,rogue,assassination,36,14,22
Эстанга,grom,1318,rogue,assassination,42,16,26
Markø,twisting-nether,1316,rogue,assassination,104,47,57
Jaxck,sylvanas,1314,rogue,assassination,24,14,10
Замлур,booty-bay,1314,rogue,assassination,42,23,19
Менрэйз,gordunni,1313,rogue,assassination,48,21,27
Keltaru,ravencrest,1312,rogue,assassination,42,16,26
Shoukoub,silvermoon,1311,rogue,assassination,66,39,27
Ganzord,dun-modr,1310,rogue,assassination,47,25,22
Icedoutoak,antonidas,1310,rogue,assassination,40,20,20
Stonecold,twilights-hammer,1310,rogue,assassination,52,20,32
Sigleif,argent-dawn,1309,rogue,assassination,61,28,33
Watzoqt,archimonde,1307,rogue,assassination,33,15,18
Jumbovanish,tarren-mill,1306,rogue,assassination,81,38,43
Dalailamer,gorgonnash,1306,rogue,assassination,80,35,45
Narzaván,ravencrest,1301,rogue,assassination,139,65,74
Søsaboy,nemesis,1301,rogue,assassination,64,29,35
Davotroz,dun-modr,1300,rogue,assassination,68,35,33
Lamøerte,hyjal,1300,rogue,assassination,60,22,38
Dæadly,archimonde,1299,rogue,assassination,58,26,32
Lùxtrà,antonidas,1298,rogue,assassination,58,28,30
Taatzz,stormscale,1295,rogue,assassination,42,23,19
Gadûz,kazzak,1295,rogue,assassination,44,17,27
Flawlesser,kazzak,1294,rogue,assassination,39,19,20
Патайчик,soulflayer,1294,rogue,assassination,91,44,47
Эксплис,ashenvale,1290,rogue,assassination,91,41,50
Stôrpîx,drakthul,1289,rogue,assassination,66,30,36
Rhak,malganis,1288,rogue,assassination,136,65,71
Анми,gordunni,1288,rogue,assassination,35,14,21
Loubina,silvermoon,1287,rogue,assassination,36,16,20
Petsakos,ravencrest,1287,rogue,assassination,65,25,40
Stin,blackrock,1284,rogue,assassination,77,34,43
Batsu,alleria,1276,rogue,assassination,72,30,42
Satiiva,terokkar,1274,rogue,assassination,78,36,42
Lixht,the-maelstrom,1273,rogue,assassination,66,34,32
Сасасин,soulflayer,1273,rogue,assassination,140,71,69
Rahes,stormscale,1273,rogue,assassination,276,131,145
Mahistt,archimonde,1270,rogue,assassination,59,32,27
Eizan,outland,1268,rogue,assassination,111,51,60
Poughkeepsie,outland,1265,rogue,assassination,65,32,33
Shersh,hyjal,1265,rogue,assassination,36,16,20
Izze,thrall,1265,rogue,assassination,48,17,31
Akira,outland,1262,rogue,assassination,69,34,35
Tez,malganis,1262,rogue,assassination,149,66,83
Veronkierto,stormreaver,1259,rogue,assassination,78,42,36
Bauwten,ravencrest,1258,rogue,assassination,42,23,19
Amhaia,twisting-nether,1255,rogue,assassination,124,57,67
Griveous,kazzak,1252,rogue,assassination,32,18,14
Войтенко,gordunni,1252,rogue,assassination,36,18,18
Aleary,ravencrest,1250,rogue,assassination,30,18,12
Shadowcralls,blackmoore,1250,rogue,assassination,35,14,21
Brñ,ravencrest,1248,rogue,assassination,18,13,5
Penita,aegwynn,1248,rogue,assassination,24,14,10
Whaazz,ravencrest,1248,rogue,assassination,24,13,11
Snulle,ravencrest,1248,rogue,assassination,24,13,11
Евгенийильич,gordunni,1247,rogue,assassination,24,13,11
Solocarnage,hyjal,1247,rogue,assassination,90,40,50
Mtb,ravencrest,1245,rogue,assassination,30,13,17
Stabdbyvegan,ragnaros,1245,rogue,assassination,79,31,48
Nojdobra,tarren-mill,1244,rogue,assassination,67,28,39
Dropdeath,dun-modr,1243,rogue,assassination,24,13,11
Freijasap,ravencrest,1243,rogue,assassination,30,13,17
Имилиона,blackscar,1242,rogue,assassination,61,31,30
Келгар,soulflayer,1242,rogue,assassination,63,27,36
Maedyv,magtheridon,1241,rogue,assassination,36,17,19
Cørek,blackhand,1240,rogue,assassination,18,13,5
Synsinte,silvermoon,1240,rogue,assassination,30,16,14
Mexxn,antonidas,1240,rogue,assassination,43,20,23
Meimei,sanguino,1240,rogue,assassination,36,13,23
Dime,silvermoon,1239,rogue,assassination,90,47,43
Нарежудольки,howling-fjord,1237,rogue,assassination,36,13,23
Mewen,sanguino,1233,rogue,assassination,30,13,17
Dîspatchx,defias-brotherhood,1232,rogue,assassination,208,97,111
Raetoc,turalyon,1231,rogue,assassination,54,26,28
Horvathzu,ravencrest,1231,rogue,assassination,62,28,34
Jamesdarmody,twisting-nether,1230,rogue,assassination,52,24,28
Biianca,sylvanas,1230,rogue,assassination,30,13,17
Streetx,nethersturm,1226,rogue,assassination,48,25,23
Gankbang,frostmane,1225,rogue,assassination,54,21,33
Maløcøxysse,dalaran,1224,rogue,assassination,158,69,89
Nukubu,draenor,1224,rogue,assassination,88,35,53
Nopz,outland,1221,rogue,assassination,59,33,26
Noxxra,blackhand,1221,rogue,assassination,67,27,40
Mystykal,twisting-nether,1221,rogue,assassination,48,19,29
Сайгакк,galakrond,1217,rogue,assassination,64,32,32
Dahlinska,ravencrest,1216,rogue,assassination,54,22,32
Ноубрэйкс,blackscar,1214,rogue,assassination,120,59,61
Babysteps,the-maelstrom,1212,rogue,assassination,28,15,13
Экичу,howling-fjord,1210,rogue,assassination,60,35,25
Szabina,outland,1210,rogue,assassination,24,13,11
Свёклапро,gordunni,1210,rogue,assassination,118,60,58
Behind,agamaggan,1210,rogue,assassination,34,16,18
Revelith,nemesis,1209,rogue,assassination,41,19,22
Drillss,ravencrest,1209,rogue,assassination,46,14,32
Sisoi,kazzak,1207,rogue,assassination,125,57,68
Nargun,archimonde,1206,rogue,assassination,36,21,15
Ordwin,silvermoon,1205,rogue,assassination,68,29,39
Bennyweth,argent-dawn,1205,rogue,assassination,42,16,26
Gðrdø,blackrock,1204,rogue,assassination,38,16,22
Phaîne,outland,1201,rogue,assassination,36,16,20
Abush,ravencrest,1199,rogue,assassination,48,20,28
Röllz,ysondre,1199,rogue,assassination,72,28,44
Maelithas,archimonde,1197,rogue,assassination,83,38,45
Lovetospoon,ravencrest,1196,rogue,assassination,90,51,39
Элиссенда,deathguard,1196,rogue,assassination,28,14,14
Davosslol,outland,1196,rogue,assassination,36,13,23
Практикиней,grom,1195,rogue,assassination,102,50,52
Næylá,kult-der-verdammten,1195,rogue,assassination,168,81,87
Kariinthuul,aegwynn,1195,rogue,assassination,92,42,50
Lorena,ravencrest,1192,rogue,assassination,29,14,15
Madlain,jaedenar,1189,rogue,assassination,97,44,53
Jazhz,archimonde,1188,rogue,assassination,36,19,17
Sùbzerø,archimonde,1186,rogue,assassination,23,13,10
Фиксдпс,lich-king,1185,rogue,assassination,30,13,17
Cbrook,sylvanas,1184,rogue,assassination,35,13,22
Vengígodx,outland,1182,rogue,assassination,66,34,32
Hallogenic,silvermoon,1181,rogue,assassination,48,21,27
Pitøu,outland,1180,rogue,assassination,122,64,58
Darkkstep,blackmoore,1178,rogue,assassination,42,15,27
Тимкок,soulflayer,1176,rogue,assassination,120,52,68
Stælf,argent-dawn,1176,rogue,assassination,52,21,31
Havox,darksorrow,1175,rogue,assassination,36,16,20
Цилана,gordunni,1173,rogue,assassination,170,87,83
Azovrouge,terokkar,1172,rogue,assassination,30,18,12
Sladen,ghostlands,1172,rogue,assassination,30,14,16
Imdma,defias-brotherhood,1170,rogue,assassination,116,64,52
Swarge,silvermoon,1157,rogue,assassination,419,205,214
Zeduxino,outland,1156,rogue,assassination,28,17,11
Фикция,greymane,1151,rogue,assassination,70,25,45
Sâtýr,ravencrest,1150,rogue,assassination,18,12,6
Djpiglet,outland,1149,rogue,assassination,18,12,6
Ravenouz,thrall,1149,rogue,assassination,24,12,12
Narsoule,ysondre,1147,rogue,assassination,76,37,39
Mewen,dun-modr,1147,rogue,assassination,36,12,24
Chalkbag,blackrock,1146,rogue,assassination,59,23,36
Unterweger,die-aldor,1145,rogue,assassination,23,13,10
Behörnchen,eredar,1145,rogue,assassination,59,23,36
Nightyx,blackmoore,1144,rogue,assassination,24,12,12
Носопыра,blackscar,1142,rogue,assassination,149,75,74
Bläde,outland,1141,rogue,assassination,18,12,6
Zsofia,ravencrest,1141,rogue,assassination,30,12,18
Oljebrunn,stormscale,1139,rogue,assassination,24,12,12
Rîg,draenor,1139,rogue,assassination,30,12,18
Nàrutò,thrall,1138,rogue,assassination,112,43,69
Скулипёс,howling-fjord,1137,rogue,assassination,58,31,27
Nevelon,chogall,1137,rogue,assassination,182,87,95
Bonejaw,tarren-mill,1137,rogue,assassination,30,14,16
Banaulikode,twisting-nether,1136,rogue,assassination,30,12,18
Kuttunga,ravencrest,1134,rogue,assassination,85,39,46
Kronin,arakarahm,1134,rogue,assassination,78,30,48
Zokush,archimonde,1134,rogue,assassination,39,15,24
Donjules,silvermoon,1133,rogue,assassination,163,74,89
Dredge,kaelthas,1132,rogue,assassination,72,31,41
Gereon,drakthul,1129,rogue,assassination,28,13,15
Gigarogue,defias-brotherhood,1129,rogue,assassination,53,24,29
Daggerz,outland,1128,rogue,assassination,24,12,12
Tootskie,outland,1128,rogue,assassination,126,59,67
Dykumah,sanguino,1124,rogue,assassination,36,17,19
Jupitor,argent-dawn,1123,rogue,assassination,144,73,71
Epidemic,stormscale,1122,rogue,assassination,265,124,141
Mallaurya,dalaran,1120,rogue,assassination,30,12,18
Myk,ravencrest,1119,rogue,assassination,23,12,11
Missesinvis,blackmoore,1118,rogue,assassination,25,14,11
Krimos,archimonde,1118,rogue,assassination,84,45,39
Белунчус,howling-fjord,1116,rogue,assassination,48,26,22
Elysm,stormscale,1112,rogue,assassination,68,35,33
Vathié,twisting-nether,1112,rogue,assassination,30,12,18
Jæto,ravencrest,1110,rogue,assassination,33,17,16
Поздоровайся,howling-fjord,1110,rogue,assassination,174,85,89
Sênsus,antonidas,1110,rogue,assassination,54,21,33
Edaniel,draenor,1109,rogue,assassination,24,12,12
Orochi,ravencrest,1109,rogue,assassination,42,19,23
Whiss,blackmoore,1108,rogue,assassination,30,15,15
Rundarz,tyrande,1108,rogue,assassination,29,12,17
Finisher,sanguino,1107,rogue,assassination,30,14,16
Raîzen,sargeras,1105,rogue,assassination,36,14,22
Vickerogue,stormreaver,1103,rogue,assassination,24,12,12
Oshä,dalaran,1102,rogue,assassination,30,13,17
Artyzoo,tarren-mill,1100,rogue,assassination,40,18,22
Elûnè,silvermoon,1097,rogue,assassination,30,14,16
Azonaticus,hyjal,1096,rogue,assassination,34,16,18
Réäpèr,sylvanas,1094,rogue,assassination,39,13,26
Ámbush,sylvanas,1092,rogue,assassination,44,13,31
Lesale,turalyon,1088,rogue,assassination,66,34,32
Sorea,twisting-nether,1087,rogue,assassination,126,61,65
Gravestam,sunstrider,1085,rogue,assassination,36,17,19
Shoshomoo,lightnings-blade,1085,rogue,assassination,27,12,15
Оскархартман,gordunni,1082,rogue,assassination,60,31,29
Horrogue,aggramar,1081,rogue,assassination,41,21,20
Kampon,sanguino,1081,rogue,assassination,40,16,24
Undîsputed,blackmoore,1074,rogue,assassination,45,15,30
Mol,defias-brotherhood,1070,rogue,assassination,38,12,26
Kirby,kaelthas,1066,rogue,assassination,25,12,13
Areldis,drakthul,1065,rogue,assassination,26,13,13
Чернаясоска,eversong,1064,rogue,assassination,125,67,58
Nighteshift,silvermoon,1064,rogue,assassination,36,14,22
Engetiran,defias-brotherhood,1064,rogue,assassination,60,17,43
Boskönigt,ragnaros,1062,rogue,assassination,70,36,34
Giftknirps,silvermoon,1062,rogue,assassination,30,15,15
Фанкироуг,soulflayer,1058,rogue,assassination,42,20,22
Utis,kazzak,1058,rogue,assassination,42,18,24
Firekry,stormscale,1057,rogue,assassination,30,12,18
Pridå,thrall,1056,rogue,assassination,24,11,13
Qwneêr,tarren-mill,1056,rogue,assassination,24,11,13
Undxrwrld,sylvanas,1055,rogue,assassination,18,11,7
Pekszcze,ravencrest,1054,rogue,assassination,18,11,7
Gamôra,arygos,1054,rogue,assassination,299,146,153
Аязлаая,blackscar,1054,rogue,assassination,36,11,25
Jimaal,stormscale,1051,rogue,assassination,30,11,19
Æsthaetic,silvermoon,1050,rogue,assassination,24,11,13
Azhothz,argent-dawn,1049,rogue,assassination,24,12,12
Ingesa,blackhand,1048,rogue,assassination,104,48,56
Batta,drakthul,1047,rogue,assassination,24,11,13
Йоио,howling-fjord,1047,rogue,assassination,24,11,13
Bigpeanuts,ragnaros,1046,rogue,assassination,18,11,7
Hasansabbah,twisting-nether,1045,rogue,assassination,30,11,19
Zélla,twisting-nether,1044,rogue,assassination,24,11,13
Паштетмашин,booty-bay,1042,rogue,assassination,71,39,32
Opiïum,ysondre,1042,rogue,assassination,24,13,11
Дисхар,soulflayer,1042,rogue,assassination,34,15,19
Pasarelo,dun-modr,1041,rogue,assassination,95,45,50
Ashami,genjuros,1040,rogue,assassination,33,15,18
Refundlands,kazzak,1040,rogue,assassination,37,14,23
Колдрейдж,soulflayer,1039,rogue,assassination,18,11,7
Sæqq,blackmoore,1038,rogue,assassination,54,22,32
Subyo,eredar,1038,rogue,assassination,30,11,19
Leÿji,archimonde,1038,rogue,assassination,42,15,27
Chiàntì,blackrock,1037,rogue,assassination,185,88,97
Alpinestars,dun-modr,1037,rogue,assassination,29,12,17
Gloomykenny,tarren-mill,1036,rogue,assassination,24,11,13
Ядорадура,eversong,1036,rogue,assassination,24,11,13
Rektbywomen,ravencrest,1031,rogue,assassination,26,13,13
Seleyese,draenor,1027,rogue,assassination,36,15,21
Imissmop,darkspear,1026,rogue,assassination,30,11,19
Мяуровани,eversong,1025,rogue,assassination,30,16,14
Rogunelf,stormreaver,1021,rogue,assassination,62,31,31
Nÿst,khaz-modan,1021,rogue,assassination,23,11,12
Tre,eredar,1021,rogue,assassination,50,23,27
Килларан,howling-fjord,1017,rogue,assassination,65,27,38
Dmfd,darksorrow,1016,rogue,assassination,343,168,175
Айвонарак,howling-fjord,1014,rogue,assassination,36,13,23
Балуса,thermaplugg,1011,rogue,assassination,84,33,51
Гаддюка,howling-fjord,1009,rogue,assassination,40,19,21
Tubes,dun-morogh,1008,rogue,assassination,44,26,18
Лунари,blackscar,1008,rogue,assassination,83,34,49
Alltaïr,ravencrest,1007,rogue,assassination,151,76,75
Кэйлфрут,gordunni,1005,rogue,assassination,222,103,119
Suley,blackrock,1004,rogue,assassination,35,16,19
Beistrichbob,terrordar,1003,rogue,assassination,24,13,11
Клозо,galakrond,1000,rogue,assassination,29,11,18
Джоннималыш,eversong,999,rogue,assassination,66,30,36
Rwaphou,ysondre,992,rogue,assassination,36,18,18
Haregan,gorgonnash,991,rogue,assassination,24,14,10
Grris,stormscale,991,rogue,assassination,22,11,11
Майндтрикс,blackscar,991,rogue,assassination,26,11,15
Zzippi,blackmoore,987,rogue,assassination,49,20,29
Dezxxyox,dun-modr,984,rogue,assassination,167,87,80
Gimzir,archimonde,982,rogue,assassination,25,11,14
Julyshadows,kazzak,974,rogue,assassination,84,38,46
Tirgo,aegwynn,970,rogue,assassination,204,101,103
Astefion,dalaran,966,rogue,assassination,54,13,41
Zóhaz,burning-legion,965,rogue,assassination,42,11,31
Veliza,twisting-nether,962,rogue,assassination,91,37,54
Shadowprank,ravencrest,960,rogue,assassination,21,10,11
Lunaryel,turalyon,960,rogue,assassination,48,17,31
Madisonivyqt,blackmoore,960,rogue,assassination,30,10,20
Ежикх,soulflayer,960,rogue,assassination,30,10,20
Miistermaen,outland,959,rogue,assassination,30,10,20
Ладжо,gordunni,959,rogue,assassination,30,10,20
Løuvees,archimonde,958,rogue,assassination,88,45,43
Jústina,die-aldor,958,rogue,assassination,109,51,58
Mackíe,antonidas,958,rogue,assassination,57,24,33
Dilemma,zuljin,958,rogue,assassination,24,10,14
Speedhackarn,jaedenar,958,rogue,assassination,24,10,14
Chatbann,blackrock,958,rogue,assassination,24,10,14
Tallac,drekthar,958,rogue,assassination,24,10,14
Xalupa,dun-modr,957,rogue,assassination,24,10,14
Psychoxygen,nemesis,956,rogue,assassination,24,10,14
Geludor,alonsus,956,rogue,assassination,24,10,14
Brazi,dalaran,955,rogue,assassination,24,10,14
Grimv,frostmane,955,rogue,assassination,24,10,14
Gârrík,blackhand,954,rogue,assassination,18,10,8
Eightball,frostmane,954,rogue,assassination,18,10,8
Skids,ravencrest,952,rogue,assassination,18,10,8
Runár,proudmoore,952,rogue,assassination,22,11,11
Кремдлявек,gordunni,950,rogue,assassination,47,14,33
Gaius,zuljin,946,rogue,assassination,52,15,37
Wedgyrog,stormscale,944,rogue,assassination,125,51,74
Deadchivalry,argent-dawn,942,rogue,assassination,24,10,14
Madita,frostmourne,942,rogue,assassination,42,11,31
Delaster,blackmoore,939,rogue,assassination,28,16,12
Tranxéne,hyjal,939,rogue,assassination,90,46,44
Kyropth,eredar,939,rogue,assassination,24,10,14
Modulok,ulduar,936,rogue,assassination,48,22,26
Kuxion,zuljin,933,rogue,assassination,42,19,23
Eniyah,tarren-mill,927,rogue,assassination,17,10,7
Helax,turalyon,927,rogue,assassination,89,35,54
Deceptio,gilneas,925,rogue,assassination,139,66,73
Sabrera,ravencrest,921,rogue,assassination,56,23,33
Yasmineskye,silvermoon,920,rogue,assassination,24,10,14
Snakeshiv,ravenholdt,919,rogue,assassination,30,15,15
Nhox,garona,913,rogue,assassination,30,11,19
Энвитио,gordunni,910,rogue,assassination,29,16,13
Kaigodd,twisting-nether,907,rogue,assassination,63,34,29
Наджийа,lich-king,907,rogue,assassination,68,35,33
Pinchoto,sanguino,907,rogue,assassination,66,31,35
Макггара,soulflayer,907,rogue,assassination,170,78,92
Jupezii,stormreaver,905,rogue,assassination,17,10,7
Xlongman,blackhand,903,rogue,assassination,75,28,47
Rohalds,silvermoon,901,rogue,assassination,32,11,21
Куррвабобер,borean-tundra,900,rogue,assassination,24,10,14
Dayrogue,doomhammer,900,rogue,assassination,42,10,32
Rascall,anetheron,898,rogue,assassination,20,11,9
Márto,archimonde,896,rogue,assassination,22,10,12
Rezzi,ravencrest,895,rogue,assassination,60,28,32
Mythicog,twisting-nether,895,rogue,assassination,60,24,36
Медиивэл,deepholm,893,rogue,assassination,47,15,32
Ороти,greymane,891,rogue,assassination,20,12,8
Леронда,deepholm,889,rogue,assassination,46,23,23
Onetwo,aggra-português,889,rogue,assassination,42,19,23
Blackone,nemesis,883,rogue,assassination,24,10,14
Вотымразь,howling-fjord,882,rogue,assassination,131,61,70
Вальпургина,borean-tundra,879,rogue,assassination,100,50,50
Batskcab,blackmoore,878,rogue,assassination,31,10,21
Dallrend,stormscale,875,rogue,assassination,60,22,38
Rossaporcona,nemesis,874,rogue,assassination,66,24,42
Lilze,ravencrest,870,rogue,assassination,174,81,93
Прнхабочка,gordunni,865,rogue,assassination,72,35,37
Skýhigh,ravencrest,864,rogue,assassination,12,9,3
Acronia,ragnaros,864,rogue,assassination,18,9,9
Mituxararr,blackrock,864,rogue,assassination,18,9,9
Watergirlx,ravencrest,864,rogue,assassination,18,9,9
Sotri,dun-modr,864,rogue,assassination,24,9,15
Angeldarky,silvermoon,864,rogue,assassination,24,9,15
Oczku,burning-legion,864,rogue,assassination,24,9,15
Jáckz,twisting-nether,864,rogue,assassination,24,9,15
Chaotix,ragnaros,864,rogue,assassination,30,9,21
Wundgîft,blackrock,864,rogue,assassination,30,9,21
Moratz,blackmoore,864,rogue,assassination,36,9,27
Nekhâ,hyjal,863,rogue,assassination,18,9,9
Лиринэлла,soulflayer,863,rogue,assassination,18,9,9
Fawkkes,la-croisade-écarlate,863,rogue,assassination,24,9,15
Chokee,blackrock,863,rogue,assassination,28,10,18
Juelz,ravencrest,863,rogue,assassination,30,9,21
Фанфистинга,gordunni,863,rogue,assassination,36,9,27
Жесть,howling-fjord,862,rogue,assassination,18,9,9
Bakalan,dun-modr,862,rogue,assassination,30,9,21
Satlol,outland,861,rogue,assassination,21,10,11
Красаа,soulflayer,861,rogue,assassination,24,9,15
Ticklzepickl,silvermoon,861,rogue,assassination,24,9,15
Doxxei,draenor,860,rogue,assassination,18,9,9
Purplereign,frostmane,860,rogue,assassination,84,40,44
Бимбабеггинз,howling-fjord,860,rogue,assassination,24,9,15
Gorgok,culte-de-la-rive-noire,858,rogue,assassination,18,9,9
Wééselby,blackrock,857,rogue,assassination,24,9,15
Kinntama,twisting-nether,857,rogue,assassination,30,9,21
Silksneak,kazzak,856,rogue,assassination,18,9,9
Norlix,ravencrest,856,rogue,assassination,18,9,9
Malvaxxs,tarren-mill,856,rogue,assassination,26,9,17
Shadowspike,sanguino,855,rogue,assassination,24,9,15
Felvengeance,stormscale,855,rogue,assassination,30,9,21
Tulipe,kaelthas,853,rogue,assassination,12,9,3
Reginlief,argent-dawn,852,rogue,assassination,56,28,28
Valdengard,antonidas,852,rogue,assassination,18,9,9
Цефира,gordunni,849,rogue,assassination,18,9,9
Blades,blackmoore,843,rogue,assassination,24,9,15
Saleanos,die-aldor,842,rogue,assassination,43,15,28
Ressputini,emeriss,841,rogue,assassination,17,9,8
Angelbeats,outland,841,rogue,assassination,22,10,12
Krymziàâ,hyjal,832,rogue,assassination,123,53,70
Yeehaaman,stormreaver,828,rogue,assassination,24,9,15
Tc,doomhammer,824,rogue,assassination,18,9,9
Jacktripper,blackrock,824,rogue,assassination,51,14,37
Îlihad,zuljin,822,rogue,assassination,72,29,43
Sessanali,silvermoon,816,rogue,assassination,36,10,26
Подкустовный,gordunni,815,rogue,assassination,23,9,14
Aszaryn,magtheridon,814,rogue,assassination,23,9,14
Raikyo,argent-dawn,813,rogue,assassination,85,44,41
Scorpionkk,blackrock,813,rogue,assassination,492,227,265
Sïdr,marécage-de-zangar,808,rogue,assassination,100,49,51
Yuffi,ysondre,803,rogue,assassination,29,11,18
Hadúr,stormscale,802,rogue,assassination,28,11,17
Folzen,archimonde,799,rogue,assassination,22,9,13
Kahsorog,draenor,795,rogue,assassination,26,10,16
Coastguard,twisting-nether,781,rogue,assassination,113,48,65
Mores,anetheron,781,rogue,assassination,30,9,21
Sospiro,nemesis,779,rogue,assassination,22,9,13
Knockyz,khaz-modan,778,rogue,assassination,267,128,139
Кейтллинн,galakrond,777,rogue,assassination,66,29,37
Пробующий,soulflayer,768,rogue,assassination,12,8,4
Кьюксе,gordunni,768,rogue,assassination,12,8,4
Ewynarog,silvermoon,768,rogue,assassination,18,8,10
Attylaria,rexxar,768,rogue,assassination,18,8,10
Houfyy,blackhand,768,rogue,assassination,18,8,10
Silass,marécage-de-zangar,768,rogue,assassination,18,8,10
Фешнподпивом,gordunni,768,rogue,assassination,21,8,13
Zwarciowa,burning-legion,768,rogue,assassination,24,8,16
Onlyluvhurt,dun-modr,768,rogue,assassination,24,8,16
Spky,ravencrest,768,rogue,assassination,30,8,22
Babouill,ysondre,767,rogue,assassination,12,8,4
Laojin,kiljaeden,767,rogue,assassination,12,8,4
Milenia,thrall,767,rogue,assassination,18,8,10
Meldee,burning-legion,767,rogue,assassination,18,8,10
Disdane,sylvanas,767,rogue,assassination,18,8,10
Imsweet,burning-legion,767,rogue,assassination,18,8,10
Röguelol,outland,767,rogue,assassination,18,8,10
Liraia,eredar,767,rogue,assassination,24,8,16
Allydede,blackmoore,767,rogue,assassination,42,8,34
Serpez,anachronos,766,rogue,assassination,12,8,4
Flaskan,tarren-mill,766,rogue,assassination,18,8,10
Nhonhonho,silvermoon,766,rogue,assassination,18,8,10
Bronxbomber,tarren-mill,766,rogue,assassination,18,8,10
Obsçuritý,ragnaros,765,rogue,assassination,16,9,7
Kuzmin,die-aldor,765,rogue,assassination,24,8,16
Satmera,silvermoon,765,rogue,assassination,24,8,16
Gpóínt,blackmoore,765,rogue,assassination,36,11,25
Jimzopf,eredar,762,rogue,assassination,18,8,10
Parker,frostmane,758,rogue,assassination,24,8,16
Thedarkness,sylvanas,755,rogue,assassination,18,8,10
ßè,frostmane,754,rogue,assassination,18,8,10
Gillette,guldan,752,rogue,assassination,120,45,75
Matarocho,ravencrest,751,rogue,assassination,24,8,16
Raiyqyu,archimonde,748,rogue,assassination,154,72,82
Juweetwelwie,twisting-nether,746,rogue,assassination,30,11,19
Рогнарек,blackscar,745,rogue,assassination,44,17,27
Elfikill,elune,741,rogue,assassination,102,49,53
Sombrafina,tyrande,737,rogue,assassination,54,13,41
Deragur,antonidas,733,rogue,assassination,18,8,10
Azkiel,archimonde,730,rogue,assassination,18,8,10
Бларефул,eversong,730,rogue,assassination,24,8,16
Якунька,soulflayer,729,rogue,assassination,23,8,15
Bondina,nemesis,727,rogue,assassination,18,8,10
Azotix,archimonde,722,rogue,assassination,38,14,24
Zarina,kirin-tor,722,rogue,assassination,42,12,30
Jibril,anubarak,716,rogue,assassination,23,8,15
Ghøßt,outland,714,rogue,assassination,23,10,13
Hmwow,kazzak,707,rogue,assassination,29,9,20
Obbexd,outland,706,rogue,assassination,28,10,18
Fumai,blackmoore,701,rogue,assassination,54,19,35
Kodlak,silvermoon,696,rogue,assassination,16,8,8
Blueberry,sargeras,693,rogue,assassination,31,10,21
Bleubleute,hyjal,693,rogue,assassination,26,8,18
Ninieu,kirin-tor,686,rogue,assassination,13,8,5
Ghøstkid,blackrock,686,rogue,assassination,22,8,14
Fleshcrawl,norgannon,677,rogue,assassination,22,8,14
Bluntyblades,silvermoon,672,rogue,assassination,12,7,5
Биокарлик,soulflayer,672,rogue,assassination,12,7,5
Doperog,antonidas,672,rogue,assassination,12,7,5
Несторина,gordunni,672,rogue,assassination,12,7,5
Ogc,draenor,672,rogue,assassination,18,7,11
Scørp,ravencrest,672,rogue,assassination,18,7,11
Eeros,kazzak,672,rogue,assassination,18,7,11
Styxro,blackhand,672,rogue,assassination,18,7,11
Zilemjr,stormscale,672,rogue,assassination,18,7,11
Soulriver,kelthuzad,672,rogue,assassination,18,7,11
Ximenidriel,ravencrest,672,rogue,assassination,18,7,11
Nitroxygen,outland,672,rogue,assassination,18,7,11
Like,aegwynn,672,rogue,assassination,18,7,11
Patryk,silvermoon,672,rogue,assassination,21,8,13
Jaqenhghar,pozzo-delleternità,672,rogue,assassination,24,7,17
Featfawkes,ragnaros,672,rogue,assassination,24,7,17
Luketherogue,twisting-nether,672,rogue,assassination,24,7,17
Rikdy,kazzak,672,rogue,assassination,30,7,23
Pookzy,blackhand,671,rogue,assassination,12,7,5
Роггбог,howling-fjord,671,rogue,assassination,12,7,5
Verresa,sylvanas,671,rogue,assassination,12,7,5
Zeiden,sanguino,671,rogue,assassination,18,7,11
Friter,stormscale,671,rogue,assassination,18,7,11
Oboraddon,blackrock,671,rogue,assassination,18,7,11
Nïhal,suramar,671,rogue,assassination,18,7,11
Stealthaldo,sylvanas,671,rogue,assassination,18,7,11
Althieves,ravencrest,671,rogue,assassination,18,7,11
Renaai,defias-brotherhood,671,rogue,assassination,18,7,11
Bødýchëck,blackmoore,670,rogue,assassination,12,7,5
Barkai,kazzak,670,rogue,assassination,18,7,11
Monster,kazzak,670,rogue,assassination,18,7,11
Kokksolidd,ravencrest,670,rogue,assassination,18,7,11
Elydriel,khaz-modan,670,rogue,assassination,24,7,17
Zhadowên,outland,669,rogue,assassination,12,7,5
Feucht,argent-dawn,669,rogue,assassination,18,7,11
Waltër,tyrande,669,rogue,assassination,30,7,23
Shinigamî,nemesis,668,rogue,assassination,12,7,5
Inentellian,frostwolf,668,rogue,assassination,24,7,17
Fizzkhalifa,zuljin,667,rogue,assassination,25,9,16
Vuuduu,frostmane,667,rogue,assassination,30,7,23
Jiraishin,blackmoore,666,rogue,assassination,30,7,23
Eperfej,silvermoon,666,rogue,assassination,30,7,23
Háshírama,ravencrest,665,rogue,assassination,22,8,14
Némésiss,archimonde,660,rogue,assassination,18,7,11
Зайт,howling-fjord,660,rogue,assassination,27,9,18
Twotimess,stormscale,658,rogue,assassination,12,7,5
Sanzoo,blackmoore,655,rogue,assassination,17,7,10
Shaklyn,antonidas,655,rogue,assassination,23,7,16
Niapro,dun-morogh,653,rogue,assassination,17,7,10
Rêdbello,dun-morogh,651,rogue,assassination,18,7,11
Джэкман,soulflayer,650,rogue,assassination,14,10,4
Breattick,blackmoore,649,rogue,assassination,66,18,48
Деравар,deathguard,639,rogue,assassination,22,7,15
Windhawkz,silvermoon,623,rogue,assassination,17,7,10
Chcksothrsty,ragnaros,622,rogue,assassination,11,7,4
Mozenn,draenor,622,rogue,assassination,15,7,8
Милеса,soulflayer,620,rogue,assassination,17,7,10
Însanus,blackmoore,620,rogue,assassination,23,7,16
Darkerzx,silvermoon,617,rogue,assassination,28,9,19
Трианон,galakrond,599,rogue,assassination,16,7,9
Флокуся,howling-fjord,599,rogue,assassination,28,10,18
Armando,amanthul,596,rogue,assassination,28,8,20
Rîplëy,ravencrest,591,rogue,assassination,13,7,6
Myxx,ravencrest,576,rogue,assassination,12,6,6
Voetdown,blackmoore,576,rogue,assassination,12,6,6
Necroli,kazzak,576,rogue,assassination,12,6,6
Mollyperph,ravencrest,576,rogue,assassination,12,6,6
Diagnoze,silvermoon,576,rogue,assassination,12,6,6
Ralffy,auchindoun,576,rogue,assassination,12,6,6
Flopsy,archimonde,576,rogue,assassination,12,6,6
Parawietje,twilights-hammer,576,rogue,assassination,12,6,6
Stâr,archimonde,576,rogue,assassination,12,6,6
Лиргенвард,deathguard,576,rogue,assassination,12,6,6
Blade,stormscale,576,rogue,assassination,12,6,6
Tyranoxoth,stormscale,576,rogue,assassination,12,6,6
Rágge,tarren-mill,576,rogue,assassination,12,6,6
Rilodedcoach,kazzak,576,rogue,assassination,12,6,6
Remindful,ravencrest,576,rogue,assassination,12,6,6
Sachsun,outland,576,rogue,assassination,12,6,6
Sîccarîus,ravencrest,576,rogue,assassination,12,6,6
Wrestlér,sylvanas,576,rogue,assassination,12,6,6
Alicanbey,silvermoon,576,rogue,assassination,12,6,6
Комедиантт,gordunni,576,rogue,assassination,12,6,6
Бейнс,howling-fjord,576,rogue,assassination,12,6,6
Secaboo,eredar,576,rogue,assassination,12,6,6
Rottemannen,stormscale,576,rogue,assassination,14,6,8
Imika,argent-dawn,576,rogue,assassination,18,6,12
Shredbull,ravencrest,576,rogue,assassination,18,6,12
Sinterklaas,earthen-ring,576,rogue,assassination,18,6,12
Myk,argent-dawn,576,rogue,assassination,18,6,12
Сильфитт,gordunni,576,rogue,assassination,18,6,12
Romiel,ravencrest,576,rogue,assassination,18,6,12
Blooddance,ragnaros,576,rogue,assassination,18,6,12
Zte,frostmane,576,rogue,assassination,18,6,12
Dnw,ravencrest,576,rogue,assassination,18,6,12
Edia,burning-legion,576,rogue,assassination,24,6,18
Îüçkÿmêñ,outland,575,rogue,assassination,6,6,0
Nevazutu,twisting-nether,575,rogue,assassination,12,6,6
Blackmøré,argent-dawn,575,rogue,assassination,12,6,6
Tênsion,silvermoon,575,rogue,assassination,12,6,6
Peqpen,ravencrest,575,rogue,assassination,12,6,6
Rbgdowngrade,ravencrest,575,rogue,assassination,12,6,6
Invisage,grim-batol,575,rogue,assassination,18,6,12
Shènz,ysondre,575,rogue,assassination,18,6,12
Таландриель,eversong,575,rogue,assassination,18,6,12
Керилера,eversong,575,rogue,assassination,18,6,12
Sinoptika,draenor,575,rogue,assassination,18,6,12
Fkuwu,dalaran,575,rogue,assassination,24,6,18
Outofstuns,earthen-ring,574,rogue,assassination,18,7,11
Жинпес,gordunni,574,rogue,assassination,18,6,12
Letheus,stormscale,573,rogue,assassination,18,6,12
Daddschâl,blackmoore,572,rogue,assassination,15,6,9
Whiz,alexstrasza,572,rogue,assassination,21,7,14
Gordous,ysondre,572,rogue,assassination,24,6,18
Kissmebaby,hyjal,571,rogue,assassination,12,6,6
Ninjaops,ravencrest,571,rogue,assassination,12,6,6
Lovesosa,turalyon,571,rogue,assassination,12,6,6
Ranjual,blackhand,571,rogue,assassination,12,6,6
Berruskaa,drakthul,571,rogue,assassination,12,6,6
Geovoreakos,silvermoon,569,rogue,assassination,18,6,12
Симус,lich-king,568,rogue,assassination,12,6,6
Clapslap,blackmoore,565,rogue,assassination,12,6,6
Dimah,blackmoore,563,rogue,assassination,18,6,12
Phøñkðånçér,ravencrest,559,rogue,assassination,17,6,11
Lapeur,conseil-des-ombres,559,rogue,assassination,18,6,12
Givilwtf,eredar,543,rogue,assassination,17,6,11
Ûltraaxx,ysondre,528,rogue,assassination,15,6,9
Snigmorder,silvermoon,528,rogue,assassination,16,6,10
Stonyhavana,ravencrest,527,rogue,assassination,11,6,5
Vaeira,ravencrest,527,rogue,assassination,17,6,11
Sjûkdøm,silvermoon,527,rogue,assassination,18,6,12
Вентури,borean-tundra,521,rogue,assassination,15,6,9
Logicalxy,ravencrest,511,rogue,assassination,10,6,4
Bamboozledx,draenor,511,rogue,assassination,11,6,5
Стронг,soulflayer,511,rogue,assassination,15,6,9
Зорго,deathguard,496,rogue,assassination,11,7,4
Ðescartes,antonidas,480,rogue,assassination,6,5,1
Pwoned,frostmourne,480,rogue,assassination,6,5,1
Kendyx,kirin-tor,480,rogue,assassination,12,5,7
Dìkcite,archimonde,480,rogue,assassination,12,5,7
Gögel,draenor,480,rogue,assassination,12,5,7
Trickfulz,stormscale,480,rogue,assassination,12,5,7
Heftychonk,doomhammer,480,rogue,assassination,12,5,7
Malatang,thrall,480,rogue,assassination,12,5,7
Leiemorder,twisting-nether,480,rogue,assassination,12,5,7
Neskagrall,aegwynn,480,rogue,assassination,12,5,7
Rylie,garona,480,rogue,assassination,12,5,7
Darkknïght,silvermoon,480,rogue,assassination,12,5,7
Lämä,stormreaver,480,rogue,assassination,12,5,7
Shabakftw,twisting-nether,480,rogue,assassination,12,5,7
Fixsap,aegwynn,480,rogue,assassination,12,5,7
Anhduy,blackrock,480,rogue,assassination,12,5,7
Zajii,eredar,480,rogue,assassination,12,5,7
Sholace,blackrock,480,rogue,assassination,12,5,7
Morgan,argent-dawn,480,rogue,assassination,12,5,7
Эрихард,howling-fjord,480,rogue,assassination,12,5,7
Kidalica,auchindoun,480,rogue,assassination,12,5,7
Backstabjr,blackmoore,480,rogue,assassination,12,5,7
Snurry,tarren-mill,480,rogue,assassination,12,5,7
Septicshiv,argent-dawn,480,rogue,assassination,12,5,7
Exiv,ragnaros,480,rogue,assassination,12,5,7
Кишмякх,howling-fjord,480,rogue,assassination,12,5,7
Hopbóp,magtheridon,480,rogue,assassination,12,5,7
Hì,bronzebeard,480,rogue,assassination,12,5,7
Psg,argent-dawn,480,rogue,assassination,12,5,7
Calve,tarren-mill,480,rogue,assassination,12,5,7
Letmeplay,ravencrest,480,rogue,assassination,12,5,7
Cali,shendralar,480,rogue,assassination,12,5,7
Nippzy,twisting-nether,480,rogue,assassination,12,5,7
Злобность,gordunni,480,rogue,assassination,12,5,7
Aikaza,blackmoore,480,rogue,assassination,12,5,7
Ratkebab,silvermoon,480,rogue,assassination,14,5,9
Søtez,ravencrest,480,rogue,assassination,18,5,13
Exanimu,ravencrest,480,rogue,assassination,18,5,13
Stealthi,stormscale,480,rogue,assassination,18,5,13
Ра,gordunni,480,rogue,assassination,18,5,13
Republicano,cthun,480,rogue,assassination,18,5,13
Ykw,tarren-mill,480,rogue,assassination,18,5,13
Рогадачери,gordunni,480,rogue,assassination,18,5,13
Kenjí,silvermoon,480,rogue,assassination,18,5,13
Ланароудсс,gordunni,480,rogue,assassination,18,5,13
Wrathed,stormreaver,480,rogue,assassination,18,5,13
Тучёна,soulflayer,480,rogue,assassination,18,5,13
Noxxy,archimonde,480,rogue,assassination,24,5,19
Vizifyx,ravencrest,480,rogue,assassination,24,5,19
Saptember,blackhand,479,rogue,assassination,6,5,1
Хэресс,soulflayer,479,rogue,assassination,6,5,1
Дамид,gordunni,479,rogue,assassination,12,5,7
Lescud,illidan,479,rogue,assassination,12,5,7
Shadowfangs,ravencrest,479,rogue,assassination,12,5,7
Smokie,frostmourne,479,rogue,assassination,12,5,7
Darák,thrall,479,rogue,assassination,12,5,7
Mðnki,outland,479,rogue,assassination,12,5,7
Jaymo,saurfang,479,rogue,assassination,12,5,7
Dahlin,stormscale,479,rogue,assassination,12,5,7
Tossmysaladx,silvermoon,479,rogue,assassination,12,5,7
Некролз,gordunni,479,rogue,assassination,13,5,8
Howhigh,stormscale,479,rogue,assassination,18,5,13
Гранетанцор,blackscar,479,rogue,assassination,18,5,13
Darkesthonor,silvermoon,479,rogue,assassination,18,5,13
Sît,twisting-nether,479,rogue,assassination,24,5,19
Yüm,burning-blade,478,rogue,assassination,18,5,13
Dravenfoot,defias-brotherhood,477,rogue,assassination,12,5,7
Jacksoon,dun-morogh,477,rogue,assassination,18,5,13
Magok,ysondre,476,rogue,assassination,12,5,7
Lubor,thrall,476,rogue,assassination,12,5,7
Owlcat,argent-dawn,475,rogue,assassination,12,5,7
Razboy,dun-morogh,475,rogue,assassination,12,5,7
Легион,razuvious,474,rogue,assassination,12,5,7
Lukkz,laughing-skull,474,rogue,assassination,12,5,7
Diarikths,silvermoon,447,rogue,assassination,11,5,6
Deevoll,tarren-mill,447,rogue,assassination,20,6,14
Sørä,ragnaros,444,rogue,assassination,10,5,5
Bhabì,uldaman,431,rogue,assassination,11,5,6
Jimmybrä,draenor,431,rogue,assassination,11,5,6
Rhâpsødýx,twisting-nether,426,rogue,assassination,14,6,8
Mâêl,blackmoore,426,rogue,assassination,16,6,10
Baldoh,kazzak,426,rogue,assassination,23,6,17
Bluehell,sanguino,415,rogue,assassination,10,5,5
Horóz,antonidas,400,rogue,assassination,7,5,2
Døpegame,ravencrest,400,rogue,assassination,13,5,8
Jakam,ravencrest,384,rogue,assassination,6,4,2
Áq,ravencrest,384,rogue,assassination,6,4,2
Bwònsàmdì,twisting-nether,384,rogue,assassination,6,4,2
Tebzr,ravencrest,384,rogue,assassination,6,4,2
Vögue,burning-legion,384,rogue,assassination,6,4,2
Meccura,silvermoon,384,rogue,assassination,6,4,2
Mouchess,hyjal,384,rogue,assassination,6,4,2
Sozzerogue,kazzak,384,rogue,assassination,6,4,2
Yuunr,kazzak,384,rogue,assassination,6,4,2
Дикийминус,howling-fjord,384,rogue,assassination,6,4,2
Ðoppex,blackmoore,384,rogue,assassination,6,4,2
Spolly,frostwolf,384,rogue,assassination,6,4,2
Obscuritys,nemesis,384,rogue,assassination,6,4,2
Neyloa,kazzak,384,rogue,assassination,6,4,2
Deadhawk,ravencrest,384,rogue,assassination,6,4,2
Sayianwho,ravencrest,384,rogue,assassination,6,4,2
Мёртвыйанарх,soulflayer,384,rogue,assassination,6,4,2
Sparv,jaedenar,384,rogue,assassination,6,4,2
Nineball,frostmane,384,rogue,assassination,6,4,2
Чернабаев,soulflayer,384,rogue,assassination,6,4,2
Melfîce,blackhand,384,rogue,assassination,6,4,2
Drâûgr,blackhand,384,rogue,assassination,6,4,2
Fûckínggød,outland,384,rogue,assassination,6,4,2
Juanperez,blackhand,384,rogue,assassination,6,4,2
Imatrickster,draenor,384,rogue,assassination,6,4,2
Leviathann,doomhammer,384,rogue,assassination,6,4,2
Whosmanz,ragnaros,384,rogue,assassination,6,4,2
Albinå,kazzak,384,rogue,assassination,6,4,2
Gâla,elune,384,rogue,assassination,6,4,2
Kalamàzoo,pozzo-delleternità,384,rogue,assassination,6,4,2
Voltarine,ysondre,384,rogue,assassination,6,4,2
Rosk,los-errantes,384,rogue,assassination,6,4,2
Mïkasa,ysondre,384,rogue,assassination,6,4,2
Jinxy,outland,384,rogue,assassination,6,4,2
Ebayscammer,ravencrest,384,rogue,assassination,6,4,2
Eltitoedu,dun-modr,384,rogue,assassination,6,4,2
Honeycakes,ravencrest,384,rogue,assassination,12,4,8
Níterush,eredar,384,rogue,assassination,12,4,8
Sunbra,hyjal,384,rogue,assassination,12,4,8
Rodjin,hyjal,384,rogue,assassination,12,4,8
Mysmullig,ragnaros,384,rogue,assassination,12,4,8
Zerfex,eredar,384,rogue,assassination,12,4,8
Ùmbræ,hyjal,384,rogue,assassination,12,4,8
Norpz,aggra-português,384,rogue,assassination,12,4,8
Obernik,draenor,384,rogue,assassination,12,4,8
Yakii,eredar,384,rogue,assassination,12,4,8
Sharkøo,eredar,384,rogue,assassination,12,4,8
Kïdney,stormscale,384,rogue,assassination,12,4,8
Mesyo,blackhand,384,rogue,assassination,12,4,8
Gämèøvërkíd,archimonde,384,rogue,assassination,12,4,8
Охотникведьм,soulflayer,384,rogue,assassination,12,4,8
Darkchomeur,archimonde,384,rogue,assassination,12,4,8
Bijâ,aegwynn,384,rogue,assassination,12,4,8
Sÿkz,hyjal,384,rogue,assassination,12,4,8
Ксяосупдупао,howling-fjord,384,rogue,assassination,12,4,8
Kallelelel,tarren-mill,384,rogue,assassination,12,4,8
Toskle,drakthul,384,rogue,assassination,12,4,8
Röguetönerö,dun-modr,384,rogue,assassination,12,4,8
Xtoyo,zuljin,384,rogue,assassination,12,4,8
Blacklife,sanguino,384,rogue,assassination,12,4,8
Salitra,die-aldor,384,rogue,assassination,12,4,8
Crimatoria,rajaxx,384,rogue,assassination,12,4,8
Xanyy,bloodfeather,384,rogue,assassination,12,4,8
Stepkickgodx,blackmoore,384,rogue,assassination,12,4,8
Paidaki,kazzak,384,rogue,assassination,12,4,8
Barisso,burning-legion,384,rogue,assassination,12,4,8
Галиновна,soulflayer,384,rogue,assassination,12,4,8
Eichê,alleria,384,rogue,assassination,12,4,8
Ddhelpra,blackrock,384,rogue,assassination,12,4,8
Achterom,tarren-mill,384,rogue,assassination,12,4,8
Doomdagger,chamber-of-aspects,384,rogue,assassination,12,4,8
Doktorrog,blackrock,384,rogue,assassination,12,4,8
Wickness,dun-modr,384,rogue,assassination,12,4,8
Otlaw,auchindoun,384,rogue,assassination,12,4,8
Jevo,kazzak,384,rogue,assassination,12,4,8
Lilrookie,argent-dawn,384,rogue,assassination,12,4,8
Ryxon,arathor,384,rogue,assassination,12,4,8
Izzyb,auchindoun,384,rogue,assassination,12,4,8
Артфулр,howling-fjord,384,rogue,assassination,12,4,8
Блимкинг,soulflayer,384,rogue,assassination,15,4,11
Sicarius,the-maelstrom,384,rogue,assassination,18,4,14
Елианора,gordunni,384,rogue,assassination,18,4,14
Ристоврация,gordunni,384,rogue,assassination,18,4,14
Lïke,frostwolf,384,rogue,assassination,18,4,14
Лайнэл,deathweaver,384,rogue,assassination,18,4,14
Katakuri,stormscale,384,rogue,assassination,18,4,14
Mindset,eredar,384,rogue,assassination,18,4,14
Sythex,archimonde,384,rogue,assassination,18,4,14
Ibizà,ravencrest,384,rogue,assassination,18,4,14
Zerö,tarren-mill,384,rogue,assassination,18,4,14
Vexedancer,stormscale,383,rogue,assassination,6,4,2
Kìmèrà,nemesis,383,rogue,assassination,6,4,2
Cusmos,twisting-nether,383,rogue,assassination,6,4,2
Tedko,dun-modr,383,rogue,assassination,6,4,2
Stumpén,darkspear,383,rogue,assassination,12,4,8
Algopyrin,ragnaros,383,rogue,assassination,12,4,8
Zhafira,magtheridon,383,rogue,assassination,12,4,8
Ppogg,pozzo-delleternità,383,rogue,assassination,12,4,8
Töbïï,sylvanas,383,rogue,assassination,12,4,8
Kyzzo,dalaran,383,rogue,assassination,12,4,8
Ксенорф,ashenvale,383,rogue,assassination,15,4,11
Kylìemirogue,blackrock,383,rogue,assassination,18,4,14
Ðæmøn,tarren-mill,383,rogue,assassination,24,5,19
Twinkyzzö,archimonde,382,rogue,assassination,12,4,8
Бамболейлоо,grom,381,rogue,assassination,12,4,8
Møkkagnom,darkspear,381,rogue,assassination,12,4,8
Pumpy,blades-edge,381,rogue,assassination,12,4,8
Midô,dun-morogh,381,rogue,assassination,18,4,14
Easy,kult-der-verdammten,376,rogue,assassination,18,4,14
Iwilsucceed,argent-dawn,376,rogue,assassination,36,5,31
Stealtheous,arathor,367,rogue,assassination,11,4,7
Стелсочка,gordunni,351,rogue,assassination,11,4,7
Blurryfacé,frostmane,351,rogue,assassination,11,4,7
Lilbubblegum,emerald-dream,351,rogue,assassination,11,4,7
Морзо,howling-fjord,351,rogue,assassination,17,4,13
Voraq,blackhand,350,rogue,assassination,11,4,7
Teralala,kazzak,336,rogue,assassination,9,4,5
Arathir,ravencrest,330,rogue,assassination,15,5,10
Eljana,amanthul,322,rogue,assassination,24,7,17
Soníc,kiljaeden,319,rogue,assassination,5,4,1
Benh,ysondre,319,rogue,assassination,8,4,4
Fz,chants-éternels,319,rogue,assassination,16,5,11
Xeløe,hyjal,288,rogue,assassination,6,3,3
Thenotorious,shadowsong,288,rogue,assassination,6,3,3
Rodént,argent-dawn,288,rogue,assassination,6,3,3
Deadraw,aegwynn,288,rogue,assassination,6,3,3
Evus,ravencrest,288,rogue,assassination,6,3,3
Mînd,kazzak,288,rogue,assassination,6,3,3
Schurok,aegwynn,288,rogue,assassination,6,3,3
Ultraxette,ysondre,288,rogue,assassination,6,3,3
Олддеадроб,soulflayer,288,rogue,assassination,6,3,3
Tasster,frostwolf,288,rogue,assassination,6,3,3
Cipher,elune,288,rogue,assassination,6,3,3
Yaelynn,argent-dawn,288,rogue,assassination,6,3,3
Jackpackáge,sylvanas,288,rogue,assassination,6,3,3
Brêêzy,die-aldor,288,rogue,assassination,6,3,3
Nhara,medivh,288,rogue,assassination,6,3,3
Aati,the-maelstrom,288,rogue,assassination,6,3,3
Langneurr,archimonde,288,rogue,assassination,6,3,3
Blackrabbít,azshara,288,rogue,assassination,6,3,3
Mazokisti,outland,288,rogue,assassination,6,3,3
Sorashna,agamaggan,288,rogue,assassination,6,3,3
Dôlf,hyjal,288,rogue,assassination,6,3,3
Steálth,silvermoon,288,rogue,assassination,6,3,3
Ææçæçæçæ,twisting-nether,288,rogue,assassination,6,3,3
Kaylí,kazzak,288,rogue,assassination,6,3,3
Obliveron,dalaran,288,rogue,assassination,6,3,3
Keexy,ravencrest,288,rogue,assassination,6,3,3
Lïhtêñßërg,ravencrest,288,rogue,assassination,6,3,3
Labronka,sanguino,288,rogue,assassination,6,3,3
Jhx,antonidas,288,rogue,assassination,6,3,3
Дореан,howling-fjord,288,rogue,assassination,6,3,3
Лорб,howling-fjord,288,rogue,assassination,6,3,3
Stroògz,ysondre,288,rogue,assassination,6,3,3
Releaserage,draenor,288,rogue,assassination,6,3,3
Zigaretz,ravencrest,288,rogue,assassination,6,3,3
Котянкахд,howling-fjord,288,rogue,assassination,6,3,3
Lättja,hyjal,288,rogue,assassination,6,3,3
Aska,antonidas,288,rogue,assassination,6,3,3
Выносяшка,deathguard,288,rogue,assassination,6,3,3
Бомбирибом,gordunni,288,rogue,assassination,6,3,3
Reaventis,ravencrest,288,rogue,assassination,6,3,3
Nezukóchan,ravencrest,288,rogue,assassination,6,3,3
Solomid,ravencrest,288,rogue,assassination,6,3,3
Jpi,ragnaros,288,rogue,assassination,6,3,3
Чудох,gordunni,288,rogue,assassination,6,3,3
Ацилия,galakrond,288,rogue,assassination,6,3,3
Stealthb,ravencrest,288,rogue,assassination,6,3,3
Mordred,stormscale,288,rogue,assassination,6,3,3
Râizo,archimonde,288,rogue,assassination,6,3,3
Pelana,defias-brotherhood,288,rogue,assassination,6,3,3
Lyray,die-aldor,288,rogue,assassination,6,3,3
Stealthyist,darkmoon-faire,288,rogue,assassination,6,3,3
Luciferx,stormscale,288,rogue,assassination,6,3,3
Illusious,ragnaros,288,rogue,assassination,6,3,3
Smorcoolio,stormscale,288,rogue,assassination,6,3,3
Syrn,ravencrest,288,rogue,assassination,9,4,5
Vyllaftw,hyjal,288,rogue,assassination,10,3,7
Psybelette,khaz-modan,288,rogue,assassination,15,4,11
Hardkølle,ravencrest,288,rogue,assassination,12,3,9
Persës,ravencrest,288,rogue,assassination,12,3,9
Highz,zenedar,288,rogue,assassination,12,3,9
Fushimi,ravencrest,288,rogue,assassination,12,3,9
Rôst,ravencrest,288,rogue,assassination,12,3,9
Азунайт,ashenvale,288,rogue,assassination,12,3,9
Gløck,die-aldor,288,rogue,assassination,12,3,9
Redork,twisting-nether,288,rogue,assassination,12,3,9
Vessel,tarren-mill,288,rogue,assassination,12,3,9
Terya,ragnaros,288,rogue,assassination,12,3,9
Turbocandle,ravencrest,288,rogue,assassination,12,3,9
Kshero,sylvanas,288,rogue,assassination,12,3,9
Курога,howling-fjord,288,rogue,assassination,12,3,9
Hamer,eredar,288,rogue,assassination,12,3,9
Seeschlange,amanthul,288,rogue,assassination,12,3,9
Yamoshí,sanguino,288,rogue,assassination,12,3,9
Poguemahone,ravencrest,288,rogue,assassination,12,3,9
Hersuub,blackmoore,288,rogue,assassination,12,3,9
Eriksonn,drakthul,288,rogue,assassination,12,3,9
Sickko,stormscale,288,rogue,assassination,12,3,9
Zip,alleria,288,rogue,assassination,12,3,9
Yakku,drakthul,288,rogue,assassination,12,3,9
Narutø,sylvanas,288,rogue,assassination,12,3,9
Radgaa,draenor,288,rogue,assassination,12,3,9
Derxx,stormscale,288,rogue,assassination,12,3,9
Nezuko,gilneas,288,rogue,assassination,12,3,9
Voltface,suramar,288,rogue,assassination,12,3,9
Маннариа,soulflayer,288,rogue,assassination,12,3,9
Anesthetics,stormscale,288,rogue,assassination,12,3,9
Teldã,archimonde,288,rogue,assassination,12,3,9
Ryurfy,archimonde,288,rogue,assassination,12,3,9
Bumaqt,silvermoon,288,rogue,assassination,12,3,9
Smokeyx,outland,288,rogue,assassination,12,3,9
Onedance,blackrock,288,rogue,assassination,14,3,11
Mxrbid,defias-brotherhood,288,rogue,assassination,18,3,15
Crittylohan,blackrock,288,rogue,assassination,18,3,15
Memphismp,drakthul,288,rogue,assassination,18,3,15
Jáyjay,antonidas,288,rogue,assassination,18,3,15
Brícx,alleria,288,rogue,assassination,18,3,15
Killboom,rexxar,287,rogue,assassination,6,3,3
Willin,kazzak,287,rogue,assassination,6,3,3
Умбрен,lich-king,287,rogue,assassination,6,3,3
Yubleeding,kazzak,287,rogue,assassination,6,3,3
Wizzo,onyxia,287,rogue,assassination,6,3,3
Гламурятина,gordunni,287,rogue,assassination,6,3,3
Coanageta,draenor,287,rogue,assassination,6,3,3
Sylaba,burning-legion,287,rogue,assassination,12,3,9
Vendox,defias-brotherhood,287,rogue,assassination,12,3,9
Nastyrogue,burning-legion,287,rogue,assassination,12,3,9
Фоксивнир,soulflayer,286,rogue,assassination,6,3,3
Adewale,kazzak,286,rogue,assassination,12,3,9
Mersible,blackrock,286,rogue,assassination,12,3,9
Ecilaa,conseil-des-ombres,285,rogue,assassination,12,3,9
Derrieretoî,archimonde,285,rogue,assassination,12,3,9
Elvís,chamber-of-aspects,284,rogue,assassination,12,3,9
Verbb,turalyon,284,rogue,assassination,12,3,9
Bobydrift,khaz-modan,284,rogue,assassination,12,3,9
Layson,les-clairvoyants,271,rogue,assassination,11,3,8
Технорэйв,gordunni,271,rogue,assassination,33,4,29
Монтанатони,eversong,271,rogue,assassination,29,3,26
Schagrath,tarren-mill,255,rogue,assassination,11,3,8
Candise,ysondre,253,rogue,assassination,11,3,8
Blckrogue,bloodfeather,240,rogue,assassination,9,3,6
Stashin,stormscale,240,rogue,assassination,10,3,7
Dizze,blackmoore,239,rogue,assassination,5,3,2
Stepdead,tarren-mill,239,rogue,assassination,5,3,2
Starkad,archimonde,239,rogue,assassination,5,3,2
Dmr,aegwynn,239,rogue,assassination,5,3,2
Kejú,alleria,239,rogue,assassination,5,3,2
Alyzon,ravencrest,239,rogue,assassination,17,3,14
Pilliwinks,alonsus,234,rogue,assassination,8,4,4
Koteczka,burning-legion,234,rogue,assassination,15,4,11
Vv,terokkar,232,rogue,assassination,12,4,8
Kebabgodx,sanguino,223,rogue,assassination,8,3,5
Asdfqwerty,ravencrest,223,rogue,assassination,8,3,5
Аренатрюки,soulflayer,192,rogue,assassination,6,2,4
Аутянин,soulflayer,192,rogue,assassination,6,2,4
Сабстрайк,soulflayer,192,rogue,assassination,6,2,4
Synexo,sylvanas,192,rogue,assassination,6,2,4
Noilek,sylvanas,192,rogue,assassination,6,2,4
Tajina,elune,192,rogue,assassination,6,2,4
Снэбак,soulflayer,192,rogue,assassination,6,2,4
Ленчюня,soulflayer,192,rogue,assassination,6,2,4
Sokillu,nemesis,192,rogue,assassination,6,2,4
Bangerstab,draenor,192,rogue,assassination,6,2,4
Fliegenfurz,blackmoore,192,rogue,assassination,6,2,4
Shúrae,blackmoore,192,rogue,assassination,6,2,4
Ålleyézonme,ravencrest,192,rogue,assassination,6,2,4
Habba,dragonblight,192,rogue,assassination,6,2,4
Pixeling,ravencrest,192,rogue,assassination,6,2,4
Xeggy,turalyon,192,rogue,assassination,6,2,4
Evi,korgall,192,rogue,assassination,6,2,4
Саулите,deathguard,192,rogue,assassination,6,2,4
Reichy,ravencrest,192,rogue,assassination,6,2,4
Ðarkreign,sanguino,192,rogue,assassination,6,2,4
Isucu,burning-legion,192,rogue,assassination,6,2,4
Notlikethis,twisting-nether,192,rogue,assassination,6,2,4
Lahzurax,twisting-nether,192,rogue,assassination,6,2,4
Lqueespack,kazzak,192,rogue,assassination,6,2,4
Câptcâp,twisting-nether,192,rogue,assassination,6,2,4
Maxrizzx,ravencrest,192,rogue,assassination,6,2,4
Kaamen,die-silberne-hand,192,rogue,assassination,6,2,4
Шизачи,gordunni,192,rogue,assassination,6,2,4
Zyphion,ragnaros,192,rogue,assassination,6,2,4
Gårónå,thrall,192,rogue,assassination,6,2,4
Dombyy,ragnaros,192,rogue,assassination,6,2,4
Sycko,alakir,192,rogue,assassination,6,2,4
Diliu,doomhammer,192,rogue,assassination,6,2,4
Киринорте,gordunni,192,rogue,assassination,6,2,4
Rearmer,burning-legion,192,rogue,assassination,6,2,4
Robtherobber,kazzak,192,rogue,assassination,6,2,4
Hideout,ravencrest,192,rogue,assassination,6,2,4
Xiom,thrall,192,rogue,assassination,6,2,4
Dwingvat,khaz-modan,192,rogue,assassination,6,2,4
Zømbië,kazzak,192,rogue,assassination,6,2,4
Kersatos,silvermoon,192,rogue,assassination,6,2,4
Gladßreakz,dun-modr,192,rogue,assassination,6,2,4
Ðelvin,dalaran,192,rogue,assassination,6,2,4
Gane,sanguino,192,rogue,assassination,6,2,4
Behindü,frostmane,192,rogue,assassination,6,2,4
Ikaze,kazzak,192,rogue,assassination,6,2,4
Zerukos,thrall,192,rogue,assassination,6,2,4
Киу,howling-fjord,192,rogue,assassination,6,2,4
Jonewrld,ravencrest,192,rogue,assassination,6,2,4
Теньглуши,gordunni,192,rogue,assassination,6,2,4
Niagram,dun-modr,192,rogue,assassination,6,2,4
Tinta,aszune,192,rogue,assassination,6,2,4
Saix,blackrock,192,rogue,assassination,6,2,4
Иннхотеп,howling-fjord,192,rogue,assassination,6,2,4
Shinobian,ravencrest,192,rogue,assassination,6,2,4
Revisiôn,tarren-mill,192,rogue,assassination,6,2,4
Silentknives,silvermoon,192,rogue,assassination,6,2,4
Drfeelgòód,nethersturm,192,rogue,assassination,6,2,4
Garou,blackhand,192,rogue,assassination,6,2,4
Grimson,kazzak,192,rogue,assassination,6,2,4
Пожилойпупь,gordunni,192,rogue,assassination,6,2,4
Fälke,dun-modr,192,rogue,assassination,6,2,4
Gleaming,madmortem,192,rogue,assassination,6,2,4
Venom,stormscale,192,rogue,assassination,6,2,4
Tofix,tarren-mill,192,rogue,assassination,6,2,4
Bloodwraith,stormscale,192,rogue,assassination,6,2,4
Fredge,stormscale,192,rogue,assassination,6,2,4
Grinfester,stormscale,192,rogue,assassination,6,2,4
Нойсеен,gordunni,192,rogue,assassination,6,2,4
Díddz,tarren-mill,192,rogue,assassination,6,2,4
Barneý,tarren-mill,192,rogue,assassination,6,2,4
Nudelholz,blackrock,192,rogue,assassination,6,2,4
Bórgós,blackrock,192,rogue,assassination,6,2,4
Warbell,stormscale,192,rogue,assassination,6,2,4
Nàlaa,ravencrest,192,rogue,assassination,6,2,4
Rexore,ravencrest,192,rogue,assassination,6,2,4
Vorsix,tarren-mill,192,rogue,assassination,6,2,4
Selfcut,blackmoore,192,rogue,assassination,6,2,4
Aaze,kazzak,192,rogue,assassination,6,2,4
Apéxx,blackrock,192,rogue,assassination,6,2,4
Maximumlel,ravencrest,192,rogue,assassination,6,2,4
Dépressionqt,ravencrest,192,rogue,assassination,6,2,4
Bickia,silvermoon,192,rogue,assassination,6,2,4
Rizzardx,ravencrest,192,rogue,assassination,6,2,4
Grocco,doomhammer,192,rogue,assassination,6,2,4
Ichiegoichie,draenor,192,rogue,assassination,6,2,4
Dioûf,frostwolf,192,rogue,assassination,6,2,4
Fenissa,ysondre,192,rogue,assassination,6,2,4
Xanders,draenor,192,rogue,assassination,6,2,4
Sêrgi,minahonda,192,rogue,assassination,6,2,4
Laciecute,silvermoon,192,rogue,assassination,6,2,4
Mattyc,bronze-dragonflight,192,rogue,assassination,6,2,4
Новиччокк,gordunni,192,rogue,assassination,6,2,4
Eigle,archimonde,192,rogue,assassination,6,2,4
Steelyowife,archimonde,192,rogue,assassination,6,2,4
Henlh,turalyon,192,rogue,assassination,6,2,4
Goldenblitz,blackmoore,192,rogue,assassination,6,2,4
Sanzsa,ravencrest,192,rogue,assassination,6,2,4
Biokioledin,draenor,192,rogue,assassination,6,2,4
Люняшка,booty-bay,192,rogue,assassination,6,2,4
Renyth,argent-dawn,192,rogue,assassination,6,2,4
Redrumx,outland,192,rogue,assassination,6,2,4
Lastkiss,aggramar,192,rogue,assassination,6,2,4
Eazmode,outland,192,rogue,assassination,6,2,4
Grüeßseebach,todeswache,192,rogue,assassination,6,2,4
Rawryy,blackmoore,192,rogue,assassination,6,2,4
Crowg,drakthul,192,rogue,assassination,6,2,4
Tiemyrópe,outland,192,rogue,assassination,6,2,4
Weird,blackmoore,192,rogue,assassination,6,2,4
Jinêxo,shattrath,192,rogue,assassination,6,2,4
Katara,antonidas,192,rogue,assassination,6,2,4
Fîst,antonidas,192,rogue,assassination,6,2,4
Кашеварить,gordunni,192,rogue,assassination,6,2,4
Mobrac,silvermoon,192,rogue,assassination,6,2,4
Brazzersx,antonidas,192,rogue,assassination,6,2,4
Hertyso,outland,192,rogue,assassination,6,2,4
Warrdenn,draenor,192,rogue,assassination,6,2,4
Kikitaklk,uldum,192,rogue,assassination,6,2,4
Enthuque,draenor,192,rogue,assassination,6,2,4
Helcof,emerald-dream,192,rogue,assassination,6,2,4
Breathcutter,hyjal,192,rogue,assassination,6,2,4
Säku,la-croisade-écarlate,192,rogue,assassination,6,2,4
Мариалолз,gordunni,192,rogue,assassination,6,2,4
Свартахейм,soulflayer,192,rogue,assassination,9,2,7
Totentánz,silvermoon,192,rogue,assassination,15,3,12
Withoutlove,drakthul,192,rogue,assassination,12,2,10
Sneakzy,sylvanas,192,rogue,assassination,12,2,10
Tyräel,burning-blade,192,rogue,assassination,12,2,10
Hanteran,magtheridon,192,rogue,assassination,12,2,10
Sylvanshadow,nemesis,192,rogue,assassination,12,2,10
Hitogoroshi,hyjal,192,rogue,assassination,12,2,10
Madridistaßß,outland,192,rogue,assassination,12,2,10
Dalishia,blackhand,192,rogue,assassination,12,2,10
Neirdà,hyjal,192,rogue,assassination,12,2,10
Ôrígìnälnezo,drakthul,192,rogue,assassination,12,2,10
Меттерз,gordunni,192,rogue,assassination,12,2,10
Naí,zuljin,192,rogue,assassination,12,2,10
Mingzhu,ravencrest,192,rogue,assassination,12,2,10
Параножей,howling-fjord,192,rogue,assassination,12,2,10
Rasponi,ragnaros,192,rogue,assassination,12,2,10
Tokyotears,ravencrest,192,rogue,assassination,12,2,10
Sheyrrà,aegwynn,192,rogue,assassination,12,2,10
Cacucoxpahu,kazzak,192,rogue,assassination,12,2,10
Vezinia,ravencrest,192,rogue,assassination,12,2,10
Bolesnirogue,draenor,192,rogue,assassination,12,2,10
Лэйкиро,gordunni,192,rogue,assassination,12,2,10
Mødinüs,archimonde,192,rogue,assassination,12,2,10
Skuggdunkarn,draenor,192,rogue,assassination,12,2,10
Skilz,sylvanas,192,rogue,assassination,12,2,10
Ayatsuji,nemesis,192,rogue,assassination,12,2,10
Nesä,hyjal,192,rogue,assassination,18,2,16
Coopér,argent-dawn,192,rogue,assassination,18,2,16
Drexxo,drakthul,191,rogue,assassination,6,2,4
Nhot,kazzak,191,rogue,assassination,6,2,4
Токссиси,gordunni,191,rogue,assassination,6,2,4
Sneazzy,marécage-de-zangar,191,rogue,assassination,6,2,4
Morder,nemesis,191,rogue,assassination,6,2,4
Thugore,thunderhorn,191,rogue,assassination,6,2,4
Arthhurra,ragnaros,191,rogue,assassination,12,2,10
Вангельм,gordunni,191,rogue,assassination,12,2,10
Murant,twisting-nether,190,rogue,assassination,12,2,10
Snikrot,karazhan,190,rogue,assassination,12,2,10
Icyicé,kazzak,175,rogue,assassination,11,2,9
Ццианидд,gordunni,169,rogue,assassination,17,5,12
Durpur,sylvanas,159,rogue,assassination,5,2,3
Dalyarrogue,twisting-nether,159,rogue,assassination,5,2,3
Nià,argent-dawn,158,rogue,assassination,10,2,8
Астерист,gordunni,142,rogue,assassination,9,2,7
Gitguduwu,tarren-mill,138,rogue,assassination,10,3,7
Shâdowfreeze,onyxia,138,rogue,assassination,22,4,18
Тойтаро,soulflayer,96,rogue,assassination,3,2,1
Hallowéén,turalyon,96,rogue,assassination,6,1,5
Duo,karazhan,96,rogue,assassination,6,1,5
Appelschorlê,eredar,96,rogue,assassination,6,1,5
Jamzyrogue,emerald-dream,96,rogue,assassination,6,1,5
Sly,emerald-dream,96,rogue,assassination,6,1,5
Msrogue,eredar,96,rogue,assassination,6,1,5
Normbutt,outland,96,rogue,assassination,6,1,5
Buffdh,eredar,96,rogue,assassination,6,1,5
Vanisshh,hyjal,96,rogue,assassination,6,1,5
Olgabuzova,hyjal,96,rogue,assassination,6,1,5
Mokmok,frostwolf,96,rogue,assassination,6,1,5
Flêxô,antonidas,96,rogue,assassination,6,1,5
Hàly,ravencrest,96,rogue,assassination,6,1,5
Иордани,gordunni,96,rogue,assassination,6,1,5
Zarlen,argent-dawn,96,rogue,assassination,6,1,5
Osap,kazzak,96,rogue,assassination,6,1,5
Vexior,argent-dawn,96,rogue,assassination,6,1,5
Paveli,ravencrest,96,rogue,assassination,6,1,5
Wøølfgang,archimonde,96,rogue,assassination,6,1,5
Lorinthel,argent-dawn,96,rogue,assassination,6,1,5
Mortdorei,argent-dawn,96,rogue,assassination,6,1,5
Dieschönheit,kazzak,96,rogue,assassination,6,1,5
Ohmydotz,archimonde,96,rogue,assassination,6,1,5
Роудхог,blackscar,96,rogue,assassination,6,1,5
Deceptionz,ravencrest,96,rogue,assassination,6,1,5
Roguy,wildhammer,96,rogue,assassination,6,1,5
Nexieane,ravencrest,96,rogue,assassination,6,1,5
Gílgámesh,outland,96,rogue,assassination,6,1,5
Takiya,ysondre,96,rogue,assassination,6,1,5
Asmodal,die-nachtwache,96,rogue,assassination,6,1,5
Nelji,archimonde,96,rogue,assassination,6,1,5
Donowan,stormscale,96,rogue,assassination,6,1,5
Bekkz,todeswache,96,rogue,assassination,6,1,5
Yörgs,eredar,96,rogue,assassination,6,1,5
Chøsen,stormscale,96,rogue,assassination,6,1,5
Azryel,tarren-mill,96,rogue,assassination,6,1,5
Sozzerog,kazzak,96,rogue,assassination,6,1,5
Djkollejk,malganis,96,rogue,assassination,6,1,5
Ñavy,archimonde,96,rogue,assassination,6,1,5
Freakzi,blackhand,96,rogue,assassination,6,1,5
Héragor,illidan,96,rogue,assassination,6,1,5
Bizzarerogue,tarren-mill,96,rogue,assassination,6,1,5
Метаболикх,gordunni,96,rogue,assassination,6,1,5
Shåkø,tarren-mill,96,rogue,assassination,6,1,5
Missàh,archimonde,96,rogue,assassination,6,1,5
Roguerstam,kazzak,96,rogue,assassination,6,1,5
Дизелюжн,howling-fjord,96,rogue,assassination,6,1,5
Pfaded,steamwheedle-cartel,96,rogue,assassination,6,1,5
Dachdagger,malfurion,96,rogue,assassination,6,1,5
Guzirogue,azshara,96,rogue,assassination,6,1,5
Социалистсс,gordunni,96,rogue,assassination,6,1,5
Кустедис,howling-fjord,96,rogue,assassination,6,1,5
Faso,thunderhorn,96,rogue,assassination,6,1,5
Hendrikske,aggramar,96,rogue,assassination,6,1,5
Пастернук,howling-fjord,96,rogue,assassination,6,1,5
Ðiè,frostmane,96,rogue,assassination,6,1,5
Knive,marécage-de-zangar,96,rogue,assassination,6,1,5
Dayanir,aggra-português,96,rogue,assassination,6,1,5
Кейнилин,gordunni,96,rogue,assassination,6,1,5
Møtivate,ragnaros,96,rogue,assassination,6,1,5
Royalflüx,grim-batol,96,rogue,assassination,6,1,5
Lizwi,ragnaros,96,rogue,assassination,6,1,5
Sbx,alakir,96,rogue,assassination,6,1,5
Mekóz,draenor,96,rogue,assassination,6,1,5
Pronna,ragnaros,96,rogue,assassination,6,1,5
Finfcyn,burning-legion,96,rogue,assassination,6,1,5
Dâlis,kazzak,96,rogue,assassination,6,1,5
Cÿlan,sylvanas,96,rogue,assassination,6,1,5
Fllowow,stormscale,96,rogue,assassination,6,1,5
Kilabre,twisting-nether,96,rogue,assassination,6,1,5
Janx,aegwynn,96,rogue,assassination,6,1,5
Ravenom,sylvanas,96,rogue,assassination,6,1,5
Гриксон,blackscar,96,rogue,assassination,6,1,5
Пондимониум,azuregos,96,rogue,assassination,6,1,5
Depleter,bloodfeather,96,rogue,assassination,6,1,5
Toketje,sylvanas,96,rogue,assassination,6,1,5
Penetrantos,eredar,96,rogue,assassination,6,1,5
Nerfexpected,silvermoon,96,rogue,assassination,6,1,5
Macix,zuljin,96,rogue,assassination,6,1,5
Twoballz,doomhammer,96,rogue,assassination,6,1,5
Natkatje,azjolnerub,96,rogue,assassination,6,1,5
Goblindrill,blackmoore,96,rogue,assassination,6,1,5
Roronao,sanguino,96,rogue,assassination,6,1,5
Frequenzalfa,silvermoon,96,rogue,assassination,6,1,5
Pjotre,mannoroth,96,rogue,assassination,6,1,5
Ziqqiqt,thrall,96,rogue,assassination,6,1,5
Tyzla,blackrock,96,rogue,assassination,6,1,5
Thiranor,cthun,96,rogue,assassination,6,1,5
Asasina,los-errantes,96,rogue,assassination,6,1,5
Куллтро,blackscar,96,rogue,assassination,6,1,5
Bakithekiddo,silvermoon,96,rogue,assassination,6,1,5
Expositiv,blackmoore,96,rogue,assassination,6,1,5
Stepbro,kelthuzad,96,rogue,assassination,6,1,5
Natillaa,dun-modr,96,rogue,assassination,6,1,5
Mazikeeñ,silvermoon,96,rogue,assassination,6,1,5
Cappuccinoxo,blackmoore,96,rogue,assassination,6,1,5
Flaycesap,blackmoore,96,rogue,assassination,6,1,5
Kenko,aerie-peak,96,rogue,assassination,6,1,5
Yamajinzu,blackmoore,96,rogue,assassination,6,1,5
Boloboc,ravencrest,96,rogue,assassination,7,1,6
Распяздяй,gordunni,96,rogue,assassination,7,1,6
Proilas,draenor,96,rogue,assassination,11,1,10
Роророл,gordunni,96,rogue,assassination,12,1,11
Tybiereus,argent-dawn,96,rogue,assassination,12,1,11
Barbuniarz,shadowsong,96,rogue,assassination,12,1,11
Axidían,argent-dawn,96,rogue,assassination,12,1,11
Sanguinea,minahonda,96,rogue,assassination,12,1,11
Jawen,silvermoon,96,rogue,assassination,12,1,11
Erenyeagerx,kazzak,96,rogue,assassination,12,1,11
Ønlylovcindy,drekthar,96,rogue,assassination,12,1,11
Engles,twisting-nether,96,rogue,assassination,12,1,11
Триплсап,howling-fjord,96,rogue,assassination,12,1,11
Рестинписер,soulflayer,96,rogue,assassination,12,1,11
Diededlmao,ragnaros,96,rogue,assassination,12,1,11
Kyoukaî,archimonde,96,rogue,assassination,12,1,11
Wxlf,ravencrest,96,rogue,assassination,12,1,11
Crispflake,frostwolf,96,rogue,assassination,18,1,17
Calyon,hyjal,96,rogue,assassination,18,1,17
Ravéñ,silvermoon,96,rogue,assassination,24,1,23
Vicenzo,archimonde,95,rogue,assassination,3,2,1
Jëster,hyjal,95,rogue,assassination,3,2,1
Аморалез,deathweaver,95,rogue,assassination,6,1,5
Belina,draenor,95,rogue,assassination,6,1,5
Вейкингдрим,gordunni,79,rogue,assassination,5,1,4
Nerkmind,ragnaros,64,rogue,assassination,4,1,3
Twitch,uldaman,64,rogue,assassination,4,1,3
Vound,tarren-mill,64,rogue,assassination,4,1,3
Elgande,stormrage,63,rogue,assassination,2,2,0
Rûzk,frostwolf,48,rogue,assassination,3,1,2
Vanquishz,arathor,48,rogue,assassination,3,1,2
Latscholol,malorne,42,rogue,assassination,12,3,9
Хемофилия,grom,42,rogue,assassination,8,2,6
Kanilol,eredar,42,rogue,assassination,8,2,6
Sýn,eredar,42,rogue,assassination,10,2,8
Nightbláde,burning-legion,42,rogue,assassination,10,2,8
Kkraken,dalaran,41,rogue,assassination,10,2,8
Sofang,colinas-pardas,31,rogue,assassination,2,1,1
Дивеас,blackscar,31,rogue,assassination,8,1,7
Abaar,defias-brotherhood,16,rogue,assassination,13,1,12
Domo,stormscale,2228,shaman,restoration,156,81,75
Chokelord,archimonde,2185,shaman,restoration,66,40,26
Shadrak,eredar,2172,shaman,restoration,102,55,47
Shamidrak,eredar,2159,shaman,restoration,114,60,54
Navajito,tarren-mill,2154,shaman,restoration,60,42,18
Hímars,ragnaros,2151,shaman,restoration,101,52,49
Gigawashed,archimonde,2145,shaman,restoration,53,38,15
Венжии,soulflayer,2144,shaman,restoration,120,61,59
Timide,ravencrest,2141,shaman,restoration,84,45,39
Killrogge,kazzak,2135,shaman,restoration,109,78,31
Сладкийстас,soulflayer,2129,shaman,restoration,197,108,89
Мефодийшаман,howling-fjord,2126,shaman,restoration,142,88,54
Chävaman,archimonde,2124,shaman,restoration,78,44,34
Терату,howling-fjord,2118,shaman,restoration,84,46,38
Valko,hellfire,2113,shaman,restoration,84,51,33
Crnine,pozzo-delleternità,2112,shaman,restoration,75,49,26
Mininini,ravencrest,2112,shaman,restoration,151,78,73
Libanô,archimonde,2112,shaman,restoration,1009,498,511
Keén,burning-legion,2103,shaman,restoration,147,82,65
Jackypink,ragnaros,2102,shaman,restoration,279,144,135
Кодитян,gordunni,2100,shaman,restoration,89,48,41
Светшам,howling-fjord,2098,shaman,restoration,94,49,45
Somethingnew,azuremyst,2096,shaman,restoration,225,112,113
Vanostbzt,kazzak,2093,shaman,restoration,94,46,48
Zhull,ravencrest,2079,shaman,restoration,693,350,343
Unbrokeñ,stormscale,2077,shaman,restoration,99,49,50
Asynchund,ravencrest,2074,shaman,restoration,77,45,32
Benpai,eredar,2072,shaman,restoration,118,61,57
Snovii,drakthul,2067,shaman,restoration,108,54,54
Ultrahound,twisting-nether,2057,shaman,restoration,48,39,9
Иними,soulflayer,2052,shaman,restoration,449,229,220
Daretodream,blackrock,2050,shaman,restoration,59,32,27
Elmezz,aggra-português,2050,shaman,restoration,88,47,41
Rheax,tarren-mill,2050,shaman,restoration,84,44,40
Wess,archimonde,2048,shaman,restoration,66,35,31
Nokster,twisting-nether,2038,shaman,restoration,230,141,89
Дольчих,deathguard,2036,shaman,restoration,325,158,167
Nickygodx,stormscale,2032,shaman,restoration,113,60,53
Jelincic,ravencrest,2027,shaman,restoration,96,52,44
Carlitosham,eredar,2027,shaman,restoration,110,54,56
Greggyb,twisting-nether,2026,shaman,restoration,60,34,26
Keenxd,burning-legion,2026,shaman,restoration,154,83,71
Langhantel,kazzak,2017,shaman,restoration,176,107,69
Вишняблэйз,soulflayer,2011,shaman,restoration,219,118,101
Arathoir,ravencrest,2009,shaman,restoration,84,47,37
Swineflowing,ysondre,2004,shaman,restoration,120,63,57
Lavalavalava,blackrock,1993,shaman,restoration,447,244,203
Josë,twisting-nether,1992,shaman,restoration,191,97,94
Skillrogge,kazzak,1990,shaman,restoration,80,49,31
Panda,stormscale,1990,shaman,restoration,102,57,45
Светшамка,howling-fjord,1988,shaman,restoration,47,28,19
Chäväman,archimonde,1987,shaman,restoration,220,108,112
Драгенхз,gordunni,1983,shaman,restoration,387,195,192
Kisshots,the-maelstrom,1976,shaman,restoration,372,191,181
Carlpeant,drakthul,1968,shaman,restoration,245,124,121
Слишкомплох,howling-fjord,1967,shaman,restoration,90,42,48
Moistpuss,kazzak,1966,shaman,restoration,126,81,45
Finaltotem,draenor,1966,shaman,restoration,132,61,71
Gargro,kazzak,1965,shaman,restoration,175,93,82
Frshprn,hyjal,1964,shaman,restoration,108,59,49
Deepwithyou,blackhand,1964,shaman,restoration,165,90,75
Söd,dun-morogh,1961,shaman,restoration,191,98,93
Слишкомпох,howling-fjord,1960,shaman,restoration,54,30,24
Trashgame,kazzak,1960,shaman,restoration,160,83,77
Twísting,tarren-mill,1959,shaman,restoration,101,57,44
Ltmsham,ravencrest,1959,shaman,restoration,54,28,26
Eras,ragnaros,1956,shaman,restoration,46,30,16
Shockojambo,kazzak,1954,shaman,restoration,78,37,41
Bowiè,twisting-nether,1954,shaman,restoration,78,36,42
Epsylone,kazzak,1953,shaman,restoration,101,51,50
Sèfìx,tarren-mill,1952,shaman,restoration,49,25,24
Bobanrajovic,silvermoon,1951,shaman,restoration,54,33,21
Linkx,stormscale,1948,shaman,restoration,40,22,18
Gettingolder,kazzak,1948,shaman,restoration,80,38,42
Боунсе,howling-fjord,1945,shaman,restoration,72,36,36
Kalypsø,arthas,1942,shaman,restoration,106,62,44
Ønepåc,hyjal,1930,shaman,restoration,93,44,49
Ripperdoc,stormreaver,1930,shaman,restoration,144,68,76
Rhinoketamin,kazzak,1928,shaman,restoration,128,79,49
Dàazle,ravencrest,1928,shaman,restoration,137,64,73
Lavelover,tarren-mill,1927,shaman,restoration,66,41,25
Rogerscruton,blades-edge,1924,shaman,restoration,365,185,180
Oldandslow,sylvanas,1923,shaman,restoration,72,38,34
Skreewu,outland,1923,shaman,restoration,144,69,75
Скарфэйсх,soulflayer,1921,shaman,restoration,108,60,48
Swkx,dun-modr,1921,shaman,restoration,260,138,122
Fersok,zuljin,1919,shaman,restoration,60,32,28
Wíllz,ravencrest,1919,shaman,restoration,66,33,33
Señordoge,kazzak,1917,shaman,restoration,54,28,26
Цукерок,soulflayer,1914,shaman,restoration,149,87,62
Zergønk,ravencrest,1913,shaman,restoration,54,34,20
Karlurban,outland,1913,shaman,restoration,85,37,48
Holytidezx,aegwynn,1912,shaman,restoration,52,34,18
Mýthaz,archimonde,1910,shaman,restoration,84,59,25
Carpetmaster,ragnaros,1910,shaman,restoration,69,34,35
Elwynnpolice,argent-dawn,1908,shaman,restoration,118,58,60
Рамаксбосс,gordunni,1907,shaman,restoration,60,38,22
Lunarsloths,hyjal,1907,shaman,restoration,54,33,21
Westide,conseil-des-ombres,1905,shaman,restoration,66,35,31
Sentûn,blackrock,1901,shaman,restoration,186,95,91
Онеоне,deathweaver,1899,shaman,restoration,83,48,35
Vivaldi,varimathras,1899,shaman,restoration,56,29,27
Котенокмур,soulflayer,1899,shaman,restoration,48,20,28
Aioñ,kazzak,1896,shaman,restoration,110,56,54
Кенкерх,gordunni,1896,shaman,restoration,138,65,73
Urzza,stormscale,1895,shaman,restoration,42,36,6
Askagain,sylvanas,1895,shaman,restoration,58,32,26
Garuga,dun-morogh,1893,shaman,restoration,60,33,27
Boruggshaman,kazzak,1892,shaman,restoration,72,35,37
Holytidez,aegwynn,1891,shaman,restoration,66,34,32
Fotmherøqtx,ravencrest,1890,shaman,restoration,378,193,185
Defibrillata,blackrock,1887,shaman,restoration,468,247,221
Hexe,kazzak,1887,shaman,restoration,105,52,53
Shaloxe,silvermoon,1885,shaman,restoration,53,28,25
Трс,razuvious,1884,shaman,restoration,239,127,112
Fufupartyxx,blackrock,1883,shaman,restoration,60,37,23
Брфф,gordunni,1882,shaman,restoration,48,26,22
Aboveaverage,stormscale,1881,shaman,restoration,72,28,44
Thunderrock,stormreaver,1880,shaman,restoration,211,102,109
Hexewar,kazzak,1875,shaman,restoration,175,94,81
Krugx,draenor,1875,shaman,restoration,81,41,40
Jazzcore,twisting-nether,1872,shaman,restoration,41,25,16
Эоя,howling-fjord,1872,shaman,restoration,260,136,124
Trbhlk,blackrock,1871,shaman,restoration,71,34,37
Sprühkot,aegwynn,1868,shaman,restoration,58,33,25
Elmezz,outland,1867,shaman,restoration,54,33,21
Ize,sylvanas,1867,shaman,restoration,281,157,124
Кодишам,howling-fjord,1866,shaman,restoration,52,29,23
Iloveléa,ravencrest,1866,shaman,restoration,131,72,59
Owrly,stormscale,1866,shaman,restoration,148,71,77
Epsy,magtheridon,1865,shaman,restoration,92,60,32
Tallyx,ravencrest,1864,shaman,restoration,131,62,69
Вавувоух,howling-fjord,1863,shaman,restoration,54,27,27
Tidepog,ravencrest,1863,shaman,restoration,102,49,53
Shànnón,kazzak,1862,shaman,restoration,47,23,24
Cherepaha,stormscale,1861,shaman,restoration,94,45,49
Dêblâzê,thrall,1860,shaman,restoration,60,35,25
Jawje,tarren-mill,1860,shaman,restoration,108,53,55
Мефодийшама,howling-fjord,1860,shaman,restoration,192,93,99
Lontarita,tarren-mill,1858,shaman,restoration,36,27,9
Yachiru,sylvanas,1854,shaman,restoration,73,59,14
Porkzzila,aggra-português,1854,shaman,restoration,101,61,40
Xelgrin,silvermoon,1852,shaman,restoration,112,54,58
Ghettero,ragnaros,1851,shaman,restoration,39,25,14
Inspektør,kazzak,1851,shaman,restoration,77,46,31
Smightys,kazzak,1851,shaman,restoration,60,32,28
Snusy,stormscale,1851,shaman,restoration,48,24,24
Slimthug,sylvanas,1850,shaman,restoration,33,20,13
Wyrolink,ragnaros,1850,shaman,restoration,72,36,36
Natasz,burning-legion,1849,shaman,restoration,224,122,102
Sugarfreé,ragnaros,1848,shaman,restoration,48,26,22
Numbs,tarren-mill,1846,shaman,restoration,48,24,24
Zaru,sanguino,1846,shaman,restoration,63,31,32
Ujasdaddy,stormscale,1844,shaman,restoration,48,29,19
Exhale,archimonde,1844,shaman,restoration,216,129,87
Waramors,eredar,1841,shaman,restoration,185,96,89
Wernøz,archimonde,1841,shaman,restoration,92,43,49
Harmony,outland,1839,shaman,restoration,66,44,22
Shamolili,stormscale,1839,shaman,restoration,165,86,79
Alanus,draenor,1839,shaman,restoration,264,133,131
Akwa,stormscale,1839,shaman,restoration,44,20,24
Bezixx,ravencrest,1838,shaman,restoration,222,126,96
Cellfury,kazzak,1837,shaman,restoration,46,36,10
Johncoltrane,archimonde,1837,shaman,restoration,144,90,54
Twkupe,tarren-mill,1837,shaman,restoration,42,24,18
Sõap,tarren-mill,1836,shaman,restoration,48,33,15
Allysidewtf,archimonde,1836,shaman,restoration,56,36,20
Brownbear,stormscale,1836,shaman,restoration,179,97,82
Hydrolîc,blackrock,1833,shaman,restoration,84,50,34
Gorbagh,zuluhed,1833,shaman,restoration,66,35,31
Morkyy,thrall,1832,shaman,restoration,56,31,25
Awcchampion,stormscale,1832,shaman,restoration,338,185,153
Kongx,blackhand,1832,shaman,restoration,232,119,113
Reidzls,kazzak,1831,shaman,restoration,42,23,19
Frenchshaman,archimonde,1831,shaman,restoration,60,30,30
Adrixxøn,burning-legion,1831,shaman,restoration,66,27,39
Shamuunn,ravencrest,1830,shaman,restoration,54,28,26
Kreamcake,bladefist,1830,shaman,restoration,188,91,97
Cylantarus,blackrock,1829,shaman,restoration,193,101,92
Wisplola,ravencrest,1829,shaman,restoration,101,42,59
Велоун,soulflayer,1828,shaman,restoration,86,44,42
Hexalicius,sylvanas,1828,shaman,restoration,78,38,40
Rostislav,ravencrest,1827,shaman,restoration,59,31,28
Cæsífer,blackrock,1827,shaman,restoration,113,50,63
Fitnessdavid,ravencrest,1826,shaman,restoration,53,29,24
Lexxthree,blackrock,1824,shaman,restoration,64,33,31
Ikeadamen,alakir,1824,shaman,restoration,78,38,40
Abujalta,stormscale,1822,shaman,restoration,42,21,21
Мвнзх,gordunni,1821,shaman,restoration,84,41,43
Centralc,twisting-nether,1820,shaman,restoration,47,28,19
Kyogre,auchindoun,1820,shaman,restoration,120,68,52
Бомжмувис,howling-fjord,1819,shaman,restoration,30,19,11
Igly,antonidas,1819,shaman,restoration,60,31,29
Totembaws,blackmoore,1819,shaman,restoration,90,44,46
Shamrockx,outland,1816,shaman,restoration,83,42,41
Icecrêam,stormreaver,1816,shaman,restoration,65,31,34
Bladeyx,ragnaros,1815,shaman,restoration,243,135,108
Faric,draenor,1815,shaman,restoration,54,30,24
Mjollnier,stormscale,1815,shaman,restoration,67,35,32
Sûckmytotem,ragnaros,1815,shaman,restoration,72,35,37
Ixxmre,blackrock,1813,shaman,restoration,189,104,85
Mymylo,archimonde,1813,shaman,restoration,48,25,23
Jawj,tarren-mill,1813,shaman,restoration,107,48,59
Bummexx,twisting-nether,1812,shaman,restoration,102,59,43
Bunyie,ragnaros,1812,shaman,restoration,90,48,42
Нойзблок,gordunni,1811,shaman,restoration,36,19,17
Ghostlights,doomhammer,1811,shaman,restoration,68,31,37
Natty,ravencrest,1810,shaman,restoration,151,96,55
Reinu,ragnaros,1809,shaman,restoration,137,74,63
Wawawoowee,archimonde,1809,shaman,restoration,132,71,61
Yannkee,ravencrest,1809,shaman,restoration,78,39,39
Remony,pozzo-delleternità,1808,shaman,restoration,128,83,45
Qoekke,uldum,1808,shaman,restoration,48,28,20
Fuzzynuts,ravencrest,1808,shaman,restoration,132,74,58
Necrodog,blackrock,1807,shaman,restoration,78,49,29
Crymemore,stormscale,1807,shaman,restoration,77,41,36
Thefirebird,blackhand,1807,shaman,restoration,178,92,86
Kïllard,archimonde,1807,shaman,restoration,116,54,62
Дочьшефа,gordunni,1805,shaman,restoration,60,36,24
Wíwi,kazzak,1805,shaman,restoration,86,47,39
Firestormx,drakthul,1803,shaman,restoration,106,71,35
Fee,silvermoon,1803,shaman,restoration,45,25,20
Voodoonerd,twisting-nether,1803,shaman,restoration,47,24,23
Neou,archimonde,1803,shaman,restoration,54,27,27
Lilalime,arthas,1803,shaman,restoration,54,25,29
Apexe,outland,1803,shaman,restoration,106,41,65
Variablelol,outland,1802,shaman,restoration,118,73,45
Bigdamshear,outland,1802,shaman,restoration,60,31,29
Meöw,nemesis,1802,shaman,restoration,274,140,134
Lilililil,sanguino,1802,shaman,restoration,733,372,361
Taste,cthun,1802,shaman,restoration,70,32,38
Мимигор,razuvious,1801,shaman,restoration,35,27,8
Kiansham,silvermoon,1801,shaman,restoration,47,26,21
Shockjob,kazzak,1801,shaman,restoration,50,26,24
Колбаскофф,gordunni,1801,shaman,restoration,77,39,38
Squixi,tarren-mill,1799,shaman,restoration,66,36,30
Beoka,dun-modr,1798,shaman,restoration,57,28,29
Sethrøllins,hyjal,1793,shaman,restoration,126,58,68
Purgerkìng,tarren-mill,1791,shaman,restoration,36,24,12
Shiranoye,blackrock,1790,shaman,restoration,162,84,78
Sadfemecraft,aggramar,1790,shaman,restoration,436,223,213
Stylia,twisting-nether,1788,shaman,restoration,84,47,37
Nimbs,tarren-mill,1788,shaman,restoration,54,29,25
Djtidex,conseil-des-ombres,1784,shaman,restoration,54,29,25
Pogchampz,nemesis,1784,shaman,restoration,42,21,21
Incredibade,stormscale,1782,shaman,restoration,66,32,34
Bytheway,aegwynn,1778,shaman,restoration,303,142,161
Nübs,aegwynn,1778,shaman,restoration,149,69,80
Bezixx,argent-dawn,1776,shaman,restoration,218,112,106
Tâkeda,blackmoore,1775,shaman,restoration,160,78,82
Pstpstpsst,azjolnerub,1774,shaman,restoration,53,25,28
Bjoernwaldur,outland,1774,shaman,restoration,88,41,47
Shøckxy,blackrock,1773,shaman,restoration,66,30,36
Sheargodx,blackmoore,1771,shaman,restoration,48,25,23
Elmie,outland,1770,shaman,restoration,40,24,16
Midgetfizzle,kazzak,1770,shaman,restoration,453,225,228
Szellento,darksorrow,1769,shaman,restoration,96,47,49
Simiann,outland,1768,shaman,restoration,42,29,13
Ларкуш,howling-fjord,1766,shaman,restoration,176,93,83
Orcshaman,khadgar,1766,shaman,restoration,84,42,42
Traickosham,eredar,1764,shaman,restoration,54,40,14
Wibra,nagrand,1764,shaman,restoration,54,33,21
Awumbahway,outland,1764,shaman,restoration,168,91,77
Daubidaubi,kazzak,1763,shaman,restoration,140,87,53
Zanezu,stormscale,1763,shaman,restoration,203,106,97
Bstr,frostmane,1763,shaman,restoration,60,30,30
Ihealbro,blackrock,1762,shaman,restoration,66,41,25
Tether,twisting-nether,1760,shaman,restoration,71,43,28
Lsdhero,stormscale,1759,shaman,restoration,30,21,9
Invadé,stormscale,1759,shaman,restoration,42,23,19
Милфшама,blackscar,1759,shaman,restoration,476,240,236
Reäz,archimonde,1758,shaman,restoration,156,77,79
Мвнз,soulflayer,1758,shaman,restoration,90,38,52
Teldatwo,archimonde,1755,shaman,restoration,71,42,29
Ominos,stormscale,1752,shaman,restoration,48,25,23
Bloodvaron,zuljin,1750,shaman,restoration,170,85,85
Cynthila,stormreaver,1749,shaman,restoration,54,34,20
Learningsham,destromath,1749,shaman,restoration,48,29,19
Brokgar,ragnaros,1749,shaman,restoration,49,29,20
Dmgaddict,kazzak,1747,shaman,restoration,78,46,32
Bzglsnkh,ravencrest,1747,shaman,restoration,69,31,38
Hexur,archimonde,1746,shaman,restoration,86,49,37
Shoqt,les-sentinelles,1744,shaman,restoration,48,28,20
Shneems,twisting-nether,1741,shaman,restoration,199,113,86
Karakoram,ysondre,1741,shaman,restoration,155,82,73
Shockmelone,blackrock,1741,shaman,restoration,260,129,131
Shivanea,blackrock,1740,shaman,restoration,48,24,24
Donv,blackmoore,1739,shaman,restoration,42,26,16
Rottulos,stormrage,1739,shaman,restoration,65,35,30
Kraksham,ravencrest,1739,shaman,restoration,142,75,67
Sniege,outland,1738,shaman,restoration,36,23,13
Imbatlys,blackmoore,1738,shaman,restoration,42,24,18
Squixi,ravencrest,1738,shaman,restoration,59,33,26
Gønuts,sylvanas,1738,shaman,restoration,132,71,61
Jenkem,hyjal,1738,shaman,restoration,138,72,66
Adroda,kazzak,1738,shaman,restoration,258,128,130
Smøul,sanguino,1738,shaman,restoration,72,31,41
Nestre,kazzak,1737,shaman,restoration,113,53,60
Prîce,blackmoore,1733,shaman,restoration,42,27,15
Totoswich,tarren-mill,1733,shaman,restoration,77,43,34
Purgeluxe,aegwynn,1733,shaman,restoration,125,65,60
Helloiamdoni,ravencrest,1730,shaman,restoration,130,73,57
Windfúhrèr,tarren-mill,1729,shaman,restoration,72,31,41
Rexatar,blackrock,1728,shaman,restoration,320,168,152
Meneswave,blackhand,1728,shaman,restoration,96,47,49
Teldarian,archimonde,1727,shaman,restoration,42,22,20
Агентхолинки,gordunni,1726,shaman,restoration,24,18,6
Melliüg,ysondre,1726,shaman,restoration,96,59,37
Wamarï,draenor,1726,shaman,restoration,108,63,45
Bullezno,kazzak,1725,shaman,restoration,111,66,45
Phaynozx,cthun,1725,shaman,restoration,114,47,67
Còób,ravencrest,1725,shaman,restoration,67,27,40
Arslos,twisting-nether,1723,shaman,restoration,30,24,6
Socialfailur,archimonde,1722,shaman,restoration,30,18,12
Agnøt,khaz-modan,1722,shaman,restoration,120,70,50
Andarà,hyjal,1722,shaman,restoration,62,34,28
Дыркавауре,soulflayer,1722,shaman,restoration,91,39,52
Baßy,archimonde,1721,shaman,restoration,60,28,32
Тафельшпиц,soulflayer,1720,shaman,restoration,109,53,56
Artîe,archimonde,1720,shaman,restoration,54,23,31
Kurreshm,stormreaver,1720,shaman,restoration,60,25,35
Zorcs,silvermoon,1719,shaman,restoration,308,160,148
Levarázsol,outland,1718,shaman,restoration,90,51,39
Nailos,dun-modr,1718,shaman,restoration,187,97,90
Qobq,ravencrest,1717,shaman,restoration,24,18,6
Mysterqt,nemesis,1716,shaman,restoration,36,18,18
Bmbx,archimonde,1716,shaman,restoration,682,336,346
Есперадох,blackscar,1716,shaman,restoration,93,44,49
Whiskiy,kazzak,1714,shaman,restoration,35,24,11
Mltx,twilights-hammer,1714,shaman,restoration,44,19,25
Lillink,stormscale,1712,shaman,restoration,63,33,30
Jps,gorgonnash,1711,shaman,restoration,168,87,81
Dôppel,archimonde,1711,shaman,restoration,42,21,21
Teldathree,archimonde,1710,shaman,restoration,399,205,194
Vioception,blackrock,1710,shaman,restoration,64,27,37
Radjus,kazzak,1709,shaman,restoration,54,23,31
Watchmetotem,stormscale,1707,shaman,restoration,60,36,24
Nizzarrathur,argent-dawn,1706,shaman,restoration,30,18,12
Lavalovers,draenor,1706,shaman,restoration,66,39,27
Alnaddaf,outland,1704,shaman,restoration,72,39,33
Connecting,hyjal,1704,shaman,restoration,39,21,18
Alëxx,hyjal,1704,shaman,restoration,115,55,60
Djtomp,kazzak,1704,shaman,restoration,54,25,29
Viinny,dun-modr,1704,shaman,restoration,126,56,70
Littletrall,outland,1703,shaman,restoration,260,136,124
Vajaele,twisting-nether,1703,shaman,restoration,125,62,63
Бунтх,howling-fjord,1702,shaman,restoration,86,42,44
Pickett,tarren-mill,1702,shaman,restoration,52,25,27
Incase,burning-legion,1701,shaman,restoration,53,30,23
Rapedtide,thrall,1701,shaman,restoration,142,68,74
Тубалкайн,soulflayer,1700,shaman,restoration,42,21,21
Lexos,ravencrest,1699,shaman,restoration,72,42,30
Mefl,tarren-mill,1699,shaman,restoration,101,52,49
Makkalisse,kazzak,1698,shaman,restoration,36,23,13
Torxii,antonidas,1698,shaman,restoration,315,169,146
Dubìff,hyjal,1697,shaman,restoration,33,23,10
Bomjspomoiki,outland,1697,shaman,restoration,47,24,23
Koruga,frostwolf,1696,shaman,restoration,82,47,35
Fatmikex,stormreaver,1696,shaman,restoration,72,30,42
Ганинапална,soulflayer,1696,shaman,restoration,60,24,36
Eurocad,draenor,1694,shaman,restoration,60,29,31
Holyshamixz,dun-modr,1694,shaman,restoration,70,32,38
Dóómhammer,jaedenar,1693,shaman,restoration,142,74,68
Bombasthicc,ravencrest,1693,shaman,restoration,66,31,35
Mustabrutus,tarren-mill,1692,shaman,restoration,71,35,36
Wacomtablet,kazzak,1690,shaman,restoration,24,18,6
Hexmeqt,frostwolf,1690,shaman,restoration,149,84,65
Palfe,khaz-modan,1689,shaman,restoration,356,176,180
Darnast,draenor,1689,shaman,restoration,118,53,65
Lahey,draenor,1688,shaman,restoration,146,75,71
Bountiti,dun-modr,1687,shaman,restoration,42,23,19
Goeller,stormscale,1687,shaman,restoration,54,29,25
Thabolter,burning-legion,1685,shaman,restoration,42,22,20
Typhoeus,ragnaros,1685,shaman,restoration,52,25,27
Виелетта,gordunni,1684,shaman,restoration,30,18,12
Átòmíc,eredar,1684,shaman,restoration,36,18,18
Bioleta,twisting-nether,1684,shaman,restoration,167,74,93
Heatti,doomhammer,1684,shaman,restoration,48,21,27
Snogane,ravencrest,1682,shaman,restoration,50,32,18
Shamdude,archimonde,1682,shaman,restoration,53,28,25
Skrewu,stormscale,1682,shaman,restoration,109,55,54
Urshak,alleria,1681,shaman,restoration,106,61,45
Thyroideus,argent-dawn,1679,shaman,restoration,414,222,192
Googleme,veklor,1679,shaman,restoration,94,45,49
Ewrecked,frostwhisper,1678,shaman,restoration,28,19,9
Totemdog,blackmoore,1678,shaman,restoration,60,37,23
Monstacookie,stormreaver,1678,shaman,restoration,102,54,48
Likê,aegwynn,1677,shaman,restoration,36,25,11
Fapmasterz,eredar,1677,shaman,restoration,66,32,34
Icanbreathe,ravencrest,1675,shaman,restoration,51,26,25
Yararsiz,twisting-nether,1675,shaman,restoration,422,209,213
Htagagain,archimonde,1674,shaman,restoration,36,21,15
Keisser,ravencrest,1674,shaman,restoration,48,26,22
Nøraa,ravencrest,1674,shaman,restoration,48,25,23
Jochenzulauf,blackrock,1672,shaman,restoration,154,89,65
Wyrt,burning-legion,1672,shaman,restoration,48,24,24
Árés,sanguino,1672,shaman,restoration,89,44,45
Mysapphie,kazzak,1672,shaman,restoration,46,22,24
Vakamme,draenor,1672,shaman,restoration,54,22,32
Tommin,silvermoon,1671,shaman,restoration,48,24,24
Warpig,alakir,1670,shaman,restoration,148,79,69
Hieronesaa,stormreaver,1668,shaman,restoration,36,18,18
Loltotem,outland,1666,shaman,restoration,42,26,16
Sanamaxx,colinas-pardas,1666,shaman,restoration,62,36,26
Shoxý,draenor,1666,shaman,restoration,84,44,40
Jamienisme,ravencrest,1666,shaman,restoration,47,22,25
Thrallmom,ravencrest,1666,shaman,restoration,42,19,23
Cahyr,ravencrest,1665,shaman,restoration,41,23,18
Bolg,veklor,1665,shaman,restoration,60,29,31
Mishoshamana,tarren-mill,1664,shaman,restoration,30,20,10
Atwâ,ravencrest,1663,shaman,restoration,51,31,20
Powerhq,thrall,1663,shaman,restoration,100,55,45
Brandiløve,nemesis,1663,shaman,restoration,36,19,17
Сёмапурж,howling-fjord,1663,shaman,restoration,124,65,59
Teckan,tarren-mill,1663,shaman,restoration,48,24,24
Boltkesh,draenor,1662,shaman,restoration,36,24,12
Snickersx,blackrock,1659,shaman,restoration,150,82,68
Triplewhoppa,thrall,1659,shaman,restoration,123,57,66
Questionable,antonidas,1658,shaman,restoration,115,54,61
Horïons,dalaran,1657,shaman,restoration,54,27,27
Snobas,kazzak,1657,shaman,restoration,41,18,23
Pacio,alakir,1655,shaman,restoration,605,313,292
Вилкойвухо,howling-fjord,1655,shaman,restoration,110,42,68
Elliesham,kazzak,1654,shaman,restoration,41,25,16
Faridstreng,blackmoore,1654,shaman,restoration,150,83,67
Bâbbub,tarren-mill,1654,shaman,restoration,51,28,23
Luckymê,blackrock,1654,shaman,restoration,146,69,77
Linknvm,thrall,1653,shaman,restoration,225,137,88
Kalhoznik,ravencrest,1653,shaman,restoration,36,18,18
Sondra,shendralar,1653,shaman,restoration,69,31,38
Earthhulk,thrall,1652,shaman,restoration,158,88,70
Dadan,ravencrest,1651,shaman,restoration,55,37,18
Tolatide,blackhand,1650,shaman,restoration,33,18,15
Rckfeller,burning-legion,1650,shaman,restoration,126,58,68
Tentacruel,sylvanas,1649,shaman,restoration,133,74,59
Ssalceliv,stormscale,1649,shaman,restoration,35,18,17
Tôrcal,hyjal,1649,shaman,restoration,48,21,27
Feizhousa,outland,1649,shaman,restoration,50,21,29
Океансекса,soulflayer,1648,shaman,restoration,30,20,10
Nstéa,zuljin,1648,shaman,restoration,36,21,15
Mbembe,blackhand,1648,shaman,restoration,66,33,33
Eddiemorphin,kazzak,1647,shaman,restoration,83,50,33
Atomstrom,frostwolf,1647,shaman,restoration,74,41,33
Coldlean,haomarush,1647,shaman,restoration,300,153,147
Спиритл,blackscar,1646,shaman,restoration,45,30,15
Navarx,blackmoore,1646,shaman,restoration,202,105,97
Jaxsh,blackmoore,1646,shaman,restoration,47,22,25
Enzymex,sanguino,1646,shaman,restoration,84,34,50
Sanktyx,blackhand,1645,shaman,restoration,76,39,37
Hugox,outland,1645,shaman,restoration,1040,508,532
Héxdóctór,ravencrest,1644,shaman,restoration,92,50,42
Splashgodx,frostwolf,1643,shaman,restoration,53,30,23
Jíkkz,aegwynn,1642,shaman,restoration,102,47,55
Bonshaman,ahnqiraj,1642,shaman,restoration,120,55,65
Снупдоггидог,howling-fjord,1642,shaman,restoration,54,22,32
Madytz,eredar,1641,shaman,restoration,72,41,31
Kutcher,aegwynn,1641,shaman,restoration,48,27,21
Naômy,kazzak,1641,shaman,restoration,128,66,62
Icytide,kazzak,1641,shaman,restoration,90,42,48
Turboeddy,blackmoore,1640,shaman,restoration,228,123,105
Coöld,archimonde,1640,shaman,restoration,36,19,17
Threnesham,kazzak,1640,shaman,restoration,198,95,103
Foxy,alakir,1638,shaman,restoration,126,66,60
Wildgust,tarren-mill,1638,shaman,restoration,46,24,22
Maestralink,aegwynn,1638,shaman,restoration,47,24,23
Ibicc,twisting-nether,1638,shaman,restoration,184,92,92
Кикподхвост,soulflayer,1638,shaman,restoration,102,49,53
Крепкийтотем,soulflayer,1636,shaman,restoration,73,47,26
Hexbeforesex,kazzak,1636,shaman,restoration,478,246,232
Bîlunder,arygos,1636,shaman,restoration,137,66,71
Fourtwogodx,kazzak,1635,shaman,restoration,42,30,12
Huux,blackmoore,1635,shaman,restoration,77,41,36
Rxs,thunderhorn,1635,shaman,restoration,54,28,26
Skottkärrà,ravencrest,1634,shaman,restoration,36,24,12
Prizærn,tarren-mill,1634,shaman,restoration,153,72,81
Rokxa,burning-legion,1633,shaman,restoration,102,56,46
Blowxd,aegwynn,1633,shaman,restoration,259,137,122
Shamansh,draenor,1632,shaman,restoration,88,55,33
Absot,dun-morogh,1632,shaman,restoration,95,49,46
Rdsanityproc,kazzak,1632,shaman,restoration,78,40,38
Nexian,kazzak,1631,shaman,restoration,77,44,33
Louiesham,outland,1631,shaman,restoration,47,26,21
Nyfario,marécage-de-zangar,1631,shaman,restoration,42,22,20
Kharvo,draenor,1631,shaman,restoration,88,43,45
Sweetpea,antonidas,1631,shaman,restoration,90,42,48
Fuzzywaagh,silvermoon,1630,shaman,restoration,178,95,83
Alroq,blackrock,1630,shaman,restoration,44,23,21
Évileye,silvermoon,1630,shaman,restoration,60,31,29
Seall,lightnings-blade,1630,shaman,restoration,42,20,22
Dgshîtdwarf,ravencrest,1630,shaman,restoration,72,33,39
Arshak,stormscale,1630,shaman,restoration,80,36,44
Batmanmain,twisting-nether,1629,shaman,restoration,34,21,13
Realiz,ysondre,1629,shaman,restoration,42,20,22
Draáx,ravencrest,1628,shaman,restoration,30,19,11
Startdie,kazzak,1628,shaman,restoration,276,133,143
Gromaburst,stormscale,1628,shaman,restoration,42,18,24
Vioceptîon,blackrock,1627,shaman,restoration,60,45,15
Søtêx,ravencrest,1627,shaman,restoration,35,23,12
Elombrion,destromath,1626,shaman,restoration,102,63,39
Xclusiveqt,archimonde,1626,shaman,restoration,30,17,13
Shäman,burning-blade,1626,shaman,restoration,139,70,69
Papaver,zirkel-des-cenarius,1626,shaman,restoration,48,19,29
Amnéshaman,ysondre,1625,shaman,restoration,72,37,35
Shamimüll,twisting-nether,1624,shaman,restoration,42,29,13
Tarchoanvahg,ragnaros,1624,shaman,restoration,77,43,34
Pepegahex,blackmoore,1624,shaman,restoration,36,20,16
Xhanon,kazzak,1624,shaman,restoration,36,20,16
Kilazz,twisting-nether,1624,shaman,restoration,86,45,41
Хэйзл,ashenvale,1624,shaman,restoration,152,79,73
Labûche,chogall,1623,shaman,restoration,36,24,12
Shocklet,twisting-nether,1622,shaman,restoration,36,29,7
Zhulnaar,hyjal,1622,shaman,restoration,108,63,45
Wernøzer,archimonde,1621,shaman,restoration,36,22,14
Putzè,blackrock,1621,shaman,restoration,81,48,33
Nellytko,aegwynn,1621,shaman,restoration,87,44,43
Ðenlos,destromath,1621,shaman,restoration,352,176,176
Var,varimathras,1620,shaman,restoration,66,39,27
Palarins,dalaran,1620,shaman,restoration,30,17,13
Murmaiderz,draenor,1620,shaman,restoration,266,142,124
Тотемо,gordunni,1620,shaman,restoration,42,21,21
Shamerific,magtheridon,1620,shaman,restoration,61,30,31
Lechii,stormscale,1619,shaman,restoration,119,63,56
Yakee,doomhammer,1619,shaman,restoration,62,29,33
Tupato,kazzak,1618,shaman,restoration,110,57,53
Tow,der-rat-von-dalaran,1617,shaman,restoration,54,36,18
Tjpimp,draenor,1617,shaman,restoration,65,39,26
Ксмо,gordunni,1617,shaman,restoration,40,24,16
Пекубулких,soulflayer,1617,shaman,restoration,48,28,20
Itselectric,ravencrest,1617,shaman,restoration,217,116,101
Zalamlól,kazzak,1616,shaman,restoration,33,21,12
Тагхорн,soulflayer,1616,shaman,restoration,68,40,28
Jazzrod,stormscale,1616,shaman,restoration,396,207,189
Qoleck,aegwynn,1615,shaman,restoration,42,22,20
Charquanda,argent-dawn,1615,shaman,restoration,84,41,43
Xenuz,nemesis,1615,shaman,restoration,42,20,22
Maelynda,argent-dawn,1614,shaman,restoration,42,18,24
Kfcmanagerzz,archimonde,1613,shaman,restoration,41,19,22
Iphosham,twisting-nether,1612,shaman,restoration,48,21,27
Tenken,khaz-modan,1611,shaman,restoration,40,22,18
Djosershamy,draenor,1611,shaman,restoration,117,56,61
Dimront,gorgonnash,1610,shaman,restoration,36,20,16
Monamour,twisting-nether,1609,shaman,restoration,36,22,14
Shamiinn,ravencrest,1609,shaman,restoration,30,17,13
Wotan,ysondre,1609,shaman,restoration,60,33,27
Averya,blackmoore,1609,shaman,restoration,100,50,50
Aeknor,ravencrest,1609,shaman,restoration,48,24,24
Blowlips,argent-dawn,1609,shaman,restoration,42,17,25
Кайрн,gordunni,1608,shaman,restoration,68,37,31
Sehn,arathor,1608,shaman,restoration,42,21,21
Izir,archimonde,1608,shaman,restoration,371,180,191
Louler,ragnaros,1608,shaman,restoration,219,105,114
Voodoluudo,korgall,1608,shaman,restoration,42,20,22
Pøwertoto,dalaran,1608,shaman,restoration,120,56,64
Инкуль,howling-fjord,1608,shaman,restoration,60,28,32
Dmgccbot,outland,1608,shaman,restoration,74,31,43
Marrakei,aegwynn,1608,shaman,restoration,83,34,49
Кхуздуфар,blackscar,1608,shaman,restoration,42,17,25
Wolkî,aegwynn,1608,shaman,restoration,56,22,34
Kardris,nemesis,1607,shaman,restoration,52,25,27
Ezilol,blackhand,1606,shaman,restoration,77,46,31
Kuxoriu,stormscale,1606,shaman,restoration,152,82,70
Kuis,sanguino,1606,shaman,restoration,100,49,51
Greenswag,drakthul,1605,shaman,restoration,48,31,17
Hypéra,kazzak,1605,shaman,restoration,216,112,104
Чинанрук,howling-fjord,1605,shaman,restoration,185,88,97
Skanda,frostwolf,1604,shaman,restoration,24,17,7
Balthasa,blackhand,1604,shaman,restoration,30,18,12
Хужик,gordunni,1604,shaman,restoration,36,21,15
Nonotsikaan,blackhand,1604,shaman,restoration,78,45,33
Xtremeshaman,blackmoore,1604,shaman,restoration,48,25,23
Schamaster,antonidas,1604,shaman,restoration,120,59,61
Ridemytotem,blackrock,1604,shaman,restoration,45,21,24
Soffsittaren,kazzak,1604,shaman,restoration,40,18,22
Shamanash,kazzak,1604,shaman,restoration,82,34,48
Imedicineman,tarren-mill,1603,shaman,restoration,41,29,12
Thog,drakthul,1603,shaman,restoration,177,91,86
Healeugene,ravencrest,1603,shaman,restoration,49,23,26
Jkoreanx,archimonde,1603,shaman,restoration,78,31,47
Lebis,outland,1602,shaman,restoration,60,35,25
Khroni,tarren-mill,1602,shaman,restoration,66,35,31
Tùiðhânâ,ravencrest,1602,shaman,restoration,243,126,117
Техношмель,howling-fjord,1601,shaman,restoration,92,45,47
Mjukiz,tarren-mill,1600,shaman,restoration,350,194,156
Xortortle,stormscale,1600,shaman,restoration,35,19,16
Ohatzu,blackhand,1600,shaman,restoration,112,60,52
Juyina,ravencrest,1600,shaman,restoration,79,39,40
Uzze,drakthul,1600,shaman,restoration,132,63,69
Sixtyone,stormscale,1599,shaman,restoration,87,49,38
Martuscielöl,drakthul,1598,shaman,restoration,88,32,56
Daykên,kazzak,1597,shaman,restoration,104,51,53
Totembeard,frostmourne,1596,shaman,restoration,36,20,16
Waterwendy,blackrock,1595,shaman,restoration,86,53,33
Groundcslol,kazzak,1595,shaman,restoration,62,35,27
Svetosham,wildhammer,1594,shaman,restoration,47,24,23
Nervii,stormscale,1592,shaman,restoration,42,27,15
Mydpsrbad,stormscale,1592,shaman,restoration,160,89,71
Melàniewalsh,archimonde,1591,shaman,restoration,148,79,69
Yegera,stormscale,1591,shaman,restoration,59,31,28
Zinjk,nemesis,1591,shaman,restoration,418,211,207
Tartorno,antonidas,1591,shaman,restoration,118,54,64
Отчима,howling-fjord,1590,shaman,restoration,202,106,96
Bìnary,ravencrest,1590,shaman,restoration,42,19,23
Bahane,frostwolf,1589,shaman,restoration,122,61,61
Fridafrog,malganis,1586,shaman,restoration,245,131,114
Indeed,frostmourne,1586,shaman,restoration,66,35,31
Paidactor,kazzak,1586,shaman,restoration,239,126,113
Kemh,nemesis,1584,shaman,restoration,36,17,19
Superthomas,archimonde,1584,shaman,restoration,89,41,48
Purgecleave,dalvengyr,1584,shaman,restoration,48,20,28
Kuhnedy,blackrock,1583,shaman,restoration,263,139,124
Higgy,stormscale,1582,shaman,restoration,29,17,12
Вардоус,soulflayer,1582,shaman,restoration,30,17,13
Лескас,howling-fjord,1582,shaman,restoration,280,153,127
Stormdrágon,kazzak,1582,shaman,restoration,203,102,101
Nêôô,blackrock,1582,shaman,restoration,71,30,41
Dawop,ravencrest,1581,shaman,restoration,54,26,28
Nqz,ysondre,1580,shaman,restoration,91,52,39
Thald,ragnaros,1580,shaman,restoration,173,94,79
Wåvex,archimonde,1580,shaman,restoration,223,110,113
Sérx,sanguino,1580,shaman,restoration,191,90,101
Ранняяпташка,soulflayer,1579,shaman,restoration,42,21,21
Upisi,burning-legion,1579,shaman,restoration,207,103,104
Лешам,soulflayer,1576,shaman,restoration,72,37,35
Muril,argent-dawn,1576,shaman,restoration,60,28,32
Smørbar,kazzak,1575,shaman,restoration,185,111,74
Niesel,ravencrest,1575,shaman,restoration,78,40,38
Horokeu,blackrock,1574,shaman,restoration,107,57,50
Végàs,ysondre,1574,shaman,restoration,78,34,44
Aesa,dun-modr,1573,shaman,restoration,54,30,24
Боргирх,soulflayer,1572,shaman,restoration,42,17,25
Kocaina,kazzak,1571,shaman,restoration,30,19,11
Drumx,aegwynn,1571,shaman,restoration,48,28,20
Joinonlyfanz,blackrock,1571,shaman,restoration,48,20,28
Tonda,stormscale,1570,shaman,restoration,28,18,10
Zelent,thrall,1570,shaman,restoration,30,19,11
Кичисанчик,howling-fjord,1570,shaman,restoration,156,73,83
Kyraw,tarren-mill,1568,shaman,restoration,44,22,22
Reezex,silvermoon,1567,shaman,restoration,146,78,68
Redomsh,stormreaver,1567,shaman,restoration,129,60,69
Shockair,frostwolf,1566,shaman,restoration,115,54,61
Fjås,stormscale,1565,shaman,restoration,68,36,32
Yarali,argent-dawn,1565,shaman,restoration,36,18,18
Riptider,draenor,1565,shaman,restoration,54,25,29
Emika,archimonde,1565,shaman,restoration,62,28,34
Firenanajkm,dun-modr,1564,shaman,restoration,100,53,47
Blakelivelyx,blackrock,1564,shaman,restoration,42,17,25
Annoying,archimonde,1563,shaman,restoration,43,23,20
Glak,draenor,1563,shaman,restoration,45,24,21
Razzuan,kazzak,1563,shaman,restoration,97,46,51
Bullfox,aszune,1563,shaman,restoration,120,55,65
Noulol,aegwynn,1563,shaman,restoration,77,35,42
Pacho,alakir,1563,shaman,restoration,48,21,27
Esher,frostwolf,1563,shaman,restoration,115,48,67
Mamacitá,eredar,1562,shaman,restoration,542,258,284
Mcbloob,kazzak,1561,shaman,restoration,139,74,65
Lilcake,ravencrest,1561,shaman,restoration,72,38,34
Koraél,dun-modr,1561,shaman,restoration,96,39,57
Yomuchacha,dun-modr,1560,shaman,restoration,148,72,76
Тотембот,soulflayer,1560,shaman,restoration,78,36,42
Radrizzle,tichondrius,1559,shaman,restoration,66,36,30
Shammychris,argent-dawn,1559,shaman,restoration,48,21,27
Лёнянефор,howling-fjord,1558,shaman,restoration,35,18,17
Miikkas,blackhand,1557,shaman,restoration,42,25,17
Aébi,dalaran,1557,shaman,restoration,60,34,26
Cobbel,argent-dawn,1557,shaman,restoration,168,92,76
Orcié,twisting-nether,1557,shaman,restoration,35,19,16
Xogor,kazzak,1557,shaman,restoration,82,37,45
Lavjar,stormscale,1557,shaman,restoration,81,34,47
Totemjuggler,ragnaros,1556,shaman,restoration,112,73,39
Nosql,draenor,1556,shaman,restoration,40,22,18
Ðevi,ravencrest,1556,shaman,restoration,53,28,25
Lzzo,ravencrest,1555,shaman,restoration,42,24,18
Anöuchkâ,ysondre,1555,shaman,restoration,216,107,109
Shøckbot,blackhand,1555,shaman,restoration,48,23,25
Shakhdan,archimonde,1554,shaman,restoration,72,32,40
Mypakypa,outland,1553,shaman,restoration,104,50,54
Banilikum,tarren-mill,1553,shaman,restoration,104,49,55
Rejax,blackmoore,1553,shaman,restoration,66,29,37
Навылет,soulflayer,1552,shaman,restoration,54,31,23
Хексорсгодх,howling-fjord,1551,shaman,restoration,54,35,19
Zimoneris,blackmoore,1551,shaman,restoration,36,17,19
Grende,sylvanas,1551,shaman,restoration,65,24,41
Eksi,ahnqiraj,1550,shaman,restoration,70,35,35
Vickeshaman,stormreaver,1550,shaman,restoration,85,42,43
Sêrø,eredar,1550,shaman,restoration,48,23,25
Cleansing,nemesis,1549,shaman,restoration,52,37,15
Kvolt,ysondre,1549,shaman,restoration,42,18,24
Cuzzer,drakthul,1548,shaman,restoration,109,59,50
Beastmodex,eredar,1548,shaman,restoration,263,134,129
Туурукк,soulflayer,1548,shaman,restoration,66,27,39
Amyst,aegwynn,1547,shaman,restoration,40,25,15
Noneedshaman,stormscale,1547,shaman,restoration,35,18,17
Machmacan,argent-dawn,1547,shaman,restoration,183,93,90
Neovim,trollbane,1547,shaman,restoration,86,43,43
Puffeh,emeriss,1547,shaman,restoration,42,17,25
Vallhur,burning-legion,1546,shaman,restoration,198,102,96
Reilah,drakthul,1546,shaman,restoration,66,33,33
Гоэл,ashenvale,1546,shaman,restoration,195,90,105
Blamy,auchindoun,1545,shaman,restoration,40,20,20
Лехадабстеп,deathguard,1545,shaman,restoration,84,40,44
Bonraptor,kirin-tor,1544,shaman,restoration,59,33,26
Есю,howling-fjord,1544,shaman,restoration,40,22,18
Greatørc,tarren-mill,1544,shaman,restoration,106,57,49
Korvsnärten,outland,1544,shaman,restoration,237,109,128
Ripstorm,sylvanas,1544,shaman,restoration,121,55,66
Stupbpes,gorgonnash,1543,shaman,restoration,96,45,51
Reitar,burning-blade,1543,shaman,restoration,120,50,70
Glücksbarren,die-aldor,1542,shaman,restoration,48,23,25
Zilheal,ysondre,1542,shaman,restoration,106,41,65
Ebøbøla,terokkar,1541,shaman,restoration,247,115,132
Yemo,alonsus,1540,shaman,restoration,237,129,108
Warianis,ravencrest,1539,shaman,restoration,116,67,49
Kelvok,kazzak,1539,shaman,restoration,78,42,36
Denastyo,nemesis,1539,shaman,restoration,89,44,45
Shamandoino,wildhammer,1539,shaman,restoration,258,116,142
Optitem,hyjal,1538,shaman,restoration,83,57,26
Bredex,doomhammer,1538,shaman,restoration,59,30,29
Неерззул,soulflayer,1538,shaman,restoration,77,32,45
Zetricek,drakthul,1538,shaman,restoration,95,38,57
Shamins,outland,1537,shaman,restoration,178,101,77
Biggiebig,ravencrest,1536,shaman,restoration,168,91,77
Sørum,grim-batol,1536,shaman,restoration,48,17,31
Zwergmann,blackrock,1535,shaman,restoration,84,48,36
Nintotemxo,stormscale,1535,shaman,restoration,101,53,48
Apocadwarf,auchindoun,1534,shaman,restoration,161,87,74
Иоч,soulflayer,1534,shaman,restoration,65,35,30
Junpi,shattered-hand,1534,shaman,restoration,135,61,74
Cuzzherø,drakthul,1532,shaman,restoration,144,76,68
Velkin,thrall,1532,shaman,restoration,237,124,113
Tllz,kargath,1529,shaman,restoration,90,58,32
Pädagogeig,antonidas,1528,shaman,restoration,66,36,30
Waldo,blackmoore,1528,shaman,restoration,30,16,14
Àbs,archimonde,1528,shaman,restoration,168,84,84
Шсаваннх,blackscar,1528,shaman,restoration,171,84,87
Vemvardetsom,stormreaver,1527,shaman,restoration,149,79,70
Ugard,burning-legion,1526,shaman,restoration,99,50,49
Rake,teldrassil,1526,shaman,restoration,95,47,48
Mcktavish,silvermoon,1525,shaman,restoration,133,69,64
Ninetzj,tarren-mill,1525,shaman,restoration,60,28,32
Mìcrøs,thrall,1524,shaman,restoration,77,41,36
Gjernhard,stormreaver,1524,shaman,restoration,78,38,40
Muddy,argent-dawn,1524,shaman,restoration,42,18,24
Navezi,twisting-nether,1523,shaman,restoration,150,92,58
Hopper,sylvanas,1523,shaman,restoration,219,111,108
Чанголист,soulflayer,1523,shaman,restoration,114,54,60
Ugáa,malganis,1523,shaman,restoration,102,41,61
Remkoo,blackrock,1522,shaman,restoration,30,20,10
Naargie,outland,1521,shaman,restoration,173,97,76
Thorenal,blackmoore,1521,shaman,restoration,79,44,35
Фоэксген,deathguard,1520,shaman,restoration,70,43,27
Sixinchwilly,outland,1520,shaman,restoration,66,39,27
Wryte,echsenkessel,1519,shaman,restoration,30,16,14
Hobblefoot,stormscale,1519,shaman,restoration,36,16,20
Schain,eredar,1518,shaman,restoration,36,24,12
Whitefoxy,stormscale,1518,shaman,restoration,115,61,54
Vælcya,archimonde,1518,shaman,restoration,66,33,33
Turbobaboon,hyjal,1517,shaman,restoration,151,85,66
Kekke,uldum,1517,shaman,restoration,30,16,14
Porkzzilá,aggra-português,1515,shaman,restoration,24,16,8
Stateside,outland,1514,shaman,restoration,42,16,26
Mvvp,stormscale,1512,shaman,restoration,96,50,46
Viallinen,stormreaver,1512,shaman,restoration,43,18,25
Costakislolz,twisting-nether,1511,shaman,restoration,33,23,10
Bloodseeker,tarren-mill,1511,shaman,restoration,53,29,24
Crazypop,outland,1511,shaman,restoration,130,69,61
Hjod,outland,1511,shaman,restoration,285,144,141
Imtoohighq,archimonde,1511,shaman,restoration,105,49,56
Pjotrasmus,mannoroth,1511,shaman,restoration,42,17,25
Pinácoladáqt,stormscale,1511,shaman,restoration,48,17,31
Cakedeux,grim-batol,1510,shaman,restoration,526,266,260
Сорит,blackscar,1510,shaman,restoration,293,144,149
Jackpotx,tarren-mill,1508,shaman,restoration,110,68,42
Shambulancex,tarren-mill,1508,shaman,restoration,78,39,39
Tvättpåse,tarren-mill,1506,shaman,restoration,34,20,14
Schamfxx,blackrock,1506,shaman,restoration,166,85,81
Vaaggu,stormreaver,1506,shaman,restoration,48,19,29
Лисёнокцарь,gordunni,1506,shaman,restoration,42,16,26
Dáínn,outland,1505,shaman,restoration,89,49,40
Vaizii,silvermoon,1505,shaman,restoration,53,26,27
Froslack,zuljin,1504,shaman,restoration,100,50,50
Patuljak,outland,1503,shaman,restoration,139,75,64
Threshðld,dun-modr,1502,shaman,restoration,42,21,21
Нитрочка,soulflayer,1501,shaman,restoration,51,27,24
Роджермур,howling-fjord,1501,shaman,restoration,42,21,21
Booga,tarren-mill,1501,shaman,restoration,68,31,37
Pokspoks,stormscale,1501,shaman,restoration,42,16,26
Nassîî,antonidas,1500,shaman,restoration,146,61,85
Cannotdoit,burning-legion,1499,shaman,restoration,59,32,27
Diix,archimonde,1498,shaman,restoration,111,50,61
Khattla,outland,1497,shaman,restoration,356,190,166
Blackone,destromath,1496,shaman,restoration,36,20,16
Chéatèr,bloodfeather,1496,shaman,restoration,165,86,79
Thunderson,daggerspine,1494,shaman,restoration,540,275,265
Kasálla,aegwynn,1494,shaman,restoration,51,24,27
Elendig,blackmoore,1491,shaman,restoration,179,104,75
Exolnard,twisting-nether,1491,shaman,restoration,238,116,122
Skullår,tarren-mill,1490,shaman,restoration,66,33,33
Milara,anachronos,1489,shaman,restoration,42,16,26
Gronash,sunstrider,1488,shaman,restoration,60,37,23
Crasherz,sanguino,1488,shaman,restoration,91,51,40
Kalaris,stormscale,1488,shaman,restoration,36,20,16
Discoranger,ravencrest,1488,shaman,restoration,516,256,260
Straehne,malganis,1488,shaman,restoration,118,58,60
Märthalouise,twisting-nether,1487,shaman,restoration,73,30,43
Bénathon,ravencrest,1486,shaman,restoration,63,39,24
Másàfî,tarren-mill,1486,shaman,restoration,36,17,19
Kacamaz,twisting-nether,1486,shaman,restoration,117,54,63
Akukuu,kazzak,1485,shaman,restoration,48,26,22
Bumblebeec,tarren-mill,1485,shaman,restoration,72,36,36
Phoenííx,twisting-nether,1485,shaman,restoration,461,218,243
Hyflex,alakir,1485,shaman,restoration,47,19,28
Elshimano,ravencrest,1484,shaman,restoration,30,18,12
Dojarat,silvermoon,1482,shaman,restoration,170,96,74
Shemanrolf,outland,1482,shaman,restoration,134,67,67
Ophís,ambossar,1482,shaman,restoration,62,28,34
Starterkit,ravencrest,1482,shaman,restoration,66,25,41
Shmanw,kazzak,1481,shaman,restoration,69,37,32
Nogag,kazzak,1481,shaman,restoration,121,59,62
Dremlok,burning-legion,1480,shaman,restoration,24,16,8
Criæ,blackrock,1480,shaman,restoration,36,23,13
Reparagos,sanguino,1480,shaman,restoration,37,22,15
Mèshuggáh,ravencrest,1480,shaman,restoration,42,19,23
Vorkanyx,ysondre,1479,shaman,restoration,153,79,74
Clickmeh,runetotem,1479,shaman,restoration,95,47,48
Kataclysm,nemesis,1477,shaman,restoration,71,35,36
Apaorkaxyz,ragnaros,1476,shaman,restoration,423,208,215
Awwey,stormscale,1475,shaman,restoration,30,22,8
Goodieesham,burning-blade,1475,shaman,restoration,66,39,27
Sucøre,die-nachtwache,1475,shaman,restoration,88,45,43
Aliatës,sanguino,1475,shaman,restoration,50,25,25
Overlewd,chamber-of-aspects,1474,shaman,restoration,51,25,26
Èxé,stormscale,1474,shaman,restoration,74,36,38
Damex,thunderhorn,1474,shaman,restoration,161,69,92
Gützli,blackmoore,1474,shaman,restoration,93,35,58
Shameari,sylvanas,1473,shaman,restoration,24,19,5
Shman,blackrock,1473,shaman,restoration,100,54,46
Vengatrox,antonidas,1473,shaman,restoration,191,102,89
Onionz,stormreaver,1473,shaman,restoration,42,21,21
Brigantino,burning-legion,1472,shaman,restoration,112,60,52
Gadula,burning-legion,1472,shaman,restoration,40,21,19
Cleptocracy,draenor,1472,shaman,restoration,35,18,17
Pprx,tarren-mill,1472,shaman,restoration,42,19,23
Deadstill,ysondre,1471,shaman,restoration,60,32,28
Ivøryz,arthas,1471,shaman,restoration,114,60,54
Bordellgast,thrall,1471,shaman,restoration,101,51,50
Eniesz,archimonde,1471,shaman,restoration,143,71,72
Loreleya,ravencrest,1471,shaman,restoration,99,48,51
Crysisx,sanguino,1471,shaman,restoration,34,16,18
Ôrgi,drakthul,1471,shaman,restoration,60,24,36
Hastabasta,sylvanas,1471,shaman,restoration,72,27,45
Gehrké,silvermoon,1470,shaman,restoration,38,24,14
Kilasqo,drakthul,1470,shaman,restoration,29,16,13
Ilovejamie,sylvanas,1470,shaman,restoration,60,31,29
Rokatotem,ysondre,1470,shaman,restoration,51,24,27
Дагод,booty-bay,1469,shaman,restoration,78,48,30
Denyx,blackmoore,1469,shaman,restoration,264,128,136
Zakuun,kazzak,1469,shaman,restoration,188,83,105
Lyricks,outland,1469,shaman,restoration,130,56,74
Kêêqo,blackrock,1468,shaman,restoration,48,23,25
Духсалата,grom,1468,shaman,restoration,71,34,37
Sawseig,tarren-mill,1467,shaman,restoration,33,18,15
Greenfatding,kazzak,1467,shaman,restoration,36,19,17
Andról,stormscale,1467,shaman,restoration,54,25,29
Джонпсинаа,gordunni,1466,shaman,restoration,48,27,21
Cuchullaín,blackmoore,1465,shaman,restoration,66,36,30
Flowèn,twisting-nether,1465,shaman,restoration,146,77,69
Redoms,stormreaver,1465,shaman,restoration,240,120,120
Vaweñ,ravencrest,1465,shaman,restoration,83,35,48
Ünknownz,archimonde,1464,shaman,restoration,71,37,34
Sebubu,twisting-nether,1463,shaman,restoration,68,34,34
Wôdân,blackrock,1463,shaman,restoration,85,39,46
Lazerboy,twisting-nether,1463,shaman,restoration,110,49,61
Courtney,sylvanas,1462,shaman,restoration,240,114,126
Zûgzûg,ragnaros,1462,shaman,restoration,64,30,34
Shuzman,emeriss,1461,shaman,restoration,133,63,70
Pakxø,malganis,1461,shaman,restoration,200,91,109
Althayr,blackmoore,1460,shaman,restoration,46,21,25
Waterboi,blackmoore,1460,shaman,restoration,98,44,54
Theshammy,vashj,1459,shaman,restoration,60,32,28
Laskopivo,doomhammer,1459,shaman,restoration,195,99,96
Yasharshammy,tarren-mill,1459,shaman,restoration,60,28,32
Lumirecia,shadowsong,1459,shaman,restoration,54,25,29
Nonnative,stormscale,1459,shaman,restoration,72,31,41
Diosberi,tichondrius,1458,shaman,restoration,24,18,6
Lariralol,malorne,1458,shaman,restoration,97,56,41
Vuls,blackmoore,1457,shaman,restoration,216,119,97
Rhun,garona,1457,shaman,restoration,267,142,125
Okdar,stormscale,1456,shaman,restoration,84,50,34
Setac,stormscale,1456,shaman,restoration,39,18,21
Geminate,stormscale,1455,shaman,restoration,45,25,20
Коляхекс,gordunni,1455,shaman,restoration,88,48,40
Шарюпокд,soulflayer,1455,shaman,restoration,48,24,24
Jenyo,alakir,1455,shaman,restoration,74,36,38
Yois,nemesis,1454,shaman,restoration,108,61,47
Onkens,ravencrest,1454,shaman,restoration,81,43,38
Zlingx,auchindoun,1454,shaman,restoration,48,22,26
Ethixx,outland,1454,shaman,restoration,106,48,58
Klouds,stormscale,1454,shaman,restoration,66,27,39
Enharvest,stormscale,1453,shaman,restoration,58,34,24
Шиока,borean-tundra,1453,shaman,restoration,170,93,77
Phobophobia,archimonde,1453,shaman,restoration,70,33,37
Khraajsy,sylvanas,1452,shaman,restoration,30,19,11
Ларисашерсть,blackscar,1452,shaman,restoration,47,26,21
Collînna,aegwynn,1452,shaman,restoration,116,58,58
Артёмлобов,gordunni,1450,shaman,restoration,77,37,40
Cheerz,ravencrest,1450,shaman,restoration,42,20,22
Groundingbtw,tarren-mill,1449,shaman,restoration,62,30,32
Xerinas,eredar,1449,shaman,restoration,153,62,91
Pilinham,aggra-português,1449,shaman,restoration,80,32,48
Багсбанних,soulflayer,1449,shaman,restoration,108,43,65
Sinzzu,ragnaros,1448,shaman,restoration,395,190,205
Lickbuthole,stormreaver,1447,shaman,restoration,46,28,18
Arigolds,twilights-hammer,1447,shaman,restoration,29,16,13
Davihla,grim-batol,1447,shaman,restoration,84,41,43
Gspót,twisting-nether,1447,shaman,restoration,98,47,51
Чаиро,howling-fjord,1447,shaman,restoration,41,16,25
Tuorak,eredar,1446,shaman,restoration,30,16,14
Eisei,stormscale,1446,shaman,restoration,90,47,43
Lustmasterx,grim-batol,1446,shaman,restoration,497,249,248
Plutonx,stormscale,1446,shaman,restoration,111,54,57
Craisaz,nemesis,1446,shaman,restoration,163,68,95
Schamazon,tarren-mill,1445,shaman,restoration,75,40,35
Selrin,blackrock,1445,shaman,restoration,231,118,113
Bigfatjay,stormscale,1444,shaman,restoration,63,33,30
Katwio,hyjal,1444,shaman,restoration,55,27,28
Abercrômbx,blackmoore,1444,shaman,restoration,93,45,48
Octon,dun-modr,1444,shaman,restoration,185,84,101
Shpankproof,kazzak,1443,shaman,restoration,42,19,23
Rawillman,kazzak,1442,shaman,restoration,30,19,11
Xintenggege,silvermoon,1442,shaman,restoration,91,46,45
Kaminarí,antonidas,1442,shaman,restoration,74,32,42
Sdkpwns,draenor,1441,shaman,restoration,46,25,21
Zeewzblast,silvermoon,1441,shaman,restoration,30,16,14
Sunysham,darkmoon-faire,1441,shaman,restoration,65,33,32
Schweízer,blackrock,1441,shaman,restoration,102,45,57
Zombilyk,burning-legion,1441,shaman,restoration,53,23,30
Crmx,blackrock,1441,shaman,restoration,120,52,68
Zaránd,ragnaros,1440,shaman,restoration,66,34,32
Berly,stormscale,1439,shaman,restoration,24,15,9
Lingz,auchindoun,1439,shaman,restoration,54,30,24
Showman,archimonde,1439,shaman,restoration,569,289,280
Xánin,thrall,1439,shaman,restoration,92,46,46
Helloitsmee,thrall,1439,shaman,restoration,40,20,20
Shamytomight,tarren-mill,1438,shaman,restoration,84,42,42
Nyzo,tarren-mill,1438,shaman,restoration,30,15,15
Сёмабро,ashenvale,1437,shaman,restoration,865,446,419
Kunsum,twisting-nether,1437,shaman,restoration,87,37,50
Roineé,draenor,1436,shaman,restoration,30,15,15
Амальтейх,soulflayer,1436,shaman,restoration,78,34,44
Imshocky,burning-legion,1435,shaman,restoration,142,78,64
Antey,ravencrest,1435,shaman,restoration,207,108,99
Emochka,ravencrest,1435,shaman,restoration,130,60,70
Healelele,frostwolf,1435,shaman,restoration,36,15,21
Ronell,argent-dawn,1434,shaman,restoration,179,91,88
Jimtrespies,dun-modr,1434,shaman,restoration,121,61,60
Arigato,eonar,1434,shaman,restoration,58,29,29
Strïvïse,ysondre,1434,shaman,restoration,47,22,25
Kataretic,kazzak,1433,shaman,restoration,24,17,7
Meeq,deathwing,1433,shaman,restoration,31,19,12
Enïgma,sylvanas,1433,shaman,restoration,166,89,77
Zaiyoxgodx,thrall,1433,shaman,restoration,49,26,23
Tonnii,tarren-mill,1433,shaman,restoration,42,18,24
Raznys,defias-brotherhood,1433,shaman,restoration,42,15,27
Drlovkexgodx,stormscale,1432,shaman,restoration,24,15,9
Nayromino,blackrock,1432,shaman,restoration,49,28,21
Elamentaly,draenor,1432,shaman,restoration,96,54,42
Wylly,aegwynn,1432,shaman,restoration,174,95,79
Linkedink,tarren-mill,1432,shaman,restoration,35,19,16
Thornos,ragnaros,1432,shaman,restoration,64,21,43
Skrimisher,draenor,1431,shaman,restoration,83,45,38
Mendiing,kazzak,1431,shaman,restoration,63,30,33
Вуфпуф,borean-tundra,1431,shaman,restoration,54,25,29
Kaptt,twisting-nether,1431,shaman,restoration,36,15,21
Zoolza,kirin-tor,1431,shaman,restoration,94,39,55
Mouraïne,eredar,1430,shaman,restoration,350,180,170
Otuschsham,blackmoore,1430,shaman,restoration,36,15,21
Thesenate,blackmoore,1430,shaman,restoration,76,30,46
Bufuxx,kazzak,1429,shaman,restoration,42,24,18
Jarona,twisting-nether,1429,shaman,restoration,408,196,212
Orcshaman,the-maelstrom,1428,shaman,restoration,74,40,34
Gards,sylvanas,1428,shaman,restoration,85,41,44
Драмшам,howling-fjord,1428,shaman,restoration,42,19,23
Шоплифтер,gordunni,1427,shaman,restoration,48,27,21
Cømedian,ragnaros,1427,shaman,restoration,107,59,48
Nøný,gorgonnash,1427,shaman,restoration,102,51,51
Pcr,archimonde,1427,shaman,restoration,111,53,58
Mightgethexd,tarren-mill,1426,shaman,restoration,39,21,18
Tahsus,blackmoore,1425,shaman,restoration,53,36,17
Kalvei,draenor,1425,shaman,restoration,65,33,32
Zulsham,sargeras,1425,shaman,restoration,131,64,67
Малекулакота,soulflayer,1425,shaman,restoration,53,25,28
Drohx,ysondre,1425,shaman,restoration,78,36,42
Pòcho,kazzak,1425,shaman,restoration,144,64,80
Ptiloup,varimathras,1423,shaman,restoration,48,22,26
Ярусскийй,howling-fjord,1422,shaman,restoration,277,134,143
Lastaltforev,kazzak,1422,shaman,restoration,98,47,51
Monstermunch,ravencrest,1422,shaman,restoration,154,71,83
Shocktastic,blackmoore,1422,shaman,restoration,112,51,61
Prøxxy,ravencrest,1422,shaman,restoration,45,20,25
Táyy,stormscale,1421,shaman,restoration,37,21,16
Ishkadar,twisting-nether,1421,shaman,restoration,99,48,51
Îolar,aegwynn,1421,shaman,restoration,120,57,63
Aeldrid,argent-dawn,1420,shaman,restoration,48,28,20
Nêmônin,perenolde,1420,shaman,restoration,55,31,24
Кислаябуба,howling-fjord,1420,shaman,restoration,172,81,91
Fernashaman,aggra-português,1419,shaman,restoration,77,41,36
Umbraverfaa,twisting-nether,1419,shaman,restoration,108,57,51
Kaffekask,stormscale,1419,shaman,restoration,42,21,21
Gnackbretzn,eredar,1419,shaman,restoration,155,77,78
Stormfreg,quelthalas,1419,shaman,restoration,42,16,26
Начилибосе,gordunni,1418,shaman,restoration,447,230,217
Mitica,ravencrest,1417,shaman,restoration,52,24,28
Тирануксис,blackscar,1416,shaman,restoration,161,87,74
Aliatoos,ravencrest,1416,shaman,restoration,58,31,27
Swedishmeat,kazzak,1416,shaman,restoration,224,118,106
Winøxiide,archimonde,1415,shaman,restoration,29,16,13
Djxyoloswag,silvermoon,1415,shaman,restoration,153,72,81
Dewasham,blackrock,1415,shaman,restoration,54,25,29
Sarkathi,kazzak,1415,shaman,restoration,77,33,44
Goldhand,ravencrest,1415,shaman,restoration,69,24,45
Energized,twilights-hammer,1414,shaman,restoration,97,56,41
Ironmack,outland,1414,shaman,restoration,60,32,28
Брайбах,howling-fjord,1414,shaman,restoration,49,26,23
Robcurly,blackmoore,1414,shaman,restoration,30,15,15
Quïzzly,ragnaros,1414,shaman,restoration,72,31,41
Ludiböris,kazzak,1414,shaman,restoration,42,18,24
Adzkímo,tarren-mill,1414,shaman,restoration,36,15,21
Deadwoodz,tarren-mill,1413,shaman,restoration,214,111,103
Bumbersham,stormscale,1413,shaman,restoration,168,83,85
Dergat,pozzo-delleternità,1412,shaman,restoration,44,21,23
Smukkere,twisting-nether,1410,shaman,restoration,24,15,9
Mestgonee,draenor,1408,shaman,restoration,60,30,30
Voitek,sargeras,1408,shaman,restoration,85,36,49
Cevas,argent-dawn,1407,shaman,restoration,78,47,31
Elijaá,nordrassil,1407,shaman,restoration,211,116,95
Miesepeter,mannoroth,1407,shaman,restoration,111,57,54
Carëx,anubarak,1407,shaman,restoration,41,21,20
Aceofraphy,thrall,1406,shaman,restoration,143,62,81
Yaamooshii,burning-legion,1405,shaman,restoration,143,77,66
Jessijames,outland,1404,shaman,restoration,26,18,8
Shago,archimonde,1404,shaman,restoration,160,78,82
Bresidendo,frostwhisper,1404,shaman,restoration,119,54,65
Гарантийный,lich-king,1404,shaman,restoration,36,15,21
Bloodburst,stormscale,1403,shaman,restoration,160,92,68
Durekk,tarren-mill,1403,shaman,restoration,90,48,42
Caliqueños,sanguino,1403,shaman,restoration,42,19,23
Spitta,ysondre,1403,shaman,restoration,42,19,23
Sîggý,eredar,1403,shaman,restoration,36,16,20
Noxazar,kazzak,1403,shaman,restoration,100,44,56
Okø,marécage-de-zangar,1402,shaman,restoration,44,25,19
Nadashami,outland,1402,shaman,restoration,95,51,44
Братишкапинг,soulflayer,1402,shaman,restoration,136,72,64
Swahilishock,the-maelstrom,1402,shaman,restoration,42,18,24
Heyzal,aegwynn,1402,shaman,restoration,44,18,26
Roverlos,blackrock,1401,shaman,restoration,159,86,73
Shyrel,burning-legion,1401,shaman,restoration,270,136,134
Mclóvín,twisting-nether,1401,shaman,restoration,42,21,21
Тандерфак,ashenvale,1401,shaman,restoration,38,18,20
Shrekcho,twisting-nether,1400,shaman,restoration,70,44,26
Тромрел,blackscar,1400,shaman,restoration,59,34,25
Nextlvlplz,draenor,1400,shaman,restoration,127,68,59
Мокос,howling-fjord,1400,shaman,restoration,60,20,40
Trustlemac,onyxia,1399,shaman,restoration,50,30,20
Shamhingo,stormscale,1399,shaman,restoration,112,49,63
Horiq,kazzak,1399,shaman,restoration,42,15,27
Tèysh,ysondre,1398,shaman,restoration,145,74,71
Zapconi,burning-legion,1398,shaman,restoration,36,15,21
Виспепешам,gordunni,1397,shaman,restoration,438,219,219
Shamatto,nemesis,1397,shaman,restoration,92,43,49
Guccisham,ravencrest,1397,shaman,restoration,60,26,34
Whatsup,aggramar,1395,shaman,restoration,93,49,44
Numdog,stormreaver,1395,shaman,restoration,29,15,14
Cjay,dunemaul,1394,shaman,restoration,46,26,20
Seasick,frostmane,1394,shaman,restoration,115,56,59
Qjie,argent-dawn,1393,shaman,restoration,295,162,133
Tallzie,ravencrest,1392,shaman,restoration,58,28,30
Shamantistik,ravencrest,1391,shaman,restoration,24,15,9
Гвинневра,azuregos,1391,shaman,restoration,153,89,64
Corintho,blackmoore,1391,shaman,restoration,70,40,30
Sjamanisme,silvermoon,1390,shaman,restoration,114,60,54
Odiuum,draenor,1390,shaman,restoration,228,114,114
Газгольдерх,razuvious,1390,shaman,restoration,136,64,72
Wokaa,twisting-nether,1389,shaman,restoration,24,15,9
Badkidney,alakir,1389,shaman,restoration,102,58,44
Rugludalli,dragonblight,1388,shaman,restoration,24,15,9
Shamanlynx,ravencrest,1388,shaman,restoration,147,82,65
Ghorall,ragnaros,1388,shaman,restoration,77,42,35
Vodoochild,hyjal,1388,shaman,restoration,215,106,109
Lsdx,silvermoon,1388,shaman,restoration,116,56,60
Aliates,sanguino,1388,shaman,restoration,36,16,20
Kwitnac,silvermoon,1387,shaman,restoration,42,24,18
Kekerrot,ragnaros,1386,shaman,restoration,152,89,63
Spaceboy,archimonde,1386,shaman,restoration,42,19,23
Gâldwyn,dalaran,1385,shaman,restoration,36,15,21
Geneazytwo,silvermoon,1384,shaman,restoration,32,19,13
Marrondevil,blackhand,1384,shaman,restoration,29,16,13
Seyfüce,archimonde,1383,shaman,restoration,77,43,34
Phêbz,archimonde,1383,shaman,restoration,93,48,45
Фридомх,gordunni,1383,shaman,restoration,35,17,18
Назульчике,razuvious,1383,shaman,restoration,83,40,43
Insanebölt,ravencrest,1383,shaman,restoration,41,17,24
Magma,kazzak,1381,shaman,restoration,36,22,14
Totemproffs,twisting-nether,1381,shaman,restoration,54,28,26
Fluuges,tarren-mill,1381,shaman,restoration,95,46,49
Guayotta,sanguino,1381,shaman,restoration,80,33,47
Saamira,pozzo-delleternità,1380,shaman,restoration,84,41,43
Pasjeop,ravencrest,1380,shaman,restoration,53,21,32
Erdenseele,blackmoore,1379,shaman,restoration,23,16,7
Fenoménes,drakthul,1378,shaman,restoration,88,44,44
Boneyka,ragnaros,1378,shaman,restoration,146,65,81
Tingyspanky,twisting-nether,1377,shaman,restoration,57,22,35
Ironkraw,stormscale,1377,shaman,restoration,90,33,57
Chunkss,argent-dawn,1377,shaman,restoration,54,18,36
Karrisha,tarren-mill,1376,shaman,restoration,48,29,19
Axemodels,archimonde,1376,shaman,restoration,32,16,16
Zenjo,the-maelstrom,1376,shaman,restoration,60,23,37
Megumín,darksorrow,1375,shaman,restoration,36,21,15
Tauridus,blackrock,1375,shaman,restoration,54,27,27
Kickmeheal,dalaran,1375,shaman,restoration,167,83,84
Grumhild,blackmoore,1375,shaman,restoration,122,52,70
Tiborr,burning-legion,1375,shaman,restoration,81,26,55
Alishie,outland,1373,shaman,restoration,117,64,53
Amaizin,stormscale,1373,shaman,restoration,90,45,45
Læh,archimonde,1373,shaman,restoration,120,52,68
Alàstor,kazzak,1372,shaman,restoration,93,46,47
Slingz,auchindoun,1372,shaman,restoration,60,26,34
Zallyy,tarren-mill,1371,shaman,restoration,113,60,53
Shamnox,blackrock,1371,shaman,restoration,89,47,42
Neddeadlyo,outland,1371,shaman,restoration,41,20,21
Testoshaman,ravencrest,1369,shaman,restoration,29,15,14
Sparklemufin,draenor,1369,shaman,restoration,33,16,17
Psychototem,twisting-nether,1368,shaman,restoration,120,38,82
Giulia,culte-de-la-rive-noire,1367,shaman,restoration,220,119,101
Purgérkíng,silvermoon,1367,shaman,restoration,56,28,28
Stortvloed,twisting-nether,1365,shaman,restoration,42,20,22
Kasjer,ravencrest,1365,shaman,restoration,36,17,19
Lupisregina,silvermoon,1365,shaman,restoration,41,19,22
Quizx,blackrock,1365,shaman,restoration,57,24,33
Pocahøntas,archimonde,1365,shaman,restoration,74,30,44
Mjahex,stormscale,1364,shaman,restoration,108,55,53
Hulcky,grim-batol,1363,shaman,restoration,48,27,21
Agatiø,dun-modr,1363,shaman,restoration,55,29,26
Acidtrip,hyjal,1363,shaman,restoration,48,24,24
Ëlfapatakÿ,uldum,1363,shaman,restoration,51,25,26
Captaínduck,garrosh,1362,shaman,restoration,232,127,105
Breadtotem,tarren-mill,1362,shaman,restoration,116,52,64
Shimmyja,draenor,1361,shaman,restoration,105,53,52
Akrobata,silvermoon,1360,shaman,restoration,180,83,97
Gunhyld,hyjal,1360,shaman,restoration,71,32,39
Jotashaman,sanguino,1360,shaman,restoration,69,31,38
Blixtlasse,magtheridon,1360,shaman,restoration,43,19,24
Thuknala,tarren-mill,1359,shaman,restoration,121,69,52
Abx,draenor,1359,shaman,restoration,54,28,26
Æcex,eredar,1358,shaman,restoration,33,15,18
Salmôn,twisting-nether,1358,shaman,restoration,42,15,27
Ærthgød,stormscale,1357,shaman,restoration,55,35,20
Glopper,ravencrest,1356,shaman,restoration,113,52,61
Götveren,eredar,1356,shaman,restoration,53,22,31
Weraeth,drakthul,1355,shaman,restoration,221,123,98
Soraiyaqt,kult-der-verdammten,1354,shaman,restoration,41,24,17
Ruvxy,twisting-nether,1354,shaman,restoration,65,38,27
Subaki,die-aldor,1354,shaman,restoration,58,32,26
Vanquïsh,archimonde,1353,shaman,restoration,48,21,27
Mcgrêgor,aegwynn,1352,shaman,restoration,45,20,25
Lindemánn,blackhand,1352,shaman,restoration,72,29,43
Krovogor,silvermoon,1351,shaman,restoration,60,34,26
Dzseksz,ragnaros,1351,shaman,restoration,77,41,36
Anakkynu,sylvanas,1351,shaman,restoration,55,27,28
Räyznx,nozdormu,1350,shaman,restoration,24,15,9
Daboó,vashj,1350,shaman,restoration,115,63,52
Devastru,ravencrest,1350,shaman,restoration,78,35,43
Cadierno,argent-dawn,1349,shaman,restoration,30,18,12
Jävlajävel,draenor,1349,shaman,restoration,142,83,59
Stòrmbreakèr,nemesis,1348,shaman,restoration,161,73,88
Volvíc,tichondrius,1348,shaman,restoration,60,22,38
Дымоквглазах,howling-fjord,1347,shaman,restoration,34,21,13
Johnblånn,stormscale,1347,shaman,restoration,324,166,158
Дердан,soulflayer,1347,shaman,restoration,84,42,42
Stylix,tarren-mill,1347,shaman,restoration,99,47,52
Zevissh,outland,1346,shaman,restoration,54,28,26
Ricid,nerathor,1346,shaman,restoration,49,22,27
Lynox,ragnaros,1345,shaman,restoration,78,48,30
Bíllý,onyxia,1345,shaman,restoration,39,22,17
Ошибся,deathguard,1345,shaman,restoration,126,69,57
Schläck,outland,1345,shaman,restoration,48,23,25
Flikus,aggra-português,1345,shaman,restoration,54,21,33
Wealey,drakthul,1344,shaman,restoration,145,71,74
Сновидений,soulflayer,1344,shaman,restoration,49,23,26
Invade,darkspear,1343,shaman,restoration,18,14,4
Teldariane,archimonde,1343,shaman,restoration,24,14,10
Erepmad,ravencrest,1343,shaman,restoration,24,14,10
Bkid,archimonde,1343,shaman,restoration,71,32,39
Henchtotem,draenor,1342,shaman,restoration,56,31,25
Denchdwarf,silvermoon,1342,shaman,restoration,30,14,16
Таззикшок,soulflayer,1342,shaman,restoration,142,66,76
Aldron,tirion,1341,shaman,restoration,81,45,36
Thunda,stormreaver,1341,shaman,restoration,36,15,21
Xoxoheal,eredar,1341,shaman,restoration,66,26,40
Jéhil,hyjal,1340,shaman,restoration,42,22,20
Intoxed,sylvanas,1340,shaman,restoration,120,62,58
Gaelic,frostmourne,1340,shaman,restoration,122,59,63
Schnessert,silvermoon,1340,shaman,restoration,36,16,20
Schïps,kirin-tor,1339,shaman,restoration,54,31,23
Maburst,silvermoon,1339,shaman,restoration,30,17,13
Thecallviper,blackmoore,1339,shaman,restoration,162,78,84
Lvj,blackrock,1339,shaman,restoration,36,16,20
Reyja,draenor,1338,shaman,restoration,42,24,18
Fußpilzmann,blackmoore,1338,shaman,restoration,139,76,63
Krolhok,hyjal,1338,shaman,restoration,30,14,16
Bananis,outland,1337,shaman,restoration,24,14,10
Lillkrutarn,tarren-mill,1336,shaman,restoration,24,16,8
Shapperdin,darksorrow,1336,shaman,restoration,24,14,10
Reticlol,kazzak,1336,shaman,restoration,30,14,16
Chamika,dentarg,1336,shaman,restoration,60,24,36
Freizeitler,antonidas,1335,shaman,restoration,78,37,41
Lorko,twisting-nether,1335,shaman,restoration,30,14,16
Dreamon,culte-de-la-rive-noire,1334,shaman,restoration,24,14,10
Lickmytôtem,frostmane,1334,shaman,restoration,33,15,18
Hephaisto,defias-brotherhood,1333,shaman,restoration,48,30,18
Ongewasgone,defias-brotherhood,1333,shaman,restoration,30,16,14
Grimn,burning-legion,1333,shaman,restoration,110,55,55
Nephylim,grim-batol,1333,shaman,restoration,48,22,26
Friski,silvermoon,1332,shaman,restoration,24,14,10
Skreppa,kazzak,1332,shaman,restoration,42,24,18
Onlytides,doomhammer,1332,shaman,restoration,144,64,80
Милыйдед,gordunni,1332,shaman,restoration,42,14,28
Istenes,frostwolf,1331,shaman,restoration,24,14,10
Amatero,drakthul,1331,shaman,restoration,61,34,27
Хотдевил,gordunni,1331,shaman,restoration,59,32,27
Bíìerlip,twisting-nether,1331,shaman,restoration,77,39,38
Kashnar,tarren-mill,1330,shaman,restoration,28,16,12
Lilshamano,ravencrest,1330,shaman,restoration,389,210,179
Shôk,ravencrest,1330,shaman,restoration,92,48,44
Касьянкочка,blackscar,1330,shaman,restoration,36,14,22
Beardling,auchindoun,1329,shaman,restoration,24,15,9
Andrewbéelko,drakthul,1329,shaman,restoration,24,14,10
Kemmi,dalaran,1328,shaman,restoration,30,14,16
Energised,alonsus,1328,shaman,restoration,60,27,33
Jarvís,gilneas,1327,shaman,restoration,50,19,31
Egí,azshara,1327,shaman,restoration,53,19,34
Rustfeather,sanguino,1326,shaman,restoration,30,14,16
Zenzua,twisting-nether,1325,shaman,restoration,47,29,18
Obêlixx,blackmoore,1325,shaman,restoration,120,62,58
Eero,darksorrow,1324,shaman,restoration,24,16,8
Регбисто,soulflayer,1324,shaman,restoration,89,44,45
Mansquidgoat,darksorrow,1323,shaman,restoration,33,22,11
Bigayak,blackrock,1323,shaman,restoration,39,20,19
Murmelï,stormreaver,1323,shaman,restoration,165,83,82
Cloovster,magtheridon,1323,shaman,restoration,36,17,19
Пит,goldrinn,1323,shaman,restoration,36,17,19
Schaname,rajaxx,1323,shaman,restoration,30,14,16
Brassefrasse,shattered-hand,1322,shaman,restoration,57,30,27
Woade,silvermoon,1322,shaman,restoration,84,43,41
Shamaam,burning-legion,1322,shaman,restoration,79,38,41
Кураж,howling-fjord,1322,shaman,restoration,52,21,31
Georgieboi,sylvanas,1321,shaman,restoration,24,14,10
Tonifo,nemesis,1321,shaman,restoration,59,34,25
Maestro,spinebreaker,1321,shaman,restoration,30,17,13
Lerosh,twisting-nether,1321,shaman,restoration,60,33,27
Mjöllnir,blackrock,1321,shaman,restoration,108,56,52
Flameshock,tarren-mill,1321,shaman,restoration,54,23,31
Sadkick,twisting-nether,1320,shaman,restoration,24,14,10
Ketzersend,alleria,1320,shaman,restoration,48,26,22
Foximus,blackhand,1320,shaman,restoration,133,68,65
Modder,ragnaros,1320,shaman,restoration,30,14,16
Zarschu,burning-legion,1320,shaman,restoration,48,17,31
Razeroø,ysondre,1318,shaman,restoration,85,45,40
Nybz,sylvanas,1318,shaman,restoration,162,83,79
Виртуосгодх,soulflayer,1318,shaman,restoration,104,50,54
Перегной,ashenvale,1318,shaman,restoration,159,76,83
Dregú,draenor,1317,shaman,restoration,105,58,47
Snugzqt,tarren-mill,1317,shaman,restoration,128,66,62
Zantam,ravencrest,1317,shaman,restoration,108,52,56
Shinds,archimonde,1317,shaman,restoration,84,37,47
Chéonz,nethersturm,1316,shaman,restoration,96,50,46
Suze,hellfire,1316,shaman,restoration,102,49,53
Yzeldan,hyjal,1315,shaman,restoration,354,195,159
Pyxton,kazzak,1315,shaman,restoration,48,26,22
Жижелье,howling-fjord,1312,shaman,restoration,128,68,60
Kbakasham,ravencrest,1312,shaman,restoration,56,27,29
Keräx,cthun,1311,shaman,restoration,24,14,10
Шаманутый,gordunni,1311,shaman,restoration,97,52,45
Outerspace,silvermoon,1311,shaman,restoration,117,58,59
Ххвхд,soulflayer,1310,shaman,restoration,84,45,39
Ampaniaristo,sylvanas,1310,shaman,restoration,108,49,59
Düsterlotus,dalvengyr,1308,shaman,restoration,196,106,90
Skoddy,blackmoore,1308,shaman,restoration,61,31,30
Shamingu,arathor,1308,shaman,restoration,152,77,75
Ephase,burning-blade,1308,shaman,restoration,67,25,42
Elvalya,archimonde,1307,shaman,restoration,23,14,9
Tâvôry,aegwynn,1307,shaman,restoration,89,36,53
Feumble,archimonde,1307,shaman,restoration,54,20,34
Bluesteel,bladefist,1306,shaman,restoration,74,28,46
Thaarley,blackmoore,1305,shaman,restoration,34,22,12
Shafallen,tarren-mill,1305,shaman,restoration,40,24,16
Alisàn,teldrassil,1305,shaman,restoration,240,117,123
Durek,aerie-peak,1304,shaman,restoration,24,14,10
Shioni,ravencrest,1304,shaman,restoration,169,80,89
Rone,burning-blade,1303,shaman,restoration,36,19,17
Laykablue,blackhand,1303,shaman,restoration,55,26,29
Baboss,blutkessel,1302,shaman,restoration,77,40,37
Crymere,chamber-of-aspects,1302,shaman,restoration,343,173,170
Cudntreskobe,kazzak,1301,shaman,restoration,46,24,22
Chilliajin,tarren-mill,1300,shaman,restoration,107,49,58
Wtsfeetpics,dragonblight,1300,shaman,restoration,73,27,46
Шаеман,soulflayer,1298,shaman,restoration,36,20,16
Iziisham,outland,1298,shaman,restoration,103,53,50
Mystycos,burning-legion,1298,shaman,restoration,36,14,22
Dpgsevenk,kazzak,1297,shaman,restoration,53,30,23
Qjx,blackrock,1297,shaman,restoration,30,16,14
Northodox,outland,1296,shaman,restoration,50,25,25
Бладих,howling-fjord,1295,shaman,restoration,321,158,163
Rhakhatheckh,nemesis,1295,shaman,restoration,58,26,32
Bomboclat,azjolnerub,1294,shaman,restoration,129,67,62
Beyp,sylvanas,1294,shaman,restoration,103,52,51
Icecrêam,auchindoun,1294,shaman,restoration,28,14,14
Bluefacebaby,nemesis,1294,shaman,restoration,212,102,110
Mwnci,anachronos,1293,shaman,restoration,195,105,90
Foxtér,burning-blade,1293,shaman,restoration,54,28,26
Frankx,stormscale,1293,shaman,restoration,62,26,36
Alteredstate,twisting-nether,1292,shaman,restoration,36,16,20
Колосх,howling-fjord,1292,shaman,restoration,60,26,34
Asaakira,blackmoore,1291,shaman,restoration,75,45,30
Fethiroth,sylvanas,1291,shaman,restoration,143,76,67
Быковат,booty-bay,1291,shaman,restoration,212,111,101
Bèx,twisting-nether,1291,shaman,restoration,60,29,31
Mcslammer,kazzak,1291,shaman,restoration,48,22,26
Ironspine,sylvanas,1290,shaman,restoration,47,24,23
Fünkchn,zuluhed,1290,shaman,restoration,100,51,49
Кразтор,howling-fjord,1290,shaman,restoration,173,78,95
Zujaz,stormscale,1289,shaman,restoration,30,14,16
Kamamura,frostwolf,1289,shaman,restoration,48,22,26
Shamanaman,stormscale,1287,shaman,restoration,24,14,10
Jimmybuffett,kazzak,1287,shaman,restoration,127,66,61
Xamic,twisting-nether,1287,shaman,restoration,81,38,43
Littledorf,ravencrest,1286,shaman,restoration,141,73,68
Эрутеон,deathguard,1286,shaman,restoration,179,82,97
Kneggebrot,blackmoore,1286,shaman,restoration,96,39,57
Jänis,ragnaros,1286,shaman,restoration,40,16,24
Soger,mannoroth,1286,shaman,restoration,68,27,41
Riverwin,silvermoon,1285,shaman,restoration,60,39,21
He,twisting-nether,1285,shaman,restoration,78,42,36
Totemglad,drakthul,1284,shaman,restoration,27,15,12
Orcinterface,tarren-mill,1284,shaman,restoration,176,85,91
Quiec,kazzak,1284,shaman,restoration,115,46,69
Slowtem,draenor,1283,shaman,restoration,119,58,61
Ferome,kazzak,1282,shaman,restoration,96,49,47
Формацепт,ashenvale,1282,shaman,restoration,179,90,89
Panicblast,stormscale,1281,shaman,restoration,50,29,21
Kuddjah,twisting-nether,1280,shaman,restoration,95,49,46
Shamhaara,blackrock,1280,shaman,restoration,54,25,29
Thurgaden,nemesis,1279,shaman,restoration,66,45,21
Эртирон,howling-fjord,1279,shaman,restoration,383,200,183
Justweirdaf,blackmoore,1279,shaman,restoration,33,16,17
Morty,tarren-mill,1279,shaman,restoration,59,27,32
Викодиншама,howling-fjord,1278,shaman,restoration,68,37,31
Praise,auchindoun,1278,shaman,restoration,53,24,29
Chaminoune,sargeras,1278,shaman,restoration,48,21,27
Kraugug,archimonde,1277,shaman,restoration,44,24,20
Bedouín,draenor,1277,shaman,restoration,132,69,63
Deaslow,hyjal,1276,shaman,restoration,40,25,15
Asumix,illidan,1276,shaman,restoration,106,53,53
Бичпак,howling-fjord,1276,shaman,restoration,102,49,53
Samantouz,archimonde,1275,shaman,restoration,150,70,80
Silko,wrathbringer,1275,shaman,restoration,92,42,50
Voodz,nathrezim,1274,shaman,restoration,67,30,37
Semrix,blackhand,1273,shaman,restoration,170,80,90
Buböta,sanguino,1273,shaman,restoration,44,17,27
Санрэйн,soulflayer,1272,shaman,restoration,65,37,28
Lorthargol,chamber-of-aspects,1272,shaman,restoration,42,17,25
Áchilleus,kazzak,1271,shaman,restoration,92,42,50
Hexyasf,ravencrest,1271,shaman,restoration,58,25,33
Шайнинлайт,soulflayer,1271,shaman,restoration,107,42,65
Yslìn,khaz-modan,1271,shaman,restoration,41,14,27
Idkteam,stormscale,1270,shaman,restoration,30,15,15
Parkroy,draenor,1270,shaman,restoration,84,37,47
Nabo,archimonde,1270,shaman,restoration,52,22,30
Flambusier,hyjal,1269,shaman,restoration,297,163,134
Honollulu,drakthul,1269,shaman,restoration,48,26,22
Nwäar,archimonde,1269,shaman,restoration,148,72,76
Nazgréll,tarren-mill,1268,shaman,restoration,157,84,73
Максибончик,soulflayer,1268,shaman,restoration,125,63,62
Gauss,agamaggan,1268,shaman,restoration,37,18,19
Shamtrix,drakthul,1268,shaman,restoration,89,41,48
Diya,karazhan,1268,shaman,restoration,132,57,75
Mehboul,hyjal,1267,shaman,restoration,28,14,14
Stormcaster,argent-dawn,1267,shaman,restoration,70,34,36
Orchal,defias-brotherhood,1267,shaman,restoration,75,36,39
Oscar,khaz-modan,1267,shaman,restoration,48,23,25
Shamanmode,twisting-nether,1267,shaman,restoration,66,28,38
Goreflame,argent-dawn,1266,shaman,restoration,91,50,41
Bendimina,chogall,1265,shaman,restoration,30,18,12
Yuliy,arathor,1265,shaman,restoration,126,59,67
Furïas,hyjal,1265,shaman,restoration,48,22,26
Wayoa,defias-brotherhood,1264,shaman,restoration,24,18,6
Knasta,malygos,1263,shaman,restoration,63,34,29
Horiun,sanguino,1263,shaman,restoration,67,32,35
Laftershamy,cthun,1263,shaman,restoration,42,14,28
Iamnyka,blackrock,1262,shaman,restoration,108,58,50
Kéimohansio,draenor,1262,shaman,restoration,468,225,243
Kelshaj,thrall,1262,shaman,restoration,33,15,18
Azifox,hyjal,1260,shaman,restoration,25,14,11
Leunam,draenor,1260,shaman,restoration,58,30,28
Rookwave,eredar,1260,shaman,restoration,46,21,25
Proxysham,the-maelstrom,1258,shaman,restoration,52,32,20
Skenflewds,alakir,1258,shaman,restoration,144,62,82
Puresham,twisting-nether,1258,shaman,restoration,60,23,37
Gorël,sinstralis,1257,shaman,restoration,79,44,35
Munjar,korgall,1257,shaman,restoration,30,15,15
Lidinsham,draenor,1257,shaman,restoration,42,19,23
Yxi,blackmoore,1256,shaman,restoration,42,25,17
Storqix,drakthul,1256,shaman,restoration,276,129,147
Mazu,spinebreaker,1256,shaman,restoration,65,26,39
Binslagala,zuljin,1254,shaman,restoration,24,16,8
Säphïr,hyjal,1254,shaman,restoration,46,25,21
Pomegranate,arthas,1254,shaman,restoration,56,23,33
Shamaxwell,blackhand,1253,shaman,restoration,24,16,8
Chartersham,silvermoon,1252,shaman,restoration,18,14,4
Gushgush,draenor,1252,shaman,restoration,48,28,20
Ogrilza,uldaman,1252,shaman,restoration,136,74,62
Onethousand,antonidas,1252,shaman,restoration,88,47,41
Tilixs,draenor,1252,shaman,restoration,87,32,55
Фистинктотем,soulflayer,1250,shaman,restoration,122,62,60
Try,zuluhed,1250,shaman,restoration,36,16,20
Lolafløres,dun-modr,1249,shaman,restoration,59,42,17
Mosterx,stormscale,1249,shaman,restoration,93,54,39
Eduorde,silvermoon,1249,shaman,restoration,88,45,43
Милжон,soulflayer,1248,shaman,restoration,212,119,93
Loppish,silvermoon,1248,shaman,restoration,177,95,82
Isak,ravencrest,1248,shaman,restoration,54,21,33
Nightrâin,kazzak,1247,shaman,restoration,49,23,26
Mandoloriana,sylvanas,1247,shaman,restoration,108,50,58
Джамандх,blackscar,1247,shaman,restoration,64,29,35
Musham,blackrock,1246,shaman,restoration,18,13,5
Дисмон,ashenvale,1246,shaman,restoration,102,56,46
Shamanet,kazzak,1246,shaman,restoration,47,21,26
Руикси,howling-fjord,1246,shaman,restoration,30,13,17
Pyrotoad,blackmoore,1246,shaman,restoration,30,13,17
Løktarøgàr,archimonde,1246,shaman,restoration,38,16,22
Повор,soulflayer,1246,shaman,restoration,75,30,45
Новогор,soulflayer,1245,shaman,restoration,84,44,40
Sorcerus,burning-legion,1245,shaman,restoration,251,118,133
Thuns,stormscale,1243,shaman,restoration,41,24,17
Watashij,outland,1243,shaman,restoration,69,36,33
Barbebiendur,archimonde,1242,shaman,restoration,30,13,17
Raincaller,archimonde,1242,shaman,restoration,76,29,47
Anlaki,silvermoon,1241,shaman,restoration,18,13,5
Dréa,draenor,1241,shaman,restoration,24,13,11
Kìra,darkmoon-faire,1241,shaman,restoration,65,34,31
Mêkyra,blackmoore,1241,shaman,restoration,146,70,76
Kryuxs,blackrock,1241,shaman,restoration,96,45,51
Sáltý,ravencrest,1241,shaman,restoration,30,14,16
Djschamihaar,blackrock,1240,shaman,restoration,18,13,5
Volwerin,blackhand,1240,shaman,restoration,24,13,11
Dwarfofwar,ravencrest,1240,shaman,restoration,149,73,76
Ríko,argent-dawn,1240,shaman,restoration,88,43,45
Mazuh,twisting-nether,1239,shaman,restoration,24,14,10
Måke,stormscale,1238,shaman,restoration,24,13,11
Ðøminantx,stormscale,1238,shaman,restoration,61,30,31
Shadowmove,bronzebeard,1237,shaman,restoration,24,13,11
Thenasil,stormscale,1237,shaman,restoration,136,69,67
Tenny,haomarush,1237,shaman,restoration,78,31,47
Nimos,drakthul,1237,shaman,restoration,36,13,23
Obadai,nemesis,1236,shaman,restoration,36,13,23
Fulminare,ravencrest,1235,shaman,restoration,83,42,41
Senfury,culte-de-la-rive-noire,1235,shaman,restoration,36,17,19
Tosaá,antonidas,1235,shaman,restoration,48,22,26
Scàráth,eredar,1235,shaman,restoration,69,27,42
Корольшомен,gordunni,1234,shaman,restoration,24,14,10
Tiddles,arathor,1234,shaman,restoration,24,13,11
Stivishamy,blackmoore,1234,shaman,restoration,58,30,28
Thundertail,ragnaros,1234,shaman,restoration,42,15,27
Shasto,draenor,1233,shaman,restoration,30,13,17
Asschick,outland,1233,shaman,restoration,36,13,23
Kyaz,ravencrest,1231,shaman,restoration,30,15,15
Heltjettad,frostmane,1231,shaman,restoration,46,21,25
Carnágé,blackrock,1230,shaman,restoration,48,27,21
Valgrosh,sylvanas,1230,shaman,restoration,24,13,11
Zapymon,draenor,1230,shaman,restoration,48,21,27
Eomsham,magtheridon,1229,shaman,restoration,30,13,17
Rakân,ysondre,1229,shaman,restoration,36,13,23
Zìik,draenor,1229,shaman,restoration,36,13,23
Lopetitchat,chogall,1228,shaman,restoration,81,40,41
Makaria,emerald-dream,1228,shaman,restoration,285,137,148
Sugardad,khaz-modan,1228,shaman,restoration,189,90,99
Натаро,soulflayer,1228,shaman,restoration,30,13,17
Wildos,zuljin,1228,shaman,restoration,54,21,33
Tuba,ragnaros,1227,shaman,restoration,81,47,34
Doriana,dalaran,1227,shaman,restoration,137,63,74
Alexmiamosch,thrall,1226,shaman,restoration,78,48,30
Крэгнор,gordunni,1226,shaman,restoration,183,90,93
Thordahr,hyjal,1226,shaman,restoration,53,19,34
Buchânan,archimonde,1226,shaman,restoration,41,13,28
Enzopotenzo,blackrock,1225,shaman,restoration,140,64,76
Amrgl,earthen-ring,1225,shaman,restoration,126,54,72
Clearwaters,tarren-mill,1225,shaman,restoration,40,14,26
Ctpukek,ysondre,1224,shaman,restoration,89,46,43
Cismine,twisting-nether,1224,shaman,restoration,30,13,17
Линейджер,soulflayer,1224,shaman,restoration,42,15,27
Avattar,twisting-nether,1223,shaman,restoration,36,21,15
Electrífied,outland,1223,shaman,restoration,108,42,66
Shevarra,silvermoon,1222,shaman,restoration,228,121,107
Kavyzyoyo,twisting-nether,1222,shaman,restoration,71,31,40
Пончо,booty-bay,1221,shaman,restoration,146,77,69
Phineaph,theradras,1221,shaman,restoration,54,28,26
Huldi,kazzak,1220,shaman,restoration,75,42,33
Турбопушкин,soulflayer,1220,shaman,restoration,36,13,23
Dinosaurer,outland,1219,shaman,restoration,18,13,5
Nîckîî,aegwynn,1219,shaman,restoration,55,29,26
Madtotem,blackrock,1219,shaman,restoration,36,14,22
Anyxxia,aegwynn,1219,shaman,restoration,56,21,35
Lycburst,twisting-nether,1219,shaman,restoration,36,13,23
Rinn,frostmane,1219,shaman,restoration,58,20,38
Индигула,soulflayer,1219,shaman,restoration,59,18,41
Ulfom,silvermoon,1218,shaman,restoration,100,51,49
Smyke,magtheridon,1217,shaman,restoration,120,68,52
Thundersioux,ravencrest,1217,shaman,restoration,126,65,61
Виндфюрер,deathguard,1217,shaman,restoration,66,32,34
Shèshe,uldaman,1216,shaman,restoration,54,30,24
Kiiaser,sanguino,1216,shaman,restoration,70,33,37
Юляукраинка,gordunni,1216,shaman,restoration,55,24,31
Sickbrain,silvermoon,1216,shaman,restoration,45,19,26
Bïgdaddy,twisting-nether,1216,shaman,restoration,54,20,34
Biztor,jaedenar,1215,shaman,restoration,82,45,37
Mosler,thunderhorn,1215,shaman,restoration,55,29,26
Gerethor,burning-legion,1215,shaman,restoration,64,32,32
Kèlls,la-croisade-écarlate,1215,shaman,restoration,60,27,33
Oprawinfury,ravencrest,1215,shaman,restoration,48,20,28
Lupinola,kazzak,1214,shaman,restoration,36,19,17
Bullit,zuljin,1214,shaman,restoration,134,65,69
Rúberg,shadowsong,1213,shaman,restoration,42,20,22
Kãitse,silvermoon,1212,shaman,restoration,42,20,22
Lavafrans,kazzak,1211,shaman,restoration,18,13,5
Джусипуси,gordunni,1210,shaman,restoration,60,25,35
Kickvando,blackmoore,1209,shaman,restoration,44,22,22
Sgf,stormscale,1209,shaman,restoration,90,41,49
Shammynox,draenor,1208,shaman,restoration,30,14,16
Moonbotico,blackrock,1207,shaman,restoration,145,72,73
Síqú,blackmoore,1207,shaman,restoration,62,29,33
Xetri,ragnaros,1206,shaman,restoration,41,22,19
Morttes,burning-legion,1205,shaman,restoration,27,14,13
Ònlìgrøvè,kazzak,1205,shaman,restoration,216,95,121
Kivra,burning-legion,1205,shaman,restoration,137,59,78
Rawtex,draenor,1205,shaman,restoration,68,24,44
Nakenfeigy,stormreaver,1204,shaman,restoration,29,16,13
Bispi,blackmoore,1204,shaman,restoration,31,15,16
Undin,burning-legion,1202,shaman,restoration,114,64,50
Icozy,stormscale,1202,shaman,restoration,51,27,24
Shamandeadly,aggra-português,1202,shaman,restoration,36,19,17
Elwynn,terenas,1202,shaman,restoration,47,18,29
Mya,frostwolf,1201,shaman,restoration,29,14,15
Roxxo,frostwolf,1200,shaman,restoration,30,16,14
Patlangoi,outland,1200,shaman,restoration,266,130,136
Klamen,kazzak,1200,shaman,restoration,36,17,19
Blöödfist,drakthul,1200,shaman,restoration,35,14,21
Нолькастов,soulflayer,1199,shaman,restoration,17,13,4
Merkàba,pozzo-delleternità,1199,shaman,restoration,103,49,54
Pwccey,drakthul,1199,shaman,restoration,90,35,55
Kaletore,ragnaros,1198,shaman,restoration,78,42,36
Teccatwo,outland,1198,shaman,restoration,100,48,52
Линчон,soulflayer,1197,shaman,restoration,30,15,15
Corbo,ysondre,1196,shaman,restoration,126,68,58
Bruhin,ravencrest,1196,shaman,restoration,96,44,52
Jellyg,outland,1196,shaman,restoration,29,13,16
Chamon,grim-batol,1195,shaman,restoration,42,19,23
Pépón,dun-modr,1195,shaman,restoration,36,16,20
Fragolias,malygos,1194,shaman,restoration,36,18,18
Рангурэн,fordragon,1194,shaman,restoration,30,15,15
Vonneuman,draenor,1194,shaman,restoration,96,44,52
Cred,the-venture-co,1193,shaman,restoration,42,16,26
Lk,twilights-hammer,1191,shaman,restoration,21,14,7
Hóonda,twisting-nether,1191,shaman,restoration,24,13,11
Adonalsium,sylvanas,1191,shaman,restoration,65,29,36
Fatotato,outland,1191,shaman,restoration,36,13,23
Malamadre,antonidas,1191,shaman,restoration,48,17,31
Khazburn,hyjal,1191,shaman,restoration,42,13,29
Mystico,sanguino,1190,shaman,restoration,64,25,39
Conor,kult-der-verdammten,1187,shaman,restoration,54,26,28
Axéron,blackhand,1187,shaman,restoration,54,25,29
Дохаку,booty-bay,1187,shaman,restoration,29,13,16
Macchiavelli,blades-edge,1186,shaman,restoration,143,63,80
Xavií,blackmoore,1186,shaman,restoration,53,19,34
Leccyavenue,twisting-nether,1186,shaman,restoration,71,25,46
Манрото,soulflayer,1185,shaman,restoration,27,18,9
Saviothewise,aggra-português,1185,shaman,restoration,30,19,11
Moowfmoo,ragnaros,1185,shaman,restoration,33,14,19
Iltis,nazjatar,1185,shaman,restoration,58,24,34
Ekstrakiks,ravencrest,1185,shaman,restoration,46,19,27
Vermu,silvermoon,1184,shaman,restoration,32,20,12
Kuiji,stormreaver,1184,shaman,restoration,154,84,70
Narvalus,throkferoth,1184,shaman,restoration,40,21,19
Spørc,ragnaros,1184,shaman,restoration,160,79,81
Croku,thrall,1183,shaman,restoration,132,71,61
Csiribä,ragnaros,1183,shaman,restoration,45,19,26
Oldrym,blackrock,1183,shaman,restoration,64,25,39
Rêêza,blackhand,1182,shaman,restoration,72,38,34
Târrocke,nethersturm,1181,shaman,restoration,54,24,30
Shexy,the-maelstrom,1181,shaman,restoration,72,25,47
Nanolasso,anubarak,1181,shaman,restoration,38,13,25
Bigschamlipp,blackhand,1180,shaman,restoration,23,13,10
Shehullk,ravencrest,1180,shaman,restoration,28,15,13
Honorqi,sylvanas,1180,shaman,restoration,111,44,67
Bigrambo,draenor,1179,shaman,restoration,89,48,41
Darnok,quelthalas,1178,shaman,restoration,66,32,34
Thundrkrakn,blackhand,1177,shaman,restoration,77,39,38
Koggaion,kazzak,1177,shaman,restoration,95,36,59
Shacharcaspi,blackmoore,1177,shaman,restoration,55,20,35
Xabat,nemesis,1176,shaman,restoration,24,14,10
Kvekkis,argent-dawn,1175,shaman,restoration,30,17,13
Alcam,twisting-nether,1175,shaman,restoration,104,45,59
Buzzingsham,tarren-mill,1173,shaman,restoration,98,48,50
Baelee,sylvanas,1173,shaman,restoration,151,72,79
Goodmañ,eonar,1173,shaman,restoration,140,61,79
Аскирия,soulflayer,1173,shaman,restoration,36,13,23
Titavio,twisting-nether,1172,shaman,restoration,42,19,23
Zkalman,kazzak,1169,shaman,restoration,41,22,19
Tegellera,ravencrest,1168,shaman,restoration,53,27,26
Rhastasha,archimonde,1168,shaman,restoration,42,18,24
Chadshaman,antonidas,1166,shaman,restoration,91,37,54
Akimboo,kilrogg,1166,shaman,restoration,48,18,30
Kongapenes,tarren-mill,1165,shaman,restoration,42,23,19
Везериан,gordunni,1165,shaman,restoration,35,15,20
Raytastic,aegwynn,1164,shaman,restoration,36,18,18
Manitus,sylvanas,1162,shaman,restoration,139,66,73
Actic,garrosh,1160,shaman,restoration,36,14,22
Pituu,tarren-mill,1158,shaman,restoration,36,15,21
Cromosoma,dun-modr,1157,shaman,restoration,92,53,39
Shinui,twisting-nether,1157,shaman,restoration,51,26,25
Shamikàze,silvermoon,1155,shaman,restoration,70,46,24
Mostachin,dun-modr,1155,shaman,restoration,64,28,36
Devosham,blackrock,1153,shaman,restoration,102,51,51
Терату,gordunni,1152,shaman,restoration,24,12,12
Invades,shattered-hand,1152,shaman,restoration,24,12,12
Enviø,ravencrest,1151,shaman,restoration,12,12,0
Enchancement,ragnaros,1151,shaman,restoration,18,12,6
Helloimblue,blackmoore,1151,shaman,restoration,18,12,6
Exesemrone,uldaman,1151,shaman,restoration,18,12,6
Snackerella,blackrock,1151,shaman,restoration,18,12,6
Scriptx,blackmoore,1151,shaman,restoration,24,12,12
Thornyberrý,outland,1151,shaman,restoration,24,12,12
Giuliah,ravencrest,1151,shaman,restoration,24,12,12
Jimkopf,eredar,1151,shaman,restoration,54,26,28
Зачикинимся,howling-fjord,1151,shaman,restoration,30,12,18
Hohedichte,amanthul,1150,shaman,restoration,18,12,6
Souqixo,drakthul,1150,shaman,restoration,18,12,6
Chimey,frostmane,1150,shaman,restoration,24,12,12
Sparkygrill,eredar,1150,shaman,restoration,24,12,12
Hérépilé,dalaran,1150,shaman,restoration,24,12,12
Flandersx,ravencrest,1150,shaman,restoration,24,12,12
Фатнир,soulflayer,1150,shaman,restoration,24,12,12
Lolalovexo,kazzak,1150,shaman,restoration,30,14,16
Wieszcz,kazzak,1150,shaman,restoration,122,53,69
Killatotem,kazzak,1150,shaman,restoration,30,12,18
Ампулаикс,gordunni,1149,shaman,restoration,24,12,12
Rëazx,archimonde,1149,shaman,restoration,24,12,12
Woopiedoopie,silvermoon,1149,shaman,restoration,24,12,12
Kaherad,antonidas,1148,shaman,restoration,72,33,39
Xêra,burning-legion,1147,shaman,restoration,22,13,9
Kärríegold,blackrock,1146,shaman,restoration,18,12,6
Lemontea,burning-blade,1146,shaman,restoration,174,83,91
Graoulelou,hyjal,1145,shaman,restoration,24,12,12
Komodski,kazzak,1145,shaman,restoration,24,12,12
Dominatorix,xavius,1144,shaman,restoration,19,12,7
Alexialul,silvermoon,1144,shaman,restoration,24,12,12
Kuse,anubarak,1144,shaman,restoration,30,12,18
Unraedorc,twisting-nether,1144,shaman,restoration,30,12,18
Drman,shattered-hand,1143,shaman,restoration,60,33,27
Чойсе,deathguard,1143,shaman,restoration,24,12,12
Lynesse,ragnaros,1142,shaman,restoration,18,12,6
Jáckdaniels,twisting-nether,1142,shaman,restoration,28,14,14
Bliksem,tarren-mill,1142,shaman,restoration,24,12,12
Harptwo,eredar,1142,shaman,restoration,89,43,46
Yasunari,sanguino,1142,shaman,restoration,48,17,31
Lumière,alonsus,1141,shaman,restoration,24,12,12
Trünk,arathi,1141,shaman,restoration,66,21,45
Кезара,razuvious,1140,shaman,restoration,66,32,34
Canhealu,nemesis,1139,shaman,restoration,361,181,180
Coxshamanic,draenor,1139,shaman,restoration,36,12,24
Clips,frostmane,1138,shaman,restoration,30,12,18
Baarona,neptulon,1137,shaman,restoration,30,16,14
Masham,darkspear,1137,shaman,restoration,30,12,18
Scamander,draenor,1137,shaman,restoration,38,14,24
Khanokekw,twisting-nether,1136,shaman,restoration,142,76,66
Дрекрош,howling-fjord,1136,shaman,restoration,365,171,194
Paniio,stormscale,1136,shaman,restoration,72,31,41
Laïnàà,archimonde,1136,shaman,restoration,65,27,38
Bogatyrk,twisting-nether,1134,shaman,restoration,23,13,10
Gárdzsúlió,ragnaros,1134,shaman,restoration,24,12,12
Xerijan,pozzo-delleternità,1134,shaman,restoration,134,65,69
Sciamanò,nemesis,1133,shaman,restoration,18,12,6
Stormred,blackmoore,1133,shaman,restoration,36,19,17
Шаманнутая,gordunni,1133,shaman,restoration,30,12,18
Mälaa,ysondre,1133,shaman,restoration,30,12,18
Sërka,cthun,1133,shaman,restoration,56,20,36
Nozòmi,defias-brotherhood,1132,shaman,restoration,30,12,18
Omgodofwar,burning-blade,1132,shaman,restoration,90,33,57
Здрахарь,howling-fjord,1130,shaman,restoration,38,15,23
Mearu,bronze-dragonflight,1129,shaman,restoration,94,56,38
Морпат,soulflayer,1129,shaman,restoration,70,38,32
Jiaan,burning-legion,1127,shaman,restoration,24,13,11
Profylax,arathor,1127,shaman,restoration,54,27,27
Gondrim,blackmoore,1127,shaman,restoration,35,17,18
Xilquid,darksorrow,1126,shaman,restoration,51,19,32
ßasìkz,hyjal,1126,shaman,restoration,59,12,47
Garifus,dun-modr,1125,shaman,restoration,198,105,93
Bigwa,dun-morogh,1124,shaman,restoration,59,37,22
Poggsham,twisting-nether,1124,shaman,restoration,80,37,43
Vimra,blackhand,1124,shaman,restoration,59,21,38
Ivaccineyou,blackmoore,1123,shaman,restoration,30,15,15
Shámpaín,outland,1123,shaman,restoration,67,29,38
Førcemajeure,kazzak,1121,shaman,restoration,24,12,12
Størmbølt,draenor,1120,shaman,restoration,114,49,65
Nesjâ,blackhand,1120,shaman,restoration,30,12,18
Эйвуа,gordunni,1119,shaman,restoration,131,66,65
Temeres,drakthul,1119,shaman,restoration,30,15,15
Blíngen,ravencrest,1117,shaman,restoration,60,35,25
Nftkal,emerald-dream,1117,shaman,restoration,94,44,50
Nazantìa,hyjal,1116,shaman,restoration,65,33,32
Grimnyr,onyxia,1115,shaman,restoration,30,12,18
Щцц,soulflayer,1115,shaman,restoration,36,12,24
Checkpoint,defias-brotherhood,1114,shaman,restoration,90,47,43
Aénéas,twisting-nether,1114,shaman,restoration,36,13,23
Sarenity,hellfire,1113,shaman,restoration,53,27,26
Fairgewalt,blackhand,1113,shaman,restoration,26,13,13
Aveet,kazzak,1113,shaman,restoration,24,12,12
Понбарон,gordunni,1113,shaman,restoration,46,19,27
Suntpraf,kazzak,1113,shaman,restoration,47,19,28
Hayvack,hyjal,1112,shaman,restoration,56,28,28
Olînours,archimonde,1112,shaman,restoration,42,21,21
Magmera,argent-dawn,1112,shaman,restoration,200,92,108
Elunaxcc,eredar,1111,shaman,restoration,73,38,35
Soramat,aegwynn,1111,shaman,restoration,29,12,17
Thopeur,ysondre,1111,shaman,restoration,48,14,34
Akuha,dun-modr,1110,shaman,restoration,44,13,31
Shakgor,draenor,1108,shaman,restoration,90,50,40
Avadokadavra,kazzak,1107,shaman,restoration,47,21,26
Alø,blackrock,1106,shaman,restoration,42,18,24
Walmartorc,kazzak,1105,shaman,restoration,27,13,14
Maflas,dun-modr,1104,shaman,restoration,69,37,32
Aviearn,ragnaros,1102,shaman,restoration,60,31,29
Alvastis,moonglade,1099,shaman,restoration,42,16,26
Jhaky,dun-modr,1099,shaman,restoration,36,13,23
Floki,emerald-dream,1096,shaman,restoration,39,13,26
Zerwurster,thrall,1094,shaman,restoration,60,30,30
Rusbeermen,silvermoon,1094,shaman,restoration,47,13,34
Tomtefaan,sylvanas,1093,shaman,restoration,36,19,17
Alakan,saurfang,1093,shaman,restoration,140,65,75
Shøckz,azjolnerub,1092,shaman,restoration,48,28,20
Ariekanarie,ravencrest,1092,shaman,restoration,66,35,31
Ironbeard,daggerspine,1092,shaman,restoration,76,36,40
Sizzurp,mugthol,1092,shaman,restoration,66,26,40
Shyyfu,kazzak,1091,shaman,restoration,54,25,29
Xoxoxoxoa,twisting-nether,1091,shaman,restoration,118,47,71
Walgon,blackhand,1091,shaman,restoration,76,27,49
Arabesk,arygos,1087,shaman,restoration,114,51,63
Lapou,archimonde,1087,shaman,restoration,36,12,24
Gotreck,zuljin,1086,shaman,restoration,36,13,23
Mufzo,draenor,1086,shaman,restoration,47,16,31
Assyrià,ravencrest,1085,shaman,restoration,58,25,33
Кислыйсоус,gordunni,1083,shaman,restoration,78,39,39
Sneggels,wrathbringer,1083,shaman,restoration,74,35,39
Mantoon,doomhammer,1083,shaman,restoration,72,32,40
Spartecøbra,dalaran,1083,shaman,restoration,36,16,20
Smö,kazzak,1082,shaman,restoration,30,15,15
Arienus,turalyon,1081,shaman,restoration,22,12,10
Bennycooch,silvermoon,1081,shaman,restoration,107,42,65
Qyo,throkferoth,1080,shaman,restoration,65,38,27
Ntaris,blackmoore,1080,shaman,restoration,22,12,10
Чоколав,howling-fjord,1079,shaman,restoration,66,36,30
Brâshô,frostwolf,1077,shaman,restoration,57,27,30
Woew,tarren-mill,1076,shaman,restoration,24,12,12
Hunorth,stormscale,1075,shaman,restoration,64,28,36
Rórekk,aegwynn,1074,shaman,restoration,42,18,24
Jaéto,ravencrest,1073,shaman,restoration,30,17,13
Shamone,stormreaver,1070,shaman,restoration,35,16,19
Holshammy,nemesis,1069,shaman,restoration,96,40,56
Worthless,quelthalas,1069,shaman,restoration,72,30,42
Lowhpqt,blackrock,1066,shaman,restoration,18,13,5
Quîn,defias-brotherhood,1066,shaman,restoration,102,48,54
Xari,earthen-ring,1066,shaman,restoration,67,28,39
Elosenx,magtheridon,1064,shaman,restoration,30,16,14
Blautorkel,amanthul,1064,shaman,restoration,65,27,38
Zuggerberg,defias-brotherhood,1063,shaman,restoration,33,12,21
Jeezy,blackhand,1062,shaman,restoration,72,26,46
Hikigane,marécage-de-zangar,1061,shaman,restoration,54,20,34
Morrtes,burning-legion,1056,shaman,restoration,19,12,7
Shamoobob,archimonde,1056,shaman,restoration,18,11,7
Лисёноклорд,gordunni,1056,shaman,restoration,24,11,13
Milfishake,frostwolf,1056,shaman,restoration,24,11,13
Rôwdy,kazzak,1056,shaman,restoration,24,11,13
Snoopfrog,dun-morogh,1056,shaman,restoration,53,22,31
Recov,draenor,1056,shaman,restoration,28,11,17
Thaw,sylvanas,1056,shaman,restoration,30,11,19
Yashëa,ysondre,1055,shaman,restoration,18,11,7
Doubleshamz,the-maelstrom,1055,shaman,restoration,18,11,7
Zuly,grim-batol,1055,shaman,restoration,18,11,7
Diaminya,tarren-mill,1055,shaman,restoration,18,11,7
Drmanathan,garona,1055,shaman,restoration,18,11,7
Vulkan,kirin-tor,1055,shaman,restoration,54,25,29
Qwázú,silvermoon,1055,shaman,restoration,24,11,13
Blipster,tarren-mill,1055,shaman,restoration,24,11,13
Icecold,grim-batol,1055,shaman,restoration,24,11,13
Infinitetide,doomhammer,1055,shaman,restoration,24,11,13
Wintradezki,tarren-mill,1055,shaman,restoration,24,11,13
Lanzatotems,dun-modr,1055,shaman,restoration,93,42,51
Kãrthala,blackhand,1055,shaman,restoration,30,11,19
Mckoy,kazzak,1054,shaman,restoration,24,11,13
Mêrowinger,blackhand,1054,shaman,restoration,24,11,13
Blóúb,blackmoore,1054,shaman,restoration,24,11,13
Elshamino,ravencrest,1054,shaman,restoration,24,11,13
Ixthus,varimathras,1054,shaman,restoration,24,11,13
Sheherezeday,aegwynn,1053,shaman,restoration,18,11,7
Flokinette,chogall,1053,shaman,restoration,24,11,13
Salatmayoo,alakir,1053,shaman,restoration,27,12,15
Kswíss,outland,1052,shaman,restoration,21,13,8
Ehrling,ysondre,1052,shaman,restoration,125,64,61
Zourià,archimonde,1052,shaman,restoration,30,11,19
Papskalla,ravencrest,1052,shaman,restoration,30,11,19
Rouwa,korgall,1051,shaman,restoration,18,11,7
Kelvok,silvermoon,1051,shaman,restoration,18,11,7
Fivezax,tarren-mill,1051,shaman,restoration,90,47,43
Zackboing,thrall,1051,shaman,restoration,75,38,37
Lòómit,anetheron,1051,shaman,restoration,89,43,46
Gungo,deathwing,1051,shaman,restoration,24,11,13
Тирона,howling-fjord,1051,shaman,restoration,30,11,19
Fläskdoris,tarren-mill,1051,shaman,restoration,30,11,19
Leafplsx,blackrock,1051,shaman,restoration,30,11,19
Ampz,boulderfist,1051,shaman,restoration,65,23,42
Kíkjo,aegwynn,1050,shaman,restoration,18,11,7
Iwaa,dalaran,1050,shaman,restoration,24,11,13
Оперочек,howling-fjord,1050,shaman,restoration,42,12,30
Bandiitti,darksorrow,1049,shaman,restoration,18,11,7
Pumbat,lothar,1049,shaman,restoration,18,11,7
Kissaru,antonidas,1049,shaman,restoration,18,11,7
Nakertaako,kazzak,1049,shaman,restoration,24,11,13
Cottoneyejoe,alexstrasza,1049,shaman,restoration,36,11,25
Esal,blackrock,1048,shaman,restoration,18,11,7
Lechirurgien,elune,1048,shaman,restoration,175,88,87
Ibkdalen,stormscale,1048,shaman,restoration,110,55,55
Zahké,stormscale,1048,shaman,restoration,24,11,13
Shamoek,argent-dawn,1048,shaman,restoration,48,20,28
Bakuga,ragnaros,1047,shaman,restoration,18,11,7
Towokk,kazzak,1047,shaman,restoration,60,34,26
Thrallash,blackhand,1047,shaman,restoration,42,12,30
Tyralià,draenor,1046,shaman,restoration,18,11,7
Nafay,lordaeron,1046,shaman,restoration,96,45,51
Анашишка,borean-tundra,1046,shaman,restoration,30,11,19
Fwoxyuwu,argent-dawn,1044,shaman,restoration,24,11,13
Adubsham,tarren-mill,1043,shaman,restoration,12,11,1
Strikerz,aggra-português,1043,shaman,restoration,32,16,16
Thaun,blackrock,1043,shaman,restoration,46,21,25
Silktotems,kazzak,1043,shaman,restoration,90,38,52
Omeletteoeuf,silvermoon,1042,shaman,restoration,24,13,11
Umgrall,archimonde,1042,shaman,restoration,66,27,39
Вашнюхтоптал,howling-fjord,1040,shaman,restoration,54,31,23
Xfiles,garona,1039,shaman,restoration,24,11,13
Syreer,silvermoon,1038,shaman,restoration,32,14,18
Милыйдорогой,soulflayer,1038,shaman,restoration,44,18,26
Görgûtz,illidan,1037,shaman,restoration,18,11,7
Slutie,stormscale,1036,shaman,restoration,23,11,12
Флафен,howling-fjord,1035,shaman,restoration,30,15,15
Zherøn,tyrande,1035,shaman,restoration,24,11,13
Manolaz,kazzak,1035,shaman,restoration,24,11,13
Eliteblood,kazzak,1034,shaman,restoration,30,21,9
Снобу,gordunni,1034,shaman,restoration,24,11,13
Gadoway,hyjal,1034,shaman,restoration,24,11,13
Jotuna,argent-dawn,1034,shaman,restoration,30,12,18
Koholona,malygos,1033,shaman,restoration,55,28,27
Dikwijls,ravencrest,1031,shaman,restoration,24,11,13
Arles,dun-modr,1031,shaman,restoration,30,12,18
Drogskull,sanguino,1030,shaman,restoration,18,11,7
Hazufel,kaelthas,1030,shaman,restoration,62,27,35
Mambokïngs,sanguino,1030,shaman,restoration,38,14,24
Moglibard,grim-batol,1028,shaman,restoration,18,11,7
Totembse,silvermoon,1028,shaman,restoration,30,11,19
Schamos,kiljaeden,1028,shaman,restoration,36,12,24
Abuzay,medivh,1026,shaman,restoration,18,11,7
Kundi,nazjatar,1026,shaman,restoration,24,11,13
Deesham,blackmoore,1026,shaman,restoration,32,12,20
Gigasham,azjolnerub,1025,shaman,restoration,82,39,43
Begeshaman,sylvanas,1025,shaman,restoration,426,199,227
Лялори,gordunni,1025,shaman,restoration,60,28,32
Zordox,zirkel-des-cenarius,1024,shaman,restoration,40,13,27
Ashmaul,outland,1023,shaman,restoration,48,24,24
Ипа,thermaplugg,1023,shaman,restoration,59,16,43
Deesbi,khaz-modan,1022,shaman,restoration,16,12,4
Aiuto,archimonde,1022,shaman,restoration,24,11,13
Hexinreflect,silvermoon,1021,shaman,restoration,96,41,55
Chaotikos,ravencrest,1019,shaman,restoration,163,99,64
Магмарончик,gordunni,1017,shaman,restoration,60,24,36
Snidge,magtheridon,1016,shaman,restoration,48,28,20
Wakka,wildhammer,1016,shaman,restoration,103,51,52
Nozer,arathor,1011,shaman,restoration,56,31,25
Мезонет,soulflayer,1011,shaman,restoration,30,16,14
Cukkerberg,ragnaros,1010,shaman,restoration,48,19,29
Protv,ravencrest,1009,shaman,restoration,54,31,23
Jøw,dun-modr,1007,shaman,restoration,96,57,39
Stkk,ravencrest,1007,shaman,restoration,152,76,76
Guulth,dun-modr,1006,shaman,restoration,21,11,10
Blainehammer,arathor,1006,shaman,restoration,30,12,18
Saamjai,turalyon,1005,shaman,restoration,30,17,13
Samant,neptulon,1004,shaman,restoration,72,36,36
Parabrisas,argent-dawn,1004,shaman,restoration,23,11,12
Symy,draenor,1002,shaman,restoration,69,31,38
Bluelasso,ysondre,1002,shaman,restoration,36,11,25
Robgon,aggra-português,1001,shaman,restoration,71,38,33
Thunderjax,laughing-skull,1001,shaman,restoration,58,29,29
Darkkshammy,silvermoon,1001,shaman,restoration,24,12,12
Soyungordoqt,sanguino,1000,shaman,restoration,20,12,8
Polystrath,silvermoon,1000,shaman,restoration,76,37,39
Xpone,blackrock,1000,shaman,restoration,54,26,28
Kissmepls,tarren-mill,999,shaman,restoration,26,12,14
Stormque,blackhand,998,shaman,restoration,214,100,114
Cmzyy,ravencrest,998,shaman,restoration,30,11,19
Isenth,ravencrest,998,shaman,restoration,71,25,46
Valdraxx,ravencrest,997,shaman,restoration,207,104,103
Grøzel,illidan,997,shaman,restoration,23,11,12
Xenda,blackrock,997,shaman,restoration,36,16,20
Totemkin,stormscale,997,shaman,restoration,84,21,63
Manush,aszune,996,shaman,restoration,42,17,25
Skunazo,sanguino,995,shaman,restoration,18,14,4
Рёнтар,howling-fjord,994,shaman,restoration,56,25,31
Hacyria,archimonde,993,shaman,restoration,60,35,25
Kanuw,kilrogg,993,shaman,restoration,75,41,34
Altesh,die-todeskrallen,992,shaman,restoration,22,11,11
Kledorchick,twisting-nether,992,shaman,restoration,69,15,54
Trixsham,ragnaros,990,shaman,restoration,29,13,16
Saarroo,ravencrest,990,shaman,restoration,123,51,72
Gharn,sanguino,990,shaman,restoration,28,11,17
Haginathor,twisting-nether,989,shaman,restoration,78,41,37
Grîzzou,les-clairvoyants,988,shaman,restoration,54,29,25
Aurelindae,silvermoon,986,shaman,restoration,52,22,30
Shamaray,stormscale,980,shaman,restoration,26,11,15
Teada,aegwynn,980,shaman,restoration,34,12,22
Дартарион,gordunni,978,shaman,restoration,74,33,41
Turbohulk,blackrock,976,shaman,restoration,19,11,8
Qusek,turalyon,976,shaman,restoration,338,172,166
Noriqt,kazzak,975,shaman,restoration,19,11,8
Ambrosioss,kazzak,975,shaman,restoration,30,17,13
Patites,twisting-nether,974,shaman,restoration,42,23,19
Jecastyle,sanguino,974,shaman,restoration,26,12,14
Shadî,kiljaeden,972,shaman,restoration,33,14,19
Quòr,antonidas,971,shaman,restoration,89,46,43
Schamannen,outland,970,shaman,restoration,43,23,20
Sakoon,twisting-nether,966,shaman,restoration,30,12,18
Hemsihammer,ysondre,965,shaman,restoration,23,11,12
Panicsc,twisting-nether,962,shaman,restoration,442,219,223
Gnomekiller,alonsus,961,shaman,restoration,42,12,30
Алексроуди,gordunni,960,shaman,restoration,12,10,2
Öyama,sinstralis,960,shaman,restoration,18,10,8
Gotta,dethecus,960,shaman,restoration,18,10,8
Çare,drakthul,960,shaman,restoration,18,10,8
Pank,kazzak,960,shaman,restoration,18,10,8
Shamounf,archimonde,960,shaman,restoration,18,10,8
Lunarsloth,hyjal,960,shaman,restoration,18,10,8
Irônmaxx,antonidas,960,shaman,restoration,24,10,14
Benlewis,twisting-nether,960,shaman,restoration,24,10,14
Kaátori,eredar,959,shaman,restoration,12,10,2
Blyxuhm,argent-dawn,959,shaman,restoration,12,10,2
Aylookitsgam,magtheridon,959,shaman,restoration,12,10,2
Hyperieon,antonidas,959,shaman,restoration,12,10,2
Sunjay,frostwolf,959,shaman,restoration,12,10,2
Ðtxkeks,onyxia,959,shaman,restoration,13,10,3
Ånny,blackmoore,959,shaman,restoration,18,10,8
Bauch,tichondrius,959,shaman,restoration,18,10,8
Frise,archimonde,959,shaman,restoration,24,12,12
Cellae,guldan,959,shaman,restoration,210,101,109
Daseus,malygos,959,shaman,restoration,75,36,39
Balúr,thrall,959,shaman,restoration,24,10,14
Loay,blackrock,959,shaman,restoration,24,10,14
Халльбьерн,howling-fjord,959,shaman,restoration,24,10,14
Tsugu,kazzak,959,shaman,restoration,30,10,20
Orcgasm,draenor,959,shaman,restoration,30,10,20
Páracetamol,blackmoore,958,shaman,restoration,18,10,8
Shamanistick,grim-batol,958,shaman,restoration,18,10,8
Jilyu,blackmoore,958,shaman,restoration,18,10,8
Arîya,blackrock,958,shaman,restoration,33,11,22
Tinyboiler,stormscale,958,shaman,restoration,30,10,20
Alikir,outland,958,shaman,restoration,30,10,20
Nerdshammyx,tarren-mill,957,shaman,restoration,12,10,2
Hakunax,twisting-nether,957,shaman,restoration,18,10,8
Dewasham,blackmoore,957,shaman,restoration,24,10,14
Stardawg,runetotem,957,shaman,restoration,25,10,15
Mantits,stormscale,956,shaman,restoration,18,10,8
Xentic,kazzak,956,shaman,restoration,24,10,14
Bajslys,kazzak,956,shaman,restoration,24,10,14
Eleir,draenor,956,shaman,restoration,24,10,14
Rotuluss,stormrage,956,shaman,restoration,24,10,14
Drakahaar,burning-blade,956,shaman,restoration,30,10,20
Finula,twisting-nether,955,shaman,restoration,18,10,8
Cølo,ravencrest,955,shaman,restoration,42,10,32
Zulwin,hyjal,954,shaman,restoration,18,10,8
Skeltar,gilneas,954,shaman,restoration,233,103,130
Сорнинай,soulflayer,954,shaman,restoration,101,44,57
Shagrax,anubarak,954,shaman,restoration,24,10,14
Aquatusk,twisting-nether,953,shaman,restoration,24,10,14
Myscarface,draenor,953,shaman,restoration,24,10,14
Shockster,sunstrider,952,shaman,restoration,24,11,13
Xadishaman,blackrock,951,shaman,restoration,18,10,8
Rixxa,stormscale,951,shaman,restoration,30,11,19
Shámpain,antonidas,950,shaman,restoration,18,10,8
Mycameltotem,ravencrest,948,shaman,restoration,32,14,18
Deeblu,nemesis,948,shaman,restoration,54,19,35
Exereon,ravencrest,947,shaman,restoration,18,10,8
Similar,the-maelstrom,946,shaman,restoration,30,12,18
Mcdz,blackrock,944,shaman,restoration,92,43,49
Эрэвия,gordunni,939,shaman,restoration,24,13,11
Chokeonme,blackrock,939,shaman,restoration,108,58,50
Shinigamy,kazzak,939,shaman,restoration,97,47,50
Тутулиб,howling-fjord,937,shaman,restoration,42,10,32
Skylá,blackrock,936,shaman,restoration,70,30,40
Brutalxl,tarren-mill,935,shaman,restoration,30,10,20
Дрфэка,soulflayer,934,shaman,restoration,57,18,39
Mìshä,archimonde,932,shaman,restoration,18,10,8
Earthliving,zuljin,931,shaman,restoration,30,10,20
Joniks,stormscale,930,shaman,restoration,90,35,55
Bullvai,dun-morogh,929,shaman,restoration,74,34,40
Elemental,silvermoon,927,shaman,restoration,40,13,27
Shmøn,outland,926,shaman,restoration,20,11,9
Briindead,archimonde,925,shaman,restoration,18,10,8
Schamhaarion,malfurion,924,shaman,restoration,16,11,5
Broner,ravencrest,922,shaman,restoration,124,63,61
Vitraanc,kazzak,920,shaman,restoration,24,10,14
Yàra,throkferoth,918,shaman,restoration,112,56,56
Asashi,blackhand,917,shaman,restoration,23,12,11
Poglavica,dragonmaw,917,shaman,restoration,35,10,25
Dasce,sylvanas,916,shaman,restoration,42,16,26
Thym,argent-dawn,913,shaman,restoration,177,74,103
Ntø,ravencrest,912,shaman,restoration,15,11,4
Imbalainen,draenor,910,shaman,restoration,21,11,10
Jabena,draenor,910,shaman,restoration,106,48,58
Brondila,shadowsong,909,shaman,restoration,21,10,11
Wagaluu,ravencrest,908,shaman,restoration,23,10,13
Yeháw,kazzak,906,shaman,restoration,16,12,4
Rooske,draenor,904,shaman,restoration,17,10,7
Kircos,blackrock,904,shaman,restoration,27,11,16
Suculenta,zuljin,902,shaman,restoration,47,22,25
Ninfómano,sanguino,901,shaman,restoration,36,10,26
Georgianaa,skullcrusher,900,shaman,restoration,84,40,44
Büffler,thrall,900,shaman,restoration,55,21,34
Nexolok,alleria,899,shaman,restoration,60,32,28
Алимика,deathguard,899,shaman,restoration,30,15,15
Thunderberg,antonidas,896,shaman,restoration,30,12,18
Notlinus,argent-dawn,895,shaman,restoration,14,10,4
Derbedigger,blackmoore,895,shaman,restoration,21,11,10
Shamvandamme,kazzak,895,shaman,restoration,38,16,22
Мке,howling-fjord,894,shaman,restoration,35,14,21
Ухмылк,azuregos,892,shaman,restoration,201,106,95
Varion,tichondrius,888,shaman,restoration,30,12,18
Rageasha,silvermoon,887,shaman,restoration,48,25,23
Ominouslove,twisting-nether,887,shaman,restoration,113,52,61
Vukroth,argent-dawn,879,shaman,restoration,72,34,38
Hañìaránì,draenor,877,shaman,restoration,15,11,4
Shàwyn,sylvanas,876,shaman,restoration,23,10,13
Fashess,sunstrider,875,shaman,restoration,18,10,8
Zeidek,nemesis,873,shaman,restoration,84,43,41
Boombaalasch,blackmoore,870,shaman,restoration,76,32,44
Gerlo,thrall,868,shaman,restoration,36,15,21
Demelena,silvermoon,865,shaman,restoration,284,145,139
Kilnius,archimonde,864,shaman,restoration,12,9,3
Coldain,zuljin,864,shaman,restoration,12,9,3
Shiliwhip,the-maelstrom,864,shaman,restoration,12,9,3
Enviø,sylvanas,864,shaman,restoration,12,9,3
Zergonk,twisting-nether,864,shaman,restoration,18,9,9
Shounx,hyjal,864,shaman,restoration,18,9,9
Феанорситх,gordunni,864,shaman,restoration,18,9,9
Raintlordx,twisting-nether,864,shaman,restoration,18,9,9
Tebzs,ravencrest,864,shaman,restoration,18,9,9
Defonceboby,archimonde,864,shaman,restoration,18,9,9
Metamorflord,ravencrest,864,shaman,restoration,18,9,9
Oningodx,drakthul,864,shaman,restoration,24,9,15
Drakamaa,ravencrest,864,shaman,restoration,24,9,15
Gorrissen,sylvanas,863,shaman,restoration,12,9,3
Nanetvåsanai,jaedenar,863,shaman,restoration,12,9,3
Isaiahjonesx,stormscale,863,shaman,restoration,12,9,3
Vladimitch,chogall,863,shaman,restoration,12,9,3
Nùggets,garona,863,shaman,restoration,18,9,9
Yrikame,dun-modr,863,shaman,restoration,18,9,9
Bobaléh,ravencrest,863,shaman,restoration,18,9,9
Fupx,the-maelstrom,863,shaman,restoration,18,9,9
Давняя,grom,863,shaman,restoration,18,9,9
Schludri,kult-der-verdammten,863,shaman,restoration,18,9,9
Evííl,tarren-mill,863,shaman,restoration,24,9,15
Thanasiss,kazzak,863,shaman,restoration,24,9,15
Zyphiz,twisting-nether,863,shaman,restoration,24,9,15
Ruffin,stormscale,863,shaman,restoration,24,9,15
Loktarogar,sunstrider,863,shaman,restoration,24,9,15
Naphe,ysondre,863,shaman,restoration,30,9,21
Mauî,twisting-nether,863,shaman,restoration,30,9,21
Spammail,argent-dawn,862,shaman,restoration,12,9,3
Бронепароход,soulflayer,862,shaman,restoration,12,9,3
Frecky,blackhand,862,shaman,restoration,12,9,3
Aredin,ysera,862,shaman,restoration,12,9,3
Ïllïïllïï,shadowsong,862,shaman,restoration,18,9,9
Электро,thermaplugg,862,shaman,restoration,18,9,9
Алтезка,blackscar,862,shaman,restoration,18,9,9
Slasket,bloodscalp,862,shaman,restoration,24,9,15
Yánux,aegwynn,861,shaman,restoration,12,9,3
Эндипёсель,ashenvale,861,shaman,restoration,12,9,3
Shamanopaf,tarren-mill,861,shaman,restoration,18,9,9
Matsudah,ragnaros,861,shaman,restoration,18,9,9
Boljin,conseil-des-ombres,861,shaman,restoration,24,9,15
Zippidizap,ulduar,861,shaman,restoration,24,9,15
Amu,ravencrest,860,shaman,restoration,18,9,9
Pomaranc,kazzak,860,shaman,restoration,24,9,15
Cristhor,nemesis,859,shaman,restoration,18,9,9
Zyrou,arthas,859,shaman,restoration,18,9,9
Kosur,kazzak,859,shaman,restoration,18,9,9
Sunsham,illidan,858,shaman,restoration,18,9,9
Fapwap,sylvanas,857,shaman,restoration,18,9,9
Randomshamx,ravencrest,857,shaman,restoration,27,11,16
Bandyy,magtheridon,857,shaman,restoration,24,9,15
Nashashuk,runetotem,856,shaman,restoration,30,9,21
Наладчик,gordunni,855,shaman,restoration,12,9,3
Foringal,thunderhorn,855,shaman,restoration,18,9,9
Gleggy,turalyon,854,shaman,restoration,12,9,3
Moltenblade,drakthul,854,shaman,restoration,12,9,3
Tidors,burning-legion,854,shaman,restoration,18,9,9
Killhorn,malganis,853,shaman,restoration,48,20,28
Karash,twisting-nether,853,shaman,restoration,24,9,15
Turbokrapka,tarren-mill,851,shaman,restoration,18,9,9
Picklechris,tarren-mill,851,shaman,restoration,24,10,14
Notwhoheals,executus,851,shaman,restoration,24,9,15
Psyforce,argent-dawn,850,shaman,restoration,12,9,3
Goldva,outland,850,shaman,restoration,115,58,57
Bubidilasso,twisting-nether,850,shaman,restoration,30,9,21
Aguitas,sanguino,849,shaman,restoration,22,10,12
Deviantsham,tarren-mill,848,shaman,restoration,109,38,71
Турелька,blackscar,846,shaman,restoration,31,11,20
Quigon,burning-legion,844,shaman,restoration,72,34,38
Snublefar,stormscale,843,shaman,restoration,14,11,3
Muhsketier,wrathbringer,843,shaman,restoration,96,37,59
Darkstrong,alakir,842,shaman,restoration,18,9,9
Duodin,defias-brotherhood,839,shaman,restoration,18,9,9
Hyoshin,kirin-tor,839,shaman,restoration,177,75,102
Psychobarbie,outland,835,shaman,restoration,28,12,16
Майайс,gordunni,831,shaman,restoration,17,9,8
Zaelyz,archimonde,831,shaman,restoration,20,10,10
Jeqs,twisting-nether,830,shaman,restoration,14,10,4
Stormzug,twisting-nether,826,shaman,restoration,20,10,10
Xâôs,blackmoore,826,shaman,restoration,24,10,14
Madrävëngodx,ragnaros,826,shaman,restoration,29,9,20
Kebandar,stormscale,825,shaman,restoration,48,20,28
Pfannakuacha,alleria,824,shaman,restoration,14,10,4
Thce,burning-legion,824,shaman,restoration,48,22,26
Foxfyre,tarren-mill,823,shaman,restoration,29,12,17
Hittheswitch,archimonde,822,shaman,restoration,44,10,34
Marranota,cthun,821,shaman,restoration,21,10,11
Killeras,deathwing,819,shaman,restoration,66,29,37
Kuubskii,ravencrest,815,shaman,restoration,17,9,8
Aspên,archimonde,815,shaman,restoration,17,9,8
Bathala,dun-modr,815,shaman,restoration,24,10,14
Télapou,ragnaros,813,shaman,restoration,17,9,8
Шаманчонушка,thermaplugg,810,shaman,restoration,62,24,38
Crixuss,argent-dawn,809,shaman,restoration,17,9,8
Джагрум,greymane,809,shaman,restoration,39,9,30
Bosskwtt,kazzak,808,shaman,restoration,22,10,12
Nonstrum,ragnaros,808,shaman,restoration,23,10,13
Neejtjak,ravencrest,808,shaman,restoration,25,10,15
Greenguard,argent-dawn,806,shaman,restoration,122,44,78
Nøxylol,veklor,805,shaman,restoration,28,10,18
Jojos,eredar,799,shaman,restoration,16,9,7
Avajana,silvermoon,798,shaman,restoration,30,9,21
Läskilehmä,darksorrow,797,shaman,restoration,22,9,13
Prem,turalyon,795,shaman,restoration,119,40,79
Smugleaf,frostmane,793,shaman,restoration,30,9,21
Waskoelement,archimonde,786,shaman,restoration,58,31,27
Penumbrah,kazzak,786,shaman,restoration,224,82,142
Abøriginal,kazzak,783,shaman,restoration,11,9,2
Lillitthya,elune,779,shaman,restoration,80,33,47
Trusthor,kult-der-verdammten,778,shaman,restoration,36,14,22
Zhead,aggramar,775,shaman,restoration,22,11,11
Isìs,norgannon,775,shaman,restoration,198,78,120
Ongedierte,tarren-mill,774,shaman,restoration,18,10,8
Hugzy,argent-dawn,773,shaman,restoration,35,9,26
Ranenmuija,outland,768,shaman,restoration,12,8,4
Leykosh,ravencrest,768,shaman,restoration,12,8,4
Roglam,blackmoore,768,shaman,restoration,12,8,4
Драмкул,soulflayer,768,shaman,restoration,12,8,4
Toteemikylpy,argent-dawn,768,shaman,restoration,12,8,4
Vibesham,outland,768,shaman,restoration,12,8,4
Ivnashaman,drakthul,768,shaman,restoration,12,8,4
Vulthog,draenor,768,shaman,restoration,12,8,4
Alorrii,tarren-mill,768,shaman,restoration,12,8,4
Yacuzwerg,blackrock,768,shaman,restoration,12,8,4
Onrègleçanow,ravencrest,768,shaman,restoration,12,8,4
Vërÿßåðxd,silvermoon,768,shaman,restoration,12,8,4
Stàrzz,eredar,768,shaman,restoration,12,8,4
Экспл,ashenvale,768,shaman,restoration,18,8,10
Tobbey,tarren-mill,768,shaman,restoration,18,8,10
Mèåtbåll,ravencrest,768,shaman,restoration,18,8,10
Djsheargødx,twisting-nether,768,shaman,restoration,18,8,10
Linkxz,sylvanas,768,shaman,restoration,18,8,10
Dosenöffner,gorgonnash,768,shaman,restoration,21,9,12
Wierdo,ragnaros,768,shaman,restoration,29,11,18
Сядьнатотем,gordunni,768,shaman,restoration,24,8,16
Epawl,kazzak,768,shaman,restoration,27,8,19
Pooga,archimonde,768,shaman,restoration,30,8,22
Хъюстэн,gordunni,767,shaman,restoration,12,8,4
Berasham,dalaran,767,shaman,restoration,12,8,4
Magizey,defias-brotherhood,767,shaman,restoration,12,8,4
Karezza,azjolnerub,767,shaman,restoration,12,8,4
Айскримтрак,gordunni,767,shaman,restoration,12,8,4
Mentaldead,draenor,767,shaman,restoration,12,8,4
Brimley,emerald-dream,767,shaman,restoration,12,8,4
Zappyhog,turalyon,767,shaman,restoration,18,8,10
Svarozyc,azuremyst,767,shaman,restoration,18,8,10
Hàrdstûkgødx,uldaman,767,shaman,restoration,18,8,10
Quinlàn,ravencrest,767,shaman,restoration,18,8,10
Inyra,eredar,767,shaman,restoration,18,8,10
Herru,blackrock,767,shaman,restoration,18,8,10
Roycee,ragnaros,767,shaman,restoration,24,8,16
Blauperle,eredar,767,shaman,restoration,30,8,22
Jasishammy,kazzak,766,shaman,restoration,12,8,4
Robbie,dentarg,766,shaman,restoration,12,8,4
Mynutz,outland,766,shaman,restoration,12,8,4
Джоукх,howling-fjord,766,shaman,restoration,12,8,4
Gruggosh,argent-dawn,766,shaman,restoration,12,8,4
Finetime,blackmoore,766,shaman,restoration,12,8,4
Dälon,thrall,766,shaman,restoration,24,8,16
Slytho,blackmoore,766,shaman,restoration,24,8,16
Mvrik,argent-dawn,765,shaman,restoration,18,8,10
Pakasschami,frostwolf,765,shaman,restoration,18,8,10
Indennacken,blackmoore,765,shaman,restoration,24,8,16
Shalisazzar,dentarg,765,shaman,restoration,30,8,22
Tarkxi,sylvanas,764,shaman,restoration,18,8,10
Brandbombe,frostwolf,764,shaman,restoration,18,8,10
Chamasombre,hyjal,764,shaman,restoration,18,8,10
Shamantaa,draenor,764,shaman,restoration,18,8,10
Hurik,sylvanas,764,shaman,restoration,24,8,16
Punjabi,nemesis,764,shaman,restoration,30,8,22
Raphaeey,blackrock,764,shaman,restoration,31,8,23
Eveeöe,outland,763,shaman,restoration,18,8,10
Gundersen,stormscale,763,shaman,restoration,18,8,10
Eponà,gilneas,763,shaman,restoration,24,8,16
Styllz,uldaman,762,shaman,restoration,30,8,22
Jogabonita,kaelthas,761,shaman,restoration,18,8,10
Eaglhex,silvermoon,760,shaman,restoration,24,8,16
Teoaka,haomarush,756,shaman,restoration,42,14,28
Bolski,stormreaver,755,shaman,restoration,24,8,16
Доргорн,grom,754,shaman,restoration,17,9,8
Záppie,nagrand,753,shaman,restoration,31,17,14
Thrallallero,pozzo-delleternità,753,shaman,restoration,18,8,10
Øzy,sanguino,749,shaman,restoration,14,8,6
Amarök,nerzhul,749,shaman,restoration,18,8,10
Prettyhooves,alleria,749,shaman,restoration,59,21,38
Maab,arathor,749,shaman,restoration,23,8,15
Espigas,uldum,746,shaman,restoration,23,8,15
Дарьюша,fordragon,744,shaman,restoration,12,8,4
Jocãsta,silvermoon,735,shaman,restoration,20,9,11
Ayesapik,dalaran,729,shaman,restoration,118,58,60
Katzubushi,pozzo-delleternità,728,shaman,restoration,56,17,39
Jakesmistake,stormscale,727,shaman,restoration,17,11,6
Muntark,thrall,719,shaman,restoration,27,8,19
Агмень,howling-fjord,717,shaman,restoration,39,8,31
Stolen,skullcrusher,712,shaman,restoration,15,9,6
Lauree,terokkar,710,shaman,restoration,23,9,14
Kamichami,sanguino,707,shaman,restoration,27,9,18
Rayitoss,tyrande,707,shaman,restoration,31,9,22
Jodel,tarren-mill,704,shaman,restoration,16,8,8
Карбонатрикс,soulflayer,703,shaman,restoration,16,8,8
Thangog,ragnaros,703,shaman,restoration,16,8,8
Тотемвуман,soulflayer,703,shaman,restoration,22,8,14
Bobmcpleb,kazzak,700,shaman,restoration,20,8,12
Cumulichan,ragnaros,687,shaman,restoration,11,8,3
Damacz,deathwing,684,shaman,restoration,37,9,28
Namestaljka,stormscale,672,shaman,restoration,12,7,5
Skitshamanx,draenor,672,shaman,restoration,12,7,5
Mxi,blackmoore,672,shaman,restoration,12,7,5
Iamshamon,kazzak,672,shaman,restoration,12,7,5
Эксициум,soulflayer,672,shaman,restoration,12,7,5
Blackbeardxd,stormscale,672,shaman,restoration,12,7,5
Popopopopor,archimonde,672,shaman,restoration,12,7,5
Тимтярра,gordunni,672,shaman,restoration,12,7,5
Vaîjîn,aegwynn,672,shaman,restoration,12,7,5
Qicholardon,archimonde,672,shaman,restoration,12,7,5
Drahka,kazzak,672,shaman,restoration,12,7,5
Lêêmo,outland,672,shaman,restoration,12,7,5
Goldou,archimonde,672,shaman,restoration,12,7,5
Banmagic,hyjal,672,shaman,restoration,12,7,5
Grapetokruml,blackmoore,672,shaman,restoration,12,7,5
Spiritbreak,kazzak,672,shaman,restoration,12,7,5
Dorxt,chogall,672,shaman,restoration,12,7,5
Shonbelly,argent-dawn,672,shaman,restoration,12,7,5
Prepegahex,blackmoore,672,shaman,restoration,12,7,5
Vann,the-shatar,672,shaman,restoration,12,7,5
Tracademics,stormscale,672,shaman,restoration,12,7,5
Hagridheals,silvermoon,672,shaman,restoration,12,7,5
Natblidaa,silvermoon,672,shaman,restoration,12,7,5
Nezug,ysondre,672,shaman,restoration,12,7,5
Winshear,twisting-nether,672,shaman,restoration,12,7,5
Nansmasher,draenor,672,shaman,restoration,12,7,5
Sümsük,twisting-nether,672,shaman,restoration,12,7,5
Spiirit,tarren-mill,672,shaman,restoration,12,7,5
Tjocknacke,tarren-mill,672,shaman,restoration,12,7,5
Raiden,aegwynn,672,shaman,restoration,18,7,11
Weandras,draenor,672,shaman,restoration,18,7,11
Sháme,azjolnerub,672,shaman,restoration,18,7,11
Horkxina,frostmourne,672,shaman,restoration,18,7,11
Mílénâqt,aegwynn,672,shaman,restoration,18,7,11
Reinssay,ysondre,672,shaman,restoration,18,7,11
Idroptotems,drakthul,672,shaman,restoration,18,7,11
Крэйвхх,howling-fjord,672,shaman,restoration,18,7,11
Nosno,ravencrest,672,shaman,restoration,18,7,11
Kimsshaman,ragnaros,672,shaman,restoration,18,7,11
Rompich,culte-de-la-rive-noire,672,shaman,restoration,18,7,11
Glasha,ragnaros,672,shaman,restoration,18,7,11
Zulylol,outland,672,shaman,restoration,18,7,11
Agrok,jaedenar,672,shaman,restoration,18,7,11
Канамаш,borean-tundra,672,shaman,restoration,18,7,11
Horcsog,ravencrest,672,shaman,restoration,18,7,11
Çøynx,aegwynn,672,shaman,restoration,20,7,13
Theodorix,silvermoon,672,shaman,restoration,24,7,17
Totemchief,stormscale,672,shaman,restoration,24,7,17
Moschamane,blackrock,672,shaman,restoration,24,7,17
Cragouz,archimonde,672,shaman,restoration,24,7,17
Insînîus,archimonde,672,shaman,restoration,30,7,23
Starpior,stormscale,672,shaman,restoration,30,7,23
Sshrredderr,the-maelstrom,671,shaman,restoration,12,7,5
Ayusham,ravencrest,671,shaman,restoration,12,7,5
Lorifah,draenor,671,shaman,restoration,12,7,5
Frozenshield,ravencrest,671,shaman,restoration,12,7,5
Grosgourdin,la-croisade-écarlate,671,shaman,restoration,12,7,5
Restocow,thrall,671,shaman,restoration,12,7,5
Healhooper,hyjal,671,shaman,restoration,12,7,5
Bbc,dalaran,671,shaman,restoration,12,7,5
Gimzx,magtheridon,671,shaman,restoration,12,7,5
Brocksamson,dentarg,671,shaman,restoration,14,7,7
Rasajin,blackmoore,671,shaman,restoration,18,7,11
Deadshammyx,ravencrest,671,shaman,restoration,18,7,11
Shâdôwlîght,antonidas,671,shaman,restoration,18,7,11
Jedsham,stormscale,671,shaman,restoration,18,7,11
Nïshä,twisting-nether,671,shaman,restoration,18,7,11
Элементаликс,ashenvale,671,shaman,restoration,18,7,11
Дикрус,gordunni,671,shaman,restoration,18,7,11
Rampenissen,azjolnerub,671,shaman,restoration,18,7,11
Skullføck,argent-dawn,671,shaman,restoration,21,8,13
Eaglesteaam,silvermoon,671,shaman,restoration,20,7,13
Dreadness,runetotem,671,shaman,restoration,24,7,17
Lamarrus,malganis,671,shaman,restoration,24,7,17
Unleashme,sylvanas,671,shaman,restoration,24,7,17
Deevill,grim-batol,671,shaman,restoration,24,7,17
Mòónz,kazzak,671,shaman,restoration,24,7,17
Bjorhuk,ravencrest,670,shaman,restoration,12,7,5
Shamsrag,draenor,670,shaman,restoration,12,7,5
Стамма,borean-tundra,670,shaman,restoration,12,7,5
Gorod,confrérie-du-thorium,670,shaman,restoration,12,7,5
Jollyhip,stormscale,670,shaman,restoration,12,7,5
Инкарнатор,deathguard,670,shaman,restoration,12,7,5
Plùx,antonidas,670,shaman,restoration,12,7,5
Totemeistér,silvermoon,670,shaman,restoration,12,7,5
Schamike,tichondrius,670,shaman,restoration,18,7,11
Vey,hyjal,670,shaman,restoration,18,7,11
Irachal,rexxar,670,shaman,restoration,18,7,11
Lokkum,blackhand,670,shaman,restoration,18,7,11
Nonie,arthas,670,shaman,restoration,18,7,11
Archsha,burning-legion,670,shaman,restoration,18,7,11
Lxâ,hyjal,670,shaman,restoration,24,7,17
Aluweckerl,eredar,670,shaman,restoration,24,7,17
Kinxold,blackrock,669,shaman,restoration,12,7,5
Nevertilt,argent-dawn,669,shaman,restoration,12,7,5
Simph,uldum,669,shaman,restoration,24,7,17
Dantheshaman,draenor,669,shaman,restoration,30,7,23
Nynuken,silvermoon,669,shaman,restoration,30,7,23
Gelaende,thrall,668,shaman,restoration,18,7,11
Raikage,elune,668,shaman,restoration,18,7,11
Bloggurt,tarren-mill,668,shaman,restoration,18,7,11
Sorontar,twisting-nether,668,shaman,restoration,18,7,11
Weho,kazzak,668,shaman,restoration,18,7,11
Iebaznis,draenor,667,shaman,restoration,12,7,5
Millacki,blackrock,667,shaman,restoration,18,7,11
Qoshi,archimonde,667,shaman,restoration,18,7,11
Mørwayn,ysondre,667,shaman,restoration,24,7,17
Zelgore,frostwhisper,666,shaman,restoration,18,7,11
Frosthamer,ragnaros,665,shaman,restoration,12,7,5
Darthshox,outland,665,shaman,restoration,22,8,14
Ftsckpower,blackhand,665,shaman,restoration,24,7,17
Windvortex,nemesis,664,shaman,restoration,12,7,5
Emansh,twisting-nether,664,shaman,restoration,24,7,17
Barean,ravencrest,664,shaman,restoration,24,7,17
Raketenrieke,blackrock,659,shaman,restoration,25,12,13
Bogmagnus,the-maelstrom,659,shaman,restoration,39,13,26
Draredemolen,archimonde,655,shaman,restoration,17,7,10
Hulkogank,marécage-de-zangar,653,shaman,restoration,18,7,11
Lausimhaus,blackrock,649,shaman,restoration,22,10,12
Darkwaters,archimonde,639,shaman,restoration,17,7,10
Arcura,twisting-nether,638,shaman,restoration,17,7,10
Nojiko,blackrock,638,shaman,restoration,17,7,10
Mortret,jaedenar,638,shaman,restoration,28,7,21
Hanumanas,kazzak,636,shaman,restoration,20,8,12
Drakhrar,pozzo-delleternità,633,shaman,restoration,14,8,6
Habibe,the-maelstrom,623,shaman,restoration,15,8,7
Basz,aegwynn,623,shaman,restoration,17,7,10
Енотикусь,soulflayer,618,shaman,restoration,12,8,4
Disharmony,outland,618,shaman,restoration,12,8,4
Chîllkrötè,blackmoore,618,shaman,restoration,12,8,4
Cgjúng,ravencrest,618,shaman,restoration,16,8,8
Randomuwu,stormscale,616,shaman,restoration,22,8,14
Elesmelly,draenor,608,shaman,restoration,19,8,11
Sakulis,ravencrest,607,shaman,restoration,20,7,13
Zugars,aszune,606,shaman,restoration,11,7,4
Couldar,stormscale,606,shaman,restoration,19,7,12
Bullthunder,alakir,601,shaman,restoration,20,7,13
Whaowhao,nemesis,600,shaman,restoration,16,7,9
Nacenty,eredar,587,shaman,restoration,13,7,6
Imdarat,hyjal,576,shaman,restoration,6,6,0
Lerra,zirkel-des-cenarius,576,shaman,restoration,6,6,0
Øxxgødx,blackrock,576,shaman,restoration,6,6,0
Сквиртолог,borean-tundra,576,shaman,restoration,6,6,0
Djalx,kazzak,576,shaman,restoration,6,6,0
Lazarevich,thrall,576,shaman,restoration,6,6,0
Oldveteran,eredar,576,shaman,restoration,6,6,0
Karthak,malganis,576,shaman,restoration,12,6,6
Hamgroof,blackrock,576,shaman,restoration,12,6,6
Чиллаут,howling-fjord,576,shaman,restoration,12,6,6
Bigdaddyxo,tarren-mill,576,shaman,restoration,12,6,6
Cardeâ,blackhand,576,shaman,restoration,12,6,6
Chamanox,dalaran,576,shaman,restoration,12,6,6
Greenone,stormscale,576,shaman,restoration,12,6,6
Tusseladden,tarren-mill,576,shaman,restoration,12,6,6
Akainu,nazjatar,576,shaman,restoration,12,6,6
Grathril,aegwynn,576,shaman,restoration,12,6,6
Wckdz,chants-éternels,576,shaman,restoration,12,6,6
Chudygôdx,drakthul,576,shaman,restoration,12,6,6
Povecategla,grim-batol,576,shaman,restoration,12,6,6
Groquick,dalaran,576,shaman,restoration,12,6,6
Juicyy,ravencrest,576,shaman,restoration,12,6,6
Totemlover,draenor,576,shaman,restoration,12,6,6
Contraire,blackrock,576,shaman,restoration,12,6,6
Homsin,stormscale,576,shaman,restoration,12,6,6
Cutzeh,archimonde,576,shaman,restoration,12,6,6
Lmnn,ravencrest,576,shaman,restoration,12,6,6
Kilninshape,archimonde,576,shaman,restoration,12,6,6
Embodiment,blackrock,576,shaman,restoration,12,6,6
Oroastbeef,archimonde,576,shaman,restoration,12,6,6
Runbrorun,hyjal,576,shaman,restoration,12,6,6
Sáàd,ravencrest,576,shaman,restoration,12,6,6
Goodevening,tarren-mill,576,shaman,restoration,12,6,6
Penatus,outland,576,shaman,restoration,12,6,6
Sunnyisup,sylvanas,576,shaman,restoration,12,6,6
Khidon,silvermoon,576,shaman,restoration,12,6,6
Thatstheswag,blackmoore,576,shaman,restoration,12,6,6
Занзазз,ashenvale,576,shaman,restoration,12,6,6
Kaluna,outland,576,shaman,restoration,12,6,6
Hablibubli,kazzak,576,shaman,restoration,12,6,6
Lortihalsen,outland,576,shaman,restoration,12,6,6
Neverqueue,defias-brotherhood,576,shaman,restoration,12,6,6
Холинкаалло,deathguard,576,shaman,restoration,12,6,6
Rhêz,kazzak,576,shaman,restoration,12,6,6
Хоупосх,gordunni,576,shaman,restoration,12,6,6
Gamixyx,magtheridon,576,shaman,restoration,12,6,6
Gamixy,magtheridon,576,shaman,restoration,12,6,6
Enoughh,the-maelstrom,576,shaman,restoration,12,6,6
Ambuu,kazzak,576,shaman,restoration,12,6,6
Артэкриошам,soulflayer,576,shaman,restoration,12,6,6
Lågertha,sanguino,576,shaman,restoration,12,6,6
Kameltotem,balnazzar,576,shaman,restoration,12,6,6
Lifestorm,hyjal,576,shaman,restoration,18,6,12
Hogmodig,tarren-mill,576,shaman,restoration,18,6,12
Maybeyes,twisting-nether,576,shaman,restoration,18,6,12
Diffrinity,tarren-mill,576,shaman,restoration,18,6,12
Reallygdnewb,silvermoon,576,shaman,restoration,18,6,12
Kioterasham,conseil-des-ombres,576,shaman,restoration,18,6,12
Mëowth,ragnaros,576,shaman,restoration,18,6,12
Птеросшам,howling-fjord,576,shaman,restoration,18,6,12
Soyun,frostwhisper,576,shaman,restoration,18,6,12
Embèr,silvermoon,576,shaman,restoration,18,6,12
Happyjuice,silvermoon,576,shaman,restoration,18,6,12
Salaithen,alakir,576,shaman,restoration,18,6,12
Shoar,twisting-nether,576,shaman,restoration,18,6,12
Joeashock,ragnaros,576,shaman,restoration,18,6,12
Yolzan,kazzak,576,shaman,restoration,18,6,12
Patsham,wildhammer,576,shaman,restoration,18,6,12
Flùffy,nemesis,576,shaman,restoration,18,6,12
Женяшилдх,howling-fjord,575,shaman,restoration,6,6,0
Хардринк,gordunni,575,shaman,restoration,12,6,6
Karlsensham,stormscale,575,shaman,restoration,12,6,6
Bufi,sanguino,575,shaman,restoration,12,6,6
Draugrinns,tarren-mill,575,shaman,restoration,12,6,6
Безрукан,howling-fjord,575,shaman,restoration,12,6,6
Sikro,frostwolf,575,shaman,restoration,12,6,6
Nannook,twisting-nether,575,shaman,restoration,12,6,6
Qona,emerald-dream,575,shaman,restoration,12,6,6
Sjearthen,defias-brotherhood,575,shaman,restoration,12,6,6
Ghoraddu,drakthul,575,shaman,restoration,12,6,6
Shazefin,twisting-nether,575,shaman,restoration,12,6,6
Grytha,argent-dawn,575,shaman,restoration,12,6,6
Flurpz,outland,575,shaman,restoration,12,6,6
Vascodagama,twisting-nether,575,shaman,restoration,12,6,6
Mortly,draenor,575,shaman,restoration,12,6,6
Hyamala,chamber-of-aspects,575,shaman,restoration,12,6,6
Fatyoe,eredar,575,shaman,restoration,12,6,6
Sonii,outland,575,shaman,restoration,15,7,8
Aesonis,kazzak,575,shaman,restoration,14,6,8
Ascìughino,nemesis,575,shaman,restoration,18,6,12
Liferqt,nemesis,575,shaman,restoration,18,6,12
Bruzzla,kiljaeden,575,shaman,restoration,18,6,12
Celphboss,draenor,575,shaman,restoration,18,6,12
Hexyladý,ravencrest,575,shaman,restoration,18,6,12
Kandrox,blackmoore,575,shaman,restoration,18,6,12
Wtbtoes,ravencrest,575,shaman,restoration,24,6,18
Archiviert,blackmoore,575,shaman,restoration,24,6,18
Bepinfame,pozzo-delleternità,575,shaman,restoration,30,6,24
Tidushears,thrall,574,shaman,restoration,12,6,6
Bacca,stormscale,574,shaman,restoration,18,6,12
Musii,argent-dawn,574,shaman,restoration,18,6,12
Elemsegara,arakarahm,574,shaman,restoration,24,6,18
Андеритс,gordunni,574,shaman,restoration,24,6,18
Vilfin,ysondre,573,shaman,restoration,12,6,6
Dobbi,dethecus,573,shaman,restoration,12,6,6
Muschi,culte-de-la-rive-noire,573,shaman,restoration,16,7,9
Amnistia,ragnaros,573,shaman,restoration,18,6,12
Omnivamp,kazzak,573,shaman,restoration,18,6,12
Róbbàn,agamaggan,573,shaman,restoration,18,6,12
Shammzy,mannoroth,573,shaman,restoration,24,6,18
Nisity,draenor,572,shaman,restoration,12,6,6
Seor,kazzak,572,shaman,restoration,18,6,12
Drizzird,argent-dawn,572,shaman,restoration,18,6,12
Veita,sylvanas,571,shaman,restoration,12,6,6
Geishablue,defias-brotherhood,570,shaman,restoration,18,6,12
Alïsyo,nemesis,570,shaman,restoration,18,6,12
Southpaw,kult-der-verdammten,569,shaman,restoration,18,6,12
Enco,kilrogg,568,shaman,restoration,12,6,6
Bunnîe,kazzak,565,shaman,restoration,18,6,12
Triplezug,archimonde,558,shaman,restoration,11,6,5
Fessel,auchindoun,558,shaman,restoration,18,6,12
Durek,sylvanas,551,shaman,restoration,19,8,11
Грейсаша,howling-fjord,545,shaman,restoration,26,9,17
Professorzap,silvermoon,544,shaman,restoration,10,7,3
Divazena,drakthul,542,shaman,restoration,11,6,5
Bierfrisch,ravencrest,542,shaman,restoration,17,6,11
Cotêaz,thrall,541,shaman,restoration,16,6,10
Gq,auchindoun,541,shaman,restoration,17,6,11
Ghafo,norgannon,540,shaman,restoration,11,6,5
Glóbal,sylvanas,528,shaman,restoration,9,7,2
Zourhia,garona,528,shaman,restoration,9,6,3
Whibbler,ravencrest,528,shaman,restoration,21,7,14
Myndro,varimathras,527,shaman,restoration,11,6,5
Nockedly,ragnaros,527,shaman,restoration,21,7,14
Surund,die-nachtwache,526,shaman,restoration,15,6,9
Splis,ravencrest,522,shaman,restoration,16,7,9
Corlysvelary,doomhammer,521,shaman,restoration,26,8,18
Asstroy,sanguino,520,shaman,restoration,16,7,9
Luckybeast,ravencrest,515,shaman,restoration,20,7,13
Purgeer,blackmoore,511,shaman,restoration,11,6,5
Shammster,drakthul,511,shaman,restoration,16,6,10
Ozzlac,thrall,511,shaman,restoration,17,6,11
Shamsteaks,thrall,480,shaman,restoration,6,5,1
Kookaboo,blackrock,480,shaman,restoration,6,5,1
Ub,garona,480,shaman,restoration,6,5,1
Myloxxtwo,outland,480,shaman,restoration,6,5,1
Qwauzinator,silvermoon,480,shaman,restoration,6,5,1
Joeexotictv,tarren-mill,480,shaman,restoration,6,5,1
Dastarus,archimonde,480,shaman,restoration,6,5,1
Nøfap,kazzak,480,shaman,restoration,6,5,1
Vønhørk,dalaran,480,shaman,restoration,6,5,1
Êvø,draenor,480,shaman,restoration,6,5,1
Keiro,burning-blade,480,shaman,restoration,6,5,1
Pierredollar,outland,480,shaman,restoration,6,5,1
Kontza,argent-dawn,480,shaman,restoration,6,5,1
Souldicer,twilights-hammer,480,shaman,restoration,6,5,1
Pissflinger,tarren-mill,480,shaman,restoration,6,5,1
Fenixshaman,die-aldor,480,shaman,restoration,9,6,3
Aslansütü,eredar,480,shaman,restoration,12,5,7
Kïtten,tarren-mill,480,shaman,restoration,12,5,7
Cynmaticsx,kargath,480,shaman,restoration,12,5,7
Vyrá,onyxia,480,shaman,restoration,12,5,7
Boltar,die-aldor,480,shaman,restoration,12,5,7
Markboymint,earthen-ring,480,shaman,restoration,12,5,7
Ørøçhý,outland,480,shaman,restoration,12,5,7
Okrall,twisting-nether,480,shaman,restoration,12,5,7
Egor,alakir,480,shaman,restoration,12,5,7
Tigo,tarren-mill,480,shaman,restoration,12,5,7
Athankatouch,draenor,480,shaman,restoration,12,5,7
Ravenshock,bloodfeather,480,shaman,restoration,12,5,7
Mbx,ravencrest,480,shaman,restoration,12,5,7
Søljar,draenor,480,shaman,restoration,12,5,7
Kuisix,sanguino,480,shaman,restoration,12,5,7
Qishwilu,ravencrest,480,shaman,restoration,12,5,7
Lontarsdaddy,twisting-nether,480,shaman,restoration,12,5,7
Kempfer,blackrock,480,shaman,restoration,12,5,7
Burrowabuser,nemesis,480,shaman,restoration,12,5,7
Uanl,stormscale,480,shaman,restoration,12,5,7
Tzhads,stormscale,480,shaman,restoration,12,5,7
Maïtregïms,archimonde,480,shaman,restoration,12,5,7
Ñx,ravencrest,480,shaman,restoration,12,5,7
Swark,stormscale,480,shaman,restoration,12,5,7
Nerowinger,stormscale,480,shaman,restoration,12,5,7
Libano,archimonde,480,shaman,restoration,12,5,7
Tooltip,tarren-mill,480,shaman,restoration,12,5,7
Totemiclol,aegwynn,480,shaman,restoration,12,5,7
Shamania,grim-batol,480,shaman,restoration,12,5,7
Riptidegodx,archimonde,480,shaman,restoration,12,5,7
Demeri,blackrock,480,shaman,restoration,12,5,7
Medistød,draenor,480,shaman,restoration,12,5,7
Саулос,howling-fjord,480,shaman,restoration,12,5,7
Bruvling,stormscale,480,shaman,restoration,12,5,7
Eggshock,ravencrest,480,shaman,restoration,12,5,7
Trolldy,outland,480,shaman,restoration,12,5,7
Stibs,silvermoon,480,shaman,restoration,12,5,7
Sojee,ysondre,480,shaman,restoration,12,5,7
Roastbeef,blackrock,480,shaman,restoration,12,5,7
Shamarco,nemesis,480,shaman,restoration,12,5,7
Thiazar,hyjal,480,shaman,restoration,12,5,7
Jakeir,auchindoun,480,shaman,restoration,12,5,7
Bloopp,stormscale,480,shaman,restoration,12,5,7
Sliiderr,draenor,480,shaman,restoration,12,5,7
Zougzy,uldaman,480,shaman,restoration,12,5,7
Jeffreyson,burning-legion,480,shaman,restoration,12,5,7
Hesitant,kazzak,480,shaman,restoration,12,5,7
Biçi,steamwheedle-cartel,480,shaman,restoration,12,5,7
Zæus,ragnaros,480,shaman,restoration,12,5,7
Thyeori,stormscale,480,shaman,restoration,12,5,7
Pesantë,silvermoon,480,shaman,restoration,12,5,7
Meeredia,aegwynn,480,shaman,restoration,12,5,7
Nevagonalink,archimonde,480,shaman,restoration,12,5,7
Daboo,the-venture-co,480,shaman,restoration,12,5,7
Бьерн,deepholm,480,shaman,restoration,12,5,7
Windie,drakthul,480,shaman,restoration,12,5,7
Ræi,drakthul,480,shaman,restoration,12,5,7
Hexftw,khaz-modan,480,shaman,restoration,12,5,7
Ulumulu,frostwolf,480,shaman,restoration,14,5,9
Peremptor,alleria,480,shaman,restoration,18,5,13
Elementalwiz,ravencrest,480,shaman,restoration,18,5,13
Aùrn,sylvanas,480,shaman,restoration,18,5,13
Swart,hyjal,480,shaman,restoration,18,5,13
Кенниарт,howling-fjord,480,shaman,restoration,18,5,13
Kjumbe,silvermoon,480,shaman,restoration,18,5,13
Ghanex,tarren-mill,480,shaman,restoration,18,5,13
ßiggie,garona,480,shaman,restoration,18,5,13
Krayton,tarren-mill,480,shaman,restoration,18,5,13
Elepumper,outland,480,shaman,restoration,18,5,13
Селфлессх,soulflayer,480,shaman,restoration,18,5,13
Bruho,mazrigos,480,shaman,restoration,18,5,13
Korfenal,draenor,480,shaman,restoration,18,5,13
Faìnt,stormscale,480,shaman,restoration,18,5,13
Gurtøg,ysondre,480,shaman,restoration,20,5,15
Nêgan,ravencrest,480,shaman,restoration,22,5,17
Peaksh,stormscale,480,shaman,restoration,24,5,19
Savan,darkspear,480,shaman,restoration,24,5,19
Gwûn,outland,479,shaman,restoration,10,6,4
Caters,baelgun,479,shaman,restoration,12,5,7
Hydrototem,archimonde,479,shaman,restoration,12,5,7
Schamibeton,antonidas,479,shaman,restoration,12,5,7
Babyshamy,kazzak,479,shaman,restoration,12,5,7
Donnerbubele,aegwynn,479,shaman,restoration,12,5,7
Happyfart,thrall,479,shaman,restoration,12,5,7
Joaléine,khaz-modan,479,shaman,restoration,12,5,7
Sakar,auchindoun,479,shaman,restoration,12,5,7
Babyboomz,bronze-dragonflight,479,shaman,restoration,12,5,7
Bloodfist,drakthul,479,shaman,restoration,12,5,7
Kyousek,drakthul,479,shaman,restoration,12,5,7
Scoobsz,thrall,479,shaman,restoration,15,5,10
Íss,cthun,479,shaman,restoration,18,5,13
Gepetto,tarren-mill,479,shaman,restoration,18,5,13
Autarky,silvermoon,479,shaman,restoration,18,5,13
Zogthor,hyjal,479,shaman,restoration,24,5,19
Дбр,howling-fjord,479,shaman,restoration,26,5,21
Louvreparis,frostwolf,478,shaman,restoration,6,5,1
Deimyan,tarren-mill,478,shaman,restoration,12,5,7
Rebekca,twisting-nether,478,shaman,restoration,18,5,13
Erscreamiko,zuljin,477,shaman,restoration,24,5,19
Зултира,gordunni,477,shaman,restoration,30,5,25
Porch,doomhammer,476,shaman,restoration,12,5,7
Халн,greymane,476,shaman,restoration,12,5,7
Wanryoku,kaelthas,472,shaman,restoration,12,5,7
Chimp,lightnings-blade,467,shaman,restoration,19,9,10
Shamanarama,sylvanas,463,shaman,restoration,23,5,18
Tøøpåc,hyjal,462,shaman,restoration,13,6,7
Heothix,outland,447,shaman,restoration,11,5,6
Shinäla,twisting-nether,447,shaman,restoration,11,5,6
Marcöø,argent-dawn,447,shaman,restoration,16,6,10
Iast,frostwolf,447,shaman,restoration,14,5,9
Diapasøn,kaelthas,446,shaman,restoration,17,5,12
Zysham,silvermoon,445,shaman,restoration,11,5,6
Kortgat,kilrogg,431,shaman,restoration,17,5,12
Shamakerr,tarren-mill,426,shaman,restoration,17,7,10
Äppelpaj,earthen-ring,426,shaman,restoration,15,6,9
Блэкмаршал,howling-fjord,423,shaman,restoration,20,6,14
Ulrichh,twisting-nether,415,shaman,restoration,8,5,3
Etabeta,shattered-hand,415,shaman,restoration,8,5,3
Rosox,blackmoore,415,shaman,restoration,14,5,9
Waterboy,tarren-mill,384,shaman,restoration,6,4,2
Thriveqt,nemesis,384,shaman,restoration,6,4,2
Ravd,outland,384,shaman,restoration,6,4,2
Prup,tarren-mill,384,shaman,restoration,6,4,2
Purgelord,tarren-mill,384,shaman,restoration,6,4,2
Shàyâ,ysondre,384,shaman,restoration,6,4,2
Tairuny,nazjatar,384,shaman,restoration,6,4,2
Yozgatlilan,aegwynn,384,shaman,restoration,6,4,2
Chadhealer,thrall,384,shaman,restoration,6,4,2
Khàlyne,archimonde,384,shaman,restoration,6,4,2
Beefblaster,guldan,384,shaman,restoration,6,4,2
Sozzesham,kazzak,384,shaman,restoration,6,4,2
Showtime,eredar,384,shaman,restoration,6,4,2
Bandulski,twisting-nether,384,shaman,restoration,6,4,2
Dooky,frostwolf,384,shaman,restoration,6,4,2
Пакни,gordunni,384,shaman,restoration,6,4,2
Totemtri,thrall,384,shaman,restoration,6,4,2
Акаи,gordunni,384,shaman,restoration,6,4,2
Konrád,thunderhorn,384,shaman,restoration,6,4,2
Pagnishm,tarren-mill,384,shaman,restoration,6,4,2
Peano,frostwolf,384,shaman,restoration,6,4,2
Imdax,hyjal,384,shaman,restoration,6,4,2
Gapingass,frostmane,384,shaman,restoration,6,4,2
Grimdonut,argent-dawn,384,shaman,restoration,6,4,2
Pàn,alleria,384,shaman,restoration,6,4,2
Boiblaster,argent-dawn,384,shaman,restoration,6,4,2
Vscx,blackmoore,384,shaman,restoration,6,4,2
Bluetide,ravencrest,384,shaman,restoration,6,4,2
Laserra,sylvanas,384,shaman,restoration,6,4,2
Stormjvj,twisting-nether,384,shaman,restoration,6,4,2
Громкеш,howling-fjord,384,shaman,restoration,6,4,2
Фредуизли,howling-fjord,384,shaman,restoration,6,4,2
Shufflenpc,twisting-nether,384,shaman,restoration,6,4,2
Minisham,drakthul,384,shaman,restoration,6,4,2
Hamuksha,nerathor,384,shaman,restoration,6,4,2
Амг,booty-bay,384,shaman,restoration,6,4,2
Mole,jaedenar,384,shaman,restoration,6,4,2
Sinrsizakbil,silvermoon,384,shaman,restoration,6,4,2
Dräpàrn,sylvanas,384,shaman,restoration,6,4,2
Salsissimous,azjolnerub,384,shaman,restoration,6,4,2
Berzærker,ravencrest,384,shaman,restoration,6,4,2
Ысч,ashenvale,384,shaman,restoration,6,4,2
Kundt,dalaran,384,shaman,restoration,6,4,2
Xinsû,kazzak,384,shaman,restoration,6,4,2
Говард,soulflayer,384,shaman,restoration,6,4,2
Chiio,draenor,384,shaman,restoration,6,4,2
Гошатотем,soulflayer,384,shaman,restoration,6,4,2
Johnnysîns,blackhand,384,shaman,restoration,6,4,2
Leyliner,blackhand,384,shaman,restoration,6,4,2
Thrasymachos,silvermoon,384,shaman,restoration,6,4,2
Toasterbread,kazzak,384,shaman,restoration,6,4,2
Рояльстарик,howling-fjord,384,shaman,restoration,9,5,4
Snowflakexsx,draenor,384,shaman,restoration,8,4,4
Pandatrials,turalyon,384,shaman,restoration,22,8,14
Criticalx,eredar,384,shaman,restoration,15,5,10
Degoblin,draenor,384,shaman,restoration,12,4,8
Agatons,twisting-nether,384,shaman,restoration,12,4,8
Mammyshammy,twisting-nether,384,shaman,restoration,12,4,8
Staxoman,daggerspine,384,shaman,restoration,12,4,8
Bubullesham,kirin-tor,384,shaman,restoration,12,4,8
Serasol,sylvanas,384,shaman,restoration,12,4,8
Kuyamii,blackrock,384,shaman,restoration,12,4,8
Saksyl,zuljin,384,shaman,restoration,12,4,8
Tteïl,archimonde,384,shaman,restoration,12,4,8
Enkou,blackmoore,384,shaman,restoration,12,4,8
Runeshock,turalyon,384,shaman,restoration,12,4,8
Terkx,blackmoore,384,shaman,restoration,12,4,8
Aeriis,twisting-nether,384,shaman,restoration,12,4,8
Меготип,deathweaver,384,shaman,restoration,12,4,8
Ishin,burning-legion,384,shaman,restoration,12,4,8
Zídané,antonidas,384,shaman,restoration,12,4,8
Porke,moonglade,384,shaman,restoration,12,4,8
Totemcil,silvermoon,384,shaman,restoration,12,4,8
Mickshagger,aegwynn,384,shaman,restoration,12,4,8
Moosavi,kazzak,384,shaman,restoration,12,4,8
Râpzz,aegwynn,384,shaman,restoration,12,4,8
Tahrox,blackmoore,384,shaman,restoration,12,4,8
Maluch,burning-legion,384,shaman,restoration,12,4,8
Smahamtwo,stormscale,384,shaman,restoration,12,4,8
Lavababe,blackmoore,384,shaman,restoration,12,4,8
Mystraas,khaz-modan,384,shaman,restoration,12,4,8
Shamdren,outland,384,shaman,restoration,12,4,8
Amrik,blackmoore,384,shaman,restoration,12,4,8
Shockingfish,grim-batol,384,shaman,restoration,12,4,8
Девлиниум,fordragon,384,shaman,restoration,12,4,8
Lanze,blackrock,384,shaman,restoration,12,4,8
Gorgath,dunemaul,384,shaman,restoration,12,4,8
Kerfo,ragnaros,384,shaman,restoration,12,4,8
Proccazu,draenor,384,shaman,restoration,12,4,8
Kelonar,aegwynn,384,shaman,restoration,12,4,8
Daklickshamy,blackmoore,384,shaman,restoration,12,4,8
Sempaihentai,draenor,384,shaman,restoration,12,4,8
Энхай,azuregos,384,shaman,restoration,12,4,8
Abdegor,burning-legion,384,shaman,restoration,12,4,8
Ohheck,outland,384,shaman,restoration,18,4,14
Stormreach,ragnaros,384,shaman,restoration,18,4,14
Natsukiko,anubarak,384,shaman,restoration,18,4,14
Taurusham,stormscale,384,shaman,restoration,18,4,14
Narache,defias-brotherhood,384,shaman,restoration,18,4,14
Dartagnón,blackhand,384,shaman,restoration,24,4,20
Djrastasham,stormscale,384,shaman,restoration,30,4,26
Nizty,tarren-mill,384,shaman,restoration,30,4,26
Marnius,ravencrest,383,shaman,restoration,6,4,2
Wioda,silvermoon,383,shaman,restoration,6,4,2
Shamaní,sporeggar,383,shaman,restoration,6,4,2
Ljube,kazzak,383,shaman,restoration,6,4,2
Herdaar,argent-dawn,383,shaman,restoration,12,4,8
Sleyvarian,chamber-of-aspects,383,shaman,restoration,12,4,8
Cisd,tarren-mill,383,shaman,restoration,12,4,8
Arixxë,twisting-nether,383,shaman,restoration,12,4,8
Zokah,emeriss,383,shaman,restoration,12,4,8
Doomkiss,silvermoon,383,shaman,restoration,18,4,14
Илюшамашина,gordunni,383,shaman,restoration,18,4,14
Ulfuz,silvermoon,383,shaman,restoration,24,4,20
Raiñdrops,silvermoon,382,shaman,restoration,6,4,2
Slippyjim,azshara,382,shaman,restoration,12,4,8
Avatarroku,blackhand,382,shaman,restoration,12,4,8
Таск,eversong,382,shaman,restoration,12,4,8
Koko,frostwhisper,382,shaman,restoration,12,4,8
Tiamât,culte-de-la-rive-noire,382,shaman,restoration,18,4,14
Zeiger,minahonda,381,shaman,restoration,24,4,20
Shamtime,aegwynn,371,shaman,restoration,24,7,17
Mikesinatra,tarren-mill,367,shaman,restoration,11,4,7
Pinguman,stormscale,351,shaman,restoration,8,5,3
Triskantza,dun-modr,351,shaman,restoration,17,4,13
Zboubii,archimonde,351,shaman,restoration,17,4,13
Voltyum,zuljin,336,shaman,restoration,9,4,5
Grübxxgg,frostmane,335,shaman,restoration,17,4,13
Antikahraman,blackrock,330,shaman,restoration,8,5,3
Schamimen,malganis,330,shaman,restoration,20,5,15
Fleurnoîr,confrérie-du-thorium,329,shaman,restoration,9,5,4
Thorkaizen,runetotem,319,shaman,restoration,5,4,1
Schamitwo,twisting-nether,319,shaman,restoration,5,4,1
Kévinn,draenor,319,shaman,restoration,8,4,4
Murog,dalaran,319,shaman,restoration,8,4,4
ßreoxxi,blackmoore,319,shaman,restoration,15,4,11
Intèrfectá,aegwynn,288,shaman,restoration,6,3,3
Snakeeyéss,kazzak,288,shaman,restoration,6,3,3
Istedgrill,tarren-mill,288,shaman,restoration,6,3,3
Yarvin,draenor,288,shaman,restoration,6,3,3
Shamamamin,argent-dawn,288,shaman,restoration,6,3,3
Tezeret,silvermoon,288,shaman,restoration,6,3,3
Xzãnti,tarren-mill,288,shaman,restoration,6,3,3
Vulkân,silvermoon,288,shaman,restoration,6,3,3
Vilrath,tarren-mill,288,shaman,restoration,6,3,3
Calamito,ragnaros,288,shaman,restoration,6,3,3
Ironblacka,dun-modr,288,shaman,restoration,6,3,3
Bingo,tarren-mill,288,shaman,restoration,6,3,3
Bharudor,antonidas,288,shaman,restoration,6,3,3
Shohmon,silvermoon,288,shaman,restoration,6,3,3
Tarzh,dalaran,288,shaman,restoration,6,3,3
Trampala,draenor,288,shaman,restoration,6,3,3
Tremorka,ravencrest,288,shaman,restoration,6,3,3
Ticutashaman,argent-dawn,288,shaman,restoration,6,3,3
Chainbeef,blackmoore,288,shaman,restoration,6,3,3
Tenror,ragnaros,288,shaman,restoration,6,3,3
Ýípìÿøû,dun-modr,288,shaman,restoration,6,3,3
Rna,ragnaros,288,shaman,restoration,6,3,3
Kubelwagen,ravencrest,288,shaman,restoration,6,3,3
Totemboyuk,tarren-mill,288,shaman,restoration,6,3,3
Azùk,kazzak,288,shaman,restoration,6,3,3
Downiesham,kazzak,288,shaman,restoration,6,3,3
Abalenn,kazzak,288,shaman,restoration,6,3,3
Richtigfies,kazzak,288,shaman,restoration,6,3,3
Windrate,burning-blade,288,shaman,restoration,6,3,3
Вэллкомм,gordunni,288,shaman,restoration,6,3,3
Ragnesch,aegwynn,288,shaman,restoration,6,3,3
Shockndawe,kazzak,288,shaman,restoration,6,3,3
Whyisitspicy,kazzak,288,shaman,restoration,6,3,3
Soulsh,die-ewige-wacht,288,shaman,restoration,6,3,3
Watchmyshøkz,aegwynn,288,shaman,restoration,6,3,3
Odiin,sanguino,288,shaman,restoration,6,3,3
Surge,darksorrow,288,shaman,restoration,6,3,3
Gemexi,kazzak,288,shaman,restoration,6,3,3
Омегануб,howling-fjord,288,shaman,restoration,6,3,3
Eradasgf,kazzak,288,shaman,restoration,6,3,3
Votie,tarren-mill,288,shaman,restoration,6,3,3
Шабыч,deathguard,288,shaman,restoration,6,3,3
Bûttâ,archimonde,288,shaman,restoration,6,3,3
Cøkka,hyjal,288,shaman,restoration,6,3,3
Ханикс,blackscar,288,shaman,restoration,6,3,3
Lightningrod,ravencrest,288,shaman,restoration,6,3,3
Majinbeb,hyjal,288,shaman,restoration,6,3,3
Shimshám,ravencrest,288,shaman,restoration,6,3,3
Zapyboye,grim-batol,288,shaman,restoration,6,3,3
Origins,archimonde,288,shaman,restoration,6,3,3
Solotov,bronzebeard,288,shaman,restoration,6,3,3
Klösbräda,stormscale,288,shaman,restoration,6,3,3
Видсон,soulflayer,288,shaman,restoration,6,3,3
Misstremmers,outland,288,shaman,restoration,6,3,3
Bronin,sylvanas,288,shaman,restoration,6,3,3
Oldmanrena,stormscale,288,shaman,restoration,6,3,3
Stinkyfînger,draenor,288,shaman,restoration,6,3,3
Statikznba,outland,288,shaman,restoration,6,3,3
Ранкодин,soulflayer,288,shaman,restoration,6,3,3
Blboz,grim-batol,288,shaman,restoration,6,3,3
Nohealtilt,stormscale,288,shaman,restoration,6,3,3
Шамкасамка,gordunni,288,shaman,restoration,6,3,3
Khâlyne,archimonde,288,shaman,restoration,6,3,3
Thaemond,draenor,288,shaman,restoration,6,3,3
Гарантииный,lich-king,288,shaman,restoration,6,3,3
Eré,archimonde,288,shaman,restoration,6,3,3
Xclusivqt,archimonde,288,shaman,restoration,6,3,3
Елемчикх,gordunni,288,shaman,restoration,6,3,3
Rkeev,blackrock,288,shaman,restoration,6,3,3
Haract,outland,288,shaman,restoration,6,3,3
Crazywitcho,archimonde,288,shaman,restoration,6,3,3
Eslu,blackhand,288,shaman,restoration,6,3,3
Аалрия,goldrinn,288,shaman,restoration,6,3,3
Horizons,the-maelstrom,288,shaman,restoration,6,3,3
Wurrzág,outland,288,shaman,restoration,6,3,3
Jäckö,archimonde,288,shaman,restoration,6,3,3
Enzain,outland,288,shaman,restoration,6,3,3
Бриз,blackscar,288,shaman,restoration,6,3,3
Nshamanx,sylvanas,288,shaman,restoration,6,3,3
Моралсидней,blackscar,288,shaman,restoration,6,3,3
Kalinn,sylvanas,288,shaman,restoration,6,3,3
Kimunamatata,draenor,288,shaman,restoration,6,3,3
Shamanshow,eredar,288,shaman,restoration,6,3,3
Dévus,stormscale,288,shaman,restoration,6,3,3
Baconbaus,stormscale,288,shaman,restoration,6,3,3
Høwl,twisting-nether,288,shaman,restoration,7,3,4
Lilmac,defias-brotherhood,288,shaman,restoration,10,4,6
Nemuderune,grim-batol,288,shaman,restoration,8,3,5
Belsazar,frostwolf,288,shaman,restoration,12,3,9
Kraznan,silvermoon,288,shaman,restoration,12,3,9
Muckerg,kazzak,288,shaman,restoration,12,3,9
Myks,sylvanas,288,shaman,restoration,12,3,9
Billburr,aegwynn,288,shaman,restoration,12,3,9
Tropvieux,dalaran,288,shaman,restoration,12,3,9
Flameshock,area-52,288,shaman,restoration,12,3,9
Zronk,blackhand,288,shaman,restoration,12,3,9
Foxhug,kazzak,288,shaman,restoration,12,3,9
Schamanskaya,antonidas,288,shaman,restoration,12,3,9
Carthis,silvermoon,288,shaman,restoration,12,3,9
Scharmany,blackhand,288,shaman,restoration,12,3,9
Shammyenh,burning-legion,288,shaman,restoration,12,3,9
Geifmeat,kazzak,288,shaman,restoration,12,3,9
Magicflames,draenor,288,shaman,restoration,12,3,9
Zamn,silvermoon,288,shaman,restoration,12,3,9
Rennji,argent-dawn,288,shaman,restoration,12,3,9
Sleyter,sanguino,288,shaman,restoration,12,3,9
Mahoni,malganis,288,shaman,restoration,12,3,9
Keb,gorgonnash,288,shaman,restoration,12,3,9
Shamgott,silvermoon,288,shaman,restoration,12,3,9
Ulchabhán,draenor,288,shaman,restoration,12,3,9
Cpthex,draenor,288,shaman,restoration,12,3,9
Бэкдафакапп,blackscar,288,shaman,restoration,12,3,9
Thrallotido,sanguino,288,shaman,restoration,12,3,9
Kuzsham,archimonde,288,shaman,restoration,12,3,9
Abordoga,twisting-nether,288,shaman,restoration,12,3,9
Ðiezz,ysondre,288,shaman,restoration,12,3,9
Kiliathsham,silvermoon,288,shaman,restoration,12,3,9
Nixxy,magtheridon,288,shaman,restoration,12,3,9
Noxl,gorgonnash,288,shaman,restoration,12,3,9
Hagelbrakan,stormscale,288,shaman,restoration,12,3,9
Афтршок,soulflayer,288,shaman,restoration,12,3,9
Huibäm,eredar,288,shaman,restoration,12,3,9
Ríleyx,twisting-nether,288,shaman,restoration,12,3,9
Idropwftotem,twilights-hammer,288,shaman,restoration,12,3,9
Thísisrestø,sanguino,288,shaman,restoration,12,3,9
Thorsteinar,kazzak,288,shaman,restoration,12,3,9
Yukmôuth,stormscale,288,shaman,restoration,13,3,10
Луперккаль,soulflayer,288,shaman,restoration,14,3,11
Haono,khaz-modan,288,shaman,restoration,18,3,15
Dumbasha,ravencrest,288,shaman,restoration,18,3,15
Dontdothat,tarren-mill,288,shaman,restoration,18,3,15
Oggyoggyoggy,outland,288,shaman,restoration,18,3,15
Mitochondria,drakthul,288,shaman,restoration,18,3,15
Shankka,ragnaros,288,shaman,restoration,18,3,15
Shaminista,ravencrest,288,shaman,restoration,24,3,21
Tidecrash,kazzak,287,shaman,restoration,6,3,3
Seam,aggra-português,287,shaman,restoration,6,3,3
Кронакай,blackscar,287,shaman,restoration,12,3,9
Barabáx,blackrock,287,shaman,restoration,18,3,15
Präsi,die-aldor,287,shaman,restoration,18,3,15
Rbghêâl,blackrock,287,shaman,restoration,18,3,15
Leftand,arathor,287,shaman,restoration,18,3,15
Янешаманка,goldrinn,285,shaman,restoration,12,3,9
Mimsy,hyjal,285,shaman,restoration,12,3,9
Dxtreame,outland,276,shaman,restoration,19,6,13
Shâm,kazzak,271,shaman,restoration,11,3,8
Valuriya,blackhand,269,shaman,restoration,11,3,8
Calmlizard,ragnaros,256,shaman,restoration,10,3,7
Localicious,ragnaros,255,shaman,restoration,11,3,8
Crazypurgeqt,arathor,255,shaman,restoration,17,3,14
Yang,der-rat-von-dalaran,240,shaman,restoration,9,4,5
Hâromm,twisting-nether,239,shaman,restoration,5,3,2
Flávy,senjin,239,shaman,restoration,5,3,2
Silden,thrall,234,shaman,restoration,10,5,5
Æxs,archimonde,234,shaman,restoration,8,4,4
Yukîmøn,hyjal,234,shaman,restoration,11,4,7
Guccishadezz,blackmoore,234,shaman,restoration,17,5,12
Ikó,kazzak,234,shaman,restoration,22,6,16
Drøgøs,dun-modr,234,shaman,restoration,18,4,14
Fettbrot,garrosh,232,shaman,restoration,27,4,23
Фарраон,deathguard,192,shaman,restoration,10,4,6
Trillebelly,outland,192,shaman,restoration,6,2,4
Hapkin,defias-brotherhood,192,shaman,restoration,6,2,4
Zneegel,ragnaros,192,shaman,restoration,6,2,4
Skuid,twisting-nether,192,shaman,restoration,6,2,4
Barnameco,outland,192,shaman,restoration,6,2,4
Sanxon,blackrock,192,shaman,restoration,6,2,4
Lexus,nordrassil,192,shaman,restoration,6,2,4
Bavalurst,doomhammer,192,shaman,restoration,6,2,4
Djerba,nordrassil,192,shaman,restoration,6,2,4
Shôcopan,los-errantes,192,shaman,restoration,6,2,4
Doflamingo,aszune,192,shaman,restoration,6,2,4
Wåe,outland,192,shaman,restoration,6,2,4
Schmamane,blutkessel,192,shaman,restoration,6,2,4
Chatbanned,blackmoore,192,shaman,restoration,6,2,4
Pumanii,silvermoon,192,shaman,restoration,6,2,4
Nopurge,thrall,192,shaman,restoration,6,2,4
Отхо,deathguard,192,shaman,restoration,6,2,4
Демианна,eversong,192,shaman,restoration,6,2,4
Spiritualx,argent-dawn,192,shaman,restoration,6,2,4
Reechiks,outland,192,shaman,restoration,6,2,4
Фикстар,soulflayer,192,shaman,restoration,6,2,4
Sëídhr,arathi,192,shaman,restoration,6,2,4
Naindefer,uldaman,192,shaman,restoration,6,2,4
Sàs,zuljin,192,shaman,restoration,6,2,4
Chaac,bloodscalp,192,shaman,restoration,6,2,4
Kikbokser,kazzak,192,shaman,restoration,6,2,4
Kärmá,lightbringer,192,shaman,restoration,6,2,4
Ráekwon,frostmourne,192,shaman,restoration,6,2,4
Урахарочка,soulflayer,192,shaman,restoration,6,2,4
Nassîî,blackhand,192,shaman,restoration,6,2,4
Shupp,stormscale,192,shaman,restoration,6,2,4
Renátosz,ragnaros,192,shaman,restoration,6,2,4
Бинграех,howling-fjord,192,shaman,restoration,6,2,4
Kevox,malganis,192,shaman,restoration,6,2,4
Reverse,xavius,192,shaman,restoration,6,2,4
Bram,aggra-português,192,shaman,restoration,6,2,4
Wiev,blackmoore,192,shaman,restoration,6,2,4
Totemino,silvermoon,192,shaman,restoration,6,2,4
Pûrge,tarren-mill,192,shaman,restoration,6,2,4
Брбртолетчик,soulflayer,192,shaman,restoration,6,2,4
Messedmyself,outland,192,shaman,restoration,6,2,4
Smorclelx,khadgar,192,shaman,restoration,6,2,4
Nutqt,archimonde,192,shaman,restoration,6,2,4
Nachtary,blackmoore,192,shaman,restoration,6,2,4
Colonoscoper,ravencrest,192,shaman,restoration,6,2,4
Rihi,twisting-nether,192,shaman,restoration,6,2,4
Arkalôl,hyjal,192,shaman,restoration,6,2,4
Cetegusx,ravencrest,192,shaman,restoration,6,2,4
Rolftheswine,defias-brotherhood,192,shaman,restoration,6,2,4
Kilosham,silvermoon,192,shaman,restoration,6,2,4
Pebble,blackrock,192,shaman,restoration,6,2,4
Berascendz,argent-dawn,192,shaman,restoration,6,2,4
Nuarishaman,kazzak,192,shaman,restoration,6,2,4
Chêlëx,silvermoon,192,shaman,restoration,6,2,4
Akylä,varimathras,192,shaman,restoration,6,2,4
Saymynamee,ragnaros,192,shaman,restoration,6,2,4
Swineflay,kirin-tor,192,shaman,restoration,6,2,4
Oladoda,archimonde,192,shaman,restoration,6,2,4
Bluéshirtguy,blackhand,192,shaman,restoration,6,2,4
Shalolx,twisting-nether,192,shaman,restoration,6,2,4
Zinlay,tarren-mill,192,shaman,restoration,6,2,4
Fuchserl,aegwynn,192,shaman,restoration,6,2,4
Bumbummann,blackmoore,192,shaman,restoration,6,2,4
Spoko,hyjal,192,shaman,restoration,6,2,4
Jacquisham,archimonde,192,shaman,restoration,6,2,4
Anteja,kazzak,192,shaman,restoration,6,2,4
Cyklopx,ravencrest,192,shaman,restoration,6,2,4
Kossborax,blackhand,192,shaman,restoration,6,2,4
Nainpulsïf,hyjal,192,shaman,restoration,6,2,4
Джейджона,soulflayer,192,shaman,restoration,6,2,4
Marjorie,archimonde,192,shaman,restoration,6,2,4
Høtgødx,blackrock,192,shaman,restoration,6,2,4
Pip,outland,192,shaman,restoration,6,2,4
Hìrnfrost,blackrock,192,shaman,restoration,6,2,4
Kàji,tarren-mill,192,shaman,restoration,6,2,4
Elektrikci,silvermoon,192,shaman,restoration,6,2,4
Wahya,stormscale,192,shaman,restoration,6,2,4
Joshan,frostmourne,192,shaman,restoration,6,2,4
Mikhey,archimonde,192,shaman,restoration,6,2,4
Hexius,drakthul,192,shaman,restoration,6,2,4
Spaltbart,blackmoore,192,shaman,restoration,6,2,4
Olmaz,ravencrest,192,shaman,restoration,6,2,4
Lêss,ysondre,192,shaman,restoration,6,2,4
Fakeyy,draenor,192,shaman,restoration,6,2,4
Matsish,sylvanas,192,shaman,restoration,6,2,4
Лавовыйдед,gordunni,192,shaman,restoration,6,2,4
Пучмек,gordunni,192,shaman,restoration,6,2,4
Khayac,ravencrest,192,shaman,restoration,6,2,4
Jsham,blackmoore,192,shaman,restoration,6,2,4
Crãnk,sylvanas,192,shaman,restoration,6,2,4
Agorasiya,frostwolf,192,shaman,restoration,6,2,4
Xalh,ysondre,192,shaman,restoration,6,2,4
Shialebôf,sylvanas,192,shaman,restoration,6,2,4
Sablolix,ravencrest,192,shaman,restoration,6,2,4
Ikdra,medivh,192,shaman,restoration,6,2,4
Narevoqi,madmortem,192,shaman,restoration,6,2,4
Imbahlink,draenor,192,shaman,restoration,6,2,4
Gevitomeraw,sylvanas,192,shaman,restoration,6,2,4
Naneunsanai,jaedenar,192,shaman,restoration,6,2,4
Biggucci,sylvanas,192,shaman,restoration,6,2,4
Basegrandpa,ravencrest,192,shaman,restoration,6,2,4
Voodude,blackrock,192,shaman,restoration,6,2,4
Mordshamanx,draenor,192,shaman,restoration,6,2,4
Ranian,frostwolf,192,shaman,restoration,9,2,7
Нерфнерф,howling-fjord,192,shaman,restoration,9,2,7
Aylíne,hyjal,192,shaman,restoration,20,4,16
Seifero,burning-legion,192,shaman,restoration,10,2,8
Dvärgenkajsa,stormreaver,192,shaman,restoration,10,2,8
Cptnkirby,malganis,192,shaman,restoration,12,2,10
Dagdush,blackhand,192,shaman,restoration,12,2,10
Fëhn,krasus,192,shaman,restoration,12,2,10
Elarae,blackrock,192,shaman,restoration,12,2,10
Cirøsham,ravencrest,192,shaman,restoration,12,2,10
Ekxr,kazzak,192,shaman,restoration,12,2,10
Hájoon,tarren-mill,192,shaman,restoration,12,2,10
Onii,alleria,192,shaman,restoration,12,2,10
Pästïs,hyjal,192,shaman,restoration,12,2,10
Walterwhite,blackrock,192,shaman,restoration,12,2,10
Nuekx,sanguino,192,shaman,restoration,12,2,10
Delvanjus,blackrock,192,shaman,restoration,12,2,10
Zënga,kazzak,192,shaman,restoration,12,2,10
Ezpz,frostmourne,192,shaman,restoration,12,2,10
Samisu,blackmoore,192,shaman,restoration,12,2,10
Zeltron,grim-batol,192,shaman,restoration,12,2,10
Epicoverlord,tarren-mill,192,shaman,restoration,12,2,10
Thunderjudge,twisting-nether,192,shaman,restoration,12,2,10
Gïzmö,tarren-mill,192,shaman,restoration,12,2,10
Hornynikita,silvermoon,192,shaman,restoration,12,2,10
Caméltótem,kazzak,192,shaman,restoration,12,2,10
Fatflop,sylvanas,192,shaman,restoration,12,2,10
Zennex,tarren-mill,192,shaman,restoration,12,2,10
Satá,blackmoore,192,shaman,restoration,12,2,10
Frizzysizzy,tarren-mill,192,shaman,restoration,12,2,10
Yolototem,drakthul,192,shaman,restoration,15,2,13
Tûrbø,ravencrest,192,shaman,restoration,18,2,16
Wuchtzwerg,terrordar,192,shaman,restoration,18,2,16
Koothe,dun-modr,191,shaman,restoration,6,2,4
Kobeye,thrall,191,shaman,restoration,6,2,4
Андумиэль,soulflayer,190,shaman,restoration,12,2,10
Krootox,sunstrider,170,shaman,restoration,18,4,14
Zhangliyi,ravencrest,169,shaman,restoration,9,5,4
Iddoz,outland,159,shaman,restoration,14,3,11
Siyina,draenor,138,shaman,restoration,9,4,5
Artsu,argent-dawn,138,shaman,restoration,11,4,7
Ruzgork,nerzhul,138,shaman,restoration,9,3,6
Shamshady,kazzak,138,shaman,restoration,12,3,9
Volstorm,ysondre,138,shaman,restoration,12,3,9
Sörén,lothar,138,shaman,restoration,13,3,10
Guqin,ravencrest,138,shaman,restoration,23,3,20
Cardenus,los-errantes,137,shaman,restoration,15,3,12
Belldandý,archimonde,128,shaman,restoration,4,2,2
Feetsniffax,outland,128,shaman,restoration,4,2,2
Крто,thermaplugg,128,shaman,restoration,4,2,2
Healníx,ravencrest,96,shaman,restoration,3,2,1
Especialista,uldum,96,shaman,restoration,6,1,5
Elchivo,blackrock,96,shaman,restoration,6,1,5
Nurychic,twisting-nether,96,shaman,restoration,6,1,5
Xrc,sylvanas,96,shaman,restoration,6,1,5
Apax,blackrock,96,shaman,restoration,6,1,5
Bjerknes,draenor,96,shaman,restoration,6,1,5
Stonetone,silvermoon,96,shaman,restoration,6,1,5
Legended,tarren-mill,96,shaman,restoration,6,1,5
Ilovédogs,tarren-mill,96,shaman,restoration,6,1,5
Weldarion,ragnaros,96,shaman,restoration,6,1,5
Shockqt,todeswache,96,shaman,restoration,6,1,5
Diabolous,drakthul,96,shaman,restoration,6,1,5
Zekmvp,tarren-mill,96,shaman,restoration,6,1,5
Fosterzz,ravencrest,96,shaman,restoration,6,1,5
Trymytotems,drakthul,96,shaman,restoration,6,1,5
Rôhâr,stormscale,96,shaman,restoration,6,1,5
Miscoj,zuljin,96,shaman,restoration,6,1,5
Elementss,stormscale,96,shaman,restoration,6,1,5
Cheatcodes,blackhand,96,shaman,restoration,6,1,5
Swepx,ravencrest,96,shaman,restoration,6,1,5
Dashakk,frostwhisper,96,shaman,restoration,6,1,5
Atuza,antonidas,96,shaman,restoration,6,1,5
Zimzalabling,kazzak,96,shaman,restoration,6,1,5
Dvrg,antonidas,96,shaman,restoration,6,1,5
Kimpa,minahonda,96,shaman,restoration,6,1,5
Efdemin,blackmoore,96,shaman,restoration,6,1,5
Bymajor,dalaran,96,shaman,restoration,6,1,5
Zethh,antonidas,96,shaman,restoration,6,1,5
Металорд,howling-fjord,96,shaman,restoration,6,1,5
Mikah,frostwhisper,96,shaman,restoration,6,1,5
Jaeslin,tarren-mill,96,shaman,restoration,6,1,5
Ragnarökaren,stormscale,96,shaman,restoration,6,1,5
Сатангодхх,howling-fjord,96,shaman,restoration,6,1,5
Hotstorm,bronzebeard,96,shaman,restoration,6,1,5
Moonlanced,aegwynn,96,shaman,restoration,6,1,5
Nucika,ragnaros,96,shaman,restoration,6,1,5
Jukelis,kazzak,96,shaman,restoration,6,1,5
Rahuna,darksorrow,96,shaman,restoration,6,1,5
Aguero,aegwynn,96,shaman,restoration,6,1,5
Daykor,chamber-of-aspects,96,shaman,restoration,6,1,5
Greenbo,burning-blade,96,shaman,restoration,6,1,5
Chênoya,blackrock,96,shaman,restoration,6,1,5
Smorcxx,kazzak,96,shaman,restoration,6,1,5
Ader,outland,96,shaman,restoration,6,1,5
Thundervick,stormscale,96,shaman,restoration,6,1,5
Вещун,deathguard,96,shaman,restoration,6,1,5
Акер,deathguard,96,shaman,restoration,6,1,5
Podvodnicata,stormscale,96,shaman,restoration,6,1,5
Kajirin,shattrath,96,shaman,restoration,6,1,5
Apolomaeuz,frostwolf,96,shaman,restoration,6,1,5
Proxjj,stormscale,96,shaman,restoration,6,1,5
Троллюшка,soulflayer,96,shaman,restoration,6,1,5
Driftal,laughing-skull,96,shaman,restoration,6,1,5
Ниарата,greymane,96,shaman,restoration,6,1,5
Neterö,la-croisade-écarlate,96,shaman,restoration,6,1,5
Jawoburst,antonidas,96,shaman,restoration,6,1,5
Poliez,outland,96,shaman,restoration,6,1,5
Reflux,outland,96,shaman,restoration,6,1,5
Cptcutíe,antonidas,96,shaman,restoration,6,1,5
Irondandy,archimonde,96,shaman,restoration,6,1,5
Despérado,archimonde,96,shaman,restoration,6,1,5
Cavemencomp,malganis,96,shaman,restoration,6,1,5
Zaxis,bronzebeard,96,shaman,restoration,6,1,5
Púrgé,outland,96,shaman,restoration,6,1,5
Valgash,khadgar,96,shaman,restoration,6,1,5
Fuchifu,eredar,96,shaman,restoration,6,1,5
Anieszka,malganis,96,shaman,restoration,6,1,5
Cy,aszune,96,shaman,restoration,6,1,5
Utto,thrall,96,shaman,restoration,6,1,5
Lekyzx,archimonde,96,shaman,restoration,6,1,5
Absinthoxid,taerar,96,shaman,restoration,6,1,5
Eclaîr,thrall,96,shaman,restoration,6,1,5
Getahex,draenor,96,shaman,restoration,6,1,5
Trendilla,malganis,96,shaman,restoration,6,1,5
Найспацан,gordunni,96,shaman,restoration,6,1,5
Earthvixen,ravencrest,96,shaman,restoration,6,1,5
Grillfleîsch,azshara,96,shaman,restoration,6,1,5
Casinoaddict,tarren-mill,96,shaman,restoration,6,1,5
Kostex,rexxar,96,shaman,restoration,6,1,5
Сагура,gordunni,96,shaman,restoration,6,1,5
Renamedagain,twisting-nether,96,shaman,restoration,6,1,5
Cupído,malganis,96,shaman,restoration,6,1,5
Крузмвп,blackscar,96,shaman,restoration,6,1,5
Yuimhi,sanguino,96,shaman,restoration,7,1,6
Schockbunny,blackrock,96,shaman,restoration,17,2,15
Freeleys,ravencrest,96,shaman,restoration,12,1,11
Porre,zuljin,96,shaman,restoration,12,1,11
Топмахвелл,soulflayer,96,shaman,restoration,12,1,11
Ikeaboy,eredar,96,shaman,restoration,12,1,11
Anstra,colinas-pardas,96,shaman,restoration,12,1,11
Namrdak,quelthalas,96,shaman,restoration,12,1,11
Dewriyl,doomhammer,96,shaman,restoration,12,1,11
Garulf,twisting-nether,96,shaman,restoration,12,1,11
Кара,gordunni,96,shaman,restoration,12,1,11
Lootqrwa,ragnaros,96,shaman,restoration,12,1,11
Xicez,sanguino,96,shaman,restoration,12,1,11
Karpsham,stormscale,96,shaman,restoration,12,1,11
Grumpystorm,agamaggan,96,shaman,restoration,18,1,17
Rohek,tarren-mill,96,shaman,restoration,18,1,17
Kvelertak,guldan,96,shaman,restoration,18,1,17
Hairball,turalyon,95,shaman,restoration,6,2,4
Bursthand,sanguino,95,shaman,restoration,12,2,10
Twotwozero,defias-brotherhood,95,shaman,restoration,6,1,5
Taiki,sylvanas,90,shaman,restoration,13,4,9
Kungachunga,pozzo-delleternità,79,shaman,restoration,5,1,4
Apád,ragnaros,79,shaman,restoration,5,1,4
Destrosoul,kazzak,64,shaman,restoration,4,1,3
Drê,daggerspine,64,shaman,restoration,4,1,3
Nowái,tarren-mill,64,shaman,restoration,4,1,3
Kirïss,hyjal,48,shaman,restoration,3,1,2
Smokingtotem,alakir,48,shaman,restoration,9,1,8
Buildthewall,archimonde,42,shaman,restoration,8,3,5
Ånný,blackmoore,42,shaman,restoration,11,3,8
Egart,stormscale,42,shaman,restoration,9,2,7
Srøgg,archimonde,42,shaman,restoration,9,2,7
Ninffø,dun-modr,42,shaman,restoration,22,4,18
Shammez,ravencrest,42,shaman,restoration,11,2,9
Oyuun,rajaxx,42,shaman,restoration,17,3,14
Zulululul,burning-blade,42,shaman,restoration,14,2,12
Søpse,stormscale,42,shaman,restoration,15,2,13
Vijaya,eredar,16,shaman,restoration,1,1,0
Guzzelinare,tarren-mill,2415,shaman,elemental,78,51,27
Elejizz,kazzak,2385,shaman,elemental,156,88,68
Rngo,blackrock,2366,shaman,elemental,120,73,47
Euprâ,archimonde,2362,shaman,elemental,275,145,130
Eupra,archimonde,2351,shaman,elemental,163,91,72
Dody,silvermoon,2344,shaman,elemental,100,70,30
Shrmful,dun-modr,2319,shaman,elemental,113,74,39
Nyed,hyjal,2313,shaman,elemental,256,137,119
Silden,thrall,2303,shaman,elemental,121,72,49
Shiggenbasta,kazzak,2300,shaman,elemental,102,60,42
Rungozvs,blackrock,2297,shaman,elemental,125,69,56
Reibanit,twisting-nether,2284,shaman,elemental,147,86,61
Drshock,blackmoore,2281,shaman,elemental,167,88,79
Nevershearx,blackrock,2269,shaman,elemental,96,56,40
Matmodir,hyjal,2260,shaman,elemental,138,75,63
Маигваза,soulflayer,2258,shaman,elemental,78,53,25
Baldcreep,blackrock,2254,shaman,elemental,60,41,19
Dakyele,ravencrest,2252,shaman,elemental,113,61,52
Edshearen,stormscale,2240,shaman,elemental,234,127,107
Ghostwolfgg,archimonde,2236,shaman,elemental,138,76,62
Qualitydoge,kazzak,2226,shaman,elemental,72,46,26
Proccit,blackrock,2226,shaman,elemental,90,50,40
Rungõo,blackrock,2215,shaman,elemental,246,133,113
Yëë,kazzak,2213,shaman,elemental,81,57,24
Theglue,kilrogg,2212,shaman,elemental,72,42,30
Blyatifulday,malganis,2196,shaman,elemental,114,64,50
Plazmorc,stormscale,2191,shaman,elemental,89,53,36
Kenaz,outland,2190,shaman,elemental,97,54,43
Lexila,doomhammer,2190,shaman,elemental,741,381,360
Mcmxcvi,ravencrest,2187,shaman,elemental,178,101,77
Houmpf,hyjal,2184,shaman,elemental,96,53,43
Autopanne,malganis,2177,shaman,elemental,84,53,31
Space,stormscale,2176,shaman,elemental,138,72,66
Haumx,blackrock,2172,shaman,elemental,177,97,80
Connecting,hyjal,2171,shaman,elemental,108,56,52
Båkka,ysondre,2170,shaman,elemental,78,47,31
Bärtigeberta,aegwynn,2170,shaman,elemental,102,54,48
Matmons,hyjal,2160,shaman,elemental,100,52,48
Tommybanger,kazzak,2158,shaman,elemental,75,49,26
Shamanazor,twisting-nether,2153,shaman,elemental,66,41,25
Tornado,ravencrest,2150,shaman,elemental,205,113,92
Mèåtbåll,ravencrest,2139,shaman,elemental,83,53,30
Trickful,kazzak,2138,shaman,elemental,66,45,21
Uselesslaso,sanguino,2136,shaman,elemental,123,62,61
Billybatman,argent-dawn,2134,shaman,elemental,108,70,38
Lavaole,blackrock,2130,shaman,elemental,84,43,41
Monsuunibaba,tarren-mill,2126,shaman,elemental,111,63,48
Eyi,ambossar,2116,shaman,elemental,152,80,72
Ìløvêxÿú,ravencrest,2115,shaman,elemental,182,101,81
Ryysham,ravencrest,2114,shaman,elemental,164,93,71
Bigschamlipp,blackhand,2111,shaman,elemental,73,51,22
Exxco,aegwynn,2111,shaman,elemental,83,51,32
Smorchamp,sanguino,2104,shaman,elemental,102,50,52
Jelvin,tarren-mill,2101,shaman,elemental,162,87,75
Blackyx,cthun,2100,shaman,elemental,164,95,69
Бпокбастэр,gordunni,2098,shaman,elemental,87,50,37
Wisplol,ravencrest,2097,shaman,elemental,370,191,179
Woof,culte-de-la-rive-noire,2093,shaman,elemental,66,36,30
Jøhnnwick,archimonde,2082,shaman,elemental,89,48,41
Blushx,blackhand,2075,shaman,elemental,48,25,23
Pleasehealme,ravencrest,2067,shaman,elemental,42,33,9
Raintlordx,twisting-nether,2060,shaman,elemental,42,36,6
Dsgrc,tarren-mill,2059,shaman,elemental,126,65,61
Starelement,draenor,2059,shaman,elemental,120,58,62
Teslashock,outland,2053,shaman,elemental,77,48,29
Zimoneris,blackmoore,2050,shaman,elemental,80,46,34
Jøhnwick,ysondre,2050,shaman,elemental,102,50,52
Matmonai,hyjal,2044,shaman,elemental,98,47,51
Kärríegold,blackrock,2039,shaman,elemental,613,316,297
Shåmssagat,kazzak,2036,shaman,elemental,60,36,24
Suldarissham,aegwynn,2036,shaman,elemental,47,28,19
Satisfya,ambossar,2034,shaman,elemental,292,154,138
Nyzo,tarren-mill,2032,shaman,elemental,96,50,46
Lavayoshi,kazzak,2026,shaman,elemental,72,48,24
Iavalavalava,tarren-mill,2025,shaman,elemental,96,46,50
Agrero,auchindoun,2024,shaman,elemental,192,99,93
Novoz,ysondre,2023,shaman,elemental,131,74,57
Шоу,gordunni,2022,shaman,elemental,84,45,39
Йодаримару,howling-fjord,2022,shaman,elemental,77,41,36
Thriveqt,nemesis,2015,shaman,elemental,108,50,58
Millesabords,dun-morogh,2004,shaman,elemental,60,37,23
Punished,blackrock,2000,shaman,elemental,107,62,45
Rottulos,stormrage,2000,shaman,elemental,60,33,27
Leccyavenue,twisting-nether,2000,shaman,elemental,224,121,103
Stacyz25F75E,twisting-nether,1999,shaman,elemental,38,30,8
Firella,the-maelstrom,1999,shaman,elemental,64,36,28
Pxsquals,ravencrest,1992,shaman,elemental,166,92,74
Langedinho,stormscale,1991,shaman,elemental,309,154,155
Eledelede,blackhand,1990,shaman,elemental,84,42,42
Шутках,gordunni,1986,shaman,elemental,42,24,18
Suldaro,aegwynn,1984,shaman,elemental,77,41,36
Eppîx,lightnings-blade,1982,shaman,elemental,100,50,50
Nowmack,archimonde,1981,shaman,elemental,48,32,16
Nykhara,sanguino,1981,shaman,elemental,108,58,50
Tâsty,blackmoore,1980,shaman,elemental,63,36,27
Naskezz,kazzak,1980,shaman,elemental,287,148,139
Elegodx,ravencrest,1980,shaman,elemental,149,74,75
Fellatia,baelgun,1978,shaman,elemental,108,74,34
Bloodseeker,tarren-mill,1976,shaman,elemental,72,41,31
Айвимэдисон,howling-fjord,1974,shaman,elemental,82,46,36
Kailash,defias-brotherhood,1974,shaman,elemental,90,44,46
Nokster,twisting-nether,1969,shaman,elemental,243,132,111
Murdá,ravencrest,1969,shaman,elemental,96,45,51
Macroburst,archimonde,1968,shaman,elemental,59,36,23
Bzezz,archimonde,1968,shaman,elemental,66,36,30
Shiranoye,blackrock,1965,shaman,elemental,96,46,50
Preshear,twisting-nether,1963,shaman,elemental,47,34,13
Könsneutral,tarren-mill,1962,shaman,elemental,71,40,31
Élé,twisting-nether,1958,shaman,elemental,102,51,51
Pipousham,blackhand,1954,shaman,elemental,47,26,21
Pheazka,outland,1950,shaman,elemental,71,37,34
Lavalars,blackhand,1949,shaman,elemental,66,37,29
Блокбастзр,gordunni,1945,shaman,elemental,134,69,65
Psyku,outland,1941,shaman,elemental,48,25,23
Dräpàrn,sylvanas,1940,shaman,elemental,72,40,32
Thyeori,stormscale,1940,shaman,elemental,90,43,47
Obryss,tarren-mill,1939,shaman,elemental,54,30,24
Blush,blackhand,1936,shaman,elemental,51,23,28
Хеллбат,howling-fjord,1934,shaman,elemental,74,43,31
Raknoxye,blackrock,1931,shaman,elemental,48,38,10
Smashz,stormscale,1930,shaman,elemental,133,79,54
Kiirín,drakthul,1929,shaman,elemental,72,39,33
Valgø,twisting-nether,1927,shaman,elemental,292,161,131
Borbor,argent-dawn,1916,shaman,elemental,58,31,27
Mjorè,twisting-nether,1911,shaman,elemental,245,120,125
Çð,ravencrest,1909,shaman,elemental,36,20,16
Acces,stormscale,1907,shaman,elemental,134,85,49
Twists,sylvanas,1906,shaman,elemental,66,40,26
Sajma,silvermoon,1903,shaman,elemental,69,48,21
Barbarra,stormscale,1903,shaman,elemental,60,33,27
Trixxsham,twisting-nether,1902,shaman,elemental,36,25,11
Roskan,archimonde,1902,shaman,elemental,89,46,43
Starpior,stormscale,1901,shaman,elemental,144,74,70
Vanrake,ravencrest,1899,shaman,elemental,285,157,128
Kilazz,twisting-nether,1897,shaman,elemental,66,35,31
Onceinalife,ambossar,1895,shaman,elemental,582,293,289
Earthhulk,thrall,1892,shaman,elemental,126,74,52
Feetenjoyerx,kazzak,1892,shaman,elemental,98,49,49
Replicusele,doomhammer,1891,shaman,elemental,48,32,16
Зэстус,soulflayer,1891,shaman,elemental,233,129,104
Agreró,auchindoun,1888,shaman,elemental,63,40,23
Totemlié,ravencrest,1887,shaman,elemental,42,27,15
Cïgänää,archimonde,1885,shaman,elemental,85,44,41
Yiiro,argent-dawn,1884,shaman,elemental,91,49,42
Shocknrun,sylvanas,1884,shaman,elemental,84,44,40
Штормкрашер,howling-fjord,1883,shaman,elemental,126,67,59
Xtremeshaman,blackmoore,1882,shaman,elemental,42,30,12
Tukino,burning-legion,1880,shaman,elemental,31,21,10
Nerdshockz,blackhand,1878,shaman,elemental,116,57,59
Horizons,the-maelstrom,1875,shaman,elemental,48,31,17
Hurik,sylvanas,1872,shaman,elemental,62,37,25
Тандерхх,howling-fjord,1870,shaman,elemental,36,23,13
Regnever,draenor,1862,shaman,elemental,185,90,95
Wørldrúiner,kazzak,1859,shaman,elemental,48,33,15
Midgetnatty,ravencrest,1858,shaman,elemental,94,51,43
Haltothunder,dalaran,1858,shaman,elemental,72,34,38
Rotuluss,stormrage,1856,shaman,elemental,58,40,18
Nekhros,sargeras,1854,shaman,elemental,247,128,119
Gungo,deathwing,1853,shaman,elemental,60,29,31
Flanax,hyjal,1852,shaman,elemental,78,44,34
Enamo,blackrock,1850,shaman,elemental,65,34,31
Volcanò,outland,1850,shaman,elemental,312,158,154
ßakingsoda,tarren-mill,1848,shaman,elemental,83,46,37
Visboer,stormscale,1847,shaman,elemental,36,22,14
Knastele,silvermoon,1846,shaman,elemental,36,27,9
Tellý,blackmoore,1846,shaman,elemental,53,31,22
Totemtilda,tarren-mill,1846,shaman,elemental,54,30,24
Djlavaburst,malganis,1846,shaman,elemental,401,202,199
Millevolt,emerald-dream,1844,shaman,elemental,42,22,20
Hothand,thrall,1844,shaman,elemental,54,26,28
Lilmarco,stormreaver,1843,shaman,elemental,72,35,37
Øwlïshâm,archimonde,1843,shaman,elemental,89,43,46
Реалайзер,blackscar,1841,shaman,elemental,54,32,22
Procc,nordrassil,1839,shaman,elemental,54,35,19
Shocktrippz,stormscale,1839,shaman,elemental,96,56,40
Dwarfracial,blackrock,1837,shaman,elemental,36,23,13
Ejx,arthas,1836,shaman,elemental,88,47,41
Ungabungha,stormscale,1835,shaman,elemental,199,113,86
Jåime,ravencrest,1834,shaman,elemental,42,26,16
Doyah,eredar,1834,shaman,elemental,54,33,21
Sayokô,grim-batol,1834,shaman,elemental,48,28,20
Bambustic,kazzak,1833,shaman,elemental,41,25,16
Bûsta,ravencrest,1833,shaman,elemental,54,29,25
Инимал,deathweaver,1830,shaman,elemental,54,30,24
Retuu,uldaman,1829,shaman,elemental,54,30,24
Crazyshaman,ravencrest,1829,shaman,elemental,53,26,27
Херург,soulflayer,1828,shaman,elemental,48,24,24
Slogic,tarren-mill,1828,shaman,elemental,71,34,37
Crespó,alakir,1827,shaman,elemental,54,25,29
Paulbaniel,alonsus,1827,shaman,elemental,114,52,62
Transcendent,malorne,1826,shaman,elemental,84,63,21
Hazardhenry,argent-dawn,1826,shaman,elemental,42,30,12
Breezzkingg,twisting-nether,1826,shaman,elemental,92,54,38
Nëllaqt,archimonde,1826,shaman,elemental,78,41,37
Sourens,twisting-nether,1826,shaman,elemental,92,48,44
Deepdamp,blackrock,1825,shaman,elemental,46,31,15
Exesemrone,uldaman,1825,shaman,elemental,66,39,27
Kæzx,blackrock,1822,shaman,elemental,78,45,33
Mehboul,hyjal,1822,shaman,elemental,66,36,30
Unluckyvault,nemesis,1822,shaman,elemental,74,34,40
Kronoxd,tarren-mill,1822,shaman,elemental,92,42,50
Georgewhat,defias-brotherhood,1821,shaman,elemental,173,87,86
Vandouille,archimonde,1820,shaman,elemental,45,29,16
Mikecrybaby,tarren-mill,1816,shaman,elemental,114,64,50
Komodski,kazzak,1814,shaman,elemental,48,26,22
Achtungblitz,blackrock,1813,shaman,elemental,42,33,9
Ronfroggo,kazzak,1812,shaman,elemental,64,38,26
Xelphia,frostmane,1812,shaman,elemental,89,42,47
Pooch,archimonde,1811,shaman,elemental,99,54,45
Korvsnärten,outland,1811,shaman,elemental,87,46,41
Jamzyshaman,emerald-dream,1810,shaman,elemental,42,27,15
Hugox,outland,1810,shaman,elemental,82,48,34
Atiix,eredar,1810,shaman,elemental,125,70,55
Lavatherapy,grim-batol,1809,shaman,elemental,114,65,49
Faridstreng,blackmoore,1808,shaman,elemental,66,42,24
Chamel,draenor,1808,shaman,elemental,30,19,11
Ztraz,blackhand,1808,shaman,elemental,50,27,23
Palfe,khaz-modan,1808,shaman,elemental,103,51,52
Ehlaina,outland,1806,shaman,elemental,30,19,11
Rokxa,burning-legion,1806,shaman,elemental,54,27,27
Kapplos,gorgonnash,1805,shaman,elemental,59,31,28
Glibbins,sylvanas,1801,shaman,elemental,41,24,17
Burstraze,tarren-mill,1801,shaman,elemental,58,32,26
Owrly,stormscale,1801,shaman,elemental,407,202,205
Spajry,drakthul,1800,shaman,elemental,54,35,19
Koiru,argent-dawn,1796,shaman,elemental,54,34,20
Карбонатрикс,soulflayer,1796,shaman,elemental,106,59,47
Lavalava,blackmoore,1795,shaman,elemental,280,148,132
Oneßuttøn,ravencrest,1794,shaman,elemental,78,35,43
Lsdx,silvermoon,1793,shaman,elemental,126,68,58
Boiblaster,argent-dawn,1790,shaman,elemental,33,26,7
Anqe,twisting-nether,1790,shaman,elemental,142,72,70
Elexuz,blackrock,1789,shaman,elemental,108,64,44
Fabslx,archimonde,1785,shaman,elemental,207,98,109
Lianitus,tarren-mill,1785,shaman,elemental,87,40,47
Voydetesto,sanguino,1783,shaman,elemental,96,46,50
Cismine,twisting-nether,1782,shaman,elemental,54,35,19
Iraterrørist,kazzak,1781,shaman,elemental,44,20,24
Pitsamestari,frostmane,1780,shaman,elemental,128,71,57
Avatarbaelon,silvermoon,1780,shaman,elemental,134,64,70
Wátermélon,stormscale,1776,shaman,elemental,78,48,30
Davinshhe,kazzak,1775,shaman,elemental,90,41,49
Suntaria,stormscale,1775,shaman,elemental,54,24,30
Suirz,dun-modr,1773,shaman,elemental,77,49,28
Çð,twisting-nether,1772,shaman,elemental,47,28,19
Vivaldi,varimathras,1770,shaman,elemental,148,73,75
Spruehkot,aegwynn,1767,shaman,elemental,33,22,11
Lavaproc,burning-legion,1767,shaman,elemental,228,115,113
Obesisham,outland,1767,shaman,elemental,140,66,74
Tasoro,sanguino,1767,shaman,elemental,94,43,51
Tølkian,dalaran,1766,shaman,elemental,60,25,35
Deeck,ravencrest,1765,shaman,elemental,119,75,44
Farùk,ravencrest,1763,shaman,elemental,45,29,16
Fahrlos,eredar,1762,shaman,elemental,78,36,42
Psÿkz,kazzak,1762,shaman,elemental,63,27,36
Anøüchkä,ysondre,1761,shaman,elemental,118,66,52
Ангустиа,galakrond,1758,shaman,elemental,47,29,18
Sykx,hyjal,1758,shaman,elemental,77,44,33
Ulrichh,twisting-nether,1758,shaman,elemental,84,41,43
Hanakô,grim-batol,1756,shaman,elemental,48,27,21
Gojõ,dun-modr,1755,shaman,elemental,66,33,33
Savan,darkspear,1754,shaman,elemental,90,45,45
Blastersondy,outland,1752,shaman,elemental,85,48,37
Smorclelx,khadgar,1750,shaman,elemental,182,93,89
Stickix,malganis,1746,shaman,elemental,89,46,43
Adamyo,stormscale,1744,shaman,elemental,149,75,74
Дашажмихекс,howling-fjord,1742,shaman,elemental,48,26,22
Healyoa,blackmoore,1741,shaman,elemental,279,135,144
Cloony,khaz-modan,1738,shaman,elemental,86,55,31
Earthtjockis,ragnaros,1738,shaman,elemental,63,29,34
Volhalo,blackmoore,1737,shaman,elemental,36,22,14
Шумноватт,howling-fjord,1736,shaman,elemental,66,31,35
Jacklupin,ravencrest,1736,shaman,elemental,84,38,46
Machmacan,argent-dawn,1733,shaman,elemental,114,70,44
Mishoshamana,tarren-mill,1733,shaman,elemental,95,54,41
Schamaster,antonidas,1731,shaman,elemental,45,22,23
Hanatopikeur,grim-batol,1728,shaman,elemental,35,19,16
Aspên,archimonde,1727,shaman,elemental,66,33,33
Fullavaids,grim-batol,1725,shaman,elemental,51,27,24
Drainergødx,ragnaros,1723,shaman,elemental,72,42,30
Daubidaubi,kazzak,1722,shaman,elemental,39,26,13
Grapefruit,blackmoore,1722,shaman,elemental,30,18,12
Köona,archimonde,1720,shaman,elemental,30,21,9
Naphe,ysondre,1717,shaman,elemental,77,40,37
Lavabelly,twisting-nether,1717,shaman,elemental,205,101,104
Shammyammy,tarren-mill,1716,shaman,elemental,183,103,80
Testpapi,twisting-nether,1716,shaman,elemental,146,81,65
Neotrax,outland,1716,shaman,elemental,119,66,53
Eleurii,burning-blade,1715,shaman,elemental,126,67,59
Tao,stormscale,1715,shaman,elemental,51,22,29
Гивми,blackscar,1714,shaman,elemental,103,54,49
Totemlyhot,blackrock,1712,shaman,elemental,66,37,29
Ânuk,blackrock,1712,shaman,elemental,251,128,123
Nöyrä,argent-dawn,1710,shaman,elemental,36,25,11
Autopanne,draenor,1709,shaman,elemental,36,23,13
Shootinguard,kazzak,1709,shaman,elemental,42,25,17
Prêxy,kazzak,1709,shaman,elemental,91,42,49
Domflux,ravencrest,1708,shaman,elemental,285,152,133
Mércander,kazzak,1708,shaman,elemental,89,44,45
Cylantarus,blackrock,1705,shaman,elemental,36,25,11
Fakehex,blackrock,1704,shaman,elemental,104,59,45
Xatis,aegwynn,1703,shaman,elemental,24,19,5
Lantbruk,twisting-nether,1703,shaman,elemental,49,28,21
Мэморисс,gordunni,1701,shaman,elemental,58,29,29
Sunsong,twisting-nether,1700,shaman,elemental,132,71,61
Rokils,tarren-mill,1699,shaman,elemental,36,24,12
Basiletta,hyjal,1697,shaman,elemental,61,43,18
Äijä,chromaggus,1696,shaman,elemental,101,52,49
Porthex,kazzak,1694,shaman,elemental,84,47,37
Thorleíf,silvermoon,1694,shaman,elemental,120,59,61
Nînadobrevx,stormscale,1692,shaman,elemental,69,39,30
Lafia,blackrock,1691,shaman,elemental,205,103,102
Kraksham,ravencrest,1690,shaman,elemental,24,18,6
Афтршок,soulflayer,1690,shaman,elemental,105,55,50
Daemp,draenor,1689,shaman,elemental,30,22,8
Azùk,kazzak,1689,shaman,elemental,30,21,9
Stromdi,azshara,1689,shaman,elemental,40,24,16
Хэйзл,ashenvale,1687,shaman,elemental,122,71,51
Zaledria,argent-dawn,1687,shaman,elemental,124,68,56
Braíntas,norgannon,1687,shaman,elemental,102,48,54
Muscade,silvermoon,1686,shaman,elemental,78,45,33
Ðreamz,kaelthas,1685,shaman,elemental,48,23,25
Stormseven,emeriss,1685,shaman,elemental,41,19,22
Naorgot,uldaman,1682,shaman,elemental,204,98,106
Sáàd,ravencrest,1681,shaman,elemental,42,20,22
Mendiing,kazzak,1680,shaman,elemental,36,19,17
Seriux,twisting-nether,1679,shaman,elemental,72,44,28
Naathir,magtheridon,1678,shaman,elemental,40,26,14
Kwanah,kaelthas,1678,shaman,elemental,42,22,20
Xereús,kazzak,1676,shaman,elemental,107,51,56
Sgroppino,stormscale,1676,shaman,elemental,47,22,25
Máui,korgall,1675,shaman,elemental,168,91,77
Kohnân,hyjal,1675,shaman,elemental,84,42,42
Lokasakke,tarren-mill,1674,shaman,elemental,40,22,18
Nalaadu,stormscale,1672,shaman,elemental,90,45,45
Solosüper,ravencrest,1671,shaman,elemental,114,53,61
Klicken,tarren-mill,1670,shaman,elemental,29,19,10
Tvådje,silvermoon,1669,shaman,elemental,78,46,32
Brokenguyman,defias-brotherhood,1669,shaman,elemental,43,24,19
Cuddleball,moonglade,1669,shaman,elemental,48,25,23
Rokils,ravencrest,1669,shaman,elemental,42,20,22
Козаностро,howling-fjord,1668,shaman,elemental,30,19,11
Bumblebetuna,stormscale,1668,shaman,elemental,74,41,33
Ogrodi,burning-legion,1668,shaman,elemental,150,79,71
Liluzivert,mannoroth,1668,shaman,elemental,137,71,66
Theodorix,silvermoon,1668,shaman,elemental,48,23,25
Windspêaker,outland,1666,shaman,elemental,35,19,16
Gammeldunder,shattered-hand,1665,shaman,elemental,115,51,64
Sakkmaballz,stormscale,1664,shaman,elemental,56,25,31
Tempest,kul-tiras,1662,shaman,elemental,90,58,32
Koífish,ravencrest,1662,shaman,elemental,48,28,20
Vamali,draenor,1662,shaman,elemental,65,31,34
Androck,tarren-mill,1661,shaman,elemental,118,74,44
Sheamanus,ravencrest,1661,shaman,elemental,173,96,77
Snusyy,ravencrest,1660,shaman,elemental,32,18,14
Mö,ragnaros,1660,shaman,elemental,389,210,179
Elrayitos,shendralar,1659,shaman,elemental,114,63,51
Qwilfish,blackmoore,1659,shaman,elemental,117,63,54
Ogkûshgödx,sylvanas,1658,shaman,elemental,42,24,18
Vorteas,burning-blade,1658,shaman,elemental,42,23,19
Rawside,thrall,1658,shaman,elemental,52,26,26
Rolftheswine,defias-brotherhood,1656,shaman,elemental,36,23,13
Djclydecarry,stormscale,1654,shaman,elemental,72,39,33
Электро,thermaplugg,1654,shaman,elemental,71,34,37
Mcbloob,kazzak,1653,shaman,elemental,90,48,42
Zengã,kazzak,1653,shaman,elemental,118,55,63
Malybou,ysondre,1651,shaman,elemental,36,18,18
Wylly,aegwynn,1650,shaman,elemental,150,79,71
Obrijames,tarren-mill,1649,shaman,elemental,42,22,20
Jouzu,ragnaros,1648,shaman,elemental,47,22,25
Крушам,gordunni,1647,shaman,elemental,53,30,23
Лескас,howling-fjord,1647,shaman,elemental,42,23,19
Kemurus,kazzak,1647,shaman,elemental,101,55,46
Mariomental,draenor,1646,shaman,elemental,103,47,56
Bredex,doomhammer,1644,shaman,elemental,36,19,17
Thazra,zirkel-des-cenarius,1643,shaman,elemental,95,54,41
Ezala,blackhand,1642,shaman,elemental,102,56,46
Кислаябуба,howling-fjord,1641,shaman,elemental,42,19,23
Axahavregryn,kazzak,1640,shaman,elemental,66,40,26
Urshak,alleria,1639,shaman,elemental,36,24,12
Jodel,tarren-mill,1639,shaman,elemental,54,29,25
Zaarok,voljin,1639,shaman,elemental,91,41,50
Mamacitá,eredar,1639,shaman,elemental,69,28,41
Waâagh,kirin-tor,1638,shaman,elemental,90,53,37
Crysenshocks,blackrock,1638,shaman,elemental,120,65,55
Mezzoblu,sanguino,1638,shaman,elemental,216,112,104
Wàve,stormscale,1638,shaman,elemental,78,39,39
Slit,quelthalas,1638,shaman,elemental,48,20,28
Reignisover,silvermoon,1637,shaman,elemental,51,32,19
Gramkar,stormscale,1637,shaman,elemental,48,23,25
Томёрк,gordunni,1636,shaman,elemental,174,90,84
Aviciix,sanguino,1636,shaman,elemental,148,70,78
Poosnortgodx,ravencrest,1635,shaman,elemental,42,23,19
Microb,blackmoore,1634,shaman,elemental,118,61,57
Shourx,ravencrest,1634,shaman,elemental,89,42,47
Thorsteinar,kazzak,1632,shaman,elemental,82,44,38
Proccq,twisting-nether,1632,shaman,elemental,34,18,16
Tteïl,archimonde,1631,shaman,elemental,96,51,45
Кирагаз,gordunni,1629,shaman,elemental,146,73,73
Végàs,ysondre,1629,shaman,elemental,84,41,43
Ттраал,eversong,1628,shaman,elemental,24,17,7
Rrtyui,twisting-nether,1628,shaman,elemental,30,17,13
Чойсе,deathguard,1628,shaman,elemental,190,91,99
Xorron,archimonde,1627,shaman,elemental,219,103,116
Elemefayo,outland,1626,shaman,elemental,108,63,45
Leavemeàlone,ysondre,1625,shaman,elemental,18,17,1
Orcshaman,the-maelstrom,1625,shaman,elemental,87,50,37
Шамвкроксах,howling-fjord,1625,shaman,elemental,36,19,17
Ронхот,soulflayer,1625,shaman,elemental,72,30,42
Hotsincezero,archimonde,1624,shaman,elemental,101,60,41
Thëtis,chogall,1624,shaman,elemental,86,48,38
Мистеркутёж,gordunni,1624,shaman,elemental,318,163,155
Silverpanne,silvermoon,1623,shaman,elemental,24,17,7
Procbly,tarren-mill,1623,shaman,elemental,30,17,13
Zaelot,blackrock,1623,shaman,elemental,59,29,30
Jâydizzle,draenor,1623,shaman,elemental,171,79,92
Krubacabra,stormscale,1622,shaman,elemental,42,23,19
Zæus,ragnaros,1622,shaman,elemental,42,20,22
Лартисс,howling-fjord,1619,shaman,elemental,78,39,39
Esal,blackrock,1618,shaman,elemental,55,31,24
Waaghbozz,eredar,1616,shaman,elemental,108,61,47
Dumpaman,frostmane,1615,shaman,elemental,90,48,42
Kristhebrave,twisting-nether,1615,shaman,elemental,126,65,61
Blüëy,ravencrest,1614,shaman,elemental,24,17,7
Meangreen,stormscale,1613,shaman,elemental,63,34,29
Nitronigi,malganis,1612,shaman,elemental,42,17,25
Tiji,eredar,1611,shaman,elemental,62,37,25
Torxii,antonidas,1611,shaman,elemental,65,30,35
Hanakokô,grim-batol,1610,shaman,elemental,30,17,13
Naturexz,silvermoon,1608,shaman,elemental,38,22,16
Jehae,archimonde,1608,shaman,elemental,30,17,13
Oldaang,ravencrest,1606,shaman,elemental,118,72,46
Bâllz,anetheron,1606,shaman,elemental,266,139,127
Jímmy,frostwhisper,1605,shaman,elemental,72,45,27
Namè,kazzak,1604,shaman,elemental,72,38,34
Зиленый,soulflayer,1604,shaman,elemental,42,22,20
Sbangx,nemesis,1603,shaman,elemental,36,18,18
Nyxoqtx,draenor,1602,shaman,elemental,36,27,9
Byma,burning-legion,1601,shaman,elemental,30,21,9
Шаманнутая,gordunni,1601,shaman,elemental,71,43,28
Migahh,stormscale,1601,shaman,elemental,41,23,18
Murmelï,stormreaver,1601,shaman,elemental,66,37,29
Saóri,zuljin,1601,shaman,elemental,33,18,15
Kapïtão,aggra-português,1600,shaman,elemental,54,28,26
Zeuclo,ysondre,1599,shaman,elemental,42,31,11
Manaphi,arthas,1599,shaman,elemental,68,35,33
Dzielnysham,silvermoon,1597,shaman,elemental,80,42,38
Elkyrie,alakir,1596,shaman,elemental,119,63,56
Sniffix,ysondre,1596,shaman,elemental,189,97,92
Elektron,malganis,1595,shaman,elemental,172,87,85
Skyróxx,blackrock,1594,shaman,elemental,58,30,28
Aylar,zenedar,1593,shaman,elemental,48,25,23
Aureo,dun-modr,1593,shaman,elemental,46,23,23
Isvk,ravencrest,1592,shaman,elemental,73,37,36
Johncoltrane,archimonde,1589,shaman,elemental,30,23,7
Ohhmm,ravencrest,1589,shaman,elemental,41,20,21
Biccon,silvermoon,1588,shaman,elemental,36,19,17
Sheherezeday,aegwynn,1588,shaman,elemental,105,47,58
Lavaz,blackmoore,1587,shaman,elemental,181,81,100
Wilson,twisting-nether,1586,shaman,elemental,54,30,24
Canjo,aegwynn,1586,shaman,elemental,81,43,38
Zðhan,azshara,1586,shaman,elemental,55,27,28
Hailele,argent-dawn,1585,shaman,elemental,30,23,7
Bèx,twisting-nether,1585,shaman,elemental,127,65,62
Targoel,blackmoore,1585,shaman,elemental,181,87,94
Гудлаик,soulflayer,1584,shaman,elemental,70,38,32
Gúîtårgøð,sanguino,1584,shaman,elemental,60,27,33
Sinirli,ravencrest,1581,shaman,elemental,66,34,32
Kankxx,stormscale,1580,shaman,elemental,30,18,12
Roxxo,frostwolf,1579,shaman,elemental,83,48,35
Chinozukems,sanguino,1578,shaman,elemental,126,64,62
Robofat,ravencrest,1577,shaman,elemental,92,49,43
Takkenuma,hyjal,1577,shaman,elemental,87,44,43
Headthirst,ragnaros,1576,shaman,elemental,62,33,29
Bigfrigid,outland,1576,shaman,elemental,102,47,55
Brugdar,tarren-mill,1574,shaman,elemental,42,28,14
Бендера,grom,1574,shaman,elemental,48,26,22
Леланай,blackscar,1574,shaman,elemental,68,36,32
Morama,silvermoon,1574,shaman,elemental,48,24,24
Makaria,emerald-dream,1574,shaman,elemental,161,76,85
Stormcallér,auchindoun,1574,shaman,elemental,42,19,23
Thebomber,guldan,1573,shaman,elemental,72,30,42
Wlãdoo,archimonde,1572,shaman,elemental,26,18,8
Incredibade,stormscale,1572,shaman,elemental,42,24,18
Ryhèn,stormscale,1572,shaman,elemental,86,45,41
Blízzilassø,malygos,1572,shaman,elemental,179,93,86
Fotmglad,blackrock,1571,shaman,elemental,66,29,37
Aldonatello,blackrock,1570,shaman,elemental,216,119,97
Mistahbeard,stormscale,1569,shaman,elemental,54,32,22
Valunii,lordaeron,1566,shaman,elemental,279,136,143
Batan,kazzak,1566,shaman,elemental,89,41,48
Nachtary,blackmoore,1565,shaman,elemental,88,47,41
Тессельхоф,howling-fjord,1564,shaman,elemental,46,23,23
Ласара,eversong,1563,shaman,elemental,54,25,29
Касикандрэра,soulflayer,1562,shaman,elemental,480,248,232
Exereon,ravencrest,1562,shaman,elemental,54,23,31
Faydasizsham,twisting-nether,1559,shaman,elemental,86,48,38
Minasa,saurfang,1559,shaman,elemental,163,76,87
Òoòoòoòoòoòo,silvermoon,1559,shaman,elemental,54,24,30
Harod,suramar,1558,shaman,elemental,72,37,35
Hapkin,defias-brotherhood,1558,shaman,elemental,54,27,27
Едрёна,blackscar,1558,shaman,elemental,40,19,21
Junpi,shattered-hand,1557,shaman,elemental,166,85,81
Вавувоух,howling-fjord,1556,shaman,elemental,41,19,22
Doneteasy,blackrock,1554,shaman,elemental,152,83,69
Виспепешам,gordunni,1552,shaman,elemental,78,39,39
Shibol,ravencrest,1552,shaman,elemental,109,52,57
Ukkz,silvermoon,1552,shaman,elemental,71,30,41
Думсия,gordunni,1550,shaman,elemental,102,52,50
Akukuu,kazzak,1548,shaman,elemental,126,59,67
Fattmorte,hyjal,1547,shaman,elemental,27,19,8
Аэрофоб,soulflayer,1547,shaman,elemental,36,22,14
Ruvxy,twisting-nether,1546,shaman,elemental,45,28,17
Lavastriker,archimonde,1546,shaman,elemental,314,165,149
Hxml,aegwynn,1546,shaman,elemental,42,22,20
Shámonn,twisting-nether,1544,shaman,elemental,62,29,33
Diaba,sylvanas,1543,shaman,elemental,78,45,33
Twiva,silvermoon,1543,shaman,elemental,82,47,35
Экслайнер,deathweaver,1543,shaman,elemental,119,58,61
Shambulançe,silvermoon,1542,shaman,elemental,30,22,8
Smort,frostwolf,1539,shaman,elemental,48,24,24
Belsazar,frostwolf,1539,shaman,elemental,72,33,39
Museum,khaz-modan,1538,shaman,elemental,73,40,33
Krahg,garona,1536,shaman,elemental,34,21,13
Милфшама,blackscar,1535,shaman,elemental,78,38,40
Preciousxo,auchindoun,1535,shaman,elemental,47,22,25
Brøkenclass,ravencrest,1534,shaman,elemental,18,16,2
ßounce,twisting-nether,1534,shaman,elemental,30,17,13
Grende,sylvanas,1534,shaman,elemental,69,37,32
Thald,ragnaros,1533,shaman,elemental,42,23,19
Shantero,draenor,1532,shaman,elemental,67,32,35
Elevlach,drakthul,1532,shaman,elemental,48,20,28
Pórçé,shattered-hand,1529,shaman,elemental,234,125,109
Hotis,onyxia,1528,shaman,elemental,333,164,169
Milotem,ysondre,1528,shaman,elemental,84,38,46
Kønat,blackmoore,1528,shaman,elemental,42,19,23
Zest,hyjal,1528,shaman,elemental,81,35,46
Chrached,kargath,1527,shaman,elemental,42,21,21
Homesickx,blackrock,1526,shaman,elemental,53,28,25
Sházz,dun-modr,1524,shaman,elemental,94,46,48
Дестройбэйби,gordunni,1523,shaman,elemental,168,91,77
Zimtmann,teldrassil,1521,shaman,elemental,36,22,14
Chênoya,blackrock,1521,shaman,elemental,102,44,58
Индигула,soulflayer,1520,shaman,elemental,200,107,93
Uselesstwo,archimonde,1520,shaman,elemental,30,16,14
Navyblue,sylvanas,1518,shaman,elemental,48,24,24
Simppe,stormreaver,1518,shaman,elemental,102,50,52
Huyø,stormscale,1518,shaman,elemental,114,48,66
Amanishama,twisting-nether,1517,shaman,elemental,123,69,54
Maahm,dalaran,1514,shaman,elemental,79,42,37
Plebzgodxkto,nemesis,1513,shaman,elemental,49,29,20
Couldar,stormscale,1513,shaman,elemental,120,66,54
Zna,archimonde,1513,shaman,elemental,94,48,46
Shamanisme,twisting-nether,1511,shaman,elemental,62,32,30
Løun,archimonde,1511,shaman,elemental,108,54,54
Ulfax,argent-dawn,1509,shaman,elemental,118,57,61
Baarona,neptulon,1506,shaman,elemental,81,43,38
Balfalor,antonidas,1506,shaman,elemental,44,18,26
Тыщатристах,howling-fjord,1505,shaman,elemental,56,38,18
Sûckmytotem,ragnaros,1504,shaman,elemental,29,16,13
Obêlixx,blackmoore,1503,shaman,elemental,54,24,30
Deazypurge,blackrock,1502,shaman,elemental,36,22,14
Даринтор,gordunni,1501,shaman,elemental,95,49,46
Dawzed,hyjal,1500,shaman,elemental,110,60,50
Lêmberger,eredar,1498,shaman,elemental,60,34,26
Nuve,stormscale,1498,shaman,elemental,82,41,41
Boomfanboy,tarren-mill,1498,shaman,elemental,39,17,22
Nosno,ravencrest,1495,shaman,elemental,53,27,26
Shareed,zuluhed,1495,shaman,elemental,48,24,24
Vladraxes,draenor,1490,shaman,elemental,66,42,24
Ralokar,blackrock,1488,shaman,elemental,78,41,37
Gagné,hyjal,1487,shaman,elemental,32,17,15
Gomoth,kazzak,1486,shaman,elemental,36,20,16
Voltyum,zuljin,1485,shaman,elemental,139,60,79
Aesstras,hyjal,1482,shaman,elemental,85,44,41
Vallhur,burning-legion,1480,shaman,elemental,48,27,21
Haasshaman,ravencrest,1480,shaman,elemental,121,50,71
Eðualc,hyjal,1479,shaman,elemental,47,25,22
Тмх,ashenvale,1479,shaman,elemental,112,58,54
Agamo,silvermoon,1478,shaman,elemental,78,42,36
Shaakez,kazzak,1476,shaman,elemental,35,17,18
Ринфан,fordragon,1474,shaman,elemental,112,53,59
Сепич,gordunni,1473,shaman,elemental,84,49,35
Crazypop,outland,1472,shaman,elemental,36,19,17
Totemkahmun,kazzak,1472,shaman,elemental,57,27,30
Pomegranate,arthas,1471,shaman,elemental,78,31,47
Kankaku,sanguino,1468,shaman,elemental,48,23,25
Скиц,gordunni,1467,shaman,elemental,84,45,39
Shamatto,nemesis,1467,shaman,elemental,88,47,41
Mouraïne,eredar,1466,shaman,elemental,30,16,14
Xenødyl,argent-dawn,1465,shaman,elemental,64,33,31
Drshockit,blackrock,1463,shaman,elemental,26,17,9
Yang,der-rat-von-dalaran,1462,shaman,elemental,30,19,11
Bigrambo,draenor,1462,shaman,elemental,77,38,39
Zoomar,tarren-mill,1462,shaman,elemental,102,46,56
Rennji,argent-dawn,1461,shaman,elemental,161,78,83
Cleandann,stormscale,1461,shaman,elemental,88,42,46
Vulcainn,marécage-de-zangar,1460,shaman,elemental,105,68,37
Бурехлест,howling-fjord,1460,shaman,elemental,48,31,17
Fúth,ysondre,1459,shaman,elemental,70,35,35
Teccatwo,outland,1458,shaman,elemental,58,31,27
Maruno,stormscale,1457,shaman,elemental,83,44,39
Гексанол,soulflayer,1457,shaman,elemental,58,30,28
Cracklord,outland,1456,shaman,elemental,48,26,22
Olawizard,draenor,1456,shaman,elemental,161,84,77
Electronova,magtheridon,1455,shaman,elemental,131,63,68
Grimtol,magtheridon,1455,shaman,elemental,47,20,27
Гоэл,ashenvale,1454,shaman,elemental,30,19,11
Vulkân,silvermoon,1454,shaman,elemental,74,41,33
Шамвкроксах,gordunni,1454,shaman,elemental,60,30,30
Alwaysangry,silvermoon,1453,shaman,elemental,84,41,43
Essneces,burning-legion,1453,shaman,elemental,65,30,35
Ríleyx,twisting-nether,1451,shaman,elemental,89,57,32
Gorpdorp,ravencrest,1451,shaman,elemental,195,101,94
Kuzsham,archimonde,1450,shaman,elemental,87,50,37
Myngo,thrall,1447,shaman,elemental,48,25,23
Turbokrapka,tarren-mill,1447,shaman,elemental,70,25,45
Мэйзии,howling-fjord,1443,shaman,elemental,60,26,34
Coñfrico,tarren-mill,1442,shaman,elemental,87,44,43
Gandalito,haomarush,1442,shaman,elemental,36,18,18
Faeldar,sanguino,1441,shaman,elemental,109,52,57
Whome,aegwynn,1440,shaman,elemental,60,34,26
Lizoo,ravencrest,1439,shaman,elemental,18,15,3
Fugekiyogan,archimonde,1439,shaman,elemental,24,15,9
Dregú,draenor,1439,shaman,elemental,48,28,20
Hemradi,blackmoore,1438,shaman,elemental,48,28,20
Смоуктли,howling-fjord,1436,shaman,elemental,65,37,28
Realiz,ysondre,1436,shaman,elemental,46,25,21
Newsham,draenor,1436,shaman,elemental,36,15,21
Fleischer,stormscale,1436,shaman,elemental,36,15,21
Luchø,drakthul,1435,shaman,elemental,24,15,9
Kabà,aegwynn,1435,shaman,elemental,73,41,32
Ædshearan,blackmoore,1434,shaman,elemental,60,30,30
Pieski,stormscale,1433,shaman,elemental,30,15,15
Berusham,ravencrest,1433,shaman,elemental,91,45,46
Ашьф,gordunni,1433,shaman,elemental,39,17,22
Skrbkic,tarren-mill,1429,shaman,elemental,91,48,43
Клоуннашаме,gordunni,1428,shaman,elemental,67,39,28
Unangemessen,silvermoon,1428,shaman,elemental,112,63,49
Xalh,ysondre,1428,shaman,elemental,59,31,28
Hairypotter,rajaxx,1428,shaman,elemental,71,36,35
Tiborr,burning-legion,1427,shaman,elemental,24,15,9
Талиесин,grom,1425,shaman,elemental,82,48,34
Ulfuz,silvermoon,1425,shaman,elemental,34,18,16
Drækthør,thrall,1424,shaman,elemental,52,28,24
Highfaî,tarren-mill,1423,shaman,elemental,18,15,3
Альтегро,blackscar,1423,shaman,elemental,85,46,39
Parkroy,draenor,1422,shaman,elemental,30,19,11
Pakwa,drakthul,1420,shaman,elemental,46,22,24
Easyplay,kazzak,1420,shaman,elemental,37,16,21
Chøurøx,hyjal,1419,shaman,elemental,61,35,26
Konodíoda,nemesis,1419,shaman,elemental,50,21,29
Wulkanus,drakthul,1419,shaman,elemental,36,15,21
Alèks,forscherliga,1418,shaman,elemental,107,62,45
Pvpshaman,aszune,1418,shaman,elemental,41,20,21
Noyá,argent-dawn,1417,shaman,elemental,148,79,69
Magnetoe,ravencrest,1417,shaman,elemental,157,78,79
Sojee,ysondre,1417,shaman,elemental,118,58,60
Haarold,sylvanas,1415,shaman,elemental,30,15,15
Baxstarxz,stormscale,1415,shaman,elemental,30,15,15
Legended,tarren-mill,1415,shaman,elemental,30,15,15
Sunraiser,blackmoore,1412,shaman,elemental,103,57,46
Reburdacoxis,sanguino,1412,shaman,elemental,30,15,15
Healocalypse,azuremyst,1411,shaman,elemental,54,31,23
Azh,twisting-nether,1411,shaman,elemental,34,18,16
Smooz,silvermoon,1409,shaman,elemental,117,60,57
Бумбумпаузр,borean-tundra,1409,shaman,elemental,75,29,46
Lilyvanlit,outland,1408,shaman,elemental,30,19,11
Lampard,magtheridon,1407,shaman,elemental,35,19,16
Сосмыслом,howling-fjord,1407,shaman,elemental,96,48,48
Gensehaut,aegwynn,1407,shaman,elemental,48,22,26
Berzer,ragnaros,1406,shaman,elemental,30,15,15
Flubberman,blackrock,1405,shaman,elemental,62,32,30
Zanyun,burning-legion,1405,shaman,elemental,56,21,35
Ludo,lothar,1404,shaman,elemental,52,32,20
Файербурст,soulflayer,1404,shaman,elemental,48,26,22
Despérado,archimonde,1404,shaman,elemental,54,27,27
Torouk,rashgarroth,1402,shaman,elemental,96,47,49
Rekhtar,burning-legion,1401,shaman,elemental,163,89,74
Støya,archimonde,1400,shaman,elemental,48,18,30
Athul,theradras,1399,shaman,elemental,49,24,25
Urinja,outland,1397,shaman,elemental,72,40,32
Nolawii,ragnaros,1396,shaman,elemental,95,49,46
Märthalouise,twisting-nether,1396,shaman,elemental,35,18,17
Superkee,kazzak,1395,shaman,elemental,520,270,250
Guuguugaga,silvermoon,1394,shaman,elemental,34,20,14
Rharhahra,archimonde,1393,shaman,elemental,66,23,43
Rakzhaza,blackmoore,1387,shaman,elemental,88,45,43
Jönayy,dun-modr,1386,shaman,elemental,30,17,13
Djbruggìe,bloodhoof,1386,shaman,elemental,60,27,33
Jumbototem,tarren-mill,1385,shaman,elemental,90,56,34
Rohknar,ragnaros,1383,shaman,elemental,54,29,25
Pandamoniumm,moonglade,1383,shaman,elemental,42,21,21
Salvadr,zuljin,1383,shaman,elemental,33,15,18
Furrymane,blackmoore,1382,shaman,elemental,51,27,24
Лукаджун,howling-fjord,1380,shaman,elemental,24,17,7
Alfang,turalyon,1375,shaman,elemental,161,78,83
Anubisll,hyjal,1374,shaman,elemental,64,31,33
Bangou,archimonde,1372,shaman,elemental,156,79,77
Motorbreath,silvermoon,1372,shaman,elemental,211,103,108
Scot,blackhand,1369,shaman,elemental,107,53,54
Ragnadim,silvermoon,1368,shaman,elemental,42,15,27
Treizelol,ysondre,1367,shaman,elemental,66,40,26
Thordes,forscherliga,1367,shaman,elemental,73,28,45
Kimpa,minahonda,1366,shaman,elemental,90,49,41
Краоми,soulflayer,1365,shaman,elemental,42,24,18
Champïx,archimonde,1365,shaman,elemental,316,153,163
Xhahal,hyjal,1364,shaman,elemental,30,21,9
Enzain,outland,1361,shaman,elemental,38,22,16
Elshifotrem,throkferoth,1361,shaman,elemental,124,66,58
Apolomaeuz,frostwolf,1361,shaman,elemental,107,56,51
Whizjy,sanguino,1359,shaman,elemental,30,15,15
Novka,eredar,1358,shaman,elemental,89,43,46
Девлиниум,fordragon,1356,shaman,elemental,53,28,25
Shôcopan,los-errantes,1355,shaman,elemental,147,65,82
Утебяпожар,blackscar,1355,shaman,elemental,51,17,34
Monstermunch,ravencrest,1355,shaman,elemental,52,17,35
Ishokyou,thrall,1353,shaman,elemental,102,50,52
Руннольв,galakrond,1347,shaman,elemental,36,17,19
Carusø,thrall,1344,shaman,elemental,79,47,32
Zeúz,the-maelstrom,1341,shaman,elemental,18,14,4
Stíckíx,malganis,1341,shaman,elemental,22,15,7
Dreanar,ragnaros,1340,shaman,elemental,24,14,10
Alëxx,hyjal,1340,shaman,elemental,24,14,10
Charliiejoh,stormscale,1340,shaman,elemental,141,71,70
Itsallrng,stormscale,1340,shaman,elemental,30,14,16
Iddoz,outland,1339,shaman,elemental,30,14,16
Джуньбургерх,gordunni,1338,shaman,elemental,54,28,26
Крайфолл,gordunni,1337,shaman,elemental,71,48,23
Sshaasam,tarren-mill,1337,shaman,elemental,24,14,10
Sgf,stormscale,1336,shaman,elemental,193,94,99
Shamanns,lordaeron,1336,shaman,elemental,250,119,131
Nobrac,rajaxx,1336,shaman,elemental,30,14,16
Fâro,dun-modr,1335,shaman,elemental,41,18,23
Dreadness,runetotem,1331,shaman,elemental,31,14,17
Ong,anubarak,1330,shaman,elemental,34,23,11
Lechirurgien,elune,1330,shaman,elemental,246,125,121
Ankzul,exodar,1330,shaman,elemental,144,67,77
Xiomora,argent-dawn,1330,shaman,elemental,39,18,21
Tidetös,doomhammer,1329,shaman,elemental,30,17,13
Антиниеми,soulflayer,1329,shaman,elemental,54,21,33
Squirtstorm,ravencrest,1329,shaman,elemental,56,18,38
Шиока,borean-tundra,1328,shaman,elemental,42,24,18
Nerekiclej,ravencrest,1327,shaman,elemental,47,23,24
Ironbuttrfly,magtheridon,1326,shaman,elemental,48,27,21
Kirak,anetheron,1326,shaman,elemental,219,109,110
Screwd,defias-brotherhood,1325,shaman,elemental,75,41,34
Fosterzz,ravencrest,1322,shaman,elemental,51,27,24
Джанндис,booty-bay,1321,shaman,elemental,42,19,23
Tanjîrø,archimonde,1320,shaman,elemental,24,14,10
Elothar,earthen-ring,1319,shaman,elemental,24,14,10
Крто,thermaplugg,1319,shaman,elemental,245,129,116
Zalitz,sanguino,1317,shaman,elemental,103,56,47
Ananasen,eonar,1311,shaman,elemental,96,49,47
Yezu,medivh,1311,shaman,elemental,102,48,54
Zmech,chamber-of-aspects,1309,shaman,elemental,30,14,16
Kärdyo,archimonde,1309,shaman,elemental,35,14,21
Beven,stormscale,1308,shaman,elemental,42,17,25
Дваллинн,gordunni,1303,shaman,elemental,36,14,22
Vajinga,aerie-peak,1302,shaman,elemental,54,30,24
Glorfidel,turalyon,1302,shaman,elemental,167,80,87
Dahryana,azjolnerub,1302,shaman,elemental,42,20,22
Hboni,chamber-of-aspects,1299,shaman,elemental,30,15,15
Mív,outland,1297,shaman,elemental,75,35,40
Zham,kul-tiras,1297,shaman,elemental,54,22,32
Runetera,ravencrest,1296,shaman,elemental,23,17,6
Cudge,arathor,1296,shaman,elemental,24,14,10
Destructør,norgannon,1295,shaman,elemental,84,42,42
Umbraverfaa,twisting-nether,1294,shaman,elemental,48,26,22
Zbysiu,ravencrest,1292,shaman,elemental,105,56,49
Dropdattotem,stormscale,1292,shaman,elemental,54,23,31
Blancc,kazzak,1291,shaman,elemental,108,57,51
Chispa,darkmoon-faire,1291,shaman,elemental,59,29,30
Griins,ravencrest,1289,shaman,elemental,36,20,16
Shamíz,draenor,1287,shaman,elemental,87,49,38
Peaksh,stormscale,1287,shaman,elemental,36,16,20
Десперо,gordunni,1286,shaman,elemental,38,21,17
Saqerr,kazzak,1286,shaman,elemental,89,36,53
Brassefrasse,shattered-hand,1283,shaman,elemental,38,18,20
Tiamât,culte-de-la-rive-noire,1280,shaman,elemental,119,63,56
Tiqle,blackmoore,1279,shaman,elemental,131,64,67
Xfiles,garona,1278,shaman,elemental,48,24,24
Stoîc,stormscale,1277,shaman,elemental,42,14,28
Rhastafarian,stormscale,1276,shaman,elemental,42,20,22
Djent,outland,1276,shaman,elemental,42,19,23
Pharmie,ravencrest,1274,shaman,elemental,23,14,9
Xesti,twisting-nether,1274,shaman,elemental,187,95,92
Gameblast,thunderhorn,1273,shaman,elemental,46,28,18
Denadrios,blackhand,1273,shaman,elemental,172,81,91
Totempoo,the-maelstrom,1272,shaman,elemental,36,19,17
Unding,azshara,1272,shaman,elemental,66,20,46
Саг,gordunni,1269,shaman,elemental,54,23,31
Zakuun,kazzak,1267,shaman,elemental,44,14,30
Raigetsu,kazzak,1263,shaman,elemental,68,34,34
Tehpielover,bladefist,1262,shaman,elemental,46,24,22
Штормбайт,azuregos,1258,shaman,elemental,30,17,13
Флоррэт,gordunni,1258,shaman,elemental,253,116,137
Élémentyum,archimonde,1258,shaman,elemental,66,28,38
Leash,blackmoore,1257,shaman,elemental,30,14,16
Chouppi,la-croisade-écarlate,1257,shaman,elemental,48,15,33
Цет,soulflayer,1255,shaman,elemental,23,15,8
Mynutz,outland,1255,shaman,elemental,54,18,36
Mosterx,stormscale,1252,shaman,elemental,30,18,12
Oprawinfury,ravencrest,1250,shaman,elemental,35,15,20
Asiorr,silvermoon,1250,shaman,elemental,41,15,26
Jagblade,neptulon,1249,shaman,elemental,88,49,39
Ðãvê,veknilash,1249,shaman,elemental,44,19,25
Сарцек,howling-fjord,1248,shaman,elemental,90,50,40
Iicks,blackrock,1248,shaman,elemental,90,45,45
Формацепт,ashenvale,1248,shaman,elemental,103,49,54
Blackyx,dun-modr,1247,shaman,elemental,18,13,5
Billburr,aegwynn,1247,shaman,elemental,27,14,13
Dòrfy,silvermoon,1247,shaman,elemental,30,13,17
Kelvok,silvermoon,1246,shaman,elemental,24,13,11
Джохарион,deathguard,1244,shaman,elemental,66,28,38
Камам,gordunni,1243,shaman,elemental,66,28,38
Shangy,blackrock,1243,shaman,elemental,42,13,29
Levarázsol,outland,1242,shaman,elemental,30,13,17
Волгоградка,soulflayer,1242,shaman,elemental,30,13,17
Lexxthree,blackrock,1241,shaman,elemental,18,13,5
Maggoshishi,blackmoore,1241,shaman,elemental,176,90,86
Djogg,sunstrider,1241,shaman,elemental,30,13,17
Mélb,eredar,1240,shaman,elemental,60,30,30
Zerak,twisting-nether,1238,shaman,elemental,24,13,11
Pawsh,dun-modr,1238,shaman,elemental,51,24,27
Makgoa,ysondre,1237,shaman,elemental,18,13,5
Меменосный,gordunni,1237,shaman,elemental,65,32,33
Orcmain,turalyon,1237,shaman,elemental,36,13,23
Shkook,archimonde,1236,shaman,elemental,42,14,28
Dðt,stormscale,1234,shaman,elemental,167,85,82
Zerodown,outland,1234,shaman,elemental,186,92,94
Zëngä,outland,1231,shaman,elemental,24,13,11
Ägornot,kazzak,1230,shaman,elemental,33,14,19
Khayac,ravencrest,1229,shaman,elemental,30,13,17
Magath,nethersturm,1228,shaman,elemental,76,38,38
Slushï,argent-dawn,1226,shaman,elemental,53,17,36
Эгриок,howling-fjord,1225,shaman,elemental,30,16,14
Maino,archimonde,1223,shaman,elemental,117,61,56
Xtatenea,uldum,1223,shaman,elemental,148,76,72
Malkabaserka,draenor,1222,shaman,elemental,54,26,28
Bigheal,quelthalas,1222,shaman,elemental,30,13,17
Waterboi,blackmoore,1219,shaman,elemental,24,13,11
Foxxyluv,stormscale,1215,shaman,elemental,20,14,6
Ххенеси,soulflayer,1215,shaman,elemental,42,19,23
Quizx,blackrock,1215,shaman,elemental,66,27,39
Тагтар,howling-fjord,1213,shaman,elemental,75,26,49
Dando,silvermoon,1212,shaman,elemental,36,16,20
Lukyjos,drakthul,1210,shaman,elemental,30,16,14
Hatyatya,ragnaros,1210,shaman,elemental,76,38,38
Atixz,blackmoore,1209,shaman,elemental,30,13,17
Akimboo,kilrogg,1208,shaman,elemental,54,26,28
Skeiilz,hyjal,1208,shaman,elemental,36,13,23
Roxìe,blackmoore,1207,shaman,elemental,18,13,5
Teslasenpai,outland,1207,shaman,elemental,94,33,61
Onlyfansmod,uldum,1204,shaman,elemental,99,42,57
Practicetwo,argent-dawn,1204,shaman,elemental,36,14,22
Ózyy,draenor,1202,shaman,elemental,18,13,5
Damntrolls,blackmoore,1198,shaman,elemental,28,13,15
Elementhero,frostmane,1196,shaman,elemental,48,21,27
Pararrayøs,sanguino,1192,shaman,elemental,61,28,33
Boxo,frostwolf,1191,shaman,elemental,124,67,57
Shellex,kazzak,1190,shaman,elemental,213,110,103
Zjindi,shattered-hand,1190,shaman,elemental,30,15,15
Valdera,dun-morogh,1189,shaman,elemental,24,14,10
Derblitz,baelgun,1189,shaman,elemental,42,21,21
Sniffa,ysondre,1187,shaman,elemental,42,20,22
Strife,argent-dawn,1185,shaman,elemental,54,23,31
Syris,sinstralis,1185,shaman,elemental,42,17,25
Coton,grim-batol,1184,shaman,elemental,36,21,15
Mòra,silvermoon,1184,shaman,elemental,74,35,39
Zapper,blackrock,1184,shaman,elemental,69,28,41
Räoûn,archimonde,1179,shaman,elemental,80,34,46
Lavalampa,magtheridon,1177,shaman,elemental,72,42,30
Ragash,shattered-halls,1177,shaman,elemental,51,25,26
Amarök,nerzhul,1177,shaman,elemental,65,30,35
Stoned,sporeggar,1177,shaman,elemental,59,25,34
Szvapotluk,ravencrest,1173,shaman,elemental,30,14,16
Nabo,archimonde,1173,shaman,elemental,32,13,19
Thokul,defias-brotherhood,1169,shaman,elemental,24,14,10
Bramùs,blackmoore,1168,shaman,elemental,60,24,36
Zhinjo,kazzak,1166,shaman,elemental,36,19,17
Blackmuamba,tarren-mill,1164,shaman,elemental,213,107,106
Nagyrakéta,ragnaros,1164,shaman,elemental,48,16,32
Thrallotido,sanguino,1163,shaman,elemental,66,23,43
Фистинктотем,soulflayer,1162,shaman,elemental,35,16,19
Амброски,gordunni,1161,shaman,elemental,42,28,14
Kungfuali,antonidas,1161,shaman,elemental,226,107,119
Narkizza,silvermoon,1158,shaman,elemental,110,47,63
Bigboisham,outland,1158,shaman,elemental,82,35,47
Thunderstryk,sylvanas,1157,shaman,elemental,66,35,31
Teslacoil,stormreaver,1156,shaman,elemental,60,34,26
Elemane,kazzak,1152,shaman,elemental,18,12,6
Azmerloth,outland,1152,shaman,elemental,18,12,6
Gschmack,blackrock,1151,shaman,elemental,24,12,12
Neverplayele,kazzak,1151,shaman,elemental,24,12,12
Дудивтф,soulflayer,1151,shaman,elemental,24,12,12
Amuñ,hyjal,1150,shaman,elemental,18,12,6
Pedrototem,silvermoon,1149,shaman,elemental,42,28,14
Fimir,archimonde,1149,shaman,elemental,24,15,9
Эфирад,blackscar,1148,shaman,elemental,204,99,105
Justweirdaf,blackmoore,1148,shaman,elemental,45,20,25
Eustodia,minahonda,1146,shaman,elemental,18,14,4
Дзод,deathweaver,1146,shaman,elemental,24,12,12
Nebean,ragnaros,1146,shaman,elemental,24,12,12
Skullføck,argent-dawn,1145,shaman,elemental,24,12,12
Screwz,archimonde,1145,shaman,elemental,119,51,68
Socesalade,ysondre,1144,shaman,elemental,24,12,12
Hekzen,tarren-mill,1143,shaman,elemental,27,13,14
Shamwowpow,stormscale,1142,shaman,elemental,30,12,18
Khanokekw,twisting-nether,1141,shaman,elemental,30,12,18
Zandali,tarren-mill,1139,shaman,elemental,43,24,19
Zuman,the-maelstrom,1138,shaman,elemental,36,19,17
Groundedx,ravencrest,1136,shaman,elemental,24,12,12
Mohàwk,eredar,1135,shaman,elemental,96,48,48
Freizeitler,antonidas,1135,shaman,elemental,30,12,18
Zhid,zuljin,1135,shaman,elemental,36,12,24
Bahuq,antonidas,1134,shaman,elemental,18,12,6
Натуралист,galakrond,1130,shaman,elemental,30,12,18
Thunderrbob,darkspear,1129,shaman,elemental,43,25,18
Вайтиту,howling-fjord,1127,shaman,elemental,45,15,30
Yaar,alleria,1126,shaman,elemental,36,22,14
Scurvy,malganis,1126,shaman,elemental,228,113,115
Saarroo,ravencrest,1126,shaman,elemental,60,25,35
Avarela,argent-dawn,1121,shaman,elemental,101,44,57
Bowtenstorm,ravencrest,1120,shaman,elemental,25,16,9
Apád,ragnaros,1120,shaman,elemental,24,12,12
Goromar,kirin-tor,1116,shaman,elemental,145,67,78
Moilensis,archimonde,1116,shaman,elemental,36,13,23
Smohallah,naxxramas,1108,shaman,elemental,72,30,42
Gnark,dun-modr,1105,shaman,elemental,59,32,27
Aslakki,turalyon,1099,shaman,elemental,128,56,72
Yasaburo,silvermoon,1097,shaman,elemental,29,15,14
Thordahr,hyjal,1091,shaman,elemental,24,12,12
Kneggebrot,blackmoore,1090,shaman,elemental,27,13,14
Earthvixenz,ravencrest,1089,shaman,elemental,29,18,11
Grommalgue,hyjal,1089,shaman,elemental,40,19,21
Fûchsí,blackhand,1086,shaman,elemental,77,40,37
Hardsmoker,antonidas,1086,shaman,elemental,102,38,64
Drocthar,defias-brotherhood,1080,shaman,elemental,98,49,49
Hugzy,argent-dawn,1075,shaman,elemental,72,42,30
Озверею,goldrinn,1075,shaman,elemental,72,37,35
Allfathêr,ragnaros,1072,shaman,elemental,36,14,22
Glenfinnan,pozzo-delleternità,1070,shaman,elemental,27,13,14
Poppelo,silvermoon,1068,shaman,elemental,26,12,14
Фоксняша,soulflayer,1067,shaman,elemental,43,21,22
Fàkecast,outland,1064,shaman,elemental,34,12,22
Бвансамдив,gordunni,1063,shaman,elemental,74,33,41
Procdaddy,eredar,1063,shaman,elemental,56,15,41
Drekthor,ulduar,1062,shaman,elemental,55,29,26
Vatrios,draenor,1062,shaman,elemental,48,20,28
Garythos,drakthul,1056,shaman,elemental,18,11,7
Chirmani,blackrock,1055,shaman,elemental,12,11,1
Cakedeux,grim-batol,1055,shaman,elemental,27,13,14
Drýtón,blackrock,1055,shaman,elemental,24,11,13
Lekthar,draenor,1055,shaman,elemental,24,11,13
Supersham,ragnaros,1055,shaman,elemental,30,11,19
Furthehorde,frostmane,1054,shaman,elemental,18,11,7
Zënga,kazzak,1053,shaman,elemental,18,11,7
Yraxara,draenor,1053,shaman,elemental,18,11,7
Èrò,blackhand,1053,shaman,elemental,24,11,13
Kiirø,ysondre,1052,shaman,elemental,94,48,46
Элвандер,howling-fjord,1052,shaman,elemental,24,11,13
Trastamar,dun-modr,1051,shaman,elemental,18,11,7
Штрайхен,blackscar,1051,shaman,elemental,24,11,13
Shamoga,kazzak,1050,shaman,elemental,12,11,1
Фанковарнесы,gordunni,1049,shaman,elemental,18,11,7
Louler,ragnaros,1049,shaman,elemental,24,11,13
Catatumbø,cthun,1049,shaman,elemental,24,11,13
Shamix,magtheridon,1049,shaman,elemental,32,11,21
Kylas,die-ewige-wacht,1047,shaman,elemental,18,11,7
Flork,burning-legion,1047,shaman,elemental,87,39,48
Frostshøck,tarren-mill,1046,shaman,elemental,18,11,7
Schockbunny,blackrock,1046,shaman,elemental,30,11,19
Ofqds,archimonde,1044,shaman,elemental,24,11,13
Эртирон,howling-fjord,1044,shaman,elemental,24,11,13
Terras,terokkar,1044,shaman,elemental,53,15,38
Tpainx,kazzak,1043,shaman,elemental,24,11,13
Смогр,gordunni,1042,shaman,elemental,36,11,25
Trosy,burning-blade,1041,shaman,elemental,36,18,18
Дрекрош,howling-fjord,1037,shaman,elemental,210,96,114
Bluéshirtguy,blackhand,1036,shaman,elemental,123,61,62
Deviantsham,tarren-mill,1034,shaman,elemental,72,35,37
Laquium,blackmoore,1032,shaman,elemental,37,15,22
Ormanthep,hyjal,1029,shaman,elemental,18,11,7
Элемшамм,soulflayer,1029,shaman,elemental,49,26,23
Flochy,argent-dawn,1027,shaman,elemental,53,31,22
Бородарастт,gordunni,1027,shaman,elemental,71,29,42
Naedom,aggramar,1024,shaman,elemental,30,11,19
Ximid,doomhammer,1018,shaman,elemental,224,112,112
Sevk,ravencrest,1012,shaman,elemental,30,15,15
Loserlol,das-syndikat,1009,shaman,elemental,83,40,43
Beefnale,bladefist,1009,shaman,elemental,78,26,52
Naix,silvermoon,1009,shaman,elemental,36,11,25
Турелька,blackscar,1008,shaman,elemental,37,14,23
Nehehehehehe,drakthul,1007,shaman,elemental,21,11,10
Azovprime,terokkar,1007,shaman,elemental,24,11,13
Гленкуллен,blackscar,1006,shaman,elemental,72,32,40
Dawop,ravencrest,1004,shaman,elemental,23,11,12
Itsnasty,blackmoore,1004,shaman,elemental,42,20,22
Demelena,silvermoon,1003,shaman,elemental,18,11,7
Mecct,ravencrest,984,shaman,elemental,28,11,17
Thatamazing,korgall,979,shaman,elemental,32,15,17
Велгур,soulflayer,979,shaman,elemental,54,23,31
Федосик,galakrond,975,shaman,elemental,130,65,65
Kcarlina,uldum,973,shaman,elemental,40,20,20
Raikton,pozzo-delleternità,971,shaman,elemental,106,44,62
Mimbar,thunderhorn,968,shaman,elemental,36,18,18
Lavadrak,eredar,960,shaman,elemental,12,10,2
Näis,hyjal,960,shaman,elemental,18,10,8
Elemayó,tarren-mill,960,shaman,elemental,18,10,8
Strór,twisting-nether,960,shaman,elemental,18,10,8
Weåfy,outland,960,shaman,elemental,18,10,8
Dshaman,aegwynn,960,shaman,elemental,24,10,14
Seyumi,draenor,960,shaman,elemental,24,10,14
Lovelyshaman,silvermoon,959,shaman,elemental,13,10,3
Bhargonen,silvermoon,959,shaman,elemental,18,10,8
Hunteronpc,twisting-nether,959,shaman,elemental,18,10,8
Лучшийшаман,soulflayer,959,shaman,elemental,18,10,8
Thundergødx,nemesis,959,shaman,elemental,24,10,14
Айбьорн,gordunni,959,shaman,elemental,24,10,14
Blover,drakthul,958,shaman,elemental,12,10,2
Rokils,silvermoon,958,shaman,elemental,18,10,8
Rockstéady,outland,958,shaman,elemental,18,10,8
Имсомниум,howling-fjord,958,shaman,elemental,30,10,20
Raïgo,hyjal,957,shaman,elemental,18,10,8
Jazzrod,stormscale,957,shaman,elemental,24,10,14
Atuaßëlha,grim-batol,957,shaman,elemental,24,10,14
Гидрокорыто,gordunni,956,shaman,elemental,18,10,8
Rizorx,stormscale,956,shaman,elemental,21,11,10
Drahka,kazzak,955,shaman,elemental,24,10,14
Klunkespiser,stormscale,955,shaman,elemental,30,10,20
Магмарончик,gordunni,953,shaman,elemental,78,27,51
Beastee,blackmoore,952,shaman,elemental,18,10,8
Aljorf,dun-modr,952,shaman,elemental,30,16,14
Jólla,twisting-nether,952,shaman,elemental,24,10,14
Hevercraft,archimonde,951,shaman,elemental,18,10,8
Sixinchwilly,outland,951,shaman,elemental,24,10,14
Schockolade,blackmoore,951,shaman,elemental,24,10,14
Quartodebue,nemesis,951,shaman,elemental,27,11,16
Chilliajin,tarren-mill,950,shaman,elemental,24,10,14
Kobeye,thrall,949,shaman,elemental,70,36,34
Babathar,ysondre,949,shaman,elemental,24,10,14
Блэкмаршал,howling-fjord,948,shaman,elemental,30,10,20
Rôhâr,stormscale,947,shaman,elemental,18,10,8
Nïà,kaelthas,946,shaman,elemental,56,20,36
Шейпан,gordunni,944,shaman,elemental,74,36,38
Oddsocks,stormscale,939,shaman,elemental,99,37,62
Óõ,dun-modr,938,shaman,elemental,18,10,8
Gotrex,pozzo-delleternità,937,shaman,elemental,48,10,38
Rãgnãr,frostwolf,935,shaman,elemental,37,16,21
Watson,conseil-des-ombres,934,shaman,elemental,36,15,21
Louisvgaal,kazzak,934,shaman,elemental,24,10,14
Smorcxx,kazzak,934,shaman,elemental,30,10,20
Orishimaru,blackrock,932,shaman,elemental,23,10,13
Especialista,uldum,931,shaman,elemental,29,16,13
Dëlkö,ravencrest,928,shaman,elemental,121,54,67
Kushme,silvermoon,927,shaman,elemental,66,29,37
Jiaan,burning-legion,925,shaman,elemental,40,16,24
Kortgat,kilrogg,924,shaman,elemental,48,23,25
Yukîmøn,hyjal,923,shaman,elemental,20,11,9
Бернтутрэп,soulflayer,919,shaman,elemental,29,10,19
Capslk,blackmoore,893,shaman,elemental,26,10,16
Garbushka,draenor,883,shaman,elemental,54,17,37
Cimbel,stormscale,880,shaman,elemental,13,10,3
Encourager,daggerspine,878,shaman,elemental,34,19,15
Соленый,booty-bay,877,shaman,elemental,152,70,82
Cloudborne,draenor,876,shaman,elemental,19,10,9
Captaînhuge,dunemaul,864,shaman,elemental,12,9,3
Jeelypink,dalaran,864,shaman,elemental,12,9,3
ßaraky,kazzak,864,shaman,elemental,12,9,3
Jaimê,ravencrest,864,shaman,elemental,18,9,9
Elvalya,archimonde,864,shaman,elemental,18,9,9
Lighttfeet,hyjal,864,shaman,elemental,18,9,9
Høtgødx,blackrock,864,shaman,elemental,19,9,10
Terobux,culte-de-la-rive-noire,864,shaman,elemental,24,9,15
Buzz,stormscale,864,shaman,elemental,24,9,15
Bammë,archimonde,863,shaman,elemental,18,9,9
Muertin,tarren-mill,863,shaman,elemental,18,9,9
Madeej,burning-legion,863,shaman,elemental,18,9,9
Luzzilol,garrosh,863,shaman,elemental,18,9,9
Рояльстарик,howling-fjord,863,shaman,elemental,18,9,9
Terranator,sanguino,863,shaman,elemental,18,9,9
Satudarah,draenor,863,shaman,elemental,18,9,9
Dûmah,sanguino,863,shaman,elemental,25,10,15
Тайорн,howling-fjord,863,shaman,elemental,24,9,15
Kyraw,tarren-mill,863,shaman,elemental,24,9,15
Strypsnare,auchindoun,862,shaman,elemental,18,9,9
Eyowassup,ragnaros,862,shaman,elemental,18,9,9
Oroastbeef,archimonde,862,shaman,elemental,18,9,9
Рэйвантотем,soulflayer,862,shaman,elemental,18,9,9
Shammehboi,auchindoun,862,shaman,elemental,21,10,11
Stormzug,twisting-nether,862,shaman,elemental,24,9,15
Bunnz,kazzak,861,shaman,elemental,12,9,3
Sopos,ragnaros,861,shaman,elemental,18,9,9
Fholst,draenor,861,shaman,elemental,18,9,9
Blixtnedslag,shattered-hand,861,shaman,elemental,24,9,15
Ærö,outland,860,shaman,elemental,30,9,21
Текка,fordragon,859,shaman,elemental,24,9,15
Shamandeadly,aggra-português,858,shaman,elemental,18,9,9
Hóonda,twisting-nether,858,shaman,elemental,18,9,9
Undae,ravencrest,858,shaman,elemental,24,9,15
Zaappyboii,azjolnerub,857,shaman,elemental,26,9,17
Hanumanas,kazzak,856,shaman,elemental,18,9,9
Taboune,illidan,854,shaman,elemental,18,9,9
Милыйдорогой,soulflayer,853,shaman,elemental,24,9,15
Proteasom,burning-legion,847,shaman,elemental,15,11,4
Бронзород,grom,840,shaman,elemental,12,9,3
Slk,blackrock,839,shaman,elemental,18,9,9
Незнаком,booty-bay,834,shaman,elemental,42,19,23
Fheng,defias-brotherhood,826,shaman,elemental,17,9,8
Grambozz,blackrock,825,shaman,elemental,16,9,7
Kíá,silvermoon,821,shaman,elemental,30,10,20
Lavaburstx,antonidas,810,shaman,elemental,28,10,18
Hothex,tarren-mill,809,shaman,elemental,38,13,25
Teleio,blackhand,807,shaman,elemental,29,11,18
Hästdvärg,the-maelstrom,807,shaman,elemental,27,10,17
Holdafstand,tarren-mill,798,shaman,elemental,14,9,5
Samlik,antonidas,796,shaman,elemental,39,10,29
Pappashaman,tarren-mill,768,shaman,elemental,10,9,1
Lakanukie,thrall,768,shaman,elemental,12,8,4
Flam,outland,768,shaman,elemental,12,8,4
Imtwelvebtw,blackrock,768,shaman,elemental,12,8,4
Vygak,tarren-mill,768,shaman,elemental,12,8,4
Cöökiekeeper,twisting-nether,768,shaman,elemental,12,8,4
Yerlas,burning-legion,768,shaman,elemental,12,8,4
Rhonix,blackmoore,768,shaman,elemental,12,8,4
Palpazerr,archimonde,768,shaman,elemental,12,8,4
Idwala,outland,768,shaman,elemental,12,8,4
Bobobygunz,stormscale,768,shaman,elemental,12,8,4
Indeed,frostmourne,768,shaman,elemental,12,8,4
Gødsplan,tarren-mill,768,shaman,elemental,12,8,4
Lilioz,ysondre,768,shaman,elemental,12,8,4
Kónjo,kazzak,768,shaman,elemental,18,8,10
Shockleted,stormscale,768,shaman,elemental,18,8,10
Gravépàct,blackrock,768,shaman,elemental,18,8,10
Momine,stormscale,768,shaman,elemental,18,8,10
Schamistyle,blackhand,768,shaman,elemental,18,8,10
Twinshock,tarren-mill,768,shaman,elemental,18,8,10
Vix,argent-dawn,768,shaman,elemental,18,8,10
Totemly,alakir,768,shaman,elemental,18,8,10
Lathisi,zenedar,768,shaman,elemental,19,8,11
Thorunir,sylvanas,768,shaman,elemental,24,8,16
Clickerboy,ravencrest,768,shaman,elemental,24,8,16
Shámanos,sylvanas,767,shaman,elemental,12,8,4
Hobblefoot,stormscale,767,shaman,elemental,12,8,4
Bourdieu,thrall,767,shaman,elemental,12,8,4
Minimalist,stormscale,767,shaman,elemental,12,8,4
Kroit,stormreaver,767,shaman,elemental,12,8,4
Чаапалах,blackscar,767,shaman,elemental,12,8,4
Shamvareja,silvermoon,767,shaman,elemental,15,9,6
Darkterrors,dun-modr,767,shaman,elemental,16,9,7
Thunderdrak,sylvanas,767,shaman,elemental,17,8,9
Stonetone,silvermoon,767,shaman,elemental,18,8,10
Pìlle,eredar,767,shaman,elemental,18,8,10
Renegad,archimonde,767,shaman,elemental,24,8,16
Вервольфоо,howling-fjord,767,shaman,elemental,24,8,16
Gaerth,aggramar,766,shaman,elemental,12,8,4
Forrak,argent-dawn,766,shaman,elemental,18,8,10
Mystico,sanguino,766,shaman,elemental,18,8,10
Talg,defias-brotherhood,766,shaman,elemental,21,8,13
Kossborax,blackhand,766,shaman,elemental,24,8,16
Parthon,ravencrest,765,shaman,elemental,12,8,4
Jollyhip,stormscale,765,shaman,elemental,12,8,4
Remkoo,blackrock,765,shaman,elemental,18,8,10
Khaleeya,blackmoore,765,shaman,elemental,24,8,16
Purgérkíng,silvermoon,764,shaman,elemental,18,8,10
Hexlettin,twisting-nether,763,shaman,elemental,18,8,10
Brryantblaks,colinas-pardas,763,shaman,elemental,23,10,13
Arabesk,arygos,763,shaman,elemental,24,9,15
Sugarsham,kazzak,763,shaman,elemental,24,8,16
Fourtwogodx,kazzak,735,shaman,elemental,20,9,11
Jessijames,outland,733,shaman,elemental,35,8,27
Vikingss,frostmane,722,shaman,elemental,17,8,9
Gàtsby,archimonde,713,shaman,elemental,20,9,11
Reivhyl,magtheridon,704,shaman,elemental,10,8,2
Wacomtablet,kazzak,703,shaman,elemental,11,8,3
Baschúrr,blackrock,702,shaman,elemental,17,9,8
Filiduttsham,ravencrest,672,shaman,elemental,12,7,5
Bigblué,tarren-mill,672,shaman,elemental,12,7,5
Bonsaigodx,twisting-nether,672,shaman,elemental,12,7,5
Kæde,dun-morogh,672,shaman,elemental,12,7,5
Suldarissha,aegwynn,672,shaman,elemental,12,7,5
Dareos,anetheron,672,shaman,elemental,12,7,5
Eneru,nemesis,672,shaman,elemental,12,7,5
Shamandoino,wildhammer,672,shaman,elemental,12,7,5
Wamah,sargeras,672,shaman,elemental,12,7,5
Бахмара,soulflayer,672,shaman,elemental,12,7,5
Windberg,ysondre,672,shaman,elemental,12,7,5
Mogzu,blackmoore,672,shaman,elemental,12,7,5
Bharr,kazzak,672,shaman,elemental,12,7,5
Labûche,chogall,672,shaman,elemental,12,7,5
Thunderman,the-maelstrom,672,shaman,elemental,12,7,5
Robcurly,blackmoore,672,shaman,elemental,12,7,5
Brennokk,the-maelstrom,672,shaman,elemental,12,7,5
Гарбаджи,galakrond,672,shaman,elemental,12,7,5
Shamerific,magtheridon,672,shaman,elemental,12,7,5
Bosslikex,ravencrest,672,shaman,elemental,12,7,5
Dynamodanny,blackmoore,672,shaman,elemental,12,7,5
Guccifootjob,defias-brotherhood,672,shaman,elemental,12,7,5
Экспатриот,greymane,672,shaman,elemental,12,7,5
Dócshock,blackmoore,672,shaman,elemental,12,7,5
Endry,elune,672,shaman,elemental,18,7,11
Шлолка,gordunni,672,shaman,elemental,18,7,11
Reäz,archimonde,672,shaman,elemental,18,7,11
Rexonaone,silvermoon,672,shaman,elemental,18,7,11
Blakelivelyx,blackrock,672,shaman,elemental,18,7,11
Caro,tarren-mill,672,shaman,elemental,18,7,11
Paidactor,kazzak,672,shaman,elemental,18,7,11
Velkin,thrall,672,shaman,elemental,18,7,11
Боузета,soulflayer,672,shaman,elemental,24,7,17
Феномх,deathguard,671,shaman,elemental,12,7,5
Санрэйн,soulflayer,671,shaman,elemental,12,7,5
Rakamakafu,blackmoore,671,shaman,elemental,12,7,5
Vukroth,argent-dawn,671,shaman,elemental,12,7,5
Stephbäck,outland,671,shaman,elemental,18,7,11
Thunberg,ravencrest,671,shaman,elemental,18,7,11
Dogfrog,silvermoon,671,shaman,elemental,18,7,11
Lethal,darksorrow,671,shaman,elemental,18,7,11
Berzærker,ravencrest,671,shaman,elemental,24,7,17
Symy,draenor,670,shaman,elemental,12,7,5
Рокутаро,gordunni,670,shaman,elemental,12,7,5
Raoult,ravencrest,670,shaman,elemental,18,7,11
Layonne,ysondre,670,shaman,elemental,18,7,11
Carakh,archimonde,669,shaman,elemental,12,7,5
Jinbao,ravencrest,669,shaman,elemental,12,7,5
Интендо,soulflayer,668,shaman,elemental,12,7,5
Дбр,howling-fjord,667,shaman,elemental,18,7,11
Furian,die-nachtwache,666,shaman,elemental,12,7,5
Eratore,xavius,666,shaman,elemental,18,7,11
Zarakuda,magtheridon,663,shaman,elemental,34,9,25
Toxicnux,nemesis,655,shaman,elemental,17,7,10
Крузмвп,blackscar,655,shaman,elemental,23,7,16
Blyátmán,twisting-nether,638,shaman,elemental,14,8,6
Magmamartin,antonidas,638,shaman,elemental,23,7,16
Yalac,archimonde,637,shaman,elemental,14,8,6
Precíous,sporeggar,637,shaman,elemental,17,7,10
Lowhpqt,blackrock,623,shaman,elemental,11,7,4
Kbds,outland,623,shaman,elemental,17,7,10
Вудвин,soulflayer,621,shaman,elemental,26,7,19
Feumble,archimonde,618,shaman,elemental,36,8,28
Sijpetetmort,ysondre,610,shaman,elemental,29,8,21
Кубадуба,blackscar,607,shaman,elemental,20,7,13
Wurstblinker,ravencrest,606,shaman,elemental,11,7,4
Убицатысячи,soulflayer,576,shaman,elemental,6,6,0
Elfenomeno,archimonde,576,shaman,elemental,6,6,0
Lavelover,tarren-mill,576,shaman,elemental,6,6,0
Хексвглаз,howling-fjord,576,shaman,elemental,6,6,0
Shoewalker,ragnaros,576,shaman,elemental,12,6,6
Pflöckli,blackmoore,576,shaman,elemental,12,6,6
Shayal,defias-brotherhood,576,shaman,elemental,12,6,6
Есю,howling-fjord,576,shaman,elemental,12,6,6
Eddiemorphin,kazzak,576,shaman,elemental,12,6,6
Localicious,ragnaros,576,shaman,elemental,12,6,6
Tonifo,nemesis,576,shaman,elemental,12,6,6
Ugáa,malganis,576,shaman,elemental,12,6,6
Windfúhrèr,tarren-mill,576,shaman,elemental,12,6,6
Yzeldan,hyjal,576,shaman,elemental,12,6,6
ßlinky,outland,576,shaman,elemental,12,6,6
Jíkkz,aegwynn,576,shaman,elemental,12,6,6
Brandiløve,nemesis,576,shaman,elemental,12,6,6
Веег,deathweaver,576,shaman,elemental,12,6,6
Kilnih,archimonde,576,shaman,elemental,12,6,6
Cendrør,hyjal,576,shaman,elemental,12,6,6
Thomz,aggra-português,576,shaman,elemental,12,6,6
Пакни,gordunni,576,shaman,elemental,12,6,6
Chocshock,tarren-mill,576,shaman,elemental,12,6,6
Дагод,booty-bay,576,shaman,elemental,12,6,6
Linshock,tarren-mill,576,shaman,elemental,12,6,6
Elemefayoh,tarren-mill,576,shaman,elemental,12,6,6
Shamanirl,tarren-mill,576,shaman,elemental,12,6,6
Inyra,eredar,576,shaman,elemental,18,6,12
Харно,gordunni,576,shaman,elemental,18,6,12
Mûhzala,blackmoore,576,shaman,elemental,18,6,12
Chenoyaa,blackrock,576,shaman,elemental,18,6,12
Horokeu,blackrock,576,shaman,elemental,18,6,12
Хыйь,howling-fjord,576,shaman,elemental,18,6,12
Elchivo,blackrock,576,shaman,elemental,18,6,12
Krakatoa,dunemaul,576,shaman,elemental,24,6,18
Dobär,madmortem,575,shaman,elemental,12,6,6
Magraith,korgall,575,shaman,elemental,12,6,6
Tholdrin,outland,575,shaman,elemental,12,6,6
Shlby,blackrock,575,shaman,elemental,12,6,6
Hardleft,stormscale,575,shaman,elemental,12,6,6
Zulululul,burning-blade,575,shaman,elemental,12,6,6
Sparkybeard,ravencrest,575,shaman,elemental,12,6,6
Скромнюля,eversong,575,shaman,elemental,12,6,6
Helloitsmee,thrall,575,shaman,elemental,12,6,6
Syndia,das-konsortium,575,shaman,elemental,12,6,6
Shockbestie,eredar,575,shaman,elemental,13,6,7
Wíndu,zuljin,575,shaman,elemental,21,7,14
Téwa,hyjal,575,shaman,elemental,18,6,12
Varthon,tarren-mill,575,shaman,elemental,28,7,21
Nurychic,twisting-nether,574,shaman,elemental,12,6,6
Tiâna,archimonde,574,shaman,elemental,12,6,6
Grimrieper,stormscale,574,shaman,elemental,12,6,6
Yeah,emeriss,574,shaman,elemental,18,6,12
Shachira,silvermoon,571,shaman,elemental,12,6,6
Attm,twisting-nether,570,shaman,elemental,20,10,10
Disharmony,outland,554,shaman,elemental,17,8,9
Isheartears,outland,543,shaman,elemental,11,6,5
Saintlyjin,kult-der-verdammten,527,shaman,elemental,11,6,5
Darkara,forscherliga,527,shaman,elemental,11,6,5
Sèfìx,tarren-mill,527,shaman,elemental,11,6,5
Rezervoir,bladefist,522,shaman,elemental,15,9,6
Boltar,die-aldor,480,shaman,elemental,6,5,1
Shaggé,tarren-mill,480,shaman,elemental,6,5,1
Kikbokser,kazzak,480,shaman,elemental,6,5,1
Kenpaci,stormscale,480,shaman,elemental,6,5,1
Plsdontpress,stormscale,480,shaman,elemental,6,5,1
Izosha,hyjal,480,shaman,elemental,6,5,1
Bumstead,ragnaros,480,shaman,elemental,6,5,1
Zujaz,stormscale,480,shaman,elemental,6,5,1
Hexina,ragnaros,480,shaman,elemental,6,5,1
Electricgødx,tarren-mill,480,shaman,elemental,6,5,1
Mëditåtïøñ,blackrock,480,shaman,elemental,6,5,1
Jarreau,turalyon,480,shaman,elemental,6,5,1
Langhantel,kazzak,480,shaman,elemental,6,5,1
Efdemin,blackmoore,480,shaman,elemental,6,5,1
Squixi,tarren-mill,480,shaman,elemental,6,5,1
Phobiatics,thrall,480,shaman,elemental,6,5,1
Pianoforte,stormscale,480,shaman,elemental,10,6,4
Múixi,sanguino,480,shaman,elemental,10,6,4
Thàrin,archimonde,480,shaman,elemental,12,5,7
Bldyhatesyou,blackmoore,480,shaman,elemental,12,5,7
Grumpystorm,agamaggan,480,shaman,elemental,12,5,7
Lindemánn,blackhand,480,shaman,elemental,12,5,7
Maddskull,argent-dawn,480,shaman,elemental,12,5,7
Youngnastyx,blackrock,480,shaman,elemental,12,5,7
Yingou,azshara,480,shaman,elemental,12,5,7
Tuncha,runetotem,480,shaman,elemental,12,5,7
Вишняблэйз,soulflayer,480,shaman,elemental,12,5,7
Синнити,blackscar,480,shaman,elemental,12,5,7
Ýípìÿøû,dun-modr,480,shaman,elemental,12,5,7
Wâisted,ravencrest,480,shaman,elemental,12,5,7
Loshohealva,stormscale,480,shaman,elemental,12,5,7
Kirïss,hyjal,480,shaman,elemental,12,5,7
Cloovster,magtheridon,480,shaman,elemental,12,5,7
Arigato,eonar,480,shaman,elemental,12,5,7
Zapojin,blackhand,480,shaman,elemental,12,5,7
Azariasz,twisting-nether,480,shaman,elemental,12,5,7
Наладчик,gordunni,480,shaman,elemental,12,5,7
Фарраон,deathguard,480,shaman,elemental,12,5,7
Wûcs,silvermoon,480,shaman,elemental,12,5,7
Cptcutíe,antonidas,480,shaman,elemental,12,5,7
Айспик,ashenvale,480,shaman,elemental,12,5,7
Ironmack,outland,480,shaman,elemental,12,5,7
Суттех,soulflayer,480,shaman,elemental,12,5,7
Flaskmus,haomarush,480,shaman,elemental,12,5,7
Amcin,stormreaver,480,shaman,elemental,12,5,7
Neystee,archimonde,480,shaman,elemental,12,5,7
Tøõøõntêëêët,dun-modr,480,shaman,elemental,12,5,7
Greenswag,drakthul,480,shaman,elemental,12,5,7
Smashsmash,the-maelstrom,480,shaman,elemental,12,5,7
Greur,twisting-nether,480,shaman,elemental,12,5,7
Stòrm,ravencrest,480,shaman,elemental,12,5,7
Swapxy,outland,480,shaman,elemental,12,5,7
Noru,ravencrest,480,shaman,elemental,12,5,7
Yøøii,nemesis,480,shaman,elemental,12,5,7
Rykarn,eredar,480,shaman,elemental,12,5,7
Bahane,frostwolf,480,shaman,elemental,15,6,9
Thunda,stormreaver,480,shaman,elemental,18,5,13
Квелси,gordunni,480,shaman,elemental,18,5,13
Havoc,boulderfist,480,shaman,elemental,18,5,13
Znakhara,burning-legion,480,shaman,elemental,18,5,13
Shamurky,kazzak,480,shaman,elemental,18,5,13
Gethrok,rajaxx,480,shaman,elemental,18,5,13
Pinkylol,stormscale,480,shaman,elemental,24,5,19
Kunan,ysera,480,shaman,elemental,24,5,19
Burnprof,nethersturm,479,shaman,elemental,12,5,7
Mïzû,conseil-des-ombres,479,shaman,elemental,12,5,7
Rinks,hyjal,479,shaman,elemental,12,5,7
Фурэн,soulflayer,479,shaman,elemental,12,5,7
Albedøo,ragnaros,479,shaman,elemental,18,5,13
Sinwithin,ravencrest,478,shaman,elemental,12,5,7
Chämalö,archimonde,476,shaman,elemental,12,5,7
Kennyo,uldum,469,shaman,elemental,18,5,13
Rayitoss,tyrande,456,shaman,elemental,18,7,11
Skengshammy,ragnaros,446,shaman,elemental,11,5,6
Urub,draenor,432,shaman,elemental,15,5,10
Mareaspibas,zuljin,431,shaman,elemental,11,5,6
Charth,ravencrest,428,shaman,elemental,9,5,4
Envergur,eitrigg,417,shaman,elemental,13,6,7
Blùé,tarren-mill,399,shaman,elemental,5,5,0
Shafallen,tarren-mill,384,shaman,elemental,6,4,2
Бладих,howling-fjord,384,shaman,elemental,6,4,2
Вашнюхтоптал,howling-fjord,384,shaman,elemental,6,4,2
Márcon,das-konsortium,384,shaman,elemental,6,4,2
Ybbarcs,eredar,384,shaman,elemental,6,4,2
Hispanoxd,sanguino,384,shaman,elemental,6,4,2
Tóuka,uldum,384,shaman,elemental,6,4,2
Rahuna,darksorrow,384,shaman,elemental,6,4,2
Shøckbot,blackhand,384,shaman,elemental,6,4,2
Pvpmax,blackhand,384,shaman,elemental,6,4,2
Euprathree,archimonde,384,shaman,elemental,6,4,2
Finpower,kul-tiras,384,shaman,elemental,6,4,2
Jacc,sunstrider,384,shaman,elemental,6,4,2
Zippidizap,ulduar,384,shaman,elemental,6,4,2
Yacuzwerg,blackrock,384,shaman,elemental,6,4,2
Teckan,tarren-mill,384,shaman,elemental,6,4,2
Flambusier,hyjal,384,shaman,elemental,6,4,2
Schamîx,blackrock,384,shaman,elemental,6,4,2
Vøhm,archimonde,384,shaman,elemental,6,4,2
Criæ,blackrock,384,shaman,elemental,6,4,2
Sebubu,twisting-nether,384,shaman,elemental,6,4,2
Sugarfreé,ragnaros,384,shaman,elemental,6,4,2
Trustlemac,onyxia,384,shaman,elemental,6,4,2
Kalji,archimonde,384,shaman,elemental,6,4,2
Aleshade,argent-dawn,384,shaman,elemental,6,4,2
Prokken,garrosh,384,shaman,elemental,6,4,2
Mící,argent-dawn,384,shaman,elemental,6,4,2
Bkdgoodz,aegwynn,384,shaman,elemental,6,4,2
Kévinn,draenor,384,shaman,elemental,6,4,2
Vyrá,onyxia,384,shaman,elemental,6,4,2
Lyrashaman,draenor,384,shaman,elemental,6,4,2
Selonthyx,ravencrest,384,shaman,elemental,6,4,2
Føxï,pozzo-delleternità,384,shaman,elemental,6,4,2
Тотембот,soulflayer,384,shaman,elemental,10,5,5
Mawae,thrall,384,shaman,elemental,12,4,8
Хипхопробот,gordunni,384,shaman,elemental,12,4,8
Jäck,ravencrest,384,shaman,elemental,12,4,8
Nùrsegemy,nemesis,384,shaman,elemental,12,4,8
Jackburst,wrathbringer,384,shaman,elemental,12,4,8
Goitbate,azuremyst,384,shaman,elemental,12,4,8
Othemix,tarren-mill,384,shaman,elemental,12,4,8
Stlakañ,chants-éternels,384,shaman,elemental,12,4,8
Hí,bronzebeard,384,shaman,elemental,12,4,8
Tism,stormscale,384,shaman,elemental,12,4,8
Rompelukt,auchindoun,384,shaman,elemental,12,4,8
Réläx,kazzak,384,shaman,elemental,12,4,8
Dreston,burning-blade,384,shaman,elemental,12,4,8
Karissah,silvermoon,384,shaman,elemental,12,4,8
Styxsm,blackhand,384,shaman,elemental,12,4,8
Zæüs,ragnaros,384,shaman,elemental,12,4,8
Shïnnkøk,stormscale,384,shaman,elemental,12,4,8
Cùn,blackmoore,384,shaman,elemental,12,4,8
Míza,ravencrest,384,shaman,elemental,12,4,8
Swart,hyjal,384,shaman,elemental,12,4,8
Димасечка,galakrond,384,shaman,elemental,12,4,8
Slayerborn,eldrethalas,384,shaman,elemental,12,4,8
Kookaboo,blackrock,384,shaman,elemental,12,4,8
Апинсмок,soulflayer,384,shaman,elemental,12,4,8
Snusy,stormscale,384,shaman,elemental,12,4,8
Khankayn,kilrogg,384,shaman,elemental,12,4,8
Ogmehu,stormreaver,384,shaman,elemental,12,4,8
Rocktopus,outland,384,shaman,elemental,12,4,8
Setac,stormscale,384,shaman,elemental,12,4,8
Saggrox,kazzak,384,shaman,elemental,12,4,8
Eskìmo,malganis,384,shaman,elemental,12,4,8
Magicmekoz,draenor,384,shaman,elemental,12,4,8
Björnbritta,outland,384,shaman,elemental,12,4,8
Zoolza,kirin-tor,384,shaman,elemental,12,4,8
Castør,silvermoon,384,shaman,elemental,12,4,8
Swåf,ravencrest,384,shaman,elemental,12,4,8
Xyckas,terrordar,384,shaman,elemental,12,4,8
Tanillopzz,dun-modr,384,shaman,elemental,12,4,8
Вензеро,howling-fjord,384,shaman,elemental,12,4,8
Znakharke,silvermoon,384,shaman,elemental,12,4,8
Пса,fordragon,384,shaman,elemental,12,4,8
Purgedaddy,tarren-mill,383,shaman,elemental,6,4,2
Rextion,ravencrest,383,shaman,elemental,6,4,2
Разодран,gordunni,383,shaman,elemental,6,4,2
Кеквэклоун,soulflayer,383,shaman,elemental,6,4,2
Zokah,emeriss,383,shaman,elemental,6,4,2
Áza,archimonde,383,shaman,elemental,9,5,4
Dudoras,doomhammer,383,shaman,elemental,18,4,14
Santy,silvermoon,352,shaman,elemental,10,4,6
Äshar,archimonde,351,shaman,elemental,11,4,7
Roastý,blackrock,346,shaman,elemental,17,6,11
Khalamity,ravencrest,330,shaman,elemental,14,6,8
Raaborio,blackmoore,330,shaman,elemental,17,6,11
Cringergodx,blackhand,330,shaman,elemental,15,5,10
ßaßystärz,hyjal,319,shaman,elemental,5,4,1
Gigawats,sylvanas,319,shaman,elemental,5,4,1
Tjamei,outland,288,shaman,elemental,6,3,3
Shaulic,ravencrest,288,shaman,elemental,6,3,3
Babydòll,neptulon,288,shaman,elemental,6,3,3
Kapristylez,outland,288,shaman,elemental,6,3,3
Dünnbier,blackhand,288,shaman,elemental,6,3,3
Shamanshow,eredar,288,shaman,elemental,6,3,3
Nightingäle,silvermoon,288,shaman,elemental,6,3,3
Rubmetotems,burning-legion,288,shaman,elemental,6,3,3
Natty,ravencrest,288,shaman,elemental,6,3,3
Fufupartyxx,blackrock,288,shaman,elemental,6,3,3
Thundersioux,ravencrest,288,shaman,elemental,6,3,3
Shamanmans,grim-batol,288,shaman,elemental,6,3,3
Hethne,kazzak,288,shaman,elemental,6,3,3
Nokosi,doomhammer,288,shaman,elemental,6,3,3
Eisenfêind,antonidas,288,shaman,elemental,6,3,3
Brandbombe,frostwolf,288,shaman,elemental,6,3,3
Xye,bloodfeather,288,shaman,elemental,6,3,3
Joeyexe,outland,288,shaman,elemental,6,3,3
Another,hakkar,288,shaman,elemental,6,3,3
Ftier,ravencrest,288,shaman,elemental,6,3,3
Ramuthra,sanguino,288,shaman,elemental,6,3,3
Kaptt,twisting-nether,288,shaman,elemental,6,3,3
Amu,ravencrest,288,shaman,elemental,6,3,3
Penesecco,nemesis,288,shaman,elemental,6,3,3
Saduria,antonidas,288,shaman,elemental,6,3,3
Онеоне,deathweaver,288,shaman,elemental,6,3,3
Bladeyx,ragnaros,288,shaman,elemental,6,3,3
Wincard,arathor,288,shaman,elemental,6,3,3
Nastysham,blackrock,288,shaman,elemental,6,3,3
Peneapunta,nemesis,288,shaman,elemental,6,3,3
Soozkovic,blackmoore,288,shaman,elemental,6,3,3
Filigran,ragnaros,288,shaman,elemental,6,3,3
Ghettero,ragnaros,288,shaman,elemental,6,3,3
Shamuzan,malfurion,288,shaman,elemental,6,3,3
Sëídhr,arathi,288,shaman,elemental,6,3,3
Whyisitspicy,kazzak,288,shaman,elemental,6,3,3
Царьбер,soulflayer,288,shaman,elemental,6,3,3
Dagra,twisting-nether,288,shaman,elemental,6,3,3
Whatsup,aggramar,288,shaman,elemental,6,3,3
Энхай,azuregos,288,shaman,elemental,6,3,3
Tuftonshaman,ravencrest,288,shaman,elemental,6,3,3
Irønythar,drakthul,288,shaman,elemental,6,3,3
Ghortus,magtheridon,288,shaman,elemental,6,3,3
Lefita,drakthul,288,shaman,elemental,6,3,3
Qenninka,drakthul,288,shaman,elemental,6,3,3
Begeshaman,sylvanas,288,shaman,elemental,6,3,3
Faroh,ravencrest,288,shaman,elemental,6,3,3
Херургх,soulflayer,288,shaman,elemental,6,3,3
Sházam,destromath,288,shaman,elemental,6,3,3
Ezrasian,ragnaros,288,shaman,elemental,6,3,3
Gissary,drakthul,288,shaman,elemental,6,3,3
Bas,nagrand,288,shaman,elemental,6,3,3
Neirdae,thunderhorn,288,shaman,elemental,6,3,3
Тотемныйчад,gordunni,288,shaman,elemental,6,3,3
Yashëa,ysondre,288,shaman,elemental,6,3,3
Estexxsham,kazzak,288,shaman,elemental,6,3,3
Exolnard,twisting-nether,288,shaman,elemental,6,3,3
Peaktrim,tarren-mill,288,shaman,elemental,6,3,3
Lifetimepro,twisting-nether,288,shaman,elemental,6,3,3
Blyxuhm,argent-dawn,288,shaman,elemental,6,3,3
Xayy,twisting-nether,288,shaman,elemental,6,3,3
Putrìfy,ravencrest,288,shaman,elemental,6,3,3
Gorgath,dunemaul,288,shaman,elemental,6,3,3
Bharudor,antonidas,288,shaman,elemental,6,3,3
Voodoodoouu,stormscale,288,shaman,elemental,6,3,3
Mjukiz,tarren-mill,288,shaman,elemental,6,3,3
Volvíc,tichondrius,288,shaman,elemental,6,3,3
Nibirû,archimonde,288,shaman,elemental,6,3,3
Родохрозид,blackscar,288,shaman,elemental,6,3,3
Lunarsloth,hyjal,288,shaman,elemental,6,3,3
Sponktrasado,eredar,288,shaman,elemental,6,3,3
Alphà,stormscale,288,shaman,elemental,6,3,3
Natureabuser,kazzak,288,shaman,elemental,6,3,3
Ilovédogs,tarren-mill,288,shaman,elemental,6,3,3
Zoraan,stormscale,288,shaman,elemental,6,3,3
Susais,outland,288,shaman,elemental,6,3,3
Hotstorm,bronzebeard,288,shaman,elemental,6,3,3
Crysham,tarren-mill,288,shaman,elemental,6,3,3
Bigpinkpig,thunderhorn,288,shaman,elemental,7,3,4
Kletskebang,tarren-mill,288,shaman,elemental,10,4,6
Bónkas,kazzak,288,shaman,elemental,12,3,9
Eliteblood,kazzak,288,shaman,elemental,12,3,9
Izir,archimonde,288,shaman,elemental,12,3,9
Fatyoe,eredar,288,shaman,elemental,12,3,9
Hecalix,ysondre,288,shaman,elemental,12,3,9
Punchì,blackhand,288,shaman,elemental,12,3,9
Iceshockz,sylvanas,288,shaman,elemental,12,3,9
Woolysocks,draenor,288,shaman,elemental,12,3,9
Cazzari,thrall,288,shaman,elemental,12,3,9
Tonto,frostmane,288,shaman,elemental,12,3,9
Rargosh,malorne,288,shaman,elemental,12,3,9
Чтозабред,gordunni,288,shaman,elemental,12,3,9
Moosavi,kazzak,288,shaman,elemental,12,3,9
Azifox,hyjal,288,shaman,elemental,12,3,9
Vodoochild,hyjal,288,shaman,elemental,12,3,9
Elemania,mugthol,288,shaman,elemental,12,3,9
Throkal,blackhand,288,shaman,elemental,12,3,9
Opaque,doomhammer,288,shaman,elemental,12,3,9
Gaera,veknilash,288,shaman,elemental,12,3,9
Benzi,ragnaros,288,shaman,elemental,12,3,9
Qwunjin,ragnaros,288,shaman,elemental,12,3,9
Berith,spinebreaker,288,shaman,elemental,12,3,9
Grinan,hyjal,288,shaman,elemental,12,3,9
Korbas,burning-legion,288,shaman,elemental,12,3,9
Corlysvelary,doomhammer,288,shaman,elemental,12,3,9
Fouchin,outland,288,shaman,elemental,12,3,9
Frostpunk,tarren-mill,288,shaman,elemental,12,3,9
Joeculdacier,hyjal,288,shaman,elemental,12,3,9
Rätxs,blackhand,288,shaman,elemental,12,3,9
Tir,auchindoun,288,shaman,elemental,12,3,9
Jaeslin,tarren-mill,288,shaman,elemental,12,3,9
Megaherz,sanguino,287,shaman,elemental,6,3,3
Bogatyrk,twisting-nether,287,shaman,elemental,6,3,3
Эскки,gordunni,286,shaman,elemental,6,3,3
Twotwozero,defias-brotherhood,286,shaman,elemental,6,3,3
Zalacrass,sanguino,286,shaman,elemental,6,3,3
Вещун,deathguard,284,shaman,elemental,12,3,9
Sypnosz,sanguino,255,shaman,elemental,11,3,8
Thytor,blackmoore,239,shaman,elemental,5,3,2
Deathshamãn,stormscale,239,shaman,elemental,11,3,8
Beautie,sylvanas,234,shaman,elemental,14,4,10
Kayden,uldum,234,shaman,elemental,15,4,11
Rindenmulch,eredar,192,shaman,elemental,6,2,4
Zinlay,tarren-mill,192,shaman,elemental,6,2,4
Пимз,gordunni,192,shaman,elemental,6,2,4
Tates,jaedenar,192,shaman,elemental,6,2,4
Fläskbjarne,stormscale,192,shaman,elemental,6,2,4
Ratatakéas,archimonde,192,shaman,elemental,6,2,4
Tolk,thrall,192,shaman,elemental,6,2,4
Krovogor,silvermoon,192,shaman,elemental,6,2,4
Dodododfewal,stormscale,192,shaman,elemental,6,2,4
Импфаразел,gordunni,192,shaman,elemental,6,2,4
Nuvet,argent-dawn,192,shaman,elemental,6,2,4
Wawawoowee,archimonde,192,shaman,elemental,6,2,4
Oldbuttgold,archimonde,192,shaman,elemental,6,2,4
Roastbeef,blackrock,192,shaman,elemental,6,2,4
Amonshokz,tarren-mill,192,shaman,elemental,6,2,4
Chllup,drakthul,192,shaman,elemental,6,2,4
Phènomènom,tarren-mill,192,shaman,elemental,6,2,4
Ahrim,argent-dawn,192,shaman,elemental,6,2,4
Cafardxx,archimonde,192,shaman,elemental,6,2,4
Драгенхз,gordunni,192,shaman,elemental,6,2,4
Zackyboi,tarren-mill,192,shaman,elemental,6,2,4
Garakh,argent-dawn,192,shaman,elemental,6,2,4
Lemonez,ravencrest,192,shaman,elemental,6,2,4
Frý,archimonde,192,shaman,elemental,6,2,4
Checkpoint,defias-brotherhood,192,shaman,elemental,6,2,4
Kappatotem,silvermoon,192,shaman,elemental,6,2,4
Shàmeonyou,dun-morogh,192,shaman,elemental,6,2,4
Exílium,tarren-mill,192,shaman,elemental,6,2,4
Shreddedcntw,ravencrest,192,shaman,elemental,6,2,4
Patites,twisting-nether,192,shaman,elemental,6,2,4
Melliska,silvermoon,192,shaman,elemental,6,2,4
Milara,anachronos,192,shaman,elemental,6,2,4
Froostshoock,eredar,192,shaman,elemental,6,2,4
Yiyi,boulderfist,192,shaman,elemental,6,2,4
Telezex,twisting-nether,192,shaman,elemental,6,2,4
Goreflame,argent-dawn,192,shaman,elemental,6,2,4
Lynox,ragnaros,192,shaman,elemental,6,2,4
Yöh,tarren-mill,192,shaman,elemental,6,2,4
Shambamm,stormscale,192,shaman,elemental,6,2,4
Elshamino,ravencrest,192,shaman,elemental,6,2,4
Zappyhog,turalyon,192,shaman,elemental,6,2,4
Baxz,twisting-nether,192,shaman,elemental,6,2,4
Mehex,tarren-mill,192,shaman,elemental,6,2,4
Karpsham,stormscale,192,shaman,elemental,6,2,4
Nabq,hyjal,192,shaman,elemental,6,2,4
Wârmachiine,burning-legion,192,shaman,elemental,6,2,4
Сновидений,soulflayer,192,shaman,elemental,6,2,4
Tigro,burning-legion,192,shaman,elemental,6,2,4
Rok,darkspear,192,shaman,elemental,6,2,4
Shamarre,executus,192,shaman,elemental,6,2,4
Mynaye,hyjal,192,shaman,elemental,6,2,4
Shadowlolz,kazzak,192,shaman,elemental,6,2,4
Tuksy,darkspear,192,shaman,elemental,6,2,4
Firsttime,alakir,192,shaman,elemental,6,2,4
Casterzajx,kazzak,192,shaman,elemental,6,2,4
Zugx,silvermoon,192,shaman,elemental,6,2,4
Giïh,ravencrest,192,shaman,elemental,6,2,4
Nnekalol,twisting-nether,192,shaman,elemental,6,2,4
Kolchidyalah,la-croisade-écarlate,192,shaman,elemental,6,2,4
Purgegødxx,aegwynn,192,shaman,elemental,6,2,4
Anöuchkâ,ysondre,192,shaman,elemental,6,2,4
Mikah,frostwhisper,192,shaman,elemental,6,2,4
Behemothsm,kazzak,192,shaman,elemental,6,2,4
Macetoyaface,darksorrow,192,shaman,elemental,6,2,4
Тандерхем,gordunni,192,shaman,elemental,6,2,4
Blubb,rajaxx,192,shaman,elemental,6,2,4
Durinlaso,sanguino,192,shaman,elemental,6,2,4
Ishkadar,twisting-nether,192,shaman,elemental,6,2,4
Keisys,kazzak,192,shaman,elemental,6,2,4
Albatroz,the-maelstrom,192,shaman,elemental,6,2,4
Dormido,sanguino,192,shaman,elemental,6,2,4
Littletrall,outland,192,shaman,elemental,6,2,4
Präsi,die-aldor,192,shaman,elemental,6,2,4
Éàsy,blackmoore,192,shaman,elemental,6,2,4
Чикочирони,gordunni,192,shaman,elemental,6,2,4
Squixi,ravencrest,192,shaman,elemental,6,2,4
Лаваяшка,gordunni,192,shaman,elemental,6,2,4
Semiro,draenor,192,shaman,elemental,6,2,4
Nuekx,sanguino,192,shaman,elemental,6,2,4
Fuzzbolt,silvermoon,192,shaman,elemental,6,2,4
Conor,kult-der-verdammten,192,shaman,elemental,6,2,4
Yobanivrot,the-maelstrom,192,shaman,elemental,6,2,4
Buffchampls,dalaran,192,shaman,elemental,6,2,4
Reinssay,ysondre,192,shaman,elemental,6,2,4
Beletili,chogall,192,shaman,elemental,6,2,4
Céndri,dun-modr,192,shaman,elemental,6,2,4
Шамяра,blackscar,192,shaman,elemental,6,2,4
Растабоба,galakrond,192,shaman,elemental,6,2,4
Djxyoloswag,silvermoon,192,shaman,elemental,6,2,4
Waterpistol,twisting-nether,192,shaman,elemental,6,2,4
Equipshammy,silvermoon,192,shaman,elemental,6,2,4
Шаеман,soulflayer,192,shaman,elemental,6,2,4
Stivishamy,blackmoore,192,shaman,elemental,6,2,4
Cptsham,blackrock,192,shaman,elemental,6,2,4
Bjerknes,draenor,192,shaman,elemental,6,2,4
Bomboclat,azjolnerub,192,shaman,elemental,6,2,4
Papskalla,ravencrest,192,shaman,elemental,6,2,4
Rakermän,dun-modr,192,shaman,elemental,6,2,4
Hogmodig,tarren-mill,192,shaman,elemental,7,2,5
Зуфар,howling-fjord,192,shaman,elemental,12,2,10
Nakenfeigy,stormreaver,192,shaman,elemental,12,2,10
Zíp,archimonde,192,shaman,elemental,12,2,10
Yarøu,antonidas,192,shaman,elemental,12,2,10
Sweetcåndy,stormscale,192,shaman,elemental,12,2,10
Thornyberrý,outland,192,shaman,elemental,12,2,10
Shockmelone,blackrock,192,shaman,elemental,12,2,10
Cámmy,twisting-nether,192,shaman,elemental,12,2,10
Lycburst,twisting-nether,192,shaman,elemental,12,2,10
Неерззул,soulflayer,192,shaman,elemental,12,2,10
Огневед,soulflayer,192,shaman,elemental,12,2,10
Максобман,howling-fjord,192,shaman,elemental,12,2,10
Ghostx,nemesis,192,shaman,elemental,18,2,16
Zeiger,minahonda,192,shaman,elemental,24,2,22
Khraajsy,sylvanas,191,shaman,elemental,6,2,4
Aspirio,ravencrest,175,shaman,elemental,11,2,9
Kivra,burning-legion,159,shaman,elemental,5,2,3
Thalgryn,twisting-nether,159,shaman,elemental,8,3,5
Tarzh,dalaran,159,shaman,elemental,8,3,5
Kortën,khaz-modan,159,shaman,elemental,10,2,8
Artigeartig,draenor,144,shaman,elemental,3,3,0
Jimkopf,eredar,138,shaman,elemental,10,4,6
Disneyplus,tarren-mill,138,shaman,elemental,8,3,5
Clappagobzz,kazzak,138,shaman,elemental,8,3,5
Amiashaman,stormscale,138,shaman,elemental,16,3,13
Корсика,gordunni,128,shaman,elemental,4,2,2
Shakgor,draenor,128,shaman,elemental,4,2,2
Thorcasso,azuremyst,96,shaman,elemental,3,2,1
Grytkungen,daggerspine,96,shaman,elemental,3,2,1
Bram,aggra-português,96,shaman,elemental,3,2,1
Zadrams,argent-dawn,96,shaman,elemental,3,2,1
Simpledream,tarren-mill,96,shaman,elemental,3,2,1
Nopivøt,hyjal,96,shaman,elemental,7,2,5
Zows,kazzak,96,shaman,elemental,6,1,5
Samisu,blackmoore,96,shaman,elemental,6,1,5
Elementy,bronze-dragonflight,96,shaman,elemental,6,1,5
Mittyzap,kazzak,96,shaman,elemental,6,1,5
Bispi,blackmoore,96,shaman,elemental,6,1,5
Bonestompamc,blackmoore,96,shaman,elemental,6,1,5
Elijaá,nordrassil,96,shaman,elemental,6,1,5
Glug,magtheridon,96,shaman,elemental,6,1,5
Châmanco,dun-modr,96,shaman,elemental,6,1,5
Nafay,lordaeron,96,shaman,elemental,6,1,5
Fugasaku,sanguino,96,shaman,elemental,6,1,5
Сентес,soulflayer,96,shaman,elemental,6,1,5
Barockox,kazzak,96,shaman,elemental,6,1,5
Пэппивкашке,howling-fjord,96,shaman,elemental,6,1,5
Ämbientador,sanguino,96,shaman,elemental,6,1,5
Subaki,die-aldor,96,shaman,elemental,6,1,5
Killhorn,malganis,96,shaman,elemental,6,1,5
Dizhkameduu,terokkar,96,shaman,elemental,6,1,5
Driftal,laughing-skull,96,shaman,elemental,6,1,5
Shamsteaks,ysera,96,shaman,elemental,6,1,5
Grillfleîsch,azshara,96,shaman,elemental,6,1,5
Lexyiasz,kazzak,96,shaman,elemental,6,1,5
Zerim,taerar,96,shaman,elemental,6,1,5
Flurpz,outland,96,shaman,elemental,6,1,5
Skailzcham,hyjal,96,shaman,elemental,6,1,5
Rykou,nagrand,96,shaman,elemental,6,1,5
Electroklart,defias-brotherhood,96,shaman,elemental,6,1,5
Phanomz,ragnaros,96,shaman,elemental,6,1,5
Felcrushed,stormscale,96,shaman,elemental,6,1,5
Biztor,jaedenar,96,shaman,elemental,6,1,5
Voodooshox,tarren-mill,96,shaman,elemental,6,1,5
Nìtratx,archimonde,96,shaman,elemental,6,1,5
Shàwyn,sylvanas,96,shaman,elemental,6,1,5
Bualocktv,sylvanas,96,shaman,elemental,6,1,5
Panzarkamp,stormscale,96,shaman,elemental,6,1,5
Ânne,blackrock,96,shaman,elemental,6,1,5
Choppintex,archimonde,96,shaman,elemental,6,1,5
Fatflop,sylvanas,96,shaman,elemental,6,1,5
Newÿorc,dalaran,96,shaman,elemental,6,1,5
Venterlofeu,archimonde,96,shaman,elemental,6,1,5
Alekaris,burning-blade,96,shaman,elemental,6,1,5
Ellyy,silvermoon,96,shaman,elemental,6,1,5
Hagelbrakan,stormscale,96,shaman,elemental,6,1,5
Ghøhp,nerzhul,96,shaman,elemental,6,1,5
Bonjwa,eitrigg,96,shaman,elemental,6,1,5
Монамур,deathguard,96,shaman,elemental,6,1,5
Papaver,zirkel-des-cenarius,96,shaman,elemental,6,1,5
Trendsetter,frostmane,96,shaman,elemental,6,1,5
Muisak,culte-de-la-rive-noire,96,shaman,elemental,6,1,5
Moglibard,grim-batol,96,shaman,elemental,6,1,5
Jabena,draenor,96,shaman,elemental,6,1,5
Growlêy,draenor,96,shaman,elemental,6,1,5
Zaffyboi,draenor,96,shaman,elemental,6,1,5
Freexx,aegwynn,96,shaman,elemental,6,1,5
Ferdizap,draenor,96,shaman,elemental,6,1,5
Jänis,ragnaros,96,shaman,elemental,6,1,5
Артокор,gordunni,96,shaman,elemental,6,1,5
Dérgérät,blackrock,96,shaman,elemental,6,1,5
Happyjuice,silvermoon,96,shaman,elemental,6,1,5
Aguero,aegwynn,96,shaman,elemental,6,1,5
Ramaka,aegwynn,96,shaman,elemental,6,1,5
Vorkanyx,ysondre,96,shaman,elemental,6,1,5
Biotopia,blackrock,96,shaman,elemental,6,1,5
Pasjeop,ravencrest,96,shaman,elemental,6,1,5
Dergat,pozzo-delleternità,96,shaman,elemental,6,1,5
Çoco,blackrock,96,shaman,elemental,6,1,5
Nuclearjohny,eredar,96,shaman,elemental,6,1,5
Kilruk,ravencrest,96,shaman,elemental,6,1,5
Rakat,twisting-nether,96,shaman,elemental,6,1,5
Dwarfofwar,ravencrest,96,shaman,elemental,6,1,5
Saburo,thrall,96,shaman,elemental,6,1,5
Depucova,silvermoon,96,shaman,elemental,6,1,5
Bärtigbaron,thrall,96,shaman,elemental,6,1,5
Stiflersmôm,antonidas,96,shaman,elemental,6,1,5
Lik,nethersturm,96,shaman,elemental,6,1,5
Shamira,nethersturm,96,shaman,elemental,6,1,5
Shaminista,ravencrest,96,shaman,elemental,6,1,5
Heheheyup,ravencrest,96,shaman,elemental,6,1,5
Poglavica,dragonmaw,96,shaman,elemental,6,1,5
Másàfî,tarren-mill,96,shaman,elemental,7,1,6
Ðdly,culte-de-la-rive-noire,96,shaman,elemental,8,1,7
Amaizin,stormscale,96,shaman,elemental,12,1,11
Tapatak,antonidas,96,shaman,elemental,12,1,11
Zappypewpew,drakthul,96,shaman,elemental,12,1,11
Kyst,elune,95,shaman,elemental,6,1,5
Torepåsporet,deathwing,79,shaman,elemental,5,1,4
Xiphoideus,draenor,79,shaman,elemental,5,1,4
Agnøt,khaz-modan,63,shaman,elemental,2,2,0
Yeháw,kazzak,48,shaman,elemental,3,1,2
Hyu,hyjal,42,shaman,elemental,10,2,8
Shammolino,nemesis,41,shaman,elemental,7,3,4
Chícago,ysondre,31,shaman,elemental,2,1,1
Gushgush,draenor,31,shaman,elemental,2,1,1
Shds,blackmoore,31,shaman,elemental,2,1,1
Michalb,tarren-mill,31,shaman,elemental,2,1,1
Thorên,blackmoore,16,shaman,elemental,1,1,0
Shamszy,grim-batol,16,shaman,elemental,1,1,0
Memourian,drakthul,16,shaman,elemental,7,1,6
Bredare,ravencrest,2406,shaman,enhancement,136,104,32
Blaukraut,stormscale,2375,shaman,enhancement,115,75,40
Mûnch,kazzak,2369,shaman,enhancement,110,73,37
Крааули,soulflayer,2283,shaman,enhancement,439,228,211
Китрасст,soulflayer,2263,shaman,enhancement,84,47,37
Китраст,soulflayer,2262,shaman,enhancement,105,56,49
Nevergroundx,perenolde,2257,shaman,enhancement,96,60,36
Axdn,ravencrest,2249,shaman,enhancement,92,51,41
Avines,twisting-nether,2249,shaman,enhancement,385,202,183
Дудивтф,soulflayer,2244,shaman,enhancement,194,105,89
Strippzz,stormscale,2238,shaman,enhancement,102,62,40
Fatpig,stormscale,2238,shaman,enhancement,83,47,36
Shadijr,stormscale,2233,shaman,enhancement,118,63,55
Hermerejildo,stormscale,2229,shaman,enhancement,196,101,95
Dennismanone,tarren-mill,2228,shaman,enhancement,120,62,58
Swapxy,ravencrest,2215,shaman,enhancement,66,42,24
Joeyexe,outland,2215,shaman,enhancement,229,123,106
Kweng,stormreaver,2208,shaman,enhancement,193,109,84
Shadiqt,stormscale,2194,shaman,enhancement,96,51,45
Onebutton,archimonde,2187,shaman,enhancement,78,51,27
Buffdraventy,archimonde,2176,shaman,enhancement,102,59,43
Treyway,dun-modr,2174,shaman,enhancement,96,64,32
Æerømachine,outland,2170,shaman,enhancement,128,67,61
Acidtrips,thrall,2170,shaman,enhancement,153,77,76
Lizoo,ravencrest,2169,shaman,enhancement,102,66,36
Kwengi,stormreaver,2161,shaman,enhancement,233,123,110
Curioustowel,kazzak,2158,shaman,enhancement,71,40,31
Stribbzz,stormscale,2158,shaman,enhancement,376,207,169
Fckumen,ravencrest,2155,shaman,enhancement,124,71,53
Metastasis,dalaran,2147,shaman,enhancement,144,92,52
Baconbazooka,tarren-mill,2147,shaman,enhancement,101,60,41
Lovèless,stormscale,2147,shaman,enhancement,48,28,20
Áä,stormscale,2146,shaman,enhancement,48,42,6
Smorcshamyy,kazzak,2145,shaman,enhancement,223,119,104
Enhahaha,tarren-mill,2141,shaman,enhancement,84,45,39
Azifox,hyjal,2141,shaman,enhancement,144,72,72
Ujasdaddy,stormscale,2139,shaman,enhancement,72,54,18
Trulylove,tarren-mill,2138,shaman,enhancement,111,58,53
Gønêxt,ravencrest,2128,shaman,enhancement,81,53,28
Mustakrakish,terokkar,2127,shaman,enhancement,78,53,25
Sillaas,ysondre,2127,shaman,enhancement,210,104,106
Майндшторм,blackscar,2123,shaman,enhancement,156,96,60
Faroh,ravencrest,2119,shaman,enhancement,89,50,39
Тандервульф,howling-fjord,2119,shaman,enhancement,361,193,168
Shadi,stormscale,2119,shaman,enhancement,84,44,40
Critonian,twisting-nether,2117,shaman,enhancement,129,68,61
Shamanyxx,tarren-mill,2114,shaman,enhancement,269,141,128
Maelstrom,eredar,2113,shaman,enhancement,300,167,133
Feetaddict,kazzak,2109,shaman,enhancement,187,104,83
Бафамет,blackscar,2108,shaman,enhancement,66,39,27
Voodoodoouu,stormscale,2106,shaman,enhancement,173,93,80
Qnanen,ravencrest,2105,shaman,enhancement,212,121,91
Krónm,dun-modr,2104,shaman,enhancement,112,73,39
Sparkygødx,twisting-nether,2104,shaman,enhancement,54,33,21
Yombaï,archimonde,2102,shaman,enhancement,263,135,128
Myguns,silvermoon,2101,shaman,enhancement,182,97,85
Møldør,tarren-mill,2100,shaman,enhancement,132,84,48
Читорра,gordunni,2096,shaman,enhancement,114,62,52
Kazing,outland,2086,shaman,enhancement,88,46,42
Noboorst,stormscale,2082,shaman,enhancement,100,52,48
Syllaas,ysondre,2082,shaman,enhancement,252,127,125
Hermerejildo,tarren-mill,2079,shaman,enhancement,78,41,37
Ostosmvp,ravencrest,2075,shaman,enhancement,108,54,54
Вацунвец,goldrinn,2071,shaman,enhancement,221,122,99
Sswf,kazzak,2070,shaman,enhancement,60,35,25
Yashëa,ysondre,2069,shaman,enhancement,73,59,14
Ruffepuffe,twisting-nether,2069,shaman,enhancement,431,224,207
Babalahziz,ysondre,2065,shaman,enhancement,142,94,48
Chancè,tarren-mill,2065,shaman,enhancement,96,54,42
Mëditåtïøñ,blackrock,2059,shaman,enhancement,66,32,34
Wóllff,archimonde,2057,shaman,enhancement,141,77,64
Shambolicc,ravencrest,2057,shaman,enhancement,124,63,61
Xa,blackrock,2056,shaman,enhancement,219,121,98
Falseshepard,kazzak,2055,shaman,enhancement,84,45,39
Shuffledog,stormscale,2054,shaman,enhancement,53,30,23
Shïnnøk,stormscale,2053,shaman,enhancement,568,289,279
Trulylove,outland,2049,shaman,enhancement,275,134,141
Zouk,ysondre,2045,shaman,enhancement,126,73,53
Milheroj,tarren-mill,2045,shaman,enhancement,165,89,76
Etox,darksorrow,2042,shaman,enhancement,144,73,71
Gúîtårgøð,sanguino,2042,shaman,enhancement,89,44,45
Gõyokunomajo,kazzak,2035,shaman,enhancement,78,52,26
Ниокумибейт,soulflayer,2035,shaman,enhancement,100,64,36
Епуклопов,soulflayer,2035,shaman,enhancement,114,69,45
Oldveteran,eredar,2035,shaman,enhancement,127,76,51
Hexmex,stormreaver,2035,shaman,enhancement,164,89,75
Zró,blackrock,2035,shaman,enhancement,192,100,92
Djonebutton,kazzak,2034,shaman,enhancement,89,51,38
Plsdontpress,stormscale,2029,shaman,enhancement,121,70,51
Chakafuyo,dun-modr,2028,shaman,enhancement,74,45,29
Zulmalis,twisting-nether,2022,shaman,enhancement,183,104,79
Taktouka,archimonde,2019,shaman,enhancement,95,48,47
Skullstorm,talnivarr,2014,shaman,enhancement,151,85,66
Sparkyxd,twisting-nether,2014,shaman,enhancement,149,67,82
Arslos,twisting-nether,2010,shaman,enhancement,50,39,11
Биттерлинкс,blackscar,2010,shaman,enhancement,80,39,41
Løne,sylvanas,2008,shaman,enhancement,227,131,96
Tebzs,ravencrest,2006,shaman,enhancement,60,39,21
Corvux,tarren-mill,2002,shaman,enhancement,96,52,44
Karpsham,stormscale,1993,shaman,enhancement,300,146,154
Phobiatics,thrall,1991,shaman,enhancement,65,41,24
Morguk,zuljin,1991,shaman,enhancement,133,76,57
Twísting,tarren-mill,1989,shaman,enhancement,59,37,22
Shukhevych,kazzak,1984,shaman,enhancement,281,147,134
Инсэйнгод,soulflayer,1983,shaman,enhancement,63,32,31
Milheroj,terenas,1981,shaman,enhancement,144,70,74
Архивоитель,soulflayer,1980,shaman,enhancement,136,80,56
Wishsteen,stormscale,1973,shaman,enhancement,95,52,43
Woopiedoopie,silvermoon,1973,shaman,enhancement,266,143,123
Yüri,stormscale,1968,shaman,enhancement,313,155,158
Nòrgan,die-aldor,1966,shaman,enhancement,55,35,20
Hardeeshot,stormscale,1965,shaman,enhancement,91,55,36
Teknorave,dun-modr,1963,shaman,enhancement,84,43,41
Horelio,sanguino,1961,shaman,enhancement,231,129,102
Turbostuck,ravencrest,1960,shaman,enhancement,171,88,83
Нарленд,gordunni,1960,shaman,enhancement,240,122,118
Ódicen,dun-modr,1959,shaman,enhancement,63,37,26
Pusspatrol,kazzak,1959,shaman,enhancement,114,55,59
Энха,howling-fjord,1957,shaman,enhancement,81,41,40
Akatuseiwah,blackrock,1956,shaman,enhancement,65,33,32
Херургх,soulflayer,1954,shaman,enhancement,188,109,79
Disciplé,blackmoore,1953,shaman,enhancement,95,51,44
Shïnnkøk,stormscale,1953,shaman,enhancement,138,70,68
Viablous,ravencrest,1950,shaman,enhancement,202,122,80
Ниу,thermaplugg,1949,shaman,enhancement,54,32,22
Ennuii,blackrock,1948,shaman,enhancement,78,45,33
Shockxy,norgannon,1947,shaman,enhancement,65,35,30
Вудумастер,gordunni,1946,shaman,enhancement,149,86,63
Kikbokser,kazzak,1944,shaman,enhancement,76,47,29
Recaim,outland,1943,shaman,enhancement,77,41,36
Zarkab,ysondre,1940,shaman,enhancement,106,71,35
Hezdnalien,aegwynn,1940,shaman,enhancement,191,108,83
Schockerdidf,blackmoore,1939,shaman,enhancement,30,24,6
Kulefesk,grim-batol,1936,shaman,enhancement,156,80,76
Talrall,twisting-nether,1934,shaman,enhancement,144,78,66
Djsnéak,blackrock,1932,shaman,enhancement,77,39,38
Obryss,tarren-mill,1927,shaman,enhancement,53,34,19
Nopre,blackrock,1926,shaman,enhancement,529,271,258
Brokenguyman,defias-brotherhood,1924,shaman,enhancement,58,34,24
Nuarishaman,kazzak,1917,shaman,enhancement,132,69,63
Matrixxer,aegwynn,1910,shaman,enhancement,63,44,19
Chehkhan,archimonde,1909,shaman,enhancement,88,44,44
Tordenlars,ragnaros,1908,shaman,enhancement,53,31,22
Kishock,tarren-mill,1907,shaman,enhancement,48,28,20
Fözk,outland,1907,shaman,enhancement,66,36,30
Spaltbart,blackmoore,1906,shaman,enhancement,156,89,67
Тиидишам,blackscar,1905,shaman,enhancement,143,72,71
Слакербэдбой,gordunni,1904,shaman,enhancement,126,62,64
Arhitopg,silvermoon,1903,shaman,enhancement,120,64,56
Вацустайл,goldrinn,1899,shaman,enhancement,108,63,45
Matchstíck,draenor,1899,shaman,enhancement,132,64,68
Lavadelrey,drakthul,1895,shaman,enhancement,65,33,32
Flappey,stormscale,1894,shaman,enhancement,78,48,30
Kilnih,archimonde,1894,shaman,enhancement,60,35,25
Rëalg,zuljin,1894,shaman,enhancement,178,102,76
Poppakonstit,twisting-nether,1892,shaman,enhancement,136,83,53
Trixey,mazrigos,1892,shaman,enhancement,52,30,22
Frankone,outland,1892,shaman,enhancement,239,131,108
Канамаш,borean-tundra,1890,shaman,enhancement,107,69,38
Nachosauce,tarren-mill,1890,shaman,enhancement,53,28,25
Gottiy,blackhand,1890,shaman,enhancement,162,80,82
Metamorflord,ravencrest,1889,shaman,enhancement,126,71,55
Bikdig,dun-modr,1889,shaman,enhancement,120,66,54
Powercolor,aegwynn,1888,shaman,enhancement,67,33,34
Djimin,sanguino,1887,shaman,enhancement,321,173,148
Экспл,ashenvale,1886,shaman,enhancement,166,85,81
Grende,sylvanas,1885,shaman,enhancement,181,98,83
Rækwon,tarren-mill,1885,shaman,enhancement,123,66,57
Blyxuhm,argent-dawn,1882,shaman,enhancement,48,26,22
Bredex,doomhammer,1881,shaman,enhancement,102,60,42
Ohhmm,ravencrest,1881,shaman,enhancement,42,20,22
Lassolasse,sylvanas,1880,shaman,enhancement,60,37,23
Mírídíuss,silvermoon,1879,shaman,enhancement,65,37,28
Blitzmann,outland,1879,shaman,enhancement,54,30,24
Doubleshock,draenor,1877,shaman,enhancement,30,21,9
Veloudinos,twisting-nether,1877,shaman,enhancement,137,89,48
Sozetwo,tarren-mill,1877,shaman,enhancement,52,33,19
Shamarach,sylvanas,1877,shaman,enhancement,66,39,27
Tâktoukâ,archimonde,1876,shaman,enhancement,226,121,105
Пэппивкашке,howling-fjord,1875,shaman,enhancement,92,50,42
Orakl,tarren-mill,1873,shaman,enhancement,221,127,94
Deaslow,hyjal,1873,shaman,enhancement,234,124,110
Zetorgg,burning-legion,1873,shaman,enhancement,136,70,66
Kardyo,archimonde,1873,shaman,enhancement,117,60,57
Qwertyxd,ravencrest,1872,shaman,enhancement,90,54,36
Jaykelul,frostmane,1871,shaman,enhancement,24,20,4
Shds,blackmoore,1871,shaman,enhancement,118,68,50
Bullx,magtheridon,1870,shaman,enhancement,138,75,63
Raìjïn,draenor,1869,shaman,enhancement,54,31,23
Ятебясмету,gordunni,1867,shaman,enhancement,48,32,16
Jäy,twisting-nether,1867,shaman,enhancement,58,31,27
Pumpcok,durotan,1866,shaman,enhancement,82,48,34
Chatbanned,blackmoore,1866,shaman,enhancement,48,26,22
Windsòng,stormscale,1865,shaman,enhancement,30,24,6
Uhøfligeulf,draenor,1865,shaman,enhancement,119,56,63
Бренненд,howling-fjord,1863,shaman,enhancement,212,113,99
Medistød,draenor,1862,shaman,enhancement,194,115,79
Turbotorgny,draenor,1862,shaman,enhancement,84,49,35
Shambolicc,kazzak,1862,shaman,enhancement,176,84,92
Mittyzap,kazzak,1860,shaman,enhancement,126,71,55
Turbostruck,ravencrest,1860,shaman,enhancement,132,57,75
Alterem,kazzak,1859,shaman,enhancement,233,120,113
Dimno,burning-blade,1857,shaman,enhancement,36,24,12
Naochí,silvermoon,1857,shaman,enhancement,35,23,12
Shrektar,outland,1857,shaman,enhancement,72,40,32
Hanrej,draenor,1856,shaman,enhancement,60,37,23
Shamhaár,blackmoore,1856,shaman,enhancement,100,61,39
Radåhn,outland,1854,shaman,enhancement,72,44,28
Nerfrets,malganis,1854,shaman,enhancement,209,121,88
Ваншотстайлз,soulflayer,1854,shaman,enhancement,148,76,72
Сидог,soulflayer,1853,shaman,enhancement,42,30,12
Musham,blackrock,1852,shaman,enhancement,66,41,25
Klintxbob,hyjal,1852,shaman,enhancement,42,23,19
Daybidaybi,stormscale,1852,shaman,enhancement,227,113,114
Høwlstørmx,ravencrest,1850,shaman,enhancement,55,36,19
Stormkiler,defias-brotherhood,1850,shaman,enhancement,237,114,123
Dakotasham,ravencrest,1849,shaman,enhancement,71,41,30
Буряя,blackscar,1848,shaman,enhancement,66,27,39
Getahex,ravencrest,1847,shaman,enhancement,35,26,9
Blubbers,magtheridon,1847,shaman,enhancement,60,36,24
Dwarfovic,ravencrest,1847,shaman,enhancement,42,24,18
Tailin,nozdormu,1846,shaman,enhancement,66,40,26
Cløke,stormscale,1846,shaman,enhancement,72,43,29
Shámi,gilneas,1846,shaman,enhancement,60,29,31
Monamour,twisting-nether,1845,shaman,enhancement,102,63,39
Echoingshock,argent-dawn,1844,shaman,enhancement,60,41,19
Wúh,twisting-nether,1844,shaman,enhancement,271,147,124
Pvpone,ravencrest,1844,shaman,enhancement,42,21,21
Zutemaster,stormscale,1843,shaman,enhancement,164,90,74
Totemofgreed,rexxar,1843,shaman,enhancement,84,40,44
Ferconex,kazzak,1842,shaman,enhancement,250,135,115
Boombastíc,ravencrest,1842,shaman,enhancement,166,83,83
Мсет,soulflayer,1841,shaman,enhancement,35,23,12
Siphem,stormscale,1841,shaman,enhancement,49,31,18
Salvadr,zuljin,1841,shaman,enhancement,91,50,41
Tosemist,stormscale,1840,shaman,enhancement,88,47,41
Marohk,uldum,1840,shaman,enhancement,90,47,43
Dendyre,outland,1840,shaman,enhancement,59,29,30
Вандерласт,howling-fjord,1839,shaman,enhancement,143,81,62
Ozilie,khaz-modan,1838,shaman,enhancement,111,67,44
Nyrat,tarren-mill,1837,shaman,enhancement,71,41,30
Asaakira,blackmoore,1837,shaman,enhancement,331,166,165
Altarian,nemesis,1834,shaman,enhancement,99,53,46
Jtouni,outland,1834,shaman,enhancement,144,72,72
Lekthar,draenor,1833,shaman,enhancement,143,83,60
Exysen,kazzak,1831,shaman,enhancement,54,26,28
Wacomtablet,kazzak,1830,shaman,enhancement,42,24,18
Hermonidas,dun-modr,1829,shaman,enhancement,70,32,38
Ganachimby,zuljin,1828,shaman,enhancement,53,36,17
Schoølbøyq,blackrock,1828,shaman,enhancement,36,22,14
Друггрумилей,soulflayer,1828,shaman,enhancement,42,24,18
Javaburst,ragnaros,1827,shaman,enhancement,203,110,93
Arkîmonde,silvermoon,1827,shaman,enhancement,339,177,162
Miikkas,blackhand,1826,shaman,enhancement,54,38,16
Eselwindzorn,blackrock,1825,shaman,enhancement,53,32,21
Commadore,korgall,1825,shaman,enhancement,71,33,38
Пеклоь,soulflayer,1824,shaman,enhancement,304,149,155
Ananasanax,twisting-nether,1823,shaman,enhancement,114,63,51
Pumpzuat,khadgar,1821,shaman,enhancement,58,37,21
Lava,haomarush,1819,shaman,enhancement,141,80,61
Xôàrqt,eredar,1819,shaman,enhancement,308,163,145
Badmojø,silvermoon,1819,shaman,enhancement,256,121,135
Senroxx,blackrock,1818,shaman,enhancement,48,32,16
Shamtard,frostwhisper,1818,shaman,enhancement,175,89,86
Grouzer,stormscale,1818,shaman,enhancement,84,42,42
Aeisey,archimonde,1817,shaman,enhancement,83,52,31
Argotan,drakthul,1817,shaman,enhancement,71,43,28
Stormlash,shattered-halls,1817,shaman,enhancement,132,77,55
Thunberg,ravencrest,1817,shaman,enhancement,107,61,46
Hapkin,defias-brotherhood,1816,shaman,enhancement,54,38,16
Mckoy,kazzak,1816,shaman,enhancement,40,27,13
Faydé,stormscale,1816,shaman,enhancement,36,19,17
Joanno,aegwynn,1815,shaman,enhancement,54,34,20
Androck,tarren-mill,1815,shaman,enhancement,109,57,52
Bobonbu,forscherliga,1813,shaman,enhancement,47,27,20
Tzaish,blackmoore,1813,shaman,enhancement,99,54,45
Voodooms,laughing-skull,1812,shaman,enhancement,151,91,60
Dhedge,draenor,1812,shaman,enhancement,108,61,47
Gelthan,zuljin,1812,shaman,enhancement,218,119,99
Zulren,draenor,1811,shaman,enhancement,42,23,19
Johncoltrane,archimonde,1810,shaman,enhancement,78,55,23
Dshaman,aegwynn,1810,shaman,enhancement,36,23,13
Speak,ragnaros,1810,shaman,enhancement,66,39,27
Lavalaesh,ravencrest,1810,shaman,enhancement,83,48,35
Jaimæ,ravencrest,1809,shaman,enhancement,30,23,7
Wishstêên,stormscale,1809,shaman,enhancement,64,29,35
Tao,stormscale,1808,shaman,enhancement,24,19,5
Roxâm,hyjal,1808,shaman,enhancement,34,20,14
Ðrshock,blackmoore,1808,shaman,enhancement,54,31,23
Царьколтрэйн,blackscar,1808,shaman,enhancement,179,99,80
Xestil,blackmoore,1808,shaman,enhancement,67,36,31
Testosterone,dun-modr,1808,shaman,enhancement,154,80,74
Маелштромс,soulflayer,1808,shaman,enhancement,90,46,44
Grytkungen,daggerspine,1807,shaman,enhancement,74,48,26
Ewion,dalvengyr,1807,shaman,enhancement,123,79,44
Furystrikez,frostwolf,1807,shaman,enhancement,120,72,48
Archiviert,blackmoore,1807,shaman,enhancement,168,93,75
Zerocarè,tarren-mill,1806,shaman,enhancement,30,22,8
Vartarius,arthas,1806,shaman,enhancement,147,79,68
Buzz,stormscale,1805,shaman,enhancement,60,29,31
Bigthór,kazzak,1804,shaman,enhancement,69,37,32
Nøxz,blackmoore,1804,shaman,enhancement,60,31,29
Altotem,blackmoore,1803,shaman,enhancement,39,27,12
Реактиватор,soulflayer,1803,shaman,enhancement,47,27,20
Actionhank,area-52,1803,shaman,enhancement,99,50,49
Sybred,twisting-nether,1800,shaman,enhancement,126,76,50
Axemodels,archimonde,1800,shaman,enhancement,60,32,28
Vargen,arygos,1799,shaman,enhancement,72,43,29
Pocahøntas,archimonde,1799,shaman,enhancement,98,49,49
Calvey,magtheridon,1799,shaman,enhancement,82,37,45
Stormdrak,eredar,1798,shaman,enhancement,54,34,20
Athe,conseil-des-ombres,1797,shaman,enhancement,164,90,74
Raidwhipper,twisting-nether,1796,shaman,enhancement,168,99,69
Azrs,ravencrest,1796,shaman,enhancement,114,63,51
Shammyenh,burning-legion,1795,shaman,enhancement,84,49,35
Proccq,twisting-nether,1795,shaman,enhancement,48,24,24
Sødeskat,twisting-nether,1792,shaman,enhancement,66,38,28
Nnele,sanguino,1791,shaman,enhancement,112,52,60
Sonnestorm,tarren-mill,1790,shaman,enhancement,64,33,31
Toteemikylpy,argent-dawn,1789,shaman,enhancement,90,54,36
Toobiib,culte-de-la-rive-noire,1789,shaman,enhancement,60,30,30
Calveyy,magtheridon,1788,shaman,enhancement,51,31,20
Чифсоса,soulflayer,1787,shaman,enhancement,110,59,51
Purgerooni,haomarush,1786,shaman,enhancement,82,50,32
Robzn,blackrock,1783,shaman,enhancement,50,32,18
Pumanii,silvermoon,1783,shaman,enhancement,114,63,51
Naturfury,ravencrest,1782,shaman,enhancement,82,59,23
Estasham,stormscale,1781,shaman,enhancement,288,158,130
Spicemélange,archimonde,1781,shaman,enhancement,126,68,58
Blastoiselol,ragnaros,1779,shaman,enhancement,58,36,22
Eysns,blackrock,1779,shaman,enhancement,106,59,47
Tzivati,draenor,1778,shaman,enhancement,77,41,36
Alainralso,archimonde,1777,shaman,enhancement,46,29,17
Stormfíst,tarren-mill,1777,shaman,enhancement,180,96,84
Satanloveme,stormscale,1777,shaman,enhancement,54,28,26
Stormasaurus,anachronos,1775,shaman,enhancement,88,51,37
Florgegoyd,eredar,1774,shaman,enhancement,162,104,58
Snëakyboom,stormscale,1774,shaman,enhancement,102,51,51
Narevoqi,madmortem,1773,shaman,enhancement,46,31,15
Pýthøn,silvermoon,1772,shaman,enhancement,54,27,27
Isucklasso,aegwynn,1769,shaman,enhancement,120,68,52
Chaeemerok,dun-modr,1769,shaman,enhancement,220,112,108
Рэйпушка,gordunni,1769,shaman,enhancement,53,25,28
Faxsham,draenor,1766,shaman,enhancement,90,54,36
Mehex,tarren-mill,1766,shaman,enhancement,108,56,52
Zaeh,antonidas,1765,shaman,enhancement,73,50,23
Caelx,ragnaros,1765,shaman,enhancement,41,27,14
Ludwigson,tarren-mill,1765,shaman,enhancement,143,83,60
Kachori,eredar,1765,shaman,enhancement,275,140,135
Чаапалах,blackscar,1765,shaman,enhancement,348,172,176
Meatballspam,stormscale,1760,shaman,enhancement,77,36,41
Sígrun,aegwynn,1758,shaman,enhancement,42,28,14
Иллюминэйшн,soulflayer,1758,shaman,enhancement,59,32,27
Yacu,blackrock,1758,shaman,enhancement,83,45,38
Voodoodocter,kazzak,1758,shaman,enhancement,171,88,83
Vayshibro,turalyon,1757,shaman,enhancement,94,50,44
Sangoma,frostmane,1756,shaman,enhancement,330,161,169
Видарх,soulflayer,1756,shaman,enhancement,42,20,22
Basz,aegwynn,1754,shaman,enhancement,64,35,29
Madbud,stormscale,1751,shaman,enhancement,83,49,34
Axsos,chamber-of-aspects,1749,shaman,enhancement,42,28,14
Tauridus,blackrock,1748,shaman,enhancement,30,23,7
Lexyiasz,kazzak,1748,shaman,enhancement,100,68,32
Shamflurry,ravencrest,1747,shaman,enhancement,108,60,48
Shaakez,kazzak,1745,shaman,enhancement,181,99,82
Sswfx,kazzak,1744,shaman,enhancement,36,22,14
Shuyö,kazzak,1742,shaman,enhancement,95,56,39
Lokes,drakthul,1742,shaman,enhancement,381,191,190
Максобман,howling-fjord,1741,shaman,enhancement,54,30,24
Babae,draenor,1741,shaman,enhancement,90,34,56
Razzuan,kazzak,1740,shaman,enhancement,132,73,59
Lavalordd,tarren-mill,1738,shaman,enhancement,86,46,40
Totemlié,ravencrest,1737,shaman,enhancement,57,32,25
Acivich,frostmane,1737,shaman,enhancement,102,57,45
Akhlýzz,ysondre,1734,shaman,enhancement,63,39,24
Mèátßãllgøðx,kazzak,1733,shaman,enhancement,165,80,85
Enhshamanop,draenor,1733,shaman,enhancement,330,159,171
Fotmburstwin,blackmoore,1732,shaman,enhancement,54,34,20
Totemilokum,stormscale,1732,shaman,enhancement,48,28,20
Сахарокь,soulflayer,1731,shaman,enhancement,71,38,33
Dzandell,silvermoon,1731,shaman,enhancement,281,136,145
Tobanga,malganis,1730,shaman,enhancement,48,29,19
Riphonda,dragonmaw,1730,shaman,enhancement,84,48,36
Jabaraklol,stormscale,1728,shaman,enhancement,115,72,43
Bkid,archimonde,1728,shaman,enhancement,36,22,14
Reyax,aegwynn,1728,shaman,enhancement,73,38,35
Халльбьерн,howling-fjord,1726,shaman,enhancement,60,36,24
Maksimon,blackrock,1726,shaman,enhancement,60,33,27
Paintball,kazzak,1726,shaman,enhancement,303,160,143
Dóómd,kazzak,1726,shaman,enhancement,207,104,103
Floorislava,culte-de-la-rive-noire,1726,shaman,enhancement,148,71,77
Lurkmon,twisting-nether,1725,shaman,enhancement,136,73,63
Дёмарок,galakrond,1724,shaman,enhancement,100,52,48
Purada,blackrock,1724,shaman,enhancement,94,47,47
Халльбиорн,gordunni,1724,shaman,enhancement,73,36,37
Brenhilda,blackmoore,1722,shaman,enhancement,102,66,36
Dalgia,tarren-mill,1722,shaman,enhancement,42,25,17
Рэггдолл,soulflayer,1722,shaman,enhancement,120,52,68
Azktor,kazzak,1721,shaman,enhancement,128,72,56
Brøxygar,archimonde,1721,shaman,enhancement,176,93,83
Oldstorm,ravencrest,1720,shaman,enhancement,93,51,42
Khrin,blackmoore,1719,shaman,enhancement,48,30,18
Dwarfstil,blackmoore,1719,shaman,enhancement,69,33,36
Lassø,blackmoore,1717,shaman,enhancement,46,26,20
Joanna,frostwolf,1716,shaman,enhancement,79,38,41
Тралси,howling-fjord,1715,shaman,enhancement,24,18,6
Drshockit,blackrock,1715,shaman,enhancement,153,83,70
Yogan,dun-modr,1714,shaman,enhancement,68,38,30
Cryrothx,outland,1714,shaman,enhancement,66,34,32
Ubies,silvermoon,1713,shaman,enhancement,147,83,64
Traktorchox,draenor,1713,shaman,enhancement,105,57,48
Рыганский,blackscar,1713,shaman,enhancement,97,42,55
Procctor,kazzak,1712,shaman,enhancement,30,24,6
Kickapoo,outland,1712,shaman,enhancement,54,32,22
Panzarkamp,stormscale,1709,shaman,enhancement,137,72,65
Volvíc,tichondrius,1709,shaman,enhancement,60,29,31
Hassebolt,draenor,1708,shaman,enhancement,48,27,21
Enhx,ravencrest,1707,shaman,enhancement,36,23,13
Ryhèn,stormscale,1707,shaman,enhancement,292,156,136
Mulf,darksorrow,1707,shaman,enhancement,142,72,70
Seçretweapøn,kazzak,1707,shaman,enhancement,72,36,36
Yeruna,arthas,1706,shaman,enhancement,60,37,23
Шаманмиша,gordunni,1706,shaman,enhancement,458,233,225
Draabada,stormscale,1705,shaman,enhancement,142,71,71
Groyaboý,blackrock,1704,shaman,enhancement,24,18,6
Drade,aegwynn,1704,shaman,enhancement,47,29,18
Пойдипокури,howling-fjord,1703,shaman,enhancement,132,76,56
Kuubskii,ravencrest,1702,shaman,enhancement,71,42,29
Hayvaan,blackrock,1701,shaman,enhancement,263,148,115
Мигнтз,soulflayer,1701,shaman,enhancement,49,24,25
Xxloon,blackrock,1700,shaman,enhancement,257,144,113
Djosershamy,draenor,1699,shaman,enhancement,132,67,65
Gromzog,twisting-nether,1699,shaman,enhancement,124,62,62
Махош,blackscar,1699,shaman,enhancement,42,21,21
Aspên,archimonde,1699,shaman,enhancement,78,35,43
Pontifhkas,ragnaros,1698,shaman,enhancement,123,70,53
Кинговели,soulflayer,1698,shaman,enhancement,386,198,188
Bluetide,ravencrest,1697,shaman,enhancement,57,38,19
Neveil,tarren-mill,1697,shaman,enhancement,36,24,12
Harpiks,tarren-mill,1697,shaman,enhancement,48,29,19
Detestable,eredar,1697,shaman,enhancement,68,34,34
Moini,eredar,1697,shaman,enhancement,102,47,55
Mjjx,blackrock,1696,shaman,enhancement,78,53,25
Fotmglad,blackrock,1696,shaman,enhancement,90,50,40
Людоед,thermaplugg,1696,shaman,enhancement,315,166,149
Aswøg,kazzak,1695,shaman,enhancement,30,21,9
Rabalalaha,twisting-nether,1695,shaman,enhancement,193,98,95
Барракудах,razuvious,1695,shaman,enhancement,212,103,109
Kyraw,tarren-mill,1694,shaman,enhancement,126,69,57
Argarok,argent-dawn,1694,shaman,enhancement,54,29,25
Enoughh,the-maelstrom,1694,shaman,enhancement,90,48,42
Шаманутый,soulflayer,1694,shaman,enhancement,328,161,167
Kaimountain,defias-brotherhood,1693,shaman,enhancement,42,26,16
Амфеминка,gordunni,1693,shaman,enhancement,150,73,77
Fyrkaz,aegwynn,1692,shaman,enhancement,36,21,15
Typhoön,sanguino,1691,shaman,enhancement,259,134,125
Zenka,burning-legion,1690,shaman,enhancement,72,49,23
Царьбер,soulflayer,1690,shaman,enhancement,80,45,35
Lightning,aszune,1690,shaman,enhancement,83,41,42
Lavarage,kazzak,1689,shaman,enhancement,69,41,28
Чесп,ashenvale,1689,shaman,enhancement,138,74,64
Totemtrine,ravencrest,1686,shaman,enhancement,167,90,77
Masztaar,ragnaros,1686,shaman,enhancement,227,116,111
Boltar,die-aldor,1684,shaman,enhancement,44,26,18
Kutipaperi,stormscale,1684,shaman,enhancement,113,65,48
Skyróxx,blackrock,1682,shaman,enhancement,51,30,21
Ïï,archimonde,1682,shaman,enhancement,273,144,129
Rokils,silvermoon,1680,shaman,enhancement,60,34,26
Griins,ravencrest,1680,shaman,enhancement,202,112,90
Взалходил,soulflayer,1680,shaman,enhancement,41,21,20
Духсалата,grom,1680,shaman,enhancement,54,27,27
Andrëw,dalaran,1679,shaman,enhancement,64,38,26
Procdaddy,stormscale,1679,shaman,enhancement,48,20,28
Иннреи,howling-fjord,1678,shaman,enhancement,201,111,90
Spetsnazz,archimonde,1678,shaman,enhancement,230,114,116
Wheygodx,ravencrest,1677,shaman,enhancement,111,58,53
Tito,stormscale,1677,shaman,enhancement,85,36,49
Sciulz,nemesis,1676,shaman,enhancement,30,18,12
Стихиябороды,gordunni,1676,shaman,enhancement,126,72,54
Thunderr,dun-modr,1676,shaman,enhancement,56,31,25
Kosface,tarren-mill,1676,shaman,enhancement,218,117,101
Kedall,archimonde,1676,shaman,enhancement,66,32,34
Tdogfx,blackhand,1675,shaman,enhancement,78,45,33
Wafflë,ragnaros,1675,shaman,enhancement,126,66,60
Doomëd,drakthul,1675,shaman,enhancement,48,24,24
Turbopuddi,kazzak,1674,shaman,enhancement,95,49,46
Palmalecki,ravencrest,1674,shaman,enhancement,75,37,38
Greythunda,archimonde,1672,shaman,enhancement,36,23,13
Björnbritta,outland,1672,shaman,enhancement,74,40,34
Ázøk,stormscale,1672,shaman,enhancement,293,144,149
Kenjaiir,twisting-nether,1671,shaman,enhancement,30,20,10
Venomos,kazzak,1671,shaman,enhancement,84,41,43
Raíndra,twisting-nether,1670,shaman,enhancement,107,59,48
Totemticks,aegwynn,1670,shaman,enhancement,78,42,36
Yobro,archimonde,1669,shaman,enhancement,96,55,41
Tinysalmon,hyjal,1669,shaman,enhancement,84,43,41
Rayoton,burning-legion,1669,shaman,enhancement,108,53,55
Shonbelly,argent-dawn,1668,shaman,enhancement,58,37,21
Mohammed,kilrogg,1668,shaman,enhancement,47,28,19
Shamerific,magtheridon,1668,shaman,enhancement,108,63,45
Асцэндэд,lich-king,1668,shaman,enhancement,94,50,44
Pïdòrás,kazzak,1668,shaman,enhancement,59,30,29
Shambamm,stormscale,1667,shaman,enhancement,60,35,25
Naahma,hyjal,1667,shaman,enhancement,88,39,49
Neystee,archimonde,1666,shaman,enhancement,36,21,15
Bærserker,blackmoore,1665,shaman,enhancement,52,29,23
Onepatchman,silvermoon,1665,shaman,enhancement,174,86,88
Depucova,silvermoon,1663,shaman,enhancement,88,56,32
Selticxz,blackrock,1663,shaman,enhancement,36,20,16
Botism,draenor,1663,shaman,enhancement,126,68,58
Funkins,hyjal,1663,shaman,enhancement,156,80,76
Veteroth,argent-dawn,1662,shaman,enhancement,132,69,63
Skilltissue,executus,1662,shaman,enhancement,102,53,49
Ñøs,blackrock,1662,shaman,enhancement,126,64,62
Lersham,the-maelstrom,1659,shaman,enhancement,89,48,41
Buffmepls,sanguino,1659,shaman,enhancement,56,28,28
Sêarix,aegwynn,1658,shaman,enhancement,120,69,51
Darkning,kazzak,1658,shaman,enhancement,90,50,40
Thoshir,silvermoon,1657,shaman,enhancement,23,19,4
Cripxo,sanguino,1657,shaman,enhancement,30,24,6
Smallwiik,hyjal,1657,shaman,enhancement,54,38,16
Bourdieu,thrall,1657,shaman,enhancement,132,76,56
Worstshamy,sanguino,1657,shaman,enhancement,42,23,19
Statikznba,outland,1656,shaman,enhancement,30,18,12
Dectus,blackrock,1656,shaman,enhancement,48,26,22
Thorâ,frostmane,1655,shaman,enhancement,103,65,38
Grrud,draenor,1655,shaman,enhancement,48,27,21
Agathoulis,burning-legion,1655,shaman,enhancement,84,42,42
Ripstorm,sylvanas,1655,shaman,enhancement,54,26,28
Foulecamp,archimonde,1654,shaman,enhancement,172,92,80
Chêlëx,silvermoon,1654,shaman,enhancement,200,106,94
Kynaz,sanguino,1653,shaman,enhancement,183,86,97
Xanoo,stormscale,1652,shaman,enhancement,38,22,16
Níkíta,hyjal,1651,shaman,enhancement,71,46,25
Лолимин,borean-tundra,1651,shaman,enhancement,51,33,18
Fiveyearsque,sylvanas,1651,shaman,enhancement,78,48,30
Плаглорд,howling-fjord,1651,shaman,enhancement,108,63,45
Toxicnux,nemesis,1651,shaman,enhancement,60,35,25
Tryor,darksorrow,1651,shaman,enhancement,48,26,22
Kilomanjaro,bloodfeather,1651,shaman,enhancement,66,35,31
Obrijames,tarren-mill,1651,shaman,enhancement,118,62,56
Everblast,arathor,1651,shaman,enhancement,42,20,22
Fiskätarn,kazzak,1651,shaman,enhancement,51,20,31
Yox,dun-modr,1650,shaman,enhancement,58,38,20
Purgelord,tarren-mill,1650,shaman,enhancement,86,52,34
Romacherry,aegwynn,1649,shaman,enhancement,179,102,77
Kaboomgødx,blackhand,1649,shaman,enhancement,47,26,21
Láynert,dun-modr,1649,shaman,enhancement,379,188,191
Pvtpunch,stormscale,1648,shaman,enhancement,42,25,17
Fabz,twisting-nether,1647,shaman,enhancement,48,28,20
Ðreamz,kaelthas,1647,shaman,enhancement,304,155,149
Locosonik,kazzak,1647,shaman,enhancement,58,28,30
Mecct,ravencrest,1646,shaman,enhancement,88,55,33
Testogodx,defias-brotherhood,1646,shaman,enhancement,99,54,45
Teyshtwö,archimonde,1646,shaman,enhancement,106,52,54
Plockepinn,ravencrest,1646,shaman,enhancement,84,38,46
Жезуш,galakrond,1645,shaman,enhancement,81,52,29
Arkaos,exodar,1645,shaman,enhancement,73,46,27
Alwaysangry,silvermoon,1645,shaman,enhancement,103,55,48
Cch,kazzak,1645,shaman,enhancement,84,43,41
Thunderhøøf,blackhand,1644,shaman,enhancement,30,19,11
Etrog,kazzak,1644,shaman,enhancement,66,38,28
Noxz,blackrock,1644,shaman,enhancement,41,19,22
Makaar,blackrock,1643,shaman,enhancement,54,28,26
Wyrdanas,drakthul,1642,shaman,enhancement,91,48,43
Spacelazers,twisting-nether,1641,shaman,enhancement,29,19,10
Shawck,ravencrest,1641,shaman,enhancement,58,34,24
Ghostkod,burning-legion,1641,shaman,enhancement,265,146,119
Чухансмент,gordunni,1641,shaman,enhancement,78,42,36
Vøda,twisting-nether,1640,shaman,enhancement,36,22,14
Krassus,drakthul,1640,shaman,enhancement,65,39,26
Boradinn,hyjal,1640,shaman,enhancement,66,37,29
Ooupsjr,tarren-mill,1640,shaman,enhancement,48,24,24
Тоннимонтана,howling-fjord,1639,shaman,enhancement,80,51,29
Lethal,darksorrow,1639,shaman,enhancement,87,50,37
Convîcted,grim-batol,1639,shaman,enhancement,125,70,55
Painshock,outland,1639,shaman,enhancement,159,82,77
Mmsalatik,nemesis,1639,shaman,enhancement,54,24,30
Jinckks,anachronos,1638,shaman,enhancement,36,21,15
Kijin,kirin-tor,1638,shaman,enhancement,142,76,66
Громовойбро,blackscar,1637,shaman,enhancement,42,24,18
Magmamonster,tarren-mill,1637,shaman,enhancement,48,25,23
Runeksham,tarren-mill,1636,shaman,enhancement,66,42,24
Btray,ravencrest,1636,shaman,enhancement,84,51,33
Freyrr,tarren-mill,1636,shaman,enhancement,308,160,148
Torcok,sanguino,1635,shaman,enhancement,42,22,20
Khelyyn,tarren-mill,1635,shaman,enhancement,82,41,41
Alexmahone,dun-morogh,1635,shaman,enhancement,72,36,36
Carrywho,blackrock,1634,shaman,enhancement,30,19,11
Faltygo,drakthul,1634,shaman,enhancement,72,38,34
Ашхикиган,howling-fjord,1634,shaman,enhancement,150,69,81
Schôcker,blackmoore,1633,shaman,enhancement,60,40,20
Elemoont,tarren-mill,1633,shaman,enhancement,48,28,20
Legitbro,ravencrest,1633,shaman,enhancement,54,25,29
Gandy,the-maelstrom,1632,shaman,enhancement,180,92,88
Belroc,ravencrest,1631,shaman,enhancement,42,21,21
Nibblez,aegwynn,1630,shaman,enhancement,84,52,32
Kezron,aegwynn,1629,shaman,enhancement,42,23,19
Defiaz,stormscale,1628,shaman,enhancement,68,45,23
Patsham,wildhammer,1628,shaman,enhancement,137,79,58
Natty,ravencrest,1628,shaman,enhancement,42,22,20
Lilmozart,twisting-nether,1628,shaman,enhancement,35,18,17
Pinácoladáqt,stormscale,1627,shaman,enhancement,66,35,31
Barrathrum,stormscale,1626,shaman,enhancement,30,22,8
Snuskilaban,tarren-mill,1626,shaman,enhancement,90,56,34
Ùseless,archimonde,1626,shaman,enhancement,36,20,16
Vann,the-shatar,1626,shaman,enhancement,79,39,40
Madzÿ,archimonde,1625,shaman,enhancement,48,28,20
Raijinn,blackrock,1625,shaman,enhancement,100,57,43
Thørÿm,archimonde,1624,shaman,enhancement,64,37,27
Gnubbzer,antonidas,1624,shaman,enhancement,78,42,36
Vforvendeta,defias-brotherhood,1624,shaman,enhancement,137,73,64
Chamkalix,sanguino,1624,shaman,enhancement,78,40,38
Proccazu,draenor,1623,shaman,enhancement,90,57,33
Broock,kazzak,1623,shaman,enhancement,42,25,17
Khanaky,hyjal,1623,shaman,enhancement,168,89,79
Sgf,stormscale,1623,shaman,enhancement,84,44,40
Rahtafary,sanguino,1623,shaman,enhancement,43,21,22
Enh,archimonde,1623,shaman,enhancement,36,17,19
Shyne,vashj,1622,shaman,enhancement,102,55,47
Úpli,blackmoore,1621,shaman,enhancement,30,18,12
Twists,sylvanas,1621,shaman,enhancement,36,21,15
Veronikka,dalaran,1621,shaman,enhancement,56,26,30
Hailele,argent-dawn,1620,shaman,enhancement,38,25,13
Одтагад,gordunni,1620,shaman,enhancement,220,115,105
Filiduttsham,ravencrest,1619,shaman,enhancement,30,22,8
Akimó,ravencrest,1619,shaman,enhancement,89,43,46
Gøretterøg,ysondre,1618,shaman,enhancement,39,24,15
Shamarach,ragnaros,1618,shaman,enhancement,41,25,16
Twkupe,tarren-mill,1618,shaman,enhancement,42,23,19
Krishun,blackmoore,1618,shaman,enhancement,55,25,30
Зэбой,howling-fjord,1616,shaman,enhancement,50,33,17
Shocktopussi,stormscale,1616,shaman,enhancement,87,50,37
Kæzx,blackrock,1616,shaman,enhancement,66,34,32
Kyshka,tarren-mill,1616,shaman,enhancement,36,17,19
Werdup,sunstrider,1616,shaman,enhancement,44,19,25
Donkingkong,ravencrest,1615,shaman,enhancement,90,51,39
Ibicc,twisting-nether,1615,shaman,enhancement,49,26,23
Kagurja,blackmoore,1614,shaman,enhancement,30,21,9
Ревашторм,howling-fjord,1612,shaman,enhancement,96,53,43
Alethea,frostmane,1612,shaman,enhancement,102,55,47
Moaxtyr,blackmoore,1611,shaman,enhancement,78,48,30
Ореганно,howling-fjord,1611,shaman,enhancement,72,40,32
Galthazar,silvermoon,1611,shaman,enhancement,70,38,32
Jondil,das-syndikat,1611,shaman,enhancement,71,37,34
Zakgar,ysondre,1611,shaman,enhancement,170,88,82
Stalkun,tarren-mill,1611,shaman,enhancement,60,31,29
Мистерэнх,soulflayer,1611,shaman,enhancement,42,20,22
Trenhard,wildhammer,1610,shaman,enhancement,95,60,35
Tàvèrnellø,nemesis,1610,shaman,enhancement,34,21,13
Electricgødx,tarren-mill,1610,shaman,enhancement,36,21,15
Stromkek,eredar,1610,shaman,enhancement,116,66,50
Satisfya,ambossar,1610,shaman,enhancement,81,46,35
Dumbasha,ravencrest,1610,shaman,enhancement,30,17,13
Tarantan,eredar,1610,shaman,enhancement,78,44,34
Mefhaman,tarren-mill,1609,shaman,enhancement,61,39,22
Benderbub,blackhand,1609,shaman,enhancement,130,70,60
Reverbx,outland,1608,shaman,enhancement,66,35,31
Шокмужик,gordunni,1608,shaman,enhancement,60,28,32
Cealdlynn,blackmoore,1607,shaman,enhancement,41,24,17
Ecclîpce,archimonde,1607,shaman,enhancement,93,52,41
Elémenta,turalyon,1607,shaman,enhancement,54,30,24
Ancestro,kazzak,1606,shaman,enhancement,60,32,28
Madmadbro,tarren-mill,1606,shaman,enhancement,228,120,108
Шанья,gordunni,1606,shaman,enhancement,249,121,128
Kættmæck,tarren-mill,1605,shaman,enhancement,132,68,64
Ивми,gordunni,1605,shaman,enhancement,41,21,20
Sherlokholms,ravencrest,1604,shaman,enhancement,74,39,35
Hyi,silvermoon,1604,shaman,enhancement,48,23,25
Sitkosham,burning-blade,1603,shaman,enhancement,146,80,66
Mástà,onyxia,1602,shaman,enhancement,42,28,14
Arashi,rashgarroth,1602,shaman,enhancement,167,91,76
Sélenágóméz,chamber-of-aspects,1602,shaman,enhancement,52,28,24
Vulkân,silvermoon,1601,shaman,enhancement,176,97,79
Neurax,sanguino,1601,shaman,enhancement,106,54,52
Naïda,conseil-des-ombres,1601,shaman,enhancement,264,129,135
Crysis,sanguino,1601,shaman,enhancement,42,19,23
Tijae,ravencrest,1600,shaman,enhancement,24,19,5
Rutil,blackhand,1600,shaman,enhancement,80,47,33
Zayliha,ravencrest,1600,shaman,enhancement,66,37,29
Porphy,kazzak,1600,shaman,enhancement,69,38,31
Buuddha,drakthul,1600,shaman,enhancement,71,39,32
Sparkii,kazzak,1600,shaman,enhancement,48,23,25
Amelie,burning-steppes,1597,shaman,enhancement,48,27,21
Megazz,drakthul,1597,shaman,enhancement,105,56,49
Thalir,aegwynn,1597,shaman,enhancement,121,60,61
Sndheal,kazzak,1596,shaman,enhancement,24,19,5
Громовойболт,howling-fjord,1596,shaman,enhancement,36,24,12
Practical,argent-dawn,1596,shaman,enhancement,80,51,29
Kooda,hyjal,1596,shaman,enhancement,54,29,25
Ubramovitch,hyjal,1596,shaman,enhancement,60,32,28
Khamo,twisting-nether,1596,shaman,enhancement,113,54,59
Tianoele,drakthul,1595,shaman,enhancement,39,25,14
Ойрхин,greymane,1595,shaman,enhancement,120,59,61
Pintulicious,antonidas,1593,shaman,enhancement,36,20,16
Nînadobrevx,stormscale,1593,shaman,enhancement,177,96,81
Рокмару,soulflayer,1593,shaman,enhancement,63,30,33
Гоэл,ashenvale,1592,shaman,enhancement,142,73,69
Voodoohexman,kazzak,1590,shaman,enhancement,226,119,107
Mikesinatra,tarren-mill,1589,shaman,enhancement,33,20,13
Åkra,kazzak,1589,shaman,enhancement,40,21,19
Kpåshaman,tarren-mill,1588,shaman,enhancement,76,46,30
Пучмек,gordunni,1587,shaman,enhancement,54,37,17
Oneshotunía,burning-legion,1587,shaman,enhancement,30,18,12
Blazingfiré,tarren-mill,1587,shaman,enhancement,66,37,29
Миддей,blackscar,1587,shaman,enhancement,48,26,22
Элементи,gordunni,1587,shaman,enhancement,447,231,216
Scherolol,aegwynn,1586,shaman,enhancement,30,20,10
Malyalewaria,silvermoon,1585,shaman,enhancement,63,44,19
Slímshámmy,twisting-nether,1585,shaman,enhancement,44,21,23
Mylilfurry,blackhand,1584,shaman,enhancement,76,47,29
Thunderdøme,stormscale,1584,shaman,enhancement,53,26,27
Shamspam,arathor,1583,shaman,enhancement,48,39,9
Kammek,tarren-mill,1583,shaman,enhancement,81,48,33
Äijä,chromaggus,1582,shaman,enhancement,96,51,45
Nuclearjohny,eredar,1581,shaman,enhancement,78,40,38
Wørldrúiner,kazzak,1578,shaman,enhancement,57,30,27
Ромчи,gordunni,1578,shaman,enhancement,36,18,18
Medoje,argent-dawn,1577,shaman,enhancement,30,24,6
Sector,silvermoon,1577,shaman,enhancement,72,32,40
Enkzäm,archimonde,1576,shaman,enhancement,192,107,85
Evalennart,stormscale,1575,shaman,enhancement,84,47,37
Kolbászlelkü,ragnaros,1573,shaman,enhancement,74,38,36
Elèon,blackrock,1573,shaman,enhancement,209,100,109
Лилнасыкс,gordunni,1571,shaman,enhancement,92,48,44
Ql,twisting-nether,1571,shaman,enhancement,89,44,45
Wertih,burning-legion,1570,shaman,enhancement,56,35,21
Бурехлест,howling-fjord,1568,shaman,enhancement,78,45,33
Эбгерсон,soulflayer,1568,shaman,enhancement,234,123,111
Wârmachiine,burning-legion,1568,shaman,enhancement,178,91,87
Neovim,trollbane,1567,shaman,enhancement,65,33,32
Mamacitá,eredar,1567,shaman,enhancement,203,99,104
Лапища,soulflayer,1566,shaman,enhancement,113,65,48
Порнёреф,howling-fjord,1566,shaman,enhancement,171,98,73
Trent,tarren-mill,1566,shaman,enhancement,210,111,99
Loshohealva,stormscale,1566,shaman,enhancement,72,37,35
Azzizael,argent-dawn,1566,shaman,enhancement,108,55,53
Cãlipsio,kazzak,1565,shaman,enhancement,41,22,19
Reparagos,sanguino,1565,shaman,enhancement,143,73,70
Thrâwl,kazzak,1563,shaman,enhancement,24,19,5
Sûmmêrz,ravencrest,1563,shaman,enhancement,42,25,17
Колаэнжоер,soulflayer,1563,shaman,enhancement,99,53,46
Ferome,kazzak,1563,shaman,enhancement,48,22,26
Bumbummann,blackmoore,1561,shaman,enhancement,124,61,63
Tóyzz,ravencrest,1560,shaman,enhancement,82,49,33
Тандершторм,soulflayer,1560,shaman,enhancement,172,97,75
Kohnân,hyjal,1559,shaman,enhancement,210,115,95
Groumgard,hyjal,1559,shaman,enhancement,62,33,29
Oronakgladx,ravencrest,1559,shaman,enhancement,182,94,88
Healníx,ravencrest,1559,shaman,enhancement,54,24,30
Ocnan,malganis,1558,shaman,enhancement,92,48,44
Earthhulk,thrall,1558,shaman,enhancement,55,28,27
Ekinoz,outland,1558,shaman,enhancement,133,61,72
Thunderpath,ragnaros,1557,shaman,enhancement,54,29,25
Kilniz,archimonde,1557,shaman,enhancement,32,17,15
Pilcosham,frostwhisper,1557,shaman,enhancement,149,75,74
Shooktide,blackrock,1557,shaman,enhancement,42,21,21
Yelawolf,shattered-hand,1556,shaman,enhancement,66,38,28
Madboys,kazzak,1556,shaman,enhancement,102,48,54
Bozzclqwnx,aegwynn,1555,shaman,enhancement,92,52,40
Kfcmanager,ravencrest,1554,shaman,enhancement,96,53,43
Casualhex,argent-dawn,1554,shaman,enhancement,564,284,280
Drímé,ravencrest,1553,shaman,enhancement,90,57,33
Moosavi,kazzak,1553,shaman,enhancement,36,19,17
Tism,stormscale,1552,shaman,enhancement,52,32,20
Tiuzzo,alakir,1552,shaman,enhancement,42,23,19
Thralgr,sylvanas,1552,shaman,enhancement,66,31,35
Dunî,tarren-mill,1551,shaman,enhancement,90,55,35
Dolkoditch,outland,1551,shaman,enhancement,36,20,16
Heeze,doomhammer,1550,shaman,enhancement,310,163,147
Smozze,grim-batol,1550,shaman,enhancement,261,131,130
Ugory,die-aldor,1549,shaman,enhancement,24,18,6
Darhgan,argent-dawn,1549,shaman,enhancement,80,47,33
Reisti,stormscale,1548,shaman,enhancement,42,27,15
Mowjo,la-croisade-écarlate,1548,shaman,enhancement,36,18,18
Грушовыйторт,howling-fjord,1547,shaman,enhancement,53,27,26
Windypops,tarren-mill,1547,shaman,enhancement,48,23,25
Kuzsham,archimonde,1547,shaman,enhancement,45,20,25
Rehgan,ragnaros,1546,shaman,enhancement,96,58,38
Pyrabolt,ravencrest,1546,shaman,enhancement,123,61,62
Apexpredlol,blackmoore,1546,shaman,enhancement,96,45,51
Triplezug,archimonde,1545,shaman,enhancement,54,30,24
Îzanami,ravencrest,1545,shaman,enhancement,179,97,82
Shroomzzx,blackmoore,1545,shaman,enhancement,104,53,51
Elemefayoh,tarren-mill,1545,shaman,enhancement,96,48,48
Sházam,destromath,1544,shaman,enhancement,72,39,33
Hexrated,draenor,1543,shaman,enhancement,117,67,50
Drexx,thrall,1543,shaman,enhancement,40,22,18
Tartakos,ravencrest,1543,shaman,enhancement,85,44,41
Stormbreáker,twisting-nether,1542,shaman,enhancement,226,122,104
Windstørm,tarren-mill,1541,shaman,enhancement,33,19,14
Zooloo,twilights-hammer,1541,shaman,enhancement,88,46,42
Urub,draenor,1541,shaman,enhancement,565,287,278
Secramas,ragnaros,1539,shaman,enhancement,178,93,85
Jeki,ysondre,1539,shaman,enhancement,263,128,135
Tharma,blackmoore,1538,shaman,enhancement,42,25,17
Tejasviin,amanthul,1538,shaman,enhancement,78,28,50
Juniyaa,blackrock,1537,shaman,enhancement,101,53,48
Skut,zuljin,1537,shaman,enhancement,58,30,28
Cåmilis,archimonde,1537,shaman,enhancement,121,59,62
Madeej,burning-legion,1536,shaman,enhancement,30,18,12
Souljaman,silvermoon,1536,shaman,enhancement,70,40,30
Barneyflight,ravencrest,1536,shaman,enhancement,59,31,28
Mazokuu,ragnaros,1535,shaman,enhancement,217,119,98
Бицэпс,gordunni,1534,shaman,enhancement,48,26,22
Keisys,kazzak,1534,shaman,enhancement,53,27,26
Rehgar,frostwhisper,1534,shaman,enhancement,120,59,61
Акаварри,gordunni,1533,shaman,enhancement,24,17,7
Pelorta,zuljin,1533,shaman,enhancement,35,23,12
Epicenter,bloodscalp,1533,shaman,enhancement,78,37,41
Politemanner,stormscale,1532,shaman,enhancement,30,16,14
Mesrines,archimonde,1532,shaman,enhancement,66,35,31
Billburr,aegwynn,1531,shaman,enhancement,24,16,8
Kàffkalafká,blackrock,1531,shaman,enhancement,40,20,20
Онеоне,deathweaver,1530,shaman,enhancement,36,17,19
Дефибо,howling-fjord,1529,shaman,enhancement,204,105,99
Gerethor,burning-legion,1529,shaman,enhancement,111,54,57
Raindx,draenor,1527,shaman,enhancement,24,16,8
Nubokesel,ragnaros,1527,shaman,enhancement,190,101,89
Jawoburst,antonidas,1527,shaman,enhancement,77,40,37
Ugáa,malganis,1527,shaman,enhancement,36,18,18
Скерлайн,blackscar,1527,shaman,enhancement,66,29,37
Shaayys,archimonde,1526,shaman,enhancement,283,140,143
Axilary,tarren-mill,1525,shaman,enhancement,24,16,8
Lapürge,archimonde,1525,shaman,enhancement,51,30,21
Ruintotems,twisting-nether,1524,shaman,enhancement,35,24,11
Løktarøgàr,archimonde,1524,shaman,enhancement,83,46,37
Chamirox,ysondre,1523,shaman,enhancement,174,88,86
Mõrax,ysondre,1523,shaman,enhancement,228,113,115
Garulf,twisting-nether,1523,shaman,enhancement,135,65,70
Rubmehtotem,silvermoon,1522,shaman,enhancement,24,16,8
Kurdhran,blackmoore,1522,shaman,enhancement,132,71,61
Windshockah,tarren-mill,1522,shaman,enhancement,89,47,42
Твалор,soulflayer,1521,shaman,enhancement,188,101,87
Swoltz,argent-dawn,1521,shaman,enhancement,108,49,59
Krovn,aszune,1521,shaman,enhancement,60,27,33
Флэшмэн,blackscar,1520,shaman,enhancement,24,19,5
Litenrolixd,tarren-mill,1520,shaman,enhancement,34,18,16
Fromhaven,doomhammer,1520,shaman,enhancement,76,40,36
Mudwalker,ravencrest,1520,shaman,enhancement,33,17,16
Тандеркок,soulflayer,1519,shaman,enhancement,197,97,100
Hïgør,hyjal,1518,shaman,enhancement,42,26,16
Zows,kazzak,1518,shaman,enhancement,48,28,20
Хаммерн,gordunni,1518,shaman,enhancement,149,73,76
Lupisregina,silvermoon,1517,shaman,enhancement,24,16,8
Tornis,terokkar,1517,shaman,enhancement,137,68,69
Pepernootje,sylvanas,1517,shaman,enhancement,70,34,36
Puumbaa,defias-brotherhood,1516,shaman,enhancement,102,52,50
Boulestraan,silvermoon,1516,shaman,enhancement,61,26,35
Xzan,tarren-mill,1516,shaman,enhancement,72,28,44
Тессельхоф,howling-fjord,1515,shaman,enhancement,42,23,19
Wylly,aegwynn,1515,shaman,enhancement,30,16,14
Irønythar,drakthul,1514,shaman,enhancement,83,42,41
Frrostshockk,outland,1514,shaman,enhancement,36,17,19
Cowfeelings,ravencrest,1513,shaman,enhancement,30,16,14
Lightningrod,ravencrest,1512,shaman,enhancement,81,48,33
Shalisazzar,dentarg,1512,shaman,enhancement,48,27,21
Filigran,ragnaros,1512,shaman,enhancement,132,72,60
Shoqt,les-sentinelles,1512,shaman,enhancement,42,22,20
Gorrissen,sylvanas,1512,shaman,enhancement,60,31,29
Ghorlin,draenor,1512,shaman,enhancement,84,43,41
Silden,thrall,1511,shaman,enhancement,18,16,2
Whizjy,sanguino,1511,shaman,enhancement,75,40,35
Wolfshade,aggra-português,1509,shaman,enhancement,68,41,27
Nwäar,archimonde,1509,shaman,enhancement,102,51,51
Жуксик,greymane,1509,shaman,enhancement,66,31,35
Apocadwarf,auchindoun,1508,shaman,enhancement,24,16,8
Soomx,hyjal,1508,shaman,enhancement,116,59,57
Miriam,stormreaver,1507,shaman,enhancement,54,31,23
Ghostwolfe,ravencrest,1507,shaman,enhancement,30,16,14
Blitzboss,eredar,1507,shaman,enhancement,54,28,26
Cheetooth,ragnaros,1507,shaman,enhancement,105,52,53
Shockndawe,kazzak,1506,shaman,enhancement,48,26,22
Дректаш,soulflayer,1506,shaman,enhancement,108,55,53
Ират,howling-fjord,1505,shaman,enhancement,66,46,20
Гексанол,soulflayer,1505,shaman,enhancement,93,50,43
Mistahbeard,stormscale,1505,shaman,enhancement,90,47,43
Ric,nemesis,1505,shaman,enhancement,48,19,29
Antomadorf,ravencrest,1504,shaman,enhancement,66,38,28
Boulggour,chogall,1504,shaman,enhancement,121,64,57
Orshan,draenor,1502,shaman,enhancement,156,87,69
Юрахафанбой,blackscar,1502,shaman,enhancement,30,16,14
Lëvi,archimonde,1501,shaman,enhancement,57,33,24
Sleven,twisting-nether,1501,shaman,enhancement,30,16,14
Bolgrath,blackmoore,1500,shaman,enhancement,121,61,60
Zomac,tarren-mill,1499,shaman,enhancement,30,17,13
Shammyspam,outland,1498,shaman,enhancement,35,21,14
Thorcc,kazzak,1498,shaman,enhancement,90,45,45
Hexwife,archimonde,1497,shaman,enhancement,245,121,124
Korvok,draenor,1497,shaman,enhancement,36,16,20
Imbaone,karazhan,1496,shaman,enhancement,54,31,23
Tanjîrø,archimonde,1496,shaman,enhancement,42,24,18
Capsoul,ravencrest,1496,shaman,enhancement,82,45,37
Preams,blackrock,1496,shaman,enhancement,44,22,22
Lickzmytotem,draenor,1495,shaman,enhancement,66,34,32
Earthshot,magtheridon,1495,shaman,enhancement,58,28,30
Штурвальный,blackscar,1494,shaman,enhancement,30,17,13
Nìno,azshara,1494,shaman,enhancement,35,16,19
Tunae,azjolnerub,1492,shaman,enhancement,52,28,24
Барракудах,gordunni,1492,shaman,enhancement,364,176,188
Baldmommy,tarren-mill,1491,shaman,enhancement,23,16,7
Freadorn,uldaman,1491,shaman,enhancement,24,16,8
Otacboziji,sylvanas,1491,shaman,enhancement,112,54,58
Kanaky,hyjal,1491,shaman,enhancement,79,36,43
Таиров,soulflayer,1490,shaman,enhancement,30,23,7
Nexdown,archimonde,1490,shaman,enhancement,57,28,29
Atée,silvermoon,1490,shaman,enhancement,87,42,45
Амг,booty-bay,1489,shaman,enhancement,121,70,51
Volltinus,tarren-mill,1489,shaman,enhancement,83,35,48
Rîzza,blackmoore,1489,shaman,enhancement,42,17,25
Juliaroberts,ragnaros,1488,shaman,enhancement,129,72,57
Mhoriaak,stormscale,1488,shaman,enhancement,119,64,55
Хастурыч,gordunni,1487,shaman,enhancement,159,83,76
Szublime,stormscale,1487,shaman,enhancement,130,65,65
Razush,draenor,1486,shaman,enhancement,30,17,13
Ericlomax,frostwhisper,1486,shaman,enhancement,76,41,35
Fatflop,sylvanas,1486,shaman,enhancement,96,51,45
Paschol,aegwynn,1486,shaman,enhancement,33,16,17
Drockg,ravencrest,1485,shaman,enhancement,30,17,13
Crowness,ragnaros,1485,shaman,enhancement,119,62,57
Элетеми,soulflayer,1485,shaman,enhancement,95,48,47
Mcbloob,kazzak,1485,shaman,enhancement,141,70,71
Orsted,blackhand,1484,shaman,enhancement,35,16,19
Nargrul,tarren-mill,1483,shaman,enhancement,74,43,31
Vrontes,kazzak,1483,shaman,enhancement,77,44,33
Dwarfofwar,ravencrest,1483,shaman,enhancement,46,26,20
Barthølømew,kazzak,1483,shaman,enhancement,54,30,24
Mehboul,hyjal,1482,shaman,enhancement,36,19,17
Juicewillis,defias-brotherhood,1481,shaman,enhancement,84,50,34
Numeschnäu,eredar,1479,shaman,enhancement,36,22,14
Моктрогтар,ashenvale,1478,shaman,enhancement,212,113,99
Axahavregryn,kazzak,1478,shaman,enhancement,100,49,51
Чёкнутое,soulflayer,1477,shaman,enhancement,136,81,55
Wolfmane,twisting-nether,1477,shaman,enhancement,125,56,69
Wolfwesti,outland,1476,shaman,enhancement,48,33,15
Chikidi,silvermoon,1476,shaman,enhancement,36,21,15
Chimp,lightnings-blade,1475,shaman,enhancement,36,21,15
Trendsetter,frostmane,1475,shaman,enhancement,50,29,21
Rocktopus,outland,1475,shaman,enhancement,57,27,30
Nêmônin,perenolde,1474,shaman,enhancement,30,18,12
Tornadozzer,burning-legion,1474,shaman,enhancement,128,74,54
Кесмар,soulflayer,1474,shaman,enhancement,72,41,31
Mîkè,draenor,1474,shaman,enhancement,30,16,14
Ramaka,aegwynn,1474,shaman,enhancement,57,25,32
Takazer,ysondre,1473,shaman,enhancement,36,26,10
Gorezz,stormscale,1472,shaman,enhancement,44,22,22
Шамунчез,gordunni,1472,shaman,enhancement,59,29,30
Kärmá,stormscale,1471,shaman,enhancement,28,16,12
Enigmar,stormscale,1471,shaman,enhancement,93,43,50
Makotonagano,ravencrest,1470,shaman,enhancement,101,57,44
Атл,deathguard,1469,shaman,enhancement,103,63,40
Elevotor,kult-der-verdammten,1468,shaman,enhancement,30,16,14
Ønlýsîn,eredar,1468,shaman,enhancement,47,25,22
Aurèl,culte-de-la-rive-noire,1468,shaman,enhancement,76,34,42
Roovenhance,aegwynn,1467,shaman,enhancement,40,27,13
Stratholmee,drakthul,1467,shaman,enhancement,86,47,39
Фарраон,deathguard,1467,shaman,enhancement,213,112,101
Xwitchdoctor,draenor,1466,shaman,enhancement,121,59,62
Totemlover,draenor,1465,shaman,enhancement,137,76,61
Пивототем,gordunni,1465,shaman,enhancement,50,27,23
Zmech,chamber-of-aspects,1465,shaman,enhancement,67,30,37
Erupted,draenor,1464,shaman,enhancement,73,34,39
Mockingghost,blackmoore,1463,shaman,enhancement,36,19,17
Дромгрон,howling-fjord,1463,shaman,enhancement,42,22,20
Movex,arathor,1463,shaman,enhancement,57,27,30
Hairball,turalyon,1462,shaman,enhancement,48,27,21
Shamrún,sylvanas,1462,shaman,enhancement,108,55,53
Obelicius,outland,1461,shaman,enhancement,86,47,39
Dökowski,nemesis,1461,shaman,enhancement,84,37,47
Apekeeper,silvermoon,1461,shaman,enhancement,66,29,37
Шамвкроксах,howling-fjord,1461,shaman,enhancement,60,26,34
Upisi,burning-legion,1460,shaman,enhancement,78,43,35
Earthquaker,the-maelstrom,1459,shaman,enhancement,36,21,15
Itswoland,tarren-mill,1459,shaman,enhancement,40,21,19
Maskiimon,blackrock,1458,shaman,enhancement,32,17,15
Stormblitz,twisting-nether,1458,shaman,enhancement,90,45,45
Tonifo,nemesis,1458,shaman,enhancement,101,50,51
Джаабб,booty-bay,1458,shaman,enhancement,153,73,80
Carousel,blackrock,1458,shaman,enhancement,34,16,18
Zyphel,draenor,1457,shaman,enhancement,36,21,15
Vascodagama,twisting-nether,1457,shaman,enhancement,54,30,24
Yabadabadoo,burning-legion,1457,shaman,enhancement,72,38,34
Тысячаимен,gordunni,1457,shaman,enhancement,58,27,31
Ózyy,draenor,1456,shaman,enhancement,34,21,13
Лаваяшка,gordunni,1456,shaman,enhancement,126,59,67
Cillysha,ravencrest,1455,shaman,enhancement,46,27,19
Тенав,blackscar,1455,shaman,enhancement,116,66,50
Ghobi,blackrock,1454,shaman,enhancement,78,35,43
Дрегтан,howling-fjord,1453,shaman,enhancement,101,47,54
Nyxoqtx,draenor,1451,shaman,enhancement,36,27,9
Rakermän,dun-modr,1450,shaman,enhancement,46,23,23
Капарис,deathweaver,1448,shaman,enhancement,180,94,86
Shyrion,onyxia,1448,shaman,enhancement,94,43,51
Hanumanas,kazzak,1447,shaman,enhancement,37,23,14
Puncochar,zuljin,1446,shaman,enhancement,52,29,23
Justblow,twisting-nether,1446,shaman,enhancement,103,56,47
Thunderforce,drakthul,1446,shaman,enhancement,90,48,42
Relentlessqt,aegwynn,1445,shaman,enhancement,23,16,7
Alphas,draenor,1445,shaman,enhancement,44,26,18
Berethar,burning-blade,1445,shaman,enhancement,55,26,29
Dirtymiké,tarren-mill,1444,shaman,enhancement,41,16,25
Barbebiendur,archimonde,1443,shaman,enhancement,48,20,28
Neptun,twisting-nether,1442,shaman,enhancement,136,69,67
Пакни,gordunni,1442,shaman,enhancement,60,28,32
Ratnandez,outland,1441,shaman,enhancement,60,28,32
Ðeron,dun-modr,1441,shaman,enhancement,36,16,20
Zzadoxor,doomhammer,1440,shaman,enhancement,48,27,21
Агмень,howling-fjord,1440,shaman,enhancement,277,136,141
Эйнхарий,howling-fjord,1440,shaman,enhancement,74,36,38
Furrymane,blackmoore,1439,shaman,enhancement,36,24,12
Khorgam,twisting-nether,1439,shaman,enhancement,24,15,9
Тыпроиграл,gordunni,1439,shaman,enhancement,30,15,15
Шлолка,gordunni,1439,shaman,enhancement,42,16,26
Gorogoró,kazzak,1438,shaman,enhancement,24,15,9
Perunya,tarren-mill,1438,shaman,enhancement,53,27,26
Rîquetanace,archimonde,1437,shaman,enhancement,18,15,3
Jasnäh,ysondre,1437,shaman,enhancement,72,33,39
Fattywopwop,alakir,1436,shaman,enhancement,24,15,9
Anstict,silvermoon,1436,shaman,enhancement,42,26,16
Kenseienh,kazzak,1436,shaman,enhancement,268,136,132
Exolnard,twisting-nether,1435,shaman,enhancement,76,43,33
Wallachia,ysondre,1434,shaman,enhancement,24,15,9
Elesilf,sanguino,1434,shaman,enhancement,102,53,49
Tonitøtem,onyxia,1434,shaman,enhancement,42,19,23
Stlakañ,chants-éternels,1433,shaman,enhancement,36,25,11
Zabojad,stormscale,1433,shaman,enhancement,36,19,17
Rodneymullen,tarren-mill,1433,shaman,enhancement,80,42,38
Valaya,archimonde,1432,shaman,enhancement,146,81,65
Kïngmuntje,sylvanas,1432,shaman,enhancement,96,52,44
Xaví,archimonde,1432,shaman,enhancement,57,27,30
Sënz,archimonde,1432,shaman,enhancement,69,32,37
Arabesk,arygos,1431,shaman,enhancement,138,79,59
Wedís,outland,1431,shaman,enhancement,96,54,42
Réxor,pozzo-delleternità,1429,shaman,enhancement,54,24,30
Blueberrÿ,grim-batol,1428,shaman,enhancement,78,43,35
Dcanne,outland,1428,shaman,enhancement,99,52,47
Yurkën,uldum,1428,shaman,enhancement,60,29,31
Bakakas,outland,1428,shaman,enhancement,102,41,61
Goatsandoats,doomhammer,1427,shaman,enhancement,44,29,15
Mcslammer,kazzak,1427,shaman,enhancement,114,54,60
Sshaasam,tarren-mill,1426,shaman,enhancement,87,55,32
Shâymin,blackhand,1426,shaman,enhancement,24,15,9
Касикандрэра,soulflayer,1426,shaman,enhancement,143,71,72
Гусан,booty-bay,1425,shaman,enhancement,223,109,114
Lehit,outland,1424,shaman,enhancement,30,15,15
Greenswag,drakthul,1423,shaman,enhancement,36,17,19
Xélania,argent-dawn,1422,shaman,enhancement,54,25,29
Vasuman,khaz-modan,1422,shaman,enhancement,48,20,28
Evííl,tarren-mill,1421,shaman,enhancement,18,15,3
Doclava,twisting-nether,1421,shaman,enhancement,65,36,29
Lesnitt,kazzak,1421,shaman,enhancement,63,27,36
Kärmá,lightbringer,1421,shaman,enhancement,54,22,32
Vorkanyx,ysondre,1420,shaman,enhancement,48,32,16
Zuvx,ravencrest,1420,shaman,enhancement,66,38,28
Язма,grom,1420,shaman,enhancement,130,70,60
Matusal,argent-dawn,1420,shaman,enhancement,81,43,38
Soteuudistus,silvermoon,1419,shaman,enhancement,78,40,38
Mèshuggáh,ravencrest,1419,shaman,enhancement,36,17,19
Nicesky,antonidas,1418,shaman,enhancement,197,111,86
Promethxis,silvermoon,1418,shaman,enhancement,105,50,55
Frostýx,draenor,1418,shaman,enhancement,45,20,25
Shunder,earthen-ring,1417,shaman,enhancement,31,17,14
Икзок,soulflayer,1417,shaman,enhancement,84,43,41
Jmpapa,tarren-mill,1417,shaman,enhancement,30,15,15
Chendra,scarshield-legion,1417,shaman,enhancement,179,83,96
Kanabi,darkspear,1417,shaman,enhancement,36,16,20
Élisabethtwo,culte-de-la-rive-noire,1417,shaman,enhancement,36,15,21
Айбывайбы,howling-fjord,1414,shaman,enhancement,59,27,32
Shreks,frostmane,1413,shaman,enhancement,66,38,28
Verlas,kazzak,1413,shaman,enhancement,88,48,40
Bubashaman,kazzak,1413,shaman,enhancement,30,15,15
Сюсуй,blackscar,1413,shaman,enhancement,63,31,32
Vascós,frostwolf,1412,shaman,enhancement,54,36,18
Kabard,silvermoon,1412,shaman,enhancement,36,21,15
Kagarsham,kazzak,1411,shaman,enhancement,44,25,19
Malvik,tarren-mill,1411,shaman,enhancement,41,23,18
Легендашам,soulflayer,1411,shaman,enhancement,66,30,36
Remkoo,blackrock,1410,shaman,enhancement,36,17,19
Шампуньхан,blackscar,1410,shaman,enhancement,88,35,53
Shamxd,kazzak,1409,shaman,enhancement,77,37,40
Ýøuschøkz,frostwolf,1409,shaman,enhancement,38,15,23
Pinkylol,stormscale,1408,shaman,enhancement,30,15,15
Wòóshy,ravencrest,1408,shaman,enhancement,30,15,15
Apolomaeuz,frostwolf,1407,shaman,enhancement,108,60,48
Shockybalbóa,blackmoore,1407,shaman,enhancement,118,58,60
Explôsive,silvermoon,1407,shaman,enhancement,117,53,64
Ogmehu,stormreaver,1404,shaman,enhancement,141,72,69
Shambambum,blackrock,1404,shaman,enhancement,170,81,89
Deathshamãn,stormscale,1404,shaman,enhancement,88,39,49
Yaar,alleria,1403,shaman,enhancement,106,58,48
Lavashnikov,burning-legion,1403,shaman,enhancement,297,155,142
Blackibird,garona,1403,shaman,enhancement,114,54,60
Andrewbéelko,drakthul,1402,shaman,enhancement,30,17,13
Fakeyy,draenor,1402,shaman,enhancement,36,20,16
Likesx,ravencrest,1402,shaman,enhancement,41,22,19
Kíngzo,archimonde,1402,shaman,enhancement,138,71,67
Ðezûga,antonidas,1402,shaman,enhancement,262,131,131
Tyrox,kirin-tor,1401,shaman,enhancement,105,54,51
Басари,gordunni,1401,shaman,enhancement,57,29,28
Allakbarz,stormscale,1401,shaman,enhancement,159,79,80
Курси,gordunni,1401,shaman,enhancement,234,113,121
Argonautt,drakthul,1401,shaman,enhancement,179,83,96
Ðelenis,dun-modr,1401,shaman,enhancement,78,34,44
Enormo,eredar,1400,shaman,enhancement,72,37,35
Twam,outland,1399,shaman,enhancement,66,37,29
Lumii,azshara,1399,shaman,enhancement,48,21,27
Суттех,soulflayer,1399,shaman,enhancement,60,25,35
Шрамуля,soulflayer,1398,shaman,enhancement,83,48,35
Nøve,nemesis,1398,shaman,enhancement,54,31,23
Shockaibo,drakthul,1398,shaman,enhancement,48,24,24
Yasaburo,silvermoon,1397,shaman,enhancement,80,39,41
Procdaddy,eredar,1396,shaman,enhancement,54,25,29
Panicblast,stormscale,1396,shaman,enhancement,41,16,25
Адичал,soulflayer,1394,shaman,enhancement,78,46,32
Fullproc,archimonde,1394,shaman,enhancement,72,37,35
Rätxs,blackhand,1393,shaman,enhancement,130,66,64
Durek,sylvanas,1392,shaman,enhancement,77,44,33
Тленозавр,gordunni,1392,shaman,enhancement,198,100,98
Laix,khaz-modan,1392,shaman,enhancement,36,17,19
Suicidesheep,grim-batol,1390,shaman,enhancement,54,28,26
Tacøshock,ravencrest,1389,shaman,enhancement,20,16,4
Rykarn,eredar,1389,shaman,enhancement,27,16,11
Shockbot,blackmoore,1388,shaman,enhancement,30,20,10
Psychobarbie,outland,1388,shaman,enhancement,59,31,28
Ñêmêsìs,gorgonnash,1388,shaman,enhancement,54,24,30
Gímlééy,argent-dawn,1386,shaman,enhancement,54,25,29
Atis,the-maelstrom,1386,shaman,enhancement,36,15,21
Xilz,twisting-nether,1384,shaman,enhancement,137,67,70
Tescriamelio,ysondre,1384,shaman,enhancement,111,53,58
Priora,argent-dawn,1383,shaman,enhancement,52,33,19
Thunderwitch,lordaeron,1383,shaman,enhancement,30,17,13
Shockthat,draenor,1383,shaman,enhancement,192,102,90
Nejbegrov,ravencrest,1383,shaman,enhancement,86,38,48
Skrewu,stormscale,1383,shaman,enhancement,36,15,21
Шоманос,gordunni,1382,shaman,enhancement,36,24,12
Treâzin,the-maelstrom,1381,shaman,enhancement,47,24,23
Elektrikci,silvermoon,1379,shaman,enhancement,90,43,47
Wfgoesbrbr,blackrock,1379,shaman,enhancement,66,31,35
Thundergun,defias-brotherhood,1377,shaman,enhancement,36,23,13
Electrify,aegwynn,1377,shaman,enhancement,46,26,20
Rink,frostmane,1376,shaman,enhancement,54,30,24
Hellskon,silvermoon,1374,shaman,enhancement,23,15,8
Плюжка,greymane,1374,shaman,enhancement,222,121,101
Rockjuices,twisting-nether,1374,shaman,enhancement,114,61,53
Furioous,ravencrest,1373,shaman,enhancement,176,92,84
Justweirdaf,blackmoore,1373,shaman,enhancement,111,55,56
Bysonx,kazzak,1373,shaman,enhancement,140,67,73
Haldrim,blackmoore,1372,shaman,enhancement,33,17,16
Быковат,booty-bay,1371,shaman,enhancement,102,53,49
Кууджа,howling-fjord,1371,shaman,enhancement,64,32,32
Tahsus,blackmoore,1371,shaman,enhancement,78,38,40
Florex,kazzak,1369,shaman,enhancement,75,34,41
Шторсонг,gordunni,1368,shaman,enhancement,86,51,35
Bôdaway,antonidas,1368,shaman,enhancement,27,16,11
You,stormscale,1368,shaman,enhancement,80,40,40
Hatchum,les-sentinelles,1367,shaman,enhancement,78,34,44
Totemino,silvermoon,1367,shaman,enhancement,42,16,26
Targoel,blackmoore,1366,shaman,enhancement,30,20,10
Gurtok,drakthul,1366,shaman,enhancement,60,35,25
Женяшилдх,howling-fjord,1366,shaman,enhancement,97,48,49
Varagun,argent-dawn,1366,shaman,enhancement,63,26,37
Рыргаск,howling-fjord,1365,shaman,enhancement,70,38,32
Splat,burning-blade,1365,shaman,enhancement,36,18,18
Notoxus,antonidas,1364,shaman,enhancement,78,39,39
Экспатриот,greymane,1364,shaman,enhancement,78,39,39
Hulcky,grim-batol,1364,shaman,enhancement,102,49,53
Moondei,archimonde,1363,shaman,enhancement,42,24,18
Rykon,teldrassil,1362,shaman,enhancement,48,26,22
Мустажи,gordunni,1361,shaman,enhancement,77,51,26
Torukhaï,archimonde,1361,shaman,enhancement,96,51,45
Smoldermane,argent-dawn,1361,shaman,enhancement,41,16,25
Шаманнутая,gordunni,1360,shaman,enhancement,25,17,8
Gnark,dun-modr,1358,shaman,enhancement,67,41,26
Nazgréll,tarren-mill,1355,shaman,enhancement,102,45,57
Arlatjur,tarren-mill,1354,shaman,enhancement,42,26,16
Shamaray,stormscale,1352,shaman,enhancement,204,108,96
Thoreign,burning-legion,1352,shaman,enhancement,34,16,18
Nâs,kazzak,1352,shaman,enhancement,36,16,20
Kuse,blackmoore,1352,shaman,enhancement,42,16,26
Элетар,gordunni,1351,shaman,enhancement,116,59,57
Хрофайс,soulflayer,1350,shaman,enhancement,54,31,23
Лайтхальзен,howling-fjord,1350,shaman,enhancement,125,59,66
Ойбоойй,howling-fjord,1348,shaman,enhancement,36,17,19
Zateen,alonsus,1348,shaman,enhancement,36,16,20
Lokresh,azjolnerub,1347,shaman,enhancement,97,48,49
Ashmantle,twisting-nether,1347,shaman,enhancement,83,40,43
Lorios,boulderfist,1347,shaman,enhancement,42,20,22
Rether,nemesis,1347,shaman,enhancement,149,69,80
Ягном,soulflayer,1347,shaman,enhancement,87,39,48
Chämalö,archimonde,1346,shaman,enhancement,187,96,91
Ferdizap,draenor,1346,shaman,enhancement,37,17,20
Carusø,thrall,1345,shaman,enhancement,79,42,37
Balfalor,antonidas,1345,shaman,enhancement,30,15,15
Bantzer,twisting-nether,1344,shaman,enhancement,34,21,13
Gatraem,drakthul,1344,shaman,enhancement,62,27,35
Leavemeàlone,ysondre,1343,shaman,enhancement,18,14,4
Exgüsi,blackhand,1343,shaman,enhancement,48,30,18
Даблпамп,howling-fjord,1343,shaman,enhancement,35,16,19
Cahuna,stormscale,1343,shaman,enhancement,75,29,46
Azagtoth,tarren-mill,1341,shaman,enhancement,24,14,10
Vukroth,argent-dawn,1341,shaman,enhancement,85,46,39
Камам,gordunni,1341,shaman,enhancement,113,56,57
Psÿkz,kazzak,1340,shaman,enhancement,79,37,42
Relampago,eredar,1339,shaman,enhancement,41,19,22
Skólt,blackrock,1337,shaman,enhancement,122,64,58
Chamel,draenor,1337,shaman,enhancement,30,14,16
Shoockwave,twisting-nether,1337,shaman,enhancement,72,32,40
Залатар,howling-fjord,1337,shaman,enhancement,63,26,37
Fingor,tarren-mill,1336,shaman,enhancement,24,17,7
Noxstorm,frostwolf,1336,shaman,enhancement,99,52,47
Nakenfeigy,stormreaver,1335,shaman,enhancement,72,40,32
Траллгодх,blackscar,1335,shaman,enhancement,41,18,23
Dabbadabba,silvermoon,1335,shaman,enhancement,54,20,34
Sûckmytotem,ragnaros,1334,shaman,enhancement,24,14,10
Эрхус,soulflayer,1334,shaman,enhancement,36,18,18
Lilbantu,ravencrest,1333,shaman,enhancement,78,48,30
Éàsy,blackmoore,1333,shaman,enhancement,38,20,18
Kpvn,blackrock,1333,shaman,enhancement,52,26,26
Dropbax,khaz-modan,1333,shaman,enhancement,97,47,50
Ударбуридуде,howling-fjord,1333,shaman,enhancement,48,14,34
Занги,soulflayer,1331,shaman,enhancement,114,56,58
Boidarbre,sargeras,1331,shaman,enhancement,42,15,27
Реалайзер,blackscar,1330,shaman,enhancement,24,14,10
Vallchan,kazzak,1330,shaman,enhancement,54,28,26
Jameo,drakthul,1330,shaman,enhancement,336,157,179
Rhastasho,archimonde,1329,shaman,enhancement,162,85,77
Hitmeagain,blackhand,1329,shaman,enhancement,30,14,16
Dräpàrn,sylvanas,1329,shaman,enhancement,30,14,16
Trîkill,hyjal,1329,shaman,enhancement,66,30,36
Xhøxy,outland,1329,shaman,enhancement,83,37,46
Notgood,blackhand,1328,shaman,enhancement,42,19,23
Jarrek,draenor,1328,shaman,enhancement,87,39,48
Moodoo,antonidas,1328,shaman,enhancement,53,20,33
Shamohd,ravencrest,1327,shaman,enhancement,60,26,34
Cringergodx,blackhand,1325,shaman,enhancement,53,29,24
Tênzo,ysondre,1325,shaman,enhancement,63,30,33
Gåiå,argent-dawn,1323,shaman,enhancement,36,15,21
Exinos,sylvanas,1322,shaman,enhancement,83,43,40
Shamãn,draenor,1322,shaman,enhancement,90,38,52
Heálmaster,sanguino,1321,shaman,enhancement,73,42,31
Surpraisq,ravencrest,1321,shaman,enhancement,120,63,57
Янапятьминут,soulflayer,1321,shaman,enhancement,35,18,17
Ошиндра,gordunni,1320,shaman,enhancement,28,15,13
Zoombieboy,dun-modr,1319,shaman,enhancement,18,14,4
Clembute,cthun,1319,shaman,enhancement,48,28,20
Shadrahla,stormscale,1319,shaman,enhancement,24,14,10
Dami,die-aldor,1319,shaman,enhancement,45,18,27
Ragnarspung,kazzak,1318,shaman,enhancement,48,24,24
Hectoraïus,ysondre,1317,shaman,enhancement,62,34,28
Gerwntas,argent-dawn,1317,shaman,enhancement,54,25,29
Imotii,burning-legion,1317,shaman,enhancement,92,37,55
Нимххе,borean-tundra,1316,shaman,enhancement,24,15,9
Hopefully,eredar,1316,shaman,enhancement,24,14,10
Igniis,frostmane,1316,shaman,enhancement,146,81,65
Pøllemodex,frostwhisper,1316,shaman,enhancement,31,15,16
Awsomo,ravencrest,1316,shaman,enhancement,85,37,48
Masatø,hyjal,1316,shaman,enhancement,55,23,32
Ðragaø,kazzak,1315,shaman,enhancement,48,25,23
Renkass,outland,1315,shaman,enhancement,30,14,16
Welgor,kult-der-verdammten,1314,shaman,enhancement,102,59,43
Blautorkel,amanthul,1314,shaman,enhancement,71,34,37
Purgérkíng,silvermoon,1314,shaman,enhancement,30,14,16
Айспик,ashenvale,1314,shaman,enhancement,101,37,64
Срувтапкии,deathguard,1313,shaman,enhancement,102,54,48
Shamarre,executus,1313,shaman,enhancement,62,29,33
Тмх,ashenvale,1313,shaman,enhancement,33,15,18
Mícheller,ravencrest,1312,shaman,enhancement,24,14,10
Лэнгипас,gordunni,1312,shaman,enhancement,205,106,99
Шабыч,deathguard,1312,shaman,enhancement,60,25,35
Outerspace,silvermoon,1311,shaman,enhancement,48,25,23
Guqin,ravencrest,1311,shaman,enhancement,88,45,43
Thogrin,bladefist,1311,shaman,enhancement,30,14,16
Blackmuamba,tarren-mill,1311,shaman,enhancement,42,18,24
Ragnadim,silvermoon,1310,shaman,enhancement,40,19,21
Botnet,outland,1309,shaman,enhancement,78,41,37
Aêriâl,shendralar,1308,shaman,enhancement,105,54,51
Dergat,pozzo-delleternità,1308,shaman,enhancement,42,20,22
Daelements,shadowsong,1308,shaman,enhancement,57,26,31
Lahur,blackmoore,1306,shaman,enhancement,30,19,11
Nátty,ravencrest,1305,shaman,enhancement,26,15,11
Opráwindfury,stormscale,1305,shaman,enhancement,68,33,35
Qauter,hellfire,1305,shaman,enhancement,30,14,16
Malicrnii,outland,1305,shaman,enhancement,39,17,22
Watzocham,archimonde,1305,shaman,enhancement,54,23,31
Интендо,soulflayer,1304,shaman,enhancement,57,30,27
Сирибериешка,soulflayer,1303,shaman,enhancement,24,15,9
Draugrinns,tarren-mill,1302,shaman,enhancement,42,21,21
Rìchì,blackrock,1302,shaman,enhancement,30,14,16
Groundead,alakir,1300,shaman,enhancement,40,16,24
Elektekk,blackrock,1299,shaman,enhancement,34,17,17
Akimboo,kilrogg,1297,shaman,enhancement,78,35,43
Jeppoh,tarren-mill,1296,shaman,enhancement,37,22,15
Maurrigan,rashgarroth,1296,shaman,enhancement,24,14,10
Zandali,tarren-mill,1296,shaman,enhancement,90,50,40
Thormarg,archimonde,1296,shaman,enhancement,60,29,31
Цс,azuregos,1295,shaman,enhancement,227,114,113
Shaddoo,stormscale,1294,shaman,enhancement,29,14,15
Sunetee,kazzak,1294,shaman,enhancement,54,23,31
Biglynx,sanguino,1293,shaman,enhancement,152,89,63
Roastbeef,blackrock,1293,shaman,enhancement,58,33,25
Rhakhatheckh,nemesis,1291,shaman,enhancement,42,19,23
Madppl,outland,1291,shaman,enhancement,37,16,21
Polarboy,blackmoore,1289,shaman,enhancement,27,16,11
Raveell,defias-brotherhood,1289,shaman,enhancement,165,76,89
Bighommie,draenor,1288,shaman,enhancement,28,20,8
Gigamuscle,ravencrest,1288,shaman,enhancement,30,15,15
Sinwithin,ravencrest,1287,shaman,enhancement,30,16,14
Кгб,greymane,1287,shaman,enhancement,258,125,133
Enzjé,blackrock,1287,shaman,enhancement,30,14,16
Reggard,drakthul,1286,shaman,enhancement,42,21,21
Ishokyou,thrall,1286,shaman,enhancement,88,42,46
Aherya,zuljin,1283,shaman,enhancement,43,23,20
Xakum,stormscale,1282,shaman,enhancement,104,62,42
Daguvner,stormscale,1282,shaman,enhancement,72,32,40
Ragnos,sanguino,1281,shaman,enhancement,242,126,116
Апинсмок,soulflayer,1280,shaman,enhancement,116,56,60
Yeemayne,outland,1279,shaman,enhancement,24,16,8
Bacheebg,darksorrow,1279,shaman,enhancement,155,79,76
Towi,krasus,1278,shaman,enhancement,44,23,21
Mou,the-maelstrom,1278,shaman,enhancement,42,16,26
Броаркар,razuvious,1277,shaman,enhancement,106,56,50
Hammerkiller,kilrogg,1277,shaman,enhancement,55,23,32
Бигмамуля,booty-bay,1276,shaman,enhancement,72,35,37
Korzo,amanthul,1275,shaman,enhancement,58,37,21
Другалёк,howling-fjord,1275,shaman,enhancement,127,66,61
Hexd,defias-brotherhood,1275,shaman,enhancement,84,36,48
Navy,frostwolf,1274,shaman,enhancement,24,14,10
Sg,la-croisade-écarlate,1274,shaman,enhancement,91,50,41
Poullpy,sargeras,1274,shaman,enhancement,44,19,25
Neroty,blackmoore,1274,shaman,enhancement,60,23,37
Yànkøràmbow,arakarahm,1273,shaman,enhancement,27,16,11
Orli,aszune,1273,shaman,enhancement,48,26,22
Sinkero,hellscream,1273,shaman,enhancement,92,44,48
Burstorama,alleria,1272,shaman,enhancement,36,17,19
Macoox,drakthul,1271,shaman,enhancement,108,45,63
Cool,tarren-mill,1270,shaman,enhancement,45,18,27
Даркгрон,thermaplugg,1269,shaman,enhancement,84,44,40
Blutschrei,tarren-mill,1269,shaman,enhancement,286,140,146
Beletili,chogall,1269,shaman,enhancement,75,33,42
Katastrofuss,stormscale,1268,shaman,enhancement,88,47,41
Thundérshock,kazzak,1268,shaman,enhancement,60,23,37
Delgagalduos,kazzak,1267,shaman,enhancement,48,25,23
Persaunne,archimonde,1267,shaman,enhancement,81,41,40
Mokteb,archimonde,1266,shaman,enhancement,30,14,16
Monstermunch,ravencrest,1266,shaman,enhancement,33,14,19
Iicks,blackrock,1264,shaman,enhancement,60,25,35
Шамвкроксах,gordunni,1261,shaman,enhancement,30,14,16
Shamananas,antonidas,1261,shaman,enhancement,84,39,45
Йовва,soulflayer,1259,shaman,enhancement,30,23,7
Baineoof,tarren-mill,1259,shaman,enhancement,41,18,23
Kunancementa,ravencrest,1258,shaman,enhancement,107,47,60
Mustang,twilights-hammer,1255,shaman,enhancement,290,141,149
Sounoukfrit,dalaran,1254,shaman,enhancement,87,46,41
Gõðzilla,blackmoore,1253,shaman,enhancement,34,17,17
Cavir,burning-blade,1253,shaman,enhancement,48,21,27
En,blackhand,1253,shaman,enhancement,36,15,21
Khorrax,malygos,1252,shaman,enhancement,66,34,32
Simularcum,kazzak,1252,shaman,enhancement,42,21,21
Shafallen,tarren-mill,1251,shaman,enhancement,18,14,4
Manrod,tarren-mill,1251,shaman,enhancement,72,36,36
Keräx,cthun,1251,shaman,enhancement,48,17,31
Layonne,ysondre,1250,shaman,enhancement,62,34,28
Humming,sanguino,1250,shaman,enhancement,93,50,43
Vollt,kazzak,1248,shaman,enhancement,31,14,17
Vhert,twisting-nether,1248,shaman,enhancement,57,24,33
Yasan,kazzak,1247,shaman,enhancement,139,69,70
Eclaîr,thrall,1247,shaman,enhancement,30,13,17
Schnellweg,arthas,1246,shaman,enhancement,18,13,5
Darkstrong,alakir,1245,shaman,enhancement,42,22,20
Holten,outland,1245,shaman,enhancement,78,37,41
Dropdattotem,stormscale,1245,shaman,enhancement,35,15,20
Domiro,ravencrest,1245,shaman,enhancement,41,13,28
Napoulion,khaz-modan,1244,shaman,enhancement,24,13,11
Murdá,ravencrest,1244,shaman,enhancement,24,13,11
Зуфар,howling-fjord,1244,shaman,enhancement,55,29,26
Shockinghell,sylvanas,1243,shaman,enhancement,24,13,11
Тандерхем,gordunni,1243,shaman,enhancement,60,31,29
Фастэра,soulflayer,1243,shaman,enhancement,36,13,23
Brotein,blackmoore,1242,shaman,enhancement,24,13,11
Tashunka,twisting-nether,1242,shaman,enhancement,190,91,99
Hichibane,archimonde,1242,shaman,enhancement,30,13,17
Morkyy,thrall,1241,shaman,enhancement,18,13,5
Greatthrall,kazzak,1241,shaman,enhancement,56,29,27
Shamanite,drakthul,1241,shaman,enhancement,89,42,47
Shamanlynx,ravencrest,1239,shaman,enhancement,36,23,13
Trollden,silvermoon,1239,shaman,enhancement,24,13,11
Zokah,emeriss,1239,shaman,enhancement,42,22,20
Izaarleus,argent-dawn,1239,shaman,enhancement,44,22,22
Maddogxz,frostwolf,1238,shaman,enhancement,18,13,5
Бездпса,gordunni,1238,shaman,enhancement,24,13,11
Podoroschnik,blackmoore,1238,shaman,enhancement,30,13,17
Théar,ravencrest,1237,shaman,enhancement,48,25,23
Stormrex,magtheridon,1237,shaman,enhancement,248,128,120
Krux,burning-blade,1237,shaman,enhancement,163,84,79
Doblir,bloodscalp,1237,shaman,enhancement,47,22,25
Рскувосемь,soulflayer,1237,shaman,enhancement,30,13,17
Prømetheüs,sanguino,1235,shaman,enhancement,86,48,38
Нэдсон,greymane,1234,shaman,enhancement,24,13,11
Gonzprime,burning-legion,1234,shaman,enhancement,24,13,11
Crespouu,doomhammer,1234,shaman,enhancement,169,89,80
Видсон,soulflayer,1234,shaman,enhancement,30,14,16
Shamomo,hyjal,1234,shaman,enhancement,173,80,93
Kargos,stormscale,1234,shaman,enhancement,30,13,17
Tholdrin,outland,1234,shaman,enhancement,30,13,17
Leetajz,dunemaul,1234,shaman,enhancement,36,13,23
Velkin,thrall,1233,shaman,enhancement,18,13,5
Burghezu,magtheridon,1232,shaman,enhancement,79,48,31
Vaesk,auchindoun,1232,shaman,enhancement,72,39,33
Hodir,bronzebeard,1232,shaman,enhancement,63,31,32
Shøckz,blackrock,1231,shaman,enhancement,24,13,11
Likklebit,twisting-nether,1231,shaman,enhancement,31,14,17
Xfiles,garona,1231,shaman,enhancement,30,13,17
Galvarod,silvermoon,1231,shaman,enhancement,30,13,17
Pushs,archimonde,1230,shaman,enhancement,24,13,11
Чернышус,soulflayer,1230,shaman,enhancement,74,34,40
Литлсмурф,gordunni,1230,shaman,enhancement,75,34,41
Cowkiller,minahonda,1229,shaman,enhancement,42,23,19
ßaßystärz,hyjal,1229,shaman,enhancement,27,13,14
Shockblaster,draenor,1228,shaman,enhancement,34,14,20
Maulstrom,pozzo-delleternità,1227,shaman,enhancement,49,30,19
Apócalypsee,ravencrest,1227,shaman,enhancement,30,13,17
Blitzviech,aegwynn,1226,shaman,enhancement,29,14,15
Redderss,silvermoon,1226,shaman,enhancement,48,22,26
Silko,wrathbringer,1226,shaman,enhancement,55,24,31
Какпак,fordragon,1226,shaman,enhancement,79,34,45
Arcura,twisting-nether,1225,shaman,enhancement,120,62,58
Shamaneo,outland,1222,shaman,enhancement,51,31,20
Акер,deathguard,1221,shaman,enhancement,42,27,15
Cementatar,burning-blade,1221,shaman,enhancement,36,21,15
Slaphappy,hellscream,1221,shaman,enhancement,27,14,13
Strygwyrl,doomhammer,1220,shaman,enhancement,30,14,16
Crawsz,archimonde,1219,shaman,enhancement,67,31,36
Charuzo,stormscale,1219,shaman,enhancement,30,13,17
Maajo,tarren-mill,1219,shaman,enhancement,125,54,71
Zerandolix,blackrock,1218,shaman,enhancement,44,22,22
Шалман,thermaplugg,1218,shaman,enhancement,502,247,255
Шамяра,blackscar,1217,shaman,enhancement,24,15,9
Idxbi,kazzak,1217,shaman,enhancement,174,92,82
Ulvur,blackhand,1216,shaman,enhancement,30,13,17
Ørgus,aegwynn,1214,shaman,enhancement,359,187,172
Mahlga,argent-dawn,1214,shaman,enhancement,147,72,75
Бетадварф,borean-tundra,1211,shaman,enhancement,26,13,13
Палачок,eversong,1210,shaman,enhancement,195,94,101
Hororka,drakthul,1209,shaman,enhancement,72,34,38
Çesto,destromath,1205,shaman,enhancement,24,13,11
Trollomatic,das-syndikat,1205,shaman,enhancement,143,70,73
Grimtøtem,defias-brotherhood,1204,shaman,enhancement,50,23,27
Ultaz,ravencrest,1204,shaman,enhancement,86,37,49
Hedjin,argent-dawn,1202,shaman,enhancement,120,62,58
Ftp,archimonde,1201,shaman,enhancement,60,31,29
Dathanar,silvermoon,1201,shaman,enhancement,30,15,15
Naariell,argent-dawn,1201,shaman,enhancement,71,34,37
Ipbar,blackrock,1200,shaman,enhancement,56,29,27
Magram,darksorrow,1200,shaman,enhancement,41,21,20
Loatrox,eredar,1200,shaman,enhancement,36,17,19
Baaruch,kazzak,1199,shaman,enhancement,151,73,78
Gárrok,nerathor,1193,shaman,enhancement,24,13,11
Wioda,silvermoon,1191,shaman,enhancement,149,84,65
Talf,tarren-mill,1186,shaman,enhancement,23,13,10
Ponzu,silvermoon,1184,shaman,enhancement,24,14,10
Noiduttu,tarren-mill,1184,shaman,enhancement,112,59,53
Dronius,kragjin,1184,shaman,enhancement,36,15,21
Faridstreng,blackmoore,1182,shaman,enhancement,17,13,4
Patites,twisting-nether,1181,shaman,enhancement,84,42,42
Nudyjuice,tarren-mill,1181,shaman,enhancement,38,17,21
Treizelol,ysondre,1179,shaman,enhancement,83,38,45
Cràfty,blackrock,1179,shaman,enhancement,64,27,37
Øzy,sanguino,1177,shaman,enhancement,58,38,20
Rúthless,blackrock,1176,shaman,enhancement,30,13,17
Fourbevent,archimonde,1175,shaman,enhancement,21,14,7
Stub,nemesis,1172,shaman,enhancement,64,32,32
Màverìck,nemesis,1171,shaman,enhancement,24,16,8
Jorny,burning-legion,1171,shaman,enhancement,54,17,37
Fika,the-venture-co,1170,shaman,enhancement,90,49,41
Ипа,thermaplugg,1170,shaman,enhancement,137,71,66
Bepiz,sylvanas,1170,shaman,enhancement,36,13,23
Qzaah,garona,1169,shaman,enhancement,27,13,14
Hokaji,tarren-mill,1168,shaman,enhancement,36,13,23
Chàrlord,twisting-nether,1167,shaman,enhancement,31,13,18
Tremuchamy,tyrande,1166,shaman,enhancement,51,28,23
Saduria,antonidas,1166,shaman,enhancement,120,64,56
Shigasu,die-aldor,1166,shaman,enhancement,39,17,22
Notragon,chamber-of-aspects,1166,shaman,enhancement,68,24,44
Tookaageeroo,burning-legion,1164,shaman,enhancement,80,41,39
Сквиртушка,gordunni,1164,shaman,enhancement,44,19,25
Çaycî,blackhand,1162,shaman,enhancement,21,14,7
Quartodebue,nemesis,1162,shaman,enhancement,24,13,11
Glibnica,draenor,1160,shaman,enhancement,27,13,14
Магмарончик,gordunni,1158,shaman,enhancement,85,40,45
Isladinks,draenor,1155,shaman,enhancement,99,46,53
Fjal,die-nachtwache,1153,shaman,enhancement,66,30,36
Uselesstwo,archimonde,1152,shaman,enhancement,24,12,12
Deadwölf,outland,1152,shaman,enhancement,30,12,18
Blîzo,tarren-mill,1151,shaman,enhancement,16,13,3
Shootinguard,kazzak,1151,shaman,enhancement,18,12,6
Sangvinus,outland,1151,shaman,enhancement,56,22,34
Pestomvp,tarren-mill,1150,shaman,enhancement,18,12,6
Шаманычгодх,howling-fjord,1150,shaman,enhancement,32,13,19
Jaszczurka,stormrage,1149,shaman,enhancement,18,12,6
Dmgaddict,kazzak,1149,shaman,enhancement,24,12,12
Kertunsisko,emeriss,1149,shaman,enhancement,78,35,43
Babal,outland,1149,shaman,enhancement,30,12,18
Chikabomb,sylvanas,1148,shaman,enhancement,18,12,6
Leasysham,antonidas,1148,shaman,enhancement,24,12,12
Warjuice,stormscale,1148,shaman,enhancement,29,14,15
Shamsterr,karazhan,1148,shaman,enhancement,36,17,19
Замвождя,blackscar,1148,shaman,enhancement,132,61,71
Shamira,nethersturm,1148,shaman,enhancement,30,12,18
Krâthøos,archimonde,1147,shaman,enhancement,18,12,6
Famepolîce,blackrock,1147,shaman,enhancement,18,12,6
Kirtach,dun-modr,1146,shaman,enhancement,18,12,6
Nairî,blackhand,1146,shaman,enhancement,24,12,12
Dianè,stormscale,1145,shaman,enhancement,19,13,6
Лёхапулемёт,gordunni,1145,shaman,enhancement,18,12,6
Киллдрак,howling-fjord,1144,shaman,enhancement,46,24,22
Самоанец,howling-fjord,1144,shaman,enhancement,24,12,12
Zevissh,outland,1144,shaman,enhancement,24,12,12
Jangal,die-nachtwache,1142,shaman,enhancement,31,17,14
Bualocktv,sylvanas,1142,shaman,enhancement,24,12,12
Bachetobg,darksorrow,1142,shaman,enhancement,71,33,38
Mcbayn,tarren-mill,1142,shaman,enhancement,91,39,52
Vemvardetsom,stormreaver,1142,shaman,enhancement,30,12,18
Ðexx,stormscale,1141,shaman,enhancement,18,12,6
Scottish,auchindoun,1140,shaman,enhancement,29,17,12
Electricmon,stormscale,1140,shaman,enhancement,72,42,30
Brooce,sylvanas,1140,shaman,enhancement,30,12,18
Elijaá,nordrassil,1138,shaman,enhancement,24,12,12
Manushamanu,stormscale,1137,shaman,enhancement,47,19,28
Vàlentina,blackmoore,1136,shaman,enhancement,206,107,99
Gahmnir,silvermoon,1136,shaman,enhancement,24,12,12
Lumpp,kazzak,1134,shaman,enhancement,48,14,34
Бирхэпнс,blackscar,1131,shaman,enhancement,104,48,56
Rauka,outland,1129,shaman,enhancement,18,12,6
Curcumin,ravencrest,1129,shaman,enhancement,42,17,25
Имсомниум,howling-fjord,1129,shaman,enhancement,35,12,23
Шамманидзе,gordunni,1128,shaman,enhancement,65,27,38
Philcallings,tarren-mill,1127,shaman,enhancement,27,13,14
Kassyoh,hyjal,1127,shaman,enhancement,30,14,16
Волкк,soulflayer,1126,shaman,enhancement,98,53,45
Reverse,xavius,1125,shaman,enhancement,24,12,12
Gibspark,twisting-nether,1124,shaman,enhancement,30,17,13
Бойкийкот,gordunni,1123,shaman,enhancement,84,41,43
Thossa,draenor,1122,shaman,enhancement,141,71,70
Keysersozey,zuluhed,1120,shaman,enhancement,24,12,12
Viandehachee,dalaran,1119,shaman,enhancement,35,18,17
Cracklord,outland,1119,shaman,enhancement,24,12,12
Jaykezap,kazzak,1118,shaman,enhancement,23,12,11
Spideysámli,ragnaros,1116,shaman,enhancement,18,12,6
Precíous,sporeggar,1116,shaman,enhancement,40,22,18
Gameblast,thunderhorn,1116,shaman,enhancement,36,12,24
Ilnspirall,drakthul,1115,shaman,enhancement,36,15,21
Mynaye,hyjal,1115,shaman,enhancement,30,12,18
Виндфайр,blackscar,1114,shaman,enhancement,24,12,12
Grommalgue,hyjal,1113,shaman,enhancement,54,30,24
Хмелецкий,soulflayer,1111,shaman,enhancement,121,65,56
Namrdak,quelthalas,1111,shaman,enhancement,273,139,134
Povecategla,grim-batol,1108,shaman,enhancement,51,24,27
Lvq,kazzak,1107,shaman,enhancement,24,12,12
Limech,dalaran,1105,shaman,enhancement,84,36,48
Тотемныйчад,gordunni,1104,shaman,enhancement,28,13,15
Cerita,bloodhoof,1103,shaman,enhancement,99,43,56
Esciamano,nemesis,1101,shaman,enhancement,47,31,16
Murog,dalaran,1100,shaman,enhancement,25,14,11
Bumm,twisting-nether,1099,shaman,enhancement,42,17,25
Жарюшашлыки,blackscar,1098,shaman,enhancement,19,12,7
Djzeus,twisting-nether,1098,shaman,enhancement,21,12,9
Eneruswag,draenor,1098,shaman,enhancement,29,14,15
Nuluadroguri,twisting-nether,1098,shaman,enhancement,34,13,21
Etxarne,twisting-nether,1098,shaman,enhancement,42,12,30
Kireekoura,tarren-mill,1097,shaman,enhancement,33,14,19
Nurychic,twisting-nether,1097,shaman,enhancement,115,47,68
Munnar,dalaran,1097,shaman,enhancement,42,17,25
Aquæ,suramar,1096,shaman,enhancement,233,120,113
Ironsidé,ragnaros,1096,shaman,enhancement,48,18,30
Zugzie,draenor,1095,shaman,enhancement,60,28,32
Windfury,sylvanas,1091,shaman,enhancement,123,60,63
Donaldopumpo,stormscale,1090,shaman,enhancement,29,15,14
Виндфуриа,gordunni,1090,shaman,enhancement,117,53,64
Janserey,burning-legion,1090,shaman,enhancement,30,12,18
Грейсаша,howling-fjord,1088,shaman,enhancement,36,21,15
Sìrenia,tarren-mill,1087,shaman,enhancement,68,39,29
Kringspierce,twisting-nether,1086,shaman,enhancement,55,34,21
Eliaap,antonidas,1082,shaman,enhancement,159,75,84
Харрум,soulflayer,1080,shaman,enhancement,110,57,53
Snoc,guldan,1077,shaman,enhancement,57,26,31
Bábbajaggí,blackrock,1077,shaman,enhancement,30,13,17
Эсфира,ashenvale,1076,shaman,enhancement,125,61,64
Gyuksz,arathor,1075,shaman,enhancement,29,12,17
Анашишка,borean-tundra,1069,shaman,enhancement,42,16,26
Atixz,blackmoore,1065,shaman,enhancement,34,12,22
Hyamala,chamber-of-aspects,1063,shaman,enhancement,37,20,17
Oddsocks,stormscale,1063,shaman,enhancement,164,77,87
Rockymarciia,dalaran,1060,shaman,enhancement,30,21,9
Rorenth,blackhand,1060,shaman,enhancement,86,44,42
Боргрим,eversong,1059,shaman,enhancement,112,48,64
Masêrati,ravencrest,1056,shaman,enhancement,12,11,1
Lokasakke,tarren-mill,1056,shaman,enhancement,18,11,7
Axiiom,draenor,1056,shaman,enhancement,18,11,7
Биттерлинкс,soulflayer,1056,shaman,enhancement,24,11,13
Aünsa,archimonde,1055,shaman,enhancement,18,11,7
Killykritz,draenor,1055,shaman,enhancement,18,11,7
Kelvok,silvermoon,1055,shaman,enhancement,18,11,7
Setac,stormscale,1055,shaman,enhancement,18,11,7
Gixor,silvermoon,1055,shaman,enhancement,18,11,7
Walterwhite,blackrock,1055,shaman,enhancement,18,11,7
Abordoga,twisting-nether,1055,shaman,enhancement,18,11,7
Psychologism,sanguino,1055,shaman,enhancement,18,11,7
Pay,stormscale,1055,shaman,enhancement,18,11,7
Weaslêy,frostwolf,1055,shaman,enhancement,45,24,21
Hungover,outland,1055,shaman,enhancement,30,11,19
Trobø,ravencrest,1055,shaman,enhancement,33,12,21
Shamroyce,blackhand,1054,shaman,enhancement,18,11,7
Berserked,emeriss,1054,shaman,enhancement,18,11,7
Flamii,burning-legion,1054,shaman,enhancement,18,11,7
Halorah,argent-dawn,1054,shaman,enhancement,260,126,134
Tryscham,blackmoore,1054,shaman,enhancement,24,11,13
Chuckystrike,arthas,1054,shaman,enhancement,24,11,13
Lothepus,balnazzar,1053,shaman,enhancement,18,11,7
Kral,defias-brotherhood,1053,shaman,enhancement,18,11,7
Othu,ragnaros,1053,shaman,enhancement,24,11,13
Shockrates,pozzo-delleternità,1053,shaman,enhancement,24,11,13
Bólterz,twisting-nether,1053,shaman,enhancement,40,16,24
Asschick,outland,1052,shaman,enhancement,18,11,7
Тотембот,soulflayer,1052,shaman,enhancement,24,11,13
Onefurall,ragnaros,1052,shaman,enhancement,24,11,13
Swooch,shattered-hand,1051,shaman,enhancement,12,11,1
Mhyrtïlle,kirin-tor,1051,shaman,enhancement,18,11,7
Электро,thermaplugg,1051,shaman,enhancement,24,11,13
Yatiri,vashj,1051,shaman,enhancement,24,11,13
Thokul,defias-brotherhood,1050,shaman,enhancement,18,11,7
Âlphan,silvermoon,1050,shaman,enhancement,24,11,13
Bloodlusts,archimonde,1050,shaman,enhancement,25,11,14
Alëssïo,ysondre,1049,shaman,enhancement,24,15,9
Еонса,howling-fjord,1048,shaman,enhancement,24,11,13
Щцц,soulflayer,1047,shaman,enhancement,18,11,7
Checkpoint,defias-brotherhood,1047,shaman,enhancement,36,14,22
Azrodas,defias-brotherhood,1046,shaman,enhancement,24,11,13
Moonkiss,veknilash,1043,shaman,enhancement,101,53,48
Stormbuzz,burning-legion,1042,shaman,enhancement,18,11,7
Asmat,pozzo-delleternità,1042,shaman,enhancement,30,15,15
Kushme,silvermoon,1041,shaman,enhancement,144,67,77
Lottery,ragnaros,1041,shaman,enhancement,24,11,13
Bíìerlip,twisting-nether,1041,shaman,enhancement,36,11,25
Shamrøck,archimonde,1040,shaman,enhancement,66,32,34
Nabq,hyjal,1040,shaman,enhancement,24,11,13
Nezuka,turalyon,1040,shaman,enhancement,39,17,22
Uhnnas,drakthul,1040,shaman,enhancement,30,11,19
Totkodem,twisting-nether,1039,shaman,enhancement,38,16,22
Mørwayn,ysondre,1035,shaman,enhancement,24,11,13
Zamals,khaz-modan,1032,shaman,enhancement,30,13,17
Свистт,fordragon,1032,shaman,enhancement,160,69,91
Salgueiro,grim-batol,1031,shaman,enhancement,30,12,18
Мэлтем,soulflayer,1031,shaman,enhancement,54,20,34
Eleboss,frostwolf,1025,shaman,enhancement,54,28,26
Haono,khaz-modan,1024,shaman,enhancement,24,11,13
Sifu,ragnaros,1023,shaman,enhancement,18,11,7
Nethershock,blackmoore,1023,shaman,enhancement,139,74,65
Shaqd,thrall,1017,shaman,enhancement,23,11,12
Fàkecast,outland,1015,shaman,enhancement,67,27,40
Grinar,stormreaver,1015,shaman,enhancement,41,16,25
Practicetwo,argent-dawn,1015,shaman,enhancement,29,11,18
Rázzìm,eredar,1014,shaman,enhancement,28,11,17
Nïà,kaelthas,1009,shaman,enhancement,117,49,68
Wargriman,kelthuzad,1008,shaman,enhancement,47,24,23
Shaminista,ravencrest,1001,shaman,enhancement,24,13,11
Chamtroulku,ysondre,1001,shaman,enhancement,23,11,12
Vegà,thrall,1000,shaman,enhancement,21,13,8
Bigmassage,blackmoore,996,shaman,enhancement,27,12,15
Watchmeplz,archimonde,990,shaman,enhancement,22,11,11
Freizeitler,antonidas,988,shaman,enhancement,17,11,6
Chronochrome,chamber-of-aspects,988,shaman,enhancement,164,84,80
Джусипуси,gordunni,987,shaman,enhancement,48,19,29
Vnqsh,arathor,986,shaman,enhancement,20,11,9
Biphrost,nemesis,986,shaman,enhancement,87,45,42
Джертик,howling-fjord,984,shaman,enhancement,25,16,9
Chamanauzore,hyjal,979,shaman,enhancement,77,31,46
Нуишам,soulflayer,978,shaman,enhancement,19,13,6
Xarozz,blackmoore,978,shaman,enhancement,127,60,67
Zerodown,outland,976,shaman,enhancement,35,12,23
Yunero,argent-dawn,975,shaman,enhancement,19,11,8
Twotwozero,defias-brotherhood,968,shaman,enhancement,47,22,25
Zoghzog,elune,968,shaman,enhancement,89,38,51
Sacwel,silvermoon,967,shaman,enhancement,18,11,7
Rûngard,aegwynn,965,shaman,enhancement,26,11,15
Peixy,dun-modr,963,shaman,enhancement,30,20,10
Krakennm,dalaran,962,shaman,enhancement,79,37,42
Amiashaman,stormscale,961,shaman,enhancement,59,30,29
Dumhuvud,stormscale,960,shaman,enhancement,12,10,2
Tätschentim,blackrock,960,shaman,enhancement,12,10,2
Miøn,kazzak,960,shaman,enhancement,12,10,2
Burstboy,tarren-mill,960,shaman,enhancement,18,10,8
Blackyx,dun-modr,960,shaman,enhancement,18,10,8
Bullet,blackmoore,960,shaman,enhancement,18,10,8
Likê,aegwynn,960,shaman,enhancement,18,10,8
Teckan,tarren-mill,960,shaman,enhancement,20,10,10
Flameshock,stormreaver,959,shaman,enhancement,12,10,2
Ræi,drakthul,959,shaman,enhancement,12,10,2
Хеллбат,howling-fjord,959,shaman,enhancement,18,10,8
Hariboo,arthas,959,shaman,enhancement,18,10,8
Sìberiano,pozzo-delleternità,959,shaman,enhancement,18,10,8
Shuraex,blackmoore,959,shaman,enhancement,18,10,8
Raketsven,dentarg,959,shaman,enhancement,18,10,8
Equipshammy,silvermoon,959,shaman,enhancement,18,10,8
Asçele,kazzak,959,shaman,enhancement,18,10,8
Gnomecake,vashj,959,shaman,enhancement,24,10,14
Batan,kazzak,959,shaman,enhancement,24,10,14
Myngo,thrall,958,shaman,enhancement,18,10,8
Hurb,malorne,958,shaman,enhancement,18,10,8
Fúre,ravencrest,958,shaman,enhancement,18,10,8
Kreyly,der-mithrilorden,958,shaman,enhancement,18,10,8
Berzer,ragnaros,958,shaman,enhancement,18,10,8
Jorginho,burning-blade,958,shaman,enhancement,18,10,8
Cloùt,the-maelstrom,958,shaman,enhancement,21,11,10
Stormkëëpër,stormscale,958,shaman,enhancement,51,19,32
Slapodden,outland,957,shaman,enhancement,18,10,8
Ironlionzion,ragnaros,957,shaman,enhancement,21,11,10
Wutgarek,blackrock,956,shaman,enhancement,18,10,8
Ybbarcs,eredar,955,shaman,enhancement,18,10,8
Tufftnamn,frostmane,955,shaman,enhancement,24,10,14
Pureflame,silvermoon,955,shaman,enhancement,24,10,14
Shynkqt,archimonde,955,shaman,enhancement,30,10,20
Ichboxdich,madmortem,954,shaman,enhancement,18,10,8
Cbshaman,sylvanas,954,shaman,enhancement,24,10,14
Mansquidgoat,darksorrow,954,shaman,enhancement,24,10,14
Charth,ravencrest,954,shaman,enhancement,49,18,31
Jinzsham,ragnaros,953,shaman,enhancement,18,10,8
Stormess,zuljin,953,shaman,enhancement,18,10,8
Ragnarökaren,stormscale,953,shaman,enhancement,24,10,14
Carcksn,nerathor,951,shaman,enhancement,18,10,8
Авалеси,gordunni,951,shaman,enhancement,30,10,20
Laquium,blackmoore,950,shaman,enhancement,24,10,14
Darkcleaver,drakthul,950,shaman,enhancement,24,10,14
Nazma,blackhand,949,shaman,enhancement,12,10,2
Rèol,blackmoore,949,shaman,enhancement,30,10,20
Rushfabi,aegwynn,948,shaman,enhancement,24,10,14
Amonshokz,tarren-mill,947,shaman,enhancement,24,10,14
Wuchtzwerg,terrordar,945,shaman,enhancement,12,10,2
Sardemar,defias-brotherhood,944,shaman,enhancement,30,17,13
Yarøu,antonidas,944,shaman,enhancement,32,11,21
Nalàar,hyjal,940,shaman,enhancement,23,12,11
Golfrick,hyjal,940,shaman,enhancement,33,11,22
Bigsmacks,runetotem,939,shaman,enhancement,23,10,13
Elcoustillou,throkferoth,936,shaman,enhancement,176,84,92
Broxh,sanguino,935,shaman,enhancement,96,36,60
Fernik,sanguino,935,shaman,enhancement,36,13,23
Чухмандос,gordunni,932,shaman,enhancement,23,11,12
Fulguris,ravencrest,927,shaman,enhancement,17,10,7
Bigpapi,azjolnerub,927,shaman,enhancement,17,10,7
Elrayitos,shendralar,927,shaman,enhancement,22,10,12
Maskulin,antonidas,925,shaman,enhancement,18,10,8
Vainerish,malygos,925,shaman,enhancement,24,11,13
Zuvboy,the-maelstrom,924,shaman,enhancement,28,10,18
Drocthar,defias-brotherhood,923,shaman,enhancement,76,32,44
Gruldo,tarren-mill,915,shaman,enhancement,41,10,31
Eomsham,magtheridon,912,shaman,enhancement,21,10,11
Shamaniak,tarren-mill,912,shaman,enhancement,48,11,37
Тыщатристах,howling-fjord,903,shaman,enhancement,18,11,7
Stubby,nagrand,903,shaman,enhancement,37,17,20
Ластыч,borean-tundra,900,shaman,enhancement,30,13,17
Sharomen,draenor,900,shaman,enhancement,36,13,23
Wawawoowee,archimonde,893,shaman,enhancement,16,10,6
Ryujìñjakka,culte-de-la-rive-noire,892,shaman,enhancement,36,16,20
Шманя,soulflayer,892,shaman,enhancement,23,10,13
Cimer,sargeras,891,shaman,enhancement,113,49,64
Schabapi,blackmoore,887,shaman,enhancement,20,10,10
Залазани,soulflayer,884,shaman,enhancement,30,15,15
Bimms,eredar,879,shaman,enhancement,19,10,9
Fòóxi,ravencrest,877,shaman,enhancement,211,104,107
Mimsy,hyjal,876,shaman,enhancement,53,21,32
Ximid,doomhammer,875,shaman,enhancement,130,52,78
Tuzep,bloodscalp,871,shaman,enhancement,59,23,36
Nervuus,burning-legion,870,shaman,enhancement,51,16,35
Argueaner,eonar,867,shaman,enhancement,40,15,25
Агирук,goldrinn,866,shaman,enhancement,25,12,13
Rylidare,khaz-modan,865,shaman,enhancement,65,28,37
Shockkanta,antonidas,864,shaman,enhancement,12,9,3
Hexftw,khaz-modan,864,shaman,enhancement,12,9,3
Khylejenner,kazzak,864,shaman,enhancement,12,9,3
Turbothea,blackmoore,864,shaman,enhancement,12,9,3
ßluegelato,silvermoon,864,shaman,enhancement,12,9,3
Йодаримару,howling-fjord,864,shaman,enhancement,12,9,3
Draeker,magtheridon,864,shaman,enhancement,12,9,3
Xorez,blackmoore,864,shaman,enhancement,12,9,3
Electro,dentarg,864,shaman,enhancement,12,9,3
Thunderman,the-maelstrom,864,shaman,enhancement,12,9,3
Martini,tichondrius,864,shaman,enhancement,15,10,5
Arshak,stormscale,864,shaman,enhancement,18,9,9
Gopimusprime,twisting-nether,864,shaman,enhancement,18,9,9
Deadwôlf,stormscale,864,shaman,enhancement,18,9,9
Eshami,tarren-mill,864,shaman,enhancement,18,9,9
Tswiftx,tarren-mill,864,shaman,enhancement,18,9,9
Ghettocheff,blackmoore,864,shaman,enhancement,24,9,15
Stephelord,blackmoore,864,shaman,enhancement,30,9,21
Crazypop,outland,863,shaman,enhancement,18,9,9
Héio,dalaran,863,shaman,enhancement,18,9,9
Réläx,kazzak,863,shaman,enhancement,18,9,9
Gwout,burning-legion,863,shaman,enhancement,18,9,9
Virrogs,argent-dawn,863,shaman,enhancement,18,9,9
Taraesh,blackhand,863,shaman,enhancement,18,9,9
Nëÿrën,drakthul,863,shaman,enhancement,18,9,9
Хукман,howling-fjord,863,shaman,enhancement,18,9,9
Zðhan,azshara,863,shaman,enhancement,18,9,9
Purgey,ravencrest,863,shaman,enhancement,18,9,9
Mendoz,nazjatar,863,shaman,enhancement,122,60,62
Sgtspyke,ragnaros,863,shaman,enhancement,24,9,15
Рэкквием,howling-fjord,863,shaman,enhancement,24,9,15
Jhagy,archimonde,863,shaman,enhancement,24,9,15
Ikiku,twisting-nether,863,shaman,enhancement,28,10,18
Shamehameha,thrall,862,shaman,enhancement,12,9,3
Szelenamoonx,outland,862,shaman,enhancement,18,9,9
Brigantino,burning-legion,862,shaman,enhancement,18,9,9
Камшатт,howling-fjord,862,shaman,enhancement,18,9,9
Jabja,antonidas,862,shaman,enhancement,18,9,9
Pissluffer,tarren-mill,862,shaman,enhancement,18,9,9
Gagné,hyjal,862,shaman,enhancement,18,9,9
Tuncha,runetotem,862,shaman,enhancement,18,9,9
Jaydc,silvermoon,862,shaman,enhancement,22,9,13
Ордосус,gordunni,862,shaman,enhancement,24,9,15
Mästerruv,the-maelstrom,862,shaman,enhancement,24,9,15
Tangragmg,runetotem,862,shaman,enhancement,42,12,30
Abdegor,burning-legion,861,shaman,enhancement,18,9,9
Vermilyon,sanguino,861,shaman,enhancement,18,9,9
Bananaspliit,stormscale,861,shaman,enhancement,24,9,15
Seriux,twisting-nether,860,shaman,enhancement,15,10,5
Syphilya,dun-morogh,860,shaman,enhancement,18,9,9
Rashtar,ravencrest,860,shaman,enhancement,18,9,9
Elesmelly,draenor,860,shaman,enhancement,24,9,15
Discoshort,kazzak,860,shaman,enhancement,24,9,15
Tatyabis,drekthar,859,shaman,enhancement,18,9,9
Loko,terokkar,857,shaman,enhancement,18,9,9
Earthvixen,ravencrest,857,shaman,enhancement,47,23,24
Yzeed,argent-dawn,856,shaman,enhancement,18,9,9
Kaareh,frostmourne,856,shaman,enhancement,18,9,9
Furian,die-nachtwache,855,shaman,enhancement,24,9,15
Fashess,sunstrider,855,shaman,enhancement,24,9,15
Slavazsu,draenor,851,shaman,enhancement,18,9,9
Magdarr,ysondre,846,shaman,enhancement,30,9,21
Халлстэин,gordunni,846,shaman,enhancement,39,10,29
Gälädhan,ysondre,839,shaman,enhancement,30,14,16
Kuhjo,malganis,837,shaman,enhancement,18,9,9
ßlãstmåçhîñê,kazzak,831,shaman,enhancement,24,10,14
Buldozar,blackmoore,831,shaman,enhancement,28,9,19
Lamoulastorm,chogall,828,shaman,enhancement,17,9,8
Levitate,pozzo-delleternità,827,shaman,enhancement,18,9,9
Deeblu,nemesis,821,shaman,enhancement,24,9,15
Grinan,hyjal,817,shaman,enhancement,53,16,37
Rodfrugten,draenor,815,shaman,enhancement,17,9,8
Shelara,drakthul,810,shaman,enhancement,31,14,17
Exereon,ravencrest,808,shaman,enhancement,20,11,9
Мамонтшам,howling-fjord,808,shaman,enhancement,17,9,8
Ìkarus,eredar,804,shaman,enhancement,40,17,23
Vix,argent-dawn,799,shaman,enhancement,14,9,5
Ниокэнх,gordunni,797,shaman,enhancement,16,9,7
Danthesham,draenor,796,shaman,enhancement,22,9,13
Hamstéole,hyjal,784,shaman,enhancement,16,9,7
Razgriz,confrérie-du-thorium,784,shaman,enhancement,19,9,10
Laghärta,dun-modr,783,shaman,enhancement,62,32,30
Саксаул,fordragon,783,shaman,enhancement,19,9,10
Koiru,argent-dawn,782,shaman,enhancement,19,9,10
Trankilo,silvermoon,768,shaman,enhancement,12,8,4
Whatsatotem,hyjal,768,shaman,enhancement,12,8,4
Бурапи,howling-fjord,768,shaman,enhancement,12,8,4
Qätär,ravencrest,768,shaman,enhancement,12,8,4
Cocolopez,tichondrius,768,shaman,enhancement,12,8,4
Драгенхз,gordunni,768,shaman,enhancement,12,8,4
Krytonian,twisting-nether,768,shaman,enhancement,12,8,4
Blimblau,stormrage,768,shaman,enhancement,12,8,4
Bufalan,uldum,768,shaman,enhancement,12,8,4
Trulor,stormscale,768,shaman,enhancement,12,8,4
Azùk,kazzak,768,shaman,enhancement,12,8,4
Olej,burning-legion,768,shaman,enhancement,12,8,4
Jillibaa,stormscale,768,shaman,enhancement,12,8,4
Achtungblitz,blackrock,768,shaman,enhancement,12,8,4
Otsle,kazzak,768,shaman,enhancement,12,8,4
Dêblâzê,thrall,768,shaman,enhancement,12,8,4
Deådwolf,stormscale,768,shaman,enhancement,17,9,8
Bmtotem,twisting-nether,768,shaman,enhancement,18,8,10
Alëxx,hyjal,768,shaman,enhancement,18,8,10
Wonderman,jaedenar,767,shaman,enhancement,12,8,4
Yinyleón,ravencrest,767,shaman,enhancement,12,8,4
Картохыч,howling-fjord,767,shaman,enhancement,12,8,4
Quexsha,kazzak,767,shaman,enhancement,12,8,4
Пиводафф,howling-fjord,767,shaman,enhancement,12,8,4
Nazzag,twisting-nether,767,shaman,enhancement,12,8,4
Dafreq,blackhand,767,shaman,enhancement,12,8,4
Davkas,chamber-of-aspects,767,shaman,enhancement,12,8,4
Complete,hyjal,767,shaman,enhancement,12,8,4
Quarris,silvermoon,767,shaman,enhancement,12,8,4
Tschacô,malganis,767,shaman,enhancement,18,8,10
Nápälm,dun-modr,767,shaman,enhancement,18,8,10
Nínive,zuljin,767,shaman,enhancement,18,8,10
Эллектрошам,ashenvale,767,shaman,enhancement,18,8,10
Ownsafe,les-clairvoyants,767,shaman,enhancement,18,8,10
Carlos,magtheridon,767,shaman,enhancement,18,8,10
Snoopfrog,dun-morogh,767,shaman,enhancement,18,8,10
Szamanito,turalyon,767,shaman,enhancement,18,8,10
Nahkasika,defias-brotherhood,767,shaman,enhancement,18,8,10
Zaappyboii,azjolnerub,767,shaman,enhancement,18,8,10
Totemcillas,sanguino,767,shaman,enhancement,18,8,10
Devastatiia,ragnaros,766,shaman,enhancement,12,8,4
Anöuchkâ,ysondre,766,shaman,enhancement,12,8,4
Mathak,thrall,766,shaman,enhancement,18,8,10
Târu,blackrock,766,shaman,enhancement,24,8,16
Niveamann,eredar,765,shaman,enhancement,12,8,4
Rosewall,twisting-nether,765,shaman,enhancement,12,8,4
Elayco,twisting-nether,765,shaman,enhancement,18,8,10
Dillerfranz,stormscale,765,shaman,enhancement,18,8,10
Lôù,archimonde,765,shaman,enhancement,18,8,10
Epti,argent-dawn,765,shaman,enhancement,24,8,16
Agrok,jaedenar,765,shaman,enhancement,30,8,22
Энхким,soulflayer,765,shaman,enhancement,32,8,24
Fuzzynuts,ravencrest,765,shaman,enhancement,36,8,28
Ronctaha,blackrock,764,shaman,enhancement,12,8,4
Nëllaqt,archimonde,764,shaman,enhancement,18,8,10
Блэкмаршал,howling-fjord,764,shaman,enhancement,18,8,10
Vilberoo,ravencrest,764,shaman,enhancement,24,8,16
Socesalade,ysondre,764,shaman,enhancement,24,8,16
Зулкунд,soulflayer,763,shaman,enhancement,18,8,10
Escreption,tarren-mill,763,shaman,enhancement,24,8,16
Sturmbréchér,area-52,763,shaman,enhancement,24,8,16
Thrallotido,sanguino,762,shaman,enhancement,12,8,4
Olayan,zenedar,762,shaman,enhancement,18,8,10
Тилливилли,howling-fjord,761,shaman,enhancement,12,8,4
Useemerollin,twisting-nether,760,shaman,enhancement,24,8,16
Wewondik,drakthul,759,shaman,enhancement,35,9,26
Shamanares,arathor,757,shaman,enhancement,12,8,4
Slushï,argent-dawn,757,shaman,enhancement,30,8,22
Azabi,defias-brotherhood,756,shaman,enhancement,24,8,16
Шамблабла,soulflayer,756,shaman,enhancement,30,8,22
Fotmslave,laughing-skull,749,shaman,enhancement,15,10,5
Óõ,dun-modr,748,shaman,enhancement,18,8,10
Asogg,archimonde,743,shaman,enhancement,24,9,15
Boltmac,mugthol,736,shaman,enhancement,16,9,7
Dénekha,zuljin,733,shaman,enhancement,14,9,5
Negårn,tarren-mill,719,shaman,enhancement,11,8,3
Wàve,stormscale,719,shaman,enhancement,17,8,9
Kkthxbb,aegwynn,718,shaman,enhancement,15,8,7
Xereús,kazzak,718,shaman,enhancement,23,8,15
Ihealbro,blackrock,714,shaman,enhancement,16,11,5
Shamansito,tyrande,713,shaman,enhancement,21,9,12
Messedmyself,outland,710,shaman,enhancement,21,9,12
Jockin,tarren-mill,710,shaman,enhancement,29,10,19
Pospodrol,ragnaros,704,shaman,enhancement,16,8,8
Spajry,drakthul,702,shaman,enhancement,14,8,6
Lavashock,tarren-mill,700,shaman,enhancement,28,8,20
Bizzlebeast,lightbringer,687,shaman,enhancement,19,8,11
Tiamât,culte-de-la-rive-noire,685,shaman,enhancement,19,8,11
Bärtigeberta,aegwynn,672,shaman,enhancement,10,8,2
Сарокида,howling-fjord,672,shaman,enhancement,12,7,5
Эоя,howling-fjord,672,shaman,enhancement,12,7,5
Metalbeef,xavius,672,shaman,enhancement,12,7,5
Magharro,kazzak,672,shaman,enhancement,12,7,5
Fudgekek,ravencrest,672,shaman,enhancement,12,7,5
Инсэйнгодх,soulflayer,672,shaman,enhancement,12,7,5
Борисэнимал,gordunni,672,shaman,enhancement,12,7,5
Zanjulu,ravenholdt,672,shaman,enhancement,12,7,5
Neterö,la-croisade-écarlate,672,shaman,enhancement,12,7,5
Vutututututu,ragnaros,672,shaman,enhancement,12,7,5
Kylas,die-ewige-wacht,672,shaman,enhancement,12,7,5
Turbosaab,draenor,672,shaman,enhancement,12,7,5
Roineé,draenor,672,shaman,enhancement,12,7,5
Proper,tichondrius,672,shaman,enhancement,12,7,5
Thorbjörne,ravencrest,672,shaman,enhancement,12,7,5
Pacó,zuluhed,672,shaman,enhancement,12,7,5
Faeroox,ravencrest,672,shaman,enhancement,12,7,5
Primez,twilights-hammer,672,shaman,enhancement,12,7,5
Runè,azjolnerub,672,shaman,enhancement,12,7,5
Horiq,kazzak,672,shaman,enhancement,18,7,11
Elhefe,ravencrest,672,shaman,enhancement,18,7,11
Нерезшок,soulflayer,672,shaman,enhancement,18,7,11
Irmax,stormscale,672,shaman,enhancement,18,7,11
Sorlk,kazzak,672,shaman,enhancement,18,7,11
Kärríegold,blackrock,672,shaman,enhancement,18,7,11
Shougaku,blackrock,672,shaman,enhancement,18,7,11
Votie,tarren-mill,672,shaman,enhancement,18,7,11
Zerak,twisting-nether,672,shaman,enhancement,21,8,13
Hurbi,twisting-nether,672,shaman,enhancement,24,7,17
Lavalew,lightbringer,672,shaman,enhancement,24,7,17
Корграш,howling-fjord,671,shaman,enhancement,12,7,5
Thalmorius,argent-dawn,671,shaman,enhancement,12,7,5
Джоннси,howling-fjord,671,shaman,enhancement,12,7,5
Zenzua,twisting-nether,671,shaman,enhancement,12,7,5
Êvø,draenor,671,shaman,enhancement,12,7,5
Wiev,blackmoore,671,shaman,enhancement,12,7,5
Okmogar,khaz-modan,671,shaman,enhancement,12,7,5
Kejazal,blackrock,671,shaman,enhancement,12,7,5
Outhell,sylvanas,671,shaman,enhancement,12,7,5
Stormfury,balnazzar,671,shaman,enhancement,12,7,5
Napwak,hyjal,671,shaman,enhancement,12,7,5
Groundedx,ravencrest,671,shaman,enhancement,12,7,5
Phookov,ravencrest,671,shaman,enhancement,12,7,5
Çøynx,aegwynn,671,shaman,enhancement,18,7,11
Galandrohk,stormscale,671,shaman,enhancement,18,7,11
Chiwas,outland,671,shaman,enhancement,18,7,11
Lafia,blackrock,671,shaman,enhancement,18,7,11
Meangreen,stormscale,671,shaman,enhancement,18,7,11
Fanatroka,ravencrest,671,shaman,enhancement,18,7,11
Bram,aggra-português,671,shaman,enhancement,18,7,11
Younglasso,blackrock,671,shaman,enhancement,18,7,11
Sajma,silvermoon,671,shaman,enhancement,18,7,11
Teenx,auchindoun,671,shaman,enhancement,18,7,11
Götveren,eredar,671,shaman,enhancement,18,7,11
Coxshamanic,draenor,671,shaman,enhancement,18,7,11
Dreamtotem,tarren-mill,671,shaman,enhancement,20,7,13
Birnenpfeffi,malfurion,671,shaman,enhancement,20,7,13
Phizzik,ravencrest,670,shaman,enhancement,18,7,11
Shockýbalboa,ragnaros,670,shaman,enhancement,18,7,11
Korbas,burning-legion,670,shaman,enhancement,24,7,17
Sacrx,dalaran,670,shaman,enhancement,24,7,17
Prettymoon,pozzo-delleternità,670,shaman,enhancement,24,7,17
Rúberg,shadowsong,669,shaman,enhancement,18,7,11
Bnovisa,kazzak,668,shaman,enhancement,20,7,13
Wartay,doomhammer,667,shaman,enhancement,12,7,5
Spirites,drakthul,667,shaman,enhancement,12,7,5
Фролыч,deathguard,645,shaman,enhancement,23,9,14
Hemradi,blackmoore,638,shaman,enhancement,11,7,4
Hollowtotem,darkmoon-faire,617,shaman,enhancement,20,8,12
Skillxdxdxd,outland,608,shaman,enhancement,16,7,9
Nintotemxo,stormscale,607,shaman,enhancement,14,7,7
Перегной,ashenvale,607,shaman,enhancement,22,7,15
Doomburger,darksorrow,592,shaman,enhancement,13,7,6
Ulumulu,frostwolf,576,shaman,enhancement,6,6,0
Darkirondwar,silvermoon,576,shaman,enhancement,6,6,0
Loryaahx,hyjal,576,shaman,enhancement,6,6,0
Lifeflow,sylvanas,576,shaman,enhancement,6,6,0
Silataf,hyjal,576,shaman,enhancement,10,6,4
Mouraïne,eredar,576,shaman,enhancement,12,6,6
Leïnnah,elune,576,shaman,enhancement,12,6,6
Tastyxo,blackmoore,576,shaman,enhancement,12,6,6
Thëhêxfäçtør,tarren-mill,576,shaman,enhancement,12,6,6
Kémar,frostwolf,576,shaman,enhancement,12,6,6
Lokkrag,archimonde,576,shaman,enhancement,12,6,6
Вайгачи,soulflayer,576,shaman,enhancement,12,6,6
Thundhrim,silvermoon,576,shaman,enhancement,12,6,6
Élement,burning-legion,576,shaman,enhancement,12,6,6
Degstaerian,ysera,576,shaman,enhancement,12,6,6
Isogrind,archimonde,576,shaman,enhancement,12,6,6
Венли,ashenvale,576,shaman,enhancement,12,6,6
Yompo,archimonde,576,shaman,enhancement,12,6,6
Thunderwill,sanguino,576,shaman,enhancement,12,6,6
Насуплекс,howling-fjord,576,shaman,enhancement,12,6,6
Charlienaay,draenor,576,shaman,enhancement,12,6,6
Lurtax,outland,576,shaman,enhancement,12,6,6
Searfang,korgall,576,shaman,enhancement,12,6,6
Nightmurpf,defias-brotherhood,576,shaman,enhancement,12,6,6
Drøgøs,dun-modr,576,shaman,enhancement,12,6,6
Buffresto,kazzak,576,shaman,enhancement,12,6,6
Crazo,tarren-mill,576,shaman,enhancement,12,6,6
Proccity,stormscale,576,shaman,enhancement,12,6,6
Bichîk,archimonde,576,shaman,enhancement,12,6,6
Sypxic,kazzak,576,shaman,enhancement,12,6,6
Kaingar,ravencrest,576,shaman,enhancement,12,6,6
Sebikzap,ravencrest,576,shaman,enhancement,12,6,6
Yiiro,argent-dawn,576,shaman,enhancement,12,6,6
Voljen,festung-der-stürme,576,shaman,enhancement,12,6,6
Povvder,ravencrest,576,shaman,enhancement,12,6,6
Gruggosh,argent-dawn,576,shaman,enhancement,12,6,6
Obêlixx,blackmoore,576,shaman,enhancement,12,6,6
Noneedshaman,stormscale,576,shaman,enhancement,12,6,6
Rèxxar,stormscale,576,shaman,enhancement,12,6,6
Shakyi,thrall,576,shaman,enhancement,12,6,6
Thundersioux,ravencrest,576,shaman,enhancement,12,6,6
Burstystorm,stormscale,576,shaman,enhancement,12,6,6
Rejrax,ravencrest,576,shaman,enhancement,18,6,12
Dagoahgra,sanguino,576,shaman,enhancement,18,6,12
Azuto,outland,576,shaman,enhancement,18,6,12
Hieroinmunaa,sunstrider,576,shaman,enhancement,18,6,12
Haasshaman,ravencrest,576,shaman,enhancement,18,6,12
Leccyavenue,twisting-nether,576,shaman,enhancement,18,6,12
Trogodos,blackrock,576,shaman,enhancement,18,6,12
Энхолет,soulflayer,575,shaman,enhancement,12,6,6
Erscreamiko,zuljin,575,shaman,enhancement,12,6,6
Schamikolben,blackmoore,575,shaman,enhancement,12,6,6
Даркнесх,howling-fjord,575,shaman,enhancement,12,6,6
Shalý,antonidas,575,shaman,enhancement,12,6,6
Сакмастер,howling-fjord,575,shaman,enhancement,12,6,6
Carakh,archimonde,575,shaman,enhancement,12,6,6
Finni,hyjal,575,shaman,enhancement,12,6,6
Pocakberci,silvermoon,575,shaman,enhancement,12,6,6
Shawnmendes,kazzak,575,shaman,enhancement,15,7,8
Izaro,blackmoore,575,shaman,enhancement,21,7,14
Ashgar,drakthul,575,shaman,enhancement,18,6,12
Saulty,archimonde,575,shaman,enhancement,18,6,12
Raytastic,aegwynn,575,shaman,enhancement,18,6,12
Emphirian,die-silberne-hand,575,shaman,enhancement,18,6,12
Dezîbel,nathrezim,575,shaman,enhancement,18,6,12
Altostratus,hellfire,575,shaman,enhancement,18,6,12
Yousainlbolt,blackrock,575,shaman,enhancement,24,6,18
Tholatir,silvermoon,575,shaman,enhancement,24,6,18
Zackyboi,tarren-mill,574,shaman,enhancement,12,6,6
Chllup,drakthul,574,shaman,enhancement,12,6,6
Shaxall,draenor,574,shaman,enhancement,18,6,12
Chamaiko,kaelthas,574,shaman,enhancement,18,6,12
Rebekca,twisting-nether,574,shaman,enhancement,18,6,12
Лорикок,grom,574,shaman,enhancement,28,7,21
Zuziki,argent-dawn,573,shaman,enhancement,12,6,6
Bubbschock,antonidas,573,shaman,enhancement,12,6,6
Thormyr,dalaran,573,shaman,enhancement,18,6,12
Дядяшаман,gordunni,573,shaman,enhancement,24,6,18
Thorhonzor,drakthul,571,shaman,enhancement,18,6,12
Zeuuss,zuljin,565,shaman,enhancement,12,6,6
Xssanimo,draenor,559,shaman,enhancement,17,6,11
Hurtigtotem,ravencrest,558,shaman,enhancement,15,7,8
Biggie,pozzo-delleternità,528,shaman,enhancement,15,6,9
Bhroly,stormscale,522,shaman,enhancement,21,8,13
Xhahal,hyjal,521,shaman,enhancement,19,7,12
Squirtstorm,ravencrest,521,shaman,enhancement,29,8,21
Johnyexe,drakthul,515,shaman,enhancement,14,7,7
Fapmasterz,eredar,511,shaman,enhancement,11,6,5
Guzguzguz,blackhand,511,shaman,enhancement,14,6,8
Дереза,greymane,510,shaman,enhancement,20,6,14
Svetosham,wildhammer,480,shaman,enhancement,6,5,1
Kutcher,aegwynn,480,shaman,enhancement,6,5,1
Eku,illidan,480,shaman,enhancement,6,5,1
Bârtmân,blackmoore,480,shaman,enhancement,6,5,1
Obsessionx,stormscale,480,shaman,enhancement,6,5,1
Маккаккаккак,gordunni,480,shaman,enhancement,6,5,1
Эйонн,gordunni,480,shaman,enhancement,6,5,1
Synergizer,kazzak,480,shaman,enhancement,6,5,1
Belford,ysondre,480,shaman,enhancement,6,5,1
Seaview,silvermoon,480,shaman,enhancement,6,5,1
Genrok,burning-blade,480,shaman,enhancement,6,5,1
Øutfox,silvermoon,480,shaman,enhancement,6,5,1
Pánjo,blackrock,480,shaman,enhancement,6,5,1
Dorxt,chogall,480,shaman,enhancement,6,5,1
Whïtewïdøw,ysondre,480,shaman,enhancement,6,5,1
Jumborumbo,quelthalas,480,shaman,enhancement,6,5,1
Celv,ravencrest,480,shaman,enhancement,6,5,1
Nargaz,burning-legion,480,shaman,enhancement,6,5,1
Wooyoungsham,sylvanas,480,shaman,enhancement,6,5,1
Slegit,arthas,480,shaman,enhancement,6,5,1
Ðevi,ravencrest,480,shaman,enhancement,6,5,1
Matapijos,dun-modr,480,shaman,enhancement,9,6,3
Windfúhrèr,tarren-mill,480,shaman,enhancement,8,5,3
Dianshaman,ravencrest,480,shaman,enhancement,10,6,4
Lilmarco,stormreaver,480,shaman,enhancement,12,5,7
Pank,kazzak,480,shaman,enhancement,12,5,7
Hobblefoot,stormscale,480,shaman,enhancement,12,5,7
Grosgourdin,la-croisade-écarlate,480,shaman,enhancement,12,5,7
Пыльныйхлеб,blackscar,480,shaman,enhancement,12,5,7
Kejllåke,stormscale,480,shaman,enhancement,12,5,7
Hurik,sylvanas,480,shaman,enhancement,12,5,7
Ацитра,gordunni,480,shaman,enhancement,12,5,7
Satzuki,stormscale,480,shaman,enhancement,12,5,7
Xelphia,frostmane,480,shaman,enhancement,12,5,7
Tîk,dalaran,480,shaman,enhancement,12,5,7
Grolifer,archimonde,480,shaman,enhancement,12,5,7
Teaboï,hyjal,480,shaman,enhancement,12,5,7
Whyisitspicy,kazzak,480,shaman,enhancement,12,5,7
Fiden,drakthul,480,shaman,enhancement,12,5,7
Jonnykaye,outland,480,shaman,enhancement,12,5,7
Khoyuav,blackrock,480,shaman,enhancement,12,5,7
Hatyatya,ragnaros,480,shaman,enhancement,12,5,7
Smorclelx,khadgar,480,shaman,enhancement,12,5,7
Djkost,archimonde,480,shaman,enhancement,12,5,7
Сенхан,goldrinn,480,shaman,enhancement,12,5,7
Guzz,cthun,480,shaman,enhancement,12,5,7
Tempóralex,blackhand,480,shaman,enhancement,12,5,7
Laserra,sylvanas,480,shaman,enhancement,12,5,7
Ñax,silvermoon,480,shaman,enhancement,12,5,7
Дротчим,soulflayer,480,shaman,enhancement,12,5,7
Смокдог,razuvious,480,shaman,enhancement,12,5,7
Jólla,twisting-nether,480,shaman,enhancement,12,5,7
Bowtenstorm,ravencrest,480,shaman,enhancement,12,5,7
Getahex,draenor,480,shaman,enhancement,12,5,7
Ctrlv,blackhand,480,shaman,enhancement,12,5,7
Volcanò,outland,480,shaman,enhancement,12,5,7
Duhdelido,ravencrest,480,shaman,enhancement,12,5,7
Zarosh,los-errantes,480,shaman,enhancement,12,5,7
Xoul,aegwynn,480,shaman,enhancement,12,5,7
Åkee,kazzak,480,shaman,enhancement,12,5,7
Feetsniffax,outland,480,shaman,enhancement,12,5,7
Afterlife,alakir,480,shaman,enhancement,18,5,13
Scharmharne,dun-morogh,480,shaman,enhancement,18,5,13
Solverna,der-mithrilorden,480,shaman,enhancement,18,5,13
Zaknakatel,drakthul,480,shaman,enhancement,18,5,13
Hiron,sylvanas,480,shaman,enhancement,18,5,13
Keshinio,archimonde,480,shaman,enhancement,18,5,13
Tomberêve,chants-éternels,480,shaman,enhancement,18,5,13
Crilath,ysondre,480,shaman,enhancement,18,5,13
Indan,kazzak,480,shaman,enhancement,18,5,13
Johnisplay,tarren-mill,480,shaman,enhancement,18,5,13
Halliane,ysondre,480,shaman,enhancement,24,5,19
Sïlvek,sanguino,480,shaman,enhancement,24,5,19
Brassefrasse,shattered-hand,479,shaman,enhancement,6,5,1
Thunderrbob,darkspear,479,shaman,enhancement,6,5,1
Zerwurster,thrall,479,shaman,enhancement,10,6,4
Bullshock,stormreaver,479,shaman,enhancement,12,5,7
Durotansan,ragnaros,479,shaman,enhancement,12,5,7
Aznan,burning-legion,479,shaman,enhancement,12,5,7
Kharazhan,blackrock,479,shaman,enhancement,12,5,7
Bautenn,kazzak,479,shaman,enhancement,12,5,7
Hønneyjck,hyjal,479,shaman,enhancement,12,5,7
Chamrøck,hyjal,479,shaman,enhancement,12,5,7
Cupet,dun-modr,479,shaman,enhancement,12,5,7
Elementarxss,blackmoore,479,shaman,enhancement,18,5,13
Плюювшкафы,ashenvale,479,shaman,enhancement,18,5,13
Kaybiel,magtheridon,478,shaman,enhancement,12,5,7
Hilerr,draenor,478,shaman,enhancement,18,5,13
Pewz,twilights-hammer,478,shaman,enhancement,24,5,19
Asstroy,sanguino,477,shaman,enhancement,6,5,1
Shockdx,dun-modr,463,shaman,enhancement,11,5,6
Zaffyboi,draenor,448,shaman,enhancement,16,5,11
Vicinitysham,twisting-nether,447,shaman,enhancement,11,5,6
Kelbi,malganis,432,shaman,enhancement,9,5,4
Electrical,kazzak,426,shaman,enhancement,15,6,9
Sicknu,eredar,425,shaman,enhancement,23,6,17
Bodytypeonex,darksorrow,415,shaman,enhancement,17,5,12
Luqas,burning-legion,414,shaman,enhancement,8,5,3
Vønhørk,dalaran,384,shaman,enhancement,6,4,2
Mustabrutus,tarren-mill,384,shaman,enhancement,6,4,2
Aloeverayo,defias-brotherhood,384,shaman,enhancement,6,4,2
Totems,the-venture-co,384,shaman,enhancement,6,4,2
Procbly,tarren-mill,384,shaman,enhancement,6,4,2
Xalta,eldrethalas,384,shaman,enhancement,6,4,2
Thundertommy,ravencrest,384,shaman,enhancement,6,4,2
Ískuma,blackmoore,384,shaman,enhancement,6,4,2
Россаврн,galakrond,384,shaman,enhancement,6,4,2
Vullpix,zuljin,384,shaman,enhancement,6,4,2
Umilbhess,pozzo-delleternità,384,shaman,enhancement,6,4,2
Watchmechoke,twisting-nether,384,shaman,enhancement,6,4,2
Stonebeard,minahonda,384,shaman,enhancement,6,4,2
Shocrates,stormreaver,384,shaman,enhancement,6,4,2
Aitch,blackmoore,384,shaman,enhancement,6,4,2
Burzum,twisting-nether,384,shaman,enhancement,6,4,2
Baldurr,sylvanas,384,shaman,enhancement,6,4,2
Blamy,auchindoun,384,shaman,enhancement,6,4,2
Tmpsykø,dalaran,384,shaman,enhancement,6,4,2
Нийрагонго,gordunni,384,shaman,enhancement,6,4,2
Burstraze,tarren-mill,384,shaman,enhancement,6,4,2
Олешао,howling-fjord,384,shaman,enhancement,6,4,2
Avatargadash,stormscale,384,shaman,enhancement,6,4,2
Darkestred,tarren-mill,384,shaman,enhancement,6,4,2
Tornado,ravencrest,384,shaman,enhancement,6,4,2
Rage,quelthalas,384,shaman,enhancement,6,4,2
Taroc,nethersturm,384,shaman,enhancement,6,4,2
Piripolkka,defias-brotherhood,384,shaman,enhancement,6,4,2
Kaej,ravencrest,384,shaman,enhancement,6,4,2
Shialesham,twisting-nether,384,shaman,enhancement,6,4,2
Элемуэль,soulflayer,384,shaman,enhancement,6,4,2
Trünk,arathi,384,shaman,enhancement,6,4,2
Lethz,hyjal,384,shaman,enhancement,6,4,2
Shamanman,kazzak,384,shaman,enhancement,6,4,2
Shakhdan,archimonde,384,shaman,enhancement,6,4,2
Thornaim,hyjal,384,shaman,enhancement,6,4,2
Alàstor,kazzak,384,shaman,enhancement,6,4,2
Ojipko,hyjal,384,shaman,enhancement,6,4,2
Ilkim,hyjal,384,shaman,enhancement,6,4,2
Srøgg,archimonde,384,shaman,enhancement,6,4,2
Weåfy,outland,384,shaman,enhancement,6,4,2
Richtigfies,kazzak,384,shaman,enhancement,6,4,2
Hextazy,archimonde,384,shaman,enhancement,6,4,2
Lunarsloth,hyjal,384,shaman,enhancement,6,4,2
Szzk,kazzak,384,shaman,enhancement,9,5,4
Shambulänce,doomhammer,384,shaman,enhancement,9,5,4
Sfeerá,burning-legion,384,shaman,enhancement,12,4,8
Алимика,deathguard,384,shaman,enhancement,12,4,8
Kayalii,silvermoon,384,shaman,enhancement,12,4,8
Hexbeforesex,kazzak,384,shaman,enhancement,12,4,8
Kiwanuká,draenor,384,shaman,enhancement,12,4,8
Tetóm,draenor,384,shaman,enhancement,12,4,8
Bumblebíí,ravencrest,384,shaman,enhancement,12,4,8
Szami,burning-legion,384,shaman,enhancement,12,4,8
Waterboi,blackmoore,384,shaman,enhancement,12,4,8
Cptcutíe,antonidas,384,shaman,enhancement,12,4,8
Beefythunder,draenor,384,shaman,enhancement,12,4,8
Klamen,kazzak,384,shaman,enhancement,12,4,8
Invòkèr,kazzak,384,shaman,enhancement,12,4,8
Крепуксх,soulflayer,384,shaman,enhancement,12,4,8
Sheldoww,tarren-mill,384,shaman,enhancement,12,4,8
Шиока,borean-tundra,384,shaman,enhancement,12,4,8
Shôcopan,los-errantes,384,shaman,enhancement,12,4,8
Blixtnedslag,shattered-hand,384,shaman,enhancement,12,4,8
Хулн,gordunni,384,shaman,enhancement,12,4,8
Jaéto,ravencrest,384,shaman,enhancement,12,4,8
Javalemcgee,ravencrest,384,shaman,enhancement,12,4,8
Эпссон,soulflayer,384,shaman,enhancement,12,4,8
Claodze,stormscale,384,shaman,enhancement,12,4,8
Nagyrakéta,ragnaros,384,shaman,enhancement,12,4,8
Дюнволкер,razuvious,384,shaman,enhancement,12,4,8
Ghøhp,nerzhul,384,shaman,enhancement,12,4,8
Dáweïs,drakthul,384,shaman,enhancement,12,4,8
Sgbich,khaz-modan,384,shaman,enhancement,12,4,8
Wisetotem,kazzak,384,shaman,enhancement,12,4,8
Türak,tarren-mill,384,shaman,enhancement,12,4,8
Courtney,sylvanas,384,shaman,enhancement,12,4,8
Sourens,twisting-nether,384,shaman,enhancement,12,4,8
Yasunari,sanguino,384,shaman,enhancement,18,4,14
Powder,tichondrius,384,shaman,enhancement,18,4,14
Wkretarka,burning-legion,384,shaman,enhancement,18,4,14
Limutsis,twilights-hammer,384,shaman,enhancement,18,4,14
Derryo,silvermoon,384,shaman,enhancement,18,4,14
Carnágé,blackrock,383,shaman,enhancement,6,4,2
Goblaman,pozzo-delleternità,383,shaman,enhancement,6,4,2
Ðuster,jaedenar,383,shaman,enhancement,6,4,2
Wolkano,zuljin,383,shaman,enhancement,10,5,5
Châmanco,dun-modr,383,shaman,enhancement,12,4,8
Аеесо,gordunni,383,shaman,enhancement,12,4,8
Hightotem,sanguino,383,shaman,enhancement,12,4,8
Rioshammy,kazzak,383,shaman,enhancement,14,4,10
Diamantiá,die-aldor,383,shaman,enhancement,18,4,14
Blutshock,zuluhed,382,shaman,enhancement,12,4,8
Envergur,eitrigg,379,shaman,enhancement,12,4,8
Shamantun,ragnaros,367,shaman,enhancement,11,4,7
Ciaolol,ragnaros,362,shaman,enhancement,13,6,7
Hassinto,dun-modr,348,shaman,enhancement,11,4,7
Piaoliang,ravencrest,336,shaman,enhancement,9,4,5
Akash,culte-de-la-rive-noire,336,shaman,enhancement,15,4,11
Chapox,alleria,319,shaman,enhancement,5,4,1
Macchiavelli,blades-edge,319,shaman,enhancement,8,4,4
Mooshock,balnazzar,319,shaman,enhancement,14,4,10
Lemoncurry,tarren-mill,319,shaman,enhancement,14,4,10
Moolurken,stormscale,304,shaman,enhancement,7,4,3
Ayrá,ulduar,297,shaman,enhancement,12,6,6
Tharwin,hellfire,288,shaman,enhancement,6,3,3
Ghoon,arathor,288,shaman,enhancement,6,3,3
Ветренаяледи,gordunni,288,shaman,enhancement,6,3,3
Нерфшок,gordunni,288,shaman,enhancement,6,3,3
Ccedtodeath,sylvanas,288,shaman,enhancement,6,3,3
Suedis,frostmane,288,shaman,enhancement,6,3,3
Sodor,laughing-skull,288,shaman,enhancement,6,3,3
Glïmar,sanguino,288,shaman,enhancement,6,3,3
Рокутаро,gordunni,288,shaman,enhancement,6,3,3
Nojiko,blackrock,288,shaman,enhancement,6,3,3
Odelagga,sylvanas,288,shaman,enhancement,6,3,3
Alkiog,cthun,288,shaman,enhancement,6,3,3
Pelicius,sanguino,288,shaman,enhancement,6,3,3
Phazuki,frostmane,288,shaman,enhancement,6,3,3
Cakedeux,grim-batol,288,shaman,enhancement,6,3,3
Ednard,silvermoon,288,shaman,enhancement,6,3,3
Ашьф,gordunni,288,shaman,enhancement,6,3,3
Làvagdx,archimonde,288,shaman,enhancement,6,3,3
Аналкарниваа,gordunni,288,shaman,enhancement,6,3,3
Stormz,blackrock,288,shaman,enhancement,6,3,3
Uomae,dun-modr,288,shaman,enhancement,6,3,3
Неутолимыйх,blackscar,288,shaman,enhancement,6,3,3
Omegaproblem,blackmoore,288,shaman,enhancement,6,3,3
Кулутхе,soulflayer,288,shaman,enhancement,6,3,3
Magraith,korgall,288,shaman,enhancement,6,3,3
Stormstout,zuljin,288,shaman,enhancement,6,3,3
Läzy,sanguino,288,shaman,enhancement,6,3,3
Størmgød,archimonde,288,shaman,enhancement,6,3,3
Сажке,booty-bay,288,shaman,enhancement,6,3,3
Vyzeries,silvermoon,288,shaman,enhancement,6,3,3
Виндфюрер,deathguard,288,shaman,enhancement,6,3,3
Cocorocks,quelthalas,288,shaman,enhancement,6,3,3
Venterlofeu,archimonde,288,shaman,enhancement,6,3,3
Wakoteh,quelthalas,288,shaman,enhancement,6,3,3
Wûcs,silvermoon,288,shaman,enhancement,6,3,3
Айбьорн,gordunni,288,shaman,enhancement,6,3,3
Xesti,twisting-nether,288,shaman,enhancement,6,3,3
Ñtk,dun-modr,288,shaman,enhancement,6,3,3
Surge,darksorrow,288,shaman,enhancement,6,3,3
Namos,aegwynn,288,shaman,enhancement,6,3,3
Warlari,silvermoon,288,shaman,enhancement,6,3,3
Diviyo,magtheridon,288,shaman,enhancement,6,3,3
Hikigane,marécage-de-zangar,288,shaman,enhancement,6,3,3
Picabøø,kazzak,288,shaman,enhancement,6,3,3
Qwevstorm,kazzak,288,shaman,enhancement,6,3,3
Shreddedcntw,ravencrest,288,shaman,enhancement,6,3,3
Demonshamy,silvermoon,288,shaman,enhancement,6,3,3
Yerlas,burning-legion,288,shaman,enhancement,6,3,3
Totoostoy,burning-legion,288,shaman,enhancement,6,3,3
Moebius,hellscream,288,shaman,enhancement,6,3,3
Hystérik,chogall,288,shaman,enhancement,6,3,3
Vaexi,doomhammer,288,shaman,enhancement,6,3,3
Malcolmhex,ysondre,288,shaman,enhancement,6,3,3
Hexmynúts,draenor,288,shaman,enhancement,6,3,3
Tidalflow,stormscale,288,shaman,enhancement,6,3,3
Thundêrclâp,blackrock,288,shaman,enhancement,6,3,3
Zahadumia,blackrock,288,shaman,enhancement,6,3,3
Karazrok,draenor,288,shaman,enhancement,6,3,3
Canoli,eredar,288,shaman,enhancement,6,3,3
Katsumî,dalaran,288,shaman,enhancement,6,3,3
Knoffl,eredar,288,shaman,enhancement,6,3,3
Laeddish,silvermoon,288,shaman,enhancement,6,3,3
Skanda,frostwolf,288,shaman,enhancement,6,3,3
Kemurus,kazzak,288,shaman,enhancement,6,3,3
Hansdieter,antonidas,288,shaman,enhancement,6,3,3
Bangrim,ragnaros,288,shaman,enhancement,6,3,3
Renjín,tarren-mill,288,shaman,enhancement,6,3,3
Eurøz,archimonde,288,shaman,enhancement,6,3,3
Freekster,die-ewige-wacht,288,shaman,enhancement,6,3,3
Vanquïsh,archimonde,288,shaman,enhancement,6,3,3
Daishodrums,antonidas,288,shaman,enhancement,6,3,3
Kazhan,alexstrasza,288,shaman,enhancement,6,3,3
Rayez,draenor,288,shaman,enhancement,6,3,3
Varion,tichondrius,288,shaman,enhancement,6,3,3
Shoewalker,ragnaros,288,shaman,enhancement,6,3,3
Hotsincezero,archimonde,288,shaman,enhancement,6,3,3
Vainzxsham,ravencrest,288,shaman,enhancement,6,3,3
Chrisbrownx,outland,288,shaman,enhancement,6,3,3
Spørc,ragnaros,288,shaman,enhancement,6,3,3
Bendimina,chogall,288,shaman,enhancement,6,3,3
Takanashisha,lordaeron,288,shaman,enhancement,6,3,3
Hyoshin,kirin-tor,288,shaman,enhancement,6,3,3
Lilkazamm,blackrock,288,shaman,enhancement,6,3,3
Bluemyst,outland,288,shaman,enhancement,6,3,3
Omnivamp,kazzak,288,shaman,enhancement,6,3,3
Darten,drakthul,288,shaman,enhancement,6,3,3
Daubidaubi,kazzak,288,shaman,enhancement,6,3,3
Skölls,kirin-tor,288,shaman,enhancement,6,3,3
Foxfyre,tarren-mill,288,shaman,enhancement,6,3,3
Weltr,drakthul,288,shaman,enhancement,6,3,3
Unrealench,ravencrest,288,shaman,enhancement,6,3,3
Håõkåh,hyjal,288,shaman,enhancement,6,3,3
Ostbumsdirne,stormscale,288,shaman,enhancement,6,3,3
Bizquit,blackhand,288,shaman,enhancement,6,3,3
Borbor,argent-dawn,288,shaman,enhancement,6,3,3
Patuljak,outland,288,shaman,enhancement,6,3,3
Parkroy,draenor,288,shaman,enhancement,6,3,3
Samyishamy,tarren-mill,288,shaman,enhancement,6,3,3
Berzærker,ravencrest,288,shaman,enhancement,6,3,3
Tarzh,dalaran,288,shaman,enhancement,6,3,3
Shametrainx,malganis,288,shaman,enhancement,6,3,3
Sadoa,ravencrest,288,shaman,enhancement,6,3,3
Cremed,kazzak,288,shaman,enhancement,6,3,3
Gamalimbo,tarren-mill,288,shaman,enhancement,6,3,3
Nakutotem,ravencrest,288,shaman,enhancement,6,3,3
Bløødypain,blackhand,288,shaman,enhancement,6,3,3
Millesabords,dun-morogh,288,shaman,enhancement,6,3,3
Kulho,stormscale,288,shaman,enhancement,6,3,3
Огнешторм,howling-fjord,288,shaman,enhancement,6,3,3
Имфеллиар,howling-fjord,288,shaman,enhancement,6,3,3
Fairgewalt,blackhand,288,shaman,enhancement,6,3,3
Мэлик,howling-fjord,288,shaman,enhancement,6,3,3
Magosh,blackmoore,288,shaman,enhancement,6,3,3
Yacuzwerg,blackrock,288,shaman,enhancement,6,3,3
Nerdshammyx,tarren-mill,288,shaman,enhancement,6,3,3
Kafese,uldaman,288,shaman,enhancement,6,3,3
Michi,dethecus,288,shaman,enhancement,6,3,3
Spamorions,rashgarroth,288,shaman,enhancement,6,3,3
Foxtér,burning-blade,288,shaman,enhancement,6,3,3
Akilzz,tarren-mill,288,shaman,enhancement,6,3,3
Saro,destromath,288,shaman,enhancement,6,3,3
Hyperbeazt,stormscale,288,shaman,enhancement,6,3,3
Happyfart,thrall,288,shaman,enhancement,9,3,6
Dastarus,archimonde,288,shaman,enhancement,12,3,9
Teldathree,archimonde,288,shaman,enhancement,12,3,9
Maino,archimonde,288,shaman,enhancement,12,3,9
Kappatotem,silvermoon,288,shaman,enhancement,12,3,9
Сторниер,howling-fjord,288,shaman,enhancement,12,3,9
Brunütansol,sylvanas,288,shaman,enhancement,12,3,9
Rharhahra,archimonde,288,shaman,enhancement,12,3,9
Areiyla,silvermoon,288,shaman,enhancement,12,3,9
Albedøo,ragnaros,288,shaman,enhancement,12,3,9
Avattar,twisting-nether,288,shaman,enhancement,12,3,9
Bonestompamc,blackmoore,288,shaman,enhancement,12,3,9
Schaufelkopf,blackrock,288,shaman,enhancement,12,3,9
Maybeyes,twisting-nether,288,shaman,enhancement,12,3,9
Titiprosop,stormscale,288,shaman,enhancement,12,3,9
Suaaktt,tyrande,288,shaman,enhancement,12,3,9
Bordellgast,thrall,288,shaman,enhancement,12,3,9
Æskalatiøn,aegwynn,288,shaman,enhancement,12,3,9
Kobzol,draenor,288,shaman,enhancement,12,3,9
Talgru,aegwynn,288,shaman,enhancement,12,3,9
Rãgnãr,frostwolf,288,shaman,enhancement,12,3,9
Lorthargol,chamber-of-aspects,288,shaman,enhancement,12,3,9
Egart,stormscale,288,shaman,enhancement,12,3,9
Orcazm,argent-dawn,288,shaman,enhancement,12,3,9
Garash,draenor,288,shaman,enhancement,12,3,9
Georgewhat,defias-brotherhood,288,shaman,enhancement,12,3,9
Bonesee,turalyon,288,shaman,enhancement,12,3,9
Akkix,antonidas,288,shaman,enhancement,12,3,9
Sturmfürsti,antonidas,288,shaman,enhancement,12,3,9
Thundrthighs,aggramar,288,shaman,enhancement,12,3,9
Enjoykenker,ravencrest,288,shaman,enhancement,12,3,9
Japom,ravencrest,288,shaman,enhancement,12,3,9
Ghortus,magtheridon,288,shaman,enhancement,12,3,9
Fünkchn,zuluhed,288,shaman,enhancement,12,3,9
Shambamty,thrall,288,shaman,enhancement,12,3,9
Shåmazïng,ravencrest,288,shaman,enhancement,12,3,9
Inkman,azjolnerub,288,shaman,enhancement,12,3,9
Satishamz,ravencrest,288,shaman,enhancement,12,3,9
Thundereater,blackmoore,288,shaman,enhancement,12,3,9
Morgenmuffel,die-aldor,287,shaman,enhancement,6,3,3
Nothìnto,pozzo-delleternità,287,shaman,enhancement,6,3,3
Стакок,soulflayer,287,shaman,enhancement,6,3,3
Trotzig,aegwynn,287,shaman,enhancement,6,3,3
Slappybag,ravencrest,287,shaman,enhancement,6,3,3
Casarú,arthas,287,shaman,enhancement,12,3,9
Heshamman,kazzak,256,shaman,enhancement,22,3,19
Krudir,pozzo-delleternità,255,shaman,enhancement,8,4,4
Rký,outland,240,shaman,enhancement,9,3,6
Kaátori,eredar,239,shaman,enhancement,5,3,2
Jehae,archimonde,239,shaman,enhancement,5,3,2
Smashellos,pozzo-delleternità,239,shaman,enhancement,5,3,2
Nefasti,stormscale,223,shaman,enhancement,8,3,5
Runfromme,kazzak,223,shaman,enhancement,8,3,5
Styxsm,blackhand,208,shaman,enhancement,7,3,4
Туркшаман,howling-fjord,192,shaman,enhancement,6,2,4
Cuchullaín,blackmoore,192,shaman,enhancement,6,2,4
Willfury,outland,192,shaman,enhancement,6,2,4
Volkar,auchindoun,192,shaman,enhancement,6,2,4
Thoráck,stormscale,192,shaman,enhancement,6,2,4
Fufupartyxx,blackrock,192,shaman,enhancement,6,2,4
Acces,stormscale,192,shaman,enhancement,6,2,4
Aubesombre,dalaran,192,shaman,enhancement,6,2,4
Palarins,dalaran,192,shaman,enhancement,6,2,4
Родохрозид,blackscar,192,shaman,enhancement,6,2,4
Türzumachen,outland,192,shaman,enhancement,6,2,4
Пончо,booty-bay,192,shaman,enhancement,6,2,4
Едрёна,blackscar,192,shaman,enhancement,6,2,4
Peaksh,stormscale,192,shaman,enhancement,6,2,4
Thunderstørm,chogall,192,shaman,enhancement,6,2,4
Dwarfpanda,ravencrest,192,shaman,enhancement,6,2,4
Shocknrun,sylvanas,192,shaman,enhancement,6,2,4
Dogfrog,silvermoon,192,shaman,enhancement,6,2,4
Bizsham,ravencrest,192,shaman,enhancement,6,2,4
Зултира,gordunni,192,shaman,enhancement,6,2,4
Gundsthunder,ravencrest,192,shaman,enhancement,6,2,4
Снюсн,blackscar,192,shaman,enhancement,6,2,4
Chodukken,grim-batol,192,shaman,enhancement,6,2,4
Tâw,blackhand,192,shaman,enhancement,6,2,4
Mahoni,malganis,192,shaman,enhancement,6,2,4
Ширудо,galakrond,192,shaman,enhancement,6,2,4
Бьерн,deepholm,192,shaman,enhancement,6,2,4
Oprawinfury,ravencrest,192,shaman,enhancement,6,2,4
Denastyo,nemesis,192,shaman,enhancement,6,2,4
Ольтез,gordunni,192,shaman,enhancement,6,2,4
Lazyspc,frostmane,192,shaman,enhancement,6,2,4
Nìtratx,archimonde,192,shaman,enhancement,6,2,4
Bladeyx,ragnaros,192,shaman,enhancement,6,2,4
Ðøminantx,stormscale,192,shaman,enhancement,6,2,4
Starik,ravencrest,192,shaman,enhancement,6,2,4
Кюгельблиц,gordunni,192,shaman,enhancement,6,2,4
Tokuyama,archimonde,192,shaman,enhancement,6,2,4
Эверви,gordunni,192,shaman,enhancement,6,2,4
Mív,outland,192,shaman,enhancement,6,2,4
Shamalamadi,ragnaros,192,shaman,enhancement,6,2,4
Elé,ravenholdt,192,shaman,enhancement,6,2,4
Giem,twisting-nether,192,shaman,enhancement,6,2,4
Трупелмен,soulflayer,192,shaman,enhancement,6,2,4
Какашисан,howling-fjord,192,shaman,enhancement,6,2,4
Wayoa,defias-brotherhood,192,shaman,enhancement,6,2,4
Xharnel,defias-brotherhood,192,shaman,enhancement,6,2,4
Kortoghissig,ravencrest,192,shaman,enhancement,6,2,4
Mycameltotem,ravencrest,192,shaman,enhancement,6,2,4
Rúnar,proudmoore,192,shaman,enhancement,6,2,4
Wurrzág,outland,192,shaman,enhancement,6,2,4
Shocknorris,auchindoun,192,shaman,enhancement,6,2,4
Iloveléa,ravencrest,192,shaman,enhancement,6,2,4
Magane,antonidas,192,shaman,enhancement,6,2,4
Wertu,ragnaros,192,shaman,enhancement,6,2,4
Zadarak,antonidas,192,shaman,enhancement,6,2,4
Zenjo,the-maelstrom,192,shaman,enhancement,6,2,4
Shamtime,aegwynn,192,shaman,enhancement,6,2,4
Пофасту,gordunni,192,shaman,enhancement,6,2,4
Argomir,kazzak,192,shaman,enhancement,6,2,4
Spoko,hyjal,192,shaman,enhancement,6,2,4
Azzizael,chamber-of-aspects,192,shaman,enhancement,6,2,4
Stiflersmôm,antonidas,192,shaman,enhancement,6,2,4
Yobanivrot,the-maelstrom,192,shaman,enhancement,6,2,4
Дортманшам,gordunni,192,shaman,enhancement,6,2,4
Tapatak,antonidas,192,shaman,enhancement,6,2,4
Pandafightin,stormscale,192,shaman,enhancement,6,2,4
Diya,karazhan,192,shaman,enhancement,6,2,4
Søló,stormscale,192,shaman,enhancement,6,2,4
Louvreparis,frostwolf,192,shaman,enhancement,6,2,4
Destroilleur,archimonde,192,shaman,enhancement,6,2,4
Pakasschami,frostwolf,192,shaman,enhancement,6,2,4
Thiogg,archimonde,192,shaman,enhancement,6,2,4
Haugren,eredar,192,shaman,enhancement,6,2,4
Schamitwo,twisting-nether,192,shaman,enhancement,6,2,4
Ogshaman,archimonde,192,shaman,enhancement,6,2,4
Museum,khaz-modan,192,shaman,enhancement,6,2,4
Shoar,twisting-nether,192,shaman,enhancement,6,2,4
Mmrpurge,twisting-nether,192,shaman,enhancement,6,2,4
Miscode,twisting-nether,192,shaman,enhancement,6,2,4
Poaeii,ysondre,192,shaman,enhancement,6,2,4
Gaerth,aggramar,192,shaman,enhancement,6,2,4
Kaptt,twisting-nether,192,shaman,enhancement,6,2,4
Donicork,aegwynn,192,shaman,enhancement,6,2,4
Yezu,medivh,192,shaman,enhancement,6,2,4
Cleptocracy,draenor,192,shaman,enhancement,6,2,4
Airfs,twisting-nether,192,shaman,enhancement,6,2,4
Vaalè,aegwynn,192,shaman,enhancement,6,2,4
Elementhor,archimonde,192,shaman,enhancement,6,2,4
Snapbábe,blackmoore,192,shaman,enhancement,6,2,4
Moropaskoil,ravencrest,192,shaman,enhancement,6,2,4
Santy,silvermoon,192,shaman,enhancement,6,2,4
Bennycooch,silvermoon,192,shaman,enhancement,6,2,4
Dalgorr,magtheridon,192,shaman,enhancement,6,2,4
Zulzur,zuljin,192,shaman,enhancement,6,2,4
Elementastic,xavius,192,shaman,enhancement,6,2,4
Miscoj,zuljin,192,shaman,enhancement,6,2,4
Turbinká,burning-legion,192,shaman,enhancement,6,2,4
Yajevol,draenor,192,shaman,enhancement,6,2,4
Peeupeeu,silvermoon,192,shaman,enhancement,6,2,4
Restmuell,blackmoore,192,shaman,enhancement,6,2,4
Shámyé,silvermoon,192,shaman,enhancement,6,2,4
Adrianjr,kazzak,192,shaman,enhancement,6,2,4
Totemeistér,silvermoon,192,shaman,enhancement,6,2,4
Tsukuyømi,blackmoore,192,shaman,enhancement,6,2,4
Törque,sanguino,192,shaman,enhancement,6,2,4
Dykumlol,sanguino,192,shaman,enhancement,6,2,4
Nicocage,draenor,192,shaman,enhancement,6,2,4
Kwitnac,silvermoon,192,shaman,enhancement,6,2,4
Pulvêrizêr,agamaggan,192,shaman,enhancement,6,2,4
Bonethugdex,bladefist,192,shaman,enhancement,6,2,4
Magicmekoz,draenor,192,shaman,enhancement,6,2,4
Soozkovic,blackmoore,192,shaman,enhancement,6,2,4
Shiggenbasta,kazzak,192,shaman,enhancement,6,2,4
Shinkd,draenor,192,shaman,enhancement,6,2,4
Savan,darkspear,192,shaman,enhancement,6,2,4
Zelenchovek,kazzak,192,shaman,enhancement,6,2,4
Athankatouch,draenor,192,shaman,enhancement,6,2,4
Bloodfist,drakthul,192,shaman,enhancement,6,2,4
Cptnbbl,blackmoore,192,shaman,enhancement,6,2,4
Lovros,kazzak,192,shaman,enhancement,6,2,4
Mailea,silvermoon,192,shaman,enhancement,6,2,4
Urshak,alleria,192,shaman,enhancement,6,2,4
Holybrolyy,malfurion,192,shaman,enhancement,6,2,4
Schamikraut,silvermoon,192,shaman,enhancement,6,2,4
Asijha,drakthul,192,shaman,enhancement,6,2,4
Clappagobzz,kazzak,192,shaman,enhancement,6,2,4
Spiritualx,argent-dawn,192,shaman,enhancement,6,2,4
Skullføck,argent-dawn,192,shaman,enhancement,6,2,4
Drekthor,ulduar,192,shaman,enhancement,6,2,4
Ironkin,tarren-mill,192,shaman,enhancement,6,2,4
Råkk,argent-dawn,192,shaman,enhancement,6,2,4
Hugzy,argent-dawn,192,shaman,enhancement,6,2,4
Stormcaster,argent-dawn,192,shaman,enhancement,6,2,4
Decoyy,tarren-mill,192,shaman,enhancement,6,2,4
Soeptent,tarren-mill,192,shaman,enhancement,6,2,4
Hamdoulaçava,archimonde,192,shaman,enhancement,7,2,5
Gnilley,blackrock,192,shaman,enhancement,8,2,6
Shamrøck,stormscale,192,shaman,enhancement,10,2,8
Zugzugdwarf,ravencrest,192,shaman,enhancement,11,2,9
Khakazis,ravencrest,192,shaman,enhancement,12,2,10
Elsassi,ravencrest,192,shaman,enhancement,12,2,10
Khon,eredar,192,shaman,enhancement,12,2,10
Veeq,ravencrest,192,shaman,enhancement,12,2,10
Kohzen,outland,192,shaman,enhancement,12,2,10
Lolphobia,ravencrest,192,shaman,enhancement,12,2,10
Shÿmä,dalaran,192,shaman,enhancement,12,2,10
Металорд,howling-fjord,192,shaman,enhancement,12,2,10
Xpv,silvermoon,192,shaman,enhancement,12,2,10
Dérgérät,blackrock,192,shaman,enhancement,12,2,10
Pwccey,drakthul,192,shaman,enhancement,12,2,10
Stormstriker,arathor,192,shaman,enhancement,12,2,10
Pachamane,archimonde,192,shaman,enhancement,12,2,10
Ххвхд,soulflayer,192,shaman,enhancement,12,2,10
Borindor,silvermoon,192,shaman,enhancement,12,2,10
Zarakuda,magtheridon,192,shaman,enhancement,12,2,10
Cudderisback,blackmoore,192,shaman,enhancement,18,2,16
Arkkain,burning-legion,191,shaman,enhancement,6,2,4
Granett,argent-dawn,191,shaman,enhancement,19,2,17
Jacklupin,ravencrest,175,shaman,enhancement,11,2,9
Entrecoté,blackmoore,160,shaman,enhancement,10,2,8
Hóonda,twisting-nether,160,shaman,enhancement,10,2,8
Pômmes,aegwynn,159,shaman,enhancement,5,2,3
Brryantblaks,colinas-pardas,138,shaman,enhancement,10,4,6
Shåmpoing,archimonde,138,shaman,enhancement,9,3,6
Trenbruv,kazzak,138,shaman,enhancement,9,3,6
Heliosz,stormscale,137,shaman,enhancement,8,3,5
Kraksham,ravencrest,128,shaman,enhancement,4,2,2
Anthrák,draenor,128,shaman,enhancement,4,2,2
Bux,khaz-modan,127,shaman,enhancement,10,2,8
Nephylim,grim-batol,96,shaman,enhancement,3,2,1
Skylá,blackrock,96,shaman,enhancement,6,1,5
Sgroppino,stormscale,96,shaman,enhancement,6,1,5
Ghaargrim,tarren-mill,96,shaman,enhancement,6,1,5
Shockmelone,blackrock,96,shaman,enhancement,6,1,5
Lamarrus,malganis,96,shaman,enhancement,6,1,5
Bigboisham,outland,96,shaman,enhancement,6,1,5
Maskinett,stormscale,96,shaman,enhancement,6,1,5
Hàgs,stormscale,96,shaman,enhancement,6,1,5
Xtremeshaman,blackmoore,96,shaman,enhancement,6,1,5
Zoélement,nerzhul,96,shaman,enhancement,6,1,5
Dens,argent-dawn,96,shaman,enhancement,6,1,5
Bambustic,kazzak,96,shaman,enhancement,6,1,5
Størmsky,outland,96,shaman,enhancement,6,1,5
Gschmack,blackrock,96,shaman,enhancement,6,1,5
Straehne,malganis,96,shaman,enhancement,6,1,5
Dartagnón,blackhand,96,shaman,enhancement,6,1,5
Überstorm,kazzak,96,shaman,enhancement,6,1,5
Amarök,nerzhul,96,shaman,enhancement,6,1,5
Takenq,stormscale,96,shaman,enhancement,6,1,5
Blitzgodx,kargath,96,shaman,enhancement,6,1,5
Trokag,hyjal,96,shaman,enhancement,6,1,5
Eneel,blackmoore,96,shaman,enhancement,6,1,5
Hí,bronzebeard,96,shaman,enhancement,6,1,5
Shaamz,tarren-mill,96,shaman,enhancement,6,1,5
Piptok,der-rat-von-dalaran,96,shaman,enhancement,6,1,5
Grabmytotemz,tarren-mill,96,shaman,enhancement,6,1,5
Epicoverlord,tarren-mill,96,shaman,enhancement,6,1,5
Spaceboy,archimonde,96,shaman,enhancement,6,1,5
Zoogang,ragnaros,96,shaman,enhancement,6,1,5
Akenoo,die-aldor,96,shaman,enhancement,6,1,5
Allfathêr,ragnaros,96,shaman,enhancement,6,1,5
Cryptotem,ragnaros,96,shaman,enhancement,6,1,5
Yolosweg,dentarg,96,shaman,enhancement,6,1,5
Carlpeant,drakthul,96,shaman,enhancement,6,1,5
Shockqt,todeswache,96,shaman,enhancement,6,1,5
Granz,archimonde,96,shaman,enhancement,6,1,5
Thachen,tarren-mill,96,shaman,enhancement,6,1,5
Yeah,emeriss,96,shaman,enhancement,6,1,5
Shaulic,ravencrest,96,shaman,enhancement,6,1,5
Vexuz,silvermoon,96,shaman,enhancement,6,1,5
Grimrieper,stormscale,96,shaman,enhancement,6,1,5
Hollster,moonglade,96,shaman,enhancement,6,1,5
Yrgus,hyjal,96,shaman,enhancement,6,1,5
Arethousa,silvermoon,96,shaman,enhancement,6,1,5
Gewieft,azshara,96,shaman,enhancement,6,1,5
Чаиро,howling-fjord,96,shaman,enhancement,6,1,5
Onii,alleria,96,shaman,enhancement,6,1,5
Hazles,ragnaros,96,shaman,enhancement,6,1,5
Woiz,ragnaros,96,shaman,enhancement,6,1,5
Sekane,archimonde,96,shaman,enhancement,6,1,5
Хексвглаз,howling-fjord,96,shaman,enhancement,6,1,5
Schmick,alleria,96,shaman,enhancement,6,1,5
Stonetone,silvermoon,96,shaman,enhancement,6,1,5
Ailsi,draenor,96,shaman,enhancement,6,1,5
Ragmir,kazzak,96,shaman,enhancement,6,1,5
Testpapi,twisting-nether,96,shaman,enhancement,6,1,5
Olibuzzyezz,outland,96,shaman,enhancement,6,1,5
Mikecrybaby,tarren-mill,96,shaman,enhancement,6,1,5
Stòrm,ravencrest,96,shaman,enhancement,6,1,5
Élémentyum,archimonde,96,shaman,enhancement,6,1,5
Linknvm,thrall,96,shaman,enhancement,6,1,5
Shámóó,twisting-nether,96,shaman,enhancement,6,1,5
Palpazerr,archimonde,96,shaman,enhancement,6,1,5
Sixinchwilly,outland,96,shaman,enhancement,6,1,5
Preshear,twisting-nether,96,shaman,enhancement,6,1,5
Shåmssagat,kazzak,96,shaman,enhancement,6,1,5
Jambie,bloodfeather,96,shaman,enhancement,6,1,5
Nas,the-maelstrom,96,shaman,enhancement,6,1,5
Драмкул,soulflayer,96,shaman,enhancement,6,1,5
Gotreck,zuljin,96,shaman,enhancement,6,1,5
Malabestia,archimonde,96,shaman,enhancement,6,1,5
Zarun,stormrage,96,shaman,enhancement,6,1,5
Laflur,draenor,96,shaman,enhancement,6,1,5
Criæ,blackrock,96,shaman,enhancement,6,1,5
Kónna,darksorrow,96,shaman,enhancement,6,1,5
Patateatotem,archimonde,96,shaman,enhancement,6,1,5
Thoranis,kazzak,96,shaman,enhancement,6,1,5
Goldhand,ravencrest,96,shaman,enhancement,6,1,5
Eisenfêind,antonidas,96,shaman,enhancement,6,1,5
Winiepuuh,antonidas,96,shaman,enhancement,6,1,5
Цукерок,soulflayer,96,shaman,enhancement,6,1,5
Urubus,kazzak,96,shaman,enhancement,6,1,5
Tosaá,antonidas,96,shaman,enhancement,6,1,5
Madarak,pozzo-delleternità,96,shaman,enhancement,6,1,5
Porthex,kazzak,96,shaman,enhancement,6,1,5
Lawdjeezes,draenor,96,shaman,enhancement,6,1,5
Vladraxes,draenor,96,shaman,enhancement,6,1,5
Eclïppce,archimonde,96,shaman,enhancement,6,1,5
Разодран,gordunni,96,shaman,enhancement,6,1,5
Mearu,bronze-dragonflight,96,shaman,enhancement,6,1,5
Nabo,archimonde,96,shaman,enhancement,6,1,5
Shøckz,azjolnerub,96,shaman,enhancement,6,1,5
Celeby,nemesis,96,shaman,enhancement,6,1,5
Харно,gordunni,96,shaman,enhancement,6,1,5
Ramuthra,sanguino,96,shaman,enhancement,6,1,5
Shamanistick,grim-batol,96,shaman,enhancement,6,1,5
Peneapunta,nemesis,96,shaman,enhancement,6,1,5
Импфаразел,gordunni,96,shaman,enhancement,6,1,5
Lampard,magtheridon,96,shaman,enhancement,6,1,5
Djznto,silvermoon,96,shaman,enhancement,8,1,7
Freexx,aegwynn,96,shaman,enhancement,8,1,7
Дваллинн,gordunni,96,shaman,enhancement,11,1,10
Эншам,blackscar,96,shaman,enhancement,12,1,11
Eliteblood,kazzak,96,shaman,enhancement,12,1,11
Sycophant,stormscale,96,shaman,enhancement,12,1,11
Sigmaz,twisting-nether,96,shaman,enhancement,12,1,11
Gamezclaw,aegwynn,96,shaman,enhancement,12,1,11
Jytkysonni,stormreaver,96,shaman,enhancement,12,1,11
Sÿfrôw,hyjal,96,shaman,enhancement,12,1,11
Хэллшам,howling-fjord,96,shaman,enhancement,12,1,11
Volgue,kaelthas,96,shaman,enhancement,12,1,11
Ymiras,argent-dawn,96,shaman,enhancement,12,1,11
Swípzy,ravencrest,79,shaman,enhancement,5,1,4
Choltaj,burning-legion,79,shaman,enhancement,7,1,6
Malizious,ravencrest,63,shaman,enhancement,2,2,0
Wenesday,ysondre,48,shaman,enhancement,3,1,2
Kuroisback,outland,48,shaman,enhancement,3,1,2
Daboo,the-venture-co,48,shaman,enhancement,3,1,2
Tholin,rexxar,48,shaman,enhancement,3,1,2
Карбонатрикс,soulflayer,48,shaman,enhancement,12,3,9
Адскийсон,gordunni,42,shaman,enhancement,9,2,7
Klât,archimonde,42,shaman,enhancement,11,2,9
Shøkxz,kazzak,31,shaman,enhancement,2,1,1
Bìgby,draenor,31,shaman,enhancement,2,1,1
Aleshade,argent-dawn,31,shaman,enhancement,2,1,1
Ulaene,ravencrest,31,shaman,enhancement,2,1,1
Qjx,blackrock,16,shaman,enhancement,1,1,0
Dotjürgen,blackrock,2349,warlock,demonology,152,86,66
Skillførçé,kazzak,2343,warlock,demonology,72,49,23
Aköyh,kazzak,2315,warlock,demonology,142,89,53
Voldby,kazzak,2292,warlock,demonology,87,49,38
Smaúg,archimonde,2249,warlock,demonology,283,148,135
Амеаль,eversong,2249,warlock,demonology,481,251,230
Pogbõss,kazzak,2229,warlock,demonology,310,160,150
Byeedriver,kazzak,2218,warlock,demonology,123,80,43
Easycheasy,ravencrest,2217,warlock,demonology,77,49,28
Whøknøws,twisting-nether,2215,warlock,demonology,90,48,42
Lankycheese,kazzak,2211,warlock,demonology,119,67,52
Rikkërt,draenor,2209,warlock,demonology,95,52,43
Kikeriki,blackhand,2200,warlock,demonology,110,58,52
Jimboneutron,stormscale,2198,warlock,demonology,65,36,29
Infý,ravencrest,2177,warlock,demonology,54,36,18
Cònq,tarren-mill,2175,warlock,demonology,90,50,40
Rumour,sunstrider,2175,warlock,demonology,96,50,46
Tuskawl,stormreaver,2173,warlock,demonology,97,55,42
Bualock,tarren-mill,2166,warlock,demonology,65,40,25
Locktrainer,tarren-mill,2165,warlock,demonology,385,195,190
Anúki,kazzak,2150,warlock,demonology,49,38,11
Thardik,azuremyst,2149,warlock,demonology,150,79,71
Jackyfalls,blackmoore,2148,warlock,demonology,144,84,60
Zezo,stormscale,2144,warlock,demonology,166,95,71
Tenshirou,blackrock,2141,warlock,demonology,83,49,34
Dispeluapls,blackmoore,2140,warlock,demonology,132,67,65
Droguri,darkspear,2139,warlock,demonology,185,111,74
Kimkold,twisting-nether,2136,warlock,demonology,210,115,95
Indrâxx,hyjal,2135,warlock,demonology,60,47,13
Nayolana,argent-dawn,2135,warlock,demonology,130,73,57
Sad,lightnings-blade,2134,warlock,demonology,184,100,84
Bibiflexberg,eredar,2133,warlock,demonology,65,39,26
Onlylock,outland,2132,warlock,demonology,114,64,50
Maintarget,blackrock,2130,warlock,demonology,171,91,80
Favorizlmp,archimonde,2123,warlock,demonology,107,74,33
Malowix,outland,2123,warlock,demonology,94,50,44
Setyouinfear,ravencrest,2122,warlock,demonology,112,64,48
Сильвиос,howling-fjord,2122,warlock,demonology,135,72,63
Blackdog,argent-dawn,2122,warlock,demonology,147,78,69
Wspolnax,ravencrest,2119,warlock,demonology,78,44,34
Neverfearjk,aegwynn,2117,warlock,demonology,86,56,30
Infïnitýx,silvermoon,2116,warlock,demonology,121,75,46
Syntaxzwo,blackmoore,2116,warlock,demonology,78,44,34
Dotyboi,tarren-mill,2115,warlock,demonology,72,44,28
Purplemonkey,burning-blade,2114,warlock,demonology,92,51,41
Sêrø,aegwynn,2113,warlock,demonology,82,43,39
Supergeîl,blackrock,2112,warlock,demonology,71,38,33
ßualock,sylvanas,2111,warlock,demonology,72,42,30
Xerkh,thrall,2111,warlock,demonology,78,43,35
Krøl,nemesis,2110,warlock,demonology,66,40,26
Smdtwo,drakthul,2109,warlock,demonology,142,75,67
Ägony,blackrock,2108,warlock,demonology,78,46,32
Dhärc,sanguino,2107,warlock,demonology,84,48,36
Ðåñtåy,ravencrest,2106,warlock,demonology,54,32,22
Фламмэнх,soulflayer,2106,warlock,demonology,84,46,38
Malddog,turalyon,2103,warlock,demonology,108,61,47
Syntax,blackmoore,2102,warlock,demonology,102,52,50
Shablagoo,twisting-nether,2099,warlock,demonology,138,77,61
Britneÿ,stormscale,2096,warlock,demonology,90,46,44
Alphazero,zuluhed,2095,warlock,demonology,90,45,45
Ogrez,nemesis,2095,warlock,demonology,131,65,66
Dæhli,argent-dawn,2092,warlock,demonology,150,77,73
Hannen,blackrock,2086,warlock,demonology,58,32,26
Viscius,ysondre,2077,warlock,demonology,54,30,24
Firochektro,ravencrest,2075,warlock,demonology,129,68,61
Anthh,doomhammer,2074,warlock,demonology,84,44,40
Alotami,frostwolf,2073,warlock,demonology,63,39,24
Capsloq,la-croisade-écarlate,2070,warlock,demonology,144,77,67
Boltimoore,magtheridon,2064,warlock,demonology,77,42,35
Mty,bronze-dragonflight,2056,warlock,demonology,147,81,66
Zehirisalari,twisting-nether,2055,warlock,demonology,114,63,51
Furrylóver,kazzak,2054,warlock,demonology,74,50,24
Firochek,ravencrest,2054,warlock,demonology,90,47,43
Makkez,outland,2052,warlock,demonology,72,46,26
Deadpapi,outland,2052,warlock,demonology,144,83,61
Хаосболик,gordunni,2035,warlock,demonology,96,52,44
Igõr,draenor,2031,warlock,demonology,42,26,16
Конидэмико,blackscar,2031,warlock,demonology,107,51,56
Synthiax,silvermoon,2027,warlock,demonology,120,65,55
Nyotu,antonidas,2021,warlock,demonology,84,41,43
Шекигами,gordunni,2019,warlock,demonology,66,42,24
Сумракк,gordunni,2017,warlock,demonology,69,38,31
Ишла,gordunni,2017,warlock,demonology,137,73,64
Raspalakuja,kazzak,2016,warlock,demonology,71,35,36
Ðïÿëñbïëñfüû,suramar,2014,warlock,demonology,147,75,72
Khavar,antonidas,2013,warlock,demonology,112,64,48
Slockoló,ragnaros,2011,warlock,demonology,96,44,52
Osbaa,bladefist,2009,warlock,demonology,83,42,41
Wârlðck,twisting-nether,2004,warlock,demonology,78,49,29
Désolaté,kazzak,2004,warlock,demonology,59,36,23
Fløkee,blackmoore,2001,warlock,demonology,42,24,18
Арон,soulflayer,2000,warlock,demonology,71,38,33
Ffpiiras,dunemaul,1999,warlock,demonology,131,67,64
Glooness,burning-legion,1998,warlock,demonology,129,64,65
Tyrantlol,sylvanas,1991,warlock,demonology,78,43,35
Zoreck,uldum,1987,warlock,demonology,71,38,33
Млечный,blackscar,1986,warlock,demonology,405,204,201
Vreeth,blackrock,1984,warlock,demonology,78,40,38
Djmäkish,outland,1983,warlock,demonology,60,31,29
Jawoxoxo,rexxar,1983,warlock,demonology,78,38,40
Dharc,dun-modr,1980,warlock,demonology,42,30,12
Ezy,auchindoun,1979,warlock,demonology,94,52,42
Stankaemayne,blackhand,1977,warlock,demonology,67,38,29
Badapow,stormscale,1971,warlock,demonology,54,29,25
Gattlingan,eredar,1970,warlock,demonology,72,47,25
Адво,howling-fjord,1969,warlock,demonology,77,40,37
Rïñ,ravencrest,1968,warlock,demonology,60,28,32
Аоепампгодх,howling-fjord,1967,warlock,demonology,36,24,12
Помечте,soulflayer,1967,warlock,demonology,142,74,68
Онлидемо,gordunni,1965,warlock,demonology,60,39,21
Xtyran,blackmoore,1964,warlock,demonology,78,44,34
Louên,dun-modr,1963,warlock,demonology,78,37,41
Cørpse,burning-legion,1958,warlock,demonology,136,72,64
Rmpfarmer,kazzak,1957,warlock,demonology,30,24,6
Jesez,aegwynn,1950,warlock,demonology,72,39,33
Онлидемон,gordunni,1946,warlock,demonology,56,33,23
Lagynka,wildhammer,1940,warlock,demonology,42,25,17
Crathar,kazzak,1939,warlock,demonology,132,70,62
Yamadea,stormscale,1939,warlock,demonology,84,43,41
Bonnieparkêr,onyxia,1938,warlock,demonology,54,28,26
Synlockiax,silvermoon,1933,warlock,demonology,110,73,37
Xenastro,silvermoon,1932,warlock,demonology,72,39,33
Apple,scarshield-legion,1930,warlock,demonology,133,69,64
Gv,ragnaros,1928,warlock,demonology,54,28,26
Cuteyess,shadowsong,1926,warlock,demonology,72,38,34
Nickrosh,terokkar,1924,warlock,demonology,51,31,20
Lokmonji,perenolde,1923,warlock,demonology,60,34,26
Kopfkissen,azshara,1921,warlock,demonology,99,50,49
Skailzlock,hyjal,1920,warlock,demonology,130,82,48
Zerulian,ragnaros,1920,warlock,demonology,90,50,40
Vultzbolt,draenor,1920,warlock,demonology,66,36,30
Инфезиус,deathweaver,1917,warlock,demonology,106,58,48
Dabezdwl,outland,1915,warlock,demonology,138,73,65
Dontargetme,draenor,1913,warlock,demonology,74,43,31
Neinbosa,tarren-mill,1913,warlock,demonology,132,67,65
Delius,eitrigg,1912,warlock,demonology,113,72,41
Kamorilock,blackhand,1912,warlock,demonology,36,20,16
Мутгодх,soulflayer,1910,warlock,demonology,42,26,16
Demoner,tarren-mill,1910,warlock,demonology,108,52,56
Zila,sylvanas,1910,warlock,demonology,66,31,35
Bfaexpert,ravencrest,1908,warlock,demonology,36,26,10
Shadowvirus,auchindoun,1908,warlock,demonology,41,23,18
Lyndi,nerathor,1906,warlock,demonology,60,32,28
Kuloo,blackmoore,1904,warlock,demonology,60,36,24
Døwz,ysondre,1904,warlock,demonology,66,32,34
Sanguinis,theradras,1903,warlock,demonology,170,93,77
Stafar,kazzak,1903,warlock,demonology,132,65,67
Простохаос,howling-fjord,1899,warlock,demonology,62,37,25
Envizer,ravencrest,1898,warlock,demonology,36,25,11
Osbaa,ravencrest,1895,warlock,demonology,48,28,20
Myliege,kilrogg,1895,warlock,demonology,130,70,60
Ambitions,hyjal,1895,warlock,demonology,222,112,110
Nerfhunter,executus,1895,warlock,demonology,54,27,27
Kazzy,grim-batol,1893,warlock,demonology,48,33,15
Noobgg,kazzak,1893,warlock,demonology,142,74,68
Nunhesh,defias-brotherhood,1892,warlock,demonology,77,40,37
Shadowflamez,argent-dawn,1891,warlock,demonology,42,33,9
Kimjongnukes,archimonde,1889,warlock,demonology,47,31,16
Оброссыш,gordunni,1880,warlock,demonology,84,47,37
Vankraken,silvermoon,1880,warlock,demonology,36,20,16
Тьмазвёздная,gordunni,1878,warlock,demonology,134,70,64
Годнодх,gordunni,1878,warlock,demonology,89,45,44
Hannens,blackrock,1877,warlock,demonology,58,32,26
Absurdity,twisting-nether,1875,warlock,demonology,64,35,29
Cigänä,archimonde,1875,warlock,demonology,48,22,26
Císuh,stormreaver,1873,warlock,demonology,86,44,42
Stafar,outland,1870,warlock,demonology,60,37,23
Keybump,outland,1870,warlock,demonology,114,68,46
Britneý,stormscale,1870,warlock,demonology,184,86,98
Glavy,burning-legion,1868,warlock,demonology,143,81,62
Тёмабиль,gordunni,1868,warlock,demonology,378,199,179
Weso,grim-batol,1868,warlock,demonology,72,36,36
Zouglougou,archimonde,1864,warlock,demonology,108,52,56
Bluh,twisting-nether,1860,warlock,demonology,36,22,14
Juicybolt,chogall,1860,warlock,demonology,94,50,44
Æßçåløønå,ravencrest,1857,warlock,demonology,48,25,23
Yôi,nemesis,1856,warlock,demonology,54,34,20
Lywov,stormscale,1856,warlock,demonology,47,24,23
Hupet,ragnaros,1855,warlock,demonology,30,21,9
Positivitywl,stormscale,1855,warlock,demonology,66,43,23
Blakstorm,archimonde,1855,warlock,demonology,48,31,17
Nêverse,archimonde,1855,warlock,demonology,40,24,16
Smíkz,blackhand,1852,warlock,demonology,48,29,19
Oniarc,ravencrest,1851,warlock,demonology,30,20,10
Cappaoww,ravencrest,1849,warlock,demonology,36,26,10
Stalowwy,silvermoon,1849,warlock,demonology,108,59,49
Jopasiski,draenor,1848,warlock,demonology,54,28,26
Shakuroz,frostwolf,1847,warlock,demonology,68,41,27
Динодотз,howling-fjord,1847,warlock,demonology,54,27,27
Gryme,dalaran,1846,warlock,demonology,81,51,30
Painowgee,kazzak,1846,warlock,demonology,42,22,20
Пухи,blackscar,1846,warlock,demonology,121,59,62
Greeylock,blackhand,1844,warlock,demonology,60,38,22
Bunne,twisting-nether,1843,warlock,demonology,96,50,46
Blacklock,argent-dawn,1841,warlock,demonology,96,51,45
Дьяволзаплач,howling-fjord,1841,warlock,demonology,102,51,51
Ravendoor,grim-batol,1841,warlock,demonology,124,61,63
Wildimp,turalyon,1840,warlock,demonology,150,84,66
Кварий,howling-fjord,1840,warlock,demonology,485,243,242
Zzooxx,silvermoon,1838,warlock,demonology,48,26,22
Attritiona,stormscale,1838,warlock,demonology,60,32,28
Commas,outland,1838,warlock,demonology,94,46,48
Oldasianman,blackrock,1835,warlock,demonology,42,26,16
Dslap,grim-batol,1835,warlock,demonology,42,23,19
Höfmänn,kazzak,1834,warlock,demonology,45,27,18
Purplereîgn,stormscale,1834,warlock,demonology,57,31,26
Dracsu,dun-modr,1832,warlock,demonology,134,78,56
Broxihwa,blackmoore,1832,warlock,demonology,229,127,102
Анрали,soulflayer,1832,warlock,demonology,59,31,28
Bibilockbert,aegwynn,1832,warlock,demonology,61,31,30
Veganlifter,ravencrest,1831,warlock,demonology,30,23,7
Froschhaxen,blackhand,1831,warlock,demonology,71,44,27
Kolskegg,doomhammer,1830,warlock,demonology,144,78,66
Jegfaller,wildhammer,1830,warlock,demonology,154,75,79
Icq,ravencrest,1829,warlock,demonology,77,46,31
Xalé,blackrock,1828,warlock,demonology,48,27,21
Svnlpowpow,kazzak,1828,warlock,demonology,71,37,34
Cujo,draenor,1828,warlock,demonology,68,31,37
Emitter,ravencrest,1827,warlock,demonology,36,27,9
Tamaduitoru,dragonblight,1827,warlock,demonology,78,51,27
Tyranttayyip,blackmoore,1826,warlock,demonology,42,25,17
Ravenglass,argent-dawn,1826,warlock,demonology,72,34,38
Benne,stormscale,1825,warlock,demonology,49,31,18
Lashyra,aszune,1825,warlock,demonology,66,40,26
Котрх,gordunni,1824,warlock,demonology,110,66,44
Malificus,silvermoon,1823,warlock,demonology,114,67,47
Rikkért,draenor,1823,warlock,demonology,54,29,25
Règis,antonidas,1823,warlock,demonology,84,45,39
Tiendi,blackhand,1823,warlock,demonology,114,60,54
Azerybedge,alexstrasza,1821,warlock,demonology,171,96,75
Épidémie,outland,1821,warlock,demonology,89,45,44
Этожедру,howling-fjord,1820,warlock,demonology,59,41,18
Kennyfõx,ysondre,1819,warlock,demonology,24,19,5
Ismenia,silvermoon,1819,warlock,demonology,60,39,21
Höfmänn,grim-batol,1819,warlock,demonology,54,33,21
Cellfear,kazzak,1818,warlock,demonology,42,24,18
Musallat,argent-dawn,1818,warlock,demonology,65,34,31
Dalamon,draenor,1818,warlock,demonology,60,31,29
Drogoon,blackmoore,1817,warlock,demonology,45,28,17
Fiveyearque,sylvanas,1817,warlock,demonology,54,33,21
Exorbïtant,blackrock,1817,warlock,demonology,235,122,113
Capsloq,sargeras,1817,warlock,demonology,57,28,29
Олимта,blackscar,1816,warlock,demonology,48,32,16
Warth,silvermoon,1816,warlock,demonology,42,28,14
Áutísm,silvermoon,1815,warlock,demonology,174,104,70
Devilfluffy,blackhand,1815,warlock,demonology,59,35,24
Афинц,deathguard,1814,warlock,demonology,30,19,11
Darkbasilet,hyjal,1814,warlock,demonology,53,31,22
Scaevóla,ravencrest,1814,warlock,demonology,469,247,222
Malzeva,ravencrest,1813,warlock,demonology,71,33,38
Spookytouch,draenor,1812,warlock,demonology,24,19,5
Тумнуктхай,gordunni,1812,warlock,demonology,42,24,18
Zàk,twisting-nether,1812,warlock,demonology,96,54,42
Ceu,tarren-mill,1812,warlock,demonology,70,39,31
Insídíous,tarren-mill,1812,warlock,demonology,78,41,37
Mustasheen,stormscale,1812,warlock,demonology,42,22,20
Gigoberto,kazzak,1811,warlock,demonology,57,31,26
Zatella,ravencrest,1811,warlock,demonology,188,100,88
Icò,ravencrest,1811,warlock,demonology,54,28,26
Zypzanti,antonidas,1810,warlock,demonology,155,97,58
Aladèèn,tarren-mill,1810,warlock,demonology,68,40,28
Kënnyfõx,ysondre,1809,warlock,demonology,24,19,5
Rektube,sanguino,1809,warlock,demonology,37,24,13
Tagzi,ravencrest,1809,warlock,demonology,47,29,18
Zzooxxie,silvermoon,1809,warlock,demonology,60,29,31
Selur,ragnaros,1808,warlock,demonology,69,43,26
Gazdruul,culte-de-la-rive-noire,1808,warlock,demonology,78,48,30
Nürgle,stormscale,1808,warlock,demonology,90,53,37
Darkenlock,burning-legion,1808,warlock,demonology,150,81,69
Skrana,kazzak,1808,warlock,demonology,83,43,40
Ðrrøßøticus,la-croisade-écarlate,1807,warlock,demonology,28,20,8
Smâûhg,blackrock,1807,warlock,demonology,42,28,14
Thugsupreme,ravencrest,1807,warlock,demonology,91,49,42
Superlocken,ragnaros,1807,warlock,demonology,42,22,20
Lúcìfér,stormscale,1806,warlock,demonology,66,34,32
Нэкрил,howling-fjord,1805,warlock,demonology,71,45,26
Фэлмор,howling-fjord,1805,warlock,demonology,54,33,21
Menescurse,blackhand,1805,warlock,demonology,46,27,19
Fearrari,ragnaros,1805,warlock,demonology,126,66,60
Nerigo,senjin,1805,warlock,demonology,48,24,24
Филоняша,gordunni,1804,warlock,demonology,90,57,33
Nemwl,draenor,1804,warlock,demonology,66,36,30
Dontvori,outland,1803,warlock,demonology,42,28,14
Splicer,eredar,1803,warlock,demonology,49,29,20
Elnïa,conseil-des-ombres,1803,warlock,demonology,39,21,18
Дёмын,howling-fjord,1803,warlock,demonology,192,91,101
Addox,destromath,1802,warlock,demonology,47,30,17
Ryks,terrordar,1802,warlock,demonology,97,51,46
Нгага,howling-fjord,1802,warlock,demonology,465,241,224
Arkanyks,dalaran,1802,warlock,demonology,72,32,40
Nastychãtøn,ysondre,1801,warlock,demonology,45,26,19
Dabeastysx,sanguino,1800,warlock,demonology,42,28,14
Кайзершлафен,fordragon,1800,warlock,demonology,58,28,30
Xartul,tarren-mill,1799,warlock,demonology,24,20,4
Htaedfo,tarren-mill,1798,warlock,demonology,110,50,60
Algolagniac,stormscale,1797,warlock,demonology,48,32,16
Fîgøk,conseil-des-ombres,1794,warlock,demonology,60,29,31
Officialysx,dun-modr,1792,warlock,demonology,30,19,11
Lïñglïñg,twisting-nether,1791,warlock,demonology,36,25,11
Варикай,gordunni,1791,warlock,demonology,98,57,41
Äåäåäåäåäåäå,ravencrest,1789,warlock,demonology,47,26,21
Mld,draenor,1786,warlock,demonology,55,39,16
Dâedra,argent-dawn,1786,warlock,demonology,107,57,50
Voídzero,hyjal,1786,warlock,demonology,55,29,26
Тевон,gordunni,1785,warlock,demonology,54,29,25
Izhi,ragnaros,1784,warlock,demonology,126,71,55
Hexdrix,thrall,1784,warlock,demonology,81,40,41
Koldarr,blackmoore,1781,warlock,demonology,186,93,93
Proßlock,kazzak,1780,warlock,demonology,123,73,50
Moslock,kazzak,1777,warlock,demonology,53,37,16
Outofcurses,earthen-ring,1776,warlock,demonology,89,43,46
Gödisdëäd,sanguino,1770,warlock,demonology,41,20,21
Makemeabrew,stormscale,1768,warlock,demonology,174,99,75
Axapnon,ragnaros,1767,warlock,demonology,48,23,25
Darksoll,hyjal,1763,warlock,demonology,42,23,19
Nâzgrel,tarren-mill,1763,warlock,demonology,138,70,68
Lockned,outland,1761,warlock,demonology,48,30,18
Kåtøñgøkákýû,aegwynn,1760,warlock,demonology,29,21,8
Evalya,archimonde,1760,warlock,demonology,42,24,18
Grimmwald,stormreaver,1759,warlock,demonology,100,49,51
Киёкка,howling-fjord,1757,warlock,demonology,96,54,42
Артисона,gordunni,1757,warlock,demonology,56,30,26
Omnípotens,silvermoon,1755,warlock,demonology,60,33,27
Санявахтовик,blackscar,1755,warlock,demonology,78,39,39
Fedpikkefar,kazzak,1755,warlock,demonology,67,27,40
Cresen,tarren-mill,1754,warlock,demonology,42,22,20
Catchlock,tarren-mill,1752,warlock,demonology,36,20,16
Interceptêr,blackrock,1750,warlock,demonology,60,32,28
Immaginare,sylvanas,1747,warlock,demonology,141,66,75
Zelieknight,ysondre,1741,warlock,demonology,66,32,34
Decayez,thrall,1739,warlock,demonology,31,19,12
Lockimon,silvermoon,1737,warlock,demonology,33,22,11
Thorolock,blackhand,1736,warlock,demonology,42,26,16
Guetta,dalaran,1735,warlock,demonology,54,40,14
Kennÿfõx,ysondre,1732,warlock,demonology,24,19,5
Adafbhf,tichondrius,1731,warlock,demonology,71,36,35
Tjockoloco,tarren-mill,1730,warlock,demonology,203,110,93
Alphalock,mannoroth,1727,warlock,demonology,84,40,44
Kemel,thrall,1725,warlock,demonology,36,26,10
Koisk,tarren-mill,1724,warlock,demonology,30,18,12
Jinusek,burning-legion,1724,warlock,demonology,49,25,24
Snackstickz,twisting-nether,1723,warlock,demonology,102,59,43
Idezis,ragnaros,1722,warlock,demonology,36,24,12
Delru,aegwynn,1721,warlock,demonology,36,18,18
Iskieel,ravencrest,1720,warlock,demonology,62,36,26
Dadcrush,antonidas,1720,warlock,demonology,84,42,42
Souleaterx,ravencrest,1719,warlock,demonology,54,26,28
Ðeface,nefarian,1717,warlock,demonology,36,23,13
Chromagnus,drakthul,1713,warlock,demonology,48,24,24
Impaler,tarren-mill,1711,warlock,demonology,305,151,154
Quadraxer,antonidas,1711,warlock,demonology,48,23,25
Fsandtwo,ravencrest,1711,warlock,demonology,54,24,30
Soupamine,ysondre,1710,warlock,demonology,60,27,33
Omegazero,zuluhed,1709,warlock,demonology,30,18,12
Despépêche,garona,1709,warlock,demonology,42,24,18
Circe,draenor,1709,warlock,demonology,36,18,18
Хитбэйн,soulflayer,1709,warlock,demonology,93,41,52
Lockxdxd,burning-legion,1708,warlock,demonology,64,43,21
Deaddydoo,kazzak,1708,warlock,demonology,60,27,33
Зажиженный,soulflayer,1707,warlock,demonology,40,26,14
Totephia,kazzak,1707,warlock,demonology,132,63,69
Ahkan,argent-dawn,1705,warlock,demonology,74,33,41
Sokyra,tarren-mill,1700,warlock,demonology,165,84,81
Æternallock,nemesis,1699,warlock,demonology,146,88,58
Парачо,eversong,1699,warlock,demonology,42,21,21
Drerlord,tarren-mill,1699,warlock,demonology,48,21,27
Stormiq,kazzak,1698,warlock,demonology,155,76,79
Rune,aegwynn,1695,warlock,demonology,52,29,23
Hltbárgrïèfx,tarren-mill,1695,warlock,demonology,90,50,40
Requeims,outland,1691,warlock,demonology,54,25,29
Бриант,gordunni,1689,warlock,demonology,47,19,28
Nécron,ysondre,1686,warlock,demonology,147,71,76
Dualla,aegwynn,1686,warlock,demonology,42,20,22
Jkz,blackrock,1685,warlock,demonology,41,23,18
Moffguldan,sanguino,1685,warlock,demonology,95,48,47
Eluinees,silvermoon,1684,warlock,demonology,36,25,11
Kûraiko,blackrock,1684,warlock,demonology,36,21,15
Shortyi,thrall,1684,warlock,demonology,47,23,24
Pipoûc,archimonde,1682,warlock,demonology,42,23,19
Æyna,thrall,1681,warlock,demonology,30,18,12
Hellbboy,azjolnerub,1681,warlock,demonology,103,60,43
Endherkonk,sanguino,1681,warlock,demonology,105,57,48
Grêenbull,eredar,1680,warlock,demonology,49,27,22
Mythoman,ravencrest,1679,warlock,demonology,60,34,26
Murua,silvermoon,1678,warlock,demonology,86,42,44
Love,alexstrasza,1677,warlock,demonology,45,27,18
Følkman,twisting-nether,1677,warlock,demonology,48,24,24
Жериновсский,gordunni,1677,warlock,demonology,36,18,18
Ahollic,frostwolf,1676,warlock,demonology,36,22,14
Kenthal,nemesis,1676,warlock,demonology,30,18,12
Golborg,draenor,1676,warlock,demonology,105,50,55
Шимара,eversong,1675,warlock,demonology,33,23,10
Ромаколдун,howling-fjord,1674,warlock,demonology,64,35,29
Srhal,blackmoore,1672,warlock,demonology,168,96,72
Dimmybyrger,stormreaver,1672,warlock,demonology,36,19,17
Nedivh,stormscale,1672,warlock,demonology,53,23,30
Bloodlock,onyxia,1670,warlock,demonology,42,22,20
Flocca,archimonde,1670,warlock,demonology,104,51,53
Incesticide,ragnaros,1669,warlock,demonology,35,23,12
Фортэр,ashenvale,1668,warlock,demonology,96,48,48
Nàughty,ragnaros,1665,warlock,demonology,120,60,60
Шэдоубёрн,soulflayer,1664,warlock,demonology,155,88,67
Sourpatchkid,the-maelstrom,1664,warlock,demonology,47,22,25
Agathaharkne,minahonda,1660,warlock,demonology,54,31,23
Kerídiin,twisting-nether,1660,warlock,demonology,46,25,21
Lockmex,outland,1658,warlock,demonology,42,26,16
Demonjoker,blackhand,1658,warlock,demonology,159,87,72
Mayden,uldum,1657,warlock,demonology,28,18,10
Nattû,outland,1656,warlock,demonology,36,20,16
Нистл,gordunni,1656,warlock,demonology,36,20,16
Darkdagor,blackrock,1656,warlock,demonology,55,30,25
Нафлэпил,gordunni,1655,warlock,demonology,54,31,23
Гурджес,soulflayer,1655,warlock,demonology,98,52,46
Кингпинг,soulflayer,1655,warlock,demonology,47,22,25
Shugglock,draenor,1654,warlock,demonology,48,26,22
Niyyu,blackmoore,1654,warlock,demonology,48,22,26
Béastmodex,eredar,1652,warlock,demonology,48,30,18
Сладкийпир,soulflayer,1652,warlock,demonology,108,63,45
Dull,ravencrest,1652,warlock,demonology,48,26,22
Gillgarres,twisting-nether,1651,warlock,demonology,53,31,22
Kerthan,malorne,1650,warlock,demonology,67,42,25
Mjor,twisting-nether,1650,warlock,demonology,30,18,12
Itstrippy,tarren-mill,1650,warlock,demonology,78,43,35
Wotlkenjoyer,ravencrest,1649,warlock,demonology,24,21,3
Erøne,archimonde,1649,warlock,demonology,321,166,155
Ponçeur,ysondre,1648,warlock,demonology,43,25,18
Hellguards,silvermoon,1648,warlock,demonology,90,42,48
Mendozaah,kazzak,1647,warlock,demonology,326,161,165
Youseenbolt,ravencrest,1647,warlock,demonology,45,22,23
Utsus,tarren-mill,1645,warlock,demonology,36,23,13
Cthxil,frostwolf,1645,warlock,demonology,93,46,47
Smadrekas,ravencrest,1644,warlock,demonology,36,22,14
Fandirxd,draenor,1643,warlock,demonology,126,59,67
Amited,drakthul,1641,warlock,demonology,42,25,17
Zezca,draenor,1640,warlock,demonology,76,39,37
Sedryn,turalyon,1637,warlock,demonology,1324,673,651
Tiffyilock,blackrock,1637,warlock,demonology,42,20,22
Scottware,draenor,1635,warlock,demonology,38,23,15
Kivuntuska,hyjal,1635,warlock,demonology,36,19,17
Darcîa,destromath,1635,warlock,demonology,247,129,118
Malumbra,argent-dawn,1635,warlock,demonology,57,27,30
Sörlewiis,the-maelstrom,1632,warlock,demonology,58,36,22
Nerzhull,stormscale,1632,warlock,demonology,123,66,57
Streganni,nemesis,1631,warlock,demonology,72,43,29
Felgødx,nemesis,1630,warlock,demonology,24,17,7
Tekron,blackhand,1629,warlock,demonology,57,37,20
Letzterlude,thrall,1629,warlock,demonology,53,25,28
Лвнг,gordunni,1628,warlock,demonology,48,29,19
Naarnust,defias-brotherhood,1628,warlock,demonology,66,35,31
Fearmydear,alleria,1628,warlock,demonology,41,21,20
Кьютсанни,howling-fjord,1628,warlock,demonology,36,17,19
Анрали,deathguard,1627,warlock,demonology,30,17,13
Мешшугга,howling-fjord,1627,warlock,demonology,44,21,23
Xiraq,nathrezim,1627,warlock,demonology,36,17,19
Neuth,draenor,1627,warlock,demonology,56,24,32
Evalin,aggra-português,1626,warlock,demonology,113,69,44
Kody,blackmoore,1625,warlock,demonology,30,18,12
Thorky,blackrock,1625,warlock,demonology,48,22,26
Erkai,kazzak,1624,warlock,demonology,45,24,21
Agâshh,blackrock,1623,warlock,demonology,97,54,43
Dasda,defias-brotherhood,1623,warlock,demonology,89,49,40
Docderlock,thrall,1623,warlock,demonology,45,23,22
Felsturm,twisting-nether,1622,warlock,demonology,58,40,18
Элси,howling-fjord,1622,warlock,demonology,30,17,13
Nachtreich,thrall,1622,warlock,demonology,30,17,13
Warlockyo,blackrock,1622,warlock,demonology,41,18,23
Храбзар,gordunni,1621,warlock,demonology,136,65,71
Xanatas,nemesis,1620,warlock,demonology,54,31,23
Ez,emeriss,1618,warlock,demonology,30,17,13
Yumiblood,tarren-mill,1618,warlock,demonology,71,38,33
Kawapow,azjolnerub,1615,warlock,demonology,88,56,32
Расмурът,soulflayer,1614,warlock,demonology,115,69,46
Xjms,darksorrow,1614,warlock,demonology,42,22,20
Lichlolock,outland,1612,warlock,demonology,72,34,38
Eroszakolock,ragnaros,1611,warlock,demonology,24,17,7
Solidwarlock,archimonde,1611,warlock,demonology,60,37,23
Tamatóax,tarren-mill,1611,warlock,demonology,104,53,51
Zéphon,blades-edge,1610,warlock,demonology,48,29,19
Dirtytyrant,sanguino,1610,warlock,demonology,30,17,13
Seldonn,pozzo-delleternità,1609,warlock,demonology,30,17,13
Môrgán,draenor,1609,warlock,demonology,234,117,117
Джердхаус,fordragon,1608,warlock,demonology,48,23,25
Azraëlle,drekthar,1606,warlock,demonology,33,20,13
Lottopallo,arathor,1606,warlock,demonology,139,84,55
Shuggul,draenor,1606,warlock,demonology,37,22,15
Lockaria,zuljin,1606,warlock,demonology,93,53,40
Demosteaks,thrall,1606,warlock,demonology,42,22,20
Nainbusdemil,dalaran,1606,warlock,demonology,48,25,23
Nerdbane,blackrock,1605,warlock,demonology,36,20,16
Hubba,earthen-ring,1604,warlock,demonology,68,39,29
Емс,gordunni,1604,warlock,demonology,63,34,29
Summonit,blackmoore,1604,warlock,demonology,108,56,52
Dzodeep,kazzak,1603,warlock,demonology,42,25,17
Havexis,tichondrius,1602,warlock,demonology,42,32,10
Shadôrí,antonidas,1602,warlock,demonology,60,36,24
Avrilla,khaz-modan,1602,warlock,demonology,36,21,15
Hasselbalch,azshara,1602,warlock,demonology,40,20,20
Fixwarlock,blackmoore,1601,warlock,demonology,30,19,11
Prekt,ragnaros,1601,warlock,demonology,36,19,17
Sethtarr,draenor,1600,warlock,demonology,56,31,25
Vêzor,twisting-nether,1600,warlock,demonology,76,36,40
Mindzsonghó,ragnaros,1599,warlock,demonology,36,21,15
Djshyasiañ,perenolde,1599,warlock,demonology,176,90,86
Егосяхаос,soulflayer,1597,warlock,demonology,280,141,139
Гвоздяшка,blackscar,1597,warlock,demonology,47,22,25
Bigbagelbob,archimonde,1596,warlock,demonology,36,19,17
Дрын,gordunni,1594,warlock,demonology,36,21,15
Thralka,burning-legion,1593,warlock,demonology,138,73,65
Azthral,nemesis,1590,warlock,demonology,266,135,131
Deamonsmith,silvermoon,1589,warlock,demonology,70,40,30
Repah,doomhammer,1587,warlock,demonology,66,34,32
Eltharis,burning-legion,1584,warlock,demonology,41,21,20
Potatowl,ravencrest,1582,warlock,demonology,36,18,18
Майдум,soulflayer,1582,warlock,demonology,47,23,24
Killua,kazzak,1581,warlock,demonology,47,24,23
Malkoran,sylvanas,1581,warlock,demonology,36,18,18
Stormytrumpy,twisting-nether,1580,warlock,demonology,39,21,18
Kosoki,burning-legion,1580,warlock,demonology,48,21,27
Мамхаус,howling-fjord,1579,warlock,demonology,36,22,14
Beloezoloto,deathwing,1578,warlock,demonology,66,33,33
Gulzot,turalyon,1575,warlock,demonology,48,31,17
Bonemetz,blackmoore,1575,warlock,demonology,64,38,26
Peremi,grim-batol,1575,warlock,demonology,42,23,19
Demicore,stormreaver,1575,warlock,demonology,66,26,40
Trollgubbe,twilights-hammer,1573,warlock,demonology,30,19,11
Topmodelx,eredar,1572,warlock,demonology,30,17,13
Warlockoloco,blackmoore,1572,warlock,demonology,36,20,16
Skitless,blackmoore,1571,warlock,demonology,57,30,27
Dayan,stormreaver,1570,warlock,demonology,94,52,42
Ájszmen,ravencrest,1569,warlock,demonology,161,82,79
Ароматныйх,howling-fjord,1569,warlock,demonology,42,20,22
Nekrosd,tarren-mill,1569,warlock,demonology,39,18,21
Endixujo,sanguino,1568,warlock,demonology,104,64,40
Ayóó,doomhammer,1568,warlock,demonology,711,363,348
Pørtalslave,ravencrest,1568,warlock,demonology,49,24,25
Демоник,deathguard,1567,warlock,demonology,36,18,18
Itrix,aegwynn,1565,warlock,demonology,36,18,18
Larina,neptulon,1564,warlock,demonology,41,24,17
Silenozz,ragnaros,1564,warlock,demonology,91,49,42
Nagash,zuljin,1563,warlock,demonology,41,29,12
Gemors,ravenholdt,1562,warlock,demonology,83,42,41
Sïlïthuss,ravencrest,1561,warlock,demonology,123,66,57
Evanore,burning-legion,1561,warlock,demonology,85,44,41
Eleriya,argent-dawn,1561,warlock,demonology,146,71,75
Dotsyoudown,kelthuzad,1560,warlock,demonology,36,18,18
Ruinovino,outland,1559,warlock,demonology,84,43,41
Itspoint,draenor,1558,warlock,demonology,65,33,32
Bionic,eredar,1557,warlock,demonology,31,18,13
Бельведерчи,blackscar,1556,warlock,demonology,258,136,122
Tonin,antonidas,1553,warlock,demonology,71,41,30
Solitariøus,arathi,1550,warlock,demonology,91,45,46
Scattler,aegwynn,1548,warlock,demonology,36,24,12
Panic,stormrage,1547,warlock,demonology,258,138,120
Luqhex,blackrock,1547,warlock,demonology,36,18,18
Velativ,silvermoon,1546,warlock,demonology,24,17,7
Костикк,howling-fjord,1546,warlock,demonology,37,21,16
Kalinowa,burning-legion,1546,warlock,demonology,167,89,78
Denzeal,argent-dawn,1546,warlock,demonology,108,53,55
Колдунишка,fordragon,1543,warlock,demonology,60,34,26
Hamnam,blackrock,1543,warlock,demonology,42,23,19
Benzakenta,sylvanas,1541,warlock,demonology,42,26,16
Haillun,twisting-nether,1541,warlock,demonology,35,17,18
Octoba,kirin-tor,1540,warlock,demonology,80,45,35
Sublînê,blackmoore,1540,warlock,demonology,100,49,51
Ilililii,ravencrest,1539,warlock,demonology,60,31,29
Rpez,archimonde,1538,warlock,demonology,448,234,214
Shalazar,dun-modr,1537,warlock,demonology,138,80,58
Bultenx,tarren-mill,1537,warlock,demonology,54,28,26
Redshíne,hyjal,1537,warlock,demonology,54,24,30
Ijixed,ravencrest,1537,warlock,demonology,80,35,45
Brokenearman,defias-brotherhood,1535,warlock,demonology,24,16,8
Kikeri,blackhand,1535,warlock,demonology,27,16,11
Nuwdles,tarren-mill,1535,warlock,demonology,42,23,19
Güulran,les-clairvoyants,1535,warlock,demonology,161,88,73
Oggelock,tarren-mill,1534,warlock,demonology,24,16,8
Secretx,kazzak,1532,warlock,demonology,18,16,2
Sizezero,tarren-mill,1532,warlock,demonology,30,18,12
Kaamosliha,frostwhisper,1532,warlock,demonology,101,51,50
Altffeer,blackmoore,1531,warlock,demonology,47,27,20
Wëndigo,stormscale,1530,warlock,demonology,41,19,22
Cròwly,area-52,1529,warlock,demonology,46,29,17
Kasztyk,grim-batol,1529,warlock,demonology,30,16,14
Hörst,das-konsortium,1528,warlock,demonology,50,27,23
Honetia,ravencrest,1528,warlock,demonology,167,79,88
Cringetamer,silvermoon,1527,warlock,demonology,52,25,27
Tochka,archimonde,1526,warlock,demonology,90,44,46
Wiitchdoktor,twisting-nether,1526,warlock,demonology,42,18,24
Tsumde,dalaran,1525,warlock,demonology,239,123,116
Abdelkarime,khaz-modan,1523,warlock,demonology,78,35,43
Skarafftan,aegwynn,1522,warlock,demonology,24,16,8
Гнильсен,borean-tundra,1521,warlock,demonology,70,42,28
Carlss,sanguino,1519,warlock,demonology,48,24,24
Rhaelgar,kazzak,1517,warlock,demonology,40,16,24
Benvyx,twisting-nether,1514,warlock,demonology,35,16,19
Stormblast,azshara,1513,warlock,demonology,92,56,36
Acererak,thunderhorn,1513,warlock,demonology,71,34,37
Alotadot,ravencrest,1511,warlock,demonology,57,30,27
Kritrouilles,sargeras,1510,warlock,demonology,36,19,17
Razzguul,blackmoore,1509,warlock,demonology,46,27,19
Харакула,fordragon,1508,warlock,demonology,54,30,24
Theolock,ragnaros,1508,warlock,demonology,60,28,32
Ydidntuwait,ragnaros,1508,warlock,demonology,60,27,33
Styxwl,blackhand,1506,warlock,demonology,30,16,14
Mundunugu,sanguino,1505,warlock,demonology,31,20,11
Цетрелисс,gordunni,1505,warlock,demonology,78,40,38
Кейкегенкай,gordunni,1504,warlock,demonology,66,38,28
Silvercurse,azuremyst,1504,warlock,demonology,54,29,25
Roedin,tarren-mill,1504,warlock,demonology,153,65,88
Rafael,stormscale,1503,warlock,demonology,60,33,27
Sineko,twisting-nether,1503,warlock,demonology,297,150,147
Гулдарий,howling-fjord,1502,warlock,demonology,351,185,166
Avanturnik,burning-legion,1500,warlock,demonology,36,20,16
Soyafärs,ravencrest,1500,warlock,demonology,60,29,31
Ðârk,silvermoon,1500,warlock,demonology,66,28,38
Hypotax,ragnaros,1499,warlock,demonology,114,58,56
Terrorrize,draenor,1499,warlock,demonology,231,115,116
Líely,ravencrest,1498,warlock,demonology,42,24,18
Nomakqlock,dun-modr,1498,warlock,demonology,84,46,38
Zanzarismo,nemesis,1497,warlock,demonology,45,25,20
Zèlêph,archimonde,1496,warlock,demonology,24,17,7
Wåfa,kazzak,1496,warlock,demonology,347,186,161
Rotyou,blackmoore,1496,warlock,demonology,67,32,35
Longdickie,ravencrest,1495,warlock,demonology,60,29,31
Deathlock,outland,1494,warlock,demonology,42,25,17
Penske,sanguino,1493,warlock,demonology,69,34,35
Morgan,jaedenar,1491,warlock,demonology,66,28,38
Yvonita,chamber-of-aspects,1490,warlock,demonology,30,16,14
Fearhändig,aegwynn,1489,warlock,demonology,71,33,38
Марэд,howling-fjord,1485,warlock,demonology,58,29,29
Khalkazar,darkspear,1485,warlock,demonology,36,18,18
Xalath,grim-batol,1483,warlock,demonology,42,24,18
Priszcilla,twisting-nether,1483,warlock,demonology,154,84,70
Эволюционист,gordunni,1483,warlock,demonology,42,22,20
Cahoa,archimonde,1481,warlock,demonology,42,26,16
Søcraqt,blackrock,1481,warlock,demonology,43,20,23
Ппинг,soulflayer,1481,warlock,demonology,96,44,52
Мембер,thermaplugg,1480,warlock,demonology,42,17,25
Themus,twisting-nether,1479,warlock,demonology,30,20,10
Jondi,blackmoore,1479,warlock,demonology,49,27,22
Zoulgania,antonidas,1479,warlock,demonology,91,43,48
Rinnieeqt,outland,1476,warlock,demonology,36,18,18
Enviroq,burning-legion,1469,warlock,demonology,59,34,25
Иллугис,gordunni,1468,warlock,demonology,36,17,19
Sevastus,argent-dawn,1467,warlock,demonology,149,78,71
Mephysteroth,dalaran,1463,warlock,demonology,66,31,35
Felburrn,twisting-nether,1459,warlock,demonology,143,70,73
Hydroxyjk,ragnaros,1458,warlock,demonology,24,16,8
Ghachi,draenor,1457,warlock,demonology,29,16,13
Ruhuen,stormscale,1455,warlock,demonology,34,18,16
Зарлог,soulflayer,1455,warlock,demonology,72,33,39
Hâres,anetheron,1454,warlock,demonology,430,208,222
Seriasa,blackmoore,1454,warlock,demonology,72,28,44
Deprecated,burning-blade,1453,warlock,demonology,29,17,12
Камнилока,booty-bay,1453,warlock,demonology,127,70,57
Vatikanet,stormscale,1449,warlock,demonology,48,29,19
Грешъник,gordunni,1448,warlock,demonology,67,32,35
Lamboo,tarren-mill,1446,warlock,demonology,34,16,18
Факлок,gordunni,1443,warlock,demonology,45,26,19
Iovol,korgall,1443,warlock,demonology,120,62,58
Mefistosx,draenor,1441,warlock,demonology,42,20,22
Absúrd,turalyon,1440,warlock,demonology,263,143,120
Ablas,bladefist,1440,warlock,demonology,87,36,51
Spongebobx,kazzak,1439,warlock,demonology,24,15,9
Scallington,shattered-hand,1439,warlock,demonology,30,15,15
Biest,drakthul,1437,warlock,demonology,36,15,21
Jïñ,ravencrest,1436,warlock,demonology,24,15,9
Slurvefar,kazzak,1436,warlock,demonology,30,15,15
Чутьчутьзлая,gordunni,1436,warlock,demonology,54,25,29
Sadisticlól,burning-legion,1435,warlock,demonology,48,25,23
Bß,argent-dawn,1434,warlock,demonology,71,38,33
Agonyzed,argent-dawn,1434,warlock,demonology,52,27,25
Guldchan,drakthul,1433,warlock,demonology,24,15,9
Ädarä,cthun,1433,warlock,demonology,162,84,78
Ganjubass,tarren-mill,1432,warlock,demonology,24,15,9
Kukcaryfuk,drakthul,1431,warlock,demonology,54,27,27
Youseenbølt,veklor,1431,warlock,demonology,36,15,21
Chargerinho,silvermoon,1430,warlock,demonology,24,15,9
Djfearbot,kazzak,1430,warlock,demonology,27,16,11
Nimh,azjolnerub,1428,warlock,demonology,101,56,45
Saganelle,hyjal,1426,warlock,demonology,18,15,3
Ghalorg,hyjal,1425,warlock,demonology,29,16,13
Corbiejr,tarren-mill,1425,warlock,demonology,70,29,41
Hyphonos,blackmoore,1422,warlock,demonology,30,15,15
Drainurlife,zenedar,1418,warlock,demonology,30,15,15
Míkæ,ravencrest,1417,warlock,demonology,101,48,53
Tschebo,eredar,1415,warlock,demonology,39,20,19
Стокыч,soulflayer,1415,warlock,demonology,42,15,27
Lunden,drakthul,1414,warlock,demonology,46,22,24
Malganas,sylvanas,1414,warlock,demonology,95,42,53
Chedipes,stormscale,1414,warlock,demonology,39,16,23
Szetbaszlock,ragnaros,1412,warlock,demonology,36,22,14
Valadair,sanguino,1408,warlock,demonology,265,139,126
Героуд,howling-fjord,1407,warlock,demonology,30,15,15
Indiasummerx,turalyon,1406,warlock,demonology,81,40,41
Dementorian,blackrock,1405,warlock,demonology,24,15,9
Паникс,gordunni,1405,warlock,demonology,54,22,32
Qullnius,kazzak,1402,warlock,demonology,42,24,18
Tudii,frostwolf,1401,warlock,demonology,54,32,22
Morgána,outland,1401,warlock,demonology,30,15,15
Валентинчик,galakrond,1399,warlock,demonology,87,45,42
Aenygma,jaedenar,1398,warlock,demonology,36,21,15
Esgül,draenor,1397,warlock,demonology,132,67,65
Profylaxis,arathor,1396,warlock,demonology,46,23,23
Dabulock,blackmoore,1393,warlock,demonology,75,34,41
Inien,sylvanas,1392,warlock,demonology,66,41,25
Brryant,colinas-pardas,1391,warlock,demonology,36,20,16
Кайрана,blackscar,1390,warlock,demonology,49,27,22
Чернаяскала,howling-fjord,1389,warlock,demonology,164,77,87
Njutbar,ragnaros,1388,warlock,demonology,30,17,13
Happycadaver,blackrock,1388,warlock,demonology,45,21,24
Армдэд,galakrond,1388,warlock,demonology,84,39,45
Cozyboi,thrall,1386,warlock,demonology,112,67,45
Morshax,ysondre,1386,warlock,demonology,36,21,15
Эмокитти,soulflayer,1380,warlock,demonology,51,29,22
Smallpee,kazzak,1380,warlock,demonology,54,25,29
Сквордин,gordunni,1378,warlock,demonology,30,17,13
Антетак,soulflayer,1378,warlock,demonology,42,22,20
Astéfion,dalaran,1378,warlock,demonology,30,15,15
Thorash,moonglade,1374,warlock,demonology,52,30,22
Wítchær,blackhand,1370,warlock,demonology,48,28,20
Telyfol,ragnaros,1370,warlock,demonology,40,17,23
Deabrus,silvermoon,1369,warlock,demonology,65,31,34
Bobkeso,sylvanas,1368,warlock,demonology,36,15,21
Tomlingen,terenas,1361,warlock,demonology,60,32,28
Lökjävel,twisting-nether,1359,warlock,demonology,30,17,13
Neffy,sinstralis,1359,warlock,demonology,69,35,34
Чингинсхан,howling-fjord,1357,warlock,demonology,35,25,10
Letzman,ravencrest,1356,warlock,demonology,31,18,13
Candyman,bronze-dragonflight,1356,warlock,demonology,87,44,43
Nihale,arakarahm,1352,warlock,demonology,38,21,17
Void,pozzo-delleternità,1352,warlock,demonology,113,58,55
Mesîkatayut,outland,1351,warlock,demonology,81,46,35
Chimera,mugthol,1350,warlock,demonology,60,27,33
Olsel,draenor,1349,warlock,demonology,36,16,20
Простоседой,gordunni,1349,warlock,demonology,35,15,20
Xanatar,blackhand,1347,warlock,demonology,72,29,43
Dedalus,zuluhed,1346,warlock,demonology,214,117,97
Mércé,stormscale,1344,warlock,demonology,18,14,4
Ukjjkhj,frostmane,1344,warlock,demonology,37,15,22
Xarica,garona,1343,warlock,demonology,18,14,4
Beebs,aegwynn,1343,warlock,demonology,18,14,4
Trellaras,bloodfeather,1343,warlock,demonology,93,47,46
Kumamoto,tarren-mill,1342,warlock,demonology,30,14,16
Bewbys,draenor,1342,warlock,demonology,55,25,30
Lacape,dalaran,1340,warlock,demonology,28,15,13
Famíliar,tarren-mill,1340,warlock,demonology,81,31,50
Shârîngan,kazzak,1337,warlock,demonology,30,14,16
Evilonion,outland,1337,warlock,demonology,36,14,22
Mpslo,archimonde,1335,warlock,demonology,24,14,10
Døtzz,blackmoore,1335,warlock,demonology,30,14,16
Инсип,blackscar,1333,warlock,demonology,78,39,39
Vanskor,argent-dawn,1331,warlock,demonology,100,42,58
Jag,neptulon,1330,warlock,demonology,86,50,36
Elìphás,blackmoore,1330,warlock,demonology,36,14,22
Lockmybllz,baelgun,1329,warlock,demonology,24,15,9
Ilarizium,ysondre,1329,warlock,demonology,95,46,49
Eatherial,twilights-hammer,1327,warlock,demonology,52,31,21
Kharless,kazzak,1327,warlock,demonology,38,19,19
Kieman,tarren-mill,1327,warlock,demonology,30,14,16
Raez,burning-blade,1327,warlock,demonology,47,18,29
Prestoc,wrathbringer,1324,warlock,demonology,30,14,16
Kwanzaa,ravencrest,1319,warlock,demonology,24,14,10
Evilbuba,burning-legion,1319,warlock,demonology,70,36,34
Gulldan,bloodfeather,1315,warlock,demonology,54,27,27
Allotropìa,ravencrest,1315,warlock,demonology,30,14,16
Dìablò,sylvanas,1314,warlock,demonology,48,29,19
Diavoolitza,sylvanas,1314,warlock,demonology,66,33,33
Dhraven,thrall,1314,warlock,demonology,78,36,42
Дуклок,howling-fjord,1313,warlock,demonology,70,37,33
Forthewin,stormreaver,1313,warlock,demonology,30,15,15
Papilena,turalyon,1312,warlock,demonology,67,31,36
Исверон,howling-fjord,1310,warlock,demonology,29,14,15
Dominvs,silvermoon,1306,warlock,demonology,162,80,82
Øupas,ysondre,1304,warlock,demonology,42,14,28
Tunrîda,illidan,1303,warlock,demonology,45,21,24
Déus,forscherliga,1300,warlock,demonology,263,126,137
Siaval,die-aldor,1299,warlock,demonology,42,21,21
Mmorgana,sanguino,1295,warlock,demonology,45,19,26
Maferous,argent-dawn,1293,warlock,demonology,41,19,22
Соргосор,gordunni,1290,warlock,demonology,23,16,7
Akumako,stormscale,1290,warlock,demonology,29,14,15
Xoky,argent-dawn,1286,warlock,demonology,42,17,25
Degdeehei,draenor,1282,warlock,demonology,24,16,8
Andid,frostwolf,1282,warlock,demonology,55,28,27
Kalhija,medivh,1282,warlock,demonology,48,24,24
Erèss,hyjal,1280,warlock,demonology,36,15,21
Cmzdalock,ravencrest,1279,warlock,demonology,36,23,13
Мицуру,howling-fjord,1279,warlock,demonology,26,16,10
Lifesteal,auchindoun,1279,warlock,demonology,67,34,33
Volomar,darkspear,1279,warlock,demonology,35,16,19
Cerberus,argent-dawn,1277,warlock,demonology,24,15,9
Мормир,deathguard,1274,warlock,demonology,88,37,51
Zdrac,stormscale,1273,warlock,demonology,62,26,36
Auxi,the-maelstrom,1270,warlock,demonology,114,57,57
Shadowpriest,nemesis,1265,warlock,demonology,29,15,14
Narayan,ysondre,1252,warlock,demonology,71,40,31
Lokisi,die-aldor,1249,warlock,demonology,60,34,26
Rövsmärta,ragnaros,1248,warlock,demonology,27,15,12
Lhestér,outland,1248,warlock,demonology,24,13,11
Ахпорбес,gordunni,1247,warlock,demonology,40,22,18
Skyrender,argent-dawn,1247,warlock,demonology,30,13,17
Idonthexafck,kazzak,1246,warlock,demonology,18,13,5
Okmybad,outland,1246,warlock,demonology,24,13,11
Fatzké,kargath,1246,warlock,demonology,28,13,15
Димаанстейбл,gordunni,1245,warlock,demonology,30,13,17
Quarimathras,antonidas,1244,warlock,demonology,24,13,11
Naze,aegwynn,1244,warlock,demonology,30,13,17
Бжк,gordunni,1243,warlock,demonology,30,13,17
Vregor,twisting-nether,1242,warlock,demonology,18,13,5
Drachus,outland,1242,warlock,demonology,18,13,5
Tarilinwelli,les-sentinelles,1242,warlock,demonology,24,13,11
Dmondmg,kazzak,1242,warlock,demonology,30,13,17
Blazik,kazzak,1237,warlock,demonology,36,20,16
Azaêl,azshara,1237,warlock,demonology,30,13,17
Lokko,nemesis,1237,warlock,demonology,65,26,39
Zetec,tarren-mill,1235,warlock,demonology,36,13,23
Visenyá,magtheridon,1234,warlock,demonology,24,13,11
Laveau,outland,1234,warlock,demonology,30,13,17
Баммес,galakrond,1234,warlock,demonology,136,58,78
Gunca,sylvanas,1231,warlock,demonology,36,17,19
Sargaerot,draenor,1230,warlock,demonology,72,33,39
Dernaxz,argent-dawn,1225,warlock,demonology,26,15,11
Boldielocks,tarren-mill,1224,warlock,demonology,18,13,5
Screamo,sylvanas,1224,warlock,demonology,85,48,37
Whj,ravencrest,1222,warlock,demonology,29,13,16
Bíü,tarren-mill,1219,warlock,demonology,30,13,17
Gnometefurax,hyjal,1218,warlock,demonology,55,24,31
Rüwel,mannoroth,1214,warlock,demonology,65,29,36
Dedobozhe,ravencrest,1213,warlock,demonology,24,13,11
Netcownt,silvermoon,1208,warlock,demonology,55,26,29
Marketwizard,turalyon,1207,warlock,demonology,26,14,12
Imadovich,silvermoon,1202,warlock,demonology,161,86,75
Filø,dalaran,1201,warlock,demonology,114,46,68
Marklock,drakthul,1199,warlock,demonology,18,13,5
Truckpunch,defias-brotherhood,1199,warlock,demonology,105,48,57
Lugdan,blackmoore,1198,warlock,demonology,36,13,23
Yamajii,krasus,1195,warlock,demonology,71,39,32
Vreyax,aegwynn,1195,warlock,demonology,29,13,16
Rngmåchinêx,ravencrest,1183,warlock,demonology,22,13,9
Vorgoth,argent-dawn,1179,warlock,demonology,28,13,15
Waltrude,conseil-des-ombres,1171,warlock,demonology,77,27,50
Cevérus,chogall,1169,warlock,demonology,60,28,32
Thyron,gorgonnash,1165,warlock,demonology,54,25,29
Sipsirica,ragnaros,1159,warlock,demonology,66,30,36
Krushell,sanguino,1158,warlock,demonology,36,21,15
Fujiitøra,ysondre,1158,warlock,demonology,165,85,80
Inani,ragnaros,1157,warlock,demonology,29,13,16
Jomitoisback,nemesis,1152,warlock,demonology,12,12,0
Gorescrèám,stormscale,1152,warlock,demonology,18,12,6
Bónz,outland,1152,warlock,demonology,18,12,6
Havefunxqt,archimonde,1152,warlock,demonology,26,13,13
Averiumx,ravencrest,1152,warlock,demonology,24,12,12
Someonepro,tarren-mill,1152,warlock,demonology,24,12,12
Isanê,blackrock,1152,warlock,demonology,24,12,12
Gyzmo,outland,1152,warlock,demonology,24,12,12
Dotrulez,nemesis,1151,warlock,demonology,18,12,6
Инфес,deathweaver,1151,warlock,demonology,18,12,6
Ethiq,blackrock,1151,warlock,demonology,24,12,12
Nargøf,outland,1151,warlock,demonology,24,12,12
Slâyâ,blackrock,1150,warlock,demonology,18,12,6
Melydor,ragnaros,1150,warlock,demonology,18,12,6
Мааверш,soulflayer,1150,warlock,demonology,36,21,15
Morwëk,ysondre,1150,warlock,demonology,36,12,24
Slobb,blackrock,1149,warlock,demonology,18,12,6
Antuan,sanguino,1149,warlock,demonology,30,12,18
Gülldän,chogall,1148,warlock,demonology,18,12,6
Desolador,tyrande,1148,warlock,demonology,30,12,18
Deadmanwlkin,aggra-português,1147,warlock,demonology,18,12,6
Édøras,archimonde,1146,warlock,demonology,30,12,18
Yoplen,drakthul,1145,warlock,demonology,24,12,12
Ashzu,quelthalas,1145,warlock,demonology,24,12,12
Jinxme,tarren-mill,1144,warlock,demonology,18,12,6
Sînâ,anubarak,1141,warlock,demonology,36,18,18
Aldhelm,draenor,1130,warlock,demonology,28,13,15
Nozalem,dalaran,1126,warlock,demonology,71,39,32
Cazul,archimonde,1118,warlock,demonology,20,13,7
Erwynna,conseil-des-ombres,1118,warlock,demonology,30,12,18
Wanderingowl,argent-dawn,1103,warlock,demonology,18,12,6
Scarly,nordrassil,1103,warlock,demonology,41,21,20
Tripleshache,elune,1101,warlock,demonology,132,67,65
Силаскверна,deathguard,1088,warlock,demonology,90,39,51
Cwyn,ravencrest,1088,warlock,demonology,30,13,17
Êdelmann,blackrock,1086,warlock,demonology,23,12,11
Remthorn,frostmane,1068,warlock,demonology,128,67,61
Wryy,nemesis,1067,warlock,demonology,25,12,13
Bicuriousdad,tarren-mill,1056,warlock,demonology,12,11,1
Chromex,dentarg,1056,warlock,demonology,12,11,1
Dotosgyörgy,ragnaros,1056,warlock,demonology,18,11,7
Shlipshlap,ravencrest,1056,warlock,demonology,18,11,7
Adellara,draenor,1056,warlock,demonology,18,11,7
Dotáhoe,twisting-nether,1056,warlock,demonology,22,12,10
Nazw,ravencrest,1056,warlock,demonology,24,11,13
Aljohno,twisting-nether,1056,warlock,demonology,24,11,13
Dwoorf,ravencrest,1056,warlock,demonology,24,11,13
Syñdrome,ragnaros,1055,warlock,demonology,18,11,7
Werzel,frostmane,1055,warlock,demonology,18,11,7
Lonelock,blackrock,1055,warlock,demonology,24,11,13
Tìdùs,nethersturm,1054,warlock,demonology,12,11,1
Drainsouls,stormscale,1054,warlock,demonology,18,11,7
Острогриф,gordunni,1054,warlock,demonology,18,11,7
Dàrksoul,thrall,1054,warlock,demonology,18,11,7
Arizyoxot,twisting-nether,1054,warlock,demonology,24,11,13
Eviloverlord,silvermoon,1054,warlock,demonology,24,11,13
Katâra,tarren-mill,1054,warlock,demonology,24,11,13
Shînîgamî,draenor,1053,warlock,demonology,18,11,7
Fenrixlol,zuljin,1052,warlock,demonology,18,11,7
Евнухоидизм,gordunni,1051,warlock,demonology,20,11,9
Törtidotcom,blackrock,1051,warlock,demonology,24,11,13
Nellyvato,eredar,1050,warlock,demonology,18,11,7
Lacus,voljin,1050,warlock,demonology,36,11,25
Azpit,draenor,1049,warlock,demonology,18,11,7
Ukicha,burning-blade,1049,warlock,demonology,18,11,7
Vidorious,kilrogg,1048,warlock,demonology,18,11,7
Дулаан,blackscar,1042,warlock,demonology,18,11,7
Isuckwarlock,aegwynn,1039,warlock,demonology,23,11,12
Ïvar,ysondre,1032,warlock,demonology,79,31,48
Abnørmus,tarren-mill,1031,warlock,demonology,24,11,13
Thanàthos,pozzo-delleternità,1030,warlock,demonology,36,17,19
Ambralia,blackmoore,1027,warlock,demonology,88,42,46
Yountyrantx,blackrock,1023,warlock,demonology,14,12,2
Shadowppl,outland,1021,warlock,demonology,26,12,14
Stregone,chogall,1018,warlock,demonology,24,13,11
Hexus,teldrassil,1017,warlock,demonology,36,11,25
Maleesh,ravenholdt,1013,warlock,demonology,78,32,46
Demonfaris,turalyon,1007,warlock,demonology,21,11,10
Dreamnyâsha,tarren-mill,1002,warlock,demonology,21,13,8
Acuacx,drakthul,1002,warlock,demonology,23,11,12
Flisiakm,exodar,1000,warlock,demonology,30,12,18
Sabiocalvo,dun-modr,999,warlock,demonology,141,67,74
Discomugg,stormscale,991,warlock,demonology,17,11,6
Fuark,teldrassil,987,warlock,demonology,17,11,6
Cedrea,ravencrest,975,warlock,demonology,47,11,36
Haitech,dalaran,974,warlock,demonology,16,11,5
Chãn,ravencrest,960,warlock,demonology,12,10,2
Miauwu,stormscale,960,warlock,demonology,12,10,2
Bankstair,stormscale,960,warlock,demonology,18,10,8
Plâytïmè,stormscale,960,warlock,demonology,18,10,8
Retnmsl,outland,960,warlock,demonology,18,10,8
Zartax,kazzak,960,warlock,demonology,24,10,14
Fearu,kazzak,960,warlock,demonology,24,10,14
Nerdlockx,tarren-mill,959,warlock,demonology,12,10,2
Oozi,tarren-mill,959,warlock,demonology,12,10,2
Pepsimaxlove,silvermoon,959,warlock,demonology,18,10,8
Cadavrus,arakarahm,959,warlock,demonology,18,10,8
Alexutzu,sylvanas,959,warlock,demonology,18,10,8
Boogersoup,outland,959,warlock,demonology,18,10,8
Нэваблэйз,howling-fjord,959,warlock,demonology,18,10,8
Dortes,blackrock,959,warlock,demonology,18,10,8
Plsbuffme,ravencrest,959,warlock,demonology,18,10,8
Selene,der-rat-von-dalaran,959,warlock,demonology,18,10,8
Ívânguldán,twisting-nether,959,warlock,demonology,24,10,14
Ipetsincl,kazzak,958,warlock,demonology,18,10,8
Teflondione,stormreaver,958,warlock,demonology,18,10,8
Killning,medivh,958,warlock,demonology,18,10,8
Davyjonessx,twisting-nether,958,warlock,demonology,18,10,8
Ooliver,kazzak,958,warlock,demonology,18,10,8
Petrapain,antonidas,958,warlock,demonology,22,11,11
Liittlefreak,silvermoon,957,warlock,demonology,18,10,8
Boxxybabee,blackhand,956,warlock,demonology,12,10,2
Elkiä,ysondre,956,warlock,demonology,36,19,17
Жмотярище,gordunni,955,warlock,demonology,18,10,8
Ohnoitsnepss,chamber-of-aspects,953,warlock,demonology,36,11,25
Hallowee,voljin,946,warlock,demonology,80,28,52
Немножковуду,soulflayer,945,warlock,demonology,18,10,8
Dardec,hyjal,910,warlock,demonology,35,10,25
Zaross,khaz-modan,907,warlock,demonology,59,25,34
Myskul,burning-legion,906,warlock,demonology,22,12,10
Migyardondup,exodar,905,warlock,demonology,105,55,50
Dbolic,ravencrest,904,warlock,demonology,19,11,8
Themengh,stormscale,904,warlock,demonology,69,27,42
Djadizpunish,stormscale,894,warlock,demonology,15,11,4
Snoggä,antonidas,885,warlock,demonology,36,17,19
Polanka,drakthul,878,warlock,demonology,18,10,8
Wewondak,drakthul,876,warlock,demonology,11,10,1
Ixal,hyjal,870,warlock,demonology,60,28,32
Dadylock,silvermoon,864,warlock,demonology,12,9,3
Sulnar,burning-legion,864,warlock,demonology,12,9,3
Nastychatøn,ysondre,864,warlock,demonology,12,9,3
Deßra,stormscale,864,warlock,demonology,12,9,3
Köftemec,blackrock,864,warlock,demonology,12,9,3
Yazurí,ravencrest,864,warlock,demonology,12,9,3
Dogdrakex,tarren-mill,864,warlock,demonology,12,9,3
Öbsury,hyjal,864,warlock,demonology,12,9,3
Ooroothothz,frostwolf,864,warlock,demonology,12,9,3
Bualock,sylvanas,864,warlock,demonology,12,9,3
Magicisback,nemesis,864,warlock,demonology,12,9,3
Фирбог,soulflayer,864,warlock,demonology,12,9,3
Nëismz,hyjal,864,warlock,demonology,12,9,3
Blekspel,outland,864,warlock,demonology,18,9,9
Nekrofille,outland,864,warlock,demonology,18,9,9
Rikmeyzter,burning-blade,864,warlock,demonology,18,9,9
Boomlok,tarren-mill,864,warlock,demonology,18,9,9
Ôlo,rajaxx,864,warlock,demonology,18,9,9
Журанайсбой,blackscar,864,warlock,demonology,18,9,9
Tops,thrall,863,warlock,demonology,12,9,3
Nastýføxÿ,ysondre,863,warlock,demonology,12,9,3
Тапкидеда,gordunni,863,warlock,demonology,12,9,3
Bananajouu,blackhand,863,warlock,demonology,18,9,9
Malathrom,garona,863,warlock,demonology,18,9,9
Ewalock,chants-éternels,863,warlock,demonology,18,9,9
Cardinall,drakthul,863,warlock,demonology,18,9,9
Myrkûl,kazzak,863,warlock,demonology,18,9,9
Fedra,steamwheedle-cartel,863,warlock,demonology,18,9,9
Nosoulnoprob,sylvanas,863,warlock,demonology,24,9,15
Dotface,aegwynn,863,warlock,demonology,24,9,15
Nomercymcr,burning-legion,862,warlock,demonology,18,9,9
Drarken,sylvanas,862,warlock,demonology,18,9,9
Topmidbusta,draenor,862,warlock,demonology,18,9,9
Малгат,howling-fjord,862,warlock,demonology,24,9,15
Summøn,stormreaver,862,warlock,demonology,32,9,23
Kazzulina,ravenholdt,861,warlock,demonology,24,9,15
Oblutak,draenor,859,warlock,demonology,18,9,9
Corínnakopf,thrall,858,warlock,demonology,18,9,9
Zytomegalie,blackrock,856,warlock,demonology,18,9,9
Nikhusadark,draenor,856,warlock,demonology,19,9,10
Mückea,eredar,856,warlock,demonology,24,9,15
Диффиндо,galakrond,854,warlock,demonology,12,9,3
Decimus,darkspear,847,warlock,demonology,23,9,14
Hhip,sanguino,842,warlock,demonology,27,10,17
Hexovíc,blackmoore,829,warlock,demonology,23,9,14
Jendzababa,burning-legion,827,warlock,demonology,17,9,8
Farasuflet,burning-steppes,826,warlock,demonology,36,16,20
Vansouls,silvermoon,815,warlock,demonology,15,10,5
Дакиса,gordunni,815,warlock,demonology,17,9,8
Гупперлок,howling-fjord,810,warlock,demonology,27,12,15
Lókkíi,silvermoon,809,warlock,demonology,24,10,14
Бирел,soulflayer,799,warlock,demonology,16,9,7
Кусокплети,grom,797,warlock,demonology,19,10,9
Йотунхейм,ashenvale,792,warlock,demonology,20,9,11
Mamasitica,ravencrest,768,warlock,demonology,12,8,4
Äri,blackmoore,768,warlock,demonology,12,8,4
Kronesx,tarren-mill,768,warlock,demonology,12,8,4
Dispelpls,dun-morogh,768,warlock,demonology,12,8,4
Mingingclass,stormscale,768,warlock,demonology,12,8,4
Rozn,ravencrest,768,warlock,demonology,12,8,4
Meshekinoqua,tarren-mill,768,warlock,demonology,12,8,4
Staenkymayne,blackhand,768,warlock,demonology,12,8,4
Gilfhaunter,malganis,768,warlock,demonology,12,8,4
Cappaoow,ravencrest,768,warlock,demonology,12,8,4
Maevoni,blackmoore,768,warlock,demonology,12,8,4
Горгзок,howling-fjord,768,warlock,demonology,12,8,4
Шрэкс,blackscar,768,warlock,demonology,12,8,4
Hyòkà,kazzak,768,warlock,demonology,12,8,4
Hyöká,kazzak,768,warlock,demonology,12,8,4
Devildodo,elune,768,warlock,demonology,12,8,4
Аскамардва,gordunni,768,warlock,demonology,12,8,4
Absoul,defias-brotherhood,768,warlock,demonology,12,8,4
Homerbamboom,hyjal,768,warlock,demonology,12,8,4
Freyzul,twisting-nether,768,warlock,demonology,12,8,4
Milfhaunter,aegwynn,768,warlock,demonology,12,8,4
Ккоксакер,gordunni,768,warlock,demonology,12,8,4
Dryaxc,frostwolf,768,warlock,demonology,18,8,10
Idkdot,ravencrest,768,warlock,demonology,18,8,10
Уанбаттон,gordunni,768,warlock,demonology,18,8,10
Holypepe,tarren-mill,768,warlock,demonology,18,8,10
Jarodshadow,stormscale,768,warlock,demonology,18,8,10
Narsok,blackrock,768,warlock,demonology,18,8,10
Nastychâtøn,ysondre,768,warlock,demonology,18,8,10
Djezzick,stormscale,768,warlock,demonology,18,8,10
Evillinna,frostmane,768,warlock,demonology,18,8,10
Manithedøg,stormscale,768,warlock,demonology,18,8,10
Myuoutwo,eldrethalas,768,warlock,demonology,18,8,10
Spelldweller,silvermoon,768,warlock,demonology,18,8,10
Viyn,blackrock,768,warlock,demonology,18,8,10
Noytan,nemesis,768,warlock,demonology,18,8,10
Melfos,blackmoore,768,warlock,demonology,18,8,10
Demospîrît,outland,768,warlock,demonology,24,8,16
Dabzw,twisting-nether,768,warlock,demonology,24,8,16
Ðelðish,draenor,767,warlock,demonology,12,8,4
Véstheim,saurfang,767,warlock,demonology,12,8,4
Eizon,tarren-mill,767,warlock,demonology,12,8,4
Wildo,grim-batol,767,warlock,demonology,12,8,4
Likeqtz,thrall,767,warlock,demonology,12,8,4
Nëeya,hyjal,767,warlock,demonology,12,8,4
Mandafni,blackmoore,767,warlock,demonology,12,8,4
Thotseducer,kazzak,767,warlock,demonology,12,8,4
Sovrìn,blackrock,767,warlock,demonology,12,8,4
Tojezlo,drakthul,767,warlock,demonology,12,8,4
Affrighten,karazhan,767,warlock,demonology,18,8,10
Heltjettad,ravencrest,767,warlock,demonology,18,8,10
Mombo,the-maelstrom,767,warlock,demonology,18,8,10
Khâmélÿa,culte-de-la-rive-noire,767,warlock,demonology,18,8,10
Violetmyst,outland,767,warlock,demonology,18,8,10
Neg,sylvanas,767,warlock,demonology,18,8,10
Klaab,hyjal,767,warlock,demonology,24,8,16
Otemlock,sanguino,766,warlock,demonology,12,8,4
Lethellin,antonidas,766,warlock,demonology,12,8,4
Guccie,ravencrest,766,warlock,demonology,17,10,7
Britneyféars,emeriss,766,warlock,demonology,18,8,10
Zeddy,draenor,766,warlock,demonology,18,8,10
Merzavka,kazzak,765,warlock,demonology,12,8,4
Bachmut,ravencrest,765,warlock,demonology,18,8,10
Xydama,blackrock,764,warlock,demonology,18,8,10
Gúldn,outland,763,warlock,demonology,30,8,22
Vazelin,stormscale,762,warlock,demonology,18,8,10
Ясяшотлав,soulflayer,761,warlock,demonology,22,11,11
Thudhor,burning-legion,745,warlock,demonology,16,8,8
Destrodanii,dun-morogh,719,warlock,demonology,11,8,3
Dotwhat,ravencrest,719,warlock,demonology,17,8,9
Lewd,dragonblight,714,warlock,demonology,17,8,9
Аттропа,gordunni,709,warlock,demonology,149,63,86
Graveshaker,quelthalas,704,warlock,demonology,26,8,18
Lifetap,tarren-mill,703,warlock,demonology,14,8,6
Myxâ,tarren-mill,699,warlock,demonology,11,8,3
Альтдаен,borean-tundra,687,warlock,demonology,19,8,11
Жасминдос,blackscar,672,warlock,demonology,12,7,5
Miazmii,ragnaros,672,warlock,demonology,12,7,5
Likilaka,draenor,672,warlock,demonology,12,7,5
Lucifer,burning-legion,672,warlock,demonology,12,7,5
Fierce,dethecus,672,warlock,demonology,12,7,5
Khaleth,dun-modr,672,warlock,demonology,12,7,5
Tropìcal,grim-batol,672,warlock,demonology,12,7,5
Noîbe,chogall,672,warlock,demonology,12,7,5
Bono,frostwhisper,672,warlock,demonology,12,7,5
Lickyicky,twisting-nether,672,warlock,demonology,12,7,5
Тагочи,gordunni,672,warlock,demonology,12,7,5
Framelock,draenor,672,warlock,demonology,12,7,5
Дядяджонн,gordunni,672,warlock,demonology,12,7,5
Mürsk,draenor,672,warlock,demonology,12,7,5
Clapx,magtheridon,672,warlock,demonology,12,7,5
Immolleria,frostmane,672,warlock,demonology,12,7,5
Thereya,dun-morogh,672,warlock,demonology,12,7,5
Flamidien,archimonde,672,warlock,demonology,12,7,5
Laoganma,outland,672,warlock,demonology,12,7,5
Ahollic,antonidas,672,warlock,demonology,12,7,5
Cptdotalot,tarren-mill,672,warlock,demonology,12,7,5
Zagreos,tarren-mill,672,warlock,demonology,12,7,5
Horststenzl,blackrock,672,warlock,demonology,12,7,5
Líí,burning-blade,672,warlock,demonology,12,7,5
Pokidrain,twisting-nether,672,warlock,demonology,12,7,5
Sippe,laughing-skull,672,warlock,demonology,12,7,5
Kosfáce,tarren-mill,672,warlock,demonology,12,7,5
Kalemma,kazzak,672,warlock,demonology,12,7,5
Plague,twisting-nether,672,warlock,demonology,12,7,5
Fearfearfear,archimonde,672,warlock,demonology,12,7,5
Boomloc,tarren-mill,672,warlock,demonology,12,7,5
Кале,goldrinn,672,warlock,demonology,12,7,5
Külebra,uldum,672,warlock,demonology,12,7,5
Ballerlock,ravencrest,672,warlock,demonology,12,7,5
Marador,drakthul,672,warlock,demonology,12,7,5
Racursed,outland,672,warlock,demonology,12,7,5
Whocarezlock,stormscale,672,warlock,demonology,12,7,5
Baldazar,dun-modr,672,warlock,demonology,18,7,11
Amerihell,pozzo-delleternità,672,warlock,demonology,18,7,11
Focalorx,tarren-mill,672,warlock,demonology,18,7,11
Xfz,stormscale,672,warlock,demonology,18,7,11
Theronas,tarren-mill,672,warlock,demonology,18,7,11
Hakai,los-errantes,672,warlock,demonology,18,7,11
Lichlolocked,outland,672,warlock,demonology,18,7,11
Ilovebronko,blackrock,672,warlock,demonology,18,7,11
Artys,tarren-mill,672,warlock,demonology,18,7,11
Андурон,galakrond,672,warlock,demonology,24,7,17
Адилея,howling-fjord,671,warlock,demonology,12,7,5
Прозерппина,azuregos,671,warlock,demonology,12,7,5
Clungesuck,argent-dawn,671,warlock,demonology,12,7,5
Grimskog,silvermoon,671,warlock,demonology,12,7,5
Сч,ashenvale,671,warlock,demonology,12,7,5
Kvælstof,stormscale,671,warlock,demonology,12,7,5
Gaznul,blackmoore,671,warlock,demonology,12,7,5
Wirbelwind,forscherliga,671,warlock,demonology,18,7,11
Indifférence,archimonde,671,warlock,demonology,18,7,11
Pestilus,thrall,671,warlock,demonology,18,7,11
Darcol,archimonde,671,warlock,demonology,18,7,11
Манапчик,soulflayer,671,warlock,demonology,24,7,17
Cannolix,blackhand,671,warlock,demonology,24,7,17
Muninnus,archimonde,670,warlock,demonology,21,8,13
Williamford,dun-modr,669,warlock,demonology,18,7,11
Etherbit,burning-legion,669,warlock,demonology,24,7,17
Darlanis,draenor,668,warlock,demonology,12,7,5
Wedgywarlock,stormscale,668,warlock,demonology,18,7,11
Унаросс,deathguard,655,warlock,demonology,23,7,16
Hadrianor,sanguino,624,warlock,demonology,15,7,8
Kavalierr,stormscale,624,warlock,demonology,21,8,13
Kïng,elune,622,warlock,demonology,15,8,7
Warlockxx,ravencrest,607,warlock,demonology,11,7,4
Fearbót,kazzak,576,warlock,demonology,6,6,0
Kakuzil,draenor,576,warlock,demonology,6,6,0
Shadowburst,outland,576,warlock,demonology,6,6,0
Missdreavius,argent-dawn,576,warlock,demonology,6,6,0
Marakh,stormscale,576,warlock,demonology,6,6,0
Onewarlock,kazzak,576,warlock,demonology,6,6,0
Evlwizardman,kazzak,576,warlock,demonology,6,6,0
Rbmk,sanguino,576,warlock,demonology,6,6,0
Freshademic,tarren-mill,576,warlock,demonology,6,6,0
Sanshukar,ravencrest,576,warlock,demonology,6,6,0
Labreego,aggra-português,576,warlock,demonology,6,6,0
Rivmuu,argent-dawn,576,warlock,demonology,12,6,6
Trickslock,kazzak,576,warlock,demonology,12,6,6
Gammalgubbe,stormscale,576,warlock,demonology,12,6,6
Zpàrta,ragnaros,576,warlock,demonology,12,6,6
Bowti,ravencrest,576,warlock,demonology,12,6,6
Lêxia,shattrath,576,warlock,demonology,12,6,6
Kakren,ysondre,576,warlock,demonology,12,6,6
Neijihbolt,blackrock,576,warlock,demonology,12,6,6
Wacamolymojo,tarren-mill,576,warlock,demonology,12,6,6
Ðêmøñîc,ravencrest,576,warlock,demonology,12,6,6
Lifedriller,drakthul,576,warlock,demonology,12,6,6
Makghal,boulderfist,576,warlock,demonology,12,6,6
Devour,magtheridon,576,warlock,demonology,12,6,6
Quanà,eredar,576,warlock,demonology,12,6,6
Fezk,outland,576,warlock,demonology,12,6,6
Kartanos,stormscale,576,warlock,demonology,12,6,6
Hextreme,anetheron,576,warlock,demonology,12,6,6
Médeâ,ravencrest,576,warlock,demonology,12,6,6
Dïna,silvermoon,576,warlock,demonology,12,6,6
Lockróck,silvermoon,576,warlock,demonology,12,6,6
Xzensor,ravencrest,576,warlock,demonology,12,6,6
Vekkna,hyjal,576,warlock,demonology,12,6,6
Deflagrate,kazzak,576,warlock,demonology,12,6,6
Lockydotty,silvermoon,576,warlock,demonology,12,6,6
Vîmø,antonidas,576,warlock,demonology,12,6,6
Cropper,turalyon,576,warlock,demonology,12,6,6
Rîas,hyjal,576,warlock,demonology,12,6,6
Gruldran,khaz-modan,576,warlock,demonology,12,6,6
Nephystø,archimonde,576,warlock,demonology,12,6,6
Комочеро,soulflayer,576,warlock,demonology,12,6,6
Zerx,malganis,576,warlock,demonology,12,6,6
Oloki,kazzak,576,warlock,demonology,12,6,6
Zilgen,argent-dawn,576,warlock,demonology,12,6,6
Hyóká,kazzak,576,warlock,demonology,12,6,6
Lifetapped,tarren-mill,576,warlock,demonology,18,6,12
Diablist,kazzak,576,warlock,demonology,18,6,12
Øbéydêmøn,silvermoon,576,warlock,demonology,18,6,12
Kamí,sanguino,576,warlock,demonology,18,6,12
Фэлдред,soulflayer,576,warlock,demonology,18,6,12
Эссминет,soulflayer,576,warlock,demonology,18,6,12
Yeatso,blackmoore,576,warlock,demonology,18,6,12
Ftpete,argent-dawn,576,warlock,demonology,18,6,12
Millhaus,gorgonnash,576,warlock,demonology,24,6,18
Скиифул,howling-fjord,576,warlock,demonology,24,6,18
Fangdred,twisting-nether,575,warlock,demonology,6,6,0
Deadleth,blackrock,575,warlock,demonology,10,7,3
Zerozwolf,tarren-mill,575,warlock,demonology,17,6,11
Heximexi,malganis,575,warlock,demonology,18,6,12
Xerxia,blackrock,575,warlock,demonology,18,6,12
Kropi,blackhand,575,warlock,demonology,18,6,12
Ragedrop,malygos,574,warlock,demonology,12,6,6
Methmuncher,twisting-nether,574,warlock,demonology,24,6,18
Petrosk,sanguino,569,warlock,demonology,12,6,6
Absurdd,turalyon,568,warlock,demonology,14,9,5
Кхадгард,howling-fjord,544,warlock,demonology,16,6,10
Gutras,ragnaros,527,warlock,demonology,11,6,5
Tvmpzwl,ravencrest,527,warlock,demonology,17,6,11
Shazem,tarren-mill,522,warlock,demonology,12,7,5
Sialri,burning-legion,522,warlock,demonology,14,7,7
Fantomass,twisting-nether,522,warlock,demonology,18,8,10
Elvània,eredar,512,warlock,demonology,10,6,4
Pinacholadá,norgannon,511,warlock,demonology,8,6,2
Dsï,outland,511,warlock,demonology,11,6,5
Никошо,gordunni,511,warlock,demonology,14,6,8
Skali,stormrage,480,warlock,demonology,6,5,1
Cheesefeet,ravencrest,480,warlock,demonology,6,5,1
Disrupted,blackmoore,480,warlock,demonology,6,5,1
Belial,minahonda,480,warlock,demonology,6,5,1
Buccellati,emerald-dream,480,warlock,demonology,6,5,1
Cadilloc,blackmoore,480,warlock,demonology,6,5,1
Morvilleur,archimonde,480,warlock,demonology,6,5,1
Hellsplat,tarren-mill,480,warlock,demonology,6,5,1
Swagzz,silvermoon,480,warlock,demonology,6,5,1
Joinx,tarren-mill,480,warlock,demonology,6,5,1
Hiloqtlock,blackmoore,480,warlock,demonology,6,5,1
Gulgash,blackrock,480,warlock,demonology,6,5,1
Fhla,kazzak,480,warlock,demonology,6,5,1
Vitalyk,sanguino,480,warlock,demonology,6,5,1
Mudwalkin,ravencrest,480,warlock,demonology,6,5,1
Фирвебало,soulflayer,480,warlock,demonology,6,5,1
Askmo,hyjal,480,warlock,demonology,6,5,1
Лираума,howling-fjord,480,warlock,demonology,9,6,3
Sîlverdîze,thrall,480,warlock,demonology,12,5,7
Msßeckinsale,tarren-mill,480,warlock,demonology,12,5,7
Cadrega,nemesis,480,warlock,demonology,12,5,7
Durátor,ravencrest,480,warlock,demonology,12,5,7
Moardôtz,tarren-mill,480,warlock,demonology,12,5,7
Hogheru,kazzak,480,warlock,demonology,12,5,7
Irnx,tarren-mill,480,warlock,demonology,12,5,7
Furchtnervt,thrall,480,warlock,demonology,12,5,7
Qzkimp,hyjal,480,warlock,demonology,12,5,7
Nécromancér,doomhammer,480,warlock,demonology,12,5,7
Zubejdaca,ragnaros,480,warlock,demonology,12,5,7
Landii,ragnaros,480,warlock,demonology,12,5,7
Nicetime,nefarian,480,warlock,demonology,12,5,7
Gulderrf,kirin-tor,480,warlock,demonology,12,5,7
Mietzekatz,stormscale,480,warlock,demonology,12,5,7
Agaton,twisting-nether,480,warlock,demonology,12,5,7
Hexendocc,blackmoore,480,warlock,demonology,12,5,7
Дотдозор,howling-fjord,480,warlock,demonology,12,5,7
Trembly,alakir,480,warlock,demonology,12,5,7
Tepelkwastje,twisting-nether,480,warlock,demonology,12,5,7
Purepkbob,quelthalas,480,warlock,demonology,12,5,7
Gulleigh,draenor,480,warlock,demonology,12,5,7
Zoodaddy,grim-batol,480,warlock,demonology,12,5,7
Bluenote,colinas-pardas,480,warlock,demonology,12,5,7
Súícìdèbøy,colinas-pardas,480,warlock,demonology,12,5,7
Philat,antonidas,480,warlock,demonology,12,5,7
Anquietas,uldaman,480,warlock,demonology,12,5,7
Kigro,burning-legion,480,warlock,demonology,12,5,7
Векстах,gordunni,480,warlock,demonology,12,5,7
Anturia,garona,480,warlock,demonology,12,5,7
Tôpsecret,aegwynn,480,warlock,demonology,12,5,7
Destroc,blackrock,480,warlock,demonology,12,5,7
Chram,uldum,480,warlock,demonology,13,5,8
Rushkush,ravencrest,480,warlock,demonology,13,5,8
Heexmex,blackmoore,480,warlock,demonology,18,5,13
Vanmorgoth,nazjatar,480,warlock,demonology,18,5,13
Brodoh,dun-modr,480,warlock,demonology,18,5,13
Ascètic,kazzak,480,warlock,demonology,18,5,13
Délidumrul,stormscale,480,warlock,demonology,18,5,13
Déemón,draenor,480,warlock,demonology,18,5,13
Kfo,ragnaros,480,warlock,demonology,18,5,13
Ezekîél,blackhand,479,warlock,demonology,6,5,1
Loriene,trollbane,479,warlock,demonology,6,5,1
Limfus,terokkar,479,warlock,demonology,6,5,1
Kedrat,die-aldor,479,warlock,demonology,6,5,1
Aluy,blackmoore,479,warlock,demonology,12,5,7
Medcit,ragnaros,479,warlock,demonology,24,5,19
Mindtrick,drakthul,477,warlock,demonology,18,5,13
Zugg,lordaeron,447,warlock,demonology,11,5,6
Mirrorz,kazzak,447,warlock,demonology,14,6,8
Dáinsleif,dun-modr,432,warlock,demonology,9,5,4
Feyras,turalyon,425,warlock,demonology,12,6,6
Sanas,blackhand,415,warlock,demonology,8,5,3
Broxsz,blackrock,415,warlock,demonology,8,5,3
Flxzshort,kazzak,384,warlock,demonology,6,4,2
Глдан,deathguard,384,warlock,demonology,6,4,2
Phoenixwrath,malfurion,384,warlock,demonology,6,4,2
Санядушнила,soulflayer,384,warlock,demonology,6,4,2
Meningitis,tyrande,384,warlock,demonology,6,4,2
Eviil,tarren-mill,384,warlock,demonology,6,4,2
Nekhar,twisting-nether,384,warlock,demonology,6,4,2
Ingwert,frostwolf,384,warlock,demonology,6,4,2
Ronazul,blackhand,384,warlock,demonology,6,4,2
Lémonz,stormscale,384,warlock,demonology,6,4,2
Keibo,drakthul,384,warlock,demonology,6,4,2
Zereff,kragjin,384,warlock,demonology,6,4,2
Imissbolt,outland,384,warlock,demonology,6,4,2
Oz,uldum,384,warlock,demonology,6,4,2
Spiritthief,kazzak,384,warlock,demonology,6,4,2
Demonkïng,archimonde,384,warlock,demonology,6,4,2
Àmæla,thrall,384,warlock,demonology,6,4,2
Cleyandra,arathor,384,warlock,demonology,6,4,2
Анвена,soulflayer,384,warlock,demonology,6,4,2
Dèsaad,stormscale,384,warlock,demonology,6,4,2
Fabz,aggra-português,384,warlock,demonology,6,4,2
Suyanne,los-errantes,384,warlock,demonology,6,4,2
Simendimen,tarren-mill,384,warlock,demonology,6,4,2
Lvko,burning-legion,384,warlock,demonology,6,4,2
Felhaen,silvermoon,384,warlock,demonology,6,4,2
Zàkx,silvermoon,384,warlock,demonology,6,4,2
Leadix,antonidas,384,warlock,demonology,6,4,2
Незерлок,soulflayer,384,warlock,demonology,6,4,2
Cosec,silvermoon,384,warlock,demonology,6,4,2
Cardyw,ravencrest,384,warlock,demonology,6,4,2
Wolfdoom,cthun,384,warlock,demonology,6,4,2
Morzár,outland,384,warlock,demonology,6,4,2
Adoxilock,twisting-nether,384,warlock,demonology,6,4,2
Coochieii,kazzak,384,warlock,demonology,6,4,2
Mayev,garrosh,384,warlock,demonology,6,4,2
Sãociprizin,archimonde,384,warlock,demonology,6,4,2
Xuloth,ravencrest,384,warlock,demonology,6,4,2
Slerpmami,ragnaros,384,warlock,demonology,6,4,2
Bualock,stormscale,384,warlock,demonology,6,4,2
Zarkasar,stormscale,384,warlock,demonology,6,4,2
Zakuri,blackmoore,384,warlock,demonology,6,4,2
Артекриолок,gordunni,384,warlock,demonology,6,4,2
Skizofrenia,zuljin,384,warlock,demonology,6,4,2
Chaoxz,outland,384,warlock,demonology,6,4,2
Yosiya,draenor,384,warlock,demonology,6,4,2
Fredé,kazzak,384,warlock,demonology,6,4,2
Holyc,blackhand,384,warlock,demonology,6,4,2
Èy,stormscale,384,warlock,demonology,6,4,2
Колмидедди,gordunni,384,warlock,demonology,6,4,2
Roglash,eredar,384,warlock,demonology,6,4,2
Aniq,eredar,384,warlock,demonology,6,4,2
Sep,aegwynn,384,warlock,demonology,6,4,2
Fearco,ravencrest,384,warlock,demonology,6,4,2
Rredington,blackmoore,384,warlock,demonology,6,4,2
Bitshlog,draenor,384,warlock,demonology,6,4,2
Acology,silvermoon,384,warlock,demonology,6,4,2
Komet,der-rat-von-dalaran,384,warlock,demonology,6,4,2
Pepitogodx,khaz-modan,384,warlock,demonology,6,4,2
Çüñ,shattered-hand,384,warlock,demonology,6,4,2
Náwwk,blackmoore,384,warlock,demonology,6,4,2
Llilithh,draenor,384,warlock,demonology,6,4,2
Âlîce,blackmoore,384,warlock,demonology,6,4,2
Хэрнор,gordunni,384,warlock,demonology,6,4,2
Karygan,blackmoore,384,warlock,demonology,6,4,2
Maleficious,silvermoon,384,warlock,demonology,6,4,2
Mbappéstylez,aegwynn,384,warlock,demonology,6,4,2
Troch,nemesis,384,warlock,demonology,6,4,2
Sêro,aegwynn,384,warlock,demonology,6,4,2
Farudai,die-aldor,384,warlock,demonology,6,4,2
Куськысь,gordunni,384,warlock,demonology,9,5,4
Kemuruss,kazzak,384,warlock,demonology,10,5,5
Tuz,blackrock,384,warlock,demonology,12,4,8
Nulo,aggra-português,384,warlock,demonology,12,4,8
Vextos,draenor,384,warlock,demonology,12,4,8
Бесстолоч,ashenvale,384,warlock,demonology,12,4,8
Мастеркрс,gordunni,384,warlock,demonology,12,4,8
Fallendex,eredar,384,warlock,demonology,12,4,8
Krútéús,perenolde,384,warlock,demonology,12,4,8
Legiozock,draenor,384,warlock,demonology,12,4,8
Birimbau,outland,384,warlock,demonology,12,4,8
Tolgaa,draenor,384,warlock,demonology,12,4,8
Xvron,tarren-mill,384,warlock,demonology,12,4,8
Babayagâ,sanguino,384,warlock,demonology,12,4,8
Hsp,dun-modr,384,warlock,demonology,12,4,8
Gorgôk,culte-de-la-rive-noire,384,warlock,demonology,12,4,8
Lagyna,wildhammer,384,warlock,demonology,12,4,8
Tharor,forscherliga,384,warlock,demonology,15,4,11
Déadwish,ravencrest,384,warlock,demonology,18,4,14
Alucena,silvermoon,384,warlock,demonology,18,4,14
Битриксс,soulflayer,383,warlock,demonology,6,4,2
Чёрныйкнижал,eversong,383,warlock,demonology,12,4,8
Sickdotter,outland,381,warlock,demonology,12,4,8
Monroé,hellfire,367,warlock,demonology,11,4,7
Nili,dethecus,351,warlock,demonology,11,4,7
Amrafel,draenor,335,warlock,demonology,15,5,10
Darkpush,outland,330,warlock,demonology,15,6,9
Cencible,twisting-nether,330,warlock,demonology,15,5,10
Divvaa,tarren-mill,330,warlock,demonology,21,5,16
Floriae,silvermoon,329,warlock,demonology,13,5,8
Shadaw,kilrogg,319,warlock,demonology,5,4,1
Atlaon,kazzak,319,warlock,demonology,5,4,1
Bëllatrïx,zuljin,288,warlock,demonology,6,3,3
Danishpistol,draenor,288,warlock,demonology,6,3,3
Karädoc,chogall,288,warlock,demonology,6,3,3
Angrynoob,silvermoon,288,warlock,demonology,6,3,3
Ммчоколадка,howling-fjord,288,warlock,demonology,6,3,3
Аркейнмизери,howling-fjord,288,warlock,demonology,6,3,3
Silås,hyjal,288,warlock,demonology,6,3,3
Slytofhandio,silvermoon,288,warlock,demonology,6,3,3
Filianore,azjolnerub,288,warlock,demonology,6,3,3
Sánas,blackhand,288,warlock,demonology,6,3,3
Curzed,emerald-dream,288,warlock,demonology,6,3,3
Holeraa,stormscale,288,warlock,demonology,6,3,3
Nineinchlock,silvermoon,288,warlock,demonology,6,3,3
Bigsuckergg,norgannon,288,warlock,demonology,6,3,3
Killidan,kelthuzad,288,warlock,demonology,6,3,3
Afflimoomoo,tarren-mill,288,warlock,demonology,6,3,3
Sofias,tarren-mill,288,warlock,demonology,6,3,3
Plocke,aegwynn,288,warlock,demonology,6,3,3
Feardinkum,twisting-nether,288,warlock,demonology,6,3,3
Alcringe,kazzak,288,warlock,demonology,6,3,3
Matheus,zenedar,288,warlock,demonology,6,3,3
Локистраик,borean-tundra,288,warlock,demonology,6,3,3
Prayz,twisting-nether,288,warlock,demonology,6,3,3
Moelock,frostmane,288,warlock,demonology,6,3,3
Гвадривер,howling-fjord,288,warlock,demonology,6,3,3
Askanios,twisting-nether,288,warlock,demonology,6,3,3
Zeromaker,kazzak,288,warlock,demonology,6,3,3
Hytsulock,ysondre,288,warlock,demonology,6,3,3
Сантизи,gordunni,288,warlock,demonology,6,3,3
Yerslock,twisting-nether,288,warlock,demonology,6,3,3
Opiumers,kazzak,288,warlock,demonology,6,3,3
Ðênnis,tarren-mill,288,warlock,demonology,6,3,3
Hifiz,grim-batol,288,warlock,demonology,6,3,3
Ноанс,howling-fjord,288,warlock,demonology,6,3,3
Wisdomness,aszune,288,warlock,demonology,6,3,3
Freshplanga,kazzak,288,warlock,demonology,6,3,3
Mekanix,kazzak,288,warlock,demonology,6,3,3
Дотботх,howling-fjord,288,warlock,demonology,6,3,3
Meleno,die-aldor,288,warlock,demonology,6,3,3
Ronniee,moonglade,288,warlock,demonology,6,3,3
Lebaa,burning-steppes,288,warlock,demonology,6,3,3
Smileyfacè,silvermoon,288,warlock,demonology,6,3,3
Hotdogvendor,kazzak,288,warlock,demonology,6,3,3
Elmîr,blackmoore,288,warlock,demonology,6,3,3
Greyz,bloodfeather,288,warlock,demonology,6,3,3
Áiram,the-maelstrom,288,warlock,demonology,6,3,3
Warlololock,magtheridon,288,warlock,demonology,6,3,3
Eredun,stormscale,288,warlock,demonology,6,3,3
Грязнобулькс,soulflayer,288,warlock,demonology,6,3,3
Talindra,stormscale,288,warlock,demonology,6,3,3
Halfwai,ravencrest,288,warlock,demonology,6,3,3
Abinsur,drakthul,288,warlock,demonology,6,3,3
Gyroib,stormscale,288,warlock,demonology,6,3,3
Buserella,eredar,288,warlock,demonology,6,3,3
Рашчер,gordunni,288,warlock,demonology,6,3,3
Necksi,archimonde,288,warlock,demonology,6,3,3
Энжелз,soulflayer,288,warlock,demonology,6,3,3
Khoug,blackmoore,288,warlock,demonology,6,3,3
Hazzikosby,ravencrest,288,warlock,demonology,6,3,3
Doomgrunt,magtheridon,288,warlock,demonology,6,3,3
Wïnärchïk,tarren-mill,288,warlock,demonology,6,3,3
Лысыйлокоть,soulflayer,288,warlock,demonology,6,3,3
Vladov,ravencrest,288,warlock,demonology,6,3,3
Bryanz,sanguino,288,warlock,demonology,6,3,3
Infernion,stormscale,288,warlock,demonology,6,3,3
Sorxez,thrall,288,warlock,demonology,6,3,3
Gjallarbrù,archimonde,288,warlock,demonology,6,3,3
Shjzzkl,blackmoore,288,warlock,demonology,6,3,3
Zlomozg,laughing-skull,288,warlock,demonology,6,3,3
Mattihoh,rexxar,288,warlock,demonology,6,3,3
Angryluna,kazzak,288,warlock,demonology,6,3,3
Waîdo,blackhand,288,warlock,demonology,6,3,3
Wombsa,blackmoore,288,warlock,demonology,6,3,3
Teemzen,tarren-mill,288,warlock,demonology,6,3,3
Shádóws,nagrand,288,warlock,demonology,6,3,3
Cainn,kilrogg,288,warlock,demonology,6,3,3
Sleethy,destromath,288,warlock,demonology,6,3,3
Sidragasoss,drakthul,288,warlock,demonology,6,3,3
Oldasian,blackrock,288,warlock,demonology,6,3,3
Zìì,silvermoon,288,warlock,demonology,6,3,3
Pidka,drakthul,288,warlock,demonology,6,3,3
Zloezlo,ravencrest,288,warlock,demonology,6,3,3
Wendetta,stormreaver,288,warlock,demonology,6,3,3
Xenq,ravencrest,288,warlock,demonology,6,3,3
Väladar,sanguino,288,warlock,demonology,6,3,3
Miselinek,drakthul,288,warlock,demonology,6,3,3
Tathyanna,archimonde,288,warlock,demonology,6,3,3
Syrax,darkmoon-faire,288,warlock,demonology,6,3,3
Osyx,ravencrest,288,warlock,demonology,6,3,3
Nopower,dun-morogh,288,warlock,demonology,9,3,6
Kàdszèle,ragnaros,288,warlock,demonology,12,3,9
Cetreros,minahonda,288,warlock,demonology,12,3,9
Surgelock,draenor,288,warlock,demonology,12,3,9
Kyyuss,burning-legion,288,warlock,demonology,12,3,9
Fyxs,talnivarr,288,warlock,demonology,12,3,9
Articfox,outland,288,warlock,demonology,12,3,9
Scheprick,twisting-nether,288,warlock,demonology,12,3,9
Assaabloy,stormscale,288,warlock,demonology,12,3,9
Stromzii,silvermoon,288,warlock,demonology,12,3,9
Clef,blackmoore,288,warlock,demonology,12,3,9
Cassen,outland,288,warlock,demonology,12,3,9
Slowfatlock,ravencrest,288,warlock,demonology,12,3,9
Ønyzukral,hyjal,288,warlock,demonology,12,3,9
Exodemon,stormscale,288,warlock,demonology,12,3,9
Morrgo,die-arguswacht,288,warlock,demonology,12,3,9
Панкмэйстер,gordunni,288,warlock,demonology,18,3,15
Hartee,argent-dawn,288,warlock,demonology,18,3,15
Lìlitu,malfurion,287,warlock,demonology,6,3,3
Dust,argent-dawn,287,warlock,demonology,12,3,9
Wieczek,doomhammer,287,warlock,demonology,12,3,9
Utuklululu,archimonde,286,warlock,demonology,12,3,9
Hasla,stormreaver,256,warlock,demonology,10,3,7
Felrazer,silvermoon,255,warlock,demonology,11,3,8
Ánderx,dun-modr,239,warlock,demonology,5,3,2
Calypso,korgall,239,warlock,demonology,5,3,2
Sallêy,blackhand,239,warlock,demonology,5,3,2
Vornex,sporeggar,234,warlock,demonology,9,4,5
Hokoreuw,echsenkessel,234,warlock,demonology,9,4,5
Watii,stormscale,234,warlock,demonology,10,4,6
Suucc,draenor,202,warlock,demonology,12,4,8
Bësly,khaz-modan,192,warlock,demonology,9,3,6
Юккасарасти,gordunni,192,warlock,demonology,6,2,4
Prestige,nemesis,192,warlock,demonology,6,2,4
Jiy,senjin,192,warlock,demonology,6,2,4
Bu,zirkel-des-cenarius,192,warlock,demonology,6,2,4
Withered,nagrand,192,warlock,demonology,6,2,4
Aratani,zuljin,192,warlock,demonology,6,2,4
Ekispekis,tarren-mill,192,warlock,demonology,6,2,4
Bountyqt,outland,192,warlock,demonology,6,2,4
Pommeslock,blackmoore,192,warlock,demonology,6,2,4
Féarléss,tarren-mill,192,warlock,demonology,6,2,4
Малдрацит,gordunni,192,warlock,demonology,6,2,4
Cali,ahnqiraj,192,warlock,demonology,6,2,4
Critchlock,tarren-mill,192,warlock,demonology,6,2,4
Ezpeazy,eredar,192,warlock,demonology,6,2,4
Ohanze,antonidas,192,warlock,demonology,6,2,4
Belzedan,blackrock,192,warlock,demonology,6,2,4
Zyréx,eredar,192,warlock,demonology,6,2,4
Retrosatanas,archimonde,192,warlock,demonology,6,2,4
Локбезног,soulflayer,192,warlock,demonology,6,2,4
Fatkkroth,ravencrest,192,warlock,demonology,6,2,4
Liwerno,dunemaul,192,warlock,demonology,6,2,4
Вериберри,gordunni,192,warlock,demonology,6,2,4
Bryanzy,dun-modr,192,warlock,demonology,6,2,4
Azurma,tarren-mill,192,warlock,demonology,6,2,4
Trimar,archimonde,192,warlock,demonology,6,2,4
Salvatoríy,outland,192,warlock,demonology,6,2,4
Darkdax,dethecus,192,warlock,demonology,6,2,4
Хэлласс,blackscar,192,warlock,demonology,6,2,4
Àbraxàs,nemesis,192,warlock,demonology,6,2,4
Kukkojapallo,ravencrest,192,warlock,demonology,6,2,4
Paintherapy,blackrock,192,warlock,demonology,6,2,4
Fearlessgødx,ravencrest,192,warlock,demonology,6,2,4
Andrealphus,outland,192,warlock,demonology,6,2,4
Denominos,ravencrest,192,warlock,demonology,6,2,4
Dotcha,ravencrest,192,warlock,demonology,6,2,4
Omegachad,draenor,192,warlock,demonology,6,2,4
Lurwina,aegwynn,192,warlock,demonology,6,2,4
Suppedo,antonidas,192,warlock,demonology,6,2,4
Mïllâïneeqtx,archimonde,192,warlock,demonology,6,2,4
Mohihi,ravencrest,192,warlock,demonology,6,2,4
Pufulet,sylvanas,192,warlock,demonology,6,2,4
Tàkaz,drekthar,192,warlock,demonology,6,2,4
Morgainé,arygos,192,warlock,demonology,6,2,4
Shirruun,the-maelstrom,192,warlock,demonology,6,2,4
Flatwolenzy,blackrock,192,warlock,demonology,6,2,4
Democraft,the-maelstrom,192,warlock,demonology,6,2,4
Minidiction,ravencrest,192,warlock,demonology,6,2,4
Kaobolt,archimonde,192,warlock,demonology,6,2,4
Anicetuslol,lightnings-blade,192,warlock,demonology,6,2,4
Nerfwarriors,stormscale,192,warlock,demonology,6,2,4
Lynnqt,sylvanas,192,warlock,demonology,6,2,4
Sneptics,draenor,192,warlock,demonology,6,2,4
Badriá,blackrock,192,warlock,demonology,6,2,4
Кощун,goldrinn,192,warlock,demonology,6,2,4
Iblis,grim-batol,192,warlock,demonology,6,2,4
Vàng,ysondre,192,warlock,demonology,6,2,4
Happysrme,thrall,192,warlock,demonology,6,2,4
Вижут,gordunni,192,warlock,demonology,6,2,4
Бешентумай,goldrinn,192,warlock,demonology,6,2,4
Balgo,blackmoore,192,warlock,demonology,6,2,4
Drith,blades-edge,192,warlock,demonology,6,2,4
Dondada,aggra-português,192,warlock,demonology,6,2,4
Бонони,blackscar,192,warlock,demonology,6,2,4
Алануэйк,deathguard,192,warlock,demonology,6,2,4
Luckylocked,kazzak,192,warlock,demonology,6,2,4
Шеизла,borean-tundra,192,warlock,demonology,6,2,4
Ribbed,frostmane,192,warlock,demonology,6,2,4
Nècrøphila,kazzak,192,warlock,demonology,6,2,4
Bigtwat,stormscale,192,warlock,demonology,6,2,4
Lykketrolle,stormscale,192,warlock,demonology,6,2,4
Nuckki,antonidas,192,warlock,demonology,6,2,4
Zxò,twisting-nether,192,warlock,demonology,6,2,4
Bytethisx,aggra-português,192,warlock,demonology,6,2,4
Fortheend,twisting-nether,192,warlock,demonology,6,2,4
Charmerx,kazzak,192,warlock,demonology,6,2,4
Sâli,draenor,192,warlock,demonology,6,2,4
Panda,aegwynn,192,warlock,demonology,6,2,4
Necronem,thrall,192,warlock,demonology,6,2,4
Vajalock,twisting-nether,192,warlock,demonology,6,2,4
Belzébut,confrérie-du-thorium,192,warlock,demonology,6,2,4
Xedras,aegwynn,192,warlock,demonology,6,2,4
Clottbott,twisting-nether,192,warlock,demonology,6,2,4
Hèrmit,kazzak,192,warlock,demonology,6,2,4
Kyyte,draenor,192,warlock,demonology,6,2,4
Oldasiangirl,blackrock,192,warlock,demonology,6,2,4
Gibbio,emerald-dream,192,warlock,demonology,6,2,4
Azgaroth,kazzak,192,warlock,demonology,6,2,4
Lockpup,draenor,192,warlock,demonology,6,2,4
Limec,dun-morogh,192,warlock,demonology,6,2,4
Lobbo,ravencrest,192,warlock,demonology,6,2,4
Hodille,argent-dawn,192,warlock,demonology,6,2,4
Nachoodude,blackrock,192,warlock,demonology,6,2,4
Meisterhexe,taerar,192,warlock,demonology,6,2,4
Kudde,twisting-nether,192,warlock,demonology,6,2,4
Gtxtreme,kazzak,192,warlock,demonology,6,2,4
Vitrolizz,twilights-hammer,192,warlock,demonology,6,2,4
Pff,emeriss,192,warlock,demonology,6,2,4
Sweëk,blackhand,192,warlock,demonology,6,2,4
Лоредо,howling-fjord,192,warlock,demonology,6,2,4
Jàckie,rexxar,192,warlock,demonology,6,2,4
Dzeju,burning-legion,192,warlock,demonology,6,2,4
Lokelicious,ragnaros,192,warlock,demonology,6,2,4
Jisera,kiljaeden,192,warlock,demonology,6,2,4
Händerå,ragnaros,192,warlock,demonology,6,2,4
Cräwley,ragnaros,192,warlock,demonology,6,2,4
Surfingbirdz,ragnaros,192,warlock,demonology,6,2,4
Branduir,ragnaros,192,warlock,demonology,6,2,4
Mirezl,taerar,192,warlock,demonology,6,2,4
Portlock,kazzak,192,warlock,demonology,6,2,4
Festlock,burning-legion,192,warlock,demonology,6,2,4
Junakot,silvermoon,192,warlock,demonology,6,2,4
Скверногрик,fordragon,192,warlock,demonology,6,2,4
Fearmighty,kazzak,192,warlock,demonology,6,2,4
Baradür,sanguino,192,warlock,demonology,6,2,4
Kelthagal,burning-legion,192,warlock,demonology,6,2,4
Pablø,silvermoon,192,warlock,demonology,6,2,4
Ebyssian,azshara,192,warlock,demonology,6,2,4
Epoku,stormscale,192,warlock,demonology,6,2,4
Portmachine,draenor,192,warlock,demonology,12,2,10
Shblakk,outland,192,warlock,demonology,12,2,10
Henriett,ravencrest,192,warlock,demonology,12,2,10
Saruna,azshara,192,warlock,demonology,12,2,10
Arciam,kazzak,192,warlock,demonology,12,2,10
Wòóni,ravencrest,192,warlock,demonology,12,2,10
Drthc,kazzak,192,warlock,demonology,12,2,10
Бестий,fordragon,192,warlock,demonology,12,2,10
Rayanna,twisting-nether,192,warlock,demonology,18,2,16
Muleerox,kazzak,159,warlock,demonology,5,2,3
Omaleinfluch,antonidas,138,warlock,demonology,9,3,6
Chaosbolts,balnazzar,138,warlock,demonology,16,3,13
Diablotiin,hyjal,128,warlock,demonology,4,2,2
Myristica,die-todeskrallen,96,warlock,demonology,3,2,1
Lovromalt,kazzak,96,warlock,demonology,6,1,5
Lockitz,kazzak,96,warlock,demonology,6,1,5
Bolt,stormscale,96,warlock,demonology,6,1,5
Ðßøhßäøùí,blackmoore,96,warlock,demonology,6,1,5
Burzak,azshara,96,warlock,demonology,6,1,5
Yourdeaath,ravencrest,96,warlock,demonology,6,1,5
Darkbazul,burning-legion,96,warlock,demonology,6,1,5
Ruvy,twisting-nether,96,warlock,demonology,6,1,5
Rrore,ravencrest,96,warlock,demonology,6,1,5
Militianu,sylvanas,96,warlock,demonology,6,1,5
Sshhaaddooww,outland,96,warlock,demonology,6,1,5
Shangalar,burning-legion,96,warlock,demonology,6,1,5
Ашимал,soulflayer,96,warlock,demonology,6,1,5
Remzin,silvermoon,96,warlock,demonology,6,1,5
Jopil,stormreaver,96,warlock,demonology,6,1,5
Méetoo,thrall,96,warlock,demonology,6,1,5
Лёхаиммолейт,deathguard,96,warlock,demonology,6,1,5
Elyraah,hyjal,96,warlock,demonology,6,1,5
Necroless,shadowsong,96,warlock,demonology,6,1,5
Dersdog,twisting-nether,96,warlock,demonology,6,1,5
Skufi,uldum,96,warlock,demonology,6,1,5
Tid,burning-legion,96,warlock,demonology,6,1,5
Hathatchi,sylvanas,96,warlock,demonology,6,1,5
Chuntlock,shadowsong,96,warlock,demonology,6,1,5
Helikipotter,kazzak,96,warlock,demonology,6,1,5
Borgenttw,stormscale,96,warlock,demonology,6,1,5
Mnscrs,blackhand,96,warlock,demonology,6,1,5
Zardonixz,stormscale,96,warlock,demonology,6,1,5
Zebauron,twisting-nether,96,warlock,demonology,6,1,5
Wetube,stormscale,96,warlock,demonology,6,1,5
Аффликатор,soulflayer,96,warlock,demonology,6,1,5
Nethros,ragnaros,96,warlock,demonology,6,1,5
Messire,ragnaros,96,warlock,demonology,6,1,5
Gnimoz,silvermoon,96,warlock,demonology,6,1,5
Zungha,pozzo-delleternità,96,warlock,demonology,6,1,5
Zangul,ysondre,96,warlock,demonology,6,1,5
Emethia,darksorrow,96,warlock,demonology,6,1,5
Nastypet,culte-de-la-rive-noire,96,warlock,demonology,6,1,5
Маверрикк,gordunni,96,warlock,demonology,6,1,5
Árkan,thrall,96,warlock,demonology,6,1,5
Däw,archimonde,96,warlock,demonology,6,1,5
Diseased,darksorrow,96,warlock,demonology,6,1,5
Томмиджонсон,gordunni,96,warlock,demonology,6,1,5
Catherine,garrosh,96,warlock,demonology,6,1,5
Fazol,terokkar,96,warlock,demonology,6,1,5
Ðæthpäct,dalaran,96,warlock,demonology,6,1,5
Marann,dun-morogh,96,warlock,demonology,6,1,5
Mulax,aegwynn,96,warlock,demonology,6,1,5
Rilette,dun-morogh,96,warlock,demonology,6,1,5
Wolramir,thrall,96,warlock,demonology,12,1,11
Kàiser,sanguino,96,warlock,demonology,12,1,11
Tchytcha,archimonde,79,warlock,demonology,5,1,4
Demiurgus,auchindoun,79,warlock,demonology,5,1,4
Boccu,magtheridon,64,warlock,demonology,4,1,3
Waryald,dun-modr,64,warlock,demonology,4,1,3
Tuchmydot,ysondre,63,warlock,demonology,2,2,0
Tequendama,ysera,42,warlock,demonology,10,3,7
Xydar,stormscale,42,warlock,demonology,10,2,8
Wartix,nathrezim,31,warlock,demonology,2,1,1
Berris,argent-dawn,31,warlock,demonology,2,1,1
Swagdots,frostwolf,31,warlock,demonology,2,1,1
Агрессивная,soulflayer,31,warlock,demonology,2,1,1
Lollock,teldrassil,31,warlock,demonology,2,1,1
Труупыч,gordunni,31,warlock,demonology,2,1,1
Hellâna,kirin-tor,31,warlock,demonology,2,1,1
Ravenmore,kazzak,16,warlock,demonology,1,1,0
Csüki,ragnaros,16,warlock,demonology,1,1,0
Loghit,ravencrest,16,warlock,demonology,1,1,0
Lzoo,ravencrest,2467,warlock,destruction,84,65,19
Creatúre,drakthul,2446,warlock,destruction,66,53,13
Inferniøn,ravencrest,2422,warlock,destruction,93,68,25
Faermorn,kazzak,2409,warlock,destruction,170,96,74
Infý,ravencrest,2400,warlock,destruction,238,151,87
Xwíng,stormscale,2399,warlock,destruction,144,90,54
Tópdogg,twisting-nether,2356,warlock,destruction,78,60,18
Шедон,soulflayer,2352,warlock,destruction,95,60,35
Jâzggz,twisting-nether,2351,warlock,destruction,96,64,32
Bfaexpert,ravencrest,2348,warlock,destruction,78,50,28
Фаерморн,blackscar,2345,warlock,destruction,132,83,49
Спаводах,soulflayer,2332,warlock,destruction,115,70,45
Sapheâ,burning-legion,2331,warlock,destruction,77,50,27
Wotlkenjoyer,ravencrest,2327,warlock,destruction,138,87,51
Steckenpferd,blackmoore,2325,warlock,destruction,66,45,21
Cryzzbad,stormscale,2319,warlock,destruction,96,62,34
Stopdaddyplz,ravencrest,2312,warlock,destruction,101,59,42
Brokenearman,defias-brotherhood,2308,warlock,destruction,53,44,9
Zâyo,ravencrest,2305,warlock,destruction,120,74,46
Erutaerc,drakthul,2303,warlock,destruction,144,86,58
Zélroth,argent-dawn,2303,warlock,destruction,217,127,90
Canabolic,stormscale,2288,warlock,destruction,102,63,39
Кириланскил,gordunni,2287,warlock,destruction,130,74,56
Geluwu,tarren-mill,2284,warlock,destruction,90,52,38
Senkai,kelthuzad,2266,warlock,destruction,72,50,22
Indraxx,hyjal,2266,warlock,destruction,110,60,50
Bualock,stormscale,2257,warlock,destruction,89,51,38
Блакхен,blackscar,2257,warlock,destruction,84,47,37
Rootzlx,ravencrest,2248,warlock,destruction,134,79,55
Acentro,stormscale,2246,warlock,destruction,83,50,33
Боуман,howling-fjord,2243,warlock,destruction,96,56,40
Шархихохо,gordunni,2242,warlock,destruction,123,68,55
Боуманн,howling-fjord,2240,warlock,destruction,141,76,65
Tjl,kazzak,2239,warlock,destruction,233,132,101
Youngtyrant,blackrock,2238,warlock,destruction,96,53,43
Xeremas,blackrock,2237,warlock,destruction,83,62,21
Lopari,aegwynn,2236,warlock,destruction,118,70,48
Shârîngan,kazzak,2225,warlock,destruction,234,137,97
Panda,aegwynn,2225,warlock,destruction,89,50,39
Кериген,gordunni,2224,warlock,destruction,90,49,41
Фримех,soulflayer,2221,warlock,destruction,95,68,27
Тагочи,gordunni,2221,warlock,destruction,279,147,132
Smoudini,blackrock,2216,warlock,destruction,78,46,32
Lyâ,ravencrest,2211,warlock,destruction,114,62,52
Anihli,kazzak,2205,warlock,destruction,383,203,180
Dæhli,argent-dawn,2204,warlock,destruction,102,56,46
Glooness,burning-legion,2203,warlock,destruction,84,47,37
Sterlock,sylvanas,2202,warlock,destruction,121,65,56
Veganlifter,ravencrest,2201,warlock,destruction,60,44,16
Bóbtown,stormscale,2200,warlock,destruction,474,255,219
Laokoon,blackmoore,2199,warlock,destruction,126,83,43
Zila,sylvanas,2199,warlock,destruction,119,63,56
Motcha,kazzak,2189,warlock,destruction,84,46,38
Amdead,sylvanas,2186,warlock,destruction,120,80,40
Ánderxyo,dun-modr,2185,warlock,destruction,54,40,14
Snapperz,stormscale,2184,warlock,destruction,162,87,75
Isodjdojk,ravencrest,2183,warlock,destruction,77,55,22
Ethiq,blackrock,2179,warlock,destruction,66,39,27
Legionlockxd,twisting-nether,2179,warlock,destruction,124,68,56
Azurma,tarren-mill,2178,warlock,destruction,107,60,47
Зеленаямразь,soulflayer,2178,warlock,destruction,157,82,75
Varaxxis,twisting-nether,2174,warlock,destruction,174,98,76
Боумонн,howling-fjord,2173,warlock,destruction,120,73,47
Ilovemimi,hyjal,2173,warlock,destruction,71,40,31
Absurdity,twisting-nether,2171,warlock,destruction,137,70,67
Hladankurac,twisting-nether,2170,warlock,destruction,78,44,34
Kerídiin,twisting-nether,2170,warlock,destruction,161,90,71
Chaosbolt,kelthuzad,2169,warlock,destruction,78,47,31
Sharhý,kazzak,2164,warlock,destruction,88,50,38
Twork,tarren-mill,2164,warlock,destruction,90,47,43
Armellixd,dun-modr,2163,warlock,destruction,92,50,42
Tierzxc,ravencrest,2162,warlock,destruction,99,58,41
Deezbolts,kazzak,2162,warlock,destruction,95,50,45
Fsandtwo,ravencrest,2160,warlock,destruction,149,90,59
Mekanix,kazzak,2160,warlock,destruction,107,61,46
Handicapped,burning-legion,2158,warlock,destruction,78,47,31
Portlock,kazzak,2158,warlock,destruction,226,122,104
Kuckacocucka,outland,2156,warlock,destruction,113,70,43
Gloon,burning-legion,2155,warlock,destruction,120,64,56
Jadesud,archimonde,2154,warlock,destruction,72,48,24
Zèlêph,archimonde,2154,warlock,destruction,192,120,72
Рашчер,gordunni,2153,warlock,destruction,119,68,51
Pepitogodx,khaz-modan,2151,warlock,destruction,132,85,47
Johanan,ravencrest,2148,warlock,destruction,53,35,18
Oarz,blackrock,2148,warlock,destruction,116,67,49
Kimkold,twisting-nether,2148,warlock,destruction,125,63,62
Yúnalesca,aegwynn,2147,warlock,destruction,149,90,59
Ìpen,bloodfeather,2146,warlock,destruction,95,54,41
Avenueat,kazzak,2145,warlock,destruction,81,43,38
Tekrowdy,blackmoore,2144,warlock,destruction,48,33,15
Soulboltx,ragnaros,2144,warlock,destruction,84,46,38
Koisk,tarren-mill,2142,warlock,destruction,82,47,35
Kresyda,dun-modr,2141,warlock,destruction,101,57,44
Arfdispo,hyjal,2140,warlock,destruction,209,110,99
Lolbadx,ravencrest,2139,warlock,destruction,72,49,23
Umbraz,blackmoore,2139,warlock,destruction,203,107,96
Lhestér,outland,2138,warlock,destruction,130,73,57
Veganlifter,blackhand,2136,warlock,destruction,72,45,27
Рауваскх,howling-fjord,2136,warlock,destruction,65,35,30
Sehk,stormreaver,2134,warlock,destruction,72,47,25
Dogdrakex,tarren-mill,2133,warlock,destruction,81,47,34
Tàkaz,drekthar,2132,warlock,destruction,136,83,53
Lockisbadx,draenor,2132,warlock,destruction,72,43,29
Rexløck,nozdormu,2132,warlock,destruction,227,133,94
Fixwarlock,blackmoore,2132,warlock,destruction,77,44,33
Эвилакс,gordunni,2131,warlock,destruction,78,50,28
Flyingjakob,argent-dawn,2131,warlock,destruction,131,70,61
Keids,silvermoon,2129,warlock,destruction,36,32,4
Fyxs,talnivarr,2129,warlock,destruction,60,42,18
Valthorion,arthas,2129,warlock,destruction,90,50,40
Ty,earthen-ring,2128,warlock,destruction,152,97,55
Bambkin,twisting-nether,2128,warlock,destruction,179,105,74
Balding,blackhand,2124,warlock,destruction,60,37,23
Kalwyn,stormscale,2123,warlock,destruction,54,39,15
Zilalol,sylvanas,2123,warlock,destruction,354,183,171
Milkywarlock,twisting-nether,2121,warlock,destruction,101,59,42
Ranath,ragnaros,2120,warlock,destruction,108,69,39
Nògg,frostwhisper,2120,warlock,destruction,66,42,24
Gulwer,blackmoore,2120,warlock,destruction,66,40,26
Vîmø,antonidas,2120,warlock,destruction,203,123,80
Válýrá,blackhand,2119,warlock,destruction,83,53,30
Артисона,gordunni,2118,warlock,destruction,89,47,42
Dayken,silvermoon,2117,warlock,destruction,63,44,19
Reznör,archimonde,2117,warlock,destruction,54,34,20
Madridistaß,outland,2116,warlock,destruction,299,155,144
Onekxz,blackrock,2115,warlock,destruction,56,45,11
Djmcwarlock,kazzak,2115,warlock,destruction,68,40,28
Brødo,dun-modr,2115,warlock,destruction,129,72,57
Guciflipflop,twisting-nether,2115,warlock,destruction,192,104,88
Lywov,stormscale,2115,warlock,destruction,132,66,66
Мспечень,howling-fjord,2112,warlock,destruction,72,46,26
Achluophobiå,ravencrest,2112,warlock,destruction,117,70,47
Abuu,ravencrest,2112,warlock,destruction,72,43,29
Xtasyslock,archimonde,2111,warlock,destruction,72,45,27
Bluefungirl,stormscale,2111,warlock,destruction,120,73,47
Гивмисоул,soulflayer,2111,warlock,destruction,88,52,36
Whakkx,blackrock,2111,warlock,destruction,114,66,48
Hasábqtja,ragnaros,2109,warlock,destruction,71,43,28
Ñia,ravencrest,2109,warlock,destruction,65,38,27
Михасяпевпев,gordunni,2109,warlock,destruction,96,54,42
Drdoit,blackrock,2109,warlock,destruction,84,46,38
Fiddyp,kazzak,2108,warlock,destruction,60,43,17
Xerxeus,drakthul,2108,warlock,destruction,66,46,20
Силорий,howling-fjord,2108,warlock,destruction,85,54,31
Metaslave,sunstrider,2107,warlock,destruction,71,49,22
Vregor,twisting-nether,2106,warlock,destruction,54,38,16
Инферналках,gordunni,2106,warlock,destruction,71,48,23
Deadpapi,outland,2106,warlock,destruction,131,82,49
Bankstair,stormscale,2105,warlock,destruction,66,44,22
Drainsouls,stormscale,2105,warlock,destruction,189,105,84
Daubi,ravencrest,2104,warlock,destruction,78,44,34
Skillførçé,kazzak,2102,warlock,destruction,54,41,13
Bk,alexstrasza,2102,warlock,destruction,65,46,19
Мишастрах,gordunni,2102,warlock,destruction,78,52,26
Wldot,ravencrest,2102,warlock,destruction,84,53,31
Humpers,kazzak,2102,warlock,destruction,103,59,44
Wester,blackmoore,2102,warlock,destruction,108,61,47
Rumour,sunstrider,2102,warlock,destruction,84,45,39
Артик,gordunni,2101,warlock,destruction,48,37,11
Kamoriwl,blackhand,2101,warlock,destruction,78,45,33
Haedache,tarren-mill,2101,warlock,destruction,143,80,63
Xfz,stormscale,2101,warlock,destruction,96,49,47
Nògg,kazzak,2101,warlock,destruction,113,57,56
Påsqúåls,ravencrest,2100,warlock,destruction,108,63,45
Nëismz,hyjal,2100,warlock,destruction,66,37,29
Deßra,stormscale,2100,warlock,destruction,90,50,40
Cigarrette,draenor,2099,warlock,destruction,84,47,37
Ez,emeriss,2097,warlock,destruction,67,50,17
Omegazero,zuluhed,2095,warlock,destruction,131,74,57
Телола,gordunni,2095,warlock,destruction,168,93,75
Boltilicious,kazzak,2094,warlock,destruction,180,96,84
Nyiks,blackhand,2088,warlock,destruction,94,53,41
Boumbye,ysondre,2086,warlock,destruction,68,42,26
Fearbîtch,ravencrest,2085,warlock,destruction,72,47,25
Healylockx,stormscale,2085,warlock,destruction,66,40,26
Kasualdot,stormscale,2083,warlock,destruction,84,46,38
Bónz,outland,2080,warlock,destruction,92,46,46
Inflicts,frostmane,2079,warlock,destruction,101,54,47
Felcamino,outland,2077,warlock,destruction,78,40,38
Tôpsecret,aegwynn,2076,warlock,destruction,60,42,18
Dabzw,twisting-nether,2075,warlock,destruction,67,43,24
Nyotu,antonidas,2072,warlock,destruction,191,106,85
Yùna,frostwolf,2071,warlock,destruction,170,92,78
Xxjz,ravencrest,2069,warlock,destruction,162,90,72
Блейдап,razuvious,2069,warlock,destruction,78,43,35
Anniefuchsia,ravencrest,2069,warlock,destruction,167,89,78
Ñøêssä,outland,2068,warlock,destruction,78,46,32
Bualock,sylvanas,2068,warlock,destruction,66,33,33
Gregwyn,hellscream,2067,warlock,destruction,72,45,27
Паилка,galakrond,2067,warlock,destruction,175,94,81
Whatamellown,aegwynn,2064,warlock,destruction,66,40,26
Voldby,kazzak,2063,warlock,destruction,304,153,151
Айхопъюдай,blackscar,2062,warlock,destruction,58,35,23
Epzi,outland,2062,warlock,destruction,65,38,27
Шархилол,gordunni,2061,warlock,destruction,53,34,19
Bewegen,frostwolf,2061,warlock,destruction,90,50,40
Gruggenbach,twisting-nether,2060,warlock,destruction,66,38,28
Djwarlock,kazzak,2060,warlock,destruction,130,68,62
Rmpfarmer,kazzak,2057,warlock,destruction,42,27,15
Соргосор,gordunni,2057,warlock,destruction,116,64,52
Ashmodéus,defias-brotherhood,2057,warlock,destruction,82,45,37
Smaúg,archimonde,2057,warlock,destruction,313,163,150
Malddog,turalyon,2056,warlock,destruction,126,72,54
Shadowrey,blackrock,2056,warlock,destruction,80,42,38
Bryanzy,dun-modr,2055,warlock,destruction,65,41,24
Vileclass,ravencrest,2055,warlock,destruction,146,79,67
Tharaqt,kazzak,2054,warlock,destruction,76,45,31
Rohyna,archimonde,2053,warlock,destruction,60,42,18
Avogeiñ,tarren-mill,2053,warlock,destruction,93,47,46
Простишутках,gordunni,2051,warlock,destruction,48,30,18
Asáel,blackrock,2051,warlock,destruction,108,62,46
Жасминдос,blackscar,2050,warlock,destruction,69,45,24
Rhüd,twisting-nether,2050,warlock,destruction,95,54,41
Velv,nagrand,2050,warlock,destruction,166,81,85
Onuurbro,kult-der-verdammten,2049,warlock,destruction,72,47,25
Кобре,howling-fjord,2048,warlock,destruction,90,52,38
Halfwai,ravencrest,2047,warlock,destruction,72,49,23
Císuh,stormreaver,2046,warlock,destruction,134,73,61
Энжелз,soulflayer,2046,warlock,destruction,107,51,56
Noobgg,kazzak,2045,warlock,destruction,174,103,71
Salvabolter,outland,2045,warlock,destruction,160,91,69
Héffer,outland,2044,warlock,destruction,121,80,41
Karygan,blackmoore,2041,warlock,destruction,95,58,37
Dersdog,twisting-nether,2039,warlock,destruction,80,42,38
Malgarøth,tarren-mill,2039,warlock,destruction,95,46,49
Kwoleriker,norgannon,2038,warlock,destruction,76,43,33
Arbusxp,norgannon,2036,warlock,destruction,72,43,29
Necorinexx,silvermoon,2035,warlock,destruction,48,27,21
Bäle,stormreaver,2035,warlock,destruction,130,71,59
Mxdojsrvqxzq,ravencrest,2035,warlock,destruction,373,195,178
Kawanoski,kazzak,2034,warlock,destruction,77,49,28
Someonepro,tarren-mill,2034,warlock,destruction,191,97,94
Araqt,thrall,2033,warlock,destruction,83,51,32
Jazggzkxx,twisting-nether,2033,warlock,destruction,59,36,23
Alxor,archimonde,2033,warlock,destruction,156,91,65
Chaosbuster,magtheridon,2033,warlock,destruction,203,115,88
Nayolana,argent-dawn,2033,warlock,destruction,111,60,51
Djdampening,bloodhoof,2031,warlock,destruction,190,111,79
Shadöwmäre,draenor,2030,warlock,destruction,90,50,40
Alphazero,zuluhed,2030,warlock,destruction,213,111,102
Sjödin,tarren-mill,2029,warlock,destruction,42,30,12
Necromanya,ravencrest,2029,warlock,destruction,192,108,84
Ниезвестнно,soulflayer,2028,warlock,destruction,65,36,29
Онлидемон,gordunni,2028,warlock,destruction,159,84,75
Тьмазвёздная,gordunni,2027,warlock,destruction,108,71,37
Châmp,stormscale,2027,warlock,destruction,73,40,33
Kaeb,archimonde,2027,warlock,destruction,66,36,30
Freezme,tarren-mill,2026,warlock,destruction,90,55,35
Buâlock,stormscale,2025,warlock,destruction,54,35,19
Simony,ravencrest,2024,warlock,destruction,66,41,25
Brodoh,dun-modr,2024,warlock,destruction,58,31,27
Tuplajekku,sylvanas,2024,warlock,destruction,130,63,67
Pørtal,aggra-português,2022,warlock,destruction,155,82,73
Chromosomex,dentarg,2021,warlock,destruction,90,54,36
Kumamoto,tarren-mill,2020,warlock,destruction,72,44,28
Nospamcliqu,ysondre,2020,warlock,destruction,83,47,36
Кюратор,howling-fjord,2019,warlock,destruction,111,63,48
Øßey,magtheridon,2018,warlock,destruction,84,46,38
Bigbolt,arathor,2017,warlock,destruction,113,61,52
Brainac,blackrock,2016,warlock,destruction,60,37,23
Andtheysay,outland,2016,warlock,destruction,266,149,117
Daeyon,ravencrest,2016,warlock,destruction,68,37,31
Jïñ,ravencrest,2015,warlock,destruction,63,47,16
Miauwu,stormscale,2015,warlock,destruction,53,38,15
Rockbèll,blackmoore,2014,warlock,destruction,66,44,22
Dótstuff,draenor,2014,warlock,destruction,54,36,18
Fearoclock,nemesis,2013,warlock,destruction,156,86,70
Laedreth,argent-dawn,2013,warlock,destruction,304,160,144
Zelieknight,ysondre,2009,warlock,destruction,545,288,257
Boltzer,archimonde,2008,warlock,destruction,155,88,67
Chromagnus,drakthul,2008,warlock,destruction,90,50,40
Простишуткаь,gordunni,2007,warlock,destruction,30,21,9
Stankaemayne,blackhand,2005,warlock,destruction,96,51,45
Rêctûmsêêkêr,ravencrest,2002,warlock,destruction,96,51,45
Vitus,malganis,2001,warlock,destruction,276,147,129
Drowlý,twisting-nether,2001,warlock,destruction,143,75,68
Aritrosyo,ravencrest,2000,warlock,destruction,36,27,9
Hlÿ,kazzak,1999,warlock,destruction,132,63,69
Габана,gordunni,1998,warlock,destruction,60,38,22
Блудгэнг,blackscar,1998,warlock,destruction,102,64,38
Kitchiarû,uldaman,1998,warlock,destruction,60,35,25
Gøzù,antonidas,1998,warlock,destruction,72,37,35
Dsï,outland,1997,warlock,destruction,131,64,67
Veridy,kazzak,1996,warlock,destruction,154,87,67
Ðiavel,kazzak,1996,warlock,destruction,143,78,65
Ripnsew,ravencrest,1994,warlock,destruction,77,49,28
Фейкгодх,soulflayer,1994,warlock,destruction,102,53,49
Gorillabolts,tarren-mill,1994,warlock,destruction,126,59,67
Bladey,ragnaros,1993,warlock,destruction,280,152,128
Vvj,ravencrest,1991,warlock,destruction,224,116,108
Exephia,laughing-skull,1991,warlock,destruction,84,40,44
Klnr,ravencrest,1990,warlock,destruction,134,79,55
Kelthedral,tarren-mill,1990,warlock,destruction,154,80,74
Upsahl,twisting-nether,1988,warlock,destruction,153,86,67
Anthraxus,argent-dawn,1988,warlock,destruction,84,43,41
Gødprotøtýpe,ragnaros,1985,warlock,destruction,65,34,31
Icéspícé,ravencrest,1984,warlock,destruction,54,28,26
Logicdotexé,tarren-mill,1983,warlock,destruction,67,42,25
Deathfløw,draenor,1983,warlock,destruction,144,90,54
Nyriat,tarren-mill,1982,warlock,destruction,90,60,30
Gymenjoyer,ravencrest,1979,warlock,destruction,96,59,37
Andrewdaniel,twisting-nether,1979,warlock,destruction,72,39,33
Sqx,veklor,1978,warlock,destruction,60,39,21
Blazed,dentarg,1978,warlock,destruction,60,36,24
Beebs,aegwynn,1977,warlock,destruction,58,40,18
Файрусх,soulflayer,1976,warlock,destruction,72,39,33
Mýlìfêbélike,kazzak,1975,warlock,destruction,46,32,14
Fearo,kazzak,1975,warlock,destruction,172,94,78
Hotdoghomie,tarren-mill,1974,warlock,destruction,36,28,8
Gnargamehl,nemesis,1973,warlock,destruction,66,39,27
Ñila,ravencrest,1973,warlock,destruction,51,30,21
Laciewaifu,silvermoon,1973,warlock,destruction,73,41,32
Ryûsuke,dun-modr,1972,warlock,destruction,119,65,54
Failtráin,blackhand,1972,warlock,destruction,65,35,30
Zarisya,blackmoore,1972,warlock,destruction,108,58,50
Тевон,gordunni,1971,warlock,destruction,117,70,47
Fercon,kazzak,1971,warlock,destruction,104,59,45
Tarilinwelli,les-sentinelles,1970,warlock,destruction,46,42,4
Sgaitxd,ravencrest,1969,warlock,destruction,48,27,21
Feardotbye,stormscale,1969,warlock,destruction,72,40,32
Чудастрх,azuregos,1969,warlock,destruction,156,81,75
Lifetapped,tarren-mill,1968,warlock,destruction,89,48,41
Взорг,soulflayer,1968,warlock,destruction,189,100,89
Èmøgøðqt,ravencrest,1968,warlock,destruction,66,33,33
Pôhzz,archimonde,1967,warlock,destruction,48,34,14
Якурюимнепох,gordunni,1967,warlock,destruction,243,132,111
Garlan,dun-modr,1967,warlock,destruction,316,168,148
Infernion,stormscale,1966,warlock,destruction,45,30,15
Exhäle,archimonde,1966,warlock,destruction,59,37,22
Acilock,outland,1966,warlock,destruction,68,42,26
Aniq,eredar,1965,warlock,destruction,72,37,35
Bryanz,sanguino,1965,warlock,destruction,141,70,71
Superlocken,ragnaros,1964,warlock,destruction,95,47,48
Korbendallas,anubarak,1963,warlock,destruction,75,41,34
Howtofake,doomhammer,1962,warlock,destruction,72,38,34
Theronas,tarren-mill,1961,warlock,destruction,66,39,27
Ragdoll,twisting-nether,1960,warlock,destruction,70,40,30
Southyx,stormscale,1960,warlock,destruction,84,46,38
Biest,drakthul,1959,warlock,destruction,121,64,57
Lémonz,stormscale,1958,warlock,destruction,64,33,31
Angst,tarren-mill,1957,warlock,destruction,66,43,23
Taon,ravencrest,1957,warlock,destruction,90,52,38
Osîrîs,aegwynn,1957,warlock,destruction,131,64,67
Rune,aegwynn,1956,warlock,destruction,154,87,67
Габаныч,soulflayer,1955,warlock,destruction,69,45,24
Хастла,ashenvale,1955,warlock,destruction,102,56,46
Бжк,gordunni,1955,warlock,destruction,359,192,167
Xiraq,nathrezim,1954,warlock,destruction,90,49,41
Сумракк,gordunni,1954,warlock,destruction,66,35,31
Syviwl,outland,1954,warlock,destruction,77,37,40
Kärme,archimonde,1953,warlock,destruction,66,42,24
Hømïcîðæl,ravencrest,1953,warlock,destruction,72,45,27
Isco,ysondre,1953,warlock,destruction,42,26,16
Ashlÿn,draenor,1952,warlock,destruction,47,31,16
Nekrofille,outland,1952,warlock,destruction,60,30,30
Kaldrik,burning-legion,1951,warlock,destruction,102,62,40
Laolife,twisting-nether,1951,warlock,destruction,132,67,65
Hopéléss,aggra-português,1950,warlock,destruction,42,31,11
Ilbidello,nemesis,1950,warlock,destruction,60,40,20
Xesh,kiljaeden,1950,warlock,destruction,276,140,136
Nightìngale,silvermoon,1949,warlock,destruction,85,45,40
Tschapatalpi,blackhand,1947,warlock,destruction,70,35,35
Wlistoohard,stormscale,1946,warlock,destruction,243,130,113
Delru,aegwynn,1945,warlock,destruction,60,38,22
Plocke,aegwynn,1944,warlock,destruction,42,25,17
Jøkèr,stormscale,1943,warlock,destruction,30,21,9
Jaimstar,ravencrest,1943,warlock,destruction,47,31,16
Сильвиос,howling-fjord,1943,warlock,destruction,100,49,51
Sarthrax,argent-dawn,1942,warlock,destruction,120,70,50
Corbbolt,drakthul,1942,warlock,destruction,114,60,54
Hebbxw,kazzak,1941,warlock,destruction,176,101,75
Gogmorok,dunemaul,1941,warlock,destruction,341,173,168
Badloljk,stormscale,1940,warlock,destruction,52,34,18
Freddaxd,outland,1940,warlock,destruction,93,56,37
Nazw,ravencrest,1939,warlock,destruction,47,31,16
Lsr,argent-dawn,1939,warlock,destruction,83,48,35
Bløødwins,burning-legion,1938,warlock,destruction,71,44,27
Redshíne,hyjal,1938,warlock,destruction,72,43,29
Raxan,stormscale,1937,warlock,destruction,101,56,45
Giñtama,ravencrest,1936,warlock,destruction,30,24,6
Suprezz,sylvanas,1936,warlock,destruction,78,45,33
Кенгарь,howling-fjord,1936,warlock,destruction,153,80,73
Mohihi,ravencrest,1934,warlock,destruction,84,42,42
Løckwood,blackrock,1933,warlock,destruction,52,32,20
Nellyvato,eredar,1933,warlock,destruction,166,85,81
Gilfhaunter,malganis,1932,warlock,destruction,30,23,7
Ruvy,twisting-nether,1932,warlock,destruction,63,37,26
Envizer,ravencrest,1931,warlock,destruction,48,30,18
Tikondrus,ravencrest,1930,warlock,destruction,96,53,43
Ayperos,tyrande,1930,warlock,destruction,108,59,49
Ðeface,nefarian,1929,warlock,destruction,144,79,65
Wällaar,ragnaros,1929,warlock,destruction,191,102,89
Obrusik,burning-legion,1929,warlock,destruction,143,68,75
Kayloo,archimonde,1928,warlock,destruction,78,48,30
Staenkymayne,blackhand,1927,warlock,destruction,28,21,7
Killua,kazzak,1927,warlock,destruction,59,43,16
Fornaio,nemesis,1927,warlock,destruction,36,24,12
Ulora,zirkel-des-cenarius,1927,warlock,destruction,113,62,51
Doturanal,blackmoore,1927,warlock,destruction,108,57,51
Wäisted,ravencrest,1926,warlock,destruction,72,39,33
Tehkorrum,archimonde,1926,warlock,destruction,83,41,42
Macchíato,ragnaros,1925,warlock,destruction,84,44,40
Davyjonessx,twisting-nether,1923,warlock,destruction,158,75,83
Fredé,kazzak,1923,warlock,destruction,77,36,41
Laoganma,outland,1921,warlock,destruction,36,27,9
Sad,lightnings-blade,1920,warlock,destruction,132,76,56
Sakkrethxd,hyjal,1919,warlock,destruction,47,32,15
Bedep,sanguino,1919,warlock,destruction,36,24,12
Acanthis,outland,1919,warlock,destruction,96,47,49
Imbalockzwei,aegwynn,1918,warlock,destruction,60,42,18
Stefcheto,twilights-hammer,1916,warlock,destruction,221,114,107
Кишмякхб,howling-fjord,1916,warlock,destruction,198,96,102
Blakstorm,archimonde,1915,warlock,destruction,60,35,25
Decimus,darkspear,1914,warlock,destruction,156,87,69
Makîø,hyjal,1914,warlock,destruction,208,105,103
Rénio,stormrage,1913,warlock,destruction,68,41,27
Malame,hyjal,1912,warlock,destruction,286,154,132
Aajora,malganis,1911,warlock,destruction,136,87,49
Drututt,the-maelstrom,1910,warlock,destruction,54,30,24
Sëngir,drakthul,1910,warlock,destruction,384,191,193
Senbolts,tarren-mill,1909,warlock,destruction,66,39,27
Drerlord,tarren-mill,1908,warlock,destruction,130,74,56
Xunzu,drakthul,1907,warlock,destruction,126,61,65
Jopil,stormreaver,1907,warlock,destruction,93,44,49
Artys,tarren-mill,1906,warlock,destruction,54,36,18
Voidstim,stormscale,1906,warlock,destruction,135,70,65
Magonyth,tarren-mill,1905,warlock,destruction,67,47,20
Carelock,chamber-of-aspects,1905,warlock,destruction,66,39,27
Raepist,terokkar,1905,warlock,destruction,78,46,32
Debbskidjur,tarren-mill,1905,warlock,destruction,97,57,40
Isuckwarlock,aegwynn,1904,warlock,destruction,90,42,48
Precogdiet,draenor,1903,warlock,destruction,36,28,8
Xarfoul,grim-batol,1903,warlock,destruction,54,36,18
Southylolz,stormscale,1902,warlock,destruction,54,32,22
Ignittes,ragnaros,1901,warlock,destruction,84,56,28
Nunomendes,archimonde,1901,warlock,destruction,60,37,23
Nineinchlock,silvermoon,1900,warlock,destruction,72,33,39
Sinthax,aegwynn,1899,warlock,destruction,102,65,37
Mafteryo,blackrock,1899,warlock,destruction,102,54,48
Drtwoit,blackrock,1898,warlock,destruction,30,20,10
Osbaa,bladefist,1898,warlock,destruction,65,41,24
Файрик,blackscar,1897,warlock,destruction,42,26,16
Инсинирейтх,gordunni,1896,warlock,destruction,66,40,26
Benne,stormscale,1896,warlock,destruction,108,60,48
Kaktakto,ravencrest,1895,warlock,destruction,54,30,24
Djfearfullx,archimonde,1893,warlock,destruction,123,71,52
Magonyth,ravencrest,1893,warlock,destruction,340,174,166
Hellíc,kazzak,1892,warlock,destruction,48,30,18
Extingul,tarren-mill,1892,warlock,destruction,77,48,29
Temnamagna,silvermoon,1892,warlock,destruction,189,103,86
Nádjá,ravencrest,1891,warlock,destruction,30,20,10
Supergeîl,blackrock,1891,warlock,destruction,114,58,56
Meepx,nordrassil,1890,warlock,destruction,36,20,16
Dualla,aegwynn,1890,warlock,destruction,182,101,81
Mallevs,outland,1888,warlock,destruction,169,97,72
Juhpz,blackrock,1888,warlock,destruction,52,24,28
Djfearbot,kazzak,1887,warlock,destruction,84,53,31
Juppi,blackrock,1887,warlock,destruction,198,114,84
Klmlover,tarren-mill,1885,warlock,destruction,48,30,18
Dotg,blackrock,1885,warlock,destruction,54,30,24
Ecoxx,aegwynn,1884,warlock,destruction,54,37,17
Whøîäm,kazzak,1883,warlock,destruction,42,31,11
Hânex,ravencrest,1883,warlock,destruction,48,28,20
Doomdog,hyjal,1882,warlock,destruction,36,25,11
Wimbii,outland,1882,warlock,destruction,30,20,10
Кишмякхб,gordunni,1880,warlock,destruction,112,54,58
Меззаморта,gordunni,1879,warlock,destruction,24,20,4
Visceris,ravencrest,1879,warlock,destruction,108,51,57
Whisperer,defias-brotherhood,1879,warlock,destruction,112,52,60
Baked,outland,1878,warlock,destruction,48,31,17
Rabasta,blackmoore,1878,warlock,destruction,71,36,35
Shangalar,burning-legion,1877,warlock,destruction,126,66,60
Kalagorn,azshara,1876,warlock,destruction,42,30,12
Шрэкс,blackscar,1876,warlock,destruction,56,30,26
Kmeta,twilights-hammer,1876,warlock,destruction,120,55,65
Eboyclass,twisting-nether,1875,warlock,destruction,33,23,10
Èlton,tarren-mill,1875,warlock,destruction,249,135,114
Fîgøk,conseil-des-ombres,1874,warlock,destruction,156,86,70
Immaginare,sylvanas,1874,warlock,destruction,222,120,102
Fizzydark,malganis,1874,warlock,destruction,78,37,41
Junakot,silvermoon,1873,warlock,destruction,102,55,47
Halaïa,outland,1872,warlock,destruction,52,34,18
Ðènnis,tarren-mill,1870,warlock,destruction,42,28,14
Ditàà,archimonde,1870,warlock,destruction,77,49,28
Gis,laughing-skull,1870,warlock,destruction,95,50,45
Worse,kazzak,1869,warlock,destruction,54,32,22
Dooms,antonidas,1868,warlock,destruction,42,31,11
Jamb,bloodfeather,1867,warlock,destruction,42,27,15
Кварий,howling-fjord,1867,warlock,destruction,288,146,142
Аоепампгодх,howling-fjord,1866,warlock,destruction,82,58,24
Tokodi,ragnaros,1866,warlock,destruction,84,46,38
Horststenzl,blackrock,1866,warlock,destruction,60,29,31
Öbsury,hyjal,1865,warlock,destruction,109,61,48
Kikeri,blackhand,1865,warlock,destruction,90,48,42
Sheitana,ysondre,1863,warlock,destruction,72,45,27
Rokkarn,kazzak,1863,warlock,destruction,48,29,19
Колодун,gordunni,1863,warlock,destruction,60,35,25
Belial,minahonda,1863,warlock,destruction,69,40,29
Zàkx,silvermoon,1863,warlock,destruction,355,188,167
Sizexl,silvermoon,1862,warlock,destruction,42,30,12
Pandacoffee,ravencrest,1861,warlock,destruction,131,76,55
Thebigsuck,tarren-mill,1861,warlock,destruction,156,90,66
Felerok,drakthul,1860,warlock,destruction,42,27,15
Trainindummy,ravencrest,1859,warlock,destruction,128,85,43
Phoyk,blackmoore,1859,warlock,destruction,48,29,19
Rustos,ravencrest,1859,warlock,destruction,123,72,51
Slipx,aegwynn,1859,warlock,destruction,94,53,41
Muleerox,kazzak,1859,warlock,destruction,78,41,37
Demonälskare,kazzak,1857,warlock,destruction,48,31,17
Fullxlock,hyjal,1857,warlock,destruction,58,35,23
Adacheezzee,tyrande,1857,warlock,destruction,104,59,45
Lecig,tarren-mill,1856,warlock,destruction,30,23,7
Sushilock,stormrage,1856,warlock,destruction,96,62,34
Mowxll,blackrock,1856,warlock,destruction,36,22,14
Holiax,archimonde,1856,warlock,destruction,48,29,19
Bréézéé,twisting-nether,1856,warlock,destruction,113,63,50
Cmdxo,malganis,1856,warlock,destruction,71,38,33
Salvatoríy,outland,1856,warlock,destruction,65,32,33
Shlipshlap,ravencrest,1855,warlock,destruction,71,43,28
Reeween,argent-dawn,1855,warlock,destruction,132,76,56
Bono,frostwhisper,1854,warlock,destruction,121,73,48
Habdruck,blackmoore,1854,warlock,destruction,427,232,195
Boltez,twisting-nether,1854,warlock,destruction,66,35,31
Darksoll,hyjal,1853,warlock,destruction,41,31,10
Shadewl,draenor,1853,warlock,destruction,70,45,25
Plaguee,outland,1853,warlock,destruction,98,56,42
Gharloch,argent-dawn,1853,warlock,destruction,81,46,35
Bóbtownjr,ravencrest,1853,warlock,destruction,54,30,24
Uddze,pozzo-delleternità,1853,warlock,destruction,167,88,79
Nëismz,ravencrest,1852,warlock,destruction,43,27,16
Chaoscrit,eredar,1852,warlock,destruction,177,94,83
Блэкфлэймх,gordunni,1852,warlock,destruction,70,33,37
Märkähuikka,stormreaver,1851,warlock,destruction,60,38,22
Gigachaos,outland,1851,warlock,destruction,179,108,71
Fakegodx,ravencrest,1851,warlock,destruction,65,35,30
Anabolicbaby,draenor,1850,warlock,destruction,36,26,10
Johnylock,draenor,1850,warlock,destruction,116,71,45
Tentigo,blackmoore,1850,warlock,destruction,90,45,45
Depressedkid,ravencrest,1850,warlock,destruction,60,30,30
Corano,ravencrest,1849,warlock,destruction,42,28,14
Bwc,aegwynn,1849,warlock,destruction,78,49,29
Alphå,blackmoore,1849,warlock,destruction,78,48,30
Satyrilian,tarren-mill,1849,warlock,destruction,71,42,29
Wÿvërnn,archimonde,1849,warlock,destruction,163,91,72
Çamille,ulduar,1849,warlock,destruction,115,64,51
Artannas,elune,1848,warlock,destruction,55,35,20
Руктал,howling-fjord,1847,warlock,destruction,54,34,20
Watchmecutt,terenas,1847,warlock,destruction,54,31,23
Bailerlock,antonidas,1847,warlock,destruction,60,28,32
Luccifer,ravencrest,1845,warlock,destruction,36,25,11
Cetreros,minahonda,1845,warlock,destruction,54,34,20
Giantape,argent-dawn,1844,warlock,destruction,66,43,23
Jupp,blackrock,1843,warlock,destruction,142,77,65
Hifiz,grim-batol,1842,warlock,destruction,36,25,11
Imforcedtowl,aegwynn,1842,warlock,destruction,48,32,16
Enragelock,tarren-mill,1842,warlock,destruction,119,76,43
Collectiòn,kazzak,1842,warlock,destruction,36,22,14
Хихихи,blackscar,1842,warlock,destruction,78,43,35
Looneytoonz,blackrock,1842,warlock,destruction,96,52,44
Pöhz,archimonde,1841,warlock,destruction,96,45,51
Mércé,stormscale,1840,warlock,destruction,36,26,10
Badapow,stormscale,1840,warlock,destruction,50,26,24
Attilergg,stormscale,1839,warlock,destruction,32,23,9
Richerdgir,ravencrest,1839,warlock,destruction,105,57,48
Fluxlight,frostmourne,1838,warlock,destruction,42,22,20
Ispankmysuc,korgall,1836,warlock,destruction,69,42,27
Shadock,scarshield-legion,1836,warlock,destruction,102,59,43
Hachishaku,ravencrest,1836,warlock,destruction,165,93,72
Märtas,burning-blade,1836,warlock,destruction,143,79,64
Vøid,hellscream,1836,warlock,destruction,131,62,69
Bobop,sanguino,1834,warlock,destruction,106,60,46
Invoke,burning-blade,1834,warlock,destruction,54,30,24
Кром,howling-fjord,1834,warlock,destruction,48,26,22
Brainwashed,the-maelstrom,1834,warlock,destruction,205,110,95
Entropyboost,stormscale,1834,warlock,destruction,138,73,65
Secretx,kazzak,1833,warlock,destruction,42,24,18
Spookytouch,draenor,1833,warlock,destruction,106,52,54
Asyncbuddy,azjolnerub,1832,warlock,destruction,48,32,16
Oldasianman,blackrock,1832,warlock,destruction,30,20,10
Chaosxd,outland,1832,warlock,destruction,58,37,21
Homerbamboom,hyjal,1832,warlock,destruction,77,49,28
Kiwibob,defias-brotherhood,1832,warlock,destruction,65,41,24
Skarløck,blackmoore,1832,warlock,destruction,42,26,16
Calli,blackrock,1832,warlock,destruction,52,32,20
Фирбог,soulflayer,1832,warlock,destruction,84,43,41
Aestheatic,draenor,1832,warlock,destruction,299,152,147
Marti,blackrock,1831,warlock,destruction,60,39,21
Ashh,ravencrest,1831,warlock,destruction,48,26,22
Wreky,thrall,1830,warlock,destruction,36,26,10
Dübêl,gorgonnash,1830,warlock,destruction,54,35,19
Akechy,dun-modr,1830,warlock,destruction,123,75,48
Worgonzolâ,madmortem,1830,warlock,destruction,221,134,87
Алистрен,fordragon,1830,warlock,destruction,179,99,80
Nekrosd,tarren-mill,1830,warlock,destruction,215,111,104
Teezeye,ragnaros,1830,warlock,destruction,118,59,59
Tõyz,twilights-hammer,1829,warlock,destruction,45,34,11
Veríty,kazzak,1829,warlock,destruction,30,20,10
Evlwizardman,kazzak,1829,warlock,destruction,50,32,18
Manhart,burning-legion,1829,warlock,destruction,70,40,30
Salouppio,archimonde,1829,warlock,destruction,88,48,40
Ícekíss,hyjal,1828,warlock,destruction,48,33,15
Pprwl,tarren-mill,1828,warlock,destruction,126,77,49
Latia,argent-dawn,1828,warlock,destruction,46,28,18
Urururustyle,hyjal,1828,warlock,destruction,102,58,44
Хэлмок,howling-fjord,1827,warlock,destruction,42,31,11
Cappaoww,ravencrest,1827,warlock,destruction,36,25,11
Idonthexafck,kazzak,1826,warlock,destruction,36,27,9
Spectarlock,tarren-mill,1826,warlock,destruction,78,43,35
Delen,ravencrest,1826,warlock,destruction,58,28,30
Oldefar,ravencrest,1825,warlock,destruction,48,30,18
Oggelock,tarren-mill,1825,warlock,destruction,79,45,34
Benganqt,kazzak,1825,warlock,destruction,242,137,105
Wewondak,drakthul,1825,warlock,destruction,214,120,94
Büm,kazzak,1825,warlock,destruction,132,70,62
Juanwick,grim-batol,1824,warlock,destruction,43,33,10
Asilock,eredar,1824,warlock,destruction,48,32,16
Анрали,deathguard,1824,warlock,destruction,42,27,15
Ìambottger,silvermoon,1824,warlock,destruction,48,30,18
Zoodíac,blackrock,1824,warlock,destruction,69,42,27
Minicielle,ravencrest,1824,warlock,destruction,36,21,15
Limity,nozdormu,1823,warlock,destruction,90,54,36
Coeurnichon,archimonde,1823,warlock,destruction,58,32,26
Spcnz,stormscale,1823,warlock,destruction,144,78,66
Tseva,aggra-português,1823,warlock,destruction,84,42,42
Sololock,ravencrest,1822,warlock,destruction,106,63,43
Jjejo,ragnaros,1822,warlock,destruction,100,59,41
Røiheenøk,archimonde,1822,warlock,destruction,156,80,76
Кале,goldrinn,1821,warlock,destruction,136,87,49
Killáksi,ravencrest,1821,warlock,destruction,42,26,16
Atmosfèar,silvermoon,1821,warlock,destruction,66,37,29
Likeqtz,thrall,1821,warlock,destruction,80,43,37
Hellfire,haomarush,1821,warlock,destruction,86,46,40
Stepwarlock,kazzak,1821,warlock,destruction,81,42,39
Framelock,draenor,1820,warlock,destruction,48,37,11
Korupcijax,kazzak,1820,warlock,destruction,36,21,15
Hauntit,chogall,1820,warlock,destruction,36,21,15
Merçedesa,tarren-mill,1820,warlock,destruction,35,20,15
Trashløckx,blackrock,1819,warlock,destruction,42,30,12
Mocha,ravencrest,1819,warlock,destruction,48,31,17
Incesticide,ragnaros,1819,warlock,destruction,60,37,23
Lyaru,blackrock,1819,warlock,destruction,44,25,19
Ôlo,rajaxx,1819,warlock,destruction,54,30,24
Исверон,howling-fjord,1819,warlock,destruction,78,41,37
Fearing,malganis,1819,warlock,destruction,101,51,50
Rozibolt,draenor,1818,warlock,destruction,48,33,15
Lichlolock,outland,1818,warlock,destruction,96,60,36
Selassie,blackmoore,1818,warlock,destruction,78,48,30
Kiros,ravencrest,1818,warlock,destruction,55,33,22
Лешабетон,gordunni,1818,warlock,destruction,34,20,14
Shánx,hyjal,1818,warlock,destruction,66,38,28
Nqa,outland,1818,warlock,destruction,47,26,21
Ziigouigouii,archimonde,1817,warlock,destruction,42,28,14
Лёхаиммолейт,deathguard,1817,warlock,destruction,54,30,24
Verson,silvermoon,1817,warlock,destruction,125,69,56
Srkzlol,durotan,1817,warlock,destruction,66,35,31
Влицотьмой,gordunni,1817,warlock,destruction,84,42,42
Nëismz,azuremyst,1816,warlock,destruction,36,25,11
Unethicalx,ragnaros,1816,warlock,destruction,113,65,48
Alcringe,kazzak,1816,warlock,destruction,158,90,68
Porchpirate,draenor,1816,warlock,destruction,72,41,31
Аймох,gordunni,1816,warlock,destruction,54,30,24
Yukokotier,archimonde,1816,warlock,destruction,323,172,151
Empra,stormscale,1816,warlock,destruction,54,28,26
Matsuei,tarren-mill,1816,warlock,destruction,48,23,25
Aldiac,aegwynn,1815,warlock,destruction,36,25,11
Barneyboi,tarren-mill,1815,warlock,destruction,87,59,28
Louloudots,ragnaros,1815,warlock,destruction,36,22,14
Kartanos,stormscale,1815,warlock,destruction,63,34,29
Бауглирх,howling-fjord,1815,warlock,destruction,161,84,77
Magicsin,aerie-peak,1814,warlock,destruction,36,31,5
Jappér,silvermoon,1814,warlock,destruction,36,30,6
Olsel,draenor,1814,warlock,destruction,47,30,17
Nemwl,draenor,1814,warlock,destruction,66,31,35
Coilxo,ravencrest,1813,warlock,destruction,58,37,21
Doodle,the-maelstrom,1813,warlock,destruction,66,38,28
Tbs,blackhand,1813,warlock,destruction,54,25,29
Slytherim,stormscale,1812,warlock,destruction,87,57,30
Osbaa,ravencrest,1812,warlock,destruction,116,62,54
Majalea,antonidas,1811,warlock,destruction,30,23,7
Overwl,kazzak,1811,warlock,destruction,42,32,10
Fiearstyle,tarren-mill,1811,warlock,destruction,36,26,10
Linuviel,argent-dawn,1811,warlock,destruction,41,29,12
Kennÿfõx,ysondre,1811,warlock,destruction,29,20,9
Zàk,twisting-nether,1811,warlock,destruction,121,77,44
Krestox,blackmoore,1811,warlock,destruction,100,60,40
Паинбрингер,soulflayer,1811,warlock,destruction,96,54,42
Trooverx,ravencrest,1810,warlock,destruction,59,40,19
Mxxmmllm,kargath,1810,warlock,destruction,125,71,54
Melydor,ragnaros,1810,warlock,destruction,111,62,49
Fearbeachx,ravencrest,1810,warlock,destruction,54,30,24
Diablist,kazzak,1810,warlock,destruction,142,77,65
Хйу,galakrond,1810,warlock,destruction,60,26,34
Boterham,kilrogg,1809,warlock,destruction,54,38,16
Dotshok,aegwynn,1809,warlock,destruction,102,56,46
Cujo,draenor,1809,warlock,destruction,354,173,181
Pederpan,stormscale,1808,warlock,destruction,30,19,11
Skrana,kazzak,1808,warlock,destruction,83,48,35
Чупачупакаб,soulflayer,1808,warlock,destruction,59,34,25
Darkleci,archimonde,1808,warlock,destruction,60,34,26
Рипхард,soulflayer,1808,warlock,destruction,62,35,27
Haltros,stormscale,1808,warlock,destruction,48,26,22
Грэтиэн,howling-fjord,1808,warlock,destruction,369,197,172
Noomaca,drakthul,1808,warlock,destruction,295,149,146
Purexlock,dragonblight,1807,warlock,destruction,53,34,19
Catchlock,tarren-mill,1807,warlock,destruction,42,26,16
Exorbïtant,blackrock,1807,warlock,destruction,312,167,145
Rhyakun,draenor,1806,warlock,destruction,51,33,18
Ahuicommem,hyjal,1806,warlock,destruction,55,33,22
Kakapo,archimonde,1806,warlock,destruction,65,38,27
Abbzey,tarren-mill,1806,warlock,destruction,132,70,62
Rûttna,kazzak,1806,warlock,destruction,53,27,26
Pumpelumpe,twisting-nether,1806,warlock,destruction,45,20,25
Yøshinø,wildhammer,1805,warlock,destruction,48,36,12
Rünek,tarren-mill,1805,warlock,destruction,42,29,13
Lockchonk,kazzak,1805,warlock,destruction,84,52,32
Rivmuu,argent-dawn,1805,warlock,destruction,130,78,52
Tanón,sanguino,1804,warlock,destruction,87,57,30
Sïeur,archimonde,1804,warlock,destruction,113,69,44
Silmerion,twilights-hammer,1804,warlock,destruction,132,74,58
Shortíì,thrall,1804,warlock,destruction,48,26,22
Demojun,silvermoon,1804,warlock,destruction,282,150,132
Pinacoládaqt,stormscale,1804,warlock,destruction,59,31,28
Letmecast,sylvanas,1803,warlock,destruction,36,22,14
Plâytïmè,stormscale,1803,warlock,destruction,126,61,65
Nerdlockx,tarren-mill,1802,warlock,destruction,47,31,16
Loel,blackrock,1802,warlock,destruction,36,23,13
Pornhubx,stormscale,1802,warlock,destruction,48,30,18
Pilock,stormscale,1802,warlock,destruction,36,22,14
Flatwolenzy,blackrock,1802,warlock,destruction,48,29,19
Zekarat,blackrock,1802,warlock,destruction,129,70,59
Britneÿ,stormscale,1802,warlock,destruction,60,29,31
Morcey,sylvanas,1801,warlock,destruction,79,49,30
Helldoom,drakthul,1801,warlock,destruction,259,129,130
Tuskawl,stormreaver,1800,warlock,destruction,36,22,14
Plsbuffme,ravencrest,1800,warlock,destruction,77,47,30
Моргоника,howling-fjord,1800,warlock,destruction,121,65,56
Tenkem,dun-modr,1800,warlock,destruction,129,69,60
Mirenli,kazzak,1800,warlock,destruction,36,19,17
Twisted,malganis,1800,warlock,destruction,132,69,63
Sluba,stormscale,1800,warlock,destruction,127,66,61
Kavalierr,stormscale,1800,warlock,destruction,151,78,73
Ðemonsoul,stormscale,1800,warlock,destruction,548,275,273
Lashyra,aszune,1800,warlock,destruction,48,24,24
Variu,blackhand,1799,warlock,destruction,206,118,88
Mosslock,silvermoon,1798,warlock,destruction,30,19,11
Atraped,zuljin,1797,warlock,destruction,370,199,171
Anomen,sanguino,1797,warlock,destruction,141,74,67
Qaripidia,ravencrest,1796,warlock,destruction,55,29,26
Djhanzó,outland,1795,warlock,destruction,57,30,27
Maderto,burning-legion,1793,warlock,destruction,191,103,88
Høliax,archimonde,1792,warlock,destruction,54,36,18
Happsõr,eredar,1792,warlock,destruction,48,30,18
Bàbyløck,archimonde,1792,warlock,destruction,78,44,34
Médeâ,ravencrest,1792,warlock,destruction,88,47,41
Robertóó,burning-legion,1792,warlock,destruction,64,34,30
Nantu,stormscale,1792,warlock,destruction,66,34,32
Adellaragg,draenor,1791,warlock,destruction,39,30,9
Rotangel,ragnaros,1791,warlock,destruction,60,33,27
Bianchii,stormscale,1790,warlock,destruction,38,27,11
Issyl,kazzak,1790,warlock,destruction,52,32,20
Aljohno,twisting-nether,1790,warlock,destruction,89,49,40
Autocannon,stormscale,1790,warlock,destruction,66,36,30
Limoges,archimonde,1789,warlock,destruction,59,33,26
Ganjubass,tarren-mill,1789,warlock,destruction,236,125,111
Jegfaller,wildhammer,1789,warlock,destruction,266,136,130
Pinacholadá,norgannon,1789,warlock,destruction,126,63,63
Brodir,aszune,1788,warlock,destruction,102,56,46
Boccebelle,pozzo-delleternità,1787,warlock,destruction,36,21,15
Fiddlestickz,gilneas,1787,warlock,destruction,107,58,49
Britnèyfears,twisting-nether,1787,warlock,destruction,48,25,23
Демоник,deathguard,1787,warlock,destruction,97,50,47
Whøknøws,twisting-nether,1786,warlock,destruction,36,25,11
Flayør,ravencrest,1786,warlock,destruction,42,23,19
Kalaslars,draenor,1786,warlock,destruction,90,47,43
Nijva,silvermoon,1786,warlock,destruction,160,83,77
Aænn,blackrock,1785,warlock,destruction,66,41,25
Ërîkå,ravencrest,1785,warlock,destruction,99,59,40
Traicklock,eredar,1785,warlock,destruction,48,27,21
Квейдсан,howling-fjord,1785,warlock,destruction,42,21,21
Hepheisto,blackmoore,1785,warlock,destruction,55,27,28
Destinyz,dun-modr,1784,warlock,destruction,60,40,20
Keybump,outland,1784,warlock,destruction,146,83,63
Dreggsow,blackmoore,1784,warlock,destruction,122,69,53
Todesgurke,alleria,1784,warlock,destruction,48,27,21
Slf,the-maelstrom,1784,warlock,destruction,66,32,34
Sznyes,ragnaros,1783,warlock,destruction,42,23,19
Gusvitori,sanguino,1783,warlock,destruction,54,29,25
Mangolicious,twisting-nether,1783,warlock,destruction,230,112,118
Harefrøken,ravencrest,1782,warlock,destruction,24,19,5
Brokengodx,dun-modr,1782,warlock,destruction,149,81,68
Knoxwhite,stormscale,1781,warlock,destruction,42,28,14
Mikthelock,nemesis,1780,warlock,destruction,77,44,33
Eltharis,burning-legion,1779,warlock,destruction,109,57,52
Htaedfo,tarren-mill,1779,warlock,destruction,226,114,112
Deadlyrust,ragnaros,1778,warlock,destruction,177,84,93
Easybolt,blackrock,1778,warlock,destruction,86,39,47
Чернокок,blackscar,1777,warlock,destruction,90,41,49
Thorolock,blackhand,1776,warlock,destruction,78,42,36
Kerway,outland,1776,warlock,destruction,126,67,59
Kurono,silvermoon,1776,warlock,destruction,90,43,47
Cwz,ysondre,1775,warlock,destruction,26,20,6
Slerpmami,ragnaros,1775,warlock,destruction,32,21,11
Themut,draenor,1775,warlock,destruction,82,49,33
Petitcayou,archimonde,1774,warlock,destruction,41,21,20
Justfamous,archimonde,1773,warlock,destruction,66,43,23
Vultzbolt,draenor,1773,warlock,destruction,165,93,72
Ràzek,kazzak,1773,warlock,destruction,239,121,118
Tajit,eredar,1773,warlock,destruction,66,32,34
Crse,antonidas,1772,warlock,destruction,79,52,27
Fiveyearque,sylvanas,1772,warlock,destruction,64,36,28
Aspass,kazzak,1772,warlock,destruction,142,79,63
Fulcanelli,sargeras,1772,warlock,destruction,51,27,24
Gravemxney,tarren-mill,1772,warlock,destruction,42,22,20
Ffpiiras,dunemaul,1771,warlock,destruction,156,76,80
Reidonk,blackrock,1770,warlock,destruction,36,21,15
Demoner,tarren-mill,1769,warlock,destruction,156,90,66
Ondarian,grim-batol,1768,warlock,destruction,56,37,19
Saffíe,ravencrest,1768,warlock,destruction,100,52,48
Bigpoodleman,twisting-nether,1767,warlock,destruction,30,22,8
Supermaus,blackrock,1767,warlock,destruction,42,25,17
Vimb,archimonde,1767,warlock,destruction,87,47,40
Bloodworth,arathor,1767,warlock,destruction,221,116,105
Онлифан,soulflayer,1765,warlock,destruction,64,40,24
Freshademic,tarren-mill,1764,warlock,destruction,30,20,10
Akumako,stormscale,1764,warlock,destruction,47,28,19
Micheller,ravencrest,1764,warlock,destruction,66,38,28
Histeria,tarren-mill,1764,warlock,destruction,69,38,31
Lonestar,sanguino,1764,warlock,destruction,60,24,36
Règis,antonidas,1763,warlock,destruction,33,21,12
Olympïe,archimonde,1763,warlock,destruction,70,44,26
Damnedhaze,stormscale,1763,warlock,destruction,169,83,86
Bufflockspls,outland,1762,warlock,destruction,114,65,49
Lockróck,silvermoon,1761,warlock,destruction,36,23,13
Mignetto,nemesis,1761,warlock,destruction,108,61,47
Cräwley,ragnaros,1761,warlock,destruction,84,41,43
Warlockoloco,blackmoore,1760,warlock,destruction,202,113,89
Telodotto,nemesis,1760,warlock,destruction,42,23,19
Finsterfluch,conseil-des-ombres,1759,warlock,destruction,68,41,27
Kronesx,tarren-mill,1759,warlock,destruction,52,23,29
Nerfbolts,archimonde,1758,warlock,destruction,36,25,11
Zenii,nemesis,1758,warlock,destruction,30,20,10
Lokmonji,perenolde,1758,warlock,destruction,87,50,37
Kenachaos,twisting-nether,1758,warlock,destruction,245,131,114
Curzed,emerald-dream,1757,warlock,destruction,80,47,33
Börsenborisq,aegwynn,1757,warlock,destruction,77,43,34
Dràghel,grim-batol,1756,warlock,destruction,36,21,15
Kivilock,dun-modr,1756,warlock,destruction,113,63,50
Domdon,stormscale,1756,warlock,destruction,108,59,49
Trîppîn,blackrock,1756,warlock,destruction,60,32,28
Nutyx,twisting-nether,1755,warlock,destruction,111,58,53
Оброссыш,gordunni,1755,warlock,destruction,54,28,26
Anthh,doomhammer,1754,warlock,destruction,30,20,10
Marador,drakthul,1754,warlock,destruction,89,45,44
Zuldanius,stormscale,1753,warlock,destruction,90,46,44
Бонибеннет,gordunni,1752,warlock,destruction,74,42,32
Dualipa,arathor,1751,warlock,destruction,36,25,11
Voukserys,tarren-mill,1751,warlock,destruction,42,29,13
Shadowcaller,sylvanas,1751,warlock,destruction,63,30,33
Iolxdd,ravencrest,1750,warlock,destruction,181,97,84
Watchdots,blackrock,1750,warlock,destruction,72,37,35
Хирацука,howling-fjord,1749,warlock,destruction,45,31,14
Jazggzkekw,twisting-nether,1748,warlock,destruction,30,22,8
Sunjal,stormscale,1748,warlock,destruction,42,26,16
Hydrôlîc,blackrock,1748,warlock,destruction,36,20,16
Жизньтлён,gordunni,1748,warlock,destruction,120,66,54
Gödisdëäd,sanguino,1748,warlock,destruction,36,19,17
Enyras,nemesis,1748,warlock,destruction,54,27,27
Sxtynine,outland,1747,warlock,destruction,84,51,33
Døtàndrun,archimonde,1747,warlock,destruction,66,39,27
Delumia,tarren-mill,1747,warlock,destruction,119,65,54
Neirah,stormscale,1747,warlock,destruction,83,45,38
Rúbs,sylvanas,1747,warlock,destruction,168,83,85
Ðæthpäct,dalaran,1747,warlock,destruction,89,42,47
Steelock,kazzak,1746,warlock,destruction,51,30,21
Trâsto,cthun,1746,warlock,destruction,52,28,24
Kìnvaras,tarren-mill,1745,warlock,destruction,55,33,22
Belastiz,blackmoore,1745,warlock,destruction,108,61,47
Smegwlock,tarren-mill,1744,warlock,destruction,90,53,37
Hamskurken,silvermoon,1744,warlock,destruction,58,33,25
Pumpfake,ravencrest,1743,warlock,destruction,41,24,17
Fatburner,draenor,1743,warlock,destruction,48,28,20
Mephaisto,kelthuzad,1743,warlock,destruction,54,30,24
Dslap,grim-batol,1742,warlock,destruction,42,25,17
Noskillfox,outland,1741,warlock,destruction,31,23,8
Дасведули,deepholm,1741,warlock,destruction,136,80,56
Guldån,twisting-nether,1741,warlock,destruction,42,24,18
Rackare,darksorrow,1740,warlock,destruction,71,48,23
Бриант,gordunni,1740,warlock,destruction,42,24,18
Ayrefik,kazzak,1740,warlock,destruction,205,107,98
Sargus,drakthul,1740,warlock,destruction,227,111,116
Gacknur,zuljin,1739,warlock,destruction,54,26,28
Gogonash,ravencrest,1739,warlock,destruction,70,33,37
Cørpse,burning-legion,1738,warlock,destruction,64,43,21
Acrion,blackrock,1738,warlock,destruction,45,22,23
Neburlock,dun-modr,1738,warlock,destruction,72,35,37
Raverboyy,blackrock,1737,warlock,destruction,156,77,79
Bubalock,kazzak,1737,warlock,destruction,78,36,42
Desimp,drakthul,1736,warlock,destruction,84,47,37
Сумракз,soulflayer,1736,warlock,destruction,36,19,17
Локдлячепухи,soulflayer,1735,warlock,destruction,46,30,16
Lasuch,burning-legion,1735,warlock,destruction,114,63,51
Starlok,nemesis,1735,warlock,destruction,47,25,22
Dwoorf,ravencrest,1735,warlock,destruction,41,21,20
Voidzero,hyjal,1735,warlock,destruction,53,26,27
Fêâr,dun-modr,1734,warlock,destruction,40,28,12
Chaosborn,ravencrest,1734,warlock,destruction,60,29,31
Oz,uldum,1733,warlock,destruction,116,74,42
Fearbót,kazzak,1733,warlock,destruction,90,49,41
Fløkee,blackmoore,1733,warlock,destruction,42,21,21
Стоишьвфире,gordunni,1732,warlock,destruction,42,21,21
Десло,thermaplugg,1731,warlock,destruction,42,25,17
Veratus,dun-modr,1731,warlock,destruction,60,33,27
Razek,eredar,1731,warlock,destruction,71,33,38
Rensayy,ysondre,1730,warlock,destruction,36,25,11
Kaijim,aegwynn,1730,warlock,destruction,272,153,119
Asbest,blackrock,1730,warlock,destruction,82,42,40
Ghachi,draenor,1730,warlock,destruction,156,75,81
Boltonez,outland,1729,warlock,destruction,178,90,88
Greenpeas,blackrock,1729,warlock,destruction,48,22,26
Wintheirl,argent-dawn,1728,warlock,destruction,176,93,83
Fogboi,tarren-mill,1728,warlock,destruction,78,40,38
Jûgøbænned,aegwynn,1727,warlock,destruction,45,33,12
Jørdanna,blackrock,1727,warlock,destruction,72,40,32
Badguldan,blackmoore,1727,warlock,destruction,193,101,92
Sanshukar,ravencrest,1726,warlock,destruction,24,18,6
Miseryfull,archimonde,1725,warlock,destruction,141,84,57
Wilog,silvermoon,1725,warlock,destruction,73,43,30
Whiteðevil,draenor,1725,warlock,destruction,42,24,18
Precogbtw,ravencrest,1724,warlock,destruction,33,20,13
Ceu,tarren-mill,1724,warlock,destruction,135,72,63
Kozaras,tarren-mill,1723,warlock,destruction,36,23,13
Äåäåäåäåäåäå,ravencrest,1723,warlock,destruction,30,18,12
Scherzinger,archimonde,1722,warlock,destruction,30,18,12
Fearu,kazzak,1722,warlock,destruction,54,32,22
Verixdots,antonidas,1722,warlock,destruction,104,61,43
Shufflous,ghostlands,1722,warlock,destruction,40,23,17
Denasty,nemesis,1721,warlock,destruction,68,40,28
Teiser,nemesis,1721,warlock,destruction,36,18,18
Jawoxoxo,rexxar,1721,warlock,destruction,60,21,39
Авенюат,gordunni,1720,warlock,destruction,24,18,6
Killerbolt,blackmoore,1720,warlock,destruction,42,28,14
Requeims,outland,1720,warlock,destruction,40,24,16
Warlockery,argent-dawn,1720,warlock,destruction,90,50,40
Лордандрюха,soulflayer,1719,warlock,destruction,36,23,13
Ламэ,gordunni,1719,warlock,destruction,126,70,56
Tessalizz,aegwynn,1718,warlock,destruction,30,21,9
Fizybubbele,malganis,1718,warlock,destruction,30,18,12
Веномхх,lich-king,1717,warlock,destruction,36,24,12
Contemtus,frostwhisper,1717,warlock,destruction,80,46,34
Päwzy,kazzak,1716,warlock,destruction,94,54,40
Scallington,shattered-hand,1715,warlock,destruction,48,24,24
Fearfearfear,archimonde,1715,warlock,destruction,90,43,47
Læsy,archimonde,1714,warlock,destruction,27,19,8
Pantry,tarren-mill,1714,warlock,destruction,30,18,12
Despayr,tarren-mill,1714,warlock,destruction,126,65,61
Nybbx,frostmane,1714,warlock,destruction,201,100,101
Блэклаш,soulflayer,1713,warlock,destruction,30,18,12
Gjallarbrù,archimonde,1713,warlock,destruction,69,37,32
Soundmagic,silvermoon,1711,warlock,destruction,36,22,14
Igneutz,twisting-nether,1711,warlock,destruction,30,18,12
Hupet,ragnaros,1710,warlock,destruction,72,39,33
Zxò,twisting-nether,1710,warlock,destruction,147,75,72
Mirah,ragnaros,1708,warlock,destruction,77,48,29
Böggilock,tarren-mill,1708,warlock,destruction,94,57,37
Mld,draenor,1708,warlock,destruction,42,23,19
Henmur,stormscale,1708,warlock,destruction,130,64,66
Vulluin,blackrock,1708,warlock,destruction,48,23,25
Uzzi,dun-modr,1707,warlock,destruction,141,77,64
Shérlock,ravencrest,1707,warlock,destruction,48,26,22
Infinitefire,ravencrest,1707,warlock,destruction,42,22,20
Fluugew,tarren-mill,1707,warlock,destruction,90,41,49
Juïcylucy,kazzak,1705,warlock,destruction,170,94,76
Shadeisblack,tarren-mill,1704,warlock,destruction,41,23,18
Purplemafia,burning-blade,1704,warlock,destruction,36,18,18
Palihatschi,eredar,1704,warlock,destruction,83,33,50
Salastro,ragnaros,1703,warlock,destruction,77,42,35
Shádóws,nagrand,1703,warlock,destruction,243,128,115
Lillemarkus,tarren-mill,1703,warlock,destruction,78,38,40
Neoe,stormscale,1703,warlock,destruction,148,72,76
Hardnes,kazzak,1702,warlock,destruction,36,18,18
Flamespitter,stormscale,1701,warlock,destruction,123,67,56
Killning,medivh,1700,warlock,destruction,266,137,129
Titimon,tarren-mill,1700,warlock,destruction,134,68,66
Boltgodx,thrall,1699,warlock,destruction,30,18,12
Tîllz,kargath,1698,warlock,destruction,24,22,2
Dotbotx,grim-batol,1698,warlock,destruction,36,23,13
Æhtrex,blackrock,1697,warlock,destruction,69,44,25
Twiseqtt,stormscale,1697,warlock,destruction,30,18,12
Trickslock,kazzak,1697,warlock,destruction,66,39,27
Chibbe,twisting-nether,1697,warlock,destruction,88,46,42
Alexindorf,silvermoon,1696,warlock,destruction,30,18,12
Orgebixx,blackmoore,1696,warlock,destruction,90,47,43
Ludé,eredar,1696,warlock,destruction,178,92,86
Ftpete,argent-dawn,1696,warlock,destruction,367,188,179
Nerzhull,stormscale,1695,warlock,destruction,368,191,177
Веномзхх,lich-king,1695,warlock,destruction,37,19,18
Elyö,dalaran,1695,warlock,destruction,599,294,305
Шеизла,borean-tundra,1694,warlock,destruction,120,70,50
Pelea,silvermoon,1694,warlock,destruction,54,31,23
Sotapen,ragnaros,1693,warlock,destruction,152,89,63
Bruzzlbube,blackhand,1693,warlock,destruction,66,36,30
Vankraken,silvermoon,1693,warlock,destruction,96,52,44
Дуэлистка,soulflayer,1692,warlock,destruction,65,42,23
Lacape,dalaran,1692,warlock,destruction,48,30,18
Marieejoana,nozdormu,1692,warlock,destruction,114,63,51
Aloof,outland,1692,warlock,destruction,291,154,137
Reuhn,kazzak,1692,warlock,destruction,96,50,46
Conditions,tarren-mill,1692,warlock,destruction,570,277,293
Bellicus,tarren-mill,1691,warlock,destruction,53,32,21
Lókkíi,silvermoon,1691,warlock,destruction,407,216,191
Ðôtgøðx,ravencrest,1691,warlock,destruction,60,28,32
Limecqt,dun-morogh,1691,warlock,destruction,65,30,35
Ekispekis,tarren-mill,1690,warlock,destruction,36,22,14
Maikus,stormscale,1690,warlock,destruction,83,50,33
Адоха,howling-fjord,1690,warlock,destruction,151,84,67
Voodooskull,kazzak,1690,warlock,destruction,36,18,18
Väladar,sanguino,1690,warlock,destruction,47,23,24
Cobràk,stormscale,1689,warlock,destruction,24,18,6
Boyyano,tarren-mill,1688,warlock,destruction,30,18,12
Smøkerzz,silvermoon,1688,warlock,destruction,100,52,48
Nagassh,arathor,1687,warlock,destruction,41,26,15
Lockukaracha,malganis,1687,warlock,destruction,98,59,39
Noahh,kazzak,1687,warlock,destruction,173,100,73
Wumz,sylvanas,1687,warlock,destruction,77,42,35
Penorr,silvermoon,1687,warlock,destruction,42,20,22
Инфезиус,deathweaver,1686,warlock,destruction,30,18,12
Joulsy,ravencrest,1686,warlock,destruction,66,39,27
Dotsyoudown,kelthuzad,1686,warlock,destruction,145,81,64
Wankdiesel,der-rat-von-dalaran,1686,warlock,destruction,301,146,155
Nekros,archimonde,1685,warlock,destruction,60,39,21
Shóx,blackmoore,1685,warlock,destruction,48,27,21
Amited,drakthul,1685,warlock,destruction,95,52,43
Fandirxd,draenor,1685,warlock,destruction,172,93,79
Ilovebronko,blackrock,1685,warlock,destruction,101,53,48
Darlih,ravencrest,1685,warlock,destruction,326,162,164
Kêkèkékêk,kazzak,1683,warlock,destruction,37,28,9
Gangleader,ravencrest,1683,warlock,destruction,59,37,22
Kasualix,ravencrest,1683,warlock,destruction,88,49,39
Lolock,archimonde,1681,warlock,destruction,32,19,13
Føtmgodx,silvermoon,1680,warlock,destruction,96,54,42
Mizxxta,zuljin,1679,warlock,destruction,35,23,12
Candleburner,khaz-modan,1679,warlock,destruction,50,32,18
Augge,tarren-mill,1679,warlock,destruction,64,38,26
Jamié,ragnaros,1679,warlock,destruction,57,31,26
Datty,grim-batol,1678,warlock,destruction,30,20,10
Bmblockerina,blackrock,1678,warlock,destruction,78,49,29
Kumas,hyjal,1678,warlock,destruction,74,46,28
Kìmar,amanthul,1678,warlock,destruction,132,71,61
Loulou,nagrand,1678,warlock,destruction,42,20,22
Darkwíngduck,aegwynn,1677,warlock,destruction,29,18,11
Guldinfy,outland,1676,warlock,destruction,24,22,2
Chãn,ravencrest,1676,warlock,destruction,36,22,14
Kognah,defias-brotherhood,1676,warlock,destruction,54,31,23
Zvinto,the-maelstrom,1676,warlock,destruction,47,26,21
Acidmvp,ravencrest,1676,warlock,destruction,72,38,34
Царьдарк,soulflayer,1676,warlock,destruction,42,22,20
Danidelarge,aegwynn,1676,warlock,destruction,70,36,34
Doomwrath,tarren-mill,1676,warlock,destruction,66,28,38
Cynícal,blackmoore,1675,warlock,destruction,48,20,28
Dabzlol,twisting-nether,1674,warlock,destruction,40,25,15
Rádiz,blackhand,1674,warlock,destruction,48,25,23
Marenov,kazzak,1673,warlock,destruction,150,81,69
Berkobaggins,ravencrest,1673,warlock,destruction,94,49,45
Ødräcïe,twisting-nether,1672,warlock,destruction,42,18,24
Boomsparkle,blackrock,1671,warlock,destruction,36,23,13
Sseb,wildhammer,1671,warlock,destruction,30,18,12
Chafir,kazzak,1671,warlock,destruction,42,25,17
Shreklock,burning-blade,1670,warlock,destruction,50,37,13
Deadmoneyz,twisting-nether,1670,warlock,destruction,30,18,12
Бонони,blackscar,1670,warlock,destruction,55,32,23
Dotrulez,nemesis,1670,warlock,destruction,43,20,23
Schøkøbasher,blackrock,1669,warlock,destruction,42,24,18
Коилсестры,blackscar,1669,warlock,destruction,45,25,20
Rohlikov,drakthul,1669,warlock,destruction,48,26,22
Mønarch,argent-dawn,1669,warlock,destruction,85,46,39
Vmorghuliss,sanguino,1669,warlock,destruction,132,59,73
Véstheim,saurfang,1668,warlock,destruction,156,83,73
Кейкегенкай,gordunni,1668,warlock,destruction,147,74,73
Иренхх,gordunni,1667,warlock,destruction,92,47,45
Ahsykal,aegwynn,1667,warlock,destruction,60,28,32
Koldarr,blackmoore,1666,warlock,destruction,211,110,101
Critchlock,tarren-mill,1665,warlock,destruction,65,35,30
Lokic,draenor,1665,warlock,destruction,52,24,28
Рипхард,gordunni,1665,warlock,destruction,54,23,31
Dotys,sanguino,1664,warlock,destruction,57,39,18
Ванадий,soulflayer,1664,warlock,destruction,101,47,54
Skrikipanik,kazzak,1663,warlock,destruction,48,25,23
Danidelarge,kazzak,1662,warlock,destruction,38,23,15
Zeñøñsama,blackrock,1662,warlock,destruction,45,20,25
Lyconidas,magtheridon,1661,warlock,destruction,34,22,12
Unstablemind,nemesis,1661,warlock,destruction,33,19,14
Pouletmicuie,archimonde,1661,warlock,destruction,86,47,39
Sadixxqt,ravencrest,1660,warlock,destruction,36,24,12
Беллулар,howling-fjord,1660,warlock,destruction,36,22,14
Morrowgleam,outland,1659,warlock,destruction,36,24,12
Helvetica,darksorrow,1659,warlock,destruction,88,47,41
Síggýy,eredar,1659,warlock,destruction,41,21,20
Stromzii,silvermoon,1659,warlock,destruction,156,79,77
Eviil,tarren-mill,1658,warlock,destruction,36,22,14
Pixelz,twisting-nether,1658,warlock,destruction,179,86,93
Датри,grom,1657,warlock,destruction,71,46,25
Pestílentía,silvermoon,1657,warlock,destruction,66,42,24
Сорзи,thermaplugg,1657,warlock,destruction,101,54,47
Tóuché,aegwynn,1657,warlock,destruction,211,111,100
Brútality,nethersturm,1657,warlock,destruction,130,60,70
Avogein,tarren-mill,1656,warlock,destruction,36,19,17
Ketzu,hyjal,1656,warlock,destruction,206,103,103
Kigro,burning-legion,1655,warlock,destruction,78,42,36
Mogwaï,blackhand,1655,warlock,destruction,166,88,78
Fatzké,kargath,1655,warlock,destruction,180,89,91
Maxiabe,hyjal,1654,warlock,destruction,106,64,42
Falakros,ravencrest,1653,warlock,destruction,95,56,39
Ностра,gordunni,1653,warlock,destruction,97,55,42
Peacedust,grim-batol,1652,warlock,destruction,36,28,8
Lykketrolle,stormscale,1652,warlock,destruction,54,35,19
Prayz,twisting-nether,1652,warlock,destruction,36,21,15
Póssiblyreef,silvermoon,1652,warlock,destruction,78,42,36
Deathcoîl,the-maelstrom,1652,warlock,destruction,42,22,20
Neg,sylvanas,1651,warlock,destruction,41,22,19
Alucena,silvermoon,1651,warlock,destruction,103,53,50
Jisera,kiljaeden,1651,warlock,destruction,42,19,23
Koffey,kazzak,1650,warlock,destruction,36,25,11
Spelldweller,silvermoon,1650,warlock,destruction,30,20,10
Siyruz,eredar,1650,warlock,destruction,82,48,34
Gentoo,xavius,1650,warlock,destruction,98,55,43
Zerulian,ragnaros,1650,warlock,destruction,41,21,20
Kaspersdame,ravencrest,1650,warlock,destruction,47,24,23
Profesorr,defias-brotherhood,1650,warlock,destruction,42,21,21
Murdee,kazzak,1650,warlock,destruction,54,22,32
Søulcä,uldum,1649,warlock,destruction,30,23,7
Óop,outland,1649,warlock,destruction,96,48,48
Stickdüse,eredar,1649,warlock,destruction,84,42,42
Psýcholoc,kazzak,1648,warlock,destruction,38,25,13
Jawdrop,blackrock,1648,warlock,destruction,51,31,20
Yoplen,drakthul,1648,warlock,destruction,122,70,52
Depressor,ragnaros,1648,warlock,destruction,156,74,82
Schrimz,blackrock,1648,warlock,destruction,57,26,31
Oldasiangirl,blackrock,1647,warlock,destruction,30,20,10
Ноубрейкс,blackscar,1647,warlock,destruction,102,65,37
Boglock,argent-dawn,1647,warlock,destruction,48,26,22
Testoorc,frostwolf,1647,warlock,destruction,146,75,71
Alexutzu,sylvanas,1646,warlock,destruction,66,42,24
Spiciously,antonidas,1646,warlock,destruction,69,37,32
Ilikebolts,blackmoore,1645,warlock,destruction,36,21,15
Withered,nagrand,1645,warlock,destruction,42,23,19
Славеномен,howling-fjord,1645,warlock,destruction,303,158,145
Xenq,ravencrest,1644,warlock,destruction,60,35,25
Necksi,archimonde,1643,warlock,destruction,36,25,11
Brugo,zuljin,1643,warlock,destruction,72,39,33
Jetsetmehmet,aegwynn,1643,warlock,destruction,90,44,46
Edrahil,lordaeron,1642,warlock,destruction,84,46,38
Âkâl,ravencrest,1642,warlock,destruction,165,90,75
Skyamino,hyjal,1641,warlock,destruction,42,27,15
Wîse,archimonde,1641,warlock,destruction,60,36,24
Drainurlife,stormscale,1641,warlock,destruction,114,66,48
Forcas,archimonde,1641,warlock,destruction,308,161,147
Таксидермия,gordunni,1641,warlock,destruction,243,124,119
Fearlessgødx,ravencrest,1641,warlock,destruction,136,69,67
Dotalike,kazzak,1641,warlock,destruction,72,33,39
Smíkz,blackhand,1640,warlock,destruction,59,36,23
Эот,soulflayer,1640,warlock,destruction,51,31,20
Ltheory,aegwynn,1640,warlock,destruction,78,44,34
Гвоздяшка,blackscar,1640,warlock,destruction,85,41,44
Dotxalot,blackrock,1639,warlock,destruction,58,40,18
Lockostock,kazzak,1639,warlock,destruction,202,96,106
Trivalis,frostwolf,1638,warlock,destruction,84,49,35
Evylock,draenor,1638,warlock,destruction,36,18,18
Miller,stormscale,1637,warlock,destruction,54,31,23
Nùdex,ravencrest,1637,warlock,destruction,66,34,32
Tudii,frostwolf,1636,warlock,destruction,54,33,21
Draka,kazzak,1636,warlock,destruction,113,68,45
Idfearthat,ragnaros,1636,warlock,destruction,60,36,24
Shugglock,draenor,1636,warlock,destruction,42,23,19
Nerfmebro,tarren-mill,1635,warlock,destruction,24,19,5
Sfwicked,tarren-mill,1635,warlock,destruction,42,26,16
Icritmore,stormscale,1635,warlock,destruction,78,42,36
Vreyax,aegwynn,1635,warlock,destruction,75,40,35
Orcwarlock,khadgar,1635,warlock,destruction,84,43,41
Dotsfired,aegwynn,1635,warlock,destruction,96,45,51
Warlololock,malganis,1634,warlock,destruction,42,24,18
Nerfwarriors,stormscale,1633,warlock,destruction,70,41,29
Sepulturá,thrall,1633,warlock,destruction,54,31,23
Puujäbäxd,stormscale,1633,warlock,destruction,42,21,21
Höfmänn,kazzak,1632,warlock,destruction,80,52,28
Lonelock,blackrock,1632,warlock,destruction,50,32,18
Rakshazza,eredar,1632,warlock,destruction,114,61,53
Blackiouz,stormscale,1632,warlock,destruction,217,109,108
Zetsubo,drakthul,1631,warlock,destruction,67,41,26
Elvània,eredar,1631,warlock,destruction,72,40,32
Striks,ragnaros,1631,warlock,destruction,94,51,43
Дэнаа,fordragon,1631,warlock,destruction,399,202,197
Azthral,nemesis,1631,warlock,destruction,463,234,229
Простшутка,gordunni,1630,warlock,destruction,24,17,7
Agaton,twisting-nether,1630,warlock,destruction,24,17,7
Onono,eredar,1630,warlock,destruction,89,49,40
Funcky,terokkar,1630,warlock,destruction,48,19,29
Vaimex,stormscale,1629,warlock,destruction,30,20,10
Xoraith,runetotem,1629,warlock,destruction,42,23,19
Wisdomness,aszune,1629,warlock,destruction,121,63,58
Worro,eredar,1629,warlock,destruction,54,28,26
Ashykal,aegwynn,1629,warlock,destruction,120,57,63
Порртвейн,howling-fjord,1628,warlock,destruction,29,18,11
Thaidakar,thrall,1628,warlock,destruction,48,28,20
Флойх,blackscar,1628,warlock,destruction,54,31,23
Aspas,outland,1628,warlock,destruction,77,43,34
Fearlólz,stormscale,1628,warlock,destruction,54,29,25
Тумнуктхай,gordunni,1628,warlock,destruction,114,59,55
Nherthul,sanguino,1628,warlock,destruction,261,133,128
Itstrippy,tarren-mill,1627,warlock,destruction,84,51,33
Ðênnis,tarren-mill,1627,warlock,destruction,30,17,13
Kyliân,blackmoore,1627,warlock,destruction,36,18,18
Xarica,garona,1627,warlock,destruction,36,17,19
Disrupted,blackmoore,1627,warlock,destruction,48,21,27
Sgait,ravencrest,1626,warlock,destruction,24,20,4
Höglund,twisting-nether,1626,warlock,destruction,39,26,13
Какойтолок,blackscar,1626,warlock,destruction,108,65,43
Çãél,ravencrest,1626,warlock,destruction,99,55,44
Cencible,twisting-nether,1626,warlock,destruction,127,66,61
Fluch,area-52,1626,warlock,destruction,60,26,34
Vitrolizz,twilights-hammer,1626,warlock,destruction,68,26,42
Соикулейн,gordunni,1625,warlock,destruction,29,23,6
Mobikagodx,drakthul,1625,warlock,destruction,27,19,8
Luwuock,twisting-nether,1625,warlock,destruction,30,21,9
Ánderx,dun-modr,1625,warlock,destruction,42,20,22
Maevex,stormscale,1625,warlock,destruction,42,18,24
Wryy,nemesis,1624,warlock,destruction,44,29,15
Pämppää,stormscale,1624,warlock,destruction,36,17,19
Bionic,eredar,1624,warlock,destruction,36,17,19
Khoug,blackmoore,1624,warlock,destruction,60,27,33
Stazox,drakthul,1623,warlock,destruction,30,18,12
Quickccast,draenor,1623,warlock,destruction,97,58,39
Zéphon,blades-edge,1623,warlock,destruction,131,65,66
Flaming,ravencrest,1623,warlock,destruction,48,22,26
Isata,blackhand,1622,warlock,destruction,36,20,16
Toryon,archimonde,1622,warlock,destruction,58,32,26
Cyanur,silvermoon,1622,warlock,destruction,36,19,17
Topmidbusta,draenor,1622,warlock,destruction,48,25,23
Danishpistol,draenor,1622,warlock,destruction,81,39,42
Kasztyk,grim-batol,1621,warlock,destruction,47,27,20
Мерседэсс,gordunni,1621,warlock,destruction,60,32,28
Gravedîgger,aggra-português,1621,warlock,destruction,42,21,21
Altffeer,blackmoore,1620,warlock,destruction,60,34,26
Zebauron,twisting-nether,1620,warlock,destruction,36,20,16
Seldonn,pozzo-delleternità,1620,warlock,destruction,35,18,17
Beåtrìce,archimonde,1620,warlock,destruction,63,31,32
Cokelight,thrall,1620,warlock,destruction,54,25,29
Cloud,kazzak,1619,warlock,destruction,30,20,10
Fatos,nemesis,1619,warlock,destruction,42,24,18
Надсх,soulflayer,1619,warlock,destruction,30,17,13
Wåfa,kazzak,1619,warlock,destruction,62,35,27
Hârzfeâr,blackmoore,1619,warlock,destruction,48,24,24
Zikozor,ravencrest,1618,warlock,destruction,28,18,10
Xtkeks,blackmoore,1618,warlock,destruction,47,30,17
Stavrogina,ravencrest,1618,warlock,destruction,30,17,13
Wìtçhßlåðes,ysondre,1618,warlock,destruction,30,17,13
Dragkur,sanguino,1618,warlock,destruction,59,31,28
Quarimathras,antonidas,1618,warlock,destruction,84,42,42
Парачо,eversong,1618,warlock,destruction,80,35,45
Highimhi,kazzak,1617,warlock,destruction,42,24,18
Krøl,nemesis,1616,warlock,destruction,30,20,10
Husaì,laughing-skull,1616,warlock,destruction,88,58,30
Манфредх,gordunni,1616,warlock,destruction,107,57,50
Bh,ragnaros,1616,warlock,destruction,147,75,72
Maevax,stormscale,1616,warlock,destruction,48,23,25
Irukandji,chants-éternels,1616,warlock,destruction,42,20,22
Celphboss,twisting-nether,1615,warlock,destruction,48,28,20
Turbonion,archimonde,1615,warlock,destruction,72,40,32
Tangolock,ravencrest,1615,warlock,destruction,82,42,40
Joemontana,blackrock,1615,warlock,destruction,42,20,22
Hiyashi,twisting-nether,1614,warlock,destruction,24,17,7
Babáyàgá,blackhand,1614,warlock,destruction,176,102,74
Mcdonkus,chamber-of-aspects,1614,warlock,destruction,39,21,18
Монтадон,howling-fjord,1614,warlock,destruction,42,22,20
Overbuffed,wildhammer,1613,warlock,destruction,30,17,13
Uralya,kazzak,1613,warlock,destruction,42,23,19
Beepbepp,grim-batol,1612,warlock,destruction,76,51,25
Сатенекс,soulflayer,1612,warlock,destruction,111,69,42
Ммотаро,soulflayer,1612,warlock,destruction,39,22,17
Yasa,khaz-modan,1612,warlock,destruction,159,87,72
Saloninus,argent-dawn,1612,warlock,destruction,72,38,34
Xuthil,korgall,1612,warlock,destruction,272,138,134
Necrofearz,sylvanas,1612,warlock,destruction,42,21,21
Opiumers,kazzak,1612,warlock,destruction,137,68,69
Chaøs,thrall,1611,warlock,destruction,36,27,9
Drarken,sylvanas,1611,warlock,destruction,36,25,11
Exiled,dragonblight,1611,warlock,destruction,40,22,18
Kosfáce,tarren-mill,1611,warlock,destruction,135,73,62
Uhlum,arthas,1611,warlock,destruction,171,90,81
ßenäfflock,ragnaros,1611,warlock,destruction,42,22,20
Jamzywarlock,kazzak,1611,warlock,destruction,47,23,24
Kenjix,blackrock,1611,warlock,destruction,66,30,36
Barbyqueue,kazzak,1610,warlock,destruction,34,24,10
Dödkärringx,auchindoun,1610,warlock,destruction,58,33,25
Dogoon,sylvanas,1610,warlock,destruction,283,149,134
Meatbot,tarren-mill,1609,warlock,destruction,46,31,15
Trinox,teldrassil,1609,warlock,destruction,54,31,23
Lockyswag,draenor,1609,warlock,destruction,66,37,29
Toobadforyou,archimonde,1609,warlock,destruction,61,33,28
Darkeds,dun-modr,1609,warlock,destruction,179,93,86
Lysanruth,la-croisade-écarlate,1609,warlock,destruction,162,82,80
Sartaz,blackmoore,1609,warlock,destruction,60,30,30
Skrabblel,tarren-mill,1609,warlock,destruction,36,18,18
Shaterz,dun-modr,1608,warlock,destruction,27,21,6
Ryssäbotti,stormscale,1608,warlock,destruction,31,23,8
Wushi,aggra-português,1608,warlock,destruction,42,27,15
Spykoosi,stormscale,1608,warlock,destruction,40,24,16
Esmuel,argent-dawn,1608,warlock,destruction,77,46,31
Хауда,gordunni,1608,warlock,destruction,238,118,120
Unkid,tarren-mill,1607,warlock,destruction,42,28,14
Селикта,gordunni,1607,warlock,destruction,30,17,13
Еротикгодх,gordunni,1607,warlock,destruction,36,20,16
Wàrrìòr,ravencrest,1607,warlock,destruction,36,20,16
Фаердирка,blackscar,1607,warlock,destruction,36,19,17
Maxlox,tarren-mill,1607,warlock,destruction,35,17,18
Mayev,garrosh,1607,warlock,destruction,94,45,49
Гурджес,soulflayer,1606,warlock,destruction,42,29,13
Jeffmillss,defias-brotherhood,1606,warlock,destruction,60,35,25
Demonkïng,archimonde,1606,warlock,destruction,147,82,65
Ðêmøñîc,ravencrest,1606,warlock,destruction,36,17,19
Vestaya,burning-legion,1606,warlock,destruction,72,31,41
Севербрянск,soulflayer,1605,warlock,destruction,30,17,13
Dejin,tarren-mill,1605,warlock,destruction,30,17,13
Dispelpls,dun-morogh,1605,warlock,destruction,42,23,19
Холичорт,howling-fjord,1605,warlock,destruction,69,37,32
Storloz,argent-dawn,1605,warlock,destruction,119,62,57
Ipme,sanguino,1604,warlock,destruction,95,55,40
Felttofel,stormscale,1604,warlock,destruction,49,28,21
Garbageclass,outland,1604,warlock,destruction,36,20,16
Moelock,frostmane,1604,warlock,destruction,135,74,61
Egiriefo,twisting-nether,1604,warlock,destruction,36,19,17
Ïori,hyjal,1604,warlock,destruction,71,36,35
Kgg,outland,1604,warlock,destruction,153,77,76
Lichlolocked,outland,1604,warlock,destruction,84,42,42
Mooncrushed,stormscale,1603,warlock,destruction,42,29,13
Zeinth,sanguino,1603,warlock,destruction,36,23,13
Nedivh,stormscale,1603,warlock,destruction,77,42,35
Felhaen,silvermoon,1603,warlock,destruction,42,22,20
Dreamnyâsha,tarren-mill,1603,warlock,destruction,42,19,23
Gishor,burning-legion,1602,warlock,destruction,24,19,5
Грань,ashenvale,1602,warlock,destruction,283,150,133
Ðream,kaelthas,1602,warlock,destruction,42,22,20
Sickening,twilights-hammer,1601,warlock,destruction,55,38,17
Spõk,ysondre,1601,warlock,destruction,250,133,117
Dastey,stormscale,1601,warlock,destruction,36,18,18
Ineri,hyjal,1600,warlock,destruction,36,20,16
Letswreck,outland,1600,warlock,destruction,90,46,44
Мегаклещ,soulflayer,1600,warlock,destruction,48,23,25
Chaozvx,kazzak,1599,warlock,destruction,83,45,38
Gulleigh,draenor,1599,warlock,destruction,124,65,59
Midgetlockx,ravencrest,1598,warlock,destruction,25,20,5
Southy,stormscale,1598,warlock,destruction,36,19,17
Shblakk,outland,1597,warlock,destruction,47,27,20
Sneptics,draenor,1597,warlock,destruction,169,95,74
Tíktik,blackhand,1597,warlock,destruction,47,20,27
Tops,thrall,1596,warlock,destruction,24,19,5
Napoloen,kazzak,1596,warlock,destruction,36,19,17
Necrobtch,quelthalas,1595,warlock,destruction,36,21,15
Sibora,eredar,1595,warlock,destruction,48,26,22
Hexdrix,thrall,1594,warlock,destruction,43,20,23
Felcollíns,ravencrest,1593,warlock,destruction,36,19,17
Bonemetz,blackmoore,1593,warlock,destruction,258,134,124
Ðîâblô,silvermoon,1593,warlock,destruction,80,41,39
Sleethy,destromath,1593,warlock,destruction,60,28,32
Ñæly,ravencrest,1592,warlock,destruction,35,19,16
Whitebøy,hyjal,1592,warlock,destruction,51,27,24
Lugnalennart,tarren-mill,1592,warlock,destruction,211,108,103
Nimbin,taerar,1591,warlock,destruction,213,115,98
Nobodyknows,outland,1591,warlock,destruction,36,19,17
Chaosbørn,twisting-nether,1590,warlock,destruction,40,26,14
Drazol,sylvanas,1590,warlock,destruction,32,18,14
Chaoxz,outland,1589,warlock,destruction,120,71,49
Shaxlock,draenor,1588,warlock,destruction,135,74,61
Ezdotggwp,stormscale,1588,warlock,destruction,42,23,19
Hongkonger,kazzak,1588,warlock,destruction,422,219,203
Morathy,drekthar,1588,warlock,destruction,46,23,23
Nøl,sargeras,1587,warlock,destruction,351,176,175
Sirmic,hyjal,1586,warlock,destruction,125,63,62
Réxz,ravencrest,1586,warlock,destruction,72,36,36
Hexdoctor,ravencrest,1586,warlock,destruction,48,18,30
Wicherson,burning-legion,1585,warlock,destruction,100,53,47
Nebulus,lightnings-blade,1585,warlock,destruction,192,101,91
Strikeførce,ravencrest,1585,warlock,destruction,111,57,54
Rúbedo,thrall,1585,warlock,destruction,41,21,20
Færqt,blackrock,1585,warlock,destruction,78,34,44
Proctolock,garona,1584,warlock,destruction,95,57,38
Jinxme,tarren-mill,1584,warlock,destruction,149,80,69
Kkomradee,kazzak,1584,warlock,destruction,67,34,33
Hellguards,silvermoon,1584,warlock,destruction,89,41,48
Nèrfxløl,ragnaros,1583,warlock,destruction,76,50,26
Pelkopeelo,tarren-mill,1583,warlock,destruction,83,45,38
Jumbodot,tarren-mill,1583,warlock,destruction,74,40,34
Adipure,blackrock,1583,warlock,destruction,42,19,23
Articfox,outland,1582,warlock,destruction,128,67,61
Octoba,kirin-tor,1581,warlock,destruction,36,23,13
Deruud,defias-brotherhood,1581,warlock,destruction,170,89,81
Nitmoredots,dun-modr,1581,warlock,destruction,60,29,31
Furchtnervt,thrall,1579,warlock,destruction,36,19,17
Mihø,hyjal,1579,warlock,destruction,86,44,42
Аркейнмизери,howling-fjord,1578,warlock,destruction,37,26,11
Мицуру,howling-fjord,1578,warlock,destruction,112,64,48
Afflimoomoo,tarren-mill,1578,warlock,destruction,126,62,64
Sædotern,stormscale,1578,warlock,destruction,42,20,22
Вайнпрессх,gordunni,1578,warlock,destruction,44,18,26
Balthezy,defias-brotherhood,1577,warlock,destruction,24,18,6
Jpjpjp,gorgonnash,1577,warlock,destruction,78,48,30
Docik,kazzak,1577,warlock,destruction,106,52,54
Jaines,forscherliga,1577,warlock,destruction,47,20,27
Slàsh,hyjal,1576,warlock,destruction,54,36,18
Sabnøck,nemesis,1576,warlock,destruction,41,24,17
Жузек,howling-fjord,1576,warlock,destruction,84,49,35
Uneedtherapy,silvermoon,1576,warlock,destruction,72,42,30
Ketamol,ravencrest,1576,warlock,destruction,69,37,32
Mariahscary,auchindoun,1575,warlock,destruction,36,21,15
Ábýss,ravencrest,1575,warlock,destruction,55,30,25
Naslock,twisting-nether,1575,warlock,destruction,42,20,22
Flawzo,blackmoore,1574,warlock,destruction,96,51,45
Ánárchy,stormscale,1572,warlock,destruction,42,22,20
Rhadaghast,outland,1571,warlock,destruction,89,50,39
Hajslaktarn,twisting-nether,1571,warlock,destruction,76,39,37
Empod,ragnaros,1571,warlock,destruction,81,37,44
Plamena,neptulon,1570,warlock,destruction,118,67,51
Áutísm,silvermoon,1570,warlock,destruction,138,71,67
Shanyor,kazzak,1569,warlock,destruction,34,20,14
Lovromalt,kazzak,1569,warlock,destruction,54,29,25
Zwockeý,ravencrest,1568,warlock,destruction,30,20,10
Craynos,die-arguswacht,1568,warlock,destruction,111,59,52
Visable,kazzak,1568,warlock,destruction,36,19,17
Qzkimp,hyjal,1568,warlock,destruction,42,22,20
Shayexen,tarren-mill,1568,warlock,destruction,42,21,21
Pliixme,ysondre,1568,warlock,destruction,53,26,27
Jaliyah,outland,1567,warlock,destruction,54,32,22
Bolt,stormscale,1567,warlock,destruction,112,64,48
Axapnon,ragnaros,1567,warlock,destruction,36,20,16
Zarastro,sunstrider,1567,warlock,destruction,322,161,161
Willthehoe,alonsus,1567,warlock,destruction,47,23,24
Lúcìfér,stormscale,1567,warlock,destruction,48,19,29
Woòkz,argent-dawn,1566,warlock,destruction,154,85,69
Xcstacy,kazzak,1566,warlock,destruction,42,22,20
Nasiegboch,frostwolf,1566,warlock,destruction,179,92,87
Fatkkroth,ravencrest,1565,warlock,destruction,49,30,19
Azaïdun,khaz-modan,1565,warlock,destruction,88,49,39
Asmodéan,silvermoon,1565,warlock,destruction,36,19,17
Hairyporta,blackmoore,1565,warlock,destruction,239,118,121
Kàjah,outland,1563,warlock,destruction,59,29,30
Акэти,borean-tundra,1563,warlock,destruction,54,26,28
Sneps,azshara,1561,warlock,destruction,48,27,21
Нгага,howling-fjord,1561,warlock,destruction,456,233,223
Væde,stormscale,1561,warlock,destruction,55,28,27
Vantimere,ragnaros,1560,warlock,destruction,72,39,33
Zoradiale,twisting-nether,1559,warlock,destruction,54,30,24
Banishedone,stormreaver,1559,warlock,destruction,135,72,63
Ael,chogall,1558,warlock,destruction,82,51,31
Spysnop,draenor,1557,warlock,destruction,58,37,21
Parásitø,zuljin,1557,warlock,destruction,35,20,15
Tropìcal,grim-batol,1557,warlock,destruction,36,17,19
Boccu,magtheridon,1556,warlock,destruction,97,54,43
Kerthan,malorne,1556,warlock,destruction,167,92,75
Егосяхаос,soulflayer,1556,warlock,destruction,102,54,48
Britneyfears,burning-legion,1556,warlock,destruction,36,18,18
Фтор,soulflayer,1555,warlock,destruction,51,28,23
Ajgreedyy,grim-batol,1555,warlock,destruction,60,30,30
Zexan,drakthul,1554,warlock,destruction,48,34,14
Gimlidota,tarren-mill,1554,warlock,destruction,180,96,84
Inoculum,xavius,1553,warlock,destruction,89,45,44
Kresnyk,kazzak,1551,warlock,destruction,109,58,51
Tdoggydog,ragnaros,1551,warlock,destruction,90,45,45
Flocca,archimonde,1551,warlock,destruction,89,44,45
Gango,outland,1550,warlock,destruction,92,50,42
Lobotomic,argent-dawn,1549,warlock,destruction,51,33,18
Barro,das-syndikat,1549,warlock,destruction,50,29,21
Nàchtt,archimonde,1549,warlock,destruction,114,58,56
Chaosboltlol,ravencrest,1547,warlock,destruction,36,22,14
Salemlel,sanguino,1546,warlock,destruction,54,31,23
Bellua,twisting-nether,1546,warlock,destruction,77,42,35
Scheprick,twisting-nether,1546,warlock,destruction,41,17,24
Annihilatîon,aegwynn,1545,warlock,destruction,42,23,19
Zloezlo,ravencrest,1545,warlock,destruction,194,98,96
Ivannadie,outland,1545,warlock,destruction,48,24,24
Chubson,tarren-mill,1545,warlock,destruction,56,26,30
Nazmordith,argent-dawn,1545,warlock,destruction,68,29,39
Soulgünter,blackmoore,1544,warlock,destruction,90,59,31
Salazaros,die-silberne-hand,1544,warlock,destruction,96,52,44
Robertóoo,burning-legion,1544,warlock,destruction,89,48,41
Rawsauce,outland,1542,warlock,destruction,20,17,3
Bigbadgoblin,kazzak,1542,warlock,destruction,30,20,10
Veoxohr,argent-dawn,1542,warlock,destruction,132,80,52
Бомбшелл,soulflayer,1542,warlock,destruction,44,19,25
Cazzo,burning-blade,1541,warlock,destruction,379,193,186
Трудзастафф,gordunni,1541,warlock,destruction,102,45,57
Инкубычь,gordunni,1540,warlock,destruction,27,18,9
Drakedoge,draenor,1540,warlock,destruction,136,71,65
Mækken,draenor,1539,warlock,destruction,252,127,125
Sûdh,sanguino,1538,warlock,destruction,120,66,54
Litox,twisting-nether,1538,warlock,destruction,129,63,66
Veanice,eredar,1538,warlock,destruction,46,20,26
Frilante,terokkar,1537,warlock,destruction,86,55,31
Unrealia,hyjal,1537,warlock,destruction,174,93,81
Депрессыш,gordunni,1537,warlock,destruction,42,21,21
Babakrake,alleria,1536,warlock,destruction,42,24,18
Enei,drakthul,1536,warlock,destruction,48,26,22
Slëydark,sanguino,1536,warlock,destruction,35,18,17
Mortuáry,drakthul,1536,warlock,destruction,108,55,53
Destrovid,stormscale,1536,warlock,destruction,42,21,21
Ðemise,antonidas,1536,warlock,destruction,69,33,36
Anderxyo,sanguino,1535,warlock,destruction,24,16,8
Nkwango,blackmoore,1535,warlock,destruction,24,16,8
Anihlix,kazzak,1535,warlock,destruction,24,16,8
Crueliadevil,stormscale,1535,warlock,destruction,181,88,93
Kaylabae,silvermoon,1534,warlock,destruction,18,16,2
Bustabrinka,aggra-português,1534,warlock,destruction,18,16,2
Potatowl,ravencrest,1534,warlock,destruction,18,16,2
Izhi,ragnaros,1534,warlock,destruction,71,42,29
Samyoung,kazzak,1534,warlock,destruction,167,91,76
Rénna,twisting-nether,1534,warlock,destruction,30,16,14
Syntax,blackmoore,1533,warlock,destruction,24,16,8
Shortyi,thrall,1533,warlock,destruction,24,16,8
Snackstickz,twisting-nether,1533,warlock,destruction,54,31,23
Calypso,korgall,1533,warlock,destruction,30,16,14
Dreameater,twilights-hammer,1533,warlock,destruction,60,30,30
Zamahell,marécage-de-zangar,1532,warlock,destruction,24,17,7
Johnybanana,eredar,1532,warlock,destruction,68,37,31
Debz,twisting-nether,1531,warlock,destruction,25,16,9
Jonsdotter,outland,1531,warlock,destruction,30,16,14
Chillman,stormrage,1530,warlock,destruction,90,54,36
Saladoor,draenor,1530,warlock,destruction,30,16,14
Notben,outland,1529,warlock,destruction,18,16,2
Aoea,draenor,1529,warlock,destruction,24,16,8
Cringelord,vashj,1528,warlock,destruction,18,16,2
Golansobolt,sanguino,1528,warlock,destruction,30,16,14
Ìzanamí,archimonde,1528,warlock,destruction,262,137,125
Kenthal,nemesis,1528,warlock,destruction,75,34,41
Falel,das-konsortium,1527,warlock,destruction,30,23,7
Dahisx,ravencrest,1527,warlock,destruction,24,16,8
Mêgasn,blackhand,1527,warlock,destruction,24,16,8
Toliver,drakthul,1527,warlock,destruction,78,44,34
Fatbëlly,argent-dawn,1527,warlock,destruction,191,95,96
Thorvos,blackmoore,1527,warlock,destruction,45,21,24
Шекигами,gordunni,1526,warlock,destruction,30,16,14
Тиранчухан,howling-fjord,1526,warlock,destruction,51,20,31
Straydots,grim-batol,1525,warlock,destruction,24,16,8
Белвет,blackscar,1525,warlock,destruction,104,51,53
Postymalony,kazzak,1523,warlock,destruction,30,19,11
Веберх,howling-fjord,1523,warlock,destruction,30,16,14
Нэдлок,greymane,1523,warlock,destruction,30,16,14
Koonlock,kazzak,1523,warlock,destruction,151,80,71
Dotzéro,ravencrest,1523,warlock,destruction,66,34,32
Parley,frostmane,1523,warlock,destruction,54,27,27
Nÿhf,kirin-tor,1523,warlock,destruction,47,21,26
Raywl,blackmoore,1522,warlock,destruction,36,19,17
Мамкадгара,howling-fjord,1522,warlock,destruction,35,17,18
Weso,grim-batol,1522,warlock,destruction,73,34,39
Darkironhuan,blackrock,1521,warlock,destruction,42,25,17
Jackyfalls,blackmoore,1521,warlock,destruction,30,16,14
Kicx,blackrock,1521,warlock,destruction,47,25,22
Bisacodyl,outland,1521,warlock,destruction,107,56,51
Malinki,silvermoon,1521,warlock,destruction,42,20,22
Hathatchi,sylvanas,1521,warlock,destruction,96,45,51
Proßlock,kazzak,1521,warlock,destruction,116,54,62
Goodclass,tarren-mill,1520,warlock,destruction,24,17,7
Déemón,draenor,1520,warlock,destruction,70,44,26
Beerdurschd,antonidas,1520,warlock,destruction,51,31,20
Экспло,ashenvale,1520,warlock,destruction,78,46,32
Яжбатько,howling-fjord,1520,warlock,destruction,78,40,38
Героуд,howling-fjord,1519,warlock,destruction,141,75,66
Bottmbolt,blackhand,1519,warlock,destruction,69,36,33
Dzey,drakthul,1519,warlock,destruction,146,76,70
Felgød,ravencrest,1518,warlock,destruction,82,43,39
Мураса,grom,1518,warlock,destruction,71,36,35
Kamí,sanguino,1518,warlock,destruction,77,37,40
Wauwish,stormscale,1517,warlock,destruction,89,52,37
Flumez,stormscale,1517,warlock,destruction,111,63,48
Noctiz,pozzo-delleternità,1517,warlock,destruction,113,62,51
Asreaël,uldum,1517,warlock,destruction,60,32,28
Wøhx,archimonde,1517,warlock,destruction,54,26,28
Yazurí,ravencrest,1516,warlock,destruction,24,16,8
Silås,hyjal,1516,warlock,destruction,52,31,21
Rêcc,blackmoore,1516,warlock,destruction,60,32,28
Onetwobolt,archimonde,1516,warlock,destruction,190,98,92
Puppylover,outland,1515,warlock,destruction,42,30,12
Noxii,gorgonnash,1515,warlock,destruction,78,43,35
Chapo,alleria,1515,warlock,destruction,48,21,27
Dbwl,kazzak,1514,warlock,destruction,24,16,8
Gengada,blackhand,1514,warlock,destruction,90,50,40
Lottopallo,arathor,1514,warlock,destruction,30,16,14
Cronai,silvermoon,1514,warlock,destruction,134,69,65
Makaspam,stormscale,1514,warlock,destruction,130,65,65
Misscringe,silvermoon,1514,warlock,destruction,168,83,85
Tôertchen,aegwynn,1513,warlock,destruction,27,18,9
Falock,tarren-mill,1513,warlock,destruction,48,28,20
Wagwann,argent-dawn,1513,warlock,destruction,54,31,23
Fearster,twisting-nether,1513,warlock,destruction,100,57,43
Бигбрейн,soulflayer,1513,warlock,destruction,72,39,33
Usianbølts,blackmoore,1513,warlock,destruction,30,16,14
Zoh,archimonde,1513,warlock,destruction,185,92,93
Lêxia,shattrath,1513,warlock,destruction,42,16,26
Tarumar,burning-legion,1512,warlock,destruction,36,16,20
Lilbolty,outland,1511,warlock,destruction,48,22,26
Ghostfiend,tarren-mill,1510,warlock,destruction,54,35,19
Mellisandre,hellfire,1510,warlock,destruction,42,25,17
Pipêz,blackmoore,1510,warlock,destruction,101,59,42
Sertdene,ravencrest,1509,warlock,destruction,78,43,35
Isata,ravencrest,1509,warlock,destruction,115,63,52
Lorelèi,silvermoon,1508,warlock,destruction,52,29,23
Xerthula,blackmoore,1507,warlock,destruction,30,16,14
Lubomirek,turalyon,1507,warlock,destruction,36,19,17
Nøxxlock,blackhand,1507,warlock,destruction,173,90,83
Kasuni,sanguino,1507,warlock,destruction,72,30,42
Altfdrölf,blackhand,1506,warlock,destruction,31,21,10
Sylvxgodx,kazzak,1506,warlock,destruction,60,37,23
Gigabolt,turalyon,1505,warlock,destruction,59,35,24
Hokmor,blutkessel,1505,warlock,destruction,118,60,58
Rcodellamado,kazzak,1505,warlock,destruction,42,18,24
Blackwizard,theradras,1504,warlock,destruction,171,90,81
Kwoh,saurfang,1504,warlock,destruction,33,17,16
Hipiwl,silvermoon,1504,warlock,destruction,72,37,35
Morgan,jaedenar,1503,warlock,destruction,96,52,44
Leídernein,blutkessel,1503,warlock,destruction,42,22,20
Merdotz,outland,1500,warlock,destruction,49,29,20
Rotinhell,kazzak,1500,warlock,destruction,165,80,85
Voidislife,alakir,1499,warlock,destruction,201,104,97
Azastarax,archimonde,1499,warlock,destruction,54,27,27
Cronice,ravencrest,1499,warlock,destruction,134,62,72
Misleev,pozzo-delleternità,1499,warlock,destruction,152,66,86
Jaimê,thrall,1498,warlock,destruction,106,57,49
Nicodemo,tarren-mill,1498,warlock,destruction,30,16,14
Evillinna,frostmane,1498,warlock,destruction,119,62,57
Nerdbane,blackrock,1497,warlock,destruction,105,57,48
Necradin,defias-brotherhood,1497,warlock,destruction,93,48,45
Bazoo,nathrezim,1497,warlock,destruction,265,128,137
Xanatas,nemesis,1496,warlock,destruction,66,38,28
Lînden,magtheridon,1496,warlock,destruction,30,16,14
Spoíl,tarren-mill,1496,warlock,destruction,72,36,36
Interceptêr,blackrock,1496,warlock,destruction,36,18,18
Naemys,archimonde,1495,warlock,destruction,57,36,21
Askmo,hyjal,1495,warlock,destruction,46,29,17
Marklock,drakthul,1495,warlock,destruction,79,47,32
Горгзок,howling-fjord,1495,warlock,destruction,48,24,24
Helgorak,ragnaros,1495,warlock,destruction,60,27,33
Gorthunz,kazzak,1495,warlock,destruction,83,37,46
Locque,kazzak,1494,warlock,destruction,24,16,8
Kïng,elune,1494,warlock,destruction,66,34,32
Kaedinx,twisting-nether,1494,warlock,destruction,610,310,300
Фирджеден,fordragon,1493,warlock,destruction,146,83,63
Inagony,twisting-nether,1493,warlock,destruction,29,16,13
Warlocat,the-maelstrom,1493,warlock,destruction,72,34,38
Aznel,nemesis,1491,warlock,destruction,37,22,15
Araphel,twisting-nether,1491,warlock,destruction,42,19,23
Weexi,kazzak,1490,warlock,destruction,32,20,12
Khano,twisting-nether,1490,warlock,destruction,147,79,68
Колдунишка,fordragon,1490,warlock,destruction,117,62,55
Gyroib,stormscale,1489,warlock,destruction,65,37,28
Chaosprophet,argent-dawn,1489,warlock,destruction,50,28,22
Zerøskil,blackrock,1488,warlock,destruction,24,16,8
Bowti,ravencrest,1488,warlock,destruction,100,63,37
Chía,thunderhorn,1488,warlock,destruction,47,26,21
Juicyj,twisting-nether,1488,warlock,destruction,50,23,27
Acrowley,twisting-nether,1487,warlock,destruction,52,26,26
Lockdest,outland,1487,warlock,destruction,131,63,68
Fandusttwo,drakthul,1486,warlock,destruction,66,36,30
Stürmer,thrall,1486,warlock,destruction,126,67,59
Scaevóla,ravencrest,1486,warlock,destruction,252,129,123
Banelock,dentarg,1486,warlock,destruction,90,43,47
Belnea,draenor,1485,warlock,destruction,33,18,15
Petrapain,antonidas,1485,warlock,destruction,42,22,20
Diabló,outland,1485,warlock,destruction,36,18,18
Azaêl,azshara,1485,warlock,destruction,153,72,81
Nieché,tarren-mill,1484,warlock,destruction,66,37,29
Zeelotko,drakthul,1484,warlock,destruction,147,82,65
Murishani,durotan,1483,warlock,destruction,30,18,12
Demoslik,hyjal,1483,warlock,destruction,60,27,33
Enzyw,drakthul,1482,warlock,destruction,66,38,28
Xârtôr,blackrock,1482,warlock,destruction,182,99,83
Golgir,draenor,1482,warlock,destruction,148,76,72
Dusken,kazzak,1481,warlock,destruction,41,21,20
Cursedotexe,ragnaros,1481,warlock,destruction,150,76,74
Faro,trollbane,1481,warlock,destruction,120,56,64
Necromantis,drakthul,1480,warlock,destruction,30,16,14
Branduir,ragnaros,1479,warlock,destruction,36,19,17
Nokickplz,nemesis,1479,warlock,destruction,57,30,27
Fearfearfear,blackhand,1478,warlock,destruction,29,16,13
Чернокнжник,soulflayer,1478,warlock,destruction,48,24,24
Xànin,thrall,1478,warlock,destruction,60,28,32
Mummraa,ravencrest,1477,warlock,destruction,59,35,24
Cavekid,tarren-mill,1477,warlock,destruction,36,21,15
Tschebo,eredar,1477,warlock,destruction,60,31,29
Kiritsugi,aszune,1476,warlock,destruction,65,38,27
Apokalyps,eldrethalas,1476,warlock,destruction,168,81,87
Rasheeka,ravencrest,1476,warlock,destruction,35,16,19
Иванфаков,soulflayer,1475,warlock,destruction,29,17,12
Zeddy,draenor,1475,warlock,destruction,120,67,53
Valcan,ragnaros,1475,warlock,destruction,139,76,63
Èrmes,eldrethalas,1475,warlock,destruction,172,88,84
Shêrlöck,stormscale,1475,warlock,destruction,138,69,69
Biotic,dun-modr,1475,warlock,destruction,42,18,24
Amadéth,twisting-nether,1474,warlock,destruction,44,26,18
Mvpðøtx,ravencrest,1474,warlock,destruction,79,45,34
Farlier,draenor,1474,warlock,destruction,95,47,48
Désolaté,kazzak,1474,warlock,destruction,36,17,19
Codeincody,blackhand,1473,warlock,destruction,53,23,30
Kirillkaá,blackhand,1472,warlock,destruction,54,32,22
Inflamis,stormscale,1472,warlock,destruction,78,43,35
Törtidotcom,blackrock,1472,warlock,destruction,42,20,22
Quasimodó,aegwynn,1471,warlock,destruction,79,48,31
Zombpunk,sanguino,1471,warlock,destruction,148,77,71
Найтварлок,soulflayer,1471,warlock,destruction,40,17,23
Кореопсис,azuregos,1470,warlock,destruction,23,18,5
Érunali,archimonde,1470,warlock,destruction,23,16,7
Сайзэр,howling-fjord,1470,warlock,destruction,171,85,86
Xtleonidas,uldum,1470,warlock,destruction,132,64,68
Féar,doomhammer,1469,warlock,destruction,51,29,22
Blackmagic,stormscale,1467,warlock,destruction,218,109,109
Sénsemann,madmortem,1466,warlock,destruction,65,37,28
Bossmanluke,defias-brotherhood,1466,warlock,destruction,29,16,13
Dérbombér,guldan,1466,warlock,destruction,36,19,17
Jmë,outland,1465,warlock,destruction,44,25,19
Mazaear,stormscale,1465,warlock,destruction,69,36,33
Hemara,emeriss,1465,warlock,destruction,54,27,27
Warlockyo,blackrock,1465,warlock,destruction,60,29,31
Holaw,tarren-mill,1464,warlock,destruction,84,41,43
Magicstick,eredar,1463,warlock,destruction,89,41,48
Balgo,blackmoore,1462,warlock,destruction,60,32,28
Datendariza,kazzak,1462,warlock,destruction,116,60,56
Sydneyshaw,draenor,1462,warlock,destruction,129,64,65
Suppedo,antonidas,1462,warlock,destruction,88,38,50
Longdickie,ravencrest,1461,warlock,destruction,36,22,14
Tomiaa,burning-legion,1460,warlock,destruction,60,27,33
Cørleen,eredar,1460,warlock,destruction,154,69,85
Palmangel,draenor,1460,warlock,destruction,54,24,30
Vactor,stormscale,1460,warlock,destruction,46,20,26
Nhéon,archimonde,1459,warlock,destruction,36,21,15
Chyther,ragnaros,1459,warlock,destruction,48,26,22
Маларгас,soulflayer,1459,warlock,destruction,218,114,104
Antoniolm,cthun,1459,warlock,destruction,72,37,35
Пъё,howling-fjord,1459,warlock,destruction,131,60,71
Spaså,kazzak,1458,warlock,destruction,42,23,19
Peardrax,draenor,1458,warlock,destruction,73,38,35
Кулутха,soulflayer,1457,warlock,destruction,37,21,16
Sherrÿ,ragnaros,1457,warlock,destruction,54,29,25
Zòóf,stormscale,1456,warlock,destruction,114,69,45
Dôtski,kazzak,1456,warlock,destruction,137,79,58
Nosoulnoprob,sylvanas,1456,warlock,destruction,108,54,54
Lockteb,tarren-mill,1455,warlock,destruction,47,25,22
Oorlogslot,sylvanas,1455,warlock,destruction,180,92,88
Zengrow,ravencrest,1454,warlock,destruction,27,17,10
Bte,draenor,1454,warlock,destruction,64,34,30
Zöyarüm,outland,1454,warlock,destruction,42,22,20
Даремно,gordunni,1454,warlock,destruction,48,24,24
Aleê,twisting-nether,1454,warlock,destruction,47,23,24
Perius,zuluhed,1454,warlock,destruction,90,39,51
Lockybàlboa,tarren-mill,1453,warlock,destruction,48,29,19
Геролин,goldrinn,1452,warlock,destruction,109,54,55
Lucifer,burning-legion,1451,warlock,destruction,48,26,22
Anicetuslol,lightnings-blade,1451,warlock,destruction,30,16,14
Ammathrel,moonglade,1451,warlock,destruction,129,64,65
Horsewarlock,stormscale,1451,warlock,destruction,158,77,81
Антетак,soulflayer,1451,warlock,destruction,70,32,38
Banshore,ysondre,1450,warlock,destruction,47,29,18
Геоматика,gordunni,1450,warlock,destruction,64,28,36
Drestar,ragnaros,1450,warlock,destruction,42,17,25
Kamehamehaa,stormscale,1449,warlock,destruction,42,26,16
Voiyane,silvermoon,1449,warlock,destruction,42,23,19
Lócki,gilneas,1448,warlock,destruction,68,43,25
Ez,frostmane,1448,warlock,destruction,30,18,12
Демирус,gordunni,1448,warlock,destruction,42,20,22
Tzeeñtch,tarren-mill,1448,warlock,destruction,122,58,64
Kvanmor,kaelthas,1448,warlock,destruction,134,63,71
Гуслин,soulflayer,1447,warlock,destruction,136,72,64
Cooldowns,ravencrest,1447,warlock,destruction,85,45,40
Malumbra,argent-dawn,1447,warlock,destruction,42,19,23
Baz,frostmane,1446,warlock,destruction,227,115,112
Baïlos,conseil-des-ombres,1446,warlock,destruction,43,21,22
Smileyfacè,silvermoon,1446,warlock,destruction,92,39,53
Meeatcookie,burning-legion,1444,warlock,destruction,25,17,8
Hellsplat,tarren-mill,1444,warlock,destruction,48,26,22
Kolosh,twisting-nether,1444,warlock,destruction,53,27,26
Gledoc,outland,1443,warlock,destruction,36,22,14
Blåir,kazzak,1443,warlock,destruction,77,45,32
Helkásh,tarren-mill,1443,warlock,destruction,66,31,35
Scrim,laughing-skull,1442,warlock,destruction,82,50,32
Liqûid,destromath,1442,warlock,destruction,181,95,86
Graveshaker,quelthalas,1442,warlock,destruction,55,27,28
Aelvur,tarren-mill,1442,warlock,destruction,48,20,28
Kimwexler,ravencrest,1441,warlock,destruction,29,16,13
Diablesse,dun-modr,1441,warlock,destruction,118,59,59
Unknownlock,tarren-mill,1441,warlock,destruction,48,22,26
Agonymaster,twisting-nether,1440,warlock,destruction,36,20,16
Abdulrahim,archimonde,1439,warlock,destruction,24,15,9
Frèija,ravencrest,1439,warlock,destruction,24,15,9
Hasibe,ravencrest,1439,warlock,destruction,51,28,23
Amyw,magtheridon,1439,warlock,destruction,56,29,27
Uelimueli,onyxia,1439,warlock,destruction,71,35,36
Rhaelgar,kazzak,1439,warlock,destruction,60,29,31
Stecksen,blackmoore,1438,warlock,destruction,18,15,3
Cursier,blackmoore,1438,warlock,destruction,48,27,21
Auxi,the-maelstrom,1438,warlock,destruction,115,62,53
Cardinall,drakthul,1438,warlock,destruction,124,66,58
Dzimmi,kazzak,1438,warlock,destruction,42,22,20
Ignorantduck,sunstrider,1438,warlock,destruction,51,25,26
Навидд,howling-fjord,1437,warlock,destruction,24,15,9
Wedlock,stormscale,1437,warlock,destruction,70,40,30
Ragequit,xavius,1437,warlock,destruction,29,16,13
Thugsupreme,ravencrest,1437,warlock,destruction,78,41,37
Vicktorious,stormscale,1437,warlock,destruction,419,215,204
Shiammetrý,kazzak,1437,warlock,destruction,30,15,15
Greeylock,blackhand,1436,warlock,destruction,27,18,9
Sopingsop,chants-éternels,1436,warlock,destruction,54,28,26
Ketriicken,argent-dawn,1436,warlock,destruction,108,55,53
Rhss,stormscale,1436,warlock,destruction,30,15,15
Elldialock,draenor,1436,warlock,destruction,30,15,15
Анвена,soulflayer,1435,warlock,destruction,24,15,9
Kàdszèle,ragnaros,1435,warlock,destruction,34,19,15
Kotihoitaja,stormreaver,1435,warlock,destruction,46,20,26
Bondejohn,ravencrest,1434,warlock,destruction,30,16,14
Impmuncher,twisting-nether,1434,warlock,destruction,30,15,15
Воттоваара,azuregos,1434,warlock,destruction,106,52,54
Прадедка,howling-fjord,1434,warlock,destruction,60,29,31
Теснер,gordunni,1434,warlock,destruction,88,39,49
Lánfeár,draenor,1434,warlock,destruction,73,30,43
Fynxo,blackmoore,1433,warlock,destruction,24,16,8
Miltuast,blackrock,1433,warlock,destruction,30,19,11
Raknoxyeyeye,blackrock,1433,warlock,destruction,24,15,9
Калестонх,soulflayer,1433,warlock,destruction,72,42,30
Азерок,howling-fjord,1433,warlock,destruction,66,34,32
Kashdrakor,twisting-nether,1433,warlock,destruction,40,17,23
Stuckhard,silvermoon,1433,warlock,destruction,60,25,35
Gillgarres,twisting-nether,1432,warlock,destruction,250,127,123
Flockyy,draenor,1431,warlock,destruction,28,16,12
Mannemus,tarren-mill,1430,warlock,destruction,24,16,8
Slavecry,silvermoon,1430,warlock,destruction,24,15,9
Softcøre,blackmoore,1430,warlock,destruction,48,29,19
Wildo,grim-batol,1430,warlock,destruction,102,61,41
Skuvee,archimonde,1429,warlock,destruction,23,18,5
Surfot,kazzak,1428,warlock,destruction,84,42,42
Чернаяскала,howling-fjord,1428,warlock,destruction,127,59,68
Chroll,nerathor,1427,warlock,destruction,84,52,32
Sylvein,drakthul,1426,warlock,destruction,18,15,3
Iriepathie,nozdormu,1426,warlock,destruction,48,22,26
Sublînê,blackmoore,1425,warlock,destruction,150,85,65
Муза,gordunni,1425,warlock,destruction,56,30,26
Krukke,tarren-mill,1424,warlock,destruction,54,28,26
Galardodric,outland,1424,warlock,destruction,60,30,30
Onyw,onyxia,1424,warlock,destruction,30,15,15
Bobstrr,drakthul,1424,warlock,destruction,42,15,27
Megalockz,draenor,1423,warlock,destruction,24,15,9
Pogrom,burning-legion,1423,warlock,destruction,56,32,24
Kospar,dun-morogh,1423,warlock,destruction,105,57,48
Chanibad,emerald-dream,1421,warlock,destruction,24,15,9
Darthvder,sylvanas,1421,warlock,destruction,55,27,28
Feer,defias-brotherhood,1421,warlock,destruction,66,30,36
Redroach,doomhammer,1420,warlock,destruction,24,16,8
Shazem,tarren-mill,1420,warlock,destruction,24,15,9
Durátor,ravencrest,1419,warlock,destruction,24,15,9
Palatical,terokkar,1419,warlock,destruction,42,21,21
Dotacy,kazzak,1419,warlock,destruction,210,103,107
Emalinne,argent-dawn,1419,warlock,destruction,68,31,37
Ðreaðlock,stormscale,1418,warlock,destruction,94,41,53
Kärringjävel,chamber-of-aspects,1417,warlock,destruction,60,34,26
Mty,bronze-dragonflight,1417,warlock,destruction,53,28,25
Asmonmald,stormscale,1417,warlock,destruction,468,238,230
Animositywl,draenor,1416,warlock,destruction,42,27,15
Elhäbedehä,blackrock,1416,warlock,destruction,30,19,11
Запрещаю,galakrond,1416,warlock,destruction,224,116,108
Rakoru,blackmoore,1416,warlock,destruction,30,15,15
Некусайсасай,galakrond,1415,warlock,destruction,47,30,17
Hydrochloric,emerald-dream,1415,warlock,destruction,36,22,14
Midnigthh,sanguino,1415,warlock,destruction,30,16,14
Honetia,ravencrest,1415,warlock,destruction,50,23,27
Waandi,ravencrest,1414,warlock,destruction,58,32,26
Anyfears,outland,1414,warlock,destruction,35,15,20
Chedipes,stormscale,1412,warlock,destruction,30,21,9
Gehirnwäsche,frostwolf,1412,warlock,destruction,34,22,12
Микурочка,gordunni,1412,warlock,destruction,130,65,65
Shadowscurse,sylvanas,1412,warlock,destruction,60,28,32
Horridum,draenor,1412,warlock,destruction,145,65,80
Rosebëaf,archimonde,1411,warlock,destruction,71,33,38
Mootay,drekthar,1411,warlock,destruction,36,16,20
Sippe,laughing-skull,1410,warlock,destruction,36,16,20
Бездушный,gordunni,1410,warlock,destruction,36,15,21
Бирел,soulflayer,1409,warlock,destruction,24,15,9
Buddyparty,blackrock,1409,warlock,destruction,52,32,20
Balatonsound,ragnaros,1409,warlock,destruction,36,15,21
Azgaroth,kazzak,1408,warlock,destruction,232,128,104
Døtzz,blackmoore,1408,warlock,destruction,44,23,21
Azzoaa,defias-brotherhood,1408,warlock,destruction,60,29,31
Krombo,kazzak,1408,warlock,destruction,36,17,19
Vlotsi,twisting-nether,1407,warlock,destruction,20,15,5
Trickyy,azjolnerub,1407,warlock,destruction,69,39,30
Czx,twisting-nether,1407,warlock,destruction,42,22,20
Natsume,ragnaros,1407,warlock,destruction,43,21,22
Mavelya,blackmoore,1406,warlock,destruction,112,55,57
Maedx,outland,1406,warlock,destruction,39,17,22
Zlohell,drakthul,1405,warlock,destruction,48,30,18
Melow,sanguino,1405,warlock,destruction,65,35,30
Margincalled,kazzak,1405,warlock,destruction,36,18,18
Evaksiá,draenor,1405,warlock,destruction,48,23,25
Wurdulock,silvermoon,1405,warlock,destruction,54,25,29
Левсекси,eversong,1404,warlock,destruction,87,44,43
Vincewl,ravencrest,1404,warlock,destruction,114,57,57
Smadrekas,ravencrest,1404,warlock,destruction,58,25,33
Enydible,frostmane,1403,warlock,destruction,24,15,9
Morphosis,agamaggan,1403,warlock,destruction,30,15,15
Rahtireino,darksorrow,1403,warlock,destruction,60,25,35
Faitless,stormscale,1402,warlock,destruction,60,35,25
Swagzz,silvermoon,1402,warlock,destruction,60,34,26
Lynchian,draenor,1401,warlock,destruction,61,33,28
Facépalm,draenor,1401,warlock,destruction,54,21,33
Darkgainz,draenor,1400,warlock,destruction,39,22,17
Janemba,ysondre,1400,warlock,destruction,42,21,21
Гупперлок,howling-fjord,1400,warlock,destruction,48,21,27
Setta,argent-dawn,1400,warlock,destruction,54,21,33
Naxdas,burning-legion,1399,warlock,destruction,127,62,65
Naavii,bloodscalp,1398,warlock,destruction,60,30,30
Cerberus,argent-dawn,1398,warlock,destruction,63,31,32
Nomakqlock,dun-modr,1397,warlock,destruction,36,23,13
Vahron,kirin-tor,1397,warlock,destruction,97,42,55
Barashnukor,blackmoore,1396,warlock,destruction,30,16,14
Birimbau,outland,1396,warlock,destruction,85,40,45
Sinsemilla,turalyon,1395,warlock,destruction,129,69,60
Dobonard,sylvanas,1395,warlock,destruction,38,19,19
Emalk,tarren-mill,1395,warlock,destruction,84,38,46
Xârdâs,blackrock,1395,warlock,destruction,50,21,29
Wajiggity,ravencrest,1394,warlock,destruction,42,23,19
Soulshift,blackmoore,1394,warlock,destruction,78,38,40
Satanizm,silvermoon,1393,warlock,destruction,95,46,49
Çhãøsførÿã,blackmoore,1392,warlock,destruction,90,43,47
Essealaes,stormscale,1392,warlock,destruction,56,23,33
Warlockholms,archimonde,1391,warlock,destruction,24,15,9
Lockboom,kazzak,1391,warlock,destruction,36,20,16
Шелруа,howling-fjord,1390,warlock,destruction,52,31,21
Vegetita,stormscale,1390,warlock,destruction,221,120,101
Fearhändig,aegwynn,1390,warlock,destruction,63,32,31
Zollon,norgannon,1389,warlock,destruction,23,17,6
Quebone,tarren-mill,1389,warlock,destruction,51,27,24
Gash,malganis,1389,warlock,destruction,72,37,35
Hellraiserir,twisting-nether,1388,warlock,destruction,22,16,6
Ltany,drakthul,1388,warlock,destruction,24,16,8
Mccøy,archimonde,1388,warlock,destruction,36,19,17
Vanmorgoth,nazjatar,1388,warlock,destruction,30,15,15
Арцах,soulflayer,1388,warlock,destruction,60,29,31
Dotloca,draenor,1388,warlock,destruction,36,17,19
Моориус,soulflayer,1388,warlock,destruction,96,45,51
Culetto,the-venture-co,1388,warlock,destruction,53,23,30
Xshay,dun-modr,1388,warlock,destruction,51,18,33
Crazybolt,archimonde,1384,warlock,destruction,54,29,25
Hyphonos,blackmoore,1384,warlock,destruction,38,18,20
Deathscréam,burning-legion,1384,warlock,destruction,139,65,74
Línkéd,blackmoore,1384,warlock,destruction,96,43,53
Boltgodx,blackrock,1383,warlock,destruction,66,42,24
Dracsu,dun-modr,1383,warlock,destruction,49,26,23
Биохозард,deathguard,1383,warlock,destruction,183,96,87
Мирмех,gordunni,1383,warlock,destruction,60,29,31
Tarhatar,tarren-mill,1382,warlock,destruction,35,16,19
Boomlock,dun-morogh,1382,warlock,destruction,42,17,25
Exitumos,eredar,1381,warlock,destruction,53,27,26
Dxfive,tarren-mill,1381,warlock,destruction,92,46,46
Алхун,razuvious,1381,warlock,destruction,126,61,65
Matheus,zenedar,1380,warlock,destruction,84,43,41
Nitecro,blackmoore,1380,warlock,destruction,156,75,81
Devoto,stormscale,1380,warlock,destruction,57,26,31
Corbiejr,tarren-mill,1379,warlock,destruction,156,92,64
Sateerik,draenor,1379,warlock,destruction,49,24,25
Trollgubbe,twilights-hammer,1378,warlock,destruction,28,18,10
Valtieri,tarren-mill,1378,warlock,destruction,36,17,19
Lewdrumpslap,kazzak,1377,warlock,destruction,74,43,31
Rafael,stormscale,1377,warlock,destruction,49,27,22
Vooses,draenor,1377,warlock,destruction,59,30,29
Zyasuk,runetotem,1376,warlock,destruction,55,26,29
Хелентесс,goldrinn,1375,warlock,destruction,36,23,13
Eatmabolt,alleria,1375,warlock,destruction,69,36,33
Сеннир,ashenvale,1375,warlock,destruction,48,22,26
Nexpoze,drakthul,1375,warlock,destruction,42,17,25
Gâlà,elune,1374,warlock,destruction,36,21,15
Ðrussi,hyjal,1374,warlock,destruction,162,82,80
Darklobos,aggra-português,1374,warlock,destruction,42,20,22
Лобарык,soulflayer,1373,warlock,destruction,48,24,24
Sweetlõck,ravencrest,1373,warlock,destruction,59,25,34
Valkiriaa,saurfang,1372,warlock,destruction,30,18,12
Telaldrah,argent-dawn,1372,warlock,destruction,46,24,22
Loveløck,blackrock,1372,warlock,destruction,35,15,20
Zaill,argent-dawn,1371,warlock,destruction,35,19,16
Shindubelore,aggra-português,1371,warlock,destruction,39,18,21
Byeedriver,kazzak,1370,warlock,destruction,22,15,7
Darcîa,destromath,1370,warlock,destruction,39,23,16
Verderbnis,malganis,1370,warlock,destruction,89,50,39
Lockydavé,outland,1370,warlock,destruction,43,18,25
Pookabee,ravencrest,1369,warlock,destruction,36,19,17
Xjms,darksorrow,1369,warlock,destruction,42,16,26
Narzisså,dalaran,1368,warlock,destruction,42,18,24
Sîlverdîze,thrall,1367,warlock,destruction,98,54,44
Nibblez,shadowsong,1367,warlock,destruction,191,100,91
Eotlid,shattered-hand,1367,warlock,destruction,63,32,31
Demonslayer,khaz-modan,1367,warlock,destruction,48,23,25
Quanchí,kazzak,1366,warlock,destruction,47,27,20
Eriken,tarren-mill,1366,warlock,destruction,57,26,31
Maveri,tarren-mill,1365,warlock,destruction,45,25,20
Líok,eredar,1365,warlock,destruction,47,21,26
Ezclapforme,aegwynn,1365,warlock,destruction,80,35,45
Hulyekotsog,ragnaros,1364,warlock,destruction,54,37,17
Карьерщица,booty-bay,1364,warlock,destruction,168,89,79
Elmîr,blackmoore,1364,warlock,destruction,54,26,28
Mÿxin,blackhand,1364,warlock,destruction,36,17,19
Wichtl,die-ewige-wacht,1364,warlock,destruction,42,19,23
Sargal,sylvanas,1363,warlock,destruction,84,42,42
Covariance,nemesis,1363,warlock,destruction,72,29,43
Soldmygranny,kazzak,1362,warlock,destruction,27,17,10
Vakgu,blackmoore,1362,warlock,destruction,47,28,19
Tharaya,ravencrest,1362,warlock,destruction,29,15,14
Backdrip,ragnaros,1362,warlock,destruction,67,34,33
Gomezz,dalaran,1362,warlock,destruction,46,22,24
Gølpilølz,ysondre,1361,warlock,destruction,30,15,15
Whodares,drakthul,1361,warlock,destruction,75,33,42
Gricorby,drakthul,1360,warlock,destruction,23,16,7
Bankley,khaz-modan,1360,warlock,destruction,60,31,29
Лоллиторпеда,gordunni,1360,warlock,destruction,44,15,29
Cárloz,aegwynn,1359,warlock,destruction,24,15,9
Légréy,blackmoore,1359,warlock,destruction,54,30,24
Lockedaway,ravencrest,1359,warlock,destruction,42,22,20
Hell,twisting-nether,1359,warlock,destruction,65,28,37
Shutdown,sylvanas,1358,warlock,destruction,83,50,33
Fivestars,tarren-mill,1358,warlock,destruction,88,45,43
Julsey,kazzak,1357,warlock,destruction,41,22,19
Sesoumaru,azshara,1357,warlock,destruction,106,46,60
Bergerac,archimonde,1357,warlock,destruction,35,15,20
Demosteaks,thrall,1356,warlock,destruction,24,15,9
Realshady,kazzak,1356,warlock,destruction,30,16,14
Bkp,dun-modr,1356,warlock,destruction,36,16,20
Lulokko,nemesis,1355,warlock,destruction,36,22,14
Cängrë,dun-modr,1355,warlock,destruction,42,25,17
Ablas,bladefist,1355,warlock,destruction,128,55,73
Moonpoxlock,nerathor,1354,warlock,destruction,73,39,34
Diablotiin,hyjal,1354,warlock,destruction,393,197,196
Niszoght,dun-modr,1353,warlock,destruction,158,93,65
Mohawkyz,chamber-of-aspects,1353,warlock,destruction,59,32,27
Voltadol,dun-modr,1353,warlock,destruction,126,65,61
Раздирающая,gordunni,1352,warlock,destruction,76,41,35
Turrôk,blackmoore,1351,warlock,destruction,36,21,15
Boltexpert,twisting-nether,1351,warlock,destruction,30,15,15
Toutseul,eitrigg,1351,warlock,destruction,36,15,21
Phántom,frostmane,1350,warlock,destruction,48,22,26
Алюций,gordunni,1350,warlock,destruction,57,24,33
Dégenerat,burning-legion,1349,warlock,destruction,42,26,16
Crokorc,ysondre,1349,warlock,destruction,107,48,59
Patirass,sanguino,1348,warlock,destruction,73,41,32
Skruios,anetheron,1346,warlock,destruction,70,36,34
Jadek,ragnaros,1346,warlock,destruction,44,21,23
Akhade,silvermoon,1346,warlock,destruction,48,21,27
Dhraven,thrall,1345,warlock,destruction,126,66,60
Potatowl,ragnaros,1344,warlock,destruction,24,14,10
Holeraa,stormscale,1344,warlock,destruction,225,112,113
Меркус,howling-fjord,1344,warlock,destruction,102,50,52
Bivör,blackmoore,1344,warlock,destruction,92,37,55
Ahollic,frostwolf,1343,warlock,destruction,18,14,4
Toutanpapier,ysondre,1343,warlock,destruction,24,14,10
Mudwalkin,ravencrest,1343,warlock,destruction,36,17,19
Setyouinfear,ravencrest,1343,warlock,destruction,30,14,16
Hædês,antonidas,1343,warlock,destruction,30,14,16
Ghastlyy,aggra-português,1342,warlock,destruction,18,14,4
Sinofbum,stormscale,1342,warlock,destruction,18,14,4
Cigänä,archimonde,1342,warlock,destruction,24,14,10
Nanotrik,draenor,1342,warlock,destruction,24,14,10
Odenbest,silvermoon,1342,warlock,destruction,24,14,10
Dakotalock,ravencrest,1342,warlock,destruction,28,15,13
Cahetel,nemesis,1342,warlock,destruction,77,38,39
Cráxx,onyxia,1342,warlock,destruction,199,98,101
Flxzshort,kazzak,1341,warlock,destruction,18,14,4
Fedpikkefar,kazzak,1341,warlock,destruction,30,14,16
Mompets,stormscale,1341,warlock,destruction,36,14,22
Anicetus,ravencrest,1340,warlock,destruction,18,14,4
Zanhek,kazzak,1340,warlock,destruction,48,28,20
Hasselbalch,azshara,1340,warlock,destruction,24,14,10
Тэлдвин,gordunni,1340,warlock,destruction,100,52,48
Sidragasoss,drakthul,1340,warlock,destruction,36,17,19
Love,alexstrasza,1339,warlock,destruction,30,18,12
Demirchayan,twisting-nether,1339,warlock,destruction,132,75,57
Salvatoriy,outland,1339,warlock,destruction,32,15,17
Dimmybyrger,stormreaver,1339,warlock,destruction,30,14,16
Loptous,dunemaul,1339,warlock,destruction,45,20,25
Tmoney,stormscale,1338,warlock,destruction,24,14,10
Lünatix,archimonde,1338,warlock,destruction,42,24,18
Ryurans,cthun,1338,warlock,destruction,98,49,49
Kromosonen,ravencrest,1338,warlock,destruction,84,37,47
Melyagang,hyjal,1336,warlock,destruction,18,14,4
Maenas,ravencrest,1336,warlock,destruction,24,14,10
Nuckki,antonidas,1336,warlock,destruction,521,260,261
Sécret,blackmoore,1335,warlock,destruction,24,14,10
Inportal,kazzak,1335,warlock,destruction,89,49,40
Skâald,senjin,1335,warlock,destruction,61,31,30
Darkdax,dethecus,1335,warlock,destruction,30,15,15
Rhev,trollbane,1335,warlock,destruction,62,30,32
Pommeslock,blackmoore,1335,warlock,destruction,119,57,62
Abnørmus,tarren-mill,1334,warlock,destruction,82,47,35
Яичнаялапша,soulflayer,1334,warlock,destruction,30,15,15
Cürsëd,culte-de-la-rive-noire,1334,warlock,destruction,30,14,16
Quentex,antonidas,1334,warlock,destruction,71,33,38
Narstia,archimonde,1334,warlock,destruction,88,38,50
Míkæ,ravencrest,1333,warlock,destruction,376,190,186
Scader,kazzak,1333,warlock,destruction,36,14,22
Глотающий,gordunni,1332,warlock,destruction,30,19,11
Niiaa,archimonde,1332,warlock,destruction,24,14,10
Ragnarók,area-52,1332,warlock,destruction,27,15,12
Warlockgødx,silvermoon,1332,warlock,destruction,114,60,54
Boohyakka,tarren-mill,1332,warlock,destruction,30,14,16
Sindown,the-maelstrom,1332,warlock,destruction,74,34,40
Sehere,ragnaros,1331,warlock,destruction,38,21,17
Diåbló,stormscale,1331,warlock,destruction,168,87,81
Sathanas,antonidas,1331,warlock,destruction,30,15,15
Holodream,stormreaver,1331,warlock,destruction,121,57,64
Shadaw,kilrogg,1330,warlock,destruction,18,14,4
Silkgates,kazzak,1330,warlock,destruction,47,21,26
Talriun,kazzak,1330,warlock,destruction,38,16,22
Primitivaa,dun-modr,1329,warlock,destruction,48,30,18
Ínsidióus,tarren-mill,1329,warlock,destruction,24,14,10
Зюзерг,soulflayer,1329,warlock,destruction,95,45,50
Eldasz,silvermoon,1329,warlock,destruction,50,20,30
Bruhoman,kazzak,1328,warlock,destruction,24,15,9
Carthagî,blackmoore,1328,warlock,destruction,66,39,27
Hyrai,sylvanas,1328,warlock,destruction,24,14,10
Dieger,thunderhorn,1328,warlock,destruction,24,14,10
Äsmødée,dalaran,1328,warlock,destruction,66,37,29
Danzil,silvermoon,1328,warlock,destruction,36,15,21
Castingsmth,draenor,1327,warlock,destruction,21,17,4
Benzakenta,sylvanas,1327,warlock,destruction,24,14,10
Dìablò,sylvanas,1327,warlock,destruction,96,54,42
Unkash,zuljin,1327,warlock,destruction,114,61,53
Dÿf,kazzak,1327,warlock,destruction,64,33,31
Ghostflame,tarren-mill,1327,warlock,destruction,100,50,50
Dalamon,draenor,1326,warlock,destruction,24,14,10
Kâzs,dun-modr,1326,warlock,destruction,87,46,41
Merloc,magtheridon,1325,warlock,destruction,50,30,20
Paranoid,sylvanas,1325,warlock,destruction,48,26,22
Ангебор,howling-fjord,1324,warlock,destruction,137,72,65
Zerokxp,blackmoore,1323,warlock,destruction,17,15,2
Demoz,sanguino,1323,warlock,destruction,106,58,48
Эннинотбэд,howling-fjord,1322,warlock,destruction,29,14,15
Thepl,dalaran,1321,warlock,destruction,113,59,54
Wuhdun,burning-legion,1321,warlock,destruction,35,16,19
Deathpoid,draenor,1321,warlock,destruction,110,46,64
Lowkeyfed,stormscale,1320,warlock,destruction,18,14,4
Adoy,tarren-mill,1320,warlock,destruction,135,75,60
Ragïa,archimonde,1319,warlock,destruction,28,17,11
Amakusa,archimonde,1319,warlock,destruction,52,25,27
Mempricious,ravencrest,1318,warlock,destruction,30,14,16
Repah,doomhammer,1317,warlock,destruction,70,29,41
Zaerea,ravenholdt,1316,warlock,destruction,60,32,28
Zerx,malganis,1316,warlock,destruction,30,14,16
Tuz,blackrock,1316,warlock,destruction,90,40,50
Luckynòób,ravencrest,1316,warlock,destruction,42,18,24
Kääk,sylvanas,1315,warlock,destruction,108,58,50
Talindra,stormscale,1315,warlock,destruction,56,30,26
Lxié,ravencrest,1315,warlock,destruction,30,16,14
Terris,khaz-modan,1315,warlock,destruction,111,56,55
Papilena,turalyon,1314,warlock,destruction,24,15,9
Олдхалапеньо,soulflayer,1314,warlock,destruction,54,24,30
Zzombie,sylvanas,1314,warlock,destruction,68,30,38
Zaklinator,twisting-nether,1313,warlock,destruction,36,19,17
Soultwist,twisting-nether,1313,warlock,destruction,60,29,31
Kokainas,dun-modr,1313,warlock,destruction,54,26,28
Hörst,das-konsortium,1313,warlock,destruction,89,40,49
Pcbbwarlock,sylvanas,1313,warlock,destruction,36,15,21
Лоредо,howling-fjord,1313,warlock,destruction,80,32,48
Fredysimo,silvermoon,1312,warlock,destruction,42,26,16
Seeles,frostmane,1312,warlock,destruction,30,14,16
Dreadnogg,tarren-mill,1311,warlock,destruction,130,63,67
Toké,blackmoore,1311,warlock,destruction,30,14,16
Wezen,stormscale,1311,warlock,destruction,30,14,16
Melkorh,twisting-nether,1311,warlock,destruction,36,16,20
Donmajor,amanthul,1311,warlock,destruction,48,19,29
Willibolt,blackhand,1311,warlock,destruction,48,17,31
Keilahkang,aerie-peak,1310,warlock,destruction,108,47,61
Kaamosliha,frostwhisper,1309,warlock,destruction,75,43,32
Seya,azuremyst,1309,warlock,destruction,30,14,16
Wormies,doomhammer,1309,warlock,destruction,36,16,20
Harrykan,blackrock,1308,warlock,destruction,24,16,8
Эктос,soulflayer,1308,warlock,destruction,36,23,13
Seagelock,silvermoon,1308,warlock,destruction,108,48,60
Cleoputra,sylvanas,1307,warlock,destruction,38,20,18
Акучабела,gordunni,1307,warlock,destruction,30,14,16
Wazze,azuremyst,1306,warlock,destruction,77,40,37
Mefistto,drakthul,1305,warlock,destruction,30,16,14
Kïrah,ysondre,1305,warlock,destruction,68,27,41
Toffifae,argent-dawn,1304,warlock,destruction,24,16,8
Plööp,malganis,1304,warlock,destruction,163,82,81
Islazoldyck,draenor,1304,warlock,destruction,122,54,68
Cháos,forscherliga,1304,warlock,destruction,91,40,51
Poulebar,ysondre,1303,warlock,destruction,24,14,10
Blyskawicar,silvermoon,1302,warlock,destruction,18,14,4
Shadeshanox,blackmoore,1302,warlock,destruction,36,23,13
Lokajci,outland,1302,warlock,destruction,37,22,15
Дольпико,howling-fjord,1301,warlock,destruction,60,33,27
Rizzbolt,ravencrest,1301,warlock,destruction,183,94,89
Batráz,tarren-mill,1301,warlock,destruction,172,86,86
Argenus,khazgoroth,1301,warlock,destruction,36,14,22
Gåylørd,ravencrest,1300,warlock,destruction,42,16,26
Fêars,blackrock,1299,warlock,destruction,62,34,28
Pufulet,sylvanas,1299,warlock,destruction,144,70,74
Problemchild,sunstrider,1298,warlock,destruction,120,64,56
Хубаскис,soulflayer,1298,warlock,destruction,61,26,35
Vâgg,blackmoore,1298,warlock,destruction,48,18,30
Dexterr,sylvanas,1297,warlock,destruction,122,61,61
Zillinzy,frostmane,1297,warlock,destruction,30,15,15
Ooliver,kazzak,1296,warlock,destruction,24,14,10
Ädarä,cthun,1296,warlock,destruction,66,33,33
Scandalfogel,frostmane,1295,warlock,destruction,24,14,10
Rumpelelse,blackrock,1294,warlock,destruction,28,16,12
Pensiblesie,runetotem,1294,warlock,destruction,622,308,314
Kar,haomarush,1293,warlock,destruction,139,61,78
Girldoom,silvermoon,1293,warlock,destruction,55,19,36
Narkstzhki,kazzak,1292,warlock,destruction,97,61,36
Chram,uldum,1292,warlock,destruction,89,51,38
Profylaxis,arathor,1292,warlock,destruction,69,38,31
Proflock,drakthul,1292,warlock,destruction,54,28,26
Galath,wrathbringer,1292,warlock,destruction,100,51,49
Àbraxàs,nemesis,1291,warlock,destruction,96,38,58
Jxø,twisting-nether,1290,warlock,destruction,34,18,16
Millhaus,gorgonnash,1290,warlock,destruction,71,36,35
Regularbag,ravencrest,1290,warlock,destruction,60,30,30
Zerozwolf,tarren-mill,1289,warlock,destruction,54,20,34
Hurn,thunderhorn,1287,warlock,destruction,66,39,27
Yahddist,hyjal,1287,warlock,destruction,32,15,17
Useidûm,ravencrest,1287,warlock,destruction,30,14,16
Apôpis,archimonde,1286,warlock,destruction,60,34,26
Untactful,tarren-mill,1286,warlock,destruction,117,60,57
Lazyblue,hyjal,1286,warlock,destruction,85,32,53
Ahylleslook,antonidas,1285,warlock,destruction,18,14,4
Nàughty,ragnaros,1285,warlock,destruction,91,39,52
Хиёрис,eversong,1284,warlock,destruction,57,33,24
Лочундра,gordunni,1284,warlock,destruction,41,19,22
Nicolino,doomhammer,1283,warlock,destruction,72,42,30
Askanios,twisting-nether,1283,warlock,destruction,73,41,32
Baskakov,zuljin,1283,warlock,destruction,39,17,22
Turbofamilly,hyjal,1282,warlock,destruction,23,14,9
Staynecro,malfurion,1282,warlock,destruction,55,27,28
Демонкор,blackscar,1281,warlock,destruction,47,32,15
Chaosftw,archimonde,1281,warlock,destruction,35,17,18
Hôjâm,twisting-nether,1280,warlock,destruction,36,18,18
Гангстахохо,soulflayer,1280,warlock,destruction,45,18,27
Southylol,stormscale,1278,warlock,destruction,17,14,3
Deo,confrérie-du-thorium,1278,warlock,destruction,54,33,21
Xfear,blackrock,1277,warlock,destruction,24,16,8
Kycknosa,archimonde,1277,warlock,destruction,26,14,12
Àsh,dun-modr,1277,warlock,destruction,101,47,54
Modzal,kazzak,1276,warlock,destruction,48,28,20
Krokator,draenor,1276,warlock,destruction,51,28,23
Xoram,kult-der-verdammten,1276,warlock,destruction,60,29,31
Demohoror,stormscale,1276,warlock,destruction,42,20,22
Zivalelia,silvermoon,1276,warlock,destruction,143,66,77
Chaotìc,nemesis,1275,warlock,destruction,24,18,6
Longchamp,stormscale,1275,warlock,destruction,28,15,13
Ocaya,kazzak,1275,warlock,destruction,30,16,14
Baalthazar,jaedenar,1275,warlock,destruction,85,43,42
Ноанс,howling-fjord,1275,warlock,destruction,34,15,19
Dreamage,exodar,1274,warlock,destruction,54,27,27
Kærastan,sylvanas,1274,warlock,destruction,100,46,54
Lokicica,karazhan,1274,warlock,destruction,53,24,29
Nerokin,blackrock,1273,warlock,destruction,132,75,57
Filianore,azjolnerub,1273,warlock,destruction,79,38,41
Neetlock,suramar,1272,warlock,destruction,36,19,17
Divvaa,tarren-mill,1272,warlock,destruction,124,59,65
Asmodaî,anubarak,1271,warlock,destruction,121,62,59
Xhartus,argent-dawn,1271,warlock,destruction,42,18,24
Bahlrok,burning-legion,1270,warlock,destruction,36,19,17
Acohab,draenor,1270,warlock,destruction,36,18,18
Shinamna,tarren-mill,1270,warlock,destruction,30,15,15
Azrail,anubarak,1270,warlock,destruction,309,151,158
Lodem,darksorrow,1270,warlock,destruction,72,31,41
Grinspoon,ysondre,1269,warlock,destruction,54,27,27
Sulvar,draenor,1269,warlock,destruction,48,22,26
Блэкмайндер,howling-fjord,1268,warlock,destruction,80,44,36
Rezax,blackrock,1268,warlock,destruction,101,55,46
Kåros,argent-dawn,1268,warlock,destruction,37,18,19
Wiitchdoktor,twisting-nether,1268,warlock,destruction,30,14,16
Lula,drakthul,1266,warlock,destruction,91,58,33
Бутабой,soulflayer,1266,warlock,destruction,87,47,40
Øpaco,khazgoroth,1266,warlock,destruction,65,27,38
Hárdí,tarren-mill,1265,warlock,destruction,24,15,9
Чиназис,gordunni,1265,warlock,destruction,102,49,53
Sovrìn,blackrock,1264,warlock,destruction,20,14,6
Tsumde,dalaran,1264,warlock,destruction,86,43,43
Tabarnak,archimonde,1264,warlock,destruction,30,14,16
Necrolock,tarren-mill,1263,warlock,destruction,47,23,24
Klimsonxd,burning-legion,1262,warlock,destruction,28,15,13
Woudstok,ysondre,1260,warlock,destruction,29,15,14
Symbiosis,kazzak,1260,warlock,destruction,102,50,52
Üserper,chamber-of-aspects,1259,warlock,destruction,143,64,79
Ariyala,alleria,1258,warlock,destruction,36,18,18
Sorxez,thrall,1258,warlock,destruction,78,36,42
Pekkoperkele,ravenholdt,1257,warlock,destruction,116,56,60
Kriplock,twisting-nether,1257,warlock,destruction,53,21,32
Krëkk,silvermoon,1256,warlock,destruction,30,14,16
Zuyox,silvermoon,1256,warlock,destruction,53,22,31
Blackjackk,tarren-mill,1256,warlock,destruction,72,27,45
Sylrathas,burning-legion,1255,warlock,destruction,117,61,56
Ladodida,darkspear,1253,warlock,destruction,50,20,30
Jobbymancer,twisting-nether,1252,warlock,destruction,42,25,17
Dededimons,stormscale,1252,warlock,destruction,104,52,52
Hunbeliever,ragnaros,1250,warlock,destruction,36,22,14
Dubbzy,outland,1250,warlock,destruction,39,19,20
Вешка,azuregos,1249,warlock,destruction,33,18,15
Oxsen,hyjal,1249,warlock,destruction,60,29,31
Kaakmasta,der-abyssische-rat,1248,warlock,destruction,18,13,5
Sêro,aegwynn,1248,warlock,destruction,18,13,5
Присесть,razuvious,1248,warlock,destruction,51,28,23
Deflagrate,kazzak,1248,warlock,destruction,24,13,11
Kyiüû,archimonde,1248,warlock,destruction,28,15,13
Антарриэль,howling-fjord,1248,warlock,destruction,42,22,20
Favris,antonidas,1248,warlock,destruction,29,15,14
Демолиша,gordunni,1248,warlock,destruction,34,14,20
Kevinbolter,kult-der-verdammten,1247,warlock,destruction,18,13,5
Dobromír,kazzak,1247,warlock,destruction,24,13,11
Mîjagî,blackhand,1247,warlock,destruction,89,47,42
Гулдарий,howling-fjord,1247,warlock,destruction,162,85,77
Felbunni,silvermoon,1247,warlock,destruction,75,33,42
Darkpiche,kazzak,1247,warlock,destruction,36,14,22
Shuggul,draenor,1246,warlock,destruction,18,13,5
Sqxfkndog,ravencrest,1246,warlock,destruction,18,13,5
Needlez,twisting-nether,1246,warlock,destruction,18,13,5
Stunspectoo,turalyon,1246,warlock,destruction,34,23,11
Osyx,ravencrest,1246,warlock,destruction,28,15,13
Камнилока,booty-bay,1246,warlock,destruction,54,24,30
Skafferi,tarren-mill,1246,warlock,destruction,30,13,17
Chev,nemesis,1245,warlock,destruction,17,14,3
Pherlet,sylvanas,1245,warlock,destruction,24,13,11
Pushedover,outland,1245,warlock,destruction,27,14,13
Grumrah,argent-dawn,1245,warlock,destruction,179,83,96
Yhwäch,archimonde,1245,warlock,destruction,48,22,26
Yasagoth,chamber-of-aspects,1245,warlock,destruction,42,16,26
Krachol,emeriss,1244,warlock,destruction,24,13,11
Charmine,tarren-mill,1244,warlock,destruction,36,18,18
Fidlesticks,ragnaros,1244,warlock,destruction,33,15,18
Shena,chogall,1244,warlock,destruction,30,13,17
Raddikal,archimonde,1243,warlock,destruction,24,13,11
Hannahowo,garona,1243,warlock,destruction,24,13,11
Mystereo,bloodscalp,1243,warlock,destruction,41,21,20
Eleriya,argent-dawn,1243,warlock,destruction,28,14,14
Varyola,twisting-nether,1243,warlock,destruction,96,42,54
Dpsforehead,draenor,1242,warlock,destruction,19,13,6
Puiia,draenor,1242,warlock,destruction,97,53,44
Cajnik,sylvanas,1242,warlock,destruction,24,13,11
Zesekk,blackmoore,1242,warlock,destruction,194,87,107
Cursecannon,outland,1241,warlock,destruction,18,13,5
Goodbyex,aegwynn,1240,warlock,destruction,24,13,11
Lockismymain,eredar,1240,warlock,destruction,24,13,11
Анкхзул,howling-fjord,1240,warlock,destruction,24,13,11
Yumala,frostmourne,1240,warlock,destruction,48,24,24
Jimbrown,eredar,1240,warlock,destruction,50,23,27
Thigh,burning-legion,1240,warlock,destruction,30,13,17
Mawdogger,ravencrest,1239,warlock,destruction,18,13,5
Phît,kilrogg,1239,warlock,destruction,24,13,11
Lézion,hyjal,1239,warlock,destruction,27,14,13
Raspalakuja,kazzak,1239,warlock,destruction,30,13,17
Shagrab,nemesis,1238,warlock,destruction,63,36,27
Babayagâ,sanguino,1238,warlock,destruction,54,27,27
Somanydots,twisting-nether,1237,warlock,destruction,120,57,63
Xaok,dun-modr,1237,warlock,destruction,35,15,20
Møärdötd,aggra-português,1236,warlock,destruction,18,13,5
Pyroplasmic,tarren-mill,1236,warlock,destruction,77,46,31
Firinmalazor,blackrock,1236,warlock,destruction,72,35,37
Rawrix,blackrock,1236,warlock,destruction,30,13,17
Braveonê,twisting-nether,1235,warlock,destruction,120,60,60
Vulgrim,kirin-tor,1235,warlock,destruction,75,37,38
Finjas,azjolnerub,1235,warlock,destruction,72,34,38
Xanth,eldrethalas,1235,warlock,destruction,36,17,19
Bloodyknight,draenor,1234,warlock,destruction,79,47,32
Rodhad,kazzak,1234,warlock,destruction,24,13,11
Radanras,blackmoore,1234,warlock,destruction,24,13,11
Dotcha,ravencrest,1233,warlock,destruction,66,41,25
Zhoxx,outland,1233,warlock,destruction,30,13,17
Глянемче,deathguard,1233,warlock,destruction,40,17,23
Vae,doomhammer,1232,warlock,destruction,24,13,11
Scud,frostwolf,1232,warlock,destruction,24,13,11
Бесстолоч,ashenvale,1232,warlock,destruction,30,13,17
Felrazer,silvermoon,1232,warlock,destruction,30,13,17
Crysy,confrérie-du-thorium,1232,warlock,destruction,30,13,17
Veinh,archimonde,1231,warlock,destruction,24,17,7
Dér,sanguino,1231,warlock,destruction,24,13,11
Aurelíá,ravencrest,1231,warlock,destruction,71,32,39
Инсип,blackscar,1230,warlock,destruction,24,14,10
Murphloc,silvermoon,1230,warlock,destruction,38,20,18
Arnoediad,twisting-nether,1230,warlock,destruction,45,18,27
Keibo,drakthul,1228,warlock,destruction,30,13,17
Rottend,aggra-português,1228,warlock,destruction,81,35,46
Wolferand,argent-dawn,1228,warlock,destruction,42,17,25
Ромаколдун,howling-fjord,1227,warlock,destruction,30,13,17
Drfóx,draenor,1227,warlock,destruction,59,24,35
Cryd,thrall,1226,warlock,destruction,18,13,5
Blackojrien,outland,1226,warlock,destruction,24,13,11
Tepegöz,korgall,1226,warlock,destruction,28,14,14
Гринлайм,howling-fjord,1225,warlock,destruction,86,43,43
Байронет,gordunni,1225,warlock,destruction,30,13,17
Samigina,argent-dawn,1224,warlock,destruction,41,16,25
Xydar,stormscale,1223,warlock,destruction,42,21,21
Lokibra,antonidas,1223,warlock,destruction,131,62,69
Hejhana,drakthul,1223,warlock,destruction,126,57,69
Капризх,blackscar,1223,warlock,destruction,30,13,17
Cocottee,la-croisade-écarlate,1222,warlock,destruction,33,17,16
Кискатёмная,blackscar,1221,warlock,destruction,215,104,111
Adriankolock,sylvanas,1220,warlock,destruction,19,13,6
Chickoz,eredar,1220,warlock,destruction,109,57,52
Nopower,dun-morogh,1220,warlock,destruction,53,27,26
Diseased,darksorrow,1218,warlock,destruction,132,75,57
Fiendy,tarren-mill,1218,warlock,destruction,30,14,16
Chochliko,silvermoon,1218,warlock,destruction,36,13,23
Whippet,nemesis,1217,warlock,destruction,18,13,5
Góblér,blackrock,1217,warlock,destruction,45,23,22
Gdkw,tarren-mill,1217,warlock,destruction,78,32,46
Westfaliu,blackhand,1217,warlock,destruction,66,24,42
Bangbrös,stormscale,1216,warlock,destruction,24,13,11
Saereda,kazzak,1216,warlock,destruction,75,39,36
Borrìs,blackhand,1216,warlock,destruction,160,83,77
Oldemoilépti,hyjal,1216,warlock,destruction,30,14,16
Senaida,sylvanas,1215,warlock,destruction,88,49,39
Artyrus,burning-legion,1215,warlock,destruction,110,56,54
Gigoberto,kazzak,1214,warlock,destruction,23,13,10
Гулдас,thermaplugg,1214,warlock,destruction,45,22,23
Dominvs,silvermoon,1212,warlock,destruction,220,107,113
Guntok,tarren-mill,1211,warlock,destruction,37,22,15
Ganesha,sanguino,1210,warlock,destruction,35,16,19
Hyòx,aegwynn,1209,warlock,destruction,116,52,64
Wxl,kazzak,1208,warlock,destruction,60,39,21
Карлон,fordragon,1208,warlock,destruction,39,16,23
Sicktir,aerie-peak,1207,warlock,destruction,82,40,42
Musallat,argent-dawn,1207,warlock,destruction,28,13,15
Крутизол,fordragon,1206,warlock,destruction,43,25,18
Lokko,nemesis,1205,warlock,destruction,42,23,19
Patricius,malfurion,1205,warlock,destruction,29,13,16
Seymor,amanthul,1203,warlock,destruction,48,22,26
Ayóó,doomhammer,1202,warlock,destruction,107,58,49
Drthc,kazzak,1202,warlock,destruction,36,17,19
Mirrorz,kazzak,1200,warlock,destruction,47,24,23
Нотимба,gordunni,1198,warlock,destruction,48,28,20
Sortiarius,silvermoon,1198,warlock,destruction,110,60,50
Mumbay,ragnaros,1198,warlock,destruction,179,87,92
Raggnarlock,ravencrest,1198,warlock,destruction,36,14,22
Zenondoros,arthas,1195,warlock,destruction,21,13,8
Innok,pozzo-delleternità,1195,warlock,destruction,23,14,9
Имморталх,soulflayer,1195,warlock,destruction,38,17,21
Capichera,nemesis,1194,warlock,destruction,70,29,41
Lîlu,hyjal,1191,warlock,destruction,30,13,17
Стафилокок,deepholm,1190,warlock,destruction,23,13,10
Jackdot,antonidas,1190,warlock,destruction,24,13,11
Emoriy,blackmoore,1190,warlock,destruction,64,34,30
Plague,twisting-nether,1188,warlock,destruction,27,14,13
Binkybabes,outland,1188,warlock,destruction,57,27,30
Neffy,sinstralis,1188,warlock,destruction,76,31,45
Johntrabolta,chogall,1187,warlock,destruction,88,46,42
Irókuzito,aggra-português,1185,warlock,destruction,24,13,11
Евнухоидизм,gordunni,1185,warlock,destruction,42,16,26
Ðârk,silvermoon,1185,warlock,destruction,106,39,67
Kneereap,antonidas,1182,warlock,destruction,45,24,21
Idleglance,outland,1181,warlock,destruction,17,13,4
Oloki,kazzak,1181,warlock,destruction,96,47,49
Lucifa,arthas,1181,warlock,destruction,66,25,41
Mantimond,uldum,1180,warlock,destruction,132,66,66
Oxypvp,ravencrest,1179,warlock,destruction,69,27,42
Ренториан,gordunni,1178,warlock,destruction,29,13,16
Truckpunch,defias-brotherhood,1177,warlock,destruction,24,14,10
Loriene,trollbane,1177,warlock,destruction,28,16,12
Phàine,outland,1177,warlock,destruction,35,14,21
Kaeos,ravencrest,1176,warlock,destruction,24,15,9
Smuutil,drakthul,1176,warlock,destruction,36,20,16
Bèkshà,blackrock,1176,warlock,destruction,26,13,13
Heximexi,malganis,1176,warlock,destruction,36,16,20
Gosa,gorgonnash,1175,warlock,destruction,18,14,4
Stonysalami,turalyon,1175,warlock,destruction,42,28,14
Öyo,outland,1175,warlock,destruction,224,113,111
Локкрис,blackscar,1175,warlock,destruction,98,48,50
Áéé,kazzak,1175,warlock,destruction,46,21,25
Fathernurgle,hellfire,1173,warlock,destruction,99,53,46
Ðestrucko,burning-legion,1170,warlock,destruction,127,55,72
Lovrog,twisting-nether,1169,warlock,destruction,21,13,8
Thorenss,medivh,1168,warlock,destruction,128,61,67
Jossim,outland,1167,warlock,destruction,83,42,41
Армдэд,galakrond,1167,warlock,destruction,47,14,33
Cocadémo,archimonde,1166,warlock,destruction,31,13,18
Neprux,burning-blade,1165,warlock,destruction,135,59,76
Troo,daggerspine,1165,warlock,destruction,30,13,17
Aldyst,ragnaros,1163,warlock,destruction,47,20,27
Хефрак,deathguard,1161,warlock,destruction,79,38,41
Íntikam,blackrock,1160,warlock,destruction,54,25,29
Дифарес,gordunni,1159,warlock,destruction,18,13,5
Arkatraz,blackhand,1159,warlock,destruction,60,28,32
Cozyboi,thrall,1156,warlock,destruction,204,104,100
Drillingsdad,dun-morogh,1155,warlock,destruction,73,31,42
Feemers,thrall,1152,warlock,destruction,18,12,6
Nephystø,archimonde,1152,warlock,destruction,18,12,6
Dotjürgen,blackrock,1152,warlock,destruction,18,12,6
Traickolock,antonidas,1152,warlock,destruction,18,12,6
Phobilock,guldan,1152,warlock,destruction,18,12,6
Низвестнно,soulflayer,1152,warlock,destruction,18,12,6
Ekàti,ravencrest,1152,warlock,destruction,24,12,12
Lìmè,silvermoon,1152,warlock,destruction,24,12,12
Ðotbot,grim-batol,1152,warlock,destruction,24,12,12
Консидёро,gordunni,1152,warlock,destruction,30,12,18
Leman,sylvanas,1151,warlock,destruction,18,12,6
Элси,howling-fjord,1151,warlock,destruction,18,12,6
Jkz,blackrock,1151,warlock,destruction,21,13,8
Wspolnax,ravencrest,1151,warlock,destruction,24,12,12
Negoda,defias-brotherhood,1151,warlock,destruction,100,48,52
Estefanía,tarren-mill,1150,warlock,destruction,18,12,6
Yamadea,stormscale,1150,warlock,destruction,18,12,6
Kikaikek,stormscale,1150,warlock,destruction,18,12,6
Kitarah,blackrock,1150,warlock,destruction,18,12,6
Louên,dun-modr,1150,warlock,destruction,24,12,12
Tastemyzbay,hyjal,1150,warlock,destruction,24,12,12
Warlockxx,ravencrest,1150,warlock,destruction,24,12,12
Zyggdrasil,hyjal,1150,warlock,destruction,24,12,12
Fondudelock,hyjal,1150,warlock,destruction,30,12,18
Zehirisalari,twisting-nether,1150,warlock,destruction,36,12,24
Cárrymemommy,ravencrest,1149,warlock,destruction,18,12,6
Dallar,stormscale,1149,warlock,destruction,18,12,6
Scadar,kazzak,1149,warlock,destruction,18,12,6
Irwene,argent-dawn,1149,warlock,destruction,24,12,12
Qwyncess,archimonde,1149,warlock,destruction,24,12,12
Sorrayá,eredar,1148,warlock,destruction,77,34,43
ßritneyfears,blackmoore,1148,warlock,destruction,30,12,18
Kieman,tarren-mill,1148,warlock,destruction,36,12,24
Mewd,hyjal,1147,warlock,destruction,24,12,12
Höfmänn,grim-batol,1147,warlock,destruction,24,12,12
Hexam,blackmoore,1147,warlock,destruction,30,12,18
Favorizlmp,archimonde,1146,warlock,destruction,24,12,12
Mjuklock,ravencrest,1146,warlock,destruction,24,12,12
Forgepower,ghostlands,1146,warlock,destruction,24,12,12
Критолог,borean-tundra,1146,warlock,destruction,30,12,18
Solomohn,steamwheedle-cartel,1145,warlock,destruction,18,13,5
Yzïah,blackrock,1145,warlock,destruction,18,12,6
Sarajaylock,kazzak,1144,warlock,destruction,24,12,12
Thicklock,twisting-nether,1144,warlock,destruction,42,20,22
Jinxzed,frostwhisper,1143,warlock,destruction,18,12,6
Izurria,tarren-mill,1143,warlock,destruction,24,12,12
Fangdred,twisting-nether,1143,warlock,destruction,24,12,12
Ionutmanea,ravencrest,1143,warlock,destruction,41,16,25
Зажиженный,soulflayer,1142,warlock,destruction,21,12,9
Dathos,ragnaros,1142,warlock,destruction,54,26,28
Psychofear,kazzak,1142,warlock,destruction,30,12,18
Чпокерша,deepholm,1141,warlock,destruction,52,22,30
Numlockz,jaedenar,1141,warlock,destruction,30,12,18
Atruruz,antonidas,1140,warlock,destruction,95,49,46
Карамбут,fordragon,1140,warlock,destruction,99,43,56
Hymirr,arathor,1140,warlock,destruction,31,12,19
Вериберри,gordunni,1139,warlock,destruction,24,12,12
Yudy,burning-legion,1137,warlock,destruction,25,13,12
Whine,uldum,1137,warlock,destruction,149,75,74
Omnigul,grim-batol,1137,warlock,destruction,92,46,46
Halacska,arathor,1137,warlock,destruction,24,12,12
Ezekîél,blackhand,1137,warlock,destruction,156,68,88
Скул,soulflayer,1137,warlock,destruction,30,12,18
Rampelnicka,burning-blade,1135,warlock,destruction,24,12,12
Делегент,deathguard,1134,warlock,destruction,114,44,70
Joopz,ravencrest,1133,warlock,destruction,46,23,23
Wildlily,aggramar,1131,warlock,destruction,46,24,22
Nirây,thrall,1131,warlock,destruction,61,19,42
Shadowflare,blackmoore,1130,warlock,destruction,38,15,23
Valkiá,earthen-ring,1129,warlock,destruction,112,57,55
Panicbolt,ravencrest,1129,warlock,destruction,24,12,12
Lomis,wrathbringer,1129,warlock,destruction,91,41,50
Bojjisama,silvermoon,1128,warlock,destruction,18,12,6
Drdotalot,twisting-nether,1126,warlock,destruction,24,12,12
Squát,kazzak,1125,warlock,destruction,24,12,12
Whiskeycola,blackmoore,1124,warlock,destruction,18,12,6
Rrore,ravencrest,1124,warlock,destruction,24,12,12
Тарналор,gordunni,1124,warlock,destruction,36,14,22
Oishi,kaelthas,1124,warlock,destruction,38,13,25
Darkà,rexxar,1121,warlock,destruction,24,13,11
Killerbeez,burning-blade,1121,warlock,destruction,48,18,30
Подликерная,howling-fjord,1120,warlock,destruction,18,12,6
Стейн,soulflayer,1120,warlock,destruction,57,24,33
Xioom,thrall,1120,warlock,destruction,52,17,35
Laanik,twisting-nether,1119,warlock,destruction,20,13,7
Fiddlock,draenor,1117,warlock,destruction,22,13,9
Shololock,kazzak,1116,warlock,destruction,20,13,7
Aftxrlife,arathor,1116,warlock,destruction,22,13,9
Noobtamer,kazzak,1116,warlock,destruction,23,12,11
Langeklunker,outland,1116,warlock,destruction,24,12,12
Биги,eversong,1115,warlock,destruction,47,16,31
Fromfuneral,anetheron,1114,warlock,destruction,170,93,77
Kharless,kazzak,1114,warlock,destruction,49,25,24
Микрочпоньк,galakrond,1113,warlock,destruction,24,14,10
Слававдвх,blackscar,1112,warlock,destruction,84,48,36
Tid,burning-legion,1112,warlock,destruction,23,12,11
Çüñ,shattered-hand,1111,warlock,destruction,23,12,11
Maxxilla,twisting-nether,1111,warlock,destruction,258,124,134
Nelektaus,stormscale,1110,warlock,destruction,24,12,12
Аномаликах,gordunni,1105,warlock,destruction,24,12,12
Gastkäft,shadowsong,1105,warlock,destruction,73,34,39
Kharzug,alakir,1105,warlock,destruction,39,16,23
Naniika,blackmoore,1104,warlock,destruction,84,50,34
Shadowbolt,outland,1104,warlock,destruction,27,12,15
Mîtskî,argent-dawn,1104,warlock,destruction,44,19,25
Bigdambolt,blackrock,1103,warlock,destruction,17,12,5
Lagoren,draenor,1102,warlock,destruction,24,12,12
Runthejewels,ragnaros,1101,warlock,destruction,30,12,18
Whitebanshee,turalyon,1099,warlock,destruction,54,31,23
Fatality,drakthul,1099,warlock,destruction,26,13,13
Pidka,drakthul,1098,warlock,destruction,24,17,7
Fearco,ravencrest,1096,warlock,destruction,21,13,8
Rikkai,anubarak,1096,warlock,destruction,24,12,12
Hivxherpes,ravencrest,1095,warlock,destruction,29,12,17
Rasputia,thunderhorn,1091,warlock,destruction,127,65,62
Даркинсоул,soulflayer,1090,warlock,destruction,21,13,8
Crippling,antonidas,1088,warlock,destruction,56,22,34
Yokûjin,twisting-nether,1087,warlock,destruction,23,12,11
Уставок,soulflayer,1087,warlock,destruction,42,20,22
Cuteyess,shadowsong,1086,warlock,destruction,23,12,11
Buserella,eredar,1085,warlock,destruction,30,12,18
Vendømlørd,archimonde,1083,warlock,destruction,36,12,24
Qloss,burning-legion,1080,warlock,destruction,56,25,31
Bunnyflow,blackmoore,1080,warlock,destruction,34,13,21
Бигтедок,gordunni,1079,warlock,destruction,164,83,81
Ruul,sanguino,1079,warlock,destruction,50,20,30
Шоуганай,soulflayer,1078,warlock,destruction,61,31,30
Skybert,sunstrider,1077,warlock,destruction,30,15,15
Konstantína,eredar,1076,warlock,destruction,217,108,109
Pff,emeriss,1074,warlock,destruction,41,22,19
Jinckslock,anachronos,1072,warlock,destruction,13,12,1
Vyku,burning-legion,1070,warlock,destruction,36,12,24
Ymersai,stormscale,1069,warlock,destruction,105,49,56
Cainn,kilrogg,1067,warlock,destruction,48,23,25
Olympos,draenor,1067,warlock,destruction,60,28,32
Demonjailer,kazzak,1067,warlock,destruction,27,12,15
Marann,dun-morogh,1066,warlock,destruction,44,26,18
Nôgariûs,blackrock,1065,warlock,destruction,29,13,16
Lefttorot,garrosh,1062,warlock,destruction,52,24,28
Korne,nemesis,1061,warlock,destruction,108,44,64
Drfresh,dun-modr,1060,warlock,destruction,54,17,37
Amon,suramar,1058,warlock,destruction,55,28,27
Babidí,blackmoore,1057,warlock,destruction,48,27,21
Ammitra,argent-dawn,1057,warlock,destruction,25,12,13
Kënnyfõx,ysondre,1056,warlock,destruction,12,11,1
Hexiønløck,archimonde,1056,warlock,destruction,12,11,1
Кремация,blackscar,1056,warlock,destruction,18,11,7
Ltoplaylock,turalyon,1056,warlock,destruction,18,11,7
Fjutta,outland,1056,warlock,destruction,18,11,7
Havocgodxx,stormscale,1056,warlock,destruction,18,11,7
Kankbae,stormscale,1056,warlock,destruction,18,11,7
Незерлок,soulflayer,1056,warlock,destruction,18,11,7
Projectlock,draenor,1056,warlock,destruction,18,11,7
Teemzen,tarren-mill,1056,warlock,destruction,24,11,13
Ratziel,sylvanas,1056,warlock,destruction,42,15,27
Rüjï,sanguino,1056,warlock,destruction,54,19,35
Resterx,blackhand,1055,warlock,destruction,12,11,1
Neverfearjk,aegwynn,1055,warlock,destruction,18,11,7
Goatsoklm,archimonde,1055,warlock,destruction,18,11,7
Razzalock,eredar,1055,warlock,destruction,24,11,13
Dalyvan,blackrock,1055,warlock,destruction,24,11,13
Methmuncher,twisting-nether,1055,warlock,destruction,50,19,31
Boltsnhoes,tarren-mill,1055,warlock,destruction,30,11,19
Flatulenzus,blackrock,1055,warlock,destruction,30,11,19
Tørcal,hyjal,1054,warlock,destruction,18,11,7
Dontargetme,draenor,1054,warlock,destruction,18,11,7
Buudds,frostmane,1054,warlock,destruction,18,11,7
Коломо,soulflayer,1054,warlock,destruction,18,11,7
Sleive,ravencrest,1054,warlock,destruction,18,11,7
Archí,twisting-nether,1054,warlock,destruction,18,11,7
Ronniee,moonglade,1054,warlock,destruction,18,11,7
Finlock,kult-der-verdammten,1054,warlock,destruction,21,12,9
Elmáestro,aegwynn,1054,warlock,destruction,21,12,9
Jelessa,lordaeron,1054,warlock,destruction,24,11,13
Ullalol,magtheridon,1054,warlock,destruction,24,11,13
Mentalx,outland,1054,warlock,destruction,24,11,13
Lilkit,kazzak,1054,warlock,destruction,36,11,25
Ржоммба,soulflayer,1053,warlock,destruction,18,11,7
Томмиджонсон,gordunni,1053,warlock,destruction,18,11,7
Хэлласс,blackscar,1053,warlock,destruction,24,11,13
Sôlon,azshara,1053,warlock,destruction,24,11,13
Shadowthrone,ragnaros,1053,warlock,destruction,24,11,13
Yenex,blackhand,1053,warlock,destruction,32,14,18
Костикк,howling-fjord,1052,warlock,destruction,18,11,7
Phicon,silvermoon,1052,warlock,destruction,18,11,7
Harrydóttár,draenor,1052,warlock,destruction,24,11,13
Jasdemonly,stormscale,1052,warlock,destruction,24,11,13
Disgraced,stormscale,1051,warlock,destruction,24,11,13
Ráklock,ragnaros,1051,warlock,destruction,24,11,13
Numidia,tarren-mill,1051,warlock,destruction,24,11,13
Katâra,tarren-mill,1051,warlock,destruction,30,11,19
Peterpaîn,blackmoore,1050,warlock,destruction,22,14,8
Hargart,ysondre,1050,warlock,destruction,18,11,7
Nelor,tarren-mill,1050,warlock,destruction,27,15,12
Нейросетьтут,howling-fjord,1050,warlock,destruction,24,11,13
Oralnatqga,draenor,1050,warlock,destruction,76,31,45
Vraduk,malygos,1049,warlock,destruction,32,19,13
Jynni,blackhand,1048,warlock,destruction,18,11,7
Гнильен,soulflayer,1048,warlock,destruction,18,11,7
Rylewl,draenor,1048,warlock,destruction,30,11,19
Synnox,blackrock,1047,warlock,destruction,30,15,15
Рыжевласочка,eversong,1046,warlock,destruction,21,12,9
Bribon,sanguino,1046,warlock,destruction,110,41,69
Kontanthjælp,tarren-mill,1046,warlock,destruction,30,11,19
Yénnéfér,ravencrest,1046,warlock,destruction,33,11,22
Diavoletta,pozzo-delleternità,1046,warlock,destruction,48,11,37
Vech,blackmoore,1045,warlock,destruction,18,11,7
Slattkica,draenor,1044,warlock,destruction,18,11,7
Esthrella,thrall,1044,warlock,destruction,85,45,40
Emmadotson,gorgonnash,1042,warlock,destruction,30,11,19
Ðear,blackrock,1041,warlock,destruction,18,11,7
Дулаан,blackscar,1041,warlock,destruction,46,17,29
Galaxywl,silvermoon,1041,warlock,destruction,30,11,19
Tbb,ravencrest,1040,warlock,destruction,24,11,13
Waîdo,blackhand,1040,warlock,destruction,30,11,19
Kalemma,kazzak,1039,warlock,destruction,32,16,16
Riitaall,khaz-modan,1038,warlock,destruction,78,30,48
Pallma,tarren-mill,1038,warlock,destruction,30,11,19
Kokonix,defias-brotherhood,1033,warlock,destruction,24,11,13
Nathgar,drakthul,1032,warlock,destruction,72,27,45
Äzarel,khaz-modan,1031,warlock,destruction,48,29,19
Tommies,die-nachtwache,1031,warlock,destruction,57,24,33
Precks,eredar,1031,warlock,destruction,30,11,19
Discolocken,outland,1030,warlock,destruction,30,12,18
Sitosa,todeswache,1027,warlock,destruction,18,11,7
Accursîus,blackmoore,1027,warlock,destruction,21,11,10
Schöp,der-rat-von-dalaran,1027,warlock,destruction,71,32,39
Demonoulis,bloodhoof,1026,warlock,destruction,18,11,7
Loliloz,les-clairvoyants,1026,warlock,destruction,35,18,17
Ainzlok,tarren-mill,1026,warlock,destruction,68,33,35
Maimonides,silvermoon,1025,warlock,destruction,35,17,18
Nava,stormscale,1024,warlock,destruction,28,12,16
Fguldan,zuljin,1023,warlock,destruction,16,11,5
Jaqqy,blackmoore,1022,warlock,destruction,50,28,22
Orisess,bronze-dragonflight,1022,warlock,destruction,147,75,72
Avati,sargeras,1018,warlock,destruction,30,14,16
Klasikas,kazzak,1016,warlock,destruction,27,12,15
Tarot,terokkar,1015,warlock,destruction,24,11,13
Angua,azuremyst,1014,warlock,destruction,22,11,11
Avoidsun,kazzak,1013,warlock,destruction,34,12,22
Lárgo,chamber-of-aspects,1012,warlock,destruction,29,12,17
Elshinko,stormscale,1010,warlock,destruction,26,12,14
Zardøx,khaz-modan,1009,warlock,destruction,18,12,6
Condalini,runetotem,1005,warlock,destruction,80,40,40
Mângo,thunderhorn,1004,warlock,destruction,24,11,13
Ванфирмен,gordunni,1004,warlock,destruction,24,11,13
Silith,magtheridon,1003,warlock,destruction,20,12,8
Llilith,bronzebeard,1003,warlock,destruction,24,11,13
Mïllâïneeqtx,archimonde,1002,warlock,destruction,19,13,6
Galagoat,archimonde,1002,warlock,destruction,30,15,15
Babayagaa,drakthul,1002,warlock,destruction,26,11,15
Iltharian,die-todeskrallen,1000,warlock,destruction,17,11,6
Kypamu,outland,997,warlock,destruction,48,18,30
Desolador,tyrande,996,warlock,destruction,23,11,12
Jackwizzer,dalaran,995,warlock,destruction,42,11,31
Petrosk,sanguino,990,warlock,destruction,26,11,15
Ottu,thrall,988,warlock,destruction,20,11,9
Lynchéd,argent-dawn,986,warlock,destruction,17,11,6
Ömegaa,hyjal,985,warlock,destruction,20,11,9
Sînâ,anubarak,984,warlock,destruction,36,11,25
Krastey,malfurion,983,warlock,destruction,16,11,5
Llilithh,draenor,983,warlock,destruction,16,11,5
Ileeo,kazzak,980,warlock,destruction,73,38,35
Dorothy,steamwheedle-cartel,978,warlock,destruction,24,15,9
Dakc,kazzak,978,warlock,destruction,60,22,38
Шайтанарба,blackscar,977,warlock,destruction,42,17,25
Happysrme,thrall,977,warlock,destruction,56,15,41
Scrabblee,dun-morogh,976,warlock,destruction,30,11,19
Thorins,sinstralis,972,warlock,destruction,30,12,18
Sickdotter,outland,971,warlock,destruction,77,29,48
Ахпорбес,gordunni,968,warlock,destruction,30,16,14
Gâlvâtorix,frostmourne,968,warlock,destruction,90,39,51
Huesecillo,sanguino,967,warlock,destruction,24,14,10
Àtreyù,daggerspine,966,warlock,destruction,128,53,75
Vinilio,kazzak,963,warlock,destruction,98,40,58
Blâckmagíc,thrall,962,warlock,destruction,26,13,13
Demox,arathor,962,warlock,destruction,26,11,15
Tchytcha,archimonde,961,warlock,destruction,59,28,31
Botrotation,ravencrest,960,warlock,destruction,12,10,2
Garb,stormreaver,960,warlock,destruction,12,10,2
Graystache,blackhand,960,warlock,destruction,12,10,2
Måracujå,kazzak,960,warlock,destruction,12,10,2
Korialstraz,sylvanas,960,warlock,destruction,12,10,2
Nefariousz,bloodfeather,960,warlock,destruction,12,10,2
Lurian,silvermoon,960,warlock,destruction,12,10,2
Slomg,sylvanas,960,warlock,destruction,12,10,2
Joinx,tarren-mill,960,warlock,destruction,12,10,2
Jamuhlee,der-abyssische-rat,960,warlock,destruction,12,10,2
Nerfmeplz,archimonde,960,warlock,destruction,12,10,2
Destrolockz,tarren-mill,960,warlock,destruction,16,11,5
Chaotick,burning-legion,960,warlock,destruction,18,10,8
Trickytée,tarren-mill,960,warlock,destruction,18,10,8
Ilovethena,hyjal,960,warlock,destruction,18,10,8
Ðåñtåy,ravencrest,960,warlock,destruction,18,10,8
Adoxilock,twisting-nether,960,warlock,destruction,18,10,8
Gutrass,ragnaros,960,warlock,destruction,18,10,8
Ммоохх,gordunni,960,warlock,destruction,18,10,8
Turdy,sylvanas,960,warlock,destruction,18,10,8
Tøtøf,sargeras,960,warlock,destruction,18,10,8
Zzooxx,silvermoon,960,warlock,destruction,18,10,8
Dmnw,antonidas,960,warlock,destruction,18,10,8
Zzooxxie,silvermoon,960,warlock,destruction,18,10,8
Dst,ravencrest,960,warlock,destruction,18,10,8
Imissbfa,stormscale,960,warlock,destruction,22,11,11
Hêxêr,terrordar,960,warlock,destruction,42,19,23
Asper,ragnaros,960,warlock,destruction,24,10,14
Skali,stormrage,960,warlock,destruction,24,10,14
Ammilock,aszune,959,warlock,destruction,12,10,2
Droguri,darkspear,959,warlock,destruction,12,10,2
Demonqueens,kazzak,959,warlock,destruction,12,10,2
Zízýéró,sylvanas,959,warlock,destruction,12,10,2
Positivitywl,stormscale,959,warlock,destruction,18,10,8
Vät,kirin-tor,959,warlock,destruction,18,10,8
Femalenjoyer,tarren-mill,959,warlock,destruction,18,10,8
Boomdalf,silvermoon,959,warlock,destruction,18,10,8
Kekbólt,twisting-nether,959,warlock,destruction,18,10,8
Nopainnodot,aegwynn,959,warlock,destruction,18,10,8
Chaostrain,sylvanas,959,warlock,destruction,18,10,8
Phøénixx,dalaran,959,warlock,destruction,18,10,8
Dotáhoe,twisting-nether,959,warlock,destruction,18,10,8
Vexsir,kazzak,959,warlock,destruction,21,11,10
Necromonger,blackrock,959,warlock,destruction,24,10,14
Dabolt,archimonde,959,warlock,destruction,24,10,14
Колмидедди,gordunni,959,warlock,destruction,24,10,14
Kaldun,outland,959,warlock,destruction,24,10,14
Shazalock,frostmane,959,warlock,destruction,24,10,14
Ogrez,nemesis,959,warlock,destruction,30,10,20
Slâyâ,blackrock,958,warlock,destruction,12,10,2
Filippö,eredar,958,warlock,destruction,18,10,8
Адво,howling-fjord,958,warlock,destruction,18,10,8
Dampini,ravencrest,958,warlock,destruction,18,10,8
Torcal,archimonde,958,warlock,destruction,18,10,8
Релента,gordunni,958,warlock,destruction,18,10,8
Kwei,nemesis,958,warlock,destruction,18,10,8
Drainurlife,zenedar,958,warlock,destruction,18,10,8
Revhy,ravencrest,958,warlock,destruction,18,10,8
Kenybalajze,the-maelstrom,958,warlock,destruction,18,10,8
Banette,sylvanas,958,warlock,destruction,18,10,8
Cryks,blackmoore,958,warlock,destruction,21,11,10
Dèv,draenor,958,warlock,destruction,24,10,14
Марэд,howling-fjord,958,warlock,destruction,24,10,14
Zorlon,frostmane,957,warlock,destruction,12,10,2
Nimmyjewtron,tarren-mill,957,warlock,destruction,18,10,8
Hexdoc,alakir,957,warlock,destruction,18,10,8
Schmexer,blutkessel,957,warlock,destruction,18,10,8
Naabz,naxxramas,957,warlock,destruction,18,10,8
Inhúman,kazzak,957,warlock,destruction,18,10,8
Телкадрейнх,gordunni,957,warlock,destruction,21,11,10
Allêgrâ,blackrock,957,warlock,destruction,20,10,10
Dïna,silvermoon,956,warlock,destruction,24,10,14
Lisànna,nemesis,956,warlock,destruction,24,10,14
Absurdd,turalyon,955,warlock,destruction,16,11,5
Thranerm,ravencrest,955,warlock,destruction,24,10,14
Банкапевка,howling-fjord,955,warlock,destruction,24,10,14
Dâhrul,argent-dawn,955,warlock,destruction,24,10,14
Chlöê,hyjal,954,warlock,destruction,18,10,8
Ezze,thrall,954,warlock,destruction,18,10,8
Nauriela,blackmoore,954,warlock,destruction,18,10,8
Gerart,tarren-mill,953,warlock,destruction,18,10,8
Chaoscu,twisting-nether,952,warlock,destruction,18,10,8
Soulnia,defias-brotherhood,952,warlock,destruction,18,10,8
Tzimice,hyjal,952,warlock,destruction,24,10,14
Lorock,rajaxx,952,warlock,destruction,30,10,20
Minniemøuse,silvermoon,951,warlock,destruction,18,10,8
Skitless,blackmoore,951,warlock,destruction,24,10,14
Nahamma,tarren-mill,951,warlock,destruction,24,10,14
Ihateyouguys,auchindoun,951,warlock,destruction,24,10,14
Деморвун,soulflayer,951,warlock,destruction,30,10,20
Zow,dun-modr,950,warlock,destruction,24,10,14
Bandìtten,alakir,949,warlock,destruction,18,10,8
Fbomber,ravencrest,948,warlock,destruction,12,10,2
Elayjalock,twisting-nether,948,warlock,destruction,24,10,14
Шейп,fordragon,948,warlock,destruction,46,12,34
Delara,drakthul,943,warlock,destruction,18,10,8
Манапчик,soulflayer,942,warlock,destruction,24,10,14
Neuth,draenor,941,warlock,destruction,30,10,20
Fujiitøra,ysondre,939,warlock,destruction,39,17,22
Мааверш,soulflayer,939,warlock,destruction,36,11,25
Адомать,lich-king,935,warlock,destruction,24,10,14
Belzébut,confrérie-du-thorium,935,warlock,destruction,34,13,21
Trusting,archimonde,934,warlock,destruction,14,11,3
Saleus,argent-dawn,934,warlock,destruction,21,11,10
Dollmak,hyjal,934,warlock,destruction,105,49,56
Снчч,soulflayer,933,warlock,destruction,23,10,13
Äbsalom,hyjal,931,warlock,destruction,193,97,96
Demowlition,archimonde,931,warlock,destruction,42,14,28
Britneyfear,aegwynn,927,warlock,destruction,14,11,3
Racursed,outland,927,warlock,destruction,16,10,6
Mintimperial,alakir,927,warlock,destruction,29,10,19
Mádará,tarren-mill,926,warlock,destruction,20,11,9
Архидрако,gordunni,925,warlock,destruction,44,17,27
Wizdoom,outland,924,warlock,destruction,22,11,11
Sulnar,burning-legion,924,warlock,destruction,23,10,13
Troyana,chants-éternels,914,warlock,destruction,120,60,60
Kárdur,blackmoore,912,warlock,destruction,20,11,9
Smithlock,blackrock,912,warlock,destruction,21,11,10
Lhester,outland,912,warlock,destruction,21,10,11
Purplemonkey,burning-blade,911,warlock,destruction,17,10,7
Absúrd,turalyon,911,warlock,destruction,21,10,11
Фламмэнх,soulflayer,911,warlock,destruction,23,10,13
Cruckz,nathrezim,910,warlock,destruction,15,10,5
Caiiden,kazzak,905,warlock,destruction,18,11,7
Jesez,aegwynn,905,warlock,destruction,22,11,11
Janneraut,terokkar,905,warlock,destruction,36,14,22
Orcboltz,tarren-mill,903,warlock,destruction,110,48,62
Destroc,blackrock,902,warlock,destruction,23,11,12
Чернокай,gordunni,895,warlock,destruction,16,10,6
Реалсамка,gordunni,895,warlock,destruction,17,10,7
Würrzag,kazzak,894,warlock,destruction,17,10,7
Eyzu,stormscale,894,warlock,destruction,17,10,7
Felcollins,sylvanas,892,warlock,destruction,20,10,10
Zozano,draenor,891,warlock,destruction,22,10,12
Zanzarismo,nemesis,886,warlock,destruction,14,10,4
Müdür,burning-legion,880,warlock,destruction,20,10,10
Vogz,burning-legion,877,warlock,destruction,25,10,15
Zøhaz,burning-legion,876,warlock,destruction,104,45,59
Fhla,kazzak,864,warlock,destruction,12,9,3
Dboyy,tarren-mill,864,warlock,destruction,12,9,3
Mìzengard,eredar,864,warlock,destruction,12,9,3
Lcollector,outland,864,warlock,destruction,12,9,3
Osclo,ravencrest,864,warlock,destruction,12,9,3
Zakazal,argent-dawn,864,warlock,destruction,12,9,3
Vamanos,stormscale,864,warlock,destruction,12,9,3
Chaosboba,silvermoon,864,warlock,destruction,12,9,3
Predlocktwo,twisting-nether,864,warlock,destruction,12,9,3
Дядяджони,gordunni,864,warlock,destruction,12,9,3
Boltmaster,burning-legion,864,warlock,destruction,12,9,3
Лооган,blackscar,864,warlock,destruction,12,9,3
Menocast,archimonde,864,warlock,destruction,12,9,3
Insomniæc,ravencrest,864,warlock,destruction,12,9,3
Trimar,archimonde,864,warlock,destruction,12,9,3
Peon,blackrock,864,warlock,destruction,12,9,3
Chàsx,archimonde,864,warlock,destruction,12,9,3
Reizouka,twisting-nether,864,warlock,destruction,12,9,3
Jackalabrute,dalaran,864,warlock,destruction,12,9,3
Priceburn,ravencrest,864,warlock,destruction,15,10,5
Beltazhor,kazzak,864,warlock,destruction,16,10,6
Demonbot,kazzak,864,warlock,destruction,15,9,6
Aggressivé,twisting-nether,864,warlock,destruction,17,9,8
Gulzot,turalyon,864,warlock,destruction,18,9,9
Fascino,nazjatar,864,warlock,destruction,18,9,9
Ubinaz,blackmoore,864,warlock,destruction,18,9,9
Köftemec,blackrock,864,warlock,destruction,18,9,9
Gremmus,outland,864,warlock,destruction,18,9,9
Joleptem,outland,864,warlock,destruction,18,9,9
Cursè,stormscale,864,warlock,destruction,18,9,9
Séxenmeister,argent-dawn,864,warlock,destruction,24,9,15
Milfhaunter,aegwynn,864,warlock,destruction,24,9,15
Fearpuss,dun-modr,863,warlock,destruction,12,9,3
Elissa,skullcrusher,863,warlock,destruction,12,9,3
Castller,burning-legion,863,warlock,destruction,12,9,3
Goatpuss,stormrage,863,warlock,destruction,12,9,3
Zelyx,archimonde,863,warlock,destruction,12,9,3
Narzok,kazzak,863,warlock,destruction,12,9,3
Dezowenn,draenor,863,warlock,destruction,12,9,3
Zxcursed,doomhammer,863,warlock,destruction,12,9,3
Metalac,tarren-mill,863,warlock,destruction,12,9,3
Evilonion,outland,863,warlock,destruction,12,9,3
Psykokwette,kirin-tor,863,warlock,destruction,12,9,3
Felgibson,destromath,863,warlock,destruction,12,9,3
Elerodril,ysondre,863,warlock,destruction,12,9,3
Tyrantlol,sylvanas,863,warlock,destruction,18,9,9
Острогриф,gordunni,863,warlock,destruction,18,9,9
Hydock,twisting-nether,863,warlock,destruction,18,9,9
Wårlørd,ragnaros,863,warlock,destruction,18,9,9
Andrealphus,outland,863,warlock,destruction,18,9,9
Súícìdèbøy,colinas-pardas,863,warlock,destruction,18,9,9
Vladov,ravencrest,863,warlock,destruction,18,9,9
Тарои,howling-fjord,863,warlock,destruction,18,9,9
Sethtarr,draenor,863,warlock,destruction,18,9,9
Ralyz,archimonde,863,warlock,destruction,18,9,9
Zharae,thrall,863,warlock,destruction,18,9,9
Pujatia,tarren-mill,863,warlock,destruction,18,9,9
Nazrõth,stormscale,863,warlock,destruction,18,9,9
Burningdemon,kazzak,863,warlock,destruction,18,9,9
Moardotts,ravencrest,863,warlock,destruction,19,9,10
Getfeared,draenor,863,warlock,destruction,24,9,15
Squiddles,sylvanas,863,warlock,destruction,24,9,15
Uezzalock,nemesis,863,warlock,destruction,24,9,15
Meningitis,tyrande,863,warlock,destruction,24,9,15
Мглавечная,soulflayer,863,warlock,destruction,31,9,22
Zeralia,nemesis,862,warlock,destruction,12,9,3
Bíggun,outland,862,warlock,destruction,12,9,3
Lanmarieberg,stormscale,862,warlock,destruction,12,9,3
Biihz,ysondre,862,warlock,destruction,12,9,3
Larzarus,aegwynn,862,warlock,destruction,18,9,9
Kuntdotz,draenor,862,warlock,destruction,18,9,9
Arthesia,archimonde,862,warlock,destruction,18,9,9
Deamions,ravencrest,862,warlock,destruction,18,9,9
Voidllynx,sylvanas,862,warlock,destruction,18,9,9
Enviroq,burning-legion,862,warlock,destruction,18,9,9
Otemlock,sanguino,862,warlock,destruction,18,9,9
Nili,dethecus,862,warlock,destruction,18,9,9
Banton,blackmoore,862,warlock,destruction,24,9,15
Grol,terokkar,861,warlock,destruction,18,11,7
Skizi,ysondre,861,warlock,destruction,18,9,9
Darkremorsez,alakir,861,warlock,destruction,24,9,15
Xeró,quelthalas,860,warlock,destruction,12,9,3
Locknroll,terokkar,860,warlock,destruction,18,9,9
Adafbhf,tichondrius,859,warlock,destruction,18,9,9
Swank,twisting-nether,859,warlock,destruction,18,9,9
Zakuri,blackmoore,859,warlock,destruction,18,9,9
Yoghurth,silvermoon,859,warlock,destruction,21,10,11
Arlu,blackrock,859,warlock,destruction,82,37,45
Андурон,galakrond,859,warlock,destruction,27,10,17
Helldozer,nordrassil,858,warlock,destruction,18,9,9
Schluépfêr,blackrock,858,warlock,destruction,18,9,9
Хемираги,soulflayer,858,warlock,destruction,24,9,15
Ravendoor,grim-batol,856,warlock,destruction,24,9,15
Fearmex,turalyon,854,warlock,destruction,18,9,9
Xolìe,azshara,853,warlock,destruction,18,9,9
Colevid,blackmoore,850,warlock,destruction,69,28,41
Ternisia,draenor,846,warlock,destruction,20,10,10
Лацерта,howling-fjord,838,warlock,destruction,12,9,3
Lauro,blackmoore,830,warlock,destruction,14,10,4
Vêzor,twisting-nether,830,warlock,destruction,17,11,6
Lokelicious,ragnaros,829,warlock,destruction,23,9,14
Dmondmg,kazzak,828,warlock,destruction,23,9,14
Kritcheq,alakir,824,warlock,destruction,104,49,55
Oddchap,magtheridon,822,warlock,destruction,89,38,51
Flisiakm,exodar,818,warlock,destruction,99,47,52
Phennrym,kazzak,815,warlock,destruction,17,9,8
Indynamo,blackrock,815,warlock,destruction,17,9,8
Shakuroz,frostwolf,815,warlock,destruction,27,10,17
Silvercurse,azuremyst,814,warlock,destruction,23,9,14
Dalfgan,wildhammer,808,warlock,destruction,137,61,76
Blëssed,aegwynn,799,warlock,destruction,20,10,10
Isendnukes,darkspear,798,warlock,destruction,14,9,5
Birraslad,silvermoon,797,warlock,destruction,16,9,7
Sacmaboltz,kazzak,797,warlock,destruction,22,9,13
Eisenkiefer,thrall,792,warlock,destruction,81,28,53
Ogiez,draenor,768,warlock,destruction,12,8,4
Muyutrix,eredar,768,warlock,destruction,12,8,4
Namarin,die-aldor,768,warlock,destruction,12,8,4
Vezmollo,stormscale,768,warlock,destruction,12,8,4
Menescurse,blackhand,768,warlock,destruction,12,8,4
Verminosiss,stormscale,768,warlock,destruction,12,8,4
Emolord,ravencrest,768,warlock,destruction,12,8,4
Yzzie,drakthul,768,warlock,destruction,12,8,4
Sebikqt,ravencrest,768,warlock,destruction,12,8,4
Læssêkøñgð,twisting-nether,768,warlock,destruction,12,8,4
Côr,twisting-nether,768,warlock,destruction,12,8,4
Cheeseyballs,ravencrest,768,warlock,destruction,12,8,4
Trembly,alakir,768,warlock,destruction,12,8,4
Gravewatcher,twisting-nether,768,warlock,destruction,12,8,4
Rikuu,ravencrest,768,warlock,destruction,12,8,4
Doublebolt,the-maelstrom,768,warlock,destruction,12,8,4
Nodavé,stormscale,768,warlock,destruction,12,8,4
Covidian,stormscale,768,warlock,destruction,12,8,4
Sniffy,stormreaver,768,warlock,destruction,12,8,4
Crunel,ragnaros,768,warlock,destruction,12,8,4
Андаинг,soulflayer,768,warlock,destruction,12,8,4
Kitingguru,stormscale,768,warlock,destruction,12,8,4
Psychoduck,stormscale,768,warlock,destruction,12,8,4
Dáinsleif,dun-modr,768,warlock,destruction,12,8,4
Gebkan,hyjal,768,warlock,destruction,12,8,4
Benafflock,veknilash,768,warlock,destruction,12,8,4
Miniparanoik,silvermoon,768,warlock,destruction,12,8,4
Ампе,blackscar,768,warlock,destruction,12,8,4
Журанайсбой,blackscar,768,warlock,destruction,12,8,4
Destrodmitri,blackmoore,768,warlock,destruction,12,8,4
Disnyo,outland,768,warlock,destruction,12,8,4
Detoxa,outland,768,warlock,destruction,12,8,4
Dadylock,silvermoon,768,warlock,destruction,12,8,4
Nasalies,grim-batol,768,warlock,destruction,12,8,4
Миражлок,gordunni,768,warlock,destruction,12,8,4
Firecast,kazzak,768,warlock,destruction,12,8,4
Dmonlock,hyjal,768,warlock,destruction,12,8,4
Gambos,kazzak,768,warlock,destruction,12,8,4
Aket,kazzak,768,warlock,destruction,12,8,4
Deathmahed,kazzak,768,warlock,destruction,12,8,4
Mosskok,kazzak,768,warlock,destruction,16,9,7
Эпсизануда,soulflayer,768,warlock,destruction,18,8,10
Mcsmitelock,argent-dawn,768,warlock,destruction,18,8,10
Hsheam,kazzak,768,warlock,destruction,18,8,10
Syntaxzwo,blackmoore,768,warlock,destruction,18,8,10
Némésiø,archimonde,768,warlock,destruction,18,8,10
Dirtyjoe,doomhammer,768,warlock,destruction,18,8,10
Vexlock,rexxar,768,warlock,destruction,18,8,10
Melforius,tarren-mill,768,warlock,destruction,18,8,10
Sargasus,kazzak,768,warlock,destruction,18,8,10
Guldãn,silvermoon,768,warlock,destruction,24,8,16
Gimmê,dun-morogh,767,warlock,destruction,12,8,4
Mentaldeadw,draenor,767,warlock,destruction,12,8,4
Capnaga,draenor,767,warlock,destruction,12,8,4
Эльбардо,soulflayer,767,warlock,destruction,12,8,4
Aribethion,draenor,767,warlock,destruction,12,8,4
Bellatrìxx,madmortem,767,warlock,destruction,12,8,4
Кандидат,blackscar,767,warlock,destruction,12,8,4
Ромзесхх,howling-fjord,767,warlock,destruction,12,8,4
Nechli,malganis,767,warlock,destruction,12,8,4
Shakoth,draenor,767,warlock,destruction,12,8,4
Iblis,grim-batol,767,warlock,destruction,12,8,4
Kalimsshar,ysondre,767,warlock,destruction,12,8,4
Deafcult,eonar,767,warlock,destruction,12,8,4
Shadowburst,outland,767,warlock,destruction,12,8,4
Мастеркрс,gordunni,767,warlock,destruction,12,8,4
Xoregar,nemesis,767,warlock,destruction,12,8,4
Cocacoil,outland,767,warlock,destruction,12,8,4
Grònkh,eredar,767,warlock,destruction,12,8,4
Lotud,drakthul,767,warlock,destruction,16,9,7
Картытаро,azuregos,767,warlock,destruction,16,9,7
Surt,la-croisade-écarlate,767,warlock,destruction,18,8,10
Stopfëar,ysondre,767,warlock,destruction,18,8,10
Heyggspal,draenor,767,warlock,destruction,18,8,10
Zhadok,blackmoore,767,warlock,destruction,18,8,10
Orkeylock,blackrock,767,warlock,destruction,18,8,10
Флягаегеря,howling-fjord,767,warlock,destruction,18,8,10
Luqhex,blackrock,767,warlock,destruction,18,8,10
Vertione,burning-legion,767,warlock,destruction,18,8,10
Eviloverlord,silvermoon,767,warlock,destruction,18,8,10
Rätlockx,blackhand,767,warlock,destruction,18,8,10
Slamalock,stormscale,767,warlock,destruction,18,8,10
Debex,ravencrest,767,warlock,destruction,18,8,10
Sadisticlól,burning-legion,767,warlock,destruction,18,8,10
Ebolara,aegwynn,767,warlock,destruction,18,8,10
Infectius,kazzak,767,warlock,destruction,24,8,16
Fearmighty,kazzak,767,warlock,destruction,24,8,16
Crathar,kazzak,767,warlock,destruction,24,8,16
Келебрах,howling-fjord,766,warlock,destruction,12,8,4
Sharion,silvermoon,766,warlock,destruction,12,8,4
Discordîân,twisting-nether,766,warlock,destruction,12,8,4
Cameltoh,stormscale,766,warlock,destruction,12,8,4
Xlara,argent-dawn,766,warlock,destruction,18,8,10
Jillyãen,hyjal,766,warlock,destruction,18,8,10
Yôi,nemesis,766,warlock,destruction,18,8,10
Justlock,tarren-mill,766,warlock,destruction,18,8,10
Warlockout,ravencrest,766,warlock,destruction,22,9,13
Рисли,deathweaver,765,warlock,destruction,12,8,4
Bravehearrt,burning-legion,765,warlock,destruction,12,8,4
Dregx,twisting-nether,765,warlock,destruction,12,8,4
Darkspit,draenor,765,warlock,destruction,12,8,4
Drestan,twisting-nether,765,warlock,destruction,18,8,10
Mestaca,dun-modr,765,warlock,destruction,24,8,16
Hexahydraten,draenor,764,warlock,destruction,18,8,10
Toîlêt,proudmoore,764,warlock,destruction,18,8,10
Gendo,twisting-nether,764,warlock,destruction,18,8,10
Urgool,ravencrest,763,warlock,destruction,12,8,4
Юникна,gordunni,763,warlock,destruction,24,8,16
Dimkeldor,kazzak,762,warlock,destruction,18,8,10
Chaosboltfm,silvermoon,762,warlock,destruction,23,8,15
Nizha,sanguino,761,warlock,destruction,92,43,49
Харрам,howling-fjord,761,warlock,destruction,18,8,10
Âpâchî,twisting-nether,761,warlock,destruction,24,8,16
Kretuss,silvermoon,760,warlock,destruction,18,8,10
Meinfearer,drakthul,760,warlock,destruction,27,8,19
Ramurox,rexxar,759,warlock,destruction,22,9,13
Mekalin,minahonda,757,warlock,destruction,18,8,10
Safirae,blackmoore,756,warlock,destruction,25,8,17
Bësly,khaz-modan,752,warlock,destruction,18,8,10
Sladurana,eredar,744,warlock,destruction,48,18,30
Trathos,minahonda,742,warlock,destruction,75,32,43
Mindfreak,turalyon,736,warlock,destruction,16,8,8
Шадофлок,deathweaver,735,warlock,destruction,17,8,9
Shaodul,stormscale,735,warlock,destruction,17,8,9
Tolgaa,draenor,735,warlock,destruction,29,8,21
Mindzsonghó,ragnaros,733,warlock,destruction,24,8,16
Bajaa,kazzak,720,warlock,destruction,15,9,6
Awon,aegwynn,719,warlock,destruction,17,8,9
Gutras,ragnaros,719,warlock,destruction,23,8,15
Kelek,anachronos,718,warlock,destruction,11,8,3
Chornota,ravencrest,715,warlock,destruction,23,8,15
Cursse,ahnqiraj,714,warlock,destruction,16,12,4
Skippity,ravencrest,714,warlock,destruction,14,9,5
Ironserious,blackrock,714,warlock,destruction,16,9,7
Тёмабиль,gordunni,714,warlock,destruction,23,10,13
Warlocklordx,ravencrest,713,warlock,destruction,22,9,13
Snowflakesxs,draenor,711,warlock,destruction,18,9,9
Pederlock,defias-brotherhood,710,warlock,destruction,33,9,24
Джастсак,gordunni,703,warlock,destruction,11,8,3
Manmilker,auchindoun,703,warlock,destruction,11,8,3
Rikta,stormscale,703,warlock,destruction,11,8,3
Nightfire,aggra-português,702,warlock,destruction,17,8,9
Элварель,galakrond,695,warlock,destruction,22,8,14
Kemmler,steamwheedle-cartel,688,warlock,destruction,13,8,5
Trollóck,the-maelstrom,686,warlock,destruction,11,8,3
Zilthon,dragonblight,672,warlock,destruction,12,7,5
Мэрджис,soulflayer,672,warlock,destruction,12,7,5
Матрикспз,soulflayer,672,warlock,destruction,12,7,5
Tindóme,blackmoore,672,warlock,destruction,12,7,5
Uqrlock,twisting-nether,672,warlock,destruction,12,7,5
Aunsá,archimonde,672,warlock,destruction,12,7,5
Yokujîn,twisting-nether,672,warlock,destruction,12,7,5
Abraðolf,blackrock,672,warlock,destruction,12,7,5
Lestebbes,frostwolf,672,warlock,destruction,12,7,5
Arakaali,dentarg,672,warlock,destruction,12,7,5
Qumbaja,alleria,672,warlock,destruction,12,7,5
Kurioula,twisting-nether,672,warlock,destruction,12,7,5
Pukemistress,tarren-mill,672,warlock,destruction,12,7,5
Ansatz,kazzak,672,warlock,destruction,12,7,5
Castywl,blackrock,672,warlock,destruction,12,7,5
Lockizz,tarren-mill,672,warlock,destruction,12,7,5
Oldmancletus,silvermoon,672,warlock,destruction,12,7,5
Jaleels,kazzak,672,warlock,destruction,12,7,5
Dexterlol,blackmoore,672,warlock,destruction,12,7,5
Nerreboltz,tarren-mill,672,warlock,destruction,12,7,5
Psykøø,shendralar,672,warlock,destruction,12,7,5
Følkman,twisting-nether,672,warlock,destruction,12,7,5
Pappabetaler,stormreaver,672,warlock,destruction,12,7,5
Skipperw,blackmoore,672,warlock,destruction,12,7,5
Galeriana,twilights-hammer,672,warlock,destruction,12,7,5
Gruldran,khaz-modan,672,warlock,destruction,12,7,5
Grâst,cthun,672,warlock,destruction,12,7,5
Defenestros,ravencrest,672,warlock,destruction,12,7,5
Bâbâyâgâqtsd,hyjal,672,warlock,destruction,12,7,5
Diva,bloodscalp,672,warlock,destruction,12,7,5
Wakro,hyjal,672,warlock,destruction,12,7,5
Nmmnmmnnmnmm,blackmoore,672,warlock,destruction,12,7,5
Itiswhatitis,ravencrest,672,warlock,destruction,12,7,5
Hehexd,steamwheedle-cartel,672,warlock,destruction,12,7,5
Xul,aggramar,672,warlock,destruction,12,7,5
Iøløløløçk,tarren-mill,672,warlock,destruction,12,7,5
Lickyicky,twisting-nether,672,warlock,destruction,12,7,5
Remzin,silvermoon,672,warlock,destruction,12,7,5
Damira,blackmoore,672,warlock,destruction,12,7,5
Archimitros,blackmoore,672,warlock,destruction,12,7,5
Demodan,aegwynn,672,warlock,destruction,12,7,5
Vilenia,doomhammer,672,warlock,destruction,12,7,5
Kradrog,nemesis,672,warlock,destruction,12,7,5
Destroylol,draenor,672,warlock,destruction,12,7,5
Sötsugen,argent-dawn,672,warlock,destruction,12,7,5
Fraky,frostwhisper,672,warlock,destruction,12,7,5
Fellord,chants-éternels,672,warlock,destruction,12,7,5
Boltsofdoom,kazzak,672,warlock,destruction,12,7,5
Hèrmit,kazzak,672,warlock,destruction,12,7,5
Numwiki,draenor,672,warlock,destruction,12,7,5
Ofgirl,ravencrest,672,warlock,destruction,12,7,5
Xjay,malorne,672,warlock,destruction,12,7,5
Cyliinia,die-aldor,672,warlock,destruction,12,7,5
Wacastwo,tarren-mill,672,warlock,destruction,12,7,5
Nürgle,stormscale,672,warlock,destruction,12,7,5
Aoeenjoer,tarren-mill,672,warlock,destruction,12,7,5
Sneltjej,draenor,672,warlock,destruction,12,7,5
Vixlock,tarren-mill,672,warlock,destruction,15,8,7
Nahzz,ravencrest,672,warlock,destruction,18,7,11
Topmodelx,eredar,672,warlock,destruction,18,7,11
Lobbo,ravencrest,672,warlock,destruction,18,7,11
Ssz,stormscale,672,warlock,destruction,18,7,11
Xuloth,ravencrest,672,warlock,destruction,18,7,11
Mocfernando,ravencrest,672,warlock,destruction,18,7,11
Mewarlock,bronze-dragonflight,672,warlock,destruction,18,7,11
Bitshlog,draenor,672,warlock,destruction,18,7,11
Ssneakydot,silvermoon,672,warlock,destruction,18,7,11
Seyzz,eredar,672,warlock,destruction,18,7,11
Dotschwingaa,eredar,672,warlock,destruction,18,7,11
Belakh,draenor,672,warlock,destruction,18,7,11
Painowgee,kazzak,672,warlock,destruction,18,7,11
Sweëk,blackhand,672,warlock,destruction,18,7,11
Haedri,kazzak,672,warlock,destruction,18,7,11
Arizyoxot,twisting-nether,672,warlock,destruction,18,7,11
Локизло,gordunni,672,warlock,destruction,18,7,11
Hungtwink,argent-dawn,672,warlock,destruction,18,7,11
Haccu,ragnaros,672,warlock,destruction,18,7,11
Bansheera,blackmoore,672,warlock,destruction,18,7,11
Mixu,hakkar,672,warlock,destruction,21,8,13
Spikemasterd,doomhammer,672,warlock,destruction,24,7,17
Marripa,sanguino,672,warlock,destruction,24,7,17
Raddock,ysondre,671,warlock,destruction,12,7,5
Zaruman,turalyon,671,warlock,destruction,12,7,5
Náwwk,blackmoore,671,warlock,destruction,12,7,5
Baladas,nemesis,671,warlock,destruction,12,7,5
Drexo,drakthul,671,warlock,destruction,12,7,5
Swèét,draenor,671,warlock,destruction,12,7,5
Омикс,gordunni,671,warlock,destruction,12,7,5
Afflicted,trollbane,671,warlock,destruction,12,7,5
Локерио,gordunni,671,warlock,destruction,12,7,5
Gnimoz,silvermoon,671,warlock,destruction,12,7,5
Saadq,draenor,671,warlock,destruction,12,7,5
Cømps,blackrock,671,warlock,destruction,12,7,5
Äri,blackmoore,671,warlock,destruction,12,7,5
Aîds,kazzak,671,warlock,destruction,12,7,5
Jillyãn,hyjal,671,warlock,destruction,12,7,5
Fauxshow,ravencrest,671,warlock,destruction,12,7,5
Sourpatchkid,the-maelstrom,671,warlock,destruction,15,8,7
Fireburner,der-mithrilorden,671,warlock,destruction,18,7,11
Máleficent,azshara,671,warlock,destruction,18,7,11
Suaakylove,tyrande,671,warlock,destruction,18,7,11
Izilove,culte-de-la-rive-noire,671,warlock,destruction,18,7,11
Гнумосятина,booty-bay,671,warlock,destruction,18,7,11
Kekihl,tarren-mill,671,warlock,destruction,18,7,11
Cancerdotcom,kazzak,671,warlock,destruction,18,7,11
Прогнившая,blackscar,671,warlock,destruction,18,7,11
Tce,ravencrest,671,warlock,destruction,18,7,11
Gimpy,sylvanas,671,warlock,destruction,18,7,11
Fràncis,dragonblight,671,warlock,destruction,18,7,11
Hampter,blackmoore,671,warlock,destruction,18,7,11
Ziloc,silvermoon,671,warlock,destruction,18,7,11
Vengidotcom,outland,671,warlock,destruction,18,7,11
Dwimmerlaikx,ragnaros,671,warlock,destruction,19,7,12
Kàiser,sanguino,671,warlock,destruction,23,7,16
Лузер,blackscar,671,warlock,destruction,24,7,17
Cjnaz,twisting-nether,670,warlock,destruction,12,7,5
Olilock,drakthul,670,warlock,destruction,12,7,5
Нафлэпил,gordunni,670,warlock,destruction,12,7,5
Ekatherini,blackhand,670,warlock,destruction,12,7,5
Зародыш,razuvious,670,warlock,destruction,18,7,11
Jondi,blackmoore,670,warlock,destruction,24,7,17
Валак,greymane,669,warlock,destruction,21,8,13
Demonzo,tarren-mill,669,warlock,destruction,23,8,15
Sheshii,argent-dawn,669,warlock,destruction,24,7,17
Badbeat,burning-legion,669,warlock,destruction,24,7,17
Peggybrown,turalyon,669,warlock,destruction,30,7,23
Сатаната,deepholm,668,warlock,destruction,12,7,5
Мракодел,deathguard,668,warlock,destruction,18,7,11
Hodille,argent-dawn,668,warlock,destruction,18,7,11
Mortori,tarren-mill,668,warlock,destruction,18,7,11
Buzztoon,doomhammer,668,warlock,destruction,24,7,17
Fadila,aegwynn,667,warlock,destruction,12,7,5
Vladlevad,argent-dawn,667,warlock,destruction,12,7,5
Декир,soulflayer,667,warlock,destruction,18,7,11
Garbagebarge,krasus,666,warlock,destruction,12,7,5
Easymeat,silvermoon,666,warlock,destruction,12,7,5
Oonz,sylvanas,661,warlock,destruction,30,9,21
Destri,blackmoore,660,warlock,destruction,12,7,5
Vinet,burning-legion,657,warlock,destruction,12,7,5
Bowhite,silvermoon,655,warlock,destruction,15,8,7
Драуктар,eversong,643,warlock,destruction,17,7,10
Saganelle,hyjal,639,warlock,destruction,11,7,4
Saucewalka,stormscale,638,warlock,destruction,11,7,4
Harrydôtta,blackmoore,637,warlock,destruction,20,8,12
Consfearacy,executus,636,warlock,destruction,11,7,4
Smallpee,kazzak,633,warlock,destruction,29,9,20
Hansbrixx,magtheridon,623,warlock,destruction,9,8,1
Warplock,sanguino,623,warlock,destruction,11,7,4
Alsseharr,blackhand,623,warlock,destruction,11,7,4
Dikkdickens,ravencrest,623,warlock,destruction,15,7,8
Силксонг,soulflayer,622,warlock,destruction,17,7,10
Tydra,die-aldor,618,warlock,destruction,20,8,12
Icony,blackhand,618,warlock,destruction,22,8,14
Embero,blackrock,617,warlock,destruction,19,8,11
Timaggrox,dun-morogh,611,warlock,destruction,93,43,50
Bonnieparkêr,onyxia,607,warlock,destruction,11,7,4
Imatión,sylvanas,607,warlock,destruction,16,7,9
Shadowppl,outland,606,warlock,destruction,20,7,13
Wòóni,ravencrest,600,warlock,destruction,26,7,19
Atlaon,kazzak,592,warlock,destruction,13,7,6
Xute,ragnaros,576,warlock,destruction,6,6,0
Janalice,hyjal,576,warlock,destruction,6,6,0
Zepsy,twisting-nether,576,warlock,destruction,6,6,0
Dragonlvrx,kazzak,576,warlock,destruction,6,6,0
Kennyfõx,ysondre,576,warlock,destruction,6,6,0
Aköyh,kazzak,576,warlock,destruction,6,6,0
Mamasitica,ravencrest,576,warlock,destruction,6,6,0
Hibachi,twisting-nether,576,warlock,destruction,6,6,0
Ceryss,argent-dawn,576,warlock,destruction,6,6,0
Nighttusk,burning-legion,576,warlock,destruction,6,6,0
Whaii,ravencrest,576,warlock,destruction,6,6,0
Zevranøss,dalaran,576,warlock,destruction,6,6,0
Cafardcancer,archimonde,576,warlock,destruction,6,6,0
Zìì,silvermoon,576,warlock,destruction,6,6,0
Kyiûu,archimonde,576,warlock,destruction,6,6,0
Popecandy,archimonde,576,warlock,destruction,6,6,0
Bultenx,tarren-mill,576,warlock,destruction,6,6,0
Аменбрейк,gordunni,576,warlock,destruction,6,6,0
Solosuperr,ravencrest,576,warlock,destruction,6,6,0
Klaier,dun-modr,576,warlock,destruction,9,7,2
Scroobydoo,stormscale,576,warlock,destruction,12,6,6
Slonertw,ragnaros,576,warlock,destruction,12,6,6
Ruszczka,burning-legion,576,warlock,destruction,12,6,6
Syñdrome,ragnaros,576,warlock,destruction,12,6,6
Staudi,eredar,576,warlock,destruction,12,6,6
Нежныйафлик,gordunni,576,warlock,destruction,12,6,6
Bountyqt,outland,576,warlock,destruction,12,6,6
Chaudor,archimonde,576,warlock,destruction,12,6,6
Jöhanan,twisting-nether,576,warlock,destruction,12,6,6
Koramu,blackrock,576,warlock,destruction,12,6,6
Gatewatcher,argent-dawn,576,warlock,destruction,12,6,6
Xalé,blackrock,576,warlock,destruction,12,6,6
Селфдестракт,howling-fjord,576,warlock,destruction,12,6,6
Drainforlife,blackrock,576,warlock,destruction,12,6,6
Zaklecie,silvermoon,576,warlock,destruction,12,6,6
Мерзея,soulflayer,576,warlock,destruction,12,6,6
Ooze,kazzak,576,warlock,destruction,12,6,6
Kraayn,blackhand,576,warlock,destruction,12,6,6
Cali,ahnqiraj,576,warlock,destruction,12,6,6
Krebares,draenor,576,warlock,destruction,12,6,6
Diabolics,twisting-nether,576,warlock,destruction,12,6,6
Larrydotter,burning-legion,576,warlock,destruction,12,6,6
Silenozz,ragnaros,576,warlock,destruction,12,6,6
Cræl,blackrock,576,warlock,destruction,12,6,6
Boltyboi,chamber-of-aspects,576,warlock,destruction,12,6,6
Fazol,terokkar,576,warlock,destruction,12,6,6
Erimdur,sanguino,576,warlock,destruction,12,6,6
Wallirikx,kazzak,576,warlock,destruction,12,6,6
Deamonhein,alonsus,576,warlock,destruction,12,6,6
Scryed,draenor,576,warlock,destruction,12,6,6
Podak,blackmoore,576,warlock,destruction,12,6,6
Numel,chamber-of-aspects,576,warlock,destruction,12,6,6
Liwerno,dunemaul,576,warlock,destruction,12,6,6
Zordochlock,kazzak,576,warlock,destruction,12,6,6
Hasigome,blackmoore,576,warlock,destruction,12,6,6
Herador,draenor,576,warlock,destruction,12,6,6
Kurokison,twisting-nether,576,warlock,destruction,12,6,6
Thieulock,twisting-nether,576,warlock,destruction,12,6,6
Mongodotz,sylvanas,576,warlock,destruction,12,6,6
Cropper,turalyon,576,warlock,destruction,12,6,6
Mayden,uldum,576,warlock,destruction,12,6,6
Vudukesh,draenor,576,warlock,destruction,12,6,6
Zigfipszen,blackmoore,576,warlock,destruction,12,6,6
Embercurse,ravencrest,576,warlock,destruction,12,6,6
Gorakthul,drakthul,576,warlock,destruction,12,6,6
Lokki,xavius,576,warlock,destruction,12,6,6
Уанбаттон,gordunni,576,warlock,destruction,12,6,6
Aranax,thrall,576,warlock,destruction,12,6,6
Mozo,stormscale,576,warlock,destruction,12,6,6
Darkspiros,tarren-mill,576,warlock,destruction,12,6,6
Ðuß,nemesis,576,warlock,destruction,12,6,6
Malanapucana,kazzak,576,warlock,destruction,12,6,6
Atheliia,draenor,576,warlock,destruction,12,6,6
Mothor,blackrock,576,warlock,destruction,12,6,6
Zardonixz,stormscale,576,warlock,destruction,12,6,6
Smoq,stormscale,576,warlock,destruction,12,6,6
Bulgyeøng,archimonde,576,warlock,destruction,12,6,6
Goosebumps,aggramar,576,warlock,destruction,12,6,6
Ghosthound,stormscale,576,warlock,destruction,12,6,6
Øprøx,sanguino,576,warlock,destruction,12,6,6
Doomkicksin,haomarush,576,warlock,destruction,12,6,6
Edgyrpname,argent-dawn,576,warlock,destruction,12,6,6
Enaio,mannoroth,576,warlock,destruction,12,6,6
Kukkojapallo,ravencrest,576,warlock,destruction,12,6,6
Bigtastybacn,blackmoore,576,warlock,destruction,12,6,6
Sanium,outland,576,warlock,destruction,12,6,6
Xyrønia,aegwynn,576,warlock,destruction,12,6,6
Nutopia,stormreaver,576,warlock,destruction,12,6,6
Slyghtéria,dalaran,576,warlock,destruction,12,6,6
Shakaxz,kazzak,576,warlock,destruction,15,7,8
Спанчгэри,soulflayer,576,warlock,destruction,15,7,8
Lockowns,twisting-nether,576,warlock,destruction,18,6,12
Tartaros,bronzebeard,576,warlock,destruction,18,6,12
Jörd,ravencrest,576,warlock,destruction,18,6,12
Zartax,kazzak,576,warlock,destruction,18,6,12
Azmondan,ahnqiraj,576,warlock,destruction,18,6,12
Alexcurse,draenor,576,warlock,destruction,18,6,12
Kriemias,malygos,576,warlock,destruction,18,6,12
Shreedlock,blackmoore,576,warlock,destruction,18,6,12
Elnïa,conseil-des-ombres,576,warlock,destruction,18,6,12
Morwëk,ysondre,576,warlock,destruction,18,6,12
Xsydewarlock,archimonde,576,warlock,destruction,18,6,12
Ajihn,sylvanas,576,warlock,destruction,18,6,12
Icq,ravencrest,576,warlock,destruction,18,6,12
Zemial,draenor,576,warlock,destruction,18,6,12
Naitix,argent-dawn,576,warlock,destruction,18,6,12
Mashïro,zuljin,576,warlock,destruction,18,6,12
Navara,thrall,576,warlock,destruction,24,6,18
Hacknator,aegwynn,575,warlock,destruction,12,6,6
Дракшара,soulflayer,575,warlock,destruction,12,6,6
Däw,archimonde,575,warlock,destruction,12,6,6
Rhaznor,frostwolf,575,warlock,destruction,12,6,6
Zevil,emerald-dream,575,warlock,destruction,12,6,6
Huaraches,stormscale,575,warlock,destruction,12,6,6
Warlockzor,auchindoun,575,warlock,destruction,12,6,6
Dottad,silvermoon,575,warlock,destruction,12,6,6
Najash,silvermoon,575,warlock,destruction,12,6,6
Дантеллия,gordunni,575,warlock,destruction,12,6,6
Sweetfire,ragnaros,575,warlock,destruction,12,6,6
Necromanccer,mazrigos,575,warlock,destruction,12,6,6
Brarvile,zuljin,575,warlock,destruction,12,6,6
Thîras,tarren-mill,575,warlock,destruction,13,6,7
Macinek,burning-blade,575,warlock,destruction,18,6,12
Marshieeyy,silvermoon,575,warlock,destruction,18,6,12
Klone,die-todeskrallen,575,warlock,destruction,18,6,12
Crymora,antonidas,575,warlock,destruction,18,6,12
Dêgrââf,azshara,575,warlock,destruction,18,6,12
Nemssy,dun-modr,575,warlock,destruction,18,6,12
Démín,ravencrest,575,warlock,destruction,18,6,12
Logice,hyjal,575,warlock,destruction,24,6,18
Clungesuck,argent-dawn,574,warlock,destruction,12,6,6
Goghlock,silvermoon,574,warlock,destruction,18,6,12
Attrappe,eredar,573,warlock,destruction,26,6,20
Rodrin,silvermoon,572,warlock,destruction,12,6,6
Taxalias,draenor,572,warlock,destruction,12,6,6
Esgül,draenor,572,warlock,destruction,12,6,6
Грашек,soulflayer,570,warlock,destruction,12,6,6
Migyardondup,exodar,568,warlock,destruction,12,6,6
Lockki,blades-edge,568,warlock,destruction,18,8,10
Олимта,blackscar,558,warlock,destruction,23,6,17
Warvoid,silvermoon,544,warlock,destruction,16,6,10
Jägerlock,draenor,543,warlock,destruction,11,6,5
Srbritoboy,burning-legion,540,warlock,destruction,11,6,5
Rozn,ravencrest,527,warlock,destruction,11,6,5
Synove,ragnaros,525,warlock,destruction,11,6,5
Diemilch,blackmoore,522,warlock,destruction,14,7,7
Брузир,gordunni,522,warlock,destruction,15,7,8
Тива,lich-king,522,warlock,destruction,21,7,14
Боррисовна,deathguard,512,warlock,destruction,16,6,10
Wanhëda,tarren-mill,511,warlock,destruction,11,6,5
Baxiaz,kazzak,511,warlock,destruction,11,6,5
Evilhippie,kazzak,511,warlock,destruction,11,6,5
Diddia,malganis,511,warlock,destruction,11,6,5
Noskillclass,stormscale,511,warlock,destruction,14,6,8
Hannens,blackrock,480,warlock,destruction,6,5,1
Struldan,outland,480,warlock,destruction,6,5,1
ßualock,sylvanas,480,warlock,destruction,6,5,1
Enmaa,eredar,480,warlock,destruction,6,5,1
Zurael,mannoroth,480,warlock,destruction,6,5,1
Bigdondi,ravencrest,480,warlock,destruction,6,5,1
Mellown,blackrock,480,warlock,destruction,6,5,1
Sumstone,kazzak,480,warlock,destruction,6,5,1
Lyns,hyjal,480,warlock,destruction,6,5,1
Shuni,defias-brotherhood,480,warlock,destruction,6,5,1
Jûnkz,ysondre,480,warlock,destruction,6,5,1
Malzeva,ravencrest,480,warlock,destruction,6,5,1
Klaab,hyjal,480,warlock,destruction,6,5,1
Mazuto,outland,480,warlock,destruction,6,5,1
Ticktockboom,twilights-hammer,480,warlock,destruction,6,5,1
Ionesdot,ravencrest,480,warlock,destruction,6,5,1
Demonmilf,ysondre,480,warlock,destruction,6,5,1
Keltuzard,zuljin,480,warlock,destruction,6,5,1
Reckony,ravencrest,480,warlock,destruction,6,5,1
Agresiw,twisting-nether,480,warlock,destruction,6,5,1
Djløckgødx,ravencrest,480,warlock,destruction,6,5,1
Rayser,shendralar,480,warlock,destruction,6,5,1
Hypercaster,shattrath,480,warlock,destruction,6,5,1
Idezis,ragnaros,480,warlock,destruction,6,5,1
Lyndi,nerathor,480,warlock,destruction,6,5,1
Ingwert,frostwolf,480,warlock,destruction,6,5,1
Öxygen,outland,480,warlock,destruction,6,5,1
Devillsoull,kazzak,480,warlock,destruction,6,5,1
Kirtaçh,dun-modr,480,warlock,destruction,6,5,1
Darkbasilet,hyjal,480,warlock,destruction,6,5,1
Veichassur,twisting-nether,480,warlock,destruction,6,5,1
Junglediffxd,ysondre,480,warlock,destruction,6,5,1
Lazytown,silvermoon,480,warlock,destruction,6,5,1
Tobibolt,blackrock,480,warlock,destruction,6,5,1
Shoøt,dalaran,480,warlock,destruction,6,5,1
Smrdex,outland,480,warlock,destruction,6,5,1
Avadakèdavra,kazzak,480,warlock,destruction,6,5,1
Dogbolt,stormscale,480,warlock,destruction,6,5,1
Hinsu,the-maelstrom,480,warlock,destruction,6,5,1
Sêrø,aegwynn,480,warlock,destruction,6,5,1
Soulmistress,stormscale,480,warlock,destruction,6,5,1
Hotdogvendor,kazzak,480,warlock,destruction,6,5,1
Harrydoter,kiljaeden,480,warlock,destruction,6,5,1
Djolagourde,archimonde,480,warlock,destruction,6,5,1
Carlitall,ravencrest,480,warlock,destruction,6,5,1
Levinbrz,ravencrest,480,warlock,destruction,6,5,1
Veafugg,blackmoore,480,warlock,destruction,6,5,1
Era,stormscale,480,warlock,destruction,6,5,1
Shallý,antonidas,480,warlock,destruction,6,5,1
Lísbeth,sylvanas,480,warlock,destruction,6,5,1
Buffdemolock,executus,480,warlock,destruction,6,5,1
Saf,ysondre,480,warlock,destruction,6,5,1
Sizezero,tarren-mill,480,warlock,destruction,6,5,1
Sâlty,stormscale,480,warlock,destruction,6,5,1
Ashid,chamber-of-aspects,480,warlock,destruction,6,5,1
Garbrandt,tarren-mill,480,warlock,destruction,6,5,1
Sep,aegwynn,480,warlock,destruction,6,5,1
Bánánbánd,draenor,480,warlock,destruction,6,5,1
Chaøsbølt,archimonde,480,warlock,destruction,6,5,1
Nøøbslayer,kazzak,480,warlock,destruction,6,5,1
Shadowtrix,darksorrow,480,warlock,destruction,9,5,4
Watchmecut,terenas,480,warlock,destruction,12,5,7
Silarioblack,nemesis,480,warlock,destruction,12,5,7
Lik,forscherliga,480,warlock,destruction,12,5,7
Elmetro,ragnaros,480,warlock,destruction,12,5,7
Mærie,hyjal,480,warlock,destruction,12,5,7
Belphagòr,nemesis,480,warlock,destruction,12,5,7
Djshyasiañ,perenolde,480,warlock,destruction,12,5,7
Farudai,die-aldor,480,warlock,destruction,12,5,7
Tiwtera,draenor,480,warlock,destruction,12,5,7
Nefalya,hyjal,480,warlock,destruction,12,5,7
Rela,arathor,480,warlock,destruction,12,5,7
Локомания,gordunni,480,warlock,destruction,12,5,7
Eilhart,aggramar,480,warlock,destruction,12,5,7
Miezexy,aegwynn,480,warlock,destruction,12,5,7
Cerberus,anetheron,480,warlock,destruction,12,5,7
Velgart,dun-modr,480,warlock,destruction,12,5,7
Pewmlock,antonidas,480,warlock,destruction,12,5,7
Xtrazâ,archimonde,480,warlock,destruction,12,5,7
Whórélóck,ravencrest,480,warlock,destruction,12,5,7
Semhein,twisting-nether,480,warlock,destruction,12,5,7
Xtremelock,blackmoore,480,warlock,destruction,12,5,7
Жижакабра,soulflayer,480,warlock,destruction,12,5,7
Snoreghast,tarren-mill,480,warlock,destruction,12,5,7
Искусность,soulflayer,480,warlock,destruction,12,5,7
Braegnok,ravencrest,480,warlock,destruction,12,5,7
Sidius,archimonde,480,warlock,destruction,12,5,7
Rikudoua,malfurion,480,warlock,destruction,12,5,7
Feardotfive,frostwolf,480,warlock,destruction,12,5,7
Zêngâ,kazzak,480,warlock,destruction,12,5,7
Vigneau,argent-dawn,480,warlock,destruction,12,5,7
Марамойка,blackscar,480,warlock,destruction,12,5,7
Khardam,sylvanas,480,warlock,destruction,12,5,7
Sanwich,dun-modr,480,warlock,destruction,12,5,7
Кайдзуки,howling-fjord,480,warlock,destruction,12,5,7
Sokyra,tarren-mill,480,warlock,destruction,12,5,7
Borovec,kazzak,480,warlock,destruction,12,5,7
Nithandrys,argent-dawn,480,warlock,destruction,12,5,7
Käristäjä,outland,480,warlock,destruction,12,5,7
Pliagaa,drakthul,480,warlock,destruction,12,5,7
Infïnitýx,silvermoon,480,warlock,destruction,12,5,7
Atomik,drakthul,480,warlock,destruction,12,5,7
Емс,gordunni,480,warlock,destruction,12,5,7
Thorky,blackrock,480,warlock,destruction,12,5,7
Динодотз,howling-fjord,480,warlock,destruction,12,5,7
Lyleath,ravencrest,480,warlock,destruction,12,5,7
Zeanort,zuljin,480,warlock,destruction,12,5,7
Zlok,silvermoon,480,warlock,destruction,12,5,7
Devilart,hellscream,480,warlock,destruction,12,5,7
Claralock,silvermoon,480,warlock,destruction,12,5,7
Franjah,alleria,480,warlock,destruction,12,5,7
Гулданоф,howling-fjord,480,warlock,destruction,12,5,7
Purplehelmet,argent-dawn,480,warlock,destruction,12,5,7
Corruptcoil,argent-dawn,480,warlock,destruction,12,5,7
Ratnu,ragnaros,480,warlock,destruction,12,5,7
Hexenjoyer,antonidas,480,warlock,destruction,12,5,7
Desrak,outland,480,warlock,destruction,12,5,7
Мистермогила,soulflayer,480,warlock,destruction,12,5,7
Jiego,stormscale,480,warlock,destruction,12,5,7
Bricktot,ragnaros,480,warlock,destruction,12,5,7
Mongulla,draenor,480,warlock,destruction,12,5,7
Bajsibyx,tarren-mill,480,warlock,destruction,12,5,7
Gorgoroð,outland,480,warlock,destruction,12,5,7
Werra,ravencrest,480,warlock,destruction,17,6,11
Уфц,grom,480,warlock,destruction,18,5,13
Erèss,hyjal,480,warlock,destruction,18,5,13
Mambra,sylvanas,480,warlock,destruction,18,5,13
Lockned,outland,480,warlock,destruction,18,5,13
Brudèrtuk,das-syndikat,480,warlock,destruction,18,5,13
ßeatrix,tyrande,480,warlock,destruction,18,5,13
Maledictio,blackrock,480,warlock,destruction,18,5,13
Händerå,ragnaros,480,warlock,destruction,18,5,13
Skorpionus,wildhammer,480,warlock,destruction,18,5,13
Closetlock,the-maelstrom,480,warlock,destruction,18,5,13
Coviddotter,stormscale,480,warlock,destruction,18,5,13
Lillithx,stormscale,480,warlock,destruction,18,5,13
Ciesare,draenor,480,warlock,destruction,18,5,13
Fruccia,hyjal,479,warlock,destruction,6,5,1
Chaosborn,twisting-nether,479,warlock,destruction,6,5,1
Сенсация,ashenvale,479,warlock,destruction,12,5,7
Милуй,eversong,479,warlock,destruction,12,5,7
Baikabahta,kazzak,479,warlock,destruction,12,5,7
Itryan,elune,479,warlock,destruction,12,5,7
Archélion,silvermoon,479,warlock,destruction,12,5,7
Cêebêry,frostwolf,479,warlock,destruction,17,6,11
Shamhara,twisting-nether,479,warlock,destruction,18,5,13
Fesse,draenor,479,warlock,destruction,18,5,13
Intina,dragonblight,479,warlock,destruction,18,5,13
Bope,the-maelstrom,479,warlock,destruction,18,5,13
Yenkorov,blackmoore,479,warlock,destruction,18,5,13
Darkphoenix,the-maelstrom,479,warlock,destruction,18,5,13
Lockpup,draenor,479,warlock,destruction,24,5,19
Лавамес,eversong,478,warlock,destruction,10,6,4
Soulsdeads,sylvanas,478,warlock,destruction,12,5,7
Warlockkey,ravencrest,478,warlock,destruction,18,5,13
Yourdeaath,ravencrest,478,warlock,destruction,18,5,13
Espilocka,dun-modr,477,warlock,destruction,6,5,1
Ohanze,antonidas,477,warlock,destruction,12,5,7
Nukeem,karazhan,475,warlock,destruction,12,5,7
Garimberas,silvermoon,468,warlock,destruction,22,8,14
Helikopter,shattered-hand,463,warlock,destruction,12,6,6
Дыханиетени,soulflayer,463,warlock,destruction,12,5,7
Hahahahah,draenor,447,warlock,destruction,11,5,6
Winterx,argent-dawn,447,warlock,destruction,11,5,6
Sândex,blackmoore,447,warlock,destruction,20,6,14
Primdåhl,ravencrest,447,warlock,destruction,17,5,12
Hilfhëim,cthun,445,warlock,destruction,11,5,6
Secretninja,silvermoon,432,warlock,destruction,15,5,10
Qliimax,blackrock,416,warlock,destruction,10,5,5
Skadz,blackmoore,416,warlock,destruction,10,5,5
Hønneyjckk,hyjal,415,warlock,destruction,8,5,3
Greemwolf,doomhammer,413,warlock,destruction,23,6,17
Furrylóver,kazzak,399,warlock,destruction,5,5,0
Waöld,sylvanas,398,warlock,destruction,16,5,11
Fearylia,aegwynn,393,warlock,destruction,11,8,3
Xenastro,silvermoon,384,warlock,destruction,6,4,2
Eizon,tarren-mill,384,warlock,destruction,6,4,2
Lindastotch,kazzak,384,warlock,destruction,6,4,2
Gemja,onyxia,384,warlock,destruction,6,4,2
Cadrega,nemesis,384,warlock,destruction,6,4,2
Getoutmaway,stormscale,384,warlock,destruction,6,4,2
Пчелокнижник,howling-fjord,384,warlock,destruction,6,4,2
Zubejdaca,ragnaros,384,warlock,destruction,6,4,2
Orchid,burning-steppes,384,warlock,destruction,6,4,2
Кичи,gordunni,384,warlock,destruction,6,4,2
Feyreah,blackmoore,384,warlock,destruction,6,4,2
Salvyrigoth,kazzak,384,warlock,destruction,6,4,2
Критокнижник,lich-king,384,warlock,destruction,6,4,2
Shelinda,earthen-ring,384,warlock,destruction,6,4,2
Keess,darksorrow,384,warlock,destruction,6,4,2
Анрали,soulflayer,384,warlock,destruction,6,4,2
Soulbolt,ragnaros,384,warlock,destruction,6,4,2
Drshegs,darkspear,384,warlock,destruction,6,4,2
Devørør,stormscale,384,warlock,destruction,6,4,2
Rayfears,draenor,384,warlock,destruction,6,4,2
Dotforgold,blackmoore,384,warlock,destruction,6,4,2
Veloces,defias-brotherhood,384,warlock,destruction,6,4,2
Бригада,howling-fjord,384,warlock,destruction,6,4,2
Unfeared,blackhand,384,warlock,destruction,6,4,2
Малгат,howling-fjord,384,warlock,destruction,6,4,2
Macklemore,twisting-nether,384,warlock,destruction,6,4,2
Cokkà,dalaran,384,warlock,destruction,6,4,2
Dotritos,tarren-mill,384,warlock,destruction,6,4,2
Miselinek,drakthul,384,warlock,destruction,6,4,2
Iryann,silvermoon,384,warlock,destruction,6,4,2
Shadowimpact,ravencrest,384,warlock,destruction,6,4,2
Boltimoore,magtheridon,384,warlock,destruction,6,4,2
Focalortwo,ravencrest,384,warlock,destruction,6,4,2
Элнуар,soulflayer,384,warlock,destruction,6,4,2
Xskyrov,blackmoore,384,warlock,destruction,6,4,2
Hiloqtlock,blackmoore,384,warlock,destruction,6,4,2
Nãshor,kazzak,384,warlock,destruction,6,4,2
Zorphu,quelthalas,384,warlock,destruction,6,4,2
Nosferatia,kult-der-verdammten,384,warlock,destruction,6,4,2
Dashirø,drakthul,384,warlock,destruction,6,4,2
Bicuriousdad,tarren-mill,384,warlock,destruction,6,4,2
Suicidekings,draenor,384,warlock,destruction,6,4,2
Warpawn,twisting-nether,384,warlock,destruction,6,4,2
Jøw,tarren-mill,384,warlock,destruction,6,4,2
Svnlpowpow,kazzak,384,warlock,destruction,6,4,2
Арматурааня,gordunni,384,warlock,destruction,6,4,2
Grixius,argent-dawn,384,warlock,destruction,6,4,2
Труупыч,gordunni,384,warlock,destruction,6,4,2
Wromged,argent-dawn,384,warlock,destruction,6,4,2
Auchaos,argent-dawn,384,warlock,destruction,6,4,2
Miláâ,argent-dawn,384,warlock,destruction,6,4,2
Mdrglock,ravencrest,384,warlock,destruction,6,4,2
Varend,drakthul,384,warlock,destruction,6,4,2
Smittorisk,stormscale,384,warlock,destruction,6,4,2
Kaukauwa,blackmoore,384,warlock,destruction,6,4,2
Zasajin,blackhand,384,warlock,destruction,6,4,2
Anthønyy,archimonde,384,warlock,destruction,6,4,2
Techlord,tarren-mill,384,warlock,destruction,6,4,2
Notloveless,stormscale,384,warlock,destruction,6,4,2
Kukburet,silvermoon,384,warlock,destruction,6,4,2
Mmorgana,sanguino,384,warlock,destruction,6,4,2
Échø,blackmoore,384,warlock,destruction,6,4,2
Løba,kazzak,384,warlock,destruction,6,4,2
Kaiczar,draenor,384,warlock,destruction,6,4,2
Zíllakami,tarren-mill,384,warlock,destruction,6,4,2
Teachluv,frostwolf,384,warlock,destruction,6,4,2
Shaarak,blackrock,384,warlock,destruction,6,4,2
Sunlicht,kazzak,384,warlock,destruction,6,4,2
Jumskerbolts,outland,384,warlock,destruction,6,4,2
Zezca,draenor,384,warlock,destruction,6,4,2
Nilsa,eredar,384,warlock,destruction,6,4,2
Born,ravencrest,384,warlock,destruction,6,4,2
Ahollic,antonidas,384,warlock,destruction,6,4,2
Siyaa,eredar,384,warlock,destruction,6,4,2
Shílda,silvermoon,384,warlock,destruction,6,4,2
Spacecarry,archimonde,384,warlock,destruction,6,4,2
Apeliction,eredar,384,warlock,destruction,6,4,2
Slaìk,eredar,384,warlock,destruction,6,4,2
Azae,outland,384,warlock,destruction,6,4,2
Trimie,tarren-mill,384,warlock,destruction,6,4,2
Cappaoow,ravencrest,384,warlock,destruction,6,4,2
Zéik,archimonde,384,warlock,destruction,6,4,2
Sïlïthuss,ravencrest,384,warlock,destruction,6,4,2
Warchilly,twisting-nether,384,warlock,destruction,6,4,2
Lynnqt,sylvanas,384,warlock,destruction,6,4,2
Voídzero,hyjal,384,warlock,destruction,6,4,2
Fatbaldold,ravencrest,384,warlock,destruction,6,4,2
Darkwìngduck,ravencrest,384,warlock,destruction,6,4,2
Mcdotnálds,thrall,384,warlock,destruction,6,4,2
Äiriss,hyjal,384,warlock,destruction,6,4,2
Rngmåchinêx,ravencrest,384,warlock,destruction,6,4,2
Malthiria,silvermoon,384,warlock,destruction,6,4,2
Iulu,sylvanas,384,warlock,destruction,6,4,2
Fîndelkind,blackrock,384,warlock,destruction,6,4,2
Hirasawa,archimonde,384,warlock,destruction,6,4,2
Xristianos,ravencrest,384,warlock,destruction,6,4,2
Døxz,blackrock,384,warlock,destruction,6,4,2
Viscius,ysondre,384,warlock,destruction,6,4,2
Zaratraz,guldan,384,warlock,destruction,6,4,2
Локкибальбоа,soulflayer,384,warlock,destruction,6,4,2
Mèsmerize,tarren-mill,384,warlock,destruction,9,5,4
Omnípotens,silvermoon,384,warlock,destruction,12,6,6
Voidlocklol,magtheridon,384,warlock,destruction,12,4,8
Ieatfel,archimonde,384,warlock,destruction,12,4,8
Бешентумай,goldrinn,384,warlock,destruction,12,4,8
Impnapper,burning-legion,384,warlock,destruction,12,4,8
Drogóth,blackmoore,384,warlock,destruction,12,4,8
Azzra,kazzak,384,warlock,destruction,12,4,8
Kaobolt,archimonde,384,warlock,destruction,12,4,8
Hextrasa,blackmoore,384,warlock,destruction,12,4,8
Legiozock,draenor,384,warlock,destruction,12,4,8
Waryald,dun-modr,384,warlock,destruction,12,4,8
Atúm,auchindoun,384,warlock,destruction,12,4,8
Suêin,dun-modr,384,warlock,destruction,12,4,8
Ranalock,blackrock,384,warlock,destruction,12,4,8
Hòbó,outland,384,warlock,destruction,12,4,8
Nicetime,nefarian,384,warlock,destruction,12,4,8
Chäös,outland,384,warlock,destruction,12,4,8
Demoncius,dun-modr,384,warlock,destruction,12,4,8
Féárx,silvermoon,384,warlock,destruction,12,4,8
Vanskor,argent-dawn,384,warlock,destruction,12,4,8
Thatscap,tarren-mill,384,warlock,destruction,12,4,8
Blubbajohnny,blackmoore,384,warlock,destruction,12,4,8
Selok,outland,384,warlock,destruction,12,4,8
Oimera,frostwolf,384,warlock,destruction,12,4,8
Sellinia,culte-de-la-rive-noire,384,warlock,destruction,12,4,8
Tekron,blackhand,384,warlock,destruction,12,4,8
Demofox,ragnaros,384,warlock,destruction,12,4,8
Reviala,kazzak,384,warlock,destruction,12,4,8
Novkan,eredar,384,warlock,destruction,12,4,8
Axy,dun-modr,384,warlock,destruction,12,4,8
Yifu,ravencrest,384,warlock,destruction,12,4,8
Hheavens,ragnaros,384,warlock,destruction,12,4,8
Warket,ragnaros,384,warlock,destruction,12,4,8
Selur,ragnaros,384,warlock,destruction,12,4,8
Tiktokér,kazzak,384,warlock,destruction,12,4,8
Roedin,tarren-mill,384,warlock,destruction,12,4,8
Harrydotterx,alakir,384,warlock,destruction,12,4,8
Vsmna,ragnaros,384,warlock,destruction,12,4,8
Warth,silvermoon,384,warlock,destruction,12,4,8
Ivesl,blackrock,384,warlock,destruction,12,4,8
Déidara,emerald-dream,384,warlock,destruction,12,4,8
Hexovíc,blackmoore,384,warlock,destruction,12,4,8
Cptdotalot,tarren-mill,384,warlock,destruction,12,4,8
Vorak,turalyon,384,warlock,destruction,12,4,8
Pekenina,outland,384,warlock,destruction,12,4,8
Mustalol,outland,384,warlock,destruction,12,4,8
Impvader,argent-dawn,384,warlock,destruction,12,4,8
Tiitz,blackmoore,384,warlock,destruction,12,4,8
Muninnus,archimonde,384,warlock,destruction,12,4,8
Darkmaw,drakthul,384,warlock,destruction,12,4,8
Razhûl,blackhand,384,warlock,destruction,12,4,8
Чиззихаос,soulflayer,384,warlock,destruction,12,4,8
Cirihexer,area-52,384,warlock,destruction,12,4,8
Kubbÿ,drakthul,384,warlock,destruction,12,4,8
Yandihimir,silvermoon,384,warlock,destruction,12,4,8
Ksenìa,khaz-modan,384,warlock,destruction,12,4,8
Tilliâ,blackhand,384,warlock,destruction,12,4,8
Wepz,chamber-of-aspects,384,warlock,destruction,12,4,8
Стокыч,soulflayer,384,warlock,destruction,12,4,8
Nécron,ysondre,384,warlock,destruction,12,4,8
Kakren,ysondre,384,warlock,destruction,12,4,8
Vextalock,drakthul,384,warlock,destruction,12,4,8
Мазаффак,gordunni,384,warlock,destruction,12,4,8
Таракай,eversong,384,warlock,destruction,18,4,14
Andrewtaint,twisting-nether,384,warlock,destruction,18,4,14
Tepelkwastje,twisting-nether,384,warlock,destruction,18,4,14
Dreadbøt,blackrock,384,warlock,destruction,18,4,14
Thinio,argent-dawn,384,warlock,destruction,18,4,14
Ðave,nemesis,384,warlock,destruction,18,4,14
Yehelzz,amanthul,384,warlock,destruction,24,4,20
Силаскверна,deathguard,383,warlock,destruction,6,4,2
Okulus,quelthalas,383,warlock,destruction,6,4,2
Injecter,stormscale,383,warlock,destruction,6,4,2
Неиставая,deathguard,383,warlock,destruction,6,4,2
Manikalinka,stormscale,383,warlock,destruction,6,4,2
Sanguinis,theradras,383,warlock,destruction,6,4,2
Angrynoob,silvermoon,383,warlock,destruction,6,4,2
Avel,dun-morogh,383,warlock,destruction,15,5,10
Feliciousx,draenor,383,warlock,destruction,12,4,8
Khandar,aegwynn,383,warlock,destruction,12,4,8
Michtv,hyjal,383,warlock,destruction,18,4,14
Grooptoop,draenor,383,warlock,destruction,18,4,14
Malfuryon,pozzo-delleternità,383,warlock,destruction,24,4,20
Watchlock,burning-legion,382,warlock,destruction,26,9,17
Adizew,kazzak,382,warlock,destruction,18,4,14
Сатари,blackscar,378,warlock,destruction,20,9,11
Mostyn,tarren-mill,361,warlock,destruction,17,6,11
Easymode,archimonde,351,warlock,destruction,11,4,7
Boltsnhoes,drakthul,351,warlock,destruction,11,4,7
Afrolock,antonidas,336,warlock,destruction,9,5,4
Smolpussgodx,ragnaros,336,warlock,destruction,9,5,4
Damßalla,cthun,330,warlock,destruction,11,8,3
Threeam,malganis,330,warlock,destruction,9,5,4
Рейнджр,eversong,330,warlock,destruction,15,6,9
Rikimancer,tarren-mill,330,warlock,destruction,15,5,10
Velativ,silvermoon,330,warlock,destruction,16,5,11
Lockpz,sylvanas,330,warlock,destruction,18,5,13
Voib,silvermoon,329,warlock,destruction,21,7,14
Лвнг,gordunni,320,warlock,destruction,10,4,6
Malganas,sylvanas,320,warlock,destruction,16,4,12
Shasi,silvermoon,319,warlock,destruction,5,4,1
Reconnected,drakthul,319,warlock,destruction,8,4,4
Maquan,blackmoore,288,warlock,destruction,6,3,3
Dragmetohêll,blackhand,288,warlock,destruction,6,3,3
Aches,sylvanas,288,warlock,destruction,6,3,3
Ароматныйх,howling-fjord,288,warlock,destruction,6,3,3
Greenjelly,ravencrest,288,warlock,destruction,6,3,3
Гулдаанн,fordragon,288,warlock,destruction,6,3,3
Darnax,pozzo-delleternità,288,warlock,destruction,6,3,3
Brolter,blackhand,288,warlock,destruction,6,3,3
Qateza,azjolnerub,288,warlock,destruction,6,3,3
Mirlax,twisting-nether,288,warlock,destruction,6,3,3
Marakh,stormscale,288,warlock,destruction,6,3,3
Tibzx,stormscale,288,warlock,destruction,6,3,3
Sambosa,twisting-nether,288,warlock,destruction,6,3,3
Muradona,nemesis,288,warlock,destruction,6,3,3
Jiruga,blackrock,288,warlock,destruction,6,3,3
Hammern,haomarush,288,warlock,destruction,6,3,3
Heexmex,blackmoore,288,warlock,destruction,6,3,3
Hazzikosby,ravencrest,288,warlock,destruction,6,3,3
Ìí,blackmoore,288,warlock,destruction,6,3,3
Kaîdö,archimonde,288,warlock,destruction,6,3,3
Гвадривер,howling-fjord,288,warlock,destruction,6,3,3
Huaian,darksorrow,288,warlock,destruction,6,3,3
Dóni,chamber-of-aspects,288,warlock,destruction,6,3,3
Soulslugger,twisting-nether,288,warlock,destruction,6,3,3
Safewagwan,auchindoun,288,warlock,destruction,6,3,3
Пувнэт,howling-fjord,288,warlock,destruction,6,3,3
Cgòw,ravencrest,288,warlock,destruction,6,3,3
Mirezl,taerar,288,warlock,destruction,6,3,3
Fellouussion,dalaran,288,warlock,destruction,6,3,3
Domyatus,chogall,288,warlock,destruction,6,3,3
Нрг,blackscar,288,warlock,destruction,6,3,3
Винстролман,blackscar,288,warlock,destruction,6,3,3
Aramnes,blackmoore,288,warlock,destruction,6,3,3
Annkî,aegwynn,288,warlock,destruction,6,3,3
Decayden,twisting-nether,288,warlock,destruction,6,3,3
Mïta,hyjal,288,warlock,destruction,6,3,3
Ninmockasin,stormscale,288,warlock,destruction,6,3,3
Impsgalore,ravencrest,288,warlock,destruction,6,3,3
Aghmar,ravencrest,288,warlock,destruction,6,3,3
Adreal,burning-legion,288,warlock,destruction,6,3,3
Асальвэйд,gordunni,288,warlock,destruction,6,3,3
Jazggzgirl,blackmoore,288,warlock,destruction,6,3,3
Исусилок,deathguard,288,warlock,destruction,6,3,3
Ðanilock,dun-modr,288,warlock,destruction,6,3,3
Dekawa,ravencrest,288,warlock,destruction,6,3,3
Volontáry,stormscale,288,warlock,destruction,6,3,3
Demonologyz,ravencrest,288,warlock,destruction,6,3,3
Palmtri,stormscale,288,warlock,destruction,6,3,3
Димаанстейбл,gordunni,288,warlock,destruction,6,3,3
Whitemagic,nemesis,288,warlock,destruction,6,3,3
Kudde,twisting-nether,288,warlock,destruction,6,3,3
Demónfire,sylvanas,288,warlock,destruction,6,3,3
Tenishia,blackrock,288,warlock,destruction,6,3,3
Колдую,gordunni,288,warlock,destruction,6,3,3
Nêstêe,archimonde,288,warlock,destruction,6,3,3
Brudergottes,blackmoore,288,warlock,destruction,6,3,3
Кукурузямба,soulflayer,288,warlock,destruction,6,3,3
Rutena,ravencrest,288,warlock,destruction,6,3,3
Bluh,twisting-nether,288,warlock,destruction,6,3,3
Schoolboizug,twisting-nether,288,warlock,destruction,6,3,3
Lockmex,outland,288,warlock,destruction,6,3,3
Ctrlaltdelet,stormscale,288,warlock,destruction,6,3,3
Sarudan,ravencrest,288,warlock,destruction,6,3,3
Fearylicious,burning-legion,288,warlock,destruction,6,3,3
Moonliwl,blackrock,288,warlock,destruction,6,3,3
Widot,ravencrest,288,warlock,destruction,6,3,3
Drbob,ravencrest,288,warlock,destruction,6,3,3
Friendlylock,quelthalas,288,warlock,destruction,6,3,3
Taylorg,blackmoore,288,warlock,destruction,6,3,3
Sodadogpìn,nemesis,288,warlock,destruction,6,3,3
Imissbfafour,stormscale,288,warlock,destruction,6,3,3
Whj,ravencrest,288,warlock,destruction,6,3,3
Deathrá,blackmoore,288,warlock,destruction,6,3,3
Пачимучка,gordunni,288,warlock,destruction,6,3,3
Spamfearxd,archimonde,288,warlock,destruction,6,3,3
Нэрфир,soulflayer,288,warlock,destruction,6,3,3
Tschiko,blackrock,288,warlock,destruction,6,3,3
Kírth,blackmoore,288,warlock,destruction,6,3,3
Cpump,twisting-nether,288,warlock,destruction,6,3,3
Xyré,twisting-nether,288,warlock,destruction,6,3,3
Ремайка,gordunni,288,warlock,destruction,6,3,3
Dement,sanguino,288,warlock,destruction,6,3,3
Martyrre,archimonde,288,warlock,destruction,6,3,3
Slem,aerie-peak,288,warlock,destruction,6,3,3
Skizofrenia,zuljin,288,warlock,destruction,6,3,3
Akdan,ragnaros,288,warlock,destruction,6,3,3
Дядяджонн,gordunni,288,warlock,destruction,6,3,3
Myzkâ,archimonde,288,warlock,destruction,6,3,3
Zizzbrah,ragnaros,288,warlock,destruction,6,3,3
Nethros,ragnaros,288,warlock,destruction,6,3,3
Cálamity,magtheridon,288,warlock,destruction,6,3,3
Inani,ragnaros,288,warlock,destruction,6,3,3
Epoku,stormscale,288,warlock,destruction,6,3,3
Kariusbaktus,stormscale,288,warlock,destruction,6,3,3
Fearhealer,blackmoore,288,warlock,destruction,6,3,3
Rokudaime,stormscale,288,warlock,destruction,6,3,3
Soezzlock,archimonde,288,warlock,destruction,6,3,3
Hiroyukí,frostmane,288,warlock,destruction,6,3,3
Veggal,outland,288,warlock,destruction,6,3,3
Grindelwald,blackmoore,288,warlock,destruction,6,3,3
Cthulhul,stormscale,288,warlock,destruction,6,3,3
Drith,blades-edge,288,warlock,destruction,6,3,3
Sharcoowl,antonidas,288,warlock,destruction,6,3,3
Omaleinfluch,antonidas,288,warlock,destruction,6,3,3
Флорэтт,gordunni,288,warlock,destruction,6,3,3
Bitch,ravencrest,288,warlock,destruction,6,3,3
Bestwarlock,ravencrest,288,warlock,destruction,6,3,3
Toskanoamani,blackmoore,288,warlock,destruction,6,3,3
Tenshirou,blackrock,288,warlock,destruction,6,3,3
Messire,ragnaros,288,warlock,destruction,6,3,3
Hypermectus,stormscale,288,warlock,destruction,6,3,3
Givënchy,archimonde,288,warlock,destruction,6,3,3
Hübschi,lothar,288,warlock,destruction,6,3,3
Динодотх,gordunni,288,warlock,destruction,6,3,3
Dmger,twisting-nether,288,warlock,destruction,6,3,3
Stridson,shattered-hand,288,warlock,destruction,6,3,3
Saymore,ragnaros,288,warlock,destruction,6,3,3
Belite,archimonde,288,warlock,destruction,6,3,3
Løvesøsa,ravencrest,288,warlock,destruction,6,3,3
Rindo,conseil-des-ombres,288,warlock,destruction,6,3,3
Drybolt,argent-dawn,288,warlock,destruction,6,3,3
Anniemoon,silvermoon,288,warlock,destruction,6,3,3
Simendimen,tarren-mill,288,warlock,destruction,6,3,3
Calistria,argent-dawn,288,warlock,destruction,6,3,3
Loq,frostwolf,288,warlock,destruction,6,3,3
Hotwhileurot,silvermoon,288,warlock,destruction,6,3,3
Deylanar,tarren-mill,288,warlock,destruction,6,3,3
Lokdok,draenor,288,warlock,destruction,6,3,3
Iwy,anetheron,288,warlock,destruction,6,3,3
Biancalawson,argent-dawn,288,warlock,destruction,6,3,3
Aparadexth,silvermoon,288,warlock,destruction,6,3,3
Chaotyk,drakthul,288,warlock,destruction,6,3,3
Húxy,silvermoon,288,warlock,destruction,6,3,3
Besthun,drakthul,288,warlock,destruction,6,3,3
Thyron,gorgonnash,288,warlock,destruction,6,3,3
Zabani,das-syndikat,288,warlock,destruction,6,3,3
Drozhna,kaelthas,288,warlock,destruction,6,3,3
Митямассфир,soulflayer,288,warlock,destruction,6,3,3
Jedlock,outland,288,warlock,destruction,6,3,3
Gïzzmo,tarren-mill,288,warlock,destruction,6,3,3
Mightnáré,tarren-mill,288,warlock,destruction,6,3,3
Selenene,norgannon,288,warlock,destruction,6,3,3
Bu,zirkel-des-cenarius,288,warlock,destruction,6,3,3
Lamboo,tarren-mill,288,warlock,destruction,6,3,3
Jeepsee,outland,288,warlock,destruction,6,3,3
Yippz,kazzak,288,warlock,destruction,6,3,3
Dailylock,kazzak,288,warlock,destruction,6,3,3
Knowfear,doomhammer,288,warlock,destruction,6,3,3
Ðiablð,tarren-mill,288,warlock,destruction,6,3,3
Lemuriel,arthas,288,warlock,destruction,6,3,3
Mïta,culte-de-la-rive-noire,288,warlock,destruction,6,3,3
Tigna,outland,288,warlock,destruction,6,3,3
Grîmløck,thrall,288,warlock,destruction,6,3,3
Lestroy,draenor,288,warlock,destruction,6,3,3
Dipsí,kazzak,288,warlock,destruction,6,3,3
Hairylock,outland,288,warlock,destruction,6,3,3
Nargøf,outland,288,warlock,destruction,6,3,3
Ascètic,kazzak,288,warlock,destruction,6,3,3
Ajc,draenor,288,warlock,destruction,6,3,3
ßudßud,kazzak,288,warlock,destruction,6,3,3
Ruinovino,outland,288,warlock,destruction,6,3,3
Lockskalle,tarren-mill,288,warlock,destruction,6,3,3
Doomgrunt,magtheridon,288,warlock,destruction,6,3,3
Amdownbad,kazzak,288,warlock,destruction,6,3,3
Данябандит,soulflayer,288,warlock,destruction,6,3,3
Covidbolt,outland,288,warlock,destruction,6,3,3
Féarléss,tarren-mill,288,warlock,destruction,6,3,3
Boldielocks,tarren-mill,288,warlock,destruction,6,3,3
Accardí,eredar,288,warlock,destruction,6,3,3
Bixle,thrall,288,warlock,destruction,6,3,3
Mvplock,magtheridon,288,warlock,destruction,6,3,3
Viclock,kazzak,288,warlock,destruction,6,3,3
Bronnox,frostmane,288,warlock,destruction,9,4,5
Fêar,frostwhisper,288,warlock,destruction,9,4,5
Wolfdoom,cthun,288,warlock,destruction,9,3,6
Ятвояпогибел,soulflayer,288,warlock,destruction,10,3,7
Минструал,soulflayer,288,warlock,destruction,11,3,8
Lostmind,doomhammer,288,warlock,destruction,11,3,8
Heldis,outland,288,warlock,destruction,12,3,9
Tiffyilock,blackrock,288,warlock,destruction,12,3,9
Fear,outland,288,warlock,destruction,12,3,9
Rogzon,eredar,288,warlock,destruction,12,3,9
Svartalfen,outland,288,warlock,destruction,12,3,9
Sebi,kirin-tor,288,warlock,destruction,12,3,9
Alicechaos,draenor,288,warlock,destruction,12,3,9
Chaoschao,silvermoon,288,warlock,destruction,12,3,9
Skyrender,argent-dawn,288,warlock,destruction,12,3,9
Purplerock,grim-batol,288,warlock,destruction,12,3,9
Beybeyd,argent-dawn,288,warlock,destruction,12,3,9
Dotzillâ,blackhand,288,warlock,destruction,12,3,9
Occult,terokkar,288,warlock,destruction,12,3,9
Deabrus,silvermoon,288,warlock,destruction,12,3,9
Shelbys,tyrande,288,warlock,destruction,12,3,9
Крегтико,galakrond,288,warlock,destruction,12,3,9
Faustes,alakir,288,warlock,destruction,12,3,9
Daeneerys,skullcrusher,288,warlock,destruction,12,3,9
Bytethisx,aggra-português,288,warlock,destruction,12,3,9
Britneý,stormscale,288,warlock,destruction,12,3,9
Maleff,sanguino,288,warlock,destruction,12,3,9
Galadninon,drakthul,288,warlock,destruction,12,3,9
Swoksáar,blackmoore,288,warlock,destruction,12,3,9
Freshh,burning-legion,288,warlock,destruction,12,3,9
Jaír,turalyon,288,warlock,destruction,12,3,9
Valgg,tarren-mill,288,warlock,destruction,12,3,9
Phéar,deathwing,288,warlock,destruction,12,3,9
Mitrela,ravencrest,288,warlock,destruction,12,3,9
Nímdaa,stormscale,288,warlock,destruction,12,3,9
Quief,silvermoon,288,warlock,destruction,12,3,9
Zhareeus,sanguino,288,warlock,destruction,12,3,9
Пучкова,azuregos,288,warlock,destruction,12,3,9
Leatherfvce,blackmoore,288,warlock,destruction,12,3,9
Isanê,blackrock,288,warlock,destruction,12,3,9
Werlock,sanguino,288,warlock,destruction,12,3,9
Тэйлок,gordunni,288,warlock,destruction,12,3,9
Brambam,stormrage,288,warlock,destruction,12,3,9
Xrathis,thunderhorn,288,warlock,destruction,12,3,9
Arwennia,malganis,288,warlock,destruction,12,3,9
Merelock,eonar,288,warlock,destruction,12,3,9
Маверрикк,gordunni,288,warlock,destruction,12,3,9
Gooey,magtheridon,288,warlock,destruction,12,3,9
Варикай,gordunni,288,warlock,destruction,12,3,9
Aloxer,sanguino,288,warlock,destruction,12,3,9
Киёкка,howling-fjord,288,warlock,destruction,12,3,9
Naginii,sanguino,288,warlock,destruction,18,3,15
Нагибатель,howling-fjord,288,warlock,destruction,18,3,15
Fewton,eonar,288,warlock,destruction,18,3,15
Imbasimba,sylvanas,287,warlock,destruction,8,4,4
Wegart,sylvanas,287,warlock,destruction,6,3,3
Grimzold,terokkar,287,warlock,destruction,6,3,3
Ashkaar,argent-dawn,287,warlock,destruction,6,3,3
Bluenote,colinas-pardas,287,warlock,destruction,12,3,9
Наруту,gordunni,287,warlock,destruction,18,3,15
Haysang,khaz-modan,274,warlock,destruction,22,7,15
Lockaria,zuljin,256,warlock,destruction,10,3,7
Newyorkcity,antonidas,255,warlock,destruction,11,3,8
Tanatos,tarren-mill,255,warlock,destruction,11,3,8
Shoobre,alakir,240,warlock,destruction,15,3,12
Nèssiè,sylvanas,239,warlock,destruction,5,3,2
Furrbidden,twisting-nether,239,warlock,destruction,5,3,2
Alwaysbroken,archimonde,239,warlock,destruction,5,3,2
Brushiè,kazzak,239,warlock,destruction,5,3,2
Insertchaos,draenor,239,warlock,destruction,5,3,2
Fearbly,tarren-mill,239,warlock,destruction,5,3,2
Opprimo,blackmoore,239,warlock,destruction,10,3,7
Chimera,mugthol,239,warlock,destruction,11,3,8
Darthdotz,outland,234,warlock,destruction,7,4,3
Talt,dalaran,234,warlock,destruction,15,6,9
Charmerx,kazzak,234,warlock,destruction,10,4,6
Arnoldswarce,doomhammer,234,warlock,destruction,12,4,8
Теймкрин,gordunni,234,warlock,destruction,13,4,9
Sineko,twisting-nether,233,warlock,destruction,11,6,5
Kemuruss,kazzak,208,warlock,destruction,7,3,4
Герциер,soulflayer,192,warlock,destruction,4,3,1
Ðankan,aegwynn,192,warlock,destruction,4,3,1
Vortëxx,tarren-mill,192,warlock,destruction,9,3,6
Isotty,hyjal,192,warlock,destruction,9,3,6
Clopot,ravencrest,192,warlock,destruction,6,2,4
Cheesefeet,ravencrest,192,warlock,destruction,6,2,4
Houndread,kazzak,192,warlock,destruction,6,2,4
Haxs,ravencrest,192,warlock,destruction,6,2,4
Somalidog,ravencrest,192,warlock,destruction,6,2,4
Taralle,ysondre,192,warlock,destruction,6,2,4
Belzedan,blackrock,192,warlock,destruction,6,2,4
Omnipótent,moonglade,192,warlock,destruction,6,2,4
Zhulthan,ravencrest,192,warlock,destruction,6,2,4
Werkx,archimonde,192,warlock,destruction,6,2,4
Azerybedge,alexstrasza,192,warlock,destruction,6,2,4
Ambjørg,kazzak,192,warlock,destruction,6,2,4
Qullnius,kazzak,192,warlock,destruction,6,2,4
Kleing,dragonblight,192,warlock,destruction,6,2,4
Sôshy,thrall,192,warlock,destruction,6,2,4
Vextos,draenor,192,warlock,destruction,6,2,4
Prydzor,archimonde,192,warlock,destruction,6,2,4
Creamcleaner,tarren-mill,192,warlock,destruction,6,2,4
Hytsulock,ysondre,192,warlock,destruction,6,2,4
Kwanzaa,ravencrest,192,warlock,destruction,6,2,4
Whydidudotha,ravencrest,192,warlock,destruction,6,2,4
Ralys,draenor,192,warlock,destruction,6,2,4
Шэдоубёрн,soulflayer,192,warlock,destruction,6,2,4
Glitchpop,archimonde,192,warlock,destruction,6,2,4
Sinlockz,tarren-mill,192,warlock,destruction,6,2,4
Laynih,blackrock,192,warlock,destruction,6,2,4
Ayôörts,archimonde,192,warlock,destruction,6,2,4
Ght,outland,192,warlock,destruction,6,2,4
Lightswitchz,ravencrest,192,warlock,destruction,6,2,4
Incubith,ravencrest,192,warlock,destruction,6,2,4
Getoffmedude,ravencrest,192,warlock,destruction,6,2,4
Øupas,ysondre,192,warlock,destruction,6,2,4
Siìre,ravencrest,192,warlock,destruction,6,2,4
Splojf,the-maelstrom,192,warlock,destruction,6,2,4
Kemel,thrall,192,warlock,destruction,6,2,4
Reapex,lightbringer,192,warlock,destruction,6,2,4
Llyluna,hyjal,192,warlock,destruction,6,2,4
Malliina,draenor,192,warlock,destruction,6,2,4
Chuntlock,shadowsong,192,warlock,destruction,6,2,4
Cindela,eredar,192,warlock,destruction,6,2,4
Grandulf,ravencrest,192,warlock,destruction,6,2,4
Silverghoul,draenor,192,warlock,destruction,6,2,4
Piouturass,hyjal,192,warlock,destruction,6,2,4
Kuzimu,aerie-peak,192,warlock,destruction,6,2,4
Nâzgrel,tarren-mill,192,warlock,destruction,6,2,4
Balrokor,talnivarr,192,warlock,destruction,6,2,4
Lockerby,kazzak,192,warlock,destruction,6,2,4
Mommymílkers,archimonde,192,warlock,destruction,6,2,4
Bigminimus,ravencrest,192,warlock,destruction,6,2,4
Zmataryn,doomhammer,192,warlock,destruction,6,2,4
Бактэрия,soulflayer,192,warlock,destruction,6,2,4
Хашонмвп,gordunni,192,warlock,destruction,6,2,4
Lzeus,archimonde,192,warlock,destruction,6,2,4
Tragus,ghostlands,192,warlock,destruction,6,2,4
Kathrose,silvermoon,192,warlock,destruction,6,2,4
Grilljédén,blackrock,192,warlock,destruction,6,2,4
Cuufi,silvermoon,192,warlock,destruction,6,2,4
Felguy,ravencrest,192,warlock,destruction,6,2,4
Elfex,ragnaros,192,warlock,destruction,6,2,4
Saabnoolock,ragnaros,192,warlock,destruction,6,2,4
Fellanova,ravencrest,192,warlock,destruction,6,2,4
Levitibus,argent-dawn,192,warlock,destruction,6,2,4
Mákas,draenor,192,warlock,destruction,6,2,4
Сэльт,howling-fjord,192,warlock,destruction,6,2,4
Angrythots,draenor,192,warlock,destruction,6,2,4
Майдум,soulflayer,192,warlock,destruction,6,2,4
Фланка,gordunni,192,warlock,destruction,6,2,4
Zenaidaa,doomhammer,192,warlock,destruction,6,2,4
Zkrwl,kazzak,192,warlock,destruction,6,2,4
Ðaddyy,stormscale,192,warlock,destruction,6,2,4
Meapx,ragnaros,192,warlock,destruction,6,2,4
Guldän,quelthalas,192,warlock,destruction,6,2,4
Darkenlock,burning-legion,192,warlock,destruction,6,2,4
Локгномус,azuregos,192,warlock,destruction,6,2,4
Kawaïí,frostwolf,192,warlock,destruction,6,2,4
Skynoby,kazzak,192,warlock,destruction,6,2,4
Шизуи,borean-tundra,192,warlock,destruction,6,2,4
Antuan,sanguino,192,warlock,destruction,6,2,4
Maldrium,zenedar,192,warlock,destruction,6,2,4
Heliphas,draenor,192,warlock,destruction,6,2,4
Bloodysûgar,blackmoore,192,warlock,destruction,6,2,4
Letor,sanguino,192,warlock,destruction,6,2,4
Degdeehei,draenor,192,warlock,destruction,6,2,4
Ravenglass,argent-dawn,192,warlock,destruction,6,2,4
Ишла,gordunni,192,warlock,destruction,6,2,4
Snoggä,antonidas,192,warlock,destruction,6,2,4
Vazelin,stormscale,192,warlock,destruction,6,2,4
Sløck,blackhand,192,warlock,destruction,6,2,4
Smoulville,sanguino,192,warlock,destruction,6,2,4
Jubekah,sanguino,192,warlock,destruction,6,2,4
Toshiku,aggra-português,192,warlock,destruction,6,2,4
Æyna,thrall,192,warlock,destruction,6,2,4
Nerflocks,aggra-português,192,warlock,destruction,6,2,4
Rojas,trollbane,192,warlock,destruction,6,2,4
Contergan,arygos,192,warlock,destruction,6,2,4
Agonux,twisting-nether,192,warlock,destruction,6,2,4
Локеда,deathguard,192,warlock,destruction,6,2,4
Astralvoid,outland,192,warlock,destruction,6,2,4
Dééznuts,blackmoore,192,warlock,destruction,6,2,4
Januzoton,kazzak,192,warlock,destruction,6,2,4
Nedhriix,drakthul,192,warlock,destruction,6,2,4
Dinolock,antonidas,192,warlock,destruction,6,2,4
Pythius,destromath,192,warlock,destruction,6,2,4
Guttate,chamber-of-aspects,192,warlock,destruction,6,2,4
Necrochiller,tarren-mill,192,warlock,destruction,6,2,4
Vittaly,sargeras,192,warlock,destruction,6,2,4
Prestige,nemesis,192,warlock,destruction,6,2,4
Sigred,sylvanas,192,warlock,destruction,6,2,4
Priszcilla,twisting-nether,192,warlock,destruction,6,2,4
Ashhlock,silvermoon,192,warlock,destruction,6,2,4
Cosec,silvermoon,192,warlock,destruction,6,2,4
Aváne,outland,192,warlock,destruction,6,2,4
Kabowie,twisting-nether,192,warlock,destruction,6,2,4
Tëazle,chogall,192,warlock,destruction,6,2,4
Kedrat,die-aldor,192,warlock,destruction,6,2,4
Hadexx,uldum,192,warlock,destruction,6,2,4
Dødheim,malganis,192,warlock,destruction,6,2,4
Devadevam,twisting-nether,192,warlock,destruction,6,2,4
Dêmön,arathi,192,warlock,destruction,6,2,4
Lokla,elune,192,warlock,destruction,6,2,4
Benztruck,blackhand,192,warlock,destruction,6,2,4
Destrodanii,dun-morogh,192,warlock,destruction,6,2,4
Lakataz,balnazzar,192,warlock,destruction,6,2,4
Merengue,uldum,192,warlock,destruction,6,2,4
Malfari,zuljin,192,warlock,destruction,6,2,4
Öhö,blackrock,192,warlock,destruction,6,2,4
Пухи,blackscar,192,warlock,destruction,6,2,4
Grinige,twisting-nether,192,warlock,destruction,6,2,4
Zagana,neptulon,192,warlock,destruction,6,2,4
Revvolt,tarren-mill,192,warlock,destruction,6,2,4
Хоратхе,soulflayer,192,warlock,destruction,6,2,4
Meshekinoqua,tarren-mill,192,warlock,destruction,6,2,4
Ívânguldán,twisting-nether,192,warlock,destruction,6,2,4
Efekentli,frostwolf,192,warlock,destruction,6,2,4
Qvvu,blackmoore,192,warlock,destruction,10,3,7
Laventina,antonidas,192,warlock,destruction,12,3,9
Lykaos,baelgun,192,warlock,destruction,8,2,6
Themits,executus,192,warlock,destruction,12,2,10
Srhal,blackmoore,192,warlock,destruction,12,2,10
Bigusdicus,aszune,192,warlock,destruction,12,2,10
Ladlocklul,silvermoon,192,warlock,destruction,12,2,10
Risujemma,stormreaver,192,warlock,destruction,12,2,10
Nimwyn,argent-dawn,192,warlock,destruction,12,2,10
Rubiloc,the-maelstrom,192,warlock,destruction,12,2,10
Sarómán,ravencrest,192,warlock,destruction,12,2,10
Valerga,zuljin,192,warlock,destruction,12,2,10
Punishteens,blackmoore,192,warlock,destruction,12,2,10
Ussetmethrie,kazzak,192,warlock,destruction,12,2,10
Shallän,dun-modr,192,warlock,destruction,12,2,10
Sanghá,frostwolf,192,warlock,destruction,12,2,10
Kopfkissen,azshara,192,warlock,destruction,12,2,10
Exodemon,stormscale,192,warlock,destruction,12,2,10
Skratti,lightnings-blade,192,warlock,destruction,12,2,10
Amnésïa,eldrethalas,192,warlock,destruction,12,2,10
Serkt,kazzak,192,warlock,destruction,12,2,10
Jerembro,hyjal,192,warlock,destruction,12,2,10
Нэйрокризиз,howling-fjord,192,warlock,destruction,12,2,10
Blugrey,nemesis,192,warlock,destruction,12,2,10
Necrophagus,outland,192,warlock,destruction,12,2,10
Agathaharkne,minahonda,192,warlock,destruction,12,2,10
Titoss,archimonde,192,warlock,destruction,12,2,10
Kiriforce,blackmoore,192,warlock,destruction,12,2,10
Zùrghan,elune,191,warlock,destruction,4,3,1
Chainlinc,turalyon,191,warlock,destruction,6,2,4
Ribtic,draenor,191,warlock,destruction,6,2,4
Karjarock,hyjal,191,warlock,destruction,12,2,10
Gaios,skullcrusher,191,warlock,destruction,18,2,16
Syrax,darkmoon-faire,191,warlock,destruction,24,2,22
Lockbubs,draenor,175,warlock,destruction,11,2,9
Qiymaster,silvermoon,160,warlock,destruction,10,2,8
Slìm,blackmoore,159,warlock,destruction,5,2,3
Pewnedmpx,archimonde,159,warlock,destruction,5,2,3
Lemonzx,stormscale,159,warlock,destruction,5,2,3
Grimlòck,antonidas,159,warlock,destruction,5,2,3
Dony,dun-morogh,159,warlock,destruction,5,2,3
Фримх,blackscar,159,warlock,destruction,5,2,3
Lockheedbao,outland,159,warlock,destruction,5,2,3
Lockimon,silvermoon,159,warlock,destruction,5,2,3
Jiltoks,blackmoore,159,warlock,destruction,5,2,3
Hp,ysondre,159,warlock,destruction,5,2,3
Kalilumpa,festung-der-stürme,144,warlock,destruction,9,2,7
Elvilaino,archimonde,138,warlock,destruction,6,3,3
Vahk,uldum,138,warlock,destruction,7,3,4
Neveah,festung-der-stürme,138,warlock,destruction,8,3,5
Rb,anachronos,138,warlock,destruction,8,3,5
Frankieboi,drakthul,138,warlock,destruction,8,3,5
Darkpush,outland,138,warlock,destruction,11,4,7
Jabalock,mazrigos,138,warlock,destruction,15,5,10
Wdauwg,nazjatar,138,warlock,destruction,9,3,6
Hhogyoku,dentarg,138,warlock,destruction,10,3,7
Sigge,auchindoun,138,warlock,destruction,10,3,7
Belzzebuth,silvermoon,128,warlock,destruction,10,2,8
Dzeju,burning-legion,128,warlock,destruction,10,2,8
Перегном,blackscar,127,warlock,destruction,8,2,6
Mqsxw,stormscale,112,warlock,destruction,7,2,5
Neijihbolt,blackrock,112,warlock,destruction,7,2,5
Fabz,aggra-português,96,warlock,destruction,3,2,1
Mulimarus,die-todeskrallen,96,warlock,destruction,3,2,1
Smaskens,trollbane,96,warlock,destruction,3,2,1
Lockitz,kazzak,96,warlock,destruction,3,2,1
Dannyboi,drakthul,96,warlock,destruction,3,2,1
Mergon,ravencrest,96,warlock,destruction,3,2,1
Faustenburg,blackmoore,96,warlock,destruction,3,2,1
Bigbabalock,frostwolf,96,warlock,destruction,6,1,5
Mattihoh,rexxar,96,warlock,destruction,6,1,5
Malfarien,blackmoore,96,warlock,destruction,6,1,5
Forzaken,bladefist,96,warlock,destruction,6,1,5
Tinaufatlard,ravencrest,96,warlock,destruction,6,1,5
Heißerheinz,blackhand,96,warlock,destruction,6,1,5
Cresen,tarren-mill,96,warlock,destruction,6,1,5
Lemonhase,frostwolf,96,warlock,destruction,6,1,5
Ackorax,kilrogg,96,warlock,destruction,6,1,5
Meisterhexe,taerar,96,warlock,destruction,6,1,5
Pablø,silvermoon,96,warlock,destruction,6,1,5
Jolette,hyjal,96,warlock,destruction,6,1,5
Ájszmen,ravencrest,96,warlock,destruction,6,1,5
Hørcrux,ravencrest,96,warlock,destruction,6,1,5
Tyranuzz,norgannon,96,warlock,destruction,6,1,5
Indifférence,archimonde,96,warlock,destruction,6,1,5
Reiukh,frostwolf,96,warlock,destruction,6,1,5
Snollerboy,antonidas,96,warlock,destruction,6,1,5
Сквиртонитх,howling-fjord,96,warlock,destruction,6,1,5
Pichwise,draenor,96,warlock,destruction,6,1,5
Vîerdotcom,blackrock,96,warlock,destruction,6,1,5
Битриксс,soulflayer,96,warlock,destruction,6,1,5
Növnöv,madmortem,96,warlock,destruction,6,1,5
Fell,outland,96,warlock,destruction,6,1,5
Totephia,kazzak,96,warlock,destruction,6,1,5
Lomendro,blackmoore,96,warlock,destruction,6,1,5
Walchia,kazzak,96,warlock,destruction,6,1,5
Shelancîá,blackmoore,96,warlock,destruction,6,1,5
Kyyte,draenor,96,warlock,destruction,6,1,5
Nècrøphila,kazzak,96,warlock,destruction,6,1,5
Shompaqzan,kazzak,96,warlock,destruction,6,1,5
Harrasmus,ravencrest,96,warlock,destruction,6,1,5
Gibbio,emerald-dream,96,warlock,destruction,6,1,5
Dadcrush,antonidas,96,warlock,destruction,6,1,5
Wake,bladefist,96,warlock,destruction,6,1,5
Варатах,grom,96,warlock,destruction,6,1,5
Murol,dalaran,96,warlock,destruction,6,1,5
Zeirat,tarren-mill,96,warlock,destruction,6,1,5
Satânius,les-sentinelles,96,warlock,destruction,6,1,5
Löck,kirin-tor,96,warlock,destruction,6,1,5
Млечный,blackscar,96,warlock,destruction,6,1,5
Krabauf,eredar,96,warlock,destruction,6,1,5
Tectite,sporeggar,96,warlock,destruction,6,1,5
Finea,sanguino,96,warlock,destruction,6,1,5
Bigsuckergg,norgannon,96,warlock,destruction,6,1,5
Mortvivants,kirin-tor,96,warlock,destruction,6,1,5
Thaliä,tarren-mill,96,warlock,destruction,6,1,5
Rigour,silvermoon,96,warlock,destruction,6,1,5
Redî,kazzak,96,warlock,destruction,6,1,5
Kathuum,outland,96,warlock,destruction,6,1,5
Ezgamebruh,turalyon,96,warlock,destruction,6,1,5
Lilskunk,draenor,96,warlock,destruction,6,1,5
Omnath,alakir,96,warlock,destruction,6,1,5
Chaostheory,stormscale,96,warlock,destruction,6,1,5
Bönnie,ravencrest,96,warlock,destruction,6,1,5
Древнина,greymane,96,warlock,destruction,6,1,5
Artery,tarren-mill,96,warlock,destruction,6,1,5
Тапкидеда,gordunni,96,warlock,destruction,6,1,5
Милбон,gordunni,96,warlock,destruction,6,1,5
Buyala,stormscale,96,warlock,destruction,6,1,5
Артекриолок,gordunni,96,warlock,destruction,6,1,5
Daemonic,shattered-hand,96,warlock,destruction,6,1,5
Nulo,aggra-português,96,warlock,destruction,6,1,5
Jujalari,stormscale,96,warlock,destruction,6,1,5
Utuklululu,archimonde,96,warlock,destruction,6,1,5
Mahishi,ravencrest,96,warlock,destruction,6,1,5
Chaotick,bronze-dragonflight,96,warlock,destruction,6,1,5
Прозерппина,azuregos,96,warlock,destruction,6,1,5
Cruello,ragnaros,96,warlock,destruction,6,1,5
Wolramir,thrall,96,warlock,destruction,6,1,5
Narkozz,archimonde,96,warlock,destruction,6,1,5
Noxregina,antonidas,96,warlock,destruction,6,1,5
Gothgul,sanguino,96,warlock,destruction,6,1,5
Ceean,silvermoon,96,warlock,destruction,6,1,5
Kostur,defias-brotherhood,96,warlock,destruction,6,1,5
Cutewife,burning-legion,96,warlock,destruction,6,1,5
Artèm,ysondre,96,warlock,destruction,6,1,5
Gulzgan,kazzak,96,warlock,destruction,6,1,5
Pssycho,defias-brotherhood,96,warlock,destruction,6,1,5
Tiig,blackrock,96,warlock,destruction,6,1,5
Цетрелисс,gordunni,96,warlock,destruction,6,1,5
Kyyuss,burning-legion,96,warlock,destruction,6,1,5
Bigtitzes,ravencrest,96,warlock,destruction,6,1,5
Zapplock,frostwolf,96,warlock,destruction,6,1,5
Seriasa,blackmoore,96,warlock,destruction,6,1,5
Mursha,auchindoun,96,warlock,destruction,6,1,5
Yashâ,thrall,96,warlock,destruction,6,1,5
Xvron,tarren-mill,96,warlock,destruction,6,1,5
Taelesh,draenor,96,warlock,destruction,6,1,5
Raest,arygos,96,warlock,destruction,6,1,5
Иммолэйтх,gordunni,96,warlock,destruction,6,1,5
Maidson,blackrock,96,warlock,destruction,6,1,5
Aerethes,twisting-nether,96,warlock,destruction,6,1,5
Candyforkid,hyjal,96,warlock,destruction,6,1,5
Lockydotty,silvermoon,96,warlock,destruction,6,1,5
Wt,twisting-nether,96,warlock,destruction,6,1,5
Rêihdon,antonidas,96,warlock,destruction,6,1,5
Lialda,twisting-nether,96,warlock,destruction,6,1,5
Dabezdwl,outland,96,warlock,destruction,6,1,5
Felzadros,dun-modr,96,warlock,destruction,6,1,5
Darkaltered,auchindoun,96,warlock,destruction,6,1,5
Zytomegalie,blackrock,96,warlock,destruction,6,1,5
Ramuhn,antonidas,96,warlock,destruction,6,1,5
Czteryka,silvermoon,96,warlock,destruction,6,1,5
Enmakorogi,twisting-nether,96,warlock,destruction,6,1,5
Aenygma,jaedenar,96,warlock,destruction,6,1,5
Znaj,tarren-mill,96,warlock,destruction,6,1,5
Matfey,twisting-nether,96,warlock,destruction,6,1,5
Kineo,argent-dawn,96,warlock,destruction,6,1,5
Kopfschmerz,twisting-nether,96,warlock,destruction,6,1,5
Yerslock,twisting-nether,96,warlock,destruction,6,1,5
Sunsero,exodar,96,warlock,destruction,6,1,5
Язлаякиска,soulflayer,96,warlock,destruction,6,1,5
Kickfear,kazzak,96,warlock,destruction,7,1,6
Ozzycrøwly,illidan,96,warlock,destruction,15,2,13
Harrydotterr,aegwynn,96,warlock,destruction,11,1,10
Wuahlock,doomhammer,96,warlock,destruction,12,1,11
Kehldor,blackmoore,96,warlock,destruction,12,1,11
Democraft,the-maelstrom,96,warlock,destruction,12,1,11
Árkan,thrall,96,warlock,destruction,12,1,11
Реймей,blackscar,96,warlock,destruction,12,1,11
Feltox,auchindoun,96,warlock,destruction,12,1,11
Rîas,hyjal,96,warlock,destruction,12,1,11
Gainel,exodar,96,warlock,destruction,12,1,11
Niights,sylvanas,96,warlock,destruction,12,1,11
Deathdawning,draenor,96,warlock,destruction,12,1,11
Alithia,sylvanas,96,warlock,destruction,12,1,11
Wellmannered,kazzak,96,warlock,destruction,12,1,11
Malagate,sylvanas,96,warlock,destruction,12,1,11
Grêenbull,eredar,96,warlock,destruction,15,1,14
Valinskej,drakthul,79,warlock,destruction,5,1,4
Okmybad,outland,79,warlock,destruction,5,1,4
Gódríg,sylvanas,79,warlock,destruction,5,1,4
Dadadots,ravenholdt,79,warlock,destruction,5,1,4
Magosnik,archimonde,79,warlock,destruction,5,1,4
Mesîkatayut,outland,79,warlock,destruction,11,1,10
Tranas,ragnaros,64,warlock,destruction,4,1,3
Néca,blackmoore,64,warlock,destruction,4,1,3
Malariaa,defias-brotherhood,63,warlock,destruction,2,2,0
Coolfayce,draenor,48,warlock,destruction,3,1,2
Coblac,outland,48,warlock,destruction,3,1,2
Zereff,kragjin,48,warlock,destruction,3,1,2
Obichamcici,tarren-mill,42,warlock,destruction,8,2,6
Anthor,tarren-mill,42,warlock,destruction,8,2,6
Stonedup,alonsus,42,warlock,destruction,8,2,6
Rockstarr,dalaran,42,warlock,destruction,10,2,8
Zaross,khaz-modan,41,warlock,destruction,8,2,6
Demospîrît,outland,40,warlock,destruction,17,3,14
Zuldiá,stormscale,32,warlock,destruction,2,2,0
Kiraxplode,nemesis,31,warlock,destruction,2,1,1
Førgøtten,ragnaros,31,warlock,destruction,2,1,1
Pereat,blackmoore,31,warlock,destruction,2,1,1
Slockoló,ragnaros,31,warlock,destruction,2,1,1
Chandelierh,kazzak,31,warlock,destruction,2,1,1
Níkâ,aegwynn,16,warlock,destruction,1,1,0
Orkamorfin,silvermoon,16,warlock,destruction,1,1,0
Tágsy,ravencrest,2309,warlock,affliction,138,79,59
Langneur,ysondre,2247,warlock,affliction,114,63,51
Micol,doomhammer,2181,warlock,affliction,132,68,64
Härèsß,dun-modr,2174,warlock,affliction,124,73,51
Hædês,antonidas,2171,warlock,affliction,180,97,83
Bualock,sylvanas,2168,warlock,affliction,108,64,44
Exoldboss,outland,2155,warlock,affliction,102,54,48
Steckenpferd,blackmoore,2149,warlock,affliction,66,39,27
Ánderx,dun-modr,2108,warlock,affliction,90,48,42
Hirasawa,archimonde,2105,warlock,affliction,73,38,35
Arukekz,blackmoore,2093,warlock,affliction,126,65,61
Chobitas,ravencrest,2076,warlock,affliction,150,78,72
Celebí,blackmoore,2075,warlock,affliction,90,56,34
Darksooul,xavius,2063,warlock,affliction,107,64,43
Kaspersdame,ravencrest,2038,warlock,affliction,237,122,115
Kärme,archimonde,2026,warlock,affliction,455,231,224
Magonyth,tarren-mill,2023,warlock,affliction,107,61,46
Arussj,blackrock,2018,warlock,affliction,104,51,53
Консидёро,gordunni,2016,warlock,affliction,133,72,61
Southylolz,stormscale,2015,warlock,affliction,71,36,35
Magonyth,ravencrest,2014,warlock,affliction,102,56,46
Buffdemo,blackmoore,2006,warlock,affliction,54,39,15
Alliyâh,archimonde,1999,warlock,affliction,254,129,125
Fruits,ysondre,1990,warlock,affliction,162,77,85
Nickrosh,terokkar,1989,warlock,affliction,66,39,27
Sehk,stormreaver,1984,warlock,affliction,85,47,38
Тагочи,gordunni,1979,warlock,affliction,83,40,43
Gulgiann,nemesis,1977,warlock,affliction,72,38,34
Skrumpis,draenor,1976,warlock,affliction,353,181,172
Мануил,eversong,1967,warlock,affliction,65,38,27
Rutena,ravencrest,1965,warlock,affliction,90,46,44
Yokûjin,twisting-nether,1956,warlock,affliction,79,41,38
Glooness,burning-legion,1955,warlock,affliction,72,44,28
Toutanpapier,ysondre,1955,warlock,affliction,48,28,20
Perpetual,eredar,1950,warlock,affliction,60,33,27
Southyx,stormscale,1950,warlock,affliction,107,56,51
Angryfránk,outland,1947,warlock,affliction,257,130,127
Southylol,stormscale,1944,warlock,affliction,138,72,66
Nesme,sylvanas,1938,warlock,affliction,95,46,49
Qyburn,drekthar,1934,warlock,affliction,84,48,36
Laokoon,blackmoore,1933,warlock,affliction,170,99,71
Gulzot,turalyon,1931,warlock,affliction,185,96,89
Мрорбит,howling-fjord,1927,warlock,affliction,125,59,66
Southy,stormscale,1918,warlock,affliction,48,25,23
Kajanova,stormscale,1916,warlock,affliction,140,84,56
Shadowflamez,argent-dawn,1914,warlock,affliction,54,34,20
Фламмэнх,soulflayer,1914,warlock,affliction,78,47,31
Boogeyboyx,stormscale,1914,warlock,affliction,125,65,60
Рашчер,gordunni,1909,warlock,affliction,48,25,23
Infïnitýx,silvermoon,1907,warlock,affliction,149,82,67
Sad,lightnings-blade,1906,warlock,affliction,106,47,59
Mïta,hyjal,1904,warlock,affliction,48,27,21
Fredé,kazzak,1899,warlock,affliction,54,29,25
Plsdîe,twisting-nether,1895,warlock,affliction,95,52,43
Infernion,stormscale,1891,warlock,affliction,51,33,18
Gøzù,antonidas,1884,warlock,affliction,52,30,22
Mediumpotato,blackhand,1878,warlock,affliction,54,30,24
Limoges,archimonde,1874,warlock,affliction,90,55,35
Bäle,stormreaver,1869,warlock,affliction,54,32,22
Debz,twisting-nether,1864,warlock,affliction,118,71,47
Nêverse,archimonde,1857,warlock,affliction,36,22,14
Hladankurac,twisting-nether,1851,warlock,affliction,78,43,35
Sêro,aegwynn,1850,warlock,affliction,111,62,49
Bwc,aegwynn,1850,warlock,affliction,140,70,70
Yosiya,draenor,1848,warlock,affliction,127,74,53
Блудгэнг,blackscar,1847,warlock,affliction,48,21,27
Vregor,twisting-nether,1844,warlock,affliction,64,35,29
Oarz,blackrock,1837,warlock,affliction,179,100,79
Kasoy,doomhammer,1837,warlock,affliction,160,84,76
Cassen,outland,1833,warlock,affliction,60,31,29
Getfaked,nordrassil,1832,warlock,affliction,54,28,26
Пчелокнижник,howling-fjord,1831,warlock,affliction,42,25,17
Dst,ravencrest,1824,warlock,affliction,72,40,32
Halfwai,ravencrest,1824,warlock,affliction,78,43,35
Dualla,aegwynn,1821,warlock,affliction,100,59,41
Xvq,twisting-nether,1819,warlock,affliction,106,67,39
Monsterz,archimonde,1819,warlock,affliction,99,53,46
Fsandtwo,ravencrest,1817,warlock,affliction,74,38,36
Demónfire,sylvanas,1816,warlock,affliction,64,35,29
Robertóoo,burning-legion,1814,warlock,affliction,128,79,49
Malddog,turalyon,1813,warlock,affliction,131,75,56
Bfaexpert,ravencrest,1808,warlock,affliction,34,22,12
Langneur,archimonde,1805,warlock,affliction,48,22,26
Wldot,ravencrest,1802,warlock,affliction,42,24,18
Kresyda,dun-modr,1799,warlock,affliction,54,22,32
Jlcreverso,eredar,1789,warlock,affliction,58,29,29
Гивмисоул,soulflayer,1784,warlock,affliction,71,40,31
Ragdoll,twisting-nether,1783,warlock,affliction,69,39,30
Sweetlõck,ravencrest,1783,warlock,affliction,317,168,149
Kitingguru,stormscale,1782,warlock,affliction,42,21,21
Bankstair,stormscale,1779,warlock,affliction,111,61,50
Xfz,stormscale,1778,warlock,affliction,162,85,77
Gezer,tarren-mill,1778,warlock,affliction,152,77,75
Korander,argent-dawn,1776,warlock,affliction,51,30,21
ßualock,sylvanas,1767,warlock,affliction,47,25,22
Асальвэйд,gordunni,1760,warlock,affliction,124,71,53
Oldboy,auchindoun,1758,warlock,affliction,201,105,96
Jïñ,ravencrest,1757,warlock,affliction,30,20,10
Sakkrethxd,hyjal,1757,warlock,affliction,35,19,16
Wällaar,ragnaros,1757,warlock,affliction,68,33,35
Graveflesh,burning-blade,1756,warlock,affliction,340,170,170
Marcoil,kazzak,1751,warlock,affliction,68,40,28
Fredé,outland,1743,warlock,affliction,36,23,13
Firochek,ravencrest,1743,warlock,affliction,42,25,17
Garebigger,blackrock,1741,warlock,affliction,295,139,156
Влицотьмой,gordunni,1739,warlock,affliction,67,39,28
Purplemafia,burning-blade,1734,warlock,affliction,58,29,29
Nightìngale,silvermoon,1733,warlock,affliction,152,79,73
Fearing,malganis,1730,warlock,affliction,66,36,30
Watchmecut,terenas,1725,warlock,affliction,45,27,18
Zodiiacc,ravencrest,1723,warlock,affliction,66,32,34
Balding,blackhand,1719,warlock,affliction,46,28,18
Глумливый,howling-fjord,1718,warlock,affliction,140,67,73
Baz,anubarak,1717,warlock,affliction,56,24,32
Funcky,terokkar,1712,warlock,affliction,54,36,18
Emreys,argent-dawn,1708,warlock,affliction,163,87,76
Архкингсдум,galakrond,1702,warlock,affliction,108,52,56
Ммоохх,gordunni,1702,warlock,affliction,42,18,24
Wallirik,kazzak,1697,warlock,affliction,35,22,13
Ghachi,draenor,1693,warlock,affliction,137,76,61
Neoe,stormscale,1693,warlock,affliction,258,129,129
Shyleen,argent-dawn,1687,warlock,affliction,30,18,12
Gremmus,outland,1684,warlock,affliction,35,19,16
Рауваскх,howling-fjord,1681,warlock,affliction,48,28,20
Fear,auchindoun,1676,warlock,affliction,41,22,19
Requeims,outland,1676,warlock,affliction,34,18,16
Robertóó,burning-legion,1673,warlock,affliction,101,54,47
Apathia,stormscale,1671,warlock,affliction,42,24,18
Rias,ragnaros,1671,warlock,affliction,63,27,36
Mowxll,blackrock,1670,warlock,affliction,42,19,23
Vîmø,antonidas,1669,warlock,affliction,118,64,54
Dededot,ysondre,1669,warlock,affliction,44,22,22
Brainsoup,burning-blade,1668,warlock,affliction,150,78,72
Hellseven,emeriss,1666,warlock,affliction,51,24,27
Нэрфир,soulflayer,1662,warlock,affliction,122,65,57
Darkwìngduck,ravencrest,1661,warlock,affliction,30,19,11
Дестроварлок,blackscar,1661,warlock,affliction,36,21,15
Lurkkis,ravencrest,1661,warlock,affliction,47,22,25
Trâshxd,sanguino,1660,warlock,affliction,84,49,35
Htaedfo,tarren-mill,1660,warlock,affliction,99,56,43
Bulgyeøng,archimonde,1659,warlock,affliction,41,27,14
Сентимент,gordunni,1656,warlock,affliction,138,73,65
Modernmisery,kazzak,1656,warlock,affliction,309,158,151
Shannzo,stormscale,1651,warlock,affliction,36,19,17
Helventti,sylvanas,1651,warlock,affliction,40,21,19
Decayez,thrall,1651,warlock,affliction,42,19,23
Pinacholadá,norgannon,1648,warlock,affliction,126,71,55
Khoug,blackmoore,1647,warlock,affliction,36,24,12
Nekrosd,tarren-mill,1646,warlock,affliction,84,46,38
Yamadea,stormscale,1646,warlock,affliction,42,22,20
Jaines,forscherliga,1643,warlock,affliction,47,29,18
Sïeur,archimonde,1643,warlock,affliction,56,32,24
Навидд,howling-fjord,1641,warlock,affliction,119,66,53
Phenolock,blackhand,1634,warlock,affliction,238,132,106
Сайденас,gordunni,1634,warlock,affliction,157,80,77
Сзот,howling-fjord,1632,warlock,affliction,60,32,28
Nerfwarriors,stormscale,1628,warlock,affliction,53,37,16
Laoganma,outland,1627,warlock,affliction,236,122,114
Ketzu,hyjal,1626,warlock,affliction,118,59,59
Midgetlockx,ravencrest,1625,warlock,affliction,42,24,18
Itiswhatitis,ravencrest,1624,warlock,affliction,42,20,22
Slàsh,hyjal,1623,warlock,affliction,120,70,50
Likee,eredar,1623,warlock,affliction,48,22,26
Mangolicious,twisting-nether,1622,warlock,affliction,42,23,19
Termss,ravencrest,1622,warlock,affliction,397,204,193
Prelest,arathor,1620,warlock,affliction,24,17,7
Bossmanluke,defias-brotherhood,1617,warlock,affliction,42,26,16
Gayskyline,blackrock,1617,warlock,affliction,48,23,25
Corbbolt,drakthul,1616,warlock,affliction,74,40,34
Ashhlock,silvermoon,1613,warlock,affliction,42,24,18
Zeinth,sanguino,1612,warlock,affliction,102,54,48
Оксси,fordragon,1612,warlock,affliction,114,59,55
Nate,stormscale,1610,warlock,affliction,111,61,50
Mortvivants,kirin-tor,1610,warlock,affliction,79,43,36
Rottndot,stormscale,1609,warlock,affliction,114,61,53
Млечный,blackscar,1608,warlock,affliction,90,53,37
Orsoyopoyo,nemesis,1607,warlock,affliction,30,20,10
Mîná,ravencrest,1607,warlock,affliction,51,30,21
Lockwkrok,burning-legion,1607,warlock,affliction,325,170,155
Apokalyps,eldrethalas,1607,warlock,affliction,678,352,326
Gate,blackrock,1606,warlock,affliction,41,20,21
Franta,chromaggus,1603,warlock,affliction,71,43,28
Dondot,frostmane,1602,warlock,affliction,90,50,40
Журанайсбой,blackscar,1598,warlock,affliction,30,21,9
Boglock,argent-dawn,1598,warlock,affliction,78,40,38
Dontargetme,draenor,1596,warlock,affliction,49,30,19
Shayexen,tarren-mill,1596,warlock,affliction,53,31,22
Methroz,burning-legion,1592,warlock,affliction,60,28,32
Дакиса,gordunni,1592,warlock,affliction,101,45,56
Olympïe,archimonde,1591,warlock,affliction,77,36,41
Dispellthat,burning-legion,1588,warlock,affliction,41,22,19
Vizour,tarren-mill,1585,warlock,affliction,42,19,23
Soezzlock,archimonde,1584,warlock,affliction,182,99,83
Мокито,grom,1581,warlock,affliction,42,20,22
Yokujîn,twisting-nether,1580,warlock,affliction,36,18,18
Drainsouls,stormscale,1579,warlock,affliction,84,45,39
Олимта,blackscar,1579,warlock,affliction,166,85,81
Жасминдос,blackscar,1578,warlock,affliction,40,19,21
Ремайка,gordunni,1577,warlock,affliction,146,73,73
Articfox,outland,1574,warlock,affliction,78,41,37
Nhw,archimonde,1572,warlock,affliction,136,79,57
Yôi,nemesis,1568,warlock,affliction,94,52,42
Exorbïtant,blackrock,1567,warlock,affliction,186,97,89
Passwoord,kazzak,1566,warlock,affliction,30,21,9
Прогнившая,blackscar,1566,warlock,affliction,206,114,92
Prestige,nemesis,1564,warlock,affliction,40,20,20
Бауглирх,howling-fjord,1560,warlock,affliction,77,39,38
Warlockoloco,blackmoore,1559,warlock,affliction,47,25,22
Smøkê,tarren-mill,1556,warlock,affliction,476,248,228
Ascètic,kazzak,1556,warlock,affliction,95,49,46
Trevium,nemesis,1555,warlock,affliction,76,43,33
Slf,the-maelstrom,1554,warlock,affliction,62,38,24
Raspalakuja,kazzak,1553,warlock,affliction,31,19,12
Сартеккс,gordunni,1552,warlock,affliction,149,85,64
Lollock,teldrassil,1549,warlock,affliction,24,17,7
Незерлок,soulflayer,1544,warlock,affliction,36,23,13
Stromzii,silvermoon,1544,warlock,affliction,91,51,40
Getfeared,stormscale,1544,warlock,affliction,106,53,53
Axapnon,ragnaros,1543,warlock,affliction,280,142,138
Infectius,kazzak,1542,warlock,affliction,115,63,52
Rottenbooty,argent-dawn,1541,warlock,affliction,65,35,30
Demonkïng,archimonde,1539,warlock,affliction,137,64,73
Acentro,stormscale,1538,warlock,affliction,63,35,28
Lánfeár,draenor,1537,warlock,affliction,697,354,343
Belíos,stormscale,1536,warlock,affliction,105,60,45
Krismer,silvermoon,1535,warlock,affliction,43,23,20
Lokic,draenor,1534,warlock,affliction,102,53,49
Osyx,ravencrest,1534,warlock,affliction,36,16,20
Zetsubo,drakthul,1533,warlock,affliction,147,80,67
Бжк,gordunni,1532,warlock,affliction,67,33,34
Ánderxyo,dun-modr,1531,warlock,affliction,24,16,8
Soffie,blackrock,1531,warlock,affliction,60,30,30
Kayako,kul-tiras,1529,warlock,affliction,74,32,42
Heavylock,sylvanas,1527,warlock,affliction,30,19,11
Twnia,the-maelstrom,1524,warlock,affliction,59,39,20
Кокобан,howling-fjord,1524,warlock,affliction,42,17,25
Tôpsecret,aegwynn,1522,warlock,affliction,30,16,14
Grimus,azuremyst,1522,warlock,affliction,102,51,51
Разъелвал,blackscar,1518,warlock,affliction,223,123,100
Nightsnake,deathwing,1516,warlock,affliction,114,50,64
Höfmänn,kazzak,1514,warlock,affliction,42,27,15
Крэдоу,soulflayer,1514,warlock,affliction,54,27,27
Waatschnbaam,eredar,1512,warlock,affliction,66,30,36
Zevil,emerald-dream,1509,warlock,affliction,78,42,36
Винстролман,blackscar,1507,warlock,affliction,162,93,69
Soulslugger,twisting-nether,1506,warlock,affliction,48,23,25
Katâra,tarren-mill,1505,warlock,affliction,80,36,44
Bowti,ravencrest,1504,warlock,affliction,66,27,39
Jumbodot,tarren-mill,1502,warlock,affliction,36,17,19
Ðemðnia,antonidas,1498,warlock,affliction,24,20,4
Marklock,drakthul,1497,warlock,affliction,96,58,38
Berkobaggins,ravencrest,1496,warlock,affliction,72,34,38
Бенлоел,borean-tundra,1493,warlock,affliction,60,29,31
Drekkrog,chogall,1490,warlock,affliction,30,16,14
Candyman,bronze-dragonflight,1490,warlock,affliction,300,151,149
Боризыч,gordunni,1487,warlock,affliction,125,67,58
Lockíe,twisting-nether,1486,warlock,affliction,59,31,28
Tøpdmg,die-aldor,1486,warlock,affliction,47,24,23
Белучи,howling-fjord,1485,warlock,affliction,36,24,12
Itsfiftycent,outland,1482,warlock,affliction,114,65,49
Муза,gordunni,1481,warlock,affliction,60,28,32
Damira,blackmoore,1478,warlock,affliction,36,23,13
Sánas,blackhand,1478,warlock,affliction,102,57,45
Brútality,nethersturm,1478,warlock,affliction,95,48,47
Априфф,soulflayer,1477,warlock,affliction,36,16,20
Kasuni,sanguino,1475,warlock,affliction,89,52,37
Saraconnor,burning-legion,1475,warlock,affliction,78,43,35
Лысыйлокоть,soulflayer,1475,warlock,affliction,36,18,18
Mty,bronze-dragonflight,1475,warlock,affliction,105,51,54
Адоха,howling-fjord,1474,warlock,affliction,47,25,22
Drozhna,kaelthas,1473,warlock,affliction,54,27,27
Валлцея,galakrond,1471,warlock,affliction,36,22,14
Soldmygranny,kazzak,1471,warlock,affliction,66,32,34
Локбезног,soulflayer,1468,warlock,affliction,84,42,42
Spiritawayx,lightbringer,1467,warlock,affliction,24,18,6
Dersdog,twisting-nether,1467,warlock,affliction,23,16,7
Xakhmet,hellscream,1466,warlock,affliction,234,125,109
Birimbau,outland,1465,warlock,affliction,51,27,24
Lickyicky,twisting-nether,1465,warlock,affliction,78,39,39
Shaarak,blackrock,1464,warlock,affliction,69,33,36
Taýle,ravencrest,1463,warlock,affliction,24,16,8
Deathfløw,draenor,1462,warlock,affliction,30,16,14
Ржоммба,soulflayer,1460,warlock,affliction,154,77,77
Нешутисвуду,blackscar,1459,warlock,affliction,64,29,35
Feardinkum,twisting-nether,1458,warlock,affliction,30,17,13
Brustlino,nemesis,1458,warlock,affliction,36,20,16
Maidson,blackrock,1458,warlock,affliction,44,22,22
Sanghá,frostwolf,1456,warlock,affliction,126,76,50
Gneticz,aegwynn,1456,warlock,affliction,60,30,30
Felsturm,twisting-nether,1453,warlock,affliction,76,47,29
Depresive,aggra-português,1453,warlock,affliction,314,164,150
Floron,silvermoon,1453,warlock,affliction,127,63,64
Zakuri,blackmoore,1452,warlock,affliction,48,32,16
Omnath,alakir,1449,warlock,affliction,36,18,18
Müdür,burning-legion,1448,warlock,affliction,239,128,111
Wezen,stormscale,1446,warlock,affliction,140,73,67
Vladov,ravencrest,1443,warlock,affliction,54,31,23
Колдунишка,fordragon,1443,warlock,affliction,431,229,202
Lockyy,karazhan,1441,warlock,affliction,71,41,30
Domdon,stormscale,1440,warlock,affliction,26,16,10
Azurma,tarren-mill,1439,warlock,affliction,24,15,9
Hivxherpes,ravencrest,1439,warlock,affliction,127,60,67
Датри,grom,1437,warlock,affliction,124,69,55
Гуслин,soulflayer,1437,warlock,affliction,183,98,85
Shanyor,kazzak,1436,warlock,affliction,93,50,43
Dracsu,dun-modr,1436,warlock,affliction,160,82,78
Kakiamagisa,twisting-nether,1433,warlock,affliction,58,38,20
Azastarax,archimonde,1432,warlock,affliction,114,54,60
Warlokk,tarren-mill,1430,warlock,affliction,163,86,77
Rune,aegwynn,1430,warlock,affliction,30,15,15
Дотдозор,howling-fjord,1429,warlock,affliction,154,76,78
Zèlêph,archimonde,1428,warlock,affliction,42,26,16
Filianore,azjolnerub,1427,warlock,affliction,60,35,25
Ebolara,aegwynn,1427,warlock,affliction,47,23,24
Çüñ,shattered-hand,1426,warlock,affliction,48,24,24
Нафлэпил,gordunni,1425,warlock,affliction,59,32,27
Miazmii,ragnaros,1422,warlock,affliction,24,15,9
Mundunugu,sanguino,1422,warlock,affliction,30,15,15
Inani,ragnaros,1420,warlock,affliction,60,31,29
Avoidsun,kazzak,1418,warlock,affliction,42,20,22
Бонони,blackscar,1417,warlock,affliction,42,19,23
Bigdamndots,twisting-nether,1417,warlock,affliction,42,16,26
Demonologyz,ravencrest,1416,warlock,affliction,24,19,5
Gódríg,sylvanas,1414,warlock,affliction,87,52,35
Lilofee,anetheron,1414,warlock,affliction,48,21,27
Werkx,archimonde,1414,warlock,affliction,36,15,21
Talt,dalaran,1412,warlock,affliction,110,61,49
Titoss,archimonde,1411,warlock,affliction,120,60,60
Prekt,ragnaros,1409,warlock,affliction,29,18,11
Degdeehei,draenor,1407,warlock,affliction,94,51,43
Лейссина,eversong,1406,warlock,affliction,183,92,91
Girgol,draenor,1405,warlock,affliction,42,15,27
Томрэдл,howling-fjord,1404,warlock,affliction,461,239,222
Dondada,aggra-português,1404,warlock,affliction,102,52,50
Kyyuss,burning-legion,1403,warlock,affliction,60,25,35
Tarilinwelli,les-sentinelles,1401,warlock,affliction,116,65,51
Vicktorious,stormscale,1401,warlock,affliction,194,101,93
Cringetamer,silvermoon,1401,warlock,affliction,48,20,28
Bemelial,culte-de-la-rive-noire,1400,warlock,affliction,30,15,15
Cazzo,burning-blade,1399,warlock,affliction,186,91,95
Flyps,stormscale,1399,warlock,affliction,47,22,25
Vivek,grim-batol,1398,warlock,affliction,208,99,109
Enviroq,burning-legion,1398,warlock,affliction,42,19,23
Dannyel,mazrigos,1397,warlock,affliction,489,247,242
Шизуи,borean-tundra,1395,warlock,affliction,103,58,45
Potterhotter,outland,1394,warlock,affliction,174,87,87
Zeotrixie,stormscale,1393,warlock,affliction,78,40,38
Trythislock,crushridge,1392,warlock,affliction,59,32,27
Sluba,stormscale,1391,warlock,affliction,54,36,18
Murphloc,silvermoon,1391,warlock,affliction,84,41,43
Øprøx,sanguino,1389,warlock,affliction,23,16,7
Véstheim,saurfang,1388,warlock,affliction,56,34,22
Murua,silvermoon,1387,warlock,affliction,30,15,15
Harrydôtta,blackmoore,1382,warlock,affliction,42,23,19
Deathcoîl,the-maelstrom,1381,warlock,affliction,23,15,8
Hatenkou,silvermoon,1379,warlock,affliction,89,49,40
Пухи,blackscar,1379,warlock,affliction,48,20,28
Gaminex,kazzak,1378,warlock,affliction,165,81,84
Necronomicon,illidan,1378,warlock,affliction,72,34,38
Zêngâ,kazzak,1377,warlock,affliction,72,36,36
Kavalierr,stormscale,1377,warlock,affliction,70,35,35
Teddyruineur,khaz-modan,1376,warlock,affliction,42,25,17
Pokifanone,tarren-mill,1376,warlock,affliction,29,16,13
Mazaear,stormscale,1373,warlock,affliction,100,51,49
Киёкка,howling-fjord,1372,warlock,affliction,114,62,52
Cârmondai,alleria,1371,warlock,affliction,55,19,36
Sadisticlól,burning-legion,1369,warlock,affliction,35,17,18
Tiwtera,draenor,1366,warlock,affliction,72,35,37
Císuh,stormreaver,1365,warlock,affliction,36,15,21
Pruegelharry,blackrock,1362,warlock,affliction,43,18,25
Nàughty,ragnaros,1361,warlock,affliction,101,53,48
Бестий,fordragon,1361,warlock,affliction,62,30,32
Dezznut,blackhand,1360,warlock,affliction,119,58,61
Vîerdotcom,blackrock,1359,warlock,affliction,24,18,6
Xanatas,nemesis,1359,warlock,affliction,48,25,23
Cadrega,nemesis,1357,warlock,affliction,58,37,21
Darkwootex,draenor,1357,warlock,affliction,39,23,16
Nîghtmare,outland,1353,warlock,affliction,35,20,15
Hòbó,outland,1353,warlock,affliction,51,28,23
Kemel,thrall,1353,warlock,affliction,42,23,19
Akdan,ragnaros,1351,warlock,affliction,50,21,29
Dailylock,kazzak,1349,warlock,affliction,32,15,17
Elmstreet,gilneas,1346,warlock,affliction,48,31,17
Dropxpvp,blackrock,1346,warlock,affliction,95,45,50
Skräp,twisting-nether,1346,warlock,affliction,73,30,43
Demonoulis,bloodhoof,1345,warlock,affliction,40,25,15
Roglash,eredar,1345,warlock,affliction,182,97,85
Hathatchi,sylvanas,1343,warlock,affliction,52,29,23
Øzze,ysondre,1343,warlock,affliction,181,97,84
Rudikiaz,sanguino,1343,warlock,affliction,36,14,22
Jegfaller,wildhammer,1341,warlock,affliction,102,53,49
Whaii,ravencrest,1339,warlock,affliction,24,14,10
Anabolicbaby,draenor,1339,warlock,affliction,27,15,12
Fyxs,talnivarr,1336,warlock,affliction,24,14,10
Gryme,dalaran,1333,warlock,affliction,72,30,42
Kharless,kazzak,1331,warlock,affliction,29,15,14
Eltharis,burning-legion,1331,warlock,affliction,30,14,16
Mayline,kult-der-verdammten,1330,warlock,affliction,42,23,19
Weedmaniac,kazzak,1329,warlock,affliction,138,67,71
Bh,ragnaros,1327,warlock,affliction,24,14,10
Staenkymayne,blackhand,1326,warlock,affliction,24,14,10
Gash,malganis,1323,warlock,affliction,174,88,86
Délidumrul,stormscale,1322,warlock,affliction,46,27,19
Ginnwick,argent-dawn,1321,warlock,affliction,18,14,4
Morgan,jaedenar,1320,warlock,affliction,144,84,60
Cgane,archimonde,1317,warlock,affliction,34,20,14
Primdåhl,ravencrest,1314,warlock,affliction,76,39,37
Themits,executus,1314,warlock,affliction,34,15,19
Dotieks,draenor,1313,warlock,affliction,126,67,59
Balgo,blackmoore,1312,warlock,affliction,60,30,30
Перегном,blackscar,1311,warlock,affliction,60,28,32
Hiimsûso,dun-modr,1309,warlock,affliction,113,59,54
Ketem,zuljin,1308,warlock,affliction,167,86,81
Azkarr,defias-brotherhood,1308,warlock,affliction,30,14,16
Ukicha,burning-blade,1307,warlock,affliction,89,44,45
Nesveti,kazzak,1305,warlock,affliction,29,20,9
Irnx,tarren-mill,1303,warlock,affliction,68,36,32
Pcbbwarlock,sylvanas,1302,warlock,affliction,198,106,92
Nihale,arakarahm,1301,warlock,affliction,106,50,56
Dxz,silvermoon,1300,warlock,affliction,36,14,22
Krombo,kazzak,1299,warlock,affliction,28,15,13
Hacklock,silvermoon,1299,warlock,affliction,169,86,83
Urssul,kazzak,1298,warlock,affliction,36,22,14
Swagzz,silvermoon,1298,warlock,affliction,96,55,41
Sublînê,blackmoore,1298,warlock,affliction,92,39,53
Scaevóla,ravencrest,1297,warlock,affliction,42,24,18
Morganounete,archimonde,1296,warlock,affliction,58,21,37
Ogkenii,ragnaros,1295,warlock,affliction,54,26,28
Bästkusten,kazzak,1294,warlock,affliction,28,16,12
Grimréaper,outland,1288,warlock,affliction,42,19,23
Tathyanna,archimonde,1287,warlock,affliction,26,15,11
Лютыйглад,blackscar,1284,warlock,affliction,69,32,37
Sleethy,destromath,1283,warlock,affliction,48,24,24
Моргррет,soulflayer,1282,warlock,affliction,48,28,20
Blackmagic,stormscale,1282,warlock,affliction,372,194,178
Robodot,eredar,1277,warlock,affliction,90,45,45
Izyguldamn,blackmoore,1276,warlock,affliction,48,16,32
Tsumde,dalaran,1275,warlock,affliction,85,40,45
Мужицкаясила,howling-fjord,1271,warlock,affliction,72,29,43
Zelhala,draenor,1270,warlock,affliction,36,16,20
Drestek,uldum,1268,warlock,affliction,72,34,38
Assuz,eredar,1267,warlock,affliction,86,42,44
Äsmødée,dalaran,1264,warlock,affliction,204,96,108
Стафилокок,deepholm,1262,warlock,affliction,55,29,26
Whocarezlock,stormscale,1260,warlock,affliction,32,15,17
Qena,outland,1259,warlock,affliction,54,26,28
Mooncrásh,blackrock,1256,warlock,affliction,162,80,82
Androxus,eredar,1255,warlock,affliction,25,14,11
Soultire,ravencrest,1255,warlock,affliction,102,48,54
Demoas,antonidas,1253,warlock,affliction,32,15,17
Nicetime,nefarian,1250,warlock,affliction,90,51,39
Kerway,outland,1249,warlock,affliction,24,14,10
Miauwu,stormscale,1247,warlock,affliction,18,13,5
Ðïÿëñbïëñfüû,suramar,1246,warlock,affliction,30,13,17
Deathpoid,draenor,1245,warlock,affliction,71,28,43
Дагира,booty-bay,1241,warlock,affliction,18,13,5
Purplehasse,draenor,1241,warlock,affliction,82,35,47
Mjabowf,outland,1240,warlock,affliction,24,13,11
Satanizm,silvermoon,1240,warlock,affliction,69,32,37
Hèrmit,kazzak,1239,warlock,affliction,74,45,29
Phelola,sylvanas,1239,warlock,affliction,110,52,58
Actelia,the-venture-co,1237,warlock,affliction,38,15,23
Тафуби,deathweaver,1234,warlock,affliction,30,18,12
Yowifeinmedm,draenor,1234,warlock,affliction,36,13,23
Варатах,grom,1233,warlock,affliction,90,43,47
Hitomitanaká,kazzak,1233,warlock,affliction,34,13,21
Whaine,kult-der-verdammten,1231,warlock,affliction,29,16,13
Elleanor,los-errantes,1231,warlock,affliction,24,13,11
Ainos,twisting-nether,1230,warlock,affliction,127,64,63
Shakuroz,frostwolf,1229,warlock,affliction,28,14,14
Mæphysto,blackrock,1227,warlock,affliction,163,85,78
Modéus,ysondre,1225,warlock,affliction,100,52,48
Ностра,gordunni,1223,warlock,affliction,32,22,10
Malagate,sylvanas,1221,warlock,affliction,66,30,36
Ongo,frostwolf,1220,warlock,affliction,30,13,17
Zéphon,blades-edge,1219,warlock,affliction,24,13,11
Klone,die-todeskrallen,1218,warlock,affliction,115,58,57
Yahata,nethersturm,1217,warlock,affliction,78,45,33
Bono,frostwhisper,1215,warlock,affliction,24,13,11
Bakal,vashj,1215,warlock,affliction,42,19,23
Локистраик,borean-tundra,1214,warlock,affliction,47,19,28
Sesshouin,alakir,1212,warlock,affliction,72,34,38
Náwwk,blackmoore,1210,warlock,affliction,24,13,11
Solitariøus,arathi,1207,warlock,affliction,90,44,46
Mephísto,kilrogg,1206,warlock,affliction,42,16,26
Xerxia,blackrock,1205,warlock,affliction,42,25,17
Agonux,twisting-nether,1205,warlock,affliction,67,37,30
Diseez,bronzebeard,1205,warlock,affliction,51,25,26
Etsanctum,blackmoore,1204,warlock,affliction,48,17,31
Friendlylock,quelthalas,1198,warlock,affliction,21,13,8
Tøtøf,sargeras,1196,warlock,affliction,21,13,8
Âkâl,ravencrest,1194,warlock,affliction,23,13,10
Kyiüû,archimonde,1194,warlock,affliction,27,14,13
Vaukras,stormscale,1194,warlock,affliction,74,35,39
Voost,aegwynn,1194,warlock,affliction,51,18,33
Toryon,archimonde,1191,warlock,affliction,40,14,26
Møärdötd,aggra-português,1190,warlock,affliction,30,13,17
Solomohn,steamwheedle-cartel,1189,warlock,affliction,30,14,16
Luzi,arthas,1186,warlock,affliction,59,27,32
Gulgash,blackrock,1183,warlock,affliction,24,13,11
Lockinasock,stormscale,1183,warlock,affliction,31,16,15
Juod,frostmane,1182,warlock,affliction,24,15,9
Глянемче,deathguard,1182,warlock,affliction,75,43,32
Nexyra,silvermoon,1182,warlock,affliction,218,106,112
Dhraven,thrall,1179,warlock,affliction,105,51,54
Kerthan,malorne,1176,warlock,affliction,80,35,45
Warlockgødx,silvermoon,1173,warlock,affliction,40,20,20
Wedlock,stormscale,1171,warlock,affliction,29,19,10
Huaian,darksorrow,1170,warlock,affliction,56,26,30
Цзинкэ,gordunni,1168,warlock,affliction,24,13,11
Draklack,turalyon,1166,warlock,affliction,103,51,52
Purenutz,twisting-nether,1165,warlock,affliction,24,13,11
Neyó,teldrassil,1164,warlock,affliction,30,17,13
Sulvar,draenor,1164,warlock,affliction,78,38,40
Ашимал,soulflayer,1158,warlock,affliction,62,28,34
Xristianos,ravencrest,1152,warlock,affliction,18,12,6
Faermorn,kazzak,1151,warlock,affliction,18,12,6
Toppluva,shattered-hand,1151,warlock,affliction,21,13,8
Fealer,magtheridon,1151,warlock,affliction,336,172,164
Kumamoto,tarren-mill,1151,warlock,affliction,24,12,12
Xskyrov,blackmoore,1151,warlock,affliction,24,12,12
Stankaemayne,blackhand,1150,warlock,affliction,18,12,6
Lockimon,silvermoon,1150,warlock,affliction,21,13,8
Thereya,dun-morogh,1150,warlock,affliction,24,12,12
Darkrorr,drakthul,1150,warlock,affliction,24,12,12
Cdztuwu,outland,1147,warlock,affliction,18,12,6
Walchia,kazzak,1147,warlock,affliction,83,44,39
Lockingcute,tarren-mill,1147,warlock,affliction,24,12,12
Lipstickx,kul-tiras,1147,warlock,affliction,36,12,24
Nydek,cthun,1146,warlock,affliction,69,32,37
Trinox,teldrassil,1144,warlock,affliction,24,15,9
Cutt,chogall,1144,warlock,affliction,89,46,43
ßatt,dalaran,1143,warlock,affliction,34,21,13
Scheele,twisting-nether,1143,warlock,affliction,32,13,19
Enyras,nemesis,1143,warlock,affliction,30,12,18
Auxi,the-maelstrom,1142,warlock,affliction,57,35,22
Yasa,khaz-modan,1142,warlock,affliction,51,31,20
Squadala,kaelthas,1142,warlock,affliction,42,22,20
Suskive,kaelthas,1141,warlock,affliction,24,12,12
Самантаглу,blackscar,1140,warlock,affliction,82,41,41
Öxygen,outland,1140,warlock,affliction,24,12,12
Ìzanamí,archimonde,1139,warlock,affliction,18,12,6
Asmonmald,stormscale,1139,warlock,affliction,120,52,68
Arelas,dragonblight,1139,warlock,affliction,30,12,18
Bobleechaos,darkspear,1136,warlock,affliction,42,17,25
Eveline,onyxia,1136,warlock,affliction,34,13,21
Банкапевка,howling-fjord,1133,warlock,affliction,30,13,17
Clungesuck,argent-dawn,1132,warlock,affliction,24,12,12
Lonepath,doomhammer,1129,warlock,affliction,25,15,10
Slowfatlock,ravencrest,1129,warlock,affliction,47,20,27
Zukau,argent-dawn,1129,warlock,affliction,46,15,31
Xjms,darksorrow,1127,warlock,affliction,37,16,21
Identîty,ravencrest,1127,warlock,affliction,40,16,24
Mendozaah,kazzak,1122,warlock,affliction,88,35,53
Noobgg,kazzak,1118,warlock,affliction,22,13,9
Toké,blackmoore,1116,warlock,affliction,52,24,28
Principle,dunemaul,1114,warlock,affliction,89,53,36
Mjojo,khaz-modan,1110,warlock,affliction,34,17,17
Priszcilla,twisting-nether,1108,warlock,affliction,31,18,13
Битриксс,soulflayer,1106,warlock,affliction,77,33,44
Wintheirl,argent-dawn,1105,warlock,affliction,35,15,20
Gamunkul,destromath,1101,warlock,affliction,109,44,65
Sunetta,silvermoon,1097,warlock,affliction,80,37,43
Diablotiin,hyjal,1095,warlock,affliction,48,20,28
Cahoa,archimonde,1093,warlock,affliction,39,17,22
Горенджо,eversong,1092,warlock,affliction,26,13,13
Brryant,colinas-pardas,1090,warlock,affliction,37,25,12
Dótcom,draenor,1089,warlock,affliction,102,51,51
Fraky,frostwhisper,1087,warlock,affliction,23,16,7
Zxcursed,doomhammer,1087,warlock,affliction,23,12,11
Diegomojes,silvermoon,1081,warlock,affliction,110,59,51
Dotfearcom,blackrock,1077,warlock,affliction,63,26,37
Lefttorot,garrosh,1077,warlock,affliction,33,13,20
Iyanda,argent-dawn,1074,warlock,affliction,24,12,12
Аксиманд,howling-fjord,1073,warlock,affliction,47,23,24
Ladodida,darkspear,1072,warlock,affliction,53,28,25
Хефрак,deathguard,1069,warlock,affliction,107,43,64
Hazelock,draenor,1068,warlock,affliction,17,12,5
Felboar,quelthalas,1068,warlock,affliction,44,24,20
Díme,kazzak,1068,warlock,affliction,64,29,35
Bësly,khaz-modan,1067,warlock,affliction,26,16,10
Venoc,kazzak,1067,warlock,affliction,150,77,73
Rhyana,sylvanas,1065,warlock,affliction,28,12,16
Pipêz,blackmoore,1060,warlock,affliction,34,12,22
Smuutil,drakthul,1058,warlock,affliction,55,28,27
Lökjävel,twisting-nether,1058,warlock,affliction,34,16,18
Elmîr,blackmoore,1057,warlock,affliction,36,13,23
Skufi,uldum,1056,warlock,affliction,57,29,28
Fräddan,draenor,1054,warlock,affliction,12,11,1
Coilxo,ravencrest,1054,warlock,affliction,30,11,19
Beleghost,sylvanas,1054,warlock,affliction,30,11,19
Dabolt,archimonde,1053,warlock,affliction,18,11,7
Mariahscary,auchindoun,1053,warlock,affliction,18,11,7
Belastiz,blackmoore,1052,warlock,affliction,18,11,7
Snackstickz,twisting-nether,1051,warlock,affliction,18,11,7
Exørzist,blackmoore,1051,warlock,affliction,124,66,58
Mykóla,terokkar,1051,warlock,affliction,24,11,13
Zatella,ravencrest,1050,warlock,affliction,24,11,13
Lubosz,silvermoon,1049,warlock,affliction,18,11,7
Korlox,antonidas,1047,warlock,affliction,54,30,24
Hodille,argent-dawn,1046,warlock,affliction,18,11,7
Vahgaz,burning-legion,1046,warlock,affliction,166,82,84
Lemuriel,arthas,1046,warlock,affliction,77,37,40
Richrichy,outland,1044,warlock,affliction,66,34,32
Wildo,grim-batol,1044,warlock,affliction,30,13,17
Mannennille,eonar,1043,warlock,affliction,24,11,13
Araphel,twisting-nether,1042,warlock,affliction,78,38,40
Letor,sanguino,1041,warlock,affliction,27,12,15
Blaizen,outland,1038,warlock,affliction,22,12,10
Backblech,wrathbringer,1038,warlock,affliction,33,15,18
Idcboutmeta,draenor,1035,warlock,affliction,23,11,12
Демонтёлка,grom,1034,warlock,affliction,26,16,10
Nerdbane,blackrock,1033,warlock,affliction,18,11,7
Selenene,norgannon,1031,warlock,affliction,63,31,32
Xlara,argent-dawn,1031,warlock,affliction,184,90,94
Шайтанарба,blackscar,1027,warlock,affliction,77,42,35
Favris,antonidas,1024,warlock,affliction,170,85,85
Мракодел,deathguard,1023,warlock,affliction,39,19,20
Oonz,sylvanas,1017,warlock,affliction,74,37,37
Сувала,soulflayer,1015,warlock,affliction,104,52,52
Олдриг,ashenvale,1013,warlock,affliction,39,18,21
Санявахтовик,blackscar,1006,warlock,affliction,21,11,10
Cokoladuocka,silvermoon,1005,warlock,affliction,72,30,42
Тэйлок,gordunni,1003,warlock,affliction,45,26,19
Vendømlørd,archimonde,1003,warlock,affliction,31,17,14
Sovrìn,blackrock,1002,warlock,affliction,23,11,12
Loriene,trollbane,1001,warlock,affliction,41,16,25
Brítneyfears,azjolnerub,986,warlock,affliction,17,11,6
Bluenote,colinas-pardas,985,warlock,affliction,63,31,32
Bu,zirkel-des-cenarius,982,warlock,affliction,17,11,6
Qullnius,kazzak,971,warlock,affliction,34,12,22
Hôköno,archimonde,970,warlock,affliction,36,17,19
Exoticaa,blackhand,968,warlock,affliction,48,27,21
Lacruum,ragnaros,963,warlock,affliction,29,12,17
Peonpedro,malganis,960,warlock,affliction,12,10,2
Pumpfake,ravencrest,960,warlock,affliction,18,10,8
Slipx,aegwynn,960,warlock,affliction,18,10,8
Murdee,kazzak,960,warlock,affliction,18,10,8
Dreamnyâsha,tarren-mill,960,warlock,affliction,18,10,8
Веномхх,lich-king,959,warlock,affliction,12,10,2
Plâytïmè,stormscale,959,warlock,affliction,18,10,8
Hannen,blackrock,959,warlock,affliction,24,10,14
Nineinchlock,silvermoon,959,warlock,affliction,24,10,14
Drstyx,anetheron,959,warlock,affliction,30,10,20
Azaïdun,khaz-modan,958,warlock,affliction,18,10,8
Коплюнапони,blackscar,958,warlock,affliction,18,10,8
Arizyoxot,twisting-nether,957,warlock,affliction,18,10,8
Chaostrain,sylvanas,957,warlock,affliction,22,11,11
Kazyn,archimonde,957,warlock,affliction,24,10,14
Drazol,sylvanas,956,warlock,affliction,18,10,8
Снэйк,deathguard,956,warlock,affliction,18,10,8
Lúcìfér,stormscale,956,warlock,affliction,24,10,14
Dotloca,draenor,955,warlock,affliction,12,10,2
Sylrathas,burning-legion,953,warlock,affliction,24,10,14
Prickster,kazzak,952,warlock,affliction,18,10,8
Cgòw,ravencrest,950,warlock,affliction,22,11,11
Sinsemilla,kazzak,949,warlock,affliction,78,34,44
Хичхкок,gordunni,947,warlock,affliction,44,19,25
Waryald,dun-modr,945,warlock,affliction,30,10,20
Warrworg,darkmoon-faire,941,warlock,affliction,78,42,36
Cêebêry,frostwolf,941,warlock,affliction,24,10,14
Valadair,sanguino,941,warlock,affliction,30,10,20
Carlman,hyjal,940,warlock,affliction,18,10,8
Phéar,deathwing,938,warlock,affliction,18,10,8
Warlockyone,silvermoon,937,warlock,affliction,18,10,8
Darkháte,blackhand,936,warlock,affliction,18,10,8
Uthdae,archimonde,933,warlock,affliction,36,13,23
Luckriel,draenor,932,warlock,affliction,24,11,13
Adizew,kazzak,929,warlock,affliction,68,26,42
Ванадий,soulflayer,926,warlock,affliction,17,10,7
Xrathis,thunderhorn,925,warlock,affliction,22,10,12
Icritmore,stormscale,924,warlock,affliction,20,11,9
Ashgron,burning-legion,924,warlock,affliction,30,16,14
Nukeem,karazhan,923,warlock,affliction,131,62,69
Антарриэль,howling-fjord,921,warlock,affliction,28,10,18
Слававдвх,blackscar,914,warlock,affliction,59,28,31
Kenthal,nemesis,908,warlock,affliction,22,10,12
Artyrus,burning-legion,904,warlock,affliction,30,16,14
Trusting,archimonde,904,warlock,affliction,30,16,14
Letoupet,la-croisade-écarlate,904,warlock,affliction,42,21,21
Cencible,twisting-nether,893,warlock,affliction,31,14,17
Lockpup,draenor,888,warlock,affliction,40,21,19
Datendariza,kazzak,886,warlock,affliction,32,10,22
Rasputia,thunderhorn,871,warlock,affliction,57,29,28
Тапкидеда,gordunni,864,warlock,affliction,12,9,3
Abinsur,drakthul,864,warlock,affliction,12,9,3
Парачо,eversong,864,warlock,affliction,12,9,3
Zzooxx,silvermoon,864,warlock,affliction,24,9,15
Fearlólz,stormscale,863,warlock,affliction,12,9,3
Voodooskull,kazzak,863,warlock,affliction,12,9,3
Wäisted,ravencrest,863,warlock,affliction,12,9,3
Whippet,nemesis,863,warlock,affliction,12,9,3
Díablø,blackmoore,863,warlock,affliction,12,9,3
Зензирил,galakrond,863,warlock,affliction,18,9,9
Luwuock,twisting-nether,863,warlock,affliction,24,9,15
Gaargamelo,blackmoore,863,warlock,affliction,24,9,15
Skuvee,archimonde,862,warlock,affliction,18,9,9
Golhok,archimonde,862,warlock,affliction,18,9,9
Esmuel,argent-dawn,862,warlock,affliction,18,9,9
Merdotz,outland,862,warlock,affliction,18,9,9
Aagon,antonidas,862,warlock,affliction,24,9,15
Tolgaa,draenor,862,warlock,affliction,28,10,18
Ívânguldán,twisting-nether,861,warlock,affliction,12,9,3
Hooligain,aegwynn,861,warlock,affliction,62,28,34
Midnigthh,sanguino,861,warlock,affliction,27,10,17
Mumutoaster,blackrock,860,warlock,affliction,12,9,3
Graell,drakthul,860,warlock,affliction,12,9,3
Нирон,grom,860,warlock,affliction,18,9,9
Iml,grim-batol,859,warlock,affliction,28,10,18
Локомания,gordunni,859,warlock,affliction,30,9,21
Therelda,sanguino,857,warlock,affliction,18,9,9
Tedor,ysondre,856,warlock,affliction,18,9,9
Sladurana,eredar,855,warlock,affliction,96,46,50
Primitivaa,dun-modr,855,warlock,affliction,30,9,21
Pfizer,varimathras,854,warlock,affliction,18,9,9
Yourdeaath,ravencrest,854,warlock,affliction,30,9,21
Iyna,blackmoore,853,warlock,affliction,18,9,9
Noqufiel,malygos,852,warlock,affliction,24,9,15
Таракай,eversong,852,warlock,affliction,30,9,21
Alithia,sylvanas,851,warlock,affliction,12,9,3
Silurus,bloodscalp,846,warlock,affliction,24,9,15
Warlocker,anachronos,844,warlock,affliction,24,10,14
Akumako,stormscale,831,warlock,affliction,16,10,6
Shazem,tarren-mill,830,warlock,affliction,23,9,14
Parley,frostmane,825,warlock,affliction,22,9,13
Savith,defias-brotherhood,821,warlock,affliction,58,25,33
Pøzzi,hyjal,807,warlock,affliction,22,10,12
Аркейнмизери,howling-fjord,801,warlock,affliction,16,11,5
Jisera,kiljaeden,800,warlock,affliction,22,9,13
Muc,sanguino,793,warlock,affliction,23,9,14
Braneiotqq,kazzak,777,warlock,affliction,26,10,16
Чупачупакаб,soulflayer,768,warlock,affliction,12,8,4
Buâlock,stormscale,768,warlock,affliction,12,8,4
Noxtarius,thrall,768,warlock,affliction,12,8,4
Zlomozg,laughing-skull,768,warlock,affliction,12,8,4
Qoltz,twisting-nether,768,warlock,affliction,12,8,4
Zzooxxie,silvermoon,768,warlock,affliction,12,8,4
Schlopp,zenedar,768,warlock,affliction,18,8,10
Rtsnmt,alakir,768,warlock,affliction,18,8,10
Bytethisx,aggra-português,768,warlock,affliction,18,8,10
Zefirer,ravencrest,767,warlock,affliction,12,8,4
Kopfschmerz,twisting-nether,767,warlock,affliction,12,8,4
Pistone,nemesis,767,warlock,affliction,12,8,4
Bandìtten,alakir,767,warlock,affliction,12,8,4
Salemlel,sanguino,767,warlock,affliction,18,8,10
Кейкегенкай,gordunni,767,warlock,affliction,18,8,10
Juïcylucy,kazzak,767,warlock,affliction,18,8,10
Jinchi,outland,767,warlock,affliction,18,8,10
Pitharo,magtheridon,767,warlock,affliction,18,8,10
Desingerica,kazzak,767,warlock,affliction,21,9,12
Dreggsow,blackmoore,767,warlock,affliction,24,8,16
Bëllatrïx,zuljin,767,warlock,affliction,30,8,22
Azauriel,argent-dawn,766,warlock,affliction,12,8,4
Jagerlock,doomhammer,766,warlock,affliction,18,8,10
Маларгас,soulflayer,765,warlock,affliction,18,8,10
Димаварлок,gordunni,765,warlock,affliction,22,9,13
Promethazine,nemesis,764,warlock,affliction,18,8,10
Dorilo,draenor,764,warlock,affliction,18,8,10
Diåbló,stormscale,764,warlock,affliction,24,8,16
Matheus,zenedar,763,warlock,affliction,18,8,10
Tzimice,hyjal,763,warlock,affliction,18,8,10
Dexterr,sylvanas,763,warlock,affliction,18,8,10
Samigina,argent-dawn,762,warlock,affliction,24,8,16
Дрын,gordunni,757,warlock,affliction,12,8,4
Squát,kazzak,750,warlock,affliction,18,8,10
Hunbeliever,ragnaros,746,warlock,affliction,12,8,4
Yenex,blackhand,745,warlock,affliction,23,8,15
Arlu,blackrock,736,warlock,affliction,24,9,15
Wiberglock,ravencrest,735,warlock,affliction,14,9,5
Crimss,silvermoon,734,warlock,affliction,14,9,5
Satia,sylvanas,730,warlock,affliction,18,8,10
Hexxenschuss,thrall,728,warlock,affliction,49,8,41
Ogrez,nemesis,720,warlock,affliction,21,8,13
Diwi,area-52,720,warlock,affliction,102,35,67
Dráintráin,burning-blade,714,warlock,affliction,25,9,16
Grinchlock,nagrand,712,warlock,affliction,17,8,9
Askanios,twisting-nether,676,warlock,affliction,25,8,17
Carelock,chamber-of-aspects,672,warlock,affliction,9,8,1
Ethanolix,burning-blade,672,warlock,affliction,12,7,5
Gnargamehl,nemesis,672,warlock,affliction,12,7,5
Ryûsuke,dun-modr,672,warlock,affliction,12,7,5
Skizi,ysondre,672,warlock,affliction,12,7,5
Abuzyaka,kazzak,672,warlock,affliction,12,7,5
Turdy,sylvanas,672,warlock,affliction,12,7,5
Йоранс,gordunni,672,warlock,affliction,12,7,5
Kimkold,twisting-nether,672,warlock,affliction,12,7,5
Mércé,stormscale,672,warlock,affliction,12,7,5
Ilikebolts,blackmoore,672,warlock,affliction,12,7,5
Усубени,greymane,672,warlock,affliction,18,7,11
Amdownbad,kazzak,672,warlock,affliction,18,7,11
Desimp,drakthul,672,warlock,affliction,18,7,11
Mønarch,argent-dawn,672,warlock,affliction,18,7,11
Tanón,sanguino,672,warlock,affliction,18,7,11
Venaarus,antonidas,672,warlock,affliction,18,7,11
Neg,sylvanas,672,warlock,affliction,24,7,17
Leahs,antonidas,671,warlock,affliction,12,7,5
Cropper,turalyon,671,warlock,affliction,12,7,5
Skrikipanik,kazzak,671,warlock,affliction,12,7,5
Äri,blackmoore,671,warlock,affliction,12,7,5
Azalock,ragnaros,671,warlock,affliction,12,7,5
Opiumers,kazzak,671,warlock,affliction,13,7,6
Lockgamerx,ravencrest,670,warlock,affliction,12,7,5
Proctolock,garona,670,warlock,affliction,12,7,5
Asmodex,dun-modr,670,warlock,affliction,18,7,11
Алануэйк,deathguard,669,warlock,affliction,12,7,5
Zywarlock,silvermoon,669,warlock,affliction,18,7,11
Greenlock,la-croisade-écarlate,668,warlock,affliction,12,7,5
Нэйрокризиз,howling-fjord,668,warlock,affliction,12,7,5
Nerône,die-todeskrallen,667,warlock,affliction,18,7,11
Artèm,ysondre,666,warlock,affliction,24,7,17
Дольпико,howling-fjord,665,warlock,affliction,12,7,5
Seadoorxt,sanguino,661,warlock,affliction,18,7,11
Vinilio,kazzak,660,warlock,affliction,18,7,11
Габиель,greymane,660,warlock,affliction,18,7,11
Garbageclass,outland,655,warlock,affliction,11,7,4
Smoulville,sanguino,655,warlock,affliction,17,7,10
Sallêy,blackhand,654,warlock,affliction,23,7,16
Affllction,auchindoun,639,warlock,affliction,23,7,16
Mvplock,magtheridon,624,warlock,affliction,15,7,8
Малгат,howling-fjord,623,warlock,affliction,23,7,16
Anthh,doomhammer,608,warlock,affliction,16,7,9
Bäcck,silvermoon,607,warlock,affliction,17,7,10
Feardotbye,stormscale,576,warlock,affliction,6,6,0
Kiriana,archimonde,576,warlock,affliction,6,6,0
Hérrin,teldrassil,576,warlock,affliction,6,6,0
Debbskidjur,tarren-mill,576,warlock,affliction,6,6,0
Teemzen,tarren-mill,576,warlock,affliction,6,6,0
Multibuyer,tarren-mill,576,warlock,affliction,12,6,6
Инферналках,gordunni,576,warlock,affliction,12,6,6
Boonzor,ravencrest,576,warlock,affliction,12,6,6
Dslap,grim-batol,576,warlock,affliction,12,6,6
Hasla,stormreaver,576,warlock,affliction,12,6,6
Raevax,ravencrest,576,warlock,affliction,12,6,6
Dimmybyrger,stormreaver,576,warlock,affliction,12,6,6
Векста,gordunni,576,warlock,affliction,12,6,6
Nicker,antonidas,576,warlock,affliction,12,6,6
Alcringe,kazzak,576,warlock,affliction,12,6,6
Тьмазвёздная,gordunni,576,warlock,affliction,12,6,6
Shreklock,burning-blade,576,warlock,affliction,12,6,6
Anderxyo,sanguino,576,warlock,affliction,12,6,6
Xoram,kult-der-verdammten,576,warlock,affliction,12,6,6
Tenishia,blackrock,576,warlock,affliction,12,6,6
Malfarien,blackmoore,576,warlock,affliction,12,6,6
Keybump,outland,576,warlock,affliction,12,6,6
Christoph,tichondrius,576,warlock,affliction,12,6,6
Aches,sylvanas,576,warlock,affliction,15,7,8
Lannik,stormscale,576,warlock,affliction,16,7,9
Louên,dun-modr,576,warlock,affliction,18,6,12
Kozhul,argent-dawn,575,warlock,affliction,12,6,6
Talindra,stormscale,575,warlock,affliction,12,6,6
Брилс,grom,575,warlock,affliction,12,6,6
Guccie,ravencrest,575,warlock,affliction,12,6,6
Raggnarlock,ravencrest,575,warlock,affliction,12,6,6
Impazzita,pozzo-delleternità,575,warlock,affliction,12,6,6
Afflicted,trollbane,575,warlock,affliction,12,6,6
Smileyfacè,silvermoon,575,warlock,affliction,17,6,11
Millhaus,gorgonnash,575,warlock,affliction,18,6,12
Ooliver,kazzak,575,warlock,affliction,18,6,12
Аминадиаль,gordunni,575,warlock,affliction,18,6,12
Toskanoamani,blackmoore,575,warlock,affliction,18,6,12
Môzoc,frostwolf,575,warlock,affliction,18,6,12
Cocacoil,outland,575,warlock,affliction,18,6,12
Flinkmongo,kazzak,575,warlock,affliction,18,6,12
Труупыч,gordunni,575,warlock,affliction,24,6,18
Hisgobussy,argent-dawn,575,warlock,affliction,24,6,18
Lulokko,nemesis,574,warlock,affliction,18,6,12
Consfearacy,executus,574,warlock,affliction,24,6,18
Kiégetlek,ragnaros,573,warlock,affliction,18,6,12
Цветника,deathguard,569,warlock,affliction,12,6,6
Smaúg,archimonde,563,warlock,affliction,24,10,14
Rëol,blackmoore,527,warlock,affliction,17,7,10
Saymore,ragnaros,522,warlock,affliction,13,7,6
Alarmlock,silvermoon,519,warlock,affliction,12,7,5
Бриант,gordunni,512,warlock,affliction,22,6,16
Скверногрик,fordragon,511,warlock,affliction,10,6,4
Mjuklock,ravencrest,510,warlock,affliction,20,6,14
Jolette,hyjal,508,warlock,affliction,26,6,20
Drarken,sylvanas,480,warlock,affliction,6,5,1
Letzterlude,thrall,480,warlock,affliction,6,5,1
Upsahl,twisting-nether,480,warlock,affliction,6,5,1
Lolock,archimonde,480,warlock,affliction,6,5,1
Drututt,the-maelstrom,480,warlock,affliction,6,5,1
Uqrlock,twisting-nether,480,warlock,affliction,6,5,1
Ranchiëk,ravencrest,480,warlock,affliction,6,5,1
Quadalahara,ravencrest,480,warlock,affliction,6,5,1
Theolteckoc,burning-blade,480,warlock,affliction,6,5,1
Dontlockonme,frostmane,480,warlock,affliction,12,5,7
Daubi,ravencrest,480,warlock,affliction,12,5,7
Enzyw,drakthul,480,warlock,affliction,12,5,7
Cyliinia,die-aldor,480,warlock,affliction,12,5,7
Druno,archimonde,480,warlock,affliction,12,5,7
Drbangerz,ravencrest,480,warlock,affliction,12,5,7
Kyiûu,archimonde,480,warlock,affliction,12,5,7
Ethiq,blackrock,480,warlock,affliction,12,5,7
Iatedora,ahnqiraj,480,warlock,affliction,12,5,7
Exerji,twisting-nether,480,warlock,affliction,12,5,7
Nozx,thrall,480,warlock,affliction,12,5,7
Negatiiv,outland,480,warlock,affliction,12,5,7
Felrazer,silvermoon,480,warlock,affliction,12,5,7
Kwoleriker,norgannon,480,warlock,affliction,12,5,7
Hyøsei,hyjal,480,warlock,affliction,12,5,7
Chaøsbølt,archimonde,480,warlock,affliction,12,5,7
Nybbx,frostmane,480,warlock,affliction,12,5,7
Dardec,hyjal,480,warlock,affliction,12,5,7
Báthori,ravencrest,480,warlock,affliction,12,5,7
Donase,khaz-modan,480,warlock,affliction,12,5,7
Chaozvx,kazzak,480,warlock,affliction,12,5,7
Freshplanga,kazzak,480,warlock,affliction,16,6,10
Moredøts,blackrock,480,warlock,affliction,14,5,9
Dwoorf,ravencrest,480,warlock,affliction,14,5,9
Stavrogina,ravencrest,480,warlock,affliction,18,5,13
Lywov,stormscale,480,warlock,affliction,18,5,13
Buffmeplease,nagrand,480,warlock,affliction,18,5,13
Muninnus,archimonde,480,warlock,affliction,18,5,13
Necroless,shadowsong,480,warlock,affliction,24,5,19
Wumz,sylvanas,480,warlock,affliction,24,5,19
Lókí,nagrand,479,warlock,affliction,6,5,1
Silås,hyjal,479,warlock,affliction,9,6,3
Jacobí,defias-brotherhood,479,warlock,affliction,12,5,7
Demonflickan,silvermoon,479,warlock,affliction,12,5,7
Trickyy,azjolnerub,479,warlock,affliction,12,5,7
Dreamage,exodar,479,warlock,affliction,12,5,7
Nozzos,zuluhed,479,warlock,affliction,30,5,25
Cedrea,ravencrest,479,warlock,affliction,30,5,25
Ezhjyr,anubarak,478,warlock,affliction,12,5,7
Lewdrumpslap,kazzak,478,warlock,affliction,15,6,9
Üserper,chamber-of-aspects,478,warlock,affliction,30,5,25
Guttate,chamber-of-aspects,476,warlock,affliction,12,5,7
Ketriicken,argent-dawn,447,warlock,affliction,14,6,8
Selur,ragnaros,447,warlock,affliction,17,6,11
Cryingface,ragnaros,447,warlock,affliction,17,5,12
Garbrandt,tarren-mill,432,warlock,affliction,9,6,3
Murol,dalaran,431,warlock,affliction,17,5,12
Ackorax,kilrogg,426,warlock,affliction,13,6,7
Covidbolt,outland,426,warlock,affliction,22,8,14
Danidelarge,blackmoore,426,warlock,affliction,21,6,15
Migyardondup,exodar,416,warlock,affliction,14,6,8
Lazyblue,hyjal,415,warlock,affliction,14,5,9
Amatet,sanguino,415,warlock,affliction,16,5,11
Attributivum,blackhand,410,warlock,affliction,16,5,11
Ariyasuke,drakthul,399,warlock,affliction,7,5,2
Nøx,quelthalas,393,warlock,affliction,14,8,6
Rilette,dun-morogh,384,warlock,affliction,6,4,2
Kêkèkékêk,kazzak,384,warlock,affliction,6,4,2
Яичнаялапша,soulflayer,384,warlock,affliction,6,4,2
Jujalari,stormscale,384,warlock,affliction,6,4,2
Zerøskil,blackrock,384,warlock,affliction,6,4,2
Uselèss,die-arguswacht,384,warlock,affliction,6,4,2
Doompianist,ghostlands,384,warlock,affliction,6,4,2
Mooncrushed,stormscale,384,warlock,affliction,6,4,2
Tharor,forscherliga,384,warlock,affliction,6,4,2
Talriun,kazzak,384,warlock,affliction,6,4,2
Dotboxdeluxe,blackmoore,384,warlock,affliction,6,4,2
Патокдрысни,howling-fjord,384,warlock,affliction,6,4,2
Justlock,tarren-mill,384,warlock,affliction,6,4,2
Wizdoom,outland,384,warlock,affliction,6,4,2
Искусность,soulflayer,384,warlock,affliction,6,4,2
Tekrowdy,blackmoore,384,warlock,affliction,6,4,2
Dusken,kazzak,384,warlock,affliction,6,4,2
Noemia,defias-brotherhood,384,warlock,affliction,6,4,2
Вервлоекте,soulflayer,384,warlock,affliction,6,4,2
Мглавечная,soulflayer,384,warlock,affliction,6,4,2
Фейкгодх,soulflayer,384,warlock,affliction,6,4,2
Adipure,blackrock,384,warlock,affliction,6,4,2
Hacknator,aegwynn,384,warlock,affliction,6,4,2
Ralyz,archimonde,384,warlock,affliction,6,4,2
Aljonah,antonidas,384,warlock,affliction,6,4,2
Lopari,aegwynn,384,warlock,affliction,6,4,2
Chickoz,eredar,384,warlock,affliction,6,4,2
Telodotto,nemesis,384,warlock,affliction,6,4,2
Discordîân,twisting-nether,384,warlock,affliction,6,4,2
Sanshukar,ravencrest,384,warlock,affliction,6,4,2
Adotroz,magtheridon,384,warlock,affliction,6,4,2
Dilox,draenor,384,warlock,affliction,6,4,2
Feargone,magtheridon,384,warlock,affliction,6,4,2
Turbonion,archimonde,384,warlock,affliction,6,4,2
Panda,aegwynn,384,warlock,affliction,6,4,2
Pablø,silvermoon,384,warlock,affliction,6,4,2
Humpers,kazzak,384,warlock,affliction,6,4,2
Datty,grim-batol,384,warlock,affliction,6,4,2
Førgøtten,ragnaros,384,warlock,affliction,6,4,2
Benafflockk,kirin-tor,384,warlock,affliction,6,4,2
Bubalock,kazzak,384,warlock,affliction,6,4,2
Dotritos,tarren-mill,384,warlock,affliction,6,4,2
Hopéléss,aggra-português,384,warlock,affliction,6,4,2
Djhanzó,outland,384,warlock,affliction,7,4,3
Psychoduck,stormscale,384,warlock,affliction,7,4,3
Cptdotalot,tarren-mill,384,warlock,affliction,12,4,8
Zoh,archimonde,384,warlock,affliction,12,4,8
Zeddy,draenor,384,warlock,affliction,12,4,8
Mortibal,dalvengyr,384,warlock,affliction,12,4,8
Thepureone,blades-edge,384,warlock,affliction,12,4,8
Shazes,blutkessel,384,warlock,affliction,12,4,8
Eleriya,argent-dawn,384,warlock,affliction,12,4,8
Славеномен,howling-fjord,384,warlock,affliction,12,4,8
Doomkicksin,haomarush,384,warlock,affliction,12,4,8
Seriasa,blackmoore,384,warlock,affliction,12,4,8
Силорий,howling-fjord,384,warlock,affliction,12,4,8
Voidlocklol,magtheridon,384,warlock,affliction,12,4,8
Supergeîl,blackrock,384,warlock,affliction,12,4,8
Gorakthul,drakthul,384,warlock,affliction,12,4,8
Pause,ysondre,384,warlock,affliction,12,4,8
Сатенекс,soulflayer,384,warlock,affliction,12,4,8
Xyzzy,silvermoon,384,warlock,affliction,12,4,8
Roedin,tarren-mill,384,warlock,affliction,18,4,14
Sanas,blackhand,384,warlock,affliction,18,4,14
Сорзи,thermaplugg,384,warlock,affliction,18,4,14
Nokzhul,blackrock,384,warlock,affliction,18,4,14
Purplemonkey,burning-blade,384,warlock,affliction,18,4,14
Antoniolm,cthun,383,warlock,affliction,6,4,2
Джигуза,howling-fjord,383,warlock,affliction,6,4,2
Энтропилька,azuregos,383,warlock,affliction,6,4,2
Whisperswerd,blackrock,383,warlock,affliction,6,4,2
Freyjå,confrérie-du-thorium,383,warlock,affliction,19,7,12
Saltybagel,draenor,383,warlock,affliction,12,4,8
Дарунг,greymane,383,warlock,affliction,12,4,8
Divvaa,tarren-mill,383,warlock,affliction,12,4,8
Сварожевич,galakrond,383,warlock,affliction,18,4,14
Lünatix,archimonde,383,warlock,affliction,18,4,14
Аннирина,eversong,382,warlock,affliction,6,4,2
Lifesteal,auchindoun,382,warlock,affliction,12,4,8
Gonzoqt,tarren-mill,352,warlock,affliction,10,5,5
Dotyboi,tarren-mill,351,warlock,affliction,8,5,3
Disrupted,blackmoore,351,warlock,affliction,11,4,7
Feyras,turalyon,351,warlock,affliction,17,4,13
Fearu,kazzak,336,warlock,affliction,15,4,11
Imbasimba,sylvanas,335,warlock,affliction,11,4,7
Hellsplat,tarren-mill,330,warlock,affliction,14,6,8
Marakh,stormscale,320,warlock,affliction,10,4,6
Shalazar,dun-modr,319,warlock,affliction,8,4,4
Fabiov,nemesis,319,warlock,affliction,10,4,6
Tepelkwastje,twisting-nether,319,warlock,affliction,14,4,10
Nardowick,kazzak,318,warlock,affliction,16,4,12
Nainbusdemil,dalaran,304,warlock,affliction,19,4,15
Mordonna,blades-edge,304,warlock,affliction,19,4,15
Dóni,chamber-of-aspects,297,warlock,affliction,17,5,12
Lubomirek,turalyon,288,warlock,affliction,8,4,4
Twisted,malganis,288,warlock,affliction,6,3,3
Zagren,antonidas,288,warlock,affliction,6,3,3
Madridistaß,outland,288,warlock,affliction,6,3,3
Dubbzy,outland,288,warlock,affliction,6,3,3
Ðæthpäct,dalaran,288,warlock,affliction,6,3,3
Clonia,nemesis,288,warlock,affliction,6,3,3
Vigget,burning-legion,288,warlock,affliction,6,3,3
Valthorion,arthas,288,warlock,affliction,6,3,3
Kigro,burning-legion,288,warlock,affliction,6,3,3
Siyaa,eredar,288,warlock,affliction,6,3,3
Aniq,eredar,288,warlock,affliction,6,3,3
Dâìñ,antonidas,288,warlock,affliction,6,3,3
Ratjamming,drakthul,288,warlock,affliction,6,3,3
Meleno,die-aldor,288,warlock,affliction,6,3,3
Felcamino,outland,288,warlock,affliction,6,3,3
Flayør,ravencrest,288,warlock,affliction,6,3,3
Itsakikus,twisting-nether,288,warlock,affliction,6,3,3
Полтарашкаа,blackscar,288,warlock,affliction,6,3,3
Azmondan,ahnqiraj,288,warlock,affliction,6,3,3
Guciflipflop,twisting-nether,288,warlock,affliction,6,3,3
Slavecry,silvermoon,288,warlock,affliction,6,3,3
Velv,nagrand,288,warlock,affliction,6,3,3
Eldrinar,twisting-nether,288,warlock,affliction,6,3,3
Staynecro,malfurion,288,warlock,affliction,6,3,3
Шрэкс,blackscar,288,warlock,affliction,6,3,3
Sanium,outland,288,warlock,affliction,6,3,3
Pprwl,tarren-mill,288,warlock,affliction,6,3,3
Tigna,outland,288,warlock,affliction,6,3,3
Ulio,outland,288,warlock,affliction,6,3,3
Kalaslars,draenor,288,warlock,affliction,6,3,3
Conditions,tarren-mill,288,warlock,affliction,6,3,3
Veoxohr,argent-dawn,288,warlock,affliction,6,3,3
Zikkhejj,ragnaros,288,warlock,affliction,6,3,3
Sazamia,ravencrest,288,warlock,affliction,6,3,3
Аиджинка,blackscar,288,warlock,affliction,6,3,3
Rawsauce,outland,288,warlock,affliction,6,3,3
Энжелз,soulflayer,288,warlock,affliction,6,3,3
Babayagâ,sanguino,288,warlock,affliction,6,3,3
Darksoll,hyjal,288,warlock,affliction,6,3,3
Kurioula,twisting-nether,288,warlock,affliction,6,3,3
Shirruun,the-maelstrom,288,warlock,affliction,6,3,3
Cálamity,magtheridon,288,warlock,affliction,6,3,3
Hepheisto,blackmoore,288,warlock,affliction,6,3,3
Dxfive,tarren-mill,288,warlock,affliction,6,3,3
Nayolana,argent-dawn,288,warlock,affliction,6,3,3
Tuskawl,stormreaver,288,warlock,affliction,6,3,3
Zélroth,argent-dawn,288,warlock,affliction,6,3,3
Catcalling,die-nachtwache,288,warlock,affliction,6,3,3
Darkgrave,the-maelstrom,288,warlock,affliction,6,3,3
Favorizlmp,archimonde,288,warlock,affliction,6,3,3
Зуи,blackscar,288,warlock,affliction,6,3,3
Marenov,kazzak,288,warlock,affliction,6,3,3
Maintarget,blackrock,288,warlock,affliction,6,3,3
Gigabolt,turalyon,288,warlock,affliction,6,3,3
Feyreah,blackmoore,288,warlock,affliction,6,3,3
Демоник,deathguard,288,warlock,affliction,6,3,3
Imphugger,kazzak,288,warlock,affliction,6,3,3
Retrosatanas,archimonde,288,warlock,affliction,6,3,3
Fîgøk,conseil-des-ombres,288,warlock,affliction,6,3,3
Kariusbaktus,stormscale,288,warlock,affliction,6,3,3
Boltsnhoes,tarren-mill,288,warlock,affliction,6,3,3
Fercon,kazzak,288,warlock,affliction,6,3,3
Moonpoxlock,nerathor,288,warlock,affliction,6,3,3
Databricks,kazzak,288,warlock,affliction,6,3,3
Absúrd,turalyon,288,warlock,affliction,6,3,3
Фримех,soulflayer,288,warlock,affliction,6,3,3
Manikalinka,stormscale,288,warlock,affliction,6,3,3
Nachtreich,thrall,288,warlock,affliction,6,3,3
Necksi,archimonde,288,warlock,affliction,6,3,3
Ooze,kazzak,288,warlock,affliction,6,3,3
Trimar,archimonde,288,warlock,affliction,6,3,3
Джастсак,gordunni,288,warlock,affliction,6,3,3
Velënne,kirin-tor,288,warlock,affliction,6,3,3
Bixik,ravencrest,288,warlock,affliction,8,3,5
Lifedriller,drakthul,288,warlock,affliction,10,3,7
Zìì,silvermoon,288,warlock,affliction,12,3,9
Kotihoitaja,stormreaver,288,warlock,affliction,12,3,9
Михасяпевпев,gordunni,288,warlock,affliction,12,3,9
Pinketo,kazzak,288,warlock,affliction,12,3,9
Zdrac,stormscale,288,warlock,affliction,12,3,9
Makuss,turalyon,288,warlock,affliction,12,3,9
Mîjagî,blackhand,288,warlock,affliction,12,3,9
Этожедру,howling-fjord,288,warlock,affliction,12,3,9
Ymersai,stormscale,288,warlock,affliction,12,3,9
Mïtä,hyjal,288,warlock,affliction,12,3,9
Tzeeñtch,tarren-mill,288,warlock,affliction,12,3,9
Vorcariel,argent-dawn,288,warlock,affliction,12,3,9
Hexovíc,blackmoore,288,warlock,affliction,18,3,15
Troo,daggerspine,287,warlock,affliction,7,5,2
Nedivh,stormscale,287,warlock,affliction,8,4,4
Kritcheq,alakir,287,warlock,affliction,6,3,3
Divinehâmmer,hyjal,287,warlock,affliction,6,3,3
Tyranuzz,norgannon,287,warlock,affliction,12,3,9
Killerbeez,burning-blade,287,warlock,affliction,18,3,15
Dotmasterz,outland,287,warlock,affliction,18,3,15
Márinho,aggra-português,276,warlock,affliction,16,6,10
Cerberus,argent-dawn,271,warlock,affliction,11,3,8
Áéé,kazzak,255,warlock,affliction,8,4,4
Евнухоидизм,gordunni,234,warlock,affliction,11,4,7
Snaga,culte-de-la-rive-noire,233,warlock,affliction,15,5,10
Nimmyjewtron,tarren-mill,224,warlock,affliction,10,3,7
Lockas,ravencrest,222,warlock,affliction,8,3,5
Pøx,nemesis,208,warlock,affliction,13,3,10
Alxor,archimonde,192,warlock,affliction,6,2,4
Аидка,gordunni,192,warlock,affliction,6,2,4
Morcey,sylvanas,192,warlock,affliction,6,2,4
Flockyy,draenor,192,warlock,affliction,6,2,4
Razkann,confrérie-du-thorium,192,warlock,affliction,6,2,4
Portyx,archimonde,192,warlock,affliction,6,2,4
Ozax,doomhammer,192,warlock,affliction,6,2,4
Dedalus,zuluhed,192,warlock,affliction,6,2,4
Иммолэйтх,gordunni,192,warlock,affliction,6,2,4
Potatowl,ravencrest,192,warlock,affliction,6,2,4
Жериновсский,gordunni,192,warlock,affliction,6,2,4
Furïeuse,archimonde,192,warlock,affliction,6,2,4
Шадофлок,deathweaver,192,warlock,affliction,6,2,4
Ezy,auchindoun,192,warlock,affliction,6,2,4
Bigbagelbob,archimonde,192,warlock,affliction,6,2,4
Кериген,gordunni,192,warlock,affliction,6,2,4
Norgebrur,draenor,192,warlock,affliction,6,2,4
Narstia,archimonde,192,warlock,affliction,6,2,4
Paintherapy,blackrock,192,warlock,affliction,6,2,4
Wutili,dun-morogh,192,warlock,affliction,6,2,4
Hexus,teldrassil,192,warlock,affliction,6,2,4
Tattered,draenor,192,warlock,affliction,6,2,4
Khazgrom,guldan,192,warlock,affliction,6,2,4
Kastón,dun-modr,192,warlock,affliction,6,2,4
Дьяволоман,blackscar,192,warlock,affliction,6,2,4
Скверножмых,gordunni,192,warlock,affliction,6,2,4
Tørcal,hyjal,192,warlock,affliction,6,2,4
Meisterhexe,taerar,192,warlock,affliction,6,2,4
Lesgrossman,draenor,192,warlock,affliction,6,2,4
Howareyou,blackrock,192,warlock,affliction,6,2,4
Brudèrtuk,das-syndikat,192,warlock,affliction,6,2,4
Dotsfired,aegwynn,192,warlock,affliction,6,2,4
Slâyâ,blackrock,192,warlock,affliction,6,2,4
Malgus,veknilash,192,warlock,affliction,6,2,4
Айнзуалгоун,gordunni,192,warlock,affliction,6,2,4
Pichwise,draenor,192,warlock,affliction,6,2,4
Ðankan,aegwynn,192,warlock,affliction,6,2,4
Necrolon,senjin,192,warlock,affliction,6,2,4
Cafardcancer,archimonde,192,warlock,affliction,6,2,4
Imatión,sylvanas,192,warlock,affliction,6,2,4
Шеизла,borean-tundra,192,warlock,affliction,6,2,4
Onlylock,outland,192,warlock,affliction,6,2,4
Born,ravencrest,192,warlock,affliction,6,2,4
Tokarrus,blackmoore,192,warlock,affliction,6,2,4
Yzïah,blackrock,192,warlock,affliction,6,2,4
Lakasytos,sanguino,192,warlock,affliction,6,2,4
Twistedfate,norgannon,192,warlock,affliction,6,2,4
Kivilock,dun-modr,192,warlock,affliction,6,2,4
Legend,trollbane,192,warlock,affliction,6,2,4
Marroux,malganis,192,warlock,affliction,6,2,4
Elvània,eredar,192,warlock,affliction,6,2,4
Azerybedge,alexstrasza,192,warlock,affliction,6,2,4
Nuckki,antonidas,192,warlock,affliction,6,2,4
Mafteryo,blackrock,192,warlock,affliction,6,2,4
Чернокнжник,soulflayer,192,warlock,affliction,6,2,4
Сатаната,deepholm,192,warlock,affliction,6,2,4
Бирел,soulflayer,192,warlock,affliction,6,2,4
Vellerian,twisting-nether,192,warlock,affliction,6,2,4
Sotapen,ragnaros,192,warlock,affliction,6,2,4
Dêmön,arathi,192,warlock,affliction,6,2,4
Setharon,burning-legion,192,warlock,affliction,6,2,4
Гумал,howling-fjord,192,warlock,affliction,6,2,4
Мамхаус,howling-fjord,192,warlock,affliction,6,2,4
Wycked,azshara,192,warlock,affliction,6,2,4
Kortsoet,silvermoon,192,warlock,affliction,6,2,4
Bowhite,silvermoon,192,warlock,affliction,6,2,4
Soundmagic,silvermoon,192,warlock,affliction,6,2,4
Âpâchî,twisting-nether,192,warlock,affliction,6,2,4
Ruvy,twisting-nether,192,warlock,affliction,6,2,4
Désolaté,kazzak,192,warlock,affliction,6,2,4
Recko,zuljin,192,warlock,affliction,6,2,4
Vibori,twisting-nether,192,warlock,affliction,6,2,4
Endherkonk,sanguino,192,warlock,affliction,6,2,4
Калестонх,soulflayer,192,warlock,affliction,6,2,4
Myristica,die-todeskrallen,192,warlock,affliction,6,2,4
Healél,sanguino,192,warlock,affliction,6,2,4
Shore,ragnaros,192,warlock,affliction,6,2,4
Jexa,silvermoon,192,warlock,affliction,6,2,4
Malumbra,argent-dawn,192,warlock,affliction,6,2,4
ßatocko,kazzak,192,warlock,affliction,6,2,4
Numidia,tarren-mill,192,warlock,affliction,6,2,4
Hellcatherin,ghostlands,192,warlock,affliction,6,2,4
Dréadful,kazzak,192,warlock,affliction,6,2,4
Vhordrai,kazzak,192,warlock,affliction,6,2,4
Demoner,tarren-mill,192,warlock,affliction,6,2,4
Dwimmerlaikx,ragnaros,192,warlock,affliction,6,2,4
Absurdity,twisting-nether,192,warlock,affliction,6,2,4
Бесстолоч,ashenvale,192,warlock,affliction,6,2,4
Cruello,ragnaros,192,warlock,affliction,6,2,4
Армдэд,galakrond,192,warlock,affliction,6,2,4
Finea,sanguino,192,warlock,affliction,6,2,4
Хастла,ashenvale,192,warlock,affliction,6,2,4
Slurvefar,kazzak,192,warlock,affliction,6,2,4
Тарои,howling-fjord,192,warlock,affliction,6,2,4
Volomar,darkspear,192,warlock,affliction,6,2,4
Zartax,kazzak,192,warlock,affliction,6,2,4
Валак,greymane,192,warlock,affliction,6,2,4
Trollóck,the-maelstrom,192,warlock,affliction,6,2,4
Dmondmg,kazzak,192,warlock,affliction,6,2,4
Lockbitch,archimonde,192,warlock,affliction,8,2,6
Adafbhf,tichondrius,192,warlock,affliction,8,2,6
Gemja,onyxia,192,warlock,affliction,15,3,12
Djadizpunish,stormscale,192,warlock,affliction,12,2,10
Nùdex,ravencrest,192,warlock,affliction,12,2,10
Drdotalot,twisting-nether,192,warlock,affliction,12,2,10
Müsli,kiljaeden,192,warlock,affliction,12,2,10
Wizesson,shadowsong,192,warlock,affliction,12,2,10
Рыжевласочка,eversong,192,warlock,affliction,12,2,10
Dupony,antonidas,192,warlock,affliction,12,2,10
Harrydotterx,alakir,192,warlock,affliction,12,2,10
Баммес,galakrond,192,warlock,affliction,12,2,10
Ribtic,draenor,191,warlock,affliction,6,2,4
Trinxs,blackmoore,191,warlock,affliction,12,2,10
Bildimar,drekthar,190,warlock,affliction,6,4,2
Zorlon,frostmane,169,warlock,affliction,8,4,4
Overbuffed,wildhammer,159,warlock,affliction,5,2,3
Røiheenøk,archimonde,159,warlock,affliction,5,2,3
Аоепампгодх,howling-fjord,159,warlock,affliction,11,2,9
Mïllâïneeqtx,archimonde,138,warlock,affliction,8,4,4
Nürgle,stormscale,138,warlock,affliction,8,3,5
Paveru,tarren-mill,128,warlock,affliction,4,2,2
Malariaa,defias-brotherhood,128,warlock,affliction,4,2,2
Hokoreuw,echsenkessel,112,warlock,affliction,7,2,5
Infernó,aerie-peak,96,warlock,affliction,3,2,1
Mergon,ravencrest,96,warlock,affliction,3,2,1
Lamagieduzub,ysondre,96,warlock,affliction,3,2,1
Ottu,thrall,96,warlock,affliction,6,1,5
Opprimo,blackmoore,96,warlock,affliction,6,1,5
Crucify,dun-morogh,96,warlock,affliction,6,1,5
Belial,minahonda,96,warlock,affliction,6,1,5
Werzel,frostmane,96,warlock,affliction,6,1,5
Numlockz,jaedenar,96,warlock,affliction,6,1,5
Чернаяскала,howling-fjord,96,warlock,affliction,6,1,5
Mobiq,twisting-nether,96,warlock,affliction,6,1,5
Вандаллизмэ,blackscar,96,warlock,affliction,6,1,5
Doturanal,blackmoore,96,warlock,affliction,6,1,5
Ðemise,antonidas,96,warlock,affliction,6,1,5
Kalifh,kazzak,96,warlock,affliction,6,1,5
Shadeshanox,blackmoore,96,warlock,affliction,6,1,5
Oralnatqga,draenor,96,warlock,affliction,6,1,5
Fearco,ravencrest,96,warlock,affliction,6,1,5
Noahh,kazzak,96,warlock,affliction,6,1,5
Mirrorz,kazzak,96,warlock,affliction,6,1,5
Pidlwick,turalyon,96,warlock,affliction,6,1,5
Berthi,doomhammer,96,warlock,affliction,6,1,5
Kretuss,silvermoon,96,warlock,affliction,6,1,5
Inagony,twisting-nether,96,warlock,affliction,6,1,5
Acohab,draenor,96,warlock,affliction,6,1,5
Blackwizard,theradras,96,warlock,affliction,6,1,5
Irwene,argent-dawn,96,warlock,affliction,6,1,5
Fêâr,dun-modr,96,warlock,affliction,6,1,5
Merelock,eonar,96,warlock,affliction,6,1,5
Kiritsugi,aszune,96,warlock,affliction,6,1,5
Alotami,frostwolf,96,warlock,affliction,6,1,5
Hhip,sanguino,96,warlock,affliction,6,1,5
Veridy,kazzak,96,warlock,affliction,6,1,5
Goefaz,blackrock,96,warlock,affliction,6,1,5
Huesecillo,sanguino,96,warlock,affliction,6,1,5
Contergan,arygos,96,warlock,affliction,6,1,5
Бигсмоук,howling-fjord,96,warlock,affliction,6,1,5
Branduir,ragnaros,96,warlock,affliction,6,1,5
Agitosan,defias-brotherhood,96,warlock,affliction,6,1,5
Pederlock,defias-brotherhood,96,warlock,affliction,6,1,5
Shblakk,outland,96,warlock,affliction,6,1,5
Nevergladtra,darksorrow,96,warlock,affliction,6,1,5
Grimzeh,silvermoon,96,warlock,affliction,6,1,5
Händerå,ragnaros,96,warlock,affliction,6,1,5
Quadraxer,antonidas,96,warlock,affliction,6,1,5
Zozano,draenor,96,warlock,affliction,6,1,5
Scud,frostwolf,96,warlock,affliction,6,1,5
Plaguee,outland,96,warlock,affliction,6,1,5
Warlockkey,ravencrest,96,warlock,affliction,6,1,5
Fearrari,ragnaros,96,warlock,affliction,6,1,5
Zxò,twisting-nether,96,warlock,affliction,8,1,7
Adøume,ysondre,96,warlock,affliction,15,1,14
Guldauni,tarren-mill,96,warlock,affliction,18,1,17
Dotex,zuljin,84,warlock,affliction,12,4,8
Warlockholms,archimonde,79,warlock,affliction,5,1,4
Poulebar,ysondre,64,warlock,affliction,4,1,3
Pufulet,sylvanas,64,warlock,affliction,4,1,3
Natpoesje,azjolnerub,64,warlock,affliction,4,1,3
Araqt,thrall,48,warlock,affliction,3,1,2
Petrosk,sanguino,42,warlock,affliction,6,2,4
Yhazel,archimonde,42,warlock,affliction,7,2,5
Omegachad,draenor,31,warlock,affliction,2,1,1
Ltany,drakthul,31,warlock,affliction,2,1,1
Hamex,draenor,16,warlock,affliction,1,1,0
Ryurans,cthun,9,warlock,affliction,8,2,6
Vitezandro,stormscale,2288,warrior,fury,84,59,25
Wodwod,kazzak,2285,warrior,fury,89,66,23
Høvdingen,outland,2250,warrior,fury,102,65,37
Dyingdogs,kazzak,2232,warrior,fury,96,52,44
Dõxlol,kazzak,2224,warrior,fury,108,64,44
Dõxqt,kazzak,2215,warrior,fury,116,70,46
Sublex,blackrock,2169,warrior,fury,129,75,54
Krônm,dun-modr,2153,warrior,fury,71,47,24
Tanja,bronzebeard,2145,warrior,fury,84,53,31
Heartmemphis,stormscale,2137,warrior,fury,93,59,34
Blîxtgordon,tarren-mill,2131,warrior,fury,90,52,38
Thezug,blackmoore,2131,warrior,fury,132,73,59
Gewyon,ragnaros,2131,warrior,fury,201,111,90
Gottdustin,lothar,2124,warrior,fury,143,78,65
Eidzo,tarren-mill,2121,warrior,fury,119,73,46
Corvínus,blackrock,2106,warrior,fury,176,95,81
Богвойны,razuvious,2104,warrior,fury,132,77,55
Syltetballe,kazzak,2104,warrior,fury,143,82,61
Nodrip,stormscale,2102,warrior,fury,168,101,67
Quanny,die-aldor,2102,warrior,fury,114,67,47
Níghtfúry,ravencrest,2102,warrior,fury,84,43,41
Hawkman,outland,2097,warrior,fury,85,46,39
Joeférnandes,ragnaros,2091,warrior,fury,138,71,67
Schultze,kazzak,2088,warrior,fury,262,128,134
Maxwall,twisting-nether,2086,warrior,fury,442,221,221
Релайк,gordunni,2079,warrior,fury,90,51,39
Sublex,aegwynn,2068,warrior,fury,102,65,37
Gregorez,silvermoon,2055,warrior,fury,180,100,80
Ðênnis,ravencrest,2054,warrior,fury,62,37,25
Dyingdog,kazzak,2045,warrior,fury,137,68,69
Kwesta,kazzak,2043,warrior,fury,78,48,30
Орвинг,soulflayer,2041,warrior,fury,140,79,61
Кавайтити,blackscar,2032,warrior,fury,103,50,53
Grulbash,stormscale,2030,warrior,fury,72,38,34
Ibunnyone,blackrock,2023,warrior,fury,152,81,71
Hangart,argent-dawn,2022,warrior,fury,177,94,83
Дахирарг,fordragon,2021,warrior,fury,198,105,93
Dreasus,ragnaros,2007,warrior,fury,202,109,93
Vykoz,sylvanas,1994,warrior,fury,78,47,31
Sockerbagarn,zenedar,1989,warrior,fury,232,121,111
Morbaac,archimonde,1987,warrior,fury,137,78,59
Insanedmg,dun-modr,1985,warrior,fury,132,69,63
Sporctaco,nemesis,1983,warrior,fury,160,87,73
Ironbound,silvermoon,1978,warrior,fury,102,56,46
Apacolata,outland,1977,warrior,fury,72,41,31
Kenryu,argent-dawn,1969,warrior,fury,78,43,35
Vrynn,nemesis,1968,warrior,fury,540,280,260
Hanìbal,ravencrest,1962,warrior,fury,291,158,133
Мигнт,howling-fjord,1961,warrior,fury,84,42,42
Allthèwayup,kazzak,1960,warrior,fury,66,36,30
Dreams,auchindoun,1958,warrior,fury,108,62,46
Nerfrend,stormscale,1958,warrior,fury,72,35,37
Wruxar,bronzebeard,1955,warrior,fury,72,37,35
Chaosedge,terokkar,1953,warrior,fury,154,92,62
Linzao,archimonde,1949,warrior,fury,96,53,43
Elsensør,thrall,1949,warrior,fury,239,119,120
Stephabibi,kazzak,1943,warrior,fury,315,161,154
Palmexwar,drakthul,1939,warrior,fury,72,40,32
Waterquéen,outland,1938,warrior,fury,36,24,12
Yawalad,stormscale,1937,warrior,fury,120,62,58
Beasterbunny,outland,1936,warrior,fury,163,95,68
Schlauberg,azshara,1936,warrior,fury,167,92,75
Ðunhammer,blackmoore,1936,warrior,fury,186,97,89
Yaler,alakir,1934,warrior,fury,107,61,46
Sonnyzz,sanguino,1933,warrior,fury,113,64,49
Pivcuga,kazzak,1928,warrior,fury,92,56,36
Pòóòóòóòópz,dun-modr,1928,warrior,fury,53,32,21
Kronmw,dun-modr,1925,warrior,fury,78,43,35
Dwarfsteel,stormscale,1914,warrior,fury,83,42,41
Shinychan,silvermoon,1913,warrior,fury,48,30,18
Arthoc,sanguino,1913,warrior,fury,135,77,58
Jeco,tarren-mill,1913,warrior,fury,125,71,54
Zyalen,stormscale,1911,warrior,fury,143,75,68
Warrez,azuremyst,1909,warrior,fury,359,194,165
Cesr,bloodhoof,1908,warrior,fury,156,88,68
Käïzën,dun-modr,1901,warrior,fury,59,38,21
Miquellá,die-aldor,1900,warrior,fury,103,58,45
Zidbi,argent-dawn,1898,warrior,fury,321,168,153
Yserá,auchindoun,1897,warrior,fury,82,41,41
Трэйдар,blackscar,1895,warrior,fury,54,31,23
Moldamis,blackhand,1895,warrior,fury,60,30,30
Risara,outland,1893,warrior,fury,127,74,53
Rocketx,blackrock,1892,warrior,fury,79,44,35
Faraam,sunstrider,1891,warrior,fury,78,38,40
Kiha,argent-dawn,1887,warrior,fury,60,35,25
Picciocino,nemesis,1886,warrior,fury,239,124,115
Злопиканка,gordunni,1885,warrior,fury,115,61,54
Rawrstorm,silvermoon,1884,warrior,fury,36,21,15
Uretirips,archimonde,1879,warrior,fury,243,130,113
Dronikos,ravencrest,1878,warrior,fury,60,39,21
Stansmash,kazzak,1878,warrior,fury,54,32,22
Borndet,eredar,1878,warrior,fury,177,103,74
Варплеер,gordunni,1875,warrior,fury,76,39,37
Elsensor,sylvanas,1873,warrior,fury,177,81,96
Mitu,sanguino,1871,warrior,fury,87,51,36
Рэйлет,gordunni,1871,warrior,fury,66,36,30
Pflanzling,nozdormu,1870,warrior,fury,274,136,138
Tooski,sylvanas,1869,warrior,fury,119,64,55
Gozgu,stormscale,1867,warrior,fury,62,37,25
Гринфинч,galakrond,1866,warrior,fury,237,129,108
Kragrâu,kazzak,1865,warrior,fury,153,81,72
Sonnylolxd,dun-modr,1865,warrior,fury,119,58,61
Budgetassa,stormscale,1864,warrior,fury,54,30,24
Vulcán,aerie-peak,1863,warrior,fury,73,40,33
Émalkay,tarren-mill,1863,warrior,fury,48,26,22
Ranyl,blackmoore,1863,warrior,fury,71,34,37
Løktær,ravencrest,1859,warrior,fury,108,55,53
Thundersword,sylvanas,1858,warrior,fury,140,78,62
Bloodhorn,blackhand,1857,warrior,fury,54,36,18
Nitojutsu,blackrock,1856,warrior,fury,54,30,24
Immørtalx,area-52,1854,warrior,fury,54,22,32
Xark,drakthul,1852,warrior,fury,102,56,46
Vegansmasher,stormscale,1851,warrior,fury,46,25,21
Manaskhan,tarren-mill,1850,warrior,fury,65,36,29
Morganãrogán,ragnaros,1850,warrior,fury,42,23,19
Boos,burning-legion,1849,warrior,fury,54,32,22
Dizzq,burning-legion,1849,warrior,fury,83,38,45
Kocmochka,tarren-mill,1848,warrior,fury,117,62,55
Нерморрог,howling-fjord,1847,warrior,fury,54,39,15
Kennyföx,ysondre,1846,warrior,fury,29,20,9
Bözzy,stormreaver,1846,warrior,fury,410,219,191
Warzzor,auchindoun,1846,warrior,fury,42,21,21
Ørìgíñälgøðx,archimonde,1845,warrior,fury,54,32,22
Уэсгар,blackscar,1844,warrior,fury,54,31,23
Shhimbanned,doomhammer,1843,warrior,fury,78,45,33
Luxurious,argent-dawn,1843,warrior,fury,114,64,50
Фктп,blackscar,1843,warrior,fury,60,33,27
Oneoneseven,archimonde,1841,warrior,fury,78,49,29
Gatts,krasus,1841,warrior,fury,150,85,65
Çon,ravencrest,1840,warrior,fury,269,144,125
Zadirich,burning-blade,1838,warrior,fury,132,70,62
Propanex,kazzak,1837,warrior,fury,84,52,32
Strife,ravencrest,1836,warrior,fury,47,31,16
Àlexander,ravencrest,1836,warrior,fury,40,21,19
Fondugodx,archimonde,1836,warrior,fury,111,54,57
Lair,zuljin,1835,warrior,fury,106,67,39
Wismerx,kazzak,1835,warrior,fury,71,44,27
Elian,ragnaros,1835,warrior,fury,72,36,36
Wøðhërõhâhåh,kazzak,1834,warrior,fury,39,22,17
Méido,argent-dawn,1833,warrior,fury,325,172,153
Krazosh,die-aldor,1831,warrior,fury,42,22,20
Êssâ,stormscale,1831,warrior,fury,90,47,43
Caméltoe,frostwolf,1829,warrior,fury,129,76,53
Anakhas,archimonde,1828,warrior,fury,60,30,30
Durif,argent-dawn,1827,warrior,fury,48,35,13
Ufu,outland,1827,warrior,fury,42,26,16
Svënja,ysondre,1826,warrior,fury,192,107,85
Каосвар,howling-fjord,1826,warrior,fury,60,31,29
Imolderthenu,blackrock,1825,warrior,fury,166,91,75
Рыгатрон,galakrond,1825,warrior,fury,84,46,38
Deatheart,ysondre,1824,warrior,fury,76,41,35
Karny,argent-dawn,1824,warrior,fury,66,34,32
Geneazyx,silvermoon,1823,warrior,fury,116,70,46
Дестингл,gordunni,1823,warrior,fury,123,67,56
Kibb,sylvanas,1820,warrior,fury,104,64,40
Jésusiskíng,amanthul,1820,warrior,fury,89,48,41
Grimlok,sylvanas,1820,warrior,fury,71,36,35
Tizh,twisting-nether,1819,warrior,fury,104,73,31
Ryghar,silvermoon,1819,warrior,fury,161,88,73
Gladius,blutkessel,1819,warrior,fury,156,80,76
Jaý,draenor,1818,warrior,fury,74,42,32
Протектор,soulflayer,1818,warrior,fury,196,102,94
Тиран,howling-fjord,1817,warrior,fury,48,27,21
Xåb,dun-morogh,1817,warrior,fury,170,87,83
Bráïnléss,silvermoon,1816,warrior,fury,135,79,56
Spartaz,eredar,1816,warrior,fury,65,38,27
Pouckette,hyjal,1816,warrior,fury,126,70,56
Gigatscheb,eredar,1815,warrior,fury,149,82,67
Tsuperman,tarren-mill,1815,warrior,fury,59,28,31
Bleaja,tarren-mill,1814,warrior,fury,60,39,21
Dangeruos,ragnaros,1814,warrior,fury,54,34,20
Luigistar,naxxramas,1814,warrior,fury,190,99,91
Adian,ravencrest,1813,warrior,fury,42,26,16
Tweran,drakthul,1813,warrior,fury,83,41,42
Badon,burning-legion,1812,warrior,fury,60,39,21
Suduri,drakthul,1812,warrior,fury,42,26,16
Боссберс,soulflayer,1812,warrior,fury,138,80,58
Zednos,twilights-hammer,1812,warrior,fury,184,102,82
Дарккардинал,deathguard,1812,warrior,fury,127,67,60
Ymaa,argent-dawn,1811,warrior,fury,30,19,11
Xzwarr,silvermoon,1810,warrior,fury,38,21,17
Троммтар,howling-fjord,1810,warrior,fury,71,35,36
Lilshockwave,argent-dawn,1809,warrior,fury,60,42,18
Spørctacø,nemesis,1809,warrior,fury,48,30,18
Кокдиллак,soulflayer,1809,warrior,fury,66,41,25
Cuzyxtwo,blackrock,1809,warrior,fury,60,35,25
Irontouch,draenor,1809,warrior,fury,117,66,51
Vÿnk,ysondre,1808,warrior,fury,260,141,119
Clellin,silvermoon,1807,warrior,fury,139,80,59
Leelazero,argent-dawn,1807,warrior,fury,78,44,34
Ragepath,ragnaros,1807,warrior,fury,72,39,33
Späns,ragnaros,1807,warrior,fury,71,34,37
Rhynot,argent-dawn,1806,warrior,fury,60,41,19
Chargeyou,ragnaros,1805,warrior,fury,47,29,18
Владикчардж,gordunni,1805,warrior,fury,166,94,72
Licious,outland,1804,warrior,fury,30,19,11
Köftemecx,blackrock,1804,warrior,fury,223,130,93
Frozenliøn,twisting-nether,1804,warrior,fury,95,54,41
Kizzyo,draenor,1804,warrior,fury,96,51,45
Tpyñåöädxzd,the-maelstrom,1803,warrior,fury,41,25,16
Oogaboogadps,silvermoon,1803,warrior,fury,249,134,115
Ampw,ravencrest,1802,warrior,fury,78,48,30
Solaje,dun-modr,1802,warrior,fury,54,33,21
Nóvamh,draenor,1802,warrior,fury,42,24,18
Capitalista,das-konsortium,1802,warrior,fury,125,68,57
Violentfunky,ravencrest,1801,warrior,fury,108,56,52
Discoklaus,blackmoore,1801,warrior,fury,415,214,201
Letiis,blackrock,1800,warrior,fury,243,126,117
Timewarrior,ravencrest,1799,warrior,fury,90,46,44
Котаче,soulflayer,1798,warrior,fury,202,107,95
Warrzor,auchindoun,1797,warrior,fury,54,27,27
Хенгард,gordunni,1795,warrior,fury,122,68,54
Bufdefstance,kazzak,1795,warrior,fury,86,43,43
Анжинерх,gordunni,1794,warrior,fury,132,70,62
Kûno,stormscale,1792,warrior,fury,102,57,45
Picklejuicer,argent-dawn,1791,warrior,fury,48,25,23
Wabisabì,silvermoon,1789,warrior,fury,117,67,50
Vajira,blackrock,1787,warrior,fury,30,19,11
Imorphius,silvermoon,1787,warrior,fury,200,110,90
Vory,ravencrest,1786,warrior,fury,54,29,25
Serveywar,twisting-nether,1783,warrior,fury,42,24,18
Raïgã,hyjal,1782,warrior,fury,167,83,84
Джакир,howling-fjord,1781,warrior,fury,127,67,60
Rofos,hellscream,1778,warrior,fury,144,81,63
Tóffèl,thrall,1773,warrior,fury,48,32,16
Vesnãpusic,draenor,1773,warrior,fury,117,68,49
Ryonâgai,aegwynn,1773,warrior,fury,54,30,24
Castlevania,ravencrest,1773,warrior,fury,103,52,51
Ulrid,draenor,1772,warrior,fury,42,22,20
Aléxsandra,ravencrest,1771,warrior,fury,36,21,15
Atrôcithy,silvermoon,1766,warrior,fury,58,36,22
Gôrilla,kazzak,1764,warrior,fury,44,25,19
Shadokaa,stormscale,1762,warrior,fury,249,133,116
Geez,burning-blade,1761,warrior,fury,54,28,26
Fatmikez,aggra-português,1759,warrior,fury,53,35,18
Nobodyx,tarren-mill,1757,warrior,fury,144,86,58
Sorkk,kazzak,1756,warrior,fury,62,38,24
Blázedblack,twisting-nether,1755,warrior,fury,138,82,56
Emune,blackhand,1755,warrior,fury,69,39,30
Грамол,soulflayer,1753,warrior,fury,156,82,74
Щекорез,soulflayer,1752,warrior,fury,66,36,30
Studzianki,argent-dawn,1750,warrior,fury,41,26,15
Drittsekken,sylvanas,1750,warrior,fury,30,19,11
Элинглир,gordunni,1750,warrior,fury,177,95,82
Decapitatëd,outland,1749,warrior,fury,102,54,48
Sumis,stormreaver,1749,warrior,fury,54,20,34
Taurenboii,ravencrest,1747,warrior,fury,37,22,15
Rãzmø,hyjal,1746,warrior,fury,96,51,45
Osha,hyjal,1746,warrior,fury,449,229,220
Кофесмолоком,ashenvale,1746,warrior,fury,48,24,24
Crîxús,silvermoon,1743,warrior,fury,48,29,19
Voffsen,tarren-mill,1740,warrior,fury,299,158,141
Basiletha,hyjal,1740,warrior,fury,71,32,39
Дралк,gordunni,1739,warrior,fury,136,73,63
Emix,arygos,1738,warrior,fury,96,51,45
Lyrv,ravencrest,1737,warrior,fury,54,31,23
Hasbullá,kazzak,1737,warrior,fury,72,39,33
Xzurgster,twisting-nether,1735,warrior,fury,148,75,73
Tidarius,twisting-nether,1735,warrior,fury,54,27,27
Helleon,twisting-nether,1734,warrior,fury,48,26,22
Штурмгешутц,deathweaver,1733,warrior,fury,51,34,17
Poggsaron,kazzak,1733,warrior,fury,171,89,82
Ntouziera,silvermoon,1733,warrior,fury,54,27,27
Pizdatos,ravencrest,1732,warrior,fury,102,57,45
Sagethi,blackrock,1732,warrior,fury,86,42,44
Brbtoilet,kazzak,1731,warrior,fury,84,48,36
Goorila,kazzak,1731,warrior,fury,90,46,44
Брокскрим,soulflayer,1729,warrior,fury,60,34,26
Eddíemòrphin,kazzak,1728,warrior,fury,58,34,24
Oldcockball,argent-dawn,1728,warrior,fury,114,64,50
Prixor,grim-batol,1728,warrior,fury,60,28,32
Jetman,ravencrest,1727,warrior,fury,101,53,48
Juna,hellscream,1726,warrior,fury,91,47,44
Inconcussae,drakthul,1725,warrior,fury,59,39,20
Ffected,blackmoore,1725,warrior,fury,143,86,57
Даймонддогс,gordunni,1725,warrior,fury,64,36,28
Двапеченька,soulflayer,1724,warrior,fury,54,32,22
Üzzy,dun-modr,1724,warrior,fury,284,165,119
Cavo,drakthul,1723,warrior,fury,36,22,14
Toptier,drakthul,1722,warrior,fury,83,48,35
Balltas,drakthul,1721,warrior,fury,102,52,50
Connorzqt,ravencrest,1720,warrior,fury,42,25,17
Ciuez,tarren-mill,1719,warrior,fury,60,35,25
Eekz,haomarush,1719,warrior,fury,122,69,53
Fluffycute,blackhand,1719,warrior,fury,174,98,76
Cathériné,drakthul,1718,warrior,fury,36,22,14
Emcix,aszune,1718,warrior,fury,72,38,34
Очепенец,soulflayer,1718,warrior,fury,200,105,95
Eskiler,burning-legion,1717,warrior,fury,54,30,24
Варынеопэ,gordunni,1717,warrior,fury,65,35,30
Wardruine,dun-modr,1716,warrior,fury,48,29,19
Harbee,stormscale,1716,warrior,fury,254,141,113
Ironmásk,tarren-mill,1716,warrior,fury,42,21,21
Rïmxøxø,haomarush,1715,warrior,fury,60,36,24
Djpuggerino,outland,1715,warrior,fury,74,43,31
Dödgrävarn,stormscale,1714,warrior,fury,142,78,64
Galous,burning-blade,1713,warrior,fury,114,64,50
Silq,zuljin,1713,warrior,fury,36,18,18
Måydåy,twisting-nether,1712,warrior,fury,139,72,67
Chelby,argent-dawn,1711,warrior,fury,36,23,13
Susugar,ysondre,1711,warrior,fury,120,62,58
Iagô,argent-dawn,1710,warrior,fury,291,152,139
Vágópityu,ragnaros,1708,warrior,fury,72,39,33
Станазалол,blackscar,1707,warrior,fury,196,102,94
Легендор,howling-fjord,1705,warrior,fury,36,24,12
Soakmybeet,archimonde,1705,warrior,fury,112,57,55
Athoc,dun-modr,1703,warrior,fury,36,26,10
Agoobagoo,alakir,1702,warrior,fury,53,38,15
Crandalius,kazzak,1702,warrior,fury,76,36,40
Derentis,echsenkessel,1701,warrior,fury,168,89,79
Jengaa,draenor,1698,warrior,fury,36,24,12
Xgs,archimonde,1698,warrior,fury,125,69,56
Agrias,burning-legion,1698,warrior,fury,166,87,79
Тьмасвятая,gordunni,1698,warrior,fury,120,53,67
Артен,ashenvale,1697,warrior,fury,110,60,50
Daymio,twisting-nether,1697,warrior,fury,59,31,28
Prestà,archimonde,1696,warrior,fury,120,65,55
Raynhorn,silvermoon,1695,warrior,fury,54,30,24
Harimà,antonidas,1695,warrior,fury,36,19,17
Bigbugatti,draenor,1695,warrior,fury,83,38,45
Mävïs,ravencrest,1693,warrior,fury,48,30,18
Waegon,twisting-nether,1693,warrior,fury,66,37,29
Honzakesl,drakthul,1693,warrior,fury,93,51,42
Testicouy,archimonde,1692,warrior,fury,36,28,8
Margon,aegwynn,1692,warrior,fury,48,29,19
Koljach,sylvanas,1692,warrior,fury,249,129,120
Slamborghini,twisting-nether,1691,warrior,fury,36,25,11
Maarshl,ysondre,1691,warrior,fury,48,27,21
Большеярости,blackscar,1691,warrior,fury,41,23,18
Incense,silvermoon,1690,warrior,fury,39,21,18
Fúri,turalyon,1689,warrior,fury,48,33,15
Васяжелезо,gordunni,1689,warrior,fury,48,26,22
Футжисубо,razuvious,1688,warrior,fury,198,98,100
Âshnâzgðûr,burning-blade,1688,warrior,fury,123,57,66
Ragnaraya,chamber-of-aspects,1688,warrior,fury,108,50,58
Yousainsbolt,blackrock,1687,warrior,fury,92,51,41
Aramý,argent-dawn,1684,warrior,fury,29,21,8
Wøokz,argent-dawn,1683,warrior,fury,294,152,142
Mokate,kazzak,1682,warrior,fury,48,31,17
Deadyet,mugthol,1681,warrior,fury,36,23,13
Хуфхорнс,soulflayer,1681,warrior,fury,99,49,50
Магрейн,grom,1680,warrior,fury,408,211,197
Miz,dun-modr,1679,warrior,fury,47,29,18
Kwedrowar,burning-legion,1679,warrior,fury,235,122,113
Мундэфэндэр,lich-king,1679,warrior,fury,117,59,58
Дейдулус,soulflayer,1678,warrior,fury,54,29,25
Байсал,gordunni,1677,warrior,fury,127,68,59
Noisey,sanguino,1675,warrior,fury,42,33,9
Даркслеерх,howling-fjord,1674,warrior,fury,36,18,18
Tåÿ,stormscale,1672,warrior,fury,36,22,14
Khosn,ravencrest,1672,warrior,fury,61,37,24
Dontrundie,kazzak,1672,warrior,fury,42,23,19
Архиватор,gordunni,1672,warrior,fury,153,83,70
Ананаслорд,blackscar,1670,warrior,fury,49,31,18
Connorzw,blackmoore,1669,warrior,fury,29,20,9
Даювзадницу,soulflayer,1668,warrior,fury,60,34,26
Súbzéro,argent-dawn,1667,warrior,fury,66,36,30
Суицидгодх,howling-fjord,1667,warrior,fury,60,29,31
Alpairx,aegwynn,1667,warrior,fury,107,47,60
Walexmaryk,ragnaros,1666,warrior,fury,161,87,74
Telrion,silvermoon,1666,warrior,fury,48,24,24
Абабоба,gordunni,1665,warrior,fury,143,74,69
Aleextrasza,silvermoon,1664,warrior,fury,43,24,19
Ironak,malganis,1664,warrior,fury,68,37,31
Berré,ragnaros,1663,warrior,fury,78,43,35
Фомори,howling-fjord,1662,warrior,fury,42,25,17
Берззлой,gordunni,1661,warrior,fury,52,30,22
Yodabär,blackmoore,1661,warrior,fury,132,67,65
Mazzkze,silvermoon,1661,warrior,fury,99,48,51
Suichôken,archimonde,1660,warrior,fury,54,28,26
Biturboo,blackrock,1660,warrior,fury,138,65,73
Wargoth,draenor,1660,warrior,fury,60,28,32
Yfy,outland,1658,warrior,fury,36,22,14
Shilix,twisting-nether,1658,warrior,fury,36,22,14
Alexdgreat,tarren-mill,1658,warrior,fury,61,36,25
Fullztrap,hyjal,1657,warrior,fury,24,19,5
Ðènlos,destromath,1657,warrior,fury,198,102,96
Táÿ,stormscale,1656,warrior,fury,36,22,14
Slaycon,sanguino,1656,warrior,fury,87,37,50
Xendyo,frostmourne,1655,warrior,fury,83,51,32
Hirurg,thrall,1654,warrior,fury,40,22,18
Rottenfall,azjolnerub,1654,warrior,fury,108,58,50
Galenthor,ravencrest,1654,warrior,fury,60,32,28
Jokkul,tarren-mill,1652,warrior,fury,36,24,12
Broley,blackhand,1652,warrior,fury,118,65,53
Роудс,soulflayer,1652,warrior,fury,42,22,20
Cøbain,eredar,1650,warrior,fury,36,20,16
Темнозорь,ashenvale,1649,warrior,fury,107,55,52
Glupakrava,sylvanas,1647,warrior,fury,36,21,15
Gromex,stormscale,1647,warrior,fury,102,47,55
Radamantys,drakthul,1646,warrior,fury,93,51,42
Andzone,alakir,1646,warrior,fury,49,23,26
Zerberos,drakthul,1645,warrior,fury,131,69,62
Вуриор,howling-fjord,1645,warrior,fury,48,25,23
Phalekxox,twisting-nether,1644,warrior,fury,39,22,17
Явараа,howling-fjord,1644,warrior,fury,192,102,90
Dreadoran,voljin,1644,warrior,fury,126,62,64
Monnee,silvermoon,1642,warrior,fury,54,35,19
Dragonfly,nathrezim,1642,warrior,fury,54,31,23
Projectchad,draenor,1641,warrior,fury,36,23,13
Averenx,frostwolf,1641,warrior,fury,147,75,72
Lepetitwar,hyjal,1641,warrior,fury,124,63,61
Каоссвар,howling-fjord,1641,warrior,fury,48,24,24
Xeraaya,kirin-tor,1641,warrior,fury,162,77,85
Duarel,blackmoore,1640,warrior,fury,41,25,16
Usz,thunderhorn,1639,warrior,fury,114,74,40
Stressfulx,silvermoon,1638,warrior,fury,43,28,15
Bloodbath,burning-legion,1637,warrior,fury,42,26,16
Wgdx,ravencrest,1637,warrior,fury,104,50,54
Rectangle,blackrock,1636,warrior,fury,52,31,21
Summerkarma,wildhammer,1636,warrior,fury,137,74,63
Seraphys,ravencrest,1636,warrior,fury,71,38,33
Геркавоин,eversong,1635,warrior,fury,84,48,36
Lyriae,argent-dawn,1634,warrior,fury,36,27,9
Bastquirage,dalaran,1633,warrior,fury,42,24,18
Bravestarrz,ungoro,1633,warrior,fury,164,87,77
Xiny,blackrock,1632,warrior,fury,79,47,32
Кладбошаа,gordunni,1632,warrior,fury,133,66,67
Рэкла,grom,1631,warrior,fury,103,59,44
Mulfwarrior,darksorrow,1631,warrior,fury,51,29,22
Dævedoff,sanguino,1631,warrior,fury,149,81,68
Megabrux,colinas-pardas,1631,warrior,fury,36,18,18
Ifir,hyjal,1631,warrior,fury,94,45,49
Лимпс,gordunni,1630,warrior,fury,24,17,7
Orkboii,ravencrest,1630,warrior,fury,42,23,19
Genç,ysondre,1629,warrior,fury,65,42,23
Senshin,sanguino,1629,warrior,fury,103,54,49
Goomby,argent-dawn,1629,warrior,fury,77,39,38
Littlebugger,ravencrest,1629,warrior,fury,72,35,37
Sanngridr,defias-brotherhood,1629,warrior,fury,66,32,34
Nímera,nemesis,1628,warrior,fury,29,18,11
Astven,blackmoore,1628,warrior,fury,40,21,19
Hasmocaru,silvermoon,1628,warrior,fury,90,46,44
Peli,burning-blade,1628,warrior,fury,228,114,114
Zodiakós,burning-legion,1628,warrior,fury,79,39,40
Agnetta,burning-legion,1628,warrior,fury,120,58,62
Bloodmyst,kazzak,1627,warrior,fury,121,70,51
Zerenaty,antonidas,1627,warrior,fury,36,20,16
Eygón,silvermoon,1627,warrior,fury,174,88,86
Megalann,silvermoon,1627,warrior,fury,84,41,43
Bogié,stormreaver,1626,warrior,fury,42,23,19
Hleljuskoos,hyjal,1625,warrior,fury,30,21,9
Göttännadåva,stormscale,1625,warrior,fury,72,41,31
Kût,les-sentinelles,1625,warrior,fury,72,41,31
Uwansum,bronzebeard,1625,warrior,fury,194,105,89
Faithless,azshara,1625,warrior,fury,88,46,42
Noproblem,ragnaros,1625,warrior,fury,89,45,44
Gantór,blackrock,1625,warrior,fury,84,40,44
Rhâpsodyw,ravencrest,1624,warrior,fury,24,17,7
Klanky,draenor,1624,warrior,fury,56,32,24
Bønecleaver,blackrock,1624,warrior,fury,129,68,61
Kyraxe,silvermoon,1624,warrior,fury,48,25,23
Skylexs,burning-legion,1624,warrior,fury,48,22,26
Bóobagodx,tarren-mill,1623,warrior,fury,36,23,13
Мамкингерой,howling-fjord,1623,warrior,fury,72,40,32
Swofty,arygos,1622,warrior,fury,24,17,7
Leàn,nemesis,1622,warrior,fury,77,45,32
Philatou,antonidas,1622,warrior,fury,54,31,23
Вульрайс,deepholm,1622,warrior,fury,66,34,32
Эйримор,gordunni,1622,warrior,fury,173,87,86
Mybigcow,darkspear,1622,warrior,fury,75,35,40
Тактоядобрый,ashenvale,1622,warrior,fury,53,24,29
Imperiousjr,draenor,1621,warrior,fury,36,22,14
Zbra,draenor,1621,warrior,fury,220,112,108
Металлие,howling-fjord,1621,warrior,fury,48,21,27
Alkuwaity,outland,1620,warrior,fury,60,33,27
Warriorri,haomarush,1619,warrior,fury,36,21,15
Brutalizator,talnivarr,1618,warrior,fury,24,17,7
Varøkka,aegwynn,1618,warrior,fury,30,21,9
Savarøx,blackmoore,1618,warrior,fury,42,26,16
Tehmountain,ravencrest,1618,warrior,fury,36,22,14
Alcathras,doomhammer,1618,warrior,fury,123,63,60
Divinvibra,dalaran,1618,warrior,fury,43,21,22
Ñegan,proudmoore,1618,warrior,fury,36,17,19
Flexbot,blackmoore,1617,warrior,fury,38,23,15
Aler,alakir,1617,warrior,fury,30,17,13
Bosniakk,ravencrest,1617,warrior,fury,209,113,96
Notvisionary,ravencrest,1617,warrior,fury,40,18,22
Skullsmasher,stormscale,1616,warrior,fury,37,23,14
Cortix,blackmoore,1616,warrior,fury,75,45,30
Esrinx,the-maelstrom,1616,warrior,fury,30,18,12
Discølove,frostwolf,1615,warrior,fury,35,19,16
Watrux,outland,1614,warrior,fury,24,17,7
Trollboii,ravencrest,1614,warrior,fury,60,36,24
Børomir,silvermoon,1614,warrior,fury,113,62,51
Panzerpung,outland,1613,warrior,fury,30,17,13
Riyan,lothar,1613,warrior,fury,64,33,31
Bartins,magtheridon,1612,warrior,fury,111,64,47
Shará,eredar,1612,warrior,fury,101,58,43
Niklaüs,ysondre,1612,warrior,fury,106,56,50
Vallahan,argent-dawn,1611,warrior,fury,166,92,74
Unstopablle,twisting-nether,1611,warrior,fury,154,81,73
Dracømort,dalaran,1610,warrior,fury,42,24,18
Monbun,silvermoon,1610,warrior,fury,43,24,19
Baoni,hyjal,1610,warrior,fury,58,30,28
Flippingout,stormscale,1610,warrior,fury,155,76,79
Féélmyfury,tarren-mill,1609,warrior,fury,29,20,9
Søil,tarren-mill,1609,warrior,fury,36,22,14
Nazyna,blackmoore,1609,warrior,fury,172,93,79
Indicaflower,ahnqiraj,1609,warrior,fury,143,75,68
Шлифую,howling-fjord,1609,warrior,fury,72,35,37
Raoh,archimonde,1608,warrior,fury,66,43,23
Flaggerware,stormscale,1608,warrior,fury,134,78,56
Celn,silvermoon,1608,warrior,fury,145,80,65
Дугмар,gordunni,1608,warrior,fury,78,43,35
Æç,argent-dawn,1608,warrior,fury,59,32,27
Blinkcharge,frostmane,1607,warrior,fury,36,26,10
Pinkíe,blackmoore,1607,warrior,fury,42,21,21
Вадло,soulflayer,1607,warrior,fury,96,47,49
Antismoke,silvermoon,1606,warrior,fury,147,79,68
Фурианка,galakrond,1606,warrior,fury,75,40,35
Джоулирэдблу,howling-fjord,1606,warrior,fury,42,22,20
Istenn,stormscale,1606,warrior,fury,42,20,22
Krathox,kazzak,1605,warrior,fury,30,17,13
Гронвер,soulflayer,1604,warrior,fury,194,105,89
Uwuwarrior,alleria,1604,warrior,fury,264,137,127
Certavus,antonidas,1604,warrior,fury,172,89,83
Wornag,argent-dawn,1604,warrior,fury,89,44,45
Yopa,draenor,1604,warrior,fury,104,50,54
Плотность,howling-fjord,1604,warrior,fury,48,22,26
Thorazin,deathwing,1603,warrior,fury,30,20,10
Tah,hyjal,1603,warrior,fury,36,20,16
Крагар,soulflayer,1603,warrior,fury,36,19,17
Бубаигавар,gordunni,1603,warrior,fury,48,22,26
Гангстарэпер,gordunni,1602,warrior,fury,60,36,24
Mélyssia,dalaran,1602,warrior,fury,34,20,14
Xalont,doomhammer,1602,warrior,fury,66,37,29
Chàrgex,blackrock,1602,warrior,fury,58,30,28
Fraq,tarren-mill,1602,warrior,fury,66,30,36
Narukeratnik,draenor,1601,warrior,fury,78,45,33
Pogoyê,blackmoore,1601,warrior,fury,30,17,13
Едигейй,gordunni,1601,warrior,fury,160,86,74
Kalakalle,twisting-nether,1601,warrior,fury,48,18,30
Nihe,stormreaver,1600,warrior,fury,34,21,13
Junjunw,archimonde,1600,warrior,fury,30,17,13
Bourbimrgllr,hyjal,1600,warrior,fury,45,25,20
Zhenshii,blackmoore,1600,warrior,fury,83,44,39
Vjs,blackhand,1600,warrior,fury,48,24,24
Ebonheart,argent-dawn,1599,warrior,fury,59,32,27
Overgear,twisting-nether,1599,warrior,fury,278,142,136
Chisatø,ravencrest,1598,warrior,fury,30,17,13
Cêlty,aegwynn,1598,warrior,fury,119,61,58
Bobswag,tarren-mill,1598,warrior,fury,66,29,37
Spitonem,blackrock,1597,warrior,fury,36,21,15
Sköldpaddor,tarren-mill,1597,warrior,fury,76,40,36
Khanox,twisting-nether,1597,warrior,fury,47,22,25
Liper,silvermoon,1596,warrior,fury,66,29,37
Rowr,argent-dawn,1595,warrior,fury,90,51,39
Hardlokers,silvermoon,1595,warrior,fury,60,33,27
Roxxyy,stormreaver,1595,warrior,fury,71,39,32
Madaxe,kazzak,1595,warrior,fury,88,46,42
Abnôrmus,tarren-mill,1594,warrior,fury,114,53,61
Jezsov,ravencrest,1594,warrior,fury,41,19,22
Stronkmon,silvermoon,1593,warrior,fury,60,31,29
Lífelover,tarren-mill,1593,warrior,fury,66,30,36
Enzja,nazjatar,1592,warrior,fury,67,39,28
Sodium,pozzo-delleternità,1592,warrior,fury,54,27,27
Creativenot,outland,1591,warrior,fury,76,40,36
Shalahed,outland,1591,warrior,fury,42,20,22
Аскагорт,soulflayer,1590,warrior,fury,30,17,13
Cazaril,kazzak,1590,warrior,fury,60,29,31
Fenzed,hyjal,1590,warrior,fury,42,20,22
Perinel,draenor,1590,warrior,fury,202,95,107
Bloodwatchêr,kazzak,1589,warrior,fury,54,29,25
Azazelslayer,dethecus,1587,warrior,fury,77,47,30
Bananapower,aszune,1587,warrior,fury,101,50,51
Stérkkû,stormscale,1587,warrior,fury,306,151,155
Alexandrrior,rexxar,1585,warrior,fury,93,54,39
Нарезаю,blackscar,1585,warrior,fury,30,17,13
Teljii,blackmoore,1585,warrior,fury,102,57,45
Råzor,blackhand,1585,warrior,fury,264,138,126
Níká,bronzebeard,1585,warrior,fury,145,74,71
Kytee,draenor,1584,warrior,fury,29,19,10
Bobitybob,ravencrest,1584,warrior,fury,111,64,47
Taeshalach,der-abyssische-rat,1584,warrior,fury,78,39,39
Dikata,stormscale,1583,warrior,fury,76,47,29
Mörkölä,ravencrest,1583,warrior,fury,40,22,18
Waralert,kazzak,1583,warrior,fury,42,21,21
Msbrr,blackrock,1582,warrior,fury,34,21,13
Workout,nemesis,1581,warrior,fury,29,19,10
Spokowar,hyjal,1581,warrior,fury,97,50,47
Латахо,gordunni,1581,warrior,fury,85,43,42
Zionto,draenor,1581,warrior,fury,222,103,119
Kaîus,blackrock,1581,warrior,fury,60,26,34
Imondiet,ragnaros,1579,warrior,fury,30,18,12
Синнэр,blackscar,1579,warrior,fury,66,33,33
Arthagore,archimonde,1579,warrior,fury,48,23,25
Ёнморт,gordunni,1578,warrior,fury,50,27,23
Kerando,tirion,1577,warrior,fury,95,52,43
Orwarrio,thrall,1577,warrior,fury,42,20,22
Roxxón,teldrassil,1576,warrior,fury,53,27,26
Cyruk,blackmoore,1576,warrior,fury,114,58,56
Thorgaz,blackmoore,1574,warrior,fury,60,35,25
Нордгаар,howling-fjord,1574,warrior,fury,86,50,36
Хёда,eversong,1574,warrior,fury,96,49,47
Titza,silvermoon,1573,warrior,fury,132,60,72
Justsquat,twisting-nether,1572,warrior,fury,109,63,46
Vatolocoese,dun-morogh,1572,warrior,fury,39,22,17
Killhound,argent-dawn,1572,warrior,fury,42,21,21
Nitheriá,draenor,1571,warrior,fury,36,20,16
Asmoche,archimonde,1571,warrior,fury,72,35,37
Horovoko,kazzak,1570,warrior,fury,40,26,14
Xiiver,burning-legion,1570,warrior,fury,42,26,16
Мастерион,soulflayer,1570,warrior,fury,36,19,17
Ididntbindit,stormscale,1570,warrior,fury,52,26,26
Halfbroken,moonglade,1570,warrior,fury,90,42,48
Valkyvia,sylvanas,1569,warrior,fury,30,17,13
Асау,ashenvale,1569,warrior,fury,232,122,110
Miko,ysondre,1569,warrior,fury,66,31,35
Dárkhammer,tarren-mill,1568,warrior,fury,64,36,28
Broxshar,shendralar,1568,warrior,fury,42,21,21
Гигасмэш,greymane,1568,warrior,fury,36,18,18
Гаррим,blackscar,1568,warrior,fury,73,34,39
Warmâchine,burning-legion,1567,warrior,fury,106,61,45
Fattysw,argent-dawn,1567,warrior,fury,81,43,38
Unqlolz,kazzak,1566,warrior,fury,39,19,20
Иктиннос,gordunni,1565,warrior,fury,57,21,36
Garlogar,twisting-nether,1564,warrior,fury,138,75,63
Касюлин,gordunni,1562,warrior,fury,53,31,22
Вменяемый,gordunni,1562,warrior,fury,112,57,55
Izurritea,tarren-mill,1561,warrior,fury,48,24,24
Jinrok,turalyon,1559,warrior,fury,141,78,63
Dríx,hyjal,1557,warrior,fury,30,19,11
Beinis,twisting-nether,1557,warrior,fury,57,29,28
Bennybryt,frostmane,1557,warrior,fury,84,40,44
Bobshaggins,stormscale,1557,warrior,fury,36,17,19
Тралмош,razuvious,1556,warrior,fury,93,52,41
Carmino,khazgoroth,1556,warrior,fury,83,43,40
Methodxd,outland,1556,warrior,fury,84,40,44
Виттурус,howling-fjord,1556,warrior,fury,46,19,27
Nuclearrage,outland,1555,warrior,fury,85,43,42
Bursch,ravencrest,1555,warrior,fury,90,44,46
Reider,twisting-nether,1554,warrior,fury,154,78,76
Takagødx,archimonde,1553,warrior,fury,36,19,17
Jiñnx,outland,1552,warrior,fury,29,17,12
Агтеррокк,deathweaver,1552,warrior,fury,36,19,17
Oravedenes,draenor,1551,warrior,fury,294,160,134
Moorgoth,ysondre,1551,warrior,fury,54,26,28
Неуно,howling-fjord,1550,warrior,fury,72,42,30
Shadowfiend,argent-dawn,1550,warrior,fury,54,30,24
Tweegles,argent-dawn,1550,warrior,fury,173,89,84
Discordîan,twisting-nether,1549,warrior,fury,54,31,23
Nozuki,archimonde,1549,warrior,fury,237,124,113
Ahaks,draenor,1548,warrior,fury,68,36,32
Kiljhimari,twisting-nether,1548,warrior,fury,68,35,33
Лаинвуд,soulflayer,1547,warrior,fury,87,47,40
Варрвик,howling-fjord,1547,warrior,fury,109,56,53
Anabolika,stormrage,1546,warrior,fury,36,22,14
Разплюхан,gordunni,1546,warrior,fury,66,33,33
Zwareboy,frostmane,1546,warrior,fury,48,20,28
Plackø,draenor,1545,warrior,fury,292,149,143
Димасфури,howling-fjord,1544,warrior,fury,63,34,29
Velgrim,ravencrest,1544,warrior,fury,56,30,26
Taskov,tarren-mill,1544,warrior,fury,66,32,34
Mash,hyjal,1543,warrior,fury,60,36,24
Hejduk,frostmane,1542,warrior,fury,75,43,32
Cleaner,blackmoore,1541,warrior,fury,38,21,17
Áwe,draenor,1541,warrior,fury,97,53,44
Baluste,culte-de-la-rive-noire,1541,warrior,fury,84,43,41
Satabasse,marécage-de-zangar,1541,warrior,fury,50,25,25
Krauus,silvermoon,1540,warrior,fury,155,87,68
Nuijija,stormscale,1540,warrior,fury,72,39,33
Cianna,silvermoon,1539,warrior,fury,36,23,13
Gronos,silvermoon,1539,warrior,fury,128,67,61
Читора,blackscar,1539,warrior,fury,137,66,71
Bäiley,drakthul,1538,warrior,fury,78,31,47
Blaktarr,dunemaul,1537,warrior,fury,115,62,53
Theolcostaud,archimonde,1537,warrior,fury,42,17,25
Myrîna,zuluhed,1536,warrior,fury,66,36,30
Tbones,kazzak,1535,warrior,fury,112,49,63
Trixwar,ragnaros,1534,warrior,fury,33,18,15
Thorken,ragnaros,1534,warrior,fury,89,43,46
Илийя,razuvious,1533,warrior,fury,65,28,37
Белославный,gordunni,1532,warrior,fury,55,38,17
Pacosky,burning-legion,1532,warrior,fury,87,49,38
Hynish,doomhammer,1532,warrior,fury,109,56,53
ßbç,ysondre,1532,warrior,fury,84,41,43
Héraclès,ravencrest,1531,warrior,fury,42,20,22
Exzecute,outland,1529,warrior,fury,66,40,26
Fantol,stormscale,1529,warrior,fury,48,27,21
Quadfather,kazzak,1529,warrior,fury,30,16,14
Totheside,blackrock,1529,warrior,fury,53,27,26
Swayzze,frostwolf,1529,warrior,fury,78,38,40
Trôth,kazzak,1528,warrior,fury,24,16,8
Griffar,malorne,1528,warrior,fury,87,43,44
Веоленс,gordunni,1527,warrior,fury,22,17,5
Jorund,archimonde,1527,warrior,fury,89,45,44
Woghard,drakthul,1526,warrior,fury,54,27,27
Cocojumbo,azuremyst,1525,warrior,fury,138,73,65
Вундеркитти,soulflayer,1525,warrior,fury,122,60,62
Nokla,kazzak,1525,warrior,fury,56,26,30
Nonow,silvermoon,1524,warrior,fury,58,26,32
Fürchtenix,blackmoore,1523,warrior,fury,54,30,24
Тегриско,goldrinn,1523,warrior,fury,102,49,53
Kåïdø,ravencrest,1522,warrior,fury,36,21,15
Добиватель,howling-fjord,1522,warrior,fury,140,75,65
Biscuitoliva,hyjal,1522,warrior,fury,42,22,20
Axislips,draenor,1522,warrior,fury,35,18,17
Ssnakeess,silvermoon,1521,warrior,fury,95,55,40
Mïîäm,archimonde,1521,warrior,fury,51,29,22
Hemèra,hyjal,1521,warrior,fury,103,53,50
Jeronimoe,blackmoore,1520,warrior,fury,41,24,17
Wowbert,frostwolf,1520,warrior,fury,54,30,24
Gachiwarri,blackhand,1520,warrior,fury,48,25,23
Рекиро,blackscar,1520,warrior,fury,47,24,23
Mirpz,doomhammer,1519,warrior,fury,47,24,23
Uncontested,argent-dawn,1518,warrior,fury,46,25,21
Гопниг,deepholm,1518,warrior,fury,70,38,32
Креспекс,gordunni,1518,warrior,fury,43,20,23
Halalmeat,minahonda,1518,warrior,fury,71,32,39
Чиллх,gordunni,1517,warrior,fury,169,89,80
Baldemort,antonidas,1517,warrior,fury,217,113,104
Shedzo,tarren-mill,1517,warrior,fury,36,18,18
Даарак,gordunni,1516,warrior,fury,40,21,19
Raizy,frostwolf,1516,warrior,fury,63,33,30
Cromvi,draenor,1515,warrior,fury,78,39,39
Чпонькмашина,soulflayer,1513,warrior,fury,152,85,67
Reapo,blackhand,1513,warrior,fury,101,56,45
Zwecko,malganis,1513,warrior,fury,30,16,14
Raicho,dentarg,1513,warrior,fury,36,18,18
Сариату,soulflayer,1513,warrior,fury,102,47,55
Ðeadyet,mugthol,1512,warrior,fury,30,16,14
Heavymetal,tarren-mill,1512,warrior,fury,90,43,47
Hobbó,draenor,1511,warrior,fury,129,63,66
Karentneuf,khaz-modan,1510,warrior,fury,41,25,16
Pokopo,blackrock,1510,warrior,fury,42,23,19
Wärlør,ravencrest,1509,warrior,fury,78,49,29
Втораянатура,howling-fjord,1508,warrior,fury,36,22,14
Ørkk,pozzo-delleternità,1508,warrior,fury,33,20,13
Deeper,twisting-nether,1508,warrior,fury,84,47,37
Bigbibbs,tarren-mill,1508,warrior,fury,122,58,64
Ravenpaw,burning-legion,1507,warrior,fury,36,27,9
Злопиканкин,gordunni,1507,warrior,fury,32,19,13
Gamöra,kirin-tor,1507,warrior,fury,104,59,45
Màlt,hyjal,1507,warrior,fury,46,20,26
Fromagekipue,draenor,1506,warrior,fury,110,59,51
Нириэла,howling-fjord,1506,warrior,fury,114,60,54
Gabbz,aggra-português,1506,warrior,fury,63,29,34
Warthur,silvermoon,1505,warrior,fury,60,32,28
Книфэк,howling-fjord,1504,warrior,fury,43,30,13
Truckfury,ravencrest,1504,warrior,fury,88,46,42
Roidspam,outland,1504,warrior,fury,76,32,44
Dizzyndumb,draenor,1503,warrior,fury,171,93,78
Gromaak,draenor,1503,warrior,fury,66,32,34
Вимор,soulflayer,1503,warrior,fury,153,73,80
Мурмадонио,soulflayer,1503,warrior,fury,78,35,43
Grumpy,lightbringer,1502,warrior,fury,50,33,17
Zupkaztrópka,burning-legion,1502,warrior,fury,109,54,55
Maruma,frostwolf,1501,warrior,fury,24,16,8
Souler,burning-legion,1501,warrior,fury,42,24,18
Røronøa,hyjal,1501,warrior,fury,69,38,31
Jarggyül,culte-de-la-rive-noire,1500,warrior,fury,36,21,15
Schuy,silvermoon,1500,warrior,fury,102,58,44
Krigarjag,kazzak,1499,warrior,fury,109,64,45
Krilza,terrordar,1499,warrior,fury,47,23,24
Пыпыса,gordunni,1499,warrior,fury,61,29,32
Crriminal,ravencrest,1498,warrior,fury,24,16,8
Divyx,tarren-mill,1498,warrior,fury,113,59,54
Sebastian,ravencrest,1498,warrior,fury,60,29,31
Ranmaru,kazzak,1498,warrior,fury,133,61,72
Darvi,burning-legion,1497,warrior,fury,48,26,22
Mezen,stormscale,1497,warrior,fury,129,67,62
Zenìa,argent-dawn,1495,warrior,fury,76,45,31
Gely,silvermoon,1495,warrior,fury,30,16,14
Stratoz,ragnaros,1495,warrior,fury,67,31,36
Mvi,frostmane,1494,warrior,fury,104,56,48
Jilias,blackrock,1494,warrior,fury,49,26,23
Vexxenn,outland,1493,warrior,fury,58,32,26
Лазба,gordunni,1493,warrior,fury,58,31,27
Traez,tarren-mill,1493,warrior,fury,133,67,66
Баджераа,soulflayer,1493,warrior,fury,88,44,44
Evrybodydown,draenor,1492,warrior,fury,148,77,71
Erosdulko,silvermoon,1492,warrior,fury,66,29,37
Forerunner,silvermoon,1490,warrior,fury,36,19,17
Youups,twisting-nether,1490,warrior,fury,75,38,37
Nemecic,arathor,1490,warrior,fury,95,48,47
Conanh,pozzo-delleternità,1490,warrior,fury,48,23,25
Noout,elune,1489,warrior,fury,60,33,27
Gypsykìng,darksorrow,1489,warrior,fury,50,27,23
Tsé,aegwynn,1489,warrior,fury,42,20,22
Gensur,skullcrusher,1488,warrior,fury,165,91,74
Cemule,doomhammer,1488,warrior,fury,90,49,41
ßloodz,hyjal,1488,warrior,fury,39,20,19
Груббоб,booty-bay,1488,warrior,fury,152,76,76
Fizzywarrior,blackmoore,1488,warrior,fury,60,29,31
Лимор,howling-fjord,1488,warrior,fury,42,16,26
Eleborn,tarren-mill,1487,warrior,fury,100,52,48
Varyian,sporeggar,1487,warrior,fury,369,191,178
Fatspacka,argent-dawn,1487,warrior,fury,38,18,20
Letzgo,ravencrest,1486,warrior,fury,30,17,13
Rommick,guldan,1486,warrior,fury,96,49,47
Штормскейл,soulflayer,1485,warrior,fury,42,24,18
Corrin,frostmourne,1485,warrior,fury,122,68,54
Nerfslam,stormscale,1485,warrior,fury,34,17,17
Ууша,soulflayer,1485,warrior,fury,59,29,30
Rimvar,alleria,1484,warrior,fury,60,28,32
Carljøhnson,dalaran,1483,warrior,fury,78,45,33
Zeliøn,elune,1483,warrior,fury,173,95,78
Thagzar,burning-legion,1483,warrior,fury,217,107,110
Grimic,quelthalas,1483,warrior,fury,45,18,27
Slidmacka,twisting-nether,1482,warrior,fury,48,28,20
Tyrâdus,kiljaeden,1482,warrior,fury,102,56,46
Азаргатан,soulflayer,1482,warrior,fury,42,22,20
Graxn,blackhand,1482,warrior,fury,245,128,117
Kyorengoku,antonidas,1482,warrior,fury,40,20,20
Grubshak,burning-legion,1482,warrior,fury,77,38,39
Thezug,twisting-nether,1482,warrior,fury,66,32,34
Warsteng,ragnaros,1481,warrior,fury,93,49,44
Zugbro,stormscale,1480,warrior,fury,66,35,31
Warorc,eredar,1480,warrior,fury,42,17,25
Gids,silvermoon,1479,warrior,fury,52,29,23
Hofmanntv,alakir,1479,warrior,fury,90,45,45
Clapkar,antonidas,1479,warrior,fury,42,19,23
Акози,fordragon,1478,warrior,fury,96,56,40
Kazzim,blackmoore,1478,warrior,fury,73,39,34
Ðønøvan,sanguino,1478,warrior,fury,139,72,67
Shadowcacau,aggra-português,1477,warrior,fury,248,127,121
Jeepzinc,blackmoore,1476,warrior,fury,72,32,40
Worgenalpha,garona,1474,warrior,fury,24,17,7
Hexj,tarren-mill,1473,warrior,fury,46,24,22
Деимосин,howling-fjord,1473,warrior,fury,87,45,42
Арристокррат,soulflayer,1473,warrior,fury,105,53,52
Ärmodäuss,norgannon,1473,warrior,fury,81,40,41
Shostka,draenor,1470,warrior,fury,34,24,10
Sorryforwhat,stormscale,1469,warrior,fury,64,34,30
Dasyana,drakthul,1468,warrior,fury,60,35,25
Трафалльгар,gordunni,1468,warrior,fury,36,18,18
Woddeywar,blackmoore,1467,warrior,fury,29,16,13
Bukisan,sylvanas,1467,warrior,fury,119,61,58
Седунг,gordunni,1467,warrior,fury,61,30,31
Raoh,malganis,1466,warrior,fury,101,48,53
Nurti,silvermoon,1465,warrior,fury,36,21,15
Rakherus,silvermoon,1465,warrior,fury,78,42,36
Búlldozér,kazzak,1465,warrior,fury,111,55,56
Dasdabane,twisting-nether,1464,warrior,fury,154,79,75
Blayr,tarren-mill,1464,warrior,fury,41,20,21
Otiep,blackmoore,1464,warrior,fury,52,25,27
Mustar,alexstrasza,1463,warrior,fury,100,57,43
Èrzà,sanguino,1463,warrior,fury,241,122,119
Straya,malorne,1463,warrior,fury,60,30,30
Mentálist,blackmoore,1463,warrior,fury,69,34,35
Krøn,stormscale,1462,warrior,fury,71,44,27
Utero,drakthul,1462,warrior,fury,36,19,17
Chrissey,argent-dawn,1462,warrior,fury,45,21,24
Astoch,outland,1462,warrior,fury,74,29,45
Syfér,grim-batol,1461,warrior,fury,88,49,39
Hrodulf,moonglade,1461,warrior,fury,83,38,45
Rheinart,nemesis,1461,warrior,fury,77,30,47
Akînos,kazzak,1460,warrior,fury,99,50,49
Broksigarr,ragnaros,1460,warrior,fury,78,39,39
Ulvenpeter,ravencrest,1460,warrior,fury,84,41,43
Horymir,ravencrest,1460,warrior,fury,39,17,22
Бшпокд,soulflayer,1459,warrior,fury,47,25,22
Tf,kazzak,1459,warrior,fury,54,21,33
Drekh,kazzak,1458,warrior,fury,54,26,28
Zaximos,twisting-nether,1458,warrior,fury,80,38,42
Kobeni,ysondre,1457,warrior,fury,50,30,20
Hidaykus,bronzebeard,1457,warrior,fury,124,65,59
Orcoddio,kazzak,1456,warrior,fury,42,20,22
Nighat,sanguino,1455,warrior,fury,95,58,37
Grâkul,twisting-nether,1455,warrior,fury,565,285,280
Irondahr,silvermoon,1455,warrior,fury,48,21,27
Skaurmosh,draenor,1454,warrior,fury,113,62,51
Boadicèe,archimonde,1453,warrior,fury,29,17,12
Faylania,tarren-mill,1453,warrior,fury,88,49,39
Lyfttokyo,tarren-mill,1453,warrior,fury,94,50,44
Craghak,twisting-nether,1453,warrior,fury,178,90,88
Dranosha,nemesis,1453,warrior,fury,45,21,24
Orengo,blackrock,1452,warrior,fury,78,50,28
Спайкуссь,goldrinn,1452,warrior,fury,149,79,70
Rum,talnivarr,1452,warrior,fury,114,59,55
Криккс,greymane,1452,warrior,fury,122,54,68
Toundrâa,archimonde,1451,warrior,fury,209,106,103
Меняло,fordragon,1450,warrior,fury,96,53,43
Vanheimsgard,ragnaros,1450,warrior,fury,60,31,29
Микермат,howling-fjord,1450,warrior,fury,104,52,52
Fuur,drakthul,1450,warrior,fury,42,17,25
Оркнарос,soulflayer,1449,warrior,fury,68,38,30
Scusi,burning-blade,1449,warrior,fury,42,23,19
Aeyon,burning-blade,1449,warrior,fury,37,17,20
Buzzingorc,tarren-mill,1448,warrior,fury,107,62,45
Doronas,der-rat-von-dalaran,1448,warrior,fury,42,21,21
Kagsteelfist,twisting-nether,1447,warrior,fury,29,16,13
Arturdayne,sanguino,1447,warrior,fury,70,38,32
Vegilhenvin,stormscale,1447,warrior,fury,151,81,70
Èscøbar,dalaran,1447,warrior,fury,61,29,32
Gollyboy,ravencrest,1447,warrior,fury,48,22,26
Buffury,twisting-nether,1446,warrior,fury,48,30,18
Sunzí,alakir,1446,warrior,fury,48,24,24
Rëvenge,burning-legion,1446,warrior,fury,129,64,65
Альмас,galakrond,1446,warrior,fury,101,47,54
Gìlgamesh,dun-modr,1444,warrior,fury,55,30,25
Rîiper,ysondre,1444,warrior,fury,42,22,20
Vandalismee,draenor,1443,warrior,fury,28,19,9
Honör,sylvanas,1443,warrior,fury,82,41,41
Зэрок,howling-fjord,1443,warrior,fury,42,21,21
Хастонер,howling-fjord,1442,warrior,fury,54,29,25
Franzbardon,archimonde,1441,warrior,fury,82,42,40
Kllinac,kazzak,1440,warrior,fury,114,65,49
Throck,drakthul,1440,warrior,fury,66,36,30
Аканок,soulflayer,1440,warrior,fury,38,18,20
Baldmano,twisting-nether,1439,warrior,fury,30,16,14
Dajnatarcze,burning-legion,1439,warrior,fury,48,25,23
Stahlhund,silvermoon,1439,warrior,fury,140,69,71
Blizo,tarren-mill,1438,warrior,fury,24,15,9
Immørtálx,tarren-mill,1438,warrior,fury,36,15,21
Andry,draenor,1438,warrior,fury,73,28,45
Filira,silvermoon,1437,warrior,fury,66,36,30
Velcorn,ravencrest,1436,warrior,fury,30,15,15
Скехит,blackscar,1435,warrior,fury,144,71,73
Ксапур,soulflayer,1434,warrior,fury,76,42,34
Chidòri,tarren-mill,1434,warrior,fury,53,22,31
Lathsmash,zenedar,1433,warrior,fury,36,18,18
Bigpapapap,kazzak,1433,warrior,fury,93,39,54
Skîêl,archimonde,1433,warrior,fury,36,15,21
Roronoâ,twisting-nether,1432,warrior,fury,22,16,6
Floppikatten,kazzak,1432,warrior,fury,24,17,7
Mômsboy,tarren-mill,1432,warrior,fury,24,15,9
Alegral,ravencrest,1432,warrior,fury,24,15,9
Dírectdash,draenor,1432,warrior,fury,59,26,33
Wätras,drakthul,1431,warrior,fury,30,16,14
Gromrigg,draenor,1431,warrior,fury,148,71,77
Jeonsoyeon,argent-dawn,1431,warrior,fury,43,16,27
Сонечко,galakrond,1430,warrior,fury,42,21,21
Føxis,aegwynn,1428,warrior,fury,22,16,6
Howdoyouløse,stormscale,1428,warrior,fury,24,15,9
Mikogød,ravencrest,1428,warrior,fury,134,69,65
Ходячийвар,gordunni,1428,warrior,fury,48,24,24
Andjuu,doomhammer,1428,warrior,fury,139,62,77
Fridaax,lightbringer,1427,warrior,fury,24,15,9
Shadroq,auchindoun,1427,warrior,fury,24,15,9
Вардеспетчер,razuvious,1426,warrior,fury,105,57,48
Dayz,draenor,1426,warrior,fury,30,15,15
Timmessenger,draenor,1425,warrior,fury,29,17,12
Каган,gordunni,1425,warrior,fury,99,54,45
Болтегар,soulflayer,1425,warrior,fury,89,48,41
Мастерпве,blackscar,1425,warrior,fury,36,17,19
Ellissari,tirion,1425,warrior,fury,53,25,28
Heinzwarrior,ravencrest,1425,warrior,fury,64,29,35
Bigrooster,argent-dawn,1424,warrior,fury,159,85,74
Mamox,archimonde,1424,warrior,fury,73,39,34
Bördz,blackhand,1424,warrior,fury,108,55,53
Лордэнгри,howling-fjord,1424,warrior,fury,65,28,37
Elayjaa,twisting-nether,1423,warrior,fury,42,24,18
Dènethor,draenor,1423,warrior,fury,134,73,61
Paynzx,blackrock,1422,warrior,fury,25,16,9
Stormboltjk,blackrock,1422,warrior,fury,24,15,9
Elénir,dalaran,1422,warrior,fury,120,64,56
Shurubel,outland,1422,warrior,fury,36,17,19
Pinkvae,doomhammer,1422,warrior,fury,47,22,25
Touguro,aggra-português,1422,warrior,fury,57,26,31
Amagaddon,draenor,1422,warrior,fury,40,18,22
Где,blackscar,1421,warrior,fury,24,15,9
Affewithwaff,blackmoore,1421,warrior,fury,69,39,30
Haewon,burning-legion,1421,warrior,fury,96,52,44
Golward,grim-batol,1421,warrior,fury,74,40,34
Itchiiz,alonsus,1421,warrior,fury,64,33,31
Siuzy,blackrock,1421,warrior,fury,30,15,15
Текайко,eversong,1421,warrior,fury,39,19,20
Hjondon,argent-dawn,1421,warrior,fury,78,36,42
Tatabaf,ysondre,1420,warrior,fury,60,32,28
Тестостеронх,soulflayer,1419,warrior,fury,24,15,9
Slaktârn,ragnaros,1419,warrior,fury,87,46,41
Анакронокс,howling-fjord,1419,warrior,fury,106,51,55
Hatefull,onyxia,1418,warrior,fury,46,20,26
Fishaco,frostwhisper,1417,warrior,fury,24,15,9
Swàck,mazrigos,1417,warrior,fury,29,17,12
Thaddaus,ravencrest,1417,warrior,fury,141,70,71
Orcarinté,draenor,1417,warrior,fury,59,26,33
Luunk,ravencrest,1416,warrior,fury,90,48,42
Thehans,grim-batol,1416,warrior,fury,198,103,95
Xanatos,khazgoroth,1416,warrior,fury,40,20,20
Prîde,kazzak,1415,warrior,fury,72,41,31
Taei,argent-dawn,1415,warrior,fury,36,20,16
Sebotagelol,twisting-nether,1415,warrior,fury,48,26,22
Popola,ravencrest,1415,warrior,fury,30,15,15
Massiveape,argent-dawn,1415,warrior,fury,36,15,21
Bluemango,ragnaros,1414,warrior,fury,60,29,31
Léonie,arakarahm,1414,warrior,fury,36,15,21
Vhargdrohpee,argent-dawn,1414,warrior,fury,53,22,31
Kragar,anetheron,1413,warrior,fury,57,34,23
Leapmaster,blackrock,1413,warrior,fury,45,22,23
Ederes,silvermoon,1412,warrior,fury,36,18,18
Naazwar,stormscale,1412,warrior,fury,30,15,15
Raaoo,blackmoore,1411,warrior,fury,60,27,33
Rerøn,dun-modr,1410,warrior,fury,36,18,18
Painswift,blackhand,1410,warrior,fury,60,28,32
Inelegant,tarren-mill,1409,warrior,fury,36,17,19
Jokis,dun-modr,1409,warrior,fury,42,19,23
Rèckless,argent-dawn,1408,warrior,fury,35,25,10
Labodor,blackhand,1408,warrior,fury,57,34,23
Вайрон,blackscar,1408,warrior,fury,108,52,56
Achérus,varimathras,1407,warrior,fury,80,37,43
Platinpunch,kazzak,1407,warrior,fury,35,16,19
Sonyd,tarren-mill,1406,warrior,fury,42,25,17
Ènma,ravencrest,1405,warrior,fury,96,46,50
Jodocus,arygos,1405,warrior,fury,34,16,18
Maclaine,ravencrest,1404,warrior,fury,48,30,18
Антурим,howling-fjord,1404,warrior,fury,40,21,19
Oesche,frostmourne,1404,warrior,fury,30,15,15
Gamepresa,silvermoon,1404,warrior,fury,67,33,34
Nmwar,turalyon,1403,warrior,fury,51,28,23
Rìsàs,draenor,1403,warrior,fury,180,89,91
Warrouner,khaz-modan,1403,warrior,fury,144,71,73
Torok,antonidas,1402,warrior,fury,36,25,11
Борзило,howling-fjord,1402,warrior,fury,36,21,15
Rarrio,kazzak,1402,warrior,fury,54,27,27
Betonica,burning-legion,1402,warrior,fury,72,33,39
Profär,archimonde,1402,warrior,fury,48,22,26
Thrallhall,kazzak,1402,warrior,fury,182,81,101
Notajinx,ravencrest,1401,warrior,fury,24,15,9
Bloodyedge,sanguino,1401,warrior,fury,128,64,64
Фузо,gordunni,1401,warrior,fury,42,20,22
Freddie,baelgun,1401,warrior,fury,36,17,19
Virgolibra,grim-batol,1401,warrior,fury,55,23,32
Raoh,blackrock,1400,warrior,fury,24,15,9
Snakewins,stormscale,1400,warrior,fury,29,18,11
Dorya,aegwynn,1400,warrior,fury,42,21,21
Auglok,twisting-nether,1400,warrior,fury,173,85,88
Bouafia,archimonde,1400,warrior,fury,47,23,24
Bergthora,antonidas,1399,warrior,fury,48,28,20
Inflacija,grim-batol,1399,warrior,fury,42,15,27
Histe,thrall,1397,warrior,fury,54,29,25
Midvînter,silvermoon,1397,warrior,fury,87,41,46
Harmstring,twisting-nether,1396,warrior,fury,63,30,33
Nellyqt,draenor,1396,warrior,fury,81,38,43
Smackaroon,draenor,1395,warrior,fury,28,16,12
Alevucerdaa,draenor,1395,warrior,fury,71,37,34
Buddysnaax,ravencrest,1395,warrior,fury,42,18,24
Bellzter,outland,1392,warrior,fury,91,50,41
Ðèxs,ravencrest,1390,warrior,fury,36,23,13
Facepálm,kazzak,1389,warrior,fury,24,15,9
Ikkr,kazzak,1389,warrior,fury,114,60,54
Keriane,garona,1389,warrior,fury,65,33,32
Gàbrânth,frostwolf,1389,warrior,fury,78,37,41
Tandrall,rexxar,1388,warrior,fury,36,15,21
Kriticah,sanguino,1387,warrior,fury,36,18,18
Cáylin,amanthul,1387,warrior,fury,68,29,39
Dgyfh,dun-morogh,1386,warrior,fury,36,20,16
Somalisktjur,tarren-mill,1386,warrior,fury,88,47,41
Reidunøks,kazzak,1386,warrior,fury,89,46,43
Klasiùs,outland,1386,warrior,fury,40,16,24
Pitii,burning-legion,1385,warrior,fury,56,32,24
Boostbywar,archimonde,1385,warrior,fury,47,22,25
Dragão,kazzak,1385,warrior,fury,72,32,40
Onga,frostwolf,1384,warrior,fury,53,28,25
Hervor,les-sentinelles,1382,warrior,fury,90,49,41
Golias,argent-dawn,1381,warrior,fury,72,40,32
Reylanor,argent-dawn,1381,warrior,fury,169,90,79
Baylis,kazzak,1380,warrior,fury,29,15,14
Qiz,silvermoon,1380,warrior,fury,167,85,82
Reccey,blackrock,1379,warrior,fury,30,16,14
Bxnx,aegwynn,1379,warrior,fury,99,46,53
Армсец,howling-fjord,1379,warrior,fury,36,16,20
Bigmercy,ragnaros,1378,warrior,fury,60,35,25
Ligthblâd,hyjal,1378,warrior,fury,63,34,29
Fîlzlaus,area-52,1378,warrior,fury,218,107,111
Tigron,burning-legion,1377,warrior,fury,54,33,21
Æsterius,blackmoore,1377,warrior,fury,101,49,52
Pistolpenny,stormscale,1376,warrior,fury,30,15,15
Suknur,silvermoon,1376,warrior,fury,98,46,52
Isnookzl,blackmoore,1376,warrior,fury,48,22,26
Shán,defias-brotherhood,1375,warrior,fury,66,36,30
Botgrinder,blackhand,1375,warrior,fury,212,112,100
Ffrostwolff,azjolnerub,1374,warrior,fury,48,28,20
Вархаус,blackscar,1373,warrior,fury,64,36,28
Дедсдрыном,howling-fjord,1372,warrior,fury,256,134,122
Saîx,garrosh,1371,warrior,fury,608,310,298
Мембершримп,howling-fjord,1371,warrior,fury,66,33,33
Calel,ravencrest,1371,warrior,fury,48,24,24
Янесними,soulflayer,1370,warrior,fury,36,20,16
Wärfäcë,blades-edge,1370,warrior,fury,94,51,43
Мутобой,soulflayer,1370,warrior,fury,74,40,34
Ralzung,twisting-nether,1370,warrior,fury,54,26,28
Жироштемп,gordunni,1369,warrior,fury,94,44,50
Проводникдуш,gordunni,1369,warrior,fury,66,25,41
Чюнилингус,soulflayer,1369,warrior,fury,43,15,28
Firebladë,ravencrest,1368,warrior,fury,41,23,18
Ryù,dun-modr,1368,warrior,fury,105,50,55
Fortressa,ravencrest,1368,warrior,fury,54,21,33
Kestialezin,archimonde,1366,warrior,fury,63,36,27
Infecwarr,stormscale,1366,warrior,fury,29,15,14
Pimagnum,stormscale,1366,warrior,fury,43,20,23
Kante,frostmane,1365,warrior,fury,36,22,14
Happyhour,sargeras,1365,warrior,fury,34,18,16
Svênsk,argent-dawn,1364,warrior,fury,50,28,22
Selkie,tirion,1364,warrior,fury,54,29,25
Darriuso,kazzak,1364,warrior,fury,129,64,65
Sasorí,blackrock,1364,warrior,fury,36,16,20
Aldébbarann,archimonde,1363,warrior,fury,74,41,33
Cathalb,quelthalas,1361,warrior,fury,40,26,14
Motorhead,tirion,1361,warrior,fury,96,53,43
Màrduk,pozzo-delleternità,1361,warrior,fury,42,23,19
Diioxyde,temple-noir,1361,warrior,fury,91,47,44
Андервульф,booty-bay,1360,warrior,fury,56,24,32
Килджаеден,deathguard,1358,warrior,fury,34,17,17
Rudor,la-croisade-écarlate,1357,warrior,fury,36,20,16
Zhyral,malygos,1357,warrior,fury,30,16,14
Antraex,zuljin,1357,warrior,fury,133,69,64
Grahatia,magtheridon,1357,warrior,fury,66,34,32
Старопрамен,thermaplugg,1357,warrior,fury,243,125,118
Jhaiteiro,dun-modr,1357,warrior,fury,111,52,59
Skefe,archimonde,1356,warrior,fury,52,31,21
Эфириад,soulflayer,1356,warrior,fury,48,26,22
Sindo,dalaran,1356,warrior,fury,42,22,20
Jakedo,outland,1356,warrior,fury,35,15,20
Ribastur,blackmoore,1355,warrior,fury,168,89,79
Grák,bronze-dragonflight,1354,warrior,fury,54,31,23
Arzes,draenor,1354,warrior,fury,71,33,38
Jkfede,nemesis,1354,warrior,fury,36,15,21
Achonar,draenor,1353,warrior,fury,49,25,24
Gimlee,kul-tiras,1352,warrior,fury,38,20,18
Calwar,sanguino,1352,warrior,fury,99,49,50
Oyrojan,blackmoore,1351,warrior,fury,58,32,26
Chadgarrosh,tarren-mill,1351,warrior,fury,71,27,44
Бьернтрел,gordunni,1350,warrior,fury,93,53,40
Offpants,drakthul,1350,warrior,fury,127,63,64
Gridra,dun-morogh,1350,warrior,fury,37,16,21
Gorgulg,stormscale,1349,warrior,fury,107,60,47
Geraltf,tarren-mill,1349,warrior,fury,90,43,47
Gëaldýr,kazzak,1348,warrior,fury,92,43,49
Flexecutie,silvermoon,1348,warrior,fury,54,25,29
Djayson,hyjal,1347,warrior,fury,41,20,21
Hagoxfit,los-errantes,1347,warrior,fury,105,51,54
Terisá,blackmoore,1347,warrior,fury,64,31,33
Tazkax,archimonde,1346,warrior,fury,95,55,40
Джэкмен,soulflayer,1346,warrior,fury,113,62,51
Murotan,dalaran,1346,warrior,fury,42,19,23
Cokeaddict,argent-dawn,1345,warrior,fury,66,32,34
Habaneroo,zuljin,1345,warrior,fury,42,15,27
Gruttak,aegwynn,1344,warrior,fury,30,18,12
Развалочка,howling-fjord,1344,warrior,fury,35,17,18
Kastraveci,outland,1343,warrior,fury,102,46,56
Zêke,thrall,1342,warrior,fury,24,18,6
Jisoowar,blackhand,1342,warrior,fury,47,18,29
Xladérz,ravencrest,1341,warrior,fury,18,14,4
Rustlord,twisting-nether,1341,warrior,fury,24,14,10
Stretch,thrall,1341,warrior,fury,31,15,16
Krieg,garrosh,1341,warrior,fury,61,21,40
Wallach,darkspear,1340,warrior,fury,24,14,10
Васильна,soulflayer,1340,warrior,fury,50,27,23
Gorroth,chamber-of-aspects,1340,warrior,fury,36,17,19
Ентил,gordunni,1340,warrior,fury,35,15,20
Валъдемар,gordunni,1339,warrior,fury,30,20,10
Kënnyföx,ysondre,1339,warrior,fury,24,14,10
Feckdech,blackrock,1338,warrior,fury,24,14,10
Brigitá,argent-dawn,1338,warrior,fury,30,14,16
Фокатопх,blackscar,1338,warrior,fury,30,14,16
Skullrage,tarren-mill,1338,warrior,fury,36,14,22
Otzmokk,blackmoore,1337,warrior,fury,39,17,22
Chillycheesy,blackmoore,1336,warrior,fury,24,14,10
Zhear,kazzak,1336,warrior,fury,83,36,47
Екзобайт,gordunni,1335,warrior,fury,23,15,8
Врэкклив,gordunni,1335,warrior,fury,71,34,37
Xurainzone,eredar,1335,warrior,fury,30,14,16
Lzdmfckmeazy,blackmoore,1334,warrior,fury,27,15,12
Toecutter,defias-brotherhood,1334,warrior,fury,33,17,16
Enderyx,blackhand,1334,warrior,fury,125,60,65
Zân,stormscale,1333,warrior,fury,30,16,14
Hirbz,silvermoon,1333,warrior,fury,66,34,32
Taoke,ravencrest,1333,warrior,fury,30,14,16
Elpap,draenor,1333,warrior,fury,73,34,39
Fivejee,ravencrest,1331,warrior,fury,48,26,22
Напутанность,soulflayer,1331,warrior,fury,48,24,24
Symphius,ravencrest,1330,warrior,fury,30,14,16
Ларджсворд,eversong,1329,warrior,fury,88,46,42
Kundrak,blackhand,1329,warrior,fury,79,40,39
Topfury,stormscale,1329,warrior,fury,86,41,45
Kelmyst,ragnaros,1329,warrior,fury,39,18,21
Tharokk,blackmoore,1328,warrior,fury,84,44,40
Ganaroth,tarren-mill,1328,warrior,fury,42,21,21
Коньвпальто,greymane,1327,warrior,fury,72,36,36
Qvate,twisting-nether,1327,warrior,fury,80,36,44
Moggorr,nemesis,1326,warrior,fury,58,30,28
Джелорд,howling-fjord,1326,warrior,fury,30,14,16
Thraxus,azjolnerub,1325,warrior,fury,42,23,19
Дизроуз,gordunni,1325,warrior,fury,86,45,41
Wanzzeur,hyjal,1325,warrior,fury,63,31,32
Роконишу,gordunni,1324,warrior,fury,78,42,36
Behemoht,tarren-mill,1324,warrior,fury,108,55,53
Тцара,howling-fjord,1324,warrior,fury,40,19,21
Ochocinco,quelthalas,1324,warrior,fury,111,51,60
Skillclapped,ravencrest,1323,warrior,fury,27,15,12
Свободатоп,howling-fjord,1323,warrior,fury,30,16,14
Nazdrago,draenor,1323,warrior,fury,30,14,16
Грош,deepholm,1322,warrior,fury,24,14,10
Зэйсс,gordunni,1321,warrior,fury,30,14,16
Откат,grom,1321,warrior,fury,119,55,64
Brúgar,antonidas,1321,warrior,fury,42,18,24
Temprament,ravencrest,1320,warrior,fury,78,43,35
Tato,frostmourne,1320,warrior,fury,58,28,30
Astreimehns,sanguino,1319,warrior,fury,24,14,10
Кроуфури,gordunni,1318,warrior,fury,54,31,23
Exeter,nagrand,1318,warrior,fury,78,41,37
Ayyub,antonidas,1318,warrior,fury,33,16,17
Lasanká,sylvanas,1318,warrior,fury,36,17,19
Конвержн,howling-fjord,1317,warrior,fury,30,17,13
Watntietnn,burning-blade,1317,warrior,fury,61,32,29
Borntothis,zuljin,1317,warrior,fury,134,70,64
Xsasuke,ragnaros,1317,warrior,fury,36,17,19
Razza,ravencrest,1317,warrior,fury,49,23,26
Furiousspear,tarren-mill,1317,warrior,fury,54,21,33
Barragan,sanguino,1316,warrior,fury,41,24,17
Kokaspincha,aggra-português,1316,warrior,fury,30,15,15
Thørïn,dun-modr,1316,warrior,fury,30,14,16
Stuck,argent-dawn,1316,warrior,fury,30,14,16
Bigbanz,outland,1316,warrior,fury,30,14,16
Hellguarrd,silvermoon,1316,warrior,fury,65,29,36
Getonxnxx,quelthalas,1316,warrior,fury,67,28,39
Саурканг,howling-fjord,1316,warrior,fury,52,21,31
Traflgardlaw,kazzak,1315,warrior,fury,49,23,26
Fortësque,uldaman,1315,warrior,fury,59,22,37
Xtu,kazzak,1314,warrior,fury,27,16,11
Kydecnick,kazzak,1314,warrior,fury,245,128,117
Realz,malganis,1314,warrior,fury,119,60,59
Mortalclaw,kazzak,1314,warrior,fury,135,65,70
Zíreael,ravencrest,1314,warrior,fury,72,34,38
Vivaladirt,argent-dawn,1313,warrior,fury,36,17,19
Beogor,grim-batol,1313,warrior,fury,35,14,21
Покручука,blackscar,1312,warrior,fury,24,15,9
Kaeo,lordaeron,1311,warrior,fury,48,22,26
Xugzug,blackmoore,1311,warrior,fury,54,24,30
Ælvstan,argent-dawn,1310,warrior,fury,59,30,29
Драмур,gordunni,1310,warrior,fury,52,18,34
Bror,dentarg,1308,warrior,fury,24,15,9
Эрисихтон,soulflayer,1308,warrior,fury,28,15,13
Deusi,garrosh,1308,warrior,fury,117,62,55
Ghoster,kazzak,1308,warrior,fury,42,19,23
Izmadfurax,archimonde,1307,warrior,fury,130,71,59
Drswing,kazzak,1307,warrior,fury,87,40,47
Cuuz,outland,1307,warrior,fury,64,29,35
Thors,deathwing,1306,warrior,fury,208,108,100
Vohnkar,emeriss,1306,warrior,fury,87,40,47
Килоагр,gordunni,1306,warrior,fury,48,19,29
Кимиюки,gordunni,1306,warrior,fury,48,17,31
Agamemnon,frostmane,1305,warrior,fury,51,25,26
Slapperr,frostwolf,1305,warrior,fury,41,20,21
Gudvin,terokkar,1304,warrior,fury,117,63,54
Goldenarm,doomhammer,1304,warrior,fury,123,66,57
Eliyahu,ghostlands,1304,warrior,fury,48,22,26
Grimli,burning-legion,1303,warrior,fury,42,24,18
Kaerz,ysondre,1302,warrior,fury,60,33,27
Blairne,burning-blade,1302,warrior,fury,48,22,26
Sørø,sargeras,1301,warrior,fury,82,44,38
Сэрг,gordunni,1301,warrior,fury,48,20,28
Кровостокхх,gordunni,1301,warrior,fury,42,17,25
Griswarr,draenor,1300,warrior,fury,26,15,11
Reckless,tarren-mill,1300,warrior,fury,42,22,20
Tragix,hyjal,1300,warrior,fury,42,18,24
Умфи,howling-fjord,1299,warrior,fury,83,46,37
Dyspó,sanguino,1298,warrior,fury,52,23,29
Neíd,malganis,1297,warrior,fury,24,14,10
Сэч,gordunni,1296,warrior,fury,24,16,8
Thôras,anetheron,1296,warrior,fury,35,21,14
Warinator,ravencrest,1296,warrior,fury,109,58,51
Oughn,silvermoon,1295,warrior,fury,147,73,74
Аштау,howling-fjord,1295,warrior,fury,208,100,108
Варёнок,soulflayer,1294,warrior,fury,79,44,35
Guruw,tarren-mill,1293,warrior,fury,132,66,66
Arinator,les-sentinelles,1293,warrior,fury,42,19,23
Феоника,azuregos,1292,warrior,fury,76,39,37
Bjorsert,dun-modr,1292,warrior,fury,58,24,34
Exsomnis,outland,1291,warrior,fury,30,17,13
Drexx,ragnaros,1291,warrior,fury,40,21,19
Арестант,soulflayer,1291,warrior,fury,137,69,68
Larrydankin,draenor,1289,warrior,fury,95,54,41
Машамеч,blackscar,1289,warrior,fury,84,42,42
Ratko,auchindoun,1289,warrior,fury,54,27,27
Hudsonn,sylvanas,1289,warrior,fury,29,14,15
Shkørwi,drakthul,1289,warrior,fury,48,22,26
Eyolf,thunderhorn,1287,warrior,fury,66,28,38
Unchåined,burning-legion,1285,warrior,fury,117,59,58
Mouliard,archimonde,1285,warrior,fury,36,17,19
Fraeydís,silvermoon,1285,warrior,fury,57,26,31
Lippir,stormrage,1284,warrior,fury,74,40,34
Bronix,blackrock,1284,warrior,fury,42,14,28
Rqyz,tarren-mill,1283,warrior,fury,36,21,15
Krasark,blackmoore,1283,warrior,fury,54,23,31
Sammäel,eldrethalas,1281,warrior,fury,36,19,17
Sway,eonar,1281,warrior,fury,289,147,142
Megaboss,blackrock,1281,warrior,fury,44,20,24
Azëlls,archimonde,1280,warrior,fury,42,19,23
Wotulko,blackrock,1279,warrior,fury,29,17,12
Optimai,kazzak,1279,warrior,fury,174,84,90
Zedori,stormrage,1279,warrior,fury,36,15,21
Juggernot,archimonde,1278,warrior,fury,43,24,19
Unn,ragnaros,1278,warrior,fury,99,49,50
Skullfondler,argent-dawn,1278,warrior,fury,30,14,16
Монгуру,howling-fjord,1278,warrior,fury,53,24,29
Oglisten,archimonde,1277,warrior,fury,30,15,15
Armirtile,twisting-nether,1277,warrior,fury,36,17,19
Andij,blackmoore,1276,warrior,fury,66,33,33
Houndburger,drakthul,1276,warrior,fury,90,38,52
Tdanielt,burning-legion,1274,warrior,fury,165,87,78
Fightinghell,stormrage,1274,warrior,fury,54,26,28
Exeldians,burning-legion,1273,warrior,fury,20,14,6
Bluntsword,twisting-nether,1273,warrior,fury,30,19,11
Fenr,sanguino,1272,warrior,fury,52,34,18
Gardom,doomhammer,1272,warrior,fury,114,66,48
Darzuh,dun-modr,1272,warrior,fury,60,29,31
Furyre,ysondre,1271,warrior,fury,37,17,20
Honeymew,draenor,1271,warrior,fury,66,27,39
Hulflon,pozzo-delleternità,1270,warrior,fury,30,18,12
Pufy,ravencrest,1270,warrior,fury,73,40,33
Céck,ravencrest,1270,warrior,fury,58,29,29
Hatenest,argent-dawn,1269,warrior,fury,408,196,212
Ipes,blackmoore,1268,warrior,fury,55,28,27
Ninja,bronze-dragonflight,1268,warrior,fury,98,46,52
Akkamagosh,argent-dawn,1266,warrior,fury,70,31,39
Fvkundercutt,xavius,1265,warrior,fury,42,26,16
Ausrastus,blackhand,1265,warrior,fury,34,15,19
Azzog,archimonde,1264,warrior,fury,92,51,41
Doryen,blackmoore,1264,warrior,fury,36,17,19
Shabir,sylvanas,1263,warrior,fury,109,52,57
Sunakaary,drakthul,1262,warrior,fury,35,23,12
Zerm,draenor,1262,warrior,fury,24,15,9
Quigatron,frostmane,1262,warrior,fury,71,40,31
Banecrush,silvermoon,1262,warrior,fury,54,30,24
Gritzi,dragonblight,1262,warrior,fury,60,29,31
Säl,ragnaros,1261,warrior,fury,121,65,56
Wilæm,ravencrest,1261,warrior,fury,71,34,37
Бормормуш,gordunni,1261,warrior,fury,73,30,43
Schmetterina,proudmoore,1260,warrior,fury,120,65,55
Anubisra,alakir,1260,warrior,fury,56,29,27
Bobzillah,kazzak,1259,warrior,fury,24,16,8
Акурра,gordunni,1259,warrior,fury,26,14,12
Delinde,cthun,1259,warrior,fury,182,91,91
Ztranger,the-maelstrom,1257,warrior,fury,36,17,19
Hazarku,colinas-pardas,1257,warrior,fury,49,22,27
Ivâar,archimonde,1256,warrior,fury,26,14,12
Zuchtrind,blackrock,1256,warrior,fury,39,19,20
Lacrima,earthen-ring,1256,warrior,fury,81,34,47
Dundulinka,outland,1255,warrior,fury,46,17,29
Saey,malorne,1254,warrior,fury,110,55,55
Насувака,deathguard,1254,warrior,fury,59,29,30
Теокрафт,howling-fjord,1254,warrior,fury,62,30,32
Toughwar,tarren-mill,1253,warrior,fury,66,35,31
Mutuh,ravenholdt,1253,warrior,fury,48,24,24
Лимэй,blackscar,1249,warrior,fury,51,20,31
Zaithironwar,tarren-mill,1248,warrior,fury,25,14,11
Tarrior,shattered-halls,1248,warrior,fury,159,78,81
Panexecute,ragnaros,1248,warrior,fury,36,16,20
Рагнарульв,gordunni,1248,warrior,fury,36,15,21
Мигнт,blackscar,1247,warrior,fury,18,13,5
Фокатоп,blackscar,1247,warrior,fury,24,13,11
Stóna,blackmoore,1247,warrior,fury,36,13,23
Kapuchino,twisting-nether,1246,warrior,fury,24,13,11
Larvalis,blackmoore,1246,warrior,fury,95,43,52
Tagavaga,tarren-mill,1246,warrior,fury,60,26,34
Avgålöfvén,stormscale,1245,warrior,fury,24,13,11
Thorock,magtheridon,1245,warrior,fury,24,13,11
Wariio,khaz-modan,1245,warrior,fury,71,38,33
Номер,eversong,1245,warrior,fury,262,127,135
Poniroula,burning-legion,1245,warrior,fury,32,14,18
Yosiwa,draenor,1243,warrior,fury,24,13,11
Барабумм,soulflayer,1243,warrior,fury,125,63,62
Nuijara,blackrock,1243,warrior,fury,54,24,30
Draxxann,ravencrest,1242,warrior,fury,91,54,37
Innos,gorgonnash,1242,warrior,fury,38,21,17
Xxeqtr,kazzak,1242,warrior,fury,24,13,11
Mertik,twisting-nether,1242,warrior,fury,24,13,11
Kurzen,voljin,1242,warrior,fury,62,33,29
Freemoney,blackrock,1242,warrior,fury,30,13,17
Schaufelørc,blackrock,1242,warrior,fury,30,13,17
Ragnurk,draenor,1242,warrior,fury,60,20,40
Turmund,turalyon,1241,warrior,fury,42,23,19
Tàuruss,blackhand,1241,warrior,fury,40,21,19
Слайдус,gordunni,1241,warrior,fury,68,34,34
Рсдрпб,eversong,1241,warrior,fury,30,15,15
Timidman,kazzak,1240,warrior,fury,24,13,11
Kvintor,bloodscalp,1240,warrior,fury,136,70,66
Bitololz,kaelthas,1239,warrior,fury,36,17,19
Xqtwar,blackhand,1239,warrior,fury,30,13,17
Whimbux,stormscale,1239,warrior,fury,96,40,56
Contrariety,ravencrest,1238,warrior,fury,71,43,28
Ptp,argent-dawn,1238,warrior,fury,24,13,11
Balsor,frostmane,1238,warrior,fury,34,17,17
Groll,aegwynn,1238,warrior,fury,30,13,17
Toporceanul,kazzak,1236,warrior,fury,70,27,43
Slûff,draenor,1235,warrior,fury,24,13,11
Renji,proudmoore,1234,warrior,fury,18,13,5
Valhrann,dalaran,1234,warrior,fury,54,28,26
Krionos,ravencrest,1233,warrior,fury,22,14,8
Kurko,blackmoore,1233,warrior,fury,83,37,46
Dxc,blackhand,1233,warrior,fury,30,13,17
Nykyro,draenor,1232,warrior,fury,105,53,52
Йомхар,howling-fjord,1231,warrior,fury,72,32,40
Rimadi,silvermoon,1231,warrior,fury,36,13,23
Блиблоб,eversong,1230,warrior,fury,47,26,21
Claptheheal,silvermoon,1230,warrior,fury,24,13,11
Стано,booty-bay,1230,warrior,fury,44,23,21
Batourga,marécage-de-zangar,1230,warrior,fury,49,21,28
Madfu,draenor,1229,warrior,fury,36,19,17
Федорссумкин,gordunni,1229,warrior,fury,74,34,40
Gvngx,zuljin,1229,warrior,fury,77,34,43
Димаказнь,gordunni,1229,warrior,fury,30,13,17
Onyi,onyxia,1228,warrior,fury,36,18,18
Viqi,alleria,1228,warrior,fury,30,13,17
Szpindah,ragnaros,1228,warrior,fury,36,13,23
Firience,silvermoon,1226,warrior,fury,24,13,11
Runkkusukka,defias-brotherhood,1224,warrior,fury,95,50,45
Зулльварн,thermaplugg,1224,warrior,fury,36,13,23
Noseringer,frostwolf,1223,warrior,fury,21,15,6
Lâmy,khaz-modan,1223,warrior,fury,125,58,67
Bløckqt,archimonde,1223,warrior,fury,30,13,17
Stormíe,outland,1221,warrior,fury,24,13,11
Rayeron,sanguino,1221,warrior,fury,97,48,49
Corpsecount,stormrage,1221,warrior,fury,72,31,41
Kebra,blackmoore,1220,warrior,fury,87,49,38
Dríppy,aegwynn,1220,warrior,fury,36,20,16
Jasperr,nemesis,1220,warrior,fury,153,76,77
Bolss,silvermoon,1220,warrior,fury,79,32,47
Экзэкутэр,howling-fjord,1219,warrior,fury,18,13,5
Familyguy,sylvanas,1219,warrior,fury,41,21,20
Ouryuu,hyjal,1218,warrior,fury,56,25,31
Gèrralt,hyjal,1218,warrior,fury,59,21,38
Riptide,aggra-português,1216,warrior,fury,40,21,19
Sjekac,stormscale,1216,warrior,fury,58,29,29
Копенгаген,ashenvale,1215,warrior,fury,87,49,38
Dabliu,burning-legion,1215,warrior,fury,102,48,54
Imora,silvermoon,1214,warrior,fury,74,37,37
Ульданианин,gordunni,1213,warrior,fury,30,15,15
Warrmax,darksorrow,1211,warrior,fury,108,55,53
Артуша,blackscar,1211,warrior,fury,48,24,24
Illydan,turalyon,1211,warrior,fury,41,20,21
Vagor,draenor,1211,warrior,fury,35,16,19
Lissanna,ravencrest,1207,warrior,fury,24,14,10
Marklarstar,ragnaros,1207,warrior,fury,96,46,50
Warriorc,hellfire,1205,warrior,fury,48,26,22
Garmal,nemesis,1205,warrior,fury,30,16,14
Paralel,tarren-mill,1205,warrior,fury,56,29,27
Skeeby,ravencrest,1205,warrior,fury,30,13,17
Yenïa,argent-dawn,1205,warrior,fury,33,14,19
Варгуш,ashenvale,1205,warrior,fury,35,13,22
Stweye,frostmane,1203,warrior,fury,24,13,11
Mfull,tarren-mill,1203,warrior,fury,63,30,33
Grimdur,kirin-tor,1203,warrior,fury,225,107,118
Варнубар,eversong,1202,warrior,fury,66,32,34
Ragecrit,ragnaros,1202,warrior,fury,34,14,20
Vhy,antonidas,1201,warrior,fury,48,22,26
Dmskodame,doomhammer,1201,warrior,fury,42,18,24
Greensmash,hyjal,1201,warrior,fury,104,44,60
Bwonsàmdí,ragnaros,1200,warrior,fury,48,16,32
Sinesterá,blackhand,1199,warrior,fury,67,31,36
Jasonnes,argent-dawn,1198,warrior,fury,52,23,29
Отнулядоста,gordunni,1198,warrior,fury,61,25,36
Драбун,howling-fjord,1197,warrior,fury,30,14,16
Assyriá,ravencrest,1196,warrior,fury,23,13,10
Drolaret,zuljin,1196,warrior,fury,63,29,34
Buzzingwarr,tarren-mill,1195,warrior,fury,126,58,68
Djiozz,khaz-modan,1194,warrior,fury,65,29,36
Blaying,ravencrest,1192,warrior,fury,23,13,10
Saykage,blackhand,1191,warrior,fury,48,24,24
Prime,outland,1191,warrior,fury,48,21,27
Cogneur,archimonde,1191,warrior,fury,42,16,26
Grumpwarrior,draenor,1191,warrior,fury,54,20,34
Daramir,turalyon,1189,warrior,fury,54,25,29
Agitoyami,defias-brotherhood,1187,warrior,fury,127,66,61
Mocagressiva,draenor,1187,warrior,fury,48,23,25
Manston,sanguino,1187,warrior,fury,36,13,23
Гацс,soulflayer,1186,warrior,fury,28,14,14
Азктор,soulflayer,1186,warrior,fury,35,15,20
Humanoç,dun-modr,1186,warrior,fury,37,15,22
Iamanorc,silvermoon,1185,warrior,fury,37,20,17
Nubá,bronze-dragonflight,1185,warrior,fury,204,108,96
Элейд,thermaplugg,1184,warrior,fury,42,22,20
Ragedotcom,archimonde,1184,warrior,fury,122,61,61
Truedamagé,blackrock,1184,warrior,fury,42,20,22
Sadgex,kazzak,1184,warrior,fury,29,13,16
Moknar,alonsus,1184,warrior,fury,71,29,42
Эпитафорх,blackscar,1181,warrior,fury,22,13,9
Morishcrak,kazzak,1181,warrior,fury,39,14,25
Leonidæs,frostwolf,1180,warrior,fury,66,30,36
Barsok,sanguino,1179,warrior,fury,66,29,37
Ryûjin,draenor,1178,warrior,fury,54,26,28
Vyseniä,dalaran,1178,warrior,fury,30,14,16
Суммрак,grom,1178,warrior,fury,41,17,24
Дерзкаяфурия,gordunni,1177,warrior,fury,41,17,24
Coyle,eredar,1176,warrior,fury,246,113,133
Thibow,hyjal,1175,warrior,fury,66,35,31
Lâppön,blackmoore,1174,warrior,fury,30,16,14
Garosh,drakthul,1173,warrior,fury,72,39,33
Hangovar,thrall,1172,warrior,fury,45,21,24
Coasterupte,draenor,1169,warrior,fury,134,60,74
Осгаард,gordunni,1169,warrior,fury,60,25,35
Tejecuto,sanguino,1166,warrior,fury,24,13,11
Berseak,dalaran,1166,warrior,fury,43,22,21
Суферна,howling-fjord,1166,warrior,fury,33,16,17
Fatbeard,twilights-hammer,1165,warrior,fury,42,19,23
Xentos,kirin-tor,1163,warrior,fury,38,21,17
Greatsword,turalyon,1162,warrior,fury,24,14,10
Grobler,blackhand,1161,warrior,fury,54,25,29
Иллидансер,howling-fjord,1161,warrior,fury,42,19,23
Weezing,argent-dawn,1160,warrior,fury,27,13,14
Shieldlord,kazzak,1160,warrior,fury,160,73,87
Sairos,kirin-tor,1158,warrior,fury,174,92,82
Soldegaard,drakthul,1158,warrior,fury,26,13,13
Gahal,tyrande,1157,warrior,fury,54,22,32
Ragnòk,eredar,1153,warrior,fury,78,36,42
Devìlscandy,stormscale,1152,warrior,fury,18,12,6
Trâshwarriør,blackhand,1152,warrior,fury,18,12,6
Naronnas,drakthul,1151,warrior,fury,18,12,6
Kotechnik,ysondre,1151,warrior,fury,18,12,6
Uselessblâme,archimonde,1151,warrior,fury,18,12,6
Whýsøsîlêñt,ragnaros,1151,warrior,fury,18,12,6
Midly,hellfire,1151,warrior,fury,54,26,28
Исскатель,gordunni,1150,warrior,fury,12,12,0
Denwar,ravencrest,1150,warrior,fury,36,13,23
Dramiél,tarren-mill,1148,warrior,fury,29,15,14
Ranndall,blackrock,1148,warrior,fury,62,31,31
Talanora,ravencrest,1147,warrior,fury,18,12,6
Undeadboii,ravencrest,1147,warrior,fury,24,12,12
Zercher,tarren-mill,1147,warrior,fury,30,12,18
Evilez,ravencrest,1146,warrior,fury,18,12,6
Litkis,silvermoon,1146,warrior,fury,101,59,42
Melferas,silvermoon,1146,warrior,fury,89,46,43
Thunderage,stormscale,1146,warrior,fury,44,20,24
Sabijach,kazzak,1145,warrior,fury,24,12,12
Ragecap,rexxar,1145,warrior,fury,50,21,29
Schmackes,terrordar,1144,warrior,fury,18,12,6
Ragnarr,ravencrest,1144,warrior,fury,24,12,12
Neoballâc,uldum,1144,warrior,fury,24,12,12
Wåks,dalaran,1144,warrior,fury,24,12,12
Gortigard,archimonde,1144,warrior,fury,81,35,46
Белхэнд,soulflayer,1143,warrior,fury,24,12,12
Krigerhans,ravencrest,1142,warrior,fury,24,12,12
Ragnacore,ravencrest,1142,warrior,fury,24,12,12
Kaazzuraa,hyjal,1142,warrior,fury,24,12,12
Waroworgen,terokkar,1142,warrior,fury,26,12,14
Marlßørø,twisting-nether,1141,warrior,fury,24,12,12
Инфиль,howling-fjord,1140,warrior,fury,30,12,18
Têtebruler,archimonde,1139,warrior,fury,24,12,12
Axamo,ragnaros,1139,warrior,fury,24,12,12
Крешер,howling-fjord,1138,warrior,fury,86,36,50
Sparkss,sylvanas,1137,warrior,fury,30,15,15
Ratgor,twisting-nether,1137,warrior,fury,24,12,12
Moustachu,kirin-tor,1137,warrior,fury,51,25,26
Zpárta,ragnaros,1136,warrior,fury,47,31,16
Edwsan,cthun,1136,warrior,fury,84,46,38
Sadex,blackmoore,1136,warrior,fury,24,13,11
Nurychïc,twisting-nether,1135,warrior,fury,30,15,15
Жужащий,howling-fjord,1135,warrior,fury,158,71,87
Kharzak,ungoro,1134,warrior,fury,29,16,13
Madhardy,chamber-of-aspects,1133,warrior,fury,24,12,12
Torinborison,ysera,1132,warrior,fury,18,12,6
Nakkelam,twisting-nether,1131,warrior,fury,18,12,6
Reinharth,dalaran,1131,warrior,fury,48,26,22
Sekecmazec,turalyon,1129,warrior,fury,63,22,41
Pybal,stormscale,1128,warrior,fury,18,12,6
Justviktor,ravencrest,1128,warrior,fury,99,45,54
Tavywar,the-maelstrom,1128,warrior,fury,82,37,45
Xiszos,ravencrest,1126,warrior,fury,30,12,18
Sadjoke,draenor,1125,warrior,fury,30,13,17
Axtuz,malorne,1124,warrior,fury,36,13,23
Nukêr,dun-modr,1123,warrior,fury,90,34,56
Arnoldalois,neptulon,1122,warrior,fury,99,44,55
Well,kult-der-verdammten,1121,warrior,fury,24,12,12
Damonx,draenor,1121,warrior,fury,84,40,44
Фейловый,gordunni,1121,warrior,fury,30,12,18
Khaalo,blackhand,1120,warrior,fury,32,19,13
Kirkwood,terokkar,1120,warrior,fury,77,34,43
Itimu,blackrock,1119,warrior,fury,44,26,18
Ânaxi,silvermoon,1118,warrior,fury,24,14,10
Téldrus,blackrock,1116,warrior,fury,18,12,6
Kharmog,hyjal,1116,warrior,fury,56,23,33
Селттик,grom,1115,warrior,fury,95,50,45
Warnox,dun-modr,1113,warrior,fury,60,31,29
Ganian,stormscale,1113,warrior,fury,30,14,16
Pahanâ,arygos,1111,warrior,fury,24,12,12
Fetidoman,zuljin,1110,warrior,fury,27,13,14
Gagatchar,die-silberne-hand,1110,warrior,fury,38,14,24
Lobotomywar,drakthul,1109,warrior,fury,36,24,12
Subot,frostmane,1109,warrior,fury,20,12,8
Warriorgaro,khaz-modan,1109,warrior,fury,72,36,36
Sabrewølf,blackmoore,1107,warrior,fury,106,54,52
Houftasir,eredar,1106,warrior,fury,45,19,26
Спунжио,ashenvale,1105,warrior,fury,54,28,26
Zetsurin,sylvanas,1105,warrior,fury,66,23,43
Hágríd,ragnaros,1103,warrior,fury,36,13,23
Vazzile,silvermoon,1100,warrior,fury,65,34,31
Azahi,dun-morogh,1100,warrior,fury,29,12,17
Bozcô,draenor,1099,warrior,fury,23,12,11
Tatya,drekthar,1098,warrior,fury,27,13,14
Cmonbrah,ravencrest,1097,warrior,fury,21,13,8
Красемир,deepholm,1097,warrior,fury,47,23,24
Wrathchild,blackrock,1097,warrior,fury,41,18,23
Telmó,blackhand,1095,warrior,fury,72,40,32
Chloade,burning-legion,1095,warrior,fury,108,55,53
Oxascand,kazzak,1095,warrior,fury,117,50,67
Аесоо,gordunni,1094,warrior,fury,281,133,148
Macgull,ysondre,1092,warrior,fury,90,42,48
Mistawolf,ravencrest,1090,warrior,fury,30,16,14
Exhumator,blackhand,1090,warrior,fury,84,32,52
Shalren,nordrassil,1087,warrior,fury,62,32,30
Armoricus,argent-dawn,1084,warrior,fury,54,30,24
Evasni,magtheridon,1082,warrior,fury,20,13,7
Onslaught,pozzo-delleternità,1082,warrior,fury,64,29,35
Gylfanders,the-maelstrom,1081,warrior,fury,22,12,10
Midasch,dun-morogh,1080,warrior,fury,60,27,33
Killpieric,krasus,1072,warrior,fury,90,38,52
Garstus,die-silberne-hand,1072,warrior,fury,66,22,44
Солоовей,gordunni,1071,warrior,fury,88,42,46
Зарган,howling-fjord,1071,warrior,fury,56,20,36
Moonkak,hyjal,1070,warrior,fury,90,40,50
Tiapollo,dun-modr,1068,warrior,fury,58,19,39
Xienia,dun-morogh,1065,warrior,fury,142,63,79
Помойник,gordunni,1064,warrior,fury,326,171,155
Serpentheron,stormscale,1064,warrior,fury,73,35,38
Giimlii,hyjal,1060,warrior,fury,36,12,24
Luphrek,ysondre,1056,warrior,fury,30,11,19
Зенобий,gordunni,1055,warrior,fury,12,11,1
Chíppéd,draenor,1055,warrior,fury,18,11,7
Bersekerstan,tarren-mill,1055,warrior,fury,18,11,7
Maroux,malganis,1055,warrior,fury,18,11,7
Sparkzu,twisting-nether,1055,warrior,fury,18,11,7
Wardropeeh,argent-dawn,1055,warrior,fury,30,15,15
Gîdra,stormscale,1054,warrior,fury,18,11,7
Мираксус,soulflayer,1054,warrior,fury,18,11,7
Prox,blackrock,1054,warrior,fury,18,11,7
Grimilax,hellscream,1054,warrior,fury,18,11,7
Yildiz,kargath,1054,warrior,fury,197,100,97
Oowar,burning-legion,1054,warrior,fury,24,11,13
Manneen,outland,1054,warrior,fury,108,45,63
Shalaceco,nemesis,1054,warrior,fury,71,24,47
Snuzzygeezer,ravencrest,1053,warrior,fury,18,11,7
Rahtok,blackrock,1053,warrior,fury,18,11,7
Circumcist,dragonblight,1053,warrior,fury,18,11,7
Oksimbillah,blackrock,1053,warrior,fury,24,11,13
Byedriver,kazzak,1053,warrior,fury,24,11,13
Zalumorth,magtheridon,1052,warrior,fury,79,41,38
Arta,arthas,1052,warrior,fury,72,34,38
Kridi,stormreaver,1051,warrior,fury,18,11,7
Aìrwave,blackmoore,1051,warrior,fury,18,11,7
Míngxuan,tarren-mill,1051,warrior,fury,18,11,7
Kamatâ,kazzak,1051,warrior,fury,24,11,13
Elainax,eredar,1051,warrior,fury,24,11,13
Punks,ravencrest,1051,warrior,fury,24,11,13
Jesster,blackmoore,1050,warrior,fury,18,11,7
Хэлвид,soulflayer,1050,warrior,fury,24,11,13
Kuangbaozhan,dun-morogh,1050,warrior,fury,30,11,19
Геленфорд,soulflayer,1049,warrior,fury,24,11,13
Keilore,hyjal,1049,warrior,fury,24,11,13
Feydal,thrall,1049,warrior,fury,173,73,100
Obox,ravencrest,1048,warrior,fury,18,11,7
Algethar,archimonde,1046,warrior,fury,18,11,7
Prater,draenor,1046,warrior,fury,27,12,15
Áosr,ravencrest,1045,warrior,fury,35,21,14
Kratosz,bloodscalp,1045,warrior,fury,157,84,73
Waltharius,das-syndikat,1045,warrior,fury,96,48,48
Bealin,the-venture-co,1045,warrior,fury,24,11,13
Koliastra,magtheridon,1044,warrior,fury,27,12,15
Whysospicey,lightbringer,1043,warrior,fury,21,12,9
Eliyel,silvermoon,1042,warrior,fury,18,11,7
Himä,burning-legion,1042,warrior,fury,18,11,7
Swizzlecrack,draenor,1042,warrior,fury,24,11,13
Vàriam,argent-dawn,1042,warrior,fury,24,11,13
Artheim,silvermoon,1042,warrior,fury,42,11,31
Bleckwarrior,ravencrest,1040,warrior,fury,16,12,4
Romanondo,doomhammer,1039,warrior,fury,18,11,7
Seka,nozdormu,1036,warrior,fury,510,259,251
Жиестьдон,soulflayer,1036,warrior,fury,74,35,39
Galdir,ravencrest,1035,warrior,fury,54,28,26
Sonnyammo,turalyon,1034,warrior,fury,80,38,42
Златоцветта,gordunni,1034,warrior,fury,24,11,13
Bootyclapper,runetotem,1032,warrior,fury,18,11,7
Afofaifadx,cthun,1029,warrior,fury,30,11,19
Каргрогар,eversong,1027,warrior,fury,30,11,19
Anastor,ragnaros,1026,warrior,fury,24,11,13
Khòrne,sanguino,1025,warrior,fury,30,15,15
Kuljapro,ravencrest,1025,warrior,fury,42,19,23
Sazox,drakthul,1023,warrior,fury,17,11,6
Vardias,pozzo-delleternità,1022,warrior,fury,22,11,11
Zyzie,argent-dawn,1020,warrior,fury,29,11,18
Amsti,doomhammer,1019,warrior,fury,24,16,8
Ogerit,blackmoore,1019,warrior,fury,117,62,55
Bogangains,outland,1018,warrior,fury,20,12,8
Whiteebeardd,draenor,1018,warrior,fury,156,76,80
Громорашман,grom,1017,warrior,fury,20,12,8
Kabbuki,die-aldor,1015,warrior,fury,58,33,25
Sperta,frostmourne,1011,warrior,fury,59,31,28
Manfred,burning-legion,1009,warrior,fury,18,11,7
Hellscreamer,auchindoun,1008,warrior,fury,17,11,6
Рыджеральд,howling-fjord,1008,warrior,fury,51,24,27
Богадорога,howling-fjord,1006,warrior,fury,17,11,6
Wardén,argent-dawn,1006,warrior,fury,54,21,33
Zoink,burning-blade,1005,warrior,fury,21,11,10
Nogo,nagrand,1004,warrior,fury,62,36,26
Бодяня,gordunni,1003,warrior,fury,30,11,19
Surp,hyjal,1000,warrior,fury,72,28,44
Evilmowaio,tarren-mill,999,warrior,fury,27,11,16
Marrowhead,ragnaros,998,warrior,fury,23,11,12
Waríos,blackrock,997,warrior,fury,36,12,24
Taleria,malygos,993,warrior,fury,34,13,21
Warfield,draenor,992,warrior,fury,30,11,19
Orcgrim,nozdormu,989,warrior,fury,48,22,26
Dj,ragnaros,986,warrior,fury,24,13,11
Candan,norgannon,986,warrior,fury,26,11,15
Nakro,hyjal,984,warrior,fury,20,11,9
Nicperh,dun-modr,984,warrior,fury,29,12,17
Fknmoo,kazzak,981,warrior,fury,174,87,87
Krlebajker,tarren-mill,977,warrior,fury,27,14,13
Rogmash,confrérie-du-thorium,973,warrior,fury,31,11,20
Luküs,dun-modr,972,warrior,fury,25,13,12
Zeppek,dalaran,969,warrior,fury,161,83,78
Merdé,blackhand,969,warrior,fury,125,64,61
Kungeen,silvermoon,968,warrior,fury,180,81,99
Malvred,eredar,968,warrior,fury,72,26,46
Solidier,archimonde,967,warrior,fury,95,41,54
Snoopdad,ravencrest,966,warrior,fury,27,15,12
Maniacwar,silvermoon,966,warrior,fury,66,20,46
Торакусу,gordunni,963,warrior,fury,113,57,56
Boxersene,blackmoore,962,warrior,fury,34,14,20
Фрейз,deathweaver,960,warrior,fury,12,10,2
Nazhar,kult-der-verdammten,960,warrior,fury,12,10,2
Pj,sanguino,960,warrior,fury,12,10,2
Phalek,argent-dawn,960,warrior,fury,18,10,8
Ástriax,ravencrest,960,warrior,fury,18,10,8
Nazrihk,ravencrest,960,warrior,fury,18,10,8
Изикол,blackscar,960,warrior,fury,21,11,10
Имеравета,gordunni,959,warrior,fury,12,10,2
Belmønt,archimonde,959,warrior,fury,18,10,8
Galatan,kazzak,959,warrior,fury,18,10,8
Psixi,stormscale,959,warrior,fury,18,10,8
Tenicx,ravencrest,959,warrior,fury,18,10,8
Googas,aegwynn,959,warrior,fury,18,10,8
Highoverlord,aggra-português,959,warrior,fury,18,10,8
Осадчийофдес,soulflayer,959,warrior,fury,18,10,8
Scelletonx,silvermoon,959,warrior,fury,18,10,8
Bím,archimonde,959,warrior,fury,18,10,8
Соджиро,howling-fjord,959,warrior,fury,18,10,8
Wutraa,kazzak,959,warrior,fury,18,10,8
Ramboramon,silvermoon,959,warrior,fury,18,10,8
Vandarms,archimonde,959,warrior,fury,24,10,14
Neoni,defias-brotherhood,959,warrior,fury,24,10,14
Bøgatyr,draenor,959,warrior,fury,24,10,14
Xurainlol,eredar,958,warrior,fury,12,10,2
Dimethefoxx,argent-dawn,958,warrior,fury,16,11,5
Kaveli,tarren-mill,958,warrior,fury,18,10,8
Supremas,eonar,958,warrior,fury,18,10,8
Avgorcgodx,stormscale,958,warrior,fury,18,10,8
Гневиболь,gordunni,958,warrior,fury,18,10,8
Ruzbie,silvermoon,958,warrior,fury,18,10,8
Antilopkräm,kazzak,958,warrior,fury,18,10,8
Profwar,drakthul,958,warrior,fury,18,10,8
Пупссяо,gordunni,958,warrior,fury,18,10,8
Оргрриммар,soulflayer,958,warrior,fury,24,10,14
Taaø,ravencrest,958,warrior,fury,24,10,14
Korama,emerald-dream,958,warrior,fury,24,10,14
Zvt,argent-dawn,958,warrior,fury,24,10,14
Razoo,stormscale,958,warrior,fury,30,10,20
Etelä,stormreaver,957,warrior,fury,18,10,8
Immera,silvermoon,957,warrior,fury,18,10,8
Budwise,stormscale,957,warrior,fury,18,10,8
Hellocritty,blackmoore,957,warrior,fury,18,10,8
Лотархард,gordunni,957,warrior,fury,18,10,8
Sørêy,aegwynn,957,warrior,fury,21,11,10
Blacko,eldrethalas,957,warrior,fury,24,10,14
Viviora,blackmoore,956,warrior,fury,12,10,2
Settin,silvermoon,956,warrior,fury,18,10,8
Skarsnaga,tarren-mill,956,warrior,fury,24,10,14
Chrobochrot,burning-blade,956,warrior,fury,24,10,14
Thodak,blackrock,956,warrior,fury,30,10,20
Kurenn,tarren-mill,956,warrior,fury,30,10,20
Nætøx,ravencrest,955,warrior,fury,18,10,8
Julmawarru,twisting-nether,955,warrior,fury,24,10,14
Nozhar,stormscale,955,warrior,fury,24,10,14
Dreadnova,tarren-mill,954,warrior,fury,24,10,14
Herkalandor,ragnaros,954,warrior,fury,86,33,53
Ампутиль,gordunni,953,warrior,fury,18,10,8
Xonnico,ravencrest,953,warrior,fury,30,11,19
Raksor,hyjal,952,warrior,fury,21,11,10
Byorr,marécage-de-zangar,952,warrior,fury,24,10,14
Thebiggreen,twisting-nether,951,warrior,fury,18,10,8
Cesaro,blackhand,951,warrior,fury,24,10,14
Fwgzl,silvermoon,950,warrior,fury,220,101,119
Лизерус,eversong,949,warrior,fury,12,10,2
Uknowmeh,twisting-nether,949,warrior,fury,21,13,8
Inexo,blackrock,949,warrior,fury,42,18,24
Potátonerd,kazzak,949,warrior,fury,24,10,14
Mikylothar,kazzak,945,warrior,fury,18,10,8
Erenowski,twisting-nether,945,warrior,fury,24,10,14
Xaturesw,twisting-nether,943,warrior,fury,12,10,2
Mane,thunderhorn,943,warrior,fury,24,14,10
Gunnarre,khaz-modan,941,warrior,fury,24,10,14
Miotyz,ahnqiraj,940,warrior,fury,24,10,14
Killaa,magtheridon,937,warrior,fury,30,10,20
Эребб,howling-fjord,935,warrior,fury,96,46,50
Schildwall,aegwynn,933,warrior,fury,24,10,14
Hazl,balnazzar,931,warrior,fury,62,33,29
Dolora,ragnaros,930,warrior,fury,50,23,27
Alepou,talnivarr,930,warrior,fury,24,10,14
Titanhaut,frostwolf,929,warrior,fury,18,10,8
Zeteta,sanguino,928,warrior,fury,56,14,42
Ganas,drakthul,926,warrior,fury,20,11,9
Oxandrolona,argent-dawn,926,warrior,fury,30,10,20
Solatika,alexstrasza,924,warrior,fury,201,102,99
Colluba,frostwolf,922,warrior,fury,65,37,28
Ocelote,elune,922,warrior,fury,30,16,14
Niozihex,the-maelstrom,921,warrior,fury,63,27,36
Thànagor,malfurion,919,warrior,fury,18,10,8
Dirtybugga,nagrand,916,warrior,fury,16,11,5
Falaliss,elune,912,warrior,fury,80,35,45
Tgabor,ragnaros,911,warrior,fury,15,10,5
Skorm,mugthol,911,warrior,fury,17,10,7
Aciu,doomhammer,911,warrior,fury,18,10,8
Arlan,dragonblight,907,warrior,fury,59,15,44
Лилслайм,gordunni,905,warrior,fury,48,25,23
Taurras,nathrezim,900,warrior,fury,162,82,80
Dullegriet,veknilash,897,warrior,fury,43,11,32
Арнвальд,galakrond,896,warrior,fury,36,18,18
Gardur,blackrock,895,warrior,fury,15,11,4
Murgrimm,die-silberne-hand,895,warrior,fury,99,48,51
Ezop,burning-blade,894,warrior,fury,16,10,6
Rüüd,mannoroth,892,warrior,fury,14,10,4
Gnompower,archimonde,892,warrior,fury,17,10,7
Warallari,khaz-modan,892,warrior,fury,56,27,29
Jhoakim,argent-dawn,892,warrior,fury,27,10,17
Djranji,kazzak,891,warrior,fury,22,10,12
Stroj,aerie-peak,889,warrior,fury,84,43,41
Bëlzé,les-clairvoyants,887,warrior,fury,38,14,24
Shinnok,stormreaver,879,warrior,fury,48,20,28
Mélin,ravencrest,876,warrior,fury,19,10,9
Jâbs,hyjal,875,warrior,fury,36,11,25
Kihili,twisting-nether,864,warrior,fury,12,9,3
Granlach,sunstrider,864,warrior,fury,12,9,3
Аэска,deathweaver,864,warrior,fury,12,9,3
Ønlyfâns,stormscale,864,warrior,fury,12,9,3
Kaieh,argent-dawn,864,warrior,fury,12,9,3
Planina,ravencrest,864,warrior,fury,12,9,3
Precel,burning-legion,864,warrior,fury,18,9,9
Лёшавор,howling-fjord,864,warrior,fury,18,9,9
Sjet,terrordar,864,warrior,fury,18,9,9
Lildaddypump,ravencrest,864,warrior,fury,18,9,9
Watergate,ysondre,864,warrior,fury,24,9,15
Рэйвисмашина,gordunni,864,warrior,fury,24,9,15
Мираккл,borean-tundra,864,warrior,fury,24,9,15
Âshkä,ysondre,863,warrior,fury,12,9,3
Nalx,tarren-mill,863,warrior,fury,12,9,3
Пепежаа,gordunni,863,warrior,fury,18,9,9
Nallepúh,silvermoon,863,warrior,fury,18,9,9
Preliator,outland,863,warrior,fury,18,9,9
Lunätic,sylvanas,863,warrior,fury,18,9,9
Бисовыйармен,soulflayer,863,warrior,fury,18,9,9
Грэйм,gordunni,863,warrior,fury,18,9,9
Sindrener,ysondre,863,warrior,fury,18,9,9
Furanos,blackrock,863,warrior,fury,18,9,9
Нейв,blackscar,863,warrior,fury,18,9,9
Balyndâ,aegwynn,863,warrior,fury,18,9,9
Showerfresh,silvermoon,863,warrior,fury,18,9,9
Gargaflike,aggra-português,863,warrior,fury,18,9,9
Lilrâge,doomhammer,863,warrior,fury,18,9,9
Therealskull,grim-batol,863,warrior,fury,18,9,9
Incendix,stormscale,863,warrior,fury,18,9,9
Skylåw,archimonde,863,warrior,fury,18,9,9
Micromachine,argent-dawn,863,warrior,fury,18,9,9
Littlewar,hyjal,863,warrior,fury,18,9,9
Khrund,burning-legion,863,warrior,fury,32,14,18
Realstars,tichondrius,862,warrior,fury,12,9,3
Warhero,burning-legion,862,warrior,fury,12,9,3
Obitron,argent-dawn,862,warrior,fury,18,9,9
Lecorrecteur,archimonde,862,warrior,fury,18,9,9
Grimleaper,twisting-nether,862,warrior,fury,18,9,9
Raley,ragnaros,862,warrior,fury,18,9,9
Rândy,confrérie-du-thorium,862,warrior,fury,18,9,9
Bigblackmooh,tarren-mill,862,warrior,fury,20,9,11
Vìbe,archimonde,862,warrior,fury,24,9,15
Abubrhm,kazzak,861,warrior,fury,12,9,3
Denshyel,dun-modr,861,warrior,fury,15,10,5
Bruxus,blackhand,861,warrior,fury,18,9,9
Dieselengine,draenor,861,warrior,fury,18,9,9
Zehirjin,sargeras,861,warrior,fury,18,9,9
Warpath,drakthul,860,warrior,fury,18,9,9
Afk,emeriss,860,warrior,fury,18,9,9
Кингкраш,gordunni,860,warrior,fury,24,9,15
Zhubaiji,ravencrest,859,warrior,fury,24,9,15
Valkirya,arthas,859,warrior,fury,30,9,21
Iwts,archimonde,858,warrior,fury,18,9,9
Auauau,arthas,856,warrior,fury,24,9,15
Dakul,earthen-ring,852,warrior,fury,18,9,9
Откачкакала,blackscar,846,warrior,fury,17,9,8
Glavý,burning-legion,845,warrior,fury,23,9,14
Rédsonja,chamber-of-aspects,844,warrior,fury,76,35,41
Giemb,doomhammer,844,warrior,fury,78,28,50
Telamonas,haomarush,839,warrior,fury,18,9,9
Apocrypha,darkspear,830,warrior,fury,23,9,14
Boomslane,twisting-nether,829,warrior,fury,17,9,8
Pollverizer,ghostlands,827,warrior,fury,51,21,30
Albabhaltair,quelthalas,826,warrior,fury,42,18,24
Josephoise,hyjal,825,warrior,fury,17,9,8
Nainpossible,marécage-de-zangar,825,warrior,fury,18,9,9
Endro,burning-legion,822,warrior,fury,17,9,8
Gunma,ragnaros,821,warrior,fury,48,19,29
Iæ,perenolde,818,warrior,fury,18,9,9
Jøtawarrior,sanguino,815,warrior,fury,17,9,8
Варриорнир,howling-fjord,814,warrior,fury,14,10,4
Kímó,silvermoon,814,warrior,fury,15,9,6
Pixelknight,argent-dawn,813,warrior,fury,15,10,5
Zerathos,emerald-dream,807,warrior,fury,102,34,68
Zames,ravencrest,804,warrior,fury,29,11,18
Miina,blutkessel,802,warrior,fury,18,9,9
Tiscanno,nemesis,797,warrior,fury,110,51,59
Guinnasse,khaz-modan,794,warrior,fury,21,9,12
Filador,wildhammer,788,warrior,fury,30,12,18
Parteyunques,sanguino,783,warrior,fury,19,9,10
Xguildone,magtheridon,772,warrior,fury,112,46,66
ßladex,azshara,768,warrior,fury,12,8,4
Chaseheal,frostwolf,768,warrior,fury,12,8,4
Cleavnseagal,ravencrest,768,warrior,fury,12,8,4
Nagibon,drakthul,768,warrior,fury,12,8,4
Ironfangs,argent-dawn,768,warrior,fury,12,8,4
Xecutie,antonidas,768,warrior,fury,12,8,4
Pasor,ysondre,768,warrior,fury,12,8,4
Grkpwh,silvermoon,768,warrior,fury,12,8,4
Sargul,ragnaros,768,warrior,fury,12,8,4
Trensexual,twisting-nether,768,warrior,fury,12,8,4
Zern,draenor,768,warrior,fury,12,8,4
Grroom,tarren-mill,768,warrior,fury,12,8,4
Бэнчпресс,soulflayer,768,warrior,fury,12,8,4
Цикламея,blackscar,768,warrior,fury,18,8,10
Kondomi,stormreaver,768,warrior,fury,18,8,10
Shazzang,kazzak,768,warrior,fury,18,8,10
Keññyfðx,ysondre,768,warrior,fury,18,8,10
Zimbabakunda,ravencrest,768,warrior,fury,18,8,10
Tweaked,argent-dawn,768,warrior,fury,18,8,10
Untiltèd,ravencrest,768,warrior,fury,18,8,10
Nightvision,skullcrusher,768,warrior,fury,18,8,10
Joéfernandés,sylvanas,768,warrior,fury,18,8,10
Mobyl,twisting-nether,768,warrior,fury,18,8,10
Birikkin,draenor,767,warrior,fury,12,8,4
Largeblade,kazzak,767,warrior,fury,12,8,4
Báshx,outland,767,warrior,fury,12,8,4
Kìrìtosan,pozzo-delleternità,767,warrior,fury,12,8,4
Rooflolly,argent-dawn,767,warrior,fury,12,8,4
Skeptikal,argent-dawn,767,warrior,fury,12,8,4
Derkarle,azshara,767,warrior,fury,12,8,4
Онатолька,eversong,767,warrior,fury,16,9,7
Manomamix,archimonde,767,warrior,fury,15,8,7
Dallion,azjolnerub,767,warrior,fury,18,8,10
Bravest,ragnaros,767,warrior,fury,18,8,10
Bulgrash,blackmoore,767,warrior,fury,18,8,10
Фелёр,gordunni,767,warrior,fury,18,8,10
Saarhoy,silvermoon,767,warrior,fury,18,8,10
Noriela,archimonde,767,warrior,fury,18,8,10
Youras,outland,767,warrior,fury,18,8,10
Kristinas,tarren-mill,767,warrior,fury,18,8,10
Sonczo,defias-brotherhood,767,warrior,fury,18,8,10
Arandyr,archimonde,767,warrior,fury,18,8,10
Ødên,frostmane,767,warrior,fury,18,8,10
Изберг,soulflayer,767,warrior,fury,18,8,10
Dollybúrster,aegwynn,767,warrior,fury,18,8,10
Ðíscøwârrìør,nethersturm,767,warrior,fury,18,8,10
Rndname,malganis,767,warrior,fury,18,8,10
Gonutz,sylvanas,767,warrior,fury,18,8,10
Rasvamaksa,stormscale,767,warrior,fury,18,8,10
Akril,kelthuzad,767,warrior,fury,18,8,10
Гантелявухо,blackscar,767,warrior,fury,20,8,12
Глинм,gordunni,767,warrior,fury,24,8,16
Rîdler,ravencrest,767,warrior,fury,24,8,16
Warriur,silvermoon,766,warrior,fury,12,8,4
Hekto,burning-legion,766,warrior,fury,12,8,4
Deadwaifu,ragnaros,766,warrior,fury,18,8,10
Pitbonez,archimonde,766,warrior,fury,18,8,10
Pahgorim,blackhand,766,warrior,fury,18,8,10
Fatøuwar,archimonde,766,warrior,fury,21,9,12
Throndin,dun-modr,766,warrior,fury,24,8,16
Knussnacker,sanguino,765,warrior,fury,12,8,4
Hardwørk,kazzak,765,warrior,fury,12,8,4
Imelite,antonidas,764,warrior,fury,18,8,10
Roninwar,the-maelstrom,764,warrior,fury,18,8,10
Malasortë,sylvanas,764,warrior,fury,18,8,10
Ryuma,lordaeron,764,warrior,fury,18,8,10
Furginox,argent-dawn,764,warrior,fury,24,8,16
Tsu,karazhan,763,warrior,fury,18,8,10
Stonlocked,blackhand,763,warrior,fury,24,8,16
Cazzpowa,frostmane,762,warrior,fury,12,8,4
Theunknown,eonar,762,warrior,fury,24,8,16
Rammaxx,tarren-mill,761,warrior,fury,18,8,10
Ксартус,gordunni,760,warrior,fury,24,8,16
Ремарус,fordragon,759,warrior,fury,12,8,4
Czarian,ragnaros,759,warrior,fury,36,8,28
Ошинай,gordunni,756,warrior,fury,18,8,10
Uleixoshark,argent-dawn,754,warrior,fury,18,8,10
Zarkos,onyxia,754,warrior,fury,24,8,16
Destrzadora,exodar,750,warrior,fury,18,8,10
Gobloater,draenor,747,warrior,fury,30,8,22
Tronhaur,stormscale,739,warrior,fury,29,9,20
Aedin,ravencrest,734,warrior,fury,17,8,9
Thrownn,daggerspine,733,warrior,fury,14,8,6
Branzei,darkspear,731,warrior,fury,22,8,14
Padzwarr,kazzak,719,warrior,fury,15,8,7
Fawa,argent-dawn,719,warrior,fury,15,8,7
Вагранна,soulflayer,719,warrior,fury,17,8,9
Bragush,shattrath,718,warrior,fury,11,8,3
Quebradita,tyrande,715,warrior,fury,21,8,13
Slambadicoot,draenor,711,warrior,fury,21,9,12
Manelar,draenor,702,warrior,fury,14,8,6
Weaknezz,aegwynn,701,warrior,fury,16,8,8
Kilkov,emeriss,701,warrior,fury,16,8,8
Grekowar,dalaran,700,warrior,fury,17,8,9
Amédé,ysondre,697,warrior,fury,17,8,9
Leyenda,steamwheedle-cartel,689,warrior,fury,23,8,15
Kirix,aegwynn,688,warrior,fury,17,8,9
Giltiné,runetotem,687,warrior,fury,13,8,5
Bablos,kul-tiras,686,warrior,fury,14,8,6
Balro,blackmoore,680,warrior,fury,23,9,14
Bubbsi,turalyon,674,warrior,fury,24,8,16
Дмидрашх,howling-fjord,672,warrior,fury,10,8,2
Beached,outland,672,warrior,fury,12,7,5
Harbor,burning-blade,672,warrior,fury,12,7,5
Кефтеме,fordragon,672,warrior,fury,12,7,5
Paindrain,burning-blade,672,warrior,fury,12,7,5
Fragsonic,stormscale,672,warrior,fury,12,7,5
Youstupide,drekthar,672,warrior,fury,12,7,5
Инкула,gordunni,672,warrior,fury,12,7,5
Jollypig,stormscale,672,warrior,fury,12,7,5
Ézélya,dalaran,672,warrior,fury,12,7,5
Blitzmarck,ragnaros,672,warrior,fury,12,7,5
Pablitø,silvermoon,672,warrior,fury,12,7,5
Nrog,blackrock,672,warrior,fury,12,7,5
Rektdrum,ravencrest,672,warrior,fury,12,7,5
Kamú,twisting-nether,672,warrior,fury,12,7,5
Thighbreaker,silvermoon,672,warrior,fury,12,7,5
Karpzug,stormscale,672,warrior,fury,12,7,5
Escapeartíst,ravencrest,672,warrior,fury,12,7,5
Lamettaheini,tichondrius,672,warrior,fury,12,7,5
Parafilia,uldum,672,warrior,fury,12,7,5
Думслэер,gordunni,672,warrior,fury,12,7,5
Saurens,twisting-nether,672,warrior,fury,12,7,5
Khrtw,silvermoon,672,warrior,fury,12,7,5
Hàssard,outland,672,warrior,fury,12,7,5
Hortswarr,drakthul,672,warrior,fury,12,7,5
Norwegian,silvermoon,672,warrior,fury,12,7,5
Urmack,ravencrest,672,warrior,fury,12,7,5
Alyx,mugthol,672,warrior,fury,12,7,5
Yuuta,ravencrest,672,warrior,fury,12,7,5
Elbicho,ravencrest,672,warrior,fury,12,7,5
Zathoro,thunderhorn,672,warrior,fury,18,7,11
Foboa,archimonde,672,warrior,fury,18,7,11
Awan,malygos,672,warrior,fury,18,7,11
Учихагодх,howling-fjord,672,warrior,fury,18,7,11
Omcat,dun-modr,672,warrior,fury,18,7,11
Shintuargar,blackrock,672,warrior,fury,18,7,11
Rarae,kazzak,672,warrior,fury,18,7,11
Destruct,tarren-mill,672,warrior,fury,18,7,11
Yaune,ravencrest,672,warrior,fury,18,7,11
Bordi,nemesis,672,warrior,fury,18,7,11
Banshe,ragnaros,672,warrior,fury,18,7,11
Arcreign,kazzak,672,warrior,fury,18,7,11
Кэйкан,gordunni,672,warrior,fury,18,7,11
Devso,ravencrest,672,warrior,fury,18,7,11
Gramrosh,eredar,672,warrior,fury,18,7,11
Crazykind,kazzak,672,warrior,fury,18,7,11
Corlo,uldaman,672,warrior,fury,18,7,11
Himarsenko,silvermoon,672,warrior,fury,24,7,17
Timmyda,dalaran,671,warrior,fury,12,7,5
Sniperwølf,tyrande,671,warrior,fury,12,7,5
Sweeyz,elune,671,warrior,fury,12,7,5
Roitz,tarren-mill,671,warrior,fury,12,7,5
Sargonas,burning-blade,671,warrior,fury,12,7,5
Broknagar,draenor,671,warrior,fury,12,7,5
Shayarielle,zirkel-des-cenarius,671,warrior,fury,12,7,5
Rryba,blackrock,671,warrior,fury,12,7,5
Pépêloup,archimonde,671,warrior,fury,12,7,5
Showneck,blackmoore,671,warrior,fury,12,7,5
Lôreex,ravencrest,671,warrior,fury,12,7,5
Haraldjuhnke,frostwolf,671,warrior,fury,12,7,5
Repzcanor,silvermoon,671,warrior,fury,12,7,5
Septymyya,eredar,671,warrior,fury,15,8,7
Zonash,kazzak,671,warrior,fury,18,7,11
Fükz,ysondre,671,warrior,fury,18,7,11
Zkb,zuljin,671,warrior,fury,18,7,11
Wakarimaszka,ragnaros,671,warrior,fury,18,7,11
Gueboparado,sanguino,671,warrior,fury,18,7,11
Ancore,kilrogg,671,warrior,fury,18,7,11
Рипаю,howling-fjord,671,warrior,fury,18,7,11
Rangnarr,doomhammer,671,warrior,fury,18,7,11
Jaowa,blackmoore,671,warrior,fury,18,7,11
Bonnejournée,stormscale,671,warrior,fury,18,7,11
Dupnica,kazzak,671,warrior,fury,18,7,11
Lurchusrexus,ysera,671,warrior,fury,18,7,11
Hzdwarr,kazzak,671,warrior,fury,24,7,17
Ukloth,sanguino,671,warrior,fury,25,7,18
Mokaro,rexxar,670,warrior,fury,12,7,5
Izrael,alakir,670,warrior,fury,12,7,5
Chadchadsson,ravencrest,670,warrior,fury,12,7,5
Obaru,antonidas,670,warrior,fury,12,7,5
Ölaff,ravencrest,670,warrior,fury,12,7,5
Terminatòr,pozzo-delleternità,670,warrior,fury,16,8,8
Zargala,stormscale,670,warrior,fury,18,7,11
Masster,argent-dawn,670,warrior,fury,18,7,11
Bloódángel,frostwolf,670,warrior,fury,18,7,11
Durus,burning-blade,670,warrior,fury,18,7,11
Saisahan,hyjal,670,warrior,fury,21,8,13
Mihari,kirin-tor,670,warrior,fury,24,7,17
Bankaju,burning-legion,669,warrior,fury,18,7,11
Wilmazutschn,nethersturm,669,warrior,fury,18,7,11
Grenad,kazzak,668,warrior,fury,18,7,11
Гаргончик,gordunni,668,warrior,fury,24,7,17
Juanvaco,tarren-mill,667,warrior,fury,30,7,23
Deadchïld,drakthul,655,warrior,fury,17,7,10
Strânge,gorgonnash,654,warrior,fury,17,7,10
Gozga,twisting-nether,639,warrior,fury,11,7,4
Nocturia,archimonde,639,warrior,fury,14,8,6
Tenvee,outland,639,warrior,fury,17,7,10
Mongojones,outland,623,warrior,fury,11,7,4
Lynnie,doomhammer,623,warrior,fury,27,7,20
Катахцифури,blackscar,611,warrior,fury,21,7,14
Nèssa,outland,607,warrior,fury,14,7,7
Scofiéld,lordaeron,601,warrior,fury,11,7,4
Lykevil,medivh,598,warrior,fury,20,7,13
Quarantino,ysondre,590,warrior,fury,23,7,16
Rhagnok,archimonde,576,warrior,fury,6,6,0
Артэкриогг,soulflayer,576,warrior,fury,6,6,0
Thomasman,nerathor,576,warrior,fury,6,6,0
Maowiecki,burning-legion,576,warrior,fury,12,6,6
Rylbrah,blackmoore,576,warrior,fury,12,6,6
Mâggus,antonidas,576,warrior,fury,12,6,6
Filoliha,silvermoon,576,warrior,fury,12,6,6
Geckoo,emerald-dream,576,warrior,fury,12,6,6
Pirovolo,twilights-hammer,576,warrior,fury,12,6,6
Асгинор,gordunni,576,warrior,fury,12,6,6
Thegullet,draenor,576,warrior,fury,12,6,6
Дуглимон,gordunni,576,warrior,fury,12,6,6
Sakumo,sylvanas,576,warrior,fury,12,6,6
Фктпх,blackscar,576,warrior,fury,12,6,6
Braindeady,burning-legion,576,warrior,fury,12,6,6
Wheelbarrow,eredar,576,warrior,fury,12,6,6
Engalxsol,tarren-mill,576,warrior,fury,12,6,6
Гигасмэш,gordunni,576,warrior,fury,12,6,6
Timagno,nemesis,576,warrior,fury,12,6,6
Lanahan,argent-dawn,576,warrior,fury,12,6,6
Sêrên,dun-modr,576,warrior,fury,12,6,6
Саркон,ashenvale,576,warrior,fury,12,6,6
Masida,senjin,576,warrior,fury,12,6,6
Dhloos,kazzak,576,warrior,fury,12,6,6
Виртилий,soulflayer,576,warrior,fury,12,6,6
Änvil,tarren-mill,576,warrior,fury,12,6,6
Gnomet,auchindoun,576,warrior,fury,12,6,6
Aurélus,rexxar,576,warrior,fury,12,6,6
Stanfury,sylvanas,576,warrior,fury,12,6,6
Weendslash,draenor,576,warrior,fury,12,6,6
Kalho,ravencrest,576,warrior,fury,12,6,6
Shownomercy,blackrock,576,warrior,fury,12,6,6
Ränchiëk,ravencrest,576,warrior,fury,12,6,6
Buckiesøde,twisting-nether,576,warrior,fury,12,6,6
Nøcturnaqq,silvermoon,576,warrior,fury,12,6,6
Texcitwow,sylvanas,576,warrior,fury,12,6,6
Balthew,defias-brotherhood,576,warrior,fury,12,6,6
Yenkonov,blackmoore,576,warrior,fury,12,6,6
Омертин,howling-fjord,576,warrior,fury,12,6,6
Luchanka,the-maelstrom,576,warrior,fury,12,6,6
Rarcus,chamber-of-aspects,576,warrior,fury,12,6,6
Xiom,blackrock,576,warrior,fury,12,6,6
Onkra,malganis,576,warrior,fury,12,6,6
Роули,blackscar,576,warrior,fury,12,6,6
Reyhan,nemesis,576,warrior,fury,12,6,6
Dominikhasek,stormscale,576,warrior,fury,12,6,6
Rexonawarr,kazzak,576,warrior,fury,12,6,6
Ангрол,grom,576,warrior,fury,12,6,6
Rinowar,archimonde,576,warrior,fury,12,6,6
Ramhadat,hyjal,576,warrior,fury,12,6,6
Bstgame,frostmane,576,warrior,fury,12,6,6
Thogrêy,archimonde,576,warrior,fury,12,6,6
Rudvard,hyjal,576,warrior,fury,12,6,6
Baboonqt,hyjal,576,warrior,fury,12,6,6
Deamonn,kazzak,576,warrior,fury,12,6,6
Dagon,dentarg,576,warrior,fury,12,6,6
Pílot,ravencrest,576,warrior,fury,15,7,8
Skrboslav,tarren-mill,576,warrior,fury,18,6,12
Эксихард,gordunni,576,warrior,fury,18,6,12
Bobolalegend,dalaran,576,warrior,fury,18,6,12
Blæsild,ravencrest,576,warrior,fury,18,6,12
Illmìndofboo,twisting-nether,576,warrior,fury,18,6,12
Velinde,outland,576,warrior,fury,18,6,12
Сталиран,gordunni,576,warrior,fury,18,6,12
Hulkzmash,tarren-mill,576,warrior,fury,18,6,12
Redwraith,stormscale,576,warrior,fury,18,6,12
Prettyangel,aegwynn,576,warrior,fury,18,6,12
Furiousbele,burning-legion,576,warrior,fury,18,6,12
Deswarr,tarren-mill,576,warrior,fury,18,6,12
Guerriax,les-sentinelles,576,warrior,fury,18,6,12
Ðjlækker,silvermoon,576,warrior,fury,18,6,12
Stévé,kazzak,576,warrior,fury,24,6,18
Zulien,sanguino,575,warrior,fury,12,6,6
Xenesthis,dun-morogh,575,warrior,fury,12,6,6
Dariius,dun-modr,575,warrior,fury,12,6,6
Warrz,turalyon,575,warrior,fury,12,6,6
Bigoö,dun-modr,575,warrior,fury,12,6,6
Nihroxis,blackrock,575,warrior,fury,12,6,6
Zaurzyfang,burning-legion,575,warrior,fury,12,6,6
Richymorty,los-errantes,575,warrior,fury,12,6,6
Durrüti,sanguino,575,warrior,fury,12,6,6
Jâmâli,malganis,575,warrior,fury,12,6,6
Leorx,draenor,575,warrior,fury,12,6,6
Berzzerker,tarren-mill,575,warrior,fury,12,6,6
Roykór,auchindoun,575,warrior,fury,12,6,6
Marjorieann,drakthul,575,warrior,fury,12,6,6
Dübèl,blackrock,575,warrior,fury,12,6,6
Akinewan,twisting-nether,575,warrior,fury,12,6,6
Моргаур,howling-fjord,575,warrior,fury,12,6,6
Vmnbgh,aszune,575,warrior,fury,12,6,6
Kogän,ragnaros,575,warrior,fury,12,6,6
Ffrancis,eldrethalas,575,warrior,fury,12,6,6
Granni,archimonde,575,warrior,fury,12,6,6
Esegryel,argent-dawn,575,warrior,fury,12,6,6
Slappie,kiljaeden,575,warrior,fury,12,6,6
Skribe,blackmoore,575,warrior,fury,12,6,6
Slyra,grim-batol,575,warrior,fury,12,6,6
Saevitius,aegwynn,575,warrior,fury,18,6,12
Khazoroth,blackmoore,575,warrior,fury,18,6,12
Rotgesicht,blackrock,575,warrior,fury,18,6,12
Tîrael,antonidas,575,warrior,fury,18,6,12
Kiryn,draenor,575,warrior,fury,18,6,12
Akäme,ysondre,575,warrior,fury,18,6,12
Execútie,argent-dawn,575,warrior,fury,18,6,12
Argomor,stormscale,575,warrior,fury,18,6,12
Nidwar,quelthalas,575,warrior,fury,18,6,12
Вкусныисыр,soulflayer,574,warrior,fury,12,6,6
Bruko,silvermoon,574,warrior,fury,12,6,6
Exødiä,hyjal,574,warrior,fury,12,6,6
Denisamanea,chamber-of-aspects,574,warrior,fury,18,6,12
Admiràl,azuremyst,573,warrior,fury,12,6,6
Gomblin,blackmoore,573,warrior,fury,12,6,6
Хенесии,soulflayer,573,warrior,fury,15,7,8
Booya,laughing-skull,573,warrior,fury,24,6,18
Джомалкович,deathweaver,572,warrior,fury,12,6,6
Deushill,sylvanas,570,warrior,fury,12,6,6
Ragghatt,draenor,570,warrior,fury,18,6,12
Bhzerrkk,nerathor,564,warrior,fury,24,6,18
Loty,drakthul,559,warrior,fury,17,6,11
Røidrage,stormscale,559,warrior,fury,20,7,13
Mokwo,chogall,543,warrior,fury,14,7,7
Refl,kazzak,543,warrior,fury,17,6,11
Cleaver,tarren-mill,543,warrior,fury,17,6,11
Жлобьен,howling-fjord,542,warrior,fury,17,6,11
Piinte,naxxramas,536,warrior,fury,14,7,7
Crushonyou,aegwynn,528,warrior,fury,9,7,2
Skeptikal,tarren-mill,527,warrior,fury,11,6,5
Мегамегаогр,howling-fjord,527,warrior,fury,11,6,5
Фишар,soulflayer,527,warrior,fury,11,6,5
Happywarrior,silvermoon,527,warrior,fury,11,6,5
Narkololzz,marécage-de-zangar,527,warrior,fury,15,6,9
Skillissues,argent-dawn,522,warrior,fury,17,9,8
Retmain,draenor,522,warrior,fury,20,8,12
Kolxoz,doomhammer,521,warrior,fury,21,7,14
Oluwafunmila,tarren-mill,512,warrior,fury,10,6,4
Shadowwarrio,burning-legion,511,warrior,fury,14,6,8
Крагерр,gordunni,511,warrior,fury,14,6,8
Dreyker,sanguino,510,warrior,fury,14,6,8
Khartoz,kult-der-verdammten,510,warrior,fury,14,6,8
Blutwar,kazzak,499,warrior,fury,25,11,14
Ragoar,blackmoore,480,warrior,fury,6,5,1
Röell,draenor,480,warrior,fury,6,5,1
Ганахан,soulflayer,480,warrior,fury,6,5,1
Melogranod,nemesis,480,warrior,fury,6,5,1
Obîwan,dalaran,480,warrior,fury,6,5,1
Coko,kirin-tor,480,warrior,fury,6,5,1
Depopulator,blackmoore,480,warrior,fury,6,5,1
Дайбек,howling-fjord,480,warrior,fury,6,5,1
Drîftkîñg,outland,480,warrior,fury,6,5,1
Bârney,ravencrest,480,warrior,fury,6,5,1
Ishbosheth,stormscale,480,warrior,fury,6,5,1
Вульфычч,gordunni,480,warrior,fury,6,5,1
Arthyx,alexstrasza,480,warrior,fury,6,5,1
Frandor,dalaran,480,warrior,fury,6,5,1
Juoppó,tarren-mill,480,warrior,fury,6,5,1
Kiaravnr,garona,480,warrior,fury,6,5,1
Bulldòzèr,kazzak,480,warrior,fury,6,5,1
Fáro,ravencrest,480,warrior,fury,6,5,1
Ousgrytamer,archimonde,480,warrior,fury,6,5,1
Juicycrits,ragnaros,480,warrior,fury,6,5,1
Melted,ravencrest,480,warrior,fury,6,5,1
Nîmera,nemesis,480,warrior,fury,6,5,1
Octtwar,twisting-nether,480,warrior,fury,6,5,1
Wítts,ravencrest,480,warrior,fury,6,5,1
Intensive,blackmoore,480,warrior,fury,6,5,1
Gguts,archimonde,480,warrior,fury,6,5,1
Çhoke,blackrock,480,warrior,fury,6,5,1
Easypoîntsx,tarren-mill,480,warrior,fury,6,5,1
Gaiuscaesar,stormscale,480,warrior,fury,9,6,3
Pihvikostaja,stormreaver,480,warrior,fury,8,5,3
Nainculay,kaelthas,480,warrior,fury,10,5,5
Petrixens,drakthul,480,warrior,fury,12,5,7
Fury,shattered-halls,480,warrior,fury,12,5,7
Astrid,rajaxx,480,warrior,fury,12,5,7
Jugg,emerald-dream,480,warrior,fury,12,5,7
Гатал,howling-fjord,480,warrior,fury,12,5,7
Like,blackrock,480,warrior,fury,12,5,7
Donvasto,sylvanas,480,warrior,fury,12,5,7
Йошихироо,howling-fjord,480,warrior,fury,12,5,7
Жарочныйшкаф,grom,480,warrior,fury,12,5,7
Jailegear,archimonde,480,warrior,fury,12,5,7
Baleroni,burning-legion,480,warrior,fury,12,5,7
Kaîsaschnitt,malganis,480,warrior,fury,12,5,7
Auguston,argent-dawn,480,warrior,fury,12,5,7
Rageaholic,blackmoore,480,warrior,fury,12,5,7
Kâllay,blackrock,480,warrior,fury,12,5,7
Zeez,magtheridon,480,warrior,fury,12,5,7
Obersten,stormscale,480,warrior,fury,12,5,7
Daxarian,twisting-nether,480,warrior,fury,12,5,7
Ахиллслэм,howling-fjord,480,warrior,fury,12,5,7
Jagannath,stormscale,480,warrior,fury,12,5,7
Riac,lothar,480,warrior,fury,12,5,7
Коттэлаттэ,gordunni,480,warrior,fury,12,5,7
Eiche,kazzak,480,warrior,fury,12,5,7
Darthmalgus,stormscale,480,warrior,fury,12,5,7
Bíanco,blackrock,480,warrior,fury,12,5,7
Daeriuss,silvermoon,480,warrior,fury,12,5,7
Ruixxted,stormreaver,480,warrior,fury,12,5,7
Lethalsnack,ragnaros,480,warrior,fury,12,5,7
Beanzz,blackmoore,480,warrior,fury,12,5,7
Tanaja,stormscale,480,warrior,fury,12,5,7
Трис,fordragon,480,warrior,fury,12,5,7
Soullmike,drakthul,480,warrior,fury,12,5,7
Тысячидуш,gordunni,480,warrior,fury,12,5,7
Römådûr,drakthul,480,warrior,fury,12,5,7
Naevus,aszune,480,warrior,fury,12,5,7
Lortèn,stormscale,480,warrior,fury,12,5,7
Rohc,kazzak,480,warrior,fury,12,5,7
Falnah,sargeras,480,warrior,fury,12,5,7
Bîmbämboom,blackmoore,480,warrior,fury,12,5,7
Friendlytwo,quelthalas,480,warrior,fury,12,5,7
Durahán,argent-dawn,480,warrior,fury,12,5,7
Prúne,hyjal,480,warrior,fury,12,5,7
Dauderup,aerie-peak,480,warrior,fury,12,5,7
Beznacaj,outland,480,warrior,fury,12,5,7
Priceswex,ravencrest,480,warrior,fury,12,5,7
Xatit,ravencrest,480,warrior,fury,12,5,7
Xirár,sylvanas,480,warrior,fury,12,5,7
Schwän,twisting-nether,480,warrior,fury,12,5,7
Kval,kazzak,480,warrior,fury,12,5,7
Zillrog,kazzak,480,warrior,fury,12,5,7
Stkacha,sanguino,480,warrior,fury,12,5,7
Ulthrak,archimonde,480,warrior,fury,12,5,7
Punahabe,draenor,480,warrior,fury,12,5,7
Mkekw,draenor,480,warrior,fury,12,5,7
Lánse,ravencrest,480,warrior,fury,12,5,7
Носфератузод,booty-bay,480,warrior,fury,12,5,7
Jamyty,burning-legion,480,warrior,fury,12,5,7
Æsirr,kazzak,480,warrior,fury,12,5,7
Лысыч,gordunni,480,warrior,fury,12,5,7
Vortok,thrall,480,warrior,fury,12,5,7
Orkoje,argent-dawn,480,warrior,fury,12,5,7
Daudal,frostwolf,480,warrior,fury,12,5,7
Боевыещёчки,eversong,480,warrior,fury,12,5,7
Iloveit,draenor,480,warrior,fury,12,5,7
Кэфтэмэ,soulflayer,480,warrior,fury,12,5,7
Jiziee,varimathras,480,warrior,fury,12,5,7
Orcmanyes,tarren-mill,480,warrior,fury,12,5,7
Wrathfül,terokkar,480,warrior,fury,12,5,7
Damáge,doomhammer,480,warrior,fury,12,5,7
Wasok,antonidas,480,warrior,fury,12,5,7
Arthayl,eredar,480,warrior,fury,12,5,7
Niukí,blackmoore,480,warrior,fury,14,5,9
Mouldyclunge,argent-dawn,480,warrior,fury,17,5,12
Asuross,dalaran,480,warrior,fury,18,5,13
Warjuice,draenor,480,warrior,fury,18,5,13
Nightmareb,magtheridon,480,warrior,fury,18,5,13
Sambucá,blackmoore,480,warrior,fury,18,5,13
Bindera,silvermoon,480,warrior,fury,18,5,13
Fluffeh,argent-dawn,480,warrior,fury,18,5,13
Delonathor,drakthul,480,warrior,fury,18,5,13
Haregos,gorgonnash,479,warrior,fury,6,5,1
Porrter,silvermoon,479,warrior,fury,6,5,1
Luciferkhan,twisting-nether,479,warrior,fury,12,5,7
Goshnac,blackmoore,479,warrior,fury,12,5,7
Azrail,xavius,479,warrior,fury,12,5,7
Мухалии,howling-fjord,479,warrior,fury,12,5,7
Granrubin,dun-modr,479,warrior,fury,12,5,7
Чорныгвард,gordunni,479,warrior,fury,12,5,7
Cosmoses,mazrigos,479,warrior,fury,12,5,7
Maidenless,quelthalas,479,warrior,fury,12,5,7
Wärlight,nemesis,479,warrior,fury,12,5,7
Ironsteve,blackmoore,479,warrior,fury,12,5,7
Hynekiller,silvermoon,479,warrior,fury,12,5,7
Sevorok,blackrock,479,warrior,fury,12,5,7
Keaile,tarren-mill,479,warrior,fury,12,5,7
Pipsysimp,ragnaros,479,warrior,fury,12,5,7
Brutalz,kazzak,479,warrior,fury,12,5,7
Ärama,sanguino,479,warrior,fury,14,5,9
Zexsors,kazzak,479,warrior,fury,18,5,13
Pumáni,silvermoon,479,warrior,fury,18,5,13
Rubyodin,tarren-mill,479,warrior,fury,18,5,13
Jeembo,blackmoore,479,warrior,fury,18,5,13
Ельмара,gordunni,479,warrior,fury,18,5,13
Noizekick,ragnaros,479,warrior,fury,23,5,18
Vaeanash,ragnaros,479,warrior,fury,24,5,19
Xaguu,magtheridon,478,warrior,fury,12,5,7
Армирован,howling-fjord,478,warrior,fury,18,5,13
Caiimewiliam,ravencrest,478,warrior,fury,18,5,13
Dorwarhoof,ravencrest,478,warrior,fury,18,5,13
Harny,silvermoon,477,warrior,fury,10,6,4
Devrez,draenor,477,warrior,fury,12,5,7
Grystal,blackrock,477,warrior,fury,24,5,19
Roostai,shattered-hand,476,warrior,fury,12,5,7
Omosha,burning-legion,476,warrior,fury,12,5,7
Worcan,blackmoore,476,warrior,fury,15,6,9
Ascendeadw,kazzak,447,warrior,fury,11,5,6
Stupidguy,garrosh,447,warrior,fury,11,5,6
Dvärgrobot,draenor,447,warrior,fury,11,5,6
Infinitehair,ravencrest,447,warrior,fury,17,5,12
Cidh,sinstralis,446,warrior,fury,8,6,2
Autumnfálls,kazzak,446,warrior,fury,10,6,4
Eriqua,archimonde,431,warrior,fury,11,5,6
Chonku,draenor,431,warrior,fury,11,5,6
Talathas,archimonde,431,warrior,fury,11,5,6
Ievilstylez,malygos,430,warrior,fury,9,5,4
Valrathion,ravencrest,426,warrior,fury,17,8,9
Roimyv,archimonde,426,warrior,fury,16,6,10
Yugoslav,argent-dawn,426,warrior,fury,16,6,10
Stix,nemesis,426,warrior,fury,21,6,15
Olagkhan,minahonda,422,warrior,fury,15,6,9
Zeryyo,blackrock,416,warrior,fury,10,5,5
Remen,archimonde,416,warrior,fury,10,5,5
Zecelei,tarren-mill,416,warrior,fury,16,5,11
Футбольчик,thermaplugg,415,warrior,fury,14,5,9
Ronda,nemesis,414,warrior,fury,8,5,3
Famous,argent-dawn,400,warrior,fury,7,5,2
Illyrish,blackmoore,393,warrior,fury,15,6,9
Nukerz,kirin-tor,384,warrior,fury,6,4,2
Executte,zuljin,384,warrior,fury,6,4,2
Lôcutus,thrall,384,warrior,fury,6,4,2
Extasceh,turalyon,384,warrior,fury,6,4,2
Dregath,uldum,384,warrior,fury,6,4,2
Feelmyfúry,ravencrest,384,warrior,fury,6,4,2
Venomflex,sanguino,384,warrior,fury,6,4,2
Highdive,outland,384,warrior,fury,6,4,2
Nabb,outland,384,warrior,fury,6,4,2
Busðriver,tarren-mill,384,warrior,fury,6,4,2
Bearimwar,ravencrest,384,warrior,fury,6,4,2
Daldiee,ravencrest,384,warrior,fury,6,4,2
Klonyarika,ravencrest,384,warrior,fury,6,4,2
Chickatilo,ravencrest,384,warrior,fury,6,4,2
Hofftor,eredar,384,warrior,fury,6,4,2
Paaki,archimonde,384,warrior,fury,6,4,2
Goragash,eredar,384,warrior,fury,6,4,2
Suzzon,hyjal,384,warrior,fury,6,4,2
Kantarion,stormscale,384,warrior,fury,6,4,2
Zhalm,stormscale,384,warrior,fury,6,4,2
Wetrx,stormscale,384,warrior,fury,6,4,2
Truepassion,outland,384,warrior,fury,6,4,2
Khalifa,stormscale,384,warrior,fury,6,4,2
Craíne,antonidas,384,warrior,fury,6,4,2
Calopsith,ysondre,384,warrior,fury,6,4,2
Enraged,tarren-mill,384,warrior,fury,6,4,2
Korghar,xavius,384,warrior,fury,6,4,2
Dominow,ysondre,384,warrior,fury,6,4,2
Infernall,burning-legion,384,warrior,fury,6,4,2
Bersurker,draenor,384,warrior,fury,6,4,2
Roadsick,outland,384,warrior,fury,6,4,2
Slux,outland,384,warrior,fury,6,4,2
Biboutons,sargeras,384,warrior,fury,6,4,2
Баам,fordragon,384,warrior,fury,6,4,2
Khvor,blackmoore,384,warrior,fury,6,4,2
Grumgor,alonsus,384,warrior,fury,6,4,2
Hugobugo,anachronos,384,warrior,fury,6,4,2
Stickifrån,darkspear,384,warrior,fury,6,4,2
Mórdér,blackmoore,384,warrior,fury,6,4,2
Warbigboss,draenor,384,warrior,fury,6,4,2
Jínfu,burning-legion,384,warrior,fury,6,4,2
Westwyde,hyjal,384,warrior,fury,6,4,2
Gandosh,blackmoore,384,warrior,fury,6,4,2
Гневныйвиги,howling-fjord,384,warrior,fury,6,4,2
Shuriká,blackmoore,384,warrior,fury,6,4,2
Имбасенпай,howling-fjord,384,warrior,fury,6,4,2
Nobelisarius,norgannon,384,warrior,fury,6,4,2
Purporcfr,archimonde,384,warrior,fury,6,4,2
Youngshorus,blackmoore,384,warrior,fury,6,4,2
Данзетар,howling-fjord,384,warrior,fury,6,4,2
Ändrow,dalaran,384,warrior,fury,6,4,2
Cheesehelmet,stormscale,384,warrior,fury,6,4,2
Strähne,malganis,384,warrior,fury,6,4,2
Gotnuub,tarren-mill,384,warrior,fury,6,4,2
Shooky,blackrock,384,warrior,fury,6,4,2
Razzani,nathrezim,384,warrior,fury,6,4,2
Чосо,razuvious,384,warrior,fury,6,4,2
Trexzor,argent-dawn,384,warrior,fury,6,4,2
Raikes,argent-dawn,384,warrior,fury,6,4,2
Dortenz,ragnaros,384,warrior,fury,6,4,2
Plebx,emeriss,384,warrior,fury,6,4,2
Gurrtug,argent-dawn,384,warrior,fury,6,4,2
Vixian,ragnaros,384,warrior,fury,6,4,2
Rageweight,ragnaros,384,warrior,fury,6,4,2
Moowar,defias-brotherhood,384,warrior,fury,6,4,2
Warrosh,defias-brotherhood,384,warrior,fury,6,4,2
Madvlad,twisting-nether,384,warrior,fury,6,4,2
Svinarghulk,twisting-nether,384,warrior,fury,6,4,2
Bigschnäbi,blackhand,384,warrior,fury,6,4,2
Pierøne,nemesis,384,warrior,fury,6,4,2
Chipstjuven,tarren-mill,384,warrior,fury,6,4,2
Mornog,blackhand,384,warrior,fury,6,4,2
Antícide,blackrock,384,warrior,fury,6,4,2
Vullgrîm,blackmoore,384,warrior,fury,6,4,2
Dmgsponge,stormscale,384,warrior,fury,6,4,2
Dollystyle,kazzak,384,warrior,fury,6,4,2
Айфилшок,gordunni,384,warrior,fury,6,4,2
Allric,sylvanas,384,warrior,fury,6,4,2
Slayermaxx,kazzak,384,warrior,fury,6,4,2
Wutrajunior,kazzak,384,warrior,fury,6,4,2
Zeldius,kazzak,384,warrior,fury,6,4,2
Maxrior,runetotem,384,warrior,fury,6,4,2
Anzzwar,silvermoon,384,warrior,fury,6,4,2
Бейлеор,gordunni,384,warrior,fury,6,4,2
Впижаме,gordunni,384,warrior,fury,6,4,2
Arkcules,ghostlands,384,warrior,fury,6,4,2
Кайзерчиф,soulflayer,384,warrior,fury,6,4,2
Isenstrider,burning-legion,384,warrior,fury,7,4,3
Kekiko,twisting-nether,384,warrior,fury,10,5,5
Sanhaevel,ravencrest,384,warrior,fury,10,4,6
Testonator,outland,384,warrior,fury,12,4,8
Ginroi,sunstrider,384,warrior,fury,12,4,8
Stamz,drakthul,384,warrior,fury,12,4,8
Bllué,ravencrest,384,warrior,fury,12,4,8
Sahl,sylvanas,384,warrior,fury,12,4,8
Барнетт,gordunni,384,warrior,fury,12,4,8
Bannedbybliz,garrosh,384,warrior,fury,12,4,8
Sabak,archimonde,384,warrior,fury,12,4,8
Sangremort,khaz-modan,384,warrior,fury,12,4,8
Überhase,taerar,384,warrior,fury,12,4,8
Акнаранд,soulflayer,384,warrior,fury,12,4,8
Råkeff,tarren-mill,384,warrior,fury,12,4,8
Ordínaryname,blackrock,384,warrior,fury,12,4,8
Bulletpants,argent-dawn,384,warrior,fury,12,4,8
Perfectblood,kazzak,384,warrior,fury,12,4,8
Rawne,kirin-tor,384,warrior,fury,12,4,8
Tanalias,outland,384,warrior,fury,12,4,8
Athérøs,outland,384,warrior,fury,12,4,8
Camaviinga,kazzak,384,warrior,fury,12,4,8
Aynerin,silvermoon,384,warrior,fury,12,4,8
Warfam,twisting-nether,384,warrior,fury,12,4,8
Shaxov,draenor,384,warrior,fury,12,4,8
Колобочек,eversong,384,warrior,fury,12,4,8
Bastrick,argent-dawn,384,warrior,fury,12,4,8
Aprilis,thrall,384,warrior,fury,12,4,8
Natriumwar,magtheridon,384,warrior,fury,12,4,8
Cranas,medivh,384,warrior,fury,12,4,8
Киссмиплис,gordunni,384,warrior,fury,12,4,8
Vãnquish,archimonde,384,warrior,fury,12,4,8
Vesterby,stormscale,384,warrior,fury,12,4,8
Blackhêart,shadowsong,384,warrior,fury,12,4,8
Hackzoro,grim-batol,384,warrior,fury,12,4,8
Yumahee,kult-der-verdammten,384,warrior,fury,12,4,8
Stillpetao,dun-modr,384,warrior,fury,12,4,8
Scrin,ravenholdt,384,warrior,fury,12,4,8
Причинный,booty-bay,384,warrior,fury,12,4,8
Аркашевич,gordunni,384,warrior,fury,12,4,8
Xial,ravencrest,384,warrior,fury,12,4,8
Utharis,stormscale,384,warrior,fury,12,4,8
Деспазитыч,fordragon,384,warrior,fury,12,4,8
Ruz,defias-brotherhood,384,warrior,fury,12,4,8
Добрыйборов,booty-bay,384,warrior,fury,12,4,8
Katmos,baelgun,384,warrior,fury,12,4,8
Zangetsú,stormscale,384,warrior,fury,12,4,8
Doomz,die-aldor,384,warrior,fury,12,4,8
Nexyycleave,kazzak,384,warrior,fury,12,4,8
Pattrock,blackmoore,384,warrior,fury,12,4,8
Jaru,alleria,384,warrior,fury,12,4,8
Ganzaésábi,aggra-português,384,warrior,fury,12,4,8
Sarkan,ravencrest,384,warrior,fury,12,4,8
Läskipää,argent-dawn,384,warrior,fury,12,4,8
Varkoz,sylvanas,384,warrior,fury,12,4,8
Skullcrûsher,archimonde,384,warrior,fury,12,4,8
Zorath,sanguino,384,warrior,fury,12,4,8
Daxhter,sanguino,384,warrior,fury,12,4,8
Neekero,burning-legion,384,warrior,fury,12,4,8
Grisettê,archimonde,384,warrior,fury,12,4,8
Tysonfurry,defias-brotherhood,384,warrior,fury,12,4,8
Vearpayne,silvermoon,384,warrior,fury,12,4,8
Fistawarrior,nemesis,384,warrior,fury,12,4,8
Sininemunn,alakir,384,warrior,fury,13,4,9
Garradoom,stormscale,384,warrior,fury,17,5,12
Séarix,blackrock,384,warrior,fury,18,4,14
Хенминия,blackscar,383,warrior,fury,6,4,2
Siltiel,marécage-de-zangar,383,warrior,fury,6,4,2
Voa,stormscale,383,warrior,fury,6,4,2
Bulbumbo,twisting-nether,383,warrior,fury,6,4,2
Dersaft,blackmoore,383,warrior,fury,9,5,4
Xhasan,sylvanas,383,warrior,fury,12,4,8
Basingaa,pozzo-delleternità,383,warrior,fury,12,4,8
Jún,dun-modr,383,warrior,fury,12,4,8
Haryssa,blackhand,383,warrior,fury,12,4,8
Xeonair,kazzak,383,warrior,fury,18,5,13
Ruuddy,draenor,382,warrior,fury,12,4,8
Biigjiim,doomhammer,381,warrior,fury,12,4,8
Colliderbody,dun-modr,367,warrior,fury,9,5,4
Scràvity,blackhand,367,warrior,fury,11,4,7
Proeliator,argent-dawn,367,warrior,fury,13,4,9
Kirzan,silvermoon,367,warrior,fury,17,4,13
Ооч,gordunni,361,warrior,fury,17,4,13
Slaba,stormscale,351,warrior,fury,11,4,7
Toxîn,dalaran,351,warrior,fury,11,4,7
Hembränt,hellfire,351,warrior,fury,17,4,13
Bossít,doomhammer,336,warrior,fury,9,4,5
Whitewash,sylvanas,336,warrior,fury,9,4,5
Kuró,archimonde,335,warrior,fury,8,5,3
Blackseven,ravencrest,330,warrior,fury,9,6,3
Sërgi,minahonda,320,warrior,fury,10,4,6
Fleshwerk,silvermoon,320,warrior,fury,10,4,6
Medioçre,ravencrest,319,warrior,fury,5,4,1
Isgrah,kazzak,319,warrior,fury,5,4,1
Zazate,archimonde,319,warrior,fury,5,4,1
Goinhamx,blackhand,319,warrior,fury,5,4,1
Хоркан,blackscar,319,warrior,fury,8,4,4
Phòbos,stormrage,319,warrior,fury,11,4,7
Groullomus,archimonde,318,warrior,fury,10,4,6
Anaba,voljin,318,warrior,fury,10,4,6
Komissarecks,aegwynn,288,warrior,fury,6,3,3
Druubak,aggra-português,288,warrior,fury,6,3,3
Barrocket,aegwynn,288,warrior,fury,6,3,3
Semanor,aegwynn,288,warrior,fury,6,3,3
Snakééyés,kazzak,288,warrior,fury,6,3,3
Merked,kazzak,288,warrior,fury,6,3,3
Kohhør,archimonde,288,warrior,fury,6,3,3
Âxti,blackrock,288,warrior,fury,6,3,3
Imabeatyoass,kazzak,288,warrior,fury,6,3,3
Azudaddy,blackmoore,288,warrior,fury,6,3,3
Mòrdréd,kazzak,288,warrior,fury,6,3,3
Deadlift,thunderhorn,288,warrior,fury,6,3,3
Argadea,archimonde,288,warrior,fury,6,3,3
Manký,kazzak,288,warrior,fury,6,3,3
Uthric,azuremyst,288,warrior,fury,6,3,3
Greenblób,kazzak,288,warrior,fury,6,3,3
Hayahol,kazzak,288,warrior,fury,6,3,3
Sucyenbrie,archimonde,288,warrior,fury,6,3,3
Pwndrizle,blackmoore,288,warrior,fury,6,3,3
Múndus,outland,288,warrior,fury,6,3,3
Kleptomane,blackrock,288,warrior,fury,6,3,3
Shaanks,archimonde,288,warrior,fury,6,3,3
Morthrang,defias-brotherhood,288,warrior,fury,6,3,3
Didgedelik,archimonde,288,warrior,fury,6,3,3
Azotz,archimonde,288,warrior,fury,6,3,3
Jaffacakes,kazzak,288,warrior,fury,6,3,3
Várkáld,nordrassil,288,warrior,fury,6,3,3
Qkazoo,nathrezim,288,warrior,fury,6,3,3
Exaldár,veknilash,288,warrior,fury,6,3,3
Drvx,twisting-nether,288,warrior,fury,6,3,3
Sathom,hyjal,288,warrior,fury,6,3,3
Brandøn,colinas-pardas,288,warrior,fury,6,3,3
Eatall,outland,288,warrior,fury,6,3,3
Shelied,twisting-nether,288,warrior,fury,6,3,3
Desprado,outland,288,warrior,fury,6,3,3
Drfeelgud,twisting-nether,288,warrior,fury,6,3,3
Auggies,outland,288,warrior,fury,6,3,3
Oombac,lordaeron,288,warrior,fury,6,3,3
Smâllpackage,silvermoon,288,warrior,fury,6,3,3
Мегавар,eversong,288,warrior,fury,6,3,3
Optiwarrior,turalyon,288,warrior,fury,6,3,3
Sovereign,kelthuzad,288,warrior,fury,6,3,3
Rasmoos,twisting-nether,288,warrior,fury,6,3,3
Bunsen,magtheridon,288,warrior,fury,6,3,3
Trìnítÿ,anubarak,288,warrior,fury,6,3,3
Zilg,twisting-nether,288,warrior,fury,6,3,3
Gnarrwarr,eredar,288,warrior,fury,6,3,3
Peon,eredar,288,warrior,fury,6,3,3
Xsann,argent-dawn,288,warrior,fury,6,3,3
Frankytank,antonidas,288,warrior,fury,6,3,3
Mídoriya,argent-dawn,288,warrior,fury,6,3,3
Lektor,eredar,288,warrior,fury,6,3,3
Previse,argent-dawn,288,warrior,fury,6,3,3
Corychase,ravencrest,288,warrior,fury,6,3,3
Carizona,twisting-nether,288,warrior,fury,6,3,3
Wëx,tarren-mill,288,warrior,fury,6,3,3
Ðæðlý,ravencrest,288,warrior,fury,6,3,3
Axxtm,ravencrest,288,warrior,fury,6,3,3
Laude,ragnaros,288,warrior,fury,6,3,3
Blackwólf,bloodhoof,288,warrior,fury,6,3,3
Ðennis,argent-dawn,288,warrior,fury,6,3,3
Ðöç,argent-dawn,288,warrior,fury,6,3,3
Finnyboi,ragnaros,288,warrior,fury,6,3,3
Uncledazzo,quelthalas,288,warrior,fury,6,3,3
Montralk,antonidas,288,warrior,fury,6,3,3
Döömed,drakthul,288,warrior,fury,6,3,3
Nakedwarrior,silvermoon,288,warrior,fury,6,3,3
Stormfàng,ragnaros,288,warrior,fury,6,3,3
Зандур,eversong,288,warrior,fury,6,3,3
Снакихснаки,gordunni,288,warrior,fury,6,3,3
Vjack,azjolnerub,288,warrior,fury,6,3,3
Wingüi,dun-modr,288,warrior,fury,6,3,3
Sóúl,nagrand,288,warrior,fury,6,3,3
Егермейстр,borean-tundra,288,warrior,fury,6,3,3
Атаир,deathweaver,288,warrior,fury,6,3,3
Wárríor,ragnaros,288,warrior,fury,6,3,3
Yøussifer,silvermoon,288,warrior,fury,6,3,3
Zarrgash,blackhand,288,warrior,fury,6,3,3
Dámpening,ravencrest,288,warrior,fury,6,3,3
Rägnât,dun-modr,288,warrior,fury,6,3,3
Whàtsup,stormscale,288,warrior,fury,6,3,3
Vernoz,sylvanas,288,warrior,fury,6,3,3
Syel,sinstralis,288,warrior,fury,6,3,3
Galanax,silvermoon,288,warrior,fury,6,3,3
Tidùs,nethersturm,288,warrior,fury,6,3,3
Lozzakum,draenor,288,warrior,fury,6,3,3
Lilenrage,stormscale,288,warrior,fury,6,3,3
Arachnoyd,drakthul,288,warrior,fury,6,3,3
Nifrediel,trollbane,288,warrior,fury,6,3,3
Jamiex,marécage-de-zangar,288,warrior,fury,6,3,3
Serakhan,argent-dawn,288,warrior,fury,6,3,3
Snuzil,the-maelstrom,288,warrior,fury,6,3,3
Lundehund,dalaran,288,warrior,fury,6,3,3
Tojaraa,kazzak,288,warrior,fury,6,3,3
Belliny,draenor,288,warrior,fury,6,3,3
Kopfnusskali,thrall,288,warrior,fury,6,3,3
Brel,suramar,288,warrior,fury,6,3,3
Sulemanslay,silvermoon,288,warrior,fury,6,3,3
Elffarian,the-maelstrom,288,warrior,fury,6,3,3
Slg,tarren-mill,288,warrior,fury,6,3,3
Rakuna,tarren-mill,288,warrior,fury,6,3,3
Keffboi,draenor,288,warrior,fury,6,3,3
Tequiero,zuljin,288,warrior,fury,6,3,3
Lovemilkers,stormscale,288,warrior,fury,6,3,3
Incharge,argent-dawn,288,warrior,fury,6,3,3
Alccont,stormscale,288,warrior,fury,6,3,3
Hellion,uldum,288,warrior,fury,6,3,3
Брэмбур,goldrinn,288,warrior,fury,6,3,3
Mumbojumbo,uldum,288,warrior,fury,6,3,3
Phalek,ravencrest,288,warrior,fury,6,3,3
Nightmareowl,tarren-mill,288,warrior,fury,6,3,3
Grinrok,thrall,288,warrior,fury,6,3,3
Бигбэйбитейп,greymane,288,warrior,fury,6,3,3
Bigbmh,tarren-mill,288,warrior,fury,6,3,3
Mfdoöm,draenor,288,warrior,fury,6,3,3
Ragébar,tarren-mill,288,warrior,fury,6,3,3
Ziglekk,thrall,288,warrior,fury,6,3,3
Tabboonishka,draenor,288,warrior,fury,6,3,3
Rakewar,draenor,288,warrior,fury,6,3,3
Karguk,blackhand,288,warrior,fury,6,3,3
Ýuritarded,silvermoon,288,warrior,fury,6,3,3
Ironlol,ravencrest,288,warrior,fury,6,3,3
Prettygucci,stormscale,288,warrior,fury,6,3,3
Keluke,thrall,288,warrior,fury,6,3,3
Uwuaraqtlol,stormscale,288,warrior,fury,6,3,3
Wunderwaffle,xavius,288,warrior,fury,6,3,3
Lagiovanni,draenor,288,warrior,fury,6,3,3
Androhan,silvermoon,288,warrior,fury,6,3,3
Cleavyera,tarren-mill,288,warrior,fury,6,3,3
Xerone,doomhammer,288,warrior,fury,6,3,3
Bernieboi,tarren-mill,288,warrior,fury,6,3,3
Sellblade,blackhand,288,warrior,fury,6,3,3
Sentrocks,sanguino,288,warrior,fury,6,3,3
Cryze,ravencrest,288,warrior,fury,6,3,3
Ijzerekast,sylvanas,288,warrior,fury,6,3,3
Ivailowar,ravencrest,288,warrior,fury,6,3,3
Stopdaddy,sylvanas,288,warrior,fury,6,3,3
Elyozz,silvermoon,288,warrior,fury,6,3,3
Ødräcîë,silvermoon,288,warrior,fury,6,3,3
Lebronjones,sylvanas,288,warrior,fury,6,3,3
Bigdbigarms,tarren-mill,288,warrior,fury,6,3,3
Dísplacement,draenor,288,warrior,fury,6,3,3
Elvedin,antonidas,288,warrior,fury,9,4,5
Nirut,blackrock,288,warrior,fury,9,4,5
Iluwar,ragnaros,288,warrior,fury,8,3,5
Mullen,thunderhorn,288,warrior,fury,8,3,5
Naspy,stormscale,288,warrior,fury,12,3,9
Wildò,frostwhisper,288,warrior,fury,12,3,9
Linkx,lightnings-blade,288,warrior,fury,12,3,9
Pamila,outland,288,warrior,fury,12,3,9
Titanstriker,silvermoon,288,warrior,fury,12,3,9
Оболис,galakrond,288,warrior,fury,12,3,9
Hördê,zuljin,288,warrior,fury,12,3,9
Gorkill,bladefist,288,warrior,fury,12,3,9
Uzuií,blackmoore,288,warrior,fury,12,3,9
Jebiga,forscherliga,288,warrior,fury,12,3,9
Barbbarus,silvermoon,288,warrior,fury,12,3,9
Drøgma,tyrande,288,warrior,fury,12,3,9
Nedart,grim-batol,288,warrior,fury,12,3,9
Хоусен,gordunni,288,warrior,fury,12,3,9
Daye,zuluhed,288,warrior,fury,12,3,9
Ònîsînîshêrû,kazzak,288,warrior,fury,12,3,9
Ireincarnate,argent-dawn,288,warrior,fury,12,3,9
Fullepixx,outland,288,warrior,fury,12,3,9
Høxy,outland,288,warrior,fury,12,3,9
Zyn,outland,288,warrior,fury,12,3,9
Phovoss,stormscale,288,warrior,fury,12,3,9
Сетт,howling-fjord,288,warrior,fury,12,3,9
Гхазгхкалл,howling-fjord,288,warrior,fury,12,3,9
Sudosolo,burning-blade,288,warrior,fury,12,3,9
Джондо,gordunni,288,warrior,fury,12,3,9
Киллдекс,gordunni,288,warrior,fury,12,3,9
Grommer,dentarg,288,warrior,fury,12,3,9
Arenameister,blackmoore,288,warrior,fury,12,3,9
Layä,krasus,288,warrior,fury,12,3,9
Ronflatter,blackrock,288,warrior,fury,12,3,9
Valldi,argent-dawn,288,warrior,fury,12,3,9
Zwheind,silvermoon,288,warrior,fury,12,3,9
Draggs,kazzak,288,warrior,fury,12,3,9
Urabrask,stormscale,288,warrior,fury,12,3,9
Conânan,blackrock,288,warrior,fury,12,3,9
Воинглад,gordunni,288,warrior,fury,12,3,9
Dragonvall,draenor,288,warrior,fury,12,3,9
Récksy,tarren-mill,288,warrior,fury,12,3,9
Skykrow,ysondre,288,warrior,fury,12,3,9
Bruks,antonidas,288,warrior,fury,12,3,9
Sisuthros,draenor,288,warrior,fury,12,3,9
Kyösti,defias-brotherhood,288,warrior,fury,12,3,9
Анимэ,blackscar,288,warrior,fury,12,3,9
Ôrcboi,tarren-mill,288,warrior,fury,12,3,9
Pekknekck,outland,288,warrior,fury,12,3,9
Aphae,defias-brotherhood,288,warrior,fury,12,3,9
Fitï,cthun,287,warrior,fury,6,3,3
Garuul,magtheridon,287,warrior,fury,6,3,3
Gartenzwerge,kelthuzad,287,warrior,fury,6,3,3
Arnnau,dun-modr,287,warrior,fury,6,3,3
Kasi,blackmoore,287,warrior,fury,6,3,3
Xragnar,sylvanas,287,warrior,fury,6,3,3
Atelier,magtheridon,287,warrior,fury,6,3,3
Shïn,kaelthas,287,warrior,fury,6,3,3
Azladan,sylvanas,287,warrior,fury,12,3,9
Luw,twisting-nether,287,warrior,fury,12,3,9
Sjuan,silvermoon,287,warrior,fury,12,3,9
Katmai,nemesis,287,warrior,fury,12,3,9
Agunnai,karazhan,286,warrior,fury,6,3,3
Weqeqf,kazzak,286,warrior,fury,6,3,3
Raffael,pozzo-delleternità,286,warrior,fury,12,3,9
Nidhoggr,frostwhisper,271,warrior,fury,11,3,8
Tchøkz,hyjal,271,warrior,fury,11,3,8
Aegís,drakthul,256,warrior,fury,10,3,7
Долирия,gordunni,255,warrior,fury,8,4,4
Клифф,gordunni,255,warrior,fury,11,3,8
Kilsorrow,silvermoon,240,warrior,fury,9,4,5
Makote,uldum,240,warrior,fury,9,3,6
Neozz,ravencrest,239,warrior,fury,5,3,2
Draur,archimonde,239,warrior,fury,5,3,2
Todesgewalt,kazzak,239,warrior,fury,5,3,2
Lutherion,drakthul,239,warrior,fury,5,3,2
Chilp,archimonde,239,warrior,fury,5,3,2
Execute,sanguino,239,warrior,fury,5,3,2
Daýz,draenor,234,warrior,fury,7,4,3
Zeldaixi,twisting-nether,234,warrior,fury,10,5,5
Perkutor,rashgarroth,234,warrior,fury,11,5,6
Xqt,laughing-skull,234,warrior,fury,9,4,5
Leapling,blackmoore,223,warrior,fury,6,4,2
Gargarensis,khadgar,223,warrior,fury,8,3,5
Iarsonn,drakthul,223,warrior,fury,8,3,5
Флокт,howling-fjord,208,warrior,fury,7,3,4
Deadlyanger,kazzak,208,warrior,fury,7,3,4
Имбанутыйвар,soulflayer,192,warrior,fury,4,3,1
Блудхаст,gordunni,192,warrior,fury,4,3,1
Mudryk,burning-blade,192,warrior,fury,4,3,1
Цезарь,greymane,192,warrior,fury,4,3,1
Балласёж,gordunni,192,warrior,fury,9,3,6
Themachine,burning-blade,192,warrior,fury,9,3,6
Ursakhan,sylvanas,192,warrior,fury,9,3,6
Elendurel,outland,192,warrior,fury,6,2,4
Wlâdimir,eredar,192,warrior,fury,6,2,4
Regulators,outland,192,warrior,fury,6,2,4
Gregórry,eredar,192,warrior,fury,6,2,4
Howdyfrau,eredar,192,warrior,fury,6,2,4
Боадрог,soulflayer,192,warrior,fury,6,2,4
Pacheco,eredar,192,warrior,fury,6,2,4
Ráksha,antonidas,192,warrior,fury,6,2,4
Rampage,ghostlands,192,warrior,fury,6,2,4
Brook,frostwolf,192,warrior,fury,6,2,4
Draskoé,hyjal,192,warrior,fury,6,2,4
Calebrind,ysondre,192,warrior,fury,6,2,4
Кунгфурик,soulflayer,192,warrior,fury,6,2,4
Janîtschar,eredar,192,warrior,fury,6,2,4
Wembley,proudmoore,192,warrior,fury,6,2,4
Goretterog,ysondre,192,warrior,fury,6,2,4
Demonraze,hyjal,192,warrior,fury,6,2,4
Кентафурик,soulflayer,192,warrior,fury,6,2,4
Syen,ysondre,192,warrior,fury,6,2,4
Buntstift,thrall,192,warrior,fury,6,2,4
Atälànte,ysondre,192,warrior,fury,6,2,4
Slamona,ravencrest,192,warrior,fury,6,2,4
Kennzz,ravencrest,192,warrior,fury,6,2,4
Crocbait,ravencrest,192,warrior,fury,6,2,4
Jambaz,ravencrest,192,warrior,fury,6,2,4
Watsabe,kazzak,192,warrior,fury,6,2,4
Piixxz,hyjal,192,warrior,fury,6,2,4
Kmag,ravencrest,192,warrior,fury,6,2,4
Falconer,ravencrest,192,warrior,fury,6,2,4
Ragehead,twisting-nether,192,warrior,fury,6,2,4
Cebystance,kazzak,192,warrior,fury,6,2,4
Jriddyzug,ravencrest,192,warrior,fury,6,2,4
Velgur,ravencrest,192,warrior,fury,6,2,4
Chrymiiee,blutkessel,192,warrior,fury,6,2,4
Rézinplin,archimonde,192,warrior,fury,6,2,4
Квистин,soulflayer,192,warrior,fury,6,2,4
Spaceløl,archimonde,192,warrior,fury,6,2,4
Glàek,archimonde,192,warrior,fury,6,2,4
Otp,ravencrest,192,warrior,fury,6,2,4
Romhilde,ravencrest,192,warrior,fury,6,2,4
Андрюхабш,soulflayer,192,warrior,fury,6,2,4
Приветсемье,deathguard,192,warrior,fury,6,2,4
Teñseî,archimonde,192,warrior,fury,6,2,4
Rayyes,stormscale,192,warrior,fury,6,2,4
Dárïus,kazzak,192,warrior,fury,6,2,4
Fookyoup,stormscale,192,warrior,fury,6,2,4
Oxxi,outland,192,warrior,fury,6,2,4
Deathrazór,stormscale,192,warrior,fury,6,2,4
Jaykr,stormscale,192,warrior,fury,6,2,4
Massivezug,kazzak,192,warrior,fury,6,2,4
Taÿ,stormscale,192,warrior,fury,6,2,4
Wïnqlùlz,archimonde,192,warrior,fury,6,2,4
Aaàaàaàa,stormscale,192,warrior,fury,6,2,4
Maniaco,kazzak,192,warrior,fury,6,2,4
Evilweraz,turalyon,192,warrior,fury,6,2,4
Aleis,stormscale,192,warrior,fury,6,2,4
Extazsion,stormscale,192,warrior,fury,6,2,4
Manwéx,silvermoon,192,warrior,fury,6,2,4
Armlock,ravencrest,192,warrior,fury,6,2,4
Raxur,kazzak,192,warrior,fury,6,2,4
Ellchefe,aggra-português,192,warrior,fury,6,2,4
Ezlx,stormscale,192,warrior,fury,6,2,4
Walkers,frostmane,192,warrior,fury,6,2,4
Hgfe,doomhammer,192,warrior,fury,6,2,4
Martins,doomhammer,192,warrior,fury,6,2,4
Oueban,doomhammer,192,warrior,fury,6,2,4
Lørð,frostmane,192,warrior,fury,6,2,4
Flundexý,todeswache,192,warrior,fury,6,2,4
Бургерс,soulflayer,192,warrior,fury,6,2,4
Onykat,aegwynn,192,warrior,fury,6,2,4
Alxqt,outland,192,warrior,fury,6,2,4
Azzaêl,blackhand,192,warrior,fury,6,2,4
Dariman,aegwynn,192,warrior,fury,6,2,4
Dabsimot,outland,192,warrior,fury,6,2,4
Xvlanter,silvermoon,192,warrior,fury,6,2,4
Optitt,dethecus,192,warrior,fury,6,2,4
Evillight,silvermoon,192,warrior,fury,6,2,4
Ærion,die-aldor,192,warrior,fury,6,2,4
Halberd,illidan,192,warrior,fury,6,2,4
Whitescale,silvermoon,192,warrior,fury,6,2,4
Nabucadnozor,illidan,192,warrior,fury,6,2,4
Искристый,howling-fjord,192,warrior,fury,6,2,4
Даммодар,howling-fjord,192,warrior,fury,6,2,4
Romxo,kazzak,192,warrior,fury,6,2,4
Tyranitar,pozzo-delleternità,192,warrior,fury,6,2,4
Seancollins,sunstrider,192,warrior,fury,6,2,4
Malyôrs,archimonde,192,warrior,fury,6,2,4
Каррагор,howling-fjord,192,warrior,fury,6,2,4
Pizivisiems,chromaggus,192,warrior,fury,6,2,4
Оверфлок,howling-fjord,192,warrior,fury,6,2,4
Opwarrko,drakthul,192,warrior,fury,6,2,4
Skullxy,talnivarr,192,warrior,fury,6,2,4
Ультрамариня,howling-fjord,192,warrior,fury,6,2,4
Crøwñd,twisting-nether,192,warrior,fury,6,2,4
Segovaxx,twisting-nether,192,warrior,fury,6,2,4
Stapta,kazzak,192,warrior,fury,6,2,4
Karkun,gilneas,192,warrior,fury,6,2,4
Zad,das-konsortium,192,warrior,fury,6,2,4
Enface,ragnaros,192,warrior,fury,6,2,4
Stormravager,balnazzar,192,warrior,fury,6,2,4
Kuran,outland,192,warrior,fury,6,2,4
Ragelust,twisting-nether,192,warrior,fury,6,2,4
Sgàthach,silvermoon,192,warrior,fury,6,2,4
Deadnamekill,ragnaros,192,warrior,fury,6,2,4
Vikiox,das-konsortium,192,warrior,fury,6,2,4
Mòrzàr,outland,192,warrior,fury,6,2,4
Dandada,arathor,192,warrior,fury,6,2,4
Tamadniakar,ragnaros,192,warrior,fury,6,2,4
Queak,kazzak,192,warrior,fury,6,2,4
Nokturnâl,silvermoon,192,warrior,fury,6,2,4
Papamatson,silvermoon,192,warrior,fury,6,2,4
Atlizz,twisting-nether,192,warrior,fury,6,2,4
Potatoslam,twisting-nether,192,warrior,fury,6,2,4
Whydeadbro,twisting-nether,192,warrior,fury,6,2,4
Zoulaani,argent-dawn,192,warrior,fury,6,2,4
Caitlyn,argent-dawn,192,warrior,fury,6,2,4
Rezn,kazzak,192,warrior,fury,6,2,4
Ragejuice,silvermoon,192,warrior,fury,6,2,4
Akkí,twisting-nether,192,warrior,fury,6,2,4
Versionx,stormscale,192,warrior,fury,6,2,4
Fuwy,argent-dawn,192,warrior,fury,6,2,4
Leviatrius,blackhand,192,warrior,fury,6,2,4
Zugzugcleave,blackrock,192,warrior,fury,6,2,4
Lianore,sanguino,192,warrior,fury,6,2,4
Holdemhammer,sanguino,192,warrior,fury,6,2,4
Ijzereter,argent-dawn,192,warrior,fury,6,2,4
Tedbuckland,blackrock,192,warrior,fury,6,2,4
Sputnikwarr,tarren-mill,192,warrior,fury,6,2,4
Гудмунт,borean-tundra,192,warrior,fury,6,2,4
Disith,dunemaul,192,warrior,fury,6,2,4
Nedåh,blackrock,192,warrior,fury,6,2,4
Thorzaram,argent-dawn,192,warrior,fury,6,2,4
Grimmbearock,amanthul,192,warrior,fury,6,2,4
Crystallake,blackrock,192,warrior,fury,6,2,4
Vaaýzx,blackrock,192,warrior,fury,6,2,4
Zaddi,blackrock,192,warrior,fury,6,2,4
Sertigan,dun-modr,192,warrior,fury,6,2,4
Pemex,stormreaver,192,warrior,fury,6,2,4
Kímbo,tarren-mill,192,warrior,fury,6,2,4
Nallen,the-venture-co,192,warrior,fury,6,2,4
Infernant,tarren-mill,192,warrior,fury,6,2,4
Брамон,gordunni,192,warrior,fury,6,2,4
Bladestormxx,blackmoore,192,warrior,fury,6,2,4
Тарттарион,gordunni,192,warrior,fury,6,2,4
Тевивар,gordunni,192,warrior,fury,6,2,4
Андертейкерх,gordunni,192,warrior,fury,6,2,4
Sleeplessjx,blackmoore,192,warrior,fury,6,2,4
Shreedshot,blackmoore,192,warrior,fury,6,2,4
Армгрид,gordunni,192,warrior,fury,6,2,4
Skrïllex,colinas-pardas,192,warrior,fury,6,2,4
Endermite,magtheridon,192,warrior,fury,6,2,4
Zirvey,tarren-mill,192,warrior,fury,6,2,4
Redow,stormreaver,192,warrior,fury,6,2,4
Vrokada,quelthalas,192,warrior,fury,6,2,4
Daywoe,spinebreaker,192,warrior,fury,6,2,4
Arozin,thrall,192,warrior,fury,6,2,4
Faugh,tarren-mill,192,warrior,fury,6,2,4
Søwtime,sanguino,192,warrior,fury,6,2,4
Guspy,sanguino,192,warrior,fury,6,2,4
Gewaltbereit,malygos,192,warrior,fury,6,2,4
Xilquib,darksorrow,192,warrior,fury,6,2,4
Zalazain,burning-legion,192,warrior,fury,6,2,4
Descending,xavius,192,warrior,fury,6,2,4
Lengthymort,tarren-mill,192,warrior,fury,6,2,4
Sefty,tarren-mill,192,warrior,fury,6,2,4
Lrb,tarren-mill,192,warrior,fury,6,2,4
Malalulu,burning-legion,192,warrior,fury,6,2,4
Zéox,baelgun,192,warrior,fury,6,2,4
Mîcî,tarren-mill,192,warrior,fury,6,2,4
Sïmstärxzy,hakkar,192,warrior,fury,6,2,4
Hradball,twilights-hammer,192,warrior,fury,6,2,4
Shíranuí,blackhand,192,warrior,fury,10,3,7
Karmok,hyjal,192,warrior,fury,7,2,5
Schneklinge,blutkessel,192,warrior,fury,8,2,6
Ikaroshi,silvermoon,192,warrior,fury,9,2,7
Buakaw,dalaran,192,warrior,fury,9,2,7
Армата,gordunni,192,warrior,fury,10,2,8
Thordis,sylvanas,192,warrior,fury,11,2,9
Smasherx,draenor,192,warrior,fury,12,2,10
Rageside,draenor,192,warrior,fury,12,2,10
Angrethar,tarren-mill,192,warrior,fury,12,2,10
Сажень,blackscar,192,warrior,fury,12,2,10
Bullie,magtheridon,192,warrior,fury,12,2,10
Andrjuscha,blackrock,192,warrior,fury,12,2,10
Davetsiz,burning-legion,192,warrior,fury,12,2,10
Bämoida,eredar,192,warrior,fury,12,2,10
Korova,blackrock,192,warrior,fury,12,2,10
Selethedrae,antonidas,192,warrior,fury,12,2,10
Kixx,twisting-nether,192,warrior,fury,12,2,10
Зигигодх,gordunni,192,warrior,fury,12,2,10
Joblôb,guldan,192,warrior,fury,12,2,10
Bätscher,nefarian,192,warrior,fury,12,2,10
Pakusrage,defias-brotherhood,192,warrior,fury,12,2,10
Urruk,archimonde,192,warrior,fury,12,2,10
Frowenn,ravencrest,192,warrior,fury,12,2,10
Sycon,chamber-of-aspects,192,warrior,fury,12,2,10
Altroox,malorne,192,warrior,fury,12,2,10
Killingstórm,kazzak,192,warrior,fury,12,2,10
Everest,aegwynn,192,warrior,fury,12,2,10
Зоранит,howling-fjord,192,warrior,fury,12,2,10
Gottfrie,argent-dawn,192,warrior,fury,12,2,10
Boofhoof,nordrassil,192,warrior,fury,12,2,10
Earny,outland,192,warrior,fury,12,2,10
Трапсир,gordunni,192,warrior,fury,12,2,10
Minotaureeni,silvermoon,192,warrior,fury,12,2,10
Rampage,azuremyst,192,warrior,fury,12,2,10
Alvis,nathrezim,191,warrior,fury,6,2,4
Tömahawk,defias-brotherhood,191,warrior,fury,6,2,4
Dorinaz,die-aldor,191,warrior,fury,6,2,4
Sakaî,temple-noir,191,warrior,fury,6,2,4
Кереешка,howling-fjord,175,warrior,fury,11,2,9
Bøyka,sinstralis,175,warrior,fury,11,2,9
Limejuicer,argent-dawn,169,warrior,fury,12,5,7
Marranu,cthun,159,warrior,fury,5,2,3
Wrcia,ragnaros,159,warrior,fury,5,2,3
Dampbob,draenor,159,warrior,fury,5,2,3
Møtomoto,defias-brotherhood,159,warrior,fury,5,2,3
Brülldozer,kargath,159,warrior,fury,5,2,3
Бэнкинс,blackscar,159,warrior,fury,8,3,5
Servion,ravencrest,138,warrior,fury,8,3,5
Cbahorde,outland,138,warrior,fury,8,3,5
Geicoo,dalaran,138,warrior,fury,16,4,12
Vlaax,ravencrest,138,warrior,fury,14,3,11
Confliction,outland,138,warrior,fury,17,3,14
Æxcoast,ravencrest,128,warrior,fury,4,2,2
Maldanor,confrérie-du-thorium,128,warrior,fury,4,2,2
Варнак,soulflayer,96,warrior,fury,3,2,1
Ög,archimonde,96,warrior,fury,3,2,1
Gorchak,blackmoore,96,warrior,fury,3,2,1
Krunchä,ragnaros,96,warrior,fury,3,2,1
Beeper,tarren-mill,96,warrior,fury,8,2,6
Марльин,howling-fjord,96,warrior,fury,6,1,5
Nismoon,culte-de-la-rive-noire,96,warrior,fury,6,1,5
Денеур,gordunni,96,warrior,fury,6,1,5
Онлихелл,howling-fjord,96,warrior,fury,6,1,5
Callipsa,argent-dawn,96,warrior,fury,6,1,5
Дуухаст,gordunni,96,warrior,fury,6,1,5
Karakaartall,silvermoon,96,warrior,fury,6,1,5
Bàal,kirin-tor,96,warrior,fury,6,1,5
Lavati,malganis,96,warrior,fury,6,1,5
Coldstory,draenor,96,warrior,fury,6,1,5
Wiliamwalace,zuljin,96,warrior,fury,6,1,5
Savedsky,zuljin,96,warrior,fury,6,1,5
Гайрана,razuvious,96,warrior,fury,6,1,5
Mexî,tarren-mill,96,warrior,fury,6,1,5
Рагкар,gordunni,96,warrior,fury,6,1,5
Slante,darksorrow,96,warrior,fury,6,1,5
Raixxon,ragnaros,96,warrior,fury,6,1,5
Parabellum,dun-modr,96,warrior,fury,6,1,5
Stromzy,silvermoon,96,warrior,fury,6,1,5
Rion,malganis,96,warrior,fury,6,1,5
Gormac,ragnaros,96,warrior,fury,6,1,5
Kaij,draenor,96,warrior,fury,6,1,5
Wifioffline,silvermoon,96,warrior,fury,6,1,5
Bladewound,draenor,96,warrior,fury,6,1,5
Furyfame,darksorrow,96,warrior,fury,6,1,5
Martoka,malganis,96,warrior,fury,6,1,5
Syphica,silvermoon,96,warrior,fury,6,1,5
Gokoff,ragnaros,96,warrior,fury,6,1,5
Raakalainen,vashj,96,warrior,fury,6,1,5
Ðý,silvermoon,96,warrior,fury,6,1,5
Jessepinkman,kirin-tor,96,warrior,fury,6,1,5
Diliul,doomhammer,96,warrior,fury,6,1,5
Tøytank,twisting-nether,96,warrior,fury,6,1,5
Bossness,turalyon,96,warrior,fury,6,1,5
Rïven,los-errantes,96,warrior,fury,6,1,5
Aiarm,twisting-nether,96,warrior,fury,6,1,5
Batoh,twisting-nether,96,warrior,fury,6,1,5
Opatos,tarren-mill,96,warrior,fury,6,1,5
Фиббоначи,deathguard,96,warrior,fury,6,1,5
Notsyn,twisting-nether,96,warrior,fury,6,1,5
Mynameisjohn,kazzak,96,warrior,fury,6,1,5
Jungar,magtheridon,96,warrior,fury,6,1,5
Tafler,twisting-nether,96,warrior,fury,6,1,5
Salom,illidan,96,warrior,fury,6,1,5
Sahaminho,draenor,96,warrior,fury,6,1,5
Noopany,kazzak,96,warrior,fury,6,1,5
Инфлэймх,gordunni,96,warrior,fury,6,1,5
Флагмэн,gordunni,96,warrior,fury,6,1,5
Fitzgibbons,ravencrest,96,warrior,fury,6,1,5
Orchilles,alakir,96,warrior,fury,6,1,5
Nýbz,sylvanas,96,warrior,fury,6,1,5
Janobito,blackmoore,96,warrior,fury,6,1,5
Proteingris,tarren-mill,96,warrior,fury,6,1,5
Håren,frostmane,96,warrior,fury,6,1,5
Тоштайн,gordunni,96,warrior,fury,6,1,5
Xenowarr,tarren-mill,96,warrior,fury,6,1,5
Армапипец,soulflayer,96,warrior,fury,6,1,5
Stratic,blackmoore,96,warrior,fury,6,1,5
Cárlsberg,pozzo-delleternità,96,warrior,fury,6,1,5
Анстасмэш,soulflayer,96,warrior,fury,6,1,5
Marícan,blackmoore,96,warrior,fury,6,1,5
Kalithon,der-rat-von-dalaran,96,warrior,fury,6,1,5
Matchoo,archimonde,96,warrior,fury,6,1,5
Модныйклык,eversong,96,warrior,fury,6,1,5
Bokth,archimonde,96,warrior,fury,6,1,5
Bababuii,blackmoore,96,warrior,fury,6,1,5
Nînes,tarren-mill,96,warrior,fury,6,1,5
Narkzsthki,kazzak,96,warrior,fury,6,1,5
Varruth,tarren-mill,96,warrior,fury,6,1,5
Monkeyfury,archimonde,96,warrior,fury,6,1,5
Classi,tarren-mill,96,warrior,fury,6,1,5
Mot,terenas,96,warrior,fury,6,1,5
Arowbaze,archimonde,96,warrior,fury,6,1,5
Malebolia,mugthol,96,warrior,fury,6,1,5
Hordox,archimonde,96,warrior,fury,6,1,5
Видманта,gordunni,96,warrior,fury,6,1,5
Gotar,ravencrest,96,warrior,fury,6,1,5
Misiaczek,the-maelstrom,96,warrior,fury,6,1,5
Уравниттель,gordunni,96,warrior,fury,6,1,5
Greekazi,kazzak,96,warrior,fury,6,1,5
Gellios,kazzak,96,warrior,fury,6,1,5
Fønex,sylvanas,96,warrior,fury,6,1,5
Aagony,hyjal,96,warrior,fury,6,1,5
Karreg,hyjal,96,warrior,fury,6,1,5
Warduvel,dragonblight,96,warrior,fury,6,1,5
Bladoran,hyjal,96,warrior,fury,6,1,5
Kysse,hyjal,96,warrior,fury,6,1,5
Gameera,aerie-peak,96,warrior,fury,6,1,5
Спаццифика,soulflayer,96,warrior,fury,6,1,5
Nellytkø,eredar,96,warrior,fury,6,1,5
Bjornalf,silvermoon,96,warrior,fury,6,1,5
Demirkol,outland,96,warrior,fury,6,1,5
Grozgeg,garona,96,warrior,fury,6,1,5
Zhadsnark,blackrock,96,warrior,fury,6,1,5
Krevó,ragnaros,96,warrior,fury,6,1,5
Sigewulf,outland,96,warrior,fury,6,1,5
Chadtherad,draenor,96,warrior,fury,6,1,5
Magooth,kazzak,96,warrior,fury,6,1,5
Dp,area-52,96,warrior,fury,6,1,5
Ayelsyssup,silvermoon,96,warrior,fury,6,1,5
Znorro,trollbane,96,warrior,fury,6,1,5
Kerpi,silvermoon,96,warrior,fury,6,1,5
Spacemachine,kazzak,96,warrior,fury,6,1,5
Dikkefeld,trollbane,96,warrior,fury,6,1,5
Feltias,drakthul,96,warrior,fury,6,1,5
Swordluw,argent-dawn,96,warrior,fury,6,1,5
Hammerfall,uldum,96,warrior,fury,6,1,5
Ghøst,frostwolf,96,warrior,fury,6,1,5
Dosenorc,frostwolf,96,warrior,fury,6,1,5
Hdarriia,ysondre,96,warrior,fury,6,1,5
Grimmrock,gorgonnash,96,warrior,fury,6,1,5
Kronstris,veklor,96,warrior,fury,6,1,5
Кимлий,deathweaver,96,warrior,fury,6,1,5
Krônôs,thrall,96,warrior,fury,6,1,5
Mazelion,ambossar,96,warrior,fury,6,1,5
Cäös,sanguino,96,warrior,fury,12,1,11
Jdiggidy,ravencrest,96,warrior,fury,12,1,11
Quandaledngl,silvermoon,96,warrior,fury,12,1,11
Tochka,kazzak,96,warrior,fury,12,1,11
Fïreflý,kazzak,96,warrior,fury,12,1,11
Zarolk,rashgarroth,96,warrior,fury,12,1,11
Анури,eversong,96,warrior,fury,12,1,11
Dräparren,ragnaros,96,warrior,fury,14,1,13
Kaodes,outland,96,warrior,fury,17,1,16
Bladewolf,khadgar,95,warrior,fury,12,1,11
Nutz,archimonde,89,warrior,fury,7,3,4
Trickzît,silvermoon,79,warrior,fury,5,1,4
Skederon,chogall,79,warrior,fury,5,1,4
Sydre,nerathor,64,warrior,fury,4,1,3
Frézzér,blackrock,64,warrior,fury,4,1,3
Krachz,draenor,63,warrior,fury,2,2,0
Lægend,hyjal,63,warrior,fury,8,2,6
Kellja,aggramar,48,warrior,fury,3,1,2
Cowbatant,darkspear,48,warrior,fury,3,1,2
Elkatar,stormscale,46,warrior,fury,23,6,17
Ieatprotein,kazzak,42,warrior,fury,7,3,4
Hellzint,sanguino,42,warrior,fury,7,2,5
Skyvajt,drakthul,42,warrior,fury,8,2,6
Pappasmurfy,outland,42,warrior,fury,10,2,8
Olriksen,dentarg,31,warrior,fury,2,1,1
Vivrya,silvermoon,31,warrior,fury,2,1,1
Josimar,kazzak,31,warrior,fury,2,1,1
Shinobú,blackrock,16,warrior,fury,1,1,0
Threa,drekthar,16,warrior,fury,7,1,6
Fatbud,tarren-mill,16,warrior,fury,7,1,6
Marcus,ravencrest,2254,warrior,arms,150,79,71
Therealman,kazzak,2224,warrior,arms,97,52,45
Réckx,twisting-nether,2217,warrior,arms,117,62,55
Dõxqt,kazzak,2204,warrior,arms,86,49,37
Scardrex,defias-brotherhood,2172,warrior,arms,94,49,45
Palianytsia,ravencrest,2170,warrior,arms,89,47,42
Sickjackenn,executus,2166,warrior,arms,111,58,53
Luphrek,ysondre,2158,warrior,arms,96,50,46
Oswáld,defias-brotherhood,2152,warrior,arms,74,55,19
Midgetdamis,blackhand,2147,warrior,arms,137,87,50
Okcool,twisting-nether,2147,warrior,arms,114,64,50
Whýsøsîleñt,ragnaros,2139,warrior,arms,94,58,36
Semmino,nemesis,2137,warrior,arms,84,46,38
Dunecrab,tarren-mill,2131,warrior,arms,197,108,89
Blîxtgordon,tarren-mill,2125,warrior,arms,126,66,60
Лёшавор,howling-fjord,2125,warrior,arms,126,65,61
Regnarok,sylvanas,2124,warrior,arms,268,147,121
Palmexwar,drakthul,2123,warrior,arms,198,106,92
Sickjackenx,executus,2121,warrior,arms,222,117,105
Rhâpsodyw,ravencrest,2116,warrior,arms,277,151,126
Joißoi,dalaran,2116,warrior,arms,238,126,112
Ðävïðßëckhäm,stormscale,2116,warrior,arms,80,41,39
Tpyñåöädxzd,the-maelstrom,2116,warrior,arms,88,45,43
Gabrijel,draenor,2116,warrior,arms,277,139,138
Tozzhug,ragnaros,2114,warrior,arms,135,76,59
Кокдиллак,soulflayer,2113,warrior,arms,160,82,78
Скварх,howling-fjord,2112,warrior,arms,120,74,46
Kartha,stormscale,2106,warrior,arms,90,50,40
Ulrid,draenor,2106,warrior,arms,198,104,94
Фрейз,deathweaver,2105,warrior,arms,78,49,29
Grkpwh,silvermoon,2105,warrior,arms,88,48,40
Yarilolx,outland,2103,warrior,arms,73,42,31
Immørtálx,tarren-mill,2102,warrior,arms,72,38,34
Стефанидзе,soulflayer,2101,warrior,arms,66,37,29
Sekwar,twisting-nether,2101,warrior,arms,77,38,39
Anahkas,archimonde,2093,warrior,arms,138,72,66
Sneakydrm,kazzak,2085,warrior,arms,88,48,40
Mastodøntes,hyjal,2071,warrior,arms,113,59,54
Ðênnis,ravencrest,2062,warrior,arms,54,31,23
Соджиро,howling-fjord,2053,warrior,arms,114,54,60
Compétiteub,archimonde,2051,warrior,arms,113,59,54
Amokdamis,blackhand,2047,warrior,arms,104,49,55
Miniphrek,ravencrest,2045,warrior,arms,90,43,47
Sharpen,chamber-of-aspects,2044,warrior,arms,122,60,62
Варплеер,gordunni,2039,warrior,arms,66,32,34
Ässholedamis,blackhand,2038,warrior,arms,78,54,24
Markers,twisting-nether,2038,warrior,arms,243,119,124
Anahkäs,archimonde,2038,warrior,arms,102,48,54
Kûrûmî,blackmoore,2035,warrior,arms,119,77,42
Anakhas,archimonde,2030,warrior,arms,108,51,57
Connorzw,blackmoore,2029,warrior,arms,71,41,30
Yorgal,arakarahm,2020,warrior,arms,185,89,96
Рвбстох,blackscar,2019,warrior,arms,166,91,75
Seifcham,ragnaros,2017,warrior,arms,317,155,162
Nazrihk,ravencrest,2014,warrior,arms,139,74,65
Jessicaday,archimonde,2013,warrior,arms,72,37,35
Nikkí,naxxramas,2013,warrior,arms,102,51,51
Irherklek,stormscale,2011,warrior,arms,59,35,24
Purporcfr,archimonde,2011,warrior,arms,148,80,68
Zhrey,stormscale,2010,warrior,arms,195,95,100
Marex,grim-batol,2008,warrior,arms,78,40,38
Ironmásk,tarren-mill,2006,warrior,arms,54,32,22
Pentagramlol,twisting-nether,2003,warrior,arms,73,40,33
Quotx,stormscale,2001,warrior,arms,129,61,68
Manaskhan,tarren-mill,2000,warrior,arms,213,111,102
Yarilol,aegwynn,1999,warrior,arms,36,21,15
Trâshwarriør,blackhand,1998,warrior,arms,62,27,35
Konebankærn,ravencrest,1997,warrior,arms,108,54,54
Joeférnandes,ragnaros,1996,warrior,arms,77,38,39
Zhoti,outland,1995,warrior,arms,82,43,39
Wràthfúl,kazzak,1995,warrior,arms,143,74,69
Pürporc,archimonde,1994,warrior,arms,100,53,47
Олдборовс,soulflayer,1993,warrior,arms,92,51,41
Galeron,kazzak,1992,warrior,arms,102,48,54
Mitu,sanguino,1990,warrior,arms,257,130,127
Куртфорренс,gordunni,1990,warrior,arms,206,101,105
Merked,kazzak,1989,warrior,arms,102,49,53
Thomasman,nerathor,1989,warrior,arms,138,64,74
Оркабал,howling-fjord,1988,warrior,arms,195,101,94
Arsinal,blackhand,1987,warrior,arms,85,46,39
Lostday,blackrock,1987,warrior,arms,242,125,117
Mercey,stormscale,1987,warrior,arms,65,31,34
Benzemá,sanguino,1984,warrior,arms,130,77,53
Elbutanero,tarren-mill,1982,warrior,arms,84,48,36
Disarmed,auchindoun,1979,warrior,arms,108,58,50
Scherø,aegwynn,1977,warrior,arms,76,45,31
Pürporcc,archimonde,1976,warrior,arms,222,115,107
Qtcockxx,stormscale,1974,warrior,arms,90,45,45
Asquare,stormscale,1973,warrior,arms,76,40,36
Zak,stormscale,1968,warrior,arms,136,63,73
Варзила,blackscar,1966,warrior,arms,86,44,42
Stupidz,hyjal,1966,warrior,arms,66,32,34
Myonmyonmyon,blackmoore,1965,warrior,arms,98,56,42
Dominikhasek,stormscale,1963,warrior,arms,94,56,38
Assgar,silvermoon,1962,warrior,arms,83,46,37
Theryk,sanguino,1962,warrior,arms,201,97,104
Ðöç,argent-dawn,1962,warrior,arms,84,40,44
Shortcvnt,ravencrest,1960,warrior,arms,72,37,35
Ðennis,argent-dawn,1959,warrior,arms,96,60,36
Apacolata,outland,1959,warrior,arms,63,34,29
Rînus,aegwynn,1957,warrior,arms,66,33,33
Cerry,ravencrest,1954,warrior,arms,165,82,83
Kaieh,argent-dawn,1953,warrior,arms,60,39,21
Joéfernandés,sylvanas,1950,warrior,arms,47,26,21
Аэска,deathweaver,1950,warrior,arms,78,38,40
Dantius,nemesis,1950,warrior,arms,102,49,53
Purpórc,archimonde,1947,warrior,arms,65,35,30
Javakt,stormscale,1947,warrior,arms,389,193,196
Mômsboy,tarren-mill,1946,warrior,arms,76,39,37
Schwän,twisting-nether,1943,warrior,arms,60,32,28
Reysleys,mazrigos,1943,warrior,arms,151,76,75
Wingüi,dun-modr,1942,warrior,arms,156,74,82
Skyowner,twisting-nether,1940,warrior,arms,57,33,24
Blizo,tarren-mill,1938,warrior,arms,62,36,26
Downpippuri,silvermoon,1938,warrior,arms,276,156,120
Regnarøk,sylvanas,1937,warrior,arms,89,55,34
Lexiliuz,twisting-nether,1937,warrior,arms,72,44,28
Dragondeznut,ravencrest,1935,warrior,arms,78,38,40
Midnightrain,archimonde,1934,warrior,arms,66,35,31
Джерамин,blackscar,1934,warrior,arms,77,35,42
Messermozart,blackmoore,1933,warrior,arms,90,44,46
Kwasimodo,blackmoore,1933,warrior,arms,70,30,40
Downpipe,twisting-nether,1932,warrior,arms,215,113,102
Velcorn,ravencrest,1931,warrior,arms,54,26,28
Infernion,jaedenar,1930,warrior,arms,48,30,18
Belver,argent-dawn,1929,warrior,arms,38,22,16
Бэнчпресс,soulflayer,1929,warrior,arms,66,33,33
Pawnerlol,mannoroth,1928,warrior,arms,114,54,60
Xurainzone,eredar,1927,warrior,arms,83,43,40
Drclapit,blackrock,1927,warrior,arms,66,30,36
Chucho,argent-dawn,1924,warrior,arms,72,40,32
Вэшикх,soulflayer,1924,warrior,arms,155,79,76
Colard,ravencrest,1924,warrior,arms,60,28,32
Kapuchino,twisting-nether,1921,warrior,arms,48,27,21
Elwarroo,dun-modr,1921,warrior,arms,388,199,189
Zodiac,aggra-português,1919,warrior,arms,66,35,31
Wasro,norgannon,1919,warrior,arms,178,92,86
Lilsweép,draenor,1917,warrior,arms,66,36,30
Zugzugcleave,blackrock,1916,warrior,arms,87,48,39
Jenkinzz,stormscale,1916,warrior,arms,294,155,139
Dabr,stormscale,1916,warrior,arms,61,32,29
Буккакеньер,gordunni,1914,warrior,arms,60,33,27
Doomqt,terokkar,1912,warrior,arms,53,29,24
Seifchamqt,ragnaros,1912,warrior,arms,163,89,74
Bravopla,silvermoon,1912,warrior,arms,108,55,53
Belattor,silvermoon,1912,warrior,arms,66,31,35
Timpey,kazzak,1911,warrior,arms,54,30,24
Комочекгнева,howling-fjord,1909,warrior,arms,235,118,117
Mckinseybcg,outland,1906,warrior,arms,209,119,90
Tonyyuu,aegwynn,1905,warrior,arms,71,37,34
Nstx,dun-modr,1902,warrior,arms,60,32,28
Valoo,malganis,1902,warrior,arms,211,108,103
Ущипнузатитю,deathguard,1900,warrior,arms,126,63,63
Длоордпро,soulflayer,1900,warrior,arms,65,29,36
Atrôcithy,silvermoon,1898,warrior,arms,60,31,29
Gewyon,ragnaros,1897,warrior,arms,102,49,53
Çatàclysmíc,kazzak,1896,warrior,arms,138,69,69
Фокатоп,blackscar,1895,warrior,arms,54,28,26
Jeriko,archimonde,1895,warrior,arms,47,21,26
Julololo,archimonde,1893,warrior,arms,72,40,32
Zåk,stormscale,1892,warrior,arms,42,20,22
Рукзуф,razuvious,1890,warrior,arms,29,21,8
Pantsupic,archimonde,1890,warrior,arms,60,24,36
Toscothegoat,ravencrest,1889,warrior,arms,54,36,18
Courageous,ravencrest,1889,warrior,arms,66,39,27
Saurens,twisting-nether,1889,warrior,arms,144,68,76
Æriø,dalaran,1888,warrior,arms,54,30,24
Tsuperman,tarren-mill,1888,warrior,arms,72,37,35
Notthateasy,blackrock,1887,warrior,arms,42,24,18
Wargoth,draenor,1886,warrior,arms,105,57,48
Лилиофаныч,soulflayer,1886,warrior,arms,71,38,33
Klonyarikjr,ravencrest,1884,warrior,arms,36,22,14
Thenx,tarren-mill,1884,warrior,arms,257,125,132
Nipes,nozdormu,1883,warrior,arms,217,108,109
Døkidøki,silvermoon,1882,warrior,arms,479,244,235
Брамон,gordunni,1881,warrior,arms,40,26,14
Куесэс,howling-fjord,1880,warrior,arms,36,20,16
Karny,ravencrest,1880,warrior,arms,192,99,93
Purporcc,archimonde,1880,warrior,arms,87,40,47
Gnømércy,stormscale,1878,warrior,arms,42,22,20
Gulläx,burning-legion,1878,warrior,arms,42,20,22
Klonyarik,ravencrest,1877,warrior,arms,42,22,20
Флагмэн,gordunni,1876,warrior,arms,89,50,39
Everdipper,outland,1876,warrior,arms,97,48,49
Trapoulas,kazzak,1876,warrior,arms,166,79,87
Cathériné,drakthul,1875,warrior,arms,48,27,21
Alegral,ravencrest,1875,warrior,arms,325,158,167
Allthèwayup,kazzak,1875,warrior,arms,69,32,37
Фрейз,blackscar,1874,warrior,arms,70,34,36
Craanked,aegwynn,1873,warrior,arms,88,44,44
Europ,silvermoon,1873,warrior,arms,264,129,135
Urmack,ravencrest,1872,warrior,arms,54,41,13
Aixer,archimonde,1871,warrior,arms,73,35,38
Шурпач,deathguard,1870,warrior,arms,102,54,48
Liptonxecute,blackhand,1870,warrior,arms,118,61,57
Pända,archimonde,1868,warrior,arms,125,54,71
Gguts,archimonde,1867,warrior,arms,97,53,44
Кимлий,deathweaver,1866,warrior,arms,204,97,107
Kamked,burning-legion,1864,warrior,arms,167,81,86
Magnî,auchindoun,1863,warrior,arms,97,53,44
Сетт,howling-fjord,1863,warrior,arms,86,42,44
Xåb,dun-morogh,1863,warrior,arms,84,37,47
Екзобайт,gordunni,1862,warrior,arms,101,55,46
Prymebeevz,blackmoore,1861,warrior,arms,84,52,32
Kurbá,stormscale,1858,warrior,arms,54,30,24
Hashladun,draenor,1857,warrior,arms,36,23,13
Feckdech,blackrock,1857,warrior,arms,53,32,21
Grimogør,stormscale,1857,warrior,arms,48,27,21
Shooky,blackrock,1857,warrior,arms,67,34,33
Pivcuga,kazzak,1857,warrior,arms,313,158,155
Saidi,outland,1857,warrior,arms,439,216,223
Ønogal,archimonde,1856,warrior,arms,120,56,64
Kiyomaro,stormscale,1855,warrior,arms,84,46,38
Vallenwar,twisting-nether,1854,warrior,arms,63,42,21
Mirageous,tarren-mill,1854,warrior,arms,83,46,37
Matrixer,aegwynn,1853,warrior,arms,47,28,19
Wake,eredar,1853,warrior,arms,60,32,28
Ланро,gordunni,1853,warrior,arms,65,33,32
Jammy,dentarg,1853,warrior,arms,84,41,43
Àlexander,ravencrest,1852,warrior,arms,35,20,15
Aeyon,burning-blade,1852,warrior,arms,51,29,22
Rec,thrall,1851,warrior,arms,42,23,19
Reacôn,twisting-nether,1851,warrior,arms,52,28,24
Balthew,defias-brotherhood,1851,warrior,arms,48,24,24
Yseras,aegwynn,1851,warrior,arms,89,39,50
Leeches,aggramar,1850,warrior,arms,66,35,31
Акнаранд,soulflayer,1850,warrior,arms,48,25,23
Mtc,blackrock,1850,warrior,arms,110,55,55
Skorm,mugthol,1849,warrior,arms,36,27,9
Reckqtw,eredar,1849,warrior,arms,92,50,42
Schaufelørc,blackrock,1849,warrior,arms,120,60,60
Mtctwo,blackrock,1849,warrior,arms,108,52,56
Slowann,argent-dawn,1848,warrior,arms,208,111,97
Элетий,soulflayer,1848,warrior,arms,66,31,35
Зотлолпромвп,booty-bay,1847,warrior,arms,170,84,86
Krônm,dun-modr,1847,warrior,arms,78,33,45
Guter,kazzak,1846,warrior,arms,180,93,87
Dortenz,ragnaros,1846,warrior,arms,72,31,41
Chippéd,draenor,1845,warrior,arms,46,28,18
Goatie,frostwhisper,1844,warrior,arms,42,30,12
Gaav,burning-legion,1844,warrior,arms,381,182,199
Civok,kult-der-verdammten,1844,warrior,arms,66,31,35
Фокатопх,blackscar,1843,warrior,arms,66,30,36
Zirêael,kazzak,1843,warrior,arms,96,43,53
Rbbx,tarren-mill,1842,warrior,arms,68,33,35
Orthoss,archimonde,1842,warrior,arms,184,88,96
Zéox,baelgun,1840,warrior,arms,53,30,23
Lrb,tarren-mill,1840,warrior,arms,258,138,120
Jriddyzug,ravencrest,1840,warrior,arms,62,33,29
Wuifly,dun-modr,1840,warrior,arms,279,140,139
Selenez,outland,1840,warrior,arms,91,44,47
Môtu,aegwynn,1839,warrior,arms,60,29,31
Enøt,kazzak,1839,warrior,arms,53,25,28
Sagethi,blackrock,1839,warrior,arms,89,41,48
Avgålöfvén,stormscale,1838,warrior,arms,27,21,6
Мираккл,borean-tundra,1838,warrior,arms,36,21,15
Орданис,deathguard,1838,warrior,arms,66,33,33
Vory,ravencrest,1837,warrior,arms,108,61,47
Eidzo,tarren-mill,1837,warrior,arms,84,45,39
Nolóve,archimonde,1837,warrior,arms,192,99,93
Артагор,blackscar,1836,warrior,arms,53,33,20
Zäløøpå,kazzak,1836,warrior,arms,43,25,18
Hasbullá,kazzak,1836,warrior,arms,400,204,196
Vvulf,eredar,1836,warrior,arms,71,31,40
Kanté,burning-blade,1834,warrior,arms,41,24,17
Greenblób,kazzak,1834,warrior,arms,72,31,41
Juggernãut,ravencrest,1833,warrior,arms,159,86,73
Salpaaja,frostwhisper,1833,warrior,arms,66,28,38
Howdoulose,dun-modr,1832,warrior,arms,54,35,19
Goldrage,archimonde,1832,warrior,arms,76,41,35
Хэйре,howling-fjord,1832,warrior,arms,238,122,116
Karpzug,stormscale,1832,warrior,arms,45,22,23
Blåvingad,kazzak,1831,warrior,arms,56,34,22
Боссберс,soulflayer,1831,warrior,arms,89,44,45
Rhagnok,archimonde,1831,warrior,arms,180,87,93
Watrux,outland,1831,warrior,arms,66,31,35
Jasi,kazzak,1830,warrior,arms,72,44,28
Воинлета,howling-fjord,1830,warrior,arms,101,60,41
Matti,magtheridon,1830,warrior,arms,53,29,24
Qapper,kazzak,1830,warrior,arms,57,28,29
Shchoor,ravencrest,1830,warrior,arms,48,23,25
Khÿze,ysondre,1829,warrior,arms,58,39,19
Mirpz,doomhammer,1829,warrior,arms,48,31,17
Klearr,silvermoon,1829,warrior,arms,91,56,35
Njn,argent-dawn,1829,warrior,arms,48,23,25
Goorila,kazzak,1829,warrior,arms,54,25,29
Демиорт,howling-fjord,1828,warrior,arms,255,144,111
Balenciarmor,silvermoon,1828,warrior,arms,54,26,28
Kragrâu,kazzak,1828,warrior,arms,83,39,44
Nightmareowl,tarren-mill,1827,warrior,arms,136,76,60
Blazefüry,ravencrest,1827,warrior,arms,61,33,28
Xiro,hellscream,1826,warrior,arms,81,50,31
Thafold,eredar,1826,warrior,arms,77,43,34
Bladrun,frostmane,1826,warrior,arms,120,67,53
Ragestarved,ragnaros,1826,warrior,arms,137,64,73
Starscourge,tarren-mill,1825,warrior,arms,114,85,29
Ярыйваряг,soulflayer,1825,warrior,arms,48,30,18
Ändrow,dalaran,1825,warrior,arms,114,64,50
Darshan,grim-batol,1825,warrior,arms,84,41,43
Nurekin,argent-dawn,1825,warrior,arms,66,32,34
Magmos,terenas,1825,warrior,arms,66,30,36
Köftemecx,blackrock,1824,warrior,arms,70,42,28
Rivah,tarren-mill,1824,warrior,arms,63,34,29
Bigdstance,outland,1824,warrior,arms,173,92,81
Xurainlol,eredar,1824,warrior,arms,58,29,29
Ðezia,tarren-mill,1823,warrior,arms,168,94,74
Naskwar,archimonde,1823,warrior,arms,60,31,29
Ozrenac,kazzak,1823,warrior,arms,213,109,104
Дроктул,howling-fjord,1823,warrior,arms,645,329,316
Ðior,bronze-dragonflight,1822,warrior,arms,53,29,24
Augustus,runetotem,1822,warrior,arms,345,183,162
Пробуюстерву,soulflayer,1822,warrior,arms,72,33,39
Crîxús,silvermoon,1822,warrior,arms,60,25,35
Badgenius,nemesis,1821,warrior,arms,42,26,16
Asçrðth,kazzak,1821,warrior,arms,54,26,28
Corvy,ravencrest,1821,warrior,arms,54,25,29
Rngmonster,kazzak,1820,warrior,arms,100,68,32
Uzamaki,bronzebeard,1820,warrior,arms,48,32,16
Мокдэмвп,soulflayer,1820,warrior,arms,36,23,13
Knutrex,tarren-mill,1820,warrior,arms,61,35,26
Xxeqtr,kazzak,1820,warrior,arms,166,80,86
Лимпс,gordunni,1819,warrior,arms,30,19,11
Shînta,hyjal,1819,warrior,arms,35,22,13
Vandarms,archimonde,1819,warrior,arms,59,35,24
Flinta,blackmoore,1819,warrior,arms,90,51,39
Maarshl,ysondre,1819,warrior,arms,225,121,104
Pazùzu,twisting-nether,1819,warrior,arms,114,54,60
Dwarfdruine,dun-modr,1818,warrior,arms,85,49,36
Hunkz,sylvanas,1818,warrior,arms,65,32,33
Дуухаст,gordunni,1818,warrior,arms,48,22,26
Nakedwarrior,silvermoon,1818,warrior,arms,66,30,36
Basemode,twisting-nether,1817,warrior,arms,116,65,51
Thebigshow,the-maelstrom,1817,warrior,arms,196,97,99
Daredevìl,eredar,1817,warrior,arms,187,91,96
Nímera,nemesis,1817,warrior,arms,77,37,40
Liferuiner,rexxar,1816,warrior,arms,133,73,60
Drxeqtit,blackrock,1816,warrior,arms,59,32,27
Eysnwar,blackrock,1815,warrior,arms,30,22,8
Erikeverhard,nathrezim,1815,warrior,arms,80,41,39
Dnoire,ravencrest,1815,warrior,arms,60,28,32
Nelthôr,alleria,1814,warrior,arms,156,94,62
Ranoth,hellfire,1814,warrior,arms,54,30,24
Maxwall,twisting-nether,1814,warrior,arms,59,32,27
Чюнилингус,soulflayer,1814,warrior,arms,146,77,69
Naskez,kazzak,1814,warrior,arms,81,41,40
Capitalista,das-konsortium,1814,warrior,arms,89,45,44
Warriorri,haomarush,1814,warrior,arms,42,20,22
Pathocend,kazzak,1814,warrior,arms,106,50,56
Juank,minahonda,1814,warrior,arms,48,21,27
Арма,howling-fjord,1813,warrior,arms,54,39,15
Eren,todeswache,1813,warrior,arms,108,65,43
Vic,tarren-mill,1813,warrior,arms,47,20,27
Zcell,kazzak,1812,warrior,arms,36,23,13
Kelhim,blackrock,1812,warrior,arms,138,75,63
Gucciwarrior,blackhand,1812,warrior,arms,90,41,49
Blademir,blackrock,1811,warrior,arms,47,32,15
Axinit,blackrock,1811,warrior,arms,42,23,19
Idiotplay,drekthar,1811,warrior,arms,42,19,23
Raaoo,blackmoore,1810,warrior,arms,57,33,24
Artøria,archimonde,1810,warrior,arms,96,54,42
Chaosedge,terokkar,1810,warrior,arms,251,137,114
Oktharu,silvermoon,1810,warrior,arms,71,37,34
Pyrul,antonidas,1810,warrior,arms,125,64,61
Ðiscordia,blackhand,1810,warrior,arms,84,43,41
Jokkul,tarren-mill,1810,warrior,arms,46,21,25
Troma,archimonde,1810,warrior,arms,89,39,50
Bîmbämboom,blackmoore,1809,warrior,arms,148,94,54
Nikoma,silvermoon,1809,warrior,arms,54,29,25
Klnrk,ravencrest,1808,warrior,arms,48,25,23
Anthalar,argent-dawn,1808,warrior,arms,179,92,87
Takeashower,hyjal,1808,warrior,arms,56,28,28
Демолишеер,howling-fjord,1808,warrior,arms,89,42,47
Drilley,blackmoore,1807,warrior,arms,50,34,16
Мелькорт,gordunni,1807,warrior,arms,60,34,26
Zeddone,drakthul,1807,warrior,arms,90,46,44
Bloodhorn,blackhand,1807,warrior,arms,107,54,53
Nìmera,nemesis,1806,warrior,arms,36,26,10
Yelanx,twisting-nether,1806,warrior,arms,48,34,14
Гатсберсерк,gordunni,1806,warrior,arms,167,91,76
Vathaleron,alakir,1806,warrior,arms,116,63,53
Wayneson,tarren-mill,1806,warrior,arms,108,58,50
Книфэк,howling-fjord,1806,warrior,arms,76,40,36
Blademir,aegwynn,1806,warrior,arms,82,37,45
Wetrx,stormscale,1805,warrior,arms,42,24,18
Cerßere,archimonde,1805,warrior,arms,128,66,62
Zhangbeihai,ravencrest,1805,warrior,arms,402,203,199
Оксенфурт,soulflayer,1804,warrior,arms,169,85,84
Hanìbal,ravencrest,1803,warrior,arms,60,32,28
Bløødyshøcks,aggra-português,1803,warrior,arms,319,166,153
Vaaýzx,blackrock,1803,warrior,arms,96,48,48
Sonnethrash,tarren-mill,1803,warrior,arms,85,40,45
Ghakra,kazzak,1802,warrior,arms,36,25,11
Westwyde,hyjal,1802,warrior,arms,48,30,18
Thyréc,blackmoore,1802,warrior,arms,60,34,26
Fràgile,ravencrest,1802,warrior,arms,113,61,52
Pummelthru,burning-legion,1802,warrior,arms,98,47,51
Yandan,ysondre,1801,warrior,arms,157,83,74
Креспекс,soulflayer,1801,warrior,arms,193,91,102
Tyrasîà,hyjal,1801,warrior,arms,120,54,66
Steroidkidx,stormscale,1801,warrior,arms,54,24,30
Wrecktal,eredar,1800,warrior,arms,81,48,33
Phalek,argent-dawn,1800,warrior,arms,48,28,20
Варбоссец,soulflayer,1800,warrior,arms,77,40,37
Dairøx,blackrock,1800,warrior,arms,60,31,29
Брокскрим,soulflayer,1800,warrior,arms,144,70,74
Shilix,twisting-nether,1799,warrior,arms,141,65,76
Louana,outland,1797,warrior,arms,78,46,32
Lyriae,argent-dawn,1796,warrior,arms,72,43,29
Ursakhan,sylvanas,1796,warrior,arms,81,39,42
Planina,ravencrest,1795,warrior,arms,207,108,99
Вокилог,soulflayer,1794,warrior,arms,865,433,432
Злопиканка,gordunni,1794,warrior,arms,58,29,29
Dõxlol,kazzak,1793,warrior,arms,42,21,21
Hitt,ysondre,1793,warrior,arms,150,71,79
Илди,soulflayer,1792,warrior,arms,70,32,38
Jackyred,silvermoon,1792,warrior,arms,77,33,44
Beevzyn,blackmoore,1791,warrior,arms,36,25,11
Аоетакси,soulflayer,1791,warrior,arms,116,63,53
Nukerz,kirin-tor,1791,warrior,arms,96,48,48
Drahkor,baelgun,1790,warrior,arms,72,44,28
Изикол,blackscar,1790,warrior,arms,47,22,25
Kënnyföx,ysondre,1789,warrior,arms,36,19,17
Broarexlion,ragnaros,1789,warrior,arms,52,23,29
Recklesnes,kazzak,1789,warrior,arms,60,26,34
Keññyfðx,ysondre,1786,warrior,arms,48,28,20
Nihe,stormreaver,1786,warrior,arms,84,37,47
Azotz,archimonde,1786,warrior,arms,60,26,34
Zheaks,kazzak,1785,warrior,arms,95,45,50
Сладкаяхурма,howling-fjord,1784,warrior,arms,54,22,32
Древилгод,gordunni,1783,warrior,arms,57,31,26
Bigboyx,kazzak,1783,warrior,arms,231,108,123
Лилиофанныч,soulflayer,1783,warrior,arms,102,47,55
Kennyföx,ysondre,1782,warrior,arms,38,24,14
Nayro,mugthol,1782,warrior,arms,42,20,22
Эпитафорх,blackscar,1780,warrior,arms,64,40,24
Randomdmg,stormscale,1779,warrior,arms,36,24,12
Andzone,alakir,1779,warrior,arms,42,22,20
Damagz,tarren-mill,1779,warrior,arms,125,62,63
Dragnil,twisting-nether,1779,warrior,arms,60,29,31
Хиро,deathweaver,1779,warrior,arms,118,57,61
Стилерин,gordunni,1779,warrior,arms,93,39,54
Avalin,outland,1778,warrior,arms,48,31,17
Dataçasé,silvermoon,1778,warrior,arms,65,36,29
Venres,blackhand,1777,warrior,arms,88,47,41
Xvlanter,silvermoon,1777,warrior,arms,151,74,77
Боссберс,howling-fjord,1776,warrior,arms,84,41,43
Shookyx,ravencrest,1775,warrior,arms,42,24,18
Skylåw,archimonde,1775,warrior,arms,127,62,65
Малаятварь,gordunni,1774,warrior,arms,58,32,26
Huyer,stormscale,1774,warrior,arms,48,26,22
Bujax,onyxia,1774,warrior,arms,67,32,35
Røidrage,stormscale,1774,warrior,arms,114,54,60
Màb,antonidas,1773,warrior,arms,108,62,46
Вуриор,howling-fjord,1773,warrior,arms,222,116,106
Shaked,dun-modr,1772,warrior,arms,119,55,64
Oldcockball,argent-dawn,1771,warrior,arms,171,91,80
Malebolia,mugthol,1771,warrior,arms,481,247,234
Zoefernandes,kazzak,1771,warrior,arms,96,46,50
Niiol,burning-blade,1770,warrior,arms,71,37,34
Крипочёк,gordunni,1770,warrior,arms,72,34,38
Loty,drakthul,1769,warrior,arms,331,158,173
Prøject,archimonde,1768,warrior,arms,54,27,27
Otp,ravencrest,1768,warrior,arms,131,61,70
Mystylez,silvermoon,1768,warrior,arms,66,28,38
Reapersrage,twisting-nether,1767,warrior,arms,81,44,37
Swaf,ravencrest,1767,warrior,arms,60,30,30
Komissarecks,aegwynn,1767,warrior,arms,63,31,32
Yosiwa,draenor,1766,warrior,arms,108,60,48
Blackbiird,blackmoore,1766,warrior,arms,77,42,35
Jesperharle,ravencrest,1766,warrior,arms,35,19,16
Lockmagewar,burning-legion,1766,warrior,arms,108,56,52
Izurritea,tarren-mill,1765,warrior,arms,78,34,44
Ехрерау,gordunni,1765,warrior,arms,66,27,39
Wørldrûiner,kazzak,1764,warrior,arms,41,31,10
Bigdamtosco,ravencrest,1764,warrior,arms,36,20,16
Mintys,sylvanas,1764,warrior,arms,98,53,45
Имеравета,gordunni,1761,warrior,arms,180,84,96
Экзекьютлол,soulflayer,1760,warrior,arms,65,32,33
Марльин,howling-fjord,1760,warrior,arms,89,40,49
Bigboomer,frostmane,1759,warrior,arms,210,96,114
Gonutz,sylvanas,1757,warrior,arms,66,39,27
Flaãy,ravencrest,1756,warrior,arms,142,79,63
Fruiittyy,ravencrest,1756,warrior,arms,149,76,73
Nitheriá,draenor,1756,warrior,arms,436,219,217
Grimlok,sylvanas,1756,warrior,arms,99,44,55
Deymio,defias-brotherhood,1755,warrior,arms,66,28,38
Cisataker,hyjal,1754,warrior,arms,54,34,20
Khalimov,tarren-mill,1754,warrior,arms,108,54,54
Böggzbunny,tarren-mill,1754,warrior,arms,72,35,37
Azudaddy,blackmoore,1753,warrior,arms,77,41,36
Старварлорд,soulflayer,1753,warrior,arms,83,41,42
Warounet,hyjal,1753,warrior,arms,54,26,28
Cleaver,tarren-mill,1752,warrior,arms,54,29,25
Trôth,kazzak,1750,warrior,arms,36,23,13
Wasdwarr,aegwynn,1748,warrior,arms,183,101,82
Oldchap,nordrassil,1746,warrior,arms,60,34,26
Cyanerd,bronzebeard,1745,warrior,arms,60,30,30
Атаир,deathweaver,1744,warrior,arms,115,63,52
Drittsekken,sylvanas,1744,warrior,arms,135,73,62
Экспла,ashenvale,1744,warrior,arms,60,32,28
Extazsion,stormscale,1744,warrior,arms,57,30,27
Ástriax,ravencrest,1744,warrior,arms,165,78,87
Läerezh,ysondre,1744,warrior,arms,72,34,38
Getsmokedjr,ravencrest,1743,warrior,arms,62,32,30
Bôlufonâ,dun-modr,1743,warrior,arms,261,132,129
Savesta,dalaran,1743,warrior,arms,233,113,120
Nedåh,blackrock,1742,warrior,arms,147,70,77
Rexonawarr,kazzak,1741,warrior,arms,36,19,17
Rageco,ravencrest,1740,warrior,arms,60,37,23
Ufu,outland,1740,warrior,arms,41,23,18
Brogre,stormrage,1740,warrior,arms,101,49,52
Whýsøsîlêñt,ragnaros,1739,warrior,arms,42,22,20
Mojotsche,taerar,1738,warrior,arms,64,36,28
Hulkensmash,kazzak,1738,warrior,arms,175,87,88
Cesr,bloodhoof,1738,warrior,arms,106,47,59
Абырабыр,howling-fjord,1737,warrior,arms,48,28,20
Veav,norgannon,1737,warrior,arms,96,42,54
Даскул,gordunni,1737,warrior,arms,66,28,38
Фктпх,blackscar,1736,warrior,arms,60,35,25
Balltas,drakthul,1736,warrior,arms,200,101,99
Hellguard,archimonde,1736,warrior,arms,107,54,53
Leethal,outland,1736,warrior,arms,102,44,58
Xørkull,zuljin,1735,warrior,arms,54,34,20
Rootmagnet,twisting-nether,1734,warrior,arms,77,47,30
Rilor,burning-legion,1734,warrior,arms,147,70,77
Howdoyouløse,stormscale,1734,warrior,arms,54,22,32
Chaddimus,draenor,1733,warrior,arms,75,39,36
Aerês,tarren-mill,1733,warrior,arms,348,171,177
Cherserker,ragnaros,1732,warrior,arms,119,63,56
Zheq,ragnaros,1732,warrior,arms,68,33,35
Meistersykes,silvermoon,1731,warrior,arms,80,36,44
Бейесличё,deathguard,1731,warrior,arms,137,61,76
Woobaby,outland,1730,warrior,arms,108,59,49
Маклецкий,gordunni,1730,warrior,arms,150,68,82
Kotechnik,ysondre,1729,warrior,arms,54,32,22
Brutilda,antonidas,1729,warrior,arms,95,43,52
Gigadot,arathor,1728,warrior,arms,294,149,145
Renwíck,burning-legion,1728,warrior,arms,72,36,36
Reccey,blackrock,1728,warrior,arms,152,75,77
Kalacher,draenor,1728,warrior,arms,170,83,87
Trashman,bronzebeard,1727,warrior,arms,204,107,97
Fruitdealer,shattrath,1726,warrior,arms,118,58,60
Oluwafunmila,tarren-mill,1726,warrior,arms,68,33,35
Zexa,tarren-mill,1725,warrior,arms,48,23,25
Jínro,draenor,1725,warrior,arms,72,32,40
Srambo,ragnaros,1724,warrior,arms,42,27,15
Creativenot,outland,1724,warrior,arms,62,32,30
Imondiet,ragnaros,1723,warrior,arms,36,21,15
Crawly,aegwynn,1723,warrior,arms,189,97,92
Maisner,stormscale,1723,warrior,arms,74,36,38
Dannyp,twisting-nether,1722,warrior,arms,36,18,18
Воованыч,gordunni,1720,warrior,arms,54,26,28
Vôx,sylvanas,1719,warrior,arms,332,163,169
Данзетар,howling-fjord,1719,warrior,arms,71,30,41
Роули,blackscar,1718,warrior,arms,105,57,48
Chargeyou,ragnaros,1718,warrior,arms,84,44,40
Mortalfist,stormscale,1718,warrior,arms,67,33,34
Ítikovan,aegwynn,1718,warrior,arms,218,107,111
Bladoran,hyjal,1717,warrior,arms,48,29,19
Urasli,doomhammer,1717,warrior,arms,42,24,18
Кисямур,soulflayer,1717,warrior,arms,66,28,38
Барсток,soulflayer,1716,warrior,arms,107,53,54
Maikouyes,archimonde,1715,warrior,arms,257,132,125
Emix,arygos,1715,warrior,arms,158,77,81
Hulksmsh,hyjal,1715,warrior,arms,149,63,86
Néxtlølz,twisting-nether,1714,warrior,arms,111,59,52
Виттурус,howling-fjord,1714,warrior,arms,48,25,23
Apacho,outland,1714,warrior,arms,42,21,21
Daigoro,ravencrest,1714,warrior,arms,244,120,124
Fulgrimu,archimonde,1714,warrior,arms,105,51,54
Bordi,nemesis,1713,warrior,arms,259,122,137
Rektdrum,ravencrest,1713,warrior,arms,68,31,37
Thrux,dalaran,1712,warrior,arms,166,86,80
Cazaril,kazzak,1712,warrior,arms,166,84,82
Jengaa,draenor,1712,warrior,arms,186,93,93
Бисовыйармен,soulflayer,1711,warrior,arms,53,28,25
Johnmeadows,ravencrest,1711,warrior,arms,60,31,29
Bonza,blackrock,1711,warrior,arms,66,32,34
Frozenliøn,twisting-nether,1711,warrior,arms,60,28,32
Tranqtum,ravencrest,1711,warrior,arms,55,25,30
Dógmòdex,stormscale,1710,warrior,arms,48,30,18
Жестокус,gordunni,1710,warrior,arms,102,55,47
Криккс,greymane,1709,warrior,arms,168,84,84
Мадс,howling-fjord,1708,warrior,arms,24,18,6
Pourfendre,archimonde,1708,warrior,arms,60,35,25
Xendyo,frostmourne,1707,warrior,arms,232,113,119
Троммтар,howling-fjord,1707,warrior,arms,210,97,113
Avalinqt,blackrock,1706,warrior,arms,44,32,12
Noxeeql,tarren-mill,1706,warrior,arms,173,97,76
Армсег,soulflayer,1706,warrior,arms,106,57,49
Громпузан,galakrond,1706,warrior,arms,109,58,51
Meovv,saurfang,1706,warrior,arms,102,44,58
Brunodressed,aegwynn,1705,warrior,arms,150,75,75
Natis,drakthul,1705,warrior,arms,168,78,90
Rumer,tarren-mill,1704,warrior,arms,111,55,56
Ezøn,aegwynn,1703,warrior,arms,95,46,49
Mîleycyrûs,stormscale,1702,warrior,arms,30,19,11
Maldark,scarshield-legion,1702,warrior,arms,194,94,100
Yaune,ravencrest,1702,warrior,arms,90,43,47
Autumnfálls,kazzak,1701,warrior,arms,59,31,28
Bêllator,stormscale,1700,warrior,arms,64,34,30
Klonyarika,ravencrest,1699,warrior,arms,36,20,16
Dríx,hyjal,1699,warrior,arms,144,74,70
Endagon,ravencrest,1699,warrior,arms,197,90,107
Fantasý,burning-legion,1699,warrior,arms,101,42,59
Karkatoes,twisting-nether,1698,warrior,arms,68,34,34
Warrez,azuremyst,1697,warrior,arms,48,30,18
Chadsmorc,twisting-nether,1697,warrior,arms,336,175,161
Giannizugzug,nemesis,1697,warrior,arms,392,201,191
Heclatos,hyjal,1697,warrior,arms,36,18,18
Кофесмолоком,ashenvale,1697,warrior,arms,225,106,119
Istyos,hyjal,1697,warrior,arms,125,57,68
Шагах,soulflayer,1696,warrior,arms,250,126,124
Naronnas,drakthul,1696,warrior,arms,206,101,105
Хенеар,howling-fjord,1696,warrior,arms,80,37,43
Nazgrosh,burning-legion,1696,warrior,arms,195,90,105
Yellowjuice,stormscale,1695,warrior,arms,156,89,67
Caltan,wildhammer,1695,warrior,arms,86,49,37
Naum,draenor,1694,warrior,arms,24,18,6
Shadokaa,stormscale,1694,warrior,arms,94,56,38
Килафх,blackscar,1694,warrior,arms,294,149,145
Cukrownik,defias-brotherhood,1694,warrior,arms,64,32,32
Capigo,tarren-mill,1693,warrior,arms,54,32,22
Aemox,silvermoon,1693,warrior,arms,148,79,69
Pinkblast,sylvanas,1693,warrior,arms,72,29,43
Donquiexote,ravencrest,1692,warrior,arms,90,49,41
Banîsher,drakthul,1692,warrior,arms,235,110,125
Брок,soulflayer,1692,warrior,arms,96,39,57
Escapematrix,kazzak,1691,warrior,arms,131,62,69
Эсфор,howling-fjord,1690,warrior,arms,36,21,15
Тролльвоен,gordunni,1690,warrior,arms,93,54,39
Fattysw,argent-dawn,1690,warrior,arms,73,37,36
Дуглимон,gordunni,1690,warrior,arms,83,42,41
Cassândrä,dalaran,1690,warrior,arms,115,53,62
Vayné,ravencrest,1690,warrior,arms,78,35,43
Naait,draenor,1688,warrior,arms,69,39,30
Orn,tarren-mill,1688,warrior,arms,60,29,31
Babovic,aegwynn,1687,warrior,arms,77,48,29
Мопк,howling-fjord,1687,warrior,arms,96,50,46
Nonow,silvermoon,1687,warrior,arms,256,125,131
Jumpilawl,khaz-modan,1687,warrior,arms,232,113,119
Clashblood,outland,1687,warrior,arms,62,28,34
Hangart,argent-dawn,1687,warrior,arms,48,20,28
Æç,argent-dawn,1686,warrior,arms,72,35,37
Rawenz,drakthul,1686,warrior,arms,89,43,46
Omcat,dun-modr,1686,warrior,arms,57,20,37
Рэмпи,soulflayer,1685,warrior,arms,80,36,44
Makgorei,outland,1684,warrior,arms,129,64,65
Тьмасвятая,gordunni,1684,warrior,arms,54,24,30
Quetrax,chogall,1684,warrior,arms,66,24,42
Luntee,ragnaros,1683,warrior,arms,56,32,24
Азктор,soulflayer,1683,warrior,arms,34,19,15
Jackzx,twisting-nether,1683,warrior,arms,48,26,22
Skywritter,archimonde,1682,warrior,arms,30,20,10
Гримг,lich-king,1682,warrior,arms,111,58,53
Nèssa,outland,1682,warrior,arms,87,42,45
Грамикк,howling-fjord,1681,warrior,arms,30,19,11
Skillissues,argent-dawn,1681,warrior,arms,72,39,33
Stepmomgodx,kazzak,1681,warrior,arms,49,24,25
Biscuitoliva,hyjal,1681,warrior,arms,49,23,26
Kronmw,dun-modr,1680,warrior,arms,54,20,34
Kamatâ,kazzak,1679,warrior,arms,78,37,41
Sjozug,tarren-mill,1679,warrior,arms,54,21,33
Ридиусх,gordunni,1678,warrior,arms,43,24,19
Toroespaña,draenor,1678,warrior,arms,360,183,177
Хеликат,soulflayer,1678,warrior,arms,102,48,54
Palmsweaty,stormrage,1678,warrior,arms,114,51,63
Nyxz,blackhand,1677,warrior,arms,119,62,57
Zaedt,tarren-mill,1677,warrior,arms,53,25,28
Хеула,gordunni,1677,warrior,arms,72,29,43
Туранк,howling-fjord,1676,warrior,arms,286,145,141
Сажень,blackscar,1676,warrior,arms,134,64,70
Alpairx,aegwynn,1676,warrior,arms,56,23,33
Lîlsaint,dun-morogh,1675,warrior,arms,54,28,26
Ðowman,blackrock,1675,warrior,arms,80,38,42
Raikaz,ravencrest,1675,warrior,arms,102,46,56
Krigipigi,antonidas,1675,warrior,arms,78,34,44
Бигдэм,howling-fjord,1674,warrior,arms,36,20,16
Xgs,archimonde,1674,warrior,arms,333,168,165
Mazutov,outland,1673,warrior,arms,54,34,20
Khemen,kazzak,1673,warrior,arms,131,73,58
Asasius,ravencrest,1673,warrior,arms,42,23,19
Gotar,ravencrest,1673,warrior,arms,255,139,116
Duckyone,zenedar,1673,warrior,arms,42,21,21
Лисерк,howling-fjord,1673,warrior,arms,96,47,49
Catrine,drakthul,1673,warrior,arms,81,33,48
Jake,rajaxx,1672,warrior,arms,54,26,28
Дарамартире,blackscar,1671,warrior,arms,76,42,34
Vorri,ravencrest,1671,warrior,arms,54,27,27
Ayraw,eredar,1671,warrior,arms,48,24,24
Chíppéd,draenor,1671,warrior,arms,54,26,28
Gatts,krasus,1671,warrior,arms,282,134,148
Kamïlio,stormscale,1671,warrior,arms,66,30,36
Nîmera,nemesis,1670,warrior,arms,24,19,5
Фалькр,soulflayer,1670,warrior,arms,48,26,22
Estarotte,ravencrest,1670,warrior,arms,73,36,37
Chromoly,aegwynn,1670,warrior,arms,90,43,47
Krionos,ravencrest,1670,warrior,arms,120,57,63
Extreemee,drakthul,1669,warrior,arms,54,28,26
Skädy,dun-modr,1669,warrior,arms,108,51,57
Riyan,lothar,1668,warrior,arms,48,28,20
Bumoletroll,draenor,1668,warrior,arms,45,24,21
Shhimbanned,doomhammer,1668,warrior,arms,85,43,42
Kymz,hyjal,1668,warrior,arms,66,33,33
Robou,hyjal,1668,warrior,arms,333,159,174
Pj,sanguino,1668,warrior,arms,146,66,80
Ranmaru,kazzak,1667,warrior,arms,115,57,58
Бигдэмс,soulflayer,1667,warrior,arms,54,22,32
Bronn,defias-brotherhood,1666,warrior,arms,92,52,40
Dasyana,drakthul,1666,warrior,arms,137,71,66
Karuck,tarren-mill,1666,warrior,arms,106,54,52
Broumír,antonidas,1666,warrior,arms,60,26,34
Уэсгар,blackscar,1666,warrior,arms,54,19,35
Puremëtal,silvermoon,1665,warrior,arms,117,58,59
Белхэнд,soulflayer,1665,warrior,arms,309,152,157
Scormash,burning-legion,1665,warrior,arms,55,27,28
Геркавоин,eversong,1665,warrior,arms,96,45,51
Wismerx,kazzak,1665,warrior,arms,54,23,31
Acaleus,the-maelstrom,1664,warrior,arms,258,128,130
Дайбайхенд,howling-fjord,1664,warrior,arms,120,59,61
Summerkarma,wildhammer,1664,warrior,arms,263,127,136
Gailko,sanguino,1664,warrior,arms,50,24,26
Zufzuf,twisting-nether,1663,warrior,arms,66,38,28
Learningwarr,eredar,1663,warrior,arms,50,26,24
Bruxus,blackhand,1663,warrior,arms,268,138,130
Rîdler,ravencrest,1663,warrior,arms,389,199,190
Skokuxx,silvermoon,1663,warrior,arms,197,99,98
Fosler,frostmane,1663,warrior,arms,78,35,43
Oplarxigos,kazzak,1663,warrior,arms,84,35,49
Furukawa,ravencrest,1662,warrior,arms,63,33,30
Càvalry,nemesis,1662,warrior,arms,42,19,23
Imglad,ragnaros,1661,warrior,arms,75,40,35
Eggsecutor,stormscale,1661,warrior,arms,145,74,71
Arms,earthen-ring,1661,warrior,arms,86,41,45
Spártacus,kazzak,1661,warrior,arms,147,68,79
Луновоин,gordunni,1660,warrior,arms,72,45,27
Tiwâz,eredar,1660,warrior,arms,175,95,80
Chainsáw,stormscale,1660,warrior,arms,202,102,100
Toptier,drakthul,1659,warrior,arms,34,23,11
Олдизаер,soulflayer,1659,warrior,arms,78,39,39
Zombossio,tarren-mill,1659,warrior,arms,175,85,90
Kèrrysmâsh,blackrock,1658,warrior,arms,108,65,43
Btr,archimonde,1658,warrior,arms,54,23,31
Huscar,thrall,1657,warrior,arms,59,31,28
Rolo,antonidas,1657,warrior,arms,85,42,43
Кибервайфу,howling-fjord,1656,warrior,arms,36,22,14
Crandalius,kazzak,1656,warrior,arms,87,51,36
Bloodrain,twilights-hammer,1656,warrior,arms,164,88,76
Lanstus,silvermoon,1656,warrior,arms,120,60,60
Ijzerekast,sylvanas,1656,warrior,arms,103,48,55
Hirurg,thrall,1656,warrior,arms,77,34,43
Rhinobob,kazzak,1656,warrior,arms,56,24,32
Суицидгодх,howling-fjord,1655,warrior,arms,101,57,44
Arnoldr,ysondre,1655,warrior,arms,63,34,29
Eradya,ravencrest,1655,warrior,arms,82,41,41
Brizeis,malganis,1655,warrior,arms,175,87,88
Mertik,twisting-nether,1653,warrior,arms,60,32,28
Латексник,booty-bay,1653,warrior,arms,149,77,72
Freelongx,stormscale,1653,warrior,arms,48,20,28
Lepka,drakthul,1652,warrior,arms,129,72,57
Zijsû,chogall,1652,warrior,arms,91,39,52
Chádtóurps,drakthul,1651,warrior,arms,41,19,22
Hli,tarren-mill,1650,warrior,arms,42,24,18
Avelyr,pozzo-delleternità,1650,warrior,arms,48,26,22
Богадорога,howling-fjord,1650,warrior,arms,72,37,35
Lazytowl,outland,1650,warrior,arms,171,87,84
Pangowar,elune,1650,warrior,arms,99,49,50
Jeronimoe,blackmoore,1649,warrior,arms,49,34,15
Заликмортал,soulflayer,1649,warrior,arms,216,110,106
Belmont,doomhammer,1649,warrior,arms,54,27,27
Drâpârn,sylvanas,1648,warrior,arms,42,24,18
Wisemanx,draenor,1648,warrior,arms,72,39,33
Kfc,chamber-of-aspects,1648,warrior,arms,60,32,28
Quadfather,kazzak,1648,warrior,arms,42,22,20
Wardruine,dun-modr,1648,warrior,arms,191,92,99
Asç,kazzak,1647,warrior,arms,42,21,21
Boldinq,ravencrest,1647,warrior,arms,147,70,77
Raidek,dragonmaw,1646,warrior,arms,132,68,64
Loosecanon,ravencrest,1646,warrior,arms,53,26,27
Termonsa,stormscale,1645,warrior,arms,67,38,29
Pházéd,kazzak,1645,warrior,arms,40,20,20
Heltslut,tarren-mill,1645,warrior,arms,131,64,67
Preliator,outland,1644,warrior,arms,42,24,18
Zhadsnark,blackrock,1644,warrior,arms,150,79,71
Taoke,ravencrest,1644,warrior,arms,90,39,51
Morbaac,archimonde,1644,warrior,arms,54,22,32
Киссмиплис,gordunni,1643,warrior,arms,135,68,67
Бургерс,soulflayer,1643,warrior,arms,135,67,68
Falconer,ravencrest,1643,warrior,arms,120,49,71
Doksziqqt,ragnaros,1642,warrior,arms,36,22,14
Rankone,bladefist,1642,warrior,arms,47,24,23
Бодибилдерыч,gordunni,1642,warrior,arms,149,74,75
Smkms,kazzak,1642,warrior,arms,101,49,52
Bhallts,tarren-mill,1642,warrior,arms,98,44,54
Ckz,ysondre,1641,warrior,arms,36,26,10
Cyruk,blackmoore,1641,warrior,arms,289,145,144
Nardoch,archimonde,1641,warrior,arms,234,116,118
Remen,archimonde,1641,warrior,arms,84,37,47
Diamonddogs,draenor,1640,warrior,arms,52,32,20
Андреевич,blackscar,1640,warrior,arms,270,138,132
Мастерион,soulflayer,1640,warrior,arms,198,101,97
Nassir,stormscale,1640,warrior,arms,138,64,74
Wlãð,archimonde,1640,warrior,arms,54,25,29
Nameless,ysondre,1639,warrior,arms,77,45,32
Braveorc,kazzak,1639,warrior,arms,60,33,27
Fatmikez,aggra-português,1639,warrior,arms,142,77,65
Ahzrok,draenor,1639,warrior,arms,238,128,110
Фенилэфрин,gordunni,1639,warrior,arms,140,71,69
Bélløne,dalaran,1639,warrior,arms,126,61,65
Wítts,ravencrest,1638,warrior,arms,36,22,14
Rødprincê,ravencrest,1638,warrior,arms,63,37,26
Samîr,arthas,1638,warrior,arms,36,21,15
Беренса,howling-fjord,1638,warrior,arms,219,114,105
Jambaz,ravencrest,1638,warrior,arms,53,27,26
Sefty,tarren-mill,1638,warrior,arms,46,18,28
Bastrick,argent-dawn,1637,warrior,arms,146,77,69
Pachipachi,blackmoore,1637,warrior,arms,44,23,21
Keluke,thrall,1637,warrior,arms,63,27,36
Lizzybigtits,kazzak,1636,warrior,arms,60,40,20
Blackfrosty,stormscale,1636,warrior,arms,78,43,35
Хедтакер,gordunni,1636,warrior,arms,63,34,29
Hatestørm,kazzak,1636,warrior,arms,42,22,20
Psychlolz,burning-legion,1636,warrior,arms,60,30,30
Thanâtøs,kazzak,1636,warrior,arms,36,18,18
Nozuki,archimonde,1636,warrior,arms,439,217,222
Garthock,stormscale,1636,warrior,arms,42,20,22
Josem,sanguino,1636,warrior,arms,45,20,25
Erickson,tarren-mill,1636,warrior,arms,42,18,24
Sydian,burning-legion,1635,warrior,arms,36,21,15
Tgabor,ragnaros,1635,warrior,arms,95,51,44
Ryofu,stormscale,1635,warrior,arms,42,22,20
Krew,drakthul,1635,warrior,arms,96,48,48
Off,archimonde,1634,warrior,arms,30,18,12
Curelia,malganis,1634,warrior,arms,36,18,18
Kawaro,rajaxx,1634,warrior,arms,72,35,37
Nârmøra,thrall,1634,warrior,arms,54,26,28
Dedewawa,ysondre,1634,warrior,arms,42,20,22
Doloresvp,zuljin,1634,warrior,arms,156,74,82
Klynd,nemesis,1634,warrior,arms,240,111,129
Devidz,outland,1634,warrior,arms,95,43,52
Høtsky,twisting-nether,1633,warrior,arms,54,29,25
Nazhar,kult-der-verdammten,1633,warrior,arms,54,27,27
Lyroe,blackrock,1633,warrior,arms,42,21,21
Moosewood,draenor,1633,warrior,arms,113,54,59
Витодпс,howling-fjord,1633,warrior,arms,96,43,53
Asuramaru,aegwynn,1632,warrior,arms,176,96,80
Арсон,soulflayer,1632,warrior,arms,36,19,17
Atlizz,twisting-nether,1632,warrior,arms,90,47,43
Agoobagoo,alakir,1632,warrior,arms,47,23,24
Кхаррнн,gordunni,1632,warrior,arms,185,89,96
Liked,tarren-mill,1632,warrior,arms,54,24,30
Ebonheart,argent-dawn,1631,warrior,arms,139,68,71
Bamme,archimonde,1631,warrior,arms,59,28,31
Lücifer,dun-modr,1630,warrior,arms,165,95,70
Zaurzyfang,burning-legion,1630,warrior,arms,94,52,42
Испепелитель,howling-fjord,1630,warrior,arms,126,66,60
Çon,ravencrest,1630,warrior,arms,121,63,58
Nalx,tarren-mill,1630,warrior,arms,135,70,65
Aranill,tarren-mill,1630,warrior,arms,117,60,57
Maxxiwumms,amanthul,1630,warrior,arms,84,39,45
Aestheticon,burning-blade,1629,warrior,arms,36,21,15
Zugstorm,outland,1629,warrior,arms,100,50,50
Lewh,blackmoore,1629,warrior,arms,139,69,70
Broarextiger,ragnaros,1628,warrior,arms,30,17,13
Unbrauchbar,silvermoon,1628,warrior,arms,182,99,83
Laavapoeg,outland,1628,warrior,arms,105,56,49
Darksídex,silvermoon,1628,warrior,arms,339,176,163
Watashilfy,ravencrest,1628,warrior,arms,78,39,39
Inhaler,ravencrest,1628,warrior,arms,74,37,37
Astidon,ravencrest,1628,warrior,arms,45,22,23
Bluxy,outland,1628,warrior,arms,54,21,33
Winabella,tarren-mill,1627,warrior,arms,36,20,16
Iameconomist,twisting-nether,1627,warrior,arms,36,17,19
Hellkau,blackmoore,1627,warrior,arms,57,26,31
Klinga,bladefist,1626,warrior,arms,42,24,18
Xzm,stormscale,1626,warrior,arms,33,18,15
Leroyluca,gilneas,1626,warrior,arms,54,25,29
Temashi,kazzak,1625,warrior,arms,113,64,49
Седлайккеану,howling-fjord,1625,warrior,arms,195,99,96
Hellzint,sanguino,1625,warrior,arms,469,236,233
Hollydeffs,blackmoore,1625,warrior,arms,114,56,58
Zouo,blackhand,1625,warrior,arms,47,23,24
Asipositas,eredar,1625,warrior,arms,42,19,23
Golmmash,draenor,1625,warrior,arms,122,55,67
Stanislav,tarren-mill,1624,warrior,arms,38,24,14
Arsinal,destromath,1624,warrior,arms,30,17,13
Sanerion,antonidas,1624,warrior,arms,48,24,24
Sørêy,aegwynn,1624,warrior,arms,84,41,43
Розети,gordunni,1623,warrior,arms,57,30,27
Богатыйпапа,howling-fjord,1623,warrior,arms,191,98,93
Rhaegon,laughing-skull,1623,warrior,arms,48,24,24
Lusan,sylvanas,1623,warrior,arms,42,21,21
Nerfmyrage,hyjal,1623,warrior,arms,124,60,64
Justyòqt,archimonde,1623,warrior,arms,84,40,44
Bhallts,twisting-nether,1623,warrior,arms,100,45,55
Hashashyn,stormscale,1622,warrior,arms,65,35,30
Facestomper,onyxia,1622,warrior,arms,145,77,68
Sorkk,kazzak,1622,warrior,arms,98,50,48
Kennzz,ravencrest,1622,warrior,arms,66,33,33
Фурианка,galakrond,1622,warrior,arms,63,31,32
Spartaz,eredar,1622,warrior,arms,66,30,36
Diz,terokkar,1621,warrior,arms,139,82,57
Solaje,dun-modr,1621,warrior,arms,39,22,17
Kût,les-sentinelles,1621,warrior,arms,41,22,19
Арткес,gordunni,1621,warrior,arms,248,130,118
Mocomomo,argent-dawn,1621,warrior,arms,48,25,23
Vizn,emerald-dream,1621,warrior,arms,100,43,57
Autístickid,aegwynn,1620,warrior,arms,30,23,7
Prestà,archimonde,1620,warrior,arms,93,49,44
Shoesmith,outland,1620,warrior,arms,358,178,180
Gargaflike,aggra-português,1620,warrior,arms,84,37,47
Vayndral,kazzak,1619,warrior,arms,126,67,59
Neoballac,uldum,1619,warrior,arms,152,75,77
Saetásh,argent-dawn,1619,warrior,arms,185,87,98
Sickslamzyø,ravencrest,1619,warrior,arms,42,17,25
Schmelzlord,thrall,1619,warrior,arms,45,18,27
Mxrdvr,kazzak,1618,warrior,arms,54,35,19
Tabboonishka,draenor,1618,warrior,arms,48,28,20
Wigsplitterx,twisting-nether,1618,warrior,arms,467,229,238
Хирошка,gordunni,1618,warrior,arms,138,66,72
Whatabeast,blackmoore,1617,warrior,arms,31,18,13
Surthur,magtheridon,1617,warrior,arms,82,42,40
Ermòr,ravencrest,1617,warrior,arms,81,40,41
Shiqo,ravencrest,1617,warrior,arms,127,60,67
Thundranium,kazzak,1616,warrior,arms,37,22,15
Nelios,sylvanas,1616,warrior,arms,113,52,61
Shavoi,die-aldor,1616,warrior,arms,47,21,26
Borthuk,tarren-mill,1616,warrior,arms,119,51,68
Khireebonk,hyjal,1615,warrior,arms,36,24,12
Räzorleaf,kul-tiras,1615,warrior,arms,126,69,57
Gerrmund,silvermoon,1615,warrior,arms,81,44,37
Рекиро,blackscar,1615,warrior,arms,40,21,19
Gladius,ysera,1615,warrior,arms,86,43,43
Voxz,stormscale,1615,warrior,arms,318,154,164
Вандэрбой,howling-fjord,1615,warrior,arms,288,133,155
Otzi,sargeras,1615,warrior,arms,135,62,73
Оманко,howling-fjord,1614,warrior,arms,60,29,31
Chàrgex,blackrock,1614,warrior,arms,64,30,34
Untiltèd,ravencrest,1613,warrior,arms,89,60,29
Фелпир,soulflayer,1613,warrior,arms,197,104,93
Cirenax,draenor,1613,warrior,arms,60,31,29
Jakim,tarren-mill,1613,warrior,arms,190,95,95
Гуорг,howling-fjord,1613,warrior,arms,326,161,165
Hamez,thunderhorn,1613,warrior,arms,70,34,36
Blayr,tarren-mill,1613,warrior,arms,163,78,85
Bøklig,stormscale,1612,warrior,arms,78,38,40
Чевчелиос,deathweaver,1612,warrior,arms,53,25,28
Ахиллслэм,howling-fjord,1612,warrior,arms,174,76,98
Ragëë,tarren-mill,1611,warrior,arms,84,46,38
Senzroy,bloodfeather,1611,warrior,arms,44,24,20
Ïnahö,hyjal,1611,warrior,arms,36,19,17
Togas,silvermoon,1611,warrior,arms,346,181,165
Asenine,sylvanas,1611,warrior,arms,510,249,261
Diô,stormscale,1611,warrior,arms,47,21,26
Mumon,burning-legion,1611,warrior,arms,59,24,35
Smoothbrian,ravencrest,1610,warrior,arms,137,70,67
Dafrang,kazzak,1610,warrior,arms,184,94,90
Куэсес,howling-fjord,1610,warrior,arms,39,19,20
Донтрелиз,howling-fjord,1610,warrior,arms,123,59,64
Enzja,nazjatar,1610,warrior,arms,66,31,35
Strife,ravencrest,1609,warrior,arms,81,51,30
Убитаякорова,soulflayer,1609,warrior,arms,72,38,34
Ивантуз,gordunni,1609,warrior,arms,54,27,27
Biggerer,blackrock,1609,warrior,arms,120,57,63
Yakhshar,silvermoon,1609,warrior,arms,54,24,30
Haanok,ravencrest,1608,warrior,arms,65,38,27
Mävïs,ravencrest,1608,warrior,arms,84,46,38
Skgrimson,stormscale,1608,warrior,arms,113,60,53
Штурмгешутц,deathweaver,1608,warrior,arms,204,105,99
Knubbz,ravencrest,1608,warrior,arms,90,46,44
Guts,frostwhisper,1608,warrior,arms,173,83,90
Caméltoe,frostwolf,1608,warrior,arms,149,70,79
Manoito,argent-dawn,1608,warrior,arms,78,36,42
Fromagekipue,argent-dawn,1607,warrior,arms,46,26,20
Ødräcîë,silvermoon,1607,warrior,arms,132,69,63
Bursch,ravencrest,1607,warrior,arms,137,69,68
Хэллоуиныч,soulflayer,1606,warrior,arms,30,17,13
Bj,blackrock,1606,warrior,arms,123,65,58
Pikkemaát,stormscale,1606,warrior,arms,101,53,48
Oppressíon,silvermoon,1606,warrior,arms,46,22,24
Takatoa,argent-dawn,1606,warrior,arms,54,23,31
Zelwar,drakthul,1605,warrior,arms,37,23,14
Trajkovic,ravencrest,1605,warrior,arms,292,160,132
Taÿ,stormscale,1605,warrior,arms,36,19,17
Okoru,stormscale,1605,warrior,arms,136,71,65
Jeax,rexxar,1605,warrior,arms,46,20,26
Albwarr,kazzak,1605,warrior,arms,42,18,24
Faimy,tarren-mill,1604,warrior,arms,36,21,15
Ronoh,kazzak,1604,warrior,arms,42,23,19
Armsbull,twisting-nether,1604,warrior,arms,126,65,61
Skumslag,blackmoore,1604,warrior,arms,113,51,62
Bloodx,archimonde,1603,warrior,arms,36,20,16
Tweran,drakthul,1603,warrior,arms,66,33,33
Buckiesøde,twisting-nether,1603,warrior,arms,36,17,19
Tenvee,outland,1603,warrior,arms,48,22,26
Paranoiás,ragnaros,1603,warrior,arms,110,47,63
Eskiler,burning-legion,1603,warrior,arms,54,23,31
Zkou,wrathbringer,1603,warrior,arms,60,22,38
Ironbutter,ravencrest,1602,warrior,arms,122,71,51
Eselhirte,blackmoore,1602,warrior,arms,85,46,39
Poyraz,blackrock,1602,warrior,arms,60,32,28
Eohere,der-rat-von-dalaran,1602,warrior,arms,117,61,56
Duncán,auchindoun,1601,warrior,arms,65,36,29
Ym,twisting-nether,1601,warrior,arms,36,19,17
Астерио,blackscar,1601,warrior,arms,120,63,57
Miz,dun-modr,1601,warrior,arms,63,32,31
Reapo,blackhand,1601,warrior,arms,207,101,106
Dragoons,tyrande,1601,warrior,arms,116,56,60
Héda,tarren-mill,1601,warrior,arms,108,52,56
Kupr,outland,1601,warrior,arms,46,21,25
Crystallake,blackrock,1601,warrior,arms,114,52,62
Kayhw,stormscale,1601,warrior,arms,60,21,39
Sunney,tarren-mill,1600,warrior,arms,35,21,14
Ммайдаен,goldrinn,1600,warrior,arms,148,77,71
Bucketheadde,thrall,1600,warrior,arms,59,26,33
Béastmødexz,eredar,1600,warrior,arms,59,26,33
Sumprunkare,stormscale,1599,warrior,arms,52,29,23
Mugteef,der-rat-von-dalaran,1599,warrior,arms,41,22,19
Вамвоосна,gordunni,1599,warrior,arms,50,22,28
Incendix,stormscale,1598,warrior,arms,178,92,86
Furanos,blackrock,1597,warrior,arms,71,36,35
Вагранна,soulflayer,1597,warrior,arms,54,26,28
Морнстар,gordunni,1597,warrior,arms,115,55,60
Bloodbrother,blackmoore,1596,warrior,arms,152,81,71
Mellîødas,blackmoore,1596,warrior,arms,78,41,37
Кладбошаа,gordunni,1596,warrior,arms,138,70,68
Gorelaw,turalyon,1596,warrior,arms,36,18,18
Омепразол,gordunni,1596,warrior,arms,289,143,146
Poolboyx,tarren-mill,1596,warrior,arms,165,80,85
Arandyr,archimonde,1596,warrior,arms,72,30,42
Spijkerbroek,alakir,1595,warrior,arms,725,369,356
Elder,darkmoon-faire,1595,warrior,arms,203,102,101
Gigasmash,pozzo-delleternità,1595,warrior,arms,392,194,198
Kobeni,ysondre,1595,warrior,arms,85,40,45
Kwaiha,kazzak,1595,warrior,arms,91,42,49
Бурчун,deathguard,1594,warrior,arms,54,34,20
Fáro,ravencrest,1594,warrior,arms,70,34,36
Xiiver,burning-legion,1593,warrior,arms,143,76,67
Bstgame,frostmane,1593,warrior,arms,54,23,31
Øfdream,tarren-mill,1592,warrior,arms,41,23,18
Secondwarri,frostwolf,1592,warrior,arms,92,49,43
Айфилшок,gordunni,1592,warrior,arms,90,43,47
Shwreck,kazzak,1591,warrior,arms,132,66,66
Najjs,eredar,1591,warrior,arms,51,25,26
Jaythegodx,blackrock,1591,warrior,arms,151,66,85
Neoballâc,uldum,1590,warrior,arms,42,24,18
Ruinatiøn,stormscale,1589,warrior,arms,48,30,18
Riptack,anetheron,1589,warrior,arms,367,190,177
Порицающий,soulflayer,1589,warrior,arms,64,33,31
Sepuko,stormscale,1589,warrior,arms,144,71,73
Axero,drakthul,1589,warrior,arms,70,34,36
Thundersword,sylvanas,1589,warrior,arms,84,30,54
Kultywator,silvermoon,1588,warrior,arms,30,21,9
Kamilfury,burning-legion,1588,warrior,arms,127,59,68
Olfik,drakthul,1588,warrior,arms,52,20,32
Spridan,ravencrest,1588,warrior,arms,54,20,34
Kazzuk,dentarg,1587,warrior,arms,75,38,37
Geforce,hellscream,1587,warrior,arms,546,276,270
Deathwingx,azuremyst,1587,warrior,arms,159,75,84
Corlo,uldaman,1587,warrior,arms,98,44,54
Drachnór,kazzak,1586,warrior,arms,57,34,23
Aeldran,argent-dawn,1586,warrior,arms,54,28,26
Bronix,blackrock,1586,warrior,arms,130,64,66
Дугмар,gordunni,1586,warrior,arms,271,131,140
Khylza,archimonde,1586,warrior,arms,42,20,22
Сабствер,howling-fjord,1586,warrior,arms,119,54,65
Greenpanzer,archimonde,1585,warrior,arms,120,64,56
Karreg,hyjal,1585,warrior,arms,253,122,131
Ogurok,frostwolf,1585,warrior,arms,129,58,71
Germantank,ravencrest,1584,warrior,arms,36,19,17
Bufdefstance,kazzak,1584,warrior,arms,86,43,43
Belfodil,outland,1584,warrior,arms,52,26,26
Bigbanz,outland,1584,warrior,arms,129,61,68
Джамалли,howling-fjord,1584,warrior,arms,60,26,34
Pumpadzhîja,stormscale,1583,warrior,arms,52,28,24
Bérsérk,blackmoore,1583,warrior,arms,46,24,22
Напутанность,soulflayer,1583,warrior,arms,459,237,222
Gravityfalls,blackmoore,1583,warrior,arms,256,131,125
Naturesfault,ravencrest,1582,warrior,arms,32,19,13
Únkqt,dalaran,1582,warrior,arms,75,40,35
Notinfa,draenor,1582,warrior,arms,239,126,113
Evrybodydown,draenor,1582,warrior,arms,278,142,136
Fragmeista,ragnaros,1582,warrior,arms,36,17,19
Молчаньеума,howling-fjord,1582,warrior,arms,90,38,52
Geroldius,silvermoon,1581,warrior,arms,60,26,34
Talión,ravencrest,1580,warrior,arms,42,28,14
Yeezy,les-sentinelles,1580,warrior,arms,50,26,24
Knoutt,burning-legion,1580,warrior,arms,42,20,22
Horsewarrior,stormscale,1580,warrior,arms,77,33,44
Форгерон,howling-fjord,1580,warrior,arms,65,27,38
Orgi,drakthul,1580,warrior,arms,42,17,25
Каосвар,howling-fjord,1579,warrior,arms,30,19,11
Wtchmyblade,blackmoore,1579,warrior,arms,124,71,53
Заверчу,soulflayer,1578,warrior,arms,215,114,101
Brewgut,argent-dawn,1577,warrior,arms,83,40,43
Badroch,kazzak,1577,warrior,arms,94,41,53
Snðw,outland,1577,warrior,arms,103,40,63
Sýkz,exodar,1577,warrior,arms,53,19,34
Vullgrîm,blackmoore,1576,warrior,arms,102,51,51
Taistelumage,stormreaver,1576,warrior,arms,35,17,18
Argean,argent-dawn,1576,warrior,arms,78,34,44
Duaig,pozzo-delleternità,1576,warrior,arms,42,17,25
Arachnoyd,drakthul,1575,warrior,arms,30,17,13
Lpa,stormscale,1575,warrior,arms,80,42,38
Gooner,argent-dawn,1575,warrior,arms,82,42,40
Eyeslicer,quelthalas,1575,warrior,arms,54,27,27
Battlemaster,die-aldor,1575,warrior,arms,92,45,47
Reìvah,silvermoon,1575,warrior,arms,129,61,68
Oxay,alakir,1575,warrior,arms,70,30,40
Tinkaton,sylvanas,1575,warrior,arms,48,20,28
Rágnør,blackrock,1575,warrior,arms,60,22,38
Nakro,hyjal,1574,warrior,arms,48,29,19
Malgár,argent-dawn,1574,warrior,arms,70,36,34
Erotixboi,blackrock,1573,warrior,arms,48,29,19
Sebeastian,ravencrest,1573,warrior,arms,126,67,59
Rabaozi,blackhand,1573,warrior,arms,167,84,83
Хоркан,blackscar,1573,warrior,arms,72,35,37
Linkx,lightnings-blade,1573,warrior,arms,66,30,36
Quáker,stormscale,1572,warrior,arms,86,48,38
Оргрриммар,soulflayer,1572,warrior,arms,501,250,251
Khanox,twisting-nether,1572,warrior,arms,166,82,84
Сариату,soulflayer,1572,warrior,arms,36,17,19
Batïk,blackmoore,1572,warrior,arms,125,57,68
Velgrim,ravencrest,1572,warrior,arms,87,37,50
Fookyoup,stormscale,1572,warrior,arms,45,18,27
Bôris,argent-dawn,1571,warrior,arms,94,51,43
Jøtawarrior,sanguino,1571,warrior,arms,79,40,39
Treze,sanguino,1571,warrior,arms,194,95,99
Mypzo,kazzak,1571,warrior,arms,156,76,80
Reider,twisting-nether,1571,warrior,arms,248,118,130
Randrion,blackrock,1571,warrior,arms,41,19,22
Rogersrage,ragnaros,1570,warrior,arms,153,81,72
Monbun,silvermoon,1570,warrior,arms,101,51,50
Arcreign,kazzak,1570,warrior,arms,216,107,109
Breaken,silvermoon,1569,warrior,arms,60,32,28
Спуллае,soulflayer,1569,warrior,arms,48,25,23
Robitusin,ragnaros,1569,warrior,arms,151,72,79
Melogranod,nemesis,1569,warrior,arms,42,20,22
Rageover,outland,1568,warrior,arms,35,20,15
Vampviv,tarren-mill,1568,warrior,arms,36,19,17
Yoñtuk,twisting-nether,1568,warrior,arms,36,19,17
Grimzot,ragnaros,1568,warrior,arms,90,47,43
Lakes,eredar,1568,warrior,arms,50,18,32
Rswar,archimonde,1567,warrior,arms,36,21,15
Ganzaésábi,aggra-português,1567,warrior,arms,108,57,51
Слуфен,galakrond,1566,warrior,arms,78,44,34
Gely,silvermoon,1566,warrior,arms,119,59,60
Chestbru,blackrock,1566,warrior,arms,164,72,92
Дейдулус,soulflayer,1566,warrior,arms,78,33,45
Miniwitts,ravencrest,1565,warrior,arms,30,20,10
Orcassmus,blackrock,1565,warrior,arms,66,36,30
Beanzz,blackmoore,1565,warrior,arms,36,19,17
Crangle,draenor,1565,warrior,arms,115,59,56
Тритиан,soulflayer,1565,warrior,arms,171,87,84
Rakuna,tarren-mill,1565,warrior,arms,138,68,70
Serastul,rajaxx,1565,warrior,arms,104,51,53
Giganza,outland,1565,warrior,arms,66,29,37
Lilgozga,stormscale,1565,warrior,arms,113,47,66
Stormfist,tarren-mill,1564,warrior,arms,96,54,42
Едигейй,gordunni,1564,warrior,arms,58,32,26
Skrawarr,das-syndikat,1564,warrior,arms,174,88,86
Perinel,draenor,1564,warrior,arms,210,104,106
Ajax,defias-brotherhood,1564,warrior,arms,101,49,52
Methodxd,outland,1564,warrior,arms,84,40,44
Romic,guldan,1564,warrior,arms,84,39,45
Jastreb,blackrock,1564,warrior,arms,132,60,72
Sankuto,kazzak,1563,warrior,arms,83,50,33
Sobii,ravencrest,1563,warrior,arms,53,28,25
Vlorgboi,drakthul,1563,warrior,arms,42,18,24
Cavo,drakthul,1563,warrior,arms,42,18,24
Cleopatra,frostwhisper,1561,warrior,arms,36,22,14
Lilshockwave,argent-dawn,1561,warrior,arms,54,31,23
Krîspie,archimonde,1561,warrior,arms,131,68,63
Футжисубо,razuvious,1561,warrior,arms,47,24,23
Gozga,twisting-nether,1561,warrior,arms,202,103,99
Rongh,saurfang,1561,warrior,arms,36,17,19
Daýz,draenor,1561,warrior,arms,48,18,30
Abrash,ysondre,1560,warrior,arms,154,75,79
Протектор,soulflayer,1560,warrior,arms,60,29,31
Stancenation,draenor,1560,warrior,arms,105,50,55
Сёнпай,soulflayer,1559,warrior,arms,35,21,14
Alyx,mugthol,1559,warrior,arms,116,62,54
Хэлслэйтэр,gordunni,1559,warrior,arms,130,65,65
Noitoved,outland,1559,warrior,arms,56,23,33
Currarms,aegwynn,1559,warrior,arms,55,22,33
Naizu,zuljin,1559,warrior,arms,60,22,38
Huullkk,nazjatar,1558,warrior,arms,149,73,76
Mikehawk,les-clairvoyants,1558,warrior,arms,53,20,33
Mortaal,frostmane,1557,warrior,arms,90,49,41
Ayasana,argent-dawn,1557,warrior,arms,48,26,22
Zíreael,ravencrest,1557,warrior,arms,95,49,46
Тише,deathweaver,1557,warrior,arms,60,29,31
Dreadbanga,blackmoore,1557,warrior,arms,91,42,49
Daminia,aegwynn,1556,warrior,arms,60,38,22
Manokikiros,sylvanas,1556,warrior,arms,36,18,18
Hasmocaru,silvermoon,1556,warrior,arms,84,40,44
Saofang,twisting-nether,1555,warrior,arms,66,33,33
Yeahq,kazzak,1555,warrior,arms,266,130,136
Hivuka,blackhand,1554,warrior,arms,42,22,20
Wazraf,khaz-modan,1554,warrior,arms,198,100,98
Cleix,frostwolf,1554,warrior,arms,41,17,24
Rendz,ravencrest,1553,warrior,arms,30,19,11
Mélindà,silvermoon,1553,warrior,arms,63,38,25
Ariéz,tarren-mill,1553,warrior,arms,116,62,54
Dagreenjo,tarren-mill,1553,warrior,arms,60,32,28
Kantarion,stormscale,1553,warrior,arms,102,52,50
Bllué,ravencrest,1553,warrior,arms,42,17,25
Fokra,draenor,1552,warrior,arms,86,53,33
Mashooxd,archimonde,1552,warrior,arms,42,23,19
Waf,hakkar,1552,warrior,arms,195,105,90
Crissx,silvermoon,1552,warrior,arms,420,214,206
Xanco,ravencrest,1552,warrior,arms,110,54,56
Shownomercy,blackrock,1552,warrior,arms,66,32,34
ßloodz,hyjal,1552,warrior,arms,144,66,78
Skullrage,tarren-mill,1551,warrior,arms,95,44,51
Tezzter,malganis,1551,warrior,arms,48,21,27
Trâshcârlitâ,eredar,1551,warrior,arms,48,17,31
Shirøx,blackrock,1550,warrior,arms,78,42,36
Philatou,antonidas,1549,warrior,arms,53,29,24
Genjutsubeat,blackmoore,1548,warrior,arms,54,31,23
Divyx,tarren-mill,1548,warrior,arms,139,72,67
Scarloc,archimonde,1548,warrior,arms,134,68,66
Martins,doomhammer,1548,warrior,arms,302,151,151
Raizy,frostwolf,1547,warrior,arms,350,185,165
Kaîsaschnitt,malganis,1547,warrior,arms,167,88,79
Arowbaze,archimonde,1547,warrior,arms,66,28,38
Hortswarr,drakthul,1546,warrior,arms,49,29,20
Donfidel,tarren-mill,1546,warrior,arms,30,17,13
Threnewar,kazzak,1546,warrior,arms,60,31,29
Tamesulo,silvermoon,1546,warrior,arms,101,52,49
Zëhef,hyjal,1546,warrior,arms,138,71,67
Bluto,dunemaul,1546,warrior,arms,447,228,219
Chrekk,khaz-modan,1546,warrior,arms,157,80,77
Shagara,defias-brotherhood,1546,warrior,arms,92,45,47
Trenôdeca,stormscale,1546,warrior,arms,48,23,25
Alexandrrior,rexxar,1546,warrior,arms,114,53,61
Khilax,ragnaros,1545,warrior,arms,228,127,101
Terrificone,drakthul,1545,warrior,arms,104,55,49
Bullrug,blackrock,1545,warrior,arms,70,36,34
Yatõ,blackmoore,1545,warrior,arms,83,41,42
Nàsher,frostwolf,1545,warrior,arms,133,64,69
Hornkesh,draenor,1545,warrior,arms,36,17,19
Rightversion,sylvanas,1545,warrior,arms,54,24,30
Roniw,sylvanas,1544,warrior,arms,102,54,48
Massiveape,argent-dawn,1544,warrior,arms,69,35,34
Trust,darksorrow,1544,warrior,arms,113,57,56
Grumpy,lightbringer,1544,warrior,arms,136,67,69
Kekrah,burning-legion,1544,warrior,arms,65,27,38
Lubcifer,emeriss,1543,warrior,arms,30,17,13
Panggy,ragnaros,1543,warrior,arms,100,50,50
Gipsyjoe,ragnaros,1543,warrior,arms,88,43,45
Teliese,argent-dawn,1543,warrior,arms,44,18,26
Rottenfall,azjolnerub,1542,warrior,arms,135,81,54
Трафалльгар,gordunni,1542,warrior,arms,285,152,133
Ignyz,stormscale,1542,warrior,arms,86,42,44
Шеломвар,gordunni,1542,warrior,arms,232,110,122
Мускулатор,soulflayer,1541,warrior,arms,159,82,77
Liqpref,draenor,1541,warrior,arms,63,32,31
Wrynir,archimonde,1541,warrior,arms,78,38,40
Hellespont,hellscream,1541,warrior,arms,191,85,106
Grimoire,drakthul,1540,warrior,arms,68,38,30
Màkáveli,stormscale,1540,warrior,arms,113,56,57
Bladesmiths,argent-dawn,1540,warrior,arms,66,32,34
Jeonsoyeon,argent-dawn,1540,warrior,arms,36,17,19
Mazaharine,archimonde,1540,warrior,arms,72,33,39
Herigan,burning-legion,1539,warrior,arms,69,32,37
Deadlyanger,kazzak,1538,warrior,arms,108,56,52
Бубаигавар,gordunni,1538,warrior,arms,72,36,36
ßamßam,draenor,1538,warrior,arms,58,29,29
Alexamazing,lordaeron,1538,warrior,arms,79,37,42
Marablind,drakthul,1538,warrior,arms,42,17,25
Zhulgar,azjolnerub,1537,warrior,arms,60,32,28
Мираксус,soulflayer,1537,warrior,arms,103,50,53
Zeepp,ravencrest,1537,warrior,arms,135,63,72
Земибор,soulflayer,1537,warrior,arms,96,38,58
Valíon,outland,1536,warrior,arms,154,85,69
Euforija,kazzak,1536,warrior,arms,160,85,75
Grántor,eredar,1536,warrior,arms,78,41,37
Renbaka,marécage-de-zangar,1536,warrior,arms,48,25,23
Агрегат,goldrinn,1536,warrior,arms,138,66,72
Axetomouth,blackrock,1535,warrior,arms,72,38,34
Stepa,sylvanas,1535,warrior,arms,86,43,43
Ckx,kazzak,1534,warrior,arms,44,28,16
Почтитайсон,howling-fjord,1534,warrior,arms,50,27,23
Akenrun,eredar,1534,warrior,arms,102,52,50
Madkill,twisting-nether,1533,warrior,arms,87,46,41
Aizy,blackhand,1533,warrior,arms,54,28,26
Архиватор,gordunni,1533,warrior,arms,175,89,86
Miodrag,kazzak,1533,warrior,arms,54,25,29
Айсиёу,howling-fjord,1533,warrior,arms,62,26,36
Tyrasia,hyjal,1532,warrior,arms,30,16,14
Èzekiel,dalaran,1532,warrior,arms,209,107,102
Pishpy,sylvanas,1532,warrior,arms,38,19,19
Skorz,kazzak,1532,warrior,arms,117,57,60
Badwarr,blackhand,1532,warrior,arms,72,35,37
Mesmash,uldum,1532,warrior,arms,54,26,28
Kookwr,aggra-português,1532,warrior,arms,116,51,65
Дезертиир,booty-bay,1532,warrior,arms,65,23,42
Lahzar,krasus,1531,warrior,arms,138,64,74
Swayzze,frostwolf,1531,warrior,arms,60,25,35
Mbappé,dragonblight,1530,warrior,arms,18,16,2
Delonathor,drakthul,1530,warrior,arms,44,25,19
Jagannath,stormscale,1530,warrior,arms,44,22,22
Êphêý,kazzak,1530,warrior,arms,36,16,20
Mouliard,archimonde,1529,warrior,arms,56,28,28
Laceysmash,anubarak,1529,warrior,arms,42,21,21
Киллдекс,gordunni,1529,warrior,arms,227,111,116
Proxxyyqt,blackrock,1529,warrior,arms,68,30,38
Suchasosuck,twisting-nether,1528,warrior,arms,328,174,154
Teg,ravencrest,1528,warrior,arms,114,58,56
Séphi,archimonde,1527,warrior,arms,96,47,49
Heubba,hyjal,1527,warrior,arms,48,18,30
Беспонятия,blackscar,1526,warrior,arms,64,35,29
Рестат,soulflayer,1526,warrior,arms,342,170,172
Kyrú,silvermoon,1526,warrior,arms,126,61,65
Bonnaventure,hyjal,1525,warrior,arms,263,140,123
Whoosah,ragnaros,1525,warrior,arms,123,60,63
Zergalot,stormscale,1525,warrior,arms,82,37,45
Adzandel,silvermoon,1525,warrior,arms,138,62,76
Darkironwolf,silvermoon,1524,warrior,arms,24,16,8
Melfis,aegwynn,1524,warrior,arms,58,31,27
Warmis,argent-dawn,1524,warrior,arms,55,27,28
Jonukas,argent-dawn,1524,warrior,arms,64,29,35
Pra,antonidas,1523,warrior,arms,84,49,35
Гладиакрис,gordunni,1523,warrior,arms,264,133,131
Vratranzhul,kirin-tor,1523,warrior,arms,349,172,177
Odenscolddry,kazzak,1523,warrior,arms,209,99,110
Tentontruck,ragnaros,1523,warrior,arms,95,40,55
Cãngo,die-todeskrallen,1522,warrior,arms,174,92,82
Wildblue,sylvanas,1522,warrior,arms,128,67,61
Ricssonz,burning-legion,1522,warrior,arms,120,62,58
Xecutie,antonidas,1522,warrior,arms,189,96,93
Shrekwarr,kazzak,1522,warrior,arms,137,67,70
Norwegian,silvermoon,1522,warrior,arms,92,44,48
Meldy,dun-morogh,1522,warrior,arms,56,22,34
Stormcoil,stormscale,1521,warrior,arms,47,24,23
Icekissx,hyjal,1521,warrior,arms,147,75,72
Каутто,howling-fjord,1521,warrior,arms,66,30,36
Bigbroh,grim-batol,1520,warrior,arms,135,78,57
Devilpanic,outland,1520,warrior,arms,30,16,14
Сика,blackscar,1520,warrior,arms,114,55,59
Rageful,saurfang,1519,warrior,arms,33,18,15
Gervvand,burning-legion,1519,warrior,arms,48,26,22
Мэйрил,lich-king,1519,warrior,arms,190,99,91
Pokopo,blackrock,1519,warrior,arms,355,179,176
Hazzael,ravencrest,1519,warrior,arms,126,63,63
Deadlycalm,blackrock,1519,warrior,arms,229,114,115
Ослаард,gordunni,1519,warrior,arms,54,26,28
Nashgrim,blackrock,1519,warrior,arms,60,26,34
Eyesonly,blackmoore,1518,warrior,arms,100,58,42
Ingensan,lightbringer,1518,warrior,arms,116,63,53
Yukizz,ravencrest,1518,warrior,arms,30,16,14
Gaisorg,die-aldor,1518,warrior,arms,60,31,29
Darkwhisper,destromath,1518,warrior,arms,84,43,41
Лотрранк,gordunni,1518,warrior,arms,114,50,64
Vurux,blackrock,1517,warrior,arms,50,27,23
Grroom,tarren-mill,1517,warrior,arms,82,41,41
Imfiñe,outland,1517,warrior,arms,173,83,90
Glendower,draenor,1517,warrior,arms,103,46,57
Savedsky,zuljin,1517,warrior,arms,48,16,32
Blitz,archimonde,1516,warrior,arms,47,28,19
Zarad,stormreaver,1516,warrior,arms,64,35,29
Warclodo,la-croisade-écarlate,1516,warrior,arms,36,18,18
Ashecröft,sylvanas,1516,warrior,arms,68,31,37
Trilon,blackrock,1516,warrior,arms,56,24,32
Оргнар,ashenvale,1515,warrior,arms,66,34,32
Skeletor,draenor,1515,warrior,arms,61,30,31
Rayner,illidan,1515,warrior,arms,60,28,32
Maniackz,tarren-mill,1514,warrior,arms,42,21,21
Cryhoof,ragnaros,1514,warrior,arms,207,103,104
Трешконтент,gordunni,1514,warrior,arms,138,66,72
Анакронокс,howling-fjord,1514,warrior,arms,50,23,27
Frcwar,kazzak,1514,warrior,arms,66,30,36
Fraggiz,auchindoun,1513,warrior,arms,47,24,23
Oweiko,blackrock,1513,warrior,arms,96,48,48
Dvvdeek,burning-legion,1513,warrior,arms,48,17,31
Warmegedon,frostmane,1512,warrior,arms,24,16,8
Bävling,kazzak,1512,warrior,arms,61,33,28
Grimarg,drakthul,1512,warrior,arms,84,42,42
Thaldrys,blackhand,1512,warrior,arms,167,81,86
Бизэмэйкер,gordunni,1512,warrior,arms,36,17,19
Firience,silvermoon,1512,warrior,arms,65,26,39
Шлифую,howling-fjord,1511,warrior,arms,79,45,34
Xorlog,thrall,1511,warrior,arms,59,33,26
Hefthyn,sanguino,1511,warrior,arms,66,36,30
Ødên,frostmane,1511,warrior,arms,30,16,14
Romanul,terokkar,1511,warrior,arms,182,91,91
Lachandrius,blackhand,1511,warrior,arms,141,70,71
Belgabad,rexxar,1511,warrior,arms,89,40,49
Ginjó,blackhand,1510,warrior,arms,82,45,37
Glakias,silvermoon,1510,warrior,arms,69,35,34
Ragnou,tarren-mill,1510,warrior,arms,100,48,52
Хамерртайм,goldrinn,1510,warrior,arms,48,20,28
Sanca,naxxramas,1509,warrior,arms,66,26,40
Wyes,kazzak,1508,warrior,arms,205,105,100
Èbert,silvermoon,1508,warrior,arms,42,20,22
Drahtalger,hyjal,1508,warrior,arms,54,25,29
Melliug,ysondre,1508,warrior,arms,48,20,28
Nøsyo,blackrock,1507,warrior,arms,30,18,12
Üs,ravencrest,1507,warrior,arms,69,37,32
Alinash,aegwynn,1507,warrior,arms,81,42,39
Бокалпивка,soulflayer,1507,warrior,arms,62,31,31
Настрамо,gordunni,1507,warrior,arms,52,26,26
Jashin,hellfire,1507,warrior,arms,90,39,51
Sonìe,kazzak,1506,warrior,arms,89,51,38
Wahin,uldum,1506,warrior,arms,30,16,14
Джанобу,soulflayer,1506,warrior,arms,36,18,18
Subwaygodx,frostwolf,1506,warrior,arms,61,25,36
Jamakun,magtheridon,1505,warrior,arms,54,29,25
Celphboss,tarren-mill,1505,warrior,arms,93,49,44
Fiveboy,tarren-mill,1505,warrior,arms,66,33,33
Haraldjuhnke,frostwolf,1505,warrior,arms,76,35,41
Wargak,stormscale,1505,warrior,arms,42,18,24
Micromachine,argent-dawn,1505,warrior,arms,66,25,41
Pied,krasus,1504,warrior,arms,36,19,17
Dokô,twisting-nether,1504,warrior,arms,84,44,40
Тэйкмисофтли,blackscar,1504,warrior,arms,54,28,26
Волрок,howling-fjord,1504,warrior,arms,67,34,33
Pptickler,argent-dawn,1504,warrior,arms,83,41,42
Raakalainen,vashj,1504,warrior,arms,59,29,30
Knoxworth,kazzak,1504,warrior,arms,77,37,40
Grezlyk,drakthul,1504,warrior,arms,149,71,78
Ironsíde,alakir,1504,warrior,arms,63,28,35
Istenn,stormscale,1504,warrior,arms,72,27,45
Alokar,draenor,1503,warrior,arms,66,35,31
Totenkrieger,draenor,1503,warrior,arms,60,29,31
Дагмар,howling-fjord,1503,warrior,arms,72,34,38
Nezruslone,dun-modr,1502,warrior,arms,58,42,16
Dødsdonny,draenor,1502,warrior,arms,162,89,73
Ollyaa,ravencrest,1502,warrior,arms,84,45,39
Leroxius,ragnaros,1502,warrior,arms,222,116,106
Кизуми,gordunni,1502,warrior,arms,81,38,43
Rookian,blackrock,1502,warrior,arms,42,19,23
Ausrastus,blackhand,1501,warrior,arms,36,18,18
Whiteowlx,argent-dawn,1501,warrior,arms,66,32,34
Slidmacka,twisting-nether,1501,warrior,arms,204,95,109
Брюслипве,gordunni,1501,warrior,arms,54,23,31
Рыгулька,gordunni,1500,warrior,arms,198,96,102
Arktharion,antonidas,1500,warrior,arms,96,46,50
Greekazi,kazzak,1499,warrior,arms,87,47,40
Mentôr,sargeras,1499,warrior,arms,47,23,24
Eduartho,dun-modr,1499,warrior,arms,39,19,20
Arreat,chogall,1499,warrior,arms,194,94,100
Sasorí,blackrock,1499,warrior,arms,208,99,109
Ansi,argent-dawn,1499,warrior,arms,157,73,84
Shimslady,outland,1499,warrior,arms,48,17,31
Люцц,gordunni,1498,warrior,arms,351,171,180
Crriminal,ravencrest,1498,warrior,arms,48,20,28
Notsyn,twisting-nether,1497,warrior,arms,60,38,22
Shedzo,tarren-mill,1497,warrior,arms,42,25,17
Dxc,blackhand,1497,warrior,arms,56,29,27
Astost,silvermoon,1497,warrior,arms,96,49,47
Fullzugzug,kazzak,1497,warrior,arms,84,41,43
Chynora,blackmoore,1497,warrior,arms,84,40,44
Trohr,blackmoore,1497,warrior,arms,36,16,20
Pezuñaloca,shendralar,1496,warrior,arms,96,56,40
Nukebomb,dun-modr,1496,warrior,arms,83,41,42
Piksitron,silvermoon,1495,warrior,arms,246,139,107
Fiverare,stormscale,1495,warrior,arms,30,16,14
Ragingqawk,outland,1495,warrior,arms,34,18,16
Bobloblaww,doomhammer,1495,warrior,arms,102,53,49
Ðraço,kazzak,1495,warrior,arms,50,25,25
Juicyglutes,turalyon,1495,warrior,arms,48,24,24
Umadyeh,stormscale,1494,warrior,arms,58,36,22
Думхаммер,howling-fjord,1494,warrior,arms,77,44,33
Morvar,sanguino,1494,warrior,arms,30,16,14
Shadowbôxer,onyxia,1494,warrior,arms,74,38,36
Thiccbra,burning-legion,1494,warrior,arms,78,40,38
Whátsup,stormscale,1494,warrior,arms,48,24,24
Gìlgamesh,dun-modr,1494,warrior,arms,182,89,93
Kleidaria,stormscale,1494,warrior,arms,80,39,41
Sholong,antonidas,1494,warrior,arms,66,31,35
Donkeymeta,frostmane,1494,warrior,arms,102,47,55
Aurélus,rexxar,1493,warrior,arms,36,22,14
Hekkarí,auchindoun,1493,warrior,arms,28,16,12
Rutch,hyjal,1493,warrior,arms,102,54,48
Ardmoo,burning-legion,1493,warrior,arms,65,34,31
Эйримор,gordunni,1493,warrior,arms,36,18,18
Dárkhammer,tarren-mill,1493,warrior,arms,102,50,52
Mordeukay,hyjal,1493,warrior,arms,72,34,38
Ssnakeess,silvermoon,1492,warrior,arms,90,48,42
Boshim,ravencrest,1492,warrior,arms,60,32,28
Tinkley,quelthalas,1492,warrior,arms,51,27,24
Solezte,tarren-mill,1492,warrior,arms,114,59,55
Deswarr,tarren-mill,1492,warrior,arms,63,25,38
Hùmøngöúslåm,ravencrest,1491,warrior,arms,42,25,17
Nighat,sanguino,1491,warrior,arms,174,88,86
Брэмбур,goldrinn,1491,warrior,arms,173,87,86
Nexpwns,blackhand,1491,warrior,arms,225,113,112
Lyes,uldaman,1491,warrior,arms,408,202,206
Párta,ravencrest,1491,warrior,arms,106,52,54
Pumpadzhîja,outland,1491,warrior,arms,66,32,34
Vectarrior,eredar,1491,warrior,arms,60,29,31
Стенденсх,howling-fjord,1491,warrior,arms,161,77,84
Gantsrip,stormscale,1491,warrior,arms,88,41,47
Каргром,howling-fjord,1491,warrior,arms,39,18,21
Вимор,soulflayer,1491,warrior,arms,39,18,21
Exoblade,silvermoon,1491,warrior,arms,88,37,51
Picciocino,nemesis,1491,warrior,arms,88,36,52
Hitmanler,frostmane,1490,warrior,arms,168,87,81
Hanna,argent-dawn,1490,warrior,arms,54,27,27
Ricovega,kazzak,1490,warrior,arms,42,21,21
Казньшалав,gordunni,1489,warrior,arms,159,81,78
Tddyy,silvermoon,1489,warrior,arms,42,21,21
Dagouor,twisting-nether,1489,warrior,arms,99,48,51
Wardrior,stormscale,1489,warrior,arms,62,30,32
Северот,deepholm,1489,warrior,arms,59,28,31
Cäös,sanguino,1489,warrior,arms,98,45,53
Gromkarg,draenor,1489,warrior,arms,122,52,70
Ishi,archimonde,1489,warrior,arms,46,19,27
Longy,mazrigos,1488,warrior,arms,51,27,24
Booj,silvermoon,1488,warrior,arms,182,95,87
Ilovealma,kiljaeden,1488,warrior,arms,107,49,58
Omgez,grim-batol,1488,warrior,arms,42,16,26
Hindbærsaft,stormscale,1487,warrior,arms,55,32,23
Зэйсс,gordunni,1486,warrior,arms,36,21,15
Jimei,temple-noir,1486,warrior,arms,30,16,14
Reider,kazzak,1486,warrior,arms,63,33,30
Галактозар,soulflayer,1486,warrior,arms,273,142,131
Голдибитч,gordunni,1486,warrior,arms,84,41,43
Shïn,kaelthas,1486,warrior,arms,78,35,43
Getjuiced,tarren-mill,1486,warrior,arms,54,21,33
Calmdownbrú,frostmane,1485,warrior,arms,119,60,59
Aromë,argent-dawn,1485,warrior,arms,36,18,18
Mfdoöm,draenor,1485,warrior,arms,172,85,87
Paow,tarren-mill,1485,warrior,arms,77,37,40
Nainculay,kaelthas,1485,warrior,arms,48,23,25
Vveerdy,stormreaver,1485,warrior,arms,96,45,51
Anarki,kaelthas,1485,warrior,arms,81,36,45
Угхпах,soulflayer,1485,warrior,arms,107,44,63
Omgihithard,draenor,1484,warrior,arms,57,28,29
Keksspec,ungoro,1484,warrior,arms,96,45,51
Fizzywarrior,blackmoore,1484,warrior,arms,63,29,34
Zévi,ravencrest,1484,warrior,arms,42,18,24
Arturo,blackmoore,1484,warrior,arms,70,27,43
Kaylì,ravencrest,1484,warrior,arms,53,20,33
Мерсилессх,gordunni,1483,warrior,arms,114,57,57
Денеур,gordunni,1483,warrior,arms,146,58,88
Ocecute,tarren-mill,1482,warrior,arms,60,33,27
Lortèn,stormscale,1482,warrior,arms,48,24,24
Leomance,hyjal,1481,warrior,arms,32,20,12
Orgazam,xavius,1481,warrior,arms,83,45,38
Frankius,ravencrest,1481,warrior,arms,102,53,49
Faltzan,bronze-dragonflight,1481,warrior,arms,83,41,42
Runhex,veknilash,1481,warrior,arms,53,26,27
Dzvenyhora,darkspear,1481,warrior,arms,108,52,56
Hôrn,stormscale,1480,warrior,arms,70,40,30
Blacksliide,blackmoore,1480,warrior,arms,30,17,13
Кринжеверт,howling-fjord,1480,warrior,arms,78,44,34
Gramr,silvermoon,1480,warrior,arms,71,36,35
Henco,twisting-nether,1480,warrior,arms,48,24,24
Airowar,drakthul,1480,warrior,arms,47,23,24
Doba,madmortem,1480,warrior,arms,103,50,53
Arenameister,blackmoore,1480,warrior,arms,48,23,25
Nurfbolt,kazzak,1480,warrior,arms,53,25,28
Warmâchine,burning-legion,1480,warrior,arms,301,141,160
Rathis,arathor,1480,warrior,arms,126,54,72
Altimáte,antonidas,1479,warrior,arms,30,18,12
Kestialezin,archimonde,1479,warrior,arms,101,60,41
Мэднас,howling-fjord,1479,warrior,arms,156,79,77
Minitizzr,stormscale,1479,warrior,arms,72,36,36
Равахим,soulflayer,1479,warrior,arms,36,18,18
Ceen,alakir,1479,warrior,arms,71,35,36
Mezugzugyou,draenor,1479,warrior,arms,63,31,32
Orimis,doomhammer,1479,warrior,arms,48,22,26
Lektor,eredar,1478,warrior,arms,54,23,31
Teronth,burning-legion,1478,warrior,arms,66,24,42
Lezgar,ragnaros,1477,warrior,arms,24,18,6
Pajalousta,elune,1477,warrior,arms,120,56,64
Bracki,ysondre,1477,warrior,arms,46,21,25
Cráft,silvermoon,1477,warrior,arms,112,50,62
Trenbullone,kazzak,1476,warrior,arms,51,32,19
Aza,burning-blade,1476,warrior,arms,102,55,47
Freutag,azshara,1476,warrior,arms,114,61,53
Kamblas,la-croisade-écarlate,1476,warrior,arms,60,24,36
Elinyar,aegwynn,1476,warrior,arms,48,17,31
Argaskurken,ravencrest,1475,warrior,arms,78,38,40
Разрубателл,soulflayer,1475,warrior,arms,66,31,35
Wvanp,tarren-mill,1474,warrior,arms,30,17,13
Metaslave,the-maelstrom,1474,warrior,arms,54,26,28
Arowpoint,doomhammer,1474,warrior,arms,47,21,26
Gíu,blackhand,1473,warrior,arms,40,23,17
Kelmyst,ragnaros,1473,warrior,arms,86,46,40
Kioskmupp,ravencrest,1473,warrior,arms,393,201,192
Bigbmh,tarren-mill,1473,warrior,arms,54,26,28
Karyoroo,eredar,1473,warrior,arms,48,23,25
Morthôr,grim-batol,1473,warrior,arms,75,34,41
Becca,rexxar,1472,warrior,arms,36,16,20
Vegilhenvin,stormscale,1471,warrior,arms,86,39,47
Роглум,blackscar,1471,warrior,arms,181,81,100
Koboone,tarren-mill,1469,warrior,arms,35,18,17
Razoo,stormscale,1469,warrior,arms,127,63,64
Clellin,silvermoon,1469,warrior,arms,75,37,38
Rumbldore,ragnaros,1469,warrior,arms,66,31,35
Wutend,nemesis,1468,warrior,arms,83,40,43
Monforte,silvermoon,1468,warrior,arms,44,18,26
Йошихироо,howling-fjord,1467,warrior,arms,60,29,31
Ormert,sylvanas,1467,warrior,arms,60,28,32
Thorgrím,ravencrest,1467,warrior,arms,90,41,49
Drushíí,shattrath,1466,warrior,arms,77,39,38
Arashicage,emeriss,1465,warrior,arms,112,62,50
Bigboibeeper,draenor,1465,warrior,arms,143,72,71
Rikistrike,tarren-mill,1465,warrior,arms,76,37,39
Markorok,kazzak,1465,warrior,arms,72,33,39
Refl,kazzak,1465,warrior,arms,94,42,52
Synrosh,hyjal,1464,warrior,arms,69,40,29
Enface,ragnaros,1464,warrior,arms,166,85,81
Polywarri,blackrock,1464,warrior,arms,42,17,25
Judditsbx,draenor,1463,warrior,arms,82,44,38
Anthrazit,stormscale,1463,warrior,arms,147,74,73
Ялаз,gordunni,1463,warrior,arms,136,66,70
Apocrypha,darkspear,1463,warrior,arms,48,23,25
Сэлфиш,lich-king,1463,warrior,arms,83,38,45
Ugardosh,burning-legion,1463,warrior,arms,75,34,41
Дотаветеран,soulflayer,1462,warrior,arms,42,23,19
Sorosterv,twisting-nether,1462,warrior,arms,117,63,54
Vauster,draenor,1462,warrior,arms,86,45,41
Worstplàyer,tarren-mill,1462,warrior,arms,143,72,71
Ladoz,ragnaros,1462,warrior,arms,172,86,86
Gorejaws,draenor,1461,warrior,arms,30,19,11
Лютобор,gordunni,1461,warrior,arms,129,64,65
Friskos,dalaran,1461,warrior,arms,154,73,81
Kieranx,silvermoon,1461,warrior,arms,80,35,45
Azjolnerub,kazzak,1461,warrior,arms,76,29,47
Xraider,ragnaros,1460,warrior,arms,116,61,55
Абабоба,gordunni,1460,warrior,arms,106,55,51
Азаргатан,soulflayer,1460,warrior,arms,62,31,31
Kerador,archimonde,1459,warrior,arms,32,25,7
Teljii,blackmoore,1459,warrior,arms,34,20,14
Greatsword,turalyon,1459,warrior,arms,47,25,22
Vallahan,argent-dawn,1459,warrior,arms,310,149,161
Aîdogar,ysondre,1459,warrior,arms,66,30,36
Erololi,sanguino,1459,warrior,arms,50,21,29
Màrduk,pozzo-delleternità,1458,warrior,arms,29,16,13
Ramhadat,hyjal,1458,warrior,arms,78,40,38
Màrv,ravencrest,1458,warrior,arms,54,25,29
Gnomeð,blackrock,1458,warrior,arms,99,45,54
Ninurtawar,tarren-mill,1458,warrior,arms,75,34,41
Hgfe,doomhammer,1458,warrior,arms,54,24,30
Shádówfáxí,outland,1458,warrior,arms,36,16,20
Kneecleaver,darksorrow,1458,warrior,arms,87,38,49
Lisztomaniak,outland,1458,warrior,arms,55,22,33
Beebsy,aegwynn,1457,warrior,arms,26,16,10
Grimsong,antonidas,1457,warrior,arms,43,24,19
Authar,tarren-mill,1457,warrior,arms,190,97,93
Sahl,sylvanas,1457,warrior,arms,198,95,103
Darksworn,alleria,1456,warrior,arms,60,35,25
Zaatar,draenor,1456,warrior,arms,232,122,110
Phenowarri,blackhand,1456,warrior,arms,115,60,55
Xennor,argent-dawn,1456,warrior,arms,94,45,49
Auroree,ragnaros,1456,warrior,arms,42,18,24
Testonator,outland,1456,warrior,arms,48,20,28
Reb,thunderhorn,1455,warrior,arms,45,26,19
Knego,ragnaros,1455,warrior,arms,173,99,74
Rodenet,dun-modr,1455,warrior,arms,107,56,51
Nucleargrab,twilights-hammer,1455,warrior,arms,265,133,132
Варгана,soulflayer,1455,warrior,arms,198,99,99
Velinde,outland,1455,warrior,arms,52,24,28
Phóó,thrall,1455,warrior,arms,88,39,49
Турбобулка,gordunni,1455,warrior,arms,42,18,24
Ragetotem,doomhammer,1455,warrior,arms,44,18,26
Belzebud,kazzak,1455,warrior,arms,96,39,57
Legendfury,ravencrest,1454,warrior,arms,174,92,82
Zetorc,burning-legion,1454,warrior,arms,351,176,175
Hexj,tarren-mill,1453,warrior,arms,77,37,40
Ðam,kazzak,1453,warrior,arms,48,20,28
Bäiley,drakthul,1453,warrior,arms,66,27,39
Агтеррокк,deathweaver,1452,warrior,arms,90,48,42
Execútioner,sylvanas,1452,warrior,arms,98,48,50
Jailapatate,khaz-modan,1452,warrior,arms,108,52,56
Gorocpt,doomhammer,1452,warrior,arms,110,52,58
Silventus,blackmoore,1452,warrior,arms,47,21,26
Blackaxe,sylvanas,1451,warrior,arms,29,18,11
Roadsick,outland,1451,warrior,arms,30,16,14
Marcnky,stormscale,1451,warrior,arms,199,101,98
Warriar,sylvanas,1451,warrior,arms,53,25,28
Alqaqa,ragnaros,1451,warrior,arms,47,16,31
Mecaguarro,dun-modr,1450,warrior,arms,30,20,10
Sazurah,ravencrest,1450,warrior,arms,30,18,12
Stahlhund,silvermoon,1450,warrior,arms,30,18,12
Гардринг,howling-fjord,1450,warrior,arms,102,59,43
Dranush,onyxia,1450,warrior,arms,303,156,147
Антурим,howling-fjord,1450,warrior,arms,78,40,38
Ràkar,stormscale,1450,warrior,arms,110,53,57
Horizonx,blackrock,1449,warrior,arms,92,48,44
Daelator,ravencrest,1449,warrior,arms,73,37,36
Irén,hellfire,1449,warrior,arms,121,59,62
Miko,ysondre,1449,warrior,arms,120,56,64
Audítóre,proudmoore,1449,warrior,arms,48,22,26
Opticsynfel,argent-dawn,1449,warrior,arms,68,29,39
Akión,zuljin,1448,warrior,arms,72,37,35
Mazzkze,silvermoon,1448,warrior,arms,301,152,149
Vyctimz,ravencrest,1448,warrior,arms,53,26,27
Vrykhul,silvermoon,1448,warrior,arms,138,63,75
Draer,sanguino,1448,warrior,arms,47,21,26
Чухануспрайм,howling-fjord,1448,warrior,arms,40,17,23
Norinhell,ravencrest,1448,warrior,arms,48,20,28
Amarthon,sylvanas,1448,warrior,arms,63,20,43
Râsk,kazzak,1447,warrior,arms,38,21,17
Jigsar,argent-dawn,1447,warrior,arms,169,93,76
Størpïx,drakthul,1447,warrior,arms,135,73,62
Гантелявухо,blackscar,1447,warrior,arms,46,23,23
Mërkürÿ,draenor,1447,warrior,arms,36,18,18
Gakgora,twisting-nether,1447,warrior,arms,36,18,18
Hoomeer,sylvanas,1447,warrior,arms,96,46,50
Isenstrider,burning-legion,1447,warrior,arms,66,25,41
Endan,kelthuzad,1446,warrior,arms,66,37,29
Liper,silvermoon,1446,warrior,arms,211,104,107
Riann,silvermoon,1446,warrior,arms,71,30,41
Elorîl,stormscale,1445,warrior,arms,30,18,12
Askawar,sylvanas,1445,warrior,arms,30,16,14
Ordovis,silvermoon,1445,warrior,arms,63,32,31
Адво,gordunni,1445,warrior,arms,114,56,58
Nardak,blackmoore,1445,warrior,arms,38,18,20
Tyrax,blackrock,1445,warrior,arms,64,29,35
Swaxx,ravencrest,1445,warrior,arms,83,35,48
Garrodan,doomhammer,1445,warrior,arms,72,30,42
Gruxx,ragnaros,1445,warrior,arms,62,25,37
Cptnzugzug,blackmoore,1444,warrior,arms,29,16,13
Yoilenno,argent-dawn,1444,warrior,arms,42,23,19
Крискинпи,deathguard,1444,warrior,arms,83,42,41
Calel,ravencrest,1444,warrior,arms,116,58,58
Thâarnar,frostwolf,1444,warrior,arms,78,36,42
Crayz,twisting-nether,1444,warrior,arms,60,27,33
Nargez,outland,1444,warrior,arms,118,51,67
Дообрыйшмель,soulflayer,1443,warrior,arms,51,32,19
Alopunch,kazzak,1443,warrior,arms,96,50,46
Elprotes,sanguino,1443,warrior,arms,156,81,75
Spodnick,ragnaros,1443,warrior,arms,41,20,21
Каниме,howling-fjord,1443,warrior,arms,70,34,36
Рагаксес,blackscar,1443,warrior,arms,82,36,46
Tealbell,chamber-of-aspects,1442,warrior,arms,211,110,101
Blackwólf,bloodhoof,1442,warrior,arms,354,173,181
Rohc,kazzak,1442,warrior,arms,118,55,63
Pøps,hyjal,1441,warrior,arms,110,66,44
Зеленыйжмых,thermaplugg,1441,warrior,arms,243,122,121
Raixxon,ragnaros,1441,warrior,arms,186,93,93
Gipsylove,twisting-nether,1441,warrior,arms,54,24,30
Foxxzorr,aszune,1441,warrior,arms,48,20,28
Sergra,ysondre,1441,warrior,arms,66,24,42
Karimlebrave,hyjal,1440,warrior,arms,68,33,35
Lfhvnlvn,ravencrest,1439,warrior,arms,24,15,9
Zeneve,auchindoun,1439,warrior,arms,30,17,13
Medaur,frostmane,1439,warrior,arms,197,100,97
Трэйдар,blackscar,1439,warrior,arms,30,15,15
Сеш,lich-king,1439,warrior,arms,246,118,128
Krodunn,argent-dawn,1439,warrior,arms,77,34,43
Leopoldx,outland,1438,warrior,arms,85,47,38
Makerrw,ravencrest,1438,warrior,arms,50,26,24
Schlierkamp,aegwynn,1438,warrior,arms,30,15,15
Dundulinka,outland,1438,warrior,arms,129,64,65
Иктиннос,gordunni,1438,warrior,arms,106,52,54
Чпокерз,gordunni,1438,warrior,arms,94,46,48
Ryle,anubarak,1438,warrior,arms,142,63,79
Juggawumba,kazzak,1438,warrior,arms,72,31,41
Pyrit,blackhand,1437,warrior,arms,18,15,3
Garouzo,hellfire,1437,warrior,arms,64,32,32
Ylana,eldrethalas,1437,warrior,arms,183,91,92
Lakhovsky,hyjal,1437,warrior,arms,77,38,39
Intrepid,dun-modr,1437,warrior,arms,90,43,47
Hobo,ravencrest,1437,warrior,arms,176,82,94
Banshe,ragnaros,1437,warrior,arms,48,16,32
Bravest,ragnaros,1436,warrior,arms,48,26,22
Tomhankz,ravencrest,1436,warrior,arms,48,25,23
Whyduck,silvermoon,1436,warrior,arms,50,25,25
Alborozie,archimonde,1436,warrior,arms,108,52,56
Varyian,sporeggar,1436,warrior,arms,143,65,78
Øzak,outland,1436,warrior,arms,48,19,29
Crizby,twisting-nether,1436,warrior,arms,45,17,28
Zames,ravencrest,1435,warrior,arms,42,23,19
Brutøs,conseil-des-ombres,1435,warrior,arms,78,39,39
Hvalross,ravencrest,1435,warrior,arms,30,15,15
Hackamore,suramar,1435,warrior,arms,102,49,53
Randix,antonidas,1435,warrior,arms,66,31,35
Kilsorrow,silvermoon,1435,warrior,arms,72,30,42
Blondboomer,neptulon,1435,warrior,arms,84,34,50
Zugpump,tarren-mill,1434,warrior,arms,86,50,36
Maikeiru,kul-tiras,1434,warrior,arms,64,34,30
Mljecho,kazzak,1434,warrior,arms,215,110,105
Dafok,rashgarroth,1434,warrior,arms,42,19,23
Détaire,archimonde,1433,warrior,arms,24,15,9
Diablozhørs,ysondre,1433,warrior,arms,103,57,46
Heracles,jaedenar,1433,warrior,arms,36,18,18
Lostbull,kazzak,1433,warrior,arms,66,31,35
Каоссвар,howling-fjord,1433,warrior,arms,36,15,21
Enragemfck,outland,1432,warrior,arms,24,15,9
Xmartha,tarren-mill,1432,warrior,arms,128,70,58
Architectman,twisting-nether,1432,warrior,arms,371,186,185
Лагалиер,borean-tundra,1432,warrior,arms,96,47,49
Барнаул,gordunni,1432,warrior,arms,48,23,25
Shædøw,archimonde,1432,warrior,arms,58,27,31
Нетконечно,howling-fjord,1432,warrior,arms,66,29,37
Erzotz,kazzak,1431,warrior,arms,57,34,23
Savh,silvermoon,1431,warrior,arms,66,34,32
Raley,ragnaros,1431,warrior,arms,346,172,174
Lokkara,blackrock,1431,warrior,arms,98,47,51
Huor,tarren-mill,1431,warrior,arms,42,18,24
Текайко,eversong,1431,warrior,arms,54,23,31
Dragão,kazzak,1431,warrior,arms,42,17,25
Otiep,blackmoore,1430,warrior,arms,36,24,12
Hamilton,bronzebeard,1430,warrior,arms,30,16,14
Zecelei,tarren-mill,1430,warrior,arms,115,61,54
Swefy,sanguino,1430,warrior,arms,305,149,156
Ajhogan,ravencrest,1430,warrior,arms,42,19,23
Scud,frostwhisper,1429,warrior,arms,64,34,30
Lollydhur,nemesis,1429,warrior,arms,78,37,41
Gamöra,kirin-tor,1429,warrior,arms,72,33,39
Wolvéshôwl,aegwynn,1429,warrior,arms,141,64,77
Garroxx,blackrock,1429,warrior,arms,42,15,27
Âwfulwarriør,blackhand,1427,warrior,arms,24,15,9
Гетрайт,galakrond,1427,warrior,arms,49,27,22
Chakrator,la-croisade-écarlate,1427,warrior,arms,339,170,169
Evosk,drakthul,1427,warrior,arms,30,15,15
Faustà,nemesis,1427,warrior,arms,167,80,87
Гопниг,deepholm,1427,warrior,arms,149,70,79
Аузерг,soulflayer,1426,warrior,arms,77,40,37
Berzzerker,tarren-mill,1426,warrior,arms,108,56,52
Bráïnléss,silvermoon,1426,warrior,arms,36,17,19
Ragark,quelthalas,1425,warrior,arms,129,72,57
Cássándráh,argent-dawn,1425,warrior,arms,149,76,73
Genç,ysondre,1425,warrior,arms,204,103,101
Zerberos,drakthul,1425,warrior,arms,76,37,39
Krônôs,thrall,1425,warrior,arms,42,17,25
Эвоэ,soulflayer,1425,warrior,arms,48,16,32
Discordîan,twisting-nether,1424,warrior,arms,24,15,9
Weareinspace,stormscale,1424,warrior,arms,171,91,80
Dirtyjoe,khaz-modan,1424,warrior,arms,394,204,190
Thickslam,argent-dawn,1424,warrior,arms,64,29,35
Grdez,archimonde,1424,warrior,arms,56,23,33
Инелутабл,eversong,1423,warrior,arms,29,19,10
Prolyx,doomhammer,1423,warrior,arms,48,25,23
Diolucido,shattered-hand,1423,warrior,arms,31,16,15
Арсонист,gordunni,1423,warrior,arms,72,37,35
Ball,zirkel-des-cenarius,1423,warrior,arms,131,67,64
Whiterebel,ravencrest,1423,warrior,arms,30,15,15
Alkuwaity,outland,1423,warrior,arms,41,19,22
Meistarinn,draenor,1423,warrior,arms,72,27,45
Beelzebuu,blackhand,1422,warrior,arms,139,73,66
Bigbosscho,draenor,1422,warrior,arms,71,37,34
Racore,aegwynn,1422,warrior,arms,33,17,16
Peack,ravencrest,1422,warrior,arms,208,107,101
Oceangg,silvermoon,1422,warrior,arms,160,80,80
Hatefury,twisting-nether,1422,warrior,arms,156,78,78
Wøokz,argent-dawn,1422,warrior,arms,52,24,28
Ranran,emerald-dream,1422,warrior,arms,44,20,24
Kriegernuss,blackmoore,1421,warrior,arms,60,33,27
Endeawour,ravencrest,1421,warrior,arms,306,163,143
Colq,doomhammer,1421,warrior,arms,149,78,71
Xsann,argent-dawn,1421,warrior,arms,89,45,44
Goldins,drakthul,1421,warrior,arms,77,38,39
Xatit,ravencrest,1421,warrior,arms,72,35,37
Smashtv,ragnaros,1421,warrior,arms,63,28,35
Unverbal,silvermoon,1421,warrior,arms,36,15,21
Паракур,soulflayer,1420,warrior,arms,136,67,69
Jáson,kazzak,1420,warrior,arms,71,33,38
Leapling,blackmoore,1420,warrior,arms,36,16,20
Ähäkutti,frostmane,1419,warrior,arms,83,47,36
Nuahka,blackmoore,1419,warrior,arms,96,48,48
Бавовник,howling-fjord,1419,warrior,arms,75,31,44
Tedbuckland,blackrock,1418,warrior,arms,60,36,24
Zellxd,stormscale,1418,warrior,arms,36,20,16
Srbinator,turalyon,1418,warrior,arms,353,178,175
Nyamnyamnyam,blackmoore,1418,warrior,arms,35,15,20
Apashe,drakthul,1417,warrior,arms,60,31,29
Tarbhfathach,draenor,1417,warrior,arms,82,42,40
Carras,confrérie-du-thorium,1417,warrior,arms,365,180,185
Tìera,ravencrest,1417,warrior,arms,33,16,17
Gridra,dun-morogh,1417,warrior,arms,60,28,32
Llestatl,hyjal,1416,warrior,arms,83,42,41
Ciocaboca,draenor,1415,warrior,arms,30,17,13
Lyfttokyo,tarren-mill,1415,warrior,arms,104,53,51
Ðynaxz,aegwynn,1415,warrior,arms,36,17,19
Zugzugernaut,stormscale,1415,warrior,arms,36,16,20
Flurie,sylvanas,1415,warrior,arms,46,20,26
Swornsword,blackmoore,1415,warrior,arms,36,15,21
Smásher,frostmourne,1415,warrior,arms,36,15,21
Kekru,silvermoon,1415,warrior,arms,69,28,41
Центварвар,soulflayer,1414,warrior,arms,72,36,36
Drvx,twisting-nether,1414,warrior,arms,30,15,15
Дзертуф,fordragon,1414,warrior,arms,30,15,15
Lolpuîk,archimonde,1414,warrior,arms,72,31,41
Roland,earthen-ring,1414,warrior,arms,56,24,32
Úwúwúwúwúwúw,stormscale,1413,warrior,arms,54,27,27
Szelenamoon,outland,1413,warrior,arms,44,22,22
Pakusrage,defias-brotherhood,1413,warrior,arms,98,46,52
Rebiy,ravencrest,1413,warrior,arms,58,27,31
Succel,drakthul,1412,warrior,arms,70,31,39
Fion,kult-der-verdammten,1412,warrior,arms,73,31,42
Guruntar,kirin-tor,1411,warrior,arms,119,62,57
Pelicos,grim-batol,1411,warrior,arms,42,21,21
Rambô,frostwolf,1411,warrior,arms,30,15,15
Голдфингер,gordunni,1411,warrior,arms,211,105,106
Hílfiger,kazzak,1411,warrior,arms,212,100,112
Пиапиа,gordunni,1410,warrior,arms,24,15,9
Hamonbophis,kirin-tor,1410,warrior,arms,30,17,13
Hundar,archimonde,1410,warrior,arms,120,65,55
Vulperizing,draenor,1410,warrior,arms,35,18,17
Kàinen,nemesis,1410,warrior,arms,90,44,46
Nharzvog,archimonde,1410,warrior,arms,54,26,28
Gromchatte,elune,1410,warrior,arms,43,20,23
Pavard,arakarahm,1410,warrior,arms,56,26,30
Selestro,outland,1409,warrior,arms,36,20,16
Frams,draenor,1409,warrior,arms,41,22,19
Bootyclapper,runetotem,1409,warrior,arms,43,22,21
Эксихард,gordunni,1409,warrior,arms,78,34,44
Atiradeon,kazzak,1409,warrior,arms,36,15,21
Reidunøks,kazzak,1408,warrior,arms,206,99,107
Deadyet,mugthol,1407,warrior,arms,24,15,9
Kirowarrior,silvermoon,1407,warrior,arms,249,129,120
Kianit,ravencrest,1407,warrior,arms,548,272,276
Тоштайн,gordunni,1407,warrior,arms,68,30,38
Chaohz,grim-batol,1407,warrior,arms,41,17,24
Khalen,grim-batol,1407,warrior,arms,66,27,39
Mikogød,ravencrest,1407,warrior,arms,66,24,42
Svënja,ysondre,1406,warrior,arms,150,67,83
Dariman,aegwynn,1406,warrior,arms,78,34,44
Masomlejnek,burning-blade,1406,warrior,arms,42,18,24
Spargebuci,draenor,1406,warrior,arms,48,17,31
ßrink,ysondre,1405,warrior,arms,36,16,20
Esegryel,argent-dawn,1405,warrior,arms,65,26,39
Enraged,tarren-mill,1404,warrior,arms,30,15,15
Elyozz,silvermoon,1404,warrior,arms,114,56,58
Mortus,baelgun,1404,warrior,arms,143,70,73
Josgrout,silvermoon,1404,warrior,arms,118,53,65
Minimcgregor,sanguino,1404,warrior,arms,48,19,29
Неосим,gordunni,1403,warrior,arms,48,29,19
Høxy,outland,1403,warrior,arms,53,29,24
Mekkagrind,ravencrest,1403,warrior,arms,124,66,58
Youokhun,kazzak,1403,warrior,arms,204,106,98
Духолоов,gordunni,1403,warrior,arms,237,123,114
Bjösk,stormscale,1403,warrior,arms,45,23,22
Ysgrammorr,magtheridon,1403,warrior,arms,66,32,34
Арбузикхаха,soulflayer,1403,warrior,arms,68,32,36
Slunecniq,azjolnerub,1403,warrior,arms,81,36,45
Mkone,ravencrest,1403,warrior,arms,42,16,26
Mgw,blackrock,1402,warrior,arms,30,17,13
Tatabaf,ysondre,1402,warrior,arms,45,23,22
Дозен,soulflayer,1402,warrior,arms,139,69,70
Zyzy,arathor,1402,warrior,arms,64,30,34
Luküs,dun-modr,1402,warrior,arms,82,38,44
Razyk,zuljin,1401,warrior,arms,40,26,14
Tarkosha,terokkar,1401,warrior,arms,624,309,315
Bloodmyst,kazzak,1401,warrior,arms,60,27,33
Strapnslap,argent-dawn,1401,warrior,arms,107,48,59
Solle,blackrock,1400,warrior,arms,61,34,27
Peldreas,silvermoon,1400,warrior,arms,64,31,33
Carljøhnson,dalaran,1400,warrior,arms,387,187,200
Андэрс,gordunni,1400,warrior,arms,142,68,74
Nyokosuzi,grim-batol,1400,warrior,arms,137,63,74
Шпингалетыч,howling-fjord,1400,warrior,arms,48,22,26
Nabb,outland,1400,warrior,arms,50,21,29
Tonifox,nemesis,1400,warrior,arms,60,23,37
Caelgarn,twisting-nether,1399,warrior,arms,45,27,18
Ogvico,stormscale,1399,warrior,arms,67,37,30
Taurosk,burning-legion,1399,warrior,arms,194,101,93
Mangonneau,archimonde,1399,warrior,arms,60,30,30
Vilass,silvermoon,1399,warrior,arms,83,37,46
Грэйм,gordunni,1398,warrior,arms,113,54,59
Zalameh,sylvanas,1398,warrior,arms,42,19,23
Orwêll,uldum,1397,warrior,arms,281,141,140
Jumbodolmen,tarren-mill,1397,warrior,arms,106,53,53
Santorro,drakthul,1397,warrior,arms,36,17,19
Blackin,blackmoore,1396,warrior,arms,33,19,14
Arithael,dun-modr,1396,warrior,arms,372,188,184
Скользкийбро,gordunni,1396,warrior,arms,303,152,151
Toxicmade,drakthul,1396,warrior,arms,78,39,39
Farianna,burning-legion,1396,warrior,arms,279,139,140
Grimlyr,twisting-nether,1396,warrior,arms,41,20,21
Èscøbar,dalaran,1396,warrior,arms,63,27,36
Nevergladx,kazzak,1396,warrior,arms,57,23,34
Sàt,kazzak,1395,warrior,arms,40,24,16
ßladex,azshara,1395,warrior,arms,47,27,20
Conanh,pozzo-delleternità,1395,warrior,arms,234,120,114
Mortalgrim,ravencrest,1395,warrior,arms,58,29,29
Xaqt,die-nachtwache,1395,warrior,arms,35,17,18
Psixi,stormscale,1395,warrior,arms,48,20,28
Rapidinhas,aggra-português,1394,warrior,arms,28,17,11
Megatronman,ravencrest,1394,warrior,arms,34,19,15
Bládez,ravencrest,1394,warrior,arms,66,36,30
Кефтеме,fordragon,1394,warrior,arms,219,106,113
Бижек,gordunni,1394,warrior,arms,114,52,62
Dolphini,argent-dawn,1394,warrior,arms,52,23,29
Einherjer,burning-legion,1393,warrior,arms,186,98,88
Royoxo,blackrock,1393,warrior,arms,59,31,28
Icybladez,kazzak,1393,warrior,arms,115,58,57
Thaitouri,eredar,1393,warrior,arms,36,15,21
Golonko,burning-legion,1392,warrior,arms,101,52,49
Mogolaki,twilights-hammer,1392,warrior,arms,172,85,87
Hørror,nemesis,1391,warrior,arms,138,69,69
Алексвайтт,gordunni,1391,warrior,arms,47,23,24
Azdrubal,outland,1391,warrior,arms,36,17,19
Graghz,archimonde,1391,warrior,arms,64,30,34
Äzathoth,silvermoon,1391,warrior,arms,89,38,51
Rázgriz,argent-dawn,1391,warrior,arms,82,35,47
Astven,blackmoore,1391,warrior,arms,46,18,28
Hellrokk,drakthul,1390,warrior,arms,54,29,25
Hemèra,hyjal,1390,warrior,arms,72,36,36
Sidiøøus,hyjal,1390,warrior,arms,152,74,78
Qweoamsd,sylvanas,1390,warrior,arms,42,18,24
Фогивэн,gordunni,1389,warrior,arms,140,73,67
Maraximus,ragnaros,1389,warrior,arms,71,36,35
Equality,ragnaros,1389,warrior,arms,142,70,72
Wanzzeur,hyjal,1389,warrior,arms,150,70,80
Nuijija,stormscale,1389,warrior,arms,90,41,49
Hogu,nemesis,1389,warrior,arms,82,36,46
Rúsher,ragnaros,1388,warrior,arms,60,34,26
Cryonix,drakthul,1388,warrior,arms,87,47,40
Xiszos,ravencrest,1388,warrior,arms,44,21,23
Nabul,thunderhorn,1387,warrior,arms,48,26,22
Birikkin,draenor,1387,warrior,arms,52,28,24
Tankdepalo,sanguino,1387,warrior,arms,30,16,14
Doragon,nemesis,1387,warrior,arms,70,37,33
Нифро,fordragon,1387,warrior,arms,89,45,44
Frézzér,blackrock,1387,warrior,arms,51,22,29
Thomasw,argent-dawn,1387,warrior,arms,84,36,48
Binsaueramk,ravencrest,1387,warrior,arms,48,20,28
Yuriko,onyxia,1386,warrior,arms,77,38,39
Ferpylél,ragnaros,1386,warrior,arms,37,18,19
Folsack,sanguino,1386,warrior,arms,71,33,38
Drekh,kazzak,1386,warrior,arms,48,21,27
Dargonedt,blackrock,1386,warrior,arms,53,22,31
Woximus,ravencrest,1386,warrior,arms,66,27,39
Cárbo,silvermoon,1385,warrior,arms,133,74,59
Oyv,tarren-mill,1385,warrior,arms,36,20,16
Kyösti,defias-brotherhood,1385,warrior,arms,38,21,17
Megtorló,ragnaros,1385,warrior,arms,86,41,45
Баварриор,greymane,1385,warrior,arms,60,27,33
Дикийппц,gordunni,1384,warrior,arms,54,30,24
Diástasi,twisting-nether,1384,warrior,arms,90,48,42
Êlbæjynløl,ambossar,1384,warrior,arms,42,22,20
Алол,gordunni,1383,warrior,arms,35,18,17
Lægend,hyjal,1383,warrior,arms,311,156,155
Éls,argent-dawn,1383,warrior,arms,46,22,24
Осгаард,gordunni,1383,warrior,arms,96,44,52
Андервульф,booty-bay,1383,warrior,arms,59,26,33
Dixo,nathrezim,1382,warrior,arms,36,25,11
Мастхэв,gordunni,1382,warrior,arms,96,49,47
Nøcturnaqq,silvermoon,1382,warrior,arms,102,48,54
Tmp,blackrock,1382,warrior,arms,66,31,35
Gnomop,ravencrest,1382,warrior,arms,66,30,36
Cêlty,aegwynn,1382,warrior,arms,100,41,59
Ærion,die-aldor,1381,warrior,arms,42,23,19
Cutting,burning-legion,1381,warrior,arms,111,54,57
Delvirx,draenor,1381,warrior,arms,84,39,45
Rukkeg,silvermoon,1381,warrior,arms,62,27,35
Faugh,tarren-mill,1380,warrior,arms,54,32,22
Shehalk,stormscale,1380,warrior,arms,63,36,27
Kirus,ravencrest,1380,warrior,arms,93,45,48
Deckluhm,sinstralis,1379,warrior,arms,60,32,28
Brutalz,kazzak,1379,warrior,arms,42,22,20
Glørïn,hyjal,1379,warrior,arms,108,56,52
Adzipotlewap,burning-legion,1379,warrior,arms,108,54,54
Варбаул,soulflayer,1379,warrior,arms,121,58,63
Скрежет,gordunni,1379,warrior,arms,78,33,45
Maidenlless,ravencrest,1378,warrior,arms,322,157,165
Sokarbey,twisting-nether,1377,warrior,arms,58,30,28
Ayelsyssup,silvermoon,1377,warrior,arms,379,192,187
Warrouner,khaz-modan,1377,warrior,arms,151,74,77
Qforína,stormscale,1377,warrior,arms,36,15,21
Madaxe,kazzak,1376,warrior,arms,65,39,26
Xaheld,blackrock,1376,warrior,arms,30,16,14
Espröc,kazzak,1376,warrior,arms,339,172,167
Mograinê,blackmoore,1376,warrior,arms,144,73,71
Craghak,twisting-nether,1376,warrior,arms,231,112,119
Djarenn,defias-brotherhood,1376,warrior,arms,36,16,20
Анманерка,ashenvale,1376,warrior,arms,36,16,20
Telderion,terokkar,1376,warrior,arms,72,30,42
Blackblades,defias-brotherhood,1375,warrior,arms,72,43,29
Temprament,ravencrest,1375,warrior,arms,36,21,15
Ajgreedy,grim-batol,1375,warrior,arms,66,30,36
Farewe,lightbringer,1375,warrior,arms,73,27,46
Zargor,kazzak,1374,warrior,arms,58,35,23
Juoppó,tarren-mill,1374,warrior,arms,192,96,96
Бларк,goldrinn,1374,warrior,arms,84,41,43
Kimboslice,ragnaros,1374,warrior,arms,47,21,26
Cléàvage,silvermoon,1374,warrior,arms,81,32,49
Gritch,ysondre,1373,warrior,arms,81,40,41
Spärtan,dun-modr,1373,warrior,arms,123,58,65
Нунара,eversong,1373,warrior,arms,70,28,42
Executorä,stormscale,1373,warrior,arms,45,15,30
Borga,blackrock,1372,warrior,arms,77,39,38
Агамемнан,soulflayer,1372,warrior,arms,451,227,224
Flawla,blackmoore,1372,warrior,arms,91,39,52
Cucøriedka,burning-blade,1372,warrior,arms,56,17,39
Babb,kazzak,1371,warrior,arms,29,16,13
Lexras,blackhand,1371,warrior,arms,56,27,29
Deathrazór,stormscale,1371,warrior,arms,42,17,25
Морталвлицо,gordunni,1370,warrior,arms,23,15,8
Krøn,stormscale,1370,warrior,arms,52,29,23
Mercedesamg,blackmoore,1370,warrior,arms,56,28,28
Anaxiam,drakthul,1370,warrior,arms,69,33,36
Roykór,auchindoun,1370,warrior,arms,156,71,85
Хьялдэргодр,deathguard,1369,warrior,arms,110,57,53
Arriess,drakthul,1369,warrior,arms,89,45,44
Informatica,doomhammer,1369,warrior,arms,65,31,34
Schwarzkoviç,hyjal,1369,warrior,arms,58,26,32
Lynton,sylvanas,1369,warrior,arms,61,24,37
Infusione,nemesis,1368,warrior,arms,42,30,12
Realz,malganis,1368,warrior,arms,120,68,52
Bdm,sylvanas,1368,warrior,arms,30,15,15
Геленфорд,soulflayer,1368,warrior,arms,60,28,32
Sombrenuit,kaelthas,1368,warrior,arms,39,18,21
Evilrage,ravencrest,1367,warrior,arms,47,30,17
Toby,rexxar,1367,warrior,arms,93,50,43
Zonash,kazzak,1367,warrior,arms,42,20,22
Davari,ravencrest,1367,warrior,arms,39,15,24
Arkcules,ghostlands,1366,warrior,arms,42,21,21
Dasbiest,malorne,1366,warrior,arms,71,35,36
Тибат,howling-fjord,1366,warrior,arms,77,34,43
Погоныч,soulflayer,1365,warrior,arms,71,39,32
Marothul,dun-modr,1365,warrior,arms,36,17,19
Gnarok,archimonde,1364,warrior,arms,145,80,65
Brabüs,kazzak,1364,warrior,arms,114,58,56
Petrixens,drakthul,1364,warrior,arms,78,39,39
Farrusco,nemesis,1364,warrior,arms,190,91,99
Rahaaxhia,kaelthas,1363,warrior,arms,56,33,23
Ragestick,stormscale,1363,warrior,arms,42,20,22
Grandslám,blackrock,1362,warrior,arms,29,15,14
Qiz,silvermoon,1362,warrior,arms,140,71,69
Lomu,bloodscalp,1362,warrior,arms,50,25,25
Anaerion,argent-dawn,1362,warrior,arms,117,57,60
Dreschus,blackrock,1362,warrior,arms,80,37,43
Propanex,kazzak,1361,warrior,arms,42,26,16
Buncljin,draenor,1361,warrior,arms,75,35,40
Vølverinwar,thrall,1361,warrior,arms,82,37,45
Letmeteachya,kazzak,1361,warrior,arms,177,79,98
Тандэр,borean-tundra,1361,warrior,arms,48,21,27
Pyrohand,arthas,1361,warrior,arms,38,16,22
Gärròsh,kazzak,1361,warrior,arms,42,16,26
Kolxoz,doomhammer,1360,warrior,arms,71,35,36
Chisco,kazzak,1360,warrior,arms,71,33,38
Garwarr,twisting-nether,1360,warrior,arms,85,38,47
Авентадорх,deathguard,1360,warrior,arms,147,65,82
Rakwarrior,blackhand,1359,warrior,arms,42,25,17
Mino,theradras,1359,warrior,arms,62,31,31
Shakeef,turalyon,1359,warrior,arms,41,19,22
Pepao,zuljin,1359,warrior,arms,150,67,83
Grahatia,magtheridon,1358,warrior,arms,99,54,45
Staribrko,outland,1358,warrior,arms,366,179,187
Kymari,sanguino,1358,warrior,arms,63,28,35
Onefourthree,silvermoon,1358,warrior,arms,42,17,25
Suksori,kazzak,1358,warrior,arms,67,27,40
Shayarielle,zirkel-des-cenarius,1357,warrior,arms,59,33,26
Zbra,draenor,1357,warrior,arms,71,34,37
Каштоуны,howling-fjord,1357,warrior,arms,48,22,26
Nuclearrage,outland,1357,warrior,arms,77,35,42
Aomen,ravencrest,1356,warrior,arms,39,22,17
Tucomessuelo,cthun,1356,warrior,arms,92,47,45
Spaceløl,archimonde,1356,warrior,arms,42,18,24
Démigodx,stormscale,1356,warrior,arms,70,29,41
Кэфтэмэ,soulflayer,1355,warrior,arms,127,62,65
Raxur,kazzak,1355,warrior,arms,77,37,40
Phantastix,dun-modr,1354,warrior,arms,252,134,118
Adamchen,blackmoore,1354,warrior,arms,67,26,41
Mllmmxxm,kargath,1353,warrior,arms,89,40,49
Grokalus,eredar,1353,warrior,arms,54,23,31
Deviousjr,ragnaros,1352,warrior,arms,88,42,46
Фикпопадешь,lich-king,1352,warrior,arms,111,51,60
Lovkal,twisting-nether,1352,warrior,arms,62,28,34
Idchargethat,ragnaros,1352,warrior,arms,42,18,24
Mladris,outland,1351,warrior,arms,49,24,25
Niouswar,kazzak,1351,warrior,arms,48,21,27
Брозя,gordunni,1350,warrior,arms,48,22,26
Cyrø,blackmoore,1350,warrior,arms,38,17,21
Dimitrow,frostmane,1349,warrior,arms,78,43,35
Steinsteg,antonidas,1349,warrior,arms,75,40,35
Exeqty,the-maelstrom,1349,warrior,arms,36,18,18
Yayoflauta,sanguino,1349,warrior,arms,84,40,44
Neîka,archimonde,1348,warrior,arms,34,17,17
Papipulki,zuljin,1348,warrior,arms,98,42,56
Kröma,hyjal,1347,warrior,arms,30,17,13
Redcloak,outland,1347,warrior,arms,84,41,43
Zarakï,zuljin,1347,warrior,arms,96,43,53
Eseishard,hyjal,1347,warrior,arms,50,22,28
Lupacha,exodar,1346,warrior,arms,101,55,46
Warriornrv,ysondre,1346,warrior,arms,89,48,41
Ральдвин,gordunni,1346,warrior,arms,230,120,110
Kratosgr,defias-brotherhood,1346,warrior,arms,41,21,20
Ordwinz,silvermoon,1346,warrior,arms,155,76,79
Mynutzx,draenor,1346,warrior,arms,72,34,38
Tazkax,archimonde,1346,warrior,arms,64,29,35
Krigarjag,kazzak,1345,warrior,arms,47,27,20
ßzv,veklor,1345,warrior,arms,38,21,17
Bumbx,kazzak,1345,warrior,arms,126,64,62
Luckyfelix,blackmoore,1345,warrior,arms,62,31,31
Axemurdererr,draenor,1345,warrior,arms,94,45,49
Vohnkar,emeriss,1345,warrior,arms,158,70,88
Pummelpete,grim-batol,1344,warrior,arms,24,14,10
Befit,quelthalas,1344,warrior,arms,90,44,46
Давилкагеев,howling-fjord,1344,warrior,arms,109,52,57
Pazl,outland,1344,warrior,arms,36,17,19
Garthro,antonidas,1344,warrior,arms,60,28,32
Raznon,magtheridon,1344,warrior,arms,72,30,42
Rabiolika,sanguino,1343,warrior,arms,29,15,14
Azik,burning-legion,1343,warrior,arms,78,36,42
Rookrage,eredar,1343,warrior,arms,42,19,23
Gorzan,dragonmaw,1343,warrior,arms,95,40,55
Salpaaja,tarren-mill,1343,warrior,arms,36,14,22
Galganiec,burning-legion,1342,warrior,arms,30,20,10
Bàhàmût,anetheron,1342,warrior,arms,35,22,13
Fedevalverde,sanguino,1342,warrior,arms,55,34,21
Reezax,blackrock,1342,warrior,arms,78,43,35
Eekz,haomarush,1342,warrior,arms,48,26,22
Murandin,outland,1342,warrior,arms,71,34,37
Kímó,silvermoon,1342,warrior,arms,77,34,43
Хазгора,howling-fjord,1341,warrior,arms,106,58,48
Ratko,auchindoun,1341,warrior,arms,51,26,25
Donátos,aegwynn,1341,warrior,arms,149,75,74
Stkacha,sanguino,1341,warrior,arms,30,14,16
Akáme,frostwolf,1341,warrior,arms,151,69,82
Radge,hyjal,1340,warrior,arms,112,55,57
Wãrby,ravencrest,1340,warrior,arms,97,47,50
Billorc,twisting-nether,1340,warrior,arms,288,137,151
Tcrujo,uldum,1340,warrior,arms,30,14,16
Kalarar,blackrock,1340,warrior,arms,197,91,106
Pablitø,silvermoon,1340,warrior,arms,36,14,22
Pag,hyjal,1339,warrior,arms,23,15,8
Norganw,die-aldor,1339,warrior,arms,24,14,10
Hoxxywar,drakthul,1339,warrior,arms,59,33,26
Kbeast,kazzak,1339,warrior,arms,64,34,30
Отключатель,howling-fjord,1339,warrior,arms,110,58,52
Kravaiski,argent-dawn,1339,warrior,arms,231,115,116
Onee,terrordar,1339,warrior,arms,136,67,69
Moowar,defias-brotherhood,1339,warrior,arms,129,62,67
Nicperh,dun-modr,1339,warrior,arms,102,48,54
Keriw,kazzak,1339,warrior,arms,30,14,16
Мобсто,soulflayer,1339,warrior,arms,65,30,35
Kundrakiz,kazzak,1339,warrior,arms,108,48,60
Nylseana,turalyon,1339,warrior,arms,60,26,34
Iuska,malganis,1339,warrior,arms,60,25,35
Kazos,twisting-nether,1339,warrior,arms,59,23,36
Acidumcremor,burning-legion,1339,warrior,arms,36,14,22
Yaystorm,stormscale,1338,warrior,arms,24,14,10
Garkathar,draenor,1338,warrior,arms,24,14,10
Uretirips,archimonde,1338,warrior,arms,24,14,10
Анархорок,howling-fjord,1338,warrior,arms,24,14,10
Kimura,archimonde,1338,warrior,arms,30,14,16
Rajä,anubarak,1338,warrior,arms,65,29,36
Шизам,howling-fjord,1338,warrior,arms,77,32,45
Brutalx,twisting-nether,1337,warrior,arms,50,25,25
Nanathiel,laughing-skull,1337,warrior,arms,30,14,16
Hradball,twilights-hammer,1337,warrior,arms,92,42,50
Faløn,archimonde,1337,warrior,arms,125,57,68
Vajira,blackrock,1337,warrior,arms,36,14,22
Antewarrior,kazzak,1336,warrior,arms,24,14,10
Jhoakim,argent-dawn,1336,warrior,arms,24,14,10
Littlebugger,ravencrest,1336,warrior,arms,24,14,10
Neverkind,twisting-nether,1336,warrior,arms,84,47,37
Mëc,twisting-nether,1336,warrior,arms,153,79,74
Инкреасес,soulflayer,1336,warrior,arms,174,86,88
Kastraveci,outland,1336,warrior,arms,54,25,29
Рокэнрольщик,fordragon,1336,warrior,arms,84,36,48
Loliclapper,grim-batol,1335,warrior,arms,74,36,38
Larrydankin,draenor,1335,warrior,arms,190,91,99
Razzimak,eredar,1334,warrior,arms,40,28,12
Bleckwarrior,ravencrest,1334,warrior,arms,157,78,79
Mkazy,kirin-tor,1334,warrior,arms,42,19,23
Madswarrior,tarren-mill,1334,warrior,arms,35,15,20
Iloveit,draenor,1334,warrior,arms,36,14,22
Bjergo,drakthul,1333,warrior,arms,22,15,7
Darkwa,azjolnerub,1333,warrior,arms,35,17,18
Critwar,silvermoon,1333,warrior,arms,54,25,29
Клоузер,blackscar,1333,warrior,arms,53,23,30
Экзекуторх,gordunni,1332,warrior,arms,18,14,4
Fløxswarri,blackmoore,1332,warrior,arms,42,23,19
Derentis,echsenkessel,1332,warrior,arms,219,105,114
Ríta,silvermoon,1332,warrior,arms,90,40,50
Delarosa,drakthul,1332,warrior,arms,42,17,25
Kryszii,ragnaros,1332,warrior,arms,36,14,22
Флэксик,soulflayer,1331,warrior,arms,24,14,10
Foxaz,burning-legion,1331,warrior,arms,72,37,35
Iluwar,ragnaros,1331,warrior,arms,553,271,282
Багрон,goldrinn,1331,warrior,arms,30,14,16
Imaginefun,ragnaros,1331,warrior,arms,48,20,28
Bovingus,tarren-mill,1330,warrior,arms,24,16,8
Сырилисуп,soulflayer,1330,warrior,arms,134,71,63
Газрош,howling-fjord,1330,warrior,arms,82,37,45
Daddie,silvermoon,1330,warrior,arms,69,27,42
Sugmanutz,argent-dawn,1329,warrior,arms,24,14,10
Xanthias,nathrezim,1329,warrior,arms,90,47,43
Adurìn,silvermoon,1329,warrior,arms,101,49,52
Geckoo,emerald-dream,1329,warrior,arms,238,113,125
Batalius,dalaran,1329,warrior,arms,48,21,27
Knôxx,eredar,1329,warrior,arms,57,24,33
Ismellurfeet,ravencrest,1328,warrior,arms,60,34,26
Zzeed,auchindoun,1328,warrior,arms,77,33,44
Haewon,burning-legion,1328,warrior,arms,42,16,26
Ангрол,grom,1327,warrior,arms,77,35,42
Ðrews,kazzak,1326,warrior,arms,24,14,10
Oruka,mannoroth,1326,warrior,arms,88,44,44
Deadchïld,drakthul,1326,warrior,arms,30,14,16
Kosttya,argent-dawn,1326,warrior,arms,95,44,51
Robsuéy,blackmoore,1326,warrior,arms,138,60,78
ßigarms,ravencrest,1325,warrior,arms,24,14,10
Burøxx,doomhammer,1325,warrior,arms,26,14,12
Franzbardon,archimonde,1325,warrior,arms,444,220,224
Fizé,blackmoore,1325,warrior,arms,30,14,16
Khagor,kazzak,1325,warrior,arms,60,23,37
Bxnx,aegwynn,1324,warrior,arms,42,23,19
Mortalik,silvermoon,1324,warrior,arms,166,77,89
Ðalf,sargeras,1324,warrior,arms,33,15,18
Kløyva,ravencrest,1323,warrior,arms,24,14,10
Кунгфурик,soulflayer,1323,warrior,arms,60,31,29
Highz,grim-batol,1323,warrior,arms,48,24,24
Shanai,silvermoon,1323,warrior,arms,41,17,24
Urbanturban,tarren-mill,1323,warrior,arms,46,19,27
Zøom,ysondre,1322,warrior,arms,160,84,76
Varrig,silvermoon,1321,warrior,arms,192,95,97
Medborgerlig,twisting-nether,1321,warrior,arms,60,27,33
Ashiku,zuljin,1321,warrior,arms,54,23,31
Lobsters,emeriss,1321,warrior,arms,41,16,25
Braìnwashed,eredar,1320,warrior,arms,36,21,15
Deicamus,tyrande,1320,warrior,arms,59,31,28
Throck,drakthul,1320,warrior,arms,41,18,23
Gacel,dun-modr,1320,warrior,arms,65,28,37
Dewclaw,stormscale,1320,warrior,arms,36,14,22
Domineon,mannoroth,1319,warrior,arms,31,15,16
Кассаб,soulflayer,1319,warrior,arms,30,14,16
Warrmax,darksorrow,1319,warrior,arms,87,40,47
Keshâr,blackhand,1319,warrior,arms,66,30,36
Tozz,azuremyst,1318,warrior,arms,60,34,26
Atälànte,ysondre,1318,warrior,arms,149,76,73
Cabzout,archimonde,1318,warrior,arms,36,14,22
Vikktor,doomhammer,1318,warrior,arms,42,14,28
Ragnacore,ravencrest,1317,warrior,arms,131,69,62
Martøswarr,uldum,1317,warrior,arms,30,14,16
Skyut,archimonde,1317,warrior,arms,72,33,39
Grimhew,argent-dawn,1317,warrior,arms,42,17,25
Zuuk,malganis,1317,warrior,arms,36,14,22
Vasabi,anetheron,1316,warrior,arms,54,28,26
Zhenshii,blackmoore,1316,warrior,arms,42,21,21
Yotanwa,aegwynn,1316,warrior,arms,42,20,22
Bønecleaver,blackrock,1316,warrior,arms,30,14,16
Zcratch,silvermoon,1316,warrior,arms,58,27,31
Matchoo,archimonde,1316,warrior,arms,80,36,44
Xanatos,khazgoroth,1316,warrior,arms,69,24,45
Rayguerrero,blackrock,1316,warrior,arms,64,22,42
Tozzabancøne,nemesis,1315,warrior,arms,30,16,14
Iljaana,blackrock,1315,warrior,arms,102,49,53
Mikylothar,kazzak,1315,warrior,arms,36,16,20
Pahgorim,blackhand,1315,warrior,arms,60,26,34
Vymd,archimonde,1315,warrior,arms,76,31,45
Atlantia,ravencrest,1315,warrior,arms,48,17,31
Ràgnarok,chogall,1314,warrior,arms,72,39,33
Reichas,ragnaros,1314,warrior,arms,92,48,44
Buyya,ravencrest,1314,warrior,arms,64,33,31
Qvate,twisting-nether,1314,warrior,arms,77,36,41
Kmica,khadgar,1314,warrior,arms,61,27,34
Elénir,dalaran,1313,warrior,arms,36,20,16
Lácrima,dun-modr,1313,warrior,arms,36,18,18
Gorchak,blackmoore,1313,warrior,arms,254,123,131
Minoke,antonidas,1313,warrior,arms,60,28,32
Yaggurtz,archimonde,1313,warrior,arms,42,19,23
Bigdbigarms,tarren-mill,1312,warrior,arms,24,14,10
Уравниттель,gordunni,1312,warrior,arms,114,62,52
Doxinator,silvermoon,1312,warrior,arms,105,42,63
Клайминг,soulflayer,1311,warrior,arms,83,50,33
Cogne,illidan,1311,warrior,arms,24,14,10
Кентаныч,howling-fjord,1311,warrior,arms,56,28,28
Оморальный,soulflayer,1311,warrior,arms,88,39,49
Nings,rashgarroth,1310,warrior,arms,88,44,44
Titanioa,draenor,1310,warrior,arms,60,27,33
Artheim,silvermoon,1310,warrior,arms,60,24,36
Lanahan,argent-dawn,1309,warrior,arms,23,14,9
Ninebites,chamber-of-aspects,1309,warrior,arms,143,73,70
Kaliroll,ysondre,1309,warrior,arms,134,65,69
Übelzord,thrall,1309,warrior,arms,307,145,162
Ruzbie,silvermoon,1309,warrior,arms,36,15,21
Sinbuay,malygos,1309,warrior,arms,48,19,29
Varmok,draenor,1309,warrior,arms,42,14,28
Дейниксис,howling-fjord,1308,warrior,arms,30,14,16
Vectus,zuljin,1308,warrior,arms,30,14,16
Barathor,kult-der-verdammten,1308,warrior,arms,38,17,21
Zappstorm,frostwolf,1307,warrior,arms,58,32,26
Колятурбо,gordunni,1307,warrior,arms,49,26,23
Lågærtha,blackmoore,1307,warrior,arms,65,33,32
Tontonsmoky,hyjal,1307,warrior,arms,142,67,75
Humanoç,dun-modr,1307,warrior,arms,36,16,20
Dodgeslam,eredar,1307,warrior,arms,88,39,49
Byorr,marécage-de-zangar,1307,warrior,arms,42,17,25
Warbringer,burning-blade,1306,warrior,arms,87,34,53
Bøgatyr,draenor,1305,warrior,arms,29,14,15
Lûckystríké,blackmoore,1305,warrior,arms,52,25,27
Steelian,kazzak,1305,warrior,arms,41,18,23
Avïlîa,dalaran,1305,warrior,arms,42,15,27
Mozeratz,magtheridon,1304,warrior,arms,28,14,14
Манхув,gordunni,1304,warrior,arms,30,14,16
Матумбо,gordunni,1304,warrior,arms,121,56,65
Puurplecloud,kazzak,1304,warrior,arms,96,42,54
Вениамин,deathweaver,1304,warrior,arms,137,59,78
Roctah,auchindoun,1303,warrior,arms,52,26,26
Nocton,blackhand,1303,warrior,arms,96,44,52
Alaë,archimonde,1303,warrior,arms,79,33,46
Friedhard,aegwynn,1302,warrior,arms,94,52,42
Ankzz,archimonde,1302,warrior,arms,84,45,39
Shãne,ysondre,1302,warrior,arms,52,27,25
Taylorswifty,twisting-nether,1302,warrior,arms,130,66,64
Brokenqt,ravencrest,1302,warrior,arms,67,34,33
Zosska,burning-legion,1302,warrior,arms,81,36,45
Halsandre,hyjal,1302,warrior,arms,72,29,43
Bossít,doomhammer,1301,warrior,arms,80,44,36
Nakkelam,twisting-nether,1300,warrior,arms,36,21,15
Draleckx,sanguino,1300,warrior,arms,362,181,181
Katxirulo,tyrande,1300,warrior,arms,72,34,38
Bjornska,defias-brotherhood,1300,warrior,arms,42,18,24
Ðræms,eldrethalas,1299,warrior,arms,104,51,53
Nobelisarius,norgannon,1298,warrior,arms,82,45,37
Slamona,ravencrest,1298,warrior,arms,29,15,14
Brondir,archimonde,1298,warrior,arms,41,21,20
Anubisra,alakir,1298,warrior,arms,49,24,25
Banshor,ysondre,1298,warrior,arms,44,19,25
Ferrum,sunstrider,1297,warrior,arms,36,19,17
Cbahorde,outland,1297,warrior,arms,128,62,66
Bellator,arakarahm,1297,warrior,arms,113,52,61
Knussnacker,sanguino,1297,warrior,arms,181,82,99
Pitii,burning-legion,1297,warrior,arms,38,16,22
Henzelhoff,stormreaver,1296,warrior,arms,52,31,21
Slapface,blackmoore,1296,warrior,arms,50,28,22
Mågne,tarren-mill,1296,warrior,arms,138,68,70
Bämoida,eredar,1296,warrior,arms,58,26,32
Армсец,howling-fjord,1296,warrior,arms,42,16,26
Seliasbro,kazzak,1295,warrior,arms,30,15,15
Caíne,drakthul,1295,warrior,arms,157,78,79
Fargon,ravencrest,1295,warrior,arms,153,71,82
Imotekh,eredar,1295,warrior,arms,34,15,19
Ramlosa,stormscale,1295,warrior,arms,40,17,23
Addy,twisting-nether,1294,warrior,arms,30,15,15
Zuchtrind,blackrock,1293,warrior,arms,60,34,26
Tchral,burning-legion,1293,warrior,arms,30,14,16
Wtchmyblades,blackmoore,1292,warrior,arms,29,14,15
Tikej,silvermoon,1292,warrior,arms,58,26,32
Mölntuss,emeriss,1292,warrior,arms,41,14,27
Bulwrak,eredar,1291,warrior,arms,269,132,137
Zeroskllz,outland,1291,warrior,arms,76,36,40
Jkarus,die-ewige-wacht,1291,warrior,arms,89,42,47
Zyn,outland,1291,warrior,arms,54,25,29
Inelegant,tarren-mill,1290,warrior,arms,60,32,28
Mödhan,archimonde,1290,warrior,arms,123,61,62
Ghorglukk,lightnings-blade,1290,warrior,arms,60,28,32
Garganelli,tarren-mill,1290,warrior,arms,68,30,38
Elyrax,dun-modr,1290,warrior,arms,36,15,21
Zøllka,dalaran,1290,warrior,arms,130,53,77
Gaarrossh,kazzak,1290,warrior,arms,41,14,27
Rådne,argent-dawn,1289,warrior,arms,42,21,21
Geraltf,tarren-mill,1289,warrior,arms,203,97,106
Purjon,twilights-hammer,1289,warrior,arms,109,50,59
Tenramar,silvermoon,1289,warrior,arms,36,15,21
Степанычь,gordunni,1288,warrior,arms,41,22,19
Dwarphex,outland,1288,warrior,arms,48,25,23
Vexxenn,outland,1288,warrior,arms,36,16,20
Nellyqt,draenor,1288,warrior,arms,58,23,35
Dutteh,tarren-mill,1287,warrior,arms,42,23,19
Jasperr,nemesis,1287,warrior,arms,133,70,63
Arouga,blackrock,1287,warrior,arms,27,14,13
Mfull,tarren-mill,1287,warrior,arms,72,35,37
Tsu,karazhan,1287,warrior,arms,63,29,34
Deeper,twisting-nether,1287,warrior,arms,48,22,26
Kronstris,veklor,1287,warrior,arms,66,29,37
Perkoulator,archimonde,1286,warrior,arms,269,130,139
Vegäpunk,nemesis,1286,warrior,arms,60,28,32
Gantór,blackrock,1286,warrior,arms,54,23,31
Slam,blackrock,1285,warrior,arms,42,14,28
Tumuerte,dun-modr,1284,warrior,arms,79,45,34
Cromix,blackrock,1283,warrior,arms,95,53,42
Torpus,outland,1283,warrior,arms,78,42,36
Unarde,silvermoon,1283,warrior,arms,257,128,129
Vorns,silvermoon,1283,warrior,arms,40,19,21
Tíabeanie,silvermoon,1283,warrior,arms,30,14,16
Leonidæs,frostwolf,1283,warrior,arms,105,48,57
Sertigan,dun-modr,1283,warrior,arms,130,57,73
Dreadstyle,burning-legion,1282,warrior,arms,65,36,29
Sigmundsdotr,outland,1282,warrior,arms,90,46,44
Hatethisgame,frostwolf,1282,warrior,arms,93,42,51
Phovoss,stormscale,1282,warrior,arms,106,44,62
Màgh,ravencrest,1282,warrior,arms,42,14,28
Ènteqt,antonidas,1281,warrior,arms,99,52,47
Buttslaper,burning-legion,1280,warrior,arms,35,19,16
Дрейсен,gordunni,1280,warrior,arms,52,26,26
Mixiko,khadgar,1280,warrior,arms,53,25,28
Гогрикк,ashenvale,1279,warrior,arms,72,35,37
Malevolént,silvermoon,1279,warrior,arms,84,40,44
Ludjack,tarren-mill,1279,warrior,arms,63,29,34
Grolbein,blackhand,1278,warrior,arms,89,42,47
Izestyi,blackrock,1278,warrior,arms,125,58,67
Klanky,draenor,1277,warrior,arms,86,41,45
Sfarpi,burning-legion,1276,warrior,arms,108,60,48
Wolfgladius,cthun,1276,warrior,arms,48,22,26
Narkololzz,marécage-de-zangar,1276,warrior,arms,91,41,50
Боадрог,soulflayer,1276,warrior,arms,54,22,32
Тысячидуш,gordunni,1275,warrior,arms,78,38,40
Kultigin,ravencrest,1275,warrior,arms,122,53,69
Aggamemnus,ravencrest,1274,warrior,arms,74,42,32
Loreven,silvermoon,1274,warrior,arms,29,14,15
Vazzle,nethersturm,1274,warrior,arms,72,26,46
Pegazón,outland,1273,warrior,arms,120,57,63
Neekero,burning-legion,1273,warrior,arms,116,54,62
Optitt,dethecus,1273,warrior,arms,59,26,33
Fàlconry,kazzak,1273,warrior,arms,140,60,80
Luunk,ravencrest,1272,warrior,arms,132,71,61
Asmongnome,ravencrest,1272,warrior,arms,63,32,31
Bonesz,jaedenar,1272,warrior,arms,225,111,114
Акумираг,soulflayer,1272,warrior,arms,108,43,65
Narox,arathor,1271,warrior,arms,74,36,38
Сигберт,gordunni,1271,warrior,arms,42,19,23
Hofftor,eredar,1270,warrior,arms,61,32,29
Protecc,burning-legion,1270,warrior,arms,174,86,88
Sayaká,twisting-nether,1270,warrior,arms,34,14,20
Olesbawro,ragnaros,1270,warrior,arms,108,43,65
Jujuwa,tarren-mill,1270,warrior,arms,83,32,51
Thorkell,genjuros,1269,warrior,arms,95,52,43
Rhonack,ragnaros,1269,warrior,arms,68,32,36
Джондо,gordunni,1269,warrior,arms,30,14,16
Sphínxx,malfurion,1269,warrior,arms,44,20,24
Zarolk,rashgarroth,1269,warrior,arms,84,38,46
Warriotrix,tarren-mill,1269,warrior,arms,43,18,25
Lamme,darksorrow,1268,warrior,arms,31,16,15
Crotoss,ravencrest,1268,warrior,arms,89,45,44
Weedo,ragnaros,1268,warrior,arms,36,18,18
Tyëlin,elune,1268,warrior,arms,137,63,74
Kriegerlutz,blackmoore,1268,warrior,arms,35,15,20
Atelier,magtheridon,1267,warrior,arms,90,52,38
Skullcrasher,draenor,1267,warrior,arms,60,29,31
Misiaczek,the-maelstrom,1267,warrior,arms,53,23,30
Kriticah,sanguino,1267,warrior,arms,104,44,60
Âdept,tarren-mill,1267,warrior,arms,84,33,51
Garodis,blackmoore,1267,warrior,arms,36,14,22
Funknîco,wrathbringer,1266,warrior,arms,55,29,26
Plt,talnivarr,1265,warrior,arms,76,44,32
Oneshót,norgannon,1265,warrior,arms,162,80,82
Malalulu,burning-legion,1265,warrior,arms,288,140,148
Swifty,bronzebeard,1265,warrior,arms,30,14,16
Aliasus,outland,1264,warrior,arms,36,16,20
Aiarm,twisting-nether,1263,warrior,arms,222,117,105
Утонаган,fordragon,1263,warrior,arms,60,28,32
Gealt,outland,1263,warrior,arms,71,29,42
Morrzerk,sylvanas,1262,warrior,arms,53,29,24
Abnôrmus,tarren-mill,1262,warrior,arms,48,25,23
Trundledaddy,silvermoon,1262,warrior,arms,29,14,15
Братишкаа,gordunni,1262,warrior,arms,65,28,37
Аранья,howling-fjord,1262,warrior,arms,40,15,25
Gintonnic,sanguino,1261,warrior,arms,48,22,26
Leyshan,archimonde,1260,warrior,arms,94,39,55
Téldrus,blackrock,1260,warrior,arms,54,22,32
Дэйст,ashenvale,1259,warrior,arms,60,31,29
Hellevorn,hyjal,1259,warrior,arms,59,30,29
Metawar,blackhand,1259,warrior,arms,60,26,34
Kirsche,blackrock,1258,warrior,arms,72,41,31
Соловейч,howling-fjord,1258,warrior,arms,36,20,16
Bolski,ravencrest,1258,warrior,arms,81,42,39
Kíngsafa,rexxar,1258,warrior,arms,36,15,21
Tarau,archimonde,1258,warrior,arms,39,16,23
Pawn,twisting-nether,1258,warrior,arms,42,17,25
Донткарлеон,howling-fjord,1258,warrior,arms,53,18,35
Shengu,kazzak,1257,warrior,arms,78,46,32
Дедсдрыном,howling-fjord,1257,warrior,arms,65,31,34
Serbo,stormscale,1257,warrior,arms,42,19,23
Himarshal,kazzak,1257,warrior,arms,79,32,47
Hurricane,sylvanas,1257,warrior,arms,42,15,27
Balyndâ,aegwynn,1256,warrior,arms,44,25,19
Wyshh,silvermoon,1256,warrior,arms,195,98,97
Thisguyfax,the-venture-co,1256,warrior,arms,111,55,56
Gigac,ragnaros,1256,warrior,arms,78,38,40
Рейнджровер,howling-fjord,1256,warrior,arms,94,43,51
Delenia,twisting-nether,1255,warrior,arms,118,60,58
Silabozija,ravencrest,1255,warrior,arms,88,43,45
Joewahl,ragnaros,1255,warrior,arms,112,47,65
Zalhym,archimonde,1254,warrior,arms,157,75,82
Buntstift,thrall,1254,warrior,arms,42,14,28
Lûxn,ragnaros,1253,warrior,arms,223,112,111
Блэйзерх,gordunni,1253,warrior,arms,43,14,29
Lëime,ravencrest,1252,warrior,arms,84,42,42
Bluntsword,twisting-nether,1252,warrior,arms,65,30,35
Roimyv,archimonde,1252,warrior,arms,42,14,28
Azëlls,archimonde,1251,warrior,arms,144,74,70
Vurra,zuljin,1251,warrior,arms,62,31,31
Gids,silvermoon,1251,warrior,arms,36,17,19
Taikyokuken,hyjal,1251,warrior,arms,96,43,53
Luffydono,stormscale,1251,warrior,arms,160,71,89
Ironstep,silvermoon,1250,warrior,arms,42,27,15
Dicaprios,silvermoon,1250,warrior,arms,72,36,36
Кимиюки,gordunni,1250,warrior,arms,110,53,57
Фоссбро,gordunni,1250,warrior,arms,129,59,70
Shihoh,blackhand,1250,warrior,arms,171,75,96
Contrariety,ravencrest,1249,warrior,arms,89,47,42
Tidrick,argent-dawn,1249,warrior,arms,36,17,19
Nårgaí,kargath,1249,warrior,arms,124,58,66
Màndø,archimonde,1249,warrior,arms,96,38,58
Зуботычник,gordunni,1248,warrior,arms,30,17,13
Behemothwr,kazzak,1248,warrior,arms,141,67,74
Brandylover,outland,1248,warrior,arms,32,15,17
Cárlsberg,pozzo-delleternità,1248,warrior,arms,81,36,45
Sabøtage,aggra-português,1248,warrior,arms,42,16,26
Горячийогонь,soulflayer,1248,warrior,arms,57,20,37
Кориалвар,gordunni,1247,warrior,arms,24,14,10
Regulators,outland,1247,warrior,arms,26,14,12
Kailyy,kazzak,1247,warrior,arms,27,14,13
Xaah,dun-modr,1247,warrior,arms,62,31,31
Empero,draenor,1247,warrior,arms,30,15,15
Romzz,malganis,1247,warrior,arms,96,46,50
Hellthõr,silvermoon,1247,warrior,arms,78,37,41
Jisoowar,blackhand,1247,warrior,arms,60,27,33
Daymio,twisting-nether,1247,warrior,arms,30,13,17
Kásúxøxøw,ravencrest,1247,warrior,arms,30,13,17
Ваншотч,blackscar,1247,warrior,arms,36,13,23
Perry,proudmoore,1246,warrior,arms,24,14,10
Hønks,antonidas,1246,warrior,arms,24,13,11
Algazarra,aggra-português,1246,warrior,arms,78,42,36
Kardinell,blackhand,1246,warrior,arms,66,30,36
Tehmountain,ravencrest,1246,warrior,arms,30,13,17
Sponkss,tarren-mill,1246,warrior,arms,30,13,17
Shará,eredar,1246,warrior,arms,114,49,65
Xiphiatwo,ravencrest,1246,warrior,arms,36,13,23
Epyøn,stormscale,1245,warrior,arms,21,13,8
Teraa,the-maelstrom,1245,warrior,arms,82,50,32
Atus,dun-modr,1245,warrior,arms,77,38,39
Sixteen,darkmoon-faire,1245,warrior,arms,156,74,82
Woosaah,ravencrest,1245,warrior,arms,34,16,18
Grinrok,thrall,1245,warrior,arms,78,36,42
Viridas,stormscale,1245,warrior,arms,176,77,99
Брокксигарр,borean-tundra,1245,warrior,arms,47,19,28
Ken,twisting-nether,1245,warrior,arms,46,14,32
Tragomorfos,ravencrest,1244,warrior,arms,24,13,11
Themeec,silvermoon,1244,warrior,arms,24,13,11
Addicty,sylvanas,1244,warrior,arms,341,175,166
Zeldaixi,twisting-nether,1244,warrior,arms,46,23,23
Weezing,argent-dawn,1244,warrior,arms,48,18,30
Gotural,ravencrest,1243,warrior,arms,18,13,5
Rhazeél,blackrock,1243,warrior,arms,18,13,5
Zeryyo,blackrock,1243,warrior,arms,24,13,11
Arkalolz,hyjal,1243,warrior,arms,24,13,11
Kiriwarr,dun-modr,1243,warrior,arms,24,13,11
Zaerna,draenor,1243,warrior,arms,24,13,11
Dianâ,der-abyssische-rat,1243,warrior,arms,47,25,22
Xunaakt,nemesis,1243,warrior,arms,81,39,42
Rocktastic,blackrock,1243,warrior,arms,41,16,25
Soundso,blackmoore,1242,warrior,arms,26,15,11
Smeshh,burning-legion,1242,warrior,arms,90,51,39
Narcx,kazzak,1242,warrior,arms,24,13,11
Oldhatreds,twisting-nether,1242,warrior,arms,52,25,27
Átlás,blackmoore,1242,warrior,arms,43,19,24
Тарартзу,soulflayer,1241,warrior,arms,24,13,11
Notvisionary,ravencrest,1241,warrior,arms,24,13,11
Dréck,aegwynn,1241,warrior,arms,101,45,56
Ivailowar,ravencrest,1241,warrior,arms,78,34,44
Фуджитаку,gordunni,1240,warrior,arms,48,13,35
Ragedotcom,archimonde,1239,warrior,arms,42,25,17
Hedral,hyjal,1239,warrior,arms,24,13,11
Recklessness,drakthul,1239,warrior,arms,24,13,11
Issatank,frostmane,1239,warrior,arms,132,64,68
Arnnau,dun-modr,1239,warrior,arms,30,14,16
Nixtor,defias-brotherhood,1239,warrior,arms,126,58,68
Vagor,aegwynn,1239,warrior,arms,114,52,62
Ironballs,saurfang,1239,warrior,arms,30,13,17
Ayawa,silvermoon,1239,warrior,arms,42,16,26
Ghettogødx,outland,1239,warrior,arms,36,13,23
Pulx,dun-modr,1239,warrior,arms,42,13,29
Àke,darksorrow,1238,warrior,arms,89,49,40
Chargekanta,antonidas,1238,warrior,arms,24,13,11
Khalghara,dun-modr,1238,warrior,arms,48,19,29
Jésusiskíng,amanthul,1237,warrior,arms,24,13,11
Rorix,blackrock,1237,warrior,arms,24,13,11
Semanor,aegwynn,1237,warrior,arms,48,22,26
Tinker,crushridge,1237,warrior,arms,30,13,17
Tahzwolf,stormscale,1236,warrior,arms,18,13,5
Fractale,kirin-tor,1236,warrior,arms,22,14,8
Данилатитич,howling-fjord,1236,warrior,arms,107,53,54
Казгримм,howling-fjord,1236,warrior,arms,98,42,56
Smackaroon,draenor,1235,warrior,arms,24,13,11
Эсвексия,gordunni,1234,warrior,arms,24,14,10
Earshy,ragnaros,1234,warrior,arms,24,13,11
Сэмвариор,gordunni,1234,warrior,arms,24,13,11
Exot,eredar,1234,warrior,arms,84,43,41
Pacosky,burning-legion,1234,warrior,arms,63,30,33
Mòrdréd,kazzak,1234,warrior,arms,51,23,28
Sentenzah,arakarahm,1234,warrior,arms,48,19,29
Imorphius,silvermoon,1234,warrior,arms,36,13,23
Fullkraft,tarren-mill,1233,warrior,arms,110,59,51
Nøøbisator,archimonde,1233,warrior,arms,103,55,48
Allmight,gorgonnash,1233,warrior,arms,42,13,29
Kloppnîx,blackmoore,1232,warrior,arms,80,44,36
Soulcleaver,stormreaver,1232,warrior,arms,118,59,59
Shtormguard,ravencrest,1232,warrior,arms,48,20,28
Сифончик,ashenvale,1232,warrior,arms,63,26,37
Gladiatoor,terenas,1232,warrior,arms,36,13,23
Nezriq,neptulon,1231,warrior,arms,24,13,11
Kaydren,durotan,1231,warrior,arms,24,13,11
Prs,defias-brotherhood,1231,warrior,arms,48,25,23
Rochful,frostwolf,1231,warrior,arms,80,41,39
Orquewarrior,stormscale,1231,warrior,arms,137,61,76
Goragthor,thrall,1230,warrior,arms,36,19,17
Arinator,les-sentinelles,1230,warrior,arms,105,46,59
Waegon,twisting-nether,1230,warrior,arms,30,13,17
Orcanism,nozdormu,1229,warrior,arms,117,62,55
Cramatao,shadowsong,1229,warrior,arms,59,25,34
Dautis,dun-modr,1228,warrior,arms,33,17,16
Thehans,grim-batol,1228,warrior,arms,44,18,26
Рагнарг,goldrinn,1227,warrior,arms,84,46,38
Gunga,ravenholdt,1227,warrior,arms,24,13,11
Furius,zuljin,1227,warrior,arms,41,20,21
Elendurel,outland,1226,warrior,arms,94,49,45
Diggawhat,antonidas,1226,warrior,arms,267,129,138
Cyniczny,draenor,1226,warrior,arms,45,21,24
Leàn,nemesis,1226,warrior,arms,36,13,23
Бруталдэз,deathguard,1226,warrior,arms,50,16,34
Lögösh,la-croisade-écarlate,1225,warrior,arms,24,13,11
Prater,draenor,1225,warrior,arms,35,18,17
Regna,eredar,1225,warrior,arms,132,65,67
Синнэр,blackscar,1225,warrior,arms,36,13,23
Aylîx,dun-modr,1224,warrior,arms,36,21,15
Бардеон,gordunni,1224,warrior,arms,30,13,17
Sephirotth,burning-legion,1224,warrior,arms,30,13,17
Fidélgastro,ysondre,1224,warrior,arms,61,25,36
Synthasixx,twisting-nether,1224,warrior,arms,54,20,34
Raggnnar,blackrock,1223,warrior,arms,55,28,27
Ishíì,twisting-nether,1223,warrior,arms,77,35,42
Erayu,outland,1223,warrior,arms,30,13,17
Johnston,frostmane,1223,warrior,arms,36,13,23
Demonraze,hyjal,1222,warrior,arms,42,27,15
Kaazzuraa,hyjal,1222,warrior,arms,66,38,28
Solaría,garona,1222,warrior,arms,30,15,15
Energo,drakthul,1222,warrior,arms,36,17,19
Evvii,terenas,1222,warrior,arms,30,13,17
Gorrashar,drakthul,1222,warrior,arms,42,17,25
Cecill,silvermoon,1221,warrior,arms,132,70,62
Kaidewarr,kazzak,1221,warrior,arms,84,44,40
Jhonnybiceps,kazzak,1221,warrior,arms,147,69,78
Blaackbeard,blackmoore,1221,warrior,arms,48,22,26
Gorok,culte-de-la-rive-noire,1221,warrior,arms,33,15,18
Gachiwarri,blackhand,1221,warrior,arms,30,13,17
Gèrralt,hyjal,1221,warrior,arms,41,16,25
Bigtulipe,archimonde,1220,warrior,arms,71,36,35
Vandras,hyjal,1220,warrior,arms,65,29,36
Brubaker,hyjal,1220,warrior,arms,30,13,17
Boomxi,burning-legion,1220,warrior,arms,47,17,30
Shäshken,archimonde,1220,warrior,arms,102,28,74
Ðamokles,silvermoon,1219,warrior,arms,73,36,37
Диодемма,gordunni,1219,warrior,arms,84,38,46
Moshpít,antonidas,1219,warrior,arms,36,13,23
Hellspin,argent-dawn,1218,warrior,arms,145,66,79
Tyragon,thrall,1217,warrior,arms,120,61,59
Goroth,vashj,1217,warrior,arms,36,14,22
Kerisandra,silvermoon,1216,warrior,arms,49,29,20
Slaughteredd,kazzak,1216,warrior,arms,108,48,60
Ozok,blackrock,1216,warrior,arms,30,13,17
Gromlogosh,stormscale,1216,warrior,arms,30,13,17
Maggisauce,aegwynn,1215,warrior,arms,112,60,52
Ghostwarx,blackmoore,1215,warrior,arms,38,19,19
Sistabossen,magtheridon,1215,warrior,arms,30,15,15
Вардроу,howling-fjord,1215,warrior,arms,60,28,32
Crocbait,ravencrest,1214,warrior,arms,42,22,20
Rogirb,drakthul,1214,warrior,arms,42,21,21
Раздолбатель,razuvious,1214,warrior,arms,87,41,46
Вилькария,eversong,1214,warrior,arms,34,15,19
Batourga,marécage-de-zangar,1214,warrior,arms,57,22,35
Varrhok,tarren-mill,1214,warrior,arms,36,13,23
Twinblyat,defias-brotherhood,1213,warrior,arms,36,15,21
Tomsom,sanguino,1213,warrior,arms,35,13,22
Bullburzt,ragnaros,1212,warrior,arms,35,15,20
Watsabe,kazzak,1212,warrior,arms,93,36,57
Атон,gordunni,1211,warrior,arms,224,109,115
Zool,madmortem,1211,warrior,arms,272,132,140
Monifes,kazzak,1211,warrior,arms,36,16,20
Лэркус,howling-fjord,1211,warrior,arms,30,13,17
Nonescape,twisting-nether,1211,warrior,arms,93,39,54
Gelforn,argent-dawn,1210,warrior,arms,24,13,11
Wargasm,burning-blade,1210,warrior,arms,58,31,27
Tommia,burning-legion,1210,warrior,arms,60,29,31
Tazdingowar,antonidas,1210,warrior,arms,94,38,56
Methaniwths,twisting-nether,1209,warrior,arms,156,77,79
Gilettepenge,draenor,1209,warrior,arms,233,115,118
Jimbock,eredar,1209,warrior,arms,38,15,23
Жлобьен,howling-fjord,1209,warrior,arms,36,13,23
Zellóx,stormscale,1208,warrior,arms,23,13,10
Lyarinsky,tyrande,1208,warrior,arms,118,65,53
Jaru,alleria,1208,warrior,arms,69,35,34
Lukkass,ravencrest,1208,warrior,arms,33,14,19
Iarsonn,drakthul,1208,warrior,arms,54,21,33
Dardi,blackrock,1206,warrior,arms,36,17,19
Kâine,blackmoore,1206,warrior,arms,134,62,72
Hoggle,runetotem,1205,warrior,arms,94,54,40
Yayoqt,sylvanas,1205,warrior,arms,136,67,69
Upholder,xavius,1205,warrior,arms,35,17,18
Mysteryman,defias-brotherhood,1205,warrior,arms,142,68,74
Valus,earthen-ring,1205,warrior,arms,30,14,16
Оверфлок,howling-fjord,1205,warrior,arms,30,13,17
Маллал,soulflayer,1204,warrior,arms,126,57,69
Astrid,rajaxx,1203,warrior,arms,57,28,29
Kallor,burning-legion,1203,warrior,arms,93,45,48
Whimbux,stormscale,1203,warrior,arms,86,38,48
Totalterror,ragnaros,1203,warrior,arms,72,31,41
Vrokoda,quelthalas,1203,warrior,arms,36,14,22
Мегаяйца,gordunni,1203,warrior,arms,41,13,28
Excutíé,twisting-nether,1202,warrior,arms,30,18,12
Fluxerella,azjolnerub,1202,warrior,arms,24,13,11
Lezúziuszh,ragnaros,1202,warrior,arms,44,21,23
Wardam,terokkar,1202,warrior,arms,30,13,17
Lurádin,kargath,1202,warrior,arms,42,18,24
Williamx,archimonde,1202,warrior,arms,60,24,36
Kekwd,burning-legion,1202,warrior,arms,36,13,23
Enemywarrior,argent-dawn,1201,warrior,arms,94,51,43
Крахгал,soulflayer,1201,warrior,arms,159,80,79
Pillorrior,ambossar,1201,warrior,arms,30,13,17
Тассэй,eversong,1201,warrior,arms,112,48,64
Tempii,ragnaros,1201,warrior,arms,42,14,28
Saitäma,burning-legion,1200,warrior,arms,24,14,10
Krigsdunken,draenor,1200,warrior,arms,99,44,55
Onyi,onyxia,1200,warrior,arms,36,13,23
Thylegorn,argent-dawn,1199,warrior,arms,25,16,9
Caraquru,silvermoon,1199,warrior,arms,48,29,19
Aloia,stormscale,1199,warrior,arms,57,26,31
Ärama,sanguino,1198,warrior,arms,48,26,22
Animaul,dalaran,1198,warrior,arms,42,20,22
Matrafox,stormscale,1198,warrior,arms,141,66,75
Drbanner,hyjal,1198,warrior,arms,86,40,46
Rayeron,sanguino,1198,warrior,arms,39,16,23
Gnuhl,eredar,1197,warrior,arms,41,21,20
Mozterwar,ravencrest,1197,warrior,arms,66,28,38
Mifuune,argent-dawn,1196,warrior,arms,56,28,28
Välkyries,archimonde,1195,warrior,arms,63,36,27
Ферхар,galakrond,1195,warrior,arms,36,20,16
Nøiir,malfurion,1195,warrior,arms,36,18,18
Nightwatchs,outland,1195,warrior,arms,102,49,53
Mellvorr,malganis,1195,warrior,arms,95,32,63
Nukefun,blackrock,1194,warrior,arms,28,15,13
Berserkpwnz,silvermoon,1194,warrior,arms,60,32,28
Beans,argent-dawn,1194,warrior,arms,127,55,72
Madsizen,ravencrest,1194,warrior,arms,36,14,22
Rèâpèr,kazzak,1193,warrior,arms,42,27,15
Лысыч,gordunni,1193,warrior,arms,35,18,17
Vojownik,argent-dawn,1193,warrior,arms,72,31,41
Argadea,archimonde,1192,warrior,arms,129,65,64
Donetenk,silvermoon,1192,warrior,arms,101,48,53
Холипротовар,fordragon,1192,warrior,arms,118,56,62
Meslammin,draenor,1192,warrior,arms,96,44,52
Xlings,auchindoun,1192,warrior,arms,128,53,75
Araxoth,silvermoon,1192,warrior,arms,97,39,58
Parasite,the-maelstrom,1191,warrior,arms,72,38,34
Zuggizug,draenor,1191,warrior,arms,78,38,40
Waxxo,frostwolf,1190,warrior,arms,41,19,22
Aegís,drakthul,1190,warrior,arms,48,19,29
Wärfäcë,blades-edge,1190,warrior,arms,36,14,22
Kllinac,kazzak,1189,warrior,arms,71,33,38
Lazaza,tarren-mill,1189,warrior,arms,49,19,30
Marcusk,thunderhorn,1189,warrior,arms,42,16,26
Xensation,kult-der-verdammten,1188,warrior,arms,83,36,47
Rövskunk,silvermoon,1188,warrior,arms,40,13,27
Skatbo,shattered-hand,1187,warrior,arms,55,20,35
Harska,ragnaros,1186,warrior,arms,88,45,43
Ахе,deathguard,1186,warrior,arms,66,32,34
Thunderage,stormscale,1186,warrior,arms,36,16,20
Bedryl,burning-legion,1186,warrior,arms,51,20,31
Huuln,outland,1186,warrior,arms,56,21,35
Kval,kazzak,1185,warrior,arms,30,14,16
Lirscuits,silvermoon,1185,warrior,arms,34,14,20
Pyret,outland,1185,warrior,arms,40,14,26
Originel,outland,1184,warrior,arms,30,14,16
Scrèàm,tarren-mill,1184,warrior,arms,67,29,38
Redow,stormreaver,1184,warrior,arms,114,49,65
Gathika,arathor,1183,warrior,arms,24,14,10
Kwesta,kazzak,1182,warrior,arms,23,13,10
Daddycool,haomarush,1182,warrior,arms,118,52,66
Beserk,defias-brotherhood,1181,warrior,arms,94,58,36
Goldenward,silvermoon,1181,warrior,arms,59,28,31
Neaka,archimonde,1181,warrior,arms,29,13,16
Warstickz,kazzak,1181,warrior,arms,42,14,28
Colosius,stormscale,1180,warrior,arms,96,51,45
Laciater,burning-legion,1180,warrior,arms,32,14,18
Wifioffline,silvermoon,1180,warrior,arms,42,15,27
Neltharon,silvermoon,1179,warrior,arms,27,17,10
Disturbance,eredar,1179,warrior,arms,42,20,22
Ragébar,tarren-mill,1179,warrior,arms,109,50,59
Jólasveinn,saurfang,1179,warrior,arms,30,13,17
Чузен,galakrond,1178,warrior,arms,75,35,40
Batrâx,eldrethalas,1178,warrior,arms,73,30,43
Iperiom,dun-modr,1177,warrior,arms,36,20,16
Дрекзот,howling-fjord,1177,warrior,arms,27,15,12
Дрейтон,eversong,1177,warrior,arms,102,51,51
Lîliana,ysondre,1177,warrior,arms,46,23,23
Radîtz,blackmoore,1177,warrior,arms,32,15,17
Milanxxalian,outland,1177,warrior,arms,39,17,22
Geneazyx,silvermoon,1177,warrior,arms,33,13,20
Ксапур,soulflayer,1177,warrior,arms,62,24,38
Виднокрай,gordunni,1177,warrior,arms,36,13,23
Imbakarimbá,blackrock,1175,warrior,arms,47,22,25
Фаталлес,galakrond,1175,warrior,arms,41,17,24
Ironsteve,blackmoore,1174,warrior,arms,456,218,238
Elyalol,ragnaros,1174,warrior,arms,33,15,18
Ruppydeluxe,frostwolf,1174,warrior,arms,74,27,47
Ванмак,gordunni,1173,warrior,arms,101,49,52
Frozenevil,kazzak,1173,warrior,arms,119,57,62
Strânge,gorgonnash,1172,warrior,arms,107,57,50
Etelä,stormreaver,1172,warrior,arms,37,17,20
Buffettleapx,kazzak,1172,warrior,arms,68,29,39
Frankstyle,sanguino,1171,warrior,arms,33,16,17
Zelfire,magtheridon,1171,warrior,arms,30,13,17
Wâtchmefear,blackrock,1171,warrior,arms,33,14,19
Cremas,cthun,1171,warrior,arms,84,33,51
Isidoro,ravencrest,1171,warrior,arms,60,20,40
Jupio,stormscale,1170,warrior,arms,27,15,12
Suolijumppa,stormreaver,1170,warrior,arms,77,37,40
Pwettygal,tarren-mill,1170,warrior,arms,96,46,50
Tongsto,outland,1170,warrior,arms,72,31,41
Dödslängtan,terokkar,1169,warrior,arms,64,35,29
Bladestorm,dun-morogh,1169,warrior,arms,35,15,20
Vohok,jaedenar,1169,warrior,arms,75,31,44
Imora,silvermoon,1169,warrior,arms,54,22,32
Роккар,gordunni,1168,warrior,arms,42,22,20
Палачубийца,deathguard,1168,warrior,arms,131,68,63
Kalregg,outland,1168,warrior,arms,90,34,56
Habaneroo,zuljin,1168,warrior,arms,48,17,31
Kriegerkraut,silvermoon,1167,warrior,arms,40,26,14
Arminvilhelm,argent-dawn,1167,warrior,arms,30,14,16
Gëaldýr,kazzak,1167,warrior,arms,114,49,65
Voidteen,argent-dawn,1167,warrior,arms,56,21,35
Whàtsup,stormscale,1166,warrior,arms,36,17,19
Pesroc,blackmoore,1165,warrior,arms,24,15,9
Nodance,doomhammer,1165,warrior,arms,39,20,19
Akarakhan,sanguino,1165,warrior,arms,96,38,58
Daguangming,outland,1165,warrior,arms,59,23,36
Rojobull,stormscale,1165,warrior,arms,42,15,27
Shuraj,hyjal,1164,warrior,arms,82,37,45
Opseagull,defias-brotherhood,1163,warrior,arms,51,23,28
Eragdagh,thrall,1163,warrior,arms,38,14,24
Warbringer,ravencrest,1163,warrior,arms,42,15,27
Merdé,blackhand,1162,warrior,arms,207,108,99
Garosh,drakthul,1162,warrior,arms,84,39,45
Audelia,sunstrider,1161,warrior,arms,66,36,30
Xamp,madmortem,1161,warrior,arms,26,14,12
Xaena,archimonde,1161,warrior,arms,48,22,26
Lø,chogall,1161,warrior,arms,107,48,59
Малграш,goldrinn,1161,warrior,arms,127,53,74
Despacitus,burning-legion,1161,warrior,arms,71,27,44
Gallaghër,ysondre,1160,warrior,arms,64,33,31
Epepseyer,sanguino,1160,warrior,arms,83,38,45
Rühlsbester,thrall,1160,warrior,arms,101,46,55
Cowlunderowl,tarren-mill,1160,warrior,arms,44,16,28
Zuharakì,nemesis,1159,warrior,arms,361,175,186
Dolforden,burning-legion,1159,warrior,arms,35,13,22
Lithanør,silvermoon,1159,warrior,arms,38,13,25
Пифс,soulflayer,1158,warrior,arms,97,52,45
Agamemnon,frostmane,1158,warrior,arms,68,31,37
Palthor,drakthul,1158,warrior,arms,149,65,84
Kenzai,aegwynn,1158,warrior,arms,31,13,18
Иалаи,howling-fjord,1156,warrior,arms,38,21,17
Sudosolo,burning-blade,1156,warrior,arms,168,82,86
Helenius,ravencrest,1156,warrior,arms,36,13,23
Gakosh,sanguino,1155,warrior,arms,66,33,33
Zargala,stormscale,1155,warrior,arms,30,14,16
Príde,kilrogg,1154,warrior,arms,42,15,27
Элейд,thermaplugg,1153,warrior,arms,53,23,30
Fknslow,ravencrest,1152,warrior,arms,18,12,6
Devìlscandy,stormscale,1152,warrior,arms,18,12,6
Uselessblâme,archimonde,1152,warrior,arms,24,12,12
Porsea,ravencrest,1152,warrior,arms,24,12,12
Chilp,archimonde,1152,warrior,arms,79,32,47
Schero,aegwynn,1151,warrior,arms,18,12,6
Jethiss,ravencrest,1151,warrior,arms,18,12,6
Brinkorf,silvermoon,1151,warrior,arms,24,12,12
Pryzinstyle,aegwynn,1151,warrior,arms,24,12,12
Lydianite,stormrage,1151,warrior,arms,31,14,17
Smèdbérg,ravencrest,1151,warrior,arms,30,12,18
Оркы,soulflayer,1151,warrior,arms,30,12,18
Wutraa,kazzak,1150,warrior,arms,18,12,6
Pikemiwarr,sanguino,1150,warrior,arms,18,12,6
Tëc,silvermoon,1150,warrior,arms,42,22,20
Crazykind,kazzak,1150,warrior,arms,24,12,12
Enzylolz,sanguino,1150,warrior,arms,24,12,12
Zidbi,argent-dawn,1150,warrior,arms,24,12,12
Shelied,twisting-nether,1150,warrior,arms,156,72,84
Panzerpung,outland,1150,warrior,arms,36,12,24
Ryuuzetsu,drakthul,1149,warrior,arms,18,12,6
Crushonyou,aegwynn,1149,warrior,arms,24,12,12
Myth,stormscale,1149,warrior,arms,24,12,12
Raivorouva,stormreaver,1149,warrior,arms,42,19,23
Ovcharq,steamwheedle-cartel,1149,warrior,arms,112,49,63
Глейс,gordunni,1149,warrior,arms,30,12,18
Laakes,eredar,1149,warrior,arms,36,12,24
Saddoh,outland,1149,warrior,arms,42,13,29
Тактоядобрый,ashenvale,1148,warrior,arms,18,12,6
Kampfente,blackrock,1148,warrior,arms,18,12,6
Jonalina,gilneas,1148,warrior,arms,84,42,42
Noisey,sanguino,1148,warrior,arms,24,12,12
Goretterog,ysondre,1148,warrior,arms,24,12,12
Konstantin,grim-batol,1148,warrior,arms,150,66,84
Халльборн,howling-fjord,1148,warrior,arms,30,12,18
Chillycheesy,blackmoore,1148,warrior,arms,42,12,30
Zwerk,rajaxx,1147,warrior,arms,24,12,12
Пасасайка,galakrond,1147,warrior,arms,30,12,18
Zlotjko,ravencrest,1147,warrior,arms,30,12,18
Draemmer,minahonda,1146,warrior,arms,30,15,15
Battleox,stormscale,1146,warrior,arms,24,12,12
Senshin,sanguino,1146,warrior,arms,24,12,12
Graumann,dun-morogh,1146,warrior,arms,28,13,15
Vagor,draenor,1146,warrior,arms,94,42,52
Stillpetao,dun-modr,1146,warrior,arms,36,12,24
Rieku,kazzak,1146,warrior,arms,36,12,24
Sená,stormscale,1145,warrior,arms,18,12,6
Voltrim,blackmoore,1145,warrior,arms,86,43,43
Warbigboss,draenor,1145,warrior,arms,24,12,12
Bobbi,gilneas,1145,warrior,arms,72,31,41
Ezop,burning-blade,1145,warrior,arms,30,12,18
Slappcuzz,blackrock,1145,warrior,arms,30,12,18
Ratko,blackmoore,1144,warrior,arms,26,15,11
Тонкрик,goldrinn,1144,warrior,arms,42,22,20
Zugzugsmash,thrall,1144,warrior,arms,24,12,12
Kirzan,silvermoon,1144,warrior,arms,24,12,12
Warriovar,draenor,1144,warrior,arms,24,12,12
Mañtís,argent-dawn,1144,warrior,arms,86,42,44
Hammerfall,uldum,1144,warrior,arms,90,42,48
Teoggr,kazzak,1144,warrior,arms,30,13,17
Jäime,dun-modr,1144,warrior,arms,40,17,23
Warristyles,arygos,1144,warrior,arms,30,12,18
Davyj,silvermoon,1144,warrior,arms,31,12,19
Smashu,outland,1143,warrior,arms,18,12,6
Karnacîer,archimonde,1143,warrior,arms,30,19,11
Maheri,antonidas,1143,warrior,arms,24,12,12
Tbomb,stormscale,1142,warrior,arms,24,12,12
Bulduzer,kazzak,1142,warrior,arms,149,66,83
Kurzen,voljin,1142,warrior,arms,65,28,37
Brahlus,frostwolf,1142,warrior,arms,31,13,18
Ericmontana,draenor,1142,warrior,arms,30,12,18
Parriwarr,sanguino,1142,warrior,arms,54,21,33
Monsterborn,bloodhoof,1142,warrior,arms,39,15,24
Freestýlz,archimonde,1141,warrior,arms,18,13,5
Nurychïc,twisting-nether,1141,warrior,arms,75,37,38
Yolal,twisting-nether,1141,warrior,arms,165,75,90
Syhtis,hyjal,1140,warrior,arms,24,13,11
Alphachadwar,azjolnerub,1140,warrior,arms,30,12,18
Björnd,hyjal,1140,warrior,arms,42,12,30
Utero,drakthul,1139,warrior,arms,30,12,18
Realstars,tichondrius,1139,warrior,arms,33,13,20
Бланкк,deathweaver,1138,warrior,arms,49,30,19
Lanïmal,eitrigg,1138,warrior,arms,27,15,12
Vrii,eredar,1138,warrior,arms,41,22,19
Xyum,pozzo-delleternità,1138,warrior,arms,120,64,56
Lucasqt,magtheridon,1137,warrior,arms,24,12,12
Kromt,shendralar,1136,warrior,arms,24,15,9
Shinnok,stormreaver,1136,warrior,arms,256,136,120
Maelvos,ravencrest,1136,warrior,arms,72,37,35
Rìght,kazzak,1135,warrior,arms,25,16,9
Vlader,dun-modr,1135,warrior,arms,206,94,112
Экзекутэр,soulflayer,1135,warrior,arms,42,18,24
Юигама,gordunni,1134,warrior,arms,25,13,12
Gunka,tarren-mill,1134,warrior,arms,167,84,83
Критико,lich-king,1134,warrior,arms,24,12,12
Weedshoter,burning-legion,1133,warrior,arms,18,12,6
Dreadshanks,doomhammer,1133,warrior,arms,78,46,32
Inticam,durotan,1133,warrior,arms,55,31,24
Dreamkil,archimonde,1133,warrior,arms,246,120,126
Vandnox,nozdormu,1133,warrior,arms,28,13,15
Cloudstomper,ravenholdt,1133,warrior,arms,64,28,36
Някитила,gordunni,1133,warrior,arms,67,28,39
Titanhaut,frostwolf,1132,warrior,arms,34,18,16
Киефси,howling-fjord,1131,warrior,arms,114,59,55
Obscurìa,argent-dawn,1131,warrior,arms,586,288,298
Quarantino,ysondre,1131,warrior,arms,116,53,63
Medov,outland,1131,warrior,arms,54,23,31
Clemmins,deathwing,1131,warrior,arms,65,24,41
Азероф,gordunni,1130,warrior,arms,18,12,6
Dübèl,blackrock,1130,warrior,arms,36,20,16
Bangbros,archimonde,1130,warrior,arms,24,13,11
Zogyall,ysondre,1130,warrior,arms,66,29,37
Aesiva,die-aldor,1130,warrior,arms,42,18,24
Математик,razuvious,1129,warrior,arms,33,17,16
Razt,bronze-dragonflight,1129,warrior,arms,24,12,12
Indiannaa,draenor,1129,warrior,arms,28,13,15
Warzy,eredar,1129,warrior,arms,66,29,37
Tycho,exodar,1129,warrior,arms,30,12,18
Klyvern,ragnaros,1129,warrior,arms,60,20,40
Battall,ysondre,1128,warrior,arms,54,30,24
Hietfield,twisting-nether,1128,warrior,arms,24,12,12
Joesalamanca,ragnaros,1127,warrior,arms,36,16,20
Gnomzilla,blackhand,1127,warrior,arms,48,16,32
Katyparry,ragnaros,1127,warrior,arms,36,12,24
Midgardsormr,blackrock,1126,warrior,arms,53,24,29
Director,aegwynn,1124,warrior,arms,24,14,10
Oralinde,silvermoon,1124,warrior,arms,178,95,83
Милославский,gordunni,1124,warrior,arms,82,42,40
Scartle,dun-modr,1124,warrior,arms,138,65,73
Crook,doomhammer,1124,warrior,arms,123,50,73
Xxoorrwarr,tarren-mill,1123,warrior,arms,47,25,22
Tajiri,alakir,1123,warrior,arms,82,41,41
Dísplacement,draenor,1123,warrior,arms,24,12,12
Алибастор,galakrond,1123,warrior,arms,105,51,54
Donjanna,ravencrest,1122,warrior,arms,36,16,20
Gladiattus,drakthul,1121,warrior,arms,84,42,42
Yüle,uldaman,1121,warrior,arms,30,15,15
Догерон,grom,1120,warrior,arms,36,20,16
Brùtus,exodar,1120,warrior,arms,30,16,14
Mistawolf,ravencrest,1120,warrior,arms,87,36,51
Nelfx,aggra-português,1119,warrior,arms,176,94,82
Sway,eonar,1118,warrior,arms,156,72,84
Bennybryt,frostmane,1117,warrior,arms,23,12,11
Thiccrich,argent-dawn,1117,warrior,arms,48,25,23
Karden,doomhammer,1117,warrior,arms,104,44,60
Creezê,blackmoore,1117,warrior,arms,30,12,18
Draktul,aegwynn,1116,warrior,arms,24,14,10
Korvjnus,burning-blade,1116,warrior,arms,138,64,74
Nélow,khaz-modan,1116,warrior,arms,48,22,26
Мутобой,soulflayer,1116,warrior,arms,82,37,45
Cliwar,ragnaros,1115,warrior,arms,58,35,23
Brisky,tarren-mill,1115,warrior,arms,30,13,17
Piixxz,hyjal,1114,warrior,arms,30,16,14
Truxiw,silvermoon,1114,warrior,arms,60,28,32
Darkchao,madmortem,1114,warrior,arms,26,12,14
Hojalator,minahonda,1112,warrior,arms,28,13,15
Orcaz,eredar,1112,warrior,arms,52,23,29
Djiozz,khaz-modan,1111,warrior,arms,36,12,24
Ezsnacks,blackrock,1110,warrior,arms,68,36,32
Muetzchen,blackhand,1110,warrior,arms,60,31,29
Ayatolah,kazzak,1110,warrior,arms,59,30,29
Мошер,fordragon,1110,warrior,arms,24,12,12
Sandalwood,wildhammer,1109,warrior,arms,39,18,21
Белриэль,gordunni,1109,warrior,arms,72,25,47
Sûgma,blackhand,1108,warrior,arms,44,23,21
Górut,zuljin,1108,warrior,arms,78,34,44
Piedbot,archimonde,1108,warrior,arms,94,39,55
Pips,minahonda,1108,warrior,arms,54,20,34
Giantknob,tarren-mill,1108,warrior,arms,94,34,60
Rugal,dragonmaw,1106,warrior,arms,35,15,20
Slambadicoot,draenor,1106,warrior,arms,72,24,48
Боевыещёчки,eversong,1105,warrior,arms,34,16,18
Turmund,turalyon,1105,warrior,arms,48,18,30
Quiño,sanguino,1104,warrior,arms,24,12,12
Claytøn,khaz-modan,1104,warrior,arms,85,38,47
Wørgenn,hyjal,1104,warrior,arms,62,25,37
Payßack,drakthul,1104,warrior,arms,30,12,18
Димаджер,razuvious,1102,warrior,arms,24,13,11
Миранир,soulflayer,1102,warrior,arms,62,30,32
Номер,eversong,1102,warrior,arms,45,20,25
Røiivar,hyjal,1102,warrior,arms,169,74,95
Рф,thermaplugg,1102,warrior,arms,32,13,19
Córswain,silvermoon,1102,warrior,arms,42,17,25
Керсантус,gordunni,1101,warrior,arms,17,12,5
Kilsera,blackmoore,1101,warrior,arms,24,13,11
Unstorm,drakthul,1101,warrior,arms,42,12,30
Корофер,galakrond,1100,warrior,arms,47,27,20
Доминатори,grom,1100,warrior,arms,55,21,34
Ceb,drakthul,1100,warrior,arms,78,29,49
Sloppychoppy,silvermoon,1099,warrior,arms,71,32,39
Rutrah,ysondre,1099,warrior,arms,30,12,18
Tiopollo,sanguino,1099,warrior,arms,30,12,18
Serakhan,argent-dawn,1097,warrior,arms,168,86,82
Rindermett,eredar,1097,warrior,arms,30,12,18
Crixusxx,sanguino,1096,warrior,arms,25,13,12
Ugbruk,blackhand,1095,warrior,arms,69,35,34
Fdmachine,kazzak,1095,warrior,arms,48,21,27
Набосуюногу,gordunni,1095,warrior,arms,29,12,17
Kugghalfswor,doomhammer,1094,warrior,arms,418,201,217
Vannié,blackhand,1094,warrior,arms,32,14,18
Bäru,ysondre,1093,warrior,arms,24,14,10
Deko,magtheridon,1093,warrior,arms,26,13,13
Thok,blades-edge,1093,warrior,arms,66,29,37
Magrintor,blackmoore,1091,warrior,arms,49,29,20
Crasher,dentarg,1091,warrior,arms,42,21,21
Копенгаген,ashenvale,1091,warrior,arms,33,13,20
Ñoxpløde,tarren-mill,1090,warrior,arms,23,13,10
Дикийлёха,soulflayer,1090,warrior,arms,42,22,20
Xerkohs,thrall,1090,warrior,arms,41,18,23
Nakroll,sanguino,1090,warrior,arms,42,17,25
Doveloo,kazzak,1085,warrior,arms,48,23,25
Katmai,nemesis,1085,warrior,arms,30,14,16
Bitethedust,darkspear,1085,warrior,arms,48,14,34
Willraxx,draenor,1084,warrior,arms,48,15,33
Бежа,gordunni,1083,warrior,arms,66,37,29
Xeratis,malganis,1082,warrior,arms,24,12,12
Крешер,howling-fjord,1082,warrior,arms,136,60,76
Hulkkis,outland,1082,warrior,arms,56,19,37
Erenowski,twisting-nether,1080,warrior,arms,37,23,14
Ordínaryname,blackrock,1080,warrior,arms,640,321,319
Ianez,nemesis,1077,warrior,arms,83,37,46
Stuble,blackhand,1076,warrior,arms,41,19,22
Jebzmiecza,kazzak,1075,warrior,arms,30,13,17
Blufurys,nemesis,1073,warrior,arms,86,41,45
Безбожник,eversong,1073,warrior,arms,171,79,92
Ziñs,silvermoon,1072,warrior,arms,28,13,15
Fatbeard,twilights-hammer,1072,warrior,arms,72,31,41
Джагенвард,soulflayer,1071,warrior,arms,100,50,50
Тычо,soulflayer,1071,warrior,arms,72,34,38
Шорпит,howling-fjord,1071,warrior,arms,108,48,60
Онлихелл,howling-fjord,1071,warrior,arms,106,46,60
Jackisop,outland,1071,warrior,arms,60,26,34
Salom,illidan,1069,warrior,arms,84,34,50
Agitoyami,defias-brotherhood,1066,warrior,arms,24,12,12
Wrtxnexor,blackhand,1066,warrior,arms,46,21,25
Prime,outland,1066,warrior,arms,34,12,22
Отпустите,howling-fjord,1066,warrior,arms,37,12,25
Manymen,outland,1065,warrior,arms,119,58,61
Láviana,aegwynn,1065,warrior,arms,40,19,21
Diliul,doomhammer,1065,warrior,arms,40,18,22
Verany,antonidas,1065,warrior,arms,32,13,19
Smásher,thrall,1063,warrior,arms,37,14,23
Gormac,ragnaros,1062,warrior,arms,22,12,10
Koliastra,magtheridon,1062,warrior,arms,87,41,46
Keksparrow,antonidas,1061,warrior,arms,48,22,26
Donedone,blackrock,1061,warrior,arms,42,16,26
Katzz,dun-morogh,1061,warrior,arms,44,15,29
Глинм,gordunni,1060,warrior,arms,243,115,128
Davoda,kazzak,1059,warrior,arms,30,17,13
Oxascand,kazzak,1057,warrior,arms,53,18,35
Sufentaniili,frostwhisper,1056,warrior,arms,12,11,1
Рексторм,soulflayer,1056,warrior,arms,12,11,1
Mahomes,ravencrest,1056,warrior,arms,18,11,7
Mâlitek,archimonde,1056,warrior,arms,18,11,7
Cmonbrah,ravencrest,1056,warrior,arms,18,11,7
Dzahboss,archimonde,1056,warrior,arms,18,11,7
Гатсх,blackscar,1056,warrior,arms,24,11,13
Proeliator,argent-dawn,1056,warrior,arms,24,11,13
Scheroh,aegwynn,1056,warrior,arms,24,11,13
Proffsét,ravencrest,1056,warrior,arms,24,11,13
Кросвуд,gordunni,1056,warrior,arms,24,11,13
Määh,frostmane,1056,warrior,arms,30,11,19
Krâgx,kazzak,1055,warrior,arms,18,11,7
Jayus,stormrage,1055,warrior,arms,18,11,7
Pedergun,defias-brotherhood,1055,warrior,arms,53,25,28
Chipstjuven,tarren-mill,1055,warrior,arms,37,17,20
Kehnan,blackrock,1055,warrior,arms,24,11,13
Лимор,howling-fjord,1055,warrior,arms,24,11,13
Bikgusdickus,drakthul,1055,warrior,arms,24,11,13
Doritoslove,sanguino,1055,warrior,arms,24,11,13
Амаззони,howling-fjord,1055,warrior,arms,24,11,13
Xdpromtius,dun-modr,1055,warrior,arms,24,11,13
Quotxwar,stormscale,1055,warrior,arms,24,11,13
Khvor,blackmoore,1055,warrior,arms,24,11,13
Luxurious,argent-dawn,1055,warrior,arms,33,12,21
Tiimbs,tarren-mill,1054,warrior,arms,18,11,7
Ethem,twisting-nether,1054,warrior,arms,229,120,109
Lænet,twisting-nether,1054,warrior,arms,149,75,74
Râmi,perenolde,1054,warrior,arms,24,11,13
Фастод,greymane,1054,warrior,arms,90,40,50
Gramash,grim-batol,1054,warrior,arms,58,25,33
Orcenjoyer,kazzak,1054,warrior,arms,30,11,19
Kzagan,outland,1054,warrior,arms,30,11,19
Apollos,der-mithrilorden,1054,warrior,arms,30,11,19
Swàck,mazrigos,1053,warrior,arms,24,11,13
Himarsenko,silvermoon,1053,warrior,arms,24,11,13
Skaylulz,ragnaros,1053,warrior,arms,24,11,13
Синглдем,gordunni,1053,warrior,arms,24,11,13
Besån,ragnaros,1053,warrior,arms,25,11,14
Bassenheim,deathwing,1053,warrior,arms,30,12,18
Scusi,burning-blade,1053,warrior,arms,30,11,19
Khoroc,die-aldor,1053,warrior,arms,30,11,19
Salamandar,zenedar,1053,warrior,arms,36,11,25
Arhzag,garona,1052,warrior,arms,30,14,16
Arenatogo,blackmoore,1052,warrior,arms,24,11,13
Scràvity,blackhand,1052,warrior,arms,24,11,13
Polak,tirion,1052,warrior,arms,24,11,13
Nejd,alakir,1052,warrior,arms,37,16,21
Gnomekek,sylvanas,1052,warrior,arms,30,11,19
Таккураги,blackscar,1051,warrior,arms,24,11,13
Paralantius,kazzak,1051,warrior,arms,24,11,13
Âxti,blackrock,1050,warrior,arms,24,11,13
Hjondon,argent-dawn,1049,warrior,arms,24,11,13
Råín,stormscale,1049,warrior,arms,29,13,16
Pihvikostaja,stormreaver,1048,warrior,arms,24,11,13
Pìngu,defias-brotherhood,1048,warrior,arms,24,11,13
Câttiva,blackmoore,1048,warrior,arms,30,11,19
Обиванкенобя,soulflayer,1048,warrior,arms,66,24,42
Dragoncry,rexxar,1047,warrior,arms,18,11,7
Icyelk,silvermoon,1047,warrior,arms,18,11,7
Ванпанчвумен,borean-tundra,1047,warrior,arms,18,11,7
Каррагор,howling-fjord,1047,warrior,arms,24,11,13
Hellripper,antonidas,1047,warrior,arms,24,11,13
Ðjlækker,silvermoon,1047,warrior,arms,24,11,13
Lebronjones,sylvanas,1047,warrior,arms,153,68,85
Mokthal,medivh,1047,warrior,arms,29,12,17
Varzeluu,sylvanas,1047,warrior,arms,51,19,32
Clukao,kazzak,1047,warrior,arms,30,11,19
Supersonîc,aegwynn,1046,warrior,arms,24,11,13
Bravestarrz,ungoro,1046,warrior,arms,30,11,19
Velikan,tarren-mill,1046,warrior,arms,30,11,19
Тэсхард,blackscar,1045,warrior,arms,60,37,23
Chargelife,sylvanas,1045,warrior,arms,18,11,7
Achsin,eredar,1045,warrior,arms,57,28,29
Trondilon,tarren-mill,1045,warrior,arms,23,11,12
Wilæm,ravencrest,1045,warrior,arms,36,17,19
Ninja,bronze-dragonflight,1045,warrior,arms,24,11,13
Roponmatsu,draenor,1045,warrior,arms,24,11,13
Coko,kirin-tor,1045,warrior,arms,30,11,19
Neoh,onyxia,1044,warrior,arms,93,47,46
Tuskyr,silvermoon,1044,warrior,arms,30,11,19
Masster,argent-dawn,1043,warrior,arms,18,11,7
Opwarrko,drakthul,1043,warrior,arms,24,11,13
Nocturia,archimonde,1043,warrior,arms,30,11,19
Difalco,archimonde,1042,warrior,arms,152,74,78
Spaiché,azshara,1042,warrior,arms,24,11,13
Gpointt,lordaeron,1042,warrior,arms,60,22,38
Тралмош,razuvious,1042,warrior,arms,30,11,19
Ronflatter,blackrock,1042,warrior,arms,42,13,29
Kirkwood,terokkar,1041,warrior,arms,30,18,12
Зед,blackscar,1041,warrior,arms,37,20,17
Tobigforu,draenor,1041,warrior,arms,45,21,24
Discotrosan,outland,1041,warrior,arms,54,25,29
Altroox,malorne,1041,warrior,arms,24,11,13
Эсканорд,gordunni,1041,warrior,arms,96,43,53
Chocoroko,draenor,1040,warrior,arms,66,30,36
Innos,gorgonnash,1040,warrior,arms,29,13,16
Heavenheart,bronzebeard,1039,warrior,arms,28,19,9
Mangore,tyrande,1039,warrior,arms,86,42,44
Stweye,frostmane,1038,warrior,arms,24,11,13
Auriwariah,silvermoon,1038,warrior,arms,53,21,32
Nokturnâl,silvermoon,1037,warrior,arms,18,11,7
Noomel,twisting-nether,1037,warrior,arms,168,82,86
Шарж,greymane,1037,warrior,arms,90,43,47
Ехасе,gordunni,1037,warrior,arms,52,24,28
Gutworm,stormscale,1037,warrior,arms,24,11,13
Kundan,antonidas,1036,warrior,arms,66,34,32
Mæuzl,draenor,1036,warrior,arms,24,11,13
Stampsalot,deathwing,1036,warrior,arms,24,11,13
Koorkhan,outland,1036,warrior,arms,24,11,13
Endermite,magtheridon,1035,warrior,arms,65,28,37
Havooc,ragnaros,1034,warrior,arms,18,11,7
Артэгиусх,blackscar,1034,warrior,arms,96,47,49
Бенчмаркпоу,gordunni,1034,warrior,arms,29,13,16
Schoolbus,outland,1034,warrior,arms,29,12,17
Karng,zenedar,1033,warrior,arms,116,51,65
Whitebêârd,antonidas,1033,warrior,arms,71,30,41
Latta,blackmoore,1032,warrior,arms,24,11,13
Raldjorn,hyjal,1031,warrior,arms,30,16,14
Kydecnick,kazzak,1031,warrior,arms,130,52,78
Teñseî,archimonde,1030,warrior,arms,18,11,7
Raizø,aegwynn,1030,warrior,arms,31,13,18
Meeyu,blackhand,1029,warrior,arms,18,11,7
Kante,frostmane,1029,warrior,arms,24,11,13
Elaniâ,die-nachtwache,1029,warrior,arms,24,11,13
Brvbert,antonidas,1029,warrior,arms,24,11,13
Troncodepino,nemesis,1028,warrior,arms,42,14,28
Tochka,kazzak,1028,warrior,arms,76,25,51
Haipaz,draenor,1027,warrior,arms,76,36,40
Smaxi,kazzak,1027,warrior,arms,30,11,19
Chatoon,elune,1025,warrior,arms,69,37,32
Larkor,frostwolf,1025,warrior,arms,94,40,54
Pmk,pozzo-delleternità,1025,warrior,arms,64,25,39
Rastaboo,ravencrest,1024,warrior,arms,24,11,13
Krostapunk,colinas-pardas,1024,warrior,arms,42,15,27
Ervanw,sylvanas,1024,warrior,arms,73,24,49
Panickill,ravencrest,1022,warrior,arms,24,11,13
Acestrike,defias-brotherhood,1021,warrior,arms,18,11,7
Shinydjuwlz,turalyon,1021,warrior,arms,36,17,19
Matthaeos,nemesis,1019,warrior,arms,17,13,4
Poör,silvermoon,1019,warrior,arms,24,12,12
Бравурный,gordunni,1019,warrior,arms,48,19,29
Áosr,ravencrest,1018,warrior,arms,88,43,45
Клавиатурный,soulflayer,1018,warrior,arms,29,11,18
Ironfists,kilrogg,1017,warrior,arms,24,11,13
Явперед,soulflayer,1014,warrior,arms,24,11,13
Loddels,frostwolf,1013,warrior,arms,61,33,28
Rîchy,blackrock,1013,warrior,arms,28,15,13
Owarr,grim-batol,1010,warrior,arms,24,13,11
Satanås,silvermoon,1008,warrior,arms,167,82,85
Etharedon,kul-tiras,1007,warrior,arms,142,62,80
Uclat,archimonde,1007,warrior,arms,125,54,71
Tanoras,kazzak,1006,warrior,arms,23,11,12
Sanhaevel,ravencrest,1006,warrior,arms,50,23,27
Falcowar,minahonda,1006,warrior,arms,24,11,13
Knegt,stormreaver,1005,warrior,arms,84,38,46
Smkw,kazzak,1004,warrior,arms,56,32,24
Ruga,echsenkessel,1004,warrior,arms,131,66,65
Antraex,zuljin,1004,warrior,arms,30,13,17
Rajaka,archimonde,1003,warrior,arms,30,15,15
Ezjau,blackmoore,1002,warrior,arms,120,61,59
Athérøs,outland,1002,warrior,arms,29,11,18
Gatlok,kazzak,1001,warrior,arms,24,11,13
Nêithan,dun-modr,1001,warrior,arms,42,16,26
Dénis,onyxia,1000,warrior,arms,30,15,15
Gauklerbaron,blackmoore,1000,warrior,arms,61,26,35
Badazz,thunderhorn,999,warrior,arms,30,12,18
Kvanyrius,archimonde,999,warrior,arms,42,13,29
Ziyetin,blackmoore,998,warrior,arms,24,11,13
Seraphys,ravencrest,998,warrior,arms,28,12,16
Smaugman,nemesis,995,warrior,arms,124,57,67
Mentalysane,outland,994,warrior,arms,32,12,20
Bulgan,thrall,994,warrior,arms,39,11,28
Roninwar,the-maelstrom,993,warrior,arms,64,32,32
Gvngx,zuljin,993,warrior,arms,71,21,50
Sangarane,archimonde,992,warrior,arms,63,36,27
Dêrion,blackmoore,992,warrior,arms,25,12,13
Executioner,ravencrest,992,warrior,arms,54,20,34
Thoròk,antonidas,991,warrior,arms,48,20,28
Sepsys,eredar,991,warrior,arms,48,15,33
Joka,dun-modr,990,warrior,arms,88,37,51
Skarnir,blackhand,990,warrior,arms,59,20,39
Serpeiro,ravencrest,990,warrior,arms,34,11,23
Deasyo,thrall,990,warrior,arms,36,11,25
Dazed,kazzak,989,warrior,arms,32,17,15
Медэвил,deepholm,989,warrior,arms,48,23,25
Knotteddickk,teldrassil,989,warrior,arms,23,11,12
Wfx,kazzak,989,warrior,arms,23,11,12
Strengjahz,ragnaros,988,warrior,arms,22,11,11
Фурозинка,deepholm,988,warrior,arms,35,11,24
Ätreides,sanguino,985,warrior,arms,29,11,18
Ragnarr,ravencrest,982,warrior,arms,28,11,17
Dearmooses,stormscale,980,warrior,arms,48,26,22
Бачус,eversong,979,warrior,arms,30,11,19
Fairly,burning-blade,977,warrior,arms,24,12,12
Murgrimm,die-silberne-hand,974,warrior,arms,48,27,21
Brindzema,doomhammer,973,warrior,arms,54,30,24
Thewitcher,stormscale,973,warrior,arms,30,11,19
Skeleton,los-errantes,972,warrior,arms,46,18,28
Крохвар,gordunni,972,warrior,arms,42,13,29
Fknmoo,kazzak,971,warrior,arms,62,31,31
Elbarbaguti,silvermoon,970,warrior,arms,29,11,18
Warsky,archimonde,968,warrior,arms,42,24,18
Tercio,exodar,968,warrior,arms,165,74,91
Dj,ragnaros,966,warrior,arms,38,20,18
Buullz,twisting-nether,966,warrior,arms,30,12,18
Dariusvolt,argent-dawn,965,warrior,arms,71,34,37
Chépérøs,kaelthas,964,warrior,arms,112,46,66
Vcorvin,dun-modr,962,warrior,arms,42,18,24
Valtýr,skullcrusher,961,warrior,arms,29,17,12
Executeme,sylvanas,961,warrior,arms,36,18,18
Keanew,tarren-mill,960,warrior,arms,12,10,2
Bigschnäbi,blackhand,960,warrior,arms,12,10,2
Wintertimex,stormscale,960,warrior,arms,12,10,2
Ryonâgai,aegwynn,960,warrior,arms,18,10,8
Phalekxox,twisting-nether,960,warrior,arms,18,10,8
Milant,antonidas,960,warrior,arms,18,10,8
Oneoneseven,archimonde,960,warrior,arms,18,10,8
Joelopes,archimonde,960,warrior,arms,18,10,8
Jà,kazzak,960,warrior,arms,18,10,8
Solatika,alexstrasza,960,warrior,arms,243,116,127
Andabad,silvermoon,960,warrior,arms,24,10,14
Repó,twisting-nether,960,warrior,arms,24,10,14
Dvigar,drakthul,960,warrior,arms,24,10,14
Téarz,blackrock,960,warrior,arms,89,35,54
Îwar,ysondre,960,warrior,arms,114,44,70
Sereiz,tarren-mill,960,warrior,arms,30,10,20
Sindrener,ysondre,960,warrior,arms,30,10,20
Brigitá,argent-dawn,960,warrior,arms,30,10,20
Ânhur,blackmoore,959,warrior,arms,18,10,8
Dulex,draenor,959,warrior,arms,18,10,8
Zdi,blackrock,959,warrior,arms,18,10,8
Chadgrave,argent-dawn,959,warrior,arms,18,10,8
Axxtm,ravencrest,959,warrior,arms,18,10,8
Кэмптон,soulflayer,959,warrior,arms,18,10,8
Bíanco,blackrock,959,warrior,arms,18,10,8
Doomz,die-aldor,959,warrior,arms,18,10,8
Trushk,antonidas,959,warrior,arms,18,10,8
Raul,ravencrest,959,warrior,arms,18,10,8
Сарамортал,howling-fjord,959,warrior,arms,18,10,8
Fearmedear,sylvanas,959,warrior,arms,18,10,8
Renatoma,stormscale,959,warrior,arms,21,10,11
Bizzey,aegwynn,959,warrior,arms,24,10,14
Легендор,howling-fjord,959,warrior,arms,24,10,14
Boonur,arthas,959,warrior,arms,24,10,14
Груббоб,booty-bay,959,warrior,arms,24,10,14
Gór,area-52,959,warrior,arms,24,10,14
Pioneer,blackhand,959,warrior,arms,24,10,14
Deackinw,kazzak,959,warrior,arms,24,10,14
Warhero,burning-legion,959,warrior,arms,24,10,14
Carksn,blackmoore,959,warrior,arms,28,11,17
Péridotruite,hyjal,959,warrior,arms,30,10,20
Chrowley,antonidas,959,warrior,arms,70,23,47
Garou,uldum,958,warrior,arms,12,10,2
Воинточкару,gordunni,958,warrior,arms,18,10,8
Hyogan,malganis,958,warrior,arms,18,10,8
Xilquib,darksorrow,958,warrior,arms,18,10,8
Braindeady,burning-legion,958,warrior,arms,18,10,8
Shorrag,outland,958,warrior,arms,18,10,8
Majestatix,doomhammer,958,warrior,arms,18,10,8
Betonica,burning-legion,958,warrior,arms,18,10,8
Darlith,azshara,958,warrior,arms,18,10,8
Gorlemar,blackmoore,958,warrior,arms,18,10,8
Zeekar,ravencrest,958,warrior,arms,18,10,8
Bavet,sylvanas,958,warrior,arms,25,11,14
ßbç,ysondre,958,warrior,arms,24,10,14
Onidrake,nemesis,958,warrior,arms,24,10,14
Uthric,azuremyst,958,warrior,arms,24,10,14
Sezomih,outland,958,warrior,arms,25,10,15
Glevran,turalyon,958,warrior,arms,30,11,19
Rowr,argent-dawn,958,warrior,arms,30,10,20
Aauv,twisting-nether,958,warrior,arms,30,10,20
Bânkai,aegwynn,958,warrior,arms,30,10,20
Ølolo,stormscale,957,warrior,arms,15,11,4
Neíd,antonidas,957,warrior,arms,18,10,8
Makote,uldum,957,warrior,arms,18,10,8
Zevlovéx,kazzak,957,warrior,arms,18,10,8
Qvicfrito,ravencrest,957,warrior,arms,18,10,8
Bèrserkir,tarren-mill,957,warrior,arms,18,10,8
Thebiggreen,twisting-nether,957,warrior,arms,18,10,8
Zamorák,twisting-nether,957,warrior,arms,24,10,14
Волдунер,gordunni,957,warrior,arms,24,10,14
Xardäs,ysondre,957,warrior,arms,24,10,14
Iuliaa,ravencrest,957,warrior,arms,24,10,14
Sanguìnius,nemesis,957,warrior,arms,30,10,20
Topozugzug,tarren-mill,957,warrior,arms,30,10,20
Bolvarson,malganis,957,warrior,arms,30,10,20
Огра,blackscar,956,warrior,arms,18,10,8
Pílot,ravencrest,956,warrior,arms,18,10,8
Anndersen,defias-brotherhood,956,warrior,arms,18,10,8
Roshas,twisting-nether,956,warrior,arms,18,10,8
Berzker,ragnaros,956,warrior,arms,18,10,8
Draken,tarren-mill,956,warrior,arms,24,10,14
Nadelicious,kazzak,956,warrior,arms,24,10,14
Quihc,outland,956,warrior,arms,24,10,14
Teramuhl,eredar,956,warrior,arms,24,10,14
Elesharde,sanguino,956,warrior,arms,27,11,16
Mìsà,ysondre,956,warrior,arms,29,10,19
Metmaschine,antonidas,956,warrior,arms,30,10,20
Soofies,madmortem,955,warrior,arms,18,10,8
Skederon,chogall,955,warrior,arms,18,10,8
Deanx,ragnaros,955,warrior,arms,18,10,8
Асхана,howling-fjord,955,warrior,arms,18,10,8
Nightbeard,twisting-nether,955,warrior,arms,18,10,8
Sazø,culte-de-la-rive-noire,955,warrior,arms,18,10,8
Odonko,blackmoore,955,warrior,arms,60,29,31
Xarmog,hyjal,955,warrior,arms,24,10,14
Gramrosh,eredar,955,warrior,arms,24,10,14
Rngcarrier,sylvanas,955,warrior,arms,24,10,14
Profftols,draenor,955,warrior,arms,30,10,20
Neíd,malganis,955,warrior,arms,30,10,20
Fluffycute,blackhand,955,warrior,arms,30,10,20
Rawne,kirin-tor,954,warrior,arms,18,10,8
Zutto,conseil-des-ombres,954,warrior,arms,18,10,8
Smob,ragnaros,954,warrior,arms,18,10,8
Труперсила,howling-fjord,954,warrior,arms,24,10,14
Protecmoo,drakthul,954,warrior,arms,24,10,14
Smushbrok,stormscale,954,warrior,arms,24,10,14
Acour,elune,954,warrior,arms,24,10,14
Ôwndbylx,aegwynn,954,warrior,arms,27,11,16
Cäbbs,stormscale,954,warrior,arms,30,10,20
Yngvar,darksorrow,954,warrior,arms,30,10,20
Øfè,ysondre,954,warrior,arms,30,10,20
Lõókåtmêñöw,hyjal,953,warrior,arms,12,10,2
Fehrax,eredar,953,warrior,arms,18,10,8
Camaon,outland,953,warrior,arms,18,10,8
Æxcoast,ravencrest,953,warrior,arms,30,10,20
Bisuko,archimonde,953,warrior,arms,36,10,26
Ginò,stormscale,952,warrior,arms,18,10,8
Blanchysnow,hyjal,952,warrior,arms,18,10,8
Papawaffle,stormscale,952,warrior,arms,18,10,8
Decreased,dun-modr,952,warrior,arms,18,10,8
Unkmòr,pozzo-delleternità,952,warrior,arms,42,22,20
Partajorma,ravencrest,952,warrior,arms,24,10,14
Hexzo,ravencrest,952,warrior,arms,24,10,14
Кейнорин,howling-fjord,952,warrior,arms,34,11,23
Rayenna,dalaran,951,warrior,arms,12,10,2
Думрайт,gordunni,951,warrior,arms,18,10,8
Marciano,dalaran,951,warrior,arms,24,12,12
Зарган,howling-fjord,951,warrior,arms,65,25,40
Dlstroyer,eonar,950,warrior,arms,35,21,14
Nðjn,archimonde,950,warrior,arms,18,10,8
Tonberry,frostwolf,950,warrior,arms,24,10,14
Xlugan,kazzak,950,warrior,arms,42,10,32
Zodiakós,burning-legion,950,warrior,arms,42,10,32
Zerm,draenor,949,warrior,arms,18,10,8
Carsannies,stormscale,949,warrior,arms,136,59,77
Gilgarez,twisting-nether,949,warrior,arms,24,10,14
Qvil,sanguino,948,warrior,arms,93,31,62
Obitron,argent-dawn,947,warrior,arms,24,10,14
Pyxis,argent-dawn,947,warrior,arms,24,10,14
Kharmog,hyjal,947,warrior,arms,54,18,36
Nyu,kirin-tor,946,warrior,arms,89,41,48
Waescanor,ragnaros,946,warrior,arms,54,21,33
Omglolnoob,magtheridon,946,warrior,arms,26,10,16
Çbr,silvermoon,945,warrior,arms,36,10,26
Geicoo,dalaran,944,warrior,arms,77,39,38
Warrgob,outland,944,warrior,arms,30,10,20
Lucciouss,sylvanas,943,warrior,arms,18,10,8
Abrogatio,emeriss,943,warrior,arms,18,10,8
Jackycoke,blackhand,943,warrior,arms,30,10,20
Dorya,aegwynn,942,warrior,arms,23,10,13
Razecraz,ysondre,941,warrior,arms,24,14,10
Snägärikovin,stormreaver,941,warrior,arms,24,10,14
Shpitzu,stormscale,941,warrior,arms,26,10,16
Mathej,drakthul,940,warrior,arms,23,10,13
Илийя,razuvious,940,warrior,arms,29,10,19
Wulfgâr,dun-modr,939,warrior,arms,48,26,22
Danoriix,drakthul,937,warrior,arms,30,10,20
Dattebane,silvermoon,937,warrior,arms,37,12,25
Overdose,anetheron,936,warrior,arms,29,16,13
Shieldwall,norgannon,935,warrior,arms,36,20,16
Zarani,antonidas,935,warrior,arms,30,10,20
Kaerz,ysondre,934,warrior,arms,18,10,8
Vooice,sylvanas,933,warrior,arms,29,10,19
Zoulaani,argent-dawn,932,warrior,arms,155,64,91
Bubciu,burning-legion,932,warrior,arms,30,10,20
Lapyy,drakthul,931,warrior,arms,36,18,18
Kreaten,chamber-of-aspects,931,warrior,arms,114,44,70
Йомхар,howling-fjord,931,warrior,arms,30,10,20
Glavý,burning-legion,927,warrior,arms,22,10,12
Ganik,malganis,927,warrior,arms,23,10,13
Rèlion,pozzo-delleternità,926,warrior,arms,21,11,10
Джеймсчейз,blackscar,926,warrior,arms,23,10,13
Skullhammer,burning-legion,925,warrior,arms,30,13,17
Léonie,arakarahm,924,warrior,arms,23,10,13
Ørkk,pozzo-delleternità,923,warrior,arms,14,11,3
Perseó,minahonda,923,warrior,arms,84,32,52
Дозикк,ashenvale,923,warrior,arms,38,11,27
Espanyol,sanguino,920,warrior,arms,68,35,33
Всемкуяолд,gordunni,920,warrior,arms,24,11,13
Pigleto,ravencrest,919,warrior,arms,99,46,53
Prag,silvermoon,918,warrior,arms,34,18,16
Abelgf,exodar,918,warrior,arms,32,12,20
Боевойму,howling-fjord,917,warrior,arms,194,88,106
Bukî,blackmoore,917,warrior,arms,29,10,19
Gizmaxe,tarren-mill,916,warrior,arms,20,11,9
Tengriy,wildhammer,915,warrior,arms,14,11,3
Takashia,ravencrest,915,warrior,arms,22,11,11
Wonne,silvermoon,915,warrior,arms,29,10,19
Hammerfíst,kazzak,913,warrior,arms,112,53,59
Kirix,aegwynn,911,warrior,arms,42,19,23
Kokonut,twisting-nether,909,warrior,arms,45,24,21
Justop,ravencrest,907,warrior,arms,23,10,13
Durmithor,silvermoon,906,warrior,arms,35,10,25
Энлами,gordunni,905,warrior,arms,21,10,11
Glut,drakthul,905,warrior,arms,24,11,13
Karbeg,ravencrest,905,warrior,arms,27,10,17
Elsinner,ravencrest,905,warrior,arms,35,10,25
Искристый,howling-fjord,903,warrior,arms,18,11,7
Cryze,ravencrest,903,warrior,arms,21,10,11
Spoofie,doomhammer,903,warrior,arms,27,10,17
Adrï,draenor,901,warrior,arms,124,63,61
Ispor,shattered-halls,901,warrior,arms,161,78,83
Ileei,kazzak,901,warrior,arms,38,12,26
Обнимаш,ashenvale,900,warrior,arms,20,11,9
Cléveland,argent-dawn,900,warrior,arms,28,11,17
Shtygar,doomhammer,898,warrior,arms,36,13,23
Креспекс,gordunni,896,warrior,arms,28,10,18
Narki,sporeggar,895,warrior,arms,78,31,47
Maroshko,burning-blade,893,warrior,arms,15,10,5
Warara,archimonde,893,warrior,arms,22,10,12
Bòónki,ravencrest,893,warrior,arms,93,41,52
Goodvibez,silvermoon,893,warrior,arms,36,10,26
Talaganos,twisting-nether,890,warrior,arms,31,17,14
Биграма,howling-fjord,890,warrior,arms,26,10,16
Мембершримп,howling-fjord,890,warrior,arms,38,10,28
Hasira,xavius,889,warrior,arms,16,10,6
Zhønya,aegwynn,889,warrior,arms,23,10,13
Рагнарульв,gordunni,885,warrior,arms,14,10,4
Arschal,khaz-modan,883,warrior,arms,44,22,22
Дотрен,galakrond,883,warrior,arms,42,20,22
Braûsepulver,guldan,883,warrior,arms,138,65,73
Rejectofrage,ragnaros,882,warrior,arms,66,29,37
Ttz,tarren-mill,880,warrior,arms,50,21,29
Nebezpeka,silvermoon,878,warrior,arms,19,10,9
Aemirage,doomhammer,876,warrior,arms,114,58,56
Themasterlen,nordrassil,876,warrior,arms,23,10,13
Авврорра,gordunni,874,warrior,arms,145,68,77
Scill,silvermoon,873,warrior,arms,44,20,24
Spartazo,turalyon,873,warrior,arms,48,18,30
Yuushi,doomhammer,865,warrior,arms,58,25,33
Bazsika,ragnaros,865,warrior,arms,72,26,46
Gladwfriends,ravencrest,864,warrior,arms,12,9,3
Zeetx,les-clairvoyants,864,warrior,arms,12,9,3
Antìcìdè,ravencrest,864,warrior,arms,12,9,3
Marqinios,archimonde,864,warrior,arms,12,9,3
Psinovich,sylvanas,864,warrior,arms,18,9,9
Earthshatter,emeriss,864,warrior,arms,18,9,9
Casty,blackrock,864,warrior,arms,18,9,9
Precel,burning-legion,864,warrior,arms,18,9,9
Moldamis,blackhand,864,warrior,arms,18,9,9
Necrio,kazzak,864,warrior,arms,18,9,9
Shadezzqt,blackmoore,864,warrior,arms,18,9,9
Tromka,stormscale,864,warrior,arms,18,9,9
Émalkay,tarren-mill,864,warrior,arms,18,9,9
Bâyer,burning-legion,864,warrior,arms,18,9,9
Ирклейн,howling-fjord,864,warrior,arms,18,9,9
Zorn,blackmoore,864,warrior,arms,18,9,9
Cerßeres,archimonde,864,warrior,arms,18,9,9
Trensexual,twisting-nether,864,warrior,arms,18,9,9
Khalidax,hyjal,864,warrior,arms,18,9,9
Stóna,blackmoore,864,warrior,arms,24,9,15
Tenthøusand,sylvanas,864,warrior,arms,24,9,15
Dmgsponge,stormscale,864,warrior,arms,24,9,15
Motres,sylvanas,864,warrior,arms,24,9,15
Deskslammer,tarren-mill,864,warrior,arms,24,9,15
Комбобрэйкер,grom,864,warrior,arms,24,9,15
Trenbolonpap,twisting-nether,863,warrior,arms,12,9,3
Bandfør,archimonde,863,warrior,arms,12,9,3
Drøgma,tyrande,863,warrior,arms,18,9,9
Luchanka,the-maelstrom,863,warrior,arms,18,9,9
Mjol,silvermoon,863,warrior,arms,18,9,9
Súbzéró,argent-dawn,863,warrior,arms,18,9,9
Pexqt,blackmoore,863,warrior,arms,18,9,9
Тягуч,howling-fjord,863,warrior,arms,18,9,9
Punisherhulk,stormscale,863,warrior,arms,18,9,9
Kaloche,hyjal,863,warrior,arms,18,9,9
Theolcostaud,archimonde,863,warrior,arms,18,9,9
Drengr,blackhand,863,warrior,arms,18,9,9
Мелефесента,gordunni,863,warrior,arms,18,9,9
Cebystance,kazzak,863,warrior,arms,18,9,9
Слоз,gordunni,863,warrior,arms,18,9,9
Vøs,hyjal,863,warrior,arms,18,9,9
Хастурхотеп,gordunni,863,warrior,arms,18,9,9
Валлй,blackscar,863,warrior,arms,18,9,9
Deathgreyø,nemesis,863,warrior,arms,18,9,9
Elpap,draenor,863,warrior,arms,18,9,9
Fitø,shendralar,863,warrior,arms,18,9,9
Pacheco,eredar,863,warrior,arms,21,10,11
Valyron,ravencrest,863,warrior,arms,22,9,13
Shiikaa,hyjal,863,warrior,arms,24,9,15
Borndet,eredar,863,warrior,arms,24,9,15
Danaüs,twisting-nether,863,warrior,arms,24,9,15
Abibe,aggra-português,863,warrior,arms,24,9,15
Johnfogerty,twisting-nether,863,warrior,arms,24,9,15
Маньякубица,howling-fjord,863,warrior,arms,24,9,15
Agres,zuluhed,863,warrior,arms,24,9,15
Visari,kiljaeden,863,warrior,arms,24,9,15
Darkblader,dalvengyr,863,warrior,arms,24,9,15
Stepchildx,silvermoon,863,warrior,arms,24,9,15
Grimblade,kazzak,863,warrior,arms,30,9,21
Nyxo,argent-dawn,863,warrior,arms,30,9,21
Symx,tarren-mill,863,warrior,arms,30,9,21
Adalyn,azjolnerub,862,warrior,arms,12,9,3
Tuncis,aszune,862,warrior,arms,18,9,9
Sorassa,eredar,862,warrior,arms,18,9,9
Fidicenz,ysondre,862,warrior,arms,18,9,9
Onkra,malganis,862,warrior,arms,18,9,9
Veeg,blackmoore,862,warrior,arms,18,9,9
Камрадшторм,borean-tundra,862,warrior,arms,24,9,15
Bekkey,lightbringer,862,warrior,arms,24,9,15
Realdrdob,kazzak,862,warrior,arms,24,9,15
Slowfeet,stormscale,861,warrior,arms,12,9,3
Sax,ravencrest,861,warrior,arms,18,9,9
Nêgan,stormscale,861,warrior,arms,18,9,9
Nêlê,thrall,861,warrior,arms,18,9,9
Мономер,soulflayer,861,warrior,arms,24,9,15
Nameless,malganis,861,warrior,arms,24,9,15
Micromachìne,sanguino,861,warrior,arms,24,9,15
Amar,defias-brotherhood,861,warrior,arms,29,10,19
Bigbaduglyy,twisting-nether,861,warrior,arms,30,9,21
Bobbys,kazzak,860,warrior,arms,12,9,3
Grudu,la-croisade-écarlate,860,warrior,arms,18,9,9
Bezark,kazzak,860,warrior,arms,18,9,9
Emmá,neptulon,860,warrior,arms,18,9,9
Arrhennius,kazzak,860,warrior,arms,18,9,9
Krieguer,sanguino,860,warrior,arms,18,9,9
Andoror,nemesis,860,warrior,arms,18,9,9
Казырной,soulflayer,860,warrior,arms,24,9,15
Zersei,los-errantes,860,warrior,arms,24,9,15
Woopzi,twisting-nether,860,warrior,arms,36,9,27
Jarlerkin,ragnaros,859,warrior,arms,18,9,9
Stits,chromaggus,859,warrior,arms,18,9,9
Buffury,twisting-nether,859,warrior,arms,24,9,15
Aeh,blackmoore,859,warrior,arms,24,9,15
Brúgar,antonidas,859,warrior,arms,24,9,15
Маханхет,soulflayer,859,warrior,arms,24,9,15
Toiscour,archimonde,859,warrior,arms,30,9,21
Voodoowarr,rexxar,858,warrior,arms,18,9,9
Crud,die-silberne-hand,858,warrior,arms,18,9,9
Tojaraa,kazzak,858,warrior,arms,18,9,9
Zion,zenedar,858,warrior,arms,24,9,15
Kronnosh,tarren-mill,857,warrior,arms,12,9,3
Rasselbandé,blackhand,857,warrior,arms,18,9,9
Варбыкмашина,howling-fjord,857,warrior,arms,18,9,9
Тревзор,gordunni,857,warrior,arms,24,9,15
Ruioz,draenor,857,warrior,arms,24,9,15
Exitod,thrall,857,warrior,arms,31,10,21
Tweener,azjolnerub,856,warrior,arms,20,9,11
Chrimo,silvermoon,856,warrior,arms,30,9,21
Gucix,tarren-mill,855,warrior,arms,18,9,9
Pvpstyle,bloodscalp,855,warrior,arms,24,9,15
Легионарус,gordunni,855,warrior,arms,24,9,15
Bjornn,azjolnerub,854,warrior,arms,18,9,9
Caloomsa,hellfire,854,warrior,arms,18,9,9
Rézinplin,archimonde,854,warrior,arms,18,9,9
Discogoon,twilights-hammer,854,warrior,arms,87,32,55
Ruuster,norgannon,853,warrior,arms,30,9,21
Janeu,nozdormu,852,warrior,arms,18,9,9
Heimdål,antonidas,852,warrior,arms,36,9,27
Fugrim,draenor,851,warrior,arms,18,9,9
Syforce,ravencrest,850,warrior,arms,18,9,9
Warclone,ravencrest,850,warrior,arms,18,9,9
Ostoppandi,sylvanas,849,warrior,arms,18,9,9
Gidra,stormscale,847,warrior,arms,17,9,8
Имяужезанято,gordunni,846,warrior,arms,17,9,8
Orchëstre,eitrigg,846,warrior,arms,244,121,123
Gogoplata,antonidas,845,warrior,arms,18,9,9
Leesh,ravenholdt,845,warrior,arms,92,44,48
Zêrklatscher,lordaeron,845,warrior,arms,54,13,41
Derbayn,tarren-mill,844,warrior,arms,26,10,16
Mótleycrüe,sanguino,843,warrior,arms,18,10,8
Xienia,dun-morogh,841,warrior,arms,30,10,20
Ethon,antonidas,840,warrior,arms,22,11,11
Лаврентии,soulflayer,840,warrior,arms,36,9,27
Vlajko,kazzak,839,warrior,arms,60,21,39
Лесковер,howling-fjord,831,warrior,arms,23,9,14
Lockia,chogall,829,warrior,arms,20,10,10
Greeneroi,khaz-modan,829,warrior,arms,35,9,26
Raufí,antonidas,828,warrior,arms,72,34,38
Armsstrong,blackhand,828,warrior,arms,23,9,14
Bashion,ghostlands,828,warrior,arms,48,16,32
Ajsiboy,burning-legion,825,warrior,arms,59,19,40
Poluneikos,turalyon,823,warrior,arms,30,9,21
Warwaw,twisting-nether,822,warrior,arms,27,11,16
Glorywhory,drakthul,821,warrior,arms,23,9,14
Turøc,illidan,821,warrior,arms,36,14,22
Cristoforo,the-shatar,821,warrior,arms,64,15,49
Darkmidgét,silvermoon,815,warrior,arms,21,9,12
Станеслав,gordunni,810,warrior,arms,23,9,14
Kixx,twisting-nether,809,warrior,arms,78,35,43
Actuallyorc,twisting-nether,799,warrior,arms,14,9,5
Слэймодх,howling-fjord,799,warrior,arms,17,9,8
Thoon,teldrassil,799,warrior,arms,30,12,18
Jiñnx,outland,798,warrior,arms,11,9,2
Zaccollini,burning-legion,798,warrior,arms,16,9,7
Fürchtenix,blackmoore,798,warrior,arms,26,9,17
Ahmedmohsen,kazzak,796,warrior,arms,20,9,11
Alothar,khaz-modan,796,warrior,arms,129,54,75
Asurian,runetotem,796,warrior,arms,99,39,60
Вениамин,fordragon,791,warrior,arms,26,9,17
Steels,outland,788,warrior,arms,43,19,24
Finalsmasher,thrall,784,warrior,arms,42,16,26
Tynyas,dalaran,782,warrior,arms,103,48,55
Panduf,rashgarroth,781,warrior,arms,11,9,2
Muyubu,eredar,768,warrior,arms,12,8,4
Möuntian,kazzak,768,warrior,arms,12,8,4
Отвечай,gordunni,768,warrior,arms,12,8,4
Beiskaldí,blackrock,768,warrior,arms,12,8,4
Выбьюглазик,gordunni,768,warrior,arms,12,8,4
Escapeartíst,ravencrest,768,warrior,arms,12,8,4
Rageside,draenor,768,warrior,arms,12,8,4
Бигбэйбитейп,greymane,768,warrior,arms,12,8,4
Ballin,dragonblight,768,warrior,arms,12,8,4
Zalazinjo,stormscale,768,warrior,arms,12,8,4
Bigdøngfur,archimonde,768,warrior,arms,12,8,4
Sevenheavy,draenor,768,warrior,arms,12,8,4
Smorccroms,stormscale,768,warrior,arms,12,8,4
Drragosh,tarren-mill,768,warrior,arms,12,8,4
Éliøkor,outland,768,warrior,arms,12,8,4
Меффект,howling-fjord,768,warrior,arms,12,8,4
Piré,tarren-mill,768,warrior,arms,12,8,4
Spiokra,hellscream,768,warrior,arms,12,8,4
Dagon,gorgonnash,768,warrior,arms,12,8,4
Лувисфолл,soulflayer,768,warrior,arms,12,8,4
Reckxpeep,twisting-nether,768,warrior,arms,12,8,4
Bulfwart,zuljin,768,warrior,arms,12,8,4
Syjin,antonidas,768,warrior,arms,12,8,4
Audrin,twisting-nether,768,warrior,arms,12,8,4
Madßud,ravencrest,768,warrior,arms,14,8,6
Андрюхабш,soulflayer,768,warrior,arms,18,8,10
Maresur,burning-legion,768,warrior,arms,18,8,10
Dréngr,blackrock,768,warrior,arms,18,8,10
Nutz,archimonde,768,warrior,arms,18,8,10
Vermis,stormscale,768,warrior,arms,18,8,10
Makaveli,twisting-nether,768,warrior,arms,18,8,10
Ликано,greymane,768,warrior,arms,18,8,10
Shewbynette,archimonde,768,warrior,arms,18,8,10
Omnity,stormscale,768,warrior,arms,18,8,10
Crebushi,burning-legion,768,warrior,arms,18,8,10
Belmønt,archimonde,768,warrior,arms,18,8,10
Notzage,les-sentinelles,768,warrior,arms,18,8,10
Steelride,silvermoon,768,warrior,arms,18,8,10
Sreym,dun-modr,768,warrior,arms,18,8,10
Safaribob,kazzak,768,warrior,arms,18,8,10
Shreedshot,blackmoore,768,warrior,arms,18,8,10
Zeover,ragnaros,768,warrior,arms,18,8,10
Styxwr,blackhand,768,warrior,arms,18,8,10
Akkixx,die-aldor,768,warrior,arms,18,8,10
Maven,thrall,768,warrior,arms,18,8,10
Epicc,alleria,768,warrior,arms,18,8,10
Nerfelepls,ravencrest,768,warrior,arms,21,9,12
Caffeinë,ravencrest,768,warrior,arms,24,8,16
Sublexgg,blackrock,768,warrior,arms,24,8,16
Guerriax,les-sentinelles,768,warrior,arms,24,8,16
Leavyu,silvermoon,768,warrior,arms,24,8,16
Galiusx,malganis,768,warrior,arms,24,8,16
Whydeadbro,twisting-nether,768,warrior,arms,30,8,22
Ludiboro,kazzak,768,warrior,arms,36,8,28
Druubak,aggra-português,767,warrior,arms,12,8,4
Unchåined,burning-legion,767,warrior,arms,12,8,4
Smikka,jaedenar,767,warrior,arms,12,8,4
Atzex,blackmoore,767,warrior,arms,12,8,4
Critwar,draenor,767,warrior,arms,12,8,4
Huevon,draenor,767,warrior,arms,12,8,4
Barvaron,argent-dawn,767,warrior,arms,12,8,4
Dikastis,kul-tiras,767,warrior,arms,15,9,6
Kasperw,kazzak,767,warrior,arms,18,8,10
Yoruíchi,sunstrider,767,warrior,arms,18,8,10
Sïmstärxzy,hakkar,767,warrior,arms,18,8,10
Vahrion,burning-blade,767,warrior,arms,18,8,10
Kalopsia,drakthul,767,warrior,arms,18,8,10
Míngxuan,tarren-mill,767,warrior,arms,18,8,10
Gueboparado,sanguino,767,warrior,arms,18,8,10
Craíne,antonidas,767,warrior,arms,18,8,10
Béhrus,blackmoore,767,warrior,arms,18,8,10
Studzianki,argent-dawn,767,warrior,arms,18,8,10
Hermosse,dalaran,767,warrior,arms,18,8,10
Josimar,kazzak,767,warrior,arms,18,8,10
Horseye,eredar,767,warrior,arms,18,8,10
Grimmvard,blackhand,767,warrior,arms,18,8,10
Arigbökh,hyjal,767,warrior,arms,18,8,10
Zonïa,ysondre,767,warrior,arms,18,8,10
Vexari,twisting-nether,767,warrior,arms,18,8,10
Громорашман,grom,767,warrior,arms,18,8,10
Instamerk,doomhammer,767,warrior,arms,18,8,10
Снорре,soulflayer,767,warrior,arms,18,8,10
Fullfäyä,hyjal,767,warrior,arms,18,8,10
Jjokkerr,magtheridon,767,warrior,arms,18,8,10
Yasuk,archimonde,767,warrior,arms,18,8,10
Bosancheros,the-maelstrom,767,warrior,arms,18,8,10
Nithradien,blades-edge,767,warrior,arms,18,8,10
Oxey,ragnaros,767,warrior,arms,18,8,10
Mòrzàr,outland,767,warrior,arms,18,8,10
Dtraque,kaelthas,767,warrior,arms,18,8,10
Litlijón,ravencrest,767,warrior,arms,18,8,10
Kunodontas,draenor,767,warrior,arms,18,8,10
Broxiw,darkspear,767,warrior,arms,18,8,10
Sprutx,tarren-mill,767,warrior,arms,18,8,10
Alexwar,draenor,767,warrior,arms,18,8,10
Wólfguard,silvermoon,767,warrior,arms,18,8,10
Achîlles,twisting-nether,767,warrior,arms,18,8,10
Akim,ysondre,767,warrior,arms,18,8,10
Kaske,alexstrasza,767,warrior,arms,23,8,15
Nuhilug,tarren-mill,767,warrior,arms,24,8,16
Rylbrah,blackmoore,767,warrior,arms,24,8,16
Linkeador,zuljin,767,warrior,arms,24,8,16
Spacemachine,kazzak,767,warrior,arms,24,8,16
Хардскар,ashenvale,767,warrior,arms,24,8,16
Qdex,kazzak,767,warrior,arms,24,8,16
Mønsterz,archimonde,767,warrior,arms,24,8,16
Celean,darksorrow,766,warrior,arms,12,8,4
Bonkonator,stormscale,766,warrior,arms,12,8,4
Свиногуб,soulflayer,766,warrior,arms,12,8,4
Дядядмг,blackscar,766,warrior,arms,12,8,4
Newgáte,silvermoon,766,warrior,arms,12,8,4
Tremuwar,tyrande,766,warrior,arms,12,8,4
Uwuaraqtlol,stormscale,766,warrior,arms,16,9,7
Beamis,ragnaros,766,warrior,arms,18,8,10
Lylïth,sinstralis,766,warrior,arms,18,8,10
Rageaholic,blackmoore,766,warrior,arms,18,8,10
Tyrag,eredar,766,warrior,arms,18,8,10
Zerxees,tarren-mill,766,warrior,arms,18,8,10
Gùts,stormreaver,766,warrior,arms,18,8,10
Willadimore,ravencrest,766,warrior,arms,18,8,10
Хэлвид,soulflayer,766,warrior,arms,18,8,10
Booya,laughing-skull,766,warrior,arms,18,8,10
Byrnjolf,zuljin,766,warrior,arms,18,8,10
Тевивар,gordunni,766,warrior,arms,18,8,10
Kekzero,kazzak,766,warrior,arms,24,8,16
Smarkz,nemesis,766,warrior,arms,24,8,16
Нэиро,howling-fjord,766,warrior,arms,24,8,16
Csíbór,ragnaros,766,warrior,arms,24,8,16
Xongoku,blackrock,765,warrior,arms,12,8,4
Кырно,gordunni,765,warrior,arms,18,8,10
Vingmyr,silvermoon,765,warrior,arms,18,8,10
Zouwar,hyjal,765,warrior,arms,18,8,10
Tyranitar,pozzo-delleternità,765,warrior,arms,18,8,10
Firebladë,ravencrest,765,warrior,arms,18,8,10
Fortësque,uldaman,765,warrior,arms,18,8,10
Альмас,galakrond,765,warrior,arms,21,9,12
Кордупэль,gordunni,765,warrior,arms,24,8,16
Younes,ravencrest,765,warrior,arms,24,8,16
Intcx,silvermoon,765,warrior,arms,24,8,16
Hanvik,zuljin,765,warrior,arms,24,8,16
Platerz,aggramar,765,warrior,arms,24,8,16
Leaply,kazzak,765,warrior,arms,24,8,16
Feydal,thrall,765,warrior,arms,24,8,16
Hirbus,ravencrest,765,warrior,arms,25,8,17
Kotto,defias-brotherhood,765,warrior,arms,30,8,22
Варинуб,soulflayer,764,warrior,arms,18,10,8
Berree,outland,764,warrior,arms,18,8,10
Tinull,silvermoon,764,warrior,arms,24,8,16
Lìón,blackhand,764,warrior,arms,24,8,16
Okke,thunderhorn,764,warrior,arms,24,8,16
Wærriør,argent-dawn,763,warrior,arms,18,8,10
Repzcanor,silvermoon,763,warrior,arms,18,8,10
Ireincarnate,argent-dawn,763,warrior,arms,18,8,10
Qree,dun-morogh,763,warrior,arms,18,8,10
Giggadaddy,tarren-mill,763,warrior,arms,18,8,10
Xenör,archimonde,763,warrior,arms,24,8,16
Ripper,scarshield-legion,763,warrior,arms,30,8,22
Leyon,blades-edge,762,warrior,arms,12,8,4
Даммодар,howling-fjord,762,warrior,arms,18,8,10
Boindal,senjin,762,warrior,arms,18,8,10
Previse,argent-dawn,762,warrior,arms,18,8,10
Bigbibbs,tarren-mill,762,warrior,arms,24,8,16
Fanfurik,silvermoon,762,warrior,arms,30,8,22
Øruch,draenor,761,warrior,arms,18,8,10
Grimdorf,frostmane,761,warrior,arms,24,8,16
Отнулядоста,gordunni,761,warrior,arms,24,8,16
Cøbe,arthas,761,warrior,arms,24,8,16
Encounter,nefarian,760,warrior,arms,12,8,4
Alhexander,dun-modr,760,warrior,arms,18,8,10
Грруд,galakrond,760,warrior,arms,24,8,16
Alysa,ravencrest,760,warrior,arms,24,8,16
Машамеч,blackscar,760,warrior,arms,30,8,22
Ceteris,eredar,759,warrior,arms,12,8,4
Legendkév,ravencrest,759,warrior,arms,24,8,16
Stallion,blackmoore,758,warrior,arms,30,8,22
Kãzzgot,burning-legion,757,warrior,arms,18,8,10
Upturn,ravencrest,757,warrior,arms,24,8,16
Bisøu,marécage-de-zangar,754,warrior,arms,30,8,22
Pappkopf,rexxar,753,warrior,arms,24,8,16
Patriotdk,runetotem,750,warrior,arms,163,64,99
Calipp,die-aldor,750,warrior,arms,24,8,16
Ètc,ravencrest,749,warrior,arms,25,11,14
Chrisred,dun-modr,748,warrior,arms,12,8,4
Shadrassil,eonar,747,warrior,arms,18,8,10
Galidras,nemesis,747,warrior,arms,29,8,21
Короноварус,greymane,746,warrior,arms,138,62,76
Furraxx,elune,736,warrior,arms,18,8,10
Irontouch,draenor,735,warrior,arms,11,8,3
Demonstðrm,silvermoon,735,warrior,arms,22,8,14
Hazzaogx,draenor,735,warrior,arms,23,8,15
Eltaré,hyjal,734,warrior,arms,14,9,5
Megaloddon,ravencrest,734,warrior,arms,17,8,9
Madict,outland,733,warrior,arms,18,8,10
Lebengtc,stormscale,732,warrior,arms,23,8,15
Boek,drakthul,729,warrior,arms,32,9,23
Koruds,outland,720,warrior,arms,15,8,7
Incompetent,twisting-nether,719,warrior,arms,21,8,13
Renji,proudmoore,718,warrior,arms,17,8,9
Chidòri,tarren-mill,718,warrior,arms,20,9,11
Gorlosh,eredar,718,warrior,arms,20,9,11
Joblôb,guldan,717,warrior,arms,15,9,6
Железныйбард,gordunni,717,warrior,arms,23,8,15
Brutariz,silvermoon,716,warrior,arms,30,12,18
Ahlda,hyjal,716,warrior,arms,27,8,19
Rezume,ravencrest,712,warrior,arms,26,9,17
Aùrora,frostmourne,712,warrior,arms,36,11,25
Knownwarrior,antonidas,711,warrior,arms,21,9,12
Scarlettjo,outland,704,warrior,arms,28,8,20
Ferv,tarren-mill,703,warrior,arms,17,8,9
Goringbame,draenor,703,warrior,arms,20,8,12
Warbek,tarren-mill,703,warrior,arms,20,8,12
Рударим,gordunni,702,warrior,arms,20,8,12
Daxhter,sanguino,702,warrior,arms,20,8,12
Isoton,kazzak,702,warrior,arms,20,8,12
Bulwork,blackhand,702,warrior,arms,22,8,14
Parabellum,dun-modr,701,warrior,arms,14,8,6
Stratic,blackmoore,697,warrior,arms,26,8,18
Melców,eredar,687,warrior,arms,11,8,3
Punishers,ysondre,687,warrior,arms,368,148,220
Bendeur,ysondre,686,warrior,arms,13,8,5
Pemex,stormreaver,686,warrior,arms,13,8,5
Жекабустер,borean-tundra,685,warrior,arms,13,8,5
Аскольд,deathguard,679,warrior,arms,32,11,21
Kriegsfürsti,antonidas,672,warrior,arms,12,7,5
Nalanis,stormreaver,672,warrior,arms,12,7,5
Cleppepx,blackmoore,672,warrior,arms,12,7,5
Ryse,nemesis,672,warrior,arms,12,7,5
Bta,burning-legion,672,warrior,arms,12,7,5
Mauser,thrall,672,warrior,arms,12,7,5
Trembolonio,sanguino,672,warrior,arms,12,7,5
Morkzul,sanguino,672,warrior,arms,12,7,5
Antïsøcial,thrall,672,warrior,arms,12,7,5
Utz,blackrock,672,warrior,arms,12,7,5
Рандомвар,howling-fjord,672,warrior,arms,12,7,5
Zelii,ravencrest,672,warrior,arms,12,7,5
Динамикс,soulflayer,672,warrior,arms,12,7,5
Masakerr,ragnaros,672,warrior,arms,12,7,5
Bubawarrior,silvermoon,672,warrior,arms,12,7,5
Хашонвар,gordunni,672,warrior,arms,12,7,5
Orelus,darkspear,672,warrior,arms,12,7,5
Shînsø,dalaran,672,warrior,arms,12,7,5
Korvan,frostwolf,672,warrior,arms,12,7,5
Tandrak,ravencrest,672,warrior,arms,12,7,5
Thirad,shattered-hand,672,warrior,arms,12,7,5
Lisera,thrall,672,warrior,arms,12,7,5
Джераса,borean-tundra,672,warrior,arms,12,7,5
Cruor,stormscale,672,warrior,arms,12,7,5
Chabonara,blackmoore,672,warrior,arms,12,7,5
Chazbo,arakarahm,672,warrior,arms,12,7,5
Ragelol,aegwynn,672,warrior,arms,12,7,5
Fearmyrage,ragnaros,672,warrior,arms,12,7,5
Chuck,ravencrest,672,warrior,arms,12,7,5
Engalxsol,tarren-mill,672,warrior,arms,12,7,5
Neismz,hyjal,672,warrior,arms,12,7,5
Cleavnseagal,ravencrest,672,warrior,arms,12,7,5
Gannondork,sunstrider,672,warrior,arms,12,7,5
Thebigtosco,ravencrest,672,warrior,arms,12,7,5
Database,blackmoore,672,warrior,arms,12,7,5
Khorage,silvermoon,672,warrior,arms,12,7,5
Azarek,blackmoore,672,warrior,arms,12,7,5
Itsamewario,outland,672,warrior,arms,12,7,5
Bìgre,la-croisade-écarlate,672,warrior,arms,12,7,5
Yoz,uldaman,672,warrior,arms,12,7,5
Iamouz,ravencrest,672,warrior,arms,12,7,5
Kielon,kazzak,672,warrior,arms,12,7,5
Choklatballz,tarren-mill,672,warrior,arms,12,7,5
Smasherx,draenor,672,warrior,arms,12,7,5
Crøwñd,twisting-nether,672,warrior,arms,12,7,5
Jäky,ragnaros,672,warrior,arms,12,7,5
Dangeruos,ragnaros,672,warrior,arms,12,7,5
Bigblackmooh,tarren-mill,672,warrior,arms,12,7,5
Djchmogodx,kazzak,672,warrior,arms,12,7,5
Slâkkxz,outland,672,warrior,arms,12,7,5
Blinkcharge,frostmane,672,warrior,arms,12,7,5
Whitefirecba,dun-modr,672,warrior,arms,12,7,5
Creekwarrior,twisting-nether,672,warrior,arms,12,7,5
Rexagon,blackrock,672,warrior,arms,16,8,8
Yazgah,blackmoore,672,warrior,arms,16,8,8
Sillken,ravencrest,672,warrior,arms,17,8,9
Imroxy,blackrock,672,warrior,arms,18,7,11
Warrieron,stormscale,672,warrior,arms,18,7,11
Sërgi,minahonda,672,warrior,arms,18,7,11
Huxies,draenor,672,warrior,arms,18,7,11
Blacktusk,kazzak,672,warrior,arms,18,7,11
Lalilulelo,argent-dawn,672,warrior,arms,18,7,11
Goinhamx,blackhand,672,warrior,arms,18,7,11
Skullsmasher,stormscale,672,warrior,arms,18,7,11
Лайонхартед,soulflayer,672,warrior,arms,18,7,11
Kamapulya,ravencrest,672,warrior,arms,18,7,11
Wallenschöld,kazzak,672,warrior,arms,18,7,11
Darkwaar,hyjal,672,warrior,arms,18,7,11
Kiha,argent-dawn,672,warrior,arms,18,7,11
Реззи,deathweaver,672,warrior,arms,18,7,11
Delfrion,pozzo-delleternità,672,warrior,arms,18,7,11
Contdem,kazzak,672,warrior,arms,18,7,11
Manký,kazzak,672,warrior,arms,18,7,11
Sgbutcher,khaz-modan,672,warrior,arms,18,7,11
Avelint,burning-blade,672,warrior,arms,18,7,11
Twoonewin,ragnaros,672,warrior,arms,18,7,11
Silencxý,blackrock,672,warrior,arms,18,7,11
Kåïdø,ravencrest,672,warrior,arms,18,7,11
Qwaggie,draenor,672,warrior,arms,18,7,11
Sóuler,blackhand,672,warrior,arms,18,7,11
Warbender,twisting-nether,672,warrior,arms,18,7,11
Xladérz,ravencrest,672,warrior,arms,18,7,11
Resttanis,arathor,672,warrior,arms,18,7,11
Donkypunch,tarren-mill,672,warrior,arms,20,7,13
Pouckette,hyjal,672,warrior,arms,24,7,17
Хохатунчик,gordunni,672,warrior,arms,24,7,17
Durändâl,archimonde,672,warrior,arms,24,7,17
Unßörn,archimonde,672,warrior,arms,24,7,17
Fullepixx,outland,672,warrior,arms,24,7,17
Лафтэйл,soulflayer,672,warrior,arms,24,7,17
Syfér,grim-batol,672,warrior,arms,24,7,17
Vøidwalker,ragnaros,672,warrior,arms,24,7,17
Jigs,twisting-nether,672,warrior,arms,29,7,22
Gôrilla,kazzak,672,warrior,arms,30,7,23
Nemár,arathor,671,warrior,arms,12,7,5
Schneklinge,blutkessel,671,warrior,arms,12,7,5
Greifax,eredar,671,warrior,arms,12,7,5
Vez,arathor,671,warrior,arms,12,7,5
Valí,drakthul,671,warrior,arms,12,7,5
Dukhe,sanguino,671,warrior,arms,12,7,5
Sakidx,dun-modr,671,warrior,arms,12,7,5
Exether,auchindoun,671,warrior,arms,12,7,5
Gamôrà,eitrigg,671,warrior,arms,12,7,5
Вбубенбахен,gordunni,671,warrior,arms,12,7,5
Сайлентлайтх,soulflayer,671,warrior,arms,12,7,5
Lvpodvcio,nemesis,671,warrior,arms,12,7,5
Dosenbier,gorgonnash,671,warrior,arms,12,7,5
Hades,kazzak,671,warrior,arms,12,7,5
Wårlord,ragnaros,671,warrior,arms,12,7,5
Escà,archimonde,671,warrior,arms,12,7,5
Remylacroix,blackrock,671,warrior,arms,12,7,5
Bulletpants,argent-dawn,671,warrior,arms,12,7,5
Когарт,gordunni,671,warrior,arms,12,7,5
Aëne,kirin-tor,671,warrior,arms,12,7,5
Stèalthy,stormscale,671,warrior,arms,12,7,5
Hashokx,draenor,671,warrior,arms,12,7,5
Reykingar,outland,671,warrior,arms,12,7,5
Morningstarr,malganis,671,warrior,arms,12,7,5
Schawar,draenor,671,warrior,arms,12,7,5
Svobodabigz,draenor,671,warrior,arms,12,7,5
Zywarrior,silvermoon,671,warrior,arms,12,7,5
Дисфория,soulflayer,671,warrior,arms,15,8,7
Akorax,frostwolf,671,warrior,arms,16,8,8
Frimpongz,arathor,671,warrior,arms,18,7,11
Кингкраш,gordunni,671,warrior,arms,18,7,11
Peppica,draenor,671,warrior,arms,18,7,11
Salsetti,nemesis,671,warrior,arms,18,7,11
Haris,malganis,671,warrior,arms,18,7,11
Donczaszka,turalyon,671,warrior,arms,18,7,11
Sydre,nerathor,671,warrior,arms,18,7,11
Авентин,lich-king,671,warrior,arms,18,7,11
Segovaxx,twisting-nether,671,warrior,arms,18,7,11
Eyolf,thunderhorn,671,warrior,arms,18,7,11
Voldyh,draenor,671,warrior,arms,18,7,11
Sanykwarrior,ragnaros,671,warrior,arms,18,7,11
Khara,frostwolf,671,warrior,arms,18,7,11
Плечастый,blackscar,671,warrior,arms,18,7,11
Билатерал,howling-fjord,671,warrior,arms,18,7,11
Intíkam,alleria,671,warrior,arms,18,7,11
Kishkamen,ravencrest,671,warrior,arms,18,7,11
Kattyparry,tarren-mill,671,warrior,arms,18,7,11
Porkchop,tarren-mill,671,warrior,arms,18,7,11
Ордоминимус,gordunni,671,warrior,arms,18,7,11
Qurujaa,kirin-tor,671,warrior,arms,18,7,11
Wentylator,silvermoon,671,warrior,arms,18,7,11
Jeyay,defias-brotherhood,671,warrior,arms,18,7,11
Darriuso,kazzak,671,warrior,arms,18,7,11
Meganna,ravenholdt,671,warrior,arms,18,7,11
Acudam,stormscale,671,warrior,arms,18,7,11
Futtekriger,ravencrest,671,warrior,arms,21,8,13
Aeons,darksorrow,671,warrior,arms,24,7,17
Ketschup,frostwolf,671,warrior,arms,24,7,17
Сышиш,greymane,671,warrior,arms,24,7,17
Jerololz,dun-modr,671,warrior,arms,24,7,17
Fracto,draenor,671,warrior,arms,24,7,17
Rïven,los-errantes,671,warrior,arms,24,7,17
Sadex,blackmoore,671,warrior,arms,24,7,17
Waelkøh,hyjal,670,warrior,arms,13,8,5
Gimor,ravencrest,670,warrior,arms,12,7,5
Xzaman,blackrock,670,warrior,arms,12,7,5
Lightit,aegwynn,670,warrior,arms,12,7,5
Eldfast,bladefist,670,warrior,arms,12,7,5
Haymaker,auchindoun,670,warrior,arms,12,7,5
Grunwi,burning-legion,670,warrior,arms,12,7,5
Cortix,blackmoore,670,warrior,arms,16,8,8
Tartadwarf,blackhand,670,warrior,arms,18,7,11
Adyx,the-maelstrom,670,warrior,arms,18,7,11
Grafted,argent-dawn,670,warrior,arms,18,7,11
Dâmso,archimonde,670,warrior,arms,18,7,11
Therapyst,sylvanas,670,warrior,arms,18,7,11
Pattrock,blackmoore,670,warrior,arms,18,7,11
Sibbo,destromath,670,warrior,arms,18,7,11
Cesaro,blackhand,670,warrior,arms,18,7,11
Чсвпони,blackscar,670,warrior,arms,24,7,17
Raminax,turalyon,670,warrior,arms,24,7,17
Гениауч,eversong,670,warrior,arms,30,7,23
Laude,ragnaros,669,warrior,arms,12,7,5
Meywara,blackhand,669,warrior,arms,12,7,5
Rivelan,argent-dawn,669,warrior,arms,12,7,5
Index,tarren-mill,669,warrior,arms,18,7,11
Slappie,kiljaeden,669,warrior,arms,18,7,11
Mistäke,les-sentinelles,669,warrior,arms,18,7,11
Tf,kazzak,669,warrior,arms,24,7,17
Justawarrior,twisting-nether,669,warrior,arms,24,7,17
Mistafleex,hyjal,669,warrior,arms,24,7,17
Méfiat,hyjal,668,warrior,arms,12,7,5
Kavorkxen,argent-dawn,668,warrior,arms,12,7,5
Árkantos,ravencrest,668,warrior,arms,12,7,5
Demirkol,outland,668,warrior,arms,15,8,7
Yeijing,culte-de-la-rive-noire,668,warrior,arms,18,7,11
Bjornalf,silvermoon,668,warrior,arms,18,7,11
Releave,draenor,668,warrior,arms,18,7,11
Blockheed,arathor,668,warrior,arms,18,7,11
Woukong,blackmoore,668,warrior,arms,18,7,11
Agriokolos,stormscale,668,warrior,arms,24,7,17
Varzica,twilights-hammer,668,warrior,arms,24,7,17
Axecuters,frostmane,667,warrior,arms,12,7,5
Papati,twisting-nether,667,warrior,arms,18,7,11
Sorgim,dethecus,667,warrior,arms,24,7,17
Bulldozer,frostmourne,667,warrior,arms,30,7,23
Furiax,dalaran,666,warrior,arms,12,7,5
Djhauge,ravencrest,664,warrior,arms,24,7,17
Rimz,blackmoore,663,warrior,arms,18,7,11
Robthebruce,ravencrest,660,warrior,arms,18,7,11
Wärlør,ravencrest,657,warrior,arms,28,10,18
Zuit,blackmoore,655,warrior,arms,17,7,10
Paaki,archimonde,655,warrior,arms,23,7,16
Rutenos,drakthul,649,warrior,arms,18,7,11
Mocka,veknilash,640,warrior,arms,16,7,9
Woterz,twisting-nether,640,warrior,arms,22,7,15
Kaithar,sanguino,638,warrior,arms,16,7,9
Манарет,gordunni,638,warrior,arms,17,7,10
Xiny,blackrock,638,warrior,arms,17,7,10
Pimagnum,stormscale,638,warrior,arms,17,7,10
Eltitoyayo,dun-modr,633,warrior,arms,17,7,10
Kakahuete,tarren-mill,624,warrior,arms,15,7,8
Bloodeater,sylvanas,623,warrior,arms,15,7,8
Grunkor,eldrethalas,623,warrior,arms,17,7,10
Vaxillium,argent-dawn,621,warrior,arms,17,7,10
Deadwily,twisting-nether,619,warrior,arms,20,8,12
Ельмара,gordunni,615,warrior,arms,27,9,18
Exekz,hyjal,607,warrior,arms,14,7,7
Facepálm,kazzak,607,warrior,arms,14,7,7
Matatorero,uldum,607,warrior,arms,21,7,14
Kegslayer,darksorrow,605,warrior,arms,14,7,7
Pizdicä,twisting-nether,605,warrior,arms,18,8,10
Rhxy,burning-legion,605,warrior,arms,16,7,9
Babyfuryo,kazzak,591,warrior,arms,13,7,6
Olriksen,dentarg,590,warrior,arms,19,8,11
Hitzo,draenor,576,warrior,arms,6,6,0
Watergate,ysondre,576,warrior,arms,6,6,0
Selký,outland,576,warrior,arms,6,6,0
Grrpow,sanguino,576,warrior,arms,6,6,0
Ragebrand,ravencrest,576,warrior,arms,6,6,0
Møonsz,ravencrest,576,warrior,arms,6,6,0
Nastywarrior,burning-legion,576,warrior,arms,12,6,6
Grímgor,aegwynn,576,warrior,arms,12,6,6
Hacci,ragnaros,576,warrior,arms,12,6,6
Долирия,gordunni,576,warrior,arms,12,6,6
Reshnak,die-todeskrallen,576,warrior,arms,12,6,6
Kirmizikafa,twisting-nether,576,warrior,arms,12,6,6
Toscow,ravencrest,576,warrior,arms,12,6,6
Mogguh,tarren-mill,576,warrior,arms,12,6,6
Frayghast,ravencrest,576,warrior,arms,12,6,6
Motx,blackmoore,576,warrior,arms,12,6,6
Jeqqu,bloodfeather,576,warrior,arms,12,6,6
Shorane,varimathras,576,warrior,arms,12,6,6
Begotten,stormscale,576,warrior,arms,12,6,6
Nørst,draenor,576,warrior,arms,12,6,6
Tùcky,ysondre,576,warrior,arms,12,6,6
Нерморрог,howling-fjord,576,warrior,arms,12,6,6
Skullbash,outland,576,warrior,arms,12,6,6
Nialihau,ysondre,576,warrior,arms,12,6,6
Rakhaldin,blackhand,576,warrior,arms,12,6,6
Noout,elune,576,warrior,arms,12,6,6
Äsgeïr,archimonde,576,warrior,arms,12,6,6
Slám,burning-legion,576,warrior,arms,12,6,6
Mauricet,elune,576,warrior,arms,12,6,6
Fankululu,kragjin,576,warrior,arms,12,6,6
Terisá,blackmoore,576,warrior,arms,12,6,6
Hycate,blackrock,576,warrior,arms,12,6,6
Vakios,confrérie-du-thorium,576,warrior,arms,12,6,6
Yuuta,ravencrest,576,warrior,arms,12,6,6
Neverfear,aegwynn,576,warrior,arms,12,6,6
Tirex,stormscale,576,warrior,arms,12,6,6
Радомель,gordunni,576,warrior,arms,12,6,6
Mindblind,ravencrest,576,warrior,arms,12,6,6
Finmajor,frostwhisper,576,warrior,arms,12,6,6
Freddio,tarren-mill,576,warrior,arms,12,6,6
Rianhh,tarren-mill,576,warrior,arms,12,6,6
Teysh,aggramar,576,warrior,arms,12,6,6
Darkseid,burning-legion,576,warrior,arms,12,6,6
Urmankey,kazzak,576,warrior,arms,12,6,6
Warriur,outland,576,warrior,arms,12,6,6
Kalym,malygos,576,warrior,arms,12,6,6
Fantorgass,drakthul,576,warrior,arms,12,6,6
Domixs,blackhand,576,warrior,arms,12,6,6
Kleckzz,blackmoore,576,warrior,arms,12,6,6
Летакс,fordragon,576,warrior,arms,12,6,6
Хэрест,gordunni,576,warrior,arms,12,6,6
Galous,burning-blade,576,warrior,arms,12,6,6
Hørdiiwar,ravencrest,576,warrior,arms,12,6,6
Torgath,kirin-tor,576,warrior,arms,12,6,6
Brutalizar,draenor,576,warrior,arms,12,6,6
Erawar,kirin-tor,576,warrior,arms,12,6,6
Zabrona,turalyon,576,warrior,arms,12,6,6
Fruitstick,tarren-mill,576,warrior,arms,12,6,6
Extrémex,stormscale,576,warrior,arms,12,6,6
Наомирассел,gordunni,576,warrior,arms,12,6,6
Madswarr,tarren-mill,576,warrior,arms,12,6,6
Zaddi,blackrock,576,warrior,arms,12,6,6
Devorta,ysondre,576,warrior,arms,12,6,6
Gromvar,draenor,576,warrior,arms,12,6,6
Waranach,drakthul,576,warrior,arms,12,6,6
Жмувихрь,howling-fjord,576,warrior,arms,12,6,6
Gember,silvermoon,576,warrior,arms,12,6,6
Skelash,blackhand,576,warrior,arms,12,6,6
Coolaa,kazzak,576,warrior,arms,12,6,6
Brutarius,scarshield-legion,576,warrior,arms,12,6,6
Psychðtïc,archimonde,576,warrior,arms,12,6,6
Dajnatarcze,burning-legion,576,warrior,arms,12,6,6
Fonky,sylvanas,576,warrior,arms,12,6,6
Bourbimrgllr,hyjal,576,warrior,arms,12,6,6
Leetzorz,aszune,576,warrior,arms,12,6,6
Thegullet,draenor,576,warrior,arms,12,6,6
Ветросвист,gordunni,576,warrior,arms,12,6,6
Víoceptíon,blackrock,576,warrior,arms,12,6,6
Titanstriker,silvermoon,576,warrior,arms,12,6,6
Belov,hyjal,576,warrior,arms,12,6,6
Lucywar,ravencrest,576,warrior,arms,12,6,6
Сосопав,howling-fjord,576,warrior,arms,12,6,6
Xqt,laughing-skull,576,warrior,arms,12,6,6
Pantsonfire,blackmoore,576,warrior,arms,12,6,6
Solairexc,ravencrest,576,warrior,arms,12,6,6
Bindcry,ahnqiraj,576,warrior,arms,12,6,6
Bimoje,stormscale,576,warrior,arms,12,6,6
Kházad,proudmoore,576,warrior,arms,12,6,6
Lacos,drakthul,576,warrior,arms,12,6,6
Сильваняшка,gordunni,576,warrior,arms,12,6,6
Дестингл,gordunni,576,warrior,arms,15,7,8
Громмашенька,howling-fjord,576,warrior,arms,13,6,7
Jivua,blackrock,576,warrior,arms,21,7,14
Durag,argent-dawn,576,warrior,arms,18,6,12
Chadgarrosh,tarren-mill,576,warrior,arms,18,6,12
Vulkân,aerie-peak,576,warrior,arms,18,6,12
Zaximos,twisting-nether,576,warrior,arms,18,6,12
Gregórry,eredar,576,warrior,arms,18,6,12
Maxisback,ysondre,576,warrior,arms,18,6,12
Реклэсс,blackscar,576,warrior,arms,18,6,12
Chazeryu,stormreaver,576,warrior,arms,18,6,12
Bladestormxx,blackmoore,576,warrior,arms,18,6,12
Lakri,chants-éternels,576,warrior,arms,18,6,12
Møgwai,sanguino,576,warrior,arms,18,6,12
Aedanath,dragonblight,576,warrior,arms,18,6,12
Noonoo,silvermoon,576,warrior,arms,18,6,12
Повстер,howling-fjord,576,warrior,arms,18,6,12
Späns,ragnaros,576,warrior,arms,18,6,12
Debiljov,ahnqiraj,576,warrior,arms,18,6,12
Ragoar,blackmoore,576,warrior,arms,18,6,12
Thismetasuck,ravencrest,576,warrior,arms,18,6,12
Béarnais,khaz-modan,576,warrior,arms,18,6,12
Jailbâit,baelgun,576,warrior,arms,18,6,12
Щекорез,soulflayer,576,warrior,arms,18,6,12
Kenet,tarren-mill,576,warrior,arms,18,6,12
Progresslol,tarren-mill,576,warrior,arms,18,6,12
Grâkul,twisting-nether,576,warrior,arms,18,6,12
Thuundeer,defias-brotherhood,576,warrior,arms,18,6,12
Ój,ravencrest,576,warrior,arms,18,6,12
Wangalang,ravencrest,576,warrior,arms,24,6,18
Cødi,antonidas,576,warrior,arms,24,6,18
Старыйклоп,blackscar,576,warrior,arms,24,6,18
Luckysop,chants-éternels,576,warrior,arms,24,6,18
Stalkom,elune,575,warrior,arms,6,6,0
Crocodìle,magtheridon,575,warrior,arms,6,6,0
Imafk,darksorrow,575,warrior,arms,12,6,6
Sígmar,die-ewige-wacht,575,warrior,arms,12,6,6
Citrok,dun-modr,575,warrior,arms,12,6,6
Акози,fordragon,575,warrior,arms,12,6,6
Waron,dalaran,575,warrior,arms,12,6,6
Kelrior,dun-modr,575,warrior,arms,12,6,6
Ràgnàmetàl,tarren-mill,575,warrior,arms,12,6,6
Pector,grim-batol,575,warrior,arms,12,6,6
Calwar,sanguino,575,warrior,arms,12,6,6
Thorast,argent-dawn,575,warrior,arms,12,6,6
Lunath,stormscale,575,warrior,arms,12,6,6
Saevitius,aegwynn,575,warrior,arms,12,6,6
Bzezita,hyjal,575,warrior,arms,12,6,6
Диктаторвар,soulflayer,575,warrior,arms,12,6,6
Бэдбрэйнс,soulflayer,575,warrior,arms,12,6,6
Bobleeragnar,ravencrest,575,warrior,arms,12,6,6
Phoboss,bloodhoof,575,warrior,arms,12,6,6
Армирован,howling-fjord,575,warrior,arms,12,6,6
Тханирох,howling-fjord,575,warrior,arms,12,6,6
Uwazu,kazzak,575,warrior,arms,12,6,6
Thráll,aszune,575,warrior,arms,12,6,6
Fótm,sylvanas,575,warrior,arms,12,6,6
Paísley,blackrock,575,warrior,arms,12,6,6
Ghostlord,dunemaul,575,warrior,arms,12,6,6
Dexter,outland,575,warrior,arms,12,6,6
Stradgedy,silvermoon,575,warrior,arms,12,6,6
Suicidia,outland,575,warrior,arms,12,6,6
Djpuggerino,outland,575,warrior,arms,12,6,6
Scârath,eredar,575,warrior,arms,12,6,6
Nefa,sylvanas,575,warrior,arms,12,6,6
Khuzz,hyjal,575,warrior,arms,12,6,6
Beyondmeta,twisting-nether,575,warrior,arms,12,6,6
Brávéheart,ravencrest,575,warrior,arms,12,6,6
Rawi,antonidas,575,warrior,arms,12,6,6
Zuroq,antonidas,575,warrior,arms,15,7,8
Stompare,tarren-mill,575,warrior,arms,15,6,9
Chakota,runetotem,575,warrior,arms,15,6,9
Furymeep,outland,575,warrior,arms,18,6,12
Letha,twisting-nether,575,warrior,arms,18,6,12
Critycall,drakthul,575,warrior,arms,18,6,12
Skulltakerx,draenor,575,warrior,arms,18,6,12
Rearar,burning-legion,575,warrior,arms,18,6,12
Potatoslam,twisting-nether,575,warrior,arms,18,6,12
Onga,frostwolf,575,warrior,arms,18,6,12
Awares,blackmoore,575,warrior,arms,18,6,12
Haldrium,malganis,575,warrior,arms,18,6,12
Rezail,silvermoon,575,warrior,arms,18,6,12
Rubyodin,tarren-mill,575,warrior,arms,18,6,12
Unga,zuljin,575,warrior,arms,18,6,12
Ysmay,dun-morogh,575,warrior,arms,18,6,12
Pnizsz,draenor,575,warrior,arms,24,6,18
Taei,argent-dawn,575,warrior,arms,24,6,18
Manqk,drakthul,575,warrior,arms,24,6,18
Greensmash,hyjal,574,warrior,arms,12,6,6
Nostrawolf,sylvanas,574,warrior,arms,12,6,6
Maxeyn,kazzak,574,warrior,arms,27,7,20
Sztixi,silvermoon,574,warrior,arms,24,6,18
Prôtectore,hyjal,573,warrior,arms,12,6,6
Sallcon,khaz-modan,573,warrior,arms,13,6,7
Eriqua,archimonde,573,warrior,arms,20,6,14
Phosphonian,outland,573,warrior,arms,24,6,18
Jôst,rexxar,572,warrior,arms,12,6,6
Oombac,lordaeron,572,warrior,arms,12,6,6
Årxex,stormscale,572,warrior,arms,12,6,6
Raduriel,antonidas,571,warrior,arms,12,6,6
Laeràzh,archimonde,571,warrior,arms,12,6,6
Silkismooth,twisting-nether,571,warrior,arms,12,6,6
Mìlo,ravencrest,571,warrior,arms,18,6,12
Xavs,grim-batol,571,warrior,arms,18,6,12
Evorian,conseil-des-ombres,571,warrior,arms,27,7,20
Lezuuziusz,ragnaros,571,warrior,arms,24,6,18
Aethwa,stormscale,568,warrior,arms,12,6,6
Wïnqlùlz,archimonde,564,warrior,arms,36,6,30
Rãgè,tarren-mill,559,warrior,arms,17,6,11
Pillu,stormscale,544,warrior,arms,16,6,10
Krasark,blackmoore,544,warrior,arms,16,6,10
Wahney,thrall,543,warrior,arms,8,7,1
Coldbanê,blackmoore,543,warrior,arms,8,7,1
Omaahton,magtheridon,543,warrior,arms,11,6,5
Соплезоид,howling-fjord,543,warrior,arms,14,7,7
Чикенсы,gordunni,543,warrior,arms,16,6,10
Deci,bronzebeard,543,warrior,arms,16,6,10
Krevó,ragnaros,543,warrior,arms,17,6,11
Puppypower,blades-edge,542,warrior,arms,11,6,5
Íchígo,bloodhoof,542,warrior,arms,17,6,11
Cowon,stormscale,539,warrior,arms,14,7,7
Xiennas,stormscale,529,warrior,arms,24,11,13
Kåñéthy,outland,528,warrior,arms,15,7,8
Imabeatyoass,kazzak,527,warrior,arms,11,6,5
Schlopp,teldrassil,527,warrior,arms,11,6,5
Манндалорец,gordunni,527,warrior,arms,15,6,9
Rexü,dun-modr,527,warrior,arms,17,6,11
Furygoat,draenor,526,warrior,arms,11,6,5
Darkbrutal,archimonde,526,warrior,arms,17,6,11
Ðíñøðøng,ravencrest,522,warrior,arms,16,7,9
Ressolwen,silvermoon,522,warrior,arms,23,7,16
Nuckii,antonidas,521,warrior,arms,21,7,14
Thorzaram,argent-dawn,521,warrior,arms,26,7,19
Ðæðlý,ravencrest,512,warrior,arms,16,6,10
Dzamtule,ravencrest,511,warrior,arms,8,6,2
Гвиневич,blackscar,511,warrior,arms,11,6,5
Crippaooga,tarren-mill,511,warrior,arms,17,7,10
Sorô,antonidas,511,warrior,arms,16,6,10
Kimmwar,tarren-mill,510,warrior,arms,16,6,10
Myryna,exodar,510,warrior,arms,20,6,14
Sacros,frostwhisper,496,warrior,arms,13,6,7
Lovehope,stormscale,496,warrior,arms,13,6,7
Marax,spinebreaker,496,warrior,arms,31,6,25
Sémø,thrall,480,warrior,arms,6,5,1
Revoidnvm,blackmoore,480,warrior,arms,6,5,1
Critícalx,kazzak,480,warrior,arms,6,5,1
Konnith,outland,480,warrior,arms,6,5,1
Serbia,blackrock,480,warrior,arms,6,5,1
Hubq,burning-legion,480,warrior,arms,6,5,1
Sajw,tarren-mill,480,warrior,arms,6,5,1
Synix,stormreaver,480,warrior,arms,6,5,1
Lurion,malganis,480,warrior,arms,6,5,1
Tørøg,eredar,480,warrior,arms,6,5,1
Karmaloop,stormscale,480,warrior,arms,6,5,1
Dreamqt,antonidas,480,warrior,arms,6,5,1
Ychro,archimonde,480,warrior,arms,6,5,1
Quateh,silvermoon,480,warrior,arms,6,5,1
Angrytoddler,silvermoon,480,warrior,arms,6,5,1
Mumbojumbo,uldum,480,warrior,arms,6,5,1
Dynther,nemesis,480,warrior,arms,6,5,1
Fvkundercutt,xavius,480,warrior,arms,6,5,1
Rockygifll,sinstralis,480,warrior,arms,6,5,1
Slg,tarren-mill,480,warrior,arms,6,5,1
Murp,lightnings-blade,480,warrior,arms,6,5,1
Suldren,cthun,480,warrior,arms,6,5,1
Tekmali,archimonde,480,warrior,arms,6,5,1
Hópbóp,magtheridon,480,warrior,arms,6,5,1
Tørrminator,stormscale,480,warrior,arms,6,5,1
Nihm,ravencrest,480,warrior,arms,6,5,1
Dunderzug,silvermoon,480,warrior,arms,6,5,1
Гневныйвиги,howling-fjord,480,warrior,arms,6,5,1
Äkzequte,blackhand,480,warrior,arms,8,5,3
Tishues,kazzak,480,warrior,arms,8,5,3
Wardoz,archimonde,480,warrior,arms,12,5,7
Garradoom,stormscale,480,warrior,arms,12,5,7
Zarrgash,blackhand,480,warrior,arms,12,5,7
Mokrakh,blackmoore,480,warrior,arms,12,5,7
Tryitmaxx,blackmoore,480,warrior,arms,12,5,7
Topur,defias-brotherhood,480,warrior,arms,12,5,7
Tharokk,blackmoore,480,warrior,arms,12,5,7
Ïllîçítmêñ,outland,480,warrior,arms,12,5,7
Yìnkxx,blackmoore,480,warrior,arms,12,5,7
Onizukarms,hyjal,480,warrior,arms,12,5,7
Dampbob,draenor,480,warrior,arms,12,5,7
Budwise,stormscale,480,warrior,arms,12,5,7
Ffz,hyjal,480,warrior,arms,12,5,7
Hellomoto,archimonde,480,warrior,arms,12,5,7
Nazrolä,hyjal,480,warrior,arms,12,5,7
Warricious,outland,480,warrior,arms,12,5,7
Niffen,stormscale,480,warrior,arms,12,5,7
Petesnot,outland,480,warrior,arms,12,5,7
Soukha,archimonde,480,warrior,arms,12,5,7
Vitezandro,stormscale,480,warrior,arms,12,5,7
Thravaeg,draenor,480,warrior,arms,12,5,7
Eifachöppis,blackhand,480,warrior,arms,12,5,7
Arakhu,blackmoore,480,warrior,arms,12,5,7
Bullac,blackmoore,480,warrior,arms,12,5,7
Ragingclue,draenor,480,warrior,arms,12,5,7
Touthi,archimonde,480,warrior,arms,12,5,7
Riash,hyjal,480,warrior,arms,12,5,7
Baryna,sanguino,480,warrior,arms,12,5,7
Oplix,antonidas,480,warrior,arms,12,5,7
Nomore,sylvanas,480,warrior,arms,12,5,7
Eyenur,drakthul,480,warrior,arms,12,5,7
Plzdontkite,blackrock,480,warrior,arms,12,5,7
Ansàvage,kazzak,480,warrior,arms,12,5,7
Holloo,destromath,480,warrior,arms,12,5,7
Taskov,tarren-mill,480,warrior,arms,12,5,7
Тэратос,soulflayer,480,warrior,arms,12,5,7
Сашарбгх,soulflayer,480,warrior,arms,12,5,7
Whysobold,quelthalas,480,warrior,arms,12,5,7
Eleborn,tarren-mill,480,warrior,arms,12,5,7
Рыгатрон,galakrond,480,warrior,arms,12,5,7
Xintha,frostwolf,480,warrior,arms,12,5,7
Jamyty,burning-legion,480,warrior,arms,12,5,7
Brasta,malganis,480,warrior,arms,12,5,7
Asintended,draenor,480,warrior,arms,12,5,7
Soe,defias-brotherhood,480,warrior,arms,12,5,7
Oogaboogadps,silvermoon,480,warrior,arms,12,5,7
Victôr,silvermoon,480,warrior,arms,12,5,7
Drumsofwar,zuljin,480,warrior,arms,12,5,7
Abunai,thrall,480,warrior,arms,12,5,7
Анжинерх,gordunni,480,warrior,arms,12,5,7
Drugo,azjolnerub,480,warrior,arms,12,5,7
Marleycx,azshara,480,warrior,arms,12,5,7
Шифик,soulflayer,480,warrior,arms,12,5,7
Irastah,frostmane,480,warrior,arms,12,5,7
Ernexpóc,silvermoon,480,warrior,arms,12,5,7
Lüund,ravencrest,480,warrior,arms,12,5,7
Бейлеор,gordunni,480,warrior,arms,12,5,7
Jurge,twisting-nether,480,warrior,arms,12,5,7
Cuzyxtwo,blackrock,480,warrior,arms,12,5,7
Ðant,kazzak,480,warrior,arms,12,5,7
Slayermaxx,kazzak,480,warrior,arms,12,5,7
Lïyah,eldrethalas,480,warrior,arms,12,5,7
Gothgirlgg,argent-dawn,480,warrior,arms,12,5,7
Matiasek,burning-legion,480,warrior,arms,12,5,7
Borsha,dalaran,480,warrior,arms,12,5,7
Kaarvx,ysondre,480,warrior,arms,12,5,7
Icharge,dunemaul,480,warrior,arms,12,5,7
Lazypeon,burning-legion,480,warrior,arms,12,5,7
Footsies,ragnaros,480,warrior,arms,12,5,7
Rohäc,drakthul,480,warrior,arms,12,5,7
Gigantous,emerald-dream,480,warrior,arms,12,5,7
Grundbulten,tarren-mill,480,warrior,arms,12,5,7
Sidekick,earthen-ring,480,warrior,arms,12,5,7
Ràgê,silvermoon,480,warrior,arms,12,5,7
Deathbleeder,argent-dawn,480,warrior,arms,12,5,7
Garrol,burning-legion,480,warrior,arms,12,5,7
Kiukkuné,argent-dawn,480,warrior,arms,12,5,7
Gorkta,uldaman,480,warrior,arms,12,5,7
Diablous,ragnaros,480,warrior,arms,12,5,7
Эрисихтон,soulflayer,480,warrior,arms,12,5,7
Harrypotta,silvermoon,480,warrior,arms,12,5,7
Skya,burning-blade,480,warrior,arms,12,5,7
Рэйердан,howling-fjord,480,warrior,arms,12,5,7
Snörlax,the-maelstrom,480,warrior,arms,12,5,7
Bradders,tarren-mill,480,warrior,arms,12,5,7
Kramix,thrall,480,warrior,arms,12,5,7
Adamastos,ragnaros,480,warrior,arms,12,5,7
Zirriox,wildhammer,480,warrior,arms,12,5,7
Calibur,emerald-dream,480,warrior,arms,12,5,7
Lippir,stormrage,480,warrior,arms,12,5,7
Baxyra,aegwynn,480,warrior,arms,12,5,7
Jimli,malygos,480,warrior,arms,12,5,7
Síúkanto,blackrock,480,warrior,arms,12,5,7
Gylfanders,the-maelstrom,480,warrior,arms,12,5,7
Pietplofstof,laughing-skull,480,warrior,arms,12,5,7
Karkool,the-maelstrom,480,warrior,arms,12,5,7
Орвинг,soulflayer,480,warrior,arms,12,5,7
Keäghan,kazzak,480,warrior,arms,12,5,7
Thirtynine,daggerspine,480,warrior,arms,12,5,7
Leelazero,argent-dawn,480,warrior,arms,12,5,7
Фэшнполис,soulflayer,480,warrior,arms,12,5,7
Steelstormz,ravencrest,480,warrior,arms,12,5,7
Nekwar,ravencrest,480,warrior,arms,15,6,9
Развалочка,howling-fjord,480,warrior,arms,16,6,10
Bøyka,sinstralis,480,warrior,arms,14,5,9
Flexay,archimonde,480,warrior,arms,18,5,13
Oravedenes,draenor,480,warrior,arms,18,5,13
Stuffed,blackrock,480,warrior,arms,18,5,13
Takagødx,archimonde,480,warrior,arms,18,5,13
Shredded,stormscale,480,warrior,arms,18,5,13
Vardias,pozzo-delleternità,480,warrior,arms,18,5,13
Serratíon,tarren-mill,480,warrior,arms,18,5,13
Sheñ,antonidas,480,warrior,arms,18,5,13
Курящийпро,blackscar,480,warrior,arms,18,5,13
Реграм,eversong,480,warrior,arms,18,5,13
Battusai,outland,480,warrior,arms,18,5,13
Pottomxx,ragnaros,480,warrior,arms,18,5,13
Ijzereter,argent-dawn,480,warrior,arms,18,5,13
Lincwar,stormscale,480,warrior,arms,18,5,13
Auguston,argent-dawn,480,warrior,arms,18,5,13
Hodenhugo,thrall,480,warrior,arms,18,5,13
Sebotagelol,twisting-nether,480,warrior,arms,18,5,13
Kussetrold,outland,480,warrior,arms,18,5,13
Erosdulko,silvermoon,480,warrior,arms,18,5,13
Maowiecki,burning-legion,480,warrior,arms,18,5,13
Unhingéd,stormscale,480,warrior,arms,18,5,13
Exhumator,blackhand,480,warrior,arms,18,5,13
Cryos,destromath,480,warrior,arms,18,5,13
Solgud,bloodfeather,480,warrior,arms,18,5,13
Kalhmeras,twisting-nether,480,warrior,arms,18,5,13
Warriorussy,ravencrest,480,warrior,arms,19,5,14
Jorund,archimonde,480,warrior,arms,24,5,19
Масульмэн,howling-fjord,480,warrior,arms,24,5,19
Zhodd,zuljin,480,warrior,arms,24,5,19
Gnolimits,antonidas,480,warrior,arms,24,5,19
Vhy,antonidas,480,warrior,arms,25,5,20
Quento,anubarak,479,warrior,arms,6,5,1
Xtu,kazzak,479,warrior,arms,6,5,1
Saey,malorne,479,warrior,arms,6,5,1
Ghorgutz,kazzak,479,warrior,arms,12,5,7
Meresin,madmortem,479,warrior,arms,12,5,7
Swtparanoid,sylvanas,479,warrior,arms,12,5,7
Dragonforce,blackmoore,479,warrior,arms,12,5,7
Kakero,bronzebeard,479,warrior,arms,12,5,7
Firethunder,burning-legion,479,warrior,arms,12,5,7
Relüx,ragnaros,479,warrior,arms,12,5,7
Fréyaá,blackrock,479,warrior,arms,12,5,7
Einhérjer,thrall,479,warrior,arms,12,5,7
Grèèn,turalyon,479,warrior,arms,12,5,7
Górgutz,defias-brotherhood,479,warrior,arms,12,5,7
Svinks,sylvanas,479,warrior,arms,12,5,7
Gucchy,nemesis,479,warrior,arms,12,5,7
Dúg,tarren-mill,479,warrior,arms,12,5,7
Maxilanthis,eonar,479,warrior,arms,12,5,7
Спарттанка,gordunni,479,warrior,arms,12,5,7
Tötø,archimonde,479,warrior,arms,12,5,7
Пушкабамби,soulflayer,479,warrior,arms,21,6,15
Модныйклык,eversong,479,warrior,arms,18,5,13
Kenpachis,magtheridon,479,warrior,arms,18,5,13
Hepos,quelthalas,479,warrior,arms,18,5,13
Ravedeath,tarren-mill,479,warrior,arms,18,5,13
Ghaze,blackhand,479,warrior,arms,18,5,13
Happynoobs,silvermoon,479,warrior,arms,18,5,13
Auggies,outland,479,warrior,arms,18,5,13
Crazymax,stormscale,479,warrior,arms,18,5,13
Lazaron,tarren-mill,479,warrior,arms,19,5,14
Tafala,blackmoore,478,warrior,arms,6,5,1
Ghorinchai,khazgoroth,478,warrior,arms,12,5,7
Farxy,dun-modr,478,warrior,arms,12,5,7
Orcil,terenas,478,warrior,arms,12,5,7
Olkowski,silvermoon,478,warrior,arms,12,5,7
Nightmareb,magtheridon,478,warrior,arms,12,5,7
Poronga,sanguino,478,warrior,arms,18,5,13
Swordluw,argent-dawn,478,warrior,arms,18,5,13
Sahaminho,draenor,478,warrior,arms,18,5,13
Нириэла,howling-fjord,478,warrior,arms,18,5,13
Лидоний,gordunni,477,warrior,arms,12,5,7
Nierninwa,silvermoon,477,warrior,arms,12,5,7
Kolgrimor,blackhand,477,warrior,arms,12,5,7
Kennesáw,draenor,477,warrior,arms,12,5,7
Olagkhan,minahonda,476,warrior,arms,10,6,4
Sheriff,dragonblight,475,warrior,arms,12,5,7
Awárøn,aegwynn,473,warrior,arms,12,5,7
Peterli,norgannon,472,warrior,arms,12,5,7
Kratosz,magtheridon,472,warrior,arms,27,7,20
Arnorlld,antonidas,471,warrior,arms,12,5,7
Ejecute,minahonda,470,warrior,arms,18,5,13
Lockdwn,kazzak,468,warrior,arms,18,5,13
Bismárck,nathrezim,457,warrior,arms,17,7,10
Duarel,blackmoore,448,warrior,arms,10,5,5
Zugzuhg,draenor,447,warrior,arms,8,6,2
Kviqr,auchindoun,447,warrior,arms,11,5,6
Takethisduck,stormscale,447,warrior,arms,11,5,6
Kôtarô,blackmoore,447,warrior,arms,17,5,12
Чпонькмашина,soulflayer,447,warrior,arms,17,5,12
Onizukawar,archimonde,447,warrior,arms,17,5,12
Kitano,garona,447,warrior,arms,23,5,18
Pétin,kaelthas,446,warrior,arms,17,5,12
Orkyu,stormrage,444,warrior,arms,11,5,6
Turdgurgler,executus,431,warrior,arms,11,5,6
Инфлэймх,gordunni,431,warrior,arms,11,5,6
Cowbatant,darkspear,431,warrior,arms,14,5,9
Toqk,draenor,426,warrior,arms,13,6,7
Mukcho,sylvanas,426,warrior,arms,15,6,9
Goreksson,aegwynn,426,warrior,arms,15,6,9
Leizey,stormscale,426,warrior,arms,15,6,9
Lilsib,outland,426,warrior,arms,19,6,13
Myshu,ravencrest,426,warrior,arms,20,6,14
Knî,archimonde,426,warrior,arms,21,6,15
Kìrìtosan,pozzo-delleternità,415,warrior,arms,8,5,3
Kylian,aegwynn,415,warrior,arms,11,5,6
Mat,outland,415,warrior,arms,11,5,6
Suduri,drakthul,415,warrior,arms,14,5,9
Danx,culte-de-la-rive-noire,413,warrior,arms,16,5,11
Casstageul,archimonde,400,warrior,arms,7,5,2
Varkoz,sylvanas,400,warrior,arms,7,5,2
Justah,silvermoon,400,warrior,arms,13,5,8
Sveafy,ravencrest,384,warrior,arms,6,4,2
Közel,bladefist,384,warrior,arms,6,4,2
Геролт,galakrond,384,warrior,arms,6,4,2
Eytra,ravencrest,384,warrior,arms,6,4,2
Darkel,chogall,384,warrior,arms,6,4,2
Ottokerñ,kazzak,384,warrior,arms,6,4,2
Ddfxz,draenor,384,warrior,arms,6,4,2
Zeó,silvermoon,384,warrior,arms,6,4,2
Jinró,ravencrest,384,warrior,arms,6,4,2
Bottekraker,magtheridon,384,warrior,arms,6,4,2
Slante,darksorrow,384,warrior,arms,6,4,2
Sucemabanner,hyjal,384,warrior,arms,6,4,2
Bixxi,eredar,384,warrior,arms,6,4,2
Azazelslayer,dethecus,384,warrior,arms,6,4,2
Hellungo,hyjal,384,warrior,arms,6,4,2
Valibunt,drakthul,384,warrior,arms,6,4,2
Frenzerker,outland,384,warrior,arms,6,4,2
Cáráxés,ravencrest,384,warrior,arms,6,4,2
Baluste,culte-de-la-rive-noire,384,warrior,arms,6,4,2
Bládestorm,outland,384,warrior,arms,6,4,2
Kevlarsusan,the-maelstrom,384,warrior,arms,6,4,2
Slamueljcksn,darksorrow,384,warrior,arms,6,4,2
Mayback,pozzo-delleternità,384,warrior,arms,6,4,2
Aliyáhh,blackrock,384,warrior,arms,6,4,2
Тартолан,gordunni,384,warrior,arms,6,4,2
Fîlzlaus,area-52,384,warrior,arms,6,4,2
Alexandriana,veknilash,384,warrior,arms,6,4,2
Khyuzo,nemesis,384,warrior,arms,6,4,2
Tejkopejko,kazzak,384,warrior,arms,6,4,2
Bloodstinger,blackrock,384,warrior,arms,6,4,2
Милаягномка,azuregos,384,warrior,arms,6,4,2
Росана,gordunni,384,warrior,arms,6,4,2
Romoth,kazzak,384,warrior,arms,6,4,2
Гигасмэш,gordunni,384,warrior,arms,6,4,2
Youstupide,drekthar,384,warrior,arms,6,4,2
Kwautkopf,blackhand,384,warrior,arms,6,4,2
Балкарок,howling-fjord,384,warrior,arms,6,4,2
Kyr,bladefist,384,warrior,arms,6,4,2
Susugar,ysondre,384,warrior,arms,6,4,2
Schmackes,terrordar,384,warrior,arms,6,4,2
Slix,dun-modr,384,warrior,arms,6,4,2
Ivâar,archimonde,384,warrior,arms,6,4,2
Smashbrother,eredar,384,warrior,arms,6,4,2
Orcìna,blackrock,384,warrior,arms,6,4,2
Beznacaj,outland,384,warrior,arms,6,4,2
Bruumbrum,blackhand,384,warrior,arms,6,4,2
Sabijach,kazzak,384,warrior,arms,6,4,2
Rzelazko,burning-legion,384,warrior,arms,6,4,2
Nøâh,kazzak,384,warrior,arms,6,4,2
Фиббоначи,deathguard,384,warrior,arms,6,4,2
Agrias,burning-legion,384,warrior,arms,6,4,2
Skahmet,dun-modr,384,warrior,arms,6,4,2
Elsiâs,aegwynn,384,warrior,arms,6,4,2
Asnw,hyjal,384,warrior,arms,6,4,2
Тандеракс,soulflayer,384,warrior,arms,6,4,2
Jessepinkman,kirin-tor,384,warrior,arms,6,4,2
Xtazen,draenor,384,warrior,arms,6,4,2
Virgolibra,grim-batol,384,warrior,arms,6,4,2
ßelugajosh,outland,384,warrior,arms,6,4,2
Tcrunch,dun-modr,384,warrior,arms,6,4,2
Highbuffalo,kazzak,384,warrior,arms,6,4,2
Deadlift,thunderhorn,384,warrior,arms,6,4,2
Rëvenge,burning-legion,384,warrior,arms,6,4,2
Garad,frostmane,384,warrior,arms,6,4,2
Rastaj,defias-brotherhood,384,warrior,arms,6,4,2
Haikyuu,blackhand,384,warrior,arms,6,4,2
Квейкс,gordunni,384,warrior,arms,6,4,2
Shadowcacau,aggra-português,384,warrior,arms,6,4,2
Ironrage,frostmane,384,warrior,arms,6,4,2
Volfenstein,burning-legion,384,warrior,arms,6,4,2
Chmg,kirin-tor,384,warrior,arms,6,4,2
Bámf,outland,384,warrior,arms,6,4,2
Gundal,silvermoon,384,warrior,arms,6,4,2
Alaerion,magtheridon,384,warrior,arms,6,4,2
Eldrian,ragnaros,384,warrior,arms,6,4,2
Dallion,azjolnerub,384,warrior,arms,6,4,2
Kisoshi,tarren-mill,384,warrior,arms,6,4,2
Haîltøkîng,alakir,384,warrior,arms,6,4,2
Swaàg,archimonde,384,warrior,arms,6,4,2
Tìxoz,archimonde,384,warrior,arms,6,4,2
Littlee,durotan,384,warrior,arms,6,4,2
Bóobagodx,tarren-mill,384,warrior,arms,6,4,2
Iamfast,blackmoore,384,warrior,arms,6,4,2
Sweetberries,hyjal,384,warrior,arms,6,4,2
Warzër,archimonde,384,warrior,arms,6,4,2
Thuder,sylvanas,384,warrior,arms,6,4,2
Panexecute,ragnaros,384,warrior,arms,6,4,2
Octtwar,twisting-nether,384,warrior,arms,6,4,2
Pappyza,hyjal,384,warrior,arms,6,4,2
Voi,jaedenar,384,warrior,arms,6,4,2
Alexdgreat,tarren-mill,384,warrior,arms,6,4,2
Dschiraa,anetheron,384,warrior,arms,6,4,2
Rwx,outland,384,warrior,arms,6,4,2
Роудс,soulflayer,384,warrior,arms,6,4,2
Dregodym,frostwolf,384,warrior,arms,6,4,2
Dräparren,ragnaros,384,warrior,arms,6,4,2
Fleshwerk,silvermoon,384,warrior,arms,6,4,2
Brittelin,tarren-mill,384,warrior,arms,6,4,2
Thorbjør,silvermoon,384,warrior,arms,6,4,2
Cyférüs,tarren-mill,384,warrior,arms,6,4,2
Swig,twisting-nether,384,warrior,arms,6,4,2
Fitzgibbons,ravencrest,384,warrior,arms,6,4,2
Ceym,twisting-nether,384,warrior,arms,6,4,2
Schidøri,blackmoore,384,warrior,arms,6,4,2
Zazzu,archimonde,384,warrior,arms,6,4,2
Wïn,silvermoon,384,warrior,arms,6,4,2
Forsi,draenor,384,warrior,arms,6,4,2
Måydåy,twisting-nether,384,warrior,arms,6,4,2
Rimvar,alleria,384,warrior,arms,6,4,2
Rândy,confrérie-du-thorium,384,warrior,arms,9,5,4
Stiefbrudah,blackmoore,384,warrior,arms,9,5,4
Sinimfzugzug,eredar,384,warrior,arms,10,5,5
Merkakis,argent-dawn,384,warrior,arms,15,5,10
Rdeniro,blackmoore,384,warrior,arms,15,5,10
Hiraclès,archimonde,384,warrior,arms,12,4,8
Blackzor,ragnaros,384,warrior,arms,12,4,8
Трапсир,gordunni,384,warrior,arms,12,4,8
Minetaur,burning-legion,384,warrior,arms,12,4,8
Eýoe,ragnaros,384,warrior,arms,12,4,8
Oesche,frostmourne,384,warrior,arms,12,4,8
Mazelion,ambossar,384,warrior,arms,12,4,8
Dataproffs,outland,384,warrior,arms,12,4,8
Yxolike,blackmoore,384,warrior,arms,12,4,8
Parachoque,ragnaros,384,warrior,arms,12,4,8
Reaperet,rexxar,384,warrior,arms,12,4,8
Ланцел,gordunni,384,warrior,arms,12,4,8
Sovax,ravencrest,384,warrior,arms,12,4,8
Claymøre,khaz-modan,384,warrior,arms,12,4,8
Uselessbrø,archimonde,384,warrior,arms,12,4,8
Chickengodx,archimonde,384,warrior,arms,12,4,8
Alphamem,sylvanas,384,warrior,arms,12,4,8
Syel,sinstralis,384,warrior,arms,12,4,8
Hubusan,blackmoore,384,warrior,arms,12,4,8
Azurnok,argent-dawn,384,warrior,arms,12,4,8
Pantava,moonglade,384,warrior,arms,12,4,8
Оптимпрайм,blackscar,384,warrior,arms,12,4,8
Woghard,drakthul,384,warrior,arms,12,4,8
Ceojohnny,ravencrest,384,warrior,arms,12,4,8
Adorlyna,silvermoon,384,warrior,arms,12,4,8
Фаллопиев,borean-tundra,384,warrior,arms,12,4,8
Ryuma,lordaeron,384,warrior,arms,12,4,8
Фрокешер,howling-fjord,384,warrior,arms,12,4,8
Веоленс,gordunni,384,warrior,arms,12,4,8
Spankprooff,kazzak,384,warrior,arms,12,4,8
Zenìa,argent-dawn,384,warrior,arms,12,4,8
Linberg,ysondre,384,warrior,arms,12,4,8
Stragga,eredar,384,warrior,arms,12,4,8
Ðræberen,kazzak,384,warrior,arms,12,4,8
Sugraclap,frostwolf,384,warrior,arms,12,4,8
Арбелоа,gordunni,384,warrior,arms,12,4,8
Waroworgen,terokkar,384,warrior,arms,12,4,8
Ellissari,tirion,384,warrior,arms,12,4,8
Arxnamus,silvermoon,384,warrior,arms,12,4,8
Rfgpwhfgjawr,ravencrest,384,warrior,arms,12,4,8
Cjak,pozzo-delleternità,384,warrior,arms,12,4,8
Nerfslam,stormscale,384,warrior,arms,12,4,8
Evermoon,sanguino,384,warrior,arms,12,4,8
Chargezon,drakthul,384,warrior,arms,12,4,8
Rimedalb,aegwynn,384,warrior,arms,12,4,8
Connorzqt,ravencrest,384,warrior,arms,12,4,8
Flugan,vashj,384,warrior,arms,12,4,8
Kgx,argent-dawn,384,warrior,arms,12,4,8
Bonkors,bronzebeard,384,warrior,arms,12,4,8
Gkhan,draenor,384,warrior,arms,12,4,8
Димаказнь,gordunni,384,warrior,arms,12,4,8
Wilko,twisting-nether,384,warrior,arms,12,4,8
Schultze,kazzak,384,warrior,arms,12,4,8
Xavari,twisting-nether,384,warrior,arms,12,4,8
Utgra,aegwynn,384,warrior,arms,12,4,8
Rkeköke,draenor,384,warrior,arms,12,4,8
Sinkiss,archimonde,384,warrior,arms,12,4,8
Kronner,blackmoore,384,warrior,arms,12,4,8
Winedru,bronzebeard,384,warrior,arms,12,4,8
Mórghúlís,aegwynn,384,warrior,arms,12,4,8
Apemonkeydk,kazzak,384,warrior,arms,12,4,8
Валдеморд,soulflayer,384,warrior,arms,12,4,8
Xállek,veknilash,384,warrior,arms,12,4,8
Xlora,argent-dawn,384,warrior,arms,12,4,8
Trillebårtøm,outland,384,warrior,arms,12,4,8
Heavycrit,ravencrest,384,warrior,arms,12,4,8
Анусбрейкер,soulflayer,384,warrior,arms,12,4,8
Schjøtt,ravencrest,384,warrior,arms,12,4,8
Rastov,argent-dawn,384,warrior,arms,12,4,8
Invictàs,hyjal,384,warrior,arms,12,4,8
Traziel,blackmoore,384,warrior,arms,12,4,8
Zugbigdam,archimonde,384,warrior,arms,12,4,8
Whitebeardx,tarren-mill,384,warrior,arms,12,4,8
Арристокррат,soulflayer,384,warrior,arms,12,4,8
Orciks,drakthul,384,warrior,arms,12,4,8
Mârcxb,antonidas,384,warrior,arms,12,4,8
Ambraxon,blackmoore,384,warrior,arms,12,4,8
Guarn,archimonde,384,warrior,arms,12,4,8
Raikin,aegwynn,384,warrior,arms,12,4,8
Cromash,die-nachtwache,384,warrior,arms,12,4,8
Undatakâh,sanguino,384,warrior,arms,12,4,8
Neozz,ravencrest,384,warrior,arms,12,4,8
Booya,zirkel-des-cenarius,384,warrior,arms,12,4,8
Brrochacho,defias-brotherhood,384,warrior,arms,12,4,8
Mickyrex,hyjal,384,warrior,arms,12,4,8
Taukkì,kazzak,384,warrior,arms,12,4,8
Inflacija,grim-batol,384,warrior,arms,12,4,8
Grombatur,tarren-mill,384,warrior,arms,12,4,8
Karadayii,blackmoore,384,warrior,arms,12,4,8
Huihui,die-aldor,384,warrior,arms,12,4,8
Hammærn,grim-batol,384,warrior,arms,12,4,8
Jesuisgaydsl,archimonde,384,warrior,arms,12,4,8
Luciferkhan,twisting-nether,384,warrior,arms,12,4,8
Craftorar,defias-brotherhood,384,warrior,arms,12,4,8
Дахирарг,fordragon,384,warrior,arms,12,4,8
Péter,arathor,384,warrior,arms,12,4,8
Pushh,dun-modr,384,warrior,arms,12,4,8
Starkz,hellscream,384,warrior,arms,12,4,8
Говяжийвоин,soulflayer,384,warrior,arms,12,4,8
Smashlz,draenor,384,warrior,arms,12,4,8
Raïgã,hyjal,384,warrior,arms,12,4,8
Draur,archimonde,384,warrior,arms,12,4,8
Warriortimi,blackhand,384,warrior,arms,12,4,8
Iiam,kilrogg,384,warrior,arms,12,4,8
Osteskanken,ravencrest,384,warrior,arms,12,4,8
Oglisten,archimonde,384,warrior,arms,12,4,8
Fzit,kazzak,384,warrior,arms,12,4,8
Snorg,defias-brotherhood,384,warrior,arms,12,4,8
Sonyd,tarren-mill,384,warrior,arms,12,4,8
Speiker,blackhand,384,warrior,arms,12,4,8
Taelgorr,draenor,384,warrior,arms,12,4,8
Tyzarwar,draenor,384,warrior,arms,12,4,8
Chrid,silvermoon,384,warrior,arms,12,4,8
Varix,burning-blade,384,warrior,arms,12,4,8
Skyrrskyr,blackrock,384,warrior,arms,12,4,8
Morshak,gorgonnash,384,warrior,arms,12,4,8
Testortv,twisting-nether,384,warrior,arms,12,4,8
Sveñor,the-maelstrom,384,warrior,arms,12,4,8
Ouryuu,hyjal,384,warrior,arms,12,4,8
Raynorwarr,tarren-mill,384,warrior,arms,12,4,8
Poppeyex,silvermoon,384,warrior,arms,12,4,8
Borion,blackmoore,384,warrior,arms,12,4,8
Wildblow,ravencrest,384,warrior,arms,12,4,8
Gromock,the-maelstrom,384,warrior,arms,12,4,8
Brokenrage,twisting-nether,384,warrior,arms,12,4,8
Klunkepumper,ravencrest,384,warrior,arms,12,4,8
Whitewôlf,stormscale,384,warrior,arms,13,4,9
Phalek,ravencrest,384,warrior,arms,14,4,10
Kaij,draenor,384,warrior,arms,18,4,14
Ykabla,dun-modr,384,warrior,arms,18,4,14
Kyorengoku,antonidas,384,warrior,arms,18,4,14
Ilyxw,blackmoore,384,warrior,arms,18,4,14
Pwndrizle,blackmoore,384,warrior,arms,18,4,14
Tadruk,stormscale,384,warrior,arms,18,4,14
Ganaroth,tarren-mill,384,warrior,arms,18,4,14
Дютенфлай,ashenvale,384,warrior,arms,18,4,14
Solidier,archimonde,384,warrior,arms,18,4,14
Syruz,malganis,384,warrior,arms,19,4,15
Vanaxd,blackrock,384,warrior,arms,20,4,16
Wardropeeh,argent-dawn,384,warrior,arms,24,4,20
Реф,gordunni,383,warrior,arms,6,4,2
Angrytmyself,silvermoon,383,warrior,arms,6,4,2
Adelphi,blackrock,383,warrior,arms,6,4,2
Красаучик,razuvious,383,warrior,arms,6,4,2
Mashamasha,twisting-nether,383,warrior,arms,9,5,4
Халиоссф,gordunni,383,warrior,arms,9,5,4
Labbio,antonidas,383,warrior,arms,10,5,5
Квистин,soulflayer,383,warrior,arms,12,4,8
Meetto,argent-dawn,383,warrior,arms,12,4,8
Mäyh,ragnaros,383,warrior,arms,12,4,8
Варзибейра,blackscar,383,warrior,arms,12,4,8
Madbert,drakthul,383,warrior,arms,12,4,8
Askaed,kirin-tor,383,warrior,arms,12,4,8
Guspy,sanguino,383,warrior,arms,12,4,8
Sharrok,blackmoore,383,warrior,arms,12,4,8
Aludarkz,sanguino,383,warrior,arms,12,4,8
Shimy,pozzo-delleternità,383,warrior,arms,12,4,8
Dundee,sanguino,383,warrior,arms,12,4,8
Фикдиш,gordunni,383,warrior,arms,18,4,14
Norbertine,blackhand,383,warrior,arms,18,4,14
Khaczer,thunderhorn,383,warrior,arms,18,4,14
Familyguy,sylvanas,383,warrior,arms,18,4,14
Xonnico,ravencrest,383,warrior,arms,18,4,14
Moshmuffín,blackmoore,383,warrior,arms,24,4,20
Sublexgg,blackrock,1862,warrior,protection,73,37,36
Swagenknecht,blackrock,1795,warrior,protection,299,147,152
Blaying,ravencrest,1668,warrior,protection,143,77,66
Doghxnterx,ravencrest,1294,warrior,protection,71,30,41
Brigitá,argent-dawn,1285,warrior,protection,35,14,21
Àlexander,ravencrest,1202,warrior,protection,44,14,30
Tríbún,kult-der-verdammten,1129,warrior,protection,83,39,44
Narrative,kazzak,1091,warrior,protection,54,20,34
Ferran,sanguino,1060,warrior,protection,180,90,90
Grimurg,drakthul,1036,warrior,protection,139,69,70
Carras,confrérie-du-thorium,979,warrior,protection,181,94,87
Флоуби,razuvious,909,warrior,protection,54,23,31
Mandiso,norgannon,862,warrior,protection,113,53,60
Extramudna,azjolnerub,834,warrior,protection,40,12,28
Naofumí,arthas,773,warrior,protection,36,14,22
Фриегар,deathguard,711,warrior,protection,76,29,47
Ylana,eldrethalas,671,warrior,protection,18,7,11
Hubin,defias-brotherhood,662,warrior,protection,30,7,23
Гештальтыч,eversong,626,warrior,protection,36,7,29
Asuvia,argent-dawn,599,warrior,protection,32,7,25
Firemyst,outland,575,warrior,protection,18,6,12
Flinn,die-nachtwache,408,warrior,protection,26,6,20
Tokrika,die-aldor,384,warrior,protection,6,4,2
Oralinde,silvermoon,384,warrior,protection,12,4,8
Драчун,thermaplugg,384,warrior,protection,18,4,14
Джубилост,goldrinn,384,warrior,protection,24,4,20
Bloodparade,argent-dawn,288,warrior,protection,6,3,3
Thecrackfoxx,silvermoon,288,warrior,protection,12,3,9
Chadgarrosh,tarren-mill,288,warrior,protection,12,3,9
Davetsiz,burning-legion,288,warrior,protection,12,3,9
Takautak,kirin-tor,288,warrior,protection,12,3,9
Трейлхард,howling-fjord,287,warrior,protection,12,3,9
Hofftor,eredar,192,warrior,protection,6,2,4
Денеур,gordunni,192,warrior,protection,6,2,4
Gaiuscaesar,stormscale,192,warrior,protection,6,2,4
Linzao,archimonde,192,warrior,protection,6,2,4
Омертин,howling-fjord,192,warrior,protection,6,2,4
Маллал,soulflayer,192,warrior,protection,6,2,4
Sergra,ysondre,96,warrior,protection,6,1,5
Valem,suramar,96,warrior,protection,6,1,5
Warrqury,ravencrest,96,warrior,protection,6,1,5
Draskoé,hyjal,96,warrior,protection,6,1,5
Markza,turalyon,96,warrior,protection,6,1,5
Layä,krasus,96,warrior,protection,6,1,5
Montysmash,ravencrest,96,warrior,protection,6,1,5
Гневныйвиги,howling-fjord,96,warrior,protection,6,1,5
Lendené,los-errantes,96,warrior,protection,6,1,5
Leryswarro,sanguino,96,warrior,protection,6,1,5
Lørð,frostmane,96,warrior,protection,6,1,5
Pahgorim,blackhand,96,warrior,protection,12,1,11
Callipsa,argent-dawn,96,warrior,protection,12,1,11
Jøtas,dun-modr,96,warrior,protection,12,1,11
Burningyou,culte-de-la-rive-noire,95,warrior,protection,3,2,1
Throneofwar,silvermoon,95,warrior,protection,6,1,5
Shinnok,stormreaver,95,warrior,protection,9,1,8
Ijzereter,argent-dawn,31,warrior,protection,2,1,1
