,name,realm,rating,cls,spec,play,win,lose
0,Rahbekius,kazzak,1529,deathknight,blood,84,32,52
1,Эваер,blackscar,1506,deathknight,blood,60,29,31
2,Оосака,gordunni,573,deathknight,blood,24,6,18
3,Nîghtmáre,ravencrest,462,deathknight,blood,11,5,6
4,Horrorda,defias-brotherhood,446,deathknight,blood,9,6,3
5,Кмамехочу,howling-fjord,288,deathknight,blood,18,3,15
6,Schiva,eredar,252,deathknight,blood,11,3,8
7,Хайвейтухэлл,soulflayer,2098,deathknight,unholy,96,48,48
8,Conqueròr,tarren-mill,2083,deathknight,unholy,94,46,48
9,Bóby,ravencrest,2050,deathknight,unholy,156,76,80
10,Кромгона,soulflayer,2036,deathknight,unholy,83,57,26
11,Leónid,kazzak,1962,deathknight,unholy,72,36,36
12,Vakü,burning-legion,1962,deathknight,unholy,178,87,91
13,Bedstemoor,ravencrest,1955,deathknight,unholy,90,47,43
14,Enzy,drakthul,1948,deathknight,unholy,42,26,16
15,Дайтоолгоун,gordunni,1937,deathknight,unholy,113,56,57
16,Murky,kazzak,1935,deathknight,unholy,126,61,65
17,Ipanic,argent-dawn,1930,deathknight,unholy,114,65,49
18,Шайбовёрт,gordunni,1918,deathknight,unholy,72,38,34
19,Shadowdeathj,kazzak,1913,deathknight,unholy,54,27,27
20,Валькейн,blackscar,1883,deathknight,unholy,60,32,28
21,Akaliz,die-aldor,1876,deathknight,unholy,66,35,31
22,Narali,argent-dawn,1859,deathknight,unholy,72,34,38
23,Fxckingmad,ravencrest,1856,deathknight,unholy,60,30,30
24,Vallenhal,twisting-nether,1850,deathknight,unholy,48,23,25
25,Azüla,ysondre,1848,deathknight,unholy,66,30,36
26,Worlviuz,argent-dawn,1847,deathknight,unholy,123,59,64
27,Меланндрис,gordunni,1845,deathknight,unholy,60,44,16
28,Øtherànóther,stormscale,1843,deathknight,unholy,54,30,24
29,Ezlyy,ravencrest,1843,deathknight,unholy,114,60,54
30,Amnésyx,ysondre,1842,deathknight,unholy,64,32,32
31,Nómòre,ravencrest,1839,deathknight,unholy,60,30,30
32,Mockingbirdo,sanguino,1836,deathknight,unholy,36,24,12
33,Leomordf,doomhammer,1832,deathknight,unholy,130,76,54
34,Lilshiet,stormreaver,1831,deathknight,unholy,66,30,36
35,Namzera,draenor,1827,deathknight,unholy,114,70,44
36,Неондк,eversong,1821,deathknight,unholy,104,53,51
37,Zokko,blackrock,1820,deathknight,unholy,59,31,28
38,Cealdris,blackmoore,1819,deathknight,unholy,30,20,10
39,Обледенение,gordunni,1819,deathknight,unholy,36,19,17
40,Mávé,tarren-mill,1819,deathknight,unholy,59,31,28
41,Rankor,grim-batol,1816,deathknight,unholy,66,36,30
42,Necrofear,grim-batol,1816,deathknight,unholy,126,62,64
43,Argonat,silvermoon,1814,deathknight,unholy,99,57,42
44,Аоепупс,gordunni,1809,deathknight,unholy,57,28,29
45,Лордэскорт,gordunni,1805,deathknight,unholy,78,37,41
46,Annabolik,ravencrest,1804,deathknight,unholy,36,19,17
47,Нишимба,soulflayer,1802,deathknight,unholy,54,28,26
48,Inflex,silvermoon,1800,deathknight,unholy,102,51,51
49,Grepetta,argent-dawn,1800,deathknight,unholy,243,121,122
50,Jesûsx,ravencrest,1799,deathknight,unholy,48,29,19
51,Дайтоолгоун,deathguard,1783,deathknight,unholy,69,38,31
52,Darkknights,archimonde,1774,deathknight,unholy,56,35,21
53,Butthurtx,stormscale,1766,deathknight,unholy,40,23,17
54,Фростинг,gordunni,1757,deathknight,unholy,42,23,19
55,Oj,darkspear,1745,deathknight,unholy,66,37,29
56,Allmawt,argent-dawn,1737,deathknight,unholy,60,34,26
57,Shanariel,khaz-modan,1733,deathknight,unholy,102,58,44
58,Køley,draenor,1732,deathknight,unholy,41,23,18
59,Kickbot,outland,1729,deathknight,unholy,112,58,54
60,Змейняша,soulflayer,1726,deathknight,unholy,72,34,38
61,Skulm,twisting-nether,1722,deathknight,unholy,48,20,28
62,Ghostreign,tarren-mill,1719,deathknight,unholy,68,33,35
63,Yandeäth,chants-éternels,1716,deathknight,unholy,59,36,23
64,Koranderx,argent-dawn,1713,deathknight,unholy,30,18,12
65,Itreachesout,ravencrest,1708,deathknight,unholy,58,27,31
66,Wombo,dentarg,1705,deathknight,unholy,51,28,23
67,Wôrgenator,kazzak,1704,deathknight,unholy,48,18,30
68,Lovroo,silvermoon,1702,deathknight,unholy,87,41,46
69,Necrølyte,sylvanas,1701,deathknight,unholy,48,26,22
70,Эриданс,gordunni,1699,deathknight,unholy,124,69,55
71,Kwc,ravencrest,1696,deathknight,unholy,87,43,44
72,Oscman,silvermoon,1693,deathknight,unholy,90,45,45
73,Verminosis,stormscale,1689,deathknight,unholy,54,21,33
74,Unhóly,tarren-mill,1687,deathknight,unholy,84,47,37
75,Icegrin,silvermoon,1687,deathknight,unholy,60,32,28
76,Кулькулегал,ashenvale,1685,deathknight,unholy,54,27,27
77,Sanlex,twisting-nether,1684,deathknight,unholy,115,51,64
78,ßankoedno,stormscale,1681,deathknight,unholy,120,62,58
79,Faznik,twisting-nether,1675,deathknight,unholy,42,20,22
80,Femilista,dun-modr,1671,deathknight,unholy,42,23,19
81,Сантамо,soulflayer,1669,deathknight,unholy,50,27,23
82,Олинф,deathguard,1664,deathknight,unholy,56,23,33
83,Blazeberg,blackrock,1662,deathknight,unholy,58,33,25
84,Andreàs,silvermoon,1662,deathknight,unholy,42,22,20
85,Гронташ,howling-fjord,1658,deathknight,unholy,53,28,25
86,Feministi,stormreaver,1652,deathknight,unholy,48,24,24
87,Sangíus,blackmoore,1652,deathknight,unholy,214,101,113
88,Reann,argent-dawn,1649,deathknight,unholy,55,31,24
89,Aryash,silvermoon,1649,deathknight,unholy,54,22,32
90,Кидер,blackscar,1647,deathknight,unholy,41,23,18
91,Fraeya,sunstrider,1647,deathknight,unholy,54,26,28
92,Nèrfx,ragnaros,1641,deathknight,unholy,66,30,36
93,Leanâdle,hyjal,1640,deathknight,unholy,80,39,41
94,Darkertimes,ragnaros,1640,deathknight,unholy,90,41,49
95,Exoflake,kazzak,1639,deathknight,unholy,46,24,22
96,Hotcherryx,dun-modr,1638,deathknight,unholy,42,18,24
97,Äyrenn,draenor,1637,deathknight,unholy,45,27,18
98,Garrinchá,stormscale,1636,deathknight,unholy,48,21,27
99,Vainajala,die-aldor,1633,deathknight,unholy,71,41,30
100,Crenshawx,twisting-nether,1633,deathknight,unholy,77,33,44
101,Sølîta,archimonde,1632,deathknight,unholy,71,39,32
102,Вирко,eversong,1631,deathknight,unholy,58,29,29
103,Аронас,blackscar,1629,deathknight,unholy,42,21,21
104,Бургер,soulflayer,1622,deathknight,unholy,54,21,33
105,Quetza,twisting-nether,1621,deathknight,unholy,36,17,19
106,Кокосоус,gordunni,1618,deathknight,unholy,36,18,18
107,Аркёт,howling-fjord,1618,deathknight,unholy,42,19,23
108,Gladiadk,ysondre,1618,deathknight,unholy,42,17,25
109,Storhøf,sanguino,1616,deathknight,unholy,30,17,13
110,Pellizquitas,sanguino,1612,deathknight,unholy,30,17,13
111,Lockhead,stormscale,1612,deathknight,unholy,90,50,40
112,Inâste,thrall,1612,deathknight,unholy,36,20,16
113,Quizon,tarren-mill,1610,deathknight,unholy,42,20,22
114,Castlevanía,ravencrest,1609,deathknight,unholy,97,48,49
115,Notsyndra,nemesis,1603,deathknight,unholy,42,23,19
116,Jiodythyy,archimonde,1602,deathknight,unholy,54,23,31
117,Økah,outland,1598,deathknight,unholy,48,21,27
118,Çruél,silvermoon,1596,deathknight,unholy,42,19,23
119,Körthazz,hyjal,1595,deathknight,unholy,49,25,24
120,Synthwave,tarren-mill,1594,deathknight,unholy,41,19,22
121,Bredox,ravencrest,1593,deathknight,unholy,36,17,19
122,Lichbørn,ragnaros,1585,deathknight,unholy,48,22,26
123,Ктунец,blackscar,1570,deathknight,unholy,36,19,17
124,Aeneriah,tarren-mill,1569,deathknight,unholy,49,27,22
125,Söttguetsi,blackrock,1566,deathknight,unholy,41,23,18
126,Motvinden,stormscale,1566,deathknight,unholy,46,22,24
127,Хорссэ,soulflayer,1563,deathknight,unholy,34,21,13
128,Fennro,ysondre,1563,deathknight,unholy,156,65,91
129,Вурдулакх,gordunni,1561,deathknight,unholy,96,48,48
130,Hellguy,draenor,1560,deathknight,unholy,132,58,74
131,Моровой,blackscar,1559,deathknight,unholy,41,20,21
132,Deathvid,ravencrest,1558,deathknight,unholy,30,18,12
133,Сванхильда,grom,1558,deathknight,unholy,66,33,33
134,Bokrak,norgannon,1551,deathknight,unholy,64,41,23
135,Gargalon,drakthul,1547,deathknight,unholy,54,28,26
136,Хассандра,galakrond,1537,deathknight,unholy,62,30,32
137,Zoree,draenor,1534,deathknight,unholy,95,50,45
138,Smörj,aggramar,1534,deathknight,unholy,42,17,25
139,Nommad,archimonde,1530,deathknight,unholy,53,22,31
140,Dörfl,antonidas,1524,deathknight,unholy,75,36,39
141,Yusehz,kazzak,1523,deathknight,unholy,41,17,24
142,Oweiowei,blackrock,1520,deathknight,unholy,24,16,8
143,Woddey,blackrock,1520,deathknight,unholy,72,39,33
144,Мёрдерфэйсх,soulflayer,1517,deathknight,unholy,78,41,37
145,Nazgül,drakthul,1517,deathknight,unholy,86,43,43
146,Ghaloob,draenor,1515,deathknight,unholy,30,16,14
147,Greymarker,kirin-tor,1513,deathknight,unholy,66,37,29
148,Слендер,howling-fjord,1510,deathknight,unholy,30,16,14
149,Ardros,eredar,1507,deathknight,unholy,48,23,25
150,Ullefuz,silvermoon,1506,deathknight,unholy,24,18,6
151,Нарилуне,blackscar,1504,deathknight,unholy,157,79,78
152,Megdeath,silvermoon,1504,deathknight,unholy,90,43,47
153,Sîck,bladefist,1503,deathknight,unholy,60,22,38
154,Numnuts,alakir,1502,deathknight,unholy,36,21,15
155,Тыпидо,howling-fjord,1502,deathknight,unholy,30,17,13
156,Qtxi,nozdormu,1500,deathknight,unholy,84,44,40
157,Devilknight,dentarg,1500,deathknight,unholy,136,68,68
158,Ахелекус,blackscar,1498,deathknight,unholy,30,17,13
159,Pavkata,outland,1497,deathknight,unholy,112,57,55
160,Алсидис,gordunni,1497,deathknight,unholy,60,22,38
161,Aleejha,draenor,1496,deathknight,unholy,40,22,18
162,Arxelas,sylvanas,1482,deathknight,unholy,60,33,27
163,Ceranto,frostwolf,1481,deathknight,unholy,71,44,27
164,Лекъса,gordunni,1481,deathknight,unholy,87,44,43
165,Bloodbane,burning-blade,1481,deathknight,unholy,36,18,18
166,Anaralien,ravencrest,1479,deathknight,unholy,89,40,49
167,Derfitt,sanguino,1478,deathknight,unholy,42,18,24
168,Арцевус,gordunni,1477,deathknight,unholy,58,29,29
169,Deathcam,emerald-dream,1472,deathknight,unholy,71,32,39
170,Sorostew,twisting-nether,1467,deathknight,unholy,42,23,19
171,Utyr,ragnaros,1463,deathknight,unholy,30,16,14
172,Кадавров,gordunni,1463,deathknight,unholy,42,20,22
173,Rizzlerdk,blackhand,1461,deathknight,unholy,78,30,48
174,Торедх,howling-fjord,1461,deathknight,unholy,42,16,26
175,Шифычдк,howling-fjord,1460,deathknight,unholy,60,27,33
176,Blízna,kazzak,1459,deathknight,unholy,78,36,42
177,Deusmort,ravencrest,1457,deathknight,unholy,66,26,40
178,Teljujad,sanguino,1453,deathknight,unholy,92,45,47
179,Борнтудай,borean-tundra,1445,deathknight,unholy,48,17,31
180,Unholy,ragnaros,1444,deathknight,unholy,38,20,18
181,Deadroses,tarren-mill,1442,deathknight,unholy,54,34,20
182,Сенкрул,gordunni,1440,deathknight,unholy,72,48,24
183,Bøby,kul-tiras,1438,deathknight,unholy,24,15,9
184,Ganessha,sanguino,1437,deathknight,unholy,27,16,11
185,Hêalz,ungoro,1433,deathknight,unholy,34,19,15
186,Смердонос,grom,1432,deathknight,unholy,68,38,30
187,Metalmanethé,tarren-mill,1432,deathknight,unholy,133,62,71
188,Спавни,blackscar,1432,deathknight,unholy,135,62,73
189,Jalapeñofan,tarren-mill,1430,deathknight,unholy,36,18,18
190,Turboface,kazzak,1427,deathknight,unholy,30,16,14
191,Babsyknight,wildhammer,1426,deathknight,unholy,78,32,46
192,Десхоб,soulflayer,1426,deathknight,unholy,102,36,66
193,Анихиме,howling-fjord,1424,deathknight,unholy,75,37,38
194,Deathlog,silvermoon,1424,deathknight,unholy,36,17,19
195,Vatø,tarren-mill,1423,deathknight,unholy,36,15,21
196,Xado,frostwolf,1421,deathknight,unholy,66,37,29
197,Skøurge,silvermoon,1421,deathknight,unholy,126,64,62
198,Ampdk,ravencrest,1421,deathknight,unholy,30,15,15
199,Discochoppa,blackmoore,1421,deathknight,unholy,36,15,21
200,Hawkthuglife,dun-modr,1421,deathknight,unholy,42,17,25
201,Mìa,kragjin,1415,deathknight,unholy,73,33,40
202,Элекна,deepholm,1412,deathknight,unholy,36,16,20
203,Terren,ravencrest,1409,deathknight,unholy,52,29,23
204,Xirra,tarren-mill,1409,deathknight,unholy,67,33,34
205,Jäätynyt,zenedar,1407,deathknight,unholy,83,31,52
206,Frostmommy,argent-dawn,1398,deathknight,unholy,48,18,30
207,Facèpalm,ravencrest,1396,deathknight,unholy,33,18,15
208,Lorvetis,malorne,1395,deathknight,unholy,42,19,23
209,Dkbladet,ravencrest,1391,deathknight,unholy,56,29,27
210,Hordak,stormscale,1384,deathknight,unholy,39,15,24
211,Necrotic,blackrock,1383,deathknight,unholy,23,15,8
212,Blorin,sylvanas,1372,deathknight,unholy,58,24,34
213,Gødofredo,dun-modr,1370,deathknight,unholy,60,30,30
214,Tyvra,blackhand,1369,deathknight,unholy,47,17,30
215,Fizzdk,pozzo-delleternità,1359,deathknight,unholy,30,15,15
216,Gaurk,aggra-português,1350,deathknight,unholy,24,15,9
217,Draforce,quelthalas,1349,deathknight,unholy,23,15,8
218,Pawcio,argent-dawn,1348,deathknight,unholy,78,39,39
219,Prænklý,blackrock,1348,deathknight,unholy,30,15,15
220,Quantumshift,ravencrest,1347,deathknight,unholy,24,15,9
221,Jihm,silvermoon,1344,deathknight,unholy,117,62,55
222,Sathmayla,silvermoon,1343,deathknight,unholy,23,15,8
223,Ahilus,bladefist,1343,deathknight,unholy,31,15,16
224,Zeghor,ragnaros,1343,deathknight,unholy,42,15,27
225,Segrim,drakthul,1342,deathknight,unholy,26,15,11
226,Roaredrick,draenor,1342,deathknight,unholy,87,40,47
227,Хейткрю,howling-fjord,1342,deathknight,unholy,48,21,27
228,Yagoora,silvermoon,1339,deathknight,unholy,33,15,18
229,Happsor,eredar,1336,deathknight,unholy,36,14,22
230,Alessia,alonsus,1335,deathknight,unholy,24,14,10
231,Ðiesel,stormscale,1334,deathknight,unholy,46,15,31
232,Akelæ,draenor,1330,deathknight,unholy,36,19,17
233,Evelys,kazzak,1329,deathknight,unholy,34,17,17
234,Moko,defias-brotherhood,1320,deathknight,unholy,30,14,16
235,Detrah,argent-dawn,1315,deathknight,unholy,52,27,25
236,Gûuts,archimonde,1313,deathknight,unholy,162,82,80
237,Ithis,zuljin,1312,deathknight,unholy,48,17,31
238,Negzul,blackmoore,1308,deathknight,unholy,42,20,22
239,Sveinnhran,kazzak,1302,deathknight,unholy,46,19,27
240,Mojodango,outland,1299,deathknight,unholy,26,15,11
241,Tanenoss,kazzak,1299,deathknight,unholy,42,18,24
242,Reportmeplz,ragnaros,1298,deathknight,unholy,42,20,22
243,Крикед,soulflayer,1297,deathknight,unholy,102,55,47
244,Роземайер,ashenvale,1297,deathknight,unholy,60,29,31
245,Nilodk,nemesis,1288,deathknight,unholy,88,45,43
246,Züg,draenor,1287,deathknight,unholy,30,14,16
247,Бреч,gordunni,1285,deathknight,unholy,42,14,28
248,Pjthedk,lightbringer,1284,deathknight,unholy,30,16,14
249,Zracul,nordrassil,1282,deathknight,unholy,60,29,31
250,Sictir,stormscale,1282,deathknight,unholy,176,83,93
251,Zelbørk,medivh,1276,deathknight,unholy,30,17,13
252,Jöndas,drakthul,1272,deathknight,unholy,42,20,22
253,Necrozy,aggra-português,1269,deathknight,unholy,84,43,41
254,Morinosei,twisting-nether,1269,deathknight,unholy,59,30,29
255,Necrocancerr,twisting-nether,1269,deathknight,unholy,104,49,55
256,Kaletorn,ragnaros,1265,deathknight,unholy,84,41,43
257,Diatriss,argent-dawn,1262,deathknight,unholy,54,25,29
258,Drenodur,amanthul,1261,deathknight,unholy,24,14,10
259,Superere,hyjal,1261,deathknight,unholy,36,17,19
260,Таможникс,soulflayer,1260,deathknight,unholy,23,14,9
261,Tyranus,quelthalas,1260,deathknight,unholy,91,38,53
262,Endlesspain,burning-legion,1249,deathknight,unholy,36,14,22
263,Lutcher,hellfire,1246,deathknight,unholy,24,13,11
264,Arizon,drakthul,1245,deathknight,unholy,36,13,23
265,Fentanil,elune,1244,deathknight,unholy,70,33,37
266,Fishtruction,tarren-mill,1242,deathknight,unholy,48,25,23
267,Raust,xavius,1242,deathknight,unholy,26,13,13
268,Baltersa,blackhand,1240,deathknight,unholy,36,13,23
269,Shabiri,twisting-nether,1238,deathknight,unholy,29,14,15
270,Nospets,kazzak,1237,deathknight,unholy,24,13,11
271,Lobotomia,burning-blade,1237,deathknight,unholy,30,15,15
272,Кристер,lich-king,1234,deathknight,unholy,30,13,17
273,Metalist,ravencrest,1229,deathknight,unholy,24,13,11
274,Bärdk,forscherliga,1229,deathknight,unholy,30,13,17
275,Dunkàn,silvermoon,1190,deathknight,unholy,24,16,8
276,Abnormus,tarren-mill,1175,deathknight,unholy,45,19,26
277,Ridire,saurfang,1159,deathknight,unholy,31,15,16
278,Zerachy,blackmoore,1150,deathknight,unholy,18,12,6
279,Рыжаяпедаль,soulflayer,1150,deathknight,unholy,18,12,6
280,Dklol,dun-morogh,1150,deathknight,unholy,36,14,22
281,Numnutz,alakir,1149,deathknight,unholy,25,13,12
282,Lurkkiss,ravencrest,1149,deathknight,unholy,30,12,18
283,Frege,tarren-mill,1149,deathknight,unholy,30,12,18
284,Nødder,ragnaros,1145,deathknight,unholy,18,12,6
285,Sevatar,zuljin,1137,deathknight,unholy,18,12,6
286,Fineral,argent-dawn,1134,deathknight,unholy,24,12,12
287,Jowân,blackmoore,1131,deathknight,unholy,24,13,11
288,Qmy,outland,1131,deathknight,unholy,24,12,12
289,Razzvy,darkspear,1131,deathknight,unholy,24,12,12
290,Dêku,aegwynn,1130,deathknight,unholy,79,44,35
291,Asakurai,grim-batol,1126,deathknight,unholy,42,22,20
292,Híruzen,blackrock,1115,deathknight,unholy,30,15,15
293,Ârtjom,aegwynn,1106,deathknight,unholy,28,12,16
294,Saromón,ravencrest,1101,deathknight,unholy,30,18,12
295,Darkhallow,thrall,1100,deathknight,unholy,50,23,27
296,Roykoopa,hyjal,1099,deathknight,unholy,30,13,17
297,Apolyio,outland,1095,deathknight,unholy,35,14,21
298,Ashlëy,kaelthas,1091,deathknight,unholy,88,44,44
299,Охъламон,soulflayer,1090,deathknight,unholy,42,16,26
300,Джайвана,soulflayer,1057,deathknight,unholy,76,36,40
301,Pandahapci,ragnaros,1055,deathknight,unholy,18,11,7
302,Nysaia,blackmoore,1055,deathknight,unholy,18,11,7
303,Вовчан,howling-fjord,1055,deathknight,unholy,24,11,13
304,Sélyne,dalaran,1055,deathknight,unholy,30,11,19
305,Doozz,draenor,1055,deathknight,unholy,30,11,19
306,Капустас,gordunni,1054,deathknight,unholy,18,11,7
307,Deathcaller,zuljin,1054,deathknight,unholy,24,11,13
308,Trialist,dun-modr,1052,deathknight,unholy,18,11,7
309,Fýhr,silvermoon,1052,deathknight,unholy,18,11,7
310,Manovar,archimonde,1052,deathknight,unholy,24,11,13
311,Erodevil,kazzak,1051,deathknight,unholy,30,11,19
312,Maradk,drakthul,1048,deathknight,unholy,24,11,13
313,Dunklerlord,malfurion,1045,deathknight,unholy,24,11,13
314,Kixx,bloodfeather,1030,deathknight,unholy,47,17,30
315,Ezreo,neptulon,1029,deathknight,unholy,25,11,14
316,Мокраявода,soulflayer,1026,deathknight,unholy,94,49,45
317,Pamplemouse,burning-blade,1016,deathknight,unholy,79,36,43
318,Takåtry,archimonde,1004,deathknight,unholy,30,14,16
319,Tyrannus,earthen-ring,1000,deathknight,unholy,23,13,10
320,Gowther,blackmoore,999,deathknight,unholy,30,16,14
321,Karalun,nagrand,983,deathknight,unholy,36,16,20
322,Gathalion,the-maelstrom,980,deathknight,unholy,48,28,20
323,Fpsrvg,minahonda,980,deathknight,unholy,47,21,26
324,Assasínator,tarren-mill,964,deathknight,unholy,54,27,27
325,Сгеатог,gordunni,960,deathknight,unholy,18,10,8
326,Kaliro,sylvanas,960,deathknight,unholy,18,10,8
327,Aceléss,drakthul,960,deathknight,unholy,18,10,8
328,Кромгондк,soulflayer,960,deathknight,unholy,24,10,14
329,Gripbroblem,nemesis,960,deathknight,unholy,30,10,20
330,Nasxsy,blackmoore,959,deathknight,unholy,18,10,8
331,Apoikos,argent-dawn,959,deathknight,unholy,18,10,8
332,Ronsôn,terrordar,959,deathknight,unholy,24,10,14
333,Скизм,howling-fjord,959,deathknight,unholy,24,10,14
334,Exanex,ragnaros,957,deathknight,unholy,18,10,8
335,Funds,kazzak,957,deathknight,unholy,24,10,14
336,Logoz,dun-modr,956,deathknight,unholy,18,10,8
337,Eltorro,ravencrest,952,deathknight,unholy,30,10,20
338,Recoil,blackrock,925,deathknight,unholy,20,11,9
339,Sang,deathwing,912,deathknight,unholy,15,11,4
340,Asakim,tarren-mill,911,deathknight,unholy,17,10,7
341,Kaldhan,nemesis,910,deathknight,unholy,24,10,14
342,Aesthaetik,draenor,908,deathknight,unholy,17,10,7
343,Лордэнергон,gordunni,888,deathknight,unholy,16,10,6
344,Restodrowd,tarren-mill,888,deathknight,unholy,24,11,13
345,Orcborg,zuljin,868,deathknight,unholy,25,10,15
346,Usbdock,stormscale,864,deathknight,unholy,18,9,9
347,Rottenpete,grim-batol,864,deathknight,unholy,18,9,9
348,Khalifamia,alonsus,864,deathknight,unholy,18,9,9
349,Panorboy,tarren-mill,864,deathknight,unholy,18,9,9
350,Catloaf,silvermoon,864,deathknight,unholy,24,9,15
351,Маххес,howling-fjord,864,deathknight,unholy,24,9,15
352,Bephomet,onyxia,864,deathknight,unholy,33,9,24
353,Bertonilo,burning-legion,863,deathknight,unholy,18,9,9
354,Reapocalypse,blackhand,862,deathknight,unholy,24,9,15
355,Unholycard,argent-dawn,860,deathknight,unholy,18,9,9
356,Тзинч,soulflayer,859,deathknight,unholy,18,9,9
357,Tarfu,kazzak,856,deathknight,unholy,18,9,9
358,Ahlat,blackmoore,854,deathknight,unholy,12,9,3
359,Marcianorock,dalaran,850,deathknight,unholy,18,9,9
360,Deathcleave,burning-legion,845,deathknight,unholy,23,9,14
361,Évìl,stormscale,815,deathknight,unholy,17,9,8
362,Zot,twisting-nether,814,deathknight,unholy,18,10,8
363,Nauser,kazzak,813,deathknight,unholy,23,9,14
364,Trigárdon,antonidas,812,deathknight,unholy,18,9,9
365,Beinlausi,dalaran,807,deathknight,unholy,15,9,6
366,Arthursq,stormscale,806,deathknight,unholy,24,10,14
367,Шмуркич,gordunni,798,deathknight,unholy,23,10,13
368,Некронн,grom,795,deathknight,unholy,17,9,8
369,Oldu,haomarush,794,deathknight,unholy,39,15,24
370,Preddktwo,twisting-nether,768,deathknight,unholy,12,8,4
371,Radan,stormscale,768,deathknight,unholy,12,8,4
372,Psychopathz,tarren-mill,768,deathknight,unholy,12,8,4
373,Wórzzag,arygos,768,deathknight,unholy,12,8,4
374,Frostplague,aegwynn,768,deathknight,unholy,18,8,10
375,Silvergreed,kazzak,768,deathknight,unholy,18,8,10
376,Акамахи,ashenvale,768,deathknight,unholy,18,8,10
377,Кромгак,soulflayer,768,deathknight,unholy,18,8,10
378,Apacstanya,ragnaros,768,deathknight,unholy,18,8,10
379,Sanuky,blackrock,768,deathknight,unholy,18,8,10
380,Senkingodx,ravencrest,768,deathknight,unholy,24,8,16
381,Zatrina,blackrock,768,deathknight,unholy,24,8,16
382,Клиссанг,razuvious,768,deathknight,unholy,30,8,22
383,Amelia,ambossar,767,deathknight,unholy,12,8,4
384,Zff,hyjal,767,deathknight,unholy,12,8,4
385,Дедхо,soulflayer,767,deathknight,unholy,18,8,10
386,Промештейн,gordunni,767,deathknight,unholy,18,8,10
387,Аирфрост,howling-fjord,767,deathknight,unholy,18,8,10
388,Nuadar,outland,767,deathknight,unholy,24,8,16
389,Arthrex,twisting-nether,766,deathknight,unholy,12,8,4
390,Payat,aegwynn,766,deathknight,unholy,12,8,4
391,Krinoe,dalaran,766,deathknight,unholy,18,8,10
392,Крус,blackscar,766,deathknight,unholy,18,8,10
393,Zombienatíon,silvermoon,766,deathknight,unholy,24,8,16
394,Zegaan,kazzak,765,deathknight,unholy,24,8,16
395,Persefal,nemesis,765,deathknight,unholy,30,8,22
396,Mãshi,hyjal,764,deathknight,unholy,18,8,10
397,Деркхаус,soulflayer,762,deathknight,unholy,12,8,4
398,Badbrian,draenor,760,deathknight,unholy,12,8,4
399,Rognvald,les-sentinelles,755,deathknight,unholy,17,11,6
400,Ilovegouàng,khaz-modan,754,deathknight,unholy,24,8,16
401,Nickolass,skullcrusher,747,deathknight,unholy,18,8,10
402,Aldramil,gorgonnash,726,deathknight,unholy,24,9,15
403,Walkeni,defias-brotherhood,718,deathknight,unholy,17,8,9
404,Dklékata,archimonde,672,deathknight,unholy,12,7,5
405,Fyrkadk,aegwynn,672,deathknight,unholy,12,7,5
406,Gareath,ragnaros,672,deathknight,unholy,12,7,5
407,Èvíl,stormscale,672,deathknight,unholy,12,7,5
408,Unholykebab,defias-brotherhood,672,deathknight,unholy,12,7,5
409,Moonpoxdk,nerathor,672,deathknight,unholy,12,7,5
410,Зибак,soulflayer,672,deathknight,unholy,12,7,5
411,Soulchaos,ravencrest,672,deathknight,unholy,18,7,11
412,Geraltbg,twisting-nether,672,deathknight,unholy,18,7,11
413,Fearléss,outland,672,deathknight,unholy,18,7,11
414,Gadres,aegwynn,672,deathknight,unholy,18,7,11
415,Smallbaboon,stormreaver,672,deathknight,unholy,18,7,11
416,Aifam,twisting-nether,672,deathknight,unholy,18,7,11
417,Никнейм,gordunni,672,deathknight,unholy,18,7,11
418,Дэдушка,gordunni,671,deathknight,unholy,12,7,5
419,Mcrune,ravencrest,671,deathknight,unholy,18,7,11
420,Ráisy,outland,671,deathknight,unholy,24,7,17
421,Amencore,kazzak,670,deathknight,unholy,14,7,7
422,Unzul,twisting-nether,660,deathknight,unholy,12,7,5
423,Lastdragon,dun-modr,657,deathknight,unholy,18,7,11
424,Винерас,soulflayer,576,deathknight,unholy,6,6,0
425,Kurían,burning-legion,576,deathknight,unholy,12,6,6
426,Nephalêm,thrall,576,deathknight,unholy,12,6,6
427,Gigadk,ragnaros,576,deathknight,unholy,12,6,6
428,Swordkill,drakthul,576,deathknight,unholy,12,6,6
429,Линфео,galakrond,576,deathknight,unholy,12,6,6
430,Feelmyfuri,mazrigos,576,deathknight,unholy,12,6,6
431,Maxto,outland,576,deathknight,unholy,12,6,6
432,Riceeater,kazzak,576,deathknight,unholy,12,6,6
433,Mefhesto,tarren-mill,576,deathknight,unholy,12,6,6
434,Mammacitaa,argent-dawn,576,deathknight,unholy,12,6,6
435,Duriel,stormscale,576,deathknight,unholy,12,6,6
436,Critgødx,draenor,576,deathknight,unholy,13,6,7
437,Pestikus,thrall,576,deathknight,unholy,18,6,12
438,Анзорини,gordunni,576,deathknight,unholy,18,6,12
439,Bloodkatana,drakthul,576,deathknight,unholy,18,6,12
440,Darhma,archimonde,576,deathknight,unholy,24,6,18
441,Oldiseas,grim-batol,575,deathknight,unholy,12,6,6
442,Undtot,azshara,575,deathknight,unholy,12,6,6
443,Kalantii,draenor,575,deathknight,unholy,12,6,6
444,Havi,thunderhorn,575,deathknight,unholy,12,6,6
445,Mosscraciun,kazzak,575,deathknight,unholy,12,6,6
446,Feugen,hyjal,575,deathknight,unholy,12,6,6
447,Dzahnecro,archimonde,575,deathknight,unholy,12,6,6
448,Reidemorte,minahonda,575,deathknight,unholy,18,6,12
449,Zathron,blackmoore,574,deathknight,unholy,12,6,6
450,Ennigmá,stormscale,572,deathknight,unholy,12,6,6
451,Малп,gordunni,569,deathknight,unholy,12,6,6
452,Deadpòól,twisting-nether,521,deathknight,unholy,33,7,26
453,Jess,blackhand,520,deathknight,unholy,11,6,5
454,Branchë,stormscale,511,deathknight,unholy,14,6,8
455,Seal,lightnings-blade,511,deathknight,unholy,26,9,17
456,Scotty,ravencrest,480,deathknight,unholy,6,5,1
457,Judin,kazzak,480,deathknight,unholy,6,5,1
458,Náthrakh,argent-dawn,480,deathknight,unholy,6,5,1
459,Aladonreith,zenedar,480,deathknight,unholy,6,5,1
460,Critycal,draenor,480,deathknight,unholy,6,5,1
461,Шейзо,soulflayer,480,deathknight,unholy,6,5,1
462,Барагган,thermaplugg,480,deathknight,unholy,6,5,1
463,Theamine,silvermoon,480,deathknight,unholy,6,5,1
464,Izanagii,exodar,480,deathknight,unholy,6,5,1
465,Миракл,howling-fjord,480,deathknight,unholy,12,5,7
466,Rêxaks,dun-modr,480,deathknight,unholy,12,5,7
467,Kaeyz,blackmoore,480,deathknight,unholy,12,5,7
468,Shewoman,stormreaver,480,deathknight,unholy,12,5,7
469,Wttdmg,kazzak,480,deathknight,unholy,12,5,7
470,Zhugzug,ragnaros,480,deathknight,unholy,12,5,7
471,Luciferon,zenedar,480,deathknight,unholy,12,5,7
472,Gethunts,drakthul,480,deathknight,unholy,12,5,7
473,Azrìal,agamaggan,480,deathknight,unholy,12,5,7
474,Sipsip,tarren-mill,480,deathknight,unholy,12,5,7
475,Prekliatylad,burning-blade,480,deathknight,unholy,12,5,7
476,Dräpârn,sylvanas,480,deathknight,unholy,12,5,7
477,Goreshovel,stormscale,480,deathknight,unholy,12,5,7
478,Itokawa,tarren-mill,480,deathknight,unholy,12,5,7
479,Dêeath,madmortem,480,deathknight,unholy,12,5,7
480,Дядьдим,soulflayer,480,deathknight,unholy,12,5,7
481,Frostich,ragnaros,480,deathknight,unholy,12,5,7
482,Morgianà,argent-dawn,480,deathknight,unholy,12,5,7
483,Шэйп,fordragon,480,deathknight,unholy,12,5,7
484,Deathmonsta,auchindoun,480,deathknight,unholy,12,5,7
485,Deathkanta,antonidas,480,deathknight,unholy,12,5,7
486,Cbalife,ragnaros,480,deathknight,unholy,12,5,7
487,Rammsteïn,ravencrest,480,deathknight,unholy,15,6,9
488,Shining,blackrock,480,deathknight,unholy,21,6,15
489,Xad,blackrock,480,deathknight,unholy,18,5,13
490,Maxïmus,argent-dawn,480,deathknight,unholy,24,5,19
491,Skèltòn,rexxar,479,deathknight,unholy,6,5,1
492,Kazay,madmortem,479,deathknight,unholy,12,5,7
493,Âlîce,culte-de-la-rive-noire,479,deathknight,unholy,12,5,7
494,Hacknorris,aegwynn,478,deathknight,unholy,12,5,7
495,Mailasse,dalaran,476,deathknight,unholy,10,6,4
496,Kailara,draenor,463,deathknight,unholy,11,5,6
497,Grubbins,kul-tiras,447,deathknight,unholy,11,5,6
498,Gravetitan,shattrath,445,deathknight,unholy,23,5,18
499,Ezlar,silvermoon,400,deathknight,unholy,7,5,2
500,Arkaris,blackmoore,399,deathknight,unholy,5,5,0
501,Xênôrr,archimonde,384,deathknight,unholy,6,4,2
502,Cheethdoom,ragnaros,384,deathknight,unholy,6,4,2
503,Redduck,silvermoon,384,deathknight,unholy,6,4,2
504,Helmich,frostmane,384,deathknight,unholy,6,4,2
505,Neph,sanguino,384,deathknight,unholy,6,4,2
506,Krisigaped,blackhand,384,deathknight,unholy,6,4,2
507,Stepknìght,draenor,384,deathknight,unholy,6,4,2
508,Copium,hyjal,384,deathknight,unholy,6,4,2
509,Arrakìs,nemesis,384,deathknight,unholy,6,4,2
510,Bølvar,zuljin,384,deathknight,unholy,6,4,2
511,Lichkunt,stormscale,384,deathknight,unholy,6,4,2
512,Styxdk,blackhand,384,deathknight,unholy,6,4,2
513,Dreadmind,blackrock,384,deathknight,unholy,12,4,8
514,Epoch,azjolnerub,384,deathknight,unholy,12,4,8
515,Кромгон,soulflayer,384,deathknight,unholy,12,4,8
516,Szayestra,draenor,384,deathknight,unholy,12,4,8
517,Mustakäsi,ravencrest,384,deathknight,unholy,12,4,8
518,Darkarthás,aegwynn,384,deathknight,unholy,12,4,8
519,Demrior,hellfire,384,deathknight,unholy,12,4,8
520,Протосеня,soulflayer,384,deathknight,unholy,12,4,8
521,Derimathras,stormscale,384,deathknight,unholy,12,4,8
522,Pängei,frostwolf,384,deathknight,unholy,12,4,8
523,Razdig,dun-modr,384,deathknight,unholy,12,4,8
524,Mawdrym,twisting-nether,384,deathknight,unholy,12,4,8
525,Сивкабурка,fordragon,384,deathknight,unholy,12,4,8
526,Колхозник,howling-fjord,384,deathknight,unholy,12,4,8
527,Sekkah,tarren-mill,384,deathknight,unholy,12,4,8
528,Ecormcpz,eredar,384,deathknight,unholy,12,4,8
529,Raizhen,ragnaros,384,deathknight,unholy,18,4,14
530,Sugarcakedk,blackrock,384,deathknight,unholy,18,4,14
531,Dizin,ravencrest,384,deathknight,unholy,19,4,15
532,Zoombie,draenor,383,deathknight,unholy,6,4,2
533,Flippmo,argent-dawn,383,deathknight,unholy,9,5,4
534,Хворной,howling-fjord,383,deathknight,unholy,12,4,8
535,Gothenburger,darksorrow,383,deathknight,unholy,12,4,8
536,Aczheron,argent-dawn,383,deathknight,unholy,12,4,8
537,Варрлнишнс,soulflayer,367,deathknight,unholy,11,4,7
538,Ogomegee,ravencrest,352,deathknight,unholy,10,4,6
539,Icyplague,ravencrest,351,deathknight,unholy,8,5,3
540,Millknight,norgannon,341,deathknight,unholy,15,6,9
541,Randomdkxd,ravencrest,304,deathknight,unholy,13,4,9
542,Saryn,burning-steppes,304,deathknight,unholy,13,4,9
543,Empiu,blackhand,288,deathknight,unholy,6,3,3
544,Galgalí,blackmoore,288,deathknight,unholy,6,3,3
545,Salezians,drakthul,288,deathknight,unholy,6,3,3
546,Дкшрёдингера,gordunni,288,deathknight,unholy,6,3,3
547,Krozzytwo,draenor,288,deathknight,unholy,6,3,3
548,Kelebglin,silvermoon,288,deathknight,unholy,6,3,3
549,Calina,frostwolf,288,deathknight,unholy,6,3,3
550,Dakyforfun,ravencrest,288,deathknight,unholy,6,3,3
551,Mamanica,sanguino,288,deathknight,unholy,6,3,3
552,Synchronic,stormscale,288,deathknight,unholy,6,3,3
553,Krookidk,archimonde,288,deathknight,unholy,6,3,3
554,Axram,ravencrest,288,deathknight,unholy,6,3,3
555,Квашонка,howling-fjord,288,deathknight,unholy,6,3,3
556,Abcdk,sargeras,288,deathknight,unholy,6,3,3
557,Clérora,argent-dawn,288,deathknight,unholy,6,3,3
558,Athanatøs,archimonde,288,deathknight,unholy,6,3,3
559,Heresjohny,stormrage,288,deathknight,unholy,6,3,3
560,Rävjakt,twisting-nether,288,deathknight,unholy,6,3,3
561,Vexxed,magtheridon,288,deathknight,unholy,6,3,3
562,Joyt,argent-dawn,288,deathknight,unholy,6,3,3
563,Gbdk,xavius,288,deathknight,unholy,6,3,3
564,Manego,eredar,288,deathknight,unholy,6,3,3
565,Dagë,twisting-nether,288,deathknight,unholy,6,3,3
566,Râke,teldrassil,288,deathknight,unholy,6,3,3
567,Zfeuda,azshara,288,deathknight,unholy,6,3,3
568,Cyphîllyth,auchindoun,288,deathknight,unholy,6,3,3
569,Vip,argent-dawn,288,deathknight,unholy,6,3,3
570,Еххел,soulflayer,288,deathknight,unholy,6,3,3
571,Fatøumatata,archimonde,288,deathknight,unholy,6,3,3
572,Mocca,aegwynn,288,deathknight,unholy,6,3,3
573,Тряпьё,galakrond,288,deathknight,unholy,6,3,3
574,Агереро,howling-fjord,288,deathknight,unholy,6,3,3
575,Løz,kazzak,288,deathknight,unholy,6,3,3
576,Myeltior,kazzak,288,deathknight,unholy,6,3,3
577,Zêlëph,archimonde,288,deathknight,unholy,6,3,3
578,Crudelias,aegwynn,288,deathknight,unholy,6,3,3
579,Альдафьод,howling-fjord,288,deathknight,unholy,6,3,3
580,Yousaindk,blackrock,288,deathknight,unholy,6,3,3
581,Jénga,ghostlands,288,deathknight,unholy,6,3,3
582,Valanaari,argent-dawn,288,deathknight,unholy,12,3,9
583,Dimania,the-maelstrom,288,deathknight,unholy,12,3,9
584,Tyranuse,kazzak,288,deathknight,unholy,12,3,9
585,Lair,shendralar,288,deathknight,unholy,12,3,9
586,Helixsdk,outland,288,deathknight,unholy,12,3,9
587,Cleverb,silvermoon,288,deathknight,unholy,12,3,9
588,Ràiven,blackmoore,288,deathknight,unholy,12,3,9
589,Plaguebones,ravencrest,288,deathknight,unholy,12,3,9
590,Drraugrinn,tarren-mill,288,deathknight,unholy,12,3,9
591,Тхиро,gordunni,288,deathknight,unholy,12,3,9
592,Дерайв,gordunni,288,deathknight,unholy,12,3,9
593,Эвессом,goldrinn,288,deathknight,unholy,12,3,9
594,Chains,sanguino,288,deathknight,unholy,12,3,9
595,Морталес,azuregos,288,deathknight,unholy,12,3,9
596,Garasu,eredar,288,deathknight,unholy,18,3,15
597,Abyad,dalaran,285,deathknight,unholy,12,3,9
598,Dekayo,blackrock,256,deathknight,unholy,10,3,7
599,Hateem,sylvanas,255,deathknight,unholy,11,3,8
600,Narrua,die-aldor,255,deathknight,unholy,11,3,8
601,Xawias,ulduar,234,deathknight,unholy,8,4,4
602,Nexium,outland,192,deathknight,unholy,4,3,1
603,Alti,blackmoore,192,deathknight,unholy,4,3,1
604,Homelándér,blackmoore,192,deathknight,unholy,6,2,4
605,Thryndiel,ravencrest,192,deathknight,unholy,6,2,4
606,Iziqroi,archimonde,192,deathknight,unholy,6,2,4
607,Feldøøm,nemesis,192,deathknight,unholy,6,2,4
608,Kacpèr,burning-legion,192,deathknight,unholy,6,2,4
609,Bigblackgrip,hyjal,192,deathknight,unholy,6,2,4
610,Nihilistyx,blackrock,192,deathknight,unholy,6,2,4
611,Буризан,blackscar,192,deathknight,unholy,6,2,4
612,Engelinä,ysondre,192,deathknight,unholy,6,2,4
613,Гнилец,soulflayer,192,deathknight,unholy,6,2,4
614,Dk,earthen-ring,192,deathknight,unholy,6,2,4
615,Haeydez,draenor,192,deathknight,unholy,6,2,4
616,Eyyoo,blackmoore,192,deathknight,unholy,6,2,4
617,Thoir,ahnqiraj,192,deathknight,unholy,6,2,4
618,Worldwiynd,ravencrest,192,deathknight,unholy,6,2,4
619,Norux,alonsus,192,deathknight,unholy,6,2,4
620,Postura,kazzak,192,deathknight,unholy,6,2,4
621,Kraken,aerie-peak,192,deathknight,unholy,6,2,4
622,Unholyysteel,silvermoon,192,deathknight,unholy,6,2,4
623,Alameda,nathrezim,192,deathknight,unholy,6,2,4
624,Letudra,outland,192,deathknight,unholy,6,2,4
625,Elendren,blackrock,192,deathknight,unholy,6,2,4
626,Шинратенсеи,howling-fjord,192,deathknight,unholy,6,2,4
627,Urukaye,silvermoon,192,deathknight,unholy,6,2,4
628,Mustapha,kazzak,192,deathknight,unholy,6,2,4
629,Scareanger,argent-dawn,192,deathknight,unholy,6,2,4
630,Eigrin,argent-dawn,192,deathknight,unholy,6,2,4
631,Njor,twisting-nether,192,deathknight,unholy,6,2,4
632,Аэрит,howling-fjord,192,deathknight,unholy,6,2,4
633,Amyntasz,twisting-nether,192,deathknight,unholy,6,2,4
634,Fdkgotbuffed,tarren-mill,192,deathknight,unholy,6,2,4
635,Zugzugdecay,kazzak,192,deathknight,unholy,6,2,4
636,Даркслэш,howling-fjord,192,deathknight,unholy,6,2,4
637,Exult,twisting-nether,192,deathknight,unholy,6,2,4
638,Ketnissq,blackrock,192,deathknight,unholy,6,2,4
639,Kromas,silvermoon,192,deathknight,unholy,6,2,4
640,Rimda,twisting-nether,192,deathknight,unholy,6,2,4
641,Vrez,argent-dawn,192,deathknight,unholy,6,2,4
642,Lithics,blades-edge,192,deathknight,unholy,6,2,4
643,Clipe,sanguino,192,deathknight,unholy,6,2,4
644,Nestia,emerald-dream,192,deathknight,unholy,12,2,10
645,Cyliandra,silvermoon,192,deathknight,unholy,12,2,10
646,Гадиния,soulflayer,191,deathknight,unholy,4,3,1
647,Àragørn,blackrock,191,deathknight,unholy,6,2,4
648,Джагат,gordunni,191,deathknight,unholy,12,2,10
649,Civilredevil,ravencrest,159,deathknight,unholy,5,2,3
650,Calhoun,teldrassil,159,deathknight,unholy,5,2,3
651,Dødsmanna,twisting-nether,144,deathknight,unholy,9,2,7
652,Táli,tarren-mill,144,deathknight,unholy,9,2,7
653,Cayliadk,tarren-mill,138,deathknight,unholy,14,4,10
654,Auto,hyjal,128,deathknight,unholy,4,2,2
655,Flinsen,blackmoore,106,deathknight,unholy,12,3,9
656,Inmau,sanguino,96,deathknight,unholy,3,2,1
657,Jarhèad,grim-batol,96,deathknight,unholy,10,3,7
658,Eívór,garrosh,96,deathknight,unholy,6,1,5
659,Rongos,norgannon,96,deathknight,unholy,6,1,5
660,Dumbclass,wildhammer,96,deathknight,unholy,6,1,5
661,Kirkster,terokkar,96,deathknight,unholy,6,1,5
662,Orrengo,blackrock,96,deathknight,unholy,6,1,5
663,Lieven,tarren-mill,96,deathknight,unholy,6,1,5
664,Madsgrip,tarren-mill,96,deathknight,unholy,6,1,5
665,Vîrus,kazzak,96,deathknight,unholy,6,1,5
666,Grimgôr,kazzak,96,deathknight,unholy,6,1,5
667,Каскадёрка,howling-fjord,96,deathknight,unholy,6,1,5
668,Peiie,ravencrest,96,deathknight,unholy,6,1,5
669,Sìrmooalot,twisting-nether,96,deathknight,unholy,6,1,5
670,Bytedk,aggra-português,96,deathknight,unholy,6,1,5
671,Gdubet,kazzak,96,deathknight,unholy,6,1,5
672,Fixmybones,frostmane,96,deathknight,unholy,6,1,5
673,Mjölnir,sanguino,96,deathknight,unholy,6,1,5
674,Madseason,burning-legion,96,deathknight,unholy,6,1,5
675,Halez,antonidas,96,deathknight,unholy,6,1,5
676,Antexdk,drakthul,96,deathknight,unholy,6,1,5
677,Wavemaker,kazzak,96,deathknight,unholy,6,1,5
678,Брексиен,gordunni,96,deathknight,unholy,6,1,5
679,Инфлюминс,soulflayer,96,deathknight,unholy,6,1,5
680,Sulf,burning-legion,96,deathknight,unholy,6,1,5
681,Spøøk,defias-brotherhood,96,deathknight,unholy,6,1,5
682,Skrati,das-syndikat,96,deathknight,unholy,6,1,5
683,Cameltôe,frostwolf,96,deathknight,unholy,6,1,5
684,Dextèr,stormreaver,96,deathknight,unholy,6,1,5
685,Mámmôn,malygos,96,deathknight,unholy,7,1,6
686,Brasith,outland,96,deathknight,unholy,12,1,11
687,Форнителли,howling-fjord,96,deathknight,unholy,12,1,11
688,Buzknight,twisting-nether,96,deathknight,unholy,12,1,11
689,Charai,blackhand,42,deathknight,unholy,8,2,6
690,Шарабум,howling-fjord,16,deathknight,unholy,7,1,6
691,Никнейм,gordunni,2096,deathknight,frost,90,48,42
692,Garrinchá,stormscale,2040,deathknight,frost,60,36,24
693,Anotherdkx,ravencrest,1997,deathknight,frost,60,36,24
694,Имерсий,gordunni,1929,deathknight,frost,42,26,16
695,Igetmount,draenor,1895,deathknight,frost,36,20,16
696,Fdkgotbuffed,tarren-mill,1865,deathknight,frost,48,25,23
697,Murbastic,draenor,1863,deathknight,frost,162,78,84
698,Jeanice,blackhand,1833,deathknight,frost,42,23,19
699,Viuff,kazzak,1814,deathknight,frost,36,19,17
700,Gorobijec,drakthul,1680,deathknight,frost,42,21,21
701,Brawlerbabe,stormscale,1679,deathknight,frost,78,39,39
702,Дарргг,ashenvale,1664,deathknight,frost,60,27,33
703,Deucàlyqt,nemesis,1646,deathknight,frost,52,24,28
704,Rêxaks,dun-modr,1630,deathknight,frost,42,19,23
705,Geunieve,ysondre,1621,deathknight,frost,60,23,37
706,Duriel,stormscale,1619,deathknight,frost,36,22,14
707,Banishabomb,ragnaros,1615,deathknight,frost,78,39,39
708,Vidofnir,argent-dawn,1611,deathknight,frost,56,31,25
709,Arxelas,sylvanas,1609,deathknight,frost,148,78,70
710,Xolaani,outland,1596,deathknight,frost,36,20,16
711,Frostlux,archimonde,1596,deathknight,frost,268,125,143
712,Винкис,gordunni,1581,deathknight,frost,42,25,17
713,Kailara,draenor,1556,deathknight,frost,48,26,22
714,Raylenx,uldaman,1543,deathknight,frost,63,31,32
715,Deucalyqt,nemesis,1538,deathknight,frost,66,31,35
716,Dripgrip,ravencrest,1529,deathknight,frost,77,36,41
717,Regniér,frostwolf,1503,deathknight,frost,86,39,47
718,Chakko,ravencrest,1503,deathknight,frost,36,16,20
719,Dktroll,blackmoore,1489,deathknight,frost,139,63,76
720,Leónid,kazzak,1486,deathknight,frost,33,17,16
721,Cayliadk,tarren-mill,1456,deathknight,frost,117,55,62
722,Furleyc,argent-dawn,1433,deathknight,frost,48,29,19
723,Fallenjaina,kazzak,1433,deathknight,frost,84,39,45
724,Stevensdk,darkspear,1427,deathknight,frost,36,17,19
725,Кулькулегал,ashenvale,1424,deathknight,frost,24,15,9
726,Маклайкнайт,gordunni,1417,deathknight,frost,78,36,42
727,Skorice,dalaran,1415,deathknight,frost,42,17,25
728,Düksito,dun-modr,1392,deathknight,frost,63,32,31
729,Фростмаран,soulflayer,1373,deathknight,frost,96,45,51
730,Frostmommy,argent-dawn,1371,deathknight,frost,39,16,23
731,Ðeucaly,nemesis,1357,deathknight,frost,66,30,36
732,Mocca,aegwynn,1357,deathknight,frost,52,21,31
733,Døuffy,hyjal,1319,deathknight,frost,48,24,24
734,Ihatelife,frostwolf,1304,deathknight,frost,42,19,23
735,Superere,hyjal,1300,deathknight,frost,78,43,35
736,Devilknight,dentarg,1282,deathknight,frost,60,31,29
737,Comehere,norgannon,1273,deathknight,frost,24,15,9
738,Âlîce,culte-de-la-rive-noire,1247,deathknight,frost,36,16,20
739,Кроуфрост,gordunni,1245,deathknight,frost,42,19,23
740,Düks,dun-modr,1238,deathknight,frost,87,39,48
741,Arthasuk,dun-modr,1207,deathknight,frost,68,36,32
742,Twardobaba,burning-legion,1203,deathknight,frost,38,17,21
743,Krasny,hyjal,1179,deathknight,frost,78,42,36
744,Abnormus,tarren-mill,1179,deathknight,frost,72,38,34
745,Espatula,ravencrest,1150,deathknight,frost,18,12,6
746,Tenzøftw,archimonde,1148,deathknight,frost,24,12,12
747,Nôsferatú,amanthul,1145,deathknight,frost,78,39,39
748,Morgouse,kazzak,1145,deathknight,frost,47,17,30
749,Darkchas,silvermoon,1144,deathknight,frost,24,12,12
750,Геннош,howling-fjord,1143,deathknight,frost,24,12,12
751,Zerodude,silvermoon,1142,deathknight,frost,60,30,30
752,Mattesøs,drakthul,1130,deathknight,frost,36,13,23
753,Dkruffos,draenor,1114,deathknight,frost,60,24,36
754,Woddey,blackrock,1073,deathknight,frost,48,22,26
755,Вафельнаяфея,blackscar,1073,deathknight,frost,43,17,26
756,Azrador,frostwolf,1071,deathknight,frost,36,12,24
757,Polimeh,draenor,1048,deathknight,frost,36,19,17
758,Alastoras,nemesis,1011,deathknight,frost,24,11,13
759,Quantumshift,ravencrest,1004,deathknight,frost,17,11,6
760,Dakyforfun,ravencrest,960,deathknight,frost,12,10,2
761,Flúrrý,kazzak,960,deathknight,frost,24,10,14
762,Mikagoddess,argent-dawn,959,deathknight,frost,18,10,8
763,Ivik,the-maelstrom,957,deathknight,frost,26,15,11
764,Sionya,outland,956,deathknight,frost,18,10,8
765,Ubiystvo,kazzak,955,deathknight,frost,18,10,8
766,Collinná,aegwynn,939,deathknight,frost,30,10,20
767,Fareast,nerathor,914,deathknight,frost,66,32,34
768,Dursall,thrall,912,deathknight,frost,119,56,63
769,Нифер,deathguard,894,deathknight,frost,20,10,10
770,Kixx,bloodfeather,873,deathknight,frost,53,13,40
771,ßambøøzle,draenor,864,deathknight,frost,18,9,9
772,Wrathlich,tyrande,863,deathknight,frost,18,9,9
773,Asphyxias,alleria,863,deathknight,frost,18,9,9
774,Neorteriona,argent-dawn,860,deathknight,frost,18,9,9
775,Vîrus,kazzak,859,deathknight,frost,18,9,9
776,Peachvajz,turalyon,855,deathknight,frost,24,11,13
777,Khelthalas,teldrassil,841,deathknight,frost,13,10,3
778,Guillemet,turalyon,830,deathknight,frost,16,10,6
779,Elbaqwan,the-shatar,827,deathknight,frost,30,13,17
780,Craftmaker,eonar,816,deathknight,frost,44,19,25
781,Ниффер,deathguard,800,deathknight,frost,22,9,13
782,Afadk,kazzak,769,deathknight,frost,36,13,23
783,Селес,ashenvale,768,deathknight,frost,12,8,4
784,Elendren,blackrock,768,deathknight,frost,12,8,4
785,Diogenisis,arthas,768,deathknight,frost,24,8,16
786,Kooklynn,aggra-português,767,deathknight,frost,12,8,4
787,Jollíe,tarren-mill,767,deathknight,frost,24,8,16
788,Orcborg,zuljin,764,deathknight,frost,18,8,10
789,Gageth,shadowsong,763,deathknight,frost,33,9,24
790,Fullbusterr,hyjal,761,deathknight,frost,12,8,4
791,Lichfils,chogall,745,deathknight,frost,27,8,19
792,Veneera,emeriss,672,deathknight,frost,12,7,5
793,Малтель,howling-fjord,672,deathknight,frost,12,7,5
794,Gorefiend,kazzak,672,deathknight,frost,12,7,5
795,Selena,blackmoore,672,deathknight,frost,12,7,5
796,Halohuntress,outland,671,deathknight,frost,18,7,11
797,Меланндрис,gordunni,669,deathknight,frost,15,8,7
798,Moosbirne,blackhand,669,deathknight,frost,18,7,11
799,Iaccidens,stormscale,669,deathknight,frost,24,7,17
800,Gravehammer,sylvanas,663,deathknight,frost,12,7,5
801,Aczheron,argent-dawn,660,deathknight,frost,24,7,17
802,Rubbann,ravencrest,576,deathknight,frost,12,6,6
803,Orangatang,dalaran,576,deathknight,frost,12,6,6
804,Планус,booty-bay,576,deathknight,frost,12,6,6
805,Narali,argent-dawn,576,deathknight,frost,12,6,6
806,Êbøla,sanguino,575,deathknight,frost,12,6,6
807,Izanagii,exodar,572,deathknight,frost,12,6,6
808,Tyranuse,kazzak,527,deathknight,frost,17,6,11
809,Exodiuss,dalaran,510,deathknight,frost,16,6,10
810,Unaxito,sanguino,480,deathknight,frost,6,5,1
811,Deckbulle,blackhand,480,deathknight,frost,6,5,1
812,Асаала,soulflayer,480,deathknight,frost,6,5,1
813,Deucalygodx,nemesis,480,deathknight,frost,12,5,7
814,Ûñhølýðéåthj,tarren-mill,480,deathknight,frost,12,5,7
815,Worlviuz,argent-dawn,480,deathknight,frost,12,5,7
816,Deathknight,spinebreaker,480,deathknight,frost,12,5,7
817,Feelmyfuri,mazrigos,480,deathknight,frost,12,5,7
818,Xtream,blackmoore,479,deathknight,frost,12,5,7
819,Ostridz,grim-batol,479,deathknight,frost,12,5,7
820,Mauryr,drakthul,479,deathknight,frost,12,5,7
821,Deadpòól,twisting-nether,479,deathknight,frost,18,5,13
822,Copium,hyjal,477,deathknight,frost,12,5,7
823,Fishtruction,tarren-mill,476,deathknight,frost,12,5,7
824,Predatormkdd,ravencrest,429,deathknight,frost,11,5,6
825,Reann,argent-dawn,384,deathknight,frost,6,4,2
826,Enzy,drakthul,384,deathknight,frost,6,4,2
827,Gozuryu,kazzak,384,deathknight,frost,6,4,2
828,Oldiseas,grim-batol,384,deathknight,frost,6,4,2
829,Namzera,draenor,384,deathknight,frost,6,4,2
830,Nymfo,tirion,384,deathknight,frost,6,4,2
831,Indrette,archimonde,384,deathknight,frost,6,4,2
832,Neitoperho,frostmane,384,deathknight,frost,12,4,8
833,Æew,kazzak,384,deathknight,frost,12,4,8
834,Belía,blackmoore,384,deathknight,frost,12,4,8
835,Doodcraft,tarren-mill,384,deathknight,frost,12,4,8
836,Sipsip,tarren-mill,384,deathknight,frost,12,4,8
837,Кокосоус,gordunni,384,deathknight,frost,17,4,13
838,Beherith,sunstrider,383,deathknight,frost,6,4,2
839,Tÿnak,der-mithrilorden,383,deathknight,frost,9,4,5
840,Kivo,marécage-de-zangar,383,deathknight,frost,12,4,8
841,Гадиния,soulflayer,383,deathknight,frost,12,4,8
842,Eckodk,aggra-português,383,deathknight,frost,12,4,8
843,Бранс,gordunni,383,deathknight,frost,12,4,8
844,Breeze,xavius,383,deathknight,frost,12,4,8
845,Дневнои,howling-fjord,382,deathknight,frost,12,4,8
846,Whippy,ravencrest,288,deathknight,frost,6,3,3
847,Apraxia,ravencrest,288,deathknight,frost,6,3,3
848,Джайвана,soulflayer,288,deathknight,frost,6,3,3
849,Ogomegee,ravencrest,288,deathknight,frost,6,3,3
850,Jjayker,kazzak,288,deathknight,frost,6,3,3
851,Cyphîllyth,auchindoun,288,deathknight,frost,6,3,3
852,Necrozy,aggra-português,288,deathknight,frost,6,3,3
853,Keridíin,twisting-nether,288,deathknight,frost,6,3,3
854,Modelo,twisting-nether,288,deathknight,frost,6,3,3
855,Vaanor,draenor,288,deathknight,frost,6,3,3
856,Xanthic,ravencrest,288,deathknight,frost,6,3,3
857,Moko,defias-brotherhood,288,deathknight,frost,6,3,3
858,Шэйп,fordragon,288,deathknight,frost,6,3,3
859,Gringly,tarren-mill,288,deathknight,frost,6,3,3
860,Persefal,nemesis,288,deathknight,frost,6,3,3
861,Nazgül,drakthul,288,deathknight,frost,6,3,3
862,Madseason,burning-legion,288,deathknight,frost,6,3,3
863,Endlesspain,burning-legion,288,deathknight,frost,6,3,3
864,Руин,blackscar,288,deathknight,frost,6,3,3
865,Raihor,outland,288,deathknight,frost,8,3,5
866,Prekliatylad,burning-blade,288,deathknight,frost,12,3,9
867,Zoree,draenor,288,deathknight,frost,12,3,9
868,Тенелла,gordunni,288,deathknight,frost,12,3,9
869,Zuggandk,tarren-mill,288,deathknight,frost,12,3,9
870,Eynoway,blackmoore,288,deathknight,frost,12,3,9
871,Thilior,silvermoon,288,deathknight,frost,12,3,9
872,Tzunâ,blackmoore,288,deathknight,frost,18,3,15
873,Dekagramcz,drakthul,287,deathknight,frost,6,3,3
874,Antîlâ,antonidas,286,deathknight,frost,6,3,3
875,Venthyrgwa,kazzak,284,deathknight,frost,7,5,2
876,Deadlygnome,silvermoon,192,deathknight,frost,6,2,4
877,Seasonfive,arathor,192,deathknight,frost,6,2,4
878,Notstacy,dragonblight,192,deathknight,frost,6,2,4
879,Sindó,blackrock,192,deathknight,frost,6,2,4
880,Abadonn,archimonde,192,deathknight,frost,6,2,4
881,Pandahapci,ragnaros,192,deathknight,frost,6,2,4
882,Køley,draenor,192,deathknight,frost,6,2,4
883,Dreadmind,blackrock,192,deathknight,frost,6,2,4
884,Ilaenu,ravencrest,192,deathknight,frost,6,2,4
885,Deathcardos,die-aldor,192,deathknight,frost,6,2,4
886,Toffy,anetheron,192,deathknight,frost,6,2,4
887,Doozz,draenor,192,deathknight,frost,6,2,4
888,Ilovegouàng,khaz-modan,192,deathknight,frost,6,2,4
889,Ratge,hyjal,192,deathknight,frost,6,2,4
890,Vaffe,tarren-mill,192,deathknight,frost,6,2,4
891,Mennal,the-maelstrom,192,deathknight,frost,6,2,4
892,Royalcrown,stormscale,192,deathknight,frost,6,2,4
893,Tyró,ravencrest,192,deathknight,frost,6,2,4
894,Hordak,stormscale,192,deathknight,frost,6,2,4
895,Ullefuz,silvermoon,192,deathknight,frost,6,2,4
896,Leonis,arthas,192,deathknight,frost,6,2,4
897,Narrua,die-aldor,192,deathknight,frost,12,2,10
898,Zioan,jaedenar,191,deathknight,frost,6,2,4
899,Nîghtmáre,ravencrest,159,deathknight,frost,5,2,3
900,Бахлыщ,soulflayer,96,deathknight,frost,6,1,5
901,Hydross,archimonde,96,deathknight,frost,6,1,5
902,Thryndiel,ravencrest,96,deathknight,frost,6,1,5
903,Dïkcite,archimonde,96,deathknight,frost,6,1,5
904,Буризан,blackscar,96,deathknight,frost,6,1,5
905,Urukaye,silvermoon,96,deathknight,frost,6,1,5
906,Arrèsted,aegwynn,96,deathknight,frost,6,1,5
907,Gigadk,ragnaros,96,deathknight,frost,6,1,5
908,Discochoppa,blackmoore,96,deathknight,frost,6,1,5
909,Kaeyz,blackmoore,96,deathknight,frost,6,1,5
910,Pestilerous,draenor,96,deathknight,frost,6,1,5
911,Veçh,turalyon,96,deathknight,frost,6,1,5
912,Cleverb,silvermoon,96,deathknight,frost,6,1,5
913,Thínkk,ysondre,96,deathknight,frost,6,1,5
914,Ezlar,silvermoon,96,deathknight,frost,6,1,5
915,Slimez,magtheridon,96,deathknight,frost,6,1,5
916,Anasûrimbor,tarren-mill,96,deathknight,frost,6,1,5
917,Feddk,stormscale,96,deathknight,frost,6,1,5
918,Arthursq,stormscale,95,deathknight,frost,6,1,5
919,Assølid,arathor,42,deathknight,frost,11,2,9
920,Zslebaans,dun-modr,2204,demonhunter,havoc,104,55,49
921,Itsdampbaby,kazzak,2187,demonhunter,havoc,79,44,35
922,Norgàn,die-aldor,2178,demonhunter,havoc,81,44,37
923,Elswavé,kazzak,2174,demonhunter,havoc,78,48,30
924,Ðesz,sanguino,2153,demonhunter,havoc,95,52,43
925,Enysia,twisting-nether,2127,demonhunter,havoc,122,62,60
926,Melan,sanguino,2116,demonhunter,havoc,108,54,54
927,Лфгхиро,soulflayer,2101,demonhunter,havoc,65,37,28
928,Razzagall,elune,2101,demonhunter,havoc,54,30,24
929,Heatx,ysondre,2094,demonhunter,havoc,138,79,59
930,Veon,ravencrest,2075,demonhunter,havoc,269,133,136
931,Ohseri,defias-brotherhood,2073,demonhunter,havoc,126,64,62
932,Évø,silvermoon,2064,demonhunter,havoc,90,44,46
933,Boostbydh,archimonde,2044,demonhunter,havoc,207,107,100
934,Battlebruh,ghostlands,2032,demonhunter,havoc,83,39,44
935,Læsy,antonidas,2025,demonhunter,havoc,101,53,48
936,Истребитель,blackscar,2016,demonhunter,havoc,114,74,40
937,Illislan,darksorrow,1985,demonhunter,havoc,191,101,90
938,Anabbele,kazzak,1968,demonhunter,havoc,96,52,44
939,Betterevoker,outland,1953,demonhunter,havoc,66,41,25
940,Bxdh,outland,1952,demonhunter,havoc,75,36,39
941,Мортрэд,gordunni,1950,demonhunter,havoc,66,39,27
942,Aiean,ravencrest,1950,demonhunter,havoc,78,39,39
943,Pipeandy,kazzak,1946,demonhunter,havoc,95,52,43
944,Battlebruuh,ghostlands,1935,demonhunter,havoc,66,27,39
945,Ïîï,archimonde,1934,demonhunter,havoc,79,37,42
946,Scubaman,tarren-mill,1932,demonhunter,havoc,54,31,23
947,Cydh,auchindoun,1917,demonhunter,havoc,72,36,36
948,Damatche,outland,1910,demonhunter,havoc,136,68,68
949,Brawndow,draenor,1905,demonhunter,havoc,90,46,44
950,Boxssabanned,archimonde,1903,demonhunter,havoc,89,44,45
951,Cuddlypeanut,argent-dawn,1898,demonhunter,havoc,76,36,40
952,Belvé,draenor,1897,demonhunter,havoc,84,43,41
953,Màuul,ravencrest,1897,demonhunter,havoc,189,95,94
954,Walkmyshoes,twisting-nether,1877,demonhunter,havoc,102,51,51
955,Tyssra,argent-dawn,1870,demonhunter,havoc,96,42,54
956,Donkeydh,tarren-mill,1868,demonhunter,havoc,54,36,18
957,Perna,ghostlands,1867,demonhunter,havoc,60,29,31
958,Oldforwow,outland,1863,demonhunter,havoc,102,55,47
959,Çøððøøððøøðð,blackmoore,1863,demonhunter,havoc,60,32,28
960,Demonalpha,stormscale,1862,demonhunter,havoc,43,23,20
961,Brolafsen,ravencrest,1859,demonhunter,havoc,66,32,34
962,Kindablind,aggramar,1858,demonhunter,havoc,77,39,38
963,Apfelbaum,die-aldor,1857,demonhunter,havoc,60,40,20
964,Badtimes,malganis,1857,demonhunter,havoc,225,113,112
965,Possomhd,kazzak,1856,demonhunter,havoc,114,70,44
966,Carboen,tarren-mill,1856,demonhunter,havoc,96,52,44
967,Fiveyearques,sylvanas,1856,demonhunter,havoc,102,49,53
968,Mädchen,blackhand,1854,demonhunter,havoc,48,23,25
969,Dasein,tarren-mill,1852,demonhunter,havoc,54,29,25
970,Paschli,tarren-mill,1850,demonhunter,havoc,60,29,31
971,Elipireli,doomhammer,1846,demonhunter,havoc,42,20,22
972,Gíftig,ravencrest,1843,demonhunter,havoc,47,24,23
973,Клопобойка,gordunni,1842,demonhunter,havoc,69,37,32
974,Bloodwatcher,twisting-nether,1842,demonhunter,havoc,54,27,27
975,Ïfï,archimonde,1837,demonhunter,havoc,95,50,45
976,Fotmdehatwo,blackrock,1837,demonhunter,havoc,61,32,29
977,Nøbodyx,tarren-mill,1837,demonhunter,havoc,66,33,33
978,Sofun,stormscale,1836,demonhunter,havoc,74,34,40
979,Ðoksy,archimonde,1835,demonhunter,havoc,60,31,29
980,Gilletteabdi,argent-dawn,1833,demonhunter,havoc,78,35,43
981,Zeroques,frostmane,1831,demonhunter,havoc,66,33,33
982,Сасун,galakrond,1831,demonhunter,havoc,69,32,37
983,Supay,rexxar,1830,demonhunter,havoc,58,31,27
984,Рейз,howling-fjord,1828,demonhunter,havoc,108,56,52
985,Yamehd,stormreaver,1827,demonhunter,havoc,42,26,16
986,Chxpo,twisting-nether,1826,demonhunter,havoc,89,47,42
987,Сибу,soulflayer,1825,demonhunter,havoc,48,21,27
988,Vexanic,chamber-of-aspects,1824,demonhunter,havoc,60,33,27
989,Элизар,howling-fjord,1821,demonhunter,havoc,120,61,59
990,Rvnx,archimonde,1820,demonhunter,havoc,122,72,50
991,Iryut,onyxia,1820,demonhunter,havoc,60,32,28
992,Malignantx,ragnaros,1819,demonhunter,havoc,54,30,24
993,Krm,dun-modr,1818,demonhunter,havoc,38,23,15
994,Mongoose,drakthul,1818,demonhunter,havoc,66,35,31
995,Maytherel,blackhand,1818,demonhunter,havoc,84,38,46
996,Dreamslash,tarren-mill,1817,demonhunter,havoc,52,29,23
997,Airelidari,tyrande,1817,demonhunter,havoc,149,76,73
998,Flyingwhale,terokkar,1815,demonhunter,havoc,33,21,12
999,Unseenshadow,ragnaros,1813,demonhunter,havoc,60,25,35
1000,Tórstenstøck,ravencrest,1811,demonhunter,havoc,47,31,16
1001,Elsynn,dalaran,1811,demonhunter,havoc,60,32,28
1002,Djratatouill,kazzak,1810,demonhunter,havoc,42,27,15
1003,Glìmpsêgøðx,twisting-nether,1809,demonhunter,havoc,42,22,20
1004,Хменчик,soulflayer,1809,demonhunter,havoc,97,47,50
1005,Yúki,blackrock,1809,demonhunter,havoc,48,23,25
1006,Ææçëñ,ravencrest,1808,demonhunter,havoc,36,23,13
1007,Xarôth,eredar,1805,demonhunter,havoc,48,22,26
1008,Cláw,ravencrest,1804,demonhunter,havoc,90,45,45
1009,Дэн,blackscar,1802,demonhunter,havoc,48,28,20
1010,Barbarinjo,silvermoon,1800,demonhunter,havoc,36,22,14
1011,Миелион,gordunni,1800,demonhunter,havoc,65,29,36
1012,Donipwnz,blackrock,1799,demonhunter,havoc,66,29,37
1013,Lassudan,stormreaver,1796,demonhunter,havoc,47,23,24
1014,Funkiller,stormscale,1788,demonhunter,havoc,46,24,22
1015,Mazöku,ravencrest,1787,demonhunter,havoc,72,41,31
1016,Eyasluna,twisting-nether,1779,demonhunter,havoc,54,24,30
1017,Zuklio,ysondre,1778,demonhunter,havoc,59,29,30
1018,Автокикер,soulflayer,1771,demonhunter,havoc,54,31,23
1019,Pulsefuzzy,burning-legion,1770,demonhunter,havoc,48,28,20
1020,Netherim,twisting-nether,1768,demonhunter,havoc,60,27,33
1021,Batik,blackmoore,1764,demonhunter,havoc,101,50,51
1022,Lelaniae,blackhand,1759,demonhunter,havoc,48,20,28
1023,Primolover,outland,1751,demonhunter,havoc,66,33,33
1024,Gøat,nemesis,1745,demonhunter,havoc,54,32,22
1025,Onof,hyjal,1742,demonhunter,havoc,54,26,28
1026,Felom,garona,1741,demonhunter,havoc,36,22,14
1027,Zerinitý,outland,1737,demonhunter,havoc,54,29,25
1028,Wojtall,silvermoon,1735,demonhunter,havoc,113,63,50
1029,Майотх,gordunni,1735,demonhunter,havoc,96,45,51
1030,Аркантт,soulflayer,1735,demonhunter,havoc,48,20,28
1031,Cuirnoir,ravencrest,1734,demonhunter,havoc,36,20,16
1032,Dadøw,dun-modr,1732,demonhunter,havoc,48,21,27
1033,Weez,kilrogg,1731,demonhunter,havoc,72,35,37
1034,Razex,kazzak,1730,demonhunter,havoc,87,44,43
1035,Haldin,kazzak,1728,demonhunter,havoc,41,22,19
1036,Khétí,tarren-mill,1728,demonhunter,havoc,65,32,33
1037,Stazó,drakthul,1726,demonhunter,havoc,91,48,43
1038,Mojothejojo,ravencrest,1725,demonhunter,havoc,44,24,20
1039,Alundil,ravencrest,1725,demonhunter,havoc,60,32,28
1040,Nuxzhell,tarren-mill,1725,demonhunter,havoc,132,66,66
1041,Kinstak,sanguino,1725,demonhunter,havoc,54,27,27
1042,Camtoe,ravencrest,1723,demonhunter,havoc,88,53,35
1043,Finwe,outland,1723,demonhunter,havoc,45,27,18
1044,Balberith,twisting-nether,1723,demonhunter,havoc,66,37,29
1045,Wibergdh,kazzak,1718,demonhunter,havoc,24,18,6
1046,Xekaul,tarren-mill,1715,demonhunter,havoc,104,49,55
1047,Íllìðåñgøðx,antonidas,1714,demonhunter,havoc,60,30,30
1048,Maevê,frostmourne,1712,demonhunter,havoc,37,19,18
1049,Mavorz,blackhand,1709,demonhunter,havoc,30,18,12
1050,Stickidan,malganis,1708,demonhunter,havoc,48,26,22
1051,Depure,blackrock,1707,demonhunter,havoc,48,24,24
1052,Hunee,kazzak,1706,demonhunter,havoc,54,32,22
1053,Íllìðåñgøðx,twisting-nether,1705,demonhunter,havoc,46,22,24
1054,Felen,zuljin,1703,demonhunter,havoc,47,21,26
1055,Авилолз,gordunni,1702,demonhunter,havoc,48,25,23
1056,Ryänåir,ravencrest,1701,demonhunter,havoc,54,34,20
1057,Indral,argent-dawn,1699,demonhunter,havoc,48,28,20
1058,Merelini,twisting-nether,1699,demonhunter,havoc,34,19,15
1059,Киттигоплей,soulflayer,1699,demonhunter,havoc,48,25,23
1060,Belákor,twisting-nether,1698,demonhunter,havoc,187,95,92
1061,Камуи,gordunni,1697,demonhunter,havoc,54,25,29
1062,Tanjero,stormscale,1696,demonhunter,havoc,53,36,17
1063,Çôæ,twisting-nether,1693,demonhunter,havoc,75,36,39
1064,Simshady,stormscale,1692,demonhunter,havoc,48,30,18
1065,Хэллшок,eversong,1691,demonhunter,havoc,30,20,10
1066,Âspen,archimonde,1690,demonhunter,havoc,66,42,24
1067,Demonkata,twisting-nether,1684,demonhunter,havoc,80,46,34
1068,Demonichanta,azjolnerub,1684,demonhunter,havoc,120,63,57
1069,Faufilé,garona,1684,demonhunter,havoc,36,18,18
1070,Slutkitten,ravencrest,1684,demonhunter,havoc,48,21,27
1071,Enfy,twisting-nether,1683,demonhunter,havoc,59,28,31
1072,Emurid,les-sentinelles,1682,demonhunter,havoc,54,26,28
1073,Demonmatheo,stormscale,1681,demonhunter,havoc,30,18,12
1074,Spheria,outland,1680,demonhunter,havoc,107,52,55
1075,Zkrdh,kazzak,1679,demonhunter,havoc,53,24,29
1076,Ranked,drakthul,1675,demonhunter,havoc,63,24,39
1077,Mentalìst,blackmoore,1674,demonhunter,havoc,63,37,26
1078,Ботология,gordunni,1674,demonhunter,havoc,54,27,27
1079,Шахдан,howling-fjord,1673,demonhunter,havoc,76,43,33
1080,Kïallz,hyjal,1672,demonhunter,havoc,165,89,76
1081,Imslapping,draenor,1669,demonhunter,havoc,66,37,29
1082,Satånist,outland,1669,demonhunter,havoc,54,26,28
1083,Nisirae,argent-dawn,1662,demonhunter,havoc,81,51,30
1084,Quazr,outland,1662,demonhunter,havoc,121,75,46
1085,Dyamo,sylvanas,1659,demonhunter,havoc,219,113,106
1086,Uldren,defias-brotherhood,1658,demonhunter,havoc,128,60,68
1087,Bojestvena,twisting-nether,1654,demonhunter,havoc,42,22,20
1088,Thorair,ravenholdt,1653,demonhunter,havoc,60,31,29
1089,Felski,outland,1653,demonhunter,havoc,49,23,26
1090,Xalgalor,silvermoon,1650,demonhunter,havoc,48,29,19
1091,Velysaría,guldan,1650,demonhunter,havoc,46,25,21
1092,Susanoø,eredar,1650,demonhunter,havoc,159,85,74
1093,Нэйтиси,soulflayer,1644,demonhunter,havoc,47,23,24
1094,Nolitara,exodar,1640,demonhunter,havoc,54,29,25
1095,Demonmancer,ravencrest,1639,demonhunter,havoc,114,62,52
1096,Врежимеэтти,soulflayer,1639,demonhunter,havoc,36,18,18
1097,Aofaye,aegwynn,1638,demonhunter,havoc,53,21,32
1098,Picpouc,archimonde,1637,demonhunter,havoc,54,24,30
1099,Riptos,blackhand,1635,demonhunter,havoc,46,22,24
1100,ßerdína,tarren-mill,1634,demonhunter,havoc,75,38,37
1101,Nèvér,silvermoon,1633,demonhunter,havoc,42,21,21
1102,Akkita,ravencrest,1631,demonhunter,havoc,68,38,30
1103,Shaihulud,sanguino,1630,demonhunter,havoc,145,81,64
1104,Evil,uldum,1630,demonhunter,havoc,84,46,38
1105,Temac,magtheridon,1630,demonhunter,havoc,42,22,20
1106,Jawohunt,rexxar,1630,demonhunter,havoc,54,18,36
1107,Molntuss,ravencrest,1629,demonhunter,havoc,80,36,44
1108,Billyhassan,kazzak,1628,demonhunter,havoc,30,18,12
1109,Reckqt,eredar,1628,demonhunter,havoc,30,17,13
1110,Azraethx,ravencrest,1627,demonhunter,havoc,36,24,12
1111,Eurobeat,dun-modr,1627,demonhunter,havoc,36,21,15
1112,Юзлескласс,gordunni,1627,demonhunter,havoc,36,20,16
1113,Xetalar,burning-legion,1626,demonhunter,havoc,144,84,60
1114,Omegapump,ravencrest,1626,demonhunter,havoc,36,19,17
1115,Nillrogthedh,stormscale,1625,demonhunter,havoc,90,59,31
1116,Unkqt,dalaran,1625,demonhunter,havoc,36,20,16
1117,Jumboo,tarren-mill,1625,demonhunter,havoc,53,29,24
1118,Drmanaburn,ravencrest,1624,demonhunter,havoc,30,17,13
1119,Dominik,the-maelstrom,1623,demonhunter,havoc,126,73,53
1120,Jolyh,nemesis,1622,demonhunter,havoc,36,24,12
1121,Sweetpety,tarren-mill,1622,demonhunter,havoc,63,37,26
1122,Lanadelbae,teldrassil,1622,demonhunter,havoc,91,46,45
1123,Fruchtzwerg,tarren-mill,1618,demonhunter,havoc,36,22,14
1124,Пибзянка,howling-fjord,1616,demonhunter,havoc,36,20,16
1125,Garoteromani,draenor,1612,demonhunter,havoc,60,38,22
1126,Lindzor,frostmane,1611,demonhunter,havoc,41,29,12
1127,Lilfly,twisting-nether,1611,demonhunter,havoc,30,17,13
1128,Gündüzgezen,silvermoon,1611,demonhunter,havoc,44,23,21
1129,Ted,frostwolf,1610,demonhunter,havoc,36,17,19
1130,Турбосвинья,gordunni,1608,demonhunter,havoc,48,26,22
1131,Przemson,mazrigos,1607,demonhunter,havoc,42,22,20
1132,Neralith,ravencrest,1607,demonhunter,havoc,42,20,22
1133,Майкелелекек,gordunni,1606,demonhunter,havoc,36,17,19
1134,Havocer,burning-legion,1605,demonhunter,havoc,60,33,27
1135,Èstefany,stormscale,1604,demonhunter,havoc,90,49,41
1136,Zevsa,ravencrest,1604,demonhunter,havoc,48,25,23
1137,Zayláh,ravencrest,1604,demonhunter,havoc,87,42,45
1138,Фэсс,soulflayer,1603,demonhunter,havoc,60,32,28
1139,Cheetòs,blackmoore,1602,demonhunter,havoc,24,17,7
1140,Крикадский,howling-fjord,1598,demonhunter,havoc,84,50,34
1141,Великаямыша,blackscar,1598,demonhunter,havoc,44,26,18
1142,Yousaindh,blackrock,1598,demonhunter,havoc,54,21,33
1143,Sepdy,draenor,1596,demonhunter,havoc,36,21,15
1144,Rezer,stormscale,1595,demonhunter,havoc,42,20,22
1145,Demoncyka,twisting-nether,1595,demonhunter,havoc,54,17,37
1146,Phesxdh,sylvanas,1594,demonhunter,havoc,30,23,7
1147,Sebyk,doomhammer,1591,demonhunter,havoc,54,32,22
1148,Gigasloth,outland,1589,demonhunter,havoc,24,18,6
1149,Dhzor,twisting-nether,1588,demonhunter,havoc,58,30,28
1150,Shanaplow,hyjal,1586,demonhunter,havoc,48,20,28
1151,Трукейт,gordunni,1582,demonhunter,havoc,56,33,23
1152,Amnésysx,ysondre,1581,demonhunter,havoc,42,19,23
1153,Геммула,howling-fjord,1575,demonhunter,havoc,144,70,74
1154,Rylqt,blackmoore,1570,demonhunter,havoc,48,21,27
1155,Shadyblady,nemesis,1568,demonhunter,havoc,46,24,22
1156,Дантеллиан,gordunni,1566,demonhunter,havoc,87,44,43
1157,Dhqoo,blackrock,1565,demonhunter,havoc,42,18,24
1158,Zireáel,stormscale,1562,demonhunter,havoc,32,18,14
1159,Roaf,twisting-nether,1561,demonhunter,havoc,57,28,29
1160,Lghdtv,ravencrest,1560,demonhunter,havoc,72,36,36
1161,Мужичок,soulflayer,1559,demonhunter,havoc,66,37,29
1162,Incanator,tarren-mill,1556,demonhunter,havoc,60,30,30
1163,Fullsënd,ragnaros,1546,demonhunter,havoc,60,25,35
1164,Däshgødx,stormscale,1543,demonhunter,havoc,54,31,23
1165,Tayo,dun-modr,1541,demonhunter,havoc,42,24,18
1166,Azaleia,archimonde,1540,demonhunter,havoc,107,53,54
1167,Чанпэн,soulflayer,1539,demonhunter,havoc,128,68,60
1168,Misli,stormscale,1537,demonhunter,havoc,30,19,11
1169,Boozlike,tarren-mill,1537,demonhunter,havoc,54,28,26
1170,Nixzon,thrall,1537,demonhunter,havoc,54,18,36
1171,Winxclub,ravencrest,1534,demonhunter,havoc,53,32,21
1172,Ambudh,kazzak,1533,demonhunter,havoc,30,16,14
1173,Demobob,tarren-mill,1533,demonhunter,havoc,30,16,14
1174,Neverdance,ravencrest,1533,demonhunter,havoc,36,16,20
1175,Râindra,twisting-nether,1532,demonhunter,havoc,132,66,66
1176,Shylea,ravencrest,1531,demonhunter,havoc,90,48,42
1177,Albunico,draenor,1527,demonhunter,havoc,105,59,46
1178,Kostiq,kazzak,1527,demonhunter,havoc,30,16,14
1179,Despèradø,archimonde,1527,demonhunter,havoc,60,30,30
1180,Alcóhon,ravencrest,1526,demonhunter,havoc,35,17,18
1181,Zintu,draenor,1526,demonhunter,havoc,66,30,36
1182,Dinastye,archimonde,1525,demonhunter,havoc,47,25,22
1183,Stellarvore,nemesis,1525,demonhunter,havoc,42,21,21
1184,Yeedhlol,blackmoore,1523,demonhunter,havoc,30,16,14
1185,Vênedri,eredar,1522,demonhunter,havoc,36,22,14
1186,Akaria,blackrock,1518,demonhunter,havoc,58,39,19
1187,Guccibaby,silvermoon,1517,demonhunter,havoc,54,27,27
1188,Ferihokurva,outland,1515,demonhunter,havoc,30,16,14
1189,Сосочков,soulflayer,1515,demonhunter,havoc,94,41,53
1190,Speedførce,antonidas,1513,demonhunter,havoc,36,16,20
1191,Pibzya,ravencrest,1512,demonhunter,havoc,33,17,16
1192,Slaanaesh,kazzak,1511,demonhunter,havoc,45,17,28
1193,Draxie,turalyon,1509,demonhunter,havoc,28,17,11
1194,Telarris,twisting-nether,1509,demonhunter,havoc,141,82,59
1195,Zitx,ravencrest,1507,demonhunter,havoc,47,26,21
1196,Edh,dalaran,1507,demonhunter,havoc,45,18,27
1197,Koomaliha,outland,1506,demonhunter,havoc,67,29,38
1198,Tenawees,blackmoore,1505,demonhunter,havoc,36,22,14
1199,Kayzel,argent-dawn,1504,demonhunter,havoc,78,37,41
1200,Tamtheone,silvermoon,1503,demonhunter,havoc,54,26,28
1201,Цэрри,soulflayer,1501,demonhunter,havoc,60,30,30
1202,Nuitrayer,hyjal,1497,demonhunter,havoc,50,33,17
1203,Hauntedseoul,grim-batol,1496,demonhunter,havoc,90,54,36
1204,Nøvillain,blackrock,1494,demonhunter,havoc,36,20,16
1205,Snitchezz,blackmoore,1493,demonhunter,havoc,96,51,45
1206,Цезарий,gordunni,1493,demonhunter,havoc,72,35,37
1207,Échô,tarren-mill,1489,demonhunter,havoc,40,18,22
1208,Shtahuntna,tarren-mill,1484,demonhunter,havoc,66,38,28
1209,Thingawoop,tarren-mill,1483,demonhunter,havoc,32,17,15
1210,Ноубрейндыха,gordunni,1483,demonhunter,havoc,54,26,28
1211,Duffin,doomhammer,1482,demonhunter,havoc,102,49,53
1212,Oonn,outland,1482,demonhunter,havoc,45,21,24
1213,Oggidanbuu,tarren-mill,1479,demonhunter,havoc,36,17,19
1214,Thehûnt,outland,1476,demonhunter,havoc,30,19,11
1215,Лизарин,gordunni,1476,demonhunter,havoc,35,16,19
1216,Frevee,outland,1475,demonhunter,havoc,95,54,41
1217,Vorbis,twisting-nether,1472,demonhunter,havoc,42,17,25
1218,Myztiko,hellscream,1470,demonhunter,havoc,140,72,68
1219,Blizdliksk,outland,1467,demonhunter,havoc,36,20,16
1220,Ilovelilith,zuljin,1466,demonhunter,havoc,47,22,25
1221,Фумиан,soulflayer,1465,demonhunter,havoc,52,22,30
1222,Arnokia,kazzak,1463,demonhunter,havoc,66,30,36
1223,Beerseewälk,ragnaros,1462,demonhunter,havoc,42,21,21
1224,Lasaka,stormscale,1460,demonhunter,havoc,30,19,11
1225,Împd,ravencrest,1456,demonhunter,havoc,90,43,47
1226,Ülquiorrä,kazzak,1450,demonhunter,havoc,53,34,19
1227,Аянамирейко,blackscar,1450,demonhunter,havoc,60,36,24
1228,Кирсена,gordunni,1450,demonhunter,havoc,35,17,18
1229,Shadoss,ravencrest,1447,demonhunter,havoc,54,22,32
1230,Valarauk,ravencrest,1440,demonhunter,havoc,87,51,36
1231,Flaybalbooll,ragnaros,1437,demonhunter,havoc,72,38,34
1232,Kebabidin,kazzak,1436,demonhunter,havoc,30,15,15
1233,Wibez,twisting-nether,1433,demonhunter,havoc,24,15,9
1234,Jesana,argent-dawn,1432,demonhunter,havoc,30,17,13
1235,Soizis,drakthul,1431,demonhunter,havoc,24,15,9
1236,Ifeeldirty,draenor,1431,demonhunter,havoc,31,16,15
1237,Darrkdemon,kazzak,1430,demonhunter,havoc,101,47,54
1238,Деструкцыя,howling-fjord,1426,demonhunter,havoc,39,22,17
1239,Thugrøse,blackrock,1426,demonhunter,havoc,60,31,29
1240,Hialdoo,sylvanas,1426,demonhunter,havoc,36,15,21
1241,Métakagoule,ysondre,1425,demonhunter,havoc,63,29,34
1242,Tkr,zuljin,1424,demonhunter,havoc,42,24,18
1243,Méruème,hyjal,1424,demonhunter,havoc,31,16,15
1244,Culywurly,silvermoon,1423,demonhunter,havoc,60,28,32
1245,Enthia,antonidas,1422,demonhunter,havoc,53,25,28
1246,Enhtailo,draenor,1421,demonhunter,havoc,24,15,9
1247,Ilidrax,hyjal,1421,demonhunter,havoc,30,15,15
1248,Doomcake,emeriss,1419,demonhunter,havoc,24,15,9
1249,Crappyftw,ravencrest,1416,demonhunter,havoc,126,64,62
1250,Toddsnuggles,thrall,1414,demonhunter,havoc,30,20,10
1251,Malakbel,nemesis,1413,demonhunter,havoc,81,38,43
1252,Коньх,goldrinn,1407,demonhunter,havoc,42,17,25
1253,Checakore,argent-dawn,1406,demonhunter,havoc,48,27,21
1254,Luzifer,ambossar,1406,demonhunter,havoc,129,68,61
1255,Luckertwo,tarren-mill,1403,demonhunter,havoc,60,33,27
1256,Древиал,gordunni,1399,demonhunter,havoc,30,16,14
1257,Malabala,grim-batol,1398,demonhunter,havoc,23,15,8
1258,Razziyel,ragnaros,1396,demonhunter,havoc,41,21,20
1259,Дартарин,gordunni,1395,demonhunter,havoc,62,34,28
1260,Cptxo,tarren-mill,1382,demonhunter,havoc,35,16,19
1261,Øbsessiøn,kazzak,1379,demonhunter,havoc,54,24,30
1262,Imlegalblind,ragnaros,1378,demonhunter,havoc,73,31,42
1263,Keanujeeves,dentarg,1376,demonhunter,havoc,60,33,27
1264,Pówèr,ravencrest,1375,demonhunter,havoc,42,23,19
1265,Ignasei,archimonde,1374,demonhunter,havoc,35,15,20
1266,Anstict,kazzak,1371,demonhunter,havoc,48,22,26
1267,Seyran,silvermoon,1367,demonhunter,havoc,30,15,15
1268,Iaml,ravencrest,1366,demonhunter,havoc,49,24,25
1269,Ziltush,archimonde,1366,demonhunter,havoc,81,38,43
1270,Monkeypox,twisting-nether,1366,demonhunter,havoc,46,19,27
1271,Покахонта,soulflayer,1364,demonhunter,havoc,70,35,35
1272,Imsickleavme,draenor,1363,demonhunter,havoc,64,32,32
1273,Varedisa,kazzak,1363,demonhunter,havoc,41,19,22
1274,Phudi,tarren-mill,1361,demonhunter,havoc,83,36,47
1275,Ларэгар,azuregos,1361,demonhunter,havoc,66,27,39
1276,Súrinox,blackrock,1355,demonhunter,havoc,77,44,33
1277,Lozakum,draenor,1353,demonhunter,havoc,46,24,22
1278,Агрочика,borean-tundra,1349,demonhunter,havoc,36,16,20
1279,Мицлейн,gordunni,1348,demonhunter,havoc,39,16,23
1280,Adalya,stormrage,1348,demonhunter,havoc,52,19,33
1281,Ibeem,dentarg,1346,demonhunter,havoc,33,23,10
1282,Obey,exodar,1346,demonhunter,havoc,41,20,21
1283,Thalamis,kazzak,1345,demonhunter,havoc,75,33,42
1284,Eréthrus,ravencrest,1343,demonhunter,havoc,24,14,10
1285,Khalestya,shendralar,1342,demonhunter,havoc,54,23,31
1286,Mandariâ,blackmoore,1341,demonhunter,havoc,24,14,10
1287,Ragnirok,deathwing,1341,demonhunter,havoc,72,34,38
1288,Wrakdh,archimonde,1340,demonhunter,havoc,50,31,19
1289,Illídana,azjolnerub,1340,demonhunter,havoc,62,32,30
1290,Alithy,kazzak,1339,demonhunter,havoc,65,36,29
1291,Nepthýs,blackhand,1338,demonhunter,havoc,33,15,18
1292,Faytundh,kult-der-verdammten,1336,demonhunter,havoc,30,14,16
1293,Hawoc,chamber-of-aspects,1334,demonhunter,havoc,42,26,16
1294,Azzïnoth,sargeras,1334,demonhunter,havoc,24,14,10
1295,Soca,ysondre,1334,demonhunter,havoc,54,24,30
1296,Felwinter,ravencrest,1332,demonhunter,havoc,36,14,22
1297,Treehunter,ravencrest,1331,demonhunter,havoc,24,14,10
1298,Kïng,frostmane,1330,demonhunter,havoc,18,14,4
1299,Øctågøñ,blackrock,1328,demonhunter,havoc,46,18,28
1300,Ämi,blackmoore,1327,demonhunter,havoc,36,15,21
1301,Louloulou,aegwynn,1326,demonhunter,havoc,93,52,41
1302,Adapterinput,auchindoun,1325,demonhunter,havoc,40,22,18
1303,Геннитиро,deathguard,1321,demonhunter,havoc,24,14,10
1304,Itheos,kazzak,1321,demonhunter,havoc,77,36,41
1305,Kâtsulol,ysondre,1321,demonhunter,havoc,30,14,16
1306,Мужна,grom,1316,demonhunter,havoc,24,14,10
1307,Yvrig,eredar,1313,demonhunter,havoc,24,14,10
1308,Notcrashy,eredar,1311,demonhunter,havoc,23,17,6
1309,Délyria,blackhand,1311,demonhunter,havoc,54,32,22
1310,Jayhan,chamber-of-aspects,1311,demonhunter,havoc,68,37,31
1311,Bestdemon,tarren-mill,1311,demonhunter,havoc,39,20,19
1312,Ðraudræm,ravencrest,1311,demonhunter,havoc,80,36,44
1313,Írony,draenor,1310,demonhunter,havoc,26,15,11
1314,Кельдарк,soulflayer,1309,demonhunter,havoc,100,41,59
1315,Slowcuzclick,stormscale,1307,demonhunter,havoc,85,44,41
1316,Breezzdh,twisting-nether,1305,demonhunter,havoc,29,14,15
1317,Trashcarlitô,eredar,1302,demonhunter,havoc,26,15,11
1318,Каралас,soulflayer,1301,demonhunter,havoc,36,21,15
1319,Nezruslfive,dun-modr,1301,demonhunter,havoc,30,15,15
1320,Chapzi,ragnaros,1300,demonhunter,havoc,42,23,19
1321,Brisingamen,outland,1297,demonhunter,havoc,30,14,16
1322,Icelucard,argent-dawn,1297,demonhunter,havoc,35,16,19
1323,Сумърак,grom,1296,demonhunter,havoc,29,15,14
1324,Skywålker,stormscale,1292,demonhunter,havoc,33,14,19
1325,Тарапынька,gordunni,1291,demonhunter,havoc,76,42,34
1326,Coltender,drakthul,1290,demonhunter,havoc,61,28,33
1327,Bläckdëvïl,uldum,1285,demonhunter,havoc,40,25,15
1328,Billidan,eredar,1282,demonhunter,havoc,54,25,29
1329,Jahannam,ysondre,1281,demonhunter,havoc,36,17,19
1330,Symbul,blackrock,1279,demonhunter,havoc,42,19,23
1331,Máédhros,ravencrest,1278,demonhunter,havoc,28,14,14
1332,Даргсайд,gordunni,1269,demonhunter,havoc,36,16,20
1333,Thëos,argent-dawn,1268,demonhunter,havoc,42,20,22
1334,Norgan,die-aldor,1248,demonhunter,havoc,18,13,5
1335,Norac,silvermoon,1248,demonhunter,havoc,41,16,25
1336,Mønkeyx,kazzak,1246,demonhunter,havoc,18,13,5
1337,Мэйзиквин,howling-fjord,1245,demonhunter,havoc,24,13,11
1338,Burchulica,sylvanas,1245,demonhunter,havoc,24,13,11
1339,Anubias,ravencrest,1243,demonhunter,havoc,36,13,23
1340,Thorno,argent-dawn,1243,demonhunter,havoc,36,13,23
1341,Kezumå,tarren-mill,1241,demonhunter,havoc,30,13,17
1342,Illiada,spinebreaker,1240,demonhunter,havoc,24,13,11
1343,Иллиферрат,blackscar,1239,demonhunter,havoc,29,14,15
1344,Easywaay,kazzak,1236,demonhunter,havoc,18,13,5
1345,Gïzmó,tarren-mill,1236,demonhunter,havoc,30,13,17
1346,Сложныйдх,howling-fjord,1235,demonhunter,havoc,18,13,5
1347,Claere,blackhand,1234,demonhunter,havoc,75,41,34
1348,Хингарский,deathguard,1234,demonhunter,havoc,24,13,11
1349,Maltok,ysondre,1234,demonhunter,havoc,27,14,13
1350,Bøøgý,silvermoon,1234,demonhunter,havoc,42,19,23
1351,Titanslayyer,azjolnerub,1233,demonhunter,havoc,30,13,17
1352,Эндимэн,soulflayer,1230,demonhunter,havoc,38,23,15
1353,Djaris,ghostlands,1228,demonhunter,havoc,18,13,5
1354,Thegamesucks,ravencrest,1228,demonhunter,havoc,163,79,84
1355,Pvpabuser,ravencrest,1224,demonhunter,havoc,24,13,11
1356,Hirbs,silvermoon,1222,demonhunter,havoc,61,25,36
1357,Ashrena,ysondre,1218,demonhunter,havoc,18,13,5
1358,Kanabiz,outland,1216,demonhunter,havoc,36,15,21
1359,Betråyêr,draenor,1213,demonhunter,havoc,38,15,23
1360,Davidastt,drakthul,1207,demonhunter,havoc,35,13,22
1361,Tharysan,sanguino,1203,demonhunter,havoc,18,13,5
1362,Philona,die-aldor,1202,demonhunter,havoc,75,34,41
1363,Blisdon,argent-dawn,1197,demonhunter,havoc,24,15,9
1364,Kiriall,blackmoore,1196,demonhunter,havoc,60,28,32
1365,Vozol,stormscale,1195,demonhunter,havoc,30,20,10
1366,Anandria,blutkessel,1194,demonhunter,havoc,59,38,21
1367,Nanocsika,twisting-nether,1187,demonhunter,havoc,51,24,27
1368,Demonligos,draenor,1183,demonhunter,havoc,72,36,36
1369,Fikyx,draenor,1177,demonhunter,havoc,32,14,18
1370,Bessus,aggra-português,1172,demonhunter,havoc,30,14,16
1371,Scarebearz,outland,1171,demonhunter,havoc,54,31,23
1372,Сильверган,soulflayer,1167,demonhunter,havoc,66,31,35
1373,Sinninse,blackmoore,1165,demonhunter,havoc,24,13,11
1374,Oxydh,ravencrest,1165,demonhunter,havoc,28,13,15
1375,Lagordin,aggramar,1161,demonhunter,havoc,18,14,4
1376,Люцифэйль,gordunni,1160,demonhunter,havoc,26,14,12
1377,Athoribos,silvermoon,1160,demonhunter,havoc,60,32,28
1378,Lùcîfer,hellfire,1158,demonhunter,havoc,42,17,25
1379,Brainlessdmg,ragnaros,1151,demonhunter,havoc,18,12,6
1380,Wyna,aggra-português,1151,demonhunter,havoc,24,12,12
1381,Hagana,tirion,1151,demonhunter,havoc,24,12,12
1382,Çrymemøre,dun-modr,1151,demonhunter,havoc,24,12,12
1383,Мишаметапамп,grom,1151,demonhunter,havoc,24,12,12
1384,Dhgoddess,kazzak,1151,demonhunter,havoc,24,12,12
1385,Testôdh,blackrock,1151,demonhunter,havoc,30,12,18
1386,Illidrax,outland,1151,demonhunter,havoc,30,12,18
1387,Найтбладия,gordunni,1150,demonhunter,havoc,18,12,6
1388,Уполномочен,howling-fjord,1150,demonhunter,havoc,24,12,12
1389,Seleverkauft,antonidas,1149,demonhunter,havoc,18,12,6
1390,Bigboychaos,twisting-nether,1149,demonhunter,havoc,36,19,17
1391,Рэгес,howling-fjord,1148,demonhunter,havoc,18,12,6
1392,Brodor,alakir,1148,demonhunter,havoc,24,12,12
1393,Sturmovik,ravencrest,1147,demonhunter,havoc,18,12,6
1394,Aethinos,sylvanas,1147,demonhunter,havoc,18,12,6
1395,Åelita,burning-legion,1147,demonhunter,havoc,18,12,6
1396,Exceltor,sanguino,1147,demonhunter,havoc,36,12,24
1397,Zahadius,silvermoon,1146,demonhunter,havoc,18,12,6
1398,Razrsolo,tarren-mill,1145,demonhunter,havoc,24,12,12
1399,Джигурдинец,gordunni,1144,demonhunter,havoc,30,17,13
1400,Baball,kazzak,1142,demonhunter,havoc,18,12,6
1401,Iphanaa,frostmane,1142,demonhunter,havoc,28,12,16
1402,Poutanaola,twisting-nether,1140,demonhunter,havoc,24,12,12
1403,Hornyhexy,stormscale,1139,demonhunter,havoc,30,12,18
1404,Gullveîg,archimonde,1136,demonhunter,havoc,24,12,12
1405,Тушино,lich-king,1135,demonhunter,havoc,18,12,6
1406,Даблкорк,soulflayer,1133,demonhunter,havoc,29,16,13
1407,Afuwarrior,doomhammer,1133,demonhunter,havoc,24,12,12
1408,Бичерезх,soulflayer,1127,demonhunter,havoc,24,12,12
1409,Sarissa,dun-modr,1120,demonhunter,havoc,26,14,12
1410,Gabquist,argent-dawn,1118,demonhunter,havoc,41,24,17
1411,Sua,outland,1116,demonhunter,havoc,24,12,12
1412,Zulthealbino,tarren-mill,1110,demonhunter,havoc,20,13,7
1413,Schonevrouw,aszune,1109,demonhunter,havoc,24,13,11
1414,Zengor,twilights-hammer,1109,demonhunter,havoc,28,14,14
1415,Kaizzy,twisting-nether,1107,demonhunter,havoc,78,35,43
1416,Dreggath,doomhammer,1104,demonhunter,havoc,36,16,20
1417,Lögan,uldum,1103,demonhunter,havoc,30,14,16
1418,Hawek,madmortem,1096,demonhunter,havoc,30,16,14
1419,Demonronin,the-maelstrom,1095,demonhunter,havoc,18,12,6
1420,Аллилания,fordragon,1092,demonhunter,havoc,44,29,15
1421,Kebiz,ragnaros,1090,demonhunter,havoc,23,12,11
1422,Venøøm,eldrethalas,1084,demonhunter,havoc,90,40,50
1423,Azazelkw,ragnaros,1082,demonhunter,havoc,42,22,20
1424,Stonebanker,turalyon,1079,demonhunter,havoc,23,14,9
1425,Felleaf,ragnaros,1077,demonhunter,havoc,28,12,16
1426,Byah,kazzak,1076,demonhunter,havoc,49,20,29
1427,Егордемон,soulflayer,1074,demonhunter,havoc,30,12,18
1428,Ascanius,nemesis,1072,demonhunter,havoc,42,24,18
1429,Айвэнгос,thermaplugg,1072,demonhunter,havoc,45,25,20
1430,Munja,hyjal,1071,demonhunter,havoc,83,40,43
1431,Bicskas,ragnaros,1070,demonhunter,havoc,32,13,19
1432,Kladius,skullcrusher,1067,demonhunter,havoc,21,12,9
1433,Guanzho,silvermoon,1066,demonhunter,havoc,33,13,20
1434,Itsukix,stormscale,1063,demonhunter,havoc,24,13,11
1435,Dantert,zuljin,1056,demonhunter,havoc,18,11,7
1436,Mittÿ,tarren-mill,1056,demonhunter,havoc,24,11,13
1437,Tdh,sanguino,1055,demonhunter,havoc,18,11,7
1438,Dhlee,ravencrest,1055,demonhunter,havoc,18,11,7
1439,Ардатйякши,borean-tundra,1055,demonhunter,havoc,23,11,12
1440,Cappaowx,ravencrest,1054,demonhunter,havoc,18,11,7
1441,Përry,archimonde,1054,demonhunter,havoc,24,11,13
1442,Dragontwist,sylvanas,1053,demonhunter,havoc,24,11,13
1443,Thedudex,dunemaul,1053,demonhunter,havoc,30,11,19
1444,Фирулия,goldrinn,1052,demonhunter,havoc,32,20,12
1445,Squan,blackmoore,1050,demonhunter,havoc,20,12,8
1446,Dibo,blackmoore,1050,demonhunter,havoc,24,11,13
1447,Aphulucky,kazzak,1050,demonhunter,havoc,30,11,19
1448,Balsza,burning-legion,1049,demonhunter,havoc,18,11,7
1449,Shadowkick,archimonde,1047,demonhunter,havoc,156,76,80
1450,Flowen,stormreaver,1047,demonhunter,havoc,24,11,13
1451,Metadel,outland,1043,demonhunter,havoc,127,66,61
1452,Demonk,nemesis,1040,demonhunter,havoc,18,11,7
1453,Kaitlyyn,norgannon,1038,demonhunter,havoc,30,11,19
1454,Demonhyan,chants-éternels,1035,demonhunter,havoc,49,25,24
1455,Aamonath,tarren-mill,1030,demonhunter,havoc,30,16,14
1456,Дитяхаоса,howling-fjord,1026,demonhunter,havoc,30,11,19
1457,Увиден,eversong,1021,demonhunter,havoc,47,22,25
1458,Sabe,ravencrest,1016,demonhunter,havoc,17,11,6
1459,Milkeyes,ravencrest,1013,demonhunter,havoc,54,26,28
1460,Vio,jaedenar,1011,demonhunter,havoc,24,14,10
1461,Noctilucent,executus,1008,demonhunter,havoc,24,14,10
1462,Demontripo,silvermoon,1005,demonhunter,havoc,81,43,38
1463,Delfee,twisting-nether,1005,demonhunter,havoc,54,25,29
1464,Нохелет,deepholm,1003,demonhunter,havoc,87,44,43
1465,Teoma,hyjal,1003,demonhunter,havoc,36,16,20
1466,Asmedios,twisting-nether,1000,demonhunter,havoc,44,15,29
1467,Шмальнуть,gordunni,997,demonhunter,havoc,32,12,20
1468,Viridisignis,silvermoon,993,demonhunter,havoc,36,16,20
1469,Hunterston,twisting-nether,992,demonhunter,havoc,68,38,30
1470,Гарнаш,howling-fjord,992,demonhunter,havoc,36,18,18
1471,Twistyy,drakthul,991,demonhunter,havoc,48,25,23
1472,Dxæn,archimonde,990,demonhunter,havoc,17,11,6
1473,Sintoraz,amanthul,975,demonhunter,havoc,36,21,15
1474,Deadskill,alexstrasza,975,demonhunter,havoc,42,19,23
1475,Флеркенкот,galakrond,972,demonhunter,havoc,55,28,27
1476,Sekørm,ragnaros,960,demonhunter,havoc,18,10,8
1477,Jumpmeister,ragnaros,960,demonhunter,havoc,18,10,8
1478,Анхардх,gordunni,960,demonhunter,havoc,18,10,8
1479,Reckqqt,eredar,960,demonhunter,havoc,18,10,8
1480,Rehagen,ysondre,960,demonhunter,havoc,24,10,14
1481,Yerla,burning-legion,960,demonhunter,havoc,24,10,14
1482,Íamprepared,tarren-mill,960,demonhunter,havoc,30,10,20
1483,Chïbrøne,archimonde,960,demonhunter,havoc,30,10,20
1484,Tylleröwittu,grim-batol,959,demonhunter,havoc,18,10,8
1485,Khray,archimonde,959,demonhunter,havoc,18,10,8
1486,Zamassu,kazzak,959,demonhunter,havoc,18,10,8
1487,Theaisbae,twisting-nether,959,demonhunter,havoc,18,10,8
1488,Völkswagen,dun-modr,959,demonhunter,havoc,18,10,8
1489,Kéftëmé,ravencrest,959,demonhunter,havoc,18,10,8
1490,Broglaive,sylvanas,959,demonhunter,havoc,18,10,8
1491,Катякрылышки,gordunni,959,demonhunter,havoc,18,10,8
1492,Ðemøñsåy,blackrock,959,demonhunter,havoc,24,10,14
1493,Daemonax,ragnaros,959,demonhunter,havoc,24,10,14
1494,Darnke,silvermoon,959,demonhunter,havoc,30,10,20
1495,Аитерия,gordunni,958,demonhunter,havoc,12,10,2
1496,Shivarræ,stormreaver,958,demonhunter,havoc,18,10,8
1497,Critlerman,blackmoore,957,demonhunter,havoc,16,11,5
1498,Skarvy,bronze-dragonflight,957,demonhunter,havoc,18,10,8
1499,Orochimaruu,kargath,956,demonhunter,havoc,30,10,20
1500,Экселия,howling-fjord,954,demonhunter,havoc,18,10,8
1501,Argnils,tarren-mill,953,demonhunter,havoc,12,10,2
1502,Pleskdh,malganis,953,demonhunter,havoc,24,10,14
1503,Momochi,silvermoon,952,demonhunter,havoc,18,10,8
1504,Flamme,amanthul,951,demonhunter,havoc,18,11,7
1505,Alandrisz,argent-dawn,949,demonhunter,havoc,30,10,20
1506,Jemoer,twisting-nether,942,demonhunter,havoc,15,12,3
1507,Sinthetyx,quelthalas,940,demonhunter,havoc,24,14,10
1508,Shishiro,alakir,937,demonhunter,havoc,24,10,14
1509,Самфор,soulflayer,935,demonhunter,havoc,24,10,14
1510,Zermut,culte-de-la-rive-noire,925,demonhunter,havoc,17,10,7
1511,Solarae,silvermoon,924,demonhunter,havoc,23,10,13
1512,Taliaa,drakthul,911,demonhunter,havoc,21,10,11
1513,Kroepoeks,mazrigos,894,demonhunter,havoc,24,13,11
1514,Nuriia,arthas,886,demonhunter,havoc,30,15,15
1515,Никельдон,howling-fjord,883,demonhunter,havoc,18,11,7
1516,Skylinex,dentarg,880,demonhunter,havoc,60,29,31
1517,Folygale,outland,864,demonhunter,havoc,12,9,3
1518,Zy,ahnqiraj,864,demonhunter,havoc,12,9,3
1519,Bignugs,ravencrest,864,demonhunter,havoc,18,9,9
1520,Mürh,nordrassil,864,demonhunter,havoc,18,9,9
1521,Guësswho,twisting-nether,864,demonhunter,havoc,18,9,9
1522,Draqula,ravencrest,864,demonhunter,havoc,18,9,9
1523,Raïley,archimonde,864,demonhunter,havoc,18,9,9
1524,Jórúnn,twisting-nether,864,demonhunter,havoc,18,9,9
1525,Sghemon,pozzo-delleternità,864,demonhunter,havoc,18,9,9
1526,Toschadh,blackmoore,864,demonhunter,havoc,18,9,9
1527,Ewlyna,stormscale,864,demonhunter,havoc,18,9,9
1528,Thulânn,twisting-nether,864,demonhunter,havoc,18,9,9
1529,Смутсайбот,howling-fjord,864,demonhunter,havoc,18,9,9
1530,Saene,ravencrest,864,demonhunter,havoc,18,9,9
1531,Oniramqt,aegwynn,864,demonhunter,havoc,18,9,9
1532,Zophý,ragnaros,864,demonhunter,havoc,18,9,9
1533,Эридари,blackscar,864,demonhunter,havoc,18,9,9
1534,Míàkhãlîfâýð,stormscale,864,demonhunter,havoc,24,9,15
1535,Anerana,malganis,864,demonhunter,havoc,24,9,15
1536,Chàk,marécage-de-zangar,864,demonhunter,havoc,30,9,21
1537,Vìdhar,tarren-mill,863,demonhunter,havoc,12,9,3
1538,Cynmatic,kargath,863,demonhunter,havoc,12,9,3
1539,Sunestaa,kazzak,863,demonhunter,havoc,12,9,3
1540,Дайкиаомине,soulflayer,863,demonhunter,havoc,18,9,9
1541,Kenzaii,aegwynn,863,demonhunter,havoc,18,9,9
1542,Ììîîííììîîíí,tarren-mill,863,demonhunter,havoc,18,9,9
1543,Sadzari,burning-legion,863,demonhunter,havoc,18,9,9
1544,Mephîsto,sylvanas,863,demonhunter,havoc,18,9,9
1545,Ydrael,terokkar,863,demonhunter,havoc,18,9,9
1546,Darktérror,silvermoon,863,demonhunter,havoc,24,9,15
1547,Luunz,argent-dawn,863,demonhunter,havoc,30,9,21
1548,Nvampire,draenor,862,demonhunter,havoc,12,9,3
1549,Yugsiturath,drakthul,862,demonhunter,havoc,18,9,9
1550,Zappikdh,silvermoon,862,demonhunter,havoc,18,9,9
1551,Finstergraf,blackmoore,862,demonhunter,havoc,30,14,16
1552,Illidián,chamber-of-aspects,862,demonhunter,havoc,24,9,15
1553,Никкэс,gordunni,859,demonhunter,havoc,18,9,9
1554,Pichkachu,sylvanas,859,demonhunter,havoc,18,9,9
1555,Doobregeesy,burning-legion,859,demonhunter,havoc,21,10,11
1556,Tokoloshë,ragnaros,854,demonhunter,havoc,18,9,9
1557,Fckmlf,outland,839,demonhunter,havoc,21,12,9
1558,Бельторо,soulflayer,798,demonhunter,havoc,22,9,13
1559,Deadhuntor,daggerspine,795,demonhunter,havoc,17,9,8
1560,Kundans,aegwynn,787,demonhunter,havoc,17,9,8
1561,Subelsiu,alakir,786,demonhunter,havoc,45,17,28
1562,Brawngodx,draenor,783,demonhunter,havoc,13,9,4
1563,Garretos,senjin,780,demonhunter,havoc,13,9,4
1564,Traumadh,tarren-mill,768,demonhunter,havoc,12,8,4
1565,Eyecandy,scarshield-legion,768,demonhunter,havoc,12,8,4
1566,Dedemøn,ysondre,768,demonhunter,havoc,12,8,4
1567,Enjøybrah,nemesis,768,demonhunter,havoc,12,8,4
1568,Chotzbrocke,blackhand,768,demonhunter,havoc,12,8,4
1569,Höllymedx,blackmoore,768,demonhunter,havoc,18,8,10
1570,Saleny,blackrock,768,demonhunter,havoc,18,8,10
1571,Vayshi,turalyon,768,demonhunter,havoc,18,8,10
1572,Mollamaija,defias-brotherhood,768,demonhunter,havoc,18,8,10
1573,Kins,dun-modr,768,demonhunter,havoc,18,8,10
1574,Nthday,draenor,768,demonhunter,havoc,18,8,10
1575,Stinkymonkey,pozzo-delleternità,768,demonhunter,havoc,18,8,10
1576,Shõ,twisting-nether,768,demonhunter,havoc,24,8,16
1577,Rõb,magtheridon,768,demonhunter,havoc,24,8,16
1578,Bichmicher,earthen-ring,768,demonhunter,havoc,24,8,16
1579,Itadora,antonidas,768,demonhunter,havoc,24,8,16
1580,Ninetzqp,tarren-mill,767,demonhunter,havoc,12,8,4
1581,Morphiyy,tarren-mill,767,demonhunter,havoc,12,8,4
1582,Tursal,dun-morogh,767,demonhunter,havoc,12,8,4
1583,Эска,razuvious,767,demonhunter,havoc,12,8,4
1584,Grimberg,tarren-mill,767,demonhunter,havoc,12,8,4
1585,Baddxd,ragnaros,767,demonhunter,havoc,14,9,5
1586,Кейтпрнстарс,howling-fjord,767,demonhunter,havoc,18,8,10
1587,Skrelarent,argent-dawn,766,demonhunter,havoc,12,8,4
1588,Danedemlia,magtheridon,766,demonhunter,havoc,12,8,4
1589,Mêgumi,kirin-tor,766,demonhunter,havoc,21,9,12
1590,Demonjay,stormscale,766,demonhunter,havoc,22,9,13
1591,Natazia,eredar,765,demonhunter,havoc,18,8,10
1592,Попкасиська,eversong,763,demonhunter,havoc,47,19,28
1593,Covidian,kilrogg,762,demonhunter,havoc,12,8,4
1594,Yuka,earthen-ring,761,demonhunter,havoc,18,8,10
1595,Цион,soulflayer,757,demonhunter,havoc,18,8,10
1596,Maryjane,nordrassil,756,demonhunter,havoc,18,8,10
1597,Кусьзакиску,soulflayer,753,demonhunter,havoc,12,8,4
1598,Pismanik,drakthul,752,demonhunter,havoc,12,8,4
1599,Lorcanmar,draenor,740,demonhunter,havoc,24,8,16
1600,Butcherr,ulduar,736,demonhunter,havoc,24,8,16
1601,Gushìñgwøuñð,blackmoore,719,demonhunter,havoc,11,8,3
1602,Ozeey,draenor,719,demonhunter,havoc,17,8,9
1603,Silan,kiljaeden,711,demonhunter,havoc,17,8,9
1604,Найтшифт,blackscar,704,demonhunter,havoc,10,8,2
1605,Zakaji,blackmoore,703,demonhunter,havoc,14,8,6
1606,Jco,kazzak,703,demonhunter,havoc,20,8,12
1607,Âkazza,archimonde,703,demonhunter,havoc,20,8,12
1608,Níghtwing,wildhammer,702,demonhunter,havoc,17,8,9
1609,Стрепа,grom,693,demonhunter,havoc,17,8,9
1610,Maddificator,silvermoon,686,demonhunter,havoc,14,8,6
1611,Hextechz,stormscale,672,demonhunter,havoc,12,7,5
1612,Kolrex,ragnaros,672,demonhunter,havoc,12,7,5
1613,Bestro,tarren-mill,672,demonhunter,havoc,12,7,5
1614,Шалдарон,howling-fjord,672,demonhunter,havoc,12,7,5
1615,Ozu,blackrock,672,demonhunter,havoc,12,7,5
1616,Stonedaf,ravencrest,672,demonhunter,havoc,12,7,5
1617,Esadeáth,ravencrest,672,demonhunter,havoc,12,7,5
1618,Äzräël,dun-modr,672,demonhunter,havoc,12,7,5
1619,Actuallytrol,argent-dawn,672,demonhunter,havoc,12,7,5
1620,Atrikagodx,kazzak,672,demonhunter,havoc,12,7,5
1621,Lagseven,ravencrest,672,demonhunter,havoc,12,7,5
1622,Гранкрю,blackscar,672,demonhunter,havoc,12,7,5
1623,Lirigizel,hellscream,672,demonhunter,havoc,12,7,5
1624,Alied,burning-blade,672,demonhunter,havoc,12,7,5
1625,Sidekiq,silvermoon,672,demonhunter,havoc,12,7,5
1626,Caronte,los-errantes,672,demonhunter,havoc,12,7,5
1627,Wintalker,nemesis,672,demonhunter,havoc,12,7,5
1628,Ronstoppable,ravencrest,672,demonhunter,havoc,12,7,5
1629,Pepenger,kazzak,672,demonhunter,havoc,12,7,5
1630,Yorxdh,eredar,672,demonhunter,havoc,12,7,5
1631,Onecho,ragnaros,672,demonhunter,havoc,12,7,5
1632,Bizl,arygos,672,demonhunter,havoc,12,7,5
1633,Kekburagól,kazzak,672,demonhunter,havoc,15,8,7
1634,Келидаррия,soulflayer,672,demonhunter,havoc,18,7,11
1635,Onizukadh,archimonde,672,demonhunter,havoc,18,7,11
1636,Yukiz,ravencrest,672,demonhunter,havoc,18,7,11
1637,Satti,sargeras,672,demonhunter,havoc,18,7,11
1638,Gnarpump,emeriss,672,demonhunter,havoc,18,7,11
1639,Abigorien,blackmoore,672,demonhunter,havoc,18,7,11
1640,Demondulle,kazzak,672,demonhunter,havoc,18,7,11
1641,Calcïum,archimonde,672,demonhunter,havoc,24,7,17
1642,Ddvh,drakthul,671,demonhunter,havoc,12,7,5
1643,Nerfy,silvermoon,671,demonhunter,havoc,12,7,5
1644,Meji,ravencrest,671,demonhunter,havoc,12,7,5
1645,Nxmpys,sanguino,671,demonhunter,havoc,12,7,5
1646,Hellarious,ragnaros,671,demonhunter,havoc,12,7,5
1647,Mareen,pozzo-delleternità,671,demonhunter,havoc,18,7,11
1648,Moojdh,malganis,671,demonhunter,havoc,18,7,11
1649,Rebelion,dun-modr,671,demonhunter,havoc,18,7,11
1650,Хорбелий,deathguard,671,demonhunter,havoc,18,7,11
1651,Милинайт,eversong,670,demonhunter,havoc,12,7,5
1652,Trekxx,ragnaros,670,demonhunter,havoc,12,7,5
1653,Adraelia,archimonde,670,demonhunter,havoc,12,7,5
1654,Hannipham,silvermoon,669,demonhunter,havoc,15,8,7
1655,Necrotyle,twisting-nether,669,demonhunter,havoc,21,8,13
1656,Nylaria,dethecus,668,demonhunter,havoc,12,7,5
1657,Мотек,howling-fjord,668,demonhunter,havoc,18,7,11
1658,Nelairia,tarren-mill,666,demonhunter,havoc,12,7,5
1659,Danshokudino,kazzak,665,demonhunter,havoc,18,7,11
1660,Judderzz,bronze-dragonflight,658,demonhunter,havoc,12,7,5
1661,Blutox,antonidas,653,demonhunter,havoc,19,8,11
1662,Legionek,burning-blade,629,demonhunter,havoc,14,8,6
1663,Makhabunda,terokkar,618,demonhunter,havoc,28,8,20
1664,Mèlfurion,hyjal,607,demonhunter,havoc,13,8,5
1665,Prouser,turalyon,588,demonhunter,havoc,21,8,13
1666,Alasune,twisting-nether,576,demonhunter,havoc,6,6,0
1667,Smydi,blackmoore,576,demonhunter,havoc,6,6,0
1668,Kiirtach,dun-modr,576,demonhunter,havoc,9,7,2
1669,Aeshalla,blackmoore,576,demonhunter,havoc,12,6,6
1670,Paindemon,outland,576,demonhunter,havoc,12,6,6
1671,Länika,drakthul,576,demonhunter,havoc,12,6,6
1672,Xyrs,draenor,576,demonhunter,havoc,12,6,6
1673,Õmen,ravencrest,576,demonhunter,havoc,12,6,6
1674,Demonzøku,ravencrest,576,demonhunter,havoc,12,6,6
1675,Vaynahi,grim-batol,576,demonhunter,havoc,12,6,6
1676,Soulmortal,draenor,576,demonhunter,havoc,12,6,6
1677,Cptncucumber,blackmoore,576,demonhunter,havoc,12,6,6
1678,Ruíko,dun-morogh,576,demonhunter,havoc,12,6,6
1679,Муими,soulflayer,576,demonhunter,havoc,12,6,6
1680,Peacedopice,drakthul,576,demonhunter,havoc,12,6,6
1681,Zyasea,blackmoore,576,demonhunter,havoc,12,6,6
1682,Størmrage,sanguino,576,demonhunter,havoc,12,6,6
1683,Quavanity,sylvanas,576,demonhunter,havoc,12,6,6
1684,Viced,kazzak,576,demonhunter,havoc,12,6,6
1685,Lezzo,tarren-mill,576,demonhunter,havoc,12,6,6
1686,Noovedh,ravencrest,576,demonhunter,havoc,12,6,6
1687,Hcsgötze,dalaran,576,demonhunter,havoc,12,6,6
1688,Tëvnic,kazzak,576,demonhunter,havoc,12,6,6
1689,Lawus,blackhand,576,demonhunter,havoc,12,6,6
1690,Notapistol,outland,576,demonhunter,havoc,12,6,6
1691,Lòsêr,ravencrest,576,demonhunter,havoc,12,6,6
1692,Rhinozerg,kazzak,576,demonhunter,havoc,12,6,6
1693,Kyuzo,sanguino,576,demonhunter,havoc,12,6,6
1694,Zmasteez,ahnqiraj,576,demonhunter,havoc,12,6,6
1695,Lanaël,kaelthas,576,demonhunter,havoc,12,6,6
1696,Lurtéx,kazzak,576,demonhunter,havoc,12,6,6
1697,Bamßi,ragnaros,576,demonhunter,havoc,12,6,6
1698,Kâsúxôxô,ravencrest,576,demonhunter,havoc,16,7,9
1699,Nøøßønline,hyjal,576,demonhunter,havoc,18,6,12
1700,Зарах,gordunni,576,demonhunter,havoc,18,6,12
1701,Xenits,kazzak,576,demonhunter,havoc,18,6,12
1702,Devilmonkey,ambossar,576,demonhunter,havoc,18,6,12
1703,Véin,stormscale,576,demonhunter,havoc,18,6,12
1704,Zaÿn,antonidas,576,demonhunter,havoc,18,6,12
1705,Ilyerias,twisting-nether,576,demonhunter,havoc,18,6,12
1706,Dmgchris,sylvanas,576,demonhunter,havoc,18,6,12
1707,Pinx,archimonde,576,demonhunter,havoc,18,6,12
1708,Dèsdemøna,nemesis,576,demonhunter,havoc,18,6,12
1709,Shyoxdh,twisting-nether,576,demonhunter,havoc,18,6,12
1710,Sailen,blackmoore,576,demonhunter,havoc,18,6,12
1711,Стараятварь,thermaplugg,576,demonhunter,havoc,24,6,18
1712,Pèpsì,kazzak,576,demonhunter,havoc,24,6,18
1713,Shizuuli,outland,576,demonhunter,havoc,30,6,24
1714,Daweeo,the-maelstrom,575,demonhunter,havoc,12,6,6
1715,Кайриель,gordunni,575,demonhunter,havoc,12,6,6
1716,Instinctivee,sylvanas,575,demonhunter,havoc,12,6,6
1717,Extraxtreme,ravencrest,575,demonhunter,havoc,12,6,6
1718,Saftad,outland,575,demonhunter,havoc,12,6,6
1719,Shizá,burning-legion,575,demonhunter,havoc,12,6,6
1720,Овецловец,deathguard,575,demonhunter,havoc,12,6,6
1721,Antidevil,kazzak,575,demonhunter,havoc,16,7,9
1722,Wauway,ragnaros,575,demonhunter,havoc,14,6,8
1723,Candylicks,kazzak,575,demonhunter,havoc,18,6,12
1724,Mcsmackface,hellfire,575,demonhunter,havoc,18,6,12
1725,Aelzeran,stormscale,575,demonhunter,havoc,18,6,12
1726,Sangita,tarren-mill,574,demonhunter,havoc,12,6,6
1727,Ôlowain,blackmoore,574,demonhunter,havoc,18,6,12
1728,Klave,argent-dawn,573,demonhunter,havoc,18,6,12
1729,Tatsukiyuzu,hyjal,572,demonhunter,havoc,6,6,0
1730,Bahmut,argent-dawn,569,demonhunter,havoc,12,6,6
1731,Дантавул,gordunni,568,demonhunter,havoc,18,6,12
1732,Olddemon,ravencrest,542,demonhunter,havoc,11,6,5
1733,Подкрадунзай,soulflayer,527,demonhunter,havoc,9,7,2
1734,Fruttidimare,frostwolf,527,demonhunter,havoc,11,6,5
1735,Makiu,archimonde,527,demonhunter,havoc,15,6,9
1736,Иланари,gordunni,526,demonhunter,havoc,11,6,5
1737,Nyalah,eredar,522,demonhunter,havoc,12,7,5
1738,Gnjurac,outland,511,demonhunter,havoc,14,6,8
1739,Amionisiken,amanthul,496,demonhunter,havoc,13,6,7
1740,Smâshêd,stormscale,480,demonhunter,havoc,6,5,1
1741,Kanéki,sylvanas,480,demonhunter,havoc,6,5,1
1742,Monion,defias-brotherhood,480,demonhunter,havoc,6,5,1
1743,Morrion,blackmoore,480,demonhunter,havoc,6,5,1
1744,Kimberleh,doomhammer,480,demonhunter,havoc,6,5,1
1745,Убийца,soulflayer,480,demonhunter,havoc,6,5,1
1746,Muharaar,ravencrest,480,demonhunter,havoc,6,5,1
1747,Jugøbænned,blackrock,480,demonhunter,havoc,6,5,1
1748,Nekkëtsu,archimonde,480,demonhunter,havoc,6,5,1
1749,Giboo,emerald-dream,480,demonhunter,havoc,6,5,1
1750,Muyoni,eredar,480,demonhunter,havoc,6,5,1
1751,Toonsdh,kazzak,480,demonhunter,havoc,6,5,1
1752,Backflipgødx,uldaman,480,demonhunter,havoc,12,5,7
1753,Jotaros,ravencrest,480,demonhunter,havoc,12,5,7
1754,Rabæ,blackhand,480,demonhunter,havoc,12,5,7
1755,Korrupt,draenor,480,demonhunter,havoc,12,5,7
1756,Topg,bladefist,480,demonhunter,havoc,12,5,7
1757,Kithan,zuljin,480,demonhunter,havoc,12,5,7
1758,Tastyblades,blackmoore,480,demonhunter,havoc,12,5,7
1759,Giftìg,ravencrest,480,demonhunter,havoc,12,5,7
1760,Veryfunhaha,ravencrest,480,demonhunter,havoc,12,5,7
1761,Èfiie,culte-de-la-rive-noire,480,demonhunter,havoc,12,5,7
1762,Tomkis,ravencrest,480,demonhunter,havoc,12,5,7
1763,Филеровщик,deathguard,480,demonhunter,havoc,12,5,7
1764,Revérse,stormscale,480,demonhunter,havoc,12,5,7
1765,Glímpse,ravencrest,480,demonhunter,havoc,12,5,7
1766,Natzú,ravencrest,480,demonhunter,havoc,12,5,7
1767,Chosabreka,zuljin,480,demonhunter,havoc,12,5,7
1768,Onlyfangodx,antonidas,480,demonhunter,havoc,12,5,7
1769,Superchocowo,sanguino,480,demonhunter,havoc,12,5,7
1770,Wrathia,rexxar,480,demonhunter,havoc,12,5,7
1771,Tthic,shadowsong,480,demonhunter,havoc,12,5,7
1772,Solrosfrön,stormscale,480,demonhunter,havoc,12,5,7
1773,Irenzy,twisting-nether,480,demonhunter,havoc,12,5,7
1774,Tatoos,bronze-dragonflight,480,demonhunter,havoc,12,5,7
1775,Alandiel,twisting-nether,480,demonhunter,havoc,12,5,7
1776,Deathblades,twisting-nether,480,demonhunter,havoc,12,5,7
1777,Зедю,howling-fjord,480,demonhunter,havoc,12,5,7
1778,Abrahêll,dun-modr,480,demonhunter,havoc,12,5,7
1779,Nstea,cthun,480,demonhunter,havoc,12,5,7
1780,Ayyo,agamaggan,480,demonhunter,havoc,12,5,7
1781,Daemonai,neptulon,480,demonhunter,havoc,12,5,7
1782,Varthag,antonidas,480,demonhunter,havoc,12,5,7
1783,Нереалочка,blackscar,480,demonhunter,havoc,12,5,7
1784,Ðémón,outland,480,demonhunter,havoc,12,5,7
1785,Такетомии,gordunni,480,demonhunter,havoc,12,5,7
1786,Spitface,aegwynn,480,demonhunter,havoc,12,5,7
1787,Dhaosh,nemesis,480,demonhunter,havoc,12,5,7
1788,Shyynedh,grim-batol,480,demonhunter,havoc,15,6,9
1789,Calendith,arathor,480,demonhunter,havoc,15,6,9
1790,Кайренсс,howling-fjord,480,demonhunter,havoc,18,5,13
1791,Баттлрэп,soulflayer,480,demonhunter,havoc,18,5,13
1792,Lòsâng,sanguino,480,demonhunter,havoc,18,5,13
1793,Slizer,draenor,480,demonhunter,havoc,18,5,13
1794,Aelina,area-52,480,demonhunter,havoc,18,5,13
1795,Wajoglaive,blackhand,480,demonhunter,havoc,18,5,13
1796,Natarásh,blackmoore,480,demonhunter,havoc,18,5,13
1797,Sephiris,argent-dawn,479,demonhunter,havoc,6,5,1
1798,Sholon,kiljaeden,479,demonhunter,havoc,6,5,1
1799,Merilidan,blackrock,479,demonhunter,havoc,12,5,7
1800,Goatcorpse,blackmoore,479,demonhunter,havoc,12,5,7
1801,Demontevz,outland,479,demonhunter,havoc,12,5,7
1802,Эридали,gordunni,479,demonhunter,havoc,12,5,7
1803,Gryphory,ravencrest,479,demonhunter,havoc,12,5,7
1804,Marsterkush,malygos,479,demonhunter,havoc,12,5,7
1805,Kumoko,burning-legion,479,demonhunter,havoc,15,6,9
1806,Карнавалыч,gordunni,479,demonhunter,havoc,24,5,19
1807,Скудайвер,gordunni,478,demonhunter,havoc,12,5,7
1808,Besnik,stormscale,478,demonhunter,havoc,18,5,13
1809,Kairidemon,eredar,477,demonhunter,havoc,12,5,7
1810,Winnztlol,chamber-of-aspects,477,demonhunter,havoc,15,5,10
1811,Гачирабыня,lich-king,477,demonhunter,havoc,30,5,25
1812,Vincbengt,tarren-mill,476,demonhunter,havoc,12,5,7
1813,Illikan,stormscale,474,demonhunter,havoc,12,5,7
1814,Etraidor,turalyon,473,demonhunter,havoc,12,5,7
1815,Anishara,die-nachtwache,463,demonhunter,havoc,13,6,7
1816,Majînßûü,ravencrest,447,demonhunter,havoc,11,5,6
1817,Shaundead,drakthul,447,demonhunter,havoc,11,5,6
1818,Akäly,hyjal,447,demonhunter,havoc,11,5,6
1819,Аллидариан,howling-fjord,431,demonhunter,havoc,11,5,6
1820,Дисофи,soulflayer,431,demonhunter,havoc,11,5,6
1821,Opmuch,eonar,416,demonhunter,havoc,10,5,5
1822,Иллианэль,howling-fjord,384,demonhunter,havoc,6,4,2
1823,Lemondehunta,twisting-nether,384,demonhunter,havoc,6,4,2
1824,Thestrength,twisting-nether,384,demonhunter,havoc,6,4,2
1825,Styxdh,blackhand,384,demonhunter,havoc,6,4,2
1826,Thkingragnar,sanguino,384,demonhunter,havoc,6,4,2
1827,Plagues,quelthalas,384,demonhunter,havoc,6,4,2
1828,Twopumpchump,twisting-nether,384,demonhunter,havoc,6,4,2
1829,Kriszidan,arathor,384,demonhunter,havoc,6,4,2
1830,Bokajr,ragnaros,384,demonhunter,havoc,6,4,2
1831,Akaniiaa,blackmoore,384,demonhunter,havoc,6,4,2
1832,Ikari,neptulon,384,demonhunter,havoc,6,4,2
1833,Аоешный,howling-fjord,384,demonhunter,havoc,6,4,2
1834,Glevenuschii,blackmoore,384,demonhunter,havoc,6,4,2
1835,Beraxulus,aegwynn,384,demonhunter,havoc,6,4,2
1836,Isila,alakir,384,demonhunter,havoc,6,4,2
1837,Véspé,naxxramas,384,demonhunter,havoc,6,4,2
1838,Anklàr,blackrock,384,demonhunter,havoc,6,4,2
1839,Cielis,outland,384,demonhunter,havoc,6,4,2
1840,Iken,ragnaros,384,demonhunter,havoc,6,4,2
1841,Niellarsc,ravencrest,384,demonhunter,havoc,6,4,2
1842,Mýg,ravencrest,384,demonhunter,havoc,6,4,2
1843,Elfmonger,ravencrest,384,demonhunter,havoc,6,4,2
1844,Varonx,drakthul,384,demonhunter,havoc,6,4,2
1845,Smoothbraiin,ravencrest,384,demonhunter,havoc,6,4,2
1846,Drilloz,ravencrest,384,demonhunter,havoc,6,4,2
1847,Талисзора,gordunni,384,demonhunter,havoc,6,4,2
1848,Itsfinee,outland,384,demonhunter,havoc,6,4,2
1849,Maupau,ravencrest,384,demonhunter,havoc,6,4,2
1850,Memedhbtw,outland,384,demonhunter,havoc,6,4,2
1851,Freakerzoid,kazzak,384,demonhunter,havoc,11,4,7
1852,Moonbeàm,kazzak,384,demonhunter,havoc,12,4,8
1853,Leylas,nagrand,384,demonhunter,havoc,12,4,8
1854,Бистлайк,soulflayer,384,demonhunter,havoc,12,4,8
1855,Лупидолх,soulflayer,384,demonhunter,havoc,12,4,8
1856,Stormshred,stormscale,384,demonhunter,havoc,12,4,8
1857,Reachfight,lothar,384,demonhunter,havoc,12,4,8
1858,Хокану,gordunni,384,demonhunter,havoc,12,4,8
1859,Exodlia,silvermoon,384,demonhunter,havoc,12,4,8
1860,Mempaan,magtheridon,384,demonhunter,havoc,12,4,8
1861,Alleyezønme,outland,384,demonhunter,havoc,12,4,8
1862,Одзангейра,blackscar,384,demonhunter,havoc,12,4,8
1863,Frostidh,ysondre,384,demonhunter,havoc,12,4,8
1864,Innocuouss,twisting-nether,384,demonhunter,havoc,12,4,8
1865,Blüëräin,draenor,384,demonhunter,havoc,12,4,8
1866,Floridaboy,ravencrest,384,demonhunter,havoc,12,4,8
1867,Djdhh,draenor,384,demonhunter,havoc,12,4,8
1868,Pijvijie,shattrath,384,demonhunter,havoc,12,4,8
1869,Maeltus,hyjal,384,demonhunter,havoc,12,4,8
1870,Shabalda,dun-morogh,384,demonhunter,havoc,12,4,8
1871,Letidyr,ravencrest,384,demonhunter,havoc,12,4,8
1872,Deadrawdh,aegwynn,384,demonhunter,havoc,12,4,8
1873,Redgi,tarren-mill,384,demonhunter,havoc,18,4,14
1874,Rouzi,defias-brotherhood,383,demonhunter,havoc,6,4,2
1875,Némesîs,cthun,383,demonhunter,havoc,6,4,2
1876,Thorskinius,ravencrest,383,demonhunter,havoc,12,4,8
1877,Vengatoria,cthun,383,demonhunter,havoc,12,4,8
1878,Шоеррей,gordunni,383,demonhunter,havoc,12,4,8
1879,Elenastar,kazzak,383,demonhunter,havoc,12,4,8
1880,Liondam,pozzo-delleternità,382,demonhunter,havoc,6,4,2
1881,Nazzan,destromath,382,demonhunter,havoc,6,4,2
1882,Roostidh,shattered-hand,382,demonhunter,havoc,12,4,8
1883,Ёмайл,soulflayer,381,demonhunter,havoc,12,4,8
1884,Lexxdh,blackmoore,351,demonhunter,havoc,8,5,3
1885,Летучий,howling-fjord,351,demonhunter,havoc,8,5,3
1886,Блэйденрифтс,soulflayer,351,demonhunter,havoc,11,4,7
1887,Nyxxeria,drakthul,336,demonhunter,havoc,15,4,11
1888,Hyperflex,blackrock,320,demonhunter,havoc,10,4,6
1889,Asperity,antonidas,320,demonhunter,havoc,12,4,8
1890,Дэйнни,blackscar,288,demonhunter,havoc,6,3,3
1891,Cánoo,blackhand,288,demonhunter,havoc,6,3,3
1892,Knùbbz,ravencrest,288,demonhunter,havoc,6,3,3
1893,Nerudas,blackhand,288,demonhunter,havoc,6,3,3
1894,Naturalis,die-todeskrallen,288,demonhunter,havoc,6,3,3
1895,Âstræa,antonidas,288,demonhunter,havoc,6,3,3
1896,Shinnu,antonidas,288,demonhunter,havoc,6,3,3
1897,Illyriel,antonidas,288,demonhunter,havoc,6,3,3
1898,Дианист,gordunni,288,demonhunter,havoc,6,3,3
1899,Annaboliik,ravencrest,288,demonhunter,havoc,6,3,3
1900,Хисаго,gordunni,288,demonhunter,havoc,6,3,3
1901,Ашерис,deathguard,288,demonhunter,havoc,6,3,3
1902,Иллидал,greymane,288,demonhunter,havoc,6,3,3
1903,Кейсимег,soulflayer,288,demonhunter,havoc,6,3,3
1904,Extitan,twisting-nether,288,demonhunter,havoc,6,3,3
1905,Batx,ravencrest,288,demonhunter,havoc,6,3,3
1906,Норилайнн,gordunni,288,demonhunter,havoc,6,3,3
1907,Shaadraz,stormscale,288,demonhunter,havoc,6,3,3
1908,Дракомуфлон,gordunni,288,demonhunter,havoc,6,3,3
1909,Lonedh,sylvanas,288,demonhunter,havoc,6,3,3
1910,Брилаброви,soulflayer,288,demonhunter,havoc,6,3,3
1911,Aedilles,ravencrest,288,demonhunter,havoc,6,3,3
1912,Резако,soulflayer,288,demonhunter,havoc,6,3,3
1913,Андрюхадх,soulflayer,288,demonhunter,havoc,6,3,3
1914,Valø,malganis,288,demonhunter,havoc,6,3,3
1915,Даудаев,gordunni,288,demonhunter,havoc,6,3,3
1916,Илнари,soulflayer,288,demonhunter,havoc,6,3,3
1917,Deschacke,eredar,288,demonhunter,havoc,6,3,3
1918,Imvnrcvr,dalaran,288,demonhunter,havoc,6,3,3
1919,Wrathill,draenor,288,demonhunter,havoc,6,3,3
1920,Cnbâckbb,archimonde,288,demonhunter,havoc,6,3,3
1921,Dzikalocha,burning-legion,288,demonhunter,havoc,6,3,3
1922,Fantabolous,ragnaros,288,demonhunter,havoc,6,3,3
1923,Alury,blackrock,288,demonhunter,havoc,6,3,3
1924,Naargof,outland,288,demonhunter,havoc,6,3,3
1925,Sayee,drakthul,288,demonhunter,havoc,6,3,3
1926,Zsídakabra,ragnaros,288,demonhunter,havoc,6,3,3
1927,Ittas,archimonde,288,demonhunter,havoc,6,3,3
1928,Betterdk,twilights-hammer,288,demonhunter,havoc,6,3,3
1929,Keýrañe,ragnaros,288,demonhunter,havoc,6,3,3
1930,Slaanesh,xavius,288,demonhunter,havoc,6,3,3
1931,Nameerr,ragnaros,288,demonhunter,havoc,6,3,3
1932,Mortyb,kazzak,288,demonhunter,havoc,6,3,3
1933,Demonsushi,tarren-mill,288,demonhunter,havoc,6,3,3
1934,Сихая,howling-fjord,288,demonhunter,havoc,6,3,3
1935,Alfaa,outland,288,demonhunter,havoc,6,3,3
1936,Schwitte,tichondrius,288,demonhunter,havoc,6,3,3
1937,Meleidar,kazzak,288,demonhunter,havoc,6,3,3
1938,Dadagodx,kazzak,288,demonhunter,havoc,6,3,3
1939,Aaryaa,archimonde,288,demonhunter,havoc,6,3,3
1940,Nightwalk,blackmoore,288,demonhunter,havoc,6,3,3
1941,Sayph,hyjal,288,demonhunter,havoc,6,3,3
1942,Сангвиннус,howling-fjord,288,demonhunter,havoc,6,3,3
1943,Анавеллка,howling-fjord,288,demonhunter,havoc,6,3,3
1944,Neony,blackmoore,288,demonhunter,havoc,6,3,3
1945,Bhaz,tichondrius,288,demonhunter,havoc,6,3,3
1946,Неффкодх,howling-fjord,288,demonhunter,havoc,6,3,3
1947,Kerog,blackmoore,288,demonhunter,havoc,6,3,3
1948,Vaterdenke,defias-brotherhood,288,demonhunter,havoc,6,3,3
1949,Bossmac,mugthol,288,demonhunter,havoc,6,3,3
1950,Hyonzyyesh,silvermoon,288,demonhunter,havoc,6,3,3
1951,Tachala,khaz-modan,288,demonhunter,havoc,6,3,3
1952,Xénôns,archimonde,288,demonhunter,havoc,6,3,3
1953,Zedxx,kazzak,288,demonhunter,havoc,6,3,3
1954,Myuøu,hyjal,288,demonhunter,havoc,6,3,3
1955,Geashy,blackmoore,288,demonhunter,havoc,6,3,3
1956,Xellidan,dun-modr,288,demonhunter,havoc,6,3,3
1957,Cirino,defias-brotherhood,288,demonhunter,havoc,6,3,3
1958,Killaden,ravenholdt,288,demonhunter,havoc,6,3,3
1959,Badgyalriri,hyjal,288,demonhunter,havoc,6,3,3
1960,Cindras,turalyon,288,demonhunter,havoc,6,3,3
1961,Sandem,blackrock,288,demonhunter,havoc,6,3,3
1962,Ðêmønìnsìðê,blackmoore,288,demonhunter,havoc,6,3,3
1963,Albdh,kazzak,288,demonhunter,havoc,6,3,3
1964,Trashclass,draenor,288,demonhunter,havoc,6,3,3
1965,Kätarïnas,confrérie-du-thorium,288,demonhunter,havoc,6,3,3
1966,Immune,aegwynn,288,demonhunter,havoc,6,3,3
1967,Hellboi,dun-modr,288,demonhunter,havoc,6,3,3
1968,Hopéless,aggra-português,288,demonhunter,havoc,6,3,3
1969,Крикетх,soulflayer,288,demonhunter,havoc,12,3,9
1970,Феяужаса,soulflayer,288,demonhunter,havoc,12,3,9
1971,Lamello,nemesis,288,demonhunter,havoc,12,3,9
1972,Metaman,archimonde,288,demonhunter,havoc,12,3,9
1973,Firebringer,silvermoon,288,demonhunter,havoc,12,3,9
1974,Asporos,pozzo-delleternità,288,demonhunter,havoc,12,3,9
1975,Bengleng,draenor,288,demonhunter,havoc,12,3,9
1976,Cptgmiasbria,eredar,288,demonhunter,havoc,12,3,9
1977,Kruthor,taerar,288,demonhunter,havoc,12,3,9
1978,Obitum,burning-legion,288,demonhunter,havoc,12,3,9
1979,Skajlan,burning-legion,288,demonhunter,havoc,12,3,9
1980,Шавермье,gordunni,288,demonhunter,havoc,12,3,9
1981,Lovesong,the-shatar,288,demonhunter,havoc,12,3,9
1982,Tuffêli,turalyon,288,demonhunter,havoc,12,3,9
1983,Gurthalak,alakir,288,demonhunter,havoc,12,3,9
1984,Tenaebris,silvermoon,288,demonhunter,havoc,12,3,9
1985,Ïvø,sargeras,288,demonhunter,havoc,12,3,9
1986,Artwar,stormscale,288,demonhunter,havoc,12,3,9
1987,Rúpél,thrall,288,demonhunter,havoc,12,3,9
1988,Rurt,sanguino,288,demonhunter,havoc,12,3,9
1989,Vandazza,argent-dawn,288,demonhunter,havoc,12,3,9
1990,Laurana,argent-dawn,288,demonhunter,havoc,12,3,9
1991,Jimdh,quelthalas,288,demonhunter,havoc,18,3,15
1992,Devildust,ravencrest,288,demonhunter,havoc,18,3,15
1993,Lasthija,dun-modr,288,demonhunter,havoc,18,3,15
1994,Saturnein,stormscale,287,demonhunter,havoc,6,3,3
1995,Eranduur,draenor,287,demonhunter,havoc,6,3,3
1996,Allalina,draenor,287,demonhunter,havoc,6,3,3
1997,Glaiverush,alakir,287,demonhunter,havoc,6,3,3
1998,Menutzdh,tarren-mill,287,demonhunter,havoc,6,3,3
1999,Amaterasù,alleria,287,demonhunter,havoc,12,3,9
2000,Гёнке,gordunni,287,demonhunter,havoc,18,3,15
2001,Dàrkinette,archimonde,286,demonhunter,havoc,6,3,3
2002,Gêliôs,kazzak,271,demonhunter,havoc,11,3,8
2003,Nithraim,kazzak,240,demonhunter,havoc,9,3,6
2004,Kalr,silvermoon,239,demonhunter,havoc,5,3,2
2005,Itskarmax,outland,239,demonhunter,havoc,5,3,2
2006,Xaro,quelthalas,239,demonhunter,havoc,5,3,2
2007,Ponn,blackmoore,239,demonhunter,havoc,5,3,2
2008,Jamule,dun-morogh,231,demonhunter,havoc,12,4,8
2009,Erenyeagerr,kazzak,192,demonhunter,havoc,4,3,1
2010,Demoqt,ragnaros,192,demonhunter,havoc,4,3,1
2011,Zlett,draenor,192,demonhunter,havoc,6,2,4
2012,Kakovicz,gorgonnash,192,demonhunter,havoc,6,2,4
2013,Мэлифсб,blackscar,192,demonhunter,havoc,6,2,4
2014,Demontoolz,outland,192,demonhunter,havoc,6,2,4
2015,Disconecting,outland,192,demonhunter,havoc,6,2,4
2016,Bämbøué,hyjal,192,demonhunter,havoc,6,2,4
2017,Папичгодх,borean-tundra,192,demonhunter,havoc,6,2,4
2018,Illidaia,ravencrest,192,demonhunter,havoc,6,2,4
2019,Тэнсу,borean-tundra,192,demonhunter,havoc,6,2,4
2020,Malzehar,tarren-mill,192,demonhunter,havoc,6,2,4
2021,Takad,twisting-nether,192,demonhunter,havoc,6,2,4
2022,Malkyor,ysondre,192,demonhunter,havoc,6,2,4
2023,Rybn,eredar,192,demonhunter,havoc,6,2,4
2024,Demonpegasus,draenor,192,demonhunter,havoc,6,2,4
2025,Cøldlean,ravencrest,192,demonhunter,havoc,6,2,4
2026,Alcadejas,pozzo-delleternità,192,demonhunter,havoc,6,2,4
2027,Ragnarak,amanthul,192,demonhunter,havoc,6,2,4
2028,Grimjow,arthas,192,demonhunter,havoc,6,2,4
2029,Datejust,archimonde,192,demonhunter,havoc,6,2,4
2030,Karpandero,stormreaver,192,demonhunter,havoc,6,2,4
2031,Ànavar,twisting-nether,192,demonhunter,havoc,6,2,4
2032,Gnaget,the-maelstrom,192,demonhunter,havoc,6,2,4
2033,Linkôs,aegwynn,192,demonhunter,havoc,6,2,4
2034,Barocs,antonidas,192,demonhunter,havoc,6,2,4
2035,Téthis,uldaman,192,demonhunter,havoc,6,2,4
2036,Hupon,drakthul,192,demonhunter,havoc,6,2,4
2037,Usaïnbolts,archimonde,192,demonhunter,havoc,6,2,4
2038,Juicyglaives,ragnaros,192,demonhunter,havoc,6,2,4
2039,Gandzsä,ragnaros,192,demonhunter,havoc,6,2,4
2040,Nanana,doomhammer,192,demonhunter,havoc,6,2,4
2041,Cíondra,aegwynn,192,demonhunter,havoc,6,2,4
2042,Sweåfy,outland,192,demonhunter,havoc,6,2,4
2043,Деорру,gordunni,192,demonhunter,havoc,6,2,4
2044,Valkorion,chamber-of-aspects,192,demonhunter,havoc,6,2,4
2045,Sakumi,azshara,192,demonhunter,havoc,6,2,4
2046,Cutforshred,zenedar,192,demonhunter,havoc,6,2,4
2047,Tacodhx,ravencrest,192,demonhunter,havoc,6,2,4
2048,Williamgrant,alonsus,192,demonhunter,havoc,6,2,4
2049,Donstyle,anachronos,192,demonhunter,havoc,6,2,4
2050,Badess,malfurion,192,demonhunter,havoc,6,2,4
2051,Vulcaan,ravencrest,192,demonhunter,havoc,6,2,4
2052,Rúllio,rexxar,192,demonhunter,havoc,6,2,4
2053,Беатриз,soulflayer,192,demonhunter,havoc,6,2,4
2054,Sazzox,blackrock,192,demonhunter,havoc,6,2,4
2055,Zxcjklcasdlk,sylvanas,192,demonhunter,havoc,6,2,4
2056,Stifeur,archimonde,192,demonhunter,havoc,6,2,4
2057,Martøsdh,uldum,192,demonhunter,havoc,6,2,4
2058,Noitradh,zuljin,192,demonhunter,havoc,6,2,4
2059,Hicke,burning-legion,192,demonhunter,havoc,6,2,4
2060,Saphira,laughing-skull,192,demonhunter,havoc,6,2,4
2061,Sazukè,blackmoore,192,demonhunter,havoc,6,2,4
2062,Bogren,sylvanas,192,demonhunter,havoc,6,2,4
2063,Palaurx,kazzak,192,demonhunter,havoc,6,2,4
2064,Arkta,kazzak,192,demonhunter,havoc,6,2,4
2065,Dhamp,kazzak,192,demonhunter,havoc,6,2,4
2066,Wolfex,hellfire,192,demonhunter,havoc,6,2,4
2067,Lucziane,blackmoore,192,demonhunter,havoc,6,2,4
2068,Roxxis,mazrigos,192,demonhunter,havoc,6,2,4
2069,Сязекть,goldrinn,192,demonhunter,havoc,6,2,4
2070,Riveén,blackhand,192,demonhunter,havoc,6,2,4
2071,Nairra,blackmoore,192,demonhunter,havoc,6,2,4
2072,Hamssterek,magtheridon,192,demonhunter,havoc,6,2,4
2073,Маскитол,soulflayer,192,demonhunter,havoc,6,2,4
2074,Bratti,kazzak,192,demonhunter,havoc,6,2,4
2075,Ataddcay,outland,192,demonhunter,havoc,8,2,6
2076,Drâparn,sylvanas,192,demonhunter,havoc,12,2,10
2077,Deehoh,twisting-nether,192,demonhunter,havoc,12,2,10
2078,Парагони,gordunni,192,demonhunter,havoc,12,2,10
2079,Tôx,dalaran,192,demonhunter,havoc,12,2,10
2080,Zynês,draenor,192,demonhunter,havoc,12,2,10
2081,Zaydra,the-maelstrom,192,demonhunter,havoc,12,2,10
2082,Gouteça,la-croisade-écarlate,192,demonhunter,havoc,12,2,10
2083,Spideymon,ragnaros,192,demonhunter,havoc,12,2,10
2084,Gagfordaddy,ravencrest,192,demonhunter,havoc,12,2,10
2085,Mettdaemon,ravencrest,192,demonhunter,havoc,12,2,10
2086,Inflection,ravencrest,192,demonhunter,havoc,12,2,10
2087,Enygamy,frostmane,192,demonhunter,havoc,12,2,10
2088,Bobdh,twisting-nether,192,demonhunter,havoc,17,2,15
2089,Deathniresa,argent-dawn,191,demonhunter,havoc,6,2,4
2090,Hellforce,nemesis,191,demonhunter,havoc,6,2,4
2091,Lilarii,argent-dawn,191,demonhunter,havoc,12,2,10
2092,Noorrd,hyjal,191,demonhunter,havoc,12,2,10
2093,Manjirosano,blackmoore,191,demonhunter,havoc,12,2,10
2094,Galafel,outland,159,demonhunter,havoc,5,2,3
2095,Zealdancer,veknilash,159,demonhunter,havoc,5,2,3
2096,Snelle,outland,144,demonhunter,havoc,9,2,7
2097,Felsbane,argent-dawn,96,demonhunter,havoc,3,2,1
2098,Подэхилла,galakrond,96,demonhunter,havoc,4,2,2
2099,Jiínx,kazzak,96,demonhunter,havoc,6,1,5
2100,Rxor,eredar,96,demonhunter,havoc,6,1,5
2101,Annee,eredar,96,demonhunter,havoc,6,1,5
2102,Flasqo,eredar,96,demonhunter,havoc,6,1,5
2103,Sgit,doomhammer,96,demonhunter,havoc,6,1,5
2104,Askari,lothar,96,demonhunter,havoc,6,1,5
2105,Stormma,kazzak,96,demonhunter,havoc,6,1,5
2106,Byakugaan,drakthul,96,demonhunter,havoc,6,1,5
2107,Zarafel,hyjal,96,demonhunter,havoc,6,1,5
2108,Ninjantiz,antonidas,96,demonhunter,havoc,6,1,5
2109,Maikko,los-errantes,96,demonhunter,havoc,6,1,5
2110,Norebb,sanguino,96,demonhunter,havoc,6,1,5
2111,Nairu,doomhammer,96,demonhunter,havoc,6,1,5
2112,Ghetzlel,draenor,96,demonhunter,havoc,6,1,5
2113,Dýlän,argent-dawn,96,demonhunter,havoc,6,1,5
2114,Найлинель,fordragon,96,demonhunter,havoc,6,1,5
2115,Спокоивич,soulflayer,96,demonhunter,havoc,6,1,5
2116,Ilovesabrina,dun-modr,96,demonhunter,havoc,6,1,5
2117,Stàmàzza,nemesis,96,demonhunter,havoc,6,1,5
2118,Shylaría,blackhand,96,demonhunter,havoc,6,1,5
2119,Cruptiq,kazzak,96,demonhunter,havoc,6,1,5
2120,Ryuhayabusa,stormscale,96,demonhunter,havoc,6,1,5
2121,Соларт,howling-fjord,96,demonhunter,havoc,6,1,5
2122,Ганстапутин,howling-fjord,96,demonhunter,havoc,6,1,5
2123,Äzot,burning-legion,96,demonhunter,havoc,6,1,5
2124,Максимлолпро,howling-fjord,96,demonhunter,havoc,6,1,5
2125,Teimotevey,silvermoon,96,demonhunter,havoc,6,1,5
2126,Nagh,archimonde,96,demonhunter,havoc,6,1,5
2127,Аззазэль,howling-fjord,96,demonhunter,havoc,6,1,5
2128,Bitex,archimonde,96,demonhunter,havoc,6,1,5
2129,Burritodh,tarren-mill,96,demonhunter,havoc,6,1,5
2130,Daekon,ahnqiraj,96,demonhunter,havoc,6,1,5
2131,Niqel,blackrock,96,demonhunter,havoc,6,1,5
2132,Trinchensdh,blackhand,96,demonhunter,havoc,6,1,5
2133,Andij,frostwolf,96,demonhunter,havoc,6,1,5
2134,Läderjoel,ravencrest,96,demonhunter,havoc,6,1,5
2135,Kiô,drakthul,96,demonhunter,havoc,6,1,5
2136,Ellare,burning-blade,96,demonhunter,havoc,6,1,5
2137,Giace,drakthul,96,demonhunter,havoc,6,1,5
2138,Mlecznygolem,silvermoon,96,demonhunter,havoc,6,1,5
2139,Pkdaemon,draenor,96,demonhunter,havoc,6,1,5
2140,Jyzu,festung-der-stürme,96,demonhunter,havoc,6,1,5
2141,Blulake,silvermoon,96,demonhunter,havoc,6,1,5
2142,Ripgodx,bronzebeard,96,demonhunter,havoc,6,1,5
2143,Jásírá,shattrath,96,demonhunter,havoc,12,1,11
2144,Babyyéah,sunstrider,96,demonhunter,havoc,12,1,11
2145,Ecthelionn,outland,96,demonhunter,havoc,12,1,11
2146,Shinarei,silvermoon,95,demonhunter,havoc,6,1,5
2147,Elldarion,blackhand,79,demonhunter,havoc,5,1,4
2148,Deamo,stormscale,79,demonhunter,havoc,5,1,4
2149,Caluxe,blackmoore,79,demonhunter,havoc,5,1,4
2150,Omegasyx,dun-modr,64,demonhunter,havoc,4,1,3
2151,Гадх,gordunni,42,demonhunter,havoc,8,2,6
2152,Felwaifu,tarren-mill,31,demonhunter,havoc,2,1,1
2153,Sinjinzoo,blackrock,31,demonhunter,havoc,2,1,1
2154,Greyfel,blackhand,31,demonhunter,havoc,2,1,1
2155,Ìllídán,ravencrest,31,demonhunter,havoc,2,1,1
2156,Herzbann,madmortem,16,demonhunter,havoc,1,1,0
2157,Vengeancezin,frostwhisper,1940,demonhunter,vengeance,114,59,55
2158,Jedidiah,aggra-português,1667,demonhunter,vengeance,39,19,20
2159,Zarín,outland,1394,demonhunter,vengeance,78,41,37
2160,Kekburagól,kazzak,575,demonhunter,vengeance,12,6,6
2161,Demonlucy,colinas-pardas,287,demonhunter,vengeance,12,3,9
2162,Геммула,howling-fjord,192,demonhunter,vengeance,6,2,4
2163,Askari,lothar,192,demonhunter,vengeance,6,2,4
2164,Сумърак,grom,192,demonhunter,vengeance,12,2,10
2165,Arussil,pozzo-delleternità,96,demonhunter,vengeance,6,1,5
2166,Xenits,kazzak,96,demonhunter,vengeance,6,1,5
2167,Zarafel,hyjal,95,demonhunter,vengeance,12,1,11
2168,Hibibi,kazzak,2257,druid,restoration,113,66,47
2169,Pegasu,kelthuzad,2206,druid,restoration,96,57,39
2170,Kev,elune,2190,druid,restoration,185,102,83
2171,Vanostboom,kazzak,2181,druid,restoration,88,50,38
2172,Iloveher,ravencrest,2180,druid,restoration,160,89,71
2173,Årt,ravencrest,2153,druid,restoration,120,65,55
2174,Trèes,outland,2107,druid,restoration,95,59,36
2175,Nesedondon,stormscale,2101,druid,restoration,60,44,16
2176,Miouzy,archimonde,2047,druid,restoration,54,28,26
2177,Unohanâ,archimonde,2045,druid,restoration,84,50,34
2178,Dendariottvx,sunstrider,2042,druid,restoration,73,44,29
2179,Bambambimbim,draenor,2023,druid,restoration,84,44,40
2180,Afky,stormreaver,2021,druid,restoration,90,47,43
2181,Thotz,kazzak,2006,druid,restoration,96,50,46
2182,Yoogy,ravencrest,1995,druid,restoration,60,37,23
2183,Lunamimi,argent-dawn,1990,druid,restoration,218,117,101
2184,Angrykejton,silvermoon,1984,druid,restoration,204,105,99
2185,Rives,sylvanas,1978,druid,restoration,78,46,32
2186,Tjxaxa,ravencrest,1966,druid,restoration,78,38,40
2187,Shinöbü,sanguino,1956,druid,restoration,57,37,20
2188,Sheippi,stormreaver,1945,druid,restoration,54,31,23
2189,Skrrlock,ravencrest,1923,druid,restoration,108,53,55
2190,Mentallyill,ravencrest,1914,druid,restoration,120,65,55
2191,Syví,outland,1912,druid,restoration,59,29,30
2192,Hånukkah,outland,1911,druid,restoration,58,29,29
2193,Håbibi,kazzak,1897,druid,restoration,42,23,19
2194,Promethezine,tarren-mill,1896,druid,restoration,135,76,59
2195,Thysabtw,archimonde,1894,druid,restoration,53,33,20
2196,Nastycat,magtheridon,1889,druid,restoration,167,83,84
2197,Clone,aegwynn,1878,druid,restoration,72,44,28
2198,Maxpojke,ravencrest,1876,druid,restoration,142,88,54
2199,Niksidruid,grim-batol,1868,druid,restoration,28,21,7
2200,Ralaa,guldan,1865,druid,restoration,54,29,25
2201,Arthéas,archimonde,1865,druid,restoration,174,89,85
2202,Naffelle,ysondre,1862,druid,restoration,71,34,37
2203,Druidrak,eredar,1855,druid,restoration,66,32,34
2204,Lalalime,arthas,1851,druid,restoration,64,31,33
2205,Åä,ravencrest,1837,druid,restoration,32,20,12
2206,Thebiggest,ravencrest,1836,druid,restoration,42,25,17
2207,Andr,voljin,1835,druid,restoration,60,26,34
2208,Jmdr,silvermoon,1830,druid,restoration,71,31,40
2209,Spamclone,draenor,1828,druid,restoration,57,30,27
2210,Kanyevotèrx,ravencrest,1828,druid,restoration,54,25,29
2211,Gummysnake,aszune,1823,druid,restoration,42,25,17
2212,Zydrux,outland,1822,druid,restoration,48,36,12
2213,Doodlez,blackrock,1820,druid,restoration,60,27,33
2214,Metagrass,stormscale,1818,druid,restoration,129,59,70
2215,Reins,silvermoon,1817,druid,restoration,36,23,13
2216,Skadooshee,kazzak,1816,druid,restoration,36,19,17
2217,Køngx,blackhand,1812,druid,restoration,125,64,61
2218,Sorryblya,ravencrest,1809,druid,restoration,60,26,34
2219,Мафио,blackscar,1805,druid,restoration,48,25,23
2220,Theatrex,ravencrest,1803,druid,restoration,111,66,45
2221,Wraithshape,stormscale,1800,druid,restoration,60,32,28
2222,Threesixnìne,dun-morogh,1795,druid,restoration,48,27,21
2223,Jìnró,ravencrest,1782,druid,restoration,129,63,66
2224,Qjkuug,twisting-nether,1774,druid,restoration,112,71,41
2225,Heçtôr,silvermoon,1767,druid,restoration,60,27,33
2226,Dokixo,kazzak,1766,druid,restoration,35,19,16
2227,Chacopic,archimonde,1764,druid,restoration,114,58,56
2228,Wéédmâñ,ravencrest,1756,druid,restoration,45,30,15
2229,Matteps,outland,1742,druid,restoration,41,19,22
2230,Asaj,argent-dawn,1741,druid,restoration,130,74,56
2231,Улдрэйн,deathguard,1739,druid,restoration,66,38,28
2232,Lifelover,outland,1734,druid,restoration,48,23,25
2233,Дикаякиара,blackscar,1731,druid,restoration,113,51,62
2234,Hizzy,burning-legion,1730,druid,restoration,231,112,119
2235,Tedel,kazzak,1728,druid,restoration,47,28,19
2236,Gaeldeth,silvermoon,1726,druid,restoration,93,53,40
2237,Филавтия,gordunni,1724,druid,restoration,60,32,28
2238,Druidella,stormscale,1716,druid,restoration,30,18,12
2239,Galadronìa,aegwynn,1715,druid,restoration,41,25,16
2240,Alolexx,archimonde,1711,druid,restoration,30,18,12
2241,Wraithmoon,stormscale,1705,druid,restoration,36,18,18
2242,Moonbee,burning-blade,1704,druid,restoration,42,28,14
2243,Slayced,blackrock,1700,druid,restoration,35,21,14
2244,Riplilpeep,grim-batol,1694,druid,restoration,48,23,25
2245,Moondra,outland,1688,druid,restoration,95,39,56
2246,Luhmanish,thunderhorn,1684,druid,restoration,102,52,50
2247,Eviscreator,stormscale,1683,druid,restoration,42,27,15
2248,Nasduck,ravencrest,1680,druid,restoration,40,27,13
2249,Erika,vashj,1676,druid,restoration,48,26,22
2250,Gøðførm,silvermoon,1673,druid,restoration,102,51,51
2251,Drjmy,silvermoon,1669,druid,restoration,30,24,6
2252,Buffbloom,auchindoun,1668,druid,restoration,126,67,59
2253,Funnyjoker,outland,1665,druid,restoration,36,18,18
2254,Sintiq,silvermoon,1661,druid,restoration,35,22,13
2255,Demerit,aegwynn,1657,druid,restoration,32,18,14
2256,Bâneth,destromath,1656,druid,restoration,60,33,27
2257,Praetorian,sylvanas,1653,druid,restoration,60,25,35
2258,Catgirlx,ravencrest,1652,druid,restoration,42,26,16
2259,Pogoth,turalyon,1641,druid,restoration,72,38,34
2260,Drøødis,archimonde,1636,druid,restoration,42,24,18
2261,Чухх,howling-fjord,1636,druid,restoration,52,29,23
2262,Trèes,draenor,1636,druid,restoration,46,22,24
2263,Pardus,ambossar,1635,druid,restoration,50,27,23
2264,Eedaza,argent-dawn,1632,druid,restoration,42,20,22
2265,Рамзес,gordunni,1631,druid,restoration,30,20,10
2266,Mafiasnipe,ravencrest,1630,druid,restoration,24,17,7
2267,Friedbrocolí,tarren-mill,1629,druid,restoration,30,17,13
2268,Asga,stormscale,1628,druid,restoration,30,17,13
2269,Olaphy,elune,1628,druid,restoration,137,67,70
2270,Frances,auchindoun,1622,druid,restoration,51,30,21
2271,Миледистайпи,gordunni,1619,druid,restoration,32,18,14
2272,Haszard,outland,1618,druid,restoration,54,26,28
2273,Floka,archimonde,1617,druid,restoration,48,30,18
2274,Goldrax,outland,1615,druid,restoration,24,17,7
2275,Treliuz,twilights-hammer,1611,druid,restoration,105,58,47
2276,Slaugh,zuljin,1608,druid,restoration,48,20,28
2277,Опапенелопа,blackscar,1607,druid,restoration,39,27,12
2278,Bigmeandruid,twisting-nether,1606,druid,restoration,30,17,13
2279,Bîrke,blackrock,1604,druid,restoration,36,17,19
2280,Naraia,aegwynn,1602,druid,restoration,30,17,13
2281,Ðarckness,kazzak,1600,druid,restoration,24,17,7
2282,Swifte,argent-dawn,1600,druid,restoration,48,27,21
2283,Akmón,tarren-mill,1600,druid,restoration,58,20,38
2284,Hyggefinger,ravencrest,1596,druid,restoration,42,19,23
2285,Trollisha,mannoroth,1596,druid,restoration,83,37,46
2286,Sélia,sylvanas,1591,druid,restoration,89,41,48
2287,Xoriauz,archimonde,1582,druid,restoration,72,33,39
2288,Builtdiffy,kazzak,1569,druid,restoration,167,83,84
2289,Nancey,auchindoun,1566,druid,restoration,89,43,46
2290,Jcpenney,xavius,1557,druid,restoration,97,47,50
2291,Diolives,stormscale,1555,druid,restoration,136,70,66
2292,Crïn,ravencrest,1553,druid,restoration,36,17,19
2293,Bearform,blackhand,1548,druid,restoration,48,23,25
2294,Khunahype,thrall,1546,druid,restoration,88,48,40
2295,Warami,eredar,1539,druid,restoration,36,19,17
2296,Mortalnight,sinstralis,1534,druid,restoration,170,83,87
2297,Skrood,kazzak,1532,druid,restoration,30,16,14
2298,Ittei,korgall,1531,druid,restoration,96,49,47
2299,Orayin,ravencrest,1530,druid,restoration,30,23,7
2300,Kundz,dalaran,1530,druid,restoration,148,81,67
2301,Acondris,kazzak,1528,druid,restoration,42,16,26
2302,Hasselhoof,eredar,1526,druid,restoration,63,26,37
2303,Bjoernbrudn,ravencrest,1524,druid,restoration,30,16,14
2304,Skillfall,ravencrest,1524,druid,restoration,42,16,26
2305,Zhosy,shattrath,1522,druid,restoration,36,16,20
2306,Dwaokut,ravencrest,1514,druid,restoration,47,24,23
2307,Arogane,outland,1512,druid,restoration,63,32,31
2308,Homek,eredar,1505,druid,restoration,30,18,12
2309,Feelstreeman,twisting-nether,1504,druid,restoration,77,42,35
2310,Sandirion,silvermoon,1501,druid,restoration,398,198,200
2311,Ёу,soulflayer,1495,druid,restoration,53,22,31
2312,Setztes,tarren-mill,1494,druid,restoration,49,28,21
2313,Kicki,outland,1494,druid,restoration,66,34,32
2314,Маккаланн,soulflayer,1493,druid,restoration,48,30,18
2315,Atôtheex,kazzak,1488,druid,restoration,43,21,22
2316,Kheazar,blackmoore,1484,druid,restoration,61,37,24
2317,Vashiko,tarren-mill,1483,druid,restoration,77,40,37
2318,Scra,anubarak,1482,druid,restoration,83,45,38
2319,Атмос,deathguard,1477,druid,restoration,77,46,31
2320,Pureballs,twisting-nether,1477,druid,restoration,165,93,72
2321,Wwvwwvwwvwvw,burning-legion,1477,druid,restoration,48,19,29
2322,Zaerox,ambossar,1474,druid,restoration,48,23,25
2323,Deluron,malganis,1472,druid,restoration,101,50,51
2324,Lukass,drakthul,1464,druid,restoration,72,40,32
2325,Drbse,silvermoon,1461,druid,restoration,56,28,28
2326,Spliçe,draenor,1458,druid,restoration,42,21,21
2327,Scorlok,eredar,1455,druid,restoration,44,25,19
2328,Ööh,outland,1453,druid,restoration,48,25,23
2329,Tamburoo,tarren-mill,1449,druid,restoration,119,52,67
2330,Велаине,soulflayer,1447,druid,restoration,99,53,46
2331,Tôrmêñtêd,outland,1442,druid,restoration,69,42,27
2332,Фапдрим,howling-fjord,1442,druid,restoration,42,22,20
2333,Flum,darksorrow,1441,druid,restoration,148,77,71
2334,Xyruden,kazzak,1441,druid,restoration,171,69,102
2335,Ына,gordunni,1438,druid,restoration,81,39,42
2336,Ilyethea,earthen-ring,1437,druid,restoration,329,178,151
2337,Síggíe,eredar,1436,druid,restoration,30,17,13
2338,Shredzz,ravencrest,1436,druid,restoration,36,15,21
2339,Блумха,howling-fjord,1435,druid,restoration,66,34,32
2340,Andromedda,twisting-nether,1435,druid,restoration,66,31,35
2341,Hadok,azjolnerub,1435,druid,restoration,36,15,21
2342,Aesha,los-errantes,1434,druid,restoration,30,15,15
2343,Evílz,kazzak,1431,druid,restoration,24,15,9
2344,Брэвно,gordunni,1430,druid,restoration,219,113,106
2345,Bëstwôrld,archimonde,1428,druid,restoration,30,15,15
2346,Tunling,ravencrest,1423,druid,restoration,30,20,10
2347,Guccicken,garona,1420,druid,restoration,88,47,41
2348,Kittý,terokkar,1414,druid,restoration,135,65,70
2349,Plàntz,tarren-mill,1406,druid,restoration,79,39,40
2350,Bammedrudu,archimonde,1401,druid,restoration,24,15,9
2351,Dûdûrînâ,blackrock,1400,druid,restoration,24,15,9
2352,Wenciorek,kazzak,1400,druid,restoration,75,37,38
2353,Ghaara,outland,1399,druid,restoration,46,28,18
2354,Bloomies,tarren-mill,1396,druid,restoration,64,36,28
2355,Друлёнышь,eversong,1394,druid,restoration,125,65,60
2356,Clovér,outland,1394,druid,restoration,30,15,15
2357,Shufflê,blackmoore,1392,druid,restoration,125,57,68
2358,Styleexd,ragnaros,1391,druid,restoration,51,27,24
2359,Cörelly,ravencrest,1382,druid,restoration,145,88,57
2360,Ивантяй,gordunni,1377,druid,restoration,77,38,39
2361,Balanc,ragnaros,1366,druid,restoration,30,16,14
2362,Wooshy,kazzak,1358,druid,restoration,40,17,23
2363,Zwierzyniec,jaedenar,1357,druid,restoration,60,27,33
2364,Thanom,auchindoun,1348,druid,restoration,110,54,56
2365,Zaeli,archimonde,1344,druid,restoration,24,14,10
2366,Acxaryl,ravencrest,1343,druid,restoration,30,14,16
2367,Adjaara,ravencrest,1335,druid,restoration,30,15,15
2368,Kooglaash,kazzak,1335,druid,restoration,85,41,44
2369,Legyna,ravencrest,1334,druid,restoration,23,15,8
2370,Shifthappénz,draenor,1334,druid,restoration,60,28,32
2371,Вакидзами,gordunni,1331,druid,restoration,48,28,20
2372,Fabsl,archimonde,1330,druid,restoration,30,14,16
2373,Làhen,ravencrest,1330,druid,restoration,36,15,21
2374,Khalec,silvermoon,1327,druid,restoration,24,17,7
2375,Scaleo,stormreaver,1326,druid,restoration,36,23,13
2376,Analmonstret,shattered-hand,1323,druid,restoration,24,14,10
2377,Knzm,dun-modr,1323,druid,restoration,120,62,58
2378,Bigßoi,stormscale,1322,druid,restoration,72,36,36
2379,Друидсимба,howling-fjord,1320,druid,restoration,51,29,22
2380,Koemarkt,sunstrider,1319,druid,restoration,46,29,17
2381,Varrdru,kazzak,1318,druid,restoration,32,19,13
2382,Yenwe,kazzak,1317,druid,restoration,124,65,59
2383,Крайсонг,soulflayer,1316,druid,restoration,36,18,18
2384,Idect,silvermoon,1314,druid,restoration,106,55,51
2385,Halyconwings,outland,1314,druid,restoration,33,17,16
2386,Hellofresh,silvermoon,1312,druid,restoration,30,14,16
2387,Nayokô,grim-batol,1310,druid,restoration,30,15,15
2388,Mangy,xavius,1309,druid,restoration,78,39,39
2389,Рефикс,gordunni,1307,druid,restoration,79,52,27
2390,Ekologiskxx,outland,1296,druid,restoration,85,40,45
2391,Callìa,sylvanas,1294,druid,restoration,36,18,18
2392,Shelby,tirion,1291,druid,restoration,69,36,33
2393,Asanaria,ravencrest,1286,druid,restoration,38,15,23
2394,Feinberg,stormscale,1286,druid,restoration,42,14,28
2395,Хуссипусси,galakrond,1285,druid,restoration,29,14,15
2396,Lyvuni,blackmoore,1285,druid,restoration,30,14,16
2397,Seikoo,defias-brotherhood,1284,druid,restoration,91,41,50
2398,Paawz,stormscale,1281,druid,restoration,65,33,32
2399,Kaamirach,blackmoore,1280,druid,restoration,23,16,7
2400,Bägira,sylvanas,1280,druid,restoration,59,29,30
2401,Cubalitis,tarren-mill,1271,druid,restoration,36,22,14
2402,Leliaen,sylvanas,1269,druid,restoration,45,24,21
2403,Chinoiserie,aszune,1268,druid,restoration,138,73,65
2404,Mchots,ragnaros,1267,druid,restoration,95,42,53
2405,Walexx,kazzak,1266,druid,restoration,44,25,19
2406,Delmond,sylvanas,1266,druid,restoration,185,93,92
2407,Nalreaa,kazzak,1265,druid,restoration,48,27,21
2408,Lalon,blackrock,1265,druid,restoration,48,24,24
2409,Обейрин,gordunni,1261,druid,restoration,78,40,38
2410,Cuxorb,rexxar,1259,druid,restoration,48,21,27
2411,Delarion,nemesis,1258,druid,restoration,36,21,15
2412,Irondruid,silvermoon,1250,druid,restoration,64,38,26
2413,Maethar,stormrage,1250,druid,restoration,51,28,23
2414,Liquis,outland,1249,druid,restoration,109,56,53
2415,Chas,ravencrest,1247,druid,restoration,24,13,11
2416,Deltsur,stormscale,1247,druid,restoration,35,17,18
2417,Bellatrx,darksorrow,1246,druid,restoration,18,13,5
2418,Lamatoes,ravencrest,1246,druid,restoration,30,13,17
2419,Doodougie,silvermoon,1245,druid,restoration,30,13,17
2420,Crep,krasus,1243,druid,restoration,30,21,9
2421,Bellhooks,blackrock,1239,druid,restoration,24,13,11
2422,ßløøm,outland,1236,druid,restoration,24,16,8
2423,Mindru,sylvanas,1236,druid,restoration,27,14,13
2424,Xôárqt,aegwynn,1236,druid,restoration,30,13,17
2425,Jtepdru,ravencrest,1234,druid,restoration,24,13,11
2426,Eyvimel,ravencrest,1233,druid,restoration,24,13,11
2427,Zaratras,arathor,1230,druid,restoration,50,23,27
2428,Zelíx,bronzebeard,1229,druid,restoration,42,28,14
2429,Корнерит,gordunni,1229,druid,restoration,82,43,39
2430,Урька,blackscar,1226,druid,restoration,41,17,24
2431,Weregoon,blackmoore,1225,druid,restoration,191,91,100
2432,Sgtdrood,archimonde,1223,druid,restoration,30,13,17
2433,Fettpumpad,karazhan,1221,druid,restoration,103,59,44
2434,Nyxxz,shattered-hand,1221,druid,restoration,30,13,17
2435,Vícvega,ravencrest,1213,druid,restoration,24,15,9
2436,Dreaddot,archimonde,1210,druid,restoration,24,13,11
2437,Autoritär,gilneas,1209,druid,restoration,49,26,23
2438,Kukisanban,stormscale,1209,druid,restoration,102,54,48
2439,Vanlise,ravencrest,1202,druid,restoration,30,16,14
2440,Дилайт,blackscar,1201,druid,restoration,30,13,17
2441,Namenloser,azshara,1200,druid,restoration,72,39,33
2442,Plsbuffdruid,ravencrest,1189,druid,restoration,28,14,14
2443,Jiujiteiro,tarren-mill,1184,druid,restoration,47,26,21
2444,Collîî,aegwynn,1183,druid,restoration,44,25,19
2445,Inkeyes,outland,1182,druid,restoration,107,45,62
2446,Amakary,blackrock,1178,druid,restoration,36,16,20
2447,Julss,archimonde,1176,druid,restoration,36,15,21
2448,Hílarío,sanguino,1174,druid,restoration,38,13,25
2449,Cellanir,blackrock,1171,druid,restoration,39,14,25
2450,Mitnik,stormscale,1159,druid,restoration,86,48,38
2451,Adiycrazy,outland,1158,druid,restoration,42,16,26
2452,Lucael,blackmoore,1158,druid,restoration,36,13,23
2453,Røsary,stormscale,1156,druid,restoration,75,40,35
2454,Mochiløxz,tarren-mill,1155,druid,restoration,24,13,11
2455,Walenok,thrall,1155,druid,restoration,179,87,92
2456,Cäsïo,khaz-modan,1154,druid,restoration,54,32,22
2457,Ceapamatii,sylvanas,1153,druid,restoration,30,15,15
2458,Lfsecondreju,ravencrest,1151,druid,restoration,18,12,6
2459,Myndrá,varimathras,1151,druid,restoration,24,12,12
2460,Dreathqt,twisting-nether,1150,druid,restoration,24,12,12
2461,Rozt,ravencrest,1150,druid,restoration,24,12,12
2462,Diriculous,kazzak,1150,druid,restoration,36,12,24
2463,Ooktharg,turalyon,1148,druid,restoration,18,12,6
2464,Rozi,draenor,1148,druid,restoration,18,12,6
2465,Weiden,twisting-nether,1147,druid,restoration,24,13,11
2466,Watchmebear,stormscale,1147,druid,restoration,24,12,12
2467,Olympïee,archimonde,1147,druid,restoration,24,12,12
2468,Rougetreize,khaz-modan,1146,druid,restoration,24,12,12
2469,Elmáestró,aegwynn,1146,druid,restoration,24,12,12
2470,Trànsformer,nemesis,1142,druid,restoration,30,12,18
2471,Eeivi,argent-dawn,1141,druid,restoration,18,12,6
2472,Катяблум,gordunni,1139,druid,restoration,30,12,18
2473,Кнесис,howling-fjord,1138,druid,restoration,19,13,6
2474,Halleyz,hyjal,1138,druid,restoration,103,53,50
2475,Arfedan,kazzak,1136,druid,restoration,42,24,18
2476,Chable,hyjal,1131,druid,restoration,18,12,6
2477,Eko,auchindoun,1131,druid,restoration,48,18,30
2478,Menolao,dun-morogh,1127,druid,restoration,30,18,12
2479,Räysa,archimonde,1127,druid,restoration,133,68,65
2480,Dadud,twisting-nether,1126,druid,restoration,30,18,12
2481,Tsuteymanga,veknilash,1123,druid,restoration,60,28,32
2482,Maryjuanita,silvermoon,1122,druid,restoration,104,43,61
2483,Raysa,archimonde,1119,druid,restoration,69,35,34
2484,Ndnd,drakthul,1112,druid,restoration,82,42,40
2485,Bynxx,antonidas,1112,druid,restoration,100,46,54
2486,Сваткумбрат,eversong,1110,druid,restoration,78,26,52
2487,Dobbmaster,aegwynn,1107,druid,restoration,222,113,109
2488,Mendozä,stormscale,1103,druid,restoration,55,28,27
2489,Zirkuszwei,aegwynn,1102,druid,restoration,29,14,15
2490,Vranz,draenor,1102,druid,restoration,42,19,23
2491,Bioházard,blackrock,1101,druid,restoration,18,12,6
2492,Snowrk,hyjal,1101,druid,restoration,30,19,11
2493,Hólo,blackrock,1097,druid,restoration,29,14,15
2494,Relache,twisting-nether,1086,druid,restoration,42,23,19
2495,Vurgyl,hyjal,1079,druid,restoration,54,33,21
2496,Cazzette,grim-batol,1073,druid,restoration,24,13,11
2497,Киберужас,gordunni,1069,druid,restoration,116,54,62
2498,Ankhenature,outland,1068,druid,restoration,65,36,29
2499,Betelgues,kazzak,1067,druid,restoration,54,31,23
2500,Spidete,sanguino,1067,druid,restoration,66,36,30
2501,Ironveins,ravencrest,1066,druid,restoration,18,12,6
2502,Elanrya,argent-dawn,1066,druid,restoration,53,15,38
2503,Midnightstry,alakir,1064,druid,restoration,84,42,42
2504,Farodiin,blackmoore,1063,druid,restoration,42,20,22
2505,Hypnosoad,outland,1062,druid,restoration,76,31,45
2506,Justforgames,ravencrest,1056,druid,restoration,12,11,1
2507,Kobrá,ravencrest,1056,druid,restoration,18,11,7
2508,Niknoom,azjolnerub,1056,druid,restoration,54,32,22
2509,Хлайси,gordunni,1056,druid,restoration,24,11,13
2510,Wømbat,ravencrest,1056,druid,restoration,24,11,13
2511,Sprøut,drakthul,1056,druid,restoration,24,11,13
2512,Asklepion,twisting-nether,1056,druid,restoration,24,11,13
2513,Kyomã,burning-legion,1056,druid,restoration,24,11,13
2514,Weisslogia,aegwynn,1055,druid,restoration,18,11,7
2515,Nasgra,malganis,1055,druid,restoration,24,11,13
2516,Дуггизавр,howling-fjord,1055,druid,restoration,24,11,13
2517,Oschlandor,blackmoore,1054,druid,restoration,12,11,1
2518,Вексиус,gordunni,1053,druid,restoration,18,11,7
2519,Тчаёк,gordunni,1052,druid,restoration,21,13,8
2520,Xenva,blackmoore,1052,druid,restoration,30,13,17
2521,Benjosef,blackmoore,1051,druid,restoration,62,31,31
2522,Dafapa,twilights-hammer,1049,druid,restoration,24,11,13
2523,Greengolly,argent-dawn,1042,druid,restoration,30,11,19
2524,Luarbak,kazzak,1041,druid,restoration,18,11,7
2525,Hashtagone,ysondre,1036,druid,restoration,23,11,12
2526,Mirana,drakthul,1032,druid,restoration,24,13,11
2527,Xadidruîd,blackrock,1030,druid,restoration,42,11,31
2528,Storpboom,drakthul,1028,druid,restoration,31,13,18
2529,Алунар,lich-king,1023,druid,restoration,54,22,32
2530,Raysien,doomhammer,1021,druid,restoration,24,13,11
2531,Shanikya,argent-dawn,1021,druid,restoration,44,20,24
2532,Bearinator,aggramar,1021,druid,restoration,33,15,18
2533,Tângo,eredar,1019,druid,restoration,25,12,13
2534,Wyngx,blackrock,1017,druid,restoration,18,11,7
2535,Cárnagè,stormscale,1017,druid,restoration,48,17,31
2536,Омгдру,gordunni,1016,druid,restoration,117,53,64
2537,Sertris,kazzak,1015,druid,restoration,31,11,20
2538,Hopê,burning-legion,1014,druid,restoration,30,21,9
2539,Wazam,kazzak,1013,druid,restoration,24,11,13
2540,Ninadobrev,ragnaros,1007,druid,restoration,21,12,9
2541,Feedbark,stormscale,1002,druid,restoration,23,13,10
2542,Saimdude,blackrock,1001,druid,restoration,24,11,13
2543,Эмканегодяйк,galakrond,994,druid,restoration,41,21,20
2544,Ellismera,argent-dawn,978,druid,restoration,36,17,19
2545,Davincidru,tarren-mill,978,druid,restoration,56,24,32
2546,Флиперкэт,howling-fjord,978,druid,restoration,30,11,19
2547,Bazilika,argent-dawn,977,druid,restoration,18,11,7
2548,Robutt,runetotem,976,druid,restoration,22,12,10
2549,Naruhot,archimonde,975,druid,restoration,19,11,8
2550,Spoco,defias-brotherhood,972,druid,restoration,78,40,38
2551,Nimèl,argent-dawn,966,druid,restoration,36,16,20
2552,Wegian,sylvanas,962,druid,restoration,63,36,27
2553,Джелони,soulflayer,960,druid,restoration,18,10,8
2554,Mutato,draenor,960,druid,restoration,80,38,42
2555,Amaré,burning-legion,960,druid,restoration,24,10,14
2556,Snedden,silvermoon,959,druid,restoration,30,15,15
2557,Siuo,ravencrest,959,druid,restoration,24,10,14
2558,Trúdl,das-konsortium,957,druid,restoration,12,10,2
2559,Çãm,magtheridon,957,druid,restoration,18,10,8
2560,Маминапуська,soulflayer,955,druid,restoration,18,10,8
2561,Inspiredrood,archimonde,954,druid,restoration,30,18,12
2562,Moonfetamine,silvermoon,954,druid,restoration,30,10,20
2563,Rabacki,blackmoore,953,druid,restoration,26,10,16
2564,Hót,ravencrest,952,druid,restoration,30,10,20
2565,Ubbeleg,kazzak,950,druid,restoration,18,10,8
2566,Thieane,blackhand,948,druid,restoration,18,10,8
2567,Merakir,dun-modr,948,druid,restoration,30,11,19
2568,Johndru,kazzak,948,druid,restoration,71,26,45
2569,Zarlaac,ravencrest,947,druid,restoration,18,10,8
2570,Thélon,antonidas,945,druid,restoration,69,35,34
2571,Corias,blackmoore,944,druid,restoration,36,10,26
2572,Cigamt,kazzak,943,druid,restoration,12,10,2
2573,Felfran,ravencrest,933,druid,restoration,30,10,20
2574,Krollix,dun-morogh,929,druid,restoration,47,25,22
2575,Maldrýn,stormscale,927,druid,restoration,17,10,7
2576,Buffspencer,ragnaros,927,druid,restoration,36,19,17
2577,Nachtelf,lightbringer,925,druid,restoration,63,21,42
2578,Missfar,doomhammer,923,druid,restoration,36,13,23
2579,Fubarmeep,outland,918,druid,restoration,36,18,18
2580,Shokazu,blackmoore,917,druid,restoration,64,29,35
2581,Yespapa,kazzak,913,druid,restoration,60,28,32
2582,Уэсериктх,blackscar,911,druid,restoration,15,10,5
2583,Chainbrake,sylvanas,911,druid,restoration,17,10,7
2584,Бехеровка,grom,910,druid,restoration,58,24,34
2585,Kárél,drakthul,906,druid,restoration,24,12,12
2586,Akifumi,archimonde,903,druid,restoration,35,11,24
2587,Jambonmaster,archimonde,899,druid,restoration,24,12,12
2588,Didi,frostwhisper,899,druid,restoration,30,11,19
2589,Celéry,silvermoon,896,druid,restoration,16,10,6
2590,Feanthur,drakthul,895,druid,restoration,130,65,65
2591,Фэйблуд,blackscar,894,druid,restoration,60,27,33
2592,Mw,dun-modr,893,druid,restoration,23,10,13
2593,Allod,stormscale,882,druid,restoration,41,18,23
2594,Do,alakir,876,druid,restoration,24,10,14
2595,Simouch,archimonde,871,druid,restoration,84,37,47
2596,Ratskrone,alleria,866,druid,restoration,60,27,33
2597,Uñsullied,kazzak,864,druid,restoration,12,9,3
2598,Panigale,dun-modr,864,druid,restoration,18,9,9
2599,Tjann,darksorrow,864,druid,restoration,18,9,9
2600,Viggez,outland,864,druid,restoration,18,9,9
2601,Лабирон,soulflayer,864,druid,restoration,24,9,15
2602,Pawful,malganis,863,druid,restoration,12,9,3
2603,Stonesight,argent-dawn,863,druid,restoration,12,9,3
2604,Shiftway,stormscale,863,druid,restoration,18,9,9
2605,Elviiradruid,tarren-mill,863,druid,restoration,18,9,9
2606,Macanbre,tarren-mill,863,druid,restoration,48,21,27
2607,Folzenqt,archimonde,863,druid,restoration,24,9,15
2608,Jikuni,ravencrest,862,druid,restoration,18,9,9
2609,Csmedruid,blackrock,862,druid,restoration,18,9,9
2610,Hideme,tarren-mill,861,druid,restoration,24,9,15
2611,Thardruid,stormscale,860,druid,restoration,18,9,9
2612,Sinthorasia,blackrock,858,druid,restoration,18,9,9
2613,Gandraste,neptulon,857,druid,restoration,12,9,3
2614,Relxc,outland,854,druid,restoration,12,9,3
2615,Happyhoter,blackrock,854,druid,restoration,24,9,15
2616,Chéchédroïd,marécage-de-zangar,854,druid,restoration,30,10,20
2617,Lunatrixs,dun-modr,852,druid,restoration,18,9,9
2618,Maxekaxe,sylvanas,852,druid,restoration,24,9,15
2619,Ovérheal,ravencrest,847,druid,restoration,17,9,8
2620,Chujogrzmot,kazzak,843,druid,restoration,23,9,14
2621,Houwalia,archimonde,840,druid,restoration,36,15,21
2622,Jagu,blackrock,839,druid,restoration,18,9,9
2623,Diastra,silvermoon,837,druid,restoration,19,10,9
2624,Triplej,twisting-nether,836,druid,restoration,18,9,9
2625,Wolfeiy,ravenholdt,835,druid,restoration,12,9,3
2626,Lyndruid,sylvanas,833,druid,restoration,72,27,45
2627,Robeala,twisting-nether,832,druid,restoration,42,17,25
2628,Найтед,gordunni,828,druid,restoration,16,10,6
2629,Nube,alonsus,826,druid,restoration,66,25,41
2630,Ruap,blackmoore,822,druid,restoration,20,10,10
2631,Metaboss,ravencrest,817,druid,restoration,71,24,47
2632,Zillo,stormscale,815,druid,restoration,26,10,16
2633,Spiralout,nemesis,805,druid,restoration,24,10,14
2634,Karlsn,ravencrest,797,druid,restoration,14,9,5
2635,Bidodici,nemesis,783,druid,restoration,135,57,78
2636,Buufu,kazzak,780,druid,restoration,19,9,10
2637,Skilloxus,gilneas,772,druid,restoration,51,17,34
2638,Dablol,draenor,768,druid,restoration,12,8,4
2639,Rînaa,ravencrest,768,druid,restoration,12,8,4
2640,Ecological,outland,768,druid,restoration,12,8,4
2641,Hotlotta,aegwynn,768,druid,restoration,12,8,4
2642,Zmira,outland,768,druid,restoration,18,8,10
2643,Muraebbasta,pozzo-delleternità,768,druid,restoration,24,8,16
2644,Kajiun,silvermoon,767,druid,restoration,12,8,4
2645,Alexialol,silvermoon,767,druid,restoration,12,8,4
2646,Elu,eredar,767,druid,restoration,12,8,4
2647,Brindefolie,archimonde,767,druid,restoration,18,8,10
2648,Exilia,kragjin,767,druid,restoration,18,8,10
2649,Bloompuf,draenor,767,druid,restoration,24,8,16
2650,Noxlunaire,ravencrest,766,druid,restoration,18,8,10
2651,Jehtrotull,nemesis,765,druid,restoration,14,8,6
2652,Crydotcom,aegwynn,765,druid,restoration,18,8,10
2653,Aolynk,twisting-nether,765,druid,restoration,18,8,10
2654,Memento,kazzak,765,druid,restoration,18,8,10
2655,Димитруа,howling-fjord,761,druid,restoration,18,8,10
2656,Mandy,spinebreaker,755,druid,restoration,18,8,10
2657,Caturday,terrordar,755,druid,restoration,24,9,15
2658,Jimmorris,eredar,754,druid,restoration,18,8,10
2659,Nargaí,kargath,753,druid,restoration,18,8,10
2660,Hootymactoot,magtheridon,752,druid,restoration,12,8,4
2661,Frostfox,ghostlands,741,druid,restoration,22,9,13
2662,Лордсенка,eversong,721,druid,restoration,18,8,10
2663,Catman,eredar,717,druid,restoration,15,9,6
2664,Nutzlos,azshara,706,druid,restoration,53,15,38
2665,Магараганага,azuregos,675,druid,restoration,25,8,17
2666,Dortalon,outland,672,druid,restoration,12,7,5
2667,Fanboij,kazzak,672,druid,restoration,12,7,5
2668,Luuxiå,archimonde,672,druid,restoration,12,7,5
2669,Jakeffsake,stormscale,672,druid,restoration,12,7,5
2670,Maiverdr,ravencrest,672,druid,restoration,12,7,5
2671,Plúx,antonidas,672,druid,restoration,12,7,5
2672,Dïsä,ravencrest,672,druid,restoration,12,7,5
2673,Icecöld,silvermoon,672,druid,restoration,12,7,5
2674,Monatamis,kazzak,672,druid,restoration,12,7,5
2675,Stevedru,ravencrest,672,druid,restoration,12,7,5
2676,Bntyx,dun-modr,672,druid,restoration,12,7,5
2677,Dartdogg,sanguino,672,druid,restoration,18,7,11
2678,Nozome,draenor,672,druid,restoration,18,7,11
2679,Smightydr,silvermoon,672,druid,restoration,18,7,11
2680,Buzzlîghtyea,outland,672,druid,restoration,18,7,11
2681,Juhudy,kazzak,672,druid,restoration,18,7,11
2682,Стомпбр,gordunni,672,druid,restoration,24,7,17
2683,Delviri,stormreaver,671,druid,restoration,12,7,5
2684,Badballance,outland,671,druid,restoration,12,7,5
2685,Pomdöner,echsenkessel,671,druid,restoration,12,7,5
2686,Lindémann,blackhand,671,druid,restoration,12,7,5
2687,Мамамышь,gordunni,671,druid,restoration,12,7,5
2688,Darktigrou,archimonde,671,druid,restoration,12,7,5
2689,Dablolo,ravencrest,671,druid,restoration,12,7,5
2690,Zkasnoname,archimonde,671,druid,restoration,18,7,11
2691,Basajáun,dun-modr,671,druid,restoration,18,7,11
2692,Euskal,chogall,671,druid,restoration,24,7,17
2693,Шеданна,gordunni,671,druid,restoration,24,7,17
2694,Ninø,gorgonnash,670,druid,restoration,12,7,5
2695,Buckxxz,nazjatar,670,druid,restoration,12,7,5
2696,Soný,aegwynn,670,druid,restoration,18,7,11
2697,Exane,ragnaros,667,druid,restoration,12,7,5
2698,Nøkki,draenor,667,druid,restoration,18,7,11
2699,Thaeldres,argent-dawn,667,druid,restoration,18,7,11
2700,Gribix,kazzak,666,druid,restoration,12,7,5
2701,Kaod,outland,666,druid,restoration,12,7,5
2702,Shenandoah,hyjal,666,druid,restoration,12,7,5
2703,Кишкинахир,razuvious,665,druid,restoration,12,7,5
2704,Dirtyhacks,blackmoore,664,druid,restoration,12,7,5
2705,Shaorma,ravencrest,661,druid,restoration,12,7,5
2706,Druiddamage,the-maelstrom,660,druid,restoration,18,7,11
2707,Сутулоерыгло,howling-fjord,658,druid,restoration,20,7,13
2708,Борзойрог,soulflayer,656,druid,restoration,18,7,11
2709,Deretus,blackmoore,640,druid,restoration,22,7,15
2710,Foaqi,aegwynn,639,druid,restoration,16,7,9
2711,Lutzmiller,eredar,637,druid,restoration,39,14,25
2712,Kùrámágødx,ravencrest,624,druid,restoration,17,7,10
2713,ßïgßúll,twisting-nether,614,druid,restoration,19,8,11
2714,Zerschmatzen,aegwynn,610,druid,restoration,28,9,19
2715,Heavysmoker,emeriss,607,druid,restoration,11,7,4
2716,Lorucka,die-nachtwache,607,druid,restoration,14,7,7
2717,Метафрея,gordunni,605,druid,restoration,11,7,4
2718,Medreas,argent-dawn,594,druid,restoration,16,7,9
2719,Ráw,dun-modr,592,druid,restoration,19,7,12
2720,Fknmad,burning-blade,576,druid,restoration,6,6,0
2721,Bakicadr,sylvanas,576,druid,restoration,6,6,0
2722,Draxedin,kazzak,576,druid,restoration,6,6,0
2723,Jnzymiau,blackrock,576,druid,restoration,10,7,3
2724,Telpha,onyxia,576,druid,restoration,12,6,6
2725,Jhiun,ragnaros,576,druid,restoration,12,6,6
2726,Yandris,argent-dawn,576,druid,restoration,12,6,6
2727,Rhonir,twisting-nether,576,druid,restoration,12,6,6
2728,Felisin,ravencrest,576,druid,restoration,12,6,6
2729,Cyriaan,eredar,576,druid,restoration,12,6,6
2730,Bloomitize,ravencrest,576,druid,restoration,12,6,6
2731,Jin,the-venture-co,576,druid,restoration,12,6,6
2732,Zaelithree,archimonde,576,druid,restoration,12,6,6
2733,Sálty,aegwynn,576,druid,restoration,12,6,6
2734,Vijaja,aegwynn,576,druid,restoration,12,6,6
2735,Foxyfeet,outland,576,druid,restoration,12,6,6
2736,Muraglia,pozzo-delleternità,576,druid,restoration,12,6,6
2737,Влажныйдру,soulflayer,576,druid,restoration,12,6,6
2738,Sakkosækk,ravencrest,576,druid,restoration,12,6,6
2739,Сладуляя,gordunni,576,druid,restoration,12,6,6
2740,Cplazi,kazzak,576,druid,restoration,12,6,6
2741,Афклалка,gordunni,576,druid,restoration,12,6,6
2742,Neverpanic,stormscale,576,druid,restoration,18,6,12
2743,Tjillevippen,tarren-mill,576,druid,restoration,18,6,12
2744,Pölkky,argent-dawn,576,druid,restoration,18,6,12
2745,Eluñeãdore,silvermoon,575,druid,restoration,6,6,0
2746,Ekaterina,dun-morogh,575,druid,restoration,12,6,6
2747,Лэвиш,blackscar,575,druid,restoration,12,6,6
2748,Geeorge,stormscale,575,druid,restoration,12,6,6
2749,Jinxaran,culte-de-la-rive-noire,575,druid,restoration,12,6,6
2750,Lucidor,frostmane,575,druid,restoration,12,6,6
2751,Afret,kazzak,575,druid,restoration,12,6,6
2752,Scarrymonsta,outland,575,druid,restoration,12,6,6
2753,Shylanna,ragnaros,575,druid,restoration,12,6,6
2754,Iamsocute,silvermoon,575,druid,restoration,12,6,6
2755,Avilary,tarren-mill,575,druid,restoration,18,6,12
2756,Telaroxx,die-nachtwache,575,druid,restoration,18,6,12
2757,Indann,kazzak,575,druid,restoration,18,6,12
2758,Mascraxx,earthen-ring,575,druid,restoration,18,6,12
2759,Storfjåset,stormscale,575,druid,restoration,18,6,12
2760,Pouletqt,archimonde,575,druid,restoration,18,6,12
2761,Digestivebis,defias-brotherhood,574,druid,restoration,6,6,0
2762,Semiflora,silvermoon,574,druid,restoration,12,6,6
2763,Mcneil,wrathbringer,574,druid,restoration,12,6,6
2764,Spritzer,tarren-mill,574,druid,restoration,12,6,6
2765,Tsihsel,ravencrest,574,druid,restoration,12,6,6
2766,Ruberg,kazzak,574,druid,restoration,12,6,6
2767,Goatmeal,draenor,574,druid,restoration,24,6,18
2768,Зервес,gordunni,574,druid,restoration,24,6,18
2769,Ковамедведь,borean-tundra,574,druid,restoration,24,6,18
2770,Лаегмерил,gordunni,573,druid,restoration,10,7,3
2771,Dfjguidfg,baelgun,573,druid,restoration,18,6,12
2772,Арбузир,howling-fjord,573,druid,restoration,24,6,18
2773,Ragdru,twisting-nether,573,druid,restoration,24,6,18
2774,Nøboorst,ravencrest,571,druid,restoration,12,6,6
2775,Vertymbras,hyjal,571,druid,restoration,12,6,6
2776,Bearshift,aggra-português,571,druid,restoration,18,6,12
2777,Pussn,twisting-nether,570,druid,restoration,18,6,12
2778,Malandrin,khazgoroth,568,druid,restoration,18,6,12
2779,Walkao,tarren-mill,566,druid,restoration,12,6,6
2780,Vlookup,tarren-mill,543,druid,restoration,17,6,11
2781,Siahra,khaz-modan,534,druid,restoration,48,6,42
2782,Quorn,pozzo-delleternità,527,druid,restoration,13,7,6
2783,Piñaclo,archimonde,480,druid,restoration,6,5,1
2784,Мегабамбук,soulflayer,480,druid,restoration,6,5,1
2785,Mykk,ravencrest,480,druid,restoration,6,5,1
2786,Utopiah,ravencrest,480,druid,restoration,6,5,1
2787,Devastras,ravencrest,480,druid,restoration,12,5,7
2788,Loleh,ragnaros,480,druid,restoration,12,5,7
2789,Slimp,the-maelstrom,480,druid,restoration,12,5,7
2790,Marmotini,the-maelstrom,480,druid,restoration,12,5,7
2791,Epicskin,kazzak,480,druid,restoration,12,5,7
2792,Druidicchi,stormscale,480,druid,restoration,12,5,7
2793,Napsta,sylvanas,480,druid,restoration,12,5,7
2794,Místergreen,ravencrest,480,druid,restoration,12,5,7
2795,Kvalitet,outland,480,druid,restoration,12,5,7
2796,Crysís,sanguino,480,druid,restoration,12,5,7
2797,Nightmoon,hellscream,480,druid,restoration,12,5,7
2798,Asude,outland,480,druid,restoration,12,5,7
2799,Jenovas,argent-dawn,480,druid,restoration,12,5,7
2800,Horstyolo,blackrock,480,druid,restoration,12,5,7
2801,Holybarkz,aegwynn,480,druid,restoration,12,5,7
2802,Solàryx,hyjal,480,druid,restoration,12,5,7
2803,Helløkittyßß,dun-modr,480,druid,restoration,12,5,7
2804,Ванечка,razuvious,480,druid,restoration,18,5,13
2805,Yseraheal,drakthul,480,druid,restoration,18,5,13
2806,Kætachy,archimonde,480,druid,restoration,18,5,13
2807,Kezbaniye,silvermoon,479,druid,restoration,6,5,1
2808,Tanariel,ravencrest,479,druid,restoration,12,5,7
2809,Ballosh,hyjal,479,druid,restoration,12,5,7
2810,Nissemand,ravencrest,479,druid,restoration,12,5,7
2811,Bhorumir,colinas-pardas,479,druid,restoration,12,5,7
2812,Epidruid,stormrage,479,druid,restoration,12,5,7
2813,Delphina,dun-modr,479,druid,restoration,12,5,7
2814,Reiss,tarren-mill,479,druid,restoration,12,5,7
2815,Quiksx,blackrock,479,druid,restoration,13,5,8
2816,Whiskers,emerald-dream,479,druid,restoration,16,6,10
2817,Drix,frostwolf,479,druid,restoration,15,5,10
2818,Jemyd,aegwynn,479,druid,restoration,24,5,19
2819,Hubek,silvermoon,478,druid,restoration,6,5,1
2820,Herbiko,turalyon,478,druid,restoration,12,5,7
2821,Kroshka,sylvanas,478,druid,restoration,12,5,7
2822,Droodfist,khaz-modan,477,druid,restoration,6,5,1
2823,Sýrês,malganis,475,druid,restoration,12,5,7
2824,Prowlinger,silvermoon,473,druid,restoration,12,5,7
2825,Druidicmorr,sylvanas,447,druid,restoration,10,5,5
2826,Joksica,draenor,447,druid,restoration,11,5,6
2827,Oyoyo,kaelthas,446,druid,restoration,8,6,2
2828,Ambracer,silvermoon,444,druid,restoration,8,6,2
2829,Driiptoohard,turalyon,444,druid,restoration,16,5,11
2830,Исмалат,howling-fjord,429,druid,restoration,11,5,6
2831,Domsz,dalaran,428,druid,restoration,15,5,10
2832,Bartoluca,twisting-nether,393,druid,restoration,28,6,22
2833,Марголав,gordunni,384,druid,restoration,6,4,2
2834,Greenberry,eonar,384,druid,restoration,6,4,2
2835,Izhusky,ravencrest,384,druid,restoration,6,4,2
2836,Yazari,nathrezim,384,druid,restoration,6,4,2
2837,Yunalaa,blackmoore,384,druid,restoration,6,4,2
2838,Sensisdruid,blackmoore,384,druid,restoration,6,4,2
2839,Zeroclones,the-maelstrom,384,druid,restoration,6,4,2
2840,Thatzdmg,blackmoore,384,druid,restoration,6,4,2
2841,Kattbjörnen,ragnaros,384,druid,restoration,6,4,2
2842,Zagrem,antonidas,384,druid,restoration,6,4,2
2843,Béccàbtw,draenor,384,druid,restoration,6,4,2
2844,Нагетсмяу,howling-fjord,384,druid,restoration,6,4,2
2845,Цукерище,gordunni,384,druid,restoration,6,4,2
2846,Darkyblood,archimonde,384,druid,restoration,6,4,2
2847,Jellyxdd,silvermoon,384,druid,restoration,6,4,2
2848,Koala,temple-noir,384,druid,restoration,6,4,2
2849,Xandersito,sanguino,384,druid,restoration,6,4,2
2850,Vioboomie,blackrock,384,druid,restoration,6,4,2
2851,Kyssope,chants-éternels,384,druid,restoration,6,4,2
2852,Zonsy,twisting-nether,384,druid,restoration,6,4,2
2853,Naphé,ysondre,384,druid,restoration,6,4,2
2854,Bigborst,ravencrest,384,druid,restoration,6,4,2
2855,Leyô,archimonde,384,druid,restoration,6,4,2
2856,Stinka,ravencrest,384,druid,restoration,6,4,2
2857,Mistgone,hyjal,384,druid,restoration,6,4,2
2858,Josedudu,twisting-nether,384,druid,restoration,12,4,8
2859,Neverfall,aegwynn,384,druid,restoration,12,4,8
2860,Crìmz,aszune,384,druid,restoration,12,4,8
2861,Meowu,twisting-nether,384,druid,restoration,12,4,8
2862,Xanxiety,outland,384,druid,restoration,12,4,8
2863,Irrlycht,blackrock,384,druid,restoration,12,4,8
2864,Ravenfel,argent-dawn,384,druid,restoration,12,4,8
2865,Eaglefox,aszune,384,druid,restoration,12,4,8
2866,Celtimi,antonidas,384,druid,restoration,12,4,8
2867,Àlec,silvermoon,384,druid,restoration,12,4,8
2868,Druncha,sunstrider,384,druid,restoration,12,4,8
2869,Wagoneis,grim-batol,384,druid,restoration,12,4,8
2870,Plantpuzzl,silvermoon,384,druid,restoration,12,4,8
2871,Murlwywy,blackmoore,384,druid,restoration,12,4,8
2872,Holybarkzqt,aegwynn,384,druid,restoration,12,4,8
2873,Biglet,tarren-mill,384,druid,restoration,12,4,8
2874,Davorian,frostmane,384,druid,restoration,12,4,8
2875,Bulldócer,sanguino,384,druid,restoration,12,4,8
2876,Найадра,gordunni,384,druid,restoration,12,4,8
2877,Kobra,twilights-hammer,384,druid,restoration,12,4,8
2878,Litany,drakthul,384,druid,restoration,13,4,9
2879,Hrz,kazzak,384,druid,restoration,18,4,14
2880,Jabbah,defias-brotherhood,383,druid,restoration,6,4,2
2881,Erdnuckèl,antonidas,383,druid,restoration,6,4,2
2882,Boomayé,archimonde,383,druid,restoration,6,4,2
2883,Xidenn,quelthalas,383,druid,restoration,12,4,8
2884,Opla,nethersturm,383,druid,restoration,12,4,8
2885,Прожималодру,deathguard,383,druid,restoration,12,4,8
2886,Semenisback,archimonde,383,druid,restoration,12,4,8
2887,Bepanten,azshara,383,druid,restoration,12,4,8
2888,Mimisiek,burning-legion,383,druid,restoration,12,4,8
2889,Itê,dun-morogh,383,druid,restoration,18,4,14
2890,Шикалат,howling-fjord,383,druid,restoration,24,4,20
2891,Xele,destromath,382,druid,restoration,6,4,2
2892,Loumpa,hyjal,382,druid,restoration,6,4,2
2893,Mongetout,ravencrest,382,druid,restoration,6,4,2
2894,Nali,arthas,382,druid,restoration,6,4,2
2895,Karochi,kazzak,382,druid,restoration,6,4,2
2896,Muju,stormscale,382,druid,restoration,12,4,8
2897,Roséa,ravencrest,382,druid,restoration,12,4,8
2898,Pega,nazjatar,382,druid,restoration,12,4,8
2899,Voodoodrood,draenor,382,druid,restoration,24,4,20
2900,Amalou,ravencrest,381,druid,restoration,12,4,8
2901,Djclonex,archimonde,381,druid,restoration,12,4,8
2902,Tranquillo,outland,379,druid,restoration,12,4,8
2903,Pudseytree,doomhammer,379,druid,restoration,12,4,8
2904,Blolzz,silvermoon,377,druid,restoration,18,4,14
2905,Demerit,defias-brotherhood,351,druid,restoration,11,4,7
2906,Nøbødy,silvermoon,351,druid,restoration,11,4,7
2907,Biegel,ysera,351,druid,restoration,11,4,7
2908,Lyvaley,dun-modr,350,druid,restoration,16,4,12
2909,Orgazmo,archimonde,335,druid,restoration,11,4,7
2910,ßlackßåmßå,zuljin,288,druid,restoration,6,3,3
2911,Faustîno,dun-modr,288,druid,restoration,6,3,3
2912,Microw,ghostlands,288,druid,restoration,6,3,3
2913,Néøu,archimonde,288,druid,restoration,6,3,3
2914,Panørax,archimonde,288,druid,restoration,6,3,3
2915,Lèafy,silvermoon,288,druid,restoration,6,3,3
2916,Тое,soulflayer,288,druid,restoration,6,3,3
2917,Madmanul,draenor,288,druid,restoration,6,3,3
2918,Kokanine,ravencrest,288,druid,restoration,6,3,3
2919,Ånåphorå,archimonde,288,druid,restoration,6,3,3
2920,Tropjeune,dalaran,288,druid,restoration,6,3,3
2921,Drozzie,twisting-nether,288,druid,restoration,6,3,3
2922,Zaethul,draenor,288,druid,restoration,6,3,3
2923,Moonbloom,defias-brotherhood,288,druid,restoration,6,3,3
2924,Сайнтификх,gordunni,288,druid,restoration,6,3,3
2925,Mnine,twisting-nether,288,druid,restoration,6,3,3
2926,Miyá,sylvanas,288,druid,restoration,6,3,3
2927,Brosephiné,stormscale,288,druid,restoration,6,3,3
2928,Inspira,teldrassil,288,druid,restoration,6,3,3
2929,Lolaven,turalyon,288,druid,restoration,6,3,3
2930,Фонш,soulflayer,288,druid,restoration,6,3,3
2931,Solutionx,aegwynn,288,druid,restoration,6,3,3
2932,Танганэку,howling-fjord,288,druid,restoration,6,3,3
2933,Wurzeldor,ravencrest,288,druid,restoration,6,3,3
2934,Friyiee,stormscale,288,druid,restoration,6,3,3
2935,Troc,karazhan,288,druid,restoration,6,3,3
2936,Magiskeforme,draenor,288,druid,restoration,6,3,3
2937,Owldschool,blackmoore,288,druid,restoration,6,3,3
2938,Ravnac,aegwynn,288,druid,restoration,6,3,3
2939,Surfingbirdx,ragnaros,288,druid,restoration,6,3,3
2940,Noobr,ravencrest,288,druid,restoration,6,3,3
2941,Restaidpvs,wildhammer,288,druid,restoration,6,3,3
2942,Vaacku,stormreaver,288,druid,restoration,6,3,3
2943,Jebaitor,tarren-mill,288,druid,restoration,6,3,3
2944,Hanibalector,silvermoon,288,druid,restoration,6,3,3
2945,Tarshish,outland,288,druid,restoration,6,3,3
2946,Juhato,outland,288,druid,restoration,6,3,3
2947,Milknosugar,tarren-mill,288,druid,restoration,6,3,3
2948,Shyni,outland,288,druid,restoration,6,3,3
2949,Ipsdray,ysondre,288,druid,restoration,6,3,3
2950,Thugzie,kazzak,288,druid,restoration,6,3,3
2951,Norkenis,neptulon,288,druid,restoration,6,3,3
2952,Derie,nazjatar,288,druid,restoration,6,3,3
2953,Göli,argent-dawn,288,druid,restoration,6,3,3
2954,Qwopeiqpwoid,kazzak,288,druid,restoration,6,3,3
2955,Nohos,blackrock,288,druid,restoration,6,3,3
2956,Druni,blackrock,288,druid,restoration,6,3,3
2957,Clownrad,tarren-mill,288,druid,restoration,6,3,3
2958,Sygko,kazzak,288,druid,restoration,6,3,3
2959,Skuhlxz,thrall,288,druid,restoration,6,3,3
2960,Rumbus,sanguino,288,druid,restoration,7,3,4
2961,Piñaclonada,archimonde,288,druid,restoration,9,3,6
2962,Smarticle,aegwynn,288,druid,restoration,11,3,8
2963,Draawun,burning-legion,288,druid,restoration,11,3,8
2964,Rawillinen,kazzak,288,druid,restoration,12,3,9
2965,Ahuevshiy,wildhammer,288,druid,restoration,12,3,9
2966,Marryat,argent-dawn,288,druid,restoration,12,3,9
2967,Bigbones,frostwolf,288,druid,restoration,12,3,9
2968,Shiotake,hyjal,288,druid,restoration,12,3,9
2969,Ezils,silvermoon,288,druid,restoration,12,3,9
2970,Coínlíp,drakthul,288,druid,restoration,12,3,9
2971,Restodruidx,ravencrest,288,druid,restoration,12,3,9
2972,Amstaffio,blackhand,288,druid,restoration,12,3,9
2973,Nostigon,azshara,288,druid,restoration,12,3,9
2974,Areidhel,pozzo-delleternità,288,druid,restoration,12,3,9
2975,Teah,darkmoon-faire,288,druid,restoration,12,3,9
2976,Храмульчик,blackscar,288,druid,restoration,12,3,9
2977,Soratess,azshara,288,druid,restoration,12,3,9
2978,Yøungreidzz,blackrock,288,druid,restoration,18,3,15
2979,Kuokkanen,azuremyst,287,druid,restoration,6,3,3
2980,Lundx,ravencrest,287,druid,restoration,6,3,3
2981,Boompjeh,chamber-of-aspects,287,druid,restoration,6,3,3
2982,Krizak,eredar,287,druid,restoration,6,3,3
2983,Taskingoman,twisting-nether,287,druid,restoration,6,3,3
2984,Аматэррасу,blackscar,287,druid,restoration,6,3,3
2985,Papalegba,kilrogg,287,druid,restoration,12,3,9
2986,Wildblu,nemesis,287,druid,restoration,12,3,9
2987,Seabath,kirin-tor,287,druid,restoration,12,3,9
2988,Xulian,exodar,287,druid,restoration,12,3,9
2989,Paniel,amanthul,286,druid,restoration,6,3,3
2990,Gladyon,ravencrest,285,druid,restoration,12,3,9
2991,Elônea,antonidas,285,druid,restoration,12,3,9
2992,Lexopewpew,ravencrest,256,druid,restoration,16,3,13
2993,Bunga,quelthalas,255,druid,restoration,11,3,8
2994,Duduque,twisting-nether,255,druid,restoration,11,3,8
2995,Mayte,ragnaros,239,druid,restoration,5,3,2
2996,Потнаякиса,grom,239,druid,restoration,5,3,2
2997,Amélor,ragnaros,239,druid,restoration,5,3,2
2998,Thornat,chamber-of-aspects,239,druid,restoration,5,3,2
2999,Ccmydcv,archimonde,234,druid,restoration,13,4,9
3000,Beerplusbeer,kazzak,234,druid,restoration,23,6,17
3001,Conn,ravencrest,192,druid,restoration,6,2,4
3002,Шокоокулист,gordunni,192,druid,restoration,6,2,4
3003,Solern,ravencrest,192,druid,restoration,6,2,4
3004,Chrisdruid,argent-dawn,192,druid,restoration,6,2,4
3005,Traffix,outland,192,druid,restoration,6,2,4
3006,Jugaia,frostmourne,192,druid,restoration,6,2,4
3007,Raila,pozzo-delleternità,192,druid,restoration,6,2,4
3008,Nooz,thrall,192,druid,restoration,6,2,4
3009,Vinniehacker,archimonde,192,druid,restoration,6,2,4
3010,Sartipus,draenor,192,druid,restoration,6,2,4
3011,Yesco,malganis,192,druid,restoration,6,2,4
3012,Jaytiz,ravencrest,192,druid,restoration,6,2,4
3013,Kkona,silvermoon,192,druid,restoration,6,2,4
3014,Skraks,ysondre,192,druid,restoration,6,2,4
3015,Midrialis,sinstralis,192,druid,restoration,6,2,4
3016,Skavenlol,zuljin,192,druid,restoration,6,2,4
3017,Champaa,aggra-português,192,druid,restoration,6,2,4
3018,Drukae,stormscale,192,druid,restoration,6,2,4
3019,Restoboi,stormscale,192,druid,restoration,6,2,4
3020,Pinkpanda,arthas,192,druid,restoration,6,2,4
3021,Moodee,kazzak,192,druid,restoration,6,2,4
3022,Mchøt,ravencrest,192,druid,restoration,6,2,4
3023,Атитока,goldrinn,192,druid,restoration,6,2,4
3024,Lyricx,kazzak,192,druid,restoration,6,2,4
3025,Shaggí,draenor,192,druid,restoration,6,2,4
3026,Príimé,kazzak,192,druid,restoration,6,2,4
3027,Milkmepls,balnazzar,192,druid,restoration,6,2,4
3028,Higuys,the-maelstrom,192,druid,restoration,6,2,4
3029,Wannabanhere,outland,192,druid,restoration,6,2,4
3030,Layzz,archimonde,192,druid,restoration,6,2,4
3031,Fanso,burning-legion,192,druid,restoration,6,2,4
3032,Drúídárn,talnivarr,192,druid,restoration,6,2,4
3033,Huebbi,blackmoore,192,druid,restoration,6,2,4
3034,Benjiee,kazzak,192,druid,restoration,6,2,4
3035,Nakkikastike,magtheridon,192,druid,restoration,12,2,10
3036,Maceyx,ravencrest,192,druid,restoration,12,2,10
3037,Элеарсия,gordunni,192,druid,restoration,12,2,10
3038,Imperador,tyrande,192,druid,restoration,12,2,10
3039,Drâcâ,antonidas,192,druid,restoration,12,2,10
3040,Салона,deathguard,192,druid,restoration,12,2,10
3041,Rakuy,thrall,192,druid,restoration,12,2,10
3042,Spaartaa,blackhand,192,druid,restoration,12,2,10
3043,Vertabrain,twilights-hammer,192,druid,restoration,12,2,10
3044,Lisovamavka,draenor,192,druid,restoration,12,2,10
3045,Охломон,gordunni,192,druid,restoration,24,2,22
3046,Дела,eversong,191,druid,restoration,6,2,4
3047,Siyoo,thrall,191,druid,restoration,6,2,4
3048,Martinesämst,outland,138,druid,restoration,6,3,3
3049,Watchmymoon,blackrock,138,druid,restoration,10,3,7
3050,Ihatewhales,ravencrest,128,druid,restoration,4,2,2
3051,Xneji,sylvanas,111,druid,restoration,13,2,11
3052,Ka,the-maelstrom,96,druid,restoration,6,1,5
3053,Sozu,magtheridon,96,druid,restoration,6,1,5
3054,Winstonka,doomhammer,96,druid,restoration,6,1,5
3055,Nuwell,arathor,96,druid,restoration,6,1,5
3056,Gintoni,dun-modr,96,druid,restoration,6,1,5
3057,Taicoo,outland,96,druid,restoration,6,1,5
3058,Tilikum,stormscale,96,druid,restoration,6,1,5
3059,Qdrood,quelthalas,96,druid,restoration,6,1,5
3060,Тианна,razuvious,96,druid,restoration,6,1,5
3061,Sylindra,argent-dawn,96,druid,restoration,6,1,5
3062,Мунпраид,gordunni,96,druid,restoration,6,1,5
3063,Nediena,twisting-nether,96,druid,restoration,6,1,5
3064,Seekíng,blackmoore,96,druid,restoration,6,1,5
3065,Uuni,sylvanas,96,druid,restoration,6,1,5
3066,Naturaven,sylvanas,96,druid,restoration,6,1,5
3067,Druvian,argent-dawn,96,druid,restoration,6,1,5
3068,Haginator,twisting-nether,96,druid,restoration,6,1,5
3069,Baawz,blackmoore,96,druid,restoration,6,1,5
3070,Fotmrerollér,darksorrow,96,druid,restoration,6,1,5
3071,Kisyqt,aegwynn,96,druid,restoration,6,1,5
3072,Thaïs,blackmoore,96,druid,restoration,6,1,5
3073,Teengirl,blackmoore,96,druid,restoration,6,1,5
3074,Kerydwen,silvermoon,96,druid,restoration,6,1,5
3075,Blanoz,ravencrest,96,druid,restoration,6,1,5
3076,Marynlord,dalaran,96,druid,restoration,6,1,5
3077,Lyj,dalaran,96,druid,restoration,6,1,5
3078,Nuggetspøwa,dalaran,96,druid,restoration,6,1,5
3079,Druidguden,tarren-mill,96,druid,restoration,6,1,5
3080,Søfiaa,argent-dawn,96,druid,restoration,6,1,5
3081,Linkin,azshara,96,druid,restoration,6,1,5
3082,Nermax,kazzak,96,druid,restoration,6,1,5
3083,Tshungubuäch,eredar,96,druid,restoration,6,1,5
3084,Tranduiil,drakthul,96,druid,restoration,6,1,5
3085,Cowárd,blackmoore,96,druid,restoration,6,1,5
3086,Elo,dun-morogh,96,druid,restoration,6,1,5
3087,Effi,aggramar,96,druid,restoration,6,1,5
3088,Meisterd,aegwynn,96,druid,restoration,6,1,5
3089,Secô,sylvanas,96,druid,restoration,6,1,5
3090,Hotundwech,blackrock,96,druid,restoration,6,1,5
3091,Baraforet,archimonde,96,druid,restoration,6,1,5
3092,Xilmai,darksorrow,96,druid,restoration,12,1,11
3093,Tokifong,kazzak,96,druid,restoration,12,1,11
3094,Athenex,azshara,96,druid,restoration,12,1,11
3095,Püpply,antonidas,96,druid,restoration,12,1,11
3096,Dreäms,ravencrest,95,druid,restoration,6,1,5
3097,Pobrica,stormscale,79,druid,restoration,5,1,4
3098,Сугрик,deathweaver,64,druid,restoration,10,1,9
3099,Rasserdruid,runetotem,63,druid,restoration,2,2,0
3100,Quizdarude,draenor,42,druid,restoration,10,3,7
3101,Eceria,the-maelstrom,42,druid,restoration,9,2,7
3102,Acidbrate,aegwynn,42,druid,restoration,9,2,7
3103,Noxann,archimonde,42,druid,restoration,10,2,8
3104,Onacor,stormrage,42,druid,restoration,10,2,8
3105,Uniquz,sylvanas,42,druid,restoration,11,2,9
3106,Vanarea,argent-dawn,42,druid,restoration,14,2,12
3107,Essya,earthen-ring,16,druid,restoration,1,1,0
3108,Djemdruid,argent-dawn,1585,druid,guardian,42,18,24
3109,Bulleyo,ysondre,1508,druid,guardian,41,22,19
3110,Windythemilf,stormscale,1364,druid,guardian,134,72,62
3111,Rbgbear,blackhand,1156,druid,guardian,36,15,21
3112,Rapatera,argent-dawn,1115,druid,guardian,24,12,12
3113,Микайо,goldrinn,986,druid,guardian,41,17,24
3114,Lioky,dun-modr,670,druid,guardian,12,7,5
3115,Critter,kargath,572,druid,guardian,18,6,12
3116,Crazydudu,tarren-mill,550,druid,guardian,27,8,19
3117,Bigdomas,sylvanas,532,druid,guardian,16,6,10
3118,Tigerbear,argent-dawn,384,druid,guardian,12,4,8
3119,Avisa,blackhand,378,druid,guardian,12,4,8
3120,Horizonline,terokkar,350,druid,guardian,11,4,7
3121,Sároman,ravencrest,192,druid,guardian,6,2,4
3122,Astralcore,stormscale,192,druid,guardian,6,2,4
3123,Nwal,thunderhorn,192,druid,guardian,6,2,4
3124,Kárrde,balnazzar,192,druid,guardian,6,2,4
3125,Zinister,hyjal,192,druid,guardian,6,2,4
3126,Fynvola,anubarak,192,druid,guardian,12,2,10
3127,Avior,eonar,192,druid,guardian,13,2,11
3128,Pure,kul-tiras,190,druid,guardian,15,3,12
3129,Oõ,aggra-português,96,druid,guardian,6,1,5
3130,Twinklex,ravencrest,2211,druid,feral,94,48,46
3131,Xercas,outland,2166,druid,feral,65,39,26
3132,Cataferal,ravencrest,2133,druid,feral,102,56,46
3133,Desenlace,ravencrest,2127,druid,feral,149,82,67
3134,Zøte,ravencrest,2083,druid,feral,84,43,41
3135,Bloodyredlyx,ysera,2073,druid,feral,78,42,36
3136,Jakamx,ravencrest,2072,druid,feral,150,79,71
3137,Ktx,aegwynn,2067,druid,feral,66,40,26
3138,Crøwnd,twisting-nether,2056,druid,feral,54,34,20
3139,Dashfull,ravencrest,2042,druid,feral,137,77,60
3140,Iminz,ravencrest,2032,druid,feral,161,78,83
3141,Rapatera,argent-dawn,2019,druid,feral,54,30,24
3142,Lxve,tarren-mill,1999,druid,feral,60,31,29
3143,Trøüpäx,outland,1994,druid,feral,84,43,41
3144,Råñkønêbëår,ravencrest,1982,druid,feral,60,36,24
3145,Öøöøöøöøöøöø,anachronos,1963,druid,feral,30,24,6
3146,Ромкабикстар,gordunni,1952,druid,feral,60,30,30
3147,Tomyn,burning-legion,1928,druid,feral,60,36,24
3148,Djgírlßøssqt,argent-dawn,1924,druid,feral,60,31,29
3149,Cløwnferalx,argent-dawn,1921,druid,feral,54,25,29
3150,Yone,blackmoore,1918,druid,feral,60,33,27
3151,Taladruide,archimonde,1897,druid,feral,60,30,30
3152,Норланда,gordunni,1884,druid,feral,60,32,28
3153,Brutaldamage,ravencrest,1873,druid,feral,54,28,26
3154,Purgatxry,ravencrest,1873,druid,feral,239,118,121
3155,Symbiosa,silvermoon,1870,druid,feral,30,20,10
3156,Nîîght,ravencrest,1852,druid,feral,48,23,25
3157,Annksunamún,ysondre,1851,druid,feral,141,84,57
3158,Minaervea,antonidas,1846,druid,feral,72,33,39
3159,Kattenvoer,stormscale,1842,druid,feral,36,27,9
3160,Skatch,sylvanas,1836,druid,feral,54,28,26
3161,Tilikum,stormscale,1834,druid,feral,251,127,124
3162,Houmrx,ravencrest,1830,druid,feral,36,23,13
3163,Февти,gordunni,1828,druid,feral,59,34,25
3164,Drbeef,sanguino,1823,druid,feral,45,28,17
3165,Zelaron,twisting-nether,1823,druid,feral,42,22,20
3166,Фейкхехе,gordunni,1822,druid,feral,48,27,21
3167,Kroñm,dun-modr,1818,druid,feral,60,25,35
3168,Uebiwe,silvermoon,1817,druid,feral,54,31,23
3169,Nøfåmïly,silvermoon,1814,druid,feral,160,83,77
3170,Mortality,proudmoore,1812,druid,feral,65,31,34
3171,Nfxdruid,argent-dawn,1810,druid,feral,90,54,36
3172,Jarethy,dun-modr,1808,druid,feral,78,37,41
3173,Jhiun,ragnaros,1806,druid,feral,72,40,32
3174,Cåssidy,archimonde,1805,druid,feral,60,26,34
3175,Bigangrycatx,ravencrest,1803,druid,feral,62,26,36
3176,Ratsimulator,tarren-mill,1802,druid,feral,54,32,22
3177,Skytek,silvermoon,1802,druid,feral,84,41,43
3178,Мелталиора,soulflayer,1800,druid,feral,59,30,29
3179,Опакот,howling-fjord,1799,druid,feral,56,25,31
3180,Djmeowxd,blackrock,1784,druid,feral,66,30,36
3181,Catkovic,kult-der-verdammten,1777,druid,feral,47,24,23
3182,Jabbari,outland,1775,druid,feral,101,56,45
3183,Pilaf,emerald-dream,1758,druid,feral,97,46,51
3184,Mykk,ravencrest,1755,druid,feral,39,27,12
3185,Desenlace,silvermoon,1754,druid,feral,48,23,25
3186,Mabkferal,ravencrest,1750,druid,feral,44,25,19
3187,Mmlprox,burning-legion,1747,druid,feral,49,27,22
3188,Kikihoux,ravencrest,1747,druid,feral,41,22,19
3189,Alexmeow,ravencrest,1739,druid,feral,36,24,12
3190,Moldrokk,ravencrest,1739,druid,feral,52,31,21
3191,Apuasaatana,stormreaver,1731,druid,feral,36,20,16
3192,Jukeboks,silvermoon,1726,druid,feral,55,25,30
3193,Mutaattori,sylvanas,1720,druid,feral,37,18,19
3194,Goodtrip,archimonde,1719,druid,feral,62,32,30
3195,Yesbody,tarren-mill,1718,druid,feral,36,18,18
3196,Shiftydruid,thunderhorn,1718,druid,feral,134,63,71
3197,Trauller,outland,1712,druid,feral,48,21,27
3198,Jasperqt,silvermoon,1706,druid,feral,30,18,12
3199,Nouin,twisting-nether,1705,druid,feral,60,29,31
3200,Elîas,kazzak,1699,druid,feral,36,23,13
3201,Adabsurdum,kazzak,1688,druid,feral,118,53,65
3202,Блюгилли,ashenvale,1687,druid,feral,56,21,35
3203,Tangela,stormreaver,1684,druid,feral,24,18,6
3204,Feralwilder,turalyon,1677,druid,feral,111,46,65
3205,Трэвисдог,gordunni,1673,druid,feral,35,18,17
3206,Freyanah,argent-dawn,1673,druid,feral,90,38,52
3207,Ðrüid,ravencrest,1668,druid,feral,72,34,38
3208,Jgltrainer,archimonde,1666,druid,feral,53,31,22
3209,Silksharp,ravencrest,1663,druid,feral,60,31,29
3210,Bernfried,silvermoon,1661,druid,feral,58,25,33
3211,ßgøðx,argent-dawn,1660,druid,feral,57,33,24
3212,Triluxa,blackmoore,1659,druid,feral,48,25,23
3213,Unoseeme,outland,1655,druid,feral,66,29,37
3214,Opresse,archimonde,1655,druid,feral,54,23,31
3215,Phenova,sargeras,1652,druid,feral,83,32,51
3216,Yongala,archimonde,1650,druid,feral,48,29,19
3217,Degmond,silvermoon,1646,druid,feral,42,21,21
3218,Simdruid,stormscale,1641,druid,feral,36,19,17
3219,Mysticalmoon,ravencrest,1639,druid,feral,48,21,27
3220,Bulan,ghostlands,1638,druid,feral,66,41,25
3221,Ñøpe,ravencrest,1630,druid,feral,30,17,13
3222,Jellytardx,outland,1628,druid,feral,66,35,31
3223,Fyrkax,aegwynn,1626,druid,feral,30,17,13
3224,Boostedbear,ragnaros,1622,druid,feral,36,17,19
3225,Dzandel,silvermoon,1619,druid,feral,282,135,147
3226,Skypinho,blackhand,1616,druid,feral,48,22,26
3227,Indann,kazzak,1614,druid,feral,42,17,25
3228,Alessathrina,argent-dawn,1611,druid,feral,42,20,22
3229,Khunahype,thrall,1610,druid,feral,24,17,7
3230,Zaibastus,doomhammer,1610,druid,feral,54,21,33
3231,Elfsu,ravencrest,1609,druid,feral,36,21,15
3232,Banzeye,nordrassil,1607,druid,feral,68,35,33
3233,Bigpapad,ravencrest,1605,druid,feral,36,19,17
3234,Evilshade,ravencrest,1604,druid,feral,115,47,68
3235,Акиша,deepholm,1602,druid,feral,44,21,23
3236,Asçdruid,kazzak,1602,druid,feral,50,22,28
3237,Kouda,draenor,1601,druid,feral,46,19,27
3238,Rbgbot,ragnaros,1583,druid,feral,30,17,13
3239,Narunis,tarren-mill,1583,druid,feral,72,33,39
3240,Natakis,blades-edge,1582,druid,feral,36,19,17
3241,Vëgâñgøðx,ragnaros,1581,druid,feral,36,22,14
3242,Reward,ragnaros,1562,druid,feral,34,17,17
3243,Риама,blackscar,1558,druid,feral,78,38,40
3244,Зонкс,gordunni,1557,druid,feral,82,44,38
3245,Drylle,argent-dawn,1555,druid,feral,87,47,40
3246,Smuktøs,twisting-nether,1546,druid,feral,35,22,13
3247,Shyngodx,archimonde,1533,druid,feral,41,17,24
3248,Maccín,draenor,1530,druid,feral,52,18,34
3249,Stopwatching,outland,1524,druid,feral,36,16,20
3250,Оудин,blackscar,1521,druid,feral,47,23,24
3251,Муумуумуу,howling-fjord,1512,druid,feral,108,49,59
3252,Rami,sylvanas,1512,druid,feral,60,25,35
3253,Fückøff,ravencrest,1510,druid,feral,30,16,14
3254,Rollozuu,blackrock,1507,druid,feral,90,44,46
3255,Мунпраид,gordunni,1506,druid,feral,60,29,31
3256,Jerrybeans,ravencrest,1504,druid,feral,120,57,63
3257,Avanah,silvermoon,1495,druid,feral,42,17,25
3258,Sabertoon,argent-dawn,1490,druid,feral,101,44,57
3259,Oleander,zuljin,1479,druid,feral,113,56,57
3260,Clipsy,twilights-hammer,1469,druid,feral,125,60,65
3261,Extracssion,ysondre,1468,druid,feral,44,17,27
3262,Arlina,magtheridon,1454,druid,feral,57,26,31
3263,Màz,blackmoore,1452,druid,feral,134,60,74
3264,Margueriti,the-maelstrom,1452,druid,feral,43,17,26
3265,Lukeyferalxo,argent-dawn,1449,druid,feral,96,47,49
3266,Thaelyy,drakthul,1430,druid,feral,54,22,32
3267,Zaethul,draenor,1429,druid,feral,24,16,8
3268,Tazdino,destromath,1427,druid,feral,36,15,21
3269,Arilíaxo,amanthul,1426,druid,feral,18,15,3
3270,Phesxd,sylvanas,1425,druid,feral,42,21,21
3271,Lugtedyr,draenor,1423,druid,feral,59,29,30
3272,Panthéra,ravencrest,1422,druid,feral,66,29,37
3273,Vancis,ravencrest,1421,druid,feral,51,29,22
3274,Mervend,tarren-mill,1420,druid,feral,41,15,26
3275,Doopdroo,tarren-mill,1419,druid,feral,42,15,27
3276,Eranor,archimonde,1405,druid,feral,110,52,58
3277,Boomzter,frostmane,1405,druid,feral,57,26,31
3278,Pipima,kazzak,1405,druid,feral,42,18,24
3279,Chiwsy,outland,1400,druid,feral,30,15,15
3280,Арбузег,gordunni,1398,druid,feral,35,16,19
3281,Vlcák,drakthul,1393,druid,feral,48,22,26
3282,Degentiuso,alakir,1386,druid,feral,82,45,37
3283,Legitx,dentarg,1385,druid,feral,43,17,26
3284,Larryburns,nathrezim,1381,druid,feral,36,16,20
3285,Liqoú,tarren-mill,1380,druid,feral,44,26,18
3286,Texoria,twisting-nether,1379,druid,feral,54,21,33
3287,Sÿlph,sylvanas,1377,druid,feral,90,46,44
3288,Elitarian,argent-dawn,1376,druid,feral,48,23,25
3289,Kirmelastas,kazzak,1374,druid,feral,30,19,11
3290,Ferøsse,hyjal,1374,druid,feral,42,21,21
3291,Cörelly,ravencrest,1370,druid,feral,78,39,39
3292,Bigdaddytate,kazzak,1364,druid,feral,29,17,12
3293,Микайо,goldrinn,1363,druid,feral,67,27,40
3294,Эскоф,gordunni,1359,druid,feral,31,17,14
3295,Biffsteak,blackhand,1357,druid,feral,60,28,32
3296,Manoestouro,draenor,1353,druid,feral,48,19,29
3297,Ripgødx,outland,1350,druid,feral,124,64,60
3298,Беконайзер,howling-fjord,1349,druid,feral,34,16,18
3299,Zechey,stormreaver,1343,druid,feral,24,14,10
3300,Shinshìva,twisting-nether,1337,druid,feral,126,67,59
3301,Котфилин,gordunni,1334,druid,feral,36,21,15
3302,Raznos,ravencrest,1333,druid,feral,18,14,4
3303,Chirnaruk,ravencrest,1326,druid,feral,42,17,25
3304,Vanhelsíng,dun-modr,1322,druid,feral,22,15,7
3305,Балаклаваа,soulflayer,1316,druid,feral,29,18,11
3306,Soléda,thrall,1310,druid,feral,36,16,20
3307,Majokz,ravencrest,1307,druid,feral,44,23,21
3308,Regelè,sylvanas,1305,druid,feral,86,45,41
3309,Epicplays,sylvanas,1300,druid,feral,24,14,10
3310,Кеорл,gordunni,1296,druid,feral,84,36,48
3311,Druidicmorr,sylvanas,1288,druid,feral,38,15,23
3312,Nalaa,festung-der-stürme,1277,druid,feral,83,35,48
3313,Jxst,tarren-mill,1270,druid,feral,48,19,29
3314,ßußßo,ravencrest,1264,druid,feral,18,15,3
3315,Лякокля,soulflayer,1260,druid,feral,42,22,20
3316,Pepeja,doomhammer,1253,druid,feral,24,15,9
3317,Yaddas,draenor,1248,druid,feral,18,13,5
3318,Ddru,ravencrest,1248,druid,feral,24,13,11
3319,Tael,elune,1248,druid,feral,24,13,11
3320,Kaldorei,nemesis,1246,druid,feral,24,13,11
3321,Blvckðvitchz,ravencrest,1246,druid,feral,24,13,11
3322,Goldrax,outland,1246,druid,feral,24,13,11
3323,Salseo,uldum,1239,druid,feral,33,14,19
3324,Cheddar,tyrande,1237,druid,feral,29,14,15
3325,Cleandc,blackhand,1234,druid,feral,34,20,14
3326,Crtx,blackhand,1234,druid,feral,36,21,15
3327,Twyty,khaz-modan,1234,druid,feral,70,33,37
3328,Тётявискас,howling-fjord,1233,druid,feral,24,13,11
3329,Webla,blackmoore,1231,druid,feral,29,15,14
3330,Deviantdruid,tarren-mill,1231,druid,feral,39,20,19
3331,Bâbusch,blackmoore,1230,druid,feral,24,13,11
3332,Катяблум,gordunni,1230,druid,feral,30,13,17
3333,Kimpine,kirin-tor,1229,druid,feral,33,15,18
3334,Shaggery,stormscale,1227,druid,feral,69,27,42
3335,Whísperclaw,ravencrest,1226,druid,feral,41,21,20
3336,Azmerloth,antonidas,1214,druid,feral,36,13,23
3337,Shymä,hyjal,1206,druid,feral,73,30,43
3338,Millenia,darkmoon-faire,1204,druid,feral,55,28,27
3339,Stelthee,silvermoon,1202,druid,feral,54,21,33
3340,Dougi,argent-dawn,1194,druid,feral,54,23,31
3341,Богарт,soulflayer,1193,druid,feral,24,14,10
3342,Tussenfryd,draenor,1189,druid,feral,64,25,39
3343,Грязныекогти,gordunni,1186,druid,feral,23,13,10
3344,Mônchô,sanguino,1182,druid,feral,51,28,23
3345,Hottad,tarren-mill,1179,druid,feral,60,31,29
3346,Dadzeus,khaz-modan,1170,druid,feral,23,13,10
3347,Kynji,twisting-nether,1169,druid,feral,60,27,33
3348,Lorcàn,argent-dawn,1164,druid,feral,40,16,24
3349,Blazor,eredar,1161,druid,feral,40,23,17
3350,Cocaqt,nemesis,1151,druid,feral,18,12,6
3351,Howtonio,archimonde,1151,druid,feral,18,12,6
3352,Kàraba,archimonde,1151,druid,feral,22,13,9
3353,Lenyl,dun-modr,1151,druid,feral,24,12,12
3354,Zbear,kazzak,1151,druid,feral,36,16,20
3355,Dirtyfantasy,alakir,1142,druid,feral,42,22,20
3356,Kyoshî,blackmoore,1142,druid,feral,82,42,40
3357,Rottweiler,doomhammer,1138,druid,feral,30,12,18
3358,Jinxaran,culte-de-la-rive-noire,1135,druid,feral,36,12,24
3359,Donoz,ravencrest,1130,druid,feral,18,12,6
3360,Koffee,archimonde,1129,druid,feral,24,12,12
3361,Кыцко,soulflayer,1124,druid,feral,24,12,12
3362,Mudpie,stormscale,1114,druid,feral,42,17,25
3363,Devonshira,ravencrest,1114,druid,feral,30,12,18
3364,Malvakten,kazzak,1112,druid,feral,25,13,12
3365,Feraligator,sanguino,1103,druid,feral,74,32,42
3366,Tibozx,stormscale,1102,druid,feral,30,17,13
3367,Battleray,twisting-nether,1102,druid,feral,45,21,24
3368,Kageioshi,kazzak,1097,druid,feral,30,16,14
3369,Cubswansón,outland,1095,druid,feral,26,13,13
3370,Zivertgodx,argent-dawn,1093,druid,feral,42,20,22
3371,Zaltaruk,sanguino,1089,druid,feral,42,19,23
3372,Vidlna,outland,1088,druid,feral,42,17,25
3373,Tsajj,stormreaver,1083,druid,feral,39,23,16
3374,Hönör,ysondre,1083,druid,feral,60,28,32
3375,Exortas,kazzak,1081,druid,feral,30,12,18
3376,Smittly,bloodhoof,1080,druid,feral,34,15,19
3377,Owling,antonidas,1061,druid,feral,42,21,21
3378,Swagmode,draenor,1059,druid,feral,43,25,18
3379,Kermit,die-aldor,1059,druid,feral,51,18,33
3380,Nìm,outland,1056,druid,feral,30,11,19
3381,Derzis,eonar,1055,druid,feral,54,25,29
3382,Belsebub,ravencrest,1055,druid,feral,30,11,19
3383,Liya,ravencrest,1054,druid,feral,30,11,19
3384,Котосапенс,howling-fjord,1052,druid,feral,24,11,13
3385,Одряя,soulflayer,1050,druid,feral,18,11,7
3386,Togara,kazzak,1050,druid,feral,24,11,13
3387,Тёмныйзверь,borean-tundra,1048,druid,feral,30,11,19
3388,Weedum,kazzak,1046,druid,feral,24,11,13
3389,Amoonaa,kazzak,1045,druid,feral,24,14,10
3390,Zokix,doomhammer,1040,druid,feral,30,12,18
3391,Eternas,elune,1027,druid,feral,82,37,45
3392,Liionheart,khaz-modan,1026,druid,feral,24,11,13
3393,Phanterus,chamber-of-aspects,1012,druid,feral,24,11,13
3394,Tatabomba,archimonde,1008,druid,feral,60,30,30
3395,Брэмблс,soulflayer,1008,druid,feral,35,15,20
3396,Salviaf,silvermoon,995,druid,feral,24,11,13
3397,Yøløswag,naxxramas,990,druid,feral,47,23,24
3398,Tsopúnisher,twisting-nether,990,druid,feral,28,13,15
3399,Janjalism,silvermoon,973,druid,feral,63,34,29
3400,Descendance,ysondre,967,druid,feral,30,14,16
3401,Migajde,ravencrest,965,druid,feral,17,11,6
3402,Pänthërä,ravencrest,960,druid,feral,18,10,8
3403,Docmedlove,aegwynn,960,druid,feral,24,10,14
3404,Ålleyézoffme,ravencrest,959,druid,feral,18,10,8
3405,Mcvøvà,kazzak,959,druid,feral,18,10,8
3406,Beerista,tarren-mill,959,druid,feral,24,11,13
3407,Hahafun,ravencrest,959,druid,feral,24,10,14
3408,Cyph,shadowsong,958,druid,feral,18,10,8
3409,Nîchtsnutz,blackmoore,958,druid,feral,18,10,8
3410,Corrupthz,outland,955,druid,feral,24,10,14
3411,Hushorde,twisting-nether,955,druid,feral,24,10,14
3412,Snøwden,twisting-nether,952,druid,feral,18,10,8
3413,Arnwaald,kaelthas,947,druid,feral,18,10,8
3414,Реептилоид,soulflayer,942,druid,feral,24,10,14
3415,Calaftayou,ravencrest,937,druid,feral,36,14,22
3416,Mpounia,twilights-hammer,927,druid,feral,54,25,29
3417,Zulazain,bladefist,921,druid,feral,42,13,29
3418,Teddîursa,kazzak,915,druid,feral,34,10,24
3419,Bagheera,archimonde,908,druid,feral,23,10,13
3420,Urfi,tyrande,864,druid,feral,12,9,3
3421,Wex,darksorrow,864,druid,feral,12,9,3
3422,Quikahn,outland,864,druid,feral,12,9,3
3423,Paramore,outland,864,druid,feral,18,9,9
3424,Sixmonthbann,ravencrest,864,druid,feral,18,9,9
3425,Aleatório,grim-batol,864,druid,feral,18,9,9
3426,Cocomojo,outland,864,druid,feral,18,9,9
3427,Furrykruger,the-maelstrom,864,druid,feral,18,9,9
3428,Cjparker,archimonde,863,druid,feral,18,9,9
3429,Hugepepega,ravencrest,863,druid,feral,18,9,9
3430,Беркамп,howling-fjord,863,druid,feral,18,9,9
3431,Rbg,dun-modr,863,druid,feral,22,10,12
3432,Пиггипоп,soulflayer,863,druid,feral,24,9,15
3433,Олежасутра,howling-fjord,863,druid,feral,30,9,21
3434,Мунфайр,galakrond,862,druid,feral,18,9,9
3435,Кецян,gordunni,862,druid,feral,19,9,10
3436,Snapeshifter,blackhand,859,druid,feral,18,9,9
3437,Caèlas,outland,859,druid,feral,18,9,9
3438,Hadespool,sanguino,859,druid,feral,18,9,9
3439,Nalreaa,kazzak,859,druid,feral,18,9,9
3440,Weydjin,garona,858,druid,feral,18,9,9
3441,Carakal,outland,858,druid,feral,24,9,15
3442,Collnaris,ravencrest,857,druid,feral,12,9,3
3443,Kodobursto,stormscale,856,druid,feral,18,9,9
3444,Trusten,nemesis,854,druid,feral,18,9,9
3445,Noyake,ragnaros,854,druid,feral,24,9,15
3446,Реалаг,howling-fjord,847,druid,feral,23,9,14
3447,Klatro,terokkar,844,druid,feral,12,9,3
3448,Kîñg,tarren-mill,839,druid,feral,52,23,29
3449,Progodd,kazzak,833,druid,feral,24,9,15
3450,Hadesx,blackhand,832,druid,feral,18,9,9
3451,Snupy,outland,815,druid,feral,17,9,8
3452,Йванныч,gordunni,793,druid,feral,26,9,17
3453,Moonkniight,ravencrest,768,druid,feral,12,8,4
3454,Bleêds,dun-modr,768,druid,feral,12,8,4
3455,Sartipus,draenor,768,druid,feral,12,8,4
3456,Muckì,alleria,768,druid,feral,18,8,10
3457,Итильтириэль,gordunni,768,druid,feral,18,8,10
3458,Апвель,gordunni,768,druid,feral,18,8,10
3459,Kørnuto,nemesis,767,druid,feral,12,8,4
3460,Mimir,la-croisade-écarlate,767,druid,feral,12,8,4
3461,Стэлларпауэр,gordunni,767,druid,feral,18,8,10
3462,Seysso,silvermoon,767,druid,feral,18,8,10
3463,Acéré,archimonde,767,druid,feral,24,8,16
3464,Laek,chogall,767,druid,feral,24,8,16
3465,Pneuma,xavius,767,druid,feral,24,8,16
3466,Thielyy,blackmoore,766,druid,feral,18,8,10
3467,Crow,saurfang,766,druid,feral,20,8,12
3468,Krvopito,tarren-mill,765,druid,feral,12,8,4
3469,Plankface,ravencrest,765,druid,feral,18,8,10
3470,Dudeimgodly,ravencrest,765,druid,feral,30,8,22
3471,Bâlou,nathrezim,764,druid,feral,18,8,10
3472,Lemmí,frostwolf,763,druid,feral,18,8,10
3473,Käissi,blackmoore,763,druid,feral,18,8,10
3474,Ziovris,silvermoon,761,druid,feral,24,8,16
3475,Théó,grim-batol,758,druid,feral,35,13,22
3476,Jupter,burning-blade,755,druid,feral,18,8,10
3477,Плагиат,grom,749,druid,feral,30,8,22
3478,Cyriaan,eredar,719,druid,feral,17,8,9
3479,Lolhaha,ravencrest,672,druid,feral,12,7,5
3480,Dureka,tarren-mill,672,druid,feral,12,7,5
3481,Bomoth,kazzak,672,druid,feral,12,7,5
3482,Jeezuschrist,archimonde,672,druid,feral,12,7,5
3483,Goodtrip,hyjal,672,druid,feral,12,7,5
3484,Fíja,blackmoore,672,druid,feral,12,7,5
3485,Kärmä,eldrethalas,672,druid,feral,12,7,5
3486,Snkyferalmov,aegwynn,672,druid,feral,12,7,5
3487,Бобасик,fordragon,672,druid,feral,12,7,5
3488,Runeclaws,twisting-nether,672,druid,feral,12,7,5
3489,Nøkki,draenor,672,druid,feral,12,7,5
3490,Фекаллис,soulflayer,672,druid,feral,12,7,5
3491,Диздру,howling-fjord,672,druid,feral,12,7,5
3492,Mooncarnatio,burning-legion,672,druid,feral,18,7,11
3493,Coldkíng,twisting-nether,672,druid,feral,18,7,11
3494,Luveena,kazzak,672,druid,feral,18,7,11
3495,Ðevilwhite,nemesis,672,druid,feral,18,7,11
3496,Oni,kelthuzad,672,druid,feral,18,7,11
3497,Sethread,ragnaros,672,druid,feral,18,7,11
3498,Starliner,ravencrest,672,druid,feral,24,7,17
3499,Liptonbite,blackhand,672,druid,feral,24,7,17
3500,Laguna,ravencrest,672,druid,feral,24,7,17
3501,Déme,twisting-nether,671,druid,feral,12,7,5
3502,Криашин,goldrinn,671,druid,feral,12,7,5
3503,Sôalôgel,blackrock,671,druid,feral,12,7,5
3504,Bærbell,blackrock,671,druid,feral,18,7,11
3505,Henessi,ragnaros,671,druid,feral,18,7,11
3506,Ефомитстерша,gordunni,671,druid,feral,18,7,11
3507,Lazerbinks,blackmoore,671,druid,feral,24,7,17
3508,Noobbiiee,silvermoon,670,druid,feral,12,7,5
3509,Biorythm,draenor,670,druid,feral,12,7,5
3510,Grimgoor,burning-legion,670,druid,feral,12,7,5
3511,Cøcøpøpsmøke,archimonde,670,druid,feral,18,7,11
3512,Radime,khaz-modan,669,druid,feral,12,7,5
3513,Toredorxy,blackrock,669,druid,feral,12,7,5
3514,Терамин,howling-fjord,669,druid,feral,18,7,11
3515,Äcajou,hyjal,668,druid,feral,18,7,11
3516,Malfyurion,ragnaros,668,druid,feral,18,7,11
3517,Nicos,elune,668,druid,feral,18,7,11
3518,Фаллендэл,gordunni,663,druid,feral,12,7,5
3519,Mordpaw,stormscale,639,druid,feral,14,8,6
3520,Sìa,frostmane,639,druid,feral,23,7,16
3521,Àyóorts,archimonde,607,druid,feral,14,7,7
3522,Hadoukan,ravencrest,576,druid,feral,6,6,0
3523,Arlandia,drakthul,576,druid,feral,12,6,6
3524,Flawkin,kazzak,576,druid,feral,12,6,6
3525,Tonycatmeow,ravencrest,576,druid,feral,12,6,6
3526,Baccthana,auchindoun,576,druid,feral,12,6,6
3527,Vulko,lightbringer,576,druid,feral,12,6,6
3528,Nédith,archimonde,576,druid,feral,12,6,6
3529,Snkyexpress,aegwynn,576,druid,feral,12,6,6
3530,Сиэн,ashenvale,576,druid,feral,12,6,6
3531,Amandial,silvermoon,576,druid,feral,12,6,6
3532,Хокан,deepholm,576,druid,feral,18,6,12
3533,Radauronny,malganis,576,druid,feral,18,6,12
3534,Drudonja,silvermoon,575,druid,feral,12,6,6
3535,Leidbulle,blackrock,575,druid,feral,12,6,6
3536,Xurta,kazzak,575,druid,feral,12,6,6
3537,Chunkeykill,alonsus,575,druid,feral,12,6,6
3538,Скайтибрайдх,gordunni,575,druid,feral,18,6,12
3539,Tyldormeow,tarren-mill,575,druid,feral,18,6,12
3540,Tricklou,tarren-mill,574,druid,feral,12,6,6
3541,Zeyne,ravencrest,574,druid,feral,12,6,6
3542,Hetalia,culte-de-la-rive-noire,571,druid,feral,12,6,6
3543,Друлевой,greymane,570,druid,feral,12,6,6
3544,Mommonga,onyxia,570,druid,feral,14,6,8
3545,Spangle,stormscale,554,druid,feral,21,7,14
3546,Tyranderawr,ravencrest,522,druid,feral,15,7,8
3547,Блиденг,gordunni,522,druid,feral,21,8,13
3548,Nuashoa,argent-dawn,521,druid,feral,16,7,9
3549,Ryselol,nemesis,480,druid,feral,6,5,1
3550,Thørkang,dun-modr,480,druid,feral,6,5,1
3551,Ytzù,archimonde,480,druid,feral,6,5,1
3552,Tjxaxa,ravencrest,480,druid,feral,6,5,1
3553,Fürfur,ravencrest,480,druid,feral,6,5,1
3554,Retzerbil,ravencrest,480,druid,feral,10,6,4
3555,Saabeq,hyjal,480,druid,feral,12,5,7
3556,Bloomly,tarren-mill,480,druid,feral,12,5,7
3557,Erenalby,draenor,480,druid,feral,12,5,7
3558,Nainket,ravencrest,480,druid,feral,12,5,7
3559,Toron,dalaran,480,druid,feral,12,5,7
3560,Arfgtdispo,hyjal,480,druid,feral,12,5,7
3561,Flum,darksorrow,480,druid,feral,12,5,7
3562,Turkus,draenor,480,druid,feral,12,5,7
3563,Zurllyn,ravencrest,480,druid,feral,12,5,7
3564,Eltroncazo,sanguino,480,druid,feral,12,5,7
3565,Nspirit,ravencrest,480,druid,feral,12,5,7
3566,Wucherwurzel,eredar,480,druid,feral,12,5,7
3567,Rysejr,nemesis,480,druid,feral,12,5,7
3568,Einsfünfkcat,madmortem,480,druid,feral,12,5,7
3569,Nå,outland,480,druid,feral,12,5,7
3570,Hrabioid,burning-legion,480,druid,feral,12,5,7
3571,Шэйпшифт,fordragon,480,druid,feral,12,5,7
3572,Rímeru,blackmoore,480,druid,feral,12,5,7
3573,Chepochem,stormscale,480,druid,feral,12,5,7
3574,Nîghtz,ravencrest,480,druid,feral,12,5,7
3575,Siire,ravencrest,480,druid,feral,12,5,7
3576,Shylovez,aegwynn,480,druid,feral,12,5,7
3577,Sketz,stormscale,480,druid,feral,12,5,7
3578,Kardashìan,ravencrest,480,druid,feral,13,5,8
3579,Wølveríne,frostmane,480,druid,feral,18,5,13
3580,Outtanowhere,drakthul,480,druid,feral,18,5,13
3581,Yiradur,stormscale,480,druid,feral,18,5,13
3582,Blintschiki,echsenkessel,480,druid,feral,18,5,13
3583,Mérias,archimonde,480,druid,feral,18,5,13
3584,Cdsxr,outland,480,druid,feral,24,5,19
3585,Селфика,gordunni,480,druid,feral,24,5,19
3586,Mgelolaf,doomhammer,479,druid,feral,6,5,1
3587,Telpha,onyxia,479,druid,feral,12,5,7
3588,Dash,the-maelstrom,479,druid,feral,12,5,7
3589,Poskehh,outland,479,druid,feral,12,5,7
3590,Terror,agamaggan,479,druid,feral,12,5,7
3591,Holditorsken,grim-batol,479,druid,feral,12,5,7
3592,Mambalol,sanguino,479,druid,feral,12,5,7
3593,Менстряк,howling-fjord,479,druid,feral,18,5,13
3594,Cattastrophe,bronzebeard,477,druid,feral,12,5,7
3595,Mitomen,ragnaros,476,druid,feral,12,5,7
3596,Skylarr,alexstrasza,475,druid,feral,12,5,7
3597,Zynmeow,lordaeron,416,druid,feral,19,6,13
3598,Euskal,chogall,415,druid,feral,8,5,3
3599,Nipply,ravencrest,415,druid,feral,15,6,9
3600,Ábomínatíon,draenor,384,druid,feral,6,4,2
3601,Osaviciosa,shendralar,384,druid,feral,6,4,2
3602,Psixx,blackhand,384,druid,feral,6,4,2
3603,Kgn,blackmoore,384,druid,feral,6,4,2
3604,Шабашиоргия,soulflayer,384,druid,feral,6,4,2
3605,Ryseqt,nemesis,384,druid,feral,6,4,2
3606,Taigarus,aerie-peak,384,druid,feral,6,4,2
3607,Ryáanz,ravencrest,384,druid,feral,6,4,2
3608,Noxxzar,stormscale,384,druid,feral,6,4,2
3609,Faveyo,die-nachtwache,384,druid,feral,6,4,2
3610,Seekx,silvermoon,384,druid,feral,6,4,2
3611,Tróllinger,blackrock,384,druid,feral,6,4,2
3612,Takamizy,ysondre,384,druid,feral,6,4,2
3613,Loyoq,elune,384,druid,feral,6,4,2
3614,Dystaleon,blackrock,384,druid,feral,6,4,2
3615,Aslanah,hyjal,384,druid,feral,6,4,2
3616,Diktus,outland,384,druid,feral,6,4,2
3617,Knatch,outland,384,druid,feral,6,4,2
3618,Minaye,hyjal,384,druid,feral,6,4,2
3619,Fzx,aegwynn,384,druid,feral,6,4,2
3620,Shiotake,hyjal,384,druid,feral,12,4,8
3621,Mbk,kazzak,384,druid,feral,12,4,8
3622,Ghettoven,kazzak,384,druid,feral,12,4,8
3623,Goatmeal,draenor,384,druid,feral,12,4,8
3624,Carridwyn,argent-dawn,384,druid,feral,12,4,8
3625,Pitchou,karazhan,384,druid,feral,12,4,8
3626,Ялория,azuregos,384,druid,feral,12,4,8
3627,Notsad,dun-modr,384,druid,feral,12,4,8
3628,Sekunden,ravencrest,384,druid,feral,12,4,8
3629,Турбокалясик,gordunni,384,druid,feral,12,4,8
3630,Gediminas,argent-dawn,384,druid,feral,18,4,14
3631,Plandros,draenor,384,druid,feral,18,4,14
3632,Tîma,blackmoore,384,druid,feral,19,4,15
3633,Shuffey,frostmane,383,druid,feral,6,4,2
3634,Tombenuit,tarren-mill,383,druid,feral,6,4,2
3635,Tsukuyómi,ragnaros,383,druid,feral,6,4,2
3636,Bearshift,aggra-português,383,druid,feral,6,4,2
3637,Itzferal,durotan,383,druid,feral,9,4,5
3638,Lutis,magtheridon,383,druid,feral,12,4,8
3639,Altramuz,uldum,382,druid,feral,6,4,2
3640,Viølin,silvermoon,381,druid,feral,12,4,8
3641,Verbat,cthun,379,druid,feral,12,4,8
3642,Phandris,argent-dawn,379,druid,feral,12,4,8
3643,Эвгедент,deathguard,379,druid,feral,24,4,20
3644,Rakuy,thrall,352,druid,feral,10,4,6
3645,Erelae,twisting-nether,352,druid,feral,10,4,6
3646,Âltashamane,elune,351,druid,feral,11,4,7
3647,Krekigaadzre,draenor,335,druid,feral,9,4,5
3648,Wolfly,ravencrest,329,druid,feral,17,6,11
3649,Броодяга,razuvious,319,druid,feral,5,4,1
3650,Nzmdruid,burning-legion,288,druid,feral,6,3,3
3651,Xercàs,outland,288,druid,feral,6,3,3
3652,Biggestnick,ravencrest,288,druid,feral,6,3,3
3653,Мивинчик,ashenvale,288,druid,feral,6,3,3
3654,Wildthing,blackmoore,288,druid,feral,6,3,3
3655,Fearthecat,defias-brotherhood,288,druid,feral,6,3,3
3656,Veryfast,blackhand,288,druid,feral,6,3,3
3657,Druidicchi,stormscale,288,druid,feral,6,3,3
3658,Fallken,burning-blade,288,druid,feral,6,3,3
3659,Carlitto,blackmoore,288,druid,feral,6,3,3
3660,Loafy,the-maelstrom,288,druid,feral,6,3,3
3661,Druiidou,dalaran,288,druid,feral,6,3,3
3662,Nightdruidcz,turalyon,288,druid,feral,6,3,3
3663,Dianabigby,silvermoon,288,druid,feral,6,3,3
3664,Fuzzylol,haomarush,288,druid,feral,6,3,3
3665,Zjukov,ragnaros,288,druid,feral,6,3,3
3666,Ferpylul,ragnaros,288,druid,feral,6,3,3
3667,Kúùsh,frostwolf,288,druid,feral,6,3,3
3668,Urgrull,baelgun,288,druid,feral,6,3,3
3669,Svass,ragnaros,288,druid,feral,6,3,3
3670,Druidou,kaelthas,288,druid,feral,6,3,3
3671,Lunanikuya,ravencrest,288,druid,feral,6,3,3
3672,Sylvy,dun-modr,288,druid,feral,6,3,3
3673,Fluffygoon,azjolnerub,288,druid,feral,6,3,3
3674,Хённим,howling-fjord,288,druid,feral,6,3,3
3675,Nefertiti,baelgun,288,druid,feral,6,3,3
3676,Feytique,aegwynn,288,druid,feral,6,3,3
3677,Reservebär,blackhand,288,druid,feral,6,3,3
3678,Yepnesse,khaz-modan,288,druid,feral,6,3,3
3679,Shingeki,alonsus,288,druid,feral,6,3,3
3680,Ðeathwatch,ravencrest,288,druid,feral,6,3,3
3681,Madgazfanboi,ravencrest,288,druid,feral,6,3,3
3682,Zhosy,shattrath,288,druid,feral,6,3,3
3683,Kovlian,argent-dawn,288,druid,feral,6,3,3
3684,Mooqt,alexstrasza,288,druid,feral,6,3,3
3685,Hipølita,zuljin,288,druid,feral,6,3,3
3686,Lyrasanna,argent-dawn,288,druid,feral,6,3,3
3687,Vãrima,ravencrest,288,druid,feral,6,3,3
3688,Apetino,dun-modr,288,druid,feral,6,3,3
3689,Moskaros,turalyon,288,druid,feral,6,3,3
3690,Shifthappens,dun-modr,288,druid,feral,6,3,3
3691,Calîmerô,blackrock,288,druid,feral,6,3,3
3692,Moonpuff,kazzak,288,druid,feral,6,3,3
3693,Aedui,tarren-mill,288,druid,feral,9,4,5
3694,Zantill,chamber-of-aspects,288,druid,feral,7,3,4
3695,Лорья,azuregos,288,druid,feral,12,3,9
3696,Psychodeliya,ragnaros,288,druid,feral,12,3,9
3697,Kittyclâw,perenolde,288,druid,feral,12,3,9
3698,Bénjî,khazgoroth,288,druid,feral,12,3,9
3699,Lupa,drakthul,288,druid,feral,12,3,9
3700,Enylasi,hyjal,288,druid,feral,12,3,9
3701,Trikill,hyjal,288,druid,feral,13,3,10
3702,Klaerke,tarren-mill,288,druid,feral,18,3,15
3703,Tallbutshort,stormscale,288,druid,feral,18,3,15
3704,Denadu,turalyon,288,druid,feral,18,3,15
3705,Frincessa,burning-legion,288,druid,feral,18,3,15
3706,Жекакотик,eversong,287,druid,feral,6,3,3
3707,Mistic,twisting-nether,287,druid,feral,12,3,9
3708,Kyth,forscherliga,287,druid,feral,12,3,9
3709,Vicendius,drakthul,287,druid,feral,12,3,9
3710,Poxu,eredar,287,druid,feral,18,3,15
3711,Bakar,ghostlands,286,druid,feral,6,3,3
3712,Zhabka,silvermoon,286,druid,feral,6,3,3
3713,Zottelmahne,blackrock,286,druid,feral,6,3,3
3714,Диджейкошка,howling-fjord,239,druid,feral,5,3,2
3715,Xarxius,sanguino,223,druid,feral,14,3,11
3716,Ephixa,burning-legion,192,druid,feral,6,2,4
3717,Эриэс,gordunni,192,druid,feral,6,2,4
3718,Defløwer,aegwynn,192,druid,feral,6,2,4
3719,Rimpularaisa,grim-batol,192,druid,feral,6,2,4
3720,Вендьета,blackscar,192,druid,feral,6,2,4
3721,Спэкк,gordunni,192,druid,feral,6,2,4
3722,Медверх,gordunni,192,druid,feral,6,2,4
3723,Catwild,blackmoore,192,druid,feral,6,2,4
3724,Glenn,alakir,192,druid,feral,6,2,4
3725,Sheiheda,kazzak,192,druid,feral,6,2,4
3726,Glyn,earthen-ring,192,druid,feral,6,2,4
3727,Savagehèals,ravencrest,192,druid,feral,6,2,4
3728,Sandirion,silvermoon,192,druid,feral,6,2,4
3729,Ckelf,ravencrest,192,druid,feral,6,2,4
3730,Treepoloski,stormscale,192,druid,feral,6,2,4
3731,Shifts,the-maelstrom,192,druid,feral,6,2,4
3732,Nidra,silvermoon,192,druid,feral,6,2,4
3733,Druiddamage,the-maelstrom,192,druid,feral,6,2,4
3734,Coineagan,frostmourne,192,druid,feral,6,2,4
3735,Kisskossa,stormscale,192,druid,feral,6,2,4
3736,Chikiz,ghostlands,192,druid,feral,6,2,4
3737,Citrus,sargeras,192,druid,feral,6,2,4
3738,Rabatout,eitrigg,192,druid,feral,6,2,4
3739,Feralsaber,ghostlands,192,druid,feral,6,2,4
3740,Snuggums,argent-dawn,192,druid,feral,6,2,4
3741,Naetsch,blackrock,192,druid,feral,6,2,4
3742,Voyerka,drakthul,192,druid,feral,6,2,4
3743,Melcow,eredar,192,druid,feral,6,2,4
3744,Aryitu,blackrock,192,druid,feral,6,2,4
3745,Jåkeferalta,outland,192,druid,feral,6,2,4
3746,Bóssít,doomhammer,192,druid,feral,6,2,4
3747,Jimmyxdd,kazzak,192,druid,feral,6,2,4
3748,Metamø,blackrock,192,druid,feral,6,2,4
3749,Astlanes,ysondre,192,druid,feral,6,2,4
3750,Bartax,culte-de-la-rive-noire,192,druid,feral,6,2,4
3751,Seekíng,blackmoore,192,druid,feral,6,2,4
3752,Nightfáll,tarren-mill,192,druid,feral,6,2,4
3753,Docdruid,outland,192,druid,feral,6,2,4
3754,Kiizal,twisting-nether,192,druid,feral,6,2,4
3755,Rabacki,blackmoore,192,druid,feral,6,2,4
3756,Jamaican,outland,192,druid,feral,6,2,4
3757,Verbxp,kazzak,192,druid,feral,6,2,4
3758,Mcservietsky,chogall,192,druid,feral,6,2,4
3759,Вохако,howling-fjord,192,druid,feral,6,2,4
3760,Wuzzington,outland,192,druid,feral,6,2,4
3761,Nelfboyuk,tarren-mill,192,druid,feral,6,2,4
3762,Zyron,sanguino,192,druid,feral,6,2,4
3763,Älênkâ,drakthul,192,druid,feral,12,2,10
3764,Affines,the-maelstrom,192,druid,feral,12,2,10
3765,Nkoyi,argent-dawn,192,druid,feral,12,2,10
3766,Erelieva,silvermoon,192,druid,feral,12,2,10
3767,Nicotex,draenor,192,druid,feral,12,2,10
3768,Amoveo,argent-dawn,192,druid,feral,12,2,10
3769,Speegle,kazzak,192,druid,feral,12,2,10
3770,Baerminatør,blackrock,192,druid,feral,12,2,10
3771,Feralzeus,sylvanas,192,druid,feral,12,2,10
3772,Trànsformer,nemesis,192,druid,feral,12,2,10
3773,Ôpium,eldrethalas,191,druid,feral,6,2,4
3774,Anyône,dun-morogh,191,druid,feral,6,2,4
3775,Kittasek,drakthul,191,druid,feral,6,2,4
3776,Jompemanfish,stormscale,191,druid,feral,6,2,4
3777,Loriann,twisting-nether,191,druid,feral,18,2,16
3778,Meuhtéki,hyjal,190,druid,feral,13,3,10
3779,Shadøwdruid,silvermoon,190,druid,feral,18,2,16
3780,Ilyethea,earthen-ring,175,druid,feral,11,2,9
3781,Carldroid,sylvanas,160,druid,feral,10,2,8
3782,Korkskruven,draenor,159,druid,feral,5,2,3
3783,Muryo,der-rat-von-dalaran,159,druid,feral,5,2,3
3784,Lionquokk,azjolnerub,128,druid,feral,4,2,2
3785,Azaría,aegwynn,128,druid,feral,4,2,2
3786,Wurnas,silvermoon,121,druid,feral,15,3,12
3787,Moderntalkin,aegwynn,96,druid,feral,17,4,13
3788,Ãnimal,argent-dawn,96,druid,feral,6,1,5
3789,Gurudru,tarren-mill,96,druid,feral,6,1,5
3790,Zðe,la-croisade-écarlate,96,druid,feral,6,1,5
3791,Kuw,archimonde,96,druid,feral,6,1,5
3792,Vanarea,argent-dawn,96,druid,feral,6,1,5
3793,Бабакошка,gordunni,96,druid,feral,6,1,5
3794,Sabresheep,twisting-nether,96,druid,feral,6,1,5
3795,Fabulous,genjuros,96,druid,feral,6,1,5
3796,Heav,kiljaeden,96,druid,feral,6,1,5
3797,Tael,argent-dawn,96,druid,feral,6,1,5
3798,Отхода,gordunni,96,druid,feral,6,1,5
3799,Greenfingerz,azjolnerub,96,druid,feral,6,1,5
3800,Awán,aegwynn,96,druid,feral,6,1,5
3801,Strand,ragnaros,96,druid,feral,6,1,5
3802,Мурталор,soulflayer,96,druid,feral,6,1,5
3803,Thaneo,blackmoore,96,druid,feral,6,1,5
3804,Naturexbot,silvermoon,96,druid,feral,6,1,5
3805,Théodên,dalaran,96,druid,feral,6,1,5
3806,Saliencias,kazzak,96,druid,feral,6,1,5
3807,Горртек,howling-fjord,96,druid,feral,6,1,5
3808,Хэрес,gordunni,96,druid,feral,6,1,5
3809,Markuslanz,blackrock,96,druid,feral,6,1,5
3810,Plàntz,tarren-mill,96,druid,feral,6,1,5
3811,Nidrien,doomhammer,96,druid,feral,6,1,5
3812,Yarrp,stormscale,96,druid,feral,6,1,5
3813,Catgirlx,ravencrest,96,druid,feral,6,1,5
3814,Alcik,silvermoon,96,druid,feral,6,1,5
3815,Ragnai,emerald-dream,96,druid,feral,6,1,5
3816,Maräanhatähr,silvermoon,96,druid,feral,6,1,5
3817,Zinister,hyjal,96,druid,feral,6,1,5
3818,Haragmancs,arathor,96,druid,feral,6,1,5
3819,Venomjr,bloodhoof,96,druid,feral,6,1,5
3820,Jamera,stormscale,96,druid,feral,6,1,5
3821,Majesty,nagrand,96,druid,feral,6,1,5
3822,Ethryl,ravencrest,96,druid,feral,6,1,5
3823,Шадараф,howling-fjord,96,druid,feral,6,1,5
3824,Nakkikastike,magtheridon,96,druid,feral,12,1,11
3825,Veyronn,burning-legion,96,druid,feral,12,1,11
3826,Teám,tarren-mill,96,druid,feral,12,1,11
3827,Farnae,kirin-tor,96,druid,feral,12,1,11
3828,Taco,eredar,96,druid,feral,12,1,11
3829,Mäywen,ravencrest,96,druid,feral,12,1,11
3830,Bidodici,nemesis,95,druid,feral,6,1,5
3831,Allîyâ,archimonde,79,druid,feral,5,1,4
3832,Dubakoo,outland,64,druid,feral,4,1,3
3833,Forigiver,draenor,64,druid,feral,4,1,3
3834,Wadles,draenor,48,druid,feral,3,1,2
3835,Aendy,tarren-mill,48,druid,feral,3,1,2
3836,Fuséton,tarren-mill,2332,druid,balance,197,120,77
3837,Merceý,ravencrest,2288,druid,balance,87,59,28
3838,Bd,stormscale,2225,druid,balance,83,49,34
3839,Immuz,kazzak,2215,druid,balance,101,55,46
3840,Broccoliboy,sylvanas,2199,druid,balance,78,46,32
3841,Maroxd,stormscale,2169,druid,balance,48,39,9
3842,Eviscreator,stormscale,2148,druid,balance,114,76,38
3843,Wriong,ravencrest,2147,druid,balance,112,68,44
3844,Tmeister,kazzak,2145,druid,balance,84,50,34
3845,Sleepyhallow,blackmoore,2142,druid,balance,100,58,42
3846,Thelire,silvermoon,2134,druid,balance,132,75,57
3847,Isatá,ravencrest,2123,druid,balance,66,42,24
3848,Ackiz,ravencrest,2121,druid,balance,69,42,27
3849,Shayia,aegwynn,2121,druid,balance,119,65,54
3850,Skivesnulle,kazzak,2119,druid,balance,113,57,56
3851,Winkler,kazzak,2109,druid,balance,50,38,12
3852,Deép,nazjatar,2106,druid,balance,84,45,39
3853,Ôwlnur,kult-der-verdammten,2080,druid,balance,85,50,35
3854,Mephîs,ravencrest,2078,druid,balance,76,49,27
3855,Jwrld,stormscale,2075,druid,balance,60,32,28
3856,Dincks,draenor,2068,druid,balance,71,47,24
3857,Handsoff,stormscale,2065,druid,balance,120,65,55
3858,Antahka,archimonde,2057,druid,balance,60,34,26
3859,Shivany,twisting-nether,2052,druid,balance,130,66,64
3860,Nutsnack,tarren-mill,2039,druid,balance,78,38,40
3861,Batboomie,zuljin,2037,druid,balance,167,95,72
3862,Méáckós,aegwynn,2025,druid,balance,104,52,52
3863,Владисзади,gordunni,2024,druid,balance,101,55,46
3864,Flanagân,hyjal,2020,druid,balance,42,26,16
3865,Agagagagagag,ravencrest,2018,druid,balance,69,39,30
3866,Oskol,tarren-mill,2004,druid,balance,52,29,23
3867,Klimakleber,ravencrest,1997,druid,balance,135,67,68
3868,Catchmê,archimonde,1993,druid,balance,62,36,26
3869,Wizzlafa,ravencrest,1988,druid,balance,58,37,21
3870,Karvajyrä,stormreaver,1972,druid,balance,162,96,66
3871,Gurru,xavius,1967,druid,balance,78,45,33
3872,Aggroasian,tarren-mill,1966,druid,balance,171,99,72
3873,ßa,blackmoore,1960,druid,balance,59,38,21
3874,Qtkitty,outland,1960,druid,balance,135,83,52
3875,Vabore,twisting-nether,1956,druid,balance,60,35,25
3876,Sunshinex,silvermoon,1956,druid,balance,78,43,35
3877,Flæppy,blackmoore,1953,druid,balance,133,69,64
3878,Turtleform,blackrock,1952,druid,balance,60,29,31
3879,Knùbz,ravencrest,1950,druid,balance,47,27,20
3880,Néllÿ,elune,1943,druid,balance,78,39,39
3881,Positivîty,stormscale,1937,druid,balance,78,49,29
3882,Howgh,destromath,1926,druid,balance,156,85,71
3883,Transmangodx,tarren-mill,1923,druid,balance,60,38,22
3884,Mooskie,draenor,1921,druid,balance,54,37,17
3885,Neirdá,hyjal,1919,druid,balance,137,81,56
3886,Fredhqt,tarren-mill,1918,druid,balance,59,37,22
3887,Ezeke,eredar,1916,druid,balance,78,41,37
3888,Norgand,die-aldor,1915,druid,balance,24,20,4
3889,Даирлин,gordunni,1913,druid,balance,106,52,54
3890,Bákhar,ravencrest,1912,druid,balance,54,29,25
3891,Laserchicken,malganis,1912,druid,balance,95,47,48
3892,Shåmss,kazzak,1910,druid,balance,36,23,13
3893,Trntydr,senjin,1906,druid,balance,35,27,8
3894,Kruwkamilka,burning-legion,1906,druid,balance,64,38,26
3895,Рейзакх,howling-fjord,1905,druid,balance,78,40,38
3896,Wwboomy,kazzak,1905,druid,balance,66,33,33
3897,Secrägodx,ragnaros,1902,druid,balance,48,29,19
3898,Muufasa,blackmoore,1899,druid,balance,170,88,82
3899,Zendda,hyjal,1896,druid,balance,61,30,31
3900,Malex,auchindoun,1895,druid,balance,54,32,22
3901,Rek,sanguino,1893,druid,balance,57,33,24
3902,Votionex,tarren-mill,1891,druid,balance,64,38,26
3903,Hppsr,eredar,1889,druid,balance,66,35,31
3904,Небесныйхант,soulflayer,1887,druid,balance,77,42,35
3905,Kankstery,stormscale,1882,druid,balance,65,44,21
3906,Greenful,drakthul,1880,druid,balance,36,24,12
3907,Blopstar,stormscale,1879,druid,balance,54,34,20
3908,Slaugh,zuljin,1879,druid,balance,83,43,40
3909,Sentería,sylvanas,1876,druid,balance,60,30,30
3910,Crnkie,sylvanas,1873,druid,balance,24,20,4
3911,Øncê,durotan,1871,druid,balance,54,29,25
3912,Zødzin,kazzak,1863,druid,balance,42,25,17
3913,Akinimod,ravencrest,1857,druid,balance,56,35,21
3914,Maijs,ravencrest,1857,druid,balance,66,31,35
3915,Peaches,aerie-peak,1856,druid,balance,53,38,15
3916,Starbro,grim-batol,1856,druid,balance,48,27,21
3917,Newaccount,kazzak,1851,druid,balance,42,29,13
3918,Ventrìx,alleria,1843,druid,balance,72,39,33
3919,Арадия,gordunni,1843,druid,balance,66,35,31
3920,Gipi,ravencrest,1843,druid,balance,60,31,29
3921,Hrz,kazzak,1839,druid,balance,79,50,29
3922,Starfallkey,dun-modr,1839,druid,balance,99,61,38
3923,Pluginbaby,stormscale,1838,druid,balance,64,41,23
3924,Tjillevippen,tarren-mill,1836,druid,balance,36,23,13
3925,Zuterlø,ragnaros,1834,druid,balance,54,28,26
3926,Nuvemone,stormscale,1831,druid,balance,84,48,36
3927,Bastodonte,skullcrusher,1830,druid,balance,102,53,49
3928,Ghostpaws,ravencrest,1829,druid,balance,60,31,29
3929,Mopboomkin,twisting-nether,1828,druid,balance,48,29,19
3930,Carnivals,twisting-nether,1825,druid,balance,54,31,23
3931,Bearpawzz,kazzak,1823,druid,balance,48,29,19
3932,Mirynn,elune,1823,druid,balance,121,63,58
3933,Nyndrà,archimonde,1823,druid,balance,99,48,51
3934,Faxotium,argent-dawn,1822,druid,balance,30,21,9
3935,Moonhusky,blackrock,1817,druid,balance,54,34,20
3936,Captaïn,twisting-nether,1816,druid,balance,36,27,9
3937,Lunahu,argent-dawn,1816,druid,balance,72,42,30
3938,Astrobazooka,stormreaver,1815,druid,balance,77,48,29
3939,Wrathgodx,aegwynn,1814,druid,balance,36,24,12
3940,Didiee,kazzak,1814,druid,balance,54,31,23
3941,Травкер,howling-fjord,1813,druid,balance,137,67,70
3942,Hyac,the-maelstrom,1811,druid,balance,36,26,10
3943,Bashmac,mugthol,1811,druid,balance,72,49,23
3944,Juicypus,ragnaros,1809,druid,balance,48,29,19
3945,Win,hellscream,1809,druid,balance,48,25,23
3946,Ferawri,draenor,1808,druid,balance,42,24,18
3947,Icek,outland,1806,druid,balance,54,33,21
3948,Fiskmåsn,twisting-nether,1806,druid,balance,119,69,50
3949,Hunkex,frostmane,1806,druid,balance,45,24,21
3950,Cøntrol,argent-dawn,1804,druid,balance,60,34,26
3951,Ruetinjeri,blackmoore,1804,druid,balance,73,38,35
3952,Rexonadudu,kazzak,1803,druid,balance,87,48,39
3953,Izhusky,ravencrest,1802,druid,balance,35,24,11
3954,Disvikz,outland,1801,druid,balance,48,29,19
3955,Geîl,blackrock,1801,druid,balance,42,24,18
3956,Abyssaldepth,ravencrest,1800,druid,balance,54,44,10
3957,Crippaa,tarren-mill,1798,druid,balance,24,19,5
3958,Afret,kazzak,1792,druid,balance,174,89,85
3959,Rootzxx,ravencrest,1788,druid,balance,48,27,21
3960,Atrosity,ravencrest,1786,druid,balance,54,33,21
3961,Trekkertt,zuljin,1784,druid,balance,53,28,25
3962,Jenovas,argent-dawn,1778,druid,balance,45,25,20
3963,Mesmerizing,ravencrest,1776,druid,balance,36,23,13
3964,Darktigrou,archimonde,1775,druid,balance,30,21,9
3965,Punxybear,ravencrest,1774,druid,balance,162,81,81
3966,Dyroxs,twisting-nether,1774,druid,balance,77,38,39
3967,Meowcry,outland,1771,druid,balance,54,32,22
3968,Xyzy,burning-legion,1770,druid,balance,66,35,31
3969,Kirexz,blackrock,1767,druid,balance,36,27,9
3970,Käyn,argent-dawn,1767,druid,balance,51,30,21
3971,Ganqb,ravencrest,1767,druid,balance,246,138,108
3972,Shiftowl,tarren-mill,1766,druid,balance,36,25,11
3973,Dizay,xavius,1765,druid,balance,48,32,16
3974,Сосисосочка,gordunni,1763,druid,balance,42,20,22
3975,Babynaty,ravencrest,1756,druid,balance,158,77,81
3976,Hammd,kazzak,1754,druid,balance,44,27,17
3977,Dudukid,nemesis,1753,druid,balance,60,28,32
3978,Pyaw,kazzak,1750,druid,balance,36,26,10
3979,Calê,blackrock,1747,druid,balance,57,39,18
3980,Gehrkehotter,silvermoon,1747,druid,balance,60,41,19
3981,Kørra,dun-modr,1747,druid,balance,55,34,21
3982,Ånaðeårmas,outland,1746,druid,balance,77,47,30
3983,Limme,ravencrest,1741,druid,balance,46,32,14
3984,Meowmf,silvermoon,1739,druid,balance,60,39,21
3985,Сибирячечка,greymane,1736,druid,balance,60,36,24
3986,Connorz,blackmoore,1735,druid,balance,42,25,17
3987,Tobid,blackrock,1732,druid,balance,36,26,10
3988,Credenz,frostmane,1732,druid,balance,72,39,33
3989,Трэйкотик,blackscar,1728,druid,balance,53,32,21
3990,Gulmi,outland,1728,druid,balance,47,28,19
3991,Sylvy,dun-modr,1726,druid,balance,54,31,23
3992,Euphørie,twisting-nether,1723,druid,balance,83,52,31
3993,Pouletqt,archimonde,1723,druid,balance,42,21,21
3994,Hugeragê,stormreaver,1720,druid,balance,47,22,25
3995,Xora,kazzak,1719,druid,balance,59,33,26
3996,Kalgarm,burning-legion,1719,druid,balance,66,29,37
3997,Narq,sylvanas,1718,druid,balance,42,25,17
3998,Qtrly,ravencrest,1718,druid,balance,38,19,19
3999,Quadpulse,ravencrest,1718,druid,balance,36,18,18
4000,Elissian,silvermoon,1717,druid,balance,155,84,71
4001,Pwnylol,teldrassil,1716,druid,balance,64,43,21
4002,Подпивасникх,gordunni,1715,druid,balance,30,20,10
4003,Mendorin,stormrage,1714,druid,balance,42,26,16
4004,Zhof,ravencrest,1713,druid,balance,58,33,25
4005,Jamzydruid,kazzak,1713,druid,balance,54,30,24
4006,Владибой,gordunni,1712,druid,balance,36,18,18
4007,Bulla,culte-de-la-rive-noire,1709,druid,balance,56,33,23
4008,Emmdru,silvermoon,1706,druid,balance,71,42,29
4009,Grisdrood,draenor,1706,druid,balance,143,75,68
4010,Laker,stormscale,1702,druid,balance,58,28,30
4011,Thardruid,stormscale,1699,druid,balance,72,42,30
4012,Htxo,kazzak,1698,druid,balance,30,18,12
4013,Imperiusx,ravencrest,1697,druid,balance,66,38,28
4014,Mdrgtwo,ravencrest,1692,druid,balance,24,18,6
4015,Bøøstèdtréè,ravencrest,1691,druid,balance,42,27,15
4016,Mochiløxz,tarren-mill,1690,druid,balance,50,33,17
4017,Néxct,stormscale,1688,druid,balance,36,22,14
4018,Solariah,garona,1688,druid,balance,125,71,54
4019,Kenzia,stormrage,1687,druid,balance,30,18,12
4020,Rngmåchinéx,ravencrest,1685,druid,balance,85,57,28
4021,Gallokiriko,zuljin,1684,druid,balance,48,23,25
4022,Naturez,sylvanas,1682,druid,balance,60,28,32
4023,Rbgkári,draenor,1681,druid,balance,36,25,11
4024,Zkrd,kazzak,1678,druid,balance,48,25,23
4025,Macron,terokkar,1677,druid,balance,52,30,22
4026,Highonfire,grim-batol,1676,druid,balance,60,41,19
4027,Мэдикейт,soulflayer,1668,druid,balance,54,33,21
4028,Drcaøs,sanguino,1668,druid,balance,84,47,37
4029,Рябчиик,blackscar,1668,druid,balance,89,49,40
4030,Æøøm,blackmoore,1667,druid,balance,65,36,29
4031,Даена,razuvious,1662,druid,balance,24,19,5
4032,Shapeshift,sanguino,1659,druid,balance,62,34,28
4033,Møømøø,tarren-mill,1658,druid,balance,30,18,12
4034,Shaakm,nerathor,1656,druid,balance,54,32,22
4035,Güccïmane,twisting-nether,1655,druid,balance,60,46,14
4036,Jaycutler,archimonde,1655,druid,balance,66,34,32
4037,Zerozerosex,archimonde,1654,druid,balance,48,22,26
4038,Metamoo,tarren-mill,1651,druid,balance,29,24,5
4039,Justyo,archimonde,1648,druid,balance,29,22,7
4040,Flanagàn,hyjal,1647,druid,balance,40,21,19
4041,Hyunâ,dalaran,1644,druid,balance,42,27,15
4042,Øffroadz,blackmoore,1643,druid,balance,30,20,10
4043,Saufeb,stormscale,1643,druid,balance,41,23,18
4044,Pradasurge,ravencrest,1642,druid,balance,149,81,68
4045,Yarinai,blackmoore,1637,druid,balance,54,29,25
4046,Yuhor,outland,1636,druid,balance,77,42,35
4047,Derfaï,kaelthas,1636,druid,balance,41,21,20
4048,Horadruid,silvermoon,1635,druid,balance,145,86,59
4049,Deví,twilights-hammer,1634,druid,balance,48,30,18
4050,Naturalbeef,argent-dawn,1634,druid,balance,40,22,18
4051,Cyriaan,eredar,1634,druid,balance,69,37,32
4052,Settembre,ragnaros,1633,druid,balance,33,22,11
4053,Damigjat,sylvanas,1631,druid,balance,125,78,47
4054,Rekked,alleria,1631,druid,balance,42,23,19
4055,Masakrelol,sanguino,1631,druid,balance,36,18,18
4056,Squirtdogx,drakthul,1630,druid,balance,30,17,13
4057,Миртлэкшн,gordunni,1628,druid,balance,43,22,21
4058,Èøèøèøèøè,stormscale,1627,druid,balance,18,17,1
4059,Scaleo,stormreaver,1627,druid,balance,42,19,23
4060,Онличикен,gordunni,1625,druid,balance,84,39,45
4061,Mäismz,hyjal,1624,druid,balance,42,29,13
4062,Çhîñêséðrüîð,kazzak,1623,druid,balance,36,21,15
4063,Лсдспайсы,soulflayer,1623,druid,balance,36,21,15
4064,Dreathqt,twisting-nether,1621,druid,balance,60,24,36
4065,Moonzysunzy,sylvanas,1620,druid,balance,30,17,13
4066,Landesverrat,kazzak,1619,druid,balance,24,21,3
4067,Nastyclones,kazzak,1619,druid,balance,24,17,7
4068,Amoveo,argent-dawn,1619,druid,balance,39,25,14
4069,Whisker,outland,1618,druid,balance,24,17,7
4070,Zapx,hyjal,1618,druid,balance,42,25,17
4071,Linkin,azshara,1618,druid,balance,60,29,31
4072,Ícekiss,hyjal,1617,druid,balance,30,24,6
4073,Hotlife,ravencrest,1614,druid,balance,37,22,15
4074,Dràkàn,dethecus,1613,druid,balance,30,17,13
4075,Exilara,twisting-nether,1612,druid,balance,61,38,23
4076,Cptnclone,blackmoore,1612,druid,balance,54,27,27
4077,Pëchy,aggra-português,1611,druid,balance,48,30,18
4078,Xenuss,kazzak,1611,druid,balance,36,22,14
4079,Trinket,frostmane,1610,druid,balance,30,23,7
4080,Аласторвов,deathweaver,1610,druid,balance,60,28,32
4081,Deadmeøw,outland,1609,druid,balance,34,21,13
4082,Större,twisting-nether,1607,druid,balance,42,28,14
4083,Píøøx,tarren-mill,1607,druid,balance,48,31,17
4084,Slahnesh,aegwynn,1607,druid,balance,36,20,16
4085,Ryng,nagrand,1606,druid,balance,60,41,19
4086,Porzi,eredar,1606,druid,balance,66,41,25
4087,Teaser,dun-modr,1606,druid,balance,48,26,22
4088,Scamlafsen,ragnaros,1606,druid,balance,42,22,20
4089,Ахисса,gordunni,1606,druid,balance,36,17,19
4090,Угощаюх,howling-fjord,1604,druid,balance,24,17,7
4091,Gudñ,tarren-mill,1603,druid,balance,35,19,16
4092,Kkona,silvermoon,1603,druid,balance,59,31,28
4093,Goom,rexxar,1602,druid,balance,168,101,67
4094,Rá,outland,1599,druid,balance,28,21,7
4095,Esrín,the-maelstrom,1599,druid,balance,54,28,26
4096,Algír,argent-dawn,1599,druid,balance,95,49,46
4097,Ahuevshiy,wildhammer,1597,druid,balance,30,21,9
4098,Bigtouch,draenor,1597,druid,balance,54,31,23
4099,Eärendir,ravencrest,1595,druid,balance,84,47,37
4100,Malfurien,magtheridon,1593,druid,balance,30,17,13
4101,Uglyrasputin,blackmoore,1590,druid,balance,101,54,47
4102,Saltymoo,tarren-mill,1589,druid,balance,41,24,17
4103,Ôp,aegwynn,1589,druid,balance,65,31,34
4104,Veyronn,burning-legion,1586,druid,balance,48,25,23
4105,Iamobito,blackmoore,1582,druid,balance,30,18,12
4106,Kokslina,sylvanas,1580,druid,balance,35,17,18
4107,Xä,bloodscalp,1576,druid,balance,142,77,65
4108,Isylia,twisting-nether,1576,druid,balance,66,32,34
4109,Sadgeconvoke,draenor,1575,druid,balance,47,33,14
4110,Merawr,ravencrest,1573,druid,balance,129,66,63
4111,Pneuma,xavius,1571,druid,balance,57,31,26
4112,Malvakten,kazzak,1570,druid,balance,110,51,59
4113,Stinkyicky,sylvanas,1569,druid,balance,36,25,11
4114,Bôoze,nathrezim,1569,druid,balance,36,19,17
4115,Kaïnak,dalaran,1567,druid,balance,30,17,13
4116,Obsessíon,kazzak,1566,druid,balance,30,17,13
4117,Balanc,ragnaros,1563,druid,balance,59,31,28
4118,Oommis,outland,1562,druid,balance,30,18,12
4119,Izzi,arathor,1562,druid,balance,48,28,20
4120,Shreedex,blackmoore,1561,druid,balance,24,18,6
4121,Elodìa,antonidas,1561,druid,balance,30,21,9
4122,Starcrash,amanthul,1559,druid,balance,60,28,32
4123,Ittei,korgall,1558,druid,balance,30,19,11
4124,Rode,magtheridon,1556,druid,balance,105,61,44
4125,Каралесер,gordunni,1555,druid,balance,53,29,24
4126,Taylorshîft,burning-legion,1553,druid,balance,42,18,24
4127,Däkk,draenor,1551,druid,balance,48,24,24
4128,Баттнэйкед,gordunni,1551,druid,balance,83,41,42
4129,Cantdonothig,ravencrest,1550,druid,balance,90,50,40
4130,Зетзул,grom,1550,druid,balance,119,59,60
4131,Wildmistake,argent-dawn,1550,druid,balance,35,17,18
4132,Fantomasik,drakthul,1546,druid,balance,66,28,38
4133,Frikolina,outland,1542,druid,balance,48,24,24
4134,Bobcup,tarren-mill,1540,druid,balance,42,24,18
4135,Milkywáys,draenor,1539,druid,balance,66,32,34
4136,Lazerbinks,blackmoore,1536,druid,balance,29,18,11
4137,Druidflight,ravencrest,1534,druid,balance,48,24,24
4138,Leathy,eredar,1531,druid,balance,48,29,19
4139,Hashishi,grim-batol,1531,druid,balance,30,18,12
4140,Starcowx,ragnaros,1530,druid,balance,33,18,15
4141,Majokz,ravencrest,1529,druid,balance,70,34,36
4142,Ljóskan,kazzak,1528,druid,balance,36,16,20
4143,Tárzáñ,ravencrest,1525,druid,balance,24,16,8
4144,Lisbethqt,nemesis,1523,druid,balance,24,16,8
4145,Chansnax,thrall,1519,druid,balance,52,29,23
4146,Exca,stormscale,1519,druid,balance,54,28,26
4147,Neverpanic,stormscale,1518,druid,balance,24,16,8
4148,Brainjuice,blackrock,1517,druid,balance,30,16,14
4149,Døttore,garona,1517,druid,balance,80,38,42
4150,Ðelix,ysera,1516,druid,balance,44,27,17
4151,Kåmen,ravenholdt,1516,druid,balance,67,37,30
4152,Муниня,gordunni,1515,druid,balance,48,27,21
4153,Dabudi,kazzak,1513,druid,balance,51,31,20
4154,Youngdinozzo,dalaran,1512,druid,balance,24,16,8
4155,Cowgurl,stormscale,1511,druid,balance,30,16,14
4156,Мунстрайк,borean-tundra,1505,druid,balance,23,16,7
4157,Gurudru,tarren-mill,1505,druid,balance,96,41,55
4158,Suevlaki,ragnaros,1502,druid,balance,79,48,31
4159,Sweetner,outland,1501,druid,balance,34,23,11
4160,Kabuul,dun-modr,1498,druid,balance,37,25,12
4161,Trylune,blackmoore,1498,druid,balance,30,17,13
4162,Thcpositiv,aegwynn,1496,druid,balance,42,16,26
4163,Гнетея,howling-fjord,1494,druid,balance,47,27,20
4164,Бамболони,gordunni,1488,druid,balance,45,30,15
4165,Dematos,forscherliga,1487,druid,balance,78,46,32
4166,Quorn,pozzo-delleternità,1487,druid,balance,58,27,31
4167,Arkatt,outland,1482,druid,balance,36,24,12
4168,Mahist,archimonde,1478,druid,balance,36,23,13
4169,Demonbalance,silvermoon,1477,druid,balance,52,33,19
4170,Kolt,rajaxx,1468,druid,balance,57,29,28
4171,Monkeynight,ambossar,1462,druid,balance,29,16,13
4172,Strinx,ragnaros,1461,druid,balance,48,35,13
4173,Мантоя,gordunni,1461,druid,balance,35,22,13
4174,Hotsincee,stormscale,1461,druid,balance,29,16,13
4175,Meatwallet,defias-brotherhood,1460,druid,balance,41,24,17
4176,Primdâhl,ravencrest,1458,druid,balance,36,19,17
4177,Drøøkîé,antonidas,1453,druid,balance,48,31,17
4178,Moffwastaken,kazzak,1453,druid,balance,42,17,25
4179,Opla,nethersturm,1452,druid,balance,28,18,10
4180,Séxycàt,ravencrest,1451,druid,balance,63,33,30
4181,Aègon,ravencrest,1450,druid,balance,67,37,30
4182,Brandyballix,twisting-nether,1450,druid,balance,47,21,26
4183,Pyqmi,stormscale,1448,druid,balance,24,17,7
4184,Aik,gorgonnash,1448,druid,balance,60,30,30
4185,Viverion,ravencrest,1445,druid,balance,36,19,17
4186,Tawaraki,outland,1444,druid,balance,156,84,72
4187,Pø,blackrock,1443,druid,balance,53,26,27
4188,Duridlol,nemesis,1439,druid,balance,18,15,3
4189,Ðiàblos,nemesis,1439,druid,balance,48,32,16
4190,Lappe,stormreaver,1439,druid,balance,30,15,15
4191,Ferraridudux,ravencrest,1437,druid,balance,18,15,3
4192,Bîjaqt,blackmoore,1437,druid,balance,24,15,9
4193,Nassii,antonidas,1435,druid,balance,54,31,23
4194,Stepgødx,twisting-nether,1435,druid,balance,30,15,15
4195,Shakso,stormscale,1434,druid,balance,24,15,9
4196,Øhmygød,stormscale,1433,druid,balance,30,15,15
4197,Restromide,ravencrest,1432,druid,balance,30,15,15
4198,Sodapop,aszune,1431,druid,balance,36,23,13
4199,Tonutc,sanguino,1430,druid,balance,51,25,26
4200,Ibnform,archimonde,1429,druid,balance,18,15,3
4201,Cmfg,blackrock,1429,druid,balance,21,16,5
4202,Magiskeforme,draenor,1429,druid,balance,24,17,7
4203,Hilom,grim-batol,1429,druid,balance,24,15,9
4204,Ziele,the-maelstrom,1427,druid,balance,28,17,11
4205,Potatodru,ragnaros,1425,druid,balance,24,15,9
4206,Seudoz,silvermoon,1425,druid,balance,36,21,15
4207,Rilak,nordrassil,1424,druid,balance,30,18,12
4208,Anabola,frostwhisper,1423,druid,balance,24,15,9
4209,Inghlo,blackmoore,1423,druid,balance,47,26,21
4210,Tâliah,silvermoon,1422,druid,balance,24,15,9
4211,Petiteorange,archimonde,1420,druid,balance,24,16,8
4212,Guthíx,silvermoon,1420,druid,balance,36,16,20
4213,Fransman,sylvanas,1419,druid,balance,41,19,22
4214,Kanataka,stormscale,1418,druid,balance,42,26,16
4215,Møønhorn,nemesis,1416,druid,balance,62,29,33
4216,Hypam,archimonde,1413,druid,balance,42,19,23
4217,Ххансолл,gordunni,1411,druid,balance,54,35,19
4218,Mogi,pozzo-delleternità,1411,druid,balance,69,32,37
4219,Sefinana,malganis,1411,druid,balance,81,33,48
4220,Ðrpressure,blackrock,1409,druid,balance,48,33,15
4221,Insølitø,sanguino,1406,druid,balance,51,27,24
4222,Leqt,ravencrest,1406,druid,balance,30,15,15
4223,Fruitdealer,antonidas,1404,druid,balance,36,20,16
4224,Neova,dun-modr,1400,druid,balance,39,21,18
4225,Carismatic,blackmoore,1400,druid,balance,97,48,49
4226,Vaizier,defias-brotherhood,1400,druid,balance,40,18,22
4227,Asterism,stormscale,1399,druid,balance,81,45,36
4228,Boomalot,auchindoun,1399,druid,balance,48,25,23
4229,Chrevarraige,saurfang,1394,druid,balance,54,31,23
4230,Nujus,kazzak,1394,druid,balance,30,15,15
4231,Spaceshift,magtheridon,1390,druid,balance,39,22,17
4232,Blackfür,sylvanas,1390,druid,balance,56,22,34
4233,Cupoftea,drakthul,1384,druid,balance,51,27,24
4234,Dudana,argent-dawn,1380,druid,balance,30,18,12
4235,Rédbull,outland,1379,druid,balance,70,36,34
4236,Bløødax,hyjal,1372,druid,balance,130,63,67
4237,Hackamore,archimonde,1371,druid,balance,36,16,20
4238,Darksbear,draenor,1368,druid,balance,24,16,8
4239,Pøpp,archimonde,1367,druid,balance,23,15,8
4240,Niul,aegwynn,1366,druid,balance,68,35,33
4241,Frodds,grim-batol,1363,druid,balance,18,16,2
4242,Heanra,frostmane,1363,druid,balance,35,22,13
4243,Irishdemón,ravencrest,1357,druid,balance,54,29,25
4244,Джоннчек,gordunni,1355,druid,balance,28,19,9
4245,Yiradur,stormscale,1355,druid,balance,38,18,20
4246,Andreud,dunemaul,1354,druid,balance,35,15,20
4247,Кекичшрекич,soulflayer,1349,druid,balance,42,20,22
4248,Bum,ravencrest,1344,druid,balance,18,14,4
4249,Näela,archimonde,1344,druid,balance,24,14,10
4250,Divref,tarren-mill,1343,druid,balance,18,14,4
4251,Boomjutzu,kazzak,1343,druid,balance,24,14,10
4252,Broxisqt,blackrock,1343,druid,balance,24,14,10
4253,Lilpumpz,outland,1343,druid,balance,24,14,10
4254,Bittebads,stormscale,1342,druid,balance,18,14,4
4255,Rosskemp,tarren-mill,1342,druid,balance,18,14,4
4256,Ccoco,aegwynn,1342,druid,balance,18,14,4
4257,Escaa,stormscale,1342,druid,balance,24,14,10
4258,Kabôôm,stormscale,1342,druid,balance,24,14,10
4259,Друлякич,gordunni,1342,druid,balance,24,14,10
4260,Kjøttberit,moonglade,1340,druid,balance,18,14,4
4261,Ravneskrig,ravencrest,1340,druid,balance,18,14,4
4262,Альмазар,lich-king,1339,druid,balance,48,25,23
4263,Fhi,antonidas,1338,druid,balance,30,19,11
4264,Hadoukan,ravencrest,1337,druid,balance,35,21,14
4265,Insanexp,antonidas,1336,druid,balance,18,14,4
4266,Krtt,tarren-mill,1336,druid,balance,58,23,35
4267,Doncy,ragnaros,1333,druid,balance,30,14,16
4268,Soward,la-croisade-écarlate,1331,druid,balance,38,17,21
4269,Droodfarm,hyjal,1328,druid,balance,28,18,10
4270,Hisoca,tarren-mill,1328,druid,balance,49,28,21
4271,Бонони,booty-bay,1328,druid,balance,30,14,16
4272,Wazam,kazzak,1325,druid,balance,26,19,7
4273,Редмун,soulflayer,1325,druid,balance,42,19,23
4274,Rexiehunty,aszune,1320,druid,balance,47,20,27
4275,Farmerone,tarren-mill,1318,druid,balance,30,19,11
4276,Wildthing,blackmoore,1316,druid,balance,44,25,19
4277,Millions,tarren-mill,1312,druid,balance,24,14,10
4278,Czarnykocur,burning-legion,1310,druid,balance,54,28,26
4279,Skywíng,stormscale,1310,druid,balance,30,14,16
4280,Klappskaft,outland,1309,druid,balance,23,14,9
4281,Haginator,twisting-nether,1306,druid,balance,90,43,47
4282,Winarchikxxl,tarren-mill,1306,druid,balance,30,14,16
4283,Zømßie,outland,1306,druid,balance,38,16,22
4284,Solarian,ravencrest,1304,druid,balance,42,26,16
4285,Adizero,blackrock,1303,druid,balance,25,15,10
4286,Asinistar,ravencrest,1303,druid,balance,26,15,11
4287,Madhatterr,kazzak,1302,druid,balance,24,14,10
4288,Twitchmoney,archimonde,1301,druid,balance,20,15,5
4289,Hardí,tarren-mill,1295,druid,balance,54,26,28
4290,Santoniq,dun-morogh,1295,druid,balance,72,32,40
4291,Callmev,hyjal,1294,druid,balance,18,14,4
4292,Quiksx,blackrock,1286,druid,balance,43,20,23
4293,Xclonedotcom,aegwynn,1283,druid,balance,24,16,8
4294,Convokeboost,archimonde,1273,druid,balance,47,32,15
4295,Meezy,ragnaros,1273,druid,balance,30,15,15
4296,Àsúnâ,eredar,1272,druid,balance,42,15,27
4297,Rektjin,stormscale,1266,druid,balance,36,15,21
4298,Druidere,outland,1262,druid,balance,54,23,31
4299,Zeifana,khaz-modan,1260,druid,balance,24,15,9
4300,Ilovedruid,forscherliga,1259,druid,balance,34,15,19
4301,Fillet,aggra-português,1257,druid,balance,20,15,5
4302,Wildanomaly,argent-dawn,1256,druid,balance,28,14,14
4303,Medreas,argent-dawn,1253,druid,balance,65,43,22
4304,Starsy,frostmane,1248,druid,balance,24,13,11
4305,Superchïcken,archimonde,1247,druid,balance,24,13,11
4306,Legitx,dentarg,1246,druid,balance,18,13,5
4307,Sheâ,nemesis,1246,druid,balance,67,34,33
4308,Вбг,soulflayer,1245,druid,balance,24,13,11
4309,Hotdóts,outland,1244,druid,balance,18,13,5
4310,Eranor,archimonde,1243,druid,balance,18,13,5
4311,Kroaxs,draenor,1243,druid,balance,30,16,14
4312,Smittly,bloodhoof,1243,druid,balance,36,17,19
4313,Kittyboomy,burning-blade,1242,druid,balance,63,30,33
4314,Шадарлогот,gordunni,1240,druid,balance,78,44,34
4315,Kubzii,archimonde,1239,druid,balance,24,13,11
4316,Hirmo,ragnaros,1238,druid,balance,24,13,11
4317,Mayhh,ragnaros,1236,druid,balance,49,28,21
4318,Cptsponksa,tarren-mill,1235,druid,balance,24,13,11
4319,Halouest,archimonde,1234,druid,balance,24,13,11
4320,Матумбо,razuvious,1233,druid,balance,156,75,81
4321,Мунмунмун,gordunni,1229,druid,balance,43,19,24
4322,Chillerin,draenor,1228,druid,balance,24,13,11
4323,Psycloniac,ravencrest,1228,druid,balance,24,13,11
4324,Limmiited,ravencrest,1228,druid,balance,30,16,14
4325,Vrill,kazzak,1228,druid,balance,75,38,37
4326,Oxox,defias-brotherhood,1227,druid,balance,24,14,10
4327,Melyo,blackmoore,1227,druid,balance,30,17,13
4328,Druiddamage,the-maelstrom,1227,druid,balance,126,63,63
4329,Slurmms,sylvanas,1220,druid,balance,102,62,40
4330,Слоич,howling-fjord,1220,druid,balance,33,15,18
4331,Àlec,silvermoon,1217,druid,balance,114,61,53
4332,Pvekek,stormscale,1211,druid,balance,20,14,6
4333,Cagaboliches,sanguino,1208,druid,balance,30,14,16
4334,Eliaster,ysondre,1204,druid,balance,30,18,12
4335,Pultsarí,tarren-mill,1199,druid,balance,21,13,8
4336,Tzeeni,stormscale,1198,druid,balance,17,13,4
4337,Jeesman,sylvanas,1198,druid,balance,36,19,17
4338,Shåmssz,kazzak,1194,druid,balance,20,15,5
4339,Itadorikun,silvermoon,1186,druid,balance,24,13,11
4340,Киллиманжаро,howling-fjord,1186,druid,balance,74,32,42
4341,Chulainn,sylvanas,1181,druid,balance,24,18,6
4342,Fantaclause,tarren-mill,1180,druid,balance,72,32,40
4343,Avior,eonar,1178,druid,balance,47,14,33
4344,Farodiin,blackmoore,1177,druid,balance,48,18,30
4345,Rullader,draenor,1176,druid,balance,24,15,9
4346,Forestrun,sylvanas,1174,druid,balance,30,17,13
4347,Maelinou,archimonde,1168,druid,balance,36,19,17
4348,Дайтеполено,howling-fjord,1166,druid,balance,42,18,24
4349,Стампид,blackscar,1164,druid,balance,35,15,20
4350,Bearcosby,burning-legion,1160,druid,balance,23,13,10
4351,Gnotten,thunderhorn,1154,druid,balance,23,13,10
4352,Feelstreeman,twisting-nether,1152,druid,balance,18,12,6
4353,Boomky,blackmoore,1152,druid,balance,24,12,12
4354,Minado,outland,1151,druid,balance,12,12,0
4355,Eôxxd,blackrock,1151,druid,balance,18,12,6
4356,Âlhajillo,dun-modr,1151,druid,balance,24,12,12
4357,Øwlkin,ravencrest,1151,druid,balance,24,12,12
4358,Bigbaddream,stormscale,1150,druid,balance,18,12,6
4359,Obrys,tarren-mill,1150,druid,balance,24,12,12
4360,Owenwilson,twisting-nether,1149,druid,balance,18,12,6
4361,Бруан,gordunni,1148,druid,balance,35,19,16
4362,Calambius,blackhand,1148,druid,balance,24,12,12
4363,Wolfhealer,blackmoore,1147,druid,balance,30,16,14
4364,Ashär,kirin-tor,1146,druid,balance,75,33,42
4365,Урркке,soulflayer,1145,druid,balance,18,12,6
4366,Lillevän,tarren-mill,1145,druid,balance,24,12,12
4367,Ðoxi,draenor,1145,druid,balance,84,37,47
4368,Лёхалепеха,gordunni,1144,druid,balance,24,12,12
4369,Hollymedx,blackmoore,1143,druid,balance,21,13,8
4370,Maaw,tarren-mill,1142,druid,balance,24,12,12
4371,Requinymph,ravencrest,1141,druid,balance,24,12,12
4372,Loriann,twisting-nether,1141,druid,balance,75,36,39
4373,Pavesino,nemesis,1140,druid,balance,18,12,6
4374,Shiotake,hyjal,1139,druid,balance,24,12,12
4375,Mascraxx,earthen-ring,1137,druid,balance,43,19,24
4376,Tankis,dalaran,1132,druid,balance,39,25,14
4377,Velnens,shattered-halls,1128,druid,balance,30,12,18
4378,Deblin,ragnaros,1119,druid,balance,29,16,13
4379,Scottparker,sylvanas,1115,druid,balance,18,12,6
4380,Braokhull,stormscale,1111,druid,balance,30,14,16
4381,Morlas,kazzak,1111,druid,balance,50,22,28
4382,Hightotem,hakkar,1104,druid,balance,29,16,13
4383,Durkdriven,kazzak,1100,druid,balance,27,12,15
4384,Vaacku,stormreaver,1082,druid,balance,22,12,10
4385,Søfiaa,argent-dawn,1074,druid,balance,59,34,25
4386,Мутаборец,howling-fjord,1071,druid,balance,18,12,6
4387,Buckshee,doomhammer,1066,druid,balance,47,25,22
4388,Whiskers,emerald-dream,1066,druid,balance,25,12,13
4389,Cubir,turalyon,1065,druid,balance,23,12,11
4390,Exiztenz,deathwing,1062,druid,balance,36,18,18
4391,Tjoepert,azjolnerub,1061,druid,balance,60,20,40
4392,Jazzme,aegwynn,1056,druid,balance,18,11,7
4393,Drmoe,blackmoore,1055,druid,balance,15,12,3
4394,Huxleyys,draenor,1055,druid,balance,18,11,7
4395,Tuttu,kazzak,1055,druid,balance,18,11,7
4396,Buckmysallz,archimonde,1055,druid,balance,18,11,7
4397,Shiffe,argent-dawn,1055,druid,balance,18,11,7
4398,Stb,outland,1055,druid,balance,18,11,7
4399,Druidka,grim-batol,1053,druid,balance,18,11,7
4400,Diggear,doomhammer,1052,druid,balance,18,11,7
4401,Drutiful,outland,1052,druid,balance,24,11,13
4402,Egirlqtxoxo,stormscale,1051,druid,balance,18,11,7
4403,Bashfui,draenor,1050,druid,balance,18,11,7
4404,Aimwaré,ravencrest,1050,druid,balance,24,11,13
4405,Couleaf,stormscale,1049,druid,balance,13,11,2
4406,Soguu,thrall,1049,druid,balance,18,11,7
4407,Deadmorph,ysondre,1049,druid,balance,24,11,13
4408,Skyphi,silvermoon,1048,druid,balance,18,11,7
4409,Pfandmalle,blackrock,1046,druid,balance,18,11,7
4410,Seboom,outland,1045,druid,balance,18,11,7
4411,Tchoubouléru,throkferoth,1045,druid,balance,36,13,23
4412,Rorugo,sanguino,1044,druid,balance,18,11,7
4413,Chúcky,twisting-nether,1044,druid,balance,21,12,9
4414,Hárty,tarren-mill,1035,druid,balance,24,11,13
4415,Anerol,arthas,1031,druid,balance,36,19,17
4416,Diepauline,aegwynn,1030,druid,balance,42,22,20
4417,Ronî,arthas,1028,druid,balance,30,11,19
4418,Exactt,blackrock,1028,druid,balance,30,11,19
4419,Smexim,dalaran,1026,druid,balance,47,25,22
4420,Храш,gordunni,1022,druid,balance,17,11,6
4421,Malammore,burning-legion,1018,druid,balance,18,14,4
4422,Darisom,alexstrasza,1015,druid,balance,117,64,53
4423,Bullmarkets,kazzak,1013,druid,balance,24,12,12
4424,ßalmain,nethersturm,1013,druid,balance,24,11,13
4425,Медведяра,howling-fjord,1009,druid,balance,33,15,18
4426,Shàal,ysondre,1006,druid,balance,17,11,6
4427,Кашаган,howling-fjord,998,druid,balance,21,11,10
4428,Ледруд,gordunni,991,druid,balance,26,11,15
4429,Skvll,silvermoon,987,druid,balance,26,11,15
4430,Bulvai,medivh,979,druid,balance,14,11,3
4431,Amalou,ravencrest,978,druid,balance,24,11,13
4432,Воому,soulflayer,960,druid,balance,12,10,2
4433,Rozi,draenor,960,druid,balance,18,10,8
4434,Björnskift,tarren-mill,960,druid,balance,18,10,8
4435,Ymagyne,frostmane,960,druid,balance,18,10,8
4436,Djfukface,ravencrest,960,druid,balance,18,10,8
4437,Хальтенис,gordunni,960,druid,balance,18,10,8
4438,Feralisser,ravencrest,959,druid,balance,12,10,2
4439,Drooshy,ravencrest,959,druid,balance,15,11,4
4440,Tiktokstar,blackrock,959,druid,balance,18,10,8
4441,Сансплэш,lich-king,958,druid,balance,12,10,2
4442,Thepuma,dun-modr,958,druid,balance,12,10,2
4443,Pèps,dalaran,958,druid,balance,18,10,8
4444,Élán,sylvanas,958,druid,balance,18,10,8
4445,Verenai,bloodfeather,957,druid,balance,12,10,2
4446,Buhuu,blackmoore,957,druid,balance,18,10,8
4447,Gbq,ravencrest,957,druid,balance,18,10,8
4448,Andjuga,doomhammer,957,druid,balance,24,10,14
4449,Brokul,kazzak,957,druid,balance,24,10,14
4450,Restouz,twisting-nether,956,druid,balance,24,10,14
4451,Sajlol,doomhammer,955,druid,balance,18,10,8
4452,Nøny,gorgonnash,955,druid,balance,18,10,8
4453,Seysso,silvermoon,955,druid,balance,24,10,14
4454,Gluqt,outland,953,druid,balance,18,10,8
4455,Bolskigg,stormreaver,953,druid,balance,24,10,14
4456,Оудин,blackscar,952,druid,balance,18,10,8
4457,Rasgath,kazzak,952,druid,balance,18,10,8
4458,Hypnosoad,outland,951,druid,balance,24,10,14
4459,Cöyote,hyjal,948,druid,balance,42,23,19
4460,Yepnesse,khaz-modan,946,druid,balance,18,10,8
4461,Certton,arakarahm,943,druid,balance,24,10,14
4462,Resthunor,draenor,935,druid,balance,18,10,8
4463,Calistane,silvermoon,935,druid,balance,36,11,25
4464,Лякокля,soulflayer,933,druid,balance,24,10,14
4465,Naone,silvermoon,929,druid,balance,24,10,14
4466,Kotomer,defias-brotherhood,926,druid,balance,108,38,70
4467,Mööñ,hyjal,917,druid,balance,16,11,5
4468,Suitti,ravencrest,910,druid,balance,17,10,7
4469,Ryuzu,aegwynn,910,druid,balance,17,10,7
4470,Суггуторр,howling-fjord,909,druid,balance,87,42,45
4471,Kakaiy,shadowsong,908,druid,balance,18,11,7
4472,Melyssea,argent-dawn,905,druid,balance,21,11,10
4473,Dudukush,eredar,876,druid,balance,31,11,20
4474,Juvencus,twisting-nether,864,druid,balance,12,9,3
4475,Bakkú,ravencrest,864,druid,balance,12,9,3
4476,Troc,karazhan,864,druid,balance,12,9,3
4477,Jøkèr,outland,864,druid,balance,18,9,9
4478,Blanoz,ravencrest,864,druid,balance,24,9,15
4479,Tronchetto,nemesis,864,druid,balance,24,9,15
4480,Merq,ravencrest,863,druid,balance,12,9,3
4481,Aolynk,twisting-nether,863,druid,balance,12,9,3
4482,Pezuñera,sanguino,863,druid,balance,12,9,3
4483,Kénshin,blackhand,863,druid,balance,12,9,3
4484,Meuhtéki,hyjal,863,druid,balance,12,9,3
4485,Dantet,the-maelstrom,863,druid,balance,18,9,9
4486,Croquetoro,sanguino,863,druid,balance,18,9,9
4487,Empi,sanguino,863,druid,balance,18,9,9
4488,Bxxmkin,draenor,862,druid,balance,12,9,3
4489,Gstahr,taerar,862,druid,balance,18,9,9
4490,Angharradh,arthas,862,druid,balance,18,9,9
4491,Mindruid,kazzak,862,druid,balance,18,9,9
4492,Metaboss,ravencrest,862,druid,balance,18,9,9
4493,Carebearlol,frostmane,862,druid,balance,24,9,15
4494,Амахасла,deathweaver,861,druid,balance,12,9,3
4495,Fruntimmern,sylvanas,861,druid,balance,18,9,9
4496,Астраджет,gordunni,860,druid,balance,18,9,9
4497,Hushorde,twisting-nether,860,druid,balance,30,9,21
4498,Corias,blackmoore,859,druid,balance,24,9,15
4499,Megaball,sylvanas,857,druid,balance,12,9,3
4500,Lunably,silvermoon,855,druid,balance,18,9,9
4501,Happysw,thrall,853,druid,balance,32,9,23
4502,Tombenuit,tarren-mill,843,druid,balance,18,9,9
4503,Rockymarci,dalaran,840,druid,balance,12,9,3
4504,Pretender,arathi,829,druid,balance,22,9,13
4505,Corrupthz,outland,814,druid,balance,11,9,2
4506,Dotclass,outland,799,druid,balance,14,9,5
4507,Théodên,dalaran,784,druid,balance,98,41,57
4508,Rifthy,nemesis,768,druid,balance,12,8,4
4509,Kribie,aegwynn,768,druid,balance,12,8,4
4510,Kbdd,outland,768,druid,balance,12,8,4
4511,Kissaey,emeriss,768,druid,balance,12,8,4
4512,Aleza,tarren-mill,768,druid,balance,12,8,4
4513,Celtimi,antonidas,768,druid,balance,12,8,4
4514,Jometatile,hyjal,768,druid,balance,12,8,4
4515,Citróne,blackrock,768,druid,balance,12,8,4
4516,Клыкояр,goldrinn,768,druid,balance,12,8,4
4517,Ðíør,ravencrest,768,druid,balance,12,8,4
4518,Pjuske,silvermoon,768,druid,balance,12,8,4
4519,Àspro,hyjal,768,druid,balance,12,8,4
4520,Ylmh,archimonde,768,druid,balance,12,8,4
4521,Elgatos,kazzak,768,druid,balance,12,8,4
4522,Boompjeh,chamber-of-aspects,768,druid,balance,18,8,10
4523,Shroomdoom,ravencrest,768,druid,balance,18,8,10
4524,Numberonebs,silvermoon,767,druid,balance,12,8,4
4525,Sagezza,draenor,767,druid,balance,12,8,4
4526,Кортанус,gordunni,767,druid,balance,12,8,4
4527,Goüsta,archimonde,767,druid,balance,12,8,4
4528,Ábomínatíon,draenor,767,druid,balance,12,8,4
4529,Sylindra,argent-dawn,767,druid,balance,18,8,10
4530,Zoxen,nefarian,767,druid,balance,18,8,10
4531,Ilovehannah,laughing-skull,767,druid,balance,18,8,10
4532,Loswochos,blackmoore,767,druid,balance,18,8,10
4533,Drazefin,twisting-nether,767,druid,balance,24,8,16
4534,When,kirin-tor,765,druid,balance,18,8,10
4535,Machie,argent-dawn,765,druid,balance,18,8,10
4536,Сейтил,deathguard,764,druid,balance,18,8,10
4537,Druice,tyrande,763,druid,balance,12,8,4
4538,Кулунхе,soulflayer,763,druid,balance,12,8,4
4539,Altix,blackmoore,763,druid,balance,12,8,4
4540,Nømat,defias-brotherhood,763,druid,balance,12,8,4
4541,Orchard,silvermoon,762,druid,balance,12,8,4
4542,Laiquaril,ravencrest,762,druid,balance,25,8,17
4543,Sároman,ravencrest,761,druid,balance,24,8,16
4544,Fakers,the-maelstrom,747,druid,balance,12,8,4
4545,Aggibääm,blackhand,724,druid,balance,18,8,10
4546,Maw,hellfire,717,druid,balance,11,8,3
4547,Rønièl,tarren-mill,702,druid,balance,11,8,3
4548,Papalegba,kilrogg,700,druid,balance,14,8,6
4549,Mazalot,kazzak,687,druid,balance,13,8,5
4550,Epicplays,sylvanas,672,druid,balance,12,7,5
4551,Yungtrappy,stormscale,672,druid,balance,12,7,5
4552,Trønchetto,nemesis,672,druid,balance,12,7,5
4553,Амераки,blackscar,672,druid,balance,12,7,5
4554,Svend,kazzak,672,druid,balance,12,7,5
4555,Deeizm,ravencrest,672,druid,balance,12,7,5
4556,Tease,blackrock,672,druid,balance,12,7,5
4557,Surlax,defias-brotherhood,672,druid,balance,12,7,5
4558,Qyoon,argent-dawn,672,druid,balance,12,7,5
4559,Hïrøshïmå,malganis,672,druid,balance,12,7,5
4560,Delarion,nemesis,672,druid,balance,12,7,5
4561,Daÿdream,ravencrest,672,druid,balance,12,7,5
4562,Frenkoz,outland,672,druid,balance,12,7,5
4563,Twerkdabooty,azjolnerub,672,druid,balance,12,7,5
4564,Thornat,chamber-of-aspects,672,druid,balance,12,7,5
4565,Mommymìlkers,archimonde,672,druid,balance,12,7,5
4566,Lilim,culte-de-la-rive-noire,672,druid,balance,12,7,5
4567,Shyngodx,archimonde,672,druid,balance,12,7,5
4568,Glúingél,tarren-mill,672,druid,balance,12,7,5
4569,Criaø,blackrock,672,druid,balance,12,7,5
4570,Hajlol,sylvanas,672,druid,balance,12,7,5
4571,Shapees,sylvanas,672,druid,balance,12,7,5
4572,Mythiaran,argent-dawn,672,druid,balance,12,7,5
4573,Okøë,marécage-de-zangar,672,druid,balance,12,7,5
4574,Sweedrood,hyjal,672,druid,balance,12,7,5
4575,Avimoo,tarren-mill,672,druid,balance,18,7,11
4576,Rivella,blackrock,672,druid,balance,18,7,11
4577,Núri,lordaeron,672,druid,balance,18,7,11
4578,Redyogurt,outland,672,druid,balance,18,7,11
4579,Alamâ,madmortem,672,druid,balance,18,7,11
4580,Schebäb,blackhand,672,druid,balance,18,7,11
4581,Ravenfang,dun-modr,672,druid,balance,18,7,11
4582,Longhornjohn,ragnaros,672,druid,balance,18,7,11
4583,Грандал,howling-fjord,672,druid,balance,18,7,11
4584,Ploho,blackmoore,672,druid,balance,18,7,11
4585,Экстазиус,borean-tundra,672,druid,balance,24,7,17
4586,Thunderzeus,mazrigos,671,druid,balance,12,7,5
4587,Rikayn,tarren-mill,671,druid,balance,12,7,5
4588,Taylorshift,argent-dawn,671,druid,balance,12,7,5
4589,Gorthunx,kazzak,671,druid,balance,12,7,5
4590,Feral,mazrigos,671,druid,balance,12,7,5
4591,Mnqn,ravencrest,671,druid,balance,12,7,5
4592,Spoco,defias-brotherhood,671,druid,balance,12,7,5
4593,Hauntie,kazzak,671,druid,balance,12,7,5
4594,Fesenjon,blackhand,671,druid,balance,18,7,11
4595,Elrroir,dun-modr,671,druid,balance,18,7,11
4596,Shìrò,kelthuzad,671,druid,balance,18,7,11
4597,Muhz,nathrezim,671,druid,balance,18,7,11
4598,Fleq,antonidas,671,druid,balance,18,7,11
4599,Taskingoman,twisting-nether,670,druid,balance,12,7,5
4600,Balzàc,ravencrest,670,druid,balance,12,7,5
4601,Fréki,ravenholdt,670,druid,balance,12,7,5
4602,Challi,nordrassil,669,druid,balance,18,7,11
4603,Sabresheep,twisting-nether,669,druid,balance,24,7,17
4604,Мяурицао,howling-fjord,668,druid,balance,12,7,5
4605,Conn,ravencrest,667,druid,balance,12,7,5
4606,Quoting,ravencrest,655,druid,balance,17,7,10
4607,Tommyruin,the-venture-co,640,druid,balance,16,7,9
4608,Nille,tarren-mill,617,druid,balance,14,8,6
4609,Fuzzylol,haomarush,607,druid,balance,11,7,4
4610,Chadru,magtheridon,607,druid,balance,14,7,7
4611,Bubidiblumdr,twisting-nether,605,druid,balance,16,7,9
4612,Rtfz,ravencrest,591,druid,balance,13,7,6
4613,Grafíx,blackrock,576,druid,balance,6,6,0
4614,Ухухуня,gordunni,576,druid,balance,6,6,0
4615,Ноунэймбич,blackscar,576,druid,balance,6,6,0
4616,Qpoof,sylvanas,576,druid,balance,6,6,0
4617,Mønrøe,ravencrest,576,druid,balance,9,7,2
4618,Saabeq,hyjal,576,druid,balance,12,6,6
4619,Forthis,frostmane,576,druid,balance,12,6,6
4620,Dyuuna,hyjal,576,druid,balance,12,6,6
4621,Nancey,auchindoun,576,druid,balance,12,6,6
4622,Layle,argent-dawn,576,druid,balance,12,6,6
4623,Kamenká,aegwynn,576,druid,balance,12,6,6
4624,Kalthazar,twisting-nether,576,druid,balance,12,6,6
4625,Mentaldead,tarren-mill,576,druid,balance,12,6,6
4626,Mikhaili,stormreaver,576,druid,balance,12,6,6
4627,Vulkayn,ysondre,576,druid,balance,12,6,6
4628,Sanaponic,burning-legion,576,druid,balance,12,6,6
4629,Nuggetspøwa,dalaran,576,druid,balance,12,6,6
4630,Зулкхаку,soulflayer,576,druid,balance,12,6,6
4631,Teryx,blackmoore,576,druid,balance,12,6,6
4632,Inbml,silvermoon,576,druid,balance,12,6,6
4633,Pórts,kazzak,576,druid,balance,12,6,6
4634,Shoca,die-ewige-wacht,576,druid,balance,12,6,6
4635,Knozylg,kazzak,576,druid,balance,12,6,6
4636,Friidaf,lightbringer,576,druid,balance,12,6,6
4637,Quinten,ulduar,576,druid,balance,12,6,6
4638,Thefudge,silvermoon,576,druid,balance,12,6,6
4639,Diolives,stormscale,576,druid,balance,12,6,6
4640,Zaoow,stormscale,576,druid,balance,12,6,6
4641,Littlecok,blackmoore,576,druid,balance,12,6,6
4642,Мунпраид,gordunni,576,druid,balance,12,6,6
4643,Elunælle,les-sentinelles,576,druid,balance,12,6,6
4644,Smedoge,outland,576,druid,balance,18,6,12
4645,Elatadru,silvermoon,576,druid,balance,18,6,12
4646,Boomzter,frostmane,576,druid,balance,18,6,12
4647,Fiomy,blackhand,575,druid,balance,6,6,0
4648,Salseo,uldum,575,druid,balance,6,6,0
4649,Ketama,sylvanas,575,druid,balance,12,6,6
4650,Zaratras,arathor,575,druid,balance,12,6,6
4651,Orazien,ravencrest,575,druid,balance,12,6,6
4652,Òniz,hyjal,575,druid,balance,12,6,6
4653,Raxona,blackmoore,575,druid,balance,12,6,6
4654,Crackfat,stormscale,575,druid,balance,12,6,6
4655,Lèafy,silvermoon,575,druid,balance,13,6,7
4656,Lúthiëñ,silvermoon,575,druid,balance,24,6,18
4657,Momaa,neptulon,574,druid,balance,12,6,6
4658,Pôpcorn,ragnaros,574,druid,balance,12,6,6
4659,Жекакотик,eversong,574,druid,balance,24,6,18
4660,Kittasek,drakthul,572,druid,balance,12,6,6
4661,Tarantinonon,kazzak,572,druid,balance,18,6,12
4662,Жибка,howling-fjord,543,druid,balance,14,7,7
4663,Pawel,defias-brotherhood,543,druid,balance,14,7,7
4664,Arecsne,turalyon,543,druid,balance,14,7,7
4665,Abercrombx,thrall,543,druid,balance,14,7,7
4666,Ancientix,burning-legion,543,druid,balance,17,6,11
4667,Ruberg,kazzak,528,druid,balance,9,6,3
4668,Xyiz,ravencrest,528,druid,balance,15,6,9
4669,Humizon,silvermoon,522,druid,balance,15,7,8
4670,Jöggel,perenolde,480,druid,balance,6,5,1
4671,Entas,kazzak,480,druid,balance,6,5,1
4672,Füllxtrap,hyjal,480,druid,balance,6,5,1
4673,Опущеныйкелх,gordunni,480,druid,balance,6,5,1
4674,Corkiy,tarren-mill,480,druid,balance,6,5,1
4675,Smøkyyd,eredar,480,druid,balance,6,5,1
4676,Xoap,kazzak,480,druid,balance,6,5,1
4677,Bambøué,khaz-modan,480,druid,balance,6,5,1
4678,Neufcinqq,archimonde,480,druid,balance,6,5,1
4679,Fabuboomy,blackrock,480,druid,balance,6,5,1
4680,Sebikboomie,ravencrest,480,druid,balance,6,5,1
4681,Everdreamx,arathor,480,druid,balance,6,5,1
4682,Harrydòtter,eredar,480,druid,balance,6,5,1
4683,Eñzo,stormscale,480,druid,balance,6,5,1
4684,Illebra,defias-brotherhood,480,druid,balance,6,5,1
4685,Хлайси,gordunni,480,druid,balance,6,5,1
4686,Светдру,blackscar,480,druid,balance,6,5,1
4687,Yshára,darkmoon-faire,480,druid,balance,6,5,1
4688,Hashtagone,ysondre,480,druid,balance,6,5,1
4689,Pinkpanda,arthas,480,druid,balance,6,5,1
4690,Забурсчу,howling-fjord,480,druid,balance,6,5,1
4691,Kidawi,frostwolf,480,druid,balance,7,5,2
4692,Zomgcow,twisting-nether,480,druid,balance,12,5,7
4693,Pewpewdruid,blackmoore,480,druid,balance,12,5,7
4694,Slâkkxz,kazzak,480,druid,balance,12,5,7
4695,Kørn,drakthul,480,druid,balance,12,5,7
4696,Rbgbear,blackhand,480,druid,balance,12,5,7
4697,Skadruid,blackmoore,480,druid,balance,12,5,7
4698,Jabbah,defias-brotherhood,480,druid,balance,12,5,7
4699,Усыильвиры,soulflayer,480,druid,balance,12,5,7
4700,Goated,stormscale,480,druid,balance,12,5,7
4701,Auches,argent-dawn,480,druid,balance,12,5,7
4702,Superpoulet,archimonde,480,druid,balance,12,5,7
4703,Rwq,outland,480,druid,balance,12,5,7
4704,Pròtodrù,twisting-nether,480,druid,balance,12,5,7
4705,Doup,alakir,480,druid,balance,12,5,7
4706,Yadon,the-maelstrom,480,druid,balance,12,5,7
4707,Felfran,ravencrest,480,druid,balance,12,5,7
4708,Angrykejton,silvermoon,480,druid,balance,12,5,7
4709,Naturina,shattered-hand,480,druid,balance,12,5,7
4710,Elrandir,tarren-mill,480,druid,balance,12,5,7
4711,Duis,twilights-hammer,480,druid,balance,12,5,7
4712,Yabbah,blackrock,480,druid,balance,12,5,7
4713,Bearhúg,kazzak,480,druid,balance,12,5,7
4714,Karodoom,twisting-nether,480,druid,balance,12,5,7
4715,Acwi,dun-morogh,480,druid,balance,12,5,7
4716,Liiandri,khaz-modan,480,druid,balance,12,5,7
4717,Lifecycle,nemesis,480,druid,balance,12,5,7
4718,Qïx,outland,480,druid,balance,15,6,9
4719,Pansarbamse,outland,480,druid,balance,13,5,8
4720,Kunya,tarren-mill,480,druid,balance,18,5,13
4721,Mariss,chogall,479,druid,balance,6,5,1
4722,Forigiver,draenor,479,druid,balance,12,5,7
4723,Elfsu,ravencrest,479,druid,balance,12,5,7
4724,Betol,das-konsortium,479,druid,balance,12,5,7
4725,Storpboom,drakthul,479,druid,balance,12,5,7
4726,Rumjin,burning-blade,479,druid,balance,12,5,7
4727,Hengst,laughing-skull,479,druid,balance,18,5,13
4728,Músclébéach,silvermoon,479,druid,balance,18,5,13
4729,Чепенкос,gordunni,478,druid,balance,12,5,7
4730,Lysende,arathor,478,druid,balance,12,5,7
4731,Барли,grom,478,druid,balance,16,6,10
4732,Wartôn,blackhand,476,druid,balance,16,7,9
4733,Zenkay,naxxramas,476,druid,balance,16,6,10
4734,Iskaarjx,archimonde,463,druid,balance,11,5,6
4735,Zhroomx,blackmoore,463,druid,balance,17,5,12
4736,Chouan,marécage-de-zangar,457,druid,balance,21,7,14
4737,Eloahdruid,blackhand,432,druid,balance,9,5,4
4738,Исмалат,howling-fjord,431,druid,balance,9,5,4
4739,Foxîo,frostmane,415,druid,balance,8,5,3
4740,Weisslogia,aegwynn,400,druid,balance,19,5,14
4741,Hornykarenn,bladefist,384,druid,balance,6,4,2
4742,Duskdawn,xavius,384,druid,balance,6,4,2
4743,Weremyst,outland,384,druid,balance,6,4,2
4744,Malolepszy,burning-legion,384,druid,balance,6,4,2
4745,Dermegon,outland,384,druid,balance,6,4,2
4746,Cpt,xavius,384,druid,balance,6,4,2
4747,Izzyb,draenor,384,druid,balance,6,4,2
4748,Фигарофигаро,gordunni,384,druid,balance,6,4,2
4749,Seasexsune,antonidas,384,druid,balance,6,4,2
4750,Holziger,azshara,384,druid,balance,6,4,2
4751,Айрокси,blackscar,384,druid,balance,6,4,2
4752,Daluria,malganis,384,druid,balance,6,4,2
4753,Bearygrylls,sylvanas,384,druid,balance,6,4,2
4754,Fordragos,ravencrest,384,druid,balance,6,4,2
4755,Fatfingerx,blackrock,384,druid,balance,6,4,2
4756,Ekologiskxx,outland,384,druid,balance,6,4,2
4757,Xvmon,draenor,384,druid,balance,6,4,2
4758,Dremdra,draenor,384,druid,balance,6,4,2
4759,Msb,the-maelstrom,384,druid,balance,6,4,2
4760,Rassia,blackrock,384,druid,balance,6,4,2
4761,Keynn,kazzak,384,druid,balance,6,4,2
4762,Freshpussyz,ravencrest,384,druid,balance,6,4,2
4763,Лолэтохег,soulflayer,384,druid,balance,6,4,2
4764,Benzinoid,silvermoon,384,druid,balance,6,4,2
4765,Хастла,galakrond,384,druid,balance,6,4,2
4766,Borticow,sanguino,384,druid,balance,6,4,2
4767,Jeaylqt,archimonde,384,druid,balance,6,4,2
4768,Sunisan,stormscale,384,druid,balance,6,4,2
4769,Smøuler,sanguino,384,druid,balance,6,4,2
4770,Vertabrain,twilights-hammer,384,druid,balance,6,4,2
4771,Yinx,darksorrow,384,druid,balance,6,4,2
4772,ßoomin,tarren-mill,384,druid,balance,6,4,2
4773,Lolaven,turalyon,384,druid,balance,6,4,2
4774,Bafere,twisting-nether,384,druid,balance,6,4,2
4775,Blazek,sylvanas,384,druid,balance,6,4,2
4776,Drutro,hellfire,384,druid,balance,6,4,2
4777,Moonsama,twisting-nether,384,druid,balance,6,4,2
4778,Lakersinfive,argent-dawn,384,druid,balance,6,4,2
4779,Lasertipu,tarren-mill,384,druid,balance,6,4,2
4780,Kasugia,aegwynn,384,druid,balance,6,4,2
4781,Kattbjörnen,ragnaros,384,druid,balance,6,4,2
4782,Leafsandstuf,ragnaros,384,druid,balance,6,4,2
4783,Найттир,gordunni,384,druid,balance,6,4,2
4784,Rhaf,argent-dawn,384,druid,balance,6,4,2
4785,Shiftmeow,tarren-mill,384,druid,balance,6,4,2
4786,Emochicken,silvermoon,384,druid,balance,9,5,4
4787,Knuffle,eredar,384,druid,balance,8,4,4
4788,Фамай,howling-fjord,384,druid,balance,8,4,4
4789,Stìck,archimonde,384,druid,balance,11,5,6
4790,Achre,thunderhorn,384,druid,balance,12,4,8
4791,Tønychopper,sanguino,384,druid,balance,12,4,8
4792,Sixtyinches,burning-blade,384,druid,balance,12,4,8
4793,Vasilona,sanguino,384,druid,balance,12,4,8
4794,Феразинария,gordunni,384,druid,balance,12,4,8
4795,Astralbody,auchindoun,384,druid,balance,12,4,8
4796,Commonsense,kazzak,384,druid,balance,12,4,8
4797,Ibroninad,ragnaros,384,druid,balance,12,4,8
4798,Ohndankalan,kazzak,384,druid,balance,12,4,8
4799,Ööh,outland,384,druid,balance,12,4,8
4800,Tmhaikyu,blackhand,384,druid,balance,12,4,8
4801,Màlàkaii,hyjal,384,druid,balance,12,4,8
4802,Alanpapi,sanguino,384,druid,balance,12,4,8
4803,Yee,twisting-nether,384,druid,balance,12,4,8
4804,Valijan,blackrock,384,druid,balance,16,5,11
4805,Губкобоб,galakrond,384,druid,balance,16,4,12
4806,Mlyzioz,ahnqiraj,383,druid,balance,6,4,2
4807,Храмульчик,blackscar,383,druid,balance,6,4,2
4808,Mongwau,blackrock,383,druid,balance,6,4,2
4809,Grizzlyhills,silvermoon,383,druid,balance,6,4,2
4810,Moonpouk,archimonde,383,druid,balance,12,4,8
4811,Blablábla,silvermoon,383,druid,balance,12,4,8
4812,Druvian,argent-dawn,383,druid,balance,18,4,14
4813,Katharo,kult-der-verdammten,383,druid,balance,24,4,20
4814,Катафей,deathguard,382,druid,balance,6,4,2
4815,Suranaelle,argent-dawn,369,druid,balance,20,8,12
4816,Ráw,dun-modr,367,druid,balance,11,4,7
4817,Ambracer,silvermoon,366,druid,balance,17,4,13
4818,Ратататата,blackscar,351,druid,balance,8,5,3
4819,Blakemonster,khaz-modan,351,druid,balance,8,5,3
4820,Nightshaðe,argent-dawn,351,druid,balance,11,4,7
4821,Нэйроуз,howling-fjord,351,druid,balance,11,4,7
4822,Zybri,ragnaros,351,druid,balance,11,4,7
4823,Sketit,grim-batol,335,druid,balance,11,4,7
4824,Thaiboimbyy,veknilash,329,druid,balance,15,5,10
4825,Martinesämst,outland,320,druid,balance,10,4,6
4826,Pikamoo,kazzak,319,druid,balance,5,4,1
4827,Ohpfo,outland,319,druid,balance,5,4,1
4828,Imaginarý,ravencrest,319,druid,balance,5,4,1
4829,Holyconvoke,stormscale,319,druid,balance,5,4,1
4830,Eclipße,silvermoon,319,druid,balance,5,4,1
4831,Cryspie,hyjal,288,druid,balance,6,3,3
4832,Uptoyou,defias-brotherhood,288,druid,balance,6,3,3
4833,Barbulloup,hyjal,288,druid,balance,6,3,3
4834,Humanoidpt,aggra-português,288,druid,balance,6,3,3
4835,Hordepwnr,sylvanas,288,druid,balance,6,3,3
4836,Siuo,ravencrest,288,druid,balance,6,3,3
4837,Quinteness,silvermoon,288,druid,balance,6,3,3
4838,Ciwone,blackrock,288,druid,balance,6,3,3
4839,Orangeterror,stormscale,288,druid,balance,6,3,3
4840,Neincat,sylvanas,288,druid,balance,6,3,3
4841,Ullainho,stormscale,288,druid,balance,6,3,3
4842,Хрофт,blackscar,288,druid,balance,6,3,3
4843,Покусаютебя,gordunni,288,druid,balance,6,3,3
4844,Lærken,the-maelstrom,288,druid,balance,6,3,3
4845,Fishe,twisting-nether,288,druid,balance,6,3,3
4846,Illmíndofboo,twisting-nether,288,druid,balance,6,3,3
4847,Applestrudle,blackrock,288,druid,balance,6,3,3
4848,Kooglaash,kazzak,288,druid,balance,6,3,3
4849,Meretrizx,kazzak,288,druid,balance,6,3,3
4850,Aryitu,blackrock,288,druid,balance,6,3,3
4851,Néøu,archimonde,288,druid,balance,6,3,3
4852,Bámbí,sylvanas,288,druid,balance,6,3,3
4853,Flower,aggramar,288,druid,balance,6,3,3
4854,Coogee,malganis,288,druid,balance,6,3,3
4855,Дарзамат,blackscar,288,druid,balance,6,3,3
4856,Tongá,draenor,288,druid,balance,6,3,3
4857,Detü,blackrock,288,druid,balance,6,3,3
4858,Kamatea,eredar,288,druid,balance,6,3,3
4859,Seey,thrall,288,druid,balance,6,3,3
4860,Вооми,gordunni,288,druid,balance,6,3,3
4861,Aetheris,varimathras,288,druid,balance,6,3,3
4862,Srkameltouss,sanguino,288,druid,balance,6,3,3
4863,Зонкс,gordunni,288,druid,balance,6,3,3
4864,Revølter,kazzak,288,druid,balance,6,3,3
4865,Jirenthegrey,antonidas,288,druid,balance,6,3,3
4866,Rbg,dun-modr,288,druid,balance,6,3,3
4867,Junglelist,antonidas,288,druid,balance,6,3,3
4868,Buboss,ravencrest,288,druid,balance,6,3,3
4869,Derie,nazjatar,288,druid,balance,6,3,3
4870,Cörelly,ravencrest,288,druid,balance,6,3,3
4871,Biologie,onyxia,288,druid,balance,6,3,3
4872,Maelkan,sanguino,288,druid,balance,6,3,3
4873,Ilus,outland,288,druid,balance,6,3,3
4874,Катяблум,gordunni,288,druid,balance,6,3,3
4875,Natoro,outland,288,druid,balance,6,3,3
4876,Блиденг,gordunni,288,druid,balance,6,3,3
4877,Islandbôy,blackrock,288,druid,balance,6,3,3
4878,Ishaqu,bladefist,288,druid,balance,12,3,9
4879,Colibrix,ravencrest,288,druid,balance,12,3,9
4880,Kidow,wrathbringer,288,druid,balance,12,3,9
4881,Chavinelf,twisting-nether,288,druid,balance,12,3,9
4882,Crywingz,antonidas,288,druid,balance,12,3,9
4883,Brujo,azjolnerub,288,druid,balance,12,3,9
4884,Likwidator,stormscale,288,druid,balance,12,3,9
4885,Loverace,dun-modr,288,druid,balance,12,3,9
4886,Azurai,blackmoore,288,druid,balance,12,3,9
4887,Thaneo,blackmoore,288,druid,balance,12,3,9
4888,Аматэррасу,blackscar,288,druid,balance,12,3,9
4889,Bigcappa,ahnqiraj,287,druid,balance,6,3,3
4890,Lindémann,blackhand,287,druid,balance,6,3,3
4891,Whythis,archimonde,282,druid,balance,17,6,11
4892,Jhiun,ragnaros,256,druid,balance,4,4,0
4893,Eikthyrson,nozdormu,256,druid,balance,4,4,0
4894,Lxz,blackhand,256,druid,balance,10,3,7
4895,Пушистаялапа,blackscar,255,druid,balance,4,4,0
4896,Ddggss,ragnaros,255,druid,balance,11,3,8
4897,Bóssít,doomhammer,255,druid,balance,11,3,8
4898,Melábufes,dun-modr,208,druid,balance,7,3,4
4899,Beamgødx,thrall,192,druid,balance,4,3,1
4900,Hotributionx,ravencrest,192,druid,balance,6,2,4
4901,Druidbox,ravencrest,192,druid,balance,6,2,4
4902,Spidete,sanguino,192,druid,balance,6,2,4
4903,Hâyâbusa,antonidas,192,druid,balance,6,2,4
4904,Zolduran,archimonde,192,druid,balance,6,2,4
4905,Hilliax,sanguino,192,druid,balance,6,2,4
4906,Kivimon,dun-modr,192,druid,balance,6,2,4
4907,Robinchwän,archimonde,192,druid,balance,6,2,4
4908,Wheyproteín,dun-modr,192,druid,balance,6,2,4
4909,Telbo,ravencrest,192,druid,balance,6,2,4
4910,Noou,aegwynn,192,druid,balance,6,2,4
4911,Baccon,ravencrest,192,druid,balance,6,2,4
4912,Шубаиздуба,howling-fjord,192,druid,balance,6,2,4
4913,Rústy,baelgun,192,druid,balance,6,2,4
4914,Lóvebeam,ravencrest,192,druid,balance,6,2,4
4915,Dresten,burning-blade,192,druid,balance,6,2,4
4916,Uglydruid,drakthul,192,druid,balance,6,2,4
4917,Коктявзер,deathweaver,192,druid,balance,6,2,4
4918,Kasiopee,hyjal,192,druid,balance,6,2,4
4919,Tranduiil,drakthul,192,druid,balance,6,2,4
4920,Tamburoo,tarren-mill,192,druid,balance,6,2,4
4921,Rootbeamftw,ravencrest,192,druid,balance,6,2,4
4922,Akiíra,twisting-nether,192,druid,balance,6,2,4
4923,Fishanchips,archimonde,192,druid,balance,6,2,4
4924,Segundø,archimonde,192,druid,balance,6,2,4
4925,Chzycow,twisting-nether,192,druid,balance,6,2,4
4926,Bigsmoké,die-aldor,192,druid,balance,6,2,4
4927,Kaamirach,blackmoore,192,druid,balance,6,2,4
4928,Старселлер,gordunni,192,druid,balance,6,2,4
4929,Luveena,kazzak,192,druid,balance,6,2,4
4930,Halfaway,ravencrest,192,druid,balance,6,2,4
4931,Nilatsfloda,quelthalas,192,druid,balance,6,2,4
4932,Laødinay,hyjal,192,druid,balance,6,2,4
4933,Athenã,blackmoore,192,druid,balance,6,2,4
4934,Héryse,hyjal,192,druid,balance,6,2,4
4935,Chupapoya,pozzo-delleternità,192,druid,balance,6,2,4
4936,Dingeren,stormscale,192,druid,balance,6,2,4
4937,Chäz,sanguino,192,druid,balance,6,2,4
4938,Emidrem,ravencrest,192,druid,balance,6,2,4
4939,Tadoson,blackmoore,192,druid,balance,6,2,4
4940,Снэйк,borean-tundra,192,druid,balance,6,2,4
4941,Littleneo,ambossar,192,druid,balance,6,2,4
4942,Tallbutshort,stormscale,192,druid,balance,6,2,4
4943,Canezmvp,blackrock,192,druid,balance,6,2,4
4944,Saliencias,kazzak,192,druid,balance,6,2,4
4945,Kheluna,the-maelstrom,192,druid,balance,6,2,4
4946,Arenshimoon,kazzak,192,druid,balance,6,2,4
4947,Луноэльф,gordunni,192,druid,balance,6,2,4
4948,Kylaaz,die-ewige-wacht,192,druid,balance,6,2,4
4949,Jaffacakeqt,draenor,192,druid,balance,6,2,4
4950,Filderah,doomhammer,192,druid,balance,6,2,4
4951,Jimmyxdd,kazzak,192,druid,balance,6,2,4
4952,Sorkoxd,silvermoon,192,druid,balance,6,2,4
4953,Kotkacy,silvermoon,192,druid,balance,6,2,4
4954,Маалир,gordunni,192,druid,balance,6,2,4
4955,Kwenden,arygos,192,druid,balance,6,2,4
4956,Gurranq,argent-dawn,192,druid,balance,11,3,8
4957,Nctmé,tarren-mill,192,druid,balance,12,2,10
4958,Leekroom,forscherliga,192,druid,balance,12,2,10
4959,Fallingmoon,ravencrest,192,druid,balance,12,2,10
4960,Broasted,stormscale,192,druid,balance,12,2,10
4961,Catbear,kazzak,191,druid,balance,6,2,4
4962,Millworgen,norgannon,191,druid,balance,6,2,4
4963,Arrock,malfurion,191,druid,balance,12,2,10
4964,Silvacustos,teldrassil,191,druid,balance,12,2,10
4965,Drix,frostwolf,175,druid,balance,11,2,9
4966,Thielyy,blackmoore,138,druid,balance,6,3,3
4967,Tekilaz,sanguino,128,druid,balance,4,2,2
4968,Bluebanana,bronzebeard,112,druid,balance,7,2,5
4969,Garudax,blackrock,96,druid,balance,6,1,5
4970,Ayven,kazzak,96,druid,balance,6,1,5
4971,Ursulaboomer,blackrock,96,druid,balance,6,1,5
4972,Batmòn,stormscale,96,druid,balance,6,1,5
4973,Tigerbalm,ravenholdt,96,druid,balance,6,1,5
4974,Nermax,kazzak,96,druid,balance,6,1,5
4975,Lifeseed,ravencrest,96,druid,balance,6,1,5
4976,Siahra,khaz-modan,96,druid,balance,6,1,5
4977,Arún,nazjatar,96,druid,balance,6,1,5
4978,Ãnimal,argent-dawn,96,druid,balance,6,1,5
4979,Samuelito,ravencrest,96,druid,balance,6,1,5
4980,Tbga,outland,96,druid,balance,6,1,5
4981,Nayemi,blackmoore,96,druid,balance,6,1,5
4982,Herekitykity,frostmane,96,druid,balance,6,1,5
4983,Hotseîdank,blackrock,96,druid,balance,6,1,5
4984,Kaira,kazzak,96,druid,balance,6,1,5
4985,Eredhion,stormscale,96,druid,balance,6,1,5
4986,Blazor,eredar,96,druid,balance,6,1,5
4987,Druidlaba,drakthul,96,druid,balance,6,1,5
4988,Cattdamon,outland,96,druid,balance,6,1,5
4989,Yosimoo,draenor,96,druid,balance,6,1,5
4990,Ipsdray,ysondre,96,druid,balance,6,1,5
4991,Whelpss,archimonde,96,druid,balance,6,1,5
4992,Xwerzz,stormscale,96,druid,balance,6,1,5
4993,Druidja,sylvanas,96,druid,balance,6,1,5
4994,Маминапуська,soulflayer,96,druid,balance,6,1,5
4995,Ösdru,tarren-mill,96,druid,balance,6,1,5
4996,Ghostdoggie,stormscale,96,druid,balance,6,1,5
4997,Two,silvermoon,96,druid,balance,6,1,5
4998,Plankface,ravencrest,96,druid,balance,13,2,11
4999,Mondino,blackrock,96,druid,balance,12,1,11
5000,Negríno,cthun,95,druid,balance,3,2,1
5001,Revoidý,blackmoore,79,druid,balance,5,1,4
5002,Kodobursto,stormscale,79,druid,balance,6,1,5
5003,Nalreaa,kazzak,31,druid,balance,8,1,7
5004,Báttlx,blackrock,16,druid,balance,7,1,6
5005,Bodytypezero,terenas,2169,evoker,preservation,110,62,48
5006,Гачитварь,galakrond,2169,evoker,preservation,215,110,105
5007,Néthy,argent-dawn,2152,evoker,preservation,90,52,38
5008,Zychodrac,draenor,2145,evoker,preservation,148,74,74
5009,Бедныйгрузин,howling-fjord,2125,evoker,preservation,66,39,27
5010,Sukkmymadnes,draenor,2120,evoker,preservation,79,39,40
5011,Dn,shattered-hand,2111,evoker,preservation,89,46,43
5012,Nesedon,stormscale,2108,evoker,preservation,227,118,109
5013,Dragonsweat,hyjal,2022,evoker,preservation,66,38,28
5014,Theories,blackhand,1978,evoker,preservation,68,36,32
5015,Puzikloh,ravencrest,1973,evoker,preservation,42,23,19
5016,Drogon,shendralar,1970,evoker,preservation,66,38,28
5017,Amadeusx,ravencrest,1960,evoker,preservation,84,45,39
5018,Шафлэнжоер,fordragon,1958,evoker,preservation,30,22,8
5019,Dizablise,burning-legion,1954,evoker,preservation,59,33,26
5020,Ripgódx,bronzebeard,1952,evoker,preservation,126,74,52
5021,Haxyia,outland,1928,evoker,preservation,60,31,29
5022,Rvrsl,outland,1916,evoker,preservation,96,48,48
5023,Waifuwu,blackhand,1900,evoker,preservation,175,85,90
5024,Lazey,stormscale,1891,evoker,preservation,54,30,24
5025,Huxleysroar,draenor,1888,evoker,preservation,54,26,28
5026,Phnx,blackrock,1886,evoker,preservation,246,125,121
5027,Matrixslave,tarren-mill,1875,evoker,preservation,81,46,35
5028,Vokedrak,eredar,1875,evoker,preservation,66,32,34
5029,Sinéstrà,antonidas,1874,evoker,preservation,108,52,56
5030,Ноубадиаттак,soulflayer,1867,evoker,preservation,90,39,51
5031,Podonok,ravencrest,1865,evoker,preservation,66,34,32
5032,Xays,ravencrest,1864,evoker,preservation,70,34,36
5033,Ipho,twisting-nether,1856,evoker,preservation,100,45,55
5034,Bodytypefour,stormscale,1854,evoker,preservation,66,28,38
5035,Myshagini,ravencrest,1846,evoker,preservation,45,27,18
5036,Æzorahai,area-52,1845,evoker,preservation,72,33,39
5037,Kankethyr,korgall,1834,evoker,preservation,47,26,21
5038,Zimbello,nemesis,1826,evoker,preservation,36,26,10
5039,Onelastdance,ravencrest,1821,evoker,preservation,59,50,9
5040,Jakelóng,ravencrest,1818,evoker,preservation,52,25,27
5041,Gardennewt,ravencrest,1817,evoker,preservation,60,29,31
5042,Healevoker,aegwynn,1814,evoker,preservation,123,58,65
5043,Mixn,argent-dawn,1812,evoker,preservation,93,41,52
5044,Infidus,ravencrest,1810,evoker,preservation,145,82,63
5045,Smellybreath,ravencrest,1810,evoker,preservation,36,19,17
5046,Dragonmeta,kazzak,1808,evoker,preservation,36,19,17
5047,Wakûwakû,kazzak,1805,evoker,preservation,135,72,63
5048,Cptdrakon,twisting-nether,1802,evoker,preservation,77,43,34
5049,Lerrastrasza,zirkel-des-cenarius,1802,evoker,preservation,48,24,24
5050,Talim,terrordar,1800,evoker,preservation,78,37,41
5051,Swainsupp,archimonde,1776,evoker,preservation,42,19,23
5052,Themasktw,kazzak,1772,evoker,preservation,36,19,17
5053,Seafolk,stormscale,1763,evoker,preservation,116,64,52
5054,Devidra,defias-brotherhood,1763,evoker,preservation,54,23,31
5055,Asyncgosa,ravencrest,1749,evoker,preservation,60,25,35
5056,Dragondaddy,eredar,1748,evoker,preservation,42,19,23
5057,Smâûg,silvermoon,1740,evoker,preservation,42,22,20
5058,Антошадф,gordunni,1736,evoker,preservation,48,25,23
5059,Puffthemagic,archimonde,1729,evoker,preservation,48,23,25
5060,Gneltharion,draenor,1723,evoker,preservation,56,25,31
5061,Camdaddy,magtheridon,1715,evoker,preservation,117,60,57
5062,Bümber,stormscale,1714,evoker,preservation,48,21,27
5063,Трейш,soulflayer,1714,evoker,preservation,72,29,43
5064,Baiyuekui,blackmoore,1709,evoker,preservation,237,114,123
5065,Jamesdéan,twisting-nether,1698,evoker,preservation,30,19,11
5066,Yulinex,argent-dawn,1697,evoker,preservation,120,67,53
5067,Ранкондракон,lich-king,1695,evoker,preservation,89,38,51
5068,Ðåñîq,kazzak,1691,evoker,preservation,48,23,25
5069,Nakavoker,arygos,1676,evoker,preservation,46,18,28
5070,Ezinice,hyjal,1672,evoker,preservation,46,20,26
5071,Kalevra,eredar,1667,evoker,preservation,65,33,32
5072,Сансетшторм,gordunni,1659,evoker,preservation,34,18,16
5073,Даэдра,gordunni,1655,evoker,preservation,84,42,42
5074,Lytër,sanguino,1652,evoker,preservation,105,61,44
5075,Bugdul,twisting-nether,1646,evoker,preservation,50,31,19
5076,Аскми,blackscar,1642,evoker,preservation,84,35,49
5077,Âspên,archimonde,1639,evoker,preservation,51,24,27
5078,Valkroth,argent-dawn,1639,evoker,preservation,89,41,48
5079,Дарконикс,gordunni,1632,evoker,preservation,60,31,29
5080,Ramfurry,kazzak,1632,evoker,preservation,49,21,28
5081,Shroudflight,draenor,1632,evoker,preservation,54,23,31
5082,Rüllatorsven,stormscale,1631,evoker,preservation,36,21,15
5083,Тирэсплюс,soulflayer,1630,evoker,preservation,30,17,13
5084,Bònéz,blackmoore,1629,evoker,preservation,101,48,53
5085,Kackaloch,tarren-mill,1625,evoker,preservation,69,37,32
5086,Akaos,silvermoon,1613,evoker,preservation,38,20,18
5087,Alusiedrake,ravencrest,1603,evoker,preservation,48,31,17
5088,Hjucen,twisting-nether,1603,evoker,preservation,90,49,41
5089,Malowux,outland,1600,evoker,preservation,36,19,17
5090,Methamfetami,kazzak,1598,evoker,preservation,66,36,30
5091,Malboroasted,archimonde,1586,evoker,preservation,42,21,21
5092,Scarydragôn,draenor,1581,evoker,preservation,87,53,34
5093,Häröpallo,stormscale,1572,evoker,preservation,60,32,28
5094,Kaipha,ravencrest,1565,evoker,preservation,42,19,23
5095,Хронолиса,blackscar,1561,evoker,preservation,67,32,35
5096,Fearawr,malganis,1552,evoker,preservation,63,22,41
5097,Obbwoke,ravencrest,1550,evoker,preservation,60,25,35
5098,Нежныйболт,howling-fjord,1536,evoker,preservation,134,68,66
5099,Tarecgosa,sanguino,1528,evoker,preservation,45,21,24
5100,Setraxia,argent-dawn,1525,evoker,preservation,24,18,6
5101,Nahkiainen,darksorrow,1514,evoker,preservation,36,16,20
5102,Odensbest,silvermoon,1496,evoker,preservation,55,32,23
5103,Bigaluga,blackmoore,1492,evoker,preservation,42,18,24
5104,Luderx,outland,1489,evoker,preservation,66,38,28
5105,Tenibris,die-nachtwache,1486,evoker,preservation,113,52,61
5106,Sakade,archimonde,1480,evoker,preservation,40,18,22
5107,Ацидракон,blackscar,1472,evoker,preservation,72,29,43
5108,Бадикабаер,thermaplugg,1465,evoker,preservation,95,49,46
5109,Oldwhiteman,guldan,1465,evoker,preservation,52,25,27
5110,Didii,frostwhisper,1458,evoker,preservation,93,40,53
5111,Madelynxoxo,draenor,1450,evoker,preservation,30,25,5
5112,Dragoncya,archimonde,1447,evoker,preservation,72,33,39
5113,Condrage,grim-batol,1445,evoker,preservation,42,22,20
5114,Kronata,sanguino,1439,evoker,preservation,30,15,15
5115,Loveheart,die-aldor,1438,evoker,preservation,70,33,37
5116,Wernøker,archimonde,1431,evoker,preservation,36,15,21
5117,Sedricae,twisting-nether,1429,evoker,preservation,131,67,64
5118,Dazaar,kazzak,1428,evoker,preservation,18,16,2
5119,Liliwood,ravencrest,1427,evoker,preservation,64,30,34
5120,Béatér,aegwynn,1426,evoker,preservation,30,15,15
5121,Saga,aegwynn,1418,evoker,preservation,53,30,23
5122,Sinistrea,conseil-des-ombres,1414,evoker,preservation,63,34,29
5123,Nanthira,darksorrow,1410,evoker,preservation,74,33,41
5124,Evizard,nagrand,1407,evoker,preservation,53,30,23
5125,Spiragon,ysondre,1392,evoker,preservation,66,32,34
5126,Nadoney,hyjal,1389,evoker,preservation,67,42,25
5127,Ammendorn,blackrock,1384,evoker,preservation,46,27,19
5128,Azorgaron,outland,1383,evoker,preservation,60,26,34
5129,Mortlalune,conseil-des-ombres,1381,evoker,preservation,88,51,37
5130,Th,stormscale,1380,evoker,preservation,30,22,8
5131,Asraestrasz,silvermoon,1380,evoker,preservation,38,24,14
5132,Dragnthsnuts,sylvanas,1380,evoker,preservation,32,16,16
5133,Badrig,silvermoon,1380,evoker,preservation,52,24,28
5134,Ятромантис,gordunni,1377,evoker,preservation,165,81,84
5135,Nexxà,archimonde,1373,evoker,preservation,39,28,11
5136,Evokazoran,dentarg,1368,evoker,preservation,66,22,44
5137,Sorextrazy,twisting-nether,1364,evoker,preservation,58,26,32
5138,Maxthecar,draenor,1359,evoker,preservation,36,21,15
5139,Scalie,ravencrest,1356,evoker,preservation,36,22,14
5140,Шкуроносец,gordunni,1352,evoker,preservation,30,15,15
5141,Cinquanteuro,hyjal,1347,evoker,preservation,101,45,56
5142,Штеци,howling-fjord,1347,evoker,preservation,193,81,112
5143,Rescuegirl,blackrock,1345,evoker,preservation,99,50,49
5144,Adriia,draenor,1341,evoker,preservation,18,14,4
5145,Choubalo,archimonde,1341,evoker,preservation,58,31,27
5146,Drarent,hyjal,1340,evoker,preservation,54,24,30
5147,Cenca,blackmoore,1338,evoker,preservation,91,44,47
5148,Profdrake,zuluhed,1337,evoker,preservation,24,14,10
5149,Whitelizzard,tarren-mill,1336,evoker,preservation,24,16,8
5150,Phyrrax,silvermoon,1336,evoker,preservation,24,14,10
5151,Apaçi,ravencrest,1336,evoker,preservation,33,15,18
5152,Dwagonzuv,the-maelstrom,1323,evoker,preservation,24,14,10
5153,Uroegevoker,twisting-nether,1316,evoker,preservation,68,36,32
5154,Draxaer,outland,1307,evoker,preservation,98,52,46
5155,Indragon,blackmoore,1307,evoker,preservation,33,15,18
5156,Xerragon,ravencrest,1306,evoker,preservation,60,20,40
5157,Fredgobrr,tarren-mill,1299,evoker,preservation,84,53,31
5158,Geckonen,stormreaver,1292,evoker,preservation,109,59,50
5159,Scalo,kazzak,1292,evoker,preservation,90,41,49
5160,Sibvoker,kazzak,1289,evoker,preservation,47,20,27
5161,Discodidling,silvermoon,1287,evoker,preservation,63,32,31
5162,Malfø,exodar,1282,evoker,preservation,115,58,57
5163,Asinitaris,ravencrest,1279,evoker,preservation,47,26,21
5164,Superflyy,kazzak,1278,evoker,preservation,110,42,68
5165,Lynastrasza,silvermoon,1274,evoker,preservation,147,78,69
5166,Drackheal,kaelthas,1269,evoker,preservation,35,21,14
5167,Erhvoker,veknilash,1269,evoker,preservation,69,29,40
5168,Ludracy,antonidas,1267,evoker,preservation,66,34,32
5169,Thundermifln,nemesis,1266,evoker,preservation,30,17,13
5170,Dinotron,uldaman,1249,evoker,preservation,54,27,27
5171,Thellon,frostwolf,1247,evoker,preservation,24,14,10
5172,Najikí,tarren-mill,1247,evoker,preservation,24,13,11
5173,Jkdrage,stormscale,1247,evoker,preservation,24,13,11
5174,Froststraza,chamber-of-aspects,1247,evoker,preservation,30,13,17
5175,Nagoli,silvermoon,1246,evoker,preservation,45,20,25
5176,Novvae,hyjal,1243,evoker,preservation,24,13,11
5177,Crottedezen,archimonde,1243,evoker,preservation,30,13,17
5178,Эндемический,soulflayer,1242,evoker,preservation,30,13,17
5179,Kymura,archimonde,1239,evoker,preservation,30,13,17
5180,Matysniak,burning-legion,1232,evoker,preservation,24,13,11
5181,Beenus,doomhammer,1228,evoker,preservation,36,24,12
5182,Патриотика,howling-fjord,1225,evoker,preservation,59,26,33
5183,Тектрис,howling-fjord,1218,evoker,preservation,78,34,44
5184,Breall,tarren-mill,1217,evoker,preservation,140,57,83
5185,Lojinevo,twisting-nether,1215,evoker,preservation,95,43,52
5186,Âbs,archimonde,1215,evoker,preservation,59,24,35
5187,Ruinastrasza,silvermoon,1212,evoker,preservation,24,13,11
5188,Amaterãsu,kazzak,1206,evoker,preservation,42,21,21
5189,Драконсила,gordunni,1198,evoker,preservation,23,13,10
5190,Kurger,twisting-nether,1198,evoker,preservation,39,17,22
5191,Jimmytrivet,archimonde,1198,evoker,preservation,39,16,23
5192,Howtodragon,twisting-nether,1189,evoker,preservation,36,17,19
5193,Ohcaralho,outland,1188,evoker,preservation,39,16,23
5194,Dragonna,argent-dawn,1171,evoker,preservation,48,23,25
5195,Aphi,frostwolf,1171,evoker,preservation,55,26,29
5196,Zethreus,silvermoon,1170,evoker,preservation,58,30,28
5197,Nonolildrake,ysondre,1167,evoker,preservation,36,16,20
5198,Tennin,thrall,1157,evoker,preservation,45,27,18
5199,Eagleflow,aszune,1154,evoker,preservation,31,13,18
5200,Jmy,bloodhoof,1152,evoker,preservation,18,12,6
5201,Dârys,kazzak,1152,evoker,preservation,24,12,12
5202,Anso,sanguino,1152,evoker,preservation,48,23,25
5203,Hehehihihaha,ravencrest,1151,evoker,preservation,24,12,12
5204,Dragawn,grim-batol,1147,evoker,preservation,73,41,32
5205,Nekrosdrake,tarren-mill,1146,evoker,preservation,24,12,12
5206,Sinusiitiis,destromath,1142,evoker,preservation,18,12,6
5207,Nazalath,eonar,1130,evoker,preservation,24,12,12
5208,Shnptyr,ragnaros,1127,evoker,preservation,18,12,6
5209,Adnoc,tarren-mill,1124,evoker,preservation,19,13,6
5210,Алифсе,howling-fjord,1123,evoker,preservation,60,18,42
5211,Drachenglas,antonidas,1112,evoker,preservation,30,13,17
5212,Uztfuzt,blackmoore,1103,evoker,preservation,24,15,9
5213,Алекстраса,blackscar,1097,evoker,preservation,30,16,14
5214,Predatax,drakthul,1095,evoker,preservation,106,56,50
5215,Saphirá,hyjal,1094,evoker,preservation,28,13,15
5216,Singe,nemesis,1081,evoker,preservation,48,12,36
5217,Wingzy,chogall,1075,evoker,preservation,171,80,91
5218,Blackli,kazzak,1074,evoker,preservation,33,14,19
5219,Retyss,twisting-nether,1068,evoker,preservation,253,126,127
5220,Lizardofoz,argent-dawn,1058,evoker,preservation,30,18,12
5221,Berlyvoke,stormscale,1056,evoker,preservation,18,11,7
5222,Tombeelee,kazzak,1055,evoker,preservation,18,11,7
5223,Samidr,ravencrest,1054,evoker,preservation,30,11,19
5224,Dragonsimp,archimonde,1047,evoker,preservation,18,11,7
5225,Sarapakara,burning-blade,1047,evoker,preservation,24,11,13
5226,Dragonerr,kiljaeden,1037,evoker,preservation,24,11,13
5227,Rafale,the-maelstrom,1029,evoker,preservation,35,16,19
5228,Thymian,ambossar,1026,evoker,preservation,68,33,35
5229,Zathîel,argent-dawn,1026,evoker,preservation,149,64,85
5230,Spirow,archimonde,1012,evoker,preservation,18,11,7
5231,Draklorn,moonglade,1012,evoker,preservation,24,13,11
5232,Шадофдрагон,deathweaver,1004,evoker,preservation,30,20,10
5233,Navilism,kazzak,1004,evoker,preservation,179,93,86
5234,Morlie,argent-dawn,1004,evoker,preservation,47,21,26
5235,Tf,doomhammer,988,evoker,preservation,40,15,25
5236,Palindre,argent-dawn,987,evoker,preservation,29,14,15
5237,Dayandnight,quelthalas,984,evoker,preservation,30,11,19
5238,Varaug,veklor,973,evoker,preservation,23,14,9
5239,Slashlowe,archimonde,972,evoker,preservation,36,17,19
5240,Reddeaddrago,silvermoon,966,evoker,preservation,44,24,20
5241,Ecovoker,outland,960,evoker,preservation,18,10,8
5242,Salamanderx,stormscale,959,evoker,preservation,12,10,2
5243,Síire,ravencrest,958,evoker,preservation,12,10,2
5244,Потныйдракон,soulflayer,958,evoker,preservation,24,10,14
5245,Raøug,blackmoore,950,evoker,preservation,30,10,20
5246,Винтер,azuregos,935,evoker,preservation,19,11,8
5247,Vozzat,stormscale,934,evoker,preservation,24,11,13
5248,Morsan,tichondrius,931,evoker,preservation,36,19,17
5249,Jurrassic,defias-brotherhood,929,evoker,preservation,18,10,8
5250,Pigioto,silvermoon,929,evoker,preservation,89,41,48
5251,Drachi,ambossar,927,evoker,preservation,60,27,33
5252,Vores,norgannon,908,evoker,preservation,59,26,33
5253,Drakars,kazzak,905,evoker,preservation,24,11,13
5254,Cárried,twilights-hammer,902,evoker,preservation,33,11,22
5255,Canitabravar,cthun,898,evoker,preservation,60,30,30
5256,Marasz,silvermoon,893,evoker,preservation,42,22,20
5257,Eosin,blackrock,890,evoker,preservation,23,10,13
5258,Hool,silvermoon,885,evoker,preservation,72,31,41
5259,Gardenewt,ravencrest,864,evoker,preservation,12,9,3
5260,Drakela,frostwhisper,864,evoker,preservation,12,9,3
5261,Moondraka,outland,864,evoker,preservation,18,9,9
5262,Drgigapump,blackmoore,864,evoker,preservation,18,9,9
5263,Dracum,kazzak,864,evoker,preservation,18,9,9
5264,Eryot,aggra-português,864,evoker,preservation,24,9,15
5265,Мишанячешуя,gordunni,863,evoker,preservation,12,9,3
5266,Crocodeal,ysondre,863,evoker,preservation,12,9,3
5267,Valtion,stormscale,863,evoker,preservation,18,9,9
5268,Cupcâke,dalaran,863,evoker,preservation,18,9,9
5269,Anlong,alakir,863,evoker,preservation,23,10,13
5270,Etier,aegwynn,862,evoker,preservation,18,9,9
5271,Sissilisko,sylvanas,861,evoker,preservation,12,9,3
5272,Gissthebuzzy,dun-modr,861,evoker,preservation,12,9,3
5273,Blazeros,sylvanas,861,evoker,preservation,36,15,21
5274,Mistvoke,kazzak,860,evoker,preservation,18,9,9
5275,Lithnxv,bladefist,859,evoker,preservation,18,9,9
5276,Dracanus,bronze-dragonflight,859,evoker,preservation,24,9,15
5277,Aphelïon,dun-modr,859,evoker,preservation,24,9,15
5278,Jamiewing,ravencrest,858,evoker,preservation,18,9,9
5279,Evok,deathwing,858,evoker,preservation,24,10,14
5280,Gilgakek,darksorrow,852,evoker,preservation,24,9,15
5281,Javåscript,outland,849,evoker,preservation,18,9,9
5282,Sumo,burning-legion,841,evoker,preservation,36,16,20
5283,Viseriðn,archimonde,827,evoker,preservation,24,9,15
5284,Nyghtx,sanguino,810,evoker,preservation,22,10,12
5285,Мэриджэин,soulflayer,809,evoker,preservation,21,9,12
5286,Jhoanna,grim-batol,804,evoker,preservation,18,9,9
5287,Yadormi,sylvanas,795,evoker,preservation,42,16,26
5288,Тирдде,deathweaver,784,evoker,preservation,30,11,19
5289,Miumyuki,drakthul,783,evoker,preservation,24,9,15
5290,Верметор,soulflayer,773,evoker,preservation,90,27,63
5291,Zendaë,archimonde,768,evoker,preservation,12,8,4
5292,Roth,stormreaver,768,evoker,preservation,12,8,4
5293,Nst,zuljin,768,evoker,preservation,12,8,4
5294,Zemar,dalaran,768,evoker,preservation,12,8,4
5295,Humòngóus,kazzak,768,evoker,preservation,12,8,4
5296,Ringil,tarren-mill,768,evoker,preservation,18,8,10
5297,Jaje,nerathor,768,evoker,preservation,18,8,10
5298,Baszz,aegwynn,767,evoker,preservation,18,8,10
5299,Мефодийевок,howling-fjord,767,evoker,preservation,18,8,10
5300,Draelaynex,eredar,767,evoker,preservation,24,8,16
5301,Уполнамоченн,soulflayer,764,evoker,preservation,12,8,4
5302,Nagimurr,kazzak,763,evoker,preservation,12,8,4
5303,Donns,frostmane,763,evoker,preservation,16,9,7
5304,Viseron,zuljin,761,evoker,preservation,21,9,12
5305,Bombrush,ragnaros,759,evoker,preservation,12,8,4
5306,Dreamiee,kazzak,758,evoker,preservation,24,8,16
5307,Dragonrocker,silvermoon,757,evoker,preservation,24,8,16
5308,Дрэгтир,lich-king,755,evoker,preservation,14,8,6
5309,Nahfr,terenas,736,evoker,preservation,22,8,14
5310,Damssx,medivh,727,evoker,preservation,15,9,6
5311,Polzeig,dentarg,719,evoker,preservation,17,8,9
5312,Dratheon,dun-modr,704,evoker,preservation,20,9,11
5313,Vyron,amanthul,702,evoker,preservation,16,8,8
5314,Sunfyres,frostmane,679,evoker,preservation,28,8,20
5315,Stormnn,kazzak,672,evoker,preservation,12,7,5
5316,Elcocodrilo,tarren-mill,672,evoker,preservation,12,7,5
5317,Kremost,sylvanas,672,evoker,preservation,12,7,5
5318,Kharduk,outland,672,evoker,preservation,15,8,7
5319,Thèrèse,hyjal,672,evoker,preservation,18,7,11
5320,Sulführer,sanguino,672,evoker,preservation,18,7,11
5321,Spacebreath,ravencrest,672,evoker,preservation,18,7,11
5322,Draaxy,twisting-nether,671,evoker,preservation,15,8,7
5323,Fusanabide,kazzak,671,evoker,preservation,14,7,7
5324,Karristrasza,silvermoon,671,evoker,preservation,18,7,11
5325,Nedflanderss,silvermoon,670,evoker,preservation,12,7,5
5326,Esalisko,kazzak,670,evoker,preservation,12,7,5
5327,Leblon,stormreaver,670,evoker,preservation,12,7,5
5328,Smokitor,kazzak,670,evoker,preservation,12,7,5
5329,Coaxoch,thunderhorn,670,evoker,preservation,12,7,5
5330,Drakeish,kazzak,669,evoker,preservation,12,7,5
5331,Folevo,stormreaver,669,evoker,preservation,18,7,11
5332,Эбиб,gordunni,664,evoker,preservation,18,7,11
5333,Awfultrash,archimonde,655,evoker,preservation,23,7,16
5334,Branados,argent-dawn,639,evoker,preservation,12,7,5
5335,Jacko,nemesis,576,evoker,preservation,12,6,6
5336,Skypov,sylvanas,576,evoker,preservation,12,6,6
5337,Sính,ravencrest,576,evoker,preservation,12,6,6
5338,Mesarin,eredar,576,evoker,preservation,12,6,6
5339,Mistrßroducr,stormreaver,576,evoker,preservation,12,6,6
5340,Bluesaphir,ravencrest,576,evoker,preservation,12,6,6
5341,Sindragonk,ravencrest,576,evoker,preservation,12,6,6
5342,Snipy,burning-legion,576,evoker,preservation,12,6,6
5343,Talynn,sylvanas,576,evoker,preservation,12,6,6
5344,Krayvoker,tarren-mill,576,evoker,preservation,12,6,6
5345,Вексалис,gordunni,576,evoker,preservation,12,6,6
5346,Dedx,sylvanas,576,evoker,preservation,12,6,6
5347,Lolprevoker,outland,576,evoker,preservation,18,6,12
5348,Myntara,tarren-mill,576,evoker,preservation,18,6,12
5349,Zeigrem,antonidas,575,evoker,preservation,6,6,0
5350,Pasqvoker,ravencrest,575,evoker,preservation,12,6,6
5351,Nevara,ragnaros,575,evoker,preservation,12,6,6
5352,Raegos,ravencrest,575,evoker,preservation,12,6,6
5353,Smrdimipytel,drakthul,575,evoker,preservation,22,6,16
5354,Groovyy,hyjal,574,evoker,preservation,12,6,6
5355,Schenlong,kelthuzad,574,evoker,preservation,12,6,6
5356,Tarystrasza,blackrock,574,evoker,preservation,12,6,6
5357,Drakpojke,stormscale,574,evoker,preservation,12,6,6
5358,Dracarysfire,kazzak,573,evoker,preservation,12,6,6
5359,Ewings,archimonde,573,evoker,preservation,24,6,18
5360,Steeken,haomarush,572,evoker,preservation,18,6,12
5361,Scaleyfurry,azshara,570,evoker,preservation,12,6,6
5362,Synhtol,ragnaros,564,evoker,preservation,18,6,12
5363,ßëkûsåùrús,ragnaros,559,evoker,preservation,17,6,11
5364,Rasalhague,uldum,522,evoker,preservation,15,6,9
5365,Dracarysx,grim-batol,520,evoker,preservation,15,7,8
5366,Drakthur,terenas,519,evoker,preservation,27,7,20
5367,Tyuz,antonidas,509,evoker,preservation,14,6,8
5368,Sürion,grim-batol,480,evoker,preservation,6,5,1
5369,Omac,sylvanas,480,evoker,preservation,6,5,1
5370,Holyvoker,aegwynn,480,evoker,preservation,6,5,1
5371,Jmyzard,tarren-mill,480,evoker,preservation,10,6,4
5372,Dragonsito,cthun,480,evoker,preservation,12,5,7
5373,Elleavo,tarren-mill,480,evoker,preservation,12,5,7
5374,Chasxstrasza,ravencrest,480,evoker,preservation,12,5,7
5375,Deathwingx,sylvanas,480,evoker,preservation,12,5,7
5376,Óceiros,silvermoon,480,evoker,preservation,12,5,7
5377,Emeraldcomun,twisting-nether,480,evoker,preservation,12,5,7
5378,Ithijin,blackmoore,480,evoker,preservation,12,5,7
5379,Reptak,stormscale,480,evoker,preservation,12,5,7
5380,Soupmah,silvermoon,480,evoker,preservation,12,5,7
5381,Evoris,frostmane,480,evoker,preservation,12,5,7
5382,Iwaavoker,archimonde,480,evoker,preservation,12,5,7
5383,Evokoloko,outland,480,evoker,preservation,12,5,7
5384,Nemrák,blackmoore,480,evoker,preservation,12,5,7
5385,Tobbebakar,silvermoon,480,evoker,preservation,12,5,7
5386,Alamostrasza,doomhammer,480,evoker,preservation,12,5,7
5387,Lìssàndra,argent-dawn,480,evoker,preservation,18,5,13
5388,Rise,tarren-mill,480,evoker,preservation,24,5,19
5389,Sudrac,antonidas,479,evoker,preservation,12,5,7
5390,Verithian,kazzak,479,evoker,preservation,12,5,7
5391,Scaleflux,argent-dawn,479,evoker,preservation,12,5,7
5392,Luftwaffel,blackmoore,479,evoker,preservation,12,5,7
5393,Puffdaddyxd,twisting-nether,479,evoker,preservation,12,5,7
5394,Widow,chromaggus,478,evoker,preservation,12,5,7
5395,Kärlethos,dun-modr,478,evoker,preservation,12,5,7
5396,Bbuszek,outland,478,evoker,preservation,18,5,13
5397,Fodom,medivh,477,evoker,preservation,12,5,7
5398,Dragorasi,frostwolf,476,evoker,preservation,24,5,19
5399,Fricandela,sanguino,472,evoker,preservation,12,5,7
5400,Avizz,tarren-mill,462,evoker,preservation,17,8,9
5401,Эфирид,blackscar,443,evoker,preservation,11,5,6
5402,Grajade,dun-modr,422,evoker,preservation,15,6,9
5403,Blyatcuka,kazzak,384,evoker,preservation,6,4,2
5404,Vizdraken,tarren-mill,384,evoker,preservation,6,4,2
5405,Bindrasz,ahnqiraj,384,evoker,preservation,6,4,2
5406,Aymoreth,argent-dawn,384,evoker,preservation,6,4,2
5407,Zaffira,kazzak,384,evoker,preservation,6,4,2
5408,Пидрактир,soulflayer,384,evoker,preservation,6,4,2
5409,Drakatha,kazzak,384,evoker,preservation,6,4,2
5410,Pe,dalaran,384,evoker,preservation,6,4,2
5411,Aeste,dun-modr,384,evoker,preservation,6,4,2
5412,Dreamwalk,archimonde,384,evoker,preservation,6,4,2
5413,Luuxiå8F57BC,archimonde,384,evoker,preservation,6,4,2
5414,Darigo,ravencrest,384,evoker,preservation,6,4,2
5415,Nhoru,stormscale,384,evoker,preservation,6,4,2
5416,Chronowalker,ragnaros,384,evoker,preservation,12,4,8
5417,Sondosa,twisting-nether,384,evoker,preservation,12,4,8
5418,Evokker,antonidas,384,evoker,preservation,12,4,8
5419,Toílet,blackmoore,384,evoker,preservation,12,4,8
5420,Mirajhti,blackrock,384,evoker,preservation,12,4,8
5421,Castytopg,blackrock,384,evoker,preservation,12,4,8
5422,Killafoolz,kazzak,384,evoker,preservation,12,4,8
5423,Fogwing,ravencrest,384,evoker,preservation,18,4,14
5424,Eidachsal,antonidas,384,evoker,preservation,18,4,14
5425,Кефтыме,soulflayer,383,evoker,preservation,6,4,2
5426,Zahaak,doomhammer,383,evoker,preservation,6,4,2
5427,Entombevoker,twisting-nether,383,evoker,preservation,6,4,2
5428,Deadfyre,dun-modr,383,evoker,preservation,6,4,2
5429,Flawxy,blackmoore,383,evoker,preservation,12,4,8
5430,Yaldthion,dun-modr,383,evoker,preservation,18,4,14
5431,Steadyop,doomhammer,382,evoker,preservation,6,4,2
5432,Мизурион,gordunni,379,evoker,preservation,12,4,8
5433,Sinastral,sanguino,350,evoker,preservation,11,4,7
5434,Meezyevo,ragnaros,288,evoker,preservation,6,3,3
5435,Zordrach,quelthalas,288,evoker,preservation,6,3,3
5436,Cragheart,ravencrest,288,evoker,preservation,6,3,3
5437,Fubukinoryuu,frostwolf,288,evoker,preservation,6,3,3
5438,Eurydíke,blackhand,288,evoker,preservation,6,3,3
5439,Rippo,tarren-mill,288,evoker,preservation,6,3,3
5440,Jmý,tarren-mill,288,evoker,preservation,6,3,3
5441,Escaaboy,stormscale,288,evoker,preservation,6,3,3
5442,Colacorta,zuljin,288,evoker,preservation,6,3,3
5443,Evokimag,grim-batol,288,evoker,preservation,6,3,3
5444,Vyore,silvermoon,288,evoker,preservation,6,3,3
5445,Сулистраза,blackscar,288,evoker,preservation,6,3,3
5446,Renalia,blackrock,288,evoker,preservation,6,3,3
5447,Botomforgold,ravencrest,288,evoker,preservation,6,3,3
5448,Tactician,stormreaver,288,evoker,preservation,6,3,3
5449,Kirivoker,dun-modr,288,evoker,preservation,6,3,3
5450,Моралдракон,soulflayer,288,evoker,preservation,6,3,3
5451,Haawwt,eredar,288,evoker,preservation,6,3,3
5452,Saphiraa,lightnings-blade,288,evoker,preservation,6,3,3
5453,Asrwea,draenor,288,evoker,preservation,6,3,3
5454,Distinkd,draenor,288,evoker,preservation,6,3,3
5455,Nezruslfarm,cthun,288,evoker,preservation,6,3,3
5456,Dangai,draenor,288,evoker,preservation,6,3,3
5457,Pruttburk,draenor,288,evoker,preservation,6,3,3
5458,Ivokerz,tarren-mill,288,evoker,preservation,6,3,3
5459,Ladrieth,hyjal,288,evoker,preservation,6,3,3
5460,Keizal,twisting-nether,288,evoker,preservation,6,3,3
5461,Viseriøn,kazzak,288,evoker,preservation,6,3,3
5462,Konstraz,kazzak,288,evoker,preservation,6,3,3
5463,Jackarlys,outland,288,evoker,preservation,6,3,3
5464,Alanikus,silvermoon,288,evoker,preservation,6,3,3
5465,Horiz,kazzak,288,evoker,preservation,12,3,9
5466,Bemil,twisting-nether,288,evoker,preservation,12,3,9
5467,Detdragetid,zenedar,288,evoker,preservation,12,3,9
5468,Mfdragon,grim-batol,288,evoker,preservation,12,3,9
5469,Reelona,silvermoon,288,evoker,preservation,12,3,9
5470,Dokkàmxk,archimonde,288,evoker,preservation,12,3,9
5471,Cadwalader,blades-edge,288,evoker,preservation,12,3,9
5472,Monftroglou,archimonde,288,evoker,preservation,12,3,9
5473,Милеис,soulflayer,287,evoker,preservation,6,3,3
5474,Mikevoker,aegwynn,287,evoker,preservation,6,3,3
5475,Elexatra,hyjal,287,evoker,preservation,12,3,9
5476,Trellie,die-aldor,255,evoker,preservation,11,3,8
5477,Smoochbumble,argent-dawn,240,evoker,preservation,9,3,6
5478,Agnî,sanguino,240,evoker,preservation,9,3,6
5479,Mugeki,burning-legion,234,evoker,preservation,7,4,3
5480,Nivoker,kazzak,223,evoker,preservation,9,3,6
5481,Baranzion,twisting-nether,207,evoker,preservation,8,3,5
5482,Pureshot,archimonde,192,evoker,preservation,6,2,4
5483,Myndragosa,varimathras,192,evoker,preservation,6,2,4
5484,Youzfull,blackrock,192,evoker,preservation,6,2,4
5485,Høt,nemesis,192,evoker,preservation,6,2,4
5486,Crazylucifer,kazzak,192,evoker,preservation,6,2,4
5487,Lînkôs,aegwynn,192,evoker,preservation,6,2,4
5488,Invinite,blackrock,192,evoker,preservation,6,2,4
5489,Freesckretx,archimonde,192,evoker,preservation,6,2,4
5490,Azurog,blackmoore,192,evoker,preservation,6,2,4
5491,Dno,archimonde,192,evoker,preservation,6,2,4
5492,Flipflapflop,twisting-nether,192,evoker,preservation,6,2,4
5493,Dragonzo,arathor,192,evoker,preservation,6,2,4
5494,Sheràqt,blackrock,192,evoker,preservation,6,2,4
5495,Arniye,ravencrest,192,evoker,preservation,6,2,4
5496,Arbîter,eredar,192,evoker,preservation,6,2,4
5497,Dägon,drakthul,192,evoker,preservation,6,2,4
5498,Nordomu,silvermoon,192,evoker,preservation,6,2,4
5499,Puzzles,ravencrest,192,evoker,preservation,6,2,4
5500,Glurak,stormscale,192,evoker,preservation,6,2,4
5501,Parodize,thrall,192,evoker,preservation,6,2,4
5502,Mistime,twisting-nether,192,evoker,preservation,6,2,4
5503,Nickydragonx,stormscale,192,evoker,preservation,6,2,4
5504,Голденджо,gordunni,192,evoker,preservation,11,2,9
5505,Margouillax,archimonde,192,evoker,preservation,12,2,10
5506,Pico,madmortem,192,evoker,preservation,12,2,10
5507,Гарил,grom,191,evoker,preservation,6,2,4
5508,Yuyux,sanguino,191,evoker,preservation,6,2,4
5509,Touge,varimathras,191,evoker,preservation,6,2,4
5510,Azza,uldum,191,evoker,preservation,12,2,10
5511,Eldrax,emerald-dream,159,evoker,preservation,5,2,3
5512,Zerario,blackhand,159,evoker,preservation,5,2,3
5513,Kuubski,ravencrest,144,evoker,preservation,3,3,0
5514,Stinka,blackmoore,138,evoker,preservation,9,5,4
5515,Primepewpew,ragnaros,138,evoker,preservation,15,3,12
5516,Zzaazaa,argent-dawn,137,evoker,preservation,10,3,7
5517,Odiin,dun-modr,96,evoker,preservation,3,2,1
5518,Kuramir,twisting-nether,96,evoker,preservation,6,1,5
5519,Drogøn,khaz-modan,96,evoker,preservation,6,1,5
5520,Drakares,la-croisade-écarlate,96,evoker,preservation,6,1,5
5521,Mulqahdiiv,archimonde,96,evoker,preservation,6,1,5
5522,Awienz,kazzak,96,evoker,preservation,6,1,5
5523,Галактиг,thermaplugg,96,evoker,preservation,6,1,5
5524,Tályn,twisting-nether,96,evoker,preservation,6,1,5
5525,Hakuzah,terokkar,96,evoker,preservation,6,1,5
5526,Смехокрыл,deathguard,96,evoker,preservation,6,1,5
5527,Reska,archimonde,96,evoker,preservation,6,1,5
5528,Kaezmasterx,blackrock,96,evoker,preservation,6,1,5
5529,Brystrasza,quelthalas,96,evoker,preservation,6,1,5
5530,Kitoed,aegwynn,96,evoker,preservation,6,1,5
5531,Lapaneri,sylvanas,96,evoker,preservation,6,1,5
5532,Ch,ghostlands,96,evoker,preservation,6,1,5
5533,Yaboismok,burning-legion,96,evoker,preservation,6,1,5
5534,Iblvicanfly,stormscale,96,evoker,preservation,6,1,5
5535,Hizzo,burning-legion,96,evoker,preservation,6,1,5
5536,Azurewings,argent-dawn,96,evoker,preservation,6,1,5
5537,Targzæ,hyjal,96,evoker,preservation,6,1,5
5538,Dragarius,tarren-mill,96,evoker,preservation,6,1,5
5539,Stjáuni,ravencrest,96,evoker,preservation,16,2,14
5540,Dragonban,tarren-mill,96,evoker,preservation,12,1,11
5541,Vullgred,sylvanas,96,evoker,preservation,12,1,11
5542,Valystrá,die-aldor,96,evoker,preservation,12,1,11
5543,Sopollina,draenor,96,evoker,preservation,12,1,11
5544,Kamings,outland,95,evoker,preservation,8,1,7
5545,Fluffykoi,silvermoon,95,evoker,preservation,12,1,11
5546,Imend,stormscale,79,evoker,preservation,5,1,4
5547,Sentos,blackmoore,64,evoker,preservation,10,1,9
5548,Rexzstrasza,eredar,2114,evoker,devastation,78,49,29
5549,Brokz,twisting-nether,2081,evoker,devastation,76,45,31
5550,Kàido,ravencrest,2053,evoker,devastation,288,147,141
5551,Sârmikas,blackhand,2031,evoker,devastation,78,43,35
5552,Babodrake,blackhand,2019,evoker,devastation,55,27,28
5553,Drakenyasha,tarren-mill,1983,evoker,devastation,123,59,64
5554,Claxy,ragnaros,1952,evoker,devastation,72,38,34
5555,Нерфсрочно,gordunni,1927,evoker,devastation,96,46,50
5556,Xzvoker,kazzak,1909,evoker,devastation,110,57,53
5557,Eldunaries,argent-dawn,1896,evoker,devastation,78,43,35
5558,Wexvoker,darksorrow,1892,evoker,devastation,68,37,31
5559,Darkssoul,outland,1875,evoker,devastation,72,38,34
5560,Meust,blackrock,1864,evoker,devastation,42,28,14
5561,Nigesaurus,burning-legion,1862,evoker,devastation,39,21,18
5562,Frozendragon,twisting-nether,1849,evoker,devastation,45,32,13
5563,Korvi,ravencrest,1830,evoker,devastation,44,25,19
5564,Lizardbøi,blackhand,1827,evoker,devastation,66,33,33
5565,Ízma,ravencrest,1826,evoker,devastation,138,70,68
5566,Драгонтьма,gordunni,1823,evoker,devastation,65,33,32
5567,Twodeep,blackrock,1821,evoker,devastation,54,30,24
5568,Дракшотик,soulflayer,1817,evoker,devastation,30,19,11
5569,Jamzyevoker,emerald-dream,1816,evoker,devastation,49,26,23
5570,Amadeusx,ravencrest,1810,evoker,devastation,55,30,25
5571,Valdrakon,doomhammer,1807,evoker,devastation,60,36,24
5572,Hehehihihaha,ravencrest,1807,evoker,devastation,48,22,26
5573,Animenorgam,alakir,1806,evoker,devastation,54,40,14
5574,Avë,kazzak,1790,evoker,devastation,77,39,38
5575,Diznutz,kazzak,1781,evoker,devastation,36,21,15
5576,Ipanicsoar,tarren-mill,1778,evoker,devastation,50,24,26
5577,Дреадди,soulflayer,1769,evoker,devastation,39,25,14
5578,Dracohfeu,archimonde,1767,evoker,devastation,42,25,17
5579,Hollowbreath,sanguino,1766,evoker,devastation,162,80,82
5580,Bigmacfrite,ysondre,1765,evoker,devastation,70,34,36
5581,Oontäälihis,ravencrest,1764,evoker,devastation,72,37,35
5582,Mizamiza,blackrock,1746,evoker,devastation,118,60,58
5583,Hanoostrasz,tarren-mill,1740,evoker,devastation,61,39,22
5584,Hëroinhenry,tarren-mill,1738,evoker,devastation,42,28,14
5585,Atoll,scarshield-legion,1732,evoker,devastation,43,20,23
5586,Merkels,blackmoore,1719,evoker,devastation,69,38,31
5587,Lesgrossman,ravencrest,1716,evoker,devastation,30,18,12
5588,Kymaíra,hyjal,1716,evoker,devastation,48,22,26
5589,Yuhabahha,kazzak,1709,evoker,devastation,136,74,62
5590,Sawk,archimonde,1706,evoker,devastation,72,46,26
5591,Edvoker,twisting-nether,1706,evoker,devastation,48,25,23
5592,Ryujíin,kazzak,1700,evoker,devastation,42,26,16
5593,Дарратель,gordunni,1696,evoker,devastation,135,72,63
5594,Хетсв,gordunni,1691,evoker,devastation,96,55,41
5595,Famouszorc,sanguino,1682,evoker,devastation,131,77,54
5596,Ruinastrasza,silvermoon,1672,evoker,devastation,141,71,70
5597,Jamiewing,ravencrest,1671,evoker,devastation,124,63,61
5598,Dispelgodx,eredar,1647,evoker,devastation,42,20,22
5599,Irvethius,argent-dawn,1645,evoker,devastation,113,52,61
5600,Sürion,grim-batol,1642,evoker,devastation,60,33,27
5601,Serulyon,draenor,1636,evoker,devastation,72,37,35
5602,Piyuli,silvermoon,1632,evoker,devastation,47,27,20
5603,Papayoyo,draenor,1630,evoker,devastation,156,75,81
5604,Саммеракс,gordunni,1619,evoker,devastation,54,22,32
5605,Rahzk,twisting-nether,1616,evoker,devastation,30,17,13
5606,Batsquatch,argent-dawn,1612,evoker,devastation,36,23,13
5607,Balthinar,argent-dawn,1612,evoker,devastation,42,17,25
5608,Draxxys,blackmoore,1607,evoker,devastation,48,23,25
5609,Ocanada,draenor,1606,evoker,devastation,36,23,13
5610,Ludwoker,tarren-mill,1605,evoker,devastation,67,44,23
5611,Мнякуня,howling-fjord,1600,evoker,devastation,46,24,22
5612,Fyndassil,blackrock,1599,evoker,devastation,48,17,31
5613,Pêengei,blackrock,1596,evoker,devastation,66,36,30
5614,Denegos,sylvanas,1594,evoker,devastation,60,36,24
5615,Tezkaz,blackmoore,1591,evoker,devastation,99,50,49
5616,Shimmerscale,blackhand,1590,evoker,devastation,105,59,46
5617,Krothus,outland,1590,evoker,devastation,124,67,57
5618,Dracoli,eredar,1590,evoker,devastation,59,30,29
5619,Ðø,antonidas,1589,evoker,devastation,35,18,17
5620,Archdragon,argent-dawn,1587,evoker,devastation,36,21,15
5621,Спайрок,gordunni,1586,evoker,devastation,91,44,47
5622,Фиамниэль,gordunni,1574,evoker,devastation,36,18,18
5623,Lilpooper,bloodhoof,1565,evoker,devastation,39,22,17
5624,Ironwing,sanguino,1560,evoker,devastation,294,155,139
5625,Ch,ghostlands,1551,evoker,devastation,41,20,21
5626,Cûddles,hyjal,1548,evoker,devastation,132,68,64
5627,Углекислот,howling-fjord,1543,evoker,devastation,48,19,29
5628,Tetsú,tarren-mill,1541,evoker,devastation,42,23,19
5629,Kayly,twisting-nether,1540,evoker,devastation,42,29,13
5630,Drakea,sanguino,1539,evoker,devastation,68,38,30
5631,Lizarduck,tarren-mill,1537,evoker,devastation,45,20,25
5632,Cinnannoe,tarren-mill,1526,evoker,devastation,56,33,23
5633,Drazam,blackrock,1524,evoker,devastation,76,43,33
5634,Hyperflexx,blackrock,1521,evoker,devastation,30,16,14
5635,Emmagosa,argent-dawn,1512,evoker,devastation,48,27,21
5636,Tibimbo,blackrock,1506,evoker,devastation,68,39,29
5637,Mommystrasza,dentarg,1493,evoker,devastation,86,43,43
5638,Agnî,sanguino,1490,evoker,devastation,82,40,42
5639,Инсейнмэн,soulflayer,1489,evoker,devastation,62,31,31
5640,Kaynyxia,argent-dawn,1487,evoker,devastation,45,25,20
5641,Bodytypechad,ravencrest,1482,evoker,devastation,60,32,28
5642,Ken,la-croisade-écarlate,1482,evoker,devastation,102,54,48
5643,Dracyan,taerar,1479,evoker,devastation,42,24,18
5644,Arbylegion,outland,1478,evoker,devastation,100,54,46
5645,Лабриса,galakrond,1465,evoker,devastation,47,20,27
5646,Drákon,dalaran,1463,evoker,devastation,48,21,27
5647,Baroqs,antonidas,1456,evoker,devastation,24,18,6
5648,Nagoli,silvermoon,1456,evoker,devastation,52,27,25
5649,Malfoyer,arathor,1452,evoker,devastation,54,30,24
5650,Ghiscar,dentarg,1451,evoker,devastation,102,50,52
5651,Drakshoff,khaz-modan,1445,evoker,devastation,83,44,39
5652,Snoby,onyxia,1439,evoker,devastation,80,35,45
5653,Ларенил,gordunni,1436,evoker,devastation,30,15,15
5654,Feyrbrand,ysera,1435,evoker,devastation,30,18,12
5655,Homeoffice,zenedar,1430,evoker,devastation,24,15,9
5656,Pippomale,nemesis,1430,evoker,devastation,42,22,20
5657,Caliss,archimonde,1427,evoker,devastation,71,38,33
5658,Nazalath,eonar,1427,evoker,devastation,71,37,34
5659,Stefanosxios,bloodfeather,1416,evoker,devastation,48,22,26
5660,Jeannedebruj,ravencrest,1416,evoker,devastation,45,16,29
5661,Dowaa,tarren-mill,1414,evoker,devastation,30,15,15
5662,Паунфаунд,eversong,1411,evoker,devastation,78,36,42
5663,Parisinka,silvermoon,1400,evoker,devastation,173,89,84
5664,Tályn,twisting-nether,1389,evoker,devastation,30,17,13
5665,Darktempest,onyxia,1387,evoker,devastation,42,23,19
5666,Drunkino,aegwynn,1377,evoker,devastation,48,23,25
5667,Nathraakhza,argent-dawn,1375,evoker,devastation,42,23,19
5668,Potéto,rashgarroth,1375,evoker,devastation,60,26,34
5669,Sintharion,ravencrest,1372,evoker,devastation,39,17,22
5670,Ксдз,soulflayer,1368,evoker,devastation,42,20,22
5671,Øseria,khaz-modan,1363,evoker,devastation,42,25,17
5672,Sakade,archimonde,1359,evoker,devastation,66,22,44
5673,Rowzy,sylvanas,1350,evoker,devastation,59,28,31
5674,Ryuu,mazrigos,1343,evoker,devastation,24,14,10
5675,Yoshinora,archimonde,1337,evoker,devastation,30,15,15
5676,Fogwing,ravencrest,1330,evoker,devastation,29,15,14
5677,Karnâks,silvermoon,1326,evoker,devastation,30,16,14
5678,Favill,blackhand,1318,evoker,devastation,45,18,27
5679,Flügelnix,blackmoore,1304,evoker,devastation,30,14,16
5680,Draxone,malfurion,1297,evoker,devastation,54,33,21
5681,Steeken,haomarush,1295,evoker,devastation,54,23,31
5682,Yála,anetheron,1286,evoker,devastation,149,75,74
5683,Xtdrakaris,uldum,1281,evoker,devastation,185,87,98
5684,Airbourne,sanguino,1280,evoker,devastation,38,18,20
5685,Sharaxis,blackmoore,1279,evoker,devastation,30,17,13
5686,Кунидракон,gordunni,1276,evoker,devastation,29,14,15
5687,Shmog,stormscale,1272,evoker,devastation,41,15,26
5688,Gharløk,outland,1262,evoker,devastation,50,27,23
5689,Llael,blackhand,1259,evoker,devastation,86,36,50
5690,Коляомон,gordunni,1255,evoker,devastation,42,24,18
5691,Magmarôs,argent-dawn,1252,evoker,devastation,31,16,15
5692,Dragoncloak,blackrock,1249,evoker,devastation,72,44,28
5693,Azorgaron,outland,1246,evoker,devastation,18,13,5
5694,Swapxyevo,ravencrest,1246,evoker,devastation,24,13,11
5695,Childofdawn,blackmoore,1244,evoker,devastation,36,19,17
5696,Kuve,stormscale,1234,evoker,devastation,22,14,8
5697,Lagerstrasza,stormreaver,1234,evoker,devastation,30,13,17
5698,Grillkylling,outland,1232,evoker,devastation,24,13,11
5699,Tokzestra,hyjal,1222,evoker,devastation,62,28,34
5700,Dragonaked,silvermoon,1220,evoker,devastation,42,18,24
5701,Шотнутый,soulflayer,1219,evoker,devastation,33,18,15
5702,Heõ,twisting-nether,1215,evoker,devastation,33,14,19
5703,Душнот,fordragon,1214,evoker,devastation,30,15,15
5704,Yaldthion,dun-modr,1212,evoker,devastation,36,14,22
5705,Isizzu,draenor,1205,evoker,devastation,73,37,36
5706,Blasto,tarren-mill,1205,evoker,devastation,42,16,26
5707,Flaminghot,stormreaver,1201,evoker,devastation,158,88,70
5708,Димадракон,gordunni,1195,evoker,devastation,34,21,13
5709,Dragomakry,blackmoore,1176,evoker,devastation,18,14,4
5710,Ahiresegyfej,ragnaros,1170,evoker,devastation,42,25,17
5711,Evodraxx,hyjal,1152,evoker,devastation,24,12,12
5712,Duvahkahr,ragnaros,1149,evoker,devastation,30,12,18
5713,Nuvese,tarren-mill,1147,evoker,devastation,24,12,12
5714,Zaralek,stormscale,1145,evoker,devastation,18,12,6
5715,Туймаада,soulflayer,1141,evoker,devastation,18,12,6
5716,Sleepnot,argent-dawn,1121,evoker,devastation,18,12,6
5717,Thebigsmoke,lightbringer,1114,evoker,devastation,54,24,30
5718,Theredpepper,outland,1104,evoker,devastation,30,12,18
5719,Iolite,dun-modr,1087,evoker,devastation,72,35,37
5720,Canitabravar,cthun,1080,evoker,devastation,42,22,20
5721,Padrepì,nemesis,1078,evoker,devastation,18,13,5
5722,Akúda,blackhand,1069,evoker,devastation,36,17,19
5723,Evojøa,tarren-mill,1056,evoker,devastation,18,11,7
5724,Zmej,twisting-nether,1056,evoker,devastation,24,11,13
5725,Shenronblue,bloodscalp,1054,evoker,devastation,18,11,7
5726,Pêrcevâl,archimonde,1053,evoker,devastation,24,11,13
5727,Draghad,blackmoore,1051,evoker,devastation,24,11,13
5728,Avizz,tarren-mill,1049,evoker,devastation,15,12,3
5729,Tenshà,nemesis,1048,evoker,devastation,18,11,7
5730,Рептилойдина,howling-fjord,1030,evoker,devastation,24,11,13
5731,Voldermort,ravencrest,1018,evoker,devastation,23,11,12
5732,Алыйкиви,howling-fjord,1016,evoker,devastation,21,12,9
5733,Ekko,nethersturm,998,evoker,devastation,24,12,12
5734,Rhegal,auchindoun,960,evoker,devastation,12,10,2
5735,Lùñe,hyjal,959,evoker,devastation,12,10,2
5736,Terradòr,die-aldor,959,evoker,devastation,18,10,8
5737,Hömeöffice,sylvanas,958,evoker,devastation,18,10,8
5738,Evokimag,grim-batol,958,evoker,devastation,24,10,14
5739,Sagrax,silvermoon,958,evoker,devastation,24,10,14
5740,Enzospatalo,nemesis,955,evoker,devastation,18,10,8
5741,Maccen,twisting-nether,955,evoker,devastation,18,10,8
5742,Grajade,dun-modr,954,evoker,devastation,18,10,8
5743,Yaboismok,burning-legion,954,evoker,devastation,24,10,14
5744,Cuufizix,silvermoon,952,evoker,devastation,18,10,8
5745,Elorand,ulduar,950,evoker,devastation,24,10,14
5746,Leskano,aegwynn,948,evoker,devastation,24,12,12
5747,Scalo,kazzak,935,evoker,devastation,17,10,7
5748,Sleipnyr,garrosh,916,evoker,devastation,54,25,29
5749,Donairian,doomhammer,911,evoker,devastation,54,27,27
5750,Stormydude,doomhammer,903,evoker,devastation,18,10,8
5751,Быковскии,howling-fjord,885,evoker,devastation,42,23,19
5752,Shaze,zuljin,879,evoker,devastation,17,10,7
5753,Orazur,hyjal,864,evoker,devastation,12,9,3
5754,Deny,frostmane,864,evoker,devastation,12,9,3
5755,Гневиан,eversong,864,evoker,devastation,12,9,3
5756,Kmzi,twisting-nether,864,evoker,devastation,18,9,9
5757,Yimvoker,blackrock,864,evoker,devastation,18,9,9
5758,Yol,bladefist,864,evoker,devastation,18,9,9
5759,Аймбадикабтв,howling-fjord,863,evoker,devastation,18,9,9
5760,Amnevoker,dalaran,863,evoker,devastation,18,9,9
5761,Рогатыйдебик,gordunni,863,evoker,devastation,18,9,9
5762,Lektar,eredar,862,evoker,devastation,18,9,9
5763,Saragoza,kirin-tor,862,evoker,devastation,18,9,9
5764,Dschíses,malganis,858,evoker,devastation,18,9,9
5765,Crygon,outland,857,evoker,devastation,18,9,9
5766,Флардикас,gordunni,842,evoker,devastation,24,9,15
5767,Dragonhero,arygos,830,evoker,devastation,36,16,20
5768,Dragotar,malygos,814,evoker,devastation,28,11,17
5769,Mazakqt,draenor,768,evoker,devastation,12,8,4
5770,Пивнаябошка,soulflayer,768,evoker,devastation,12,8,4
5771,Tsunamì,ysondre,768,evoker,devastation,12,8,4
5772,Obbwoke,ravencrest,768,evoker,devastation,16,9,7
5773,Meust,destromath,768,evoker,devastation,18,8,10
5774,Zp,kazzak,768,evoker,devastation,18,8,10
5775,Nekrosdrake,tarren-mill,768,evoker,devastation,18,8,10
5776,Dragonlia,blackrock,767,evoker,devastation,12,8,4
5777,Fayral,blackmoore,767,evoker,devastation,12,8,4
5778,Balerioon,draenor,767,evoker,devastation,12,8,4
5779,Dragonide,draenor,767,evoker,devastation,18,8,10
5780,Deathwingx,sylvanas,767,evoker,devastation,18,8,10
5781,Flawxy,blackmoore,766,evoker,devastation,18,8,10
5782,Evosker,zuljin,764,evoker,devastation,24,8,16
5783,Ayders,khaz-modan,764,evoker,devastation,24,8,16
5784,Firebutt,argent-dawn,763,evoker,devastation,12,8,4
5785,Keeqo,silvermoon,762,evoker,devastation,18,8,10
5786,Imwhite,doomhammer,761,evoker,devastation,18,8,10
5787,Ольменго,fordragon,735,evoker,devastation,17,8,9
5788,Rîncêwind,uldum,726,evoker,devastation,18,8,10
5789,Эбиб,gordunni,672,evoker,devastation,12,7,5
5790,Crueh,outland,672,evoker,devastation,12,7,5
5791,Varagon,rexxar,672,evoker,devastation,12,7,5
5792,Melodio,outland,672,evoker,devastation,12,7,5
5793,Kôlaghan,archimonde,672,evoker,devastation,12,7,5
5794,Sebek,archimonde,672,evoker,devastation,12,7,5
5795,Zapaflap,silvermoon,672,evoker,devastation,12,7,5
5796,Saintly,kult-der-verdammten,672,evoker,devastation,18,7,11
5797,Aegón,uldum,672,evoker,devastation,18,7,11
5798,Bindrasz,ahnqiraj,672,evoker,devastation,18,7,11
5799,Evoslaps,norgannon,671,evoker,devastation,12,7,5
5800,Woasid,outland,671,evoker,devastation,12,7,5
5801,Stalkhyr,elune,671,evoker,devastation,18,7,11
5802,Rytoshi,medivh,671,evoker,devastation,24,7,17
5803,Enemi,twisting-nether,669,evoker,devastation,14,9,5
5804,Fruhans,tarren-mill,667,evoker,devastation,12,7,5
5805,Vucashi,blackhand,665,evoker,devastation,18,7,11
5806,Scalash,drakthul,658,evoker,devastation,12,7,5
5807,Azzul,teldrassil,630,evoker,devastation,13,9,4
5808,Zharas,nemesis,623,evoker,devastation,11,7,4
5809,Morsan,tichondrius,619,evoker,devastation,11,7,4
5810,Dovakin,arathi,601,evoker,devastation,14,7,7
5811,Lago,gorgonnash,588,evoker,devastation,13,7,6
5812,Zpartadraga,ragnaros,584,evoker,devastation,9,8,1
5813,Henmon,defias-brotherhood,576,evoker,devastation,6,6,0
5814,Øxyom,archimonde,576,evoker,devastation,10,7,3
5815,Glurakk,aegwynn,576,evoker,devastation,12,6,6
5816,Terrorclaw,ragnaros,576,evoker,devastation,12,6,6
5817,Dracalos,silvermoon,576,evoker,devastation,12,6,6
5818,Khimari,xavius,576,evoker,devastation,12,6,6
5819,Draknil,ysondre,576,evoker,devastation,12,6,6
5820,Spicylizard,stormscale,576,evoker,devastation,12,6,6
5821,Scathethrel,draenor,576,evoker,devastation,12,6,6
5822,Tremmérz,outland,576,evoker,devastation,12,6,6
5823,Mattyastrasz,hyjal,576,evoker,devastation,12,6,6
5824,Krazuntus,argent-dawn,576,evoker,devastation,12,6,6
5825,Solandor,kazzak,576,evoker,devastation,12,6,6
5826,Haltorr,ravencrest,576,evoker,devastation,18,6,12
5827,Lifestrasza,drakthul,575,evoker,devastation,6,6,0
5828,Chunlooi,baelgun,575,evoker,devastation,12,6,6
5829,Dratheon,dun-modr,575,evoker,devastation,12,6,6
5830,Xfckd,ragnaros,575,evoker,devastation,12,6,6
5831,Алексатэтсуя,ashenvale,574,evoker,devastation,18,6,12
5832,Firaxis,kazzak,573,evoker,devastation,12,6,6
5833,Xatures,twisting-nether,572,evoker,devastation,6,6,0
5834,Ryújín,blackhand,527,evoker,devastation,17,6,11
5835,Ashlàr,earthen-ring,525,evoker,devastation,15,6,9
5836,Rise,tarren-mill,522,evoker,devastation,12,7,5
5837,Jelboen,draenor,510,evoker,devastation,10,6,4
5838,Juicyjeffe,blackrock,480,evoker,devastation,6,5,1
5839,Jinthyr,anachronos,480,evoker,devastation,6,5,1
5840,Raagnar,kazzak,480,evoker,devastation,12,5,7
5841,Abehethan,archimonde,480,evoker,devastation,12,5,7
5842,Леерустан,howling-fjord,480,evoker,devastation,12,5,7
5843,Pandagos,archimonde,480,evoker,devastation,12,5,7
5844,Loveheart,die-aldor,480,evoker,devastation,12,5,7
5845,Dracnass,silvermoon,480,evoker,devastation,12,5,7
5846,Burnrate,draenor,480,evoker,devastation,12,5,7
5847,Pavelito,ysondre,480,evoker,devastation,12,5,7
5848,Sloeez,kazzak,480,evoker,devastation,18,5,13
5849,Dakir,blackmoore,479,evoker,devastation,8,5,3
5850,Vermithors,ravencrest,479,evoker,devastation,12,5,7
5851,Dragônslayer,amanthul,478,evoker,devastation,6,5,1
5852,Vanima,forscherliga,477,evoker,devastation,6,5,1
5853,Lugarius,gilneas,477,evoker,devastation,16,6,10
5854,Syraxis,shadowsong,415,evoker,devastation,10,5,5
5855,Elitedraach,tarren-mill,384,evoker,devastation,6,4,2
5856,Pinacóladaqt,stormscale,384,evoker,devastation,6,4,2
5857,Scalewind,twisting-nether,384,evoker,devastation,6,4,2
5858,Dragorus,stormscale,384,evoker,devastation,6,4,2
5859,Wurm,shadowsong,384,evoker,devastation,6,4,2
5860,Nurilla,twisting-nether,384,evoker,devastation,6,4,2
5861,Skiora,argent-dawn,384,evoker,devastation,6,4,2
5862,Karistrasza,sylvanas,384,evoker,devastation,6,4,2
5863,Iblvicanfly,stormscale,384,evoker,devastation,6,4,2
5864,Штеци,howling-fjord,384,evoker,devastation,6,4,2
5865,Nochance,dentarg,384,evoker,devastation,6,4,2
5866,Zyevoker,silvermoon,384,evoker,devastation,6,4,2
5867,Deathdream,stormscale,384,evoker,devastation,6,4,2
5868,Advancedboy,archimonde,384,evoker,devastation,6,4,2
5869,Croker,ravencrest,384,evoker,devastation,12,4,8
5870,Dracofeuxd,archimonde,384,evoker,devastation,12,4,8
5871,Nynnaydoth,drakthul,384,evoker,devastation,12,4,8
5872,Лавеон,gordunni,384,evoker,devastation,12,4,8
5873,Skywitch,ragnaros,384,evoker,devastation,18,4,14
5874,Hekatonshire,hyjal,383,evoker,devastation,6,4,2
5875,Bombrush,ragnaros,383,evoker,devastation,9,5,4
5876,Sheego,anetheron,382,evoker,devastation,6,4,2
5877,Davioncz,thunderhorn,382,evoker,devastation,6,4,2
5878,Calonddraig,turalyon,382,evoker,devastation,6,4,2
5879,Мизурион,gordunni,382,evoker,devastation,6,4,2
5880,Kayizer,archimonde,382,evoker,devastation,6,4,2
5881,Dracsamdi,tarren-mill,367,evoker,devastation,11,4,7
5882,Somntersu,argent-dawn,319,evoker,devastation,5,4,1
5883,Mollÿ,sanguino,288,evoker,devastation,6,3,3
5884,Fivebeers,silvermoon,288,evoker,devastation,6,3,3
5885,Драккалис,eversong,288,evoker,devastation,6,3,3
5886,Feinerkerl,blackmoore,288,evoker,devastation,6,3,3
5887,Gonzalo,dun-modr,288,evoker,devastation,6,3,3
5888,Whaazzdragon,tarren-mill,288,evoker,devastation,6,3,3
5889,Azurog,blackmoore,288,evoker,devastation,6,3,3
5890,Ðragøn,argent-dawn,288,evoker,devastation,6,3,3
5891,Dracofion,ravencrest,288,evoker,devastation,6,3,3
5892,Jrmdragik,kaelthas,288,evoker,devastation,6,3,3
5893,Ughvoker,kazzak,288,evoker,devastation,6,3,3
5894,Nørgan,die-aldor,288,evoker,devastation,6,3,3
5895,Hateroll,ravencrest,288,evoker,devastation,6,3,3
5896,Darthagos,outland,288,evoker,devastation,6,3,3
5897,Predictrash,archimonde,288,evoker,devastation,6,3,3
5898,Nerfmeplze,outland,288,evoker,devastation,6,3,3
5899,Lajra,ragnaros,288,evoker,devastation,6,3,3
5900,Geckonen,stormreaver,288,evoker,devastation,6,3,3
5901,Feldrac,ravencrest,288,evoker,devastation,6,3,3
5902,Apacstrasza,ragnaros,288,evoker,devastation,6,3,3
5903,Zettaflare,nazjatar,288,evoker,devastation,6,3,3
5904,Daboc,tarren-mill,288,evoker,devastation,6,3,3
5905,Ripgódx,bronzebeard,288,evoker,devastation,6,3,3
5906,Malowux,outland,288,evoker,devastation,6,3,3
5907,Dalsath,silvermoon,288,evoker,devastation,6,3,3
5908,Tiganj,silvermoon,288,evoker,devastation,6,3,3
5909,Azustraza,ysondre,288,evoker,devastation,6,3,3
5910,Paizz,tarren-mill,288,evoker,devastation,6,3,3
5911,Drachenwut,aegwynn,288,evoker,devastation,6,3,3
5912,Jaykvoker,kazzak,288,evoker,devastation,6,3,3
5913,Puffdaddyxd,twisting-nether,288,evoker,devastation,6,3,3
5914,Mazzg,blackmoore,288,evoker,devastation,9,4,5
5915,Kirien,blackhand,288,evoker,devastation,12,3,9
5916,Ryuujin,outland,288,evoker,devastation,12,3,9
5917,Veo,aggra-português,288,evoker,devastation,12,3,9
5918,Tamargon,frostwhisper,288,evoker,devastation,12,3,9
5919,Valdrakken,anubarak,288,evoker,devastation,12,3,9
5920,Hästdrake,the-maelstrom,288,evoker,devastation,12,3,9
5921,Belianf,silvermoon,287,evoker,devastation,6,3,3
5922,Shenrøn,garona,287,evoker,devastation,6,3,3
5923,Sivaas,arathi,286,evoker,devastation,6,3,3
5924,Филлид,gordunni,255,evoker,devastation,8,4,4
5925,Серцедраконн,gordunni,240,evoker,devastation,9,3,6
5926,Exitelolx,blackrock,192,evoker,devastation,6,2,4
5927,Draaxy,twisting-nether,192,evoker,devastation,6,2,4
5928,Chürbis,blackmoore,192,evoker,devastation,6,2,4
5929,Митокада,soulflayer,192,evoker,devastation,6,2,4
5930,Xendragon,kazzak,192,evoker,devastation,6,2,4
5931,Gasparievok,sylvanas,192,evoker,devastation,6,2,4
5932,Rokki,blackrock,192,evoker,devastation,6,2,4
5933,Wuiflyta,dun-modr,192,evoker,devastation,6,2,4
5934,Raøug,blackmoore,192,evoker,devastation,6,2,4
5935,Bæxo,blackrock,192,evoker,devastation,6,2,4
5936,Adamâs,archimonde,192,evoker,devastation,6,2,4
5937,Bal,arakarahm,192,evoker,devastation,6,2,4
5938,Kda,die-nachtwache,192,evoker,devastation,6,2,4
5939,Reddeaddrago,silvermoon,192,evoker,devastation,6,2,4
5940,Дракарус,soulflayer,192,evoker,devastation,6,2,4
5941,Bittewhyally,grim-batol,192,evoker,devastation,6,2,4
5942,Ellphi,illidan,192,evoker,devastation,6,2,4
5943,Niluslangbal,stormscale,192,evoker,devastation,6,2,4
5944,Skulblakas,blackmoore,192,evoker,devastation,6,2,4
5945,Otr,draenor,192,evoker,devastation,6,2,4
5946,Twokgbananas,blackhand,192,evoker,devastation,6,2,4
5947,Vynestria,argent-dawn,192,evoker,devastation,6,2,4
5948,Fueu,draenor,192,evoker,devastation,6,2,4
5949,Ppiaxx,dalaran,192,evoker,devastation,6,2,4
5950,Norskairline,kazzak,192,evoker,devastation,6,2,4
5951,Kroqmoo,drekthar,192,evoker,devastation,7,2,5
5952,Andragosa,confrérie-du-thorium,192,evoker,devastation,12,2,10
5953,Дракомант,eversong,192,evoker,devastation,12,2,10
5954,Jacra,twisting-nether,192,evoker,devastation,12,2,10
5955,Tenkenfutsu,elune,192,evoker,devastation,18,2,16
5956,Kraakraa,turalyon,191,evoker,devastation,6,2,4
5957,Drakridarn,kazzak,159,evoker,devastation,5,2,3
5958,Gypsydrake,tarren-mill,159,evoker,devastation,8,3,5
5959,Йормунгандка,soulflayer,144,evoker,devastation,9,3,6
5960,Tremola,twisting-nether,128,evoker,devastation,4,2,2
5961,Tneen,stormscale,96,evoker,devastation,3,2,1
5962,Кеннокс,soulflayer,96,evoker,devastation,6,1,5
5963,Evøkergøðx,outland,96,evoker,devastation,6,1,5
5964,Zørix,hyjal,96,evoker,devastation,6,1,5
5965,Nybxx,frostmane,96,evoker,devastation,6,1,5
5966,Terrorwings,twisting-nether,96,evoker,devastation,6,1,5
5967,Ominobari,silvermoon,96,evoker,devastation,6,1,5
5968,Мельхиор,booty-bay,96,evoker,devastation,6,1,5
5969,Czerwonooki,turalyon,96,evoker,devastation,6,1,5
5970,Oeos,dragonblight,96,evoker,devastation,6,1,5
5971,Dracarysfire,kazzak,96,evoker,devastation,6,1,5
5972,Asharys,argent-dawn,96,evoker,devastation,6,1,5
5973,Släshés,ravencrest,96,evoker,devastation,6,1,5
5974,Eosin,blackrock,96,evoker,devastation,6,1,5
5975,Devanthar,argent-dawn,96,evoker,devastation,6,1,5
5976,Oldlizard,blackrock,96,evoker,devastation,6,1,5
5977,Ronmanarmy,blackrock,96,evoker,devastation,6,1,5
5978,Spioche,burning-legion,96,evoker,devastation,12,1,11
5979,Xidalulz,sylvanas,63,evoker,devastation,2,2,0
5980,Bulydracguir,kazzak,42,evoker,devastation,7,2,5
5981,Âspên,archimonde,31,evoker,devastation,2,1,1
5982,Stavfel,kazzak,2037,hunter,marksmanship,89,49,40
5983,Pjållistani,ravencrest,2014,hunter,marksmanship,113,64,49
5984,Matasso,burning-legion,1982,hunter,marksmanship,107,55,52
5985,Nennimi,ravencrest,1978,hunter,marksmanship,87,44,43
5986,Alêx,outland,1973,hunter,marksmanship,114,58,56
5987,Мартидэн,howling-fjord,1949,hunter,marksmanship,137,67,70
5988,Yezzu,sylvanas,1936,hunter,marksmanship,68,34,34
5989,Huprah,ravencrest,1901,hunter,marksmanship,126,63,63
5990,Душнила,razuvious,1898,hunter,marksmanship,83,44,39
5991,Yasuohasagi,archimonde,1828,hunter,marksmanship,42,23,19
5992,Evacuatur,argent-dawn,1826,hunter,marksmanship,66,33,33
5993,Wildheárt,aegwynn,1824,hunter,marksmanship,66,35,31
5994,Ancalarion,tarren-mill,1824,hunter,marksmanship,54,26,28
5995,Techpoint,silvermoon,1816,hunter,marksmanship,42,27,15
5996,Crôwley,twisting-nether,1816,hunter,marksmanship,54,30,24
5997,Xanter,blackrock,1806,hunter,marksmanship,36,20,16
5998,Áñmy,ravencrest,1804,hunter,marksmanship,53,28,25
5999,Mogwai,stormscale,1801,hunter,marksmanship,59,29,30
6000,Wruck,echsenkessel,1779,hunter,marksmanship,42,29,13
6001,Myice,twisting-nether,1771,hunter,marksmanship,66,36,30
6002,Hallé,frostmane,1769,hunter,marksmanship,66,39,27
6003,Murtagh,khaz-modan,1767,hunter,marksmanship,66,35,31
6004,Ceitronox,argent-dawn,1765,hunter,marksmanship,42,23,19
6005,Buffrøgues,ravencrest,1728,hunter,marksmanship,62,31,31
6006,Trashcarlito,eredar,1725,hunter,marksmanship,36,23,13
6007,Onlystuns,sylvanas,1720,hunter,marksmanship,47,22,25
6008,Strikke,archimonde,1709,hunter,marksmanship,42,18,24
6009,Bestregards,ravencrest,1708,hunter,marksmanship,71,29,42
6010,Johnreapèr,sylvanas,1698,hunter,marksmanship,65,29,36
6011,Scheixanter,drakthul,1684,hunter,marksmanship,95,46,49
6012,Skilachi,stormscale,1684,hunter,marksmanship,48,21,27
6013,Lowcaskor,turalyon,1678,hunter,marksmanship,47,26,21
6014,Bearmane,tarren-mill,1670,hunter,marksmanship,82,42,40
6015,Jabela,eredar,1668,hunter,marksmanship,78,35,43
6016,Huntrag,tarren-mill,1663,hunter,marksmanship,115,55,60
6017,Hï,eitrigg,1662,hunter,marksmanship,48,21,27
6018,Eldrekou,kazzak,1657,hunter,marksmanship,48,22,26
6019,Murkek,drakthul,1653,hunter,marksmanship,42,26,16
6020,Speedhack,argent-dawn,1650,hunter,marksmanship,63,35,28
6021,Dragnial,kazzak,1649,hunter,marksmanship,47,22,25
6022,Травок,gordunni,1648,hunter,marksmanship,58,32,26
6023,Ремонтлицаа,gordunni,1642,hunter,marksmanship,85,49,36
6024,Velrox,blackmoore,1641,hunter,marksmanship,48,23,25
6025,Triggaz,stormscale,1635,hunter,marksmanship,46,21,25
6026,Naid,lordaeron,1632,hunter,marksmanship,36,20,16
6027,Куфачка,soulflayer,1627,hunter,marksmanship,36,17,19
6028,Адвентурер,howling-fjord,1624,hunter,marksmanship,84,46,38
6029,Ледо,deathguard,1621,hunter,marksmanship,42,19,23
6030,Amistat,kazzak,1614,hunter,marksmanship,54,23,31
6031,Khregan,aerie-peak,1612,hunter,marksmanship,36,17,19
6032,Evengance,dragonblight,1611,hunter,marksmanship,48,34,14
6033,Дарктеххно,howling-fjord,1611,hunter,marksmanship,30,17,13
6034,Inayah,outland,1607,hunter,marksmanship,85,48,37
6035,Streetxpres,nethersturm,1602,hunter,marksmanship,35,19,16
6036,Lenooby,blades-edge,1600,hunter,marksmanship,36,20,16
6037,Килофвратх,gordunni,1594,hunter,marksmanship,54,25,29
6038,Gugenot,tarren-mill,1589,hunter,marksmanship,56,33,23
6039,Desudi,tarren-mill,1588,hunter,marksmanship,59,30,29
6040,Recrent,kazzak,1582,hunter,marksmanship,96,53,43
6041,Длинноемоджо,soulflayer,1576,hunter,marksmanship,96,47,49
6042,Dexter,ravencrest,1575,hunter,marksmanship,89,38,51
6043,Chaussons,kazzak,1570,hunter,marksmanship,78,42,36
6044,Лисатия,gordunni,1562,hunter,marksmanship,48,22,26
6045,Мизэрица,soulflayer,1556,hunter,marksmanship,60,29,31
6046,Natchell,ysondre,1555,hunter,marksmanship,36,18,18
6047,Mantinell,hellfire,1553,hunter,marksmanship,36,20,16
6048,Yarnvid,twisting-nether,1549,hunter,marksmanship,93,49,44
6049,Lebalaffré,arathi,1537,hunter,marksmanship,71,37,34
6050,Nidaliyae,archimonde,1532,hunter,marksmanship,36,16,20
6051,Vangeroth,kazzak,1531,hunter,marksmanship,132,70,62
6052,Mînérvá,blackhand,1530,hunter,marksmanship,54,35,19
6053,Афигеннски,ashenvale,1527,hunter,marksmanship,42,21,21
6054,Doncar,stormscale,1527,hunter,marksmanship,57,28,29
6055,Vavabxl,ysondre,1524,hunter,marksmanship,60,31,29
6056,Elja,laughing-skull,1521,hunter,marksmanship,30,19,11
6057,Миссклик,soulflayer,1515,hunter,marksmanship,30,20,10
6058,Jup,elune,1507,hunter,marksmanship,49,17,32
6059,Eferos,quelthalas,1502,hunter,marksmanship,36,16,20
6060,Rattentäter,alexstrasza,1498,hunter,marksmanship,54,28,26
6061,Minisay,magtheridon,1491,hunter,marksmanship,196,95,101
6062,Summa,silvermoon,1482,hunter,marksmanship,54,26,28
6063,Хальвеген,gordunni,1461,hunter,marksmanship,117,57,60
6064,Tntabsotrap,silvermoon,1456,hunter,marksmanship,40,23,17
6065,Nanns,silvermoon,1456,hunter,marksmanship,41,21,20
6066,Rex,chamber-of-aspects,1454,hunter,marksmanship,39,23,16
6067,Autoturret,eredar,1454,hunter,marksmanship,48,24,24
6068,Meinkoenig,frostwolf,1448,hunter,marksmanship,48,30,18
6069,Будкусломаю,grom,1447,hunter,marksmanship,77,35,42
6070,Bapt,blackrock,1447,hunter,marksmanship,42,17,25
6071,Hunsed,sanguino,1445,hunter,marksmanship,36,23,13
6072,Balamut,aegwynn,1445,hunter,marksmanship,83,45,38
6073,Asthorio,stormscale,1442,hunter,marksmanship,83,36,47
6074,Аскентр,gordunni,1439,hunter,marksmanship,30,16,14
6075,Джоуе,ashenvale,1437,hunter,marksmanship,30,15,15
6076,Kariss,khaz-modan,1437,hunter,marksmanship,84,38,46
6077,Luuszapfae,aegwynn,1436,hunter,marksmanship,29,16,13
6078,Nagu,antonidas,1435,hunter,marksmanship,30,15,15
6079,Skillzone,silvermoon,1432,hunter,marksmanship,36,15,21
6080,Mindgap,pozzo-delleternità,1421,hunter,marksmanship,54,25,29
6081,Kalima,malfurion,1416,hunter,marksmanship,72,28,44
6082,Firescorpion,onyxia,1414,hunter,marksmanship,30,19,11
6083,Шимэйла,gordunni,1414,hunter,marksmanship,43,22,21
6084,Darts,outland,1414,hunter,marksmanship,30,15,15
6085,Elonyr,sanguino,1411,hunter,marksmanship,196,90,106
6086,Bøøgy,silvermoon,1403,hunter,marksmanship,78,43,35
6087,Hiðe,archimonde,1399,hunter,marksmanship,56,28,28
6088,Meskette,ravencrest,1396,hunter,marksmanship,24,15,9
6089,Miladinorc,azjolnerub,1395,hunter,marksmanship,24,15,9
6090,Àfpro,hyjal,1394,hunter,marksmanship,30,15,15
6091,Podroto,tyrande,1387,hunter,marksmanship,35,15,20
6092,Carpante,nemesis,1384,hunter,marksmanship,54,23,31
6093,Gilgharsh,rajaxx,1380,hunter,marksmanship,42,20,22
6094,Lincolne,ravencrest,1375,hunter,marksmanship,41,17,24
6095,Stingarrow,stormscale,1374,hunter,marksmanship,42,24,18
6096,Дисконнэктор,soulflayer,1374,hunter,marksmanship,48,17,31
6097,Encore,sylvanas,1365,hunter,marksmanship,42,21,21
6098,Iòvól,azuremyst,1364,hunter,marksmanship,60,33,27
6099,Boomkillshot,zuljin,1363,hunter,marksmanship,42,26,16
6100,Slmao,tarren-mill,1357,hunter,marksmanship,60,27,33
6101,Ensomnia,silvermoon,1354,hunter,marksmanship,18,15,3
6102,Szybky,defias-brotherhood,1354,hunter,marksmanship,60,25,35
6103,Оленнька,howling-fjord,1349,hunter,marksmanship,36,21,15
6104,Selaesa,chamber-of-aspects,1345,hunter,marksmanship,36,18,18
6105,Cenaa,ragnaros,1343,hunter,marksmanship,19,14,5
6106,Xqzmytrapz,blackrock,1334,hunter,marksmanship,30,14,16
6107,Rzeezznik,burning-legion,1333,hunter,marksmanship,24,14,10
6108,Amphi,stormscale,1333,hunter,marksmanship,54,30,24
6109,Aimnfire,anachronos,1333,hunter,marksmanship,36,18,18
6110,Røxxilia,blackmoore,1333,hunter,marksmanship,54,23,31
6111,Glad,argent-dawn,1333,hunter,marksmanship,55,21,34
6112,Mizumo,burning-legion,1332,hunter,marksmanship,59,34,25
6113,Deadfire,hyjal,1325,hunter,marksmanship,42,20,22
6114,Diapositiv,draenor,1325,hunter,marksmanship,30,14,16
6115,Zirgoo,outland,1320,hunter,marksmanship,66,28,38
6116,Pickaboo,defias-brotherhood,1316,hunter,marksmanship,118,52,66
6117,Narawinger,silvermoon,1310,hunter,marksmanship,36,21,15
6118,Arrowdoxx,silvermoon,1310,hunter,marksmanship,117,51,66
6119,Prodanhunts,frostmane,1306,hunter,marksmanship,60,28,32
6120,Høward,aegwynn,1300,hunter,marksmanship,36,20,16
6121,Samhunt,blackrock,1299,hunter,marksmanship,29,14,15
6122,Yoúmad,draenor,1288,hunter,marksmanship,28,14,14
6123,Smitheye,argent-dawn,1287,hunter,marksmanship,84,40,44
6124,Narøs,blackhand,1286,hunter,marksmanship,60,26,34
6125,Kyudo,ravencrest,1286,hunter,marksmanship,35,15,20
6126,Rabiate,blackrock,1284,hunter,marksmanship,34,16,18
6127,Bigfoot,argent-dawn,1283,hunter,marksmanship,84,37,47
6128,Doomhorg,quelthalas,1276,hunter,marksmanship,60,30,30
6129,Moschtix,forscherliga,1263,hunter,marksmanship,42,15,27
6130,Хантвкроксах,gordunni,1257,hunter,marksmanship,22,14,8
6131,Booms,eonar,1254,hunter,marksmanship,65,31,34
6132,Одисенс,eversong,1250,hunter,marksmanship,57,30,27
6133,Mönster,ravenholdt,1248,hunter,marksmanship,27,14,13
6134,Drxta,blackrock,1246,hunter,marksmanship,36,13,23
6135,Jamzyhunter,emerald-dream,1243,hunter,marksmanship,30,13,17
6136,Iilac,argent-dawn,1242,hunter,marksmanship,184,104,80
6137,Barnabaz,skullcrusher,1238,hunter,marksmanship,24,13,11
6138,Surtfire,alonsus,1237,hunter,marksmanship,24,13,11
6139,Shedzargo,twisting-nether,1234,hunter,marksmanship,24,13,11
6140,Fränko,ravencrest,1234,hunter,marksmanship,30,13,17
6141,Mmaaee,ravencrest,1228,hunter,marksmanship,28,14,14
6142,Babclaar,culte-de-la-rive-noire,1227,hunter,marksmanship,18,13,5
6143,Rmnsbm,blackmoore,1224,hunter,marksmanship,24,13,11
6144,Travels,tarren-mill,1222,hunter,marksmanship,30,13,17
6145,Redneckjoe,draenor,1219,hunter,marksmanship,41,18,23
6146,Fauda,hellscream,1215,hunter,marksmanship,24,13,11
6147,Elyxa,ysondre,1211,hunter,marksmanship,54,30,24
6148,Bollo,malganis,1211,hunter,marksmanship,29,13,16
6149,Gromaya,elune,1210,hunter,marksmanship,29,14,15
6150,Blackas,dun-modr,1208,hunter,marksmanship,42,19,23
6151,Touscahunter,kazzak,1207,hunter,marksmanship,156,79,77
6152,Vïcødïnë,sinstralis,1205,hunter,marksmanship,42,17,25
6153,Arize,quelthalas,1204,hunter,marksmanship,67,32,35
6154,Jeston,amanthul,1202,hunter,marksmanship,31,14,17
6155,Skohal,draenor,1200,hunter,marksmanship,78,36,42
6156,Watty,chogall,1195,hunter,marksmanship,88,45,43
6157,Naven,minahonda,1170,hunter,marksmanship,36,15,21
6158,Blowplac,moonglade,1157,hunter,marksmanship,34,14,20
6159,Sâetha,dun-modr,1157,hunter,marksmanship,36,14,22
6160,Jodd,ragnaros,1152,hunter,marksmanship,24,12,12
6161,Olyleskotch,ravencrest,1152,hunter,marksmanship,24,12,12
6162,Eenel,twisting-nether,1148,hunter,marksmanship,24,12,12
6163,Farmerjoee,alakir,1147,hunter,marksmanship,24,13,11
6164,Kendow,blackrock,1146,hunter,marksmanship,55,24,31
6165,Роктджана,deathguard,1143,hunter,marksmanship,24,12,12
6166,Smekminbåge,tarren-mill,1142,hunter,marksmanship,30,12,18
6167,Poatan,outland,1140,hunter,marksmanship,105,52,53
6168,Swïtchz,hyjal,1140,hunter,marksmanship,27,13,14
6169,Хапмьюзик,howling-fjord,1138,hunter,marksmanship,42,13,29
6170,Voitelka,terokkar,1137,hunter,marksmanship,50,26,24
6171,Tinlop,ragnaros,1137,hunter,marksmanship,42,17,25
6172,Хакаар,grom,1136,hunter,marksmanship,30,14,16
6173,Cooroona,stormrage,1119,hunter,marksmanship,24,12,12
6174,Serihu,cthun,1119,hunter,marksmanship,36,12,24
6175,Xesih,twisting-nether,1116,hunter,marksmanship,35,13,22
6176,Souljâh,ravencrest,1093,hunter,marksmanship,23,12,11
6177,Анхантэй,lich-king,1092,hunter,marksmanship,136,69,67
6178,Overhït,hyjal,1088,hunter,marksmanship,71,31,40
6179,Сандабар,borean-tundra,1083,hunter,marksmanship,35,18,17
6180,Breier,argent-dawn,1082,hunter,marksmanship,30,13,17
6181,Thelasiel,aerie-peak,1079,hunter,marksmanship,67,33,34
6182,Lillynahh,argent-dawn,1066,hunter,marksmanship,84,34,50
6183,Opsi,area-52,1066,hunter,marksmanship,32,12,20
6184,Sisilianno,khaz-modan,1063,hunter,marksmanship,43,15,28
6185,Epheso,daggerspine,1055,hunter,marksmanship,18,11,7
6186,Suchskill,stormreaver,1055,hunter,marksmanship,24,11,13
6187,Iceyx,stormscale,1055,hunter,marksmanship,30,11,19
6188,Dentaar,draenor,1054,hunter,marksmanship,83,40,43
6189,Darm,sunstrider,1054,hunter,marksmanship,24,11,13
6190,Короткиствол,gordunni,1051,hunter,marksmanship,30,11,19
6191,Artémíss,kazzak,1050,hunter,marksmanship,24,11,13
6192,Kbesagrillo,sanguino,1050,hunter,marksmanship,24,11,13
6193,Слезыотлука,howling-fjord,1048,hunter,marksmanship,18,11,7
6194,Zendar,blackmoore,1047,hunter,marksmanship,33,12,21
6195,Xalaar,frostwolf,1044,hunter,marksmanship,18,11,7
6196,Swáy,twisting-nether,1041,hunter,marksmanship,196,89,107
6197,Винтаж,deepholm,1041,hunter,marksmanship,59,26,33
6198,Cêdric,alleria,1041,hunter,marksmanship,28,12,16
6199,Maroxy,ragnaros,1039,hunter,marksmanship,29,11,18
6200,Crní,tarren-mill,1024,hunter,marksmanship,18,11,7
6201,Fetts,silvermoon,1023,hunter,marksmanship,24,11,13
6202,Lonewolfe,ravencrest,1021,hunter,marksmanship,90,39,51
6203,Slicer,arthas,1019,hunter,marksmanship,43,16,27
6204,Noobatala,tarren-mill,1018,hunter,marksmanship,36,17,19
6205,Tránsphobic,kilrogg,1017,hunter,marksmanship,24,11,13
6206,Laara,khaz-modan,1009,hunter,marksmanship,77,37,40
6207,Bendit,eredar,1009,hunter,marksmanship,30,11,19
6208,Tungusta,defias-brotherhood,1006,hunter,marksmanship,42,19,23
6209,Nutzz,ragnaros,1006,hunter,marksmanship,41,15,26
6210,Jaýlah,draenor,991,hunter,marksmanship,54,24,30
6211,Bonquiesha,tarren-mill,991,hunter,marksmanship,25,11,14
6212,Lookmyezzy,ravencrest,990,hunter,marksmanship,20,11,9
6213,Bélier,hyjal,986,hunter,marksmanship,30,14,16
6214,Ártemide,pozzo-delleternità,975,hunter,marksmanship,33,15,18
6215,Oatmeal,dun-morogh,974,hunter,marksmanship,50,22,28
6216,Azsräel,dalaran,972,hunter,marksmanship,35,15,20
6217,Ispo,frostwolf,969,hunter,marksmanship,52,21,31
6218,Talcaliste,archimonde,964,hunter,marksmanship,38,14,24
6219,Квит,blackscar,960,hunter,marksmanship,24,10,14
6220,Velites,aggra-português,959,hunter,marksmanship,18,10,8
6221,Yelanna,argent-dawn,957,hunter,marksmanship,18,10,8
6222,Huntazt,draenor,956,hunter,marksmanship,18,10,8
6223,Tiidus,burning-legion,955,hunter,marksmanship,18,10,8
6224,Setis,uldaman,955,hunter,marksmanship,36,10,26
6225,Фузег,deathguard,953,hunter,marksmanship,18,10,8
6226,Taveon,turalyon,953,hunter,marksmanship,18,10,8
6227,Rediction,ravencrest,953,hunter,marksmanship,24,10,14
6228,Azaella,tarren-mill,948,hunter,marksmanship,18,10,8
6229,Aaryel,outland,948,hunter,marksmanship,18,10,8
6230,Aliyah,blackmoore,946,hunter,marksmanship,42,24,18
6231,Freezyshinkn,blackrock,945,hunter,marksmanship,18,11,7
6232,Tomtus,aggramar,944,hunter,marksmanship,31,14,17
6233,Hardscoped,tarren-mill,941,hunter,marksmanship,29,10,19
6234,Феорика,grom,939,hunter,marksmanship,30,10,20
6235,Celtya,archimonde,934,hunter,marksmanship,18,10,8
6236,Madida,ravencrest,925,hunter,marksmanship,12,10,2
6237,Эвилтар,soulflayer,925,hunter,marksmanship,20,11,9
6238,Амобарбиталх,gordunni,901,hunter,marksmanship,33,11,22
6239,Каизик,soulflayer,898,hunter,marksmanship,23,10,13
6240,Ekz,twisting-nether,894,hunter,marksmanship,22,10,12
6241,Adventures,darkmoon-faire,881,hunter,marksmanship,18,10,8
6242,Luckyshooter,nethersturm,877,hunter,marksmanship,71,32,39
6243,Aszasi,azjolnerub,871,hunter,marksmanship,25,10,15
6244,Krøsh,blackmoore,870,hunter,marksmanship,36,16,20
6245,Grafhunter,antonidas,865,hunter,marksmanship,44,21,23
6246,Feelmyfurý,tarren-mill,864,hunter,marksmanship,12,9,3
6247,Chindala,zuljin,864,hunter,marksmanship,18,9,9
6248,Aimywinehaus,drakthul,864,hunter,marksmanship,18,9,9
6249,Rizlay,the-maelstrom,864,hunter,marksmanship,24,9,15
6250,Аккулэйд,blackscar,864,hunter,marksmanship,24,9,15
6251,Çryneth,ravencrest,863,hunter,marksmanship,18,9,9
6252,Jayri,ravencrest,863,hunter,marksmanship,18,9,9
6253,Ронингуд,gordunni,862,hunter,marksmanship,18,9,9
6254,Огнеборик,howling-fjord,862,hunter,marksmanship,24,9,15
6255,Theuzikat,ragnaros,861,hunter,marksmanship,24,9,15
6256,Загзигзаг,soulflayer,860,hunter,marksmanship,18,9,9
6257,Gorá,dethecus,858,hunter,marksmanship,12,9,3
6258,Bazrzokh,elune,858,hunter,marksmanship,18,9,9
6259,Gintønic,blackmoore,857,hunter,marksmanship,36,9,27
6260,Neosmoke,shadowsong,856,hunter,marksmanship,24,9,15
6261,Лорбан,gordunni,855,hunter,marksmanship,18,9,9
6262,Qmbonboni,ravencrest,855,hunter,marksmanship,24,9,15
6263,Sivoh,silvermoon,854,hunter,marksmanship,24,9,15
6264,Baraduh,sylvanas,853,hunter,marksmanship,18,9,9
6265,Baldazr,shadowsong,853,hunter,marksmanship,24,9,15
6266,Eldrilaon,arthas,852,hunter,marksmanship,39,18,21
6267,Zerkarok,draenor,851,hunter,marksmanship,30,9,21
6268,Фридор,deathguard,850,hunter,marksmanship,24,10,14
6269,Heavenlyx,area-52,835,hunter,marksmanship,36,9,27
6270,Куфа,blackscar,831,hunter,marksmanship,20,10,10
6271,Wìndrunner,malfurion,826,hunter,marksmanship,59,25,34
6272,Rollei,uldum,816,hunter,marksmanship,18,9,9
6273,Арийская,gordunni,803,hunter,marksmanship,29,10,19
6274,Zicko,argent-dawn,799,hunter,marksmanship,23,9,14
6275,Väärä,stormscale,780,hunter,marksmanship,22,9,13
6276,Nyxìa,shattered-halls,768,hunter,marksmanship,12,8,4
6277,Åíøñs,kazzak,768,hunter,marksmanship,12,8,4
6278,Carre,twilights-hammer,768,hunter,marksmanship,18,8,10
6279,Zlejkadlec,burning-blade,768,hunter,marksmanship,18,8,10
6280,Рбг,blackscar,768,hunter,marksmanship,18,8,10
6281,Daela,elune,768,hunter,marksmanship,18,8,10
6282,Celesticx,chamber-of-aspects,768,hunter,marksmanship,18,8,10
6283,Sylverain,silvermoon,767,hunter,marksmanship,12,8,4
6284,Mareyn,argent-dawn,767,hunter,marksmanship,12,8,4
6285,Dasimir,blackrock,767,hunter,marksmanship,18,8,10
6286,Raegal,sanguino,767,hunter,marksmanship,18,8,10
6287,Skitari,draenor,767,hunter,marksmanship,18,8,10
6288,Иоссифсталин,soulflayer,767,hunter,marksmanship,24,8,16
6289,Ëluna,burning-legion,766,hunter,marksmanship,12,8,4
6290,Shoót,blackmoore,766,hunter,marksmanship,18,8,10
6291,Mainblu,nemesis,765,hunter,marksmanship,18,8,10
6292,Ixôn,tarren-mill,765,hunter,marksmanship,24,8,16
6293,Pappous,kul-tiras,764,hunter,marksmanship,18,8,10
6294,Aourön,archimonde,764,hunter,marksmanship,18,8,10
6295,Madtony,aegwynn,763,hunter,marksmanship,18,8,10
6296,Sinsé,conseil-des-ombres,762,hunter,marksmanship,12,8,4
6297,Shibai,outland,762,hunter,marksmanship,18,8,10
6298,Серргио,soulflayer,761,hunter,marksmanship,12,8,4
6299,Wetto,ravencrest,759,hunter,marksmanship,18,8,10
6300,Fèhn,krasus,757,hunter,marksmanship,12,8,4
6301,Erestor,hellfire,747,hunter,marksmanship,12,8,4
6302,Calea,zirkel-des-cenarius,743,hunter,marksmanship,24,9,15
6303,Tupalax,outland,734,hunter,marksmanship,22,9,13
6304,Йошумитсу,howling-fjord,727,hunter,marksmanship,14,9,5
6305,Deathøfrats,ravencrest,719,hunter,marksmanship,11,8,3
6306,Greel,saurfang,718,hunter,marksmanship,42,15,27
6307,Vanstro,ragnaros,672,hunter,marksmanship,12,7,5
6308,Avaren,archimonde,672,hunter,marksmanship,12,7,5
6309,Jurá,perenolde,672,hunter,marksmanship,12,7,5
6310,Агелетка,gordunni,672,hunter,marksmanship,12,7,5
6311,Killershadow,twisting-nether,672,hunter,marksmanship,12,7,5
6312,Dtq,silvermoon,672,hunter,marksmanship,12,7,5
6313,Хвоостт,gordunni,672,hunter,marksmanship,12,7,5
6314,Bigbowyahurd,draenor,672,hunter,marksmanship,12,7,5
6315,Гусецап,gordunni,672,hunter,marksmanship,12,7,5
6316,Costner,darksorrow,672,hunter,marksmanship,12,7,5
6317,Merquryh,ravencrest,672,hunter,marksmanship,12,7,5
6318,Кисяныч,gordunni,672,hunter,marksmanship,12,7,5
6319,Weilerz,drakthul,672,hunter,marksmanship,12,7,5
6320,Corrupth,outland,672,hunter,marksmanship,15,8,7
6321,Birgitta,jaedenar,672,hunter,marksmanship,18,7,11
6322,Землепух,howling-fjord,672,hunter,marksmanship,18,7,11
6323,Трольболь,eversong,672,hunter,marksmanship,18,7,11
6324,Ahrtemís,destromath,672,hunter,marksmanship,18,7,11
6325,Джарвиз,soulflayer,672,hunter,marksmanship,18,7,11
6326,Påtrîckbátém,ravencrest,672,hunter,marksmanship,18,7,11
6327,Онкьяр,gordunni,672,hunter,marksmanship,24,7,17
6328,Griffithstew,blackmoore,672,hunter,marksmanship,24,7,17
6329,Vruh,antonidas,671,hunter,marksmanship,12,7,5
6330,Maknamara,tarren-mill,671,hunter,marksmanship,12,7,5
6331,Халикер,soulflayer,671,hunter,marksmanship,12,7,5
6332,Ôrïøn,archimonde,671,hunter,marksmanship,12,7,5
6333,Rísu,argent-dawn,671,hunter,marksmanship,12,7,5
6334,Adariana,archimonde,671,hunter,marksmanship,12,7,5
6335,Ashrak,frostmourne,671,hunter,marksmanship,18,7,11
6336,Sjufemman,ravencrest,671,hunter,marksmanship,24,7,17
6337,Ямакасси,thermaplugg,671,hunter,marksmanship,36,7,29
6338,Pewpewshotz,stormscale,670,hunter,marksmanship,12,7,5
6339,Deathtrapper,bronzebeard,670,hunter,marksmanship,12,7,5
6340,Spêctrâ,sylvanas,670,hunter,marksmanship,18,7,11
6341,Yip,twisting-nether,670,hunter,marksmanship,18,7,11
6342,Wishmeweed,kazzak,668,hunter,marksmanship,18,7,11
6343,Survivr,frostmane,667,hunter,marksmanship,12,7,5
6344,Arkman,malganis,660,hunter,marksmanship,30,7,23
6345,Shokre,silvermoon,657,hunter,marksmanship,12,7,5
6346,Breezhunt,twisting-nether,655,hunter,marksmanship,17,7,10
6347,Амореселф,gordunni,655,hunter,marksmanship,17,7,10
6348,Aadarshh,turalyon,645,hunter,marksmanship,18,7,11
6349,Sogoru,dun-modr,637,hunter,marksmanship,15,8,7
6350,Scark,tarren-mill,621,hunter,marksmanship,11,7,4
6351,Miezuu,ravencrest,620,hunter,marksmanship,15,7,8
6352,Crétin,archimonde,617,hunter,marksmanship,20,8,12
6353,Iniduhr,dalaran,617,hunter,marksmanship,21,8,13
6354,Chizuna,dun-morogh,606,hunter,marksmanship,14,7,7
6355,Ofortuna,silvermoon,576,hunter,marksmanship,6,6,0
6356,Absolutnoob,blackrock,576,hunter,marksmanship,9,7,2
6357,Watchouttah,the-maelstrom,576,hunter,marksmanship,12,6,6
6358,Инкризшот,gordunni,576,hunter,marksmanship,12,6,6
6359,Nirn,ravencrest,576,hunter,marksmanship,12,6,6
6360,Hunlin,kazzak,576,hunter,marksmanship,12,6,6
6361,Nätzz,dun-modr,576,hunter,marksmanship,12,6,6
6362,Vorsia,tarren-mill,576,hunter,marksmanship,12,6,6
6363,Migro,sylvanas,576,hunter,marksmanship,12,6,6
6364,Shína,argent-dawn,576,hunter,marksmanship,12,6,6
6365,Aenina,kazzak,576,hunter,marksmanship,12,6,6
6366,Луврен,deepholm,576,hunter,marksmanship,18,6,12
6367,Такувами,gordunni,576,hunter,marksmanship,18,6,12
6368,Манаррия,soulflayer,576,hunter,marksmanship,18,6,12
6369,Honzu,silvermoon,575,hunter,marksmanship,12,6,6
6370,Gwalëndil,hyjal,575,hunter,marksmanship,12,6,6
6371,Pøca,kaelthas,575,hunter,marksmanship,12,6,6
6372,Oneeyedjoe,the-maelstrom,575,hunter,marksmanship,12,6,6
6373,Loca,twilights-hammer,575,hunter,marksmanship,12,6,6
6374,Ксидре,eversong,575,hunter,marksmanship,12,6,6
6375,Dirtydolores,thrall,575,hunter,marksmanship,12,6,6
6376,Tolkienn,archimonde,575,hunter,marksmanship,12,6,6
6377,Helioshin,pozzo-delleternità,575,hunter,marksmanship,12,6,6
6378,Elladiel,blackmoore,575,hunter,marksmanship,12,6,6
6379,Kilölek,ragnaros,575,hunter,marksmanship,12,6,6
6380,Ina,tarren-mill,575,hunter,marksmanship,12,6,6
6381,Shootingbob,blackrock,575,hunter,marksmanship,12,6,6
6382,Yanger,burning-legion,575,hunter,marksmanship,18,6,12
6383,Lightarròw,nordrassil,575,hunter,marksmanship,18,6,12
6384,Egy,the-maelstrom,574,hunter,marksmanship,12,6,6
6385,Seariko,draenor,574,hunter,marksmanship,18,6,12
6386,Omixloua,ragnaros,572,hunter,marksmanship,18,6,12
6387,Kartouche,culte-de-la-rive-noire,565,hunter,marksmanship,12,6,6
6388,Sauer,stormreaver,564,hunter,marksmanship,18,6,12
6389,Rockymarciaa,dalaran,527,hunter,marksmanship,21,6,15
6390,Hoody,culte-de-la-rive-noire,517,hunter,marksmanship,13,7,6
6391,Фэйсконтроль,azuregos,506,hunter,marksmanship,20,6,14
6392,Mooj,malganis,480,hunter,marksmanship,6,5,1
6393,Antiork,doomhammer,480,hunter,marksmanship,6,5,1
6394,Ðarrk,tarren-mill,480,hunter,marksmanship,6,5,1
6395,Сальверди,gordunni,480,hunter,marksmanship,6,5,1
6396,Nyjal,archimonde,480,hunter,marksmanship,6,5,1
6397,Toptìérgoðx,drakthul,480,hunter,marksmanship,6,5,1
6398,Elyar,eredar,480,hunter,marksmanship,6,5,1
6399,Huntsmart,kazzak,480,hunter,marksmanship,12,5,7
6400,Sashobg,aerie-peak,480,hunter,marksmanship,12,5,7
6401,Deathmarks,blackrock,480,hunter,marksmanship,12,5,7
6402,Carrilynn,blackrock,480,hunter,marksmanship,12,5,7
6403,Tavira,zuljin,480,hunter,marksmanship,12,5,7
6404,Ðõt,ravencrest,480,hunter,marksmanship,12,5,7
6405,Jomerin,thrall,480,hunter,marksmanship,12,5,7
6406,Scartet,blackmoore,480,hunter,marksmanship,12,5,7
6407,Denaik,ravencrest,480,hunter,marksmanship,12,5,7
6408,Imfiné,outland,480,hunter,marksmanship,12,5,7
6409,Huntardös,outland,480,hunter,marksmanship,12,5,7
6410,Kravên,anubarak,480,hunter,marksmanship,12,5,7
6411,Shieryu,archimonde,480,hunter,marksmanship,12,5,7
6412,Øßlíck,ysondre,480,hunter,marksmanship,12,5,7
6413,Littlerat,kult-der-verdammten,480,hunter,marksmanship,12,5,7
6414,Lennylynx,garrosh,480,hunter,marksmanship,12,5,7
6415,Brk,dun-modr,480,hunter,marksmanship,12,5,7
6416,Agbaba,twisting-nether,480,hunter,marksmanship,12,5,7
6417,Galou,ghostlands,480,hunter,marksmanship,12,5,7
6418,Крой,howling-fjord,480,hunter,marksmanship,12,5,7
6419,Кайсго,gordunni,480,hunter,marksmanship,12,5,7
6420,Nothrokh,auchindoun,480,hunter,marksmanship,12,5,7
6421,Dramin,defias-brotherhood,480,hunter,marksmanship,18,5,13
6422,Тэуреэль,gordunni,480,hunter,marksmanship,18,5,13
6423,Xoarqt,aegwynn,480,hunter,marksmanship,18,5,13
6424,Aureboby,hyjal,480,hunter,marksmanship,18,5,13
6425,Tetiscaza,sanguino,480,hunter,marksmanship,24,5,19
6426,Jaggatee,senjin,479,hunter,marksmanship,6,5,1
6427,Jozsiur,ragnaros,479,hunter,marksmanship,6,5,1
6428,Bluetiger,azshara,479,hunter,marksmanship,6,5,1
6429,Nìsalle,argent-dawn,479,hunter,marksmanship,12,5,7
6430,Whereismypet,azjolnerub,479,hunter,marksmanship,12,5,7
6431,Zäyk,zuljin,479,hunter,marksmanship,12,5,7
6432,Vèreesa,azjolnerub,479,hunter,marksmanship,12,5,7
6433,Nightarrows,ravencrest,478,hunter,marksmanship,6,5,1
6434,Tiph,argent-dawn,478,hunter,marksmanship,12,5,7
6435,Thebalrog,korgall,478,hunter,marksmanship,12,5,7
6436,Bloodshot,nethersturm,477,hunter,marksmanship,12,5,7
6437,Robìnhood,nemesis,477,hunter,marksmanship,12,5,7
6438,Брухлянка,gordunni,476,hunter,marksmanship,12,5,7
6439,Robros,dentarg,475,hunter,marksmanship,12,5,7
6440,Klittcrit,bloodhoof,475,hunter,marksmanship,12,5,7
6441,Sixty,rajaxx,474,hunter,marksmanship,18,5,13
6442,Karmios,drakthul,473,hunter,marksmanship,12,5,7
6443,Snaped,malganis,447,hunter,marksmanship,11,5,6
6444,Haleth,uldum,447,hunter,marksmanship,17,5,12
6445,Jocitwitch,ragnaros,432,hunter,marksmanship,9,6,3
6446,Zaragattas,aggra-português,426,hunter,marksmanship,17,7,10
6447,Quinty,durotan,414,hunter,marksmanship,8,5,3
6448,Хантероо,gordunni,384,hunter,marksmanship,6,4,2
6449,Zulthat,thrall,384,hunter,marksmanship,6,4,2
6450,Silvyina,todeswache,384,hunter,marksmanship,6,4,2
6451,Sandchaton,ragnaros,384,hunter,marksmanship,6,4,2
6452,Comegetme,auchindoun,384,hunter,marksmanship,6,4,2
6453,Darllene,kazzak,384,hunter,marksmanship,6,4,2
6454,Lrr,grim-batol,384,hunter,marksmanship,6,4,2
6455,Сацыви,gordunni,384,hunter,marksmanship,6,4,2
6456,Metak,auchindoun,384,hunter,marksmanship,6,4,2
6457,Kikilirilivi,ysondre,384,hunter,marksmanship,6,4,2
6458,Myoui,silvermoon,384,hunter,marksmanship,6,4,2
6459,Kragán,silvermoon,384,hunter,marksmanship,6,4,2
6460,Ðøper,hyjal,384,hunter,marksmanship,6,4,2
6461,Snipinx,draenor,384,hunter,marksmanship,6,4,2
6462,Likandria,blackmoore,384,hunter,marksmanship,6,4,2
6463,Doloresman,tarren-mill,384,hunter,marksmanship,6,4,2
6464,Джеймсфранко,blackscar,384,hunter,marksmanship,6,4,2
6465,Jägarenen,kazzak,384,hunter,marksmanship,6,4,2
6466,Rymous,nemesis,384,hunter,marksmanship,6,4,2
6467,Nêzz,tarren-mill,384,hunter,marksmanship,6,4,2
6468,Denkstah,tarren-mill,384,hunter,marksmanship,6,4,2
6469,Hntudwn,azshara,384,hunter,marksmanship,6,4,2
6470,Aidsmacka,shattered-hand,384,hunter,marksmanship,6,4,2
6471,Сынсема,blackscar,384,hunter,marksmanship,6,4,2
6472,Burninghunt,ravencrest,384,hunter,marksmanship,6,4,2
6473,Xzmiq,outland,384,hunter,marksmanship,6,4,2
6474,Earlyspring,ragnaros,384,hunter,marksmanship,6,4,2
6475,Silvyn,pozzo-delleternità,384,hunter,marksmanship,6,4,2
6476,Sùnzí,alakir,384,hunter,marksmanship,6,4,2
6477,Slo,sylvanas,384,hunter,marksmanship,6,4,2
6478,Thugzilla,auchindoun,384,hunter,marksmanship,6,4,2
6479,Dariusmm,silvermoon,384,hunter,marksmanship,6,4,2
6480,Ixxmhunt,blackrock,384,hunter,marksmanship,6,4,2
6481,Nßatrapper,outland,384,hunter,marksmanship,6,4,2
6482,Wîldhunt,burning-legion,384,hunter,marksmanship,11,4,7
6483,Дайпострелят,gordunni,384,hunter,marksmanship,12,4,8
6484,Noobhuntress,norgannon,384,hunter,marksmanship,12,4,8
6485,Абунай,soulflayer,384,hunter,marksmanship,12,4,8
6486,Vallêria,malganis,384,hunter,marksmanship,12,4,8
6487,Makaxx,stormscale,384,hunter,marksmanship,12,4,8
6488,Йинги,gordunni,384,hunter,marksmanship,12,4,8
6489,Kanlina,ravencrest,384,hunter,marksmanship,12,4,8
6490,Focushunter,outland,384,hunter,marksmanship,12,4,8
6491,Arung,ravencrest,384,hunter,marksmanship,12,4,8
6492,Свадебная,gordunni,384,hunter,marksmanship,12,4,8
6493,Ruppig,nozdormu,384,hunter,marksmanship,12,4,8
6494,Hashaya,hyjal,384,hunter,marksmanship,12,4,8
6495,Darkshe,dun-modr,384,hunter,marksmanship,12,4,8
6496,Darilli,wildhammer,384,hunter,marksmanship,12,4,8
6497,Deeparrow,stormscale,384,hunter,marksmanship,12,4,8
6498,Rupeebtw,stormscale,384,hunter,marksmanship,12,4,8
6499,Tartaupommes,hyjal,384,hunter,marksmanship,12,4,8
6500,Bugspitz,outland,384,hunter,marksmanship,12,4,8
6501,Zurzok,blackrock,384,hunter,marksmanship,12,4,8
6502,Dangerousfoe,argent-dawn,384,hunter,marksmanship,12,4,8
6503,Peonfarmer,argent-dawn,384,hunter,marksmanship,12,4,8
6504,Bulseye,kilrogg,384,hunter,marksmanship,12,4,8
6505,Gødzftw,kazzak,384,hunter,marksmanship,14,4,10
6506,Blacksyo,elune,384,hunter,marksmanship,15,4,11
6507,Kêêpsmile,blackmoore,384,hunter,marksmanship,18,4,14
6508,Конар,soulflayer,383,hunter,marksmanship,6,4,2
6509,Ønur,twisting-nether,383,hunter,marksmanship,6,4,2
6510,Agarez,blackrock,383,hunter,marksmanship,6,4,2
6511,Zirriath,mazrigos,383,hunter,marksmanship,12,4,8
6512,Hanzolo,uldum,383,hunter,marksmanship,12,4,8
6513,Kyéra,kirin-tor,383,hunter,marksmanship,12,4,8
6514,Penelopé,darkmoon-faire,383,hunter,marksmanship,12,4,8
6515,Agnõr,chants-éternels,382,hunter,marksmanship,6,4,2
6516,Tenkai,cthun,382,hunter,marksmanship,6,4,2
6517,Бурбоньчик,soulflayer,382,hunter,marksmanship,12,4,8
6518,Saccä,ysondre,381,hunter,marksmanship,12,4,8
6519,Euphellius,darkmoon-faire,380,hunter,marksmanship,15,5,10
6520,Krippie,dun-modr,379,hunter,marksmanship,12,4,8
6521,Lumidii,burning-legion,379,hunter,marksmanship,12,4,8
6522,Boehelientje,defias-brotherhood,351,hunter,marksmanship,11,4,7
6523,Shadoox,argent-dawn,335,hunter,marksmanship,11,4,7
6524,Arwenna,argent-dawn,328,hunter,marksmanship,11,6,5
6525,Bloópy,silvermoon,320,hunter,marksmanship,10,4,6
6526,Weridia,der-rat-von-dalaran,319,hunter,marksmanship,5,4,1
6527,Retroxia,stormreaver,319,hunter,marksmanship,8,4,4
6528,Lioness,ahnqiraj,288,hunter,marksmanship,6,3,3
6529,Комомура,soulflayer,288,hunter,marksmanship,6,3,3
6530,Rapid,sylvanas,288,hunter,marksmanship,6,3,3
6531,Djøgi,archimonde,288,hunter,marksmanship,6,3,3
6532,Lithell,kazzak,288,hunter,marksmanship,6,3,3
6533,Xeragon,frostwolf,288,hunter,marksmanship,6,3,3
6534,Techpøint,silvermoon,288,hunter,marksmanship,6,3,3
6535,Zøk,stormscale,288,hunter,marksmanship,6,3,3
6536,Feyoonxx,blackrock,288,hunter,marksmanship,6,3,3
6537,Spirys,drakthul,288,hunter,marksmanship,6,3,3
6538,Phinecone,stormscale,288,hunter,marksmanship,6,3,3
6539,Narziel,die-todeskrallen,288,hunter,marksmanship,6,3,3
6540,Lilsnuss,outland,288,hunter,marksmanship,6,3,3
6541,Samasukë,grim-batol,288,hunter,marksmanship,6,3,3
6542,Neescafe,sylvanas,288,hunter,marksmanship,6,3,3
6543,Zajaczek,burning-legion,288,hunter,marksmanship,6,3,3
6544,Fylealaes,ravencrest,288,hunter,marksmanship,6,3,3
6545,Bocek,silvermoon,288,hunter,marksmanship,6,3,3
6546,Eliune,silvermoon,288,hunter,marksmanship,6,3,3
6547,Антисерт,ashenvale,288,hunter,marksmanship,6,3,3
6548,Noxxen,burning-legion,288,hunter,marksmanship,6,3,3
6549,Kundra,ravencrest,288,hunter,marksmanship,6,3,3
6550,Celebor,sanguino,288,hunter,marksmanship,6,3,3
6551,Fize,blackmoore,288,hunter,marksmanship,6,3,3
6552,Barbrady,nethersturm,288,hunter,marksmanship,6,3,3
6553,Яроняютрапу,gordunni,288,hunter,marksmanship,6,3,3
6554,Burbutsuluki,silvermoon,288,hunter,marksmanship,6,3,3
6555,Éddiémórphín,kazzak,288,hunter,marksmanship,6,3,3
6556,Egodennis,frostwolf,288,hunter,marksmanship,6,3,3
6557,ßæro,hyjal,288,hunter,marksmanship,6,3,3
6558,Nerdhark,hyjal,288,hunter,marksmanship,6,3,3
6559,Pläpp,stormscale,288,hunter,marksmanship,6,3,3
6560,Djidawn,ysondre,288,hunter,marksmanship,6,3,3
6561,Anguerande,khaz-modan,288,hunter,marksmanship,6,3,3
6562,Sissnik,thrall,288,hunter,marksmanship,6,3,3
6563,Люблюлюбовь,gordunni,288,hunter,marksmanship,6,3,3
6564,Medgical,outland,288,hunter,marksmanship,6,3,3
6565,Deadluck,kazzak,288,hunter,marksmanship,6,3,3
6566,Muddí,ravencrest,288,hunter,marksmanship,6,3,3
6567,Jðsi,dalaran,288,hunter,marksmanship,6,3,3
6568,Трапавграунд,howling-fjord,288,hunter,marksmanship,6,3,3
6569,Fugass,ragnaros,288,hunter,marksmanship,6,3,3
6570,Threeguns,blackrock,288,hunter,marksmanship,6,3,3
6571,Hurion,sanguino,288,hunter,marksmanship,6,3,3
6572,Джинксан,blackscar,288,hunter,marksmanship,6,3,3
6573,Osie,kazzak,288,hunter,marksmanship,6,3,3
6574,Atranex,ravencrest,288,hunter,marksmanship,6,3,3
6575,Dreemshoot,stormscale,288,hunter,marksmanship,6,3,3
6576,Velne,ravencrest,288,hunter,marksmanship,6,3,3
6577,Zugzlug,tarren-mill,288,hunter,marksmanship,6,3,3
6578,Snipèr,blackmoore,288,hunter,marksmanship,6,3,3
6579,Littlenugget,ravencrest,288,hunter,marksmanship,6,3,3
6580,Nightarrowq,tarren-mill,288,hunter,marksmanship,9,4,5
6581,Amdéa,boulderfist,288,hunter,marksmanship,10,4,6
6582,Arrown,outland,288,hunter,marksmanship,11,4,7
6583,Secrety,doomhammer,288,hunter,marksmanship,11,3,8
6584,Deahtviper,blackmoore,288,hunter,marksmanship,12,3,9
6585,Jakis,silvermoon,288,hunter,marksmanship,12,3,9
6586,Ричардн,howling-fjord,288,hunter,marksmanship,12,3,9
6587,Белыйатомщик,howling-fjord,288,hunter,marksmanship,12,3,9
6588,Lùchiean,kazzak,288,hunter,marksmanship,12,3,9
6589,Naaztko,stormscale,288,hunter,marksmanship,12,3,9
6590,Бубунн,howling-fjord,288,hunter,marksmanship,12,3,9
6591,Chassuu,khaz-modan,288,hunter,marksmanship,12,3,9
6592,Spakster,blackrock,288,hunter,marksmanship,12,3,9
6593,Hÿyrøk,ysondre,288,hunter,marksmanship,12,3,9
6594,Fatfrumos,twisting-nether,288,hunter,marksmanship,12,3,9
6595,Zubro,kazzak,288,hunter,marksmanship,12,3,9
6596,Deify,grim-batol,288,hunter,marksmanship,12,3,9
6597,Thalanel,arthas,288,hunter,marksmanship,12,3,9
6598,Nezekielle,drekthar,288,hunter,marksmanship,12,3,9
6599,Koreic,silvermoon,288,hunter,marksmanship,12,3,9
6600,Triggery,ravencrest,288,hunter,marksmanship,12,3,9
6601,Deneja,kilrogg,288,hunter,marksmanship,12,3,9
6602,Incompetence,argent-dawn,288,hunter,marksmanship,12,3,9
6603,Andtamed,thunderhorn,288,hunter,marksmanship,12,3,9
6604,Oduross,minahonda,288,hunter,marksmanship,12,3,9
6605,Marcher,aggra-português,288,hunter,marksmanship,18,3,15
6606,Showdope,drakthul,288,hunter,marksmanship,18,3,15
6607,Ayshæ,tarren-mill,287,hunter,marksmanship,6,3,3
6608,Анариэлль,gordunni,287,hunter,marksmanship,6,3,3
6609,Мокку,howling-fjord,287,hunter,marksmanship,6,3,3
6610,Оркос,deathweaver,287,hunter,marksmanship,6,3,3
6611,Pylos,azshara,287,hunter,marksmanship,6,3,3
6612,Dwoas,darkspear,287,hunter,marksmanship,12,3,9
6613,Jomoguin,stormscale,286,hunter,marksmanship,6,3,3
6614,Thedanchodak,stormrage,286,hunter,marksmanship,6,3,3
6615,Лордввт,howling-fjord,286,hunter,marksmanship,6,3,3
6616,Есселин,thermaplugg,284,hunter,marksmanship,12,3,9
6617,Millhunter,norgannon,284,hunter,marksmanship,12,3,9
6618,Urith,les-clairvoyants,255,hunter,marksmanship,8,4,4
6619,Twinshot,anetheron,234,hunter,marksmanship,10,4,6
6620,Cais,drakthul,234,hunter,marksmanship,12,4,8
6621,Darkshàdow,archimonde,192,hunter,marksmanship,6,2,4
6622,Amiosi,sanguino,192,hunter,marksmanship,6,2,4
6623,Kodakcrack,draenor,192,hunter,marksmanship,6,2,4
6624,Draknik,nemesis,192,hunter,marksmanship,6,2,4
6625,Garrash,teldrassil,192,hunter,marksmanship,6,2,4
6626,Bellecoq,arathi,192,hunter,marksmanship,6,2,4
6627,Zulldek,sanguino,192,hunter,marksmanship,6,2,4
6628,Bláckheart,doomhammer,192,hunter,marksmanship,6,2,4
6629,Galintzor,area-52,192,hunter,marksmanship,6,2,4
6630,Sjins,draenor,192,hunter,marksmanship,6,2,4
6631,Døømslayer,nemesis,192,hunter,marksmanship,6,2,4
6632,Féliché,elune,192,hunter,marksmanship,6,2,4
6633,Deadyeyez,doomhammer,192,hunter,marksmanship,6,2,4
6634,Zirilan,nemesis,192,hunter,marksmanship,6,2,4
6635,Aliriana,doomhammer,192,hunter,marksmanship,6,2,4
6636,Хисдед,howling-fjord,192,hunter,marksmanship,6,2,4
6637,Huntbeard,ragnaros,192,hunter,marksmanship,6,2,4
6638,Greenstar,twisting-nether,192,hunter,marksmanship,6,2,4
6639,Mobshot,twisting-nether,192,hunter,marksmanship,6,2,4
6640,Bobshmurda,defias-brotherhood,192,hunter,marksmanship,6,2,4
6641,Sarblade,bronze-dragonflight,192,hunter,marksmanship,6,2,4
6642,Anoroxx,arthas,192,hunter,marksmanship,6,2,4
6643,Мафчик,razuvious,192,hunter,marksmanship,6,2,4
6644,Охотуначал,soulflayer,192,hunter,marksmanship,6,2,4
6645,Sayn,la-croisade-écarlate,192,hunter,marksmanship,6,2,4
6646,Meetyour,stormscale,192,hunter,marksmanship,6,2,4
6647,Jamais02AEE6,stormscale,192,hunter,marksmanship,6,2,4
6648,Горгудц,gordunni,192,hunter,marksmanship,6,2,4
6649,Doknak,gilneas,192,hunter,marksmanship,6,2,4
6650,Guerrilla,stormscale,192,hunter,marksmanship,6,2,4
6651,Velvett,blackmoore,192,hunter,marksmanship,6,2,4
6652,Notikâ,aegwynn,192,hunter,marksmanship,6,2,4
6653,Фетсол,soulflayer,192,hunter,marksmanship,6,2,4
6654,Carioca,blackhand,192,hunter,marksmanship,6,2,4
6655,Tytoyz,khaz-modan,192,hunter,marksmanship,6,2,4
6656,Bowner,frostmane,192,hunter,marksmanship,6,2,4
6657,Majuli,stormrage,192,hunter,marksmanship,6,2,4
6658,Bóssit,skullcrusher,192,hunter,marksmanship,6,2,4
6659,Nelf,shattered-hand,192,hunter,marksmanship,6,2,4
6660,Miracleh,tarren-mill,192,hunter,marksmanship,6,2,4
6661,Bobleearrow,darkspear,192,hunter,marksmanship,6,2,4
6662,Realme,blackrock,192,hunter,marksmanship,6,2,4
6663,Vâleriaa,blackrock,192,hunter,marksmanship,6,2,4
6664,Kerrveros,ravencrest,192,hunter,marksmanship,6,2,4
6665,Domsín,ravencrest,192,hunter,marksmanship,6,2,4
6666,Olrik,dentarg,192,hunter,marksmanship,6,2,4
6667,Merveilleux,hyjal,192,hunter,marksmanship,6,2,4
6668,Wowkulaka,kazzak,192,hunter,marksmanship,6,2,4
6669,Sharpeyezz,ravencrest,192,hunter,marksmanship,6,2,4
6670,Foxmis,kazzak,192,hunter,marksmanship,6,2,4
6671,Beletor,medivh,192,hunter,marksmanship,6,2,4
6672,Slayman,kazzak,192,hunter,marksmanship,6,2,4
6673,Jskey,aggramar,192,hunter,marksmanship,6,2,4
6674,Brizza,talnivarr,192,hunter,marksmanship,6,2,4
6675,Nimri,kazzak,192,hunter,marksmanship,6,2,4
6676,Othellö,kazzak,192,hunter,marksmanship,6,2,4
6677,Rafaela,genjuros,192,hunter,marksmanship,6,2,4
6678,Axran,ravencrest,192,hunter,marksmanship,6,2,4
6679,Banglor,shattered-hand,192,hunter,marksmanship,6,2,4
6680,Leílah,kazzak,192,hunter,marksmanship,6,2,4
6681,Spitchy,kazzak,192,hunter,marksmanship,6,2,4
6682,Silenta,outland,192,hunter,marksmanship,6,2,4
6683,Lilsnipè,outland,192,hunter,marksmanship,6,2,4
6684,Monnee,outland,192,hunter,marksmanship,6,2,4
6685,Querro,azshara,192,hunter,marksmanship,6,2,4
6686,Freexkite,aegwynn,192,hunter,marksmanship,8,2,6
6687,Ghostriders,archimonde,192,hunter,marksmanship,11,2,9
6688,Shademd,ahnqiraj,192,hunter,marksmanship,12,2,10
6689,Weedonyhunt,hyjal,192,hunter,marksmanship,12,2,10
6690,Muckel,area-52,192,hunter,marksmanship,12,2,10
6691,Apolix,ragnaros,192,hunter,marksmanship,12,2,10
6692,Explicits,stormscale,192,hunter,marksmanship,12,2,10
6693,Friskì,draenor,192,hunter,marksmanship,12,2,10
6694,Сашатетива,gordunni,192,hunter,marksmanship,12,2,10
6695,Stormhoofd,bloodhoof,191,hunter,marksmanship,6,2,4
6696,Selini,bloodfeather,191,hunter,marksmanship,6,2,4
6697,Isarnexx,dun-modr,191,hunter,marksmanship,6,2,4
6698,Jibolad,stormreaver,191,hunter,marksmanship,6,2,4
6699,Kure,blackrock,191,hunter,marksmanship,12,2,10
6700,Jaguàr,kazzak,159,hunter,marksmanship,5,2,3
6701,Buttsnipe,sylvanas,159,hunter,marksmanship,5,2,3
6702,Neremyn,sylvanas,138,hunter,marksmanship,9,3,6
6703,Пушкабомби,soulflayer,126,hunter,marksmanship,8,2,6
6704,Chrishyh,blackrock,112,hunter,marksmanship,7,2,5
6705,Tryx,darksorrow,96,hunter,marksmanship,3,2,1
6706,Akahr,thrall,96,hunter,marksmanship,3,2,1
6707,Tyrone,saurfang,96,hunter,marksmanship,9,2,7
6708,Desow,blackrock,96,hunter,marksmanship,6,1,5
6709,Syx,amanthul,96,hunter,marksmanship,6,1,5
6710,Xaraimz,ravencrest,96,hunter,marksmanship,6,1,5
6711,Nethria,antonidas,96,hunter,marksmanship,6,1,5
6712,Drolarin,zuljin,96,hunter,marksmanship,6,1,5
6713,Fayenia,ravencrest,96,hunter,marksmanship,6,1,5
6714,Honilsom,thunderhorn,96,hunter,marksmanship,6,1,5
6715,Наладдчик,howling-fjord,96,hunter,marksmanship,6,1,5
6716,Cléò,kazzak,96,hunter,marksmanship,6,1,5
6717,Wolfmcquade,draenor,96,hunter,marksmanship,6,1,5
6718,Avizi,anachronos,96,hunter,marksmanship,6,1,5
6719,Statik,deathwing,96,hunter,marksmanship,6,1,5
6720,Faccacamoale,twisting-nether,96,hunter,marksmanship,6,1,5
6721,Akaname,ravencrest,96,hunter,marksmanship,6,1,5
6722,Cxc,dun-modr,96,hunter,marksmanship,6,1,5
6723,Eowale,outland,96,hunter,marksmanship,6,1,5
6724,Фаффурион,gordunni,96,hunter,marksmanship,6,1,5
6725,Nezuqo,archimonde,96,hunter,marksmanship,6,1,5
6726,Chantalia,ravencrest,96,hunter,marksmanship,6,1,5
6727,Metalbaci,sylvanas,96,hunter,marksmanship,6,1,5
6728,Eilaa,ravencrest,96,hunter,marksmanship,6,1,5
6729,Камсшотт,gordunni,96,hunter,marksmanship,6,1,5
6730,Feedbackloop,silvermoon,96,hunter,marksmanship,6,1,5
6731,Matarmeya,los-errantes,96,hunter,marksmanship,6,1,5
6732,Горгонт,blackscar,96,hunter,marksmanship,6,1,5
6733,Grimazg,chogall,96,hunter,marksmanship,6,1,5
6734,Superfacial,twisting-nether,96,hunter,marksmanship,6,1,5
6735,Deadlymayhem,dragonblight,96,hunter,marksmanship,6,1,5
6736,Tillhunt,kargath,96,hunter,marksmanship,6,1,5
6737,Castbuny,drakthul,96,hunter,marksmanship,6,1,5
6738,Pestilencio,shendralar,96,hunter,marksmanship,6,1,5
6739,Cítyzens,drakthul,96,hunter,marksmanship,6,1,5
6740,Salie,argent-dawn,96,hunter,marksmanship,6,1,5
6741,Killzo,sylvanas,96,hunter,marksmanship,6,1,5
6742,Nalys,argent-dawn,96,hunter,marksmanship,6,1,5
6743,Jimbow,blackrock,96,hunter,marksmanship,6,1,5
6744,Sloee,sylvanas,96,hunter,marksmanship,6,1,5
6745,Wèdra,hyjal,96,hunter,marksmanship,6,1,5
6746,Ренектон,soulflayer,96,hunter,marksmanship,6,1,5
6747,Donáldtrúmp,tarren-mill,96,hunter,marksmanship,12,1,11
6748,Denixxia,bronzebeard,95,hunter,marksmanship,3,2,1
6749,Magahra,thrall,95,hunter,marksmanship,6,1,5
6750,Ранбоу,howling-fjord,79,hunter,marksmanship,5,1,4
6751,Gettóbuxa,arathor,79,hunter,marksmanship,5,1,4
6752,Rdevill,outland,64,hunter,marksmanship,4,1,3
6753,Dréws,kazzak,64,hunter,marksmanship,4,1,3
6754,Draugrinnh,tarren-mill,48,hunter,marksmanship,3,1,2
6755,Elgango,blackrock,16,hunter,marksmanship,1,1,0
6756,Imortaltroll,kazzak,16,hunter,marksmanship,1,1,0
6757,Pridz,archimonde,2137,hunter,survival,150,76,74
6758,Rynex,festung-der-stürme,2134,hunter,survival,78,45,33
6759,Corossity,blackmoore,2107,hunter,survival,101,67,34
6760,Belaux,archimonde,2103,hunter,survival,119,60,59
6761,Razoorine,blackrock,2102,hunter,survival,156,87,69
6762,Bonquiesha,tarren-mill,2091,hunter,survival,114,63,51
6763,Fíng,tarren-mill,2084,hunter,survival,162,82,80
6764,Harrianlar,ravenholdt,2012,hunter,survival,112,53,59
6765,Yeezu,sylvanas,2009,hunter,survival,66,36,30
6766,Mestar,outland,2001,hunter,survival,199,100,99
6767,Huntity,kazzak,1994,hunter,survival,95,51,44
6768,Booxun,sylvanas,1982,hunter,survival,133,68,65
6769,Macrolaim,outland,1978,hunter,survival,114,53,61
6770,Stormblãze,ravencrest,1978,hunter,survival,113,52,61
6771,Mspt,archimonde,1967,hunter,survival,60,31,29
6772,Pokefangirlx,grim-batol,1960,hunter,survival,138,80,58
6773,Sneakyshøt,nemesis,1960,hunter,survival,197,106,91
6774,Earfalass,twisting-nether,1932,hunter,survival,92,56,36
6775,Горгонт,blackscar,1924,hunter,survival,126,70,56
6776,Ryomen,garona,1917,hunter,survival,171,92,79
6777,Zhulk,los-errantes,1910,hunter,survival,90,44,46
6778,Kagrot,silvermoon,1907,hunter,survival,72,36,36
6779,Momohenní,archimonde,1901,hunter,survival,126,72,54
6780,Lágåta,outland,1864,hunter,survival,53,27,26
6781,Øvade,argent-dawn,1861,hunter,survival,67,41,26
6782,Ravebae,silvermoon,1850,hunter,survival,126,64,62
6783,Лесбиянюсь,gordunni,1841,hunter,survival,42,24,18
6784,Квит,blackscar,1832,hunter,survival,30,20,10
6785,Josethepimpo,stormscale,1832,hunter,survival,66,32,34
6786,Vunter,malganis,1828,hunter,survival,48,26,22
6787,Dabeszt,draenor,1827,hunter,survival,60,38,22
6788,Götdelen,kult-der-verdammten,1822,hunter,survival,60,30,30
6789,Polaqu,burning-legion,1809,hunter,survival,60,37,23
6790,Djshibalxd,argent-dawn,1807,hunter,survival,48,27,21
6791,Yemistar,archimonde,1802,hunter,survival,48,24,24
6792,Zpf,silvermoon,1801,hunter,survival,56,30,26
6793,Onlylfg,drakthul,1801,hunter,survival,56,30,26
6794,Jackjager,ravencrest,1800,hunter,survival,33,21,12
6795,Avaren,archimonde,1798,hunter,survival,70,36,34
6796,Nikzeubii,archimonde,1798,hunter,survival,42,19,23
6797,Fatbushpig,stormscale,1786,hunter,survival,30,19,11
6798,Frog,crushridge,1783,hunter,survival,72,42,30
6799,Pwon,ravencrest,1782,hunter,survival,158,85,73
6800,Glosendra,ravencrest,1769,hunter,survival,27,20,7
6801,Clifton,archimonde,1763,hunter,survival,36,25,11
6802,Easyclass,hyjal,1762,hunter,survival,42,27,15
6803,Djheartstrng,argent-dawn,1754,hunter,survival,46,27,19
6804,Obbnfriends,ravencrest,1749,hunter,survival,66,30,36
6805,Exquisitor,draenor,1748,hunter,survival,67,33,34
6806,Dreämhäck,ravencrest,1742,hunter,survival,36,25,11
6807,Thugzilla,auchindoun,1741,hunter,survival,41,24,17
6808,Burbutsuluki,silvermoon,1739,hunter,survival,42,23,19
6809,Hunjo,quelthalas,1739,hunter,survival,90,40,50
6810,Âkane,argent-dawn,1737,hunter,survival,48,27,21
6811,Летмимейт,howling-fjord,1724,hunter,survival,78,43,35
6812,Avizi,anachronos,1724,hunter,survival,78,41,37
6813,Gíggí,malganis,1723,hunter,survival,30,18,12
6814,Yosia,draenor,1723,hunter,survival,60,31,29
6815,Alexdi,kazzak,1722,hunter,survival,42,19,23
6816,Mmkekw,guldan,1716,hunter,survival,30,22,8
6817,Mewithoutyou,ragnaros,1711,hunter,survival,150,70,80
6818,Minibicmex,aegwynn,1709,hunter,survival,30,18,12
6819,Разплюханка,howling-fjord,1699,hunter,survival,108,56,52
6820,Оскорбление,howling-fjord,1697,hunter,survival,66,34,32
6821,Yazqua,deathwing,1696,hunter,survival,70,42,28
6822,Sarrow,ravencrest,1696,hunter,survival,66,35,31
6823,Closeenought,ravencrest,1689,hunter,survival,54,29,25
6824,Zerberas,blackrock,1688,hunter,survival,42,21,21
6825,Madzynette,archimonde,1684,hunter,survival,37,25,12
6826,Akronis,outland,1684,hunter,survival,60,24,36
6827,Yemmeth,argent-dawn,1679,hunter,survival,165,86,79
6828,Sorozo,aegwynn,1675,hunter,survival,47,25,22
6829,Чууч,blackscar,1673,hunter,survival,57,26,31
6830,Knokkelmann,outland,1668,hunter,survival,36,24,12
6831,Gedept,blackrock,1663,hunter,survival,56,30,26
6832,Kurkelx,ravencrest,1661,hunter,survival,48,30,18
6833,Rayadz,nethersturm,1661,hunter,survival,41,18,23
6834,Snippy,sanguino,1656,hunter,survival,60,25,35
6835,Monkeytrapz,norgannon,1655,hunter,survival,42,23,19
6836,Zäroury,ravencrest,1653,hunter,survival,64,32,32
6837,Dyndns,blackmoore,1645,hunter,survival,42,18,24
6838,Zeer,sylvanas,1643,hunter,survival,75,34,41
6839,Zulldek,sanguino,1638,hunter,survival,78,42,36
6840,Fablet,draenor,1637,hunter,survival,42,24,18
6841,Calyssae,shattered-halls,1631,hunter,survival,52,34,18
6842,Renathir,argent-dawn,1628,hunter,survival,50,28,22
6843,Кулерквест,soulflayer,1627,hunter,survival,79,43,36
6844,Xiumiune,antonidas,1626,hunter,survival,54,32,22
6845,Kajtarn,outland,1621,hunter,survival,60,27,33
6846,Nienel,archimonde,1618,hunter,survival,71,29,42
6847,Nemámponetí,drakthul,1615,hunter,survival,42,25,17
6848,Ntwoõ,ravencrest,1615,hunter,survival,65,37,28
6849,Pizzafanatic,blackrock,1614,hunter,survival,49,25,24
6850,Ruxhunter,sanguino,1607,hunter,survival,90,50,40
6851,Rizlay,the-maelstrom,1607,hunter,survival,48,24,24
6852,Стингергодх,gordunni,1606,hunter,survival,36,18,18
6853,Ищименявтени,gordunni,1604,hunter,survival,65,36,29
6854,Tillhunt,kargath,1600,hunter,survival,57,36,21
6855,Сабакаа,borean-tundra,1599,hunter,survival,66,38,28
6856,Микихаса,galakrond,1599,hunter,survival,57,29,28
6857,Darllene,kazzak,1599,hunter,survival,89,40,49
6858,Dariusmm,silvermoon,1598,hunter,survival,58,32,26
6859,Lukez,ravencrest,1594,hunter,survival,36,21,15
6860,Losiané,thrall,1592,hunter,survival,58,29,29
6861,Wikariusz,kazzak,1592,hunter,survival,60,26,34
6862,Зеленыйиисус,gordunni,1590,hunter,survival,30,20,10
6863,Танчибосс,soulflayer,1589,hunter,survival,92,47,45
6864,Scypher,ragnaros,1578,hunter,survival,27,19,8
6865,Свадебная,gordunni,1572,hunter,survival,148,78,70
6866,Marryme,blackhand,1568,hunter,survival,42,26,16
6867,Ódelagga,sylvanas,1568,hunter,survival,72,40,32
6868,Subha,quelthalas,1563,hunter,survival,30,19,11
6869,Turdy,executus,1559,hunter,survival,40,23,17
6870,Ázurâ,blackhand,1559,hunter,survival,74,34,40
6871,Kalani,la-croisade-écarlate,1552,hunter,survival,78,40,38
6872,Жэш,howling-fjord,1551,hunter,survival,30,18,12
6873,Ðarrk,tarren-mill,1551,hunter,survival,66,35,31
6874,Âmalphy,ravencrest,1549,hunter,survival,42,17,25
6875,Lxoh,turalyon,1541,hunter,survival,185,89,96
6876,Psychotik,stormreaver,1540,hunter,survival,94,50,44
6877,Horxxa,kul-tiras,1539,hunter,survival,54,36,18
6878,Sphexya,ravencrest,1528,hunter,survival,30,16,14
6879,Хансбург,howling-fjord,1526,hunter,survival,30,16,14
6880,Rewgodxq,ravencrest,1526,hunter,survival,42,16,26
6881,Saliressa,ravencrest,1517,hunter,survival,36,16,20
6882,Фломидзе,gordunni,1515,hunter,survival,30,21,9
6883,Huntiika,silvermoon,1512,hunter,survival,49,24,25
6884,Sznxøxo,ravencrest,1498,hunter,survival,24,16,8
6885,Riema,ragnaros,1482,hunter,survival,64,28,36
6886,Unsáinted,ravencrest,1459,hunter,survival,60,29,31
6887,Næ,kazzak,1449,hunter,survival,38,21,17
6888,Nalys,argent-dawn,1447,hunter,survival,64,36,28
6889,Zacxx,ravencrest,1440,hunter,survival,41,27,14
6890,Arykes,drakthul,1440,hunter,survival,53,25,28
6891,Olk,stormscale,1439,hunter,survival,24,15,9
6892,Sipsomewater,ravencrest,1439,hunter,survival,24,15,9
6893,Uglybaboon,draenor,1439,hunter,survival,30,15,15
6894,Nwnw,tarren-mill,1437,hunter,survival,24,15,9
6895,Mogumogu,blackhand,1432,hunter,survival,30,15,15
6896,Clicker,runetotem,1425,hunter,survival,36,16,20
6897,Robzyhunter,kazzak,1415,hunter,survival,24,15,9
6898,Zøk,stormscale,1407,hunter,survival,24,15,9
6899,Shoty,zuluhed,1402,hunter,survival,106,50,56
6900,Vengefull,draenor,1399,hunter,survival,66,35,31
6901,Andjelaa,kazzak,1398,hunter,survival,30,15,15
6902,Crème,blackrock,1395,hunter,survival,65,26,39
6903,Кфоззи,soulflayer,1391,hunter,survival,30,15,15
6904,Raztreadör,dun-modr,1390,hunter,survival,66,32,34
6905,Hakkoti,argent-dawn,1388,hunter,survival,30,15,15
6906,Kyosoku,silvermoon,1388,hunter,survival,33,15,18
6907,Ðoñko,hyjal,1379,hunter,survival,123,58,65
6908,Slagatronic,ragnaros,1378,hunter,survival,96,53,43
6909,Глаззалмаз,howling-fjord,1373,hunter,survival,28,16,12
6910,Сильвиина,eversong,1372,hunter,survival,36,17,19
6911,Ðrãke,blackmoore,1370,hunter,survival,30,15,15
6912,Suxino,doomhammer,1360,hunter,survival,82,37,45
6913,Zwerghauer,arthas,1358,hunter,survival,30,17,13
6914,Китас,soulflayer,1346,hunter,survival,56,34,22
6915,Icetrapped,eredar,1341,hunter,survival,30,14,16
6916,Xaone,blackrock,1340,hunter,survival,18,14,4
6917,Cjezka,blackmoore,1339,hunter,survival,30,14,16
6918,Копия,azuregos,1338,hunter,survival,30,14,16
6919,Субоота,gordunni,1335,hunter,survival,24,14,10
6920,Zaphody,doomhammer,1334,hunter,survival,45,23,22
6921,Shootingu,aegwynn,1334,hunter,survival,42,21,21
6922,Мандалорецц,soulflayer,1329,hunter,survival,50,22,28
6923,Taurïel,stormscale,1326,hunter,survival,36,19,17
6924,Jamalinho,silvermoon,1322,hunter,survival,60,38,22
6925,Santiägø,archimonde,1322,hunter,survival,42,23,19
6926,Карвинн,soulflayer,1321,hunter,survival,30,14,16
6927,Westcøãst,archimonde,1316,hunter,survival,24,14,10
6928,Zehned,ysondre,1316,hunter,survival,57,25,32
6929,Malgorn,burning-legion,1314,hunter,survival,34,23,11
6930,Littlhuntard,tarren-mill,1306,hunter,survival,24,14,10
6931,Tortillia,madmortem,1305,hunter,survival,30,14,16
6932,Karabeg,twisting-nether,1301,hunter,survival,53,22,31
6933,Prodanhunts,frostmane,1296,hunter,survival,30,14,16
6934,Feignindeath,twisting-nether,1291,hunter,survival,32,17,15
6935,Kasperle,frostwolf,1281,hunter,survival,24,14,10
6936,Getsniffarn,sylvanas,1277,hunter,survival,36,18,18
6937,Ashablack,argent-dawn,1265,hunter,survival,89,45,44
6938,Nvukaze,argent-dawn,1262,hunter,survival,33,22,11
6939,Ajko,blackmoore,1247,hunter,survival,30,15,15
6940,Jumong,ragnaros,1246,hunter,survival,24,13,11
6941,Guanchin,silvermoon,1245,hunter,survival,42,16,26
6942,Albumx,hyjal,1244,hunter,survival,163,76,87
6943,Daweí,draenor,1244,hunter,survival,30,13,17
6944,Kazzaak,kazzak,1243,hunter,survival,54,19,35
6945,Paxiwtf,eredar,1242,hunter,survival,22,14,8
6946,Fusko,ysondre,1242,hunter,survival,24,13,11
6947,Bicepspump,dun-morogh,1240,hunter,survival,30,13,17
6948,Suzumebachi,twisting-nether,1233,hunter,survival,18,13,5
6949,Skydraz,ysondre,1229,hunter,survival,30,13,17
6950,Sayn,la-croisade-écarlate,1227,hunter,survival,24,13,11
6951,Betarayjinx,kazzak,1198,hunter,survival,21,13,8
6952,Sainttcc,thrall,1195,hunter,survival,54,25,29
6953,Knoxblå,stormscale,1152,hunter,survival,18,12,6
6954,Майен,thermaplugg,1152,hunter,survival,24,12,12
6955,Ähäkutti,kazzak,1151,hunter,survival,30,12,18
6956,Grulog,kazzak,1150,hunter,survival,30,12,18
6957,Lìmpy,stormreaver,1147,hunter,survival,24,12,12
6958,Тэмплест,howling-fjord,1146,hunter,survival,18,12,6
6959,Rettoo,aszune,1146,hunter,survival,19,12,7
6960,Saejku,archimonde,1146,hunter,survival,24,12,12
6961,Kobayashi,arathor,1140,hunter,survival,36,12,24
6962,Gilzog,exodar,1138,hunter,survival,30,12,18
6963,Cabaim,eredar,1137,hunter,survival,18,12,6
6964,Notikâ,aegwynn,1135,hunter,survival,30,12,18
6965,Cämper,aegwynn,1124,hunter,survival,24,12,12
6966,Jakis,silvermoon,1101,hunter,survival,23,12,11
6967,Aszasi,azjolnerub,1096,hunter,survival,23,12,11
6968,Spakker,the-shatar,1094,hunter,survival,28,14,14
6969,Lutza,sanguino,1056,hunter,survival,24,11,13
6970,Shiceloch,blackmoore,1055,hunter,survival,18,11,7
6971,Djtrápálót,dragonmaw,1055,hunter,survival,18,11,7
6972,Sunyjuyono,ravencrest,1055,hunter,survival,24,11,13
6973,Véncsótány,ragnaros,1054,hunter,survival,18,11,7
6974,Juniorm,kazzak,1054,hunter,survival,18,11,7
6975,Éddiémórphín,kazzak,1053,hunter,survival,24,11,13
6976,Cataleýà,outland,1052,hunter,survival,18,11,7
6977,Skzu,archimonde,1050,hunter,survival,18,11,7
6978,Стивстифлер,razuvious,1043,hunter,survival,18,11,7
6979,Шадак,soulflayer,1038,hunter,survival,30,11,19
6980,Doru,silvermoon,1025,hunter,survival,24,11,13
6981,Dragonflayer,sylvanas,1021,hunter,survival,18,11,7
6982,Huntoruu,outland,1008,hunter,survival,85,35,50
6983,Melissax,silvermoon,1001,hunter,survival,28,12,16
6984,Giobi,draenor,996,hunter,survival,24,13,11
6985,Reviam,ravencrest,960,hunter,survival,12,10,2
6986,Kukenisluken,stormscale,960,hunter,survival,18,10,8
6987,Neddly,draenor,960,hunter,survival,24,10,14
6988,Stuckstepbro,silvermoon,960,hunter,survival,24,10,14
6989,Islide,ravencrest,960,hunter,survival,24,10,14
6990,Qwèrts,stormscale,959,hunter,survival,18,10,8
6991,Fmatzen,the-maelstrom,959,hunter,survival,18,10,8
6992,Cadier,argent-dawn,959,hunter,survival,24,10,14
6993,Менстряк,deathguard,958,hunter,survival,18,10,8
6994,Atalnta,ravencrest,958,hunter,survival,24,10,14
6995,Галятрицепс,eversong,957,hunter,survival,24,10,14
6996,Mcgloebels,archimonde,956,hunter,survival,21,11,10
6997,Dorota,auchindoun,955,hunter,survival,18,10,8
6998,Wastage,draenor,954,hunter,survival,24,10,14
6999,Binhoker,argent-dawn,953,hunter,survival,12,10,2
7000,Vorsord,zuljin,952,hunter,survival,24,10,14
7001,Memli,uldaman,950,hunter,survival,18,10,8
7002,Herubin,doomhammer,947,hunter,survival,21,11,10
7003,Zipzâp,blackrock,936,hunter,survival,18,10,8
7004,Neilime,marécage-de-zangar,890,hunter,survival,54,21,33
7005,Ирртой,grom,885,hunter,survival,24,10,14
7006,Bicmex,ravencrest,864,hunter,survival,12,9,3
7007,Åíøñs,kazzak,864,hunter,survival,12,9,3
7008,Ketaminösa,zuljin,864,hunter,survival,12,9,3
7009,Urrane,archimonde,864,hunter,survival,12,9,3
7010,Hyderr,aegwynn,864,hunter,survival,12,9,3
7011,Nttcoopzz,silvermoon,864,hunter,survival,12,9,3
7012,Куджикс,soulflayer,864,hunter,survival,12,9,3
7013,Curbý,blackhand,864,hunter,survival,12,9,3
7014,Wonkeedx,ravencrest,864,hunter,survival,18,9,9
7015,Eunte,archimonde,864,hunter,survival,18,9,9
7016,Svinrbglol,arygos,864,hunter,survival,18,9,9
7017,Nooksem,blackrock,864,hunter,survival,18,9,9
7018,Murkek,drakthul,863,hunter,survival,12,9,3
7019,Mileysaures,stormscale,863,hunter,survival,12,9,3
7020,Миаур,gordunni,863,hunter,survival,18,9,9
7021,Amilienne,nozdormu,863,hunter,survival,21,10,11
7022,Ballistix,elune,862,hunter,survival,18,9,9
7023,Вилдфлекс,gordunni,861,hunter,survival,12,9,3
7024,Rollin,khaz-modan,861,hunter,survival,12,9,3
7025,Hoffen,dentarg,861,hunter,survival,12,9,3
7026,Abovival,ragnaros,860,hunter,survival,12,9,3
7027,Foxyfoxo,guldan,860,hunter,survival,24,9,15
7028,Wôôdsy,blackrock,858,hunter,survival,24,9,15
7029,Voltár,antonidas,854,hunter,survival,24,9,15
7030,Ilovejwrld,dun-modr,810,hunter,survival,22,10,12
7031,Норапина,eversong,797,hunter,survival,18,9,9
7032,Drolig,blackmoore,793,hunter,survival,17,9,8
7033,Крысюкпифпаф,blackscar,783,hunter,survival,13,9,4
7034,Änubïs,culte-de-la-rive-noire,783,hunter,survival,16,10,6
7035,Calesthas,tarren-mill,768,hunter,survival,12,8,4
7036,Velen,pozzo-delleternità,768,hunter,survival,12,8,4
7037,Poggersdaddy,kazzak,768,hunter,survival,12,8,4
7038,Vargar,arygos,768,hunter,survival,12,8,4
7039,Maiver,ravencrest,768,hunter,survival,12,8,4
7040,Djfortnite,ravencrest,768,hunter,survival,12,8,4
7041,Maiverx,ravencrest,768,hunter,survival,12,8,4
7042,Фираналь,blackscar,768,hunter,survival,18,8,10
7043,Nurki,the-maelstrom,768,hunter,survival,18,8,10
7044,Jäinenool,outland,768,hunter,survival,18,8,10
7045,Epicsurvive,kazzak,768,hunter,survival,24,8,16
7046,Onefatalshot,the-maelstrom,767,hunter,survival,12,8,4
7047,Querro,azshara,767,hunter,survival,24,8,16
7048,Хантероо,gordunni,756,hunter,survival,18,8,10
7049,Powerhord,burning-legion,751,hunter,survival,18,8,10
7050,Skyh,outland,750,hunter,survival,32,8,24
7051,Lugnåls,hyjal,672,hunter,survival,12,7,5
7052,Иснсейшн,soulflayer,672,hunter,survival,12,7,5
7053,Halfogre,draenor,672,hunter,survival,12,7,5
7054,Wórldz,dun-modr,672,hunter,survival,12,7,5
7055,Robinbuds,stormscale,672,hunter,survival,12,7,5
7056,Глефард,fordragon,672,hunter,survival,12,7,5
7057,Xelsera,antonidas,672,hunter,survival,12,7,5
7058,Burninghunt,ravencrest,672,hunter,survival,12,7,5
7059,Гудхантер,blackscar,672,hunter,survival,12,7,5
7060,Ilovemax,archimonde,672,hunter,survival,12,7,5
7061,Avashah,ravencrest,672,hunter,survival,16,7,9
7062,Барабаша,deathguard,672,hunter,survival,18,7,11
7063,Terrorduni,tarren-mill,672,hunter,survival,18,7,11
7064,Floris,outland,671,hunter,survival,12,7,5
7065,Fyoni,silvermoon,671,hunter,survival,12,7,5
7066,Capullospawn,dun-morogh,671,hunter,survival,12,7,5
7067,Мертвыйпсарь,soulflayer,670,hunter,survival,12,7,5
7068,Szybky,defias-brotherhood,666,hunter,survival,12,7,5
7069,Yake,kazzak,660,hunter,survival,34,10,24
7070,Skyythe,dun-morogh,649,hunter,survival,18,7,11
7071,Marvelmary,ravencrest,639,hunter,survival,17,7,10
7072,Bugspitz,outland,622,hunter,survival,11,7,4
7073,Animàl,argent-dawn,607,hunter,survival,16,7,9
7074,Gitanìlla,dun-modr,576,hunter,survival,6,6,0
7075,Ðévi,ravencrest,576,hunter,survival,6,6,0
7076,Løvebombing,ravencrest,576,hunter,survival,6,6,0
7077,Rubydacherrý,argent-dawn,576,hunter,survival,6,6,0
7078,Maddoqx,frostwolf,576,hunter,survival,12,6,6
7079,Doubleright,ravencrest,576,hunter,survival,12,6,6
7080,Nirn,ravencrest,576,hunter,survival,12,6,6
7081,Torelk,dalaran,576,hunter,survival,12,6,6
7082,Morkahs,dalaran,576,hunter,survival,12,6,6
7083,Weraxo,ravencrest,576,hunter,survival,12,6,6
7084,Jamoneame,sanguino,576,hunter,survival,12,6,6
7085,Búddhìst,ravencrest,576,hunter,survival,12,6,6
7086,Snoude,silvermoon,576,hunter,survival,12,6,6
7087,Nkl,archimonde,576,hunter,survival,12,6,6
7088,Steezowl,kazzak,576,hunter,survival,12,6,6
7089,Хитвейн,gordunni,576,hunter,survival,12,6,6
7090,Cira,archimonde,576,hunter,survival,12,6,6
7091,Mouganstine,archimonde,576,hunter,survival,12,6,6
7092,Nunziatellà,nemesis,576,hunter,survival,12,6,6
7093,Ashendan,silvermoon,576,hunter,survival,18,6,12
7094,Grimazg,chogall,575,hunter,survival,12,6,6
7095,Hevl,silvermoon,575,hunter,survival,12,6,6
7096,Thëoden,cthun,575,hunter,survival,12,6,6
7097,Йинги,gordunni,575,hunter,survival,12,6,6
7098,Nektard,ravencrest,575,hunter,survival,12,6,6
7099,Gakco,twisting-nether,575,hunter,survival,12,6,6
7100,Pãstèque,ravencrest,575,hunter,survival,12,6,6
7101,Makeawish,antonidas,575,hunter,survival,12,6,6
7102,Amjamh,hyjal,575,hunter,survival,18,6,12
7103,Sekkeh,ragnaros,575,hunter,survival,18,6,12
7104,Milandra,the-maelstrom,573,hunter,survival,12,6,6
7105,Mâjôô,blackhand,544,hunter,survival,10,6,4
7106,Боцекабузер,galakrond,543,hunter,survival,11,6,5
7107,Reðrighthånð,throkferoth,528,hunter,survival,9,6,3
7108,Pechvogel,blackmoore,527,hunter,survival,11,6,5
7109,Musen,draenor,480,hunter,survival,6,5,1
7110,Пьёт,gordunni,480,hunter,survival,6,5,1
7111,Glama,archimonde,480,hunter,survival,6,5,1
7112,Wicmex,archimonde,480,hunter,survival,6,5,1
7113,Dackeldustin,norgannon,480,hunter,survival,6,5,1
7114,Jaggy,hyjal,480,hunter,survival,6,5,1
7115,Frapt,dalaran,480,hunter,survival,6,5,1
7116,Röwene,argent-dawn,480,hunter,survival,6,5,1
7117,Vilopez,arthas,480,hunter,survival,6,5,1
7118,Mòzetónq,ravencrest,480,hunter,survival,6,5,1
7119,Ватмано,gordunni,480,hunter,survival,6,5,1
7120,Smellygroin,darksorrow,480,hunter,survival,6,5,1
7121,Deek,ysera,480,hunter,survival,6,5,1
7122,Айхана,gordunni,480,hunter,survival,6,5,1
7123,Grusijohn,executus,480,hunter,survival,12,5,7
7124,Kirax,ravencrest,480,hunter,survival,12,5,7
7125,Agnêas,silvermoon,480,hunter,survival,12,5,7
7126,Horku,kazzak,480,hunter,survival,12,5,7
7127,Дондонандон,gordunni,480,hunter,survival,12,5,7
7128,Unferth,the-venture-co,480,hunter,survival,12,5,7
7129,Hunterado,burning-legion,480,hunter,survival,12,5,7
7130,Doloresman,tarren-mill,480,hunter,survival,12,5,7
7131,Вкинулматрас,gordunni,480,hunter,survival,12,5,7
7132,Abeba,grim-batol,480,hunter,survival,12,5,7
7133,Moscowmule,tarren-mill,480,hunter,survival,12,5,7
7134,Løwg,drekthar,480,hunter,survival,12,5,7
7135,Boggy,outland,480,hunter,survival,12,5,7
7136,Aequitaz,blackhand,480,hunter,survival,18,5,13
7137,Badboyxoxo,stormscale,479,hunter,survival,6,5,1
7138,Daltyr,ravencrest,479,hunter,survival,12,5,7
7139,Bloodxx,ragnaros,479,hunter,survival,12,5,7
7140,Absolutnoob,blackrock,478,hunter,survival,12,5,7
7141,Mahemi,mazrigos,478,hunter,survival,24,5,19
7142,Pôîson,kazzak,478,hunter,survival,24,5,19
7143,Bowkeeper,kazzak,471,hunter,survival,18,5,13
7144,Jabela,eredar,447,hunter,survival,11,5,6
7145,Оверман,azuregos,447,hunter,survival,20,6,14
7146,Azuren,twisting-nether,430,hunter,survival,11,5,6
7147,Oldlynx,ravencrest,384,hunter,survival,6,4,2
7148,Flamehand,kazzak,384,hunter,survival,6,4,2
7149,Raelaf,zuljin,384,hunter,survival,6,4,2
7150,Trappewpew,blackmoore,384,hunter,survival,6,4,2
7151,Xxø,ravencrest,384,hunter,survival,6,4,2
7152,Gogolehunt,archimonde,384,hunter,survival,6,4,2
7153,Trapandstun,aszune,384,hunter,survival,6,4,2
7154,Jamboss,twisting-nether,384,hunter,survival,6,4,2
7155,Vádîazmeý,twisting-nether,384,hunter,survival,6,4,2
7156,Куфа,blackscar,384,hunter,survival,6,4,2
7157,Vâleriaa,blackrock,384,hunter,survival,6,4,2
7158,Virzion,silvermoon,384,hunter,survival,6,4,2
7159,Gradevine,twisting-nether,384,hunter,survival,6,4,2
7160,Djøgi,archimonde,384,hunter,survival,6,4,2
7161,Аминотоксид,blackscar,384,hunter,survival,6,4,2
7162,Nomorex,frostwhisper,384,hunter,survival,6,4,2
7163,Renegansnipe,silvermoon,384,hunter,survival,6,4,2
7164,Пятницкий,soulflayer,384,hunter,survival,6,4,2
7165,Luftikuss,arthas,384,hunter,survival,6,4,2
7166,Tôm,ravencrest,384,hunter,survival,6,4,2
7167,Ледо,deathguard,384,hunter,survival,6,4,2
7168,Gharzok,blackrock,384,hunter,survival,6,4,2
7169,Тэуреэль,gordunni,384,hunter,survival,12,4,8
7170,Фурболгов,gordunni,384,hunter,survival,12,4,8
7171,Ниалла,thermaplugg,384,hunter,survival,12,4,8
7172,Abgeherjoe,antonidas,384,hunter,survival,12,4,8
7173,Magicnanø,nemesis,384,hunter,survival,12,4,8
7174,Eâgleêyê,frostwolf,384,hunter,survival,12,4,8
7175,Wärft,arathi,384,hunter,survival,12,4,8
7176,Dettas,silvermoon,384,hunter,survival,12,4,8
7177,Voldagor,hyjal,384,hunter,survival,12,4,8
7178,Beaststeaks,thrall,384,hunter,survival,12,4,8
7179,Skumrask,outland,384,hunter,survival,12,4,8
7180,Salie,argent-dawn,384,hunter,survival,12,4,8
7181,Bâng,zuljin,383,hunter,survival,12,4,8
7182,Platza,ragnaros,383,hunter,survival,12,4,8
7183,Одисенс,eversong,383,hunter,survival,12,4,8
7184,Hanibale,burning-blade,382,hunter,survival,18,4,14
7185,Ghob,kazzak,330,hunter,survival,8,5,3
7186,Killdembro,sunstrider,320,hunter,survival,16,4,12
7187,Sùnzí,alakir,319,hunter,survival,6,4,2
7188,Eazzyy,auchindoun,288,hunter,survival,6,3,3
7189,Kleiar,dun-modr,288,hunter,survival,6,3,3
7190,Oneeyedjoe,the-maelstrom,288,hunter,survival,6,3,3
7191,Faccacamoale,twisting-nether,288,hunter,survival,6,3,3
7192,Ksreport,stormscale,288,hunter,survival,6,3,3
7193,Crispystix,draenor,288,hunter,survival,6,3,3
7194,Rdwlf,draenor,288,hunter,survival,6,3,3
7195,Deskö,shendralar,288,hunter,survival,6,3,3
7196,Sworra,silvermoon,288,hunter,survival,6,3,3
7197,Simppeli,sylvanas,288,hunter,survival,6,3,3
7198,Himatoumi,elune,288,hunter,survival,6,3,3
7199,Schwabbels,silvermoon,288,hunter,survival,6,3,3
7200,Thëhunter,tyrande,288,hunter,survival,6,3,3
7201,Blackox,zirkel-des-cenarius,288,hunter,survival,6,3,3
7202,Assaultrifle,frostmane,288,hunter,survival,6,3,3
7203,Spakster,blackrock,288,hunter,survival,6,3,3
7204,Hreo,twisting-nether,288,hunter,survival,6,3,3
7205,Aidsmacka,shattered-hand,288,hunter,survival,6,3,3
7206,Hræsvëlg,archimonde,288,hunter,survival,6,3,3
7207,Engetsu,drakthul,288,hunter,survival,6,3,3
7208,Helvetiya,sylvanas,288,hunter,survival,6,3,3
7209,Jäegarn,ravencrest,288,hunter,survival,6,3,3
7210,Ремонтлицаа,gordunni,288,hunter,survival,6,3,3
7211,Паркх,soulflayer,288,hunter,survival,6,3,3
7212,Lightxyz,ravencrest,288,hunter,survival,6,3,3
7213,Prinzz,blackmoore,288,hunter,survival,6,3,3
7214,Hühneknubbel,blackmoore,288,hunter,survival,6,3,3
7215,Crucfixion,kazzak,288,hunter,survival,6,3,3
7216,Rákthar,blackmoore,288,hunter,survival,6,3,3
7217,Natchell,ysondre,288,hunter,survival,6,3,3
7218,Крэин,howling-fjord,288,hunter,survival,6,3,3
7219,Natheldir,silvermoon,288,hunter,survival,6,3,3
7220,Сногивкабину,soulflayer,288,hunter,survival,12,3,9
7221,Nestór,todeswache,288,hunter,survival,12,3,9
7222,Киссмайпет,howling-fjord,288,hunter,survival,12,3,9
7223,Aleenya,dalaran,288,hunter,survival,12,3,9
7224,Aspergun,ragnaros,288,hunter,survival,12,3,9
7225,Satantrapbot,outland,288,hunter,survival,12,3,9
7226,Cásper,tarren-mill,288,hunter,survival,12,3,9
7227,Lezigoulleur,marécage-de-zangar,287,hunter,survival,6,3,3
7228,Charlet,archimonde,287,hunter,survival,6,3,3
7229,Санясурв,gordunni,239,hunter,survival,10,6,4
7230,Axiøs,thrall,239,hunter,survival,5,3,2
7231,Xamisch,eredar,192,hunter,survival,4,3,1
7232,Gerzyy,drakthul,192,hunter,survival,6,2,4
7233,Flexifys,tarren-mill,192,hunter,survival,6,2,4
7234,Roscke,drakthul,192,hunter,survival,6,2,4
7235,Rølyn,hyjal,192,hunter,survival,6,2,4
7236,Abeji,malygos,192,hunter,survival,6,2,4
7237,Aboleon,ragnaros,192,hunter,survival,6,2,4
7238,Evazeonhunt,antonidas,192,hunter,survival,6,2,4
7239,Jomoguin,stormscale,192,hunter,survival,6,2,4
7240,Gynax,hyjal,192,hunter,survival,6,2,4
7241,Raenard,ragnaros,192,hunter,survival,6,2,4
7242,Yakayoshi,kazzak,192,hunter,survival,6,2,4
7243,Наладдчик,howling-fjord,192,hunter,survival,6,2,4
7244,Huntanova,antonidas,192,hunter,survival,6,2,4
7245,Djsecousse,hyjal,192,hunter,survival,6,2,4
7246,Eromoar,outland,192,hunter,survival,6,2,4
7247,Draugrinnh,tarren-mill,192,hunter,survival,6,2,4
7248,Valtondre,argent-dawn,192,hunter,survival,6,2,4
7249,Штынь,gordunni,192,hunter,survival,6,2,4
7250,Гаррельд,blackscar,192,hunter,survival,6,2,4
7251,Steffxd,twisting-nether,192,hunter,survival,6,2,4
7252,Ammò,kazzak,192,hunter,survival,6,2,4
7253,Jarekk,auchindoun,192,hunter,survival,6,2,4
7254,Brindefolìe,archimonde,192,hunter,survival,6,2,4
7255,Yezzu,sylvanas,192,hunter,survival,6,2,4
7256,Lithell,kazzak,192,hunter,survival,6,2,4
7257,Regale,archimonde,192,hunter,survival,6,2,4
7258,Tdapills,sanguino,192,hunter,survival,6,2,4
7259,Robosexual,ravencrest,192,hunter,survival,6,2,4
7260,Grundibg,chamber-of-aspects,192,hunter,survival,6,2,4
7261,Marluxiâ,archimonde,192,hunter,survival,6,2,4
7262,Vasco,chogall,192,hunter,survival,6,2,4
7263,Adram,burning-legion,192,hunter,survival,6,2,4
7264,Babûsch,blackmoore,192,hunter,survival,6,2,4
7265,Zøøkëëper,silvermoon,192,hunter,survival,6,2,4
7266,Sakaryali,silvermoon,192,hunter,survival,6,2,4
7267,Bùddhíst,ravencrest,192,hunter,survival,6,2,4
7268,Epicsurvive,ravencrest,192,hunter,survival,6,2,4
7269,Неужто,deathguard,192,hunter,survival,6,2,4
7270,Aggrobatics,blackmoore,192,hunter,survival,6,2,4
7271,Coromant,blackrock,192,hunter,survival,8,2,6
7272,Skewdar,hyjal,192,hunter,survival,12,2,10
7273,Haskeer,shattrath,192,hunter,survival,12,2,10
7274,Yinn,kilrogg,192,hunter,survival,12,2,10
7275,Ecthelione,the-venture-co,192,hunter,survival,12,2,10
7276,Бомбетта,grom,192,hunter,survival,12,2,10
7277,Комомура,soulflayer,169,hunter,survival,17,4,13
7278,Ryztik,garona,96,hunter,survival,6,1,5
7279,Panzershot,hyjal,96,hunter,survival,6,1,5
7280,Katzchen,burning-legion,96,hunter,survival,6,1,5
7281,Zuggi,defias-brotherhood,96,hunter,survival,6,1,5
7282,Escaflôwn,aegwynn,96,hunter,survival,6,1,5
7283,Fantus,sylvanas,96,hunter,survival,6,1,5
7284,Aimywinehaus,drakthul,96,hunter,survival,6,1,5
7285,Zynga,sylvanas,96,hunter,survival,6,1,5
7286,Amadia,defias-brotherhood,96,hunter,survival,6,1,5
7287,Clicktrap,runetotem,96,hunter,survival,6,1,5
7288,Supcuz,stormscale,96,hunter,survival,6,1,5
7289,Cryts,dun-modr,96,hunter,survival,6,1,5
7290,Эвилтар,soulflayer,96,hunter,survival,6,1,5
7291,Vuloshi,twisting-nether,96,hunter,survival,6,1,5
7292,Grollar,ragnaros,96,hunter,survival,6,1,5
7293,Куоль,gordunni,96,hunter,survival,6,1,5
7294,Рангмар,howling-fjord,79,hunter,survival,5,1,4
7295,Twinkhunter,pozzo-delleternità,64,hunter,survival,4,1,3
7296,Skyyw,tarren-mill,64,hunter,survival,5,1,4
7297,Jacobszy,outland,63,hunter,survival,2,2,0
7298,Velrhegal,tarren-mill,16,hunter,survival,7,1,6
7299,Mariabanks,aegwynn,2278,hunter,beastmastery,222,118,104
7300,Brokeasalwys,ravencrest,2164,hunter,beastmastery,84,46,38
7301,Hypse,kazzak,2127,hunter,beastmastery,190,94,96
7302,Esperion,ragnaros,2042,hunter,beastmastery,96,46,50
7303,Plugonbaby,hyjal,2035,hunter,beastmastery,77,37,40
7304,Берх,gordunni,2015,hunter,beastmastery,108,53,55
7305,Cbã,ravencrest,1995,hunter,beastmastery,42,21,21
7306,Gernoqz,frostwolf,1973,hunter,beastmastery,107,51,56
7307,Eldrekou,kazzak,1968,hunter,beastmastery,72,41,31
7308,Zyphx,der-rat-von-dalaran,1936,hunter,beastmastery,102,46,56
7309,Libanais,archimonde,1933,hunter,beastmastery,245,117,128
7310,Feevah,frostmane,1923,hunter,beastmastery,260,130,130
7311,Куфа,blackscar,1909,hunter,beastmastery,36,20,16
7312,Thing,kazzak,1900,hunter,beastmastery,36,21,15
7313,Тружка,soulflayer,1899,hunter,beastmastery,78,35,43
7314,Trapgoddxx,archimonde,1894,hunter,beastmastery,65,44,21
7315,Биско,gordunni,1890,hunter,beastmastery,80,40,40
7316,Manj,blackhand,1888,hunter,beastmastery,54,29,25
7317,Tagz,ravencrest,1887,hunter,beastmastery,60,29,31
7318,Wilfyre,twisting-nether,1885,hunter,beastmastery,63,32,31
7319,Odeôn,twisting-nether,1884,hunter,beastmastery,59,24,35
7320,Baltímore,stormscale,1877,hunter,beastmastery,41,22,19
7321,Blackszpak,jaedenar,1876,hunter,beastmastery,42,23,19
7322,Дианнесса,howling-fjord,1876,hunter,beastmastery,71,35,36
7323,Dogetrainer,silvermoon,1872,hunter,beastmastery,66,37,29
7324,Phesx,sylvanas,1865,hunter,beastmastery,54,27,27
7325,Ígrågøßñø,silvermoon,1864,hunter,beastmastery,44,30,14
7326,Aimshots,twisting-nether,1864,hunter,beastmastery,60,33,27
7327,Breezme,twisting-nether,1864,hunter,beastmastery,72,33,39
7328,Kfcmanagerx,silvermoon,1860,hunter,beastmastery,54,22,32
7329,Moscowmule,tarren-mill,1859,hunter,beastmastery,59,29,30
7330,Fãdê,ravencrest,1858,hunter,beastmastery,42,30,12
7331,Krampack,dun-modr,1858,hunter,beastmastery,54,31,23
7332,Gaeln,outland,1856,hunter,beastmastery,90,44,46
7333,Найстити,deathguard,1854,hunter,beastmastery,66,31,35
7334,Doghxnter,ravencrest,1853,hunter,beastmastery,42,21,21
7335,Sipsomewater,ravencrest,1852,hunter,beastmastery,57,30,27
7336,Draxil,archimonde,1852,hunter,beastmastery,42,22,20
7337,Nexztwo,blackrock,1852,hunter,beastmastery,69,33,36
7338,Âmalphy,ravencrest,1846,hunter,beastmastery,47,23,24
7339,Safnirx,tarren-mill,1845,hunter,beastmastery,66,27,39
7340,Nyzuri,die-aldor,1843,hunter,beastmastery,54,26,28
7341,Luzivarus,malganis,1842,hunter,beastmastery,59,29,30
7342,Thogel,hyjal,1838,hunter,beastmastery,72,33,39
7343,Miløø,silvermoon,1835,hunter,beastmastery,48,26,22
7344,Rákthar,blackmoore,1832,hunter,beastmastery,66,32,34
7345,Bilbohunter,draenor,1825,hunter,beastmastery,48,27,21
7346,Горгонт,blackscar,1825,hunter,beastmastery,47,25,22
7347,Burninghunt,ravencrest,1822,hunter,beastmastery,60,32,28
7348,Wêskêr,tarren-mill,1821,hunter,beastmastery,66,31,35
7349,Sukzess,antonidas,1818,hunter,beastmastery,54,27,27
7350,Ooh,doomhammer,1816,hunter,beastmastery,96,44,52
7351,Jabela,eredar,1814,hunter,beastmastery,53,39,14
7352,Рагнарианх,gordunni,1813,hunter,beastmastery,60,25,35
7353,Rndhunt,shattrath,1811,hunter,beastmastery,60,30,30
7354,Марчик,blackscar,1810,hunter,beastmastery,42,19,23
7355,Corossity,blackmoore,1808,hunter,beastmastery,30,19,11
7356,Hiddenx,blackmoore,1808,hunter,beastmastery,42,21,21
7357,Trend,silvermoon,1808,hunter,beastmastery,48,23,25
7358,Huntchonk,kazzak,1806,hunter,beastmastery,53,27,26
7359,Truejkee,silvermoon,1805,hunter,beastmastery,54,29,25
7360,Crippa,tarren-mill,1803,hunter,beastmastery,54,28,26
7361,Ynv,argent-dawn,1802,hunter,beastmastery,60,30,30
7362,Fluphy,thrall,1794,hunter,beastmastery,70,41,29
7363,Orcji,blackhand,1788,hunter,beastmastery,59,29,30
7364,Wodhunterxdd,outland,1788,hunter,beastmastery,53,25,28
7365,Triggaz,stormscale,1785,hunter,beastmastery,160,85,75
7366,Mtrider,twisting-nether,1785,hunter,beastmastery,65,33,32
7367,Wîldhunt,burning-legion,1781,hunter,beastmastery,161,76,85
7368,Alpharaven,ravencrest,1779,hunter,beastmastery,54,29,25
7369,Nystaleoss,grim-batol,1776,hunter,beastmastery,88,42,46
7370,Jamesyy,ravencrest,1776,hunter,beastmastery,60,28,32
7371,Онкьяр,gordunni,1773,hunter,beastmastery,39,23,16
7372,Eazzyy,auchindoun,1769,hunter,beastmastery,42,25,17
7373,Erethrus,ravencrest,1769,hunter,beastmastery,48,19,29
7374,Amyndôr,ravencrest,1767,hunter,beastmastery,48,27,21
7375,Izmad,archimonde,1766,hunter,beastmastery,239,134,105
7376,Séyena,outland,1764,hunter,beastmastery,42,19,23
7377,Fullxtrap,hyjal,1763,hunter,beastmastery,41,19,22
7378,Пивопьюня,ashenvale,1761,hunter,beastmastery,47,24,23
7379,Åsynåmvp,twisting-nether,1759,hunter,beastmastery,47,23,24
7380,Nimhunt,dentarg,1759,hunter,beastmastery,65,29,36
7381,Порошокк,gordunni,1756,hunter,beastmastery,69,29,40
7382,Klausmanne,blackrock,1755,hunter,beastmastery,123,58,65
7383,Мориартис,ashenvale,1754,hunter,beastmastery,53,29,24
7384,Мэлвиса,borean-tundra,1752,hunter,beastmastery,66,38,28
7385,Kachaxa,kazzak,1751,hunter,beastmastery,58,27,31
7386,Ilovemax,archimonde,1750,hunter,beastmastery,46,20,26
7387,Mekerosh,burning-legion,1749,hunter,beastmastery,46,23,23
7388,Carioca,blackhand,1744,hunter,beastmastery,48,21,27
7389,Treaz,sanguino,1739,hunter,beastmastery,66,33,33
7390,Saggymilkies,outland,1735,hunter,beastmastery,54,23,31
7391,Шергала,soulflayer,1734,hunter,beastmastery,73,33,40
7392,Nèxz,blackrock,1732,hunter,beastmastery,77,33,44
7393,Вождь,howling-fjord,1730,hunter,beastmastery,42,21,21
7394,Играсломана,howling-fjord,1729,hunter,beastmastery,42,27,15
7395,Duppdupp,eredar,1726,hunter,beastmastery,84,38,46
7396,Лесбиянюсь,gordunni,1723,hunter,beastmastery,30,24,6
7397,Babýrage,twisting-nether,1716,hunter,beastmastery,30,18,12
7398,Дашатрирубля,soulflayer,1715,hunter,beastmastery,42,21,21
7399,Noversia,aegwynn,1714,hunter,beastmastery,71,33,38
7400,Twineyes,ravencrest,1712,hunter,beastmastery,48,25,23
7401,Mogwai,stormscale,1709,hunter,beastmastery,42,18,24
7402,Omegakek,madmortem,1707,hunter,beastmastery,46,23,23
7403,Easyclass,hyjal,1705,hunter,beastmastery,102,58,44
7404,Impxgodx,outland,1704,hunter,beastmastery,51,24,27
7405,Elamondria,outland,1699,hunter,beastmastery,72,42,30
7406,Sznxøxo,ravencrest,1699,hunter,beastmastery,48,26,22
7407,Куроните,howling-fjord,1697,hunter,beastmastery,30,18,12
7408,Irefutabilâ,outland,1696,hunter,beastmastery,96,43,53
7409,Priceqtxd,ravencrest,1694,hunter,beastmastery,61,40,21
7410,Krix,ragnaros,1691,hunter,beastmastery,54,34,20
7411,Пихпахах,gordunni,1691,hunter,beastmastery,82,43,39
7412,Mânhunt,blackhand,1691,hunter,beastmastery,224,110,114
7413,Paimen,darksorrow,1690,hunter,beastmastery,96,54,42
7414,Fize,blackmoore,1690,hunter,beastmastery,65,30,35
7415,Pawzz,kazzak,1687,hunter,beastmastery,54,25,29
7416,Jägarnmt,twisting-nether,1686,hunter,beastmastery,54,23,31
7417,Letsrock,outland,1682,hunter,beastmastery,33,20,13
7418,Скадхи,blackscar,1681,hunter,beastmastery,46,23,23
7419,Nestór,todeswache,1678,hunter,beastmastery,47,28,19
7420,Tyranski,ravencrest,1678,hunter,beastmastery,57,28,29
7421,Отерон,gordunni,1677,hunter,beastmastery,90,55,35
7422,Трапгодикс,eversong,1677,hunter,beastmastery,96,51,45
7423,Appirc,tarren-mill,1675,hunter,beastmastery,36,19,17
7424,Father,auchindoun,1670,hunter,beastmastery,77,39,38
7425,Qtìp,aegwynn,1668,hunter,beastmastery,42,20,22
7426,Dréws,kazzak,1665,hunter,beastmastery,40,18,22
7427,Trenesta,tarren-mill,1659,hunter,beastmastery,34,18,16
7428,Pérnix,tarren-mill,1657,hunter,beastmastery,30,18,12
7429,Lowfet,neptulon,1656,hunter,beastmastery,54,35,19
7430,Cnby,stormscale,1652,hunter,beastmastery,43,26,17
7431,Índigo,kazzak,1650,hunter,beastmastery,44,25,19
7432,Røzy,twisting-nether,1647,hunter,beastmastery,48,35,13
7433,Nîøssx,blackrock,1644,hunter,beastmastery,53,28,25
7434,Ericspet,stormscale,1641,hunter,beastmastery,36,24,12
7435,Ðéadsøulz,stormscale,1641,hunter,beastmastery,84,45,39
7436,Hacz,bronzebeard,1641,hunter,beastmastery,48,20,28
7437,Drøøðqt,blackrock,1637,hunter,beastmastery,60,31,29
7438,Экономист,fordragon,1633,hunter,beastmastery,36,21,15
7439,Horhyndan,ragnaros,1631,hunter,beastmastery,51,24,27
7440,Xiioo,ravencrest,1631,hunter,beastmastery,65,29,36
7441,Imcuteandfun,ravencrest,1630,hunter,beastmastery,60,24,36
7442,Lofiel,blackrock,1628,hunter,beastmastery,53,27,26
7443,Roarmantic,blackrock,1627,hunter,beastmastery,36,17,19
7444,Порошокк,howling-fjord,1625,hunter,beastmastery,30,17,13
7445,Дэнвин,deathweaver,1625,hunter,beastmastery,42,22,20
7446,Gibiswag,outland,1625,hunter,beastmastery,36,17,19
7447,Uglybaboon,draenor,1625,hunter,beastmastery,42,17,25
7448,Akaris,archimonde,1624,hunter,beastmastery,48,23,25
7449,Sicktrapbtw,hyjal,1624,hunter,beastmastery,42,17,25
7450,Merquryh,ravencrest,1619,hunter,beastmastery,36,20,16
7451,Vezeka,ravencrest,1618,hunter,beastmastery,42,26,16
7452,Sïmc,archimonde,1617,hunter,beastmastery,84,44,40
7453,Búddhá,stormscale,1617,hunter,beastmastery,132,63,69
7454,Ганидони,soulflayer,1616,hunter,beastmastery,59,23,36
7455,Jeeso,baelgun,1614,hunter,beastmastery,88,42,46
7456,Diapositiv,draenor,1613,hunter,beastmastery,42,25,17
7457,Missmytraps,ravencrest,1613,hunter,beastmastery,39,20,19
7458,Coldmonster,tarren-mill,1612,hunter,beastmastery,113,68,45
7459,Erilis,twisting-nether,1612,hunter,beastmastery,31,18,13
7460,Eaglexx,twisting-nether,1612,hunter,beastmastery,54,27,27
7461,Grynu,kazzak,1612,hunter,beastmastery,54,21,33
7462,Aroeris,ravencrest,1611,hunter,beastmastery,57,32,25
7463,Цитрукс,gordunni,1611,hunter,beastmastery,48,21,27
7464,Pekaxôxô,sanguino,1609,hunter,beastmastery,48,34,14
7465,Nordafrøst,antonidas,1609,hunter,beastmastery,66,27,39
7466,Bànsundara,hyjal,1605,hunter,beastmastery,78,43,35
7467,Taoshii,die-aldor,1604,hunter,beastmastery,66,36,30
7468,Céah,blackrock,1604,hunter,beastmastery,54,28,26
7469,Gucçi,kazzak,1602,hunter,beastmastery,28,18,10
7470,Brisbya,khaz-modan,1600,hunter,beastmastery,29,21,8
7471,Stickey,antonidas,1600,hunter,beastmastery,66,34,32
7472,Moistmán,kazzak,1594,hunter,beastmastery,44,22,22
7473,Poupoune,uldum,1593,hunter,beastmastery,36,17,19
7474,Зоотян,gordunni,1589,hunter,beastmastery,111,55,56
7475,Nottberozz,silvermoon,1589,hunter,beastmastery,122,59,63
7476,Eagletalon,twisting-nether,1588,hunter,beastmastery,42,21,21
7477,Каоссхант,howling-fjord,1585,hunter,beastmastery,29,20,9
7478,Tayaa,draenor,1585,hunter,beastmastery,79,43,36
7479,Janko,ravencrest,1584,hunter,beastmastery,108,55,53
7480,Xxiioo,ravencrest,1583,hunter,beastmastery,79,46,33
7481,Parhainkoira,argent-dawn,1581,hunter,beastmastery,36,20,16
7482,Eggcowmeow,azjolnerub,1579,hunter,beastmastery,30,19,11
7483,Тиблэк,soulflayer,1579,hunter,beastmastery,101,51,50
7484,Ryuwen,dun-modr,1579,hunter,beastmastery,36,18,18
7485,Chasseurcool,argent-dawn,1576,hunter,beastmastery,44,24,20
7486,Grusijohn,executus,1573,hunter,beastmastery,66,33,33
7487,Леао,howling-fjord,1571,hunter,beastmastery,45,30,15
7488,Мунлэс,lich-king,1569,hunter,beastmastery,69,30,39
7489,Комомура,soulflayer,1568,hunter,beastmastery,53,24,29
7490,Samanou,kazzak,1567,hunter,beastmastery,41,17,24
7491,Sagethunt,blackrock,1565,hunter,beastmastery,41,17,24
7492,Ariabeast,archimonde,1564,hunter,beastmastery,36,17,19
7493,Pluttbug,xavius,1560,hunter,beastmastery,26,17,9
7494,Kamar,archimonde,1560,hunter,beastmastery,36,23,13
7495,Futureman,blackrock,1557,hunter,beastmastery,36,17,19
7496,Жокра,greymane,1557,hunter,beastmastery,42,19,23
7497,Søuïlløn,archimonde,1553,hunter,beastmastery,36,24,12
7498,Gunde,kazzak,1551,hunter,beastmastery,102,52,50
7499,Zuxz,blackmoore,1546,hunter,beastmastery,42,18,24
7500,Пулявзубах,gordunni,1544,hunter,beastmastery,92,49,43
7501,Palaur,kazzak,1542,hunter,beastmastery,88,48,40
7502,Кразайс,ashenvale,1542,hunter,beastmastery,44,18,26
7503,Hultasy,outland,1541,hunter,beastmastery,94,43,51
7504,Feralhound,exodar,1539,hunter,beastmastery,36,18,18
7505,Oldcocknbals,silvermoon,1539,hunter,beastmastery,58,28,30
7506,Антисерт,ashenvale,1538,hunter,beastmastery,70,33,37
7507,Arcø,dun-modr,1535,hunter,beastmastery,30,16,14
7508,Expiraa,twisting-nether,1535,hunter,beastmastery,30,16,14
7509,Jêsslíne,ravencrest,1532,hunter,beastmastery,30,16,14
7510,Гринмех,gordunni,1530,hunter,beastmastery,30,16,14
7511,Almogrote,sanguino,1526,hunter,beastmastery,42,21,21
7512,Nkdchef,outland,1526,hunter,beastmastery,36,17,19
7513,Hlogic,tarren-mill,1526,hunter,beastmastery,36,16,20
7514,Sarrow,ravencrest,1523,hunter,beastmastery,77,41,36
7515,Idtrapthat,nagrand,1522,hunter,beastmastery,30,16,14
7516,Liquidhunter,quelthalas,1520,hunter,beastmastery,24,16,8
7517,Haltrâdar,archimonde,1511,hunter,beastmastery,33,17,16
7518,Draugrinnh,tarren-mill,1511,hunter,beastmastery,66,29,37
7519,Kafkules,outland,1507,hunter,beastmastery,53,29,24
7520,Icetrapped,eredar,1502,hunter,beastmastery,41,25,16
7521,Leriath,shadowsong,1502,hunter,beastmastery,89,52,37
7522,Hîldegard,todeswache,1499,hunter,beastmastery,36,16,20
7523,Rdom,stormreaver,1497,hunter,beastmastery,50,26,24
7524,Slmao,tarren-mill,1497,hunter,beastmastery,36,16,20
7525,Gumm,gorgonnash,1496,hunter,beastmastery,30,17,13
7526,Bortian,argent-dawn,1495,hunter,beastmastery,37,22,15
7527,Funkalation,ravencrest,1495,hunter,beastmastery,36,20,16
7528,Badkirves,kazzak,1490,hunter,beastmastery,60,28,32
7529,Nallepuuoh,outland,1487,hunter,beastmastery,63,30,33
7530,Vaelyste,doomhammer,1485,hunter,beastmastery,54,27,27
7531,Забзаб,soulflayer,1484,hunter,beastmastery,29,16,13
7532,Аллони,booty-bay,1483,hunter,beastmastery,90,41,49
7533,Gnouminøu,archimonde,1479,hunter,beastmastery,85,45,40
7534,Mariehunt,blackmoore,1472,hunter,beastmastery,78,38,40
7535,Snipertjuh,silvermoon,1472,hunter,beastmastery,37,17,20
7536,Wingclip,ravencrest,1472,hunter,beastmastery,40,17,23
7537,Bastianapa,twisting-nether,1471,hunter,beastmastery,66,31,35
7538,Aenina,kazzak,1466,hunter,beastmastery,30,19,11
7539,Råhl,zuljin,1466,hunter,beastmastery,41,17,24
7540,Куоль,gordunni,1463,hunter,beastmastery,47,21,26
7541,Бубунн,howling-fjord,1461,hunter,beastmastery,72,33,39
7542,Anca,aegwynn,1460,hunter,beastmastery,60,28,32
7543,Ázurâ,blackhand,1458,hunter,beastmastery,75,39,36
7544,Boulaax,ysondre,1457,hunter,beastmastery,100,60,40
7545,Metalmaison,archimonde,1453,hunter,beastmastery,70,31,39
7546,Druckwelle,frostwolf,1449,hunter,beastmastery,39,16,23
7547,Маунтдроп,gordunni,1439,hunter,beastmastery,79,42,37
7548,Bíllybobbs,argent-dawn,1439,hunter,beastmastery,30,15,15
7549,Techpøint,silvermoon,1438,hunter,beastmastery,30,15,15
7550,Pfizershotx,khaz-modan,1436,hunter,beastmastery,30,15,15
7551,Каосси,gordunni,1436,hunter,beastmastery,38,17,21
7552,Mágaz,draenor,1435,hunter,beastmastery,48,26,22
7553,Unrealy,grim-batol,1433,hunter,beastmastery,42,27,15
7554,Orcoro,ysondre,1432,hunter,beastmastery,115,51,64
7555,Tukene,kazzak,1432,hunter,beastmastery,45,17,28
7556,Shoranon,stormscale,1431,hunter,beastmastery,30,15,15
7557,Dzikapumpa,burning-legion,1429,hunter,beastmastery,39,18,21
7558,Jomerin,thrall,1429,hunter,beastmastery,36,15,21
7559,Афонадзе,gordunni,1428,hunter,beastmastery,66,33,33
7560,Anjeschka,nemesis,1427,hunter,beastmastery,40,24,16
7561,Gondoo,tarren-mill,1427,hunter,beastmastery,30,15,15
7562,Elsasehunter,zuljin,1426,hunter,beastmastery,90,40,50
7563,Tåxi,silvermoon,1424,hunter,beastmastery,60,31,29
7564,Meskette,ravencrest,1423,hunter,beastmastery,49,23,26
7565,Xystîco,thrall,1421,hunter,beastmastery,36,18,18
7566,Rhee,the-maelstrom,1421,hunter,beastmastery,90,39,51
7567,Waalth,ragnaros,1420,hunter,beastmastery,72,34,38
7568,Qmbonboni,ravencrest,1417,hunter,beastmastery,41,27,14
7569,Eufumo,sanguino,1416,hunter,beastmastery,36,22,14
7570,Гигапупсх,howling-fjord,1415,hunter,beastmastery,36,19,17
7571,Яроняютрапу,gordunni,1413,hunter,beastmastery,24,17,7
7572,Velocity,nagrand,1411,hunter,beastmastery,41,19,22
7573,Reptile,outland,1410,hunter,beastmastery,24,15,9
7574,Straybullet,kazzak,1409,hunter,beastmastery,72,34,38
7575,Neíth,the-maelstrom,1405,hunter,beastmastery,42,17,25
7576,Traktorr,stormscale,1403,hunter,beastmastery,33,17,16
7577,Mytown,hyjal,1403,hunter,beastmastery,78,37,41
7578,Váal,dun-modr,1401,hunter,beastmastery,63,36,27
7579,Шэйдуокер,gordunni,1400,hunter,beastmastery,75,34,41
7580,Kethos,draenor,1399,hunter,beastmastery,24,15,9
7581,Phinecone,stormscale,1399,hunter,beastmastery,42,18,24
7582,Pammycakes,bronze-dragonflight,1394,hunter,beastmastery,66,34,32
7583,Ayyubi,blackrock,1389,hunter,beastmastery,59,28,31
7584,Jägarntwo,stormscale,1389,hunter,beastmastery,39,15,24
7585,Афигеннски,ashenvale,1387,hunter,beastmastery,54,25,29
7586,Acmé,kazzak,1385,hunter,beastmastery,36,15,21
7587,Felorya,kazzak,1383,hunter,beastmastery,30,18,12
7588,Hammertime,sanguino,1382,hunter,beastmastery,53,26,27
7589,Drestan,drakthul,1379,hunter,beastmastery,48,22,26
7590,Bambamgalke,antonidas,1378,hunter,beastmastery,72,34,38
7591,Loógosh,blackmoore,1376,hunter,beastmastery,54,26,28
7592,Esgar,blackrock,1374,hunter,beastmastery,74,34,40
7593,Sonìc,kazzak,1373,hunter,beastmastery,32,16,16
7594,Честнный,howling-fjord,1373,hunter,beastmastery,113,51,62
7595,Raymear,kazzak,1370,hunter,beastmastery,30,16,14
7596,Travels,tarren-mill,1370,hunter,beastmastery,81,42,39
7597,Стреладемона,gordunni,1368,hunter,beastmastery,51,30,21
7598,Shroomynuts,kazzak,1368,hunter,beastmastery,42,16,26
7599,Kalt,twisting-nether,1357,hunter,beastmastery,42,22,20
7600,Nycrom,ravencrest,1354,hunter,beastmastery,32,15,17
7601,Киборка,howling-fjord,1352,hunter,beastmastery,30,15,15
7602,Laoriane,hyjal,1351,hunter,beastmastery,30,15,15
7603,Shawnrai,drakthul,1348,hunter,beastmastery,32,16,16
7604,Чапуршилов,lich-king,1346,hunter,beastmastery,106,50,56
7605,Камшотовна,blackscar,1342,hunter,beastmastery,30,18,12
7606,Ðoxz,blackrock,1342,hunter,beastmastery,24,14,10
7607,Pryse,hyjal,1342,hunter,beastmastery,30,14,16
7608,Baileé,onyxia,1340,hunter,beastmastery,32,17,15
7609,Фираналь,blackscar,1339,hunter,beastmastery,27,15,12
7610,Joshalama,quelthalas,1339,hunter,beastmastery,35,19,16
7611,Saromán,ravencrest,1336,hunter,beastmastery,36,19,17
7612,Notikâ,aegwynn,1336,hunter,beastmastery,48,20,28
7613,Feignindeath,twisting-nether,1335,hunter,beastmastery,30,19,11
7614,Сатарр,gordunni,1334,hunter,beastmastery,54,24,30
7615,Asousa,stormscale,1333,hunter,beastmastery,42,22,20
7616,Жмыххунтер,howling-fjord,1331,hunter,beastmastery,30,14,16
7617,Ägris,die-todeskrallen,1330,hunter,beastmastery,63,32,31
7618,Ixix,blackhand,1330,hunter,beastmastery,30,14,16
7619,Trapwann,argent-dawn,1329,hunter,beastmastery,24,14,10
7620,Huntma,kazzak,1324,hunter,beastmastery,24,14,10
7621,Cubro,sanguino,1322,hunter,beastmastery,30,14,16
7622,Hantro,argent-dawn,1321,hunter,beastmastery,30,18,12
7623,Hogar,frostwolf,1317,hunter,beastmastery,24,14,10
7624,Meredo,burning-legion,1313,hunter,beastmastery,58,30,28
7625,Muspigen,tarren-mill,1313,hunter,beastmastery,81,37,44
7626,Jarekk,auchindoun,1312,hunter,beastmastery,24,14,10
7627,Люблюлюбовь,gordunni,1310,hunter,beastmastery,42,27,15
7628,Memehunter,aegwynn,1307,hunter,beastmastery,24,14,10
7629,Bravestarr,blades-edge,1307,hunter,beastmastery,30,16,14
7630,Чизано,deathguard,1295,hunter,beastmastery,30,14,16
7631,Maknamara,tarren-mill,1293,hunter,beastmastery,24,14,10
7632,Flunkytim,blackmoore,1290,hunter,beastmastery,42,21,21
7633,Greathorn,arthas,1288,hunter,beastmastery,22,15,7
7634,Salvia,chromaggus,1288,hunter,beastmastery,96,51,45
7635,Снюсинка,gordunni,1287,hunter,beastmastery,29,14,15
7636,Cobra,magtheridon,1282,hunter,beastmastery,71,30,41
7637,Кулинарк,howling-fjord,1279,hunter,beastmastery,48,23,25
7638,Tháyn,tarren-mill,1268,hunter,beastmastery,23,14,9
7639,Kiingsane,archimonde,1268,hunter,beastmastery,33,15,18
7640,Linchpin,dentarg,1261,hunter,beastmastery,45,20,25
7641,Шионо,howling-fjord,1250,hunter,beastmastery,26,14,12
7642,Bufosh,twisting-nether,1250,hunter,beastmastery,36,19,17
7643,Ðowz,ysondre,1248,hunter,beastmastery,24,13,11
7644,Pagman,thrall,1247,hunter,beastmastery,30,13,17
7645,Astari,outland,1247,hunter,beastmastery,30,13,17
7646,Símpíng,tarren-mill,1245,hunter,beastmastery,18,13,5
7647,Neescafe,sylvanas,1236,hunter,beastmastery,27,14,13
7648,Johnwick,aerie-peak,1233,hunter,beastmastery,18,13,5
7649,Rxr,kazzak,1232,hunter,beastmastery,30,13,17
7650,Sparcùs,stormreaver,1231,hunter,beastmastery,30,13,17
7651,Yoggys,outland,1229,hunter,beastmastery,30,13,17
7652,Xüscha,ysera,1226,hunter,beastmastery,36,13,23
7653,Davíncí,tarren-mill,1224,hunter,beastmastery,77,41,36
7654,Туруханец,gordunni,1224,hunter,beastmastery,66,33,33
7655,Neeske,sylvanas,1224,hunter,beastmastery,30,13,17
7656,Desow,blackrock,1222,hunter,beastmastery,18,13,5
7657,Vexhh,outland,1221,hunter,beastmastery,24,13,11
7658,Stogie,auchindoun,1217,hunter,beastmastery,24,13,11
7659,Belorgrim,kirin-tor,1216,hunter,beastmastery,24,13,11
7660,Snipingdog,stormscale,1209,hunter,beastmastery,36,18,18
7661,Sixty,rajaxx,1207,hunter,beastmastery,24,13,11
7662,Heylie,senjin,1206,hunter,beastmastery,47,16,31
7663,Diac,dalaran,1201,hunter,beastmastery,18,13,5
7664,Slojork,thrall,1190,hunter,beastmastery,92,40,52
7665,Ashjen,aszune,1188,hunter,beastmastery,29,18,11
7666,Eddy,the-maelstrom,1187,hunter,beastmastery,36,20,16
7667,Быщь,gordunni,1186,hunter,beastmastery,29,14,15
7668,Cinan,twisting-nether,1182,hunter,beastmastery,40,21,19
7669,Zúzú,hyjal,1177,hunter,beastmastery,24,13,11
7670,Haleth,uldum,1177,hunter,beastmastery,29,13,16
7671,Jaky,illidan,1176,hunter,beastmastery,89,52,37
7672,Nieki,eitrigg,1175,hunter,beastmastery,56,22,34
7673,Skullstah,ravencrest,1169,hunter,beastmastery,24,13,11
7674,Harpin,azuremyst,1166,hunter,beastmastery,30,14,16
7675,Балласкиндер,gordunni,1164,hunter,beastmastery,60,31,29
7676,Olamay,blackmoore,1159,hunter,beastmastery,36,19,17
7677,Oròme,pozzo-delleternità,1157,hunter,beastmastery,54,28,26
7678,Rafizox,kazzak,1152,hunter,beastmastery,18,12,6
7679,Ataxyz,draenor,1152,hunter,beastmastery,24,12,12
7680,Cor,ravencrest,1151,hunter,beastmastery,24,12,12
7681,Brawnshunt,stormscale,1151,hunter,beastmastery,24,12,12
7682,Diktatos,kazzak,1151,hunter,beastmastery,24,12,12
7683,Sentriks,tarren-mill,1151,hunter,beastmastery,24,12,12
7684,Dohter,kazzak,1151,hunter,beastmastery,25,12,13
7685,Bebar,kazzak,1150,hunter,beastmastery,18,12,6
7686,Digimørtal,kazzak,1150,hunter,beastmastery,18,12,6
7687,Raythe,argent-dawn,1150,hunter,beastmastery,24,12,12
7688,Galileo,sanguino,1150,hunter,beastmastery,26,12,14
7689,Misstrap,nemesis,1150,hunter,beastmastery,30,12,18
7690,Амореселф,gordunni,1150,hunter,beastmastery,30,12,18
7691,Mâjôô,blackhand,1149,hunter,beastmastery,22,13,9
7692,Ingvi,antonidas,1149,hunter,beastmastery,30,12,18
7693,Freebïrd,shattered-hand,1147,hunter,beastmastery,18,12,6
7694,Zubro,kazzak,1146,hunter,beastmastery,30,12,18
7695,Ловихимеру,soulflayer,1145,hunter,beastmastery,18,12,6
7696,Лсныйпамп,howling-fjord,1145,hunter,beastmastery,24,12,12
7697,Fiftyóne,festung-der-stürme,1144,hunter,beastmastery,30,12,18
7698,Artemisas,draenor,1144,hunter,beastmastery,36,12,24
7699,Tempestes,tarren-mill,1143,hunter,beastmastery,39,20,19
7700,Chagaure,hyjal,1141,hunter,beastmastery,24,12,12
7701,Dramin,defias-brotherhood,1140,hunter,beastmastery,119,57,62
7702,Abovival,ragnaros,1134,hunter,beastmastery,24,12,12
7703,Grrizzly,kazzak,1132,hunter,beastmastery,24,12,12
7704,Lusifa,antonidas,1131,hunter,beastmastery,26,14,12
7705,Джантига,howling-fjord,1128,hunter,beastmastery,24,12,12
7706,Basìcs,nemesis,1119,hunter,beastmastery,24,12,12
7707,Schnezzler,nerathor,1116,hunter,beastmastery,74,38,36
7708,Karstarkk,sanguino,1115,hunter,beastmastery,41,17,24
7709,Tsoutsoukoss,silvermoon,1114,hunter,beastmastery,55,26,29
7710,Juha,the-maelstrom,1111,hunter,beastmastery,26,13,13
7711,Куфачка,soulflayer,1103,hunter,beastmastery,17,12,5
7712,Savori,kazzak,1096,hunter,beastmastery,31,18,13
7713,Goonii,bronzebeard,1094,hunter,beastmastery,24,12,12
7714,Pigoen,sporeggar,1092,hunter,beastmastery,36,13,23
7715,Cruelsummer,kul-tiras,1091,hunter,beastmastery,30,12,18
7716,Ertestuing,tarren-mill,1090,hunter,beastmastery,30,14,16
7717,Ezelina,lightnings-blade,1089,hunter,beastmastery,36,18,18
7718,Luckyhunty,dalaran,1086,hunter,beastmastery,36,15,21
7719,Brometheus,sylvanas,1083,hunter,beastmastery,41,15,26
7720,Ládysháyà,blackrock,1074,hunter,beastmastery,24,13,11
7721,Spiritshot,baelgun,1066,hunter,beastmastery,34,14,20
7722,Deblaze,aegwynn,1056,hunter,beastmastery,18,11,7
7723,Хастла,greymane,1055,hunter,beastmastery,18,11,7
7724,Smhx,stormscale,1055,hunter,beastmastery,18,11,7
7725,Fåded,ravencrest,1054,hunter,beastmastery,25,12,13
7726,Daveq,drakthul,1054,hunter,beastmastery,24,11,13
7727,Фетсол,soulflayer,1053,hunter,beastmastery,12,11,1
7728,Оути,azuregos,1053,hunter,beastmastery,18,11,7
7729,Pilogbueferd,silvermoon,1050,hunter,beastmastery,18,11,7
7730,Askaway,sylvanas,1049,hunter,beastmastery,18,11,7
7731,Коблазнх,howling-fjord,1048,hunter,beastmastery,24,11,13
7732,Amitar,tarren-mill,1044,hunter,beastmastery,18,11,7
7733,Venkox,archimonde,1039,hunter,beastmastery,55,28,27
7734,Yukina,frostmourne,1038,hunter,beastmastery,28,13,15
7735,Pumukle,madmortem,1035,hunter,beastmastery,34,15,19
7736,Айлиси,soulflayer,1031,hunter,beastmastery,43,11,32
7737,Румлис,gordunni,1029,hunter,beastmastery,29,14,15
7738,Mykris,aegwynn,1024,hunter,beastmastery,35,13,22
7739,Smegmagol,baelgun,1021,hunter,beastmastery,23,11,12
7740,Dioxis,silvermoon,1021,hunter,beastmastery,60,27,33
7741,Ветиринарша,gordunni,1020,hunter,beastmastery,30,11,19
7742,Grollar,ragnaros,1014,hunter,beastmastery,80,42,38
7743,Altimor,blackmoore,1007,hunter,beastmastery,23,11,12
7744,Nerfjuice,silvermoon,1006,hunter,beastmastery,27,13,14
7745,Винченцо,blackscar,1003,hunter,beastmastery,21,11,10
7746,Shpider,burning-blade,1000,hunter,beastmastery,52,22,30
7747,Sinux,lordaeron,995,hunter,beastmastery,17,11,6
7748,Feigur,sanguino,993,hunter,beastmastery,42,21,21
7749,Loyalman,blackmoore,985,hunter,beastmastery,16,11,5
7750,Arrechus,khaz-modan,982,hunter,beastmastery,48,18,30
7751,Missmytrap,archimonde,960,hunter,beastmastery,12,10,2
7752,Kásúxøxø,ravencrest,960,hunter,beastmastery,16,11,5
7753,Dìgítal,twisting-nether,960,hunter,beastmastery,18,10,8
7754,Akhtabot,twisting-nether,960,hunter,beastmastery,18,10,8
7755,Brokenpetman,defias-brotherhood,960,hunter,beastmastery,18,10,8
7756,Lajnus,frostmane,960,hunter,beastmastery,18,10,8
7757,Zeanort,nordrassil,960,hunter,beastmastery,24,10,14
7758,Jägarn,stormscale,960,hunter,beastmastery,24,10,14
7759,Dafhel,hyjal,960,hunter,beastmastery,24,10,14
7760,Nolove,burning-legion,959,hunter,beastmastery,18,10,8
7761,Lëgølåslõrdx,blackrock,959,hunter,beastmastery,18,10,8
7762,Ahlgood,stormscale,959,hunter,beastmastery,18,10,8
7763,Spidak,stormscale,959,hunter,beastmastery,18,10,8
7764,Thinkerer,silvermoon,959,hunter,beastmastery,18,10,8
7765,Gorgorm,ravencrest,959,hunter,beastmastery,18,10,8
7766,Spider,zuljin,959,hunter,beastmastery,18,10,8
7767,Gedzer,silvermoon,959,hunter,beastmastery,22,11,11
7768,Djøgi,archimonde,959,hunter,beastmastery,24,10,14
7769,Grabbin,silvermoon,959,hunter,beastmastery,24,10,14
7770,Sylariel,die-aldor,958,hunter,beastmastery,18,10,8
7771,Dragosvis,arathor,958,hunter,beastmastery,18,10,8
7772,Corrupth,outland,958,hunter,beastmastery,18,10,8
7773,Зуланария,howling-fjord,958,hunter,beastmastery,18,10,8
7774,Shieryu,archimonde,958,hunter,beastmastery,24,10,14
7775,Choukzt,archimonde,957,hunter,beastmastery,18,10,8
7776,Arnatti,tyrande,957,hunter,beastmastery,18,10,8
7777,Ххун,gordunni,957,hunter,beastmastery,18,10,8
7778,Толяарканшот,razuvious,956,hunter,beastmastery,18,10,8
7779,Herpray,blackmoore,953,hunter,beastmastery,18,10,8
7780,Magarosh,eredar,953,hunter,beastmastery,24,10,14
7781,Ecalter,dun-modr,951,hunter,beastmastery,18,10,8
7782,Darkdexou,defias-brotherhood,951,hunter,beastmastery,18,10,8
7783,Lioness,ahnqiraj,951,hunter,beastmastery,24,10,14
7784,Nidromel,stormscale,951,hunter,beastmastery,78,31,47
7785,Zappikhunter,silvermoon,950,hunter,beastmastery,24,10,14
7786,Nerdhark,hyjal,950,hunter,beastmastery,27,11,16
7787,Cêleste,kaelthas,947,hunter,beastmastery,22,11,11
7788,Lemeric,blackmoore,942,hunter,beastmastery,19,10,9
7789,Безос,soulflayer,942,hunter,beastmastery,24,10,14
7790,Deadlysnîpe,antonidas,941,hunter,beastmastery,16,11,5
7791,Kure,blackrock,929,hunter,beastmastery,40,15,25
7792,Enanorabioso,minahonda,927,hunter,beastmastery,24,10,14
7793,Paînfull,kazzak,926,hunter,beastmastery,23,10,13
7794,Goliathoz,blackmoore,917,hunter,beastmastery,35,19,16
7795,Stjordal,chamber-of-aspects,917,hunter,beastmastery,63,30,33
7796,Happyrme,thrall,916,hunter,beastmastery,24,12,12
7797,Kronzucker,eredar,914,hunter,beastmastery,36,16,20
7798,Mehtäsika,xavius,904,hunter,beastmastery,21,10,11
7799,Kënshiro,kazzak,893,hunter,beastmastery,20,10,10
7800,Hispanøxd,sanguino,864,hunter,beastmastery,12,9,3
7801,Lilpancake,kazzak,864,hunter,beastmastery,12,9,3
7802,Eenel,twisting-nether,864,hunter,beastmastery,12,9,3
7803,Ilovekatsu,archimonde,864,hunter,beastmastery,12,9,3
7804,Kapowz,kazzak,864,hunter,beastmastery,12,9,3
7805,Иоссифсталин,soulflayer,864,hunter,beastmastery,18,9,9
7806,Scrubbi,destromath,864,hunter,beastmastery,18,9,9
7807,Leza,kult-der-verdammten,864,hunter,beastmastery,18,9,9
7808,Negz,eredar,864,hunter,beastmastery,18,9,9
7809,Painaldeepz,stormscale,864,hunter,beastmastery,18,9,9
7810,Pussirotta,stormreaver,864,hunter,beastmastery,24,9,15
7811,Downey,azshara,864,hunter,beastmastery,24,9,15
7812,Denkstah,tarren-mill,864,hunter,beastmastery,24,9,15
7813,Lysanhunt,zuljin,864,hunter,beastmastery,24,9,15
7814,Nillaxy,blackmoore,863,hunter,beastmastery,18,9,9
7815,Porch,dragonmaw,863,hunter,beastmastery,18,9,9
7816,Fléxyz,sylvanas,863,hunter,beastmastery,18,9,9
7817,Darllene,kazzak,863,hunter,beastmastery,24,9,15
7818,Massimox,draenor,862,hunter,beastmastery,12,9,3
7819,Lokiis,hyjal,862,hunter,beastmastery,12,9,3
7820,Синглшот,blackscar,862,hunter,beastmastery,18,9,9
7821,Mordhunterx,draenor,861,hunter,beastmastery,18,9,9
7822,Shaznak,argent-dawn,858,hunter,beastmastery,18,9,9
7823,Darilli,wildhammer,858,hunter,beastmastery,19,9,10
7824,Бруксиан,fordragon,857,hunter,beastmastery,19,9,10
7825,Ulyash,ysondre,854,hunter,beastmastery,18,9,9
7826,Arakton,drakthul,854,hunter,beastmastery,24,11,13
7827,Greenstar,twisting-nether,846,hunter,beastmastery,27,10,17
7828,Grokis,blackhand,834,hunter,beastmastery,55,25,30
7829,Гримнар,borean-tundra,831,hunter,beastmastery,17,9,8
7830,Enty,blackrock,830,hunter,beastmastery,14,10,4
7831,Deathmarks,blackrock,830,hunter,beastmastery,29,9,20
7832,Lissudarlin,stormreaver,829,hunter,beastmastery,48,22,26
7833,Võnbødefeld,frostmourne,827,hunter,beastmastery,17,9,8
7834,Пушкабомби,soulflayer,823,hunter,beastmastery,46,19,27
7835,Anoroxx,arthas,815,hunter,beastmastery,17,9,8
7836,Шаурмэ,gordunni,815,hunter,beastmastery,21,9,12
7837,Vystrelil,drakthul,806,hunter,beastmastery,36,15,21
7838,Colth,hyjal,799,hunter,beastmastery,29,9,20
7839,Slaghunter,argent-dawn,798,hunter,beastmastery,17,9,8
7840,Teacee,twisting-nether,773,hunter,beastmastery,20,9,11
7841,Ebobuss,tarren-mill,768,hunter,beastmastery,12,8,4
7842,Sníper,aggra-português,768,hunter,beastmastery,12,8,4
7843,Mettämies,twisting-nether,768,hunter,beastmastery,12,8,4
7844,Трапча,soulflayer,768,hunter,beastmastery,12,8,4
7845,Suffrebobbs,ravencrest,768,hunter,beastmastery,12,8,4
7846,Irükandji,chants-éternels,768,hunter,beastmastery,12,8,4
7847,Мираклдримз,gordunni,768,hunter,beastmastery,12,8,4
7848,Spergmeister,argent-dawn,768,hunter,beastmastery,12,8,4
7849,Weoneshot,ravencrest,768,hunter,beastmastery,12,8,4
7850,Nivshot,kazzak,768,hunter,beastmastery,12,8,4
7851,Mufdii,sylvanas,768,hunter,beastmastery,18,8,10
7852,Krâýnn,aegwynn,768,hunter,beastmastery,18,8,10
7853,Pewpewstuff,draenor,768,hunter,beastmastery,18,8,10
7854,Hawkeyé,forscherliga,768,hunter,beastmastery,18,8,10
7855,Dispairge,antonidas,768,hunter,beastmastery,18,8,10
7856,Lambo,laughing-skull,768,hunter,beastmastery,18,8,10
7857,Trapgodxx,archimonde,768,hunter,beastmastery,18,8,10
7858,Lobo,kazzak,768,hunter,beastmastery,24,8,16
7859,Fridion,argent-dawn,768,hunter,beastmastery,24,8,16
7860,Mogumogu,blackhand,768,hunter,beastmastery,24,8,16
7861,Nelida,ragnaros,768,hunter,beastmastery,24,8,16
7862,Huntyadaun,blackrock,767,hunter,beastmastery,12,8,4
7863,Oliene,twisting-nether,767,hunter,beastmastery,12,8,4
7864,Devøurer,blackmoore,767,hunter,beastmastery,12,8,4
7865,Хлопс,howling-fjord,767,hunter,beastmastery,12,8,4
7866,Awoe,blackrock,767,hunter,beastmastery,12,8,4
7867,Kuljaa,ravencrest,767,hunter,beastmastery,12,8,4
7868,Drigs,blackrock,767,hunter,beastmastery,18,8,10
7869,Strélka,blackrock,767,hunter,beastmastery,18,8,10
7870,Солевойй,gordunni,767,hunter,beastmastery,18,8,10
7871,Platzpatron,eredar,767,hunter,beastmastery,18,8,10
7872,Gbureczka,burning-legion,767,hunter,beastmastery,18,8,10
7873,Earnzie,outland,767,hunter,beastmastery,18,8,10
7874,Vassiliadis,bronze-dragonflight,767,hunter,beastmastery,24,8,16
7875,Prodanhunts,frostmane,767,hunter,beastmastery,24,8,16
7876,Wolfster,kazzak,767,hunter,beastmastery,24,8,16
7877,Шурикцаревич,galakrond,767,hunter,beastmastery,24,8,16
7878,Амобарбиталх,gordunni,766,hunter,beastmastery,12,8,4
7879,Miracleh,tarren-mill,766,hunter,beastmastery,18,8,10
7880,Rickh,ravencrest,765,hunter,beastmastery,12,8,4
7881,Benbutton,antonidas,764,hunter,beastmastery,18,8,10
7882,Фаталлити,grom,763,hunter,beastmastery,12,8,4
7883,Blastarrow,the-maelstrom,763,hunter,beastmastery,30,8,22
7884,Анютикус,gordunni,761,hunter,beastmastery,12,8,4
7885,Plong,argent-dawn,761,hunter,beastmastery,12,8,4
7886,Vachekiki,archimonde,759,hunter,beastmastery,12,8,4
7887,Floppybobby,burning-blade,759,hunter,beastmastery,18,8,10
7888,Soulshoot,khaz-modan,755,hunter,beastmastery,18,8,10
7889,Sushimän,kaelthas,751,hunter,beastmastery,12,8,4
7890,Ремонтлицаа,gordunni,735,hunter,beastmastery,17,8,9
7891,Marlaska,exodar,732,hunter,beastmastery,18,8,10
7892,Nixxay,antonidas,722,hunter,beastmastery,18,8,10
7893,Catmother,grim-batol,717,hunter,beastmastery,14,9,5
7894,Бей,gordunni,703,hunter,beastmastery,14,8,6
7895,Sélenaé,hyjal,703,hunter,beastmastery,16,8,8
7896,Feyoonx,blackrock,703,hunter,beastmastery,23,9,14
7897,Ønur,twisting-nether,703,hunter,beastmastery,25,9,16
7898,Huntbeard,aegwynn,695,hunter,beastmastery,22,8,14
7899,Karuso,ravencrest,672,hunter,beastmastery,12,7,5
7900,Ulfrîc,exodar,672,hunter,beastmastery,12,7,5
7901,Bigramy,sanguino,672,hunter,beastmastery,12,7,5
7902,Ufecläimbe,eredar,672,hunter,beastmastery,12,7,5
7903,Potatobeast,twisting-nether,672,hunter,beastmastery,12,7,5
7904,Beorind,frostwolf,672,hunter,beastmastery,12,7,5
7905,Khatia,blackrock,672,hunter,beastmastery,12,7,5
7906,Stamzer,drakthul,672,hunter,beastmastery,12,7,5
7907,Ledrox,ravencrest,672,hunter,beastmastery,12,7,5
7908,Marcsman,blackrock,672,hunter,beastmastery,12,7,5
7909,Utoast,ravencrest,672,hunter,beastmastery,12,7,5
7910,Эвилтар,soulflayer,672,hunter,beastmastery,12,7,5
7911,Dåo,doomhammer,672,hunter,beastmastery,12,7,5
7912,Riflur,stormscale,672,hunter,beastmastery,12,7,5
7913,Милфхантерхе,blackscar,672,hunter,beastmastery,12,7,5
7914,Fôx,frostmane,672,hunter,beastmastery,12,7,5
7915,Ahotnik,aegwynn,672,hunter,beastmastery,12,7,5
7916,Knokkelmann,outland,672,hunter,beastmastery,12,7,5
7917,Gitanìlla,dun-modr,672,hunter,beastmastery,18,7,11
7918,Дьярэ,gordunni,672,hunter,beastmastery,18,7,11
7919,Valhnir,sanguino,672,hunter,beastmastery,18,7,11
7920,Баянист,soulflayer,672,hunter,beastmastery,18,7,11
7921,Boybiron,silvermoon,672,hunter,beastmastery,18,7,11
7922,Düivell,grim-batol,672,hunter,beastmastery,18,7,11
7923,Hunterstein,archimonde,672,hunter,beastmastery,18,7,11
7924,Svolatch,blackrock,672,hunter,beastmastery,18,7,11
7925,Chúx,twisting-nether,672,hunter,beastmastery,24,7,17
7926,Lis,gorgonnash,672,hunter,beastmastery,24,7,17
7927,Летмимейт,howling-fjord,672,hunter,beastmastery,26,7,19
7928,Waidø,blackhand,671,hunter,beastmastery,12,7,5
7929,Strade,argent-dawn,671,hunter,beastmastery,12,7,5
7930,Ashryqt,ravencrest,671,hunter,beastmastery,12,7,5
7931,Tomli,nemesis,671,hunter,beastmastery,12,7,5
7932,Settisetä,defias-brotherhood,671,hunter,beastmastery,12,7,5
7933,Кежма,howling-fjord,671,hunter,beastmastery,12,7,5
7934,Mazekhin,khaz-modan,671,hunter,beastmastery,12,7,5
7935,Бэталол,gordunni,671,hunter,beastmastery,12,7,5
7936,Jaydogg,lightbringer,671,hunter,beastmastery,12,7,5
7937,Castbuny,drakthul,671,hunter,beastmastery,18,7,11
7938,Câonimâ,twisting-nether,671,hunter,beastmastery,18,7,11
7939,Halgen,medivh,671,hunter,beastmastery,18,7,11
7940,Блудитролль,soulflayer,671,hunter,beastmastery,18,7,11
7941,Mindgap,pozzo-delleternità,671,hunter,beastmastery,18,7,11
7942,Orian,argent-dawn,671,hunter,beastmastery,18,7,11
7943,Kyliun,frostmane,669,hunter,beastmastery,18,7,11
7944,Blainehunts,arathor,669,hunter,beastmastery,18,7,11
7945,Casey,zuluhed,669,hunter,beastmastery,18,7,11
7946,Poatan,outland,667,hunter,beastmastery,18,7,11
7947,Rollei,uldum,666,hunter,beastmastery,12,7,5
7948,Aroldo,kazzak,665,hunter,beastmastery,12,7,5
7949,Саэсантессис,howling-fjord,665,hunter,beastmastery,18,7,11
7950,Bornum,khaz-modan,662,hunter,beastmastery,25,7,18
7951,Llamp,draenor,657,hunter,beastmastery,18,7,11
7952,Сяову,gordunni,643,hunter,beastmastery,30,7,23
7953,Notchan,stormscale,639,hunter,beastmastery,11,7,4
7954,Oife,auchindoun,637,hunter,beastmastery,17,7,10
7955,Adram,burning-legion,623,hunter,beastmastery,11,7,4
7956,Michaelvm,ravencrest,576,hunter,beastmastery,6,6,0
7957,Trapzila,aggra-português,576,hunter,beastmastery,6,6,0
7958,Sithrom,blackmoore,576,hunter,beastmastery,12,6,6
7959,Dorkos,sanguino,576,hunter,beastmastery,12,6,6
7960,Стёпкахант,gordunni,576,hunter,beastmastery,12,6,6
7961,Vu,shattered-hand,576,hunter,beastmastery,12,6,6
7962,Акройя,gordunni,576,hunter,beastmastery,12,6,6
7963,Showdope,drakthul,576,hunter,beastmastery,12,6,6
7964,Toptìérgoðx,drakthul,576,hunter,beastmastery,12,6,6
7965,Razoorine,blackrock,576,hunter,beastmastery,12,6,6
7966,Jackjager,ravencrest,576,hunter,beastmastery,12,6,6
7967,Cítyzens,drakthul,576,hunter,beastmastery,12,6,6
7968,Шмыгахант,gordunni,576,hunter,beastmastery,12,6,6
7969,Зеленыйиисус,gordunni,576,hunter,beastmastery,12,6,6
7970,Magicnanø,nemesis,576,hunter,beastmastery,12,6,6
7971,Iuyiuy,dalaran,576,hunter,beastmastery,12,6,6
7972,Holdmypurse,kazzak,576,hunter,beastmastery,12,6,6
7973,Burbutsuluki,silvermoon,576,hunter,beastmastery,12,6,6
7974,Raegal,sanguino,576,hunter,beastmastery,12,6,6
7975,Fogknows,ravencrest,576,hunter,beastmastery,12,6,6
7976,Petitsui,zuljin,576,hunter,beastmastery,12,6,6
7977,Ausgefuchst,forscherliga,576,hunter,beastmastery,12,6,6
7978,Paraskámu,twisting-nether,576,hunter,beastmastery,12,6,6
7979,Homesz,blackmoore,576,hunter,beastmastery,12,6,6
7980,Logales,dragonblight,576,hunter,beastmastery,12,6,6
7981,Rifle,dun-morogh,576,hunter,beastmastery,12,6,6
7982,Sallya,kazzak,576,hunter,beastmastery,12,6,6
7983,Avatarofwoe,blackmoore,576,hunter,beastmastery,12,6,6
7984,Nagu,antonidas,576,hunter,beastmastery,12,6,6
7985,Zoomiesuwu,antonidas,576,hunter,beastmastery,12,6,6
7986,Chïefhunt,twisting-nether,576,hunter,beastmastery,12,6,6
7987,Ishotharambe,doomhammer,576,hunter,beastmastery,12,6,6
7988,Dtq,silvermoon,576,hunter,beastmastery,12,6,6
7989,Krakenaspect,kazzak,576,hunter,beastmastery,12,6,6
7990,Беспокойный,soulflayer,576,hunter,beastmastery,12,6,6
7991,Therakal,culte-de-la-rive-noire,576,hunter,beastmastery,12,6,6
7992,Bigdog,eredar,576,hunter,beastmastery,12,6,6
7993,Wodlenprince,draenor,576,hunter,beastmastery,12,6,6
7994,Rdwlf,draenor,576,hunter,beastmastery,12,6,6
7995,Xéraphine,mannoroth,576,hunter,beastmastery,12,6,6
7996,Saymqt,blackrock,576,hunter,beastmastery,15,7,8
7997,Azrhu,ravencrest,576,hunter,beastmastery,18,6,12
7998,Wetto,ravencrest,576,hunter,beastmastery,18,6,12
7999,Матанал,gordunni,576,hunter,beastmastery,18,6,12
8000,Такувами,gordunni,576,hunter,beastmastery,18,6,12
8001,Coltan,nemesis,576,hunter,beastmastery,18,6,12
8002,Thogelle,hyjal,576,hunter,beastmastery,18,6,12
8003,Свадебная,gordunni,576,hunter,beastmastery,18,6,12
8004,Realme,blackrock,576,hunter,beastmastery,18,6,12
8005,Колякилшот,gordunni,576,hunter,beastmastery,18,6,12
8006,Kreiden,twisting-nether,576,hunter,beastmastery,18,6,12
8007,Vhalín,magtheridon,576,hunter,beastmastery,18,6,12
8008,Disyö,kazzak,576,hunter,beastmastery,18,6,12
8009,Дзэнмашина,booty-bay,575,hunter,beastmastery,12,6,6
8010,Gløbi,malfurion,575,hunter,beastmastery,12,6,6
8011,Puska,gilneas,575,hunter,beastmastery,12,6,6
8012,Krasavcik,shattrath,575,hunter,beastmastery,12,6,6
8013,Абунай,soulflayer,575,hunter,beastmastery,12,6,6
8014,Dirtydolores,thrall,575,hunter,beastmastery,12,6,6
8015,Ghanik,draenor,575,hunter,beastmastery,12,6,6
8016,Бирмингем,ashenvale,575,hunter,beastmastery,12,6,6
8017,Truedetectiv,aggramar,575,hunter,beastmastery,12,6,6
8018,Täpy,arathor,575,hunter,beastmastery,18,6,12
8019,Zäyk,zuljin,575,hunter,beastmastery,18,6,12
8020,Дипшот,deathguard,575,hunter,beastmastery,18,6,12
8021,Zantorious,ravencrest,574,hunter,beastmastery,12,6,6
8022,Kruk,blackhand,574,hunter,beastmastery,12,6,6
8023,Dravara,blackmoore,574,hunter,beastmastery,12,6,6
8024,Kannon,twisting-nether,574,hunter,beastmastery,18,6,12
8025,Atraxi,aegwynn,574,hunter,beastmastery,18,6,12
8026,Penelopé,darkmoon-faire,573,hunter,beastmastery,12,6,6
8027,Dreemshoot,stormscale,542,hunter,beastmastery,11,6,5
8028,Braatski,stormscale,526,hunter,beastmastery,18,7,11
8029,Mirmona,stormscale,512,hunter,beastmastery,16,6,10
8030,Мунмейстер,blackscar,480,hunter,beastmastery,6,5,1
8031,Wellocérapt,confrérie-du-thorium,480,hunter,beastmastery,6,5,1
8032,Solò,eredar,480,hunter,beastmastery,6,5,1
8033,Подлыйстарик,gordunni,480,hunter,beastmastery,6,5,1
8034,Виралатта,gordunni,480,hunter,beastmastery,6,5,1
8035,Bebiyo,sanguino,480,hunter,beastmastery,6,5,1
8036,Tigerups,burning-legion,480,hunter,beastmastery,6,5,1
8037,Spinella,antonidas,480,hunter,beastmastery,6,5,1
8038,Келен,blackscar,480,hunter,beastmastery,6,5,1
8039,Glizzygobblr,kazzak,480,hunter,beastmastery,6,5,1
8040,Connyrövöga,draenor,480,hunter,beastmastery,6,5,1
8041,Jinxbomber,draenor,480,hunter,beastmastery,6,5,1
8042,Hidethegun,draenor,480,hunter,beastmastery,6,5,1
8043,Dogliz,stormscale,480,hunter,beastmastery,6,5,1
8044,Survabuse,silvermoon,480,hunter,beastmastery,9,6,3
8045,Jawox,antonidas,480,hunter,beastmastery,12,5,7
8046,Silvos,blackrock,480,hunter,beastmastery,12,5,7
8047,Китас,soulflayer,480,hunter,beastmastery,12,5,7
8048,Рафлекс,eversong,480,hunter,beastmastery,12,5,7
8049,Bubbahubba,ragnaros,480,hunter,beastmastery,12,5,7
8050,Kerólus,blackhand,480,hunter,beastmastery,12,5,7
8051,Arrowman,burning-legion,480,hunter,beastmastery,12,5,7
8052,Halessia,ravencrest,480,hunter,beastmastery,12,5,7
8053,Zanpa,archimonde,480,hunter,beastmastery,12,5,7
8054,Waneìs,stormscale,480,hunter,beastmastery,12,5,7
8055,Hanuong,ragnaros,480,hunter,beastmastery,12,5,7
8056,Géeked,ravencrest,480,hunter,beastmastery,12,5,7
8057,Tizzlbang,ragnaros,480,hunter,beastmastery,12,5,7
8058,Naposin,ragnaros,480,hunter,beastmastery,12,5,7
8059,Lolez,dun-modr,480,hunter,beastmastery,12,5,7
8060,Келкузд,howling-fjord,480,hunter,beastmastery,12,5,7
8061,Pilpetra,tarren-mill,480,hunter,beastmastery,12,5,7
8062,Vimd,archimonde,480,hunter,beastmastery,12,5,7
8063,Dràcula,tarren-mill,480,hunter,beastmastery,12,5,7
8064,Квит,blackscar,480,hunter,beastmastery,12,5,7
8065,Dyve,antonidas,480,hunter,beastmastery,12,5,7
8066,Джеймсфранко,blackscar,480,hunter,beastmastery,12,5,7
8067,Jins,illidan,480,hunter,beastmastery,12,5,7
8068,Khort,twisting-nether,480,hunter,beastmastery,12,5,7
8069,Vargar,arygos,480,hunter,beastmastery,12,5,7
8070,Ромкола,gordunni,480,hunter,beastmastery,12,5,7
8071,Зимняясказка,soulflayer,480,hunter,beastmastery,12,5,7
8072,Valkrys,die-aldor,480,hunter,beastmastery,12,5,7
8073,Tiendat,kazzak,480,hunter,beastmastery,12,5,7
8074,Yamadorî,blackrock,480,hunter,beastmastery,12,5,7
8075,Rushgarroth,ravencrest,480,hunter,beastmastery,12,5,7
8076,Elvenian,twisting-nether,480,hunter,beastmastery,12,5,7
8077,Bubby,burning-legion,480,hunter,beastmastery,16,6,10
8078,Latschodives,malorne,480,hunter,beastmastery,15,5,10
8079,Bluefluclue,draenor,480,hunter,beastmastery,16,5,11
8080,Setyouintrap,ravencrest,480,hunter,beastmastery,18,5,13
8081,Chrishyh,blackrock,480,hunter,beastmastery,18,5,13
8082,Ivanrockstar,draenor,479,hunter,beastmastery,12,5,7
8083,Laerya,les-clairvoyants,479,hunter,beastmastery,12,5,7
8084,Arhyah,medivh,479,hunter,beastmastery,12,5,7
8085,Killzo,sylvanas,479,hunter,beastmastery,12,5,7
8086,Boompuf,draenor,479,hunter,beastmastery,12,5,7
8087,Sàclak,ysondre,479,hunter,beastmastery,12,5,7
8088,Droubidi,garona,479,hunter,beastmastery,12,5,7
8089,Nelerias,defias-brotherhood,479,hunter,beastmastery,18,5,13
8090,Bouboule,elune,477,hunter,beastmastery,6,5,1
8091,Бодрыйсэм,soulflayer,477,hunter,beastmastery,12,5,7
8092,Xyrone,bladefist,476,hunter,beastmastery,12,5,7
8093,Momohenní,archimonde,448,hunter,beastmastery,10,5,5
8094,Bellecoq,arathi,447,hunter,beastmastery,11,5,6
8095,Allcollapse,outland,432,hunter,beastmastery,9,6,3
8096,Såvëâmäzøñíà,stormscale,431,hunter,beastmastery,11,5,6
8097,Remiss,sanguino,425,hunter,beastmastery,14,6,8
8098,Topbow,talnivarr,415,hunter,beastmastery,10,5,5
8099,Fizè,blackmoore,415,hunter,beastmastery,11,5,6
8100,Darkshe,dun-modr,415,hunter,beastmastery,14,5,9
8101,Нью,soulflayer,384,hunter,beastmastery,6,4,2
8102,Kondy,twisting-nether,384,hunter,beastmastery,6,4,2
8103,Патапум,deathguard,384,hunter,beastmastery,6,4,2
8104,Thursty,twisting-nether,384,hunter,beastmastery,6,4,2
8105,Pufyrella,kilrogg,384,hunter,beastmastery,6,4,2
8106,Machinedream,sylvanas,384,hunter,beastmastery,6,4,2
8107,Illaice,antonidas,384,hunter,beastmastery,6,4,2
8108,Straikkeri,draenor,384,hunter,beastmastery,6,4,2
8109,Khregan,aerie-peak,384,hunter,beastmastery,6,4,2
8110,Bøwjøb,arthas,384,hunter,beastmastery,6,4,2
8111,Djurmästaren,ravencrest,384,hunter,beastmastery,6,4,2
8112,Bøøya,aegwynn,384,hunter,beastmastery,6,4,2
8113,Вуйчеч,howling-fjord,384,hunter,beastmastery,6,4,2
8114,Robbingyou,tarren-mill,384,hunter,beastmastery,6,4,2
8115,Йокуя,blackscar,384,hunter,beastmastery,6,4,2
8116,Kareltje,stormscale,384,hunter,beastmastery,6,4,2
8117,Nomorepain,outland,384,hunter,beastmastery,6,4,2
8118,Lultrap,nemesis,384,hunter,beastmastery,6,4,2
8119,Nocturr,ragnaros,384,hunter,beastmastery,6,4,2
8120,Sejkxi,malganis,384,hunter,beastmastery,6,4,2
8121,Alexdi,kazzak,384,hunter,beastmastery,6,4,2
8122,Dregor,nemesis,384,hunter,beastmastery,6,4,2
8123,Nulldmgmaker,malganis,384,hunter,beastmastery,6,4,2
8124,Fatmum,magtheridon,384,hunter,beastmastery,6,4,2
8125,Pareia,blackrock,384,hunter,beastmastery,6,4,2
8126,Jaxxoo,outland,384,hunter,beastmastery,6,4,2
8127,Hask,pozzo-delleternità,384,hunter,beastmastery,6,4,2
8128,Mestar,outland,384,hunter,beastmastery,6,4,2
8129,Srvol,dun-modr,384,hunter,beastmastery,6,4,2
8130,Jaxteller,archimonde,384,hunter,beastmastery,6,4,2
8131,Xiviora,archimonde,384,hunter,beastmastery,6,4,2
8132,Zpy,blackmoore,384,hunter,beastmastery,6,4,2
8133,Трэйсх,howling-fjord,384,hunter,beastmastery,6,4,2
8134,Chindaliña,zuljin,384,hunter,beastmastery,6,4,2
8135,Zanéy,ravencrest,384,hunter,beastmastery,6,4,2
8136,Drukan,hyjal,384,hunter,beastmastery,6,4,2
8137,Fendros,kazzak,384,hunter,beastmastery,6,4,2
8138,Разплюханка,howling-fjord,384,hunter,beastmastery,6,4,2
8139,Nith,ungoro,384,hunter,beastmastery,6,4,2
8140,Кайсго,gordunni,384,hunter,beastmastery,6,4,2
8141,Xndr,sanguino,384,hunter,beastmastery,6,4,2
8142,Azzazeal,drakthul,384,hunter,beastmastery,6,4,2
8143,Rïm,haomarush,384,hunter,beastmastery,6,4,2
8144,Shinkichi,archimonde,384,hunter,beastmastery,6,4,2
8145,Flytomars,ravencrest,384,hunter,beastmastery,6,4,2
8146,Garratha,burning-legion,384,hunter,beastmastery,6,4,2
8147,Healscare,dalaran,384,hunter,beastmastery,10,5,5
8148,Талигар,razuvious,384,hunter,beastmastery,12,4,8
8149,Вейзу,ashenvale,384,hunter,beastmastery,12,4,8
8150,Aléxy,sanguino,384,hunter,beastmastery,12,4,8
8151,Дэлмор,greymane,384,hunter,beastmastery,12,4,8
8152,Dissectiøn,hyjal,384,hunter,beastmastery,12,4,8
8153,Siegbald,ragnaros,384,hunter,beastmastery,12,4,8
8154,Horxxa,kul-tiras,384,hunter,beastmastery,12,4,8
8155,Zippyzen,twisting-nether,384,hunter,beastmastery,12,4,8
8156,Sjufemman,ravencrest,384,hunter,beastmastery,12,4,8
8157,Berkobaggins,twisting-nether,384,hunter,beastmastery,12,4,8
8158,Sharpeneye,ragnaros,384,hunter,beastmastery,12,4,8
8159,Nßatrapper,outland,384,hunter,beastmastery,12,4,8
8160,Øï,outland,384,hunter,beastmastery,12,4,8
8161,Monnee,outland,384,hunter,beastmastery,12,4,8
8162,Pergola,spinebreaker,384,hunter,beastmastery,12,4,8
8163,Nîco,nathrezim,384,hunter,beastmastery,12,4,8
8164,Catman,stormreaver,384,hunter,beastmastery,12,4,8
8165,Valomeere,tarren-mill,384,hunter,beastmastery,12,4,8
8166,Nesthor,sinstralis,384,hunter,beastmastery,12,4,8
8167,Neocb,ravencrest,384,hunter,beastmastery,12,4,8
8168,Tøixøna,tyrande,384,hunter,beastmastery,12,4,8
8169,Hollyz,auchindoun,384,hunter,beastmastery,12,4,8
8170,Frencharena,the-venture-co,384,hunter,beastmastery,12,4,8
8171,Thérón,ravencrest,384,hunter,beastmastery,12,4,8
8172,Лузановка,gordunni,384,hunter,beastmastery,12,4,8
8173,Amigoss,argent-dawn,384,hunter,beastmastery,12,4,8
8174,Córelly,outland,384,hunter,beastmastery,12,4,8
8175,Saiko,kazzak,384,hunter,beastmastery,12,4,8
8176,Amdonesia,ravencrest,384,hunter,beastmastery,18,4,14
8177,Tervueren,burning-blade,384,hunter,beastmastery,18,4,14
8178,Bláckheart,doomhammer,384,hunter,beastmastery,18,4,14
8179,Bemtistaru,draenor,384,hunter,beastmastery,18,4,14
8180,Xscaper,twilights-hammer,383,hunter,beastmastery,6,4,2
8181,Delazi,proudmoore,383,hunter,beastmastery,12,4,8
8182,Towu,archimonde,382,hunter,beastmastery,12,4,8
8183,Neuwi,stormreaver,382,hunter,beastmastery,12,4,8
8184,Beerox,ysondre,382,hunter,beastmastery,12,4,8
8185,Spycke,dalaran,333,hunter,beastmastery,9,5,4
8186,Skyh,outland,330,hunter,beastmastery,16,5,11
8187,Taurïel,stormscale,288,hunter,beastmastery,6,3,3
8188,Kragán,silvermoon,288,hunter,beastmastery,6,3,3
8189,Raindra,twisting-nether,288,hunter,beastmastery,6,3,3
8190,Bòw,antonidas,288,hunter,beastmastery,6,3,3
8191,Колтрэйнборз,blackscar,288,hunter,beastmastery,6,3,3
8192,Nosfuratu,stormscale,288,hunter,beastmastery,6,3,3
8193,Mètrolog,twisting-nether,288,hunter,beastmastery,6,3,3
8194,Cryptomars,twisting-nether,288,hunter,beastmastery,6,3,3
8195,Valtondre,argent-dawn,288,hunter,beastmastery,6,3,3
8196,Оркос,deathweaver,288,hunter,beastmastery,6,3,3
8197,Vescar,argent-dawn,288,hunter,beastmastery,6,3,3
8198,Будкусломаю,grom,288,hunter,beastmastery,6,3,3
8199,Shedzargo,twisting-nether,288,hunter,beastmastery,6,3,3
8200,Hunterlolz,tarren-mill,288,hunter,beastmastery,6,3,3
8201,Кискавтесте,gordunni,288,hunter,beastmastery,6,3,3
8202,Lunaunii,argent-dawn,288,hunter,beastmastery,6,3,3
8203,Imonér,frostmane,288,hunter,beastmastery,6,3,3
8204,Mobshot,twisting-nether,288,hunter,beastmastery,6,3,3
8205,Скукота,grom,288,hunter,beastmastery,6,3,3
8206,Lioneli,sylvanas,288,hunter,beastmastery,6,3,3
8207,Hattorisama,ghostlands,288,hunter,beastmastery,6,3,3
8208,Hallem,karazhan,288,hunter,beastmastery,6,3,3
8209,Ekz,twisting-nether,288,hunter,beastmastery,6,3,3
8210,Axran,ravencrest,288,hunter,beastmastery,6,3,3
8211,Beefchops,draenor,288,hunter,beastmastery,6,3,3
8212,Живучийорех,gordunni,288,hunter,beastmastery,6,3,3
8213,Sakaryali,silvermoon,288,hunter,beastmastery,6,3,3
8214,Kronkh,nemesis,288,hunter,beastmastery,6,3,3
8215,Abonah,khaz-modan,288,hunter,beastmastery,6,3,3
8216,Загзигзаг,soulflayer,288,hunter,beastmastery,6,3,3
8217,Oldrocker,sylvanas,288,hunter,beastmastery,6,3,3
8218,Appollo,magtheridon,288,hunter,beastmastery,6,3,3
8219,Thebigboom,outland,288,hunter,beastmastery,6,3,3
8220,Retroxia,stormreaver,288,hunter,beastmastery,6,3,3
8221,Sillychilly,frostwolf,288,hunter,beastmastery,6,3,3
8222,Tsivoula,twisting-nether,288,hunter,beastmastery,6,3,3
8223,Scräppÿ,kazzak,288,hunter,beastmastery,6,3,3
8224,Nukenfoobs,draenor,288,hunter,beastmastery,6,3,3
8225,Traenuss,azuremyst,288,hunter,beastmastery,6,3,3
8226,Anhur,blackmoore,288,hunter,beastmastery,6,3,3
8227,Yümekø,khaz-modan,288,hunter,beastmastery,6,3,3
8228,Blmlooter,stormreaver,288,hunter,beastmastery,6,3,3
8229,Artze,outland,288,hunter,beastmastery,6,3,3
8230,Джэромо,gordunni,288,hunter,beastmastery,6,3,3
8231,Iliíilíiílíl,outland,288,hunter,beastmastery,6,3,3
8232,Chasseeur,archimonde,288,hunter,beastmastery,6,3,3
8233,Zoophobiaqt,silvermoon,288,hunter,beastmastery,6,3,3
8234,Klèo,frostwhisper,288,hunter,beastmastery,6,3,3
8235,Kxx,kazzak,288,hunter,beastmastery,6,3,3
8236,Tedohunter,ragnaros,288,hunter,beastmastery,6,3,3
8237,Kukenisluken,stormscale,288,hunter,beastmastery,6,3,3
8238,Zinco,ravencrest,288,hunter,beastmastery,6,3,3
8239,Ipad,cthun,288,hunter,beastmastery,6,3,3
8240,Blazeblue,hyjal,288,hunter,beastmastery,6,3,3
8241,Доррети,howling-fjord,288,hunter,beastmastery,6,3,3
8242,Оксанчек,howling-fjord,288,hunter,beastmastery,6,3,3
8243,Earlygrey,ravencrest,288,hunter,beastmastery,6,3,3
8244,Pewpewshotz,stormscale,288,hunter,beastmastery,6,3,3
8245,Assbúrgers,silvermoon,288,hunter,beastmastery,6,3,3
8246,Djtrapyasis,blackmoore,288,hunter,beastmastery,6,3,3
8247,Midist,stormscale,288,hunter,beastmastery,6,3,3
8248,Kondirox,twisting-nether,288,hunter,beastmastery,6,3,3
8249,Thekev,ravencrest,288,hunter,beastmastery,6,3,3
8250,Ozunâ,blackmoore,288,hunter,beastmastery,6,3,3
8251,Enthur,sylvanas,288,hunter,beastmastery,6,3,3
8252,Sauce,alonsus,288,hunter,beastmastery,6,3,3
8253,Flugsmälla,kazzak,288,hunter,beastmastery,6,3,3
8254,Niedzwiedzor,silvermoon,288,hunter,beastmastery,6,3,3
8255,Metalbaci,sylvanas,288,hunter,beastmastery,6,3,3
8256,Микихаса,galakrond,288,hunter,beastmastery,6,3,3
8257,Bugspitz,outland,288,hunter,beastmastery,6,3,3
8258,Sebikh,ravencrest,288,hunter,beastmastery,6,3,3
8259,Демела,gordunni,288,hunter,beastmastery,6,3,3
8260,Doubleoseven,frostmane,288,hunter,beastmastery,6,3,3
8261,Fedya,kazzak,288,hunter,beastmastery,6,3,3
8262,Yssup,frostmane,288,hunter,beastmastery,6,3,3
8263,Noréaga,suramar,288,hunter,beastmastery,6,3,3
8264,Mooj,malganis,288,hunter,beastmastery,6,3,3
8265,Beletor,medivh,288,hunter,beastmastery,6,3,3
8266,Bnji,hyjal,288,hunter,beastmastery,6,3,3
8267,Natchell,ysondre,288,hunter,beastmastery,6,3,3
8268,Боураш,gordunni,288,hunter,beastmastery,6,3,3
8269,Razuye,nerathor,288,hunter,beastmastery,6,3,3
8270,Рофшор,gordunni,288,hunter,beastmastery,6,3,3
8271,Katzchen,burning-legion,288,hunter,beastmastery,6,3,3
8272,Visas,burning-legion,288,hunter,beastmastery,6,3,3
8273,Хантероо,gordunni,288,hunter,beastmastery,8,3,5
8274,Nerøz,ravencrest,288,hunter,beastmastery,12,3,9
8275,Demónhunter,frostmane,288,hunter,beastmastery,12,3,9
8276,Jamesbownd,ravencrest,288,hunter,beastmastery,12,3,9
8277,Drakess,daggerspine,288,hunter,beastmastery,12,3,9
8278,Stuckstepbro,silvermoon,288,hunter,beastmastery,12,3,9
8279,Хансбург,howling-fjord,288,hunter,beastmastery,12,3,9
8280,Orgasmatronn,stormscale,288,hunter,beastmastery,12,3,9
8281,Spakster,blackrock,288,hunter,beastmastery,12,3,9
8282,Narziel,die-todeskrallen,288,hunter,beastmastery,12,3,9
8283,Coôkie,ysondre,288,hunter,beastmastery,12,3,9
8284,Riik,ragnaros,288,hunter,beastmastery,12,3,9
8285,Frikandelli,outland,288,hunter,beastmastery,12,3,9
8286,Akù,magtheridon,288,hunter,beastmastery,12,3,9
8287,Karên,blackmoore,288,hunter,beastmastery,12,3,9
8288,Дафирия,deathguard,288,hunter,beastmastery,12,3,9
8289,Xoarqt,aegwynn,288,hunter,beastmastery,12,3,9
8290,Headhunterzz,dun-modr,288,hunter,beastmastery,12,3,9
8291,Craná,blackrock,288,hunter,beastmastery,12,3,9
8292,Mârked,argent-dawn,288,hunter,beastmastery,12,3,9
8293,Cliff,kiljaeden,288,hunter,beastmastery,18,3,15
8294,Voraxh,draenor,287,hunter,beastmastery,12,3,9
8295,Oatmeal,dun-morogh,287,hunter,beastmastery,12,3,9
8296,Asca,eldrethalas,287,hunter,beastmastery,12,3,9
8297,Lightrandom,kazzak,269,hunter,beastmastery,11,3,8
8298,Sarblade,bronze-dragonflight,255,hunter,beastmastery,11,3,8
8299,Shoothim,destromath,254,hunter,beastmastery,8,4,4
8300,Johnblønn,stormscale,240,hunter,beastmastery,9,3,6
8301,Кулерквест,soulflayer,240,hunter,beastmastery,9,3,6
8302,Barzti,thrall,239,hunter,beastmastery,5,3,2
8303,Grufflin,bronzebeard,239,hunter,beastmastery,5,3,2
8304,Bigbababotan,blackrock,234,hunter,beastmastery,9,4,5
8305,Musraah,zuljin,192,hunter,beastmastery,5,3,2
8306,Lännennopein,outland,192,hunter,beastmastery,11,4,7
8307,Zusale,azshara,192,hunter,beastmastery,6,2,4
8308,Nómarak,drakthul,192,hunter,beastmastery,6,2,4
8309,Zulldek,sanguino,192,hunter,beastmastery,6,2,4
8310,Arykes,drakthul,192,hunter,beastmastery,6,2,4
8311,Jarran,karazhan,192,hunter,beastmastery,6,2,4
8312,Doraxa,sanguino,192,hunter,beastmastery,6,2,4
8313,Ridbàck,archimonde,192,hunter,beastmastery,6,2,4
8314,Whatifany,tarren-mill,192,hunter,beastmastery,6,2,4
8315,Hitray,stormscale,192,hunter,beastmastery,6,2,4
8316,Deskö,shendralar,192,hunter,beastmastery,6,2,4
8317,Ренектон,soulflayer,192,hunter,beastmastery,6,2,4
8318,Sarbacanes,hyjal,192,hunter,beastmastery,6,2,4
8319,Crasharrow,stormscale,192,hunter,beastmastery,6,2,4
8320,Травок,gordunni,192,hunter,beastmastery,6,2,4
8321,Wodhunterjr,ravencrest,192,hunter,beastmastery,6,2,4
8322,Ефрейя,gordunni,192,hunter,beastmastery,6,2,4
8323,Гернриета,gordunni,192,hunter,beastmastery,6,2,4
8324,Mdmalol,malganis,192,hunter,beastmastery,6,2,4
8325,Серцебиение,soulflayer,192,hunter,beastmastery,6,2,4
8326,Jàsøn,ravencrest,192,hunter,beastmastery,6,2,4
8327,Raztreadör,dun-modr,192,hunter,beastmastery,6,2,4
8328,Lurigalinda,twisting-nether,192,hunter,beastmastery,6,2,4
8329,Nikzeubii,archimonde,192,hunter,beastmastery,6,2,4
8330,Jayyke,frostmane,192,hunter,beastmastery,6,2,4
8331,Ansâvage,ravencrest,192,hunter,beastmastery,6,2,4
8332,Lísy,hyjal,192,hunter,beastmastery,6,2,4
8333,Lascazador,dun-modr,192,hunter,beastmastery,6,2,4
8334,Samodiva,twisting-nether,192,hunter,beastmastery,6,2,4
8335,Aughtism,turalyon,192,hunter,beastmastery,6,2,4
8336,Silencxz,aegwynn,192,hunter,beastmastery,6,2,4
8337,Thecorruptor,skullcrusher,192,hunter,beastmastery,6,2,4
8338,Soen,zuljin,192,hunter,beastmastery,6,2,4
8339,Jeskö,tarren-mill,192,hunter,beastmastery,6,2,4
8340,Pixxeel,khaz-modan,192,hunter,beastmastery,6,2,4
8341,Инкризшот,gordunni,192,hunter,beastmastery,6,2,4
8342,Willzz,ravencrest,192,hunter,beastmastery,6,2,4
8343,Holytrapqt,aegwynn,192,hunter,beastmastery,6,2,4
8344,Фэйсконтроль,azuregos,192,hunter,beastmastery,6,2,4
8345,Vasco,chogall,192,hunter,beastmastery,6,2,4
8346,Ancalarion,tarren-mill,192,hunter,beastmastery,6,2,4
8347,Ninjaskillss,ravencrest,192,hunter,beastmastery,6,2,4
8348,Zynga,sylvanas,192,hunter,beastmastery,6,2,4
8349,Dentaar,draenor,192,hunter,beastmastery,6,2,4
8350,Luuszapfae,aegwynn,192,hunter,beastmastery,6,2,4
8351,Díkembe,aegwynn,192,hunter,beastmastery,6,2,4
8352,Bówyóurfácé,outland,192,hunter,beastmastery,6,2,4
8353,Jambomambo,twisting-nether,192,hunter,beastmastery,6,2,4
8354,Comegetme,auchindoun,192,hunter,beastmastery,6,2,4
8355,Ecthelione,the-venture-co,192,hunter,beastmastery,6,2,4
8356,Scatterinc,antonidas,192,hunter,beastmastery,6,2,4
8357,Bernhardoder,blackhand,192,hunter,beastmastery,6,2,4
8358,Marryme,blackhand,192,hunter,beastmastery,6,2,4
8359,Legolex,burning-blade,192,hunter,beastmastery,6,2,4
8360,Azahunt,kazzak,192,hunter,beastmastery,6,2,4
8361,Тофуитер,howling-fjord,192,hunter,beastmastery,6,2,4
8362,Privelle,argent-dawn,192,hunter,beastmastery,6,2,4
8363,Marzenielas,silvermoon,192,hunter,beastmastery,6,2,4
8364,Naid,lordaeron,192,hunter,beastmastery,6,2,4
8365,Droz,blackmoore,192,hunter,beastmastery,6,2,4
8366,Deathcode,stormscale,192,hunter,beastmastery,6,2,4
8367,Feedbackloop,silvermoon,192,hunter,beastmastery,6,2,4
8368,Gunmeister,bronzebeard,192,hunter,beastmastery,6,2,4
8369,As,kazzak,192,hunter,beastmastery,6,2,4
8370,Dragoki,blackmoore,192,hunter,beastmastery,6,2,4
8371,Tillhunt,kargath,192,hunter,beastmastery,6,2,4
8372,Sourxete,silvermoon,192,hunter,beastmastery,6,2,4
8373,Dahunter,blackmoore,192,hunter,beastmastery,6,2,4
8374,Wildwingsebb,nazjatar,192,hunter,beastmastery,6,2,4
8375,Phyllobates,blackrock,192,hunter,beastmastery,6,2,4
8376,Gandro,blackmoore,192,hunter,beastmastery,6,2,4
8377,Vilopez,arthas,192,hunter,beastmastery,6,2,4
8378,Tràpz,archimonde,192,hunter,beastmastery,8,2,6
8379,Куджикс,soulflayer,192,hunter,beastmastery,19,4,15
8380,Örrn,ragnaros,192,hunter,beastmastery,12,2,10
8381,Кронн,howling-fjord,192,hunter,beastmastery,12,2,10
8382,Biorson,silvermoon,192,hunter,beastmastery,12,2,10
8383,Rheyl,dun-morogh,192,hunter,beastmastery,12,2,10
8384,Elja,laughing-skull,192,hunter,beastmastery,12,2,10
8385,Talmïr,archimonde,192,hunter,beastmastery,12,2,10
8386,Schräubchen,antonidas,192,hunter,beastmastery,12,2,10
8387,Calesthas,tarren-mill,192,hunter,beastmastery,12,2,10
8388,Slayman,kazzak,192,hunter,beastmastery,18,2,16
8389,Øutkast,silvermoon,191,hunter,beastmastery,6,2,4
8390,Charlet,archimonde,191,hunter,beastmastery,6,2,4
8391,Traknard,confrérie-du-thorium,191,hunter,beastmastery,6,2,4
8392,Kizscamander,magtheridon,191,hunter,beastmastery,12,2,10
8393,Bynen,tarren-mill,180,hunter,beastmastery,18,5,13
8394,Velites,aggra-português,159,hunter,beastmastery,5,2,3
8395,Phinox,sanguino,159,hunter,beastmastery,5,2,3
8396,Rakmo,blackmoore,159,hunter,beastmastery,5,2,3
8397,Åånei,twisting-nether,144,hunter,beastmastery,9,2,7
8398,Elnazar,archimonde,128,hunter,beastmastery,4,2,2
8399,Deathøfrats,ravencrest,128,hunter,beastmastery,4,2,2
8400,Gramzy,blackmoore,96,hunter,beastmastery,6,1,5
8401,Chambiann,tarren-mill,96,hunter,beastmastery,6,1,5
8402,Hairyplottér,kazzak,96,hunter,beastmastery,6,1,5
8403,Hntudwn,azshara,96,hunter,beastmastery,6,1,5
8404,Imahuntard,frostmane,96,hunter,beastmastery,6,1,5
8405,Дочьпескова,gordunni,96,hunter,beastmastery,6,1,5
8406,Буреклык,gordunni,96,hunter,beastmastery,6,1,5
8407,Traptard,blackrock,96,hunter,beastmastery,6,1,5
8408,Ichbringbier,blackrock,96,hunter,beastmastery,6,1,5
8409,Кертион,howling-fjord,96,hunter,beastmastery,6,1,5
8410,Евилик,gordunni,96,hunter,beastmastery,6,1,5
8411,Hõth,kazzak,96,hunter,beastmastery,6,1,5
8412,Сочнаятурель,howling-fjord,96,hunter,beastmastery,6,1,5
8413,Beastmaster,ragnaros,96,hunter,beastmastery,6,1,5
8414,Jägerjokke,blackrock,96,hunter,beastmastery,6,1,5
8415,Raggeh,frostwhisper,96,hunter,beastmastery,6,1,5
8416,Jozsiur,ragnaros,96,hunter,beastmastery,6,1,5
8417,Traplørdx,sylvanas,96,hunter,beastmastery,6,1,5
8418,Sokrám,sanguino,96,hunter,beastmastery,6,1,5
8419,Grigur,dalaran,96,hunter,beastmastery,6,1,5
8420,Betarayjinx,kazzak,96,hunter,beastmastery,6,1,5
8421,Darkray,dalaran,96,hunter,beastmastery,6,1,5
8422,Stingsz,chogall,96,hunter,beastmastery,6,1,5
8423,Duïvell,grim-batol,96,hunter,beastmastery,6,1,5
8424,Bogüen,sanguino,96,hunter,beastmastery,6,1,5
8425,Hashaya,hyjal,96,hunter,beastmastery,6,1,5
8426,Nomorex,frostwhisper,96,hunter,beastmastery,6,1,5
8427,Wórldz,dun-modr,96,hunter,beastmastery,6,1,5
8428,Bobtroll,twisting-nether,96,hunter,beastmastery,6,1,5
8429,Runescimmy,twisting-nether,96,hunter,beastmastery,6,1,5
8430,Weafster,outland,96,hunter,beastmastery,6,1,5
8431,Bloodpanter,ragnaros,96,hunter,beastmastery,6,1,5
8432,Trollohunt,twisting-nether,96,hunter,beastmastery,6,1,5
8433,Anun,magtheridon,96,hunter,beastmastery,6,1,5
8434,Gurkans,aggramar,96,hunter,beastmastery,6,1,5
8435,Zurzok,blackrock,96,hunter,beastmastery,6,1,5
8436,Exorbitant,blackrock,96,hunter,beastmastery,6,1,5
8437,Фитьфитий,howling-fjord,96,hunter,beastmastery,6,1,5
8438,Huntarbeît,eredar,96,hunter,beastmastery,6,1,5
8439,Zogzøg,draenor,96,hunter,beastmastery,6,1,5
8440,Bloodking,madmortem,96,hunter,beastmastery,6,1,5
8441,Táráh,proudmoore,96,hunter,beastmastery,6,1,5
8442,Zergst,nathrezim,96,hunter,beastmastery,6,1,5
8443,Dasmusdrückn,antonidas,96,hunter,beastmastery,6,1,5
8444,Douglas,die-silberne-hand,96,hunter,beastmastery,6,1,5
8445,ßèástymãç,ravencrest,96,hunter,beastmastery,6,1,5
8446,Sayn,la-croisade-écarlate,96,hunter,beastmastery,6,1,5
8447,Achiles,die-todeskrallen,96,hunter,beastmastery,6,1,5
8448,Pjållistani,ravencrest,96,hunter,beastmastery,6,1,5
8449,Tsyapka,tarren-mill,96,hunter,beastmastery,12,1,11
8450,Mævis,ravencrest,96,hunter,beastmastery,12,1,11
8451,Críted,blackmoore,96,hunter,beastmastery,12,1,11
8452,Thóorin,ravencrest,96,hunter,beastmastery,12,1,11
8453,Thelasiel,aerie-peak,95,hunter,beastmastery,6,1,5
8454,Youngjinh,ravencrest,64,hunter,beastmastery,4,1,3
8455,Yahamenistos,ysondre,64,hunter,beastmastery,4,1,3
8456,Voldtzeig,dentarg,42,hunter,beastmastery,13,4,9
8457,Liscie,silvermoon,42,hunter,beastmastery,14,2,12
8458,Tunhaa,arthas,16,hunter,beastmastery,1,1,0
8459,Gwaan,outland,9,hunter,beastmastery,6,2,4
8460,Aleç,ravencrest,1932,mage,arcane,60,31,29
8461,Bebenm,archimonde,1881,mage,arcane,69,34,35
8462,Choll,stormscale,1866,mage,arcane,30,20,10
8463,Нефростмаг,gordunni,1843,mage,arcane,78,43,35
8464,Wàneís,ravencrest,1840,mage,arcane,72,37,35
8465,Obbjob,ravencrest,1748,mage,arcane,60,30,30
8466,Castorcato,kazzak,1725,mage,arcane,48,26,22
8467,Raíku,ravencrest,1723,mage,arcane,30,18,12
8468,Непутевыймаг,gordunni,1715,mage,arcane,24,23,1
8469,Mercem,stormscale,1711,mage,arcane,30,21,9
8470,Persi,dentarg,1709,mage,arcane,84,43,41
8471,Wracrz,argent-dawn,1690,mage,arcane,60,35,25
8472,Shirrunn,the-maelstrom,1687,mage,arcane,38,19,19
8473,Dardíe,ravencrest,1681,mage,arcane,54,31,23
8474,Sallesauruus,outland,1651,mage,arcane,54,26,28
8475,Шттрвблнкт,soulflayer,1644,mage,arcane,83,41,42
8476,Radagulf,outland,1631,mage,arcane,42,20,22
8477,Magijoana,silvermoon,1629,mage,arcane,32,18,14
8478,Dárdie,ravencrest,1629,mage,arcane,34,19,15
8479,Sérc,ravencrest,1626,mage,arcane,30,17,13
8480,Orkamor,sylvanas,1622,mage,arcane,42,17,25
8481,Alustrasz,skullcrusher,1612,mage,arcane,66,37,29
8482,Манкай,fordragon,1604,mage,arcane,105,61,44
8483,Lemaroxd,draenor,1550,mage,arcane,29,17,12
8484,Ekron,sanguino,1541,mage,arcane,146,76,70
8485,Ecovation,tarren-mill,1532,mage,arcane,38,19,19
8486,Absie,tarren-mill,1516,mage,arcane,36,26,10
8487,Nakamura,outland,1514,mage,arcane,244,121,123
8488,Раканчик,gordunni,1503,mage,arcane,56,30,26
8489,Samirra,stormscale,1460,mage,arcane,36,19,17
8490,Ogarcanefist,outland,1424,mage,arcane,69,35,34
8491,Tnhigh,blackrock,1407,mage,arcane,39,24,15
8492,Barspin,lightnings-blade,1396,mage,arcane,54,31,23
8493,Lusionator,defias-brotherhood,1394,mage,arcane,54,31,23
8494,Фоулли,howling-fjord,1390,mage,arcane,23,15,8
8495,Jhawkwizard,draenor,1369,mage,arcane,97,51,46
8496,Ðøæø,twisting-nether,1346,mage,arcane,93,46,47
8497,Манаманна,gordunni,1341,mage,arcane,123,63,60
8498,Diper,burning-legion,1328,mage,arcane,36,15,21
8499,Nefrendel,kazzak,1299,mage,arcane,68,33,35
8500,Akâri,silvermoon,1294,mage,arcane,30,18,12
8501,Pradapimp,ravencrest,1286,mage,arcane,32,15,17
8502,Léa,rashgarroth,1275,mage,arcane,36,17,19
8503,Валбериса,deepholm,1270,mage,arcane,54,35,19
8504,Tokyodes,twisting-nether,1262,mage,arcane,65,29,36
8505,Xiaomofashi,quelthalas,1252,mage,arcane,42,22,20
8506,Meolchum,outland,1237,mage,arcane,45,22,23
8507,Nécrømage,confrérie-du-thorium,1235,mage,arcane,18,13,5
8508,Magikere,tarren-mill,1230,mage,arcane,36,23,13
8509,Rezre,stormscale,1212,mage,arcane,54,28,26
8510,Sszz,ravencrest,1201,mage,arcane,72,41,31
8511,Ozdewish,hyjal,1198,mage,arcane,85,39,46
8512,Канеллис,howling-fjord,1197,mage,arcane,37,14,23
8513,Demizboub,archimonde,1154,mage,arcane,168,85,83
8514,Cubis,archimonde,1152,mage,arcane,24,12,12
8515,Tiqma,sylvanas,1151,mage,arcane,24,12,12
8516,Ephreaym,stormscale,1151,mage,arcane,30,12,18
8517,Hardways,archimonde,1091,mage,arcane,114,47,67
8518,Sulteaxion,garrosh,1085,mage,arcane,24,12,12
8519,Макотшельник,gordunni,1056,mage,arcane,12,11,1
8520,Roulettefar,kazzak,1038,mage,arcane,24,11,13
8521,Mylord,bronze-dragonflight,996,mage,arcane,41,15,26
8522,Проблембойх,gordunni,960,mage,arcane,18,10,8
8523,Aleteia,stormscale,960,mage,arcane,18,10,8
8524,Burstology,kazzak,959,mage,arcane,18,10,8
8525,Portal,scarshield-legion,956,mage,arcane,18,10,8
8526,Sukalamink,alonsus,955,mage,arcane,24,10,14
8527,Иссэя,borean-tundra,954,mage,arcane,37,21,16
8528,Zezt,tarren-mill,939,mage,arcane,30,10,20
8529,Frostdeath,medivh,906,mage,arcane,24,10,14
8530,Вадимодесса,soulflayer,904,mage,arcane,37,17,20
8531,Waterhagx,tarren-mill,894,mage,arcane,17,10,7
8532,Scaless,stormscale,891,mage,arcane,22,10,12
8533,Puni,emerald-dream,864,mage,arcane,12,9,3
8534,Fuhry,tarren-mill,864,mage,arcane,12,9,3
8535,Dohnnyjepp,gorgonnash,864,mage,arcane,23,10,13
8536,Дырявка,galakrond,859,mage,arcane,24,9,15
8537,Kobrass,spinebreaker,855,mage,arcane,30,9,21
8538,Zimbabweborc,burning-legion,768,mage,arcane,12,8,4
8539,Bullegong,archimonde,768,mage,arcane,12,8,4
8540,Nïo,ravencrest,767,mage,arcane,18,8,10
8541,Zehnvonzehn,antonidas,767,mage,arcane,18,8,10
8542,Aeghis,darkspear,765,mage,arcane,18,8,10
8543,Elor,eredar,765,mage,arcane,21,9,12
8544,Freshforces,ragnaros,703,mage,arcane,22,8,14
8545,Doryy,silvermoon,672,mage,arcane,12,7,5
8546,Яшабурстх,blackscar,672,mage,arcane,12,7,5
8547,Trucy,eredar,672,mage,arcane,12,7,5
8548,Tokerlol,stormscale,672,mage,arcane,12,7,5
8549,Nötmârtònxø,ragnaros,671,mage,arcane,12,7,5
8550,Димаскунфу,howling-fjord,640,mage,arcane,22,7,15
8551,Mageé,argent-dawn,621,mage,arcane,17,7,10
8552,Зухвала,howling-fjord,611,mage,arcane,23,7,16
8553,Arkeus,turalyon,605,mage,arcane,11,7,4
8554,Pyllymake,kazzak,576,mage,arcane,12,6,6
8555,Spicymash,chogall,575,mage,arcane,12,6,6
8556,Thorstäin,ragnaros,575,mage,arcane,12,6,6
8557,Banjó,twilights-hammer,480,mage,arcane,6,5,1
8558,Tamtheone,frostwhisper,480,mage,arcane,6,5,1
8559,Pwntt,terenas,480,mage,arcane,12,5,7
8560,Alarak,drakthul,480,mage,arcane,12,5,7
8561,Soulraider,tarren-mill,480,mage,arcane,12,5,7
8562,Сизаам,howling-fjord,480,mage,arcane,12,5,7
8563,Astrryy,burning-legion,480,mage,arcane,12,5,7
8564,Barryscótt,stormscale,480,mage,arcane,12,5,7
8565,Mðj,kazzak,480,mage,arcane,18,5,13
8566,Ледянойкекс,gordunni,480,mage,arcane,18,5,13
8567,Ewina,twisting-nether,479,mage,arcane,6,5,1
8568,Mortlol,chamber-of-aspects,479,mage,arcane,12,5,7
8569,Нормалмап,soulflayer,479,mage,arcane,24,5,19
8570,Gorn,ravencrest,478,mage,arcane,12,5,7
8571,Ímnotback,outland,431,mage,arcane,11,5,6
8572,Nelfchewer,ravencrest,399,mage,arcane,5,5,0
8573,Hexmath,tarren-mill,384,mage,arcane,6,4,2
8574,Apollohouse,ravencrest,384,mage,arcane,6,4,2
8575,Paradigma,sylvanas,384,mage,arcane,6,4,2
8576,Jengele,argent-dawn,384,mage,arcane,6,4,2
8577,Yunox,stormscale,384,mage,arcane,6,4,2
8578,Fadi,anachronos,384,mage,arcane,6,4,2
8579,Tarovan,defias-brotherhood,384,mage,arcane,6,4,2
8580,Rizzlybear,outland,384,mage,arcane,6,4,2
8581,Мглавечная,azuregos,384,mage,arcane,6,4,2
8582,Uní,emerald-dream,384,mage,arcane,12,4,8
8583,Zoot,ravencrest,384,mage,arcane,12,4,8
8584,Mannenye,stormscale,384,mage,arcane,12,4,8
8585,Fôôxy,aegwynn,383,mage,arcane,6,4,2
8586,Дантрий,gordunni,382,mage,arcane,6,4,2
8587,Gagaj,ravencrest,288,mage,arcane,6,3,3
8588,Auchenax,argent-dawn,288,mage,arcane,6,3,3
8589,Khoshgele,draenor,288,mage,arcane,6,3,3
8590,Choise,stormscale,288,mage,arcane,6,3,3
8591,Даанрен,galakrond,288,mage,arcane,6,3,3
8592,Æskalatîøn,blackmoore,288,mage,arcane,6,3,3
8593,Kyrn,zuljin,288,mage,arcane,6,3,3
8594,Ovrpwrdxd,kazzak,288,mage,arcane,6,3,3
8595,Brokenlegman,defias-brotherhood,288,mage,arcane,6,3,3
8596,Aristarco,outland,288,mage,arcane,6,3,3
8597,Serctheone,ravencrest,288,mage,arcane,9,4,5
8598,Хблэйз,howling-fjord,288,mage,arcane,12,3,9
8599,Kudakto,ravencrest,288,mage,arcane,12,3,9
8600,Malshash,outland,287,mage,arcane,6,3,3
8601,Кронни,razuvious,287,mage,arcane,6,3,3
8602,Arcadua,sanguino,287,mage,arcane,6,3,3
8603,Kasus,sporeggar,286,mage,arcane,6,3,3
8604,Naween,hyjal,239,mage,arcane,5,3,2
8605,Teeclis,twisting-nether,192,mage,arcane,6,2,4
8606,Versachi,neptulon,192,mage,arcane,6,2,4
8607,Naomypayton,tarren-mill,192,mage,arcane,6,2,4
8608,Ãshs,archimonde,192,mage,arcane,6,2,4
8609,Phyzed,archimonde,192,mage,arcane,6,2,4
8610,Kbd,outland,192,mage,arcane,6,2,4
8611,Superduck,ragnaros,192,mage,arcane,6,2,4
8612,Ryûblast,archimonde,192,mage,arcane,6,2,4
8613,Линклер,fordragon,192,mage,arcane,6,2,4
8614,Shiranize,aegwynn,192,mage,arcane,6,2,4
8615,Baravar,blackrock,192,mage,arcane,6,2,4
8616,Nerzzhul,burning-legion,192,mage,arcane,6,2,4
8617,Kuhwar,echsenkessel,192,mage,arcane,6,2,4
8618,Леракобольд,gordunni,192,mage,arcane,6,2,4
8619,Arimila,sylvanas,192,mage,arcane,6,2,4
8620,Noxkin,stormscale,192,mage,arcane,6,2,4
8621,Зерагуд,eversong,192,mage,arcane,6,2,4
8622,Schøkø,eredar,192,mage,arcane,6,2,4
8623,Hruon,ravenholdt,192,mage,arcane,6,2,4
8624,Æones,kult-der-verdammten,192,mage,arcane,12,2,10
8625,Icx,tarren-mill,191,mage,arcane,6,2,4
8626,Magse,kirin-tor,191,mage,arcane,6,2,4
8627,Sorrow,outland,96,mage,arcane,6,1,5
8628,Thelastmage,outland,96,mage,arcane,6,1,5
8629,Мерац,howling-fjord,96,mage,arcane,6,1,5
8630,Angélique,ragnaros,96,mage,arcane,6,1,5
8631,Nohbrain,blackmoore,96,mage,arcane,6,1,5
8632,Souldemon,burning-legion,96,mage,arcane,6,1,5
8633,Animaze,argent-dawn,96,mage,arcane,6,1,5
8634,Seraf,argent-dawn,96,mage,arcane,6,1,5
8635,Moosemæn,stormscale,96,mage,arcane,6,1,5
8636,Старкскрим,gordunni,96,mage,arcane,6,1,5
8637,Døomey,ravencrest,96,mage,arcane,6,1,5
8638,Hólmess,silvermoon,96,mage,arcane,6,1,5
8639,Sidildur,ravencrest,96,mage,arcane,6,1,5
8640,Azakadabra,ysondre,96,mage,arcane,6,1,5
8641,Манднесс,azuregos,79,mage,arcane,11,1,10
8642,Thegoodoctor,kazzak,2119,mage,fire,69,39,30
8643,Slôw,kazzak,2029,mage,fire,42,29,13
8644,Håtemebaby,kazzak,2021,mage,fire,84,38,46
8645,Håtsu,ravencrest,1998,mage,fire,66,35,31
8646,Twizzkek,silvermoon,1993,mage,fire,69,34,35
8647,Рофкастер,gordunni,1978,mage,fire,65,34,31
8648,Яшабурстх,blackscar,1943,mage,fire,66,35,31
8649,Tommy,laughing-skull,1928,mage,fire,60,34,26
8650,Rizzlybear,outland,1918,mage,fire,75,35,40
8651,Laynerz,kazzak,1917,mage,fire,27,21,6
8652,Milkenjoyer,ravencrest,1906,mage,fire,47,30,17
8653,Hatsu,kazzak,1884,mage,fire,60,32,28
8654,Uknowhowwedu,aegwynn,1879,mage,fire,36,20,16
8655,Шипми,gordunni,1862,mage,fire,78,39,39
8656,Hey,khazgoroth,1857,mage,fire,54,35,19
8657,Uniquenoodle,alakir,1857,mage,fire,72,34,38
8658,Cörnflekz,stormscale,1850,mage,fire,44,28,16
8659,Dardie,ravencrest,1849,mage,fire,48,30,18
8660,Hazewrld,ravencrest,1848,mage,fire,132,62,70
8661,Spelltastíc,blackmoore,1844,mage,fire,54,34,20
8662,Isenhour,frostmane,1843,mage,fire,126,65,61
8663,Hólmess,silvermoon,1840,mage,fire,54,28,26
8664,Wàneís,ravencrest,1831,mage,fire,40,25,15
8665,Твейзи,blackscar,1823,mage,fire,40,24,16
8666,Evohz,stormscale,1822,mage,fire,66,33,33
8667,Elmaestró,aegwynn,1815,mage,fire,48,30,18
8668,Bigkent,stormscale,1814,mage,fire,62,27,35
8669,Nihilvm,dalaran,1812,mage,fire,46,26,20
8670,Libre,stormscale,1811,mage,fire,106,63,43
8671,Cesi,silvermoon,1793,mage,fire,36,19,17
8672,Jirt,stormscale,1782,mage,fire,47,28,19
8673,Reyown,archimonde,1777,mage,fire,54,40,14
8674,Ókamí,ravencrest,1776,mage,fire,103,53,50
8675,Ширм,blackscar,1774,mage,fire,42,22,20
8676,Dizzy,ahnqiraj,1751,mage,fire,78,35,43
8677,Диссоциация,greymane,1746,mage,fire,42,26,16
8678,Hardtimes,blackhand,1738,mage,fire,70,38,32
8679,Гекомория,fordragon,1736,mage,fire,65,26,39
8680,Asterixus,sylvanas,1728,mage,fire,72,44,28
8681,Disnay,draenor,1725,mage,fire,144,82,62
8682,Mágetráiner,ravencrest,1721,mage,fire,36,18,18
8683,Ygø,hyjal,1712,mage,fire,85,36,49
8684,Авгурей,howling-fjord,1704,mage,fire,84,40,44
8685,Dxdxdxdxdx,drakthul,1700,mage,fire,42,23,19
8686,Gelußaßa,ravencrest,1696,mage,fire,35,22,13
8687,Mssilvy,sylvanas,1681,mage,fire,66,36,30
8688,Skrex,blackrock,1677,mage,fire,78,48,30
8689,Spelltastìc,blackmoore,1675,mage,fire,36,18,18
8690,Реордиан,gordunni,1667,mage,fire,47,18,29
8691,Siérra,outland,1651,mage,fire,60,38,22
8692,Itrius,tarren-mill,1647,mage,fire,48,23,25
8693,Magenerfed,archimonde,1637,mage,fire,42,21,21
8694,Ðevlqt,blackmoore,1636,mage,fire,30,22,8
8695,Sheepmeepbip,ravencrest,1632,mage,fire,81,35,46
8696,Obbjob,ravencrest,1631,mage,fire,72,36,36
8697,Doonii,ragnaros,1615,mage,fire,41,19,22
8698,Elldiamage,draenor,1608,mage,fire,35,21,14
8699,Cienaños,outland,1606,mage,fire,66,34,32
8700,Smlx,outland,1603,mage,fire,36,20,16
8701,Айслэнц,howling-fjord,1602,mage,fire,42,21,21
8702,Frozentwink,kul-tiras,1601,mage,fire,40,21,19
8703,Råståfåri,uldum,1592,mage,fire,66,35,31
8704,Whats,korgall,1585,mage,fire,70,39,31
8705,Lilblinks,silvermoon,1585,mage,fire,75,40,35
8706,Naps,argent-dawn,1574,mage,fire,42,26,16
8707,Czd,outland,1574,mage,fire,53,21,32
8708,Прауз,soulflayer,1573,mage,fire,33,17,16
8709,Stoychav,outland,1573,mage,fire,72,36,36
8710,Hexmath,tarren-mill,1572,mage,fire,41,26,15
8711,Underscore,outland,1563,mage,fire,30,18,12
8712,Camiina,shattered-hand,1545,mage,fire,48,29,19
8713,Gagaj,ravencrest,1534,mage,fire,42,20,22
8714,Фоулли,howling-fjord,1526,mage,fire,30,16,14
8715,Petar,tarren-mill,1526,mage,fire,34,18,16
8716,Consquens,aszune,1509,mage,fire,24,16,8
8717,Evovar,silvermoon,1492,mage,fire,35,16,19
8718,Macheat,kazzak,1485,mage,fire,30,16,14
8719,Glïder,archimonde,1482,mage,fire,30,16,14
8720,Insanewizard,kazzak,1480,mage,fire,59,30,29
8721,Gnomag,argent-dawn,1478,mage,fire,54,28,26
8722,Dantiqa,ravencrest,1472,mage,fire,110,53,57
8723,Экзорсус,goldrinn,1465,mage,fire,105,51,54
8724,Plætinum,ravencrest,1453,mage,fire,98,50,48
8725,Htwhy,kazzak,1448,mage,fire,36,16,20
8726,Secretagent,aegwynn,1439,mage,fire,66,37,29
8727,Mäalaka,archimonde,1439,mage,fire,48,26,22
8728,Dazz,ravencrest,1435,mage,fire,30,15,15
8729,Shahnoza,thrall,1428,mage,fire,24,15,9
8730,Fireblood,runetotem,1426,mage,fire,36,15,21
8731,Triplesevenx,silvermoon,1422,mage,fire,53,26,27
8732,Skarxaa,sanguino,1418,mage,fire,42,21,21
8733,Calientay,ragnaros,1414,mage,fire,30,15,15
8734,Aikamie,draenor,1412,mage,fire,48,24,24
8735,Vzrmage,antonidas,1402,mage,fire,108,46,62
8736,Колдрагос,gordunni,1398,mage,fire,42,17,25
8737,Lokilus,dalaran,1393,mage,fire,24,15,9
8738,Ледянойкекс,gordunni,1390,mage,fire,52,26,26
8739,Rayniß,blackmoore,1389,mage,fire,66,30,36
8740,Дрраго,greymane,1386,mage,fire,93,46,47
8741,Аваон,deathguard,1372,mage,fire,60,32,28
8742,Atixx,aegwynn,1369,mage,fire,48,20,28
8743,Рифтиг,howling-fjord,1365,mage,fire,61,27,34
8744,Razrkh,ragnaros,1364,mage,fire,60,30,30
8745,Bonto,tarren-mill,1364,mage,fire,48,23,25
8746,Blitzo,madmortem,1361,mage,fire,42,25,17
8747,Деозар,eversong,1353,mage,fire,36,16,20
8748,Noviina,argent-dawn,1346,mage,fire,30,17,13
8749,Kappotjeplif,ravencrest,1346,mage,fire,54,28,26
8750,Pisini,tarren-mill,1342,mage,fire,30,14,16
8751,Zestrax,kazzak,1339,mage,fire,42,29,13
8752,Нереварин,soulflayer,1338,mage,fire,27,15,12
8753,Ryzea,ravencrest,1338,mage,fire,41,21,20
8754,Neird,sinstralis,1338,mage,fire,54,26,28
8755,Bloodycast,archimonde,1338,mage,fire,40,16,24
8756,Аквамэрис,gordunni,1336,mage,fire,24,14,10
8757,Tiltedpapi,ravencrest,1325,mage,fire,29,15,14
8758,Darríck,argent-dawn,1323,mage,fire,41,16,25
8759,Stylaaz,twisting-nether,1317,mage,fire,35,18,17
8760,Liendri,aegwynn,1305,mage,fire,30,14,16
8761,Fiveboyjr,tarren-mill,1302,mage,fire,54,29,25
8762,Вселениум,razuvious,1299,mage,fire,52,29,23
8763,Bobbasor,defias-brotherhood,1299,mage,fire,45,21,24
8764,Fenrirson,drakthul,1297,mage,fire,30,18,12
8765,Magicalmig,draenor,1295,mage,fire,120,71,49
8766,Momomagic,silvermoon,1287,mage,fire,52,24,28
8767,Manvo,bloodscalp,1279,mage,fire,42,21,21
8768,Быкуня,gordunni,1276,mage,fire,36,20,16
8769,Zéngã,kazzak,1263,mage,fire,31,15,16
8770,Cinoox,blackrock,1259,mage,fire,78,41,37
8771,Varenca,blackrock,1256,mage,fire,75,35,40
8772,Фрозитв,blackscar,1247,mage,fire,18,13,5
8773,Prácticemàge,archimonde,1246,mage,fire,18,13,5
8774,Fingolfin,amanthul,1246,mage,fire,237,111,126
8775,Yanir,die-arguswacht,1245,mage,fire,24,13,11
8776,Dóncójones,blackrock,1244,mage,fire,47,21,26
8777,Âcryz,blackrock,1242,mage,fire,30,13,17
8778,Zensheep,silvermoon,1235,mage,fire,24,13,11
8779,Elcølgaø,sanguino,1233,mage,fire,30,13,17
8780,Carinuz,blackmoore,1232,mage,fire,31,13,18
8781,Смилер,gordunni,1231,mage,fire,24,13,11
8782,Tokerlol,stormscale,1231,mage,fire,27,13,14
8783,Faunas,kazzak,1230,mage,fire,46,27,19
8784,Magmarro,burning-legion,1229,mage,fire,54,24,30
8785,Warwizz,sanguino,1226,mage,fire,24,13,11
8786,Ênizt,archimonde,1222,mage,fire,23,13,10
8787,Nuvx,ravencrest,1212,mage,fire,72,39,33
8788,Athenå,dalaran,1207,mage,fire,36,17,19
8789,Romethito,dun-modr,1203,mage,fire,24,17,7
8790,Skylezy,blackrock,1198,mage,fire,23,13,10
8791,Dobbite,archimonde,1178,mage,fire,30,21,9
8792,Mëgu,silvermoon,1170,mage,fire,110,52,58
8793,Nilitar,kazzak,1152,mage,fire,24,12,12
8794,Kaki,stormscale,1150,mage,fire,30,16,14
8795,Azulêera,archimonde,1149,mage,fire,24,12,12
8796,Rewq,twisting-nether,1147,mage,fire,18,12,6
8797,Demensida,ravencrest,1145,mage,fire,28,13,15
8798,Büyübaba,twisting-nether,1145,mage,fire,30,12,18
8799,Immortanjoe,thrall,1142,mage,fire,42,16,26
8800,Themagicguy,silvermoon,1140,mage,fire,24,12,12
8801,Eutkir,silvermoon,1121,mage,fire,27,13,14
8802,Fritmckhaine,archimonde,1116,mage,fire,36,21,15
8803,Gorleg,draenor,1072,mage,fire,47,17,30
8804,Newtwo,ravencrest,1070,mage,fire,25,12,13
8805,Wizmec,silvermoon,1068,mage,fire,36,12,24
8806,Mowns,ravencrest,1056,mage,fire,24,11,13
8807,Твейдей,blackscar,1056,mage,fire,24,11,13
8808,Nøw,kazzak,1055,mage,fire,18,11,7
8809,Sleepingfate,stormscale,1055,mage,fire,18,11,7
8810,Anisovsky,archimonde,1055,mage,fire,24,11,13
8811,Fuego,sylvanas,1052,mage,fire,27,12,15
8812,Мозифорест,gordunni,1047,mage,fire,30,11,19
8813,Laetitiah,archimonde,1042,mage,fire,24,11,13
8814,Larah,les-clairvoyants,1038,mage,fire,18,11,7
8815,Aimaniac,stormscale,1029,mage,fire,78,36,42
8816,Pablø,blackrock,1014,mage,fire,31,15,16
8817,Cyrîll,malygos,1004,mage,fire,73,36,37
8818,Apócalyptic,tarren-mill,997,mage,fire,29,11,18
8819,Enandia,darksorrow,959,mage,fire,18,10,8
8820,Magijoana,silvermoon,959,mage,fire,36,10,26
8821,Akâri,silvermoon,958,mage,fire,18,10,8
8822,Texmexguden,tarren-mill,958,mage,fire,24,10,14
8823,Mejtschazor,twisting-nether,957,mage,fire,18,10,8
8824,Charizard,emerald-dream,956,mage,fire,15,11,4
8825,Gerdâ,chants-éternels,953,mage,fire,26,12,14
8826,Çana,thrall,952,mage,fire,30,10,20
8827,Leontus,outland,951,mage,fire,12,10,2
8828,Shealá,blackhand,951,mage,fire,24,10,14
8829,Firewitch,blackhand,950,mage,fire,24,10,14
8830,Kuríbo,gorgonnash,944,mage,fire,21,11,10
8831,Дмблдр,soulflayer,943,mage,fire,21,11,10
8832,Ghalanz,ravencrest,941,mage,fire,23,10,13
8833,Icx,tarren-mill,931,mage,fire,39,19,20
8834,Sèrum,drakthul,927,mage,fire,23,10,13
8835,Santoz,blackrock,926,mage,fire,58,30,28
8836,Freezandrun,tarren-mill,918,mage,fire,47,21,26
8837,Magicspark,madmortem,904,mage,fire,74,35,39
8838,Nåzmyz,outland,891,mage,fire,17,10,7
8839,Sagregas,silvermoon,876,mage,fire,65,28,37
8840,Freezeballs,blackmoore,871,mage,fire,31,10,21
8841,Ráìkù,ravencrest,864,mage,fire,12,9,3
8842,Magerocks,ragnaros,864,mage,fire,12,9,3
8843,Turbomedusa,draenor,864,mage,fire,12,9,3
8844,Auchenax,argent-dawn,864,mage,fire,12,9,3
8845,Spacehoe,stormscale,864,mage,fire,18,9,9
8846,Lotharie,aegwynn,864,mage,fire,18,9,9
8847,Smíte,kazzak,863,mage,fire,12,9,3
8848,Tagrine,kaelthas,863,mage,fire,12,9,3
8849,Estelliên,burning-legion,863,mage,fire,18,9,9
8850,Weedup,zuljin,862,mage,fire,18,9,9
8851,Morphis,talnivarr,862,mage,fire,18,9,9
8852,Hil,blackrock,862,mage,fire,18,9,9
8853,Silatara,twisting-nether,860,mage,fire,18,9,9
8854,Чоуза,gordunni,858,mage,fire,24,9,15
8855,Nezousta,sinstralis,854,mage,fire,18,9,9
8856,Løxyy,ysondre,852,mage,fire,26,11,15
8857,Netherstorm,chogall,848,mage,fire,24,10,14
8858,Töframaður,draenor,827,mage,fire,16,9,7
8859,Firen,thrall,827,mage,fire,18,9,9
8860,Fakeklepter,sylvanas,768,mage,fire,12,8,4
8861,Ilikesheep,blackmoore,768,mage,fire,12,8,4
8862,Roxxis,kazzak,768,mage,fire,12,8,4
8863,Yésdávé,stormscale,768,mage,fire,12,8,4
8864,Apollohouse,ravencrest,768,mage,fire,12,8,4
8865,Frøstqt,ravencrest,768,mage,fire,12,8,4
8866,Nùts,archimonde,768,mage,fire,12,8,4
8867,Mlodysimba,burning-legion,768,mage,fire,12,8,4
8868,Zelimeth,outland,768,mage,fire,18,8,10
8869,Mðj,kazzak,768,mage,fire,24,8,16
8870,Imtrynasheep,kazzak,767,mage,fire,12,8,4
8871,Bclaudiu,terokkar,767,mage,fire,16,9,7
8872,Mieria,argent-dawn,767,mage,fire,18,8,10
8873,Dauwen,silvermoon,767,mage,fire,18,8,10
8874,Dynamica,ravencrest,767,mage,fire,18,8,10
8875,Aulny,kaelthas,767,mage,fire,18,8,10
8876,Pluggis,the-maelstrom,767,mage,fire,18,8,10
8877,Алаурс,howling-fjord,767,mage,fire,18,8,10
8878,Магмагистр,blackscar,767,mage,fire,24,8,16
8879,Takiix,antonidas,766,mage,fire,12,8,4
8880,Pandathis,frostwolf,766,mage,fire,12,8,4
8881,Versachi,neptulon,766,mage,fire,18,8,10
8882,Iamslow,sylvanas,762,mage,fire,12,8,4
8883,Arcadua,sanguino,758,mage,fire,12,8,4
8884,Yshax,malganis,751,mage,fire,17,8,9
8885,Kalyypso,arygos,735,mage,fire,16,9,7
8886,Mitchmage,ravencrest,732,mage,fire,17,8,9
8887,Вовзон,howling-fjord,672,mage,fire,12,7,5
8888,Эммилиарда,gordunni,672,mage,fire,12,7,5
8889,Elesios,blackmoore,672,mage,fire,12,7,5
8890,Двинск,soulflayer,672,mage,fire,12,7,5
8891,Iconic,eredar,672,mage,fire,12,7,5
8892,Rambau,archimonde,672,mage,fire,12,7,5
8893,Equálity,blackrock,672,mage,fire,12,7,5
8894,Mangiafuoco,nemesis,672,mage,fire,18,7,11
8895,Anaxtra,guldan,672,mage,fire,18,7,11
8896,Revanov,outland,671,mage,fire,12,7,5
8897,Calegos,twisting-nether,671,mage,fire,12,7,5
8898,Spellfaker,drakthul,671,mage,fire,12,7,5
8899,Sadrã,kazzak,671,mage,fire,18,7,11
8900,Ustafrr,argent-dawn,670,mage,fire,13,7,6
8901,Caesarclown,silvermoon,667,mage,fire,12,7,5
8902,Bigbazzabean,silvermoon,657,mage,fire,18,7,11
8903,Magikere,tarren-mill,639,mage,fire,17,7,10
8904,Vulcanx,stormscale,638,mage,fire,17,7,10
8905,Bezelgeuse,pozzo-delleternità,623,mage,fire,17,7,10
8906,Chrismage,argent-dawn,606,mage,fire,20,7,13
8907,Takayaki,terokkar,592,mage,fire,13,7,6
8908,Matsuratkø,nemesis,576,mage,fire,6,6,0
8909,Arcticfury,ravencrest,576,mage,fire,6,6,0
8910,Whócárés,dragonmaw,576,mage,fire,6,6,0
8911,Codeincassie,blackhand,576,mage,fire,12,6,6
8912,Pradapimp,ravencrest,576,mage,fire,12,6,6
8913,Säroumäne,archimonde,576,mage,fire,12,6,6
8914,Feath,ravencrest,576,mage,fire,12,6,6
8915,Macey,ravencrest,576,mage,fire,12,6,6
8916,Canceled,kazzak,576,mage,fire,12,6,6
8917,Medivqt,ragnaros,576,mage,fire,12,6,6
8918,Serctheone,ravencrest,576,mage,fire,12,6,6
8919,Octtmiss,twisting-nether,576,mage,fire,12,6,6
8920,Rhodghar,ravencrest,576,mage,fire,12,6,6
8921,Zimbabweborc,burning-legion,576,mage,fire,12,6,6
8922,Steveishigh,tarren-mill,576,mage,fire,13,6,7
8923,Relik,sylvanas,576,mage,fire,18,6,12
8924,Arhi,silvermoon,575,mage,fire,12,6,6
8925,Akhali,chamber-of-aspects,575,mage,fire,12,6,6
8926,Baxeraa,draenor,575,mage,fire,12,6,6
8927,Saturator,burning-legion,575,mage,fire,18,6,12
8928,Explosìve,arthas,574,mage,fire,12,6,6
8929,Durdi,silvermoon,574,mage,fire,12,6,6
8930,Mauvé,blades-edge,520,mage,fire,13,7,6
8931,Cleancc,blackhand,480,mage,fire,6,5,1
8932,Choll,stormscale,480,mage,fire,6,5,1
8933,Yoku,nethersturm,480,mage,fire,6,5,1
8934,Jél,stormscale,480,mage,fire,6,5,1
8935,Excuséme,ravencrest,480,mage,fire,6,5,1
8936,Jíncks,draenor,480,mage,fire,6,5,1
8937,Larmp,outland,480,mage,fire,6,5,1
8938,Bzzr,tarren-mill,480,mage,fire,6,5,1
8939,Utarii,deathwing,480,mage,fire,6,5,1
8940,Kurtcobain,draenor,480,mage,fire,6,5,1
8941,Schøkø,eredar,480,mage,fire,12,5,7
8942,Røysi,ravencrest,480,mage,fire,12,5,7
8943,Magechonk,kazzak,480,mage,fire,12,5,7
8944,Teeclis,twisting-nether,480,mage,fire,12,5,7
8945,Проблембойх,gordunni,480,mage,fire,12,5,7
8946,Sheepwithmeh,blackrock,480,mage,fire,12,5,7
8947,Backped,kazzak,480,mage,fire,18,5,13
8948,Валбериса,deepholm,479,mage,fire,6,5,1
8949,Wizarð,archimonde,479,mage,fire,12,5,7
8950,Spispi,burning-legion,479,mage,fire,15,6,9
8951,Вельдрик,soulflayer,479,mage,fire,18,5,13
8952,Nohbrain,blackmoore,479,mage,fire,18,5,13
8953,Iceorb,azshara,479,mage,fire,24,5,19
8954,Spader,argent-dawn,478,mage,fire,12,5,7
8955,Skitsó,shadowsong,477,mage,fire,12,5,7
8956,Exorifrigo,dun-modr,477,mage,fire,22,5,17
8957,Eldiablo,dun-modr,476,mage,fire,12,5,7
8958,Mikefires,blackrock,447,mage,fire,8,6,2
8959,Buuszek,outland,430,mage,fire,11,5,6
8960,Gennésïs,darksorrow,384,mage,fire,6,4,2
8961,Drè,daggerspine,384,mage,fire,6,4,2
8962,Rotøk,burning-legion,384,mage,fire,6,4,2
8963,Pavlé,draenor,384,mage,fire,6,4,2
8964,Gaárá,stormscale,384,mage,fire,6,4,2
8965,Drewna,silvermoon,384,mage,fire,6,4,2
8966,Файрусх,deathguard,384,mage,fire,6,4,2
8967,Praison,defias-brotherhood,384,mage,fire,6,4,2
8968,Zaci,argent-dawn,384,mage,fire,6,4,2
8969,Doryy,silvermoon,384,mage,fire,6,4,2
8970,Blinker,frostwhisper,384,mage,fire,6,4,2
8971,Gidsor,silvermoon,384,mage,fire,6,4,2
8972,Saryotheone,silvermoon,384,mage,fire,6,4,2
8973,Zyreanx,blackrock,384,mage,fire,6,4,2
8974,Ovrpwrdxd,kazzak,384,mage,fire,6,4,2
8975,Нефростмаг,gordunni,384,mage,fire,6,4,2
8976,Azîlko,frostwolf,384,mage,fire,6,4,2
8977,Kitchimage,ravencrest,384,mage,fire,6,4,2
8978,Cardioexpert,ravencrest,384,mage,fire,6,4,2
8979,Mnday,ravencrest,384,mage,fire,6,4,2
8980,Zuckerzimt,ravencrest,384,mage,fire,12,4,8
8981,Незерёб,soulflayer,384,mage,fire,12,4,8
8982,Genviedgiclé,arathi,384,mage,fire,12,4,8
8983,Magicuze,argent-dawn,384,mage,fire,12,4,8
8984,Деорро,gordunni,384,mage,fire,12,4,8
8985,Airo,drakthul,384,mage,fire,12,4,8
8986,Викликс,borean-tundra,384,mage,fire,12,4,8
8987,Camelshaver,tarren-mill,384,mage,fire,12,4,8
8988,Anthrex,drakthul,384,mage,fire,12,4,8
8989,Rooven,aegwynn,384,mage,fire,12,4,8
8990,Aarcheon,kazzak,384,mage,fire,12,4,8
8991,Popbg,outland,384,mage,fire,12,4,8
8992,Insaneex,aegwynn,384,mage,fire,12,4,8
8993,Lusionator,defias-brotherhood,384,mage,fire,18,4,14
8994,Rapidfrost,drakthul,383,mage,fire,6,4,2
8995,Majinbo,doomhammer,383,mage,fire,12,4,8
8996,Draenaya,forscherliga,381,mage,fire,18,4,14
8997,Hidrax,outland,352,mage,fire,10,4,6
8998,Lusifera,outland,336,mage,fire,9,4,5
8999,Мэдраша,gordunni,335,mage,fire,17,4,13
9000,Intz,twisting-nether,288,mage,fire,6,3,3
9001,Driana,dragonmaw,288,mage,fire,6,3,3
9002,Capphaow,ravencrest,288,mage,fire,6,3,3
9003,Мэджу,gordunni,288,mage,fire,6,3,3
9004,Alyraza,chamber-of-aspects,288,mage,fire,6,3,3
9005,Ziscine,tarren-mill,288,mage,fire,6,3,3
9006,Lëyra,ysondre,288,mage,fire,6,3,3
9007,Тудысюдым,eversong,288,mage,fire,6,3,3
9008,Sonybonanza,kazzak,288,mage,fire,6,3,3
9009,Росвенд,gordunni,288,mage,fire,6,3,3
9010,Radiantfury,outland,288,mage,fire,6,3,3
9011,Fleurdelacur,ravencrest,288,mage,fire,6,3,3
9012,Wankel,blackmoore,288,mage,fire,6,3,3
9013,Coachrmp,ravencrest,288,mage,fire,6,3,3
9014,Estwald,arathor,288,mage,fire,6,3,3
9015,Maveya,blackmoore,288,mage,fire,6,3,3
9016,Trowbe,blackmoore,288,mage,fire,6,3,3
9017,Marøjuniõr,draenor,288,mage,fire,6,3,3
9018,Alterwhite,archimonde,288,mage,fire,6,3,3
9019,Namemage,stormscale,288,mage,fire,6,3,3
9020,Shermî,blackrock,288,mage,fire,6,3,3
9021,Zøe,aggra-português,288,mage,fire,6,3,3
9022,Funkyfriday,twisting-nether,288,mage,fire,6,3,3
9023,Modrone,ragnaros,288,mage,fire,6,3,3
9024,Salvadordalí,ravencrest,288,mage,fire,6,3,3
9025,Ørka,stormscale,288,mage,fire,6,3,3
9026,Hahahehe,aegwynn,288,mage,fire,6,3,3
9027,Хблэйз,howling-fjord,288,mage,fire,9,4,5
9028,Sokardes,the-maelstrom,288,mage,fire,10,4,6
9029,Колтрэйн,blackscar,288,mage,fire,9,3,6
9030,Kyrn,zuljin,288,mage,fire,10,3,7
9031,Niivel,ysondre,288,mage,fire,12,3,9
9032,Frökenfrost,stormscale,288,mage,fire,12,3,9
9033,Aylan,kazzak,288,mage,fire,12,3,9
9034,Trenpapi,twisting-nether,288,mage,fire,12,3,9
9035,Rasaku,argent-dawn,288,mage,fire,12,3,9
9036,Oblív,ravencrest,288,mage,fire,12,3,9
9037,Anshara,stormscale,287,mage,fire,6,3,3
9038,Rasputina,blackrock,287,mage,fire,23,7,16
9039,Ceanna,argent-dawn,287,mage,fire,12,3,9
9040,Regenn,kazzak,286,mage,fire,6,3,3
9041,Critr,sylvanas,239,mage,fire,5,3,2
9042,Arcandor,tarren-mill,192,mage,fire,6,2,4
9043,Wenndrid,draenor,192,mage,fire,6,2,4
9044,Димаскунфу,howling-fjord,192,mage,fire,6,2,4
9045,Malshash,outland,192,mage,fire,6,2,4
9046,Zeklo,frostmane,192,mage,fire,6,2,4
9047,Transformo,draenor,192,mage,fire,6,2,4
9048,Vantimere,twisting-nether,192,mage,fire,6,2,4
9049,Roberx,sanguino,192,mage,fire,6,2,4
9050,Kilféfroid,ysondre,192,mage,fire,6,2,4
9051,Magenox,blackrock,192,mage,fire,6,2,4
9052,Elynaé,draenor,192,mage,fire,6,2,4
9053,Milminmage,ravencrest,192,mage,fire,6,2,4
9054,Watchmeclic,archimonde,192,mage,fire,6,2,4
9055,Beardmorph,auchindoun,192,mage,fire,6,2,4
9056,Alarak,drakthul,192,mage,fire,6,2,4
9057,Hopewell,aszune,192,mage,fire,6,2,4
9058,Lupuus,anubarak,192,mage,fire,6,2,4
9059,Szarbán,ragnaros,192,mage,fire,6,2,4
9060,Аквамелис,gordunni,192,mage,fire,6,2,4
9061,Abêj,malygos,192,mage,fire,6,2,4
9062,Firedeáth,kazzak,192,mage,fire,6,2,4
9063,Dnt,twilights-hammer,192,mage,fire,6,2,4
9064,Atzin,sanguino,192,mage,fire,6,2,4
9065,Letitsnow,ravencrest,192,mage,fire,6,2,4
9066,Zerobelow,silvermoon,192,mage,fire,6,2,4
9067,Mesvef,archimonde,192,mage,fire,12,2,10
9068,Kyani,mannoroth,192,mage,fire,12,2,10
9069,Çatàclysmík,kazzak,192,mage,fire,12,2,10
9070,Zoot,ravencrest,192,mage,fire,12,2,10
9071,Firelight,argent-dawn,192,mage,fire,12,2,10
9072,Nötmârtònxø,ragnaros,192,mage,fire,12,2,10
9073,Veveroiu,defias-brotherhood,191,mage,fire,6,2,4
9074,Nabucor,culte-de-la-rive-noire,190,mage,fire,13,3,10
9075,Shizzy,onyxia,96,mage,fire,9,2,7
9076,Phenoxi,sylvanas,96,mage,fire,6,1,5
9077,Пламяорды,soulflayer,96,mage,fire,6,1,5
9078,Waan,sylvanas,96,mage,fire,6,1,5
9079,Овеча,gordunni,96,mage,fire,6,1,5
9080,Símple,sylvanas,96,mage,fire,6,1,5
9081,Nodnarb,dragonblight,96,mage,fire,6,1,5
9082,Варриморыч,soulflayer,96,mage,fire,6,1,5
9083,Slashlife,wrathbringer,96,mage,fire,6,1,5
9084,Moleester,twisting-nether,96,mage,fire,6,1,5
9085,Tsungy,twisting-nether,96,mage,fire,6,1,5
9086,Radagulf,outland,96,mage,fire,6,1,5
9087,Røvso,ragnaros,96,mage,fire,6,1,5
9088,Мэджиксул,grom,96,mage,fire,6,1,5
9089,Фантомланс,howling-fjord,96,mage,fire,6,1,5
9090,Megancox,blackmoore,96,mage,fire,6,1,5
9091,Alaster,culte-de-la-rive-noire,96,mage,fire,6,1,5
9092,Миднаит,gordunni,96,mage,fire,6,1,5
9093,Дизордерх,gordunni,96,mage,fire,6,1,5
9094,Polÿmorph,stormscale,96,mage,fire,6,1,5
9095,Satheril,argent-dawn,96,mage,fire,6,1,5
9096,Wîtchcurse,dentarg,96,mage,fire,6,1,5
9097,Akadran,blackmoore,96,mage,fire,6,1,5
9098,Ckrax,sanguino,96,mage,fire,6,1,5
9099,Roey,defias-brotherhood,96,mage,fire,6,1,5
9100,Mexxî,thrall,96,mage,fire,6,1,5
9101,Mallphass,dalaran,96,mage,fire,12,1,11
9102,Shâdozy,blackmoore,89,mage,fire,6,3,3
9103,Preí,archimonde,42,mage,fire,12,3,9
9104,Озобочений,greymane,31,mage,fire,2,1,1
9105,Ðøæø,twisting-nether,16,mage,fire,1,1,0
9106,Worstwòrld,draenor,16,mage,fire,1,1,0
9107,Partypower,twisting-nether,2252,mage,frost,129,68,61
9108,Chikounet,archimonde,2188,mage,frost,150,78,72
9109,Avizura,kazzak,2134,mage,frost,60,35,25
9110,Dastion,ravencrest,2105,mage,frost,91,45,46
9111,Oseri,defias-brotherhood,2037,mage,frost,119,60,59
9112,Serctheone,ravencrest,2034,mage,frost,108,53,55
9113,Sóz,ravencrest,2033,mage,frost,97,45,52
9114,Fakér,ravencrest,1994,mage,frost,142,65,77
9115,Барсуктри,deathguard,1942,mage,frost,54,27,27
9116,Efes,dun-modr,1934,mage,frost,58,32,26
9117,Nilitar,kazzak,1910,mage,frost,60,24,36
9118,Watchmeclick,archimonde,1909,mage,frost,36,20,16
9119,Auchenax,argent-dawn,1902,mage,frost,131,68,63
9120,Søz,agamaggan,1899,mage,frost,65,31,34
9121,Sukmikok,twisting-nether,1889,mage,frost,102,50,52
9122,Rekzaop,ravencrest,1886,mage,frost,72,34,38
9123,Drfeeldgoodd,mazrigos,1880,mage,frost,60,29,31
9124,Løwskìll,outland,1867,mage,frost,78,47,31
9125,Praison,defias-brotherhood,1863,mage,frost,54,32,22
9126,Shíróyama,ravencrest,1849,mage,frost,132,77,55
9127,Макотшельник,gordunni,1838,mage,frost,36,25,11
9128,Aìnz,hyjal,1837,mage,frost,60,27,33
9129,Rosady,ragnaros,1836,mage,frost,72,37,35
9130,Exone,sylvanas,1828,mage,frost,66,32,34
9131,Мэдвэйз,gordunni,1819,mage,frost,48,31,17
9132,Gavno,ravencrest,1815,mage,frost,36,19,17
9133,Zhodusqt,ragnaros,1808,mage,frost,48,24,24
9134,Øscarwizyo,ravencrest,1807,mage,frost,36,19,17
9135,Xmoo,blackrock,1805,mage,frost,48,24,24
9136,Novaco,ravencrest,1805,mage,frost,59,29,30
9137,Незерёб,soulflayer,1803,mage,frost,48,24,24
9138,Tellysia,blackmoore,1802,mage,frost,47,26,21
9139,Símple,sylvanas,1802,mage,frost,60,27,33
9140,Lidely,kazzak,1800,mage,frost,30,19,11
9141,Zøe,aggra-português,1800,mage,frost,54,34,20
9142,Knometsj,ravencrest,1796,mage,frost,48,26,22
9143,Èverix,ravencrest,1793,mage,frost,100,43,57
9144,Bombswag,bloodhoof,1776,mage,frost,65,33,32
9145,Медивера,gordunni,1776,mage,frost,54,27,27
9146,Rambau,archimonde,1771,mage,frost,156,78,78
9147,Ovrpwrdxd,kazzak,1763,mage,frost,24,20,4
9148,Wmp,ravencrest,1763,mage,frost,42,23,19
9149,Henqo,burning-legion,1762,mage,frost,58,25,33
9150,Shakéx,outland,1758,mage,frost,51,26,25
9151,Onnÿy,dun-modr,1749,mage,frost,50,25,25
9152,Колинас,soulflayer,1748,mage,frost,101,50,51
9153,Nightfee,eredar,1745,mage,frost,42,21,21
9154,Setyouoncs,ravencrest,1729,mage,frost,42,25,17
9155,Neymar,aszune,1725,mage,frost,35,24,11
9156,Blackfirez,ravencrest,1725,mage,frost,30,18,12
9157,Mexxî,thrall,1719,mage,frost,72,37,35
9158,Tánu,quelthalas,1717,mage,frost,66,32,34
9159,Vilenciaga,kazzak,1716,mage,frost,60,34,26
9160,Jaimey,blackhand,1715,mage,frost,143,67,76
9161,Swizzy,arathor,1713,mage,frost,58,33,25
9162,Ввнд,galakrond,1713,mage,frost,48,18,30
9163,Lorothar,blackhand,1712,mage,frost,60,24,36
9164,Zimbabweborc,burning-legion,1706,mage,frost,48,30,18
9165,Pryt,ragnaros,1699,mage,frost,96,53,43
9166,Mlodysimba,burning-legion,1699,mage,frost,47,25,22
9167,Tfmchamp,ravencrest,1698,mage,frost,33,22,11
9168,Sâkuya,blackrock,1697,mage,frost,80,37,43
9169,Girldalf,silvermoon,1695,mage,frost,131,68,63
9170,Oscarwizyo,ravencrest,1695,mage,frost,50,20,30
9171,Ёкай,soulflayer,1690,mage,frost,78,53,25
9172,Tommy,laughing-skull,1690,mage,frost,35,18,17
9173,Ãshs,archimonde,1690,mage,frost,48,20,28
9174,Jirø,cthun,1688,mage,frost,40,23,17
9175,Алаурс,howling-fjord,1686,mage,frost,42,22,20
9176,Buddi,burning-blade,1685,mage,frost,227,120,107
9177,Jenggot,ravencrest,1681,mage,frost,35,18,17
9178,Silverlining,ravencrest,1679,mage,frost,36,18,18
9179,Vilain,tarren-mill,1678,mage,frost,35,18,17
9180,Raíner,eredar,1675,mage,frost,66,37,29
9181,Soloqtarget,archimonde,1675,mage,frost,92,44,48
9182,Bestial,alexstrasza,1672,mage,frost,58,27,31
9183,Alearis,die-aldor,1667,mage,frost,36,20,16
9184,Stickiburn,malganis,1667,mage,frost,51,23,28
9185,Sylbris,outland,1665,mage,frost,42,20,22
9186,Gossipgirlz,outland,1664,mage,frost,178,85,93
9187,Ironhood,nemesis,1656,mage,frost,30,18,12
9188,Гекомория,fordragon,1654,mage,frost,74,39,35
9189,Naynn,archimonde,1651,mage,frost,34,21,13
9190,Zoot,ravencrest,1649,mage,frost,48,18,30
9191,Crylz,kazzak,1644,mage,frost,41,20,21
9192,Afterimage,zuljin,1641,mage,frost,80,39,41
9193,Nickg,ravencrest,1636,mage,frost,42,21,21
9194,Magerocks,ragnaros,1635,mage,frost,36,20,16
9195,Sondremage,outland,1635,mage,frost,134,60,74
9196,Äntigood,outland,1633,mage,frost,53,27,26
9197,Манахк,gordunni,1631,mage,frost,42,19,23
9198,Asiman,eredar,1631,mage,frost,51,22,29
9199,Thesiôu,ravencrest,1629,mage,frost,36,20,16
9200,Kurtkiels,draenor,1627,mage,frost,36,17,19
9201,Glowie,stormreaver,1623,mage,frost,36,20,16
9202,Xenant,ravencrest,1623,mage,frost,42,18,24
9203,Frostgodxqt,ravencrest,1622,mage,frost,55,30,25
9204,Blasty,guldan,1622,mage,frost,57,25,32
9205,Thinamerican,defias-brotherhood,1620,mage,frost,24,18,6
9206,Sykz,hyjal,1617,mage,frost,65,35,30
9207,Bigkent,stormscale,1614,mage,frost,42,20,22
9208,Kiirin,drakthul,1613,mage,frost,39,23,16
9209,Cleophe,burning-legion,1611,mage,frost,30,17,13
9210,Xæll,silvermoon,1611,mage,frost,114,61,53
9211,Joulz,ravencrest,1611,mage,frost,86,38,48
9212,Fireblood,runetotem,1610,mage,frost,48,21,27
9213,Tills,kargath,1606,mage,frost,42,20,22
9214,Excuses,chamber-of-aspects,1604,mage,frost,75,37,38
9215,Magethings,kazzak,1603,mage,frost,54,25,29
9216,Bzzr,tarren-mill,1601,mage,frost,54,35,19
9217,Mecharience,rexxar,1597,mage,frost,33,18,15
9218,Левелнес,howling-fjord,1597,mage,frost,62,27,35
9219,Datpolytho,twisting-nether,1596,mage,frost,48,34,14
9220,Ôbsury,hyjal,1588,mage,frost,42,24,18
9221,Rihnou,blackmoore,1583,mage,frost,53,23,30
9222,Itzlucky,twisting-nether,1582,mage,frost,105,53,52
9223,Ímnotback,outland,1578,mage,frost,78,45,33
9224,Sunehx,blackrock,1578,mage,frost,36,19,17
9225,Ceillech,blackrock,1578,mage,frost,71,36,35
9226,Petepan,argent-dawn,1578,mage,frost,42,20,22
9227,Lo,kilrogg,1578,mage,frost,69,29,40
9228,Райоми,fordragon,1575,mage,frost,61,30,31
9229,Мибринк,soulflayer,1575,mage,frost,72,32,40
9230,Beaun,tarren-mill,1570,mage,frost,54,31,23
9231,Ингилейф,howling-fjord,1570,mage,frost,46,18,28
9232,Демолюшн,soulflayer,1569,mage,frost,47,21,26
9233,Вендайса,soulflayer,1565,mage,frost,186,112,74
9234,Бингчилинг,howling-fjord,1561,mage,frost,61,30,31
9235,Iroya,festung-der-stürme,1561,mage,frost,96,47,49
9236,Chareyla,argent-dawn,1558,mage,frost,83,42,41
9237,Gaduz,kazzak,1556,mage,frost,72,31,41
9238,Sheepthrillz,blackmoore,1536,mage,frost,30,18,12
9239,Вольняша,azuregos,1534,mage,frost,106,44,62
9240,Tiqma,sylvanas,1528,mage,frost,30,16,14
9241,Сосулькина,gordunni,1520,mage,frost,77,42,35
9242,Arimila,sylvanas,1519,mage,frost,94,43,51
9243,Phélenia,sargeras,1516,mage,frost,48,24,24
9244,Gêrky,drakthul,1507,mage,frost,84,44,40
9245,Óuíja,outland,1504,mage,frost,33,19,14
9246,Trowbe,blackmoore,1504,mage,frost,30,16,14
9247,Корадо,gordunni,1502,mage,frost,90,39,51
9248,Comodus,ragnaros,1500,mage,frost,78,37,41
9249,Fullpolly,twisting-nether,1493,mage,frost,30,19,11
9250,Únna,sanguino,1493,mage,frost,51,29,22
9251,Surlancealot,outland,1488,mage,frost,41,17,24
9252,Джейнанис,gordunni,1483,mage,frost,30,17,13
9253,Саваннхмаег,blackscar,1482,mage,frost,33,18,15
9254,Find,archimonde,1479,mage,frost,47,20,27
9255,Тачмахал,soulflayer,1478,mage,frost,60,31,29
9256,Qqpwn,ragnaros,1477,mage,frost,65,32,33
9257,Магсимум,ashenvale,1476,mage,frost,30,18,12
9258,Octtmiss,twisting-nether,1476,mage,frost,33,17,16
9259,Dzikk,silvermoon,1474,mage,frost,48,24,24
9260,Plætinum,ravencrest,1473,mage,frost,108,55,53
9261,Ghalanz,ravencrest,1473,mage,frost,54,23,31
9262,Maquiwizz,aggra-português,1472,mage,frost,42,22,20
9263,Quinella,ravencrest,1470,mage,frost,48,21,27
9264,Shainax,dun-modr,1466,mage,frost,88,45,43
9265,Fïttan,stormscale,1464,mage,frost,44,20,24
9266,Widmage,silvermoon,1457,mage,frost,66,25,41
9267,Emoden,silvermoon,1455,mage,frost,119,56,63
9268,Lesoleil,archimonde,1453,mage,frost,30,19,11
9269,Khivax,twisting-nether,1448,mage,frost,66,27,39
9270,Woorm,sylvanas,1446,mage,frost,76,44,32
9271,Eldariel,ravencrest,1446,mage,frost,53,24,29
9272,Laurents,silvermoon,1443,mage,frost,86,51,35
9273,Afklow,pozzo-delleternità,1442,mage,frost,39,21,18
9274,Demensida,ravencrest,1439,mage,frost,70,33,37
9275,Animaze,argent-dawn,1436,mage,frost,131,79,52
9276,Iggilaus,blackhand,1436,mage,frost,167,87,80
9277,Hayaka,sanguino,1435,mage,frost,59,30,29
9278,Polÿmorph,stormscale,1434,mage,frost,24,15,9
9279,Cheerió,aggramar,1431,mage,frost,138,63,75
9280,Nimdáá,stormscale,1429,mage,frost,85,49,36
9281,Alkhazzar,defias-brotherhood,1428,mage,frost,84,37,47
9282,Absoluteswag,tarren-mill,1416,mage,frost,33,16,17
9283,Гатмир,gordunni,1416,mage,frost,77,37,40
9284,Tôke,kaelthas,1410,mage,frost,60,33,27
9285,Pipihu,silvermoon,1409,mage,frost,54,27,27
9286,Синийлед,galakrond,1408,mage,frost,54,25,29
9287,Elcølgaø,sanguino,1406,mage,frost,90,39,51
9288,Shüri,kazzak,1404,mage,frost,60,35,25
9289,Rexør,frostwolf,1404,mage,frost,36,19,17
9290,Missl,draenor,1403,mage,frost,26,16,10
9291,Shinzel,hyjal,1403,mage,frost,54,24,30
9292,Pluribusunum,outland,1398,mage,frost,38,17,21
9293,Fractox,ysondre,1391,mage,frost,65,36,29
9294,Ymirë,khaz-modan,1391,mage,frost,45,20,25
9295,Icefix,dun-modr,1377,mage,frost,59,29,30
9296,Caesarclown,silvermoon,1372,mage,frost,98,49,49
9297,Цепнойпёс,goldrinn,1371,mage,frost,34,17,17
9298,Орижн,howling-fjord,1360,mage,frost,35,20,15
9299,Sekulicgoga,draenor,1360,mage,frost,171,94,77
9300,Smöked,tarren-mill,1350,mage,frost,252,128,124
9301,Søphiâ,thrall,1347,mage,frost,45,25,20
9302,Jíncks,anachronos,1344,mage,frost,24,14,10
9303,Preí,archimonde,1344,mage,frost,37,15,22
9304,Mxrrz,kazzak,1343,mage,frost,91,44,47
9305,Apócalyptic,tarren-mill,1340,mage,frost,64,36,28
9306,Spelltastíc,blackmoore,1333,mage,frost,24,14,10
9307,Iulie,kazzak,1331,mage,frost,42,19,23
9308,Sused,outland,1321,mage,frost,30,16,14
9309,Alicánte,silvermoon,1320,mage,frost,48,18,30
9310,Stillfrostin,blackrock,1319,mage,frost,42,25,17
9311,Walian,burning-blade,1319,mage,frost,24,14,10
9312,Гунмаказ,soulflayer,1318,mage,frost,22,16,6
9313,Mdog,stormreaver,1317,mage,frost,68,35,33
9314,Nups,ravencrest,1315,mage,frost,60,24,36
9315,Ðeejkñ,archimonde,1310,mage,frost,20,15,5
9316,Tàylerdarden,nemesis,1310,mage,frost,29,14,15
9317,Immobilizer,eredar,1310,mage,frost,48,23,25
9318,Firehasse,draenor,1309,mage,frost,60,32,28
9319,Iceterror,ravencrest,1300,mage,frost,24,15,9
9320,Psychosiss,kazzak,1298,mage,frost,49,27,22
9321,Abolf,twisting-nether,1288,mage,frost,30,16,14
9322,Кройзис,howling-fjord,1278,mage,frost,36,21,15
9323,Destruct,doomhammer,1277,mage,frost,30,18,12
9324,Jedite,die-todeskrallen,1269,mage,frost,52,25,27
9325,Leafløver,ravencrest,1267,mage,frost,29,14,15
9326,Айсбоунт,eversong,1265,mage,frost,37,25,12
9327,Дырявка,galakrond,1263,mage,frost,54,23,31
9328,Braxxorz,chamber-of-aspects,1261,mage,frost,36,24,12
9329,Bebarz,darksorrow,1261,mage,frost,36,16,20
9330,Corpusqq,eredar,1261,mage,frost,36,15,21
9331,Lovësosa,hyjal,1260,mage,frost,41,20,21
9332,Homellander,silvermoon,1258,mage,frost,64,32,32
9333,Seelengott,onyxia,1253,mage,frost,103,52,51
9334,Laynerz,kazzak,1248,mage,frost,19,13,6
9335,Pwntt,terenas,1248,mage,frost,39,15,24
9336,Anaxtra,guldan,1244,mage,frost,24,13,11
9337,Nebbur,dun-modr,1243,mage,frost,30,13,17
9338,Oiklo,eitrigg,1243,mage,frost,49,19,30
9339,Xânârchy,minahonda,1242,mage,frost,72,33,39
9340,Jackin,burning-legion,1241,mage,frost,48,21,27
9341,Mgtowforlife,ravencrest,1241,mage,frost,36,13,23
9342,Melíssa,silvermoon,1240,mage,frost,18,13,5
9343,Pizit,ravencrest,1229,mage,frost,24,13,11
9344,Tromie,archimonde,1229,mage,frost,29,15,14
9345,Kaaguraa,ravencrest,1228,mage,frost,42,22,20
9346,Iceorb,azshara,1227,mage,frost,30,13,17
9347,Boredpeon,burning-legion,1225,mage,frost,30,16,14
9348,Alktraz,outland,1223,mage,frost,30,13,17
9349,Хблэйз,howling-fjord,1218,mage,frost,24,13,11
9350,Laenadria,argent-dawn,1218,mage,frost,36,13,23
9351,Suidas,auchindoun,1217,mage,frost,66,28,38
9352,Pyroden,stormscale,1216,mage,frost,30,14,16
9353,Лутиум,howling-fjord,1210,mage,frost,139,76,63
9354,Scaless,stormscale,1209,mage,frost,58,28,30
9355,Хируэль,gordunni,1208,mage,frost,30,14,16
9356,Silvariy,stormscale,1204,mage,frost,100,48,52
9357,Rektd,blackhand,1200,mage,frost,51,20,31
9358,Tradez,norgannon,1197,mage,frost,36,13,23
9359,Misscandy,doomhammer,1196,mage,frost,42,18,24
9360,Сибиди,gordunni,1185,mage,frost,24,13,11
9361,Latiny,destromath,1184,mage,frost,35,17,18
9362,Fleurdelacur,ravencrest,1182,mage,frost,57,29,28
9363,Teuboku,ysondre,1180,mage,frost,25,15,10
9364,Дарнивил,gordunni,1178,mage,frost,108,46,62
9365,Akúmã,stormscale,1171,mage,frost,24,14,10
9366,Zvuta,sanguino,1166,mage,frost,18,14,4
9367,Саназэр,soulflayer,1163,mage,frost,36,17,19
9368,Bossgb,twisting-nether,1160,mage,frost,27,15,12
9369,Katarapower,silvermoon,1158,mage,frost,96,41,55
9370,Baravar,blackrock,1155,mage,frost,35,14,21
9371,Gliffy,terokkar,1152,mage,frost,37,22,15
9372,Lyndsey,dalaran,1152,mage,frost,24,12,12
9373,Noxkin,stormscale,1151,mage,frost,24,12,12
9374,Xall,silvermoon,1148,mage,frost,18,12,6
9375,Koreanbbq,outland,1148,mage,frost,30,12,18
9376,Kippercarry,outland,1144,mage,frost,24,12,12
9377,Zionw,frostwolf,1142,mage,frost,24,12,12
9378,Qulinx,kazzak,1142,mage,frost,29,13,16
9379,Айсвеном,gordunni,1142,mage,frost,30,13,17
9380,Вельдрик,soulflayer,1136,mage,frost,64,31,33
9381,Oathkeepper,silvermoon,1134,mage,frost,76,36,40
9382,Morphees,twisting-nether,1132,mage,frost,18,12,6
9383,Iamslow,sylvanas,1130,mage,frost,18,12,6
9384,Amicuta,ravencrest,1125,mage,frost,42,20,22
9385,Jodiefroster,bronzebeard,1121,mage,frost,30,16,14
9386,Shalien,tarren-mill,1117,mage,frost,23,12,11
9387,Saphiregos,dalaran,1110,mage,frost,60,29,31
9388,Snowrain,chogall,1099,mage,frost,29,16,13
9389,Réd,earthen-ring,1098,mage,frost,35,12,23
9390,Pruneau,hyjal,1094,mage,frost,30,12,18
9391,Левченкопро,soulflayer,1088,mage,frost,41,16,25
9392,Zedsdeadbaby,argent-dawn,1083,mage,frost,27,15,12
9393,Goeb,kazzak,1083,mage,frost,35,14,21
9394,Qtiepatootie,silvermoon,1077,mage,frost,85,48,37
9395,Haljina,kazzak,1066,mage,frost,102,44,58
9396,Дедамаг,eversong,1064,mage,frost,36,18,18
9397,Tacto,ravencrest,1061,mage,frost,94,44,50
9398,Lifemagic,chamber-of-aspects,1058,mage,frost,72,36,36
9399,Лемозяра,gordunni,1056,mage,frost,12,11,1
9400,Emerlyn,ragnaros,1056,mage,frost,18,11,7
9401,Soz,agamaggan,1056,mage,frost,18,11,7
9402,Sìsia,ragnaros,1056,mage,frost,18,11,7
9403,Jocelynn,aggramar,1056,mage,frost,24,11,13
9404,Hazzá,ravencrest,1055,mage,frost,18,11,7
9405,Rere,zenedar,1054,mage,frost,26,13,13
9406,Samath,conseil-des-ombres,1054,mage,frost,30,11,19
9407,Викликс,borean-tundra,1052,mage,frost,22,13,9
9408,Hernêise,silvermoon,1050,mage,frost,18,11,7
9409,Файрусх,blackscar,1049,mage,frost,18,11,7
9410,Roughfked,silvermoon,1049,mage,frost,42,23,19
9411,Férécide,ysondre,1045,mage,frost,30,11,19
9412,Khoshgele,draenor,1039,mage,frost,24,11,13
9413,Winterblues,frostmourne,1037,mage,frost,24,11,13
9414,Heavyfire,kazzak,1034,mage,frost,18,11,7
9415,Clonefcf,sylvanas,1032,mage,frost,55,31,24
9416,Forestie,silvermoon,1032,mage,frost,50,23,27
9417,Schtenen,silvermoon,1028,mage,frost,80,34,46
9418,Arkhaen,archimonde,1022,mage,frost,23,11,12
9419,Мрперут,eversong,1008,mage,frost,54,32,22
9420,Илайла,booty-bay,1007,mage,frost,15,12,3
9421,Broduy,draenor,1005,mage,frost,36,12,24
9422,Margistikus,die-aldor,1003,mage,frost,90,50,40
9423,Ramcoz,twisting-nether,1000,mage,frost,24,12,12
9424,Momotemp,emerald-dream,994,mage,frost,62,25,37
9425,Erzà,todeswache,992,mage,frost,23,13,10
9426,Slobbery,aggramar,990,mage,frost,20,11,9
9427,Инкрионити,gordunni,989,mage,frost,17,11,6
9428,Kumakara,archimonde,981,mage,frost,24,12,12
9429,Dnt,twilights-hammer,974,mage,frost,24,11,13
9430,Niivel,ysondre,972,mage,frost,66,37,29
9431,Ryzea,ravencrest,968,mage,frost,17,12,5
9432,Acx,drakthul,960,mage,frost,18,10,8
9433,Santriss,defias-brotherhood,960,mage,frost,24,10,14
9434,Borêta,blackrock,959,mage,frost,18,10,8
9435,Vannq,silvermoon,959,mage,frost,18,10,8
9436,Гамаюнх,deathguard,959,mage,frost,18,10,8
9437,Тортикток,soulflayer,959,mage,frost,24,10,14
9438,Манакса,gordunni,959,mage,frost,24,10,14
9439,Discomorph,the-maelstrom,957,mage,frost,18,10,8
9440,Zenó,blackrock,956,mage,frost,30,10,20
9441,Stryee,ragnaros,954,mage,frost,18,10,8
9442,Gacosane,chamber-of-aspects,952,mage,frost,24,10,14
9443,Nightplays,sylvanas,951,mage,frost,18,10,8
9444,Quincy,frostwolf,951,mage,frost,18,10,8
9445,Celdra,blackrock,949,mage,frost,24,10,14
9446,Этридемус,howling-fjord,947,mage,frost,30,10,20
9447,Fashes,sunstrider,946,mage,frost,60,28,32
9448,Evuryl,nemesis,944,mage,frost,18,10,8
9449,Морозящий,howling-fjord,940,mage,frost,18,10,8
9450,Aileean,burning-legion,940,mage,frost,24,10,14
9451,Килавый,eversong,938,mage,frost,12,10,2
9452,Speedshatter,aegwynn,928,mage,frost,22,10,12
9453,Блья,howling-fjord,918,mage,frost,18,11,7
9454,Ghostgivree,archimonde,917,mage,frost,30,16,14
9455,Ттэль,gordunni,900,mage,frost,16,11,5
9456,Døliprane,garona,900,mage,frost,36,19,17
9457,Iceym,ravencrest,891,mage,frost,26,11,15
9458,Amazona,veklor,889,mage,frost,32,16,16
9459,Êmmá,blackmoore,885,mage,frost,54,22,32
9460,Piego,turalyon,883,mage,frost,30,16,14
9461,Xæl,ravencrest,866,mage,frost,57,27,30
9462,Ney,drakthul,864,mage,frost,12,9,3
9463,Goneforever,draenor,864,mage,frost,12,9,3
9464,Manafuzz,outland,864,mage,frost,12,9,3
9465,Fakeklepter,sylvanas,864,mage,frost,12,9,3
9466,Старкскрим,gordunni,864,mage,frost,12,9,3
9467,Baconlance,stormscale,864,mage,frost,18,9,9
9468,Tagrine,kaelthas,864,mage,frost,18,9,9
9469,Medara,darkspear,864,mage,frost,18,9,9
9470,Sorrow,outland,864,mage,frost,18,9,9
9471,Nozarashí,hyjal,864,mage,frost,22,10,12
9472,Esscheppert,blackrock,864,mage,frost,24,9,15
9473,Мэтаскрим,soulflayer,864,mage,frost,24,9,15
9474,Djdankzter,outland,864,mage,frost,30,9,21
9475,Abovè,outland,864,mage,frost,30,9,21
9476,Blinklet,twisting-nether,863,mage,frost,16,10,6
9477,Scoodles,kazzak,863,mage,frost,18,9,9
9478,Muchmage,silvermoon,863,mage,frost,24,9,15
9479,Layzzy,kazzak,863,mage,frost,30,9,21
9480,Манднесс,azuregos,861,mage,frost,18,9,9
9481,Strychne,ragnaros,860,mage,frost,12,9,3
9482,Frisstana,outland,859,mage,frost,18,9,9
9483,Naote,blackhand,858,mage,frost,18,9,9
9484,Meydoum,archimonde,858,mage,frost,18,9,9
9485,Klésh,nemesis,858,mage,frost,18,9,9
9486,Suikune,twisting-nether,857,mage,frost,12,9,3
9487,Bolesnimage,draenor,857,mage,frost,18,9,9
9488,Юлианх,gordunni,856,mage,frost,220,99,121
9489,Voralastor,doomhammer,855,mage,frost,12,9,3
9490,Farrä,dun-modr,854,mage,frost,53,26,27
9491,Вайконд,howling-fjord,853,mage,frost,24,9,15
9492,Nazø,archimonde,853,mage,frost,24,9,15
9493,Iceicebáby,draenor,845,mage,frost,24,9,15
9494,Ezzekkiel,elune,835,mage,frost,18,9,9
9495,Isolia,silvermoon,810,mage,frost,23,9,14
9496,Lemonshelo,archimonde,806,mage,frost,27,9,18
9497,Bengé,ragnaros,796,mage,frost,16,9,7
9498,Akâri,silvermoon,784,mage,frost,25,9,16
9499,Serclulz,ravencrest,768,mage,frost,12,8,4
9500,Subzeraxo,archimonde,768,mage,frost,12,8,4
9501,Séxmachiné,draenor,768,mage,frost,12,8,4
9502,Mðj,kazzak,768,mage,frost,18,8,10
9503,Transformo,draenor,768,mage,frost,18,8,10
9504,Track,blackhand,768,mage,frost,18,8,10
9505,Väänik,draenor,768,mage,frost,18,8,10
9506,Гдедипфриз,soulflayer,768,mage,frost,18,8,10
9507,Zelimeth,outland,768,mage,frost,24,8,16
9508,Нереварин,soulflayer,768,mage,frost,24,8,16
9509,Ewina,twisting-nether,767,mage,frost,12,8,4
9510,Necizbored,tarren-mill,767,mage,frost,12,8,4
9511,Tajos,drakthul,767,mage,frost,12,8,4
9512,Gagaj,ravencrest,767,mage,frost,12,8,4
9513,Chicke,outland,767,mage,frost,12,8,4
9514,Zili,draenor,767,mage,frost,12,8,4
9515,Фростидзе,gordunni,767,mage,frost,18,8,10
9516,Helminsterr,archimonde,767,mage,frost,18,8,10
9517,Magebotgril,dun-morogh,767,mage,frost,18,8,10
9518,Quilava,ghostlands,766,mage,frost,12,8,4
9519,Insanewizard,kazzak,766,mage,frost,12,8,4
9520,Игрдлпдров,gordunni,766,mage,frost,18,8,10
9521,Ærrflôw,frostwolf,765,mage,frost,18,8,10
9522,Xakiha,kazzak,764,mage,frost,18,8,10
9523,Кельтузат,azuregos,762,mage,frost,12,8,4
9524,Lêgólás,blackmoore,762,mage,frost,18,8,10
9525,Dominos,medivh,762,mage,frost,18,8,10
9526,Frigus,khaz-modan,761,mage,frost,24,8,16
9527,Леракобольд,gordunni,745,mage,frost,29,10,19
9528,Lexalia,blackmoore,744,mage,frost,24,9,15
9529,Kapueca,jaedenar,736,mage,frost,15,9,6
9530,Amalou,stormscale,729,mage,frost,32,9,23
9531,Hetaxata,kazzak,719,mage,frost,15,9,6
9532,Fîsheye,blackrock,672,mage,frost,12,7,5
9533,Cardioexpert,ravencrest,672,mage,frost,12,7,5
9534,Qtpoof,sylvanas,672,mage,frost,12,7,5
9535,Lyès,uldaman,672,mage,frost,12,7,5
9536,Yobys,burning-legion,672,mage,frost,12,7,5
9537,Agus,ravencrest,672,mage,frost,12,7,5
9538,Axhole,darksorrow,672,mage,frost,12,7,5
9539,Skyblink,hyjal,672,mage,frost,12,7,5
9540,Sangumage,silvermoon,672,mage,frost,12,7,5
9541,Evilmagíc,tarren-mill,672,mage,frost,12,7,5
9542,Mageyreid,quelthalas,672,mage,frost,18,7,11
9543,Миднаит,gordunni,672,mage,frost,18,7,11
9544,Чистокрут,gordunni,672,mage,frost,18,7,11
9545,Vinlimar,drakthul,672,mage,frost,18,7,11
9546,Aterso,azshara,672,mage,frost,21,8,13
9547,Krookéd,tarren-mill,672,mage,frost,24,7,17
9548,Фемна,soulflayer,671,mage,frost,12,7,5
9549,Kaì,twisting-nether,671,mage,frost,12,7,5
9550,Geepie,twisting-nether,671,mage,frost,12,7,5
9551,Badphaz,frostmane,671,mage,frost,12,7,5
9552,Ice,sargeras,671,mage,frost,18,7,11
9553,Zoubaz,archimonde,671,mage,frost,18,7,11
9554,Däpper,ragnaros,671,mage,frost,18,7,11
9555,Frostvirgin,twisting-nether,671,mage,frost,18,7,11
9556,Daneliam,outland,670,mage,frost,18,7,11
9557,Unreadyx,archimonde,670,mage,frost,18,7,11
9558,Irreversal,ravencrest,669,mage,frost,12,7,5
9559,Titanshao,silvermoon,669,mage,frost,12,7,5
9560,Lenycz,burning-blade,668,mage,frost,18,7,11
9561,Lukewizard,twisting-nether,668,mage,frost,18,7,11
9562,Toxttr,drakthul,657,mage,frost,12,7,5
9563,Helloimgone,blackmoore,655,mage,frost,17,7,10
9564,Psika,kazzak,623,mage,frost,17,7,10
9565,Skæde,ravencrest,618,mage,frost,17,11,6
9566,Escapematrix,ravencrest,576,mage,frost,6,6,0
9567,Estonka,ravencrest,576,mage,frost,6,6,0
9568,Джинетикс,deathguard,576,mage,frost,12,6,6
9569,Nécrømage,confrérie-du-thorium,576,mage,frost,12,6,6
9570,Lepronsito,kazzak,576,mage,frost,12,6,6
9571,Skdroople,ravencrest,576,mage,frost,12,6,6
9572,Iverson,kazzak,576,mage,frost,12,6,6
9573,Spellcast,ravencrest,576,mage,frost,12,6,6
9574,Sainth,sanguino,576,mage,frost,12,6,6
9575,Frostjävel,grim-batol,576,mage,frost,12,6,6
9576,Titarie,ravencrest,576,mage,frost,12,6,6
9577,Нонекс,soulflayer,576,mage,frost,12,6,6
9578,Watchmeclic,archimonde,576,mage,frost,12,6,6
9579,Sickofme,blackmoore,576,mage,frost,12,6,6
9580,Bumbumdead,sylvanas,576,mage,frost,12,6,6
9581,Ecnaclappy,blackrock,576,mage,frost,12,6,6
9582,Kurtcobain,draenor,576,mage,frost,12,6,6
9583,Insømnium,stormscale,576,mage,frost,12,6,6
9584,Obbjob,ravencrest,576,mage,frost,12,6,6
9585,Articunoh,ravencrest,576,mage,frost,18,6,12
9586,Слизерин,gordunni,576,mage,frost,18,6,12
9587,Ury,hyjal,576,mage,frost,18,6,12
9588,Ephixis,ravencrest,576,mage,frost,18,6,12
9589,Yshax,malganis,576,mage,frost,24,6,18
9590,Коласольдом,gordunni,575,mage,frost,12,6,6
9591,Длинныеухи,blackscar,575,mage,frost,12,6,6
9592,Pitbones,archimonde,575,mage,frost,12,6,6
9593,Flakeh,outland,575,mage,frost,18,6,12
9594,Vathalis,zuluhed,575,mage,frost,18,6,12
9595,Crackheads,hyjal,575,mage,frost,18,6,12
9596,Saturator,burning-legion,575,mage,frost,18,6,12
9597,Вхламинка,howling-fjord,574,mage,frost,12,6,6
9598,Zzombi,sylvanas,574,mage,frost,16,7,9
9599,Pinkis,darkmoon-faire,572,mage,frost,12,6,6
9600,Rafaeala,argent-dawn,572,mage,frost,12,6,6
9601,Aelire,die-aldor,527,mage,frost,15,6,9
9602,Avb,twisting-nether,527,mage,frost,17,6,11
9603,Kaeki,khaz-modan,520,mage,frost,14,8,6
9604,Miihawkk,khaz-modan,510,mage,frost,20,6,14
9605,Zehnvonzehn,antonidas,480,mage,frost,6,5,1
9606,Glindalefay,silvermoon,480,mage,frost,6,5,1
9607,Dsmoke,ravencrest,480,mage,frost,6,5,1
9608,Wortyvery,outland,480,mage,frost,6,5,1
9609,Azkarr,stormscale,480,mage,frost,6,5,1
9610,Veemi,blackmoore,480,mage,frost,6,5,1
9611,Arunx,magtheridon,480,mage,frost,6,5,1
9612,Hérä,archimonde,480,mage,frost,6,5,1
9613,Фоулли,howling-fjord,480,mage,frost,10,6,4
9614,Magnopvp,sanguino,480,mage,frost,10,6,4
9615,Thelastmage,outland,480,mage,frost,12,5,7
9616,Charliezard,argent-dawn,480,mage,frost,12,5,7
9617,Shnitz,stormscale,480,mage,frost,12,5,7
9618,Lylla,cthun,480,mage,frost,12,5,7
9619,Chrømy,twisting-nether,480,mage,frost,12,5,7
9620,Okey,frostwhisper,480,mage,frost,12,5,7
9621,Moffmage,sylvanas,480,mage,frost,12,5,7
9622,Milkenjoyer,ravencrest,480,mage,frost,12,5,7
9623,Spell,blackmoore,480,mage,frost,12,5,7
9624,Dyx,nemesis,480,mage,frost,12,5,7
9625,Reeroll,arthas,480,mage,frost,12,5,7
9626,Snowsánji,blackmoore,480,mage,frost,12,5,7
9627,Betomage,blackmoore,480,mage,frost,12,5,7
9628,Wracrz,argent-dawn,480,mage,frost,12,5,7
9629,Bamz,malganis,480,mage,frost,12,5,7
9630,Gàtsby,outland,480,mage,frost,12,5,7
9631,Primodious,kazzak,480,mage,frost,12,5,7
9632,Marikisanx,blackmoore,480,mage,frost,12,5,7
9633,Shøcked,blackrock,480,mage,frost,18,5,13
9634,Wàneís,ravencrest,480,mage,frost,18,5,13
9635,Wukidiwn,draenor,480,mage,frost,18,5,13
9636,Stîckî,malganis,480,mage,frost,18,5,13
9637,Pinguíni,aegwynn,479,mage,frost,6,5,1
9638,Fôôxy,aegwynn,479,mage,frost,12,5,7
9639,Dabina,sanguino,479,mage,frost,12,5,7
9640,Deletron,ragnaros,479,mage,frost,18,5,13
9641,Popixx,magtheridon,479,mage,frost,18,5,13
9642,Rifinouu,archimonde,476,mage,frost,12,5,7
9643,Phibonaci,sylvanas,475,mage,frost,12,5,7
9644,Мерджреквест,howling-fjord,462,mage,frost,11,5,6
9645,Blinkinggoat,ragnaros,448,mage,frost,16,5,11
9646,Zaruna,arathor,432,mage,frost,9,6,3
9647,Aerius,lightnings-blade,432,mage,frost,9,5,4
9648,Swemagus,outland,432,mage,frost,9,5,4
9649,Kelthuzed,twisting-nether,432,mage,frost,15,5,10
9650,Xerathon,ravencrest,414,mage,frost,16,5,11
9651,Leylus,blackmoore,399,mage,frost,5,5,0
9652,Pezi,outland,384,mage,frost,6,4,2
9653,Grömit,drakthul,384,mage,frost,6,4,2
9654,Scaleeth,kazzak,384,mage,frost,6,4,2
9655,Sneakii,the-maelstrom,384,mage,frost,6,4,2
9656,Ahøllic,frostwolf,384,mage,frost,6,4,2
9657,Fuhry,tarren-mill,384,mage,frost,6,4,2
9658,Ón,burning-steppes,384,mage,frost,6,4,2
9659,Chililol,dun-modr,384,mage,frost,6,4,2
9660,Kleini,die-aldor,384,mage,frost,6,4,2
9661,Crzyubrdrver,blackrock,384,mage,frost,6,4,2
9662,Zionara,stormscale,384,mage,frost,6,4,2
9663,Meign,eredar,384,mage,frost,6,4,2
9664,Zerobelow,silvermoon,384,mage,frost,6,4,2
9665,Phenoxi,sylvanas,384,mage,frost,6,4,2
9666,Goodheadcake,ragnaros,384,mage,frost,6,4,2
9667,Noviina,argent-dawn,384,mage,frost,6,4,2
9668,Doryy,silvermoon,384,mage,frost,6,4,2
9669,Nïo,ravencrest,384,mage,frost,6,4,2
9670,Pinkusbruh,aggra-português,384,mage,frost,6,4,2
9671,Botanicula,the-maelstrom,384,mage,frost,6,4,2
9672,Nötmârtònxø,ragnaros,384,mage,frost,6,4,2
9673,Cinoox,blackrock,384,mage,frost,6,4,2
9674,Nutsa,silvermoon,384,mage,frost,6,4,2
9675,Arcitech,tarren-mill,384,mage,frost,6,4,2
9676,Proudmøøre,argent-dawn,384,mage,frost,6,4,2
9677,Reflexz,thrall,384,mage,frost,6,4,2
9678,Leontus,outland,384,mage,frost,6,4,2
9679,Ðazzftw,archimonde,384,mage,frost,6,4,2
9680,Nightcàller,pozzo-delleternità,384,mage,frost,6,4,2
9681,Çana,thrall,384,mage,frost,6,4,2
9682,Альмодера,gordunni,384,mage,frost,6,4,2
9683,Пиньон,borean-tundra,384,mage,frost,6,4,2
9684,Razzìatore,pozzo-delleternità,384,mage,frost,7,4,3
9685,Пламяорды,soulflayer,384,mage,frost,12,4,8
9686,Lambaa,thrall,384,mage,frost,12,4,8
9687,Stellarie,sylvanas,384,mage,frost,12,4,8
9688,Гаразлик,howling-fjord,384,mage,frost,12,4,8
9689,Юджегс,soulflayer,384,mage,frost,12,4,8
9690,Faunas,kazzak,384,mage,frost,12,4,8
9691,Newtwo,ravencrest,384,mage,frost,12,4,8
9692,Ahdetärjag,silvermoon,384,mage,frost,12,4,8
9693,Råståfåri,uldum,384,mage,frost,12,4,8
9694,Roberx,sanguino,384,mage,frost,12,4,8
9695,Acclay,malganis,384,mage,frost,12,4,8
9696,Aern,sinstralis,384,mage,frost,12,4,8
9697,Darkoftw,ysondre,384,mage,frost,12,4,8
9698,Shakeándbake,ravencrest,384,mage,frost,12,4,8
9699,Zikyo,silvermoon,384,mage,frost,12,4,8
9700,Facerollyo,tarren-mill,384,mage,frost,12,4,8
9701,Whïm,ysondre,384,mage,frost,12,4,8
9702,Proffset,outland,384,mage,frost,12,4,8
9703,Muntiks,ravencrest,384,mage,frost,12,4,8
9704,Ioriyagami,dragonmaw,384,mage,frost,12,4,8
9705,Tærrëñshíll,tarren-mill,384,mage,frost,12,4,8
9706,Cavadrex,arathor,384,mage,frost,18,4,14
9707,Умелецмаг,gordunni,383,mage,frost,6,4,2
9708,Wuffwuffspik,grim-batol,383,mage,frost,6,4,2
9709,Brandonjames,ragnaros,383,mage,frost,12,4,8
9710,Magicoliwia,ysera,382,mage,frost,6,4,2
9711,Chogger,blackmoore,382,mage,frost,6,4,2
9712,Лордбелиал,soulflayer,382,mage,frost,12,4,8
9713,Nebby,argent-dawn,351,mage,frost,11,4,7
9714,Escobar,frostmane,335,mage,frost,8,5,3
9715,Sleîhg,sanguino,320,mage,frost,10,4,6
9716,Magitron,wildhammer,319,mage,frost,5,4,1
9717,Regenn,kazzak,318,mage,frost,5,4,1
9718,Coldnight,uldum,301,mage,frost,13,4,9
9719,Dumblemore,ragnaros,288,mage,frost,6,3,3
9720,Lyramage,draenor,288,mage,frost,6,3,3
9721,Onegaisenpai,ragnaros,288,mage,frost,6,3,3
9722,Сизаам,howling-fjord,288,mage,frost,6,3,3
9723,Magekaoz,sylvanas,288,mage,frost,6,3,3
9724,Lidin,draenor,288,mage,frost,6,3,3
9725,Bigburns,draenor,288,mage,frost,6,3,3
9726,Luckydo,turalyon,288,mage,frost,6,3,3
9727,Сэрруденкент,soulflayer,288,mage,frost,6,3,3
9728,Zyllu,argent-dawn,288,mage,frost,6,3,3
9729,Tìnder,tarren-mill,288,mage,frost,6,3,3
9730,Haginatorr,twisting-nether,288,mage,frost,6,3,3
9731,Fboltprocd,ragnaros,288,mage,frost,6,3,3
9732,Dragotus,dragonblight,288,mage,frost,6,3,3
9733,Учительйода,ashenvale,288,mage,frost,6,3,3
9734,Metaboi,ragnaros,288,mage,frost,6,3,3
9735,Tommyboy,dragonblight,288,mage,frost,6,3,3
9736,Justvik,eredar,288,mage,frost,6,3,3
9737,Овеча,gordunni,288,mage,frost,6,3,3
9738,Eliosia,drakthul,288,mage,frost,6,3,3
9739,Anthrex,drakthul,288,mage,frost,6,3,3
9740,Muuckie,blackrock,288,mage,frost,6,3,3
9741,Bóósh,alakir,288,mage,frost,6,3,3
9742,Takayaki,terokkar,288,mage,frost,6,3,3
9743,Milminmage,ravencrest,288,mage,frost,6,3,3
9744,Tirenia,bloodfeather,288,mage,frost,6,3,3
9745,Smashdown,blackrock,288,mage,frost,6,3,3
9746,Ørixx,blackhand,288,mage,frost,6,3,3
9747,Codeincassie,blackhand,288,mage,frost,6,3,3
9748,Snowberry,blackrock,288,mage,frost,6,3,3
9749,Kadsy,tarren-mill,288,mage,frost,6,3,3
9750,Johnnydeepp,archimonde,288,mage,frost,6,3,3
9751,Bebenm,archimonde,288,mage,frost,6,3,3
9752,Frökenfrost,stormscale,288,mage,frost,6,3,3
9753,Narcîsa,sanguino,288,mage,frost,6,3,3
9754,Gotone,tarren-mill,288,mage,frost,6,3,3
9755,Rèkt,lightbringer,288,mage,frost,6,3,3
9756,Vodjka,nemesis,288,mage,frost,6,3,3
9757,Nevertøxic,ravencrest,288,mage,frost,6,3,3
9758,Brunettdelux,archimonde,288,mage,frost,6,3,3
9759,Siérra,outland,288,mage,frost,6,3,3
9760,Orelox,kazzak,288,mage,frost,6,3,3
9761,Kilstine,outland,288,mage,frost,6,3,3
9762,Kleptomania,archimonde,288,mage,frost,6,3,3
9763,Arandartis,kazzak,288,mage,frost,6,3,3
9764,Broccosoup,kazzak,288,mage,frost,6,3,3
9765,Dumbledores,aegwynn,288,mage,frost,6,3,3
9766,Microsmag,thrall,288,mage,frost,6,3,3
9767,Håtemebaby,kazzak,288,mage,frost,6,3,3
9768,Blinkmehome,silvermoon,288,mage,frost,12,3,9
9769,Tadaa,blackmoore,288,mage,frost,12,3,9
9770,Buffenhance,ravencrest,288,mage,frost,12,3,9
9771,Apeex,chamber-of-aspects,288,mage,frost,12,3,9
9772,Shroomie,eredar,288,mage,frost,12,3,9
9773,Fernandéz,ravencrest,288,mage,frost,12,3,9
9774,Wambamm,ravencrest,288,mage,frost,12,3,9
9775,Consquens,aszune,288,mage,frost,12,3,9
9776,Sérc,ravencrest,288,mage,frost,12,3,9
9777,Потныйдпс,eversong,288,mage,frost,12,3,9
9778,Distrophy,vashj,288,mage,frost,12,3,9
9779,Эммилиарда,gordunni,288,mage,frost,12,3,9
9780,Gogara,kazzak,288,mage,frost,12,3,9
9781,Ахиригиз,gordunni,288,mage,frost,12,3,9
9782,Деметрадон,gordunni,288,mage,frost,12,3,9
9783,Naween,hyjal,288,mage,frost,12,3,9
9784,Voraxma,draenor,288,mage,frost,12,3,9
9785,Paradigma,sylvanas,288,mage,frost,12,3,9
9786,Magó,eredar,287,mage,frost,6,3,3
9787,Hagiko,archimonde,287,mage,frost,6,3,3
9788,Magjaw,twisting-nether,287,mage,frost,6,3,3
9789,Wopi,sylvanas,287,mage,frost,6,3,3
9790,Valtarisoo,amanthul,287,mage,frost,6,3,3
9791,Sylênna,kazzak,287,mage,frost,9,4,5
9792,Rintoh,pozzo-delleternità,287,mage,frost,12,3,9
9793,Kasus,sporeggar,287,mage,frost,12,3,9
9794,Sammelbot,kargath,286,mage,frost,6,3,3
9795,Freeto,blackmoore,286,mage,frost,6,3,3
9796,Lìx,ravencrest,239,mage,frost,5,3,2
9797,Rayniß,blackmoore,223,mage,frost,8,3,5
9798,Viro,defias-brotherhood,192,mage,frost,9,3,6
9799,Бд,blackscar,192,mage,frost,6,2,4
9800,Ingibjorg,auchindoun,192,mage,frost,6,2,4
9801,Brutal,thrall,192,mage,frost,6,2,4
9802,Shealá,blackhand,192,mage,frost,6,2,4
9803,Tygaone,tirion,192,mage,frost,6,2,4
9804,Smokedaddy,stormscale,192,mage,frost,6,2,4
9805,Озобочений,greymane,192,mage,frost,6,2,4
9806,Бальзамон,eversong,192,mage,frost,6,2,4
9807,Feath,ravencrest,192,mage,frost,6,2,4
9808,Магниффика,blackscar,192,mage,frost,6,2,4
9809,Stilnox,nemesis,192,mage,frost,6,2,4
9810,Frostbringer,archimonde,192,mage,frost,6,2,4
9811,Галадриелька,gordunni,192,mage,frost,6,2,4
9812,Creak,blackhand,192,mage,frost,6,2,4
9813,Chíefsheep,thrall,192,mage,frost,6,2,4
9814,Nøxas,archimonde,192,mage,frost,6,2,4
9815,Doidadetanga,aggra-português,192,mage,frost,6,2,4
9816,Sperow,marécage-de-zangar,192,mage,frost,6,2,4
9817,Welt,drakthul,192,mage,frost,6,2,4
9818,Chread,bronze-dragonflight,192,mage,frost,6,2,4
9819,Jockin,stormrage,192,mage,frost,6,2,4
9820,Xenodike,blackrock,192,mage,frost,6,2,4
9821,Rizzlybear,outland,192,mage,frost,6,2,4
9822,Sebers,kazzak,192,mage,frost,6,2,4
9823,Frazztato,tarren-mill,192,mage,frost,6,2,4
9824,Warwizz,sanguino,192,mage,frost,6,2,4
9825,Blinkfloyd,blackmoore,192,mage,frost,6,2,4
9826,Magenox,blackrock,192,mage,frost,6,2,4
9827,Gameart,alexstrasza,192,mage,frost,6,2,4
9828,Laciee,silvermoon,192,mage,frost,6,2,4
9829,Elor,eredar,192,mage,frost,6,2,4
9830,Alleii,kazzak,192,mage,frost,6,2,4
9831,Ckrax,sanguino,192,mage,frost,6,2,4
9832,Tschelo,eredar,192,mage,frost,6,2,4
9833,Bloodymage,zenedar,192,mage,frost,6,2,4
9834,Phonkim,stormscale,192,mage,frost,6,2,4
9835,Cortis,outland,192,mage,frost,6,2,4
9836,Labius,dun-modr,192,mage,frost,6,2,4
9837,Løxyy,ysondre,192,mage,frost,6,2,4
9838,Ehbehad,doomhammer,192,mage,frost,6,2,4
9839,Tomia,burning-legion,192,mage,frost,6,2,4
9840,Maybeblood,kazzak,192,mage,frost,6,2,4
9841,Ðøæø,twisting-nether,192,mage,frost,6,2,4
9842,Balmak,doomhammer,192,mage,frost,6,2,4
9843,Estupen,sanguino,192,mage,frost,6,2,4
9844,Meteofrost,draenor,192,mage,frost,6,2,4
9845,Kobrass,spinebreaker,192,mage,frost,6,2,4
9846,Blastus,ragnaros,192,mage,frost,6,2,4
9847,Beardyman,haomarush,192,mage,frost,6,2,4
9848,Pixlet,kazzak,192,mage,frost,6,2,4
9849,Mezaiyh,blackmoore,192,mage,frost,6,2,4
9850,Lillelord,defias-brotherhood,192,mage,frost,6,2,4
9851,Maveya,blackmoore,192,mage,frost,6,2,4
9852,Dxdxdxdxdx,drakthul,192,mage,frost,6,2,4
9853,Etherìon,los-errantes,192,mage,frost,6,2,4
9854,Alieni,stormreaver,192,mage,frost,6,2,4
9855,Portnography,draenor,192,mage,frost,12,2,10
9856,Pogmage,blackrock,192,mage,frost,12,2,10
9857,Freezeballs,blackmoore,192,mage,frost,12,2,10
9858,Mariujana,ravencrest,192,mage,frost,12,2,10
9859,Flamê,ragnaros,192,mage,frost,12,2,10
9860,Intêrnet,archimonde,192,mage,frost,12,2,10
9861,Kalamaras,quelthalas,192,mage,frost,12,2,10
9862,Yojimbot,archimonde,192,mage,frost,12,2,10
9863,Rapidfrost,drakthul,192,mage,frost,12,2,10
9864,Wslyx,dun-morogh,192,mage,frost,12,2,10
9865,Makkertje,silvermoon,191,mage,frost,6,2,4
9866,Mátraxx,silvermoon,191,mage,frost,12,2,10
9867,Щавзорву,gordunni,159,mage,frost,5,2,3
9868,Dødo,archimonde,159,mage,frost,5,2,3
9869,Kyan,burning-legion,159,mage,frost,5,2,3
9870,Azadan,pozzo-delleternità,159,mage,frost,5,2,3
9871,Mínêrvâ,blackrock,144,mage,frost,3,3,0
9872,Mimicassa,defias-brotherhood,138,mage,frost,12,4,8
9873,Ehren,ravencrest,138,mage,frost,10,3,7
9874,Skitsó,shadowsong,127,mage,frost,4,2,2
9875,Markasaura,kazzak,127,mage,frost,8,2,6
9876,Dmmeforcam,archimonde,127,mage,frost,8,2,6
9877,Mutly,kazzak,96,mage,frost,3,2,1
9878,Firestárter,ravencrest,96,mage,frost,3,2,1
9879,Ntintsec,tarren-mill,96,mage,frost,3,2,1
9880,Larmp,outland,96,mage,frost,6,1,5
9881,Homeessa,stormreaver,96,mage,frost,6,1,5
9882,Loskapaska,stormreaver,96,mage,frost,6,1,5
9883,Kpacey,guldan,96,mage,frost,6,1,5
9884,Aarcheon,kazzak,96,mage,frost,6,1,5
9885,Холдми,gordunni,96,mage,frost,6,1,5
9886,Sheeptonreup,archimonde,96,mage,frost,6,1,5
9887,Деорро,gordunni,96,mage,frost,6,1,5
9888,Nekroulis,agamaggan,96,mage,frost,6,1,5
9889,Froostii,aegwynn,96,mage,frost,6,1,5
9890,Kaiyn,argent-dawn,96,mage,frost,6,1,5
9891,Waterhagx,tarren-mill,96,mage,frost,6,1,5
9892,Alphaburstqx,ragnaros,96,mage,frost,6,1,5
9893,Dzomage,kazzak,96,mage,frost,6,1,5
9894,Teeclis,twisting-nether,96,mage,frost,6,1,5
9895,Testoletku,twisting-nether,96,mage,frost,6,1,5
9896,Колтрэйн,blackscar,96,mage,frost,6,1,5
9897,Mëgu,silvermoon,96,mage,frost,6,1,5
9898,Nåzmyz,outland,96,mage,frost,6,1,5
9899,Xèrec,ysondre,96,mage,frost,6,1,5
9900,Xoouuboo,eredar,96,mage,frost,6,1,5
9901,Niladyel,hyjal,96,mage,frost,6,1,5
9902,Boned,ravencrest,96,mage,frost,6,1,5
9903,Rezre,stormscale,96,mage,frost,6,1,5
9904,Karstnstenzl,blackrock,96,mage,frost,6,1,5
9905,Elynaé,draenor,96,mage,frost,6,1,5
9906,Fîrestorm,doomhammer,96,mage,frost,6,1,5
9907,Nullso,zuljin,96,mage,frost,6,1,5
9908,Shizzy,onyxia,96,mage,frost,6,1,5
9909,Dwarfyy,frostmane,96,mage,frost,6,1,5
9910,Subtempo,silvermoon,96,mage,frost,6,1,5
9911,Rilac,nordrassil,96,mage,frost,6,1,5
9912,Devòna,silvermoon,96,mage,frost,6,1,5
9913,Squìshy,magtheridon,96,mage,frost,6,1,5
9914,Familyfrost,thunderhorn,96,mage,frost,6,1,5
9915,Hruon,ravenholdt,96,mage,frost,9,1,8
9916,Magipus,anetheron,95,mage,frost,6,1,5
9917,Чогоце,eversong,95,mage,frost,6,1,5
9918,Pickaachu,doomhammer,95,mage,frost,6,1,5
9919,Nalord,saurfang,95,mage,frost,6,1,5
9920,Aurayaa,teldrassil,95,mage,frost,11,1,10
9921,Milhoux,ysondre,79,mage,frost,5,1,4
9922,Bceps,stormscale,64,mage,frost,4,1,3
9923,Maege,ragnaros,63,mage,frost,2,2,0
9924,Gocu,tarren-mill,63,mage,frost,2,2,0
9925,Aeghis,darkspear,42,mage,frost,10,3,7
9926,Yoxt,blackhand,31,mage,frost,2,1,1
9927,Шеллестун,soulflayer,16,mage,frost,1,1,0
9928,Xaramael,colinas-pardas,8,mage,frost,9,3,6
9929,Fisterino,zuljin,2304,monk,mistweaver,54,42,12
9930,Nnsstt,zuljin,2277,monk,mistweaver,104,64,40
9931,Bankmw,tarren-mill,2265,monk,mistweaver,77,52,25
9932,Brickedup,twisting-nether,2246,monk,mistweaver,139,81,58
9933,Ballademager,magtheridon,2218,monk,mistweaver,84,52,32
9934,Montex,stormscale,2210,monk,mistweaver,96,53,43
9935,Cocojones,tarren-mill,2194,monk,mistweaver,60,42,18
9936,Онимэшнеца,gordunni,2170,monk,mistweaver,77,48,29
9937,Ltmxy,ravencrest,2127,monk,mistweaver,66,40,26
9938,Umadbrohuh,outland,2126,monk,mistweaver,66,39,27
9939,Леолайт,borean-tundra,2124,monk,mistweaver,83,52,31
9940,Фунтос,soulflayer,2124,monk,mistweaver,66,41,25
9941,Çoomðragon,stormscale,2122,monk,mistweaver,42,29,13
9942,Tryhârdx,stormscale,2122,monk,mistweaver,84,45,39
9943,Beetlejuicé,stormscale,2118,monk,mistweaver,42,28,14
9944,Akanetsu,kazzak,2112,monk,mistweaver,96,58,38
9945,Joke,ragnaros,2111,monk,mistweaver,78,41,37
9946,Teampro,ragnaros,2108,monk,mistweaver,211,120,91
9947,Donitrivegas,blackrock,2106,monk,mistweaver,126,85,41
9948,Sinted,blackmoore,2103,monk,mistweaver,83,52,31
9949,Lifelessons,blackrock,2103,monk,mistweaver,57,34,23
9950,Mibe,alonsus,2103,monk,mistweaver,108,53,55
9951,Blubberwurst,gorgonnash,2102,monk,mistweaver,130,74,56
9952,Flowy,uldum,2101,monk,mistweaver,60,31,29
9953,Lylleri,darksorrow,2089,monk,mistweaver,68,40,28
9954,Tímmz,blackrock,2088,monk,mistweaver,96,56,40
9955,Cranex,terenas,2072,monk,mistweaver,112,68,44
9956,Øllen,stormscale,2062,monk,mistweaver,71,41,30
9957,Monkeyi,silvermoon,2040,monk,mistweaver,108,57,51
9958,Webhottie,twisting-nether,2032,monk,mistweaver,66,42,24
9959,Pennyflame,stormscale,2026,monk,mistweaver,125,67,58
9960,Quendiz,frostwolf,2025,monk,mistweaver,72,40,32
9961,Bobthewild,draenor,2023,monk,mistweaver,239,120,119
9962,Ðalvan,blackrock,2011,monk,mistweaver,78,39,39
9963,Fåtjøë,ravencrest,2010,monk,mistweaver,48,31,17
9964,Flandersmonk,archimonde,2008,monk,mistweaver,73,48,25
9965,Stringg,zuljin,2005,monk,mistweaver,240,137,103
9966,Monkeystar,archimonde,2004,monk,mistweaver,66,38,28
9967,Кимлейн,blackscar,1995,monk,mistweaver,30,21,9
9968,Inlakech,auchindoun,1992,monk,mistweaver,129,73,56
9969,Mösêê,eredar,1992,monk,mistweaver,88,39,49
9970,Brxndimonk,antonidas,1990,monk,mistweaver,63,35,28
9971,Суммрачная,gordunni,1989,monk,mistweaver,126,79,47
9972,Voltzeig,dentarg,1988,monk,mistweaver,160,88,72
9973,Seeyoulater,nemesis,1983,monk,mistweaver,168,85,83
9974,Halùnkè,eredar,1982,monk,mistweaver,112,69,43
9975,Кулакх,blackscar,1982,monk,mistweaver,76,42,34
9976,Skailzkrtwo,hyjal,1979,monk,mistweaver,66,39,27
9977,Zeoverx,ragnaros,1977,monk,mistweaver,78,36,42
9978,Loiyh,dun-modr,1969,monk,mistweaver,72,35,37
9979,Turricane,blackmoore,1967,monk,mistweaver,60,31,29
9980,Veganweaver,ravencrest,1966,monk,mistweaver,60,37,23
9981,Arenatwo,outland,1957,monk,mistweaver,75,48,27
9982,Ouhmaikgød,dun-modr,1955,monk,mistweaver,76,37,39
9983,Môûsè,ravencrest,1949,monk,mistweaver,72,46,26
9984,Шортмневноги,howling-fjord,1949,monk,mistweaver,77,41,36
9985,Commadore,draenor,1949,monk,mistweaver,60,29,31
9986,Beili,ravencrest,1946,monk,mistweaver,79,42,37
9987,Shirkán,ragnaros,1945,monk,mistweaver,96,58,38
9988,Kêkburagol,kazzak,1938,monk,mistweaver,66,45,21
9989,Couchfrmikea,twisting-nether,1937,monk,mistweaver,72,38,34
9990,Yuukiiqt,kult-der-verdammten,1934,monk,mistweaver,83,47,36
9991,Vanost,kazzak,1933,monk,mistweaver,60,28,32
9992,Dmonkz,magtheridon,1932,monk,mistweaver,36,26,10
9993,Mememaster,blackhand,1930,monk,mistweaver,54,37,17
9994,Howtoown,burning-legion,1930,monk,mistweaver,54,31,23
9995,Pizzabud,ravencrest,1926,monk,mistweaver,46,31,15
9996,Subàru,draenor,1924,monk,mistweaver,87,58,29
9997,Monkrah,blackmoore,1922,monk,mistweaver,48,26,22
9998,Kêkbûrâgól,kazzak,1917,monk,mistweaver,73,39,34
9999,Pwner,daggerspine,1914,monk,mistweaver,193,103,90
10000,Zaerin,eredar,1913,monk,mistweaver,43,24,19
10001,Manjini,blackhand,1908,monk,mistweaver,47,27,20
10002,Meemyo,blackmoore,1904,monk,mistweaver,83,34,49
10003,Moariann,drakthul,1902,monk,mistweaver,120,64,56
10004,Effeots,blackrock,1900,monk,mistweaver,187,100,87
10005,Seventhirty,ravencrest,1896,monk,mistweaver,36,20,16
10006,Jades,emeriss,1893,monk,mistweaver,162,83,79
10007,Wwvwwvwwvwwv,ragnaros,1892,monk,mistweaver,54,24,30
10008,Muchobijca,defias-brotherhood,1891,monk,mistweaver,72,41,31
10009,Dmonk,aegwynn,1891,monk,mistweaver,100,46,54
10010,Wajoba,blackhand,1884,monk,mistweaver,66,30,36
10011,Коконгкд,blackscar,1883,monk,mistweaver,113,62,51
10012,Haìryplotter,kazzak,1872,monk,mistweaver,90,53,37
10013,Cåpybårå,outland,1872,monk,mistweaver,138,79,59
10014,Bigbummer,blackmoore,1871,monk,mistweaver,90,48,42
10015,Jiafei,tarren-mill,1862,monk,mistweaver,42,25,17
10016,Hiryu,argent-dawn,1862,monk,mistweaver,53,31,22
10017,Chichigneux,hyjal,1861,monk,mistweaver,51,35,16
10018,Youkâi,blackrock,1859,monk,mistweaver,48,31,17
10019,Zonsym,twisting-nether,1859,monk,mistweaver,60,32,28
10020,Qwertyxo,draenor,1858,monk,mistweaver,51,36,15
10021,Glooni,blackrock,1858,monk,mistweaver,57,33,24
10022,Rullsimpa,ravencrest,1858,monk,mistweaver,77,34,43
10023,Digzzy,draenor,1856,monk,mistweaver,63,35,28
10024,Mønkeÿ,ravencrest,1855,monk,mistweaver,34,25,9
10025,Waramow,eredar,1855,monk,mistweaver,36,25,11
10026,Supercoach,blackrock,1855,monk,mistweaver,111,65,46
10027,Фейкнаут,soulflayer,1855,monk,mistweaver,108,57,51
10028,Zoida,azuremyst,1853,monk,mistweaver,60,33,27
10029,Pyrìt,blackhand,1852,monk,mistweaver,36,29,7
10030,Meliowo,ravencrest,1851,monk,mistweaver,54,31,23
10031,Alprox,moonglade,1846,monk,mistweaver,152,80,72
10032,Tráïner,madmortem,1842,monk,mistweaver,101,54,47
10033,Musclemage,turalyon,1841,monk,mistweaver,60,31,29
10034,Siignmonk,ravencrest,1840,monk,mistweaver,54,31,23
10035,Neszesmonk,ragnaros,1840,monk,mistweaver,121,65,56
10036,Yungsooth,stormscale,1838,monk,mistweaver,53,37,16
10037,Yellowtape,kiljaeden,1838,monk,mistweaver,42,29,13
10038,Kratzl,blackrock,1838,monk,mistweaver,42,27,15
10039,Yoghurtz,frostmourne,1837,monk,mistweaver,72,43,29
10040,Pøhx,ragnaros,1837,monk,mistweaver,87,51,36
10041,Homes,blackmoore,1837,monk,mistweaver,60,35,25
10042,Monkdrak,eredar,1835,monk,mistweaver,39,24,15
10043,Toram,burning-legion,1833,monk,mistweaver,60,29,31
10044,Døk,twisting-nether,1832,monk,mistweaver,30,22,8
10045,Shonba9D659E,argent-dawn,1829,monk,mistweaver,48,30,18
10046,Deepl,dun-modr,1829,monk,mistweaver,48,24,24
10047,Нубстриимс,gordunni,1828,monk,mistweaver,62,33,29
10048,Mistyfox,aszune,1828,monk,mistweaver,95,45,50
10049,Твикса,soulflayer,1828,monk,mistweaver,78,36,42
10050,Véxyra,draenor,1827,monk,mistweaver,48,32,16
10051,Мефодийкун,howling-fjord,1826,monk,mistweaver,108,63,45
10052,Playbîrd,archimonde,1826,monk,mistweaver,100,54,46
10053,Zevenblad,stormscale,1826,monk,mistweaver,60,28,32
10054,Notachi,doomhammer,1825,monk,mistweaver,243,135,108
10055,Ønlyfäns,kazzak,1824,monk,mistweaver,106,64,42
10056,Элонхаск,gordunni,1824,monk,mistweaver,54,29,25
10057,Swagmonk,silvermoon,1824,monk,mistweaver,56,30,26
10058,Вульфхильда,soulflayer,1823,monk,mistweaver,150,83,67
10059,Tigermw,twisting-nether,1821,monk,mistweaver,49,31,18
10060,Luru,outland,1820,monk,mistweaver,53,33,20
10061,Trollroll,defias-brotherhood,1820,monk,mistweaver,132,74,58
10062,Анстапоблх,grom,1820,monk,mistweaver,54,24,30
10063,Perceptîon,thrall,1819,monk,mistweaver,41,23,18
10064,Mistyhoe,twisting-nether,1818,monk,mistweaver,71,37,34
10065,Motang,blackmoore,1816,monk,mistweaver,62,34,28
10066,Mugenzen,sanguino,1816,monk,mistweaver,36,19,17
10067,Zulein,defias-brotherhood,1814,monk,mistweaver,36,21,15
10068,Рендикаое,soulflayer,1814,monk,mistweaver,151,85,66
10069,Savagex,sanguino,1814,monk,mistweaver,60,32,28
10070,Тамаз,gordunni,1814,monk,mistweaver,59,24,35
10071,Manatoiled,draenor,1813,monk,mistweaver,36,24,12
10072,Basilbrushxd,stormscale,1813,monk,mistweaver,48,27,21
10073,Lünara,ambossar,1812,monk,mistweaver,72,44,28
10074,Uwû,ravencrest,1811,monk,mistweaver,59,45,14
10075,Onlyfist,stormscale,1811,monk,mistweaver,42,28,14
10076,Sugermum,outland,1811,monk,mistweaver,54,31,23
10077,Claudiå,kazzak,1811,monk,mistweaver,54,27,27
10078,Bigbøøty,silvermoon,1810,monk,mistweaver,60,29,31
10079,Karmasnitch,antonidas,1808,monk,mistweaver,66,38,28
10080,Gronkr,draenor,1808,monk,mistweaver,53,27,26
10081,Лиянь,soulflayer,1807,monk,mistweaver,96,56,40
10082,Mobrac,twisting-nether,1807,monk,mistweaver,39,21,18
10083,Kilograme,tarren-mill,1806,monk,mistweaver,66,36,30
10084,Kîrânâ,eredar,1806,monk,mistweaver,54,29,25
10085,Ранки,lich-king,1806,monk,mistweaver,60,27,33
10086,Panson,twisting-nether,1804,monk,mistweaver,54,28,26
10087,Mbynxtlife,draenor,1803,monk,mistweaver,42,21,21
10088,Shâng,blackhand,1802,monk,mistweaver,36,21,15
10089,Notzaele,zuljin,1802,monk,mistweaver,42,23,19
10090,Lyashi,dalaran,1801,monk,mistweaver,54,28,26
10091,Callysra,archimonde,1800,monk,mistweaver,42,30,12
10092,Hurricaine,hyjal,1799,monk,mistweaver,30,19,11
10093,Brewnox,ragnaros,1797,monk,mistweaver,59,30,29
10094,Monkler,blackhand,1794,monk,mistweaver,72,34,38
10095,Rolxx,twisting-nether,1793,monk,mistweaver,74,35,39
10096,Chanzey,silvermoon,1790,monk,mistweaver,156,88,68
10097,Loofey,ragnaros,1789,monk,mistweaver,113,63,50
10098,Барлиос,soulflayer,1788,monk,mistweaver,162,90,72
10099,Xoconut,kazzak,1785,monk,mistweaver,161,94,67
10100,Brysiqtx,aegwynn,1783,monk,mistweaver,45,26,19
10101,Trashcarlita,eredar,1781,monk,mistweaver,36,21,15
10102,Fùckaround,emeriss,1780,monk,mistweaver,54,33,21
10103,Hurri,krasus,1779,monk,mistweaver,30,20,10
10104,Porcman,archimonde,1778,monk,mistweaver,81,40,41
10105,Stifmeister,tarren-mill,1772,monk,mistweaver,60,34,26
10106,Karsat,hyjal,1769,monk,mistweaver,218,110,108
10107,Sinanger,dun-modr,1766,monk,mistweaver,180,100,80
10108,Milkhy,minahonda,1763,monk,mistweaver,46,26,20
10109,Bicmex,archimonde,1763,monk,mistweaver,66,30,36
10110,Shadezz,blackmoore,1762,monk,mistweaver,46,30,16
10111,Sniffn,ravencrest,1754,monk,mistweaver,54,35,19
10112,Monkield,kazzak,1751,monk,mistweaver,103,69,34
10113,Эрмилинда,gordunni,1749,monk,mistweaver,54,26,28
10114,Kaezm,blackrock,1746,monk,mistweaver,42,26,16
10115,Xámell,ravencrest,1746,monk,mistweaver,36,19,17
10116,Koguosa,outland,1742,monk,mistweaver,36,27,9
10117,Mcscrub,ragnaros,1742,monk,mistweaver,35,24,11
10118,Dewamønk,blackmoore,1742,monk,mistweaver,36,22,14
10119,Jerymonk,tarren-mill,1742,monk,mistweaver,162,91,71
10120,Тащунаскилле,thermaplugg,1741,monk,mistweaver,50,28,22
10121,Kóan,stormscale,1740,monk,mistweaver,60,31,29
10122,Inuria,ravencrest,1739,monk,mistweaver,54,37,17
10123,Мичан,howling-fjord,1739,monk,mistweaver,78,48,30
10124,Vivie,destromath,1735,monk,mistweaver,36,20,16
10125,Fatdad,magtheridon,1735,monk,mistweaver,83,41,42
10126,Greentape,kiljaeden,1730,monk,mistweaver,42,27,15
10127,Prototyp,burning-legion,1729,monk,mistweaver,36,23,13
10128,Séi,kazzak,1721,monk,mistweaver,36,18,18
10129,Mwrbg,shadowsong,1720,monk,mistweaver,113,63,50
10130,Chimara,kazzak,1718,monk,mistweaver,79,45,34
10131,Аскмилол,deathweaver,1717,monk,mistweaver,60,35,25
10132,Merína,ragnaros,1715,monk,mistweaver,195,103,92
10133,Alë,argent-dawn,1714,monk,mistweaver,105,65,40
10134,Jacksa,bronze-dragonflight,1712,monk,mistweaver,84,42,42
10135,Neisha,drakthul,1711,monk,mistweaver,42,26,16
10136,Mugotea,twisting-nether,1711,monk,mistweaver,42,23,19
10137,Bammemw,archimonde,1710,monk,mistweaver,48,22,26
10138,Meldi,ravencrest,1709,monk,mistweaver,42,24,18
10139,Jemp,ravencrest,1708,monk,mistweaver,168,105,63
10140,Tjann,stormscale,1706,monk,mistweaver,48,33,15
10141,Babbub,tarren-mill,1704,monk,mistweaver,42,27,15
10142,Koraxx,blackmoore,1703,monk,mistweaver,60,34,26
10143,Djpunchable,blackrock,1701,monk,mistweaver,35,26,9
10144,Pudgefeed,silvermoon,1701,monk,mistweaver,30,19,11
10145,Æøwyn,ragnaros,1699,monk,mistweaver,36,27,9
10146,Ziibaa,outland,1698,monk,mistweaver,42,28,14
10147,Evad,kazzak,1698,monk,mistweaver,66,41,25
10148,Rullefald,stormscale,1697,monk,mistweaver,102,57,45
10149,Neash,silvermoon,1695,monk,mistweaver,48,27,21
10150,Olympiiee,archimonde,1695,monk,mistweaver,209,114,95
10151,Pizelx,alakir,1695,monk,mistweaver,36,18,18
10152,Вакидзави,gordunni,1694,monk,mistweaver,48,31,17
10153,Фучой,howling-fjord,1692,monk,mistweaver,57,34,23
10154,Táuriéll,eredar,1692,monk,mistweaver,36,18,18
10155,Hardi,chamber-of-aspects,1691,monk,mistweaver,78,41,37
10156,Sîono,antonidas,1689,monk,mistweaver,30,22,8
10157,Astromune,draenor,1683,monk,mistweaver,41,24,17
10158,Stramonk,nemesis,1681,monk,mistweaver,156,77,79
10159,Sadmw,archimonde,1679,monk,mistweaver,36,20,16
10160,Papours,ysondre,1676,monk,mistweaver,30,22,8
10161,Limbaskalol,dun-modr,1674,monk,mistweaver,145,68,77
10162,Fungku,azjolnerub,1669,monk,mistweaver,133,75,58
10163,Encanthar,blackhand,1669,monk,mistweaver,214,114,100
10164,Bullergøjen,ravencrest,1668,monk,mistweaver,78,52,26
10165,Donkeymønk,hyjal,1668,monk,mistweaver,135,75,60
10166,Dearmw,silvermoon,1667,monk,mistweaver,54,31,23
10167,Zorkev,dun-modr,1667,monk,mistweaver,113,63,50
10168,Jingfeng,arthas,1667,monk,mistweaver,54,24,30
10169,Adis,nerathor,1662,monk,mistweaver,36,20,16
10170,Jabington,aegwynn,1657,monk,mistweaver,70,40,30
10171,Elvand,twisting-nether,1656,monk,mistweaver,66,39,27
10172,Репаблликуес,gordunni,1656,monk,mistweaver,34,20,14
10173,Varyat,uldum,1656,monk,mistweaver,41,24,17
10174,Эддрос,gordunni,1655,monk,mistweaver,66,35,31
10175,Mangi,rexxar,1655,monk,mistweaver,72,37,35
10176,Shyheim,outland,1654,monk,mistweaver,42,31,11
10177,Meltfistqt,ravencrest,1654,monk,mistweaver,112,52,60
10178,Birgitbuddha,gorgonnash,1652,monk,mistweaver,42,24,18
10179,Боецкфц,soulflayer,1652,monk,mistweaver,40,21,19
10180,Джулибубба,borean-tundra,1650,monk,mistweaver,48,30,18
10181,Skailzkrt,hyjal,1649,monk,mistweaver,43,19,24
10182,Otemøøn,sanguino,1646,monk,mistweaver,45,25,20
10183,Jorahmarmond,tarren-mill,1645,monk,mistweaver,30,23,7
10184,Imeon,dun-modr,1644,monk,mistweaver,30,18,12
10185,Эрмонд,soulflayer,1644,monk,mistweaver,44,23,21
10186,Unsanegodx,ravencrest,1643,monk,mistweaver,48,35,13
10187,Áyell,archimonde,1643,monk,mistweaver,75,48,27
10188,Нийтринно,howling-fjord,1643,monk,mistweaver,36,19,17
10189,Wrv,kazzak,1643,monk,mistweaver,78,37,41
10190,Nepho,twisting-nether,1642,monk,mistweaver,38,23,15
10191,Trollandroll,stormscale,1642,monk,mistweaver,83,46,37
10192,Pogimonkey,ragnaros,1642,monk,mistweaver,42,23,19
10193,Nêøø,blackrock,1641,monk,mistweaver,109,77,32
10194,Hajlong,outland,1641,monk,mistweaver,42,21,21
10195,Mer,outland,1640,monk,mistweaver,44,24,20
10196,Fistify,destromath,1639,monk,mistweaver,24,20,4
10197,Suliya,zuluhed,1639,monk,mistweaver,36,21,15
10198,Timboqt,blackmoore,1638,monk,mistweaver,70,43,27
10199,Uckkm,ragnaros,1637,monk,mistweaver,42,24,18
10200,Apolskis,ravencrest,1636,monk,mistweaver,42,30,12
10201,Dicedkiwi,quelthalas,1635,monk,mistweaver,83,54,29
10202,Extrimist,sylvanas,1635,monk,mistweaver,69,38,31
10203,Jpstwo,gorgonnash,1635,monk,mistweaver,48,26,22
10204,Bossmanfred,outland,1631,monk,mistweaver,48,31,17
10205,Loobee,ravencrest,1630,monk,mistweaver,30,17,13
10206,Orcimon,draenor,1630,monk,mistweaver,30,17,13
10207,Onlyfunn,sanguino,1629,monk,mistweaver,36,20,16
10208,Youssee,silvermoon,1629,monk,mistweaver,186,102,84
10209,Seandyche,ravencrest,1628,monk,mistweaver,28,18,10
10210,Pe,blackhand,1628,monk,mistweaver,60,34,26
10211,Problematic,blackmoore,1626,monk,mistweaver,30,17,13
10212,Twistie,aegwynn,1626,monk,mistweaver,36,17,19
10213,Йорита,soulflayer,1625,monk,mistweaver,30,17,13
10214,Yto,gorgonnash,1624,monk,mistweaver,30,17,13
10215,Sâu,twisting-nether,1623,monk,mistweaver,30,17,13
10216,Аци,blackscar,1622,monk,mistweaver,42,26,16
10217,Ultdave,eredar,1622,monk,mistweaver,93,52,41
10218,Swaghäuser,blackmoore,1622,monk,mistweaver,101,53,48
10219,Monkim,chogall,1621,monk,mistweaver,36,23,13
10220,Errowin,blackmoore,1621,monk,mistweaver,72,42,30
10221,Cykatea,dun-modr,1620,monk,mistweaver,235,128,107
10222,Chitea,argent-dawn,1618,monk,mistweaver,29,20,9
10223,Inthepoopa,outland,1618,monk,mistweaver,90,51,39
10224,Jetleê,eredar,1617,monk,mistweaver,138,71,67
10225,Hamsster,ravencrest,1617,monk,mistweaver,60,30,30
10226,Кулаквнос,gordunni,1616,monk,mistweaver,54,30,24
10227,Fansolini,burning-legion,1616,monk,mistweaver,46,22,24
10228,Binkote,zuljin,1615,monk,mistweaver,77,46,31
10229,Ceeja,blackmoore,1615,monk,mistweaver,137,76,61
10230,Kaizetsu,drakthul,1614,monk,mistweaver,36,27,9
10231,Soulxq,blackrock,1613,monk,mistweaver,90,51,39
10232,Magixc,drakthul,1613,monk,mistweaver,41,20,21
10233,Dokternelg,silvermoon,1612,monk,mistweaver,30,20,10
10234,Sart,aerie-peak,1612,monk,mistweaver,42,22,20
10235,Kåýðø,archimonde,1610,monk,mistweaver,72,42,30
10236,Chiuna,sylvanas,1608,monk,mistweaver,36,20,16
10237,Ulns,blackrock,1607,monk,mistweaver,60,25,35
10238,Aromipesäx,outland,1606,monk,mistweaver,35,20,15
10239,Hokespokus,silvermoon,1605,monk,mistweaver,30,20,10
10240,Räyh,outland,1602,monk,mistweaver,57,31,26
10241,Zýru,ragnaros,1601,monk,mistweaver,65,38,27
10242,Zenfir,sylvanas,1600,monk,mistweaver,56,38,18
10243,Yörg,eredar,1600,monk,mistweaver,51,30,21
10244,Snookzlol,aegwynn,1600,monk,mistweaver,65,38,27
10245,Rogvi,argent-dawn,1598,monk,mistweaver,102,43,59
10246,Факенщет,soulflayer,1596,monk,mistweaver,36,20,16
10247,Soulring,kazzak,1595,monk,mistweaver,45,21,24
10248,Brewstea,kazzak,1594,monk,mistweaver,66,29,37
10249,Chàrràth,blackmoore,1593,monk,mistweaver,121,62,59
10250,Elmonkodonko,draenor,1590,monk,mistweaver,30,17,13
10251,Brüderlichke,elune,1590,monk,mistweaver,42,19,23
10252,Бадика,howling-fjord,1589,monk,mistweaver,108,58,50
10253,Pitrols,twisting-nether,1588,monk,mistweaver,48,28,20
10254,Ivanzamonka,stormscale,1587,monk,mistweaver,36,24,12
10255,Вдыхайтуман,gordunni,1585,monk,mistweaver,90,51,39
10256,Çz,tarren-mill,1585,monk,mistweaver,30,17,13
10257,Igozoom,draenor,1581,monk,mistweaver,30,25,5
10258,Слишкомхорош,thermaplugg,1580,monk,mistweaver,23,17,6
10259,Монккд,gordunni,1578,monk,mistweaver,147,83,64
10260,Warsox,aegwynn,1570,monk,mistweaver,48,26,22
10261,Diffenbachia,outland,1569,monk,mistweaver,51,36,15
10262,Namelessmist,drakthul,1569,monk,mistweaver,42,26,16
10263,Orgasmix,tarren-mill,1569,monk,mistweaver,42,21,21
10264,Gronoz,drakthul,1562,monk,mistweaver,66,43,23
10265,Pamtu,dun-modr,1558,monk,mistweaver,42,25,17
10266,Òó,vashj,1558,monk,mistweaver,42,20,22
10267,Bitbird,zirkel-des-cenarius,1557,monk,mistweaver,42,25,17
10268,Malkaviano,kazzak,1557,monk,mistweaver,64,37,27
10269,Sneezao,ravencrest,1556,monk,mistweaver,144,82,62
10270,Kitingbuddha,aegwynn,1556,monk,mistweaver,108,57,51
10271,Sindresa,outland,1553,monk,mistweaver,48,25,23
10272,Crymonkya,aegwynn,1551,monk,mistweaver,90,53,37
10273,Yäffa,archimonde,1550,monk,mistweaver,42,18,24
10274,Plebmonkx,frostmane,1547,monk,mistweaver,66,36,30
10275,Macpunchy,defias-brotherhood,1545,monk,mistweaver,30,18,12
10276,Kapitan,sanguino,1539,monk,mistweaver,63,39,24
10277,Endorrphine,ravencrest,1538,monk,mistweaver,80,35,45
10278,Pembi,blades-edge,1534,monk,mistweaver,80,39,41
10279,Vitnam,auchindoun,1533,monk,mistweaver,84,51,33
10280,Wwception,blackrock,1533,monk,mistweaver,32,17,15
10281,Smâsh,blackhand,1531,monk,mistweaver,46,32,14
10282,Actionsusi,area-52,1531,monk,mistweaver,30,16,14
10283,Marqinio,archimonde,1529,monk,mistweaver,30,16,14
10284,Hôn,sanguino,1528,monk,mistweaver,23,17,6
10285,Неэверида,deepholm,1527,monk,mistweaver,90,53,37
10286,Freyas,outland,1527,monk,mistweaver,53,29,24
10287,Musashiden,twisting-nether,1525,monk,mistweaver,42,23,19
10288,Fatskeleton,stormreaver,1523,monk,mistweaver,421,197,224
10289,Plaguer,nordrassil,1519,monk,mistweaver,30,18,12
10290,Misthera,burning-legion,1517,monk,mistweaver,72,32,40
10291,Notfist,kazzak,1513,monk,mistweaver,54,35,19
10292,Calmpalms,tarren-mill,1513,monk,mistweaver,42,23,19
10293,Melamonk,ravencrest,1513,monk,mistweaver,66,32,34
10294,Xiaokingqvq,silvermoon,1512,monk,mistweaver,78,41,37
10295,Германика,soulflayer,1511,monk,mistweaver,86,43,43
10296,Loddarita,ravencrest,1510,monk,mistweaver,36,28,8
10297,Medovic,blackmoore,1510,monk,mistweaver,156,89,67
10298,Idrdob,kazzak,1510,monk,mistweaver,87,49,38
10299,Urbàs,blackmoore,1507,monk,mistweaver,36,25,11
10300,Ticktak,archimonde,1506,monk,mistweaver,36,27,9
10301,Gravityfist,aegwynn,1503,monk,mistweaver,36,18,18
10302,Ipmanlol,archimonde,1502,monk,mistweaver,42,22,20
10303,Caniluvz,eredar,1501,monk,mistweaver,24,16,8
10304,Dmonk,alakir,1501,monk,mistweaver,60,28,32
10305,Bmane,archimonde,1499,monk,mistweaver,29,16,13
10306,Jayber,laughing-skull,1497,monk,mistweaver,30,17,13
10307,Miînd,tarren-mill,1494,monk,mistweaver,48,29,19
10308,Monkzdino,destromath,1494,monk,mistweaver,47,24,23
10309,Тевикс,gordunni,1491,monk,mistweaver,42,19,23
10310,Eckø,rashgarroth,1489,monk,mistweaver,36,24,12
10311,Thuz,kazzak,1488,monk,mistweaver,57,31,26
10312,Moveietss,stormscale,1485,monk,mistweaver,18,16,2
10313,Bóber,kazzak,1485,monk,mistweaver,42,22,20
10314,Incapme,outland,1479,monk,mistweaver,85,51,34
10315,Vanoarabidze,ravencrest,1478,monk,mistweaver,36,16,20
10316,Santoron,baelgun,1478,monk,mistweaver,39,16,23
10317,Dìó,tarren-mill,1477,monk,mistweaver,210,117,93
10318,Pikemi,dun-modr,1477,monk,mistweaver,36,17,19
10319,Rzi,amanthul,1475,monk,mistweaver,125,68,57
10320,Grauwe,stormscale,1474,monk,mistweaver,27,17,10
10321,Okdontnerf,kazzak,1474,monk,mistweaver,42,20,22
10322,Zinnout,twisting-nether,1467,monk,mistweaver,36,26,10
10323,Hollymêdx,blackmoore,1465,monk,mistweaver,31,17,14
10324,Psychocop,drakthul,1462,monk,mistweaver,77,37,40
10325,Pøwcow,blackrock,1459,monk,mistweaver,113,61,52
10326,Noni,gorgonnash,1459,monk,mistweaver,65,31,34
10327,ßojo,kazzak,1458,monk,mistweaver,39,24,15
10328,Legsweep,blackhand,1458,monk,mistweaver,31,19,12
10329,Prettysus,silvermoon,1457,monk,mistweaver,42,25,17
10330,Monkgd,sylvanas,1457,monk,mistweaver,126,73,53
10331,Shiguru,dun-morogh,1456,monk,mistweaver,41,27,14
10332,Saitamä,archimonde,1453,monk,mistweaver,38,17,21
10333,Genjosanso,kazzak,1449,monk,mistweaver,36,25,11
10334,Heartless,sporeggar,1448,monk,mistweaver,36,28,8
10335,Njursten,twilights-hammer,1447,monk,mistweaver,183,89,94
10336,Slugerpigen,stormscale,1446,monk,mistweaver,98,59,39
10337,Civix,sanguino,1443,monk,mistweaver,98,57,41
10338,Umagon,chogall,1442,monk,mistweaver,48,26,22
10339,Vienuolè,silvermoon,1439,monk,mistweaver,24,15,9
10340,Ashm,shattered-halls,1438,monk,mistweaver,30,15,15
10341,Acidflexx,kazzak,1437,monk,mistweaver,24,16,8
10342,Kungfupandy,blackmoore,1435,monk,mistweaver,145,84,61
10343,Lanory,blackmoore,1433,monk,mistweaver,24,15,9
10344,Yarie,blackmoore,1432,monk,mistweaver,66,33,33
10345,Nievah,argent-dawn,1430,monk,mistweaver,39,24,15
10346,Setup,thrall,1430,monk,mistweaver,110,61,49
10347,Yadokaí,darkmoon-faire,1425,monk,mistweaver,36,15,21
10348,Cbmonk,sylvanas,1422,monk,mistweaver,24,17,7
10349,Dudulinda,silvermoon,1422,monk,mistweaver,54,29,25
10350,Xianxiaa,ravencrest,1420,monk,mistweaver,88,51,37
10351,Watchmedamp,draenor,1419,monk,mistweaver,120,67,53
10352,Lacasyto,sanguino,1417,monk,mistweaver,18,15,3
10353,Biftas,nagrand,1415,monk,mistweaver,27,16,11
10354,Fistingfury,burning-blade,1415,monk,mistweaver,48,24,24
10355,Mistsen,kazzak,1414,monk,mistweaver,81,47,34
10356,Eugenn,alonsus,1412,monk,mistweaver,30,15,15
10357,Kukn,twisting-nether,1412,monk,mistweaver,39,16,23
10358,Zenzu,blackmoore,1411,monk,mistweaver,30,20,10
10359,Kroyus,antonidas,1410,monk,mistweaver,60,31,29
10360,Амаззонния,soulflayer,1408,monk,mistweaver,54,21,33
10361,Guthäxlul,khazgoroth,1405,monk,mistweaver,111,63,48
10362,Mistïnguette,dalaran,1402,monk,mistweaver,36,24,12
10363,Leôlulu,blackmoore,1400,monk,mistweaver,24,17,7
10364,Самадайка,howling-fjord,1397,monk,mistweaver,74,35,39
10365,Farmander,silvermoon,1394,monk,mistweaver,85,51,34
10366,Orkiya,archimonde,1394,monk,mistweaver,198,102,96
10367,Woushou,outland,1393,monk,mistweaver,54,33,21
10368,Salsina,nemesis,1390,monk,mistweaver,98,54,44
10369,Haxxo,die-nachtwache,1387,monk,mistweaver,32,22,10
10370,Quezatrix,ravencrest,1387,monk,mistweaver,96,48,48
10371,Badcøwboy,archimonde,1387,monk,mistweaver,122,54,68
10372,Pundok,blackrock,1383,monk,mistweaver,53,31,22
10373,Allosthenos,ravencrest,1379,monk,mistweaver,27,18,9
10374,Chikokon,silvermoon,1378,monk,mistweaver,24,17,7
10375,Kruemelkeks,frostwolf,1378,monk,mistweaver,57,33,24
10376,Onlyvegan,ravencrest,1375,monk,mistweaver,28,16,12
10377,Beaglemo,blackrock,1366,monk,mistweaver,35,15,20
10378,Ðëvx,argent-dawn,1360,monk,mistweaver,72,42,30
10379,Ричфлекс,howling-fjord,1357,monk,mistweaver,102,59,43
10380,Vivir,stormreaver,1355,monk,mistweaver,55,31,24
10381,Thayne,blades-edge,1354,monk,mistweaver,30,15,15
10382,Romk,darkspear,1352,monk,mistweaver,36,25,11
10383,Патаомальчик,blackscar,1352,monk,mistweaver,35,15,20
10384,Demakis,stormscale,1350,monk,mistweaver,23,15,8
10385,Gigilonis,korgall,1350,monk,mistweaver,91,47,44
10386,Quendi,arthas,1348,monk,mistweaver,149,78,71
10387,Coollann,drakthul,1347,monk,mistweaver,30,15,15
10388,Waitaminute,outland,1345,monk,mistweaver,48,28,20
10389,Uao,tarren-mill,1344,monk,mistweaver,24,14,10
10390,Popcornn,archimonde,1343,monk,mistweaver,48,24,24
10391,Trifogeorge,archimonde,1342,monk,mistweaver,24,14,10
10392,Zagar,emeriss,1342,monk,mistweaver,24,14,10
10393,Mistbringer,kazzak,1341,monk,mistweaver,108,53,55
10394,Evelios,blackmoore,1340,monk,mistweaver,29,20,9
10395,Tyzin,blackrock,1340,monk,mistweaver,30,17,13
10396,Kaàli,pozzo-delleternità,1337,monk,mistweaver,24,14,10
10397,Aseidith,tarren-mill,1337,monk,mistweaver,24,14,10
10398,Rocknreroll,executus,1336,monk,mistweaver,30,14,16
10399,Happymonktwo,ravencrest,1333,monk,mistweaver,24,14,10
10400,Boomboôom,outland,1332,monk,mistweaver,24,14,10
10401,Assfist,drakthul,1331,monk,mistweaver,69,44,25
10402,Caskgut,ravencrest,1330,monk,mistweaver,42,26,16
10403,Sajin,la-croisade-écarlate,1329,monk,mistweaver,36,15,21
10404,Oikodomos,twisting-nether,1328,monk,mistweaver,30,14,16
10405,Vooxis,drakthul,1323,monk,mistweaver,24,14,10
10406,Krylin,antonidas,1322,monk,mistweaver,93,45,48
10407,Akalaja,alakir,1316,monk,mistweaver,34,19,15
10408,Benenutz,archimonde,1315,monk,mistweaver,18,14,4
10409,Bluum,ravencrest,1315,monk,mistweaver,36,16,20
10410,Thegrudge,dragonblight,1315,monk,mistweaver,42,16,26
10411,Shreckmonk,burning-blade,1313,monk,mistweaver,30,14,16
10412,Brewswíllis,tarren-mill,1312,monk,mistweaver,18,14,4
10413,Loreo,burning-legion,1310,monk,mistweaver,81,48,33
10414,Marrave,chogall,1310,monk,mistweaver,51,19,32
10415,Tokz,ravencrest,1309,monk,mistweaver,24,14,10
10416,Løsang,blackrock,1303,monk,mistweaver,68,46,22
10417,Vetocorleone,kazzak,1299,monk,mistweaver,123,64,59
10418,Vladikus,tarren-mill,1299,monk,mistweaver,63,28,35
10419,Джоский,borean-tundra,1299,monk,mistweaver,60,23,37
10420,Камикадзэн,gordunni,1296,monk,mistweaver,24,15,9
10421,Pandimaci,ragnaros,1295,monk,mistweaver,47,27,20
10422,Ðurîmar,ravencrest,1294,monk,mistweaver,23,14,9
10423,Zenmist,kazzak,1294,monk,mistweaver,23,14,9
10424,Хэйхати,gordunni,1289,monk,mistweaver,53,26,27
10425,Mareki,nethersturm,1288,monk,mistweaver,38,19,19
10426,Mestro,argent-dawn,1284,monk,mistweaver,80,50,30
10427,Carnat,blackrock,1284,monk,mistweaver,30,17,13
10428,Trivi,blackrock,1284,monk,mistweaver,39,21,18
10429,Drboombay,kazzak,1283,monk,mistweaver,38,21,17
10430,Teacup,aegwynn,1282,monk,mistweaver,30,21,9
10431,Schaulong,blackmoore,1280,monk,mistweaver,30,15,15
10432,Scare,stormreaver,1280,monk,mistweaver,35,16,19
10433,Toon,eredar,1277,monk,mistweaver,42,21,21
10434,Numpys,sanguino,1277,monk,mistweaver,29,14,15
10435,Ugras,auchindoun,1273,monk,mistweaver,36,14,22
10436,Trnd,draenor,1269,monk,mistweaver,41,15,26
10437,Mishax,draenor,1268,monk,mistweaver,78,38,40
10438,Torqualis,kazzak,1267,monk,mistweaver,66,34,32
10439,Boredom,wildhammer,1266,monk,mistweaver,60,35,25
10440,Szilvia,sylvanas,1263,monk,mistweaver,48,25,23
10441,Nîcko,ravencrest,1259,monk,mistweaver,24,14,10
10442,Macgyverr,outland,1258,monk,mistweaver,24,14,10
10443,Chígoku,grim-batol,1257,monk,mistweaver,52,23,29
10444,Трикленд,azuregos,1254,monk,mistweaver,30,15,15
10445,Yahní,eredar,1253,monk,mistweaver,47,24,23
10446,Supaverli,archimonde,1248,monk,mistweaver,18,13,5
10447,Angeryw,kazzak,1248,monk,mistweaver,18,13,5
10448,Bighealz,aggra-português,1248,monk,mistweaver,24,13,11
10449,Jackål,silvermoon,1247,monk,mistweaver,21,14,7
10450,Sonydl,archimonde,1247,monk,mistweaver,22,14,8
10451,Natsuø,nemesis,1246,monk,mistweaver,18,13,5
10452,Crñ,blackmoore,1246,monk,mistweaver,24,13,11
10453,Egg,frostmane,1246,monk,mistweaver,24,13,11
10454,Srdarr,kazzak,1246,monk,mistweaver,24,13,11
10455,Йуппи,galakrond,1246,monk,mistweaver,24,13,11
10456,Эифорйя,howling-fjord,1246,monk,mistweaver,28,14,14
10457,Nesthorian,draenor,1246,monk,mistweaver,123,61,62
10458,Papimonkx,garona,1246,monk,mistweaver,30,13,17
10459,Taìka,archimonde,1245,monk,mistweaver,18,13,5
10460,Timmzý,blackmoore,1245,monk,mistweaver,18,13,5
10461,Амаранточка,howling-fjord,1244,monk,mistweaver,24,13,11
10462,Кубермонкер,gordunni,1243,monk,mistweaver,24,13,11
10463,Nìkâ,blackmoore,1243,monk,mistweaver,57,29,28
10464,Xarêlla,aegwynn,1243,monk,mistweaver,30,13,17
10465,Bigmckoy,kazzak,1242,monk,mistweaver,21,14,7
10466,Mmrkick,kazzak,1241,monk,mistweaver,24,13,11
10467,Rymz,sanguino,1241,monk,mistweaver,49,26,23
10468,Chibuku,burning-legion,1240,monk,mistweaver,24,13,11
10469,Jolude,nemesis,1239,monk,mistweaver,30,13,17
10470,Kayen,frostwhisper,1238,monk,mistweaver,46,23,23
10471,Baddany,sanguino,1238,monk,mistweaver,54,26,28
10472,Авентусс,howling-fjord,1234,monk,mistweaver,18,13,5
10473,Yukimøn,hyjal,1232,monk,mistweaver,18,13,5
10474,Drpajhiwo,burning-legion,1231,monk,mistweaver,46,27,19
10475,Chainster,defias-brotherhood,1229,monk,mistweaver,70,35,35
10476,Fisterinos,blackrock,1222,monk,mistweaver,18,13,5
10477,Vanquishlølz,archimonde,1222,monk,mistweaver,39,17,22
10478,Xplosiv,twisting-nether,1220,monk,mistweaver,18,13,5
10479,Wteg,emerald-dream,1220,monk,mistweaver,30,14,16
10480,Yèna,pozzo-delleternità,1220,monk,mistweaver,42,15,27
10481,Mondrim,burning-legion,1218,monk,mistweaver,40,16,24
10482,Фапдао,howling-fjord,1216,monk,mistweaver,38,15,23
10483,Makïi,archimonde,1214,monk,mistweaver,39,22,17
10484,Fistus,dentarg,1214,monk,mistweaver,29,13,16
10485,Bhasundara,turalyon,1212,monk,mistweaver,88,51,37
10486,Gråce,nemesis,1210,monk,mistweaver,18,13,5
10487,Monkehst,dun-modr,1210,monk,mistweaver,60,25,35
10488,Yeetkunmeep,outland,1209,monk,mistweaver,36,15,21
10489,Mofisto,bladefist,1208,monk,mistweaver,60,29,31
10490,Freemann,archimonde,1204,monk,mistweaver,70,33,37
10491,Larå,ravencrest,1204,monk,mistweaver,113,53,60
10492,Kurbanov,stormscale,1200,monk,mistweaver,27,13,14
10493,Ivi,neptulon,1197,monk,mistweaver,58,29,29
10494,Влажныйтач,soulflayer,1195,monk,mistweaver,24,14,10
10495,Zenified,ragnaros,1192,monk,mistweaver,21,13,8
10496,Ksll,silvermoon,1189,monk,mistweaver,36,17,19
10497,Jyll,malganis,1182,monk,mistweaver,23,13,10
10498,Phrynè,silvermoon,1182,monk,mistweaver,31,16,15
10499,Mîstxd,kazzak,1181,monk,mistweaver,17,13,4
10500,Jetchi,twisting-nether,1181,monk,mistweaver,36,25,11
10501,Carloz,drakthul,1174,monk,mistweaver,30,16,14
10502,Fistweavr,antonidas,1171,monk,mistweaver,36,14,22
10503,Boozmoo,stormscale,1166,monk,mistweaver,22,16,6
10504,Brewzleè,ravencrest,1165,monk,mistweaver,34,14,20
10505,Fulgrem,stormscale,1162,monk,mistweaver,19,13,6
10506,Xwtdreamz,hyjal,1156,monk,mistweaver,36,14,22
10507,Yuuhai,ravencrest,1152,monk,mistweaver,18,12,6
10508,Residùe,kazzak,1151,monk,mistweaver,18,12,6
10509,Подвижник,soulflayer,1151,monk,mistweaver,18,12,6
10510,Shixen,ragnaros,1151,monk,mistweaver,24,12,12
10511,Phyxone,twisting-nether,1151,monk,mistweaver,24,12,12
10512,Ashenore,outland,1151,monk,mistweaver,24,12,12
10513,Capkum,dun-modr,1151,monk,mistweaver,30,12,18
10514,Zesha,zuljin,1151,monk,mistweaver,30,12,18
10515,Xado,aegwynn,1150,monk,mistweaver,18,12,6
10516,Нунтяк,gordunni,1150,monk,mistweaver,24,12,12
10517,Гроксси,howling-fjord,1148,monk,mistweaver,22,13,9
10518,Cubw,archimonde,1148,monk,mistweaver,24,12,12
10519,Aryphus,blackmoore,1148,monk,mistweaver,24,12,12
10520,Tintatama,aszune,1143,monk,mistweaver,82,36,46
10521,Shiftchenko,stormscale,1142,monk,mistweaver,42,24,18
10522,Suggy,kilrogg,1139,monk,mistweaver,24,12,12
10523,Cicera,kazzak,1138,monk,mistweaver,30,12,18
10524,Riendy,silvermoon,1137,monk,mistweaver,18,12,6
10525,Syyrø,silvermoon,1137,monk,mistweaver,36,12,24
10526,Lubeï,kirin-tor,1131,monk,mistweaver,34,21,13
10527,Graffy,eonar,1128,monk,mistweaver,18,13,5
10528,Tripitakâ,dun-modr,1120,monk,mistweaver,35,13,22
10529,Badonkamonk,twilights-hammer,1119,monk,mistweaver,18,12,6
10530,Worf,haomarush,1116,monk,mistweaver,24,13,11
10531,Tsouli,twilights-hammer,1116,monk,mistweaver,24,12,12
10532,Milkabtw,kazzak,1100,monk,mistweaver,21,13,8
10533,Alphafist,argent-dawn,1093,monk,mistweaver,24,12,12
10534,Carcasce,la-croisade-écarlate,1089,monk,mistweaver,36,20,16
10535,Enceladion,burning-legion,1089,monk,mistweaver,36,16,20
10536,Cybert,blackmoore,1083,monk,mistweaver,23,12,11
10537,Hvnm,ravencrest,1082,monk,mistweaver,42,22,20
10538,Zeldrís,ragnaros,1079,monk,mistweaver,32,12,20
10539,Adgoh,tarren-mill,1070,monk,mistweaver,17,14,3
10540,Benzzy,ragnaros,1064,monk,mistweaver,19,12,7
10541,Bobbyknuckls,ravencrest,1064,monk,mistweaver,54,17,37
10542,Precocconx,stormreaver,1056,monk,mistweaver,18,11,7
10543,Snówtea,silvermoon,1056,monk,mistweaver,18,11,7
10544,Öhlinmonk,outland,1056,monk,mistweaver,18,11,7
10545,Loiyah,dun-modr,1056,monk,mistweaver,18,11,7
10546,Izuwumi,ragnaros,1056,monk,mistweaver,18,11,7
10547,Фуфинус,gordunni,1056,monk,mistweaver,24,11,13
10548,Darkmonkky,tarren-mill,1056,monk,mistweaver,24,11,13
10549,Ffxivrefugee,argent-dawn,1056,monk,mistweaver,24,11,13
10550,Kakor,gorgonnash,1055,monk,mistweaver,18,11,7
10551,Clemoine,archimonde,1055,monk,mistweaver,18,11,7
10552,Darlaa,ravencrest,1055,monk,mistweaver,18,11,7
10553,Shiftkin,stormscale,1055,monk,mistweaver,24,11,13
10554,Cochonhalall,archimonde,1055,monk,mistweaver,24,11,13
10555,Almonkdiga,sanguino,1055,monk,mistweaver,24,11,13
10556,Jakethestake,twilights-hammer,1054,monk,mistweaver,12,11,1
10557,Hærleyquin,ravencrest,1054,monk,mistweaver,18,11,7
10558,Bruceflea,blackrock,1053,monk,mistweaver,36,15,21
10559,Shàká,stormscale,1052,monk,mistweaver,12,11,1
10560,Pepesmacks,kazzak,1052,monk,mistweaver,18,11,7
10561,Windspiritt,ragnaros,1052,monk,mistweaver,24,11,13
10562,Mankee,kazzak,1052,monk,mistweaver,26,11,15
10563,Basthek,blackhand,1052,monk,mistweaver,30,11,19
10564,Lambofmonkz,stormscale,1052,monk,mistweaver,36,11,25
10565,Eynodiggity,blackmoore,1050,monk,mistweaver,24,11,13
10566,Puddinpop,auchindoun,1049,monk,mistweaver,24,11,13
10567,Shiesel,draenor,1048,monk,mistweaver,24,11,13
10568,Fisticuffs,tarren-mill,1048,monk,mistweaver,24,11,13
10569,Onlyfísts,stormscale,1047,monk,mistweaver,30,11,19
10570,Brünó,kazzak,1046,monk,mistweaver,33,22,11
10571,Maiver,stormscale,1046,monk,mistweaver,18,11,7
10572,Mjaweaver,stormscale,1046,monk,mistweaver,62,23,39
10573,Zukatan,tarren-mill,1043,monk,mistweaver,24,11,13
10574,Irphan,ravencrest,1042,monk,mistweaver,18,11,7
10575,Mcronald,blackhand,1041,monk,mistweaver,22,14,8
10576,Monkypunch,tarren-mill,1039,monk,mistweaver,28,12,16
10577,Kungfubatti,stormscale,1034,monk,mistweaver,24,11,13
10578,Dèathpunch,doomhammer,1025,monk,mistweaver,54,26,28
10579,Sydras,silvermoon,1023,monk,mistweaver,90,40,50
10580,Ugotcraned,tarren-mill,1019,monk,mistweaver,72,27,45
10581,Birdymonk,boulderfist,1009,monk,mistweaver,36,22,14
10582,Mwmkgodxz,archimonde,1007,monk,mistweaver,15,12,3
10583,Апесиинка,gordunni,1002,monk,mistweaver,24,11,13
10584,Zenchî,ysondre,1001,monk,mistweaver,22,13,9
10585,Lucebree,nozdormu,999,monk,mistweaver,48,18,30
10586,Celestine,mugthol,998,monk,mistweaver,54,25,29
10587,Kégman,silvermoon,992,monk,mistweaver,33,18,15
10588,Лалафест,soulflayer,987,monk,mistweaver,22,11,11
10589,Heäléna,ragnaros,979,monk,mistweaver,21,15,6
10590,Dipdop,blackhand,978,monk,mistweaver,39,14,25
10591,Äcé,sylvanas,972,monk,mistweaver,25,11,14
10592,Kz,culte-de-la-rive-noire,960,monk,mistweaver,12,10,2
10593,Dihsa,ragnaros,960,monk,mistweaver,12,10,2
10594,Glaphan,the-maelstrom,960,monk,mistweaver,12,10,2
10595,Ipmonk,outland,960,monk,mistweaver,12,10,2
10596,Ofwgkta,moonglade,960,monk,mistweaver,18,10,8
10597,Ræïzò,dun-morogh,960,monk,mistweaver,18,10,8
10598,Xoleck,aegwynn,960,monk,mistweaver,24,10,14
10599,Loiythree,dun-modr,960,monk,mistweaver,24,10,14
10600,Jeññie,stormscale,959,monk,mistweaver,12,10,2
10601,Mimimatrick,hyjal,959,monk,mistweaver,12,10,2
10602,Citamonk,blackmoore,959,monk,mistweaver,12,10,2
10603,Mâjô,blackhand,959,monk,mistweaver,18,10,8
10604,Kickin,burning-legion,959,monk,mistweaver,18,10,8
10605,Xadoqt,aegwynn,959,monk,mistweaver,18,10,8
10606,Zlodey,laughing-skull,959,monk,mistweaver,18,10,8
10607,Erapanzon,nemesis,959,monk,mistweaver,18,10,8
10608,Zappikmonk,silvermoon,958,monk,mistweaver,12,10,2
10609,Yotke,ravencrest,958,monk,mistweaver,18,10,8
10610,Brewmâster,kazzak,958,monk,mistweaver,18,10,8
10611,Yuyuni,laughing-skull,958,monk,mistweaver,18,10,8
10612,Búns,draenor,958,monk,mistweaver,18,10,8
10613,Bigballs,ysera,958,monk,mistweaver,24,10,14
10614,Panicfist,stormscale,957,monk,mistweaver,18,10,8
10615,Karoou,kelthuzad,957,monk,mistweaver,24,10,14
10616,Imamonk,tarren-mill,957,monk,mistweaver,24,10,14
10617,Rheinair,antonidas,956,monk,mistweaver,24,10,14
10618,Bruceliam,emerald-dream,955,monk,mistweaver,24,10,14
10619,Йомо,borean-tundra,954,monk,mistweaver,30,10,20
10620,Zøubida,draenor,952,monk,mistweaver,18,10,8
10621,Monkyd,stormscale,950,monk,mistweaver,18,10,8
10622,Ariä,marécage-de-zangar,930,monk,mistweaver,24,13,11
10623,Loctak,nathrezim,911,monk,mistweaver,18,12,6
10624,Dícxi,ravencrest,910,monk,mistweaver,17,10,7
10625,Keeba,kirin-tor,907,monk,mistweaver,125,58,67
10626,Tierrax,cthun,906,monk,mistweaver,22,12,10
10627,Behrens,defias-brotherhood,905,monk,mistweaver,21,11,10
10628,Shimmichanga,blackrock,895,monk,mistweaver,17,10,7
10629,Changzu,sanguino,894,monk,mistweaver,30,15,15
10630,Kelechi,stormreaver,894,monk,mistweaver,20,10,10
10631,Мишапяточка,howling-fjord,890,monk,mistweaver,12,11,1
10632,Eclipsè,dragonmaw,889,monk,mistweaver,17,10,7
10633,Тиктокмонк,gordunni,877,monk,mistweaver,20,11,9
10634,Remyhadley,dun-modr,864,monk,mistweaver,12,9,3
10635,Фунтих,soulflayer,864,monk,mistweaver,12,9,3
10636,Roadrunnér,ravencrest,864,monk,mistweaver,12,9,3
10637,Iixil,sylvanas,864,monk,mistweaver,12,9,3
10638,Belärus,outland,864,monk,mistweaver,18,9,9
10639,Kebabrolle,blackrock,864,monk,mistweaver,18,9,9
10640,Perelman,burning-legion,864,monk,mistweaver,18,9,9
10641,Jiest,outland,864,monk,mistweaver,18,9,9
10642,Ultrasense,outland,864,monk,mistweaver,18,9,9
10643,Polch,archimonde,864,monk,mistweaver,18,9,9
10644,Pafia,ysondre,864,monk,mistweaver,18,9,9
10645,Luvmollý,silvermoon,864,monk,mistweaver,24,9,15
10646,Balia,blackrock,864,monk,mistweaver,24,9,15
10647,Pô,sanguino,863,monk,mistweaver,12,9,3
10648,Shabaz,draenor,863,monk,mistweaver,12,9,3
10649,Schane,zuluhed,863,monk,mistweaver,12,9,3
10650,Simonex,ravencrest,863,monk,mistweaver,12,9,3
10651,Kyleestrutt,stormscale,863,monk,mistweaver,18,9,9
10652,Shokko,uldaman,863,monk,mistweaver,18,9,9
10653,Monkwithlove,blackhand,863,monk,mistweaver,18,9,9
10654,Nimander,burning-legion,863,monk,mistweaver,18,9,9
10655,Kattlåda,darkspear,863,monk,mistweaver,18,9,9
10656,Spoompls,argent-dawn,863,monk,mistweaver,18,9,9
10657,Nirexi,blackrock,863,monk,mistweaver,21,10,11
10658,Beerbringer,kazzak,862,monk,mistweaver,12,9,3
10659,Mwsama,stormscale,861,monk,mistweaver,12,9,3
10660,Konexzx,blackmoore,861,monk,mistweaver,12,9,3
10661,Oddessa,ravenholdt,860,monk,mistweaver,12,9,3
10662,Мирюзаки,gordunni,859,monk,mistweaver,18,9,9
10663,Mistréss,silvermoon,858,monk,mistweaver,18,9,9
10664,Jumper,xavius,858,monk,mistweaver,18,9,9
10665,Herdom,blackmoore,856,monk,mistweaver,12,9,3
10666,Blackmonk,chromaggus,852,monk,mistweaver,18,9,9
10667,Cudworth,silvermoon,850,monk,mistweaver,12,9,3
10668,ßæutiful,silvermoon,835,monk,mistweaver,30,13,17
10669,Sheishot,kazzak,829,monk,mistweaver,20,10,10
10670,Melysà,antonidas,815,monk,mistweaver,17,9,8
10671,Drugashe,archimonde,815,monk,mistweaver,23,9,14
10672,Tèam,defias-brotherhood,810,monk,mistweaver,15,9,6
10673,Extaszeh,turalyon,802,monk,mistweaver,17,11,6
10674,Nyrkkiseski,outland,799,monk,mistweaver,11,9,2
10675,Hurjat,stormreaver,768,monk,mistweaver,12,8,4
10676,Ганссмонк,blackscar,768,monk,mistweaver,12,8,4
10677,Brutamonk,blackmoore,768,monk,mistweaver,12,8,4
10678,Kirkeý,ravencrest,768,monk,mistweaver,12,8,4
10679,Ikuyaa,ravencrest,768,monk,mistweaver,12,8,4
10680,Jiuhjitsu,blackmoore,768,monk,mistweaver,12,8,4
10681,Botweaver,tarren-mill,768,monk,mistweaver,12,8,4
10682,Miamalkøva,nemesis,768,monk,mistweaver,12,8,4
10683,Lmnsx,ravencrest,768,monk,mistweaver,12,8,4
10684,Fckisrael,archimonde,768,monk,mistweaver,12,8,4
10685,Mástermônkèy,tarren-mill,768,monk,mistweaver,12,8,4
10686,Shyrea,nazjatar,768,monk,mistweaver,12,8,4
10687,Zødiac,quelthalas,768,monk,mistweaver,12,8,4
10688,Adamlól,tarren-mill,768,monk,mistweaver,18,8,10
10689,Ryx,twisting-nether,768,monk,mistweaver,18,8,10
10690,Ronkingkong,ravencrest,768,monk,mistweaver,18,8,10
10691,Nsq,ravencrest,768,monk,mistweaver,18,8,10
10692,Якунка,soulflayer,768,monk,mistweaver,18,8,10
10693,Tøxicweaver,kazzak,768,monk,mistweaver,18,8,10
10694,Maigraith,malganis,767,monk,mistweaver,12,8,4
10695,Moistweaver,hellfire,767,monk,mistweaver,12,8,4
10696,Гачитварина,galakrond,767,monk,mistweaver,12,8,4
10697,Leblatt,blackhand,767,monk,mistweaver,12,8,4
10698,Adzk,tarren-mill,767,monk,mistweaver,12,8,4
10699,Tanyà,hyjal,767,monk,mistweaver,12,8,4
10700,Brêwjob,archimonde,767,monk,mistweaver,12,8,4
10701,Мистхоррор,gordunni,767,monk,mistweaver,12,8,4
10702,Lin,nathrezim,767,monk,mistweaver,12,8,4
10703,Gízmö,tarren-mill,767,monk,mistweaver,18,8,10
10704,Saduh,thrall,767,monk,mistweaver,18,8,10
10705,Qî,ravencrest,767,monk,mistweaver,24,8,16
10706,Moohamood,argent-dawn,767,monk,mistweaver,24,8,16
10707,Индоран,howling-fjord,766,monk,mistweaver,12,8,4
10708,Nulojeu,archimonde,766,monk,mistweaver,12,8,4
10709,Riip,ysondre,766,monk,mistweaver,12,8,4
10710,Nela,sanguino,766,monk,mistweaver,18,8,10
10711,Gakunie,blackhand,766,monk,mistweaver,18,8,10
10712,Hersmonk,drakthul,765,monk,mistweaver,12,8,4
10713,Lûxz,ragnaros,765,monk,mistweaver,18,8,10
10714,Boomshaq,defias-brotherhood,765,monk,mistweaver,18,8,10
10715,Gammelbruno,azshara,763,monk,mistweaver,12,8,4
10716,Pekinn,sanguino,761,monk,mistweaver,18,8,10
10717,Wangho,magtheridon,760,monk,mistweaver,24,8,16
10718,Ляосинь,deepholm,758,monk,mistweaver,18,8,10
10719,Сукавкимоно,soulflayer,758,monk,mistweaver,18,8,10
10720,Hidekami,archimonde,702,monk,mistweaver,22,8,14
10721,Merçury,dun-morogh,672,monk,mistweaver,12,7,5
10722,Shkorwi,drakthul,672,monk,mistweaver,12,7,5
10723,Vingurd,terokkar,672,monk,mistweaver,12,7,5
10724,Yulon,blackrock,672,monk,mistweaver,12,7,5
10725,Coularx,stormscale,672,monk,mistweaver,12,7,5
10726,Mêshuggâh,malganis,672,monk,mistweaver,12,7,5
10727,Oneshotmacro,spinebreaker,672,monk,mistweaver,12,7,5
10728,Ana,eredar,672,monk,mistweaver,12,7,5
10729,Bekachu,ragnaros,672,monk,mistweaver,12,7,5
10730,Quendi,frostwolf,672,monk,mistweaver,12,7,5
10731,Monkel,frostwolf,672,monk,mistweaver,12,7,5
10732,Dollyqt,ravencrest,672,monk,mistweaver,12,7,5
10733,Hessuzen,stormreaver,672,monk,mistweaver,12,7,5
10734,Prismaticx,ravencrest,672,monk,mistweaver,12,7,5
10735,Fugmonk,ravencrest,672,monk,mistweaver,12,7,5
10736,Mjoo,blackrock,672,monk,mistweaver,12,7,5
10737,Irønmaxx,die-aldor,672,monk,mistweaver,12,7,5
10738,Xdhehehexd,twisting-nether,672,monk,mistweaver,12,7,5
10739,Linshai,eredar,672,monk,mistweaver,12,7,5
10740,Kbwser,silvermoon,672,monk,mistweaver,12,7,5
10741,Flexify,outland,672,monk,mistweaver,12,7,5
10742,Mommymonk,outland,672,monk,mistweaver,12,7,5
10743,Frajer,auchindoun,672,monk,mistweaver,12,7,5
10744,Bamiegoreng,aegwynn,672,monk,mistweaver,12,7,5
10745,Kushvendorx,silvermoon,672,monk,mistweaver,12,7,5
10746,Tøwtc,outland,672,monk,mistweaver,12,7,5
10747,Dodomino,archimonde,672,monk,mistweaver,12,7,5
10748,Yumhai,dun-modr,672,monk,mistweaver,18,7,11
10749,Scz,draenor,672,monk,mistweaver,18,7,11
10750,Stdzym,tarren-mill,672,monk,mistweaver,18,7,11
10751,Leïsha,ysondre,672,monk,mistweaver,18,7,11
10752,Abdulhealer,stormscale,672,monk,mistweaver,18,7,11
10753,Anadia,blackrock,671,monk,mistweaver,12,7,5
10754,Кисеч,soulflayer,671,monk,mistweaver,12,7,5
10755,Jagermonk,doomhammer,671,monk,mistweaver,12,7,5
10756,Conguitø,colinas-pardas,671,monk,mistweaver,12,7,5
10757,Dumplings,earthen-ring,671,monk,mistweaver,12,7,5
10758,Chigee,kazzak,671,monk,mistweaver,12,7,5
10759,Lazuros,auchindoun,671,monk,mistweaver,18,7,11
10760,Uncleheal,tarren-mill,671,monk,mistweaver,18,7,11
10761,Rebekko,pozzo-delleternità,671,monk,mistweaver,18,7,11
10762,Jarô,silvermoon,671,monk,mistweaver,24,7,17
10763,Tokkz,eredar,670,monk,mistweaver,10,8,2
10764,Ytonie,gorgonnash,670,monk,mistweaver,12,7,5
10765,Bréwsléé,ragnaros,670,monk,mistweaver,12,7,5
10766,Zendyy,argent-dawn,670,monk,mistweaver,12,7,5
10767,Ívó,ragnaros,669,monk,mistweaver,18,7,11
10768,Fistarfrans,sylvanas,639,monk,mistweaver,8,8,0
10769,Monknice,sylvanas,639,monk,mistweaver,17,7,10
10770,Klischi,taerar,639,monk,mistweaver,17,7,10
10771,Chucknorrís,kilrogg,624,monk,mistweaver,15,7,8
10772,Akkadianx,ravencrest,623,monk,mistweaver,17,7,10
10773,Redundänt,kazzak,576,monk,mistweaver,6,6,0
10774,Lilithrevan,frostmourne,576,monk,mistweaver,6,6,0
10775,Кувырбек,howling-fjord,576,monk,mistweaver,6,6,0
10776,Chìless,shadowsong,576,monk,mistweaver,6,6,0
10777,Orfantal,ravencrest,576,monk,mistweaver,6,6,0
10778,Telder,sylvanas,576,monk,mistweaver,12,6,6
10779,Wajøba,blackhand,576,monk,mistweaver,12,6,6
10780,Bigkim,khadgar,576,monk,mistweaver,12,6,6
10781,Pivomamrad,drakthul,576,monk,mistweaver,12,6,6
10782,Akuuji,silvermoon,576,monk,mistweaver,12,6,6
10783,Visk,blackmoore,576,monk,mistweaver,12,6,6
10784,Kæmará,blackrock,576,monk,mistweaver,12,6,6
10785,Mahøni,malganis,576,monk,mistweaver,12,6,6
10786,Vedak,stormreaver,576,monk,mistweaver,12,6,6
10787,Mistur,blackrock,576,monk,mistweaver,12,6,6
10788,Mørbradgryde,silvermoon,576,monk,mistweaver,12,6,6
10789,Potkuri,stormreaver,576,monk,mistweaver,12,6,6
10790,Poohya,silvermoon,576,monk,mistweaver,12,6,6
10791,Cøcøøn,blackrock,576,monk,mistweaver,12,6,6
10792,Vàlky,outland,576,monk,mistweaver,12,6,6
10793,Maybeexm,ravencrest,576,monk,mistweaver,12,6,6
10794,Oiorie,twisting-nether,576,monk,mistweaver,12,6,6
10795,Musaya,chamber-of-aspects,576,monk,mistweaver,12,6,6
10796,Annoyingtwo,archimonde,576,monk,mistweaver,12,6,6
10797,Féfè,archimonde,576,monk,mistweaver,12,6,6
10798,Iliketofist,ravencrest,576,monk,mistweaver,12,6,6
10799,Ygêrne,archimonde,576,monk,mistweaver,12,6,6
10800,Aritisi,tarren-mill,576,monk,mistweaver,12,6,6
10801,Goamix,ravencrest,576,monk,mistweaver,12,6,6
10802,Кончеглаз,soulflayer,576,monk,mistweaver,12,6,6
10803,Коумана,gordunni,576,monk,mistweaver,15,7,8
10804,Fatcarry,blackrock,576,monk,mistweaver,18,6,12
10805,Heyami,ravencrest,576,monk,mistweaver,24,6,18
10806,Itsthemonkky,tarren-mill,576,monk,mistweaver,24,6,18
10807,Tojokirumi,dalaran,575,monk,mistweaver,6,6,0
10808,Rakowo,arthas,575,monk,mistweaver,12,6,6
10809,Vexzen,tarren-mill,575,monk,mistweaver,12,6,6
10810,Samie,ravencrest,575,monk,mistweaver,12,6,6
10811,Tily,stormreaver,575,monk,mistweaver,12,6,6
10812,Фериго,gordunni,575,monk,mistweaver,12,6,6
10813,Drlyn,blackmoore,575,monk,mistweaver,12,6,6
10814,Painswîft,blackhand,575,monk,mistweaver,18,6,12
10815,Mulana,sanguino,575,monk,mistweaver,18,6,12
10816,Othalain,silvermoon,574,monk,mistweaver,12,6,6
10817,Gârdt,blackmoore,573,monk,mistweaver,6,6,0
10818,Zedruu,tarren-mill,571,monk,mistweaver,12,6,6
10819,Xalyà,archimonde,556,monk,mistweaver,14,8,6
10820,Psychö,zuljin,538,monk,mistweaver,17,6,11
10821,Trymax,blackmoore,522,monk,mistweaver,17,7,10
10822,Maikez,stormreaver,512,monk,mistweaver,16,6,10
10823,Ûnknöw,archimonde,511,monk,mistweaver,8,6,2
10824,Indris,dun-modr,511,monk,mistweaver,11,6,5
10825,Tarzaki,hyjal,494,monk,mistweaver,13,6,7
10826,Dánný,antonidas,494,monk,mistweaver,13,6,7
10827,Керизз,gordunni,480,monk,mistweaver,6,5,1
10828,Павнмонкх,gordunni,480,monk,mistweaver,6,5,1
10829,Такиера,gordunni,480,monk,mistweaver,6,5,1
10830,Habmit,ravencrest,480,monk,mistweaver,6,5,1
10831,Kaowar,nerzhul,480,monk,mistweaver,6,5,1
10832,Lovange,silvermoon,480,monk,mistweaver,6,5,1
10833,Ohmegah,frostmane,480,monk,mistweaver,6,5,1
10834,Holyrop,aegwynn,480,monk,mistweaver,6,5,1
10835,Cattleyah,ysondre,480,monk,mistweaver,6,5,1
10836,Djsnake,blackrock,480,monk,mistweaver,6,5,1
10837,Niborc,doomhammer,480,monk,mistweaver,6,5,1
10838,Dukhi,kazzak,480,monk,mistweaver,6,5,1
10839,Applestrûdel,blackrock,480,monk,mistweaver,6,5,1
10840,Blamethegame,hyjal,480,monk,mistweaver,6,5,1
10841,Stromon,silvermoon,480,monk,mistweaver,6,5,1
10842,Fistpunk,kazzak,480,monk,mistweaver,6,5,1
10843,Sio,dentarg,480,monk,mistweaver,6,5,1
10844,Astolfochan,silvermoon,480,monk,mistweaver,6,5,1
10845,Pafia,sargeras,480,monk,mistweaver,6,5,1
10846,Sloopkogel,tarren-mill,480,monk,mistweaver,6,5,1
10847,Blinkër,sanguino,480,monk,mistweaver,6,5,1
10848,Jacm,blackhand,480,monk,mistweaver,12,5,7
10849,Siezlebabo,blackrock,480,monk,mistweaver,12,5,7
10850,Folfimo,silvermoon,480,monk,mistweaver,12,5,7
10851,Minervaez,grim-batol,480,monk,mistweaver,12,5,7
10852,Midgetyoda,outland,480,monk,mistweaver,12,5,7
10853,Elhäbedehä,eredar,480,monk,mistweaver,12,5,7
10854,Erandja,silvermoon,480,monk,mistweaver,12,5,7
10855,Bountyño,dun-modr,480,monk,mistweaver,12,5,7
10856,Kandislee,ravencrest,480,monk,mistweaver,12,5,7
10857,Gemil,argent-dawn,480,monk,mistweaver,12,5,7
10858,Holyropx,aegwynn,480,monk,mistweaver,12,5,7
10859,Tîptap,blackrock,480,monk,mistweaver,12,5,7
10860,Лолидевочка,soulflayer,480,monk,mistweaver,12,5,7
10861,Simòna,dun-modr,480,monk,mistweaver,12,5,7
10862,Pandacus,silvermoon,480,monk,mistweaver,12,5,7
10863,Zóma,ragnaros,480,monk,mistweaver,12,5,7
10864,Whytoosxy,silvermoon,480,monk,mistweaver,18,5,13
10865,Patiencebro,archimonde,480,monk,mistweaver,18,5,13
10866,Madraven,ravencrest,480,monk,mistweaver,18,5,13
10867,Diabolùs,blackmoore,480,monk,mistweaver,18,5,13
10868,Ðéliora,la-croisade-écarlate,480,monk,mistweaver,24,5,19
10869,Proxxona,eredar,479,monk,mistweaver,6,5,1
10870,Jackamonk,kazzak,479,monk,mistweaver,12,5,7
10871,Sotqyy,stormscale,479,monk,mistweaver,12,5,7
10872,Яутжа,soulflayer,479,monk,mistweaver,12,5,7
10873,Knotze,eredar,479,monk,mistweaver,18,5,13
10874,Toaborsten,tarren-mill,478,monk,mistweaver,6,5,1
10875,Bensó,stormscale,478,monk,mistweaver,6,5,1
10876,Брэйки,lich-king,478,monk,mistweaver,18,5,13
10877,Mistyheals,nagrand,474,monk,mistweaver,12,5,7
10878,Jsuispasheal,dalaran,473,monk,mistweaver,12,5,7
10879,Filomenata,rexxar,469,monk,mistweaver,19,5,14
10880,Pìmpìnelle,garona,432,monk,mistweaver,9,6,3
10881,Dræk,twisting-nether,426,monk,mistweaver,19,6,13
10882,Годъяр,gordunni,415,monk,mistweaver,8,5,3
10883,Brxmonki,antonidas,384,monk,mistweaver,6,4,2
10884,Олежатоксик,gordunni,384,monk,mistweaver,6,4,2
10885,Mushush,draenor,384,monk,mistweaver,6,4,2
10886,Katmunk,kazzak,384,monk,mistweaver,6,4,2
10887,Alomonk,archimonde,384,monk,mistweaver,6,4,2
10888,Муррчалкин,howling-fjord,384,monk,mistweaver,6,4,2
10889,Escopetin,los-errantes,384,monk,mistweaver,6,4,2
10890,Bhrag,die-aldor,384,monk,mistweaver,6,4,2
10891,Yoogychi,ravencrest,384,monk,mistweaver,6,4,2
10892,Xurf,draenor,384,monk,mistweaver,6,4,2
10893,Глитч,deepholm,384,monk,mistweaver,6,4,2
10894,Ennamoly,blackmoore,384,monk,mistweaver,6,4,2
10895,Леобтв,soulflayer,384,monk,mistweaver,6,4,2
10896,Highline,draenor,384,monk,mistweaver,6,4,2
10897,Camlen,draenor,384,monk,mistweaver,6,4,2
10898,Ryac,defias-brotherhood,384,monk,mistweaver,6,4,2
10899,Nillebpgodx,kazzak,384,monk,mistweaver,6,4,2
10900,Luciellie,archimonde,384,monk,mistweaver,6,4,2
10901,Lizardspock,hyjal,384,monk,mistweaver,6,4,2
10902,Peaceweaver,ravencrest,384,monk,mistweaver,6,4,2
10903,Zanizu,blackhand,384,monk,mistweaver,6,4,2
10904,Bigflex,conseil-des-ombres,384,monk,mistweaver,6,4,2
10905,Erannas,turalyon,384,monk,mistweaver,6,4,2
10906,Enveløp,stormscale,384,monk,mistweaver,6,4,2
10907,Эрумонк,gordunni,384,monk,mistweaver,6,4,2
10908,Monkersquad,doomhammer,384,monk,mistweaver,6,4,2
10909,Sugra,frostwolf,384,monk,mistweaver,6,4,2
10910,Bratana,dun-morogh,384,monk,mistweaver,6,4,2
10911,Trancendent,silvermoon,384,monk,mistweaver,6,4,2
10912,Punkfukanda,drakthul,384,monk,mistweaver,6,4,2
10913,Dath,outland,384,monk,mistweaver,6,4,2
10914,Latify,todeswache,384,monk,mistweaver,6,4,2
10915,Jemijedno,drakthul,384,monk,mistweaver,6,4,2
10916,Valdaras,runetotem,384,monk,mistweaver,6,4,2
10917,Naìsh,arygos,384,monk,mistweaver,6,4,2
10918,Nêrfmeta,kazzak,384,monk,mistweaver,6,4,2
10919,Missislee,aegwynn,384,monk,mistweaver,6,4,2
10920,Bréwmáster,silvermoon,384,monk,mistweaver,6,4,2
10921,Foaqer,aegwynn,384,monk,mistweaver,6,4,2
10922,Callim,blackrock,384,monk,mistweaver,6,4,2
10923,Barracüs,dun-modr,384,monk,mistweaver,6,4,2
10924,Gangichi,blackhand,384,monk,mistweaver,9,5,4
10925,Irishdëmon,ravencrest,384,monk,mistweaver,10,4,6
10926,Nebelwandler,blackhand,384,monk,mistweaver,12,4,8
10927,Ltmdwarf,ravencrest,384,monk,mistweaver,12,4,8
10928,Dromarch,dun-modr,384,monk,mistweaver,12,4,8
10929,Akùmawíns,archimonde,384,monk,mistweaver,12,4,8
10930,Woofi,tarren-mill,384,monk,mistweaver,12,4,8
10931,Монкиннияя,gordunni,384,monk,mistweaver,12,4,8
10932,Eth,nagrand,384,monk,mistweaver,12,4,8
10933,Audaz,dun-modr,384,monk,mistweaver,12,4,8
10934,Invsionrush,crushridge,384,monk,mistweaver,12,4,8
10935,Слишкомхорош,howling-fjord,384,monk,mistweaver,12,4,8
10936,Daitaro,ravencrest,384,monk,mistweaver,12,4,8
10937,Тсайм,howling-fjord,384,monk,mistweaver,12,4,8
10938,Supwithat,kazzak,383,monk,mistweaver,6,4,2
10939,Xentimus,kazzak,383,monk,mistweaver,12,4,8
10940,Senseithai,trollbane,383,monk,mistweaver,12,4,8
10941,Drugarix,uldaman,382,monk,mistweaver,6,4,2
10942,Fkflying,defias-brotherhood,381,monk,mistweaver,12,4,8
10943,Geeberz,twisting-nether,380,monk,mistweaver,12,4,8
10944,Matrim,arathor,351,monk,mistweaver,8,5,3
10945,Chiá,tarren-mill,351,monk,mistweaver,11,4,7
10946,Thiccbaby,kazzak,336,monk,mistweaver,9,4,5
10947,Ilikeducks,ravencrest,319,monk,mistweaver,5,4,1
10948,Zaalleh,draenor,319,monk,mistweaver,5,4,1
10949,Strillen,twisting-nether,304,monk,mistweaver,7,4,3
10950,Timmyßênz,kaelthas,288,monk,mistweaver,6,3,3
10951,Domedagsdamp,draenor,288,monk,mistweaver,6,3,3
10952,Lassador,onyxia,288,monk,mistweaver,6,3,3
10953,Kragor,eredar,288,monk,mistweaver,6,3,3
10954,Saneshayne,ravencrest,288,monk,mistweaver,6,3,3
10955,Mecin,ragnaros,288,monk,mistweaver,6,3,3
10956,Uggs,hyjal,288,monk,mistweaver,6,3,3
10957,Киликххл,deathguard,288,monk,mistweaver,6,3,3
10958,Bullbøx,chamber-of-aspects,288,monk,mistweaver,6,3,3
10959,Heramonk,dun-modr,288,monk,mistweaver,6,3,3
10960,Zyrosmonk,blackmoore,288,monk,mistweaver,6,3,3
10961,Culiacàn,blackmoore,288,monk,mistweaver,6,3,3
10962,Córporation,outland,288,monk,mistweaver,6,3,3
10963,Píco,gorgonnash,288,monk,mistweaver,6,3,3
10964,Perikencito,dun-modr,288,monk,mistweaver,6,3,3
10965,Родо,blackscar,288,monk,mistweaver,6,3,3
10966,Rhatid,twisting-nether,288,monk,mistweaver,6,3,3
10967,Shoskio,chamber-of-aspects,288,monk,mistweaver,6,3,3
10968,Lp,mugthol,288,monk,mistweaver,6,3,3
10969,Fairhand,emerald-dream,288,monk,mistweaver,6,3,3
10970,Lanuia,aegwynn,288,monk,mistweaver,6,3,3
10971,Chakuro,ravencrest,288,monk,mistweaver,6,3,3
10972,Craneovic,kult-der-verdammten,288,monk,mistweaver,6,3,3
10973,Kätelyys,dun-modr,288,monk,mistweaver,6,3,3
10974,Coalsack,outland,288,monk,mistweaver,6,3,3
10975,Wèéman,grim-batol,288,monk,mistweaver,6,3,3
10976,Moontríx,kazzak,288,monk,mistweaver,6,3,3
10977,Chazu,outland,288,monk,mistweaver,6,3,3
10978,Dråf,ysondre,288,monk,mistweaver,6,3,3
10979,Louiemon,outland,288,monk,mistweaver,6,3,3
10980,Stolas,spinebreaker,288,monk,mistweaver,6,3,3
10981,Xanderpowa,sanguino,288,monk,mistweaver,6,3,3
10982,Коррелир,howling-fjord,288,monk,mistweaver,6,3,3
10983,Atommyran,frostmane,288,monk,mistweaver,6,3,3
10984,Loempia,outland,288,monk,mistweaver,6,3,3
10985,Threesíxníne,dun-morogh,288,monk,mistweaver,6,3,3
10986,Cheriedevile,drakthul,288,monk,mistweaver,6,3,3
10987,Saáru,argent-dawn,288,monk,mistweaver,6,3,3
10988,Moinalisaa,outland,288,monk,mistweaver,6,3,3
10989,Mickeyworms,archimonde,288,monk,mistweaver,6,3,3
10990,Koba,frostwolf,288,monk,mistweaver,6,3,3
10991,Fettakules,eredar,288,monk,mistweaver,6,3,3
10992,Kylâas,die-ewige-wacht,288,monk,mistweaver,6,3,3
10993,Baisi,blackhand,288,monk,mistweaver,6,3,3
10994,Relentlessly,blackrock,288,monk,mistweaver,6,3,3
10995,Totemlygodx,alakir,288,monk,mistweaver,6,3,3
10996,Chisurgeon,outland,288,monk,mistweaver,6,3,3
10997,Wisebeb,les-clairvoyants,288,monk,mistweaver,6,3,3
10998,Räpeltäjä,stormreaver,288,monk,mistweaver,6,3,3
10999,Demmonkz,stormreaver,288,monk,mistweaver,6,3,3
11000,Rípple,alakir,288,monk,mistweaver,6,3,3
11001,Kaizenthor,runetotem,288,monk,mistweaver,6,3,3
11002,Tiddor,burning-legion,288,monk,mistweaver,6,3,3
11003,Fistwave,malganis,288,monk,mistweaver,6,3,3
11004,Mistless,ragnaros,288,monk,mistweaver,6,3,3
11005,Leikô,grim-batol,288,monk,mistweaver,6,3,3
11006,Ruurruuru,archimonde,288,monk,mistweaver,6,3,3
11007,Crommul,burning-legion,288,monk,mistweaver,6,3,3
11008,Askmeout,ravencrest,288,monk,mistweaver,7,3,4
11009,Drunklee,aegwynn,288,monk,mistweaver,12,3,9
11010,Olîvê,ravencrest,288,monk,mistweaver,12,3,9
11011,Jinora,theradras,288,monk,mistweaver,12,3,9
11012,Løkî,culte-de-la-rive-noire,288,monk,mistweaver,12,3,9
11013,Tossen,ragnaros,288,monk,mistweaver,12,3,9
11014,Justfistyoux,archimonde,288,monk,mistweaver,12,3,9
11015,Leøni,malfurion,288,monk,mistweaver,12,3,9
11016,Wkiller,outland,288,monk,mistweaver,12,3,9
11017,Brewdooms,laughing-skull,288,monk,mistweaver,12,3,9
11018,Playboicarti,frostwolf,287,monk,mistweaver,6,3,3
11019,Bo,malorne,287,monk,mistweaver,6,3,3
11020,Ryanshazier,eredar,287,monk,mistweaver,6,3,3
11021,Brizs,outland,287,monk,mistweaver,6,3,3
11022,Hanumahn,kilrogg,287,monk,mistweaver,12,3,9
11023,Pepefocho,sanguino,286,monk,mistweaver,6,3,3
11024,Papermakerx,blackrock,256,monk,mistweaver,4,4,0
11025,Trlmøna,gorgonnash,240,monk,mistweaver,9,4,5
11026,Pikajeww,kazzak,239,monk,mistweaver,5,3,2
11027,Арнольдовна,blackscar,234,monk,mistweaver,17,4,13
11028,Colita,kazzak,233,monk,mistweaver,16,5,11
11029,Jadefain,argent-dawn,192,monk,mistweaver,6,2,4
11030,Kûngfu,tarren-mill,192,monk,mistweaver,6,2,4
11031,Auaaua,ravencrest,192,monk,mistweaver,6,2,4
11032,Saintmoon,drakthul,192,monk,mistweaver,6,2,4
11033,Зараз,gordunni,192,monk,mistweaver,6,2,4
11034,Tøngpø,argent-dawn,192,monk,mistweaver,6,2,4
11035,Fistmeg,grim-batol,192,monk,mistweaver,6,2,4
11036,Jetsweep,kazzak,192,monk,mistweaver,6,2,4
11037,Mystize,shattered-hand,192,monk,mistweaver,6,2,4
11038,Acbcz,draenor,192,monk,mistweaver,6,2,4
11039,Rgkekw,dun-modr,192,monk,mistweaver,6,2,4
11040,Sînge,archimonde,192,monk,mistweaver,6,2,4
11041,Dalaipyjama,quelthalas,192,monk,mistweaver,6,2,4
11042,Bakersdozen,tarren-mill,192,monk,mistweaver,6,2,4
11043,Domingovivas,dun-modr,192,monk,mistweaver,6,2,4
11044,Discoelysia,outland,192,monk,mistweaver,6,2,4
11045,Люсилью,howling-fjord,192,monk,mistweaver,6,2,4
11046,Exbuddhist,outland,192,monk,mistweaver,6,2,4
11047,Kmorhin,antonidas,192,monk,mistweaver,6,2,4
11048,Jolifine,alleria,192,monk,mistweaver,6,2,4
11049,Rbgmachine,burning-legion,192,monk,mistweaver,6,2,4
11050,Trippyv,ragnaros,192,monk,mistweaver,6,2,4
11051,Кулаквтебе,borean-tundra,192,monk,mistweaver,6,2,4
11052,Siouxxsie,thunderhorn,192,monk,mistweaver,6,2,4
11053,Kapud,twisting-nether,192,monk,mistweaver,6,2,4
11054,Syy,medivh,192,monk,mistweaver,6,2,4
11055,Mouhous,hellscream,192,monk,mistweaver,6,2,4
11056,Espectrå,dun-modr,192,monk,mistweaver,6,2,4
11057,Тэсси,blackscar,192,monk,mistweaver,6,2,4
11058,Zywoo,emerald-dream,192,monk,mistweaver,6,2,4
11059,Merlyñ,blackmoore,192,monk,mistweaver,6,2,4
11060,Dennismansix,sylvanas,192,monk,mistweaver,6,2,4
11061,Dunkfjås,stormscale,192,monk,mistweaver,6,2,4
11062,Johnsôn,blackmoore,192,monk,mistweaver,6,2,4
11063,Loveít,blackrock,192,monk,mistweaver,6,2,4
11064,Fisterxd,blackrock,192,monk,mistweaver,6,2,4
11065,Scorpìon,blackrock,192,monk,mistweaver,6,2,4
11066,Yinsho,stormscale,192,monk,mistweaver,6,2,4
11067,Daltailr,silvermoon,192,monk,mistweaver,12,2,10
11068,Konnîchîwa,kazzak,192,monk,mistweaver,12,2,10
11069,Tsifsakari,silvermoon,192,monk,mistweaver,12,2,10
11070,Ascrem,ragnaros,192,monk,mistweaver,12,2,10
11071,Чвка,booty-bay,191,monk,mistweaver,6,2,4
11072,Hisagi,khaz-modan,191,monk,mistweaver,6,2,4
11073,Sargnorak,dalaran,191,monk,mistweaver,6,2,4
11074,Pandasia,kargath,186,monk,mistweaver,16,4,12
11075,Andrah,blackmoore,185,monk,mistweaver,14,4,10
11076,Swiftmonky,azuremyst,159,monk,mistweaver,5,2,3
11077,Quotes,darksorrow,138,monk,mistweaver,10,4,6
11078,Monkeymain,tarren-mill,138,monk,mistweaver,11,4,7
11079,Зрти,gordunni,138,monk,mistweaver,12,4,8
11080,Shenlong,burning-blade,138,monk,mistweaver,14,3,11
11081,Wraq,tarren-mill,128,monk,mistweaver,4,2,2
11082,Cheechong,grim-batol,127,monk,mistweaver,8,2,6
11083,Mynaira,tarren-mill,112,monk,mistweaver,19,2,17
11084,Jessiemonk,blackhand,96,monk,mistweaver,6,1,5
11085,Pitit,outland,96,monk,mistweaver,6,1,5
11086,Moorf,ravencrest,96,monk,mistweaver,6,1,5
11087,Itxelita,zuljin,96,monk,mistweaver,6,1,5
11088,Pream,blackrock,96,monk,mistweaver,6,1,5
11089,Boîndíl,malfurion,96,monk,mistweaver,6,1,5
11090,Kano,burning-legion,96,monk,mistweaver,6,1,5
11091,Smlpp,kazzak,96,monk,mistweaver,6,1,5
11092,Mongretod,ravencrest,96,monk,mistweaver,6,1,5
11093,Rostick,drakthul,96,monk,mistweaver,6,1,5
11094,Monkolben,blackmoore,96,monk,mistweaver,6,1,5
11095,Lìlíy,taerar,96,monk,mistweaver,6,1,5
11096,Whywalker,silvermoon,96,monk,mistweaver,6,1,5
11097,Glivilalis,drekthar,96,monk,mistweaver,6,1,5
11098,Legpunch,the-maelstrom,96,monk,mistweaver,6,1,5
11099,Антошамв,gordunni,96,monk,mistweaver,6,1,5
11100,Brandy,kazzak,96,monk,mistweaver,6,1,5
11101,Kegrøll,doomhammer,96,monk,mistweaver,6,1,5
11102,Brewbunnyqt,thrall,96,monk,mistweaver,6,1,5
11103,Brixelol,kazzak,96,monk,mistweaver,6,1,5
11104,Botsmw,kazzak,96,monk,mistweaver,6,1,5
11105,Ytjin,draenor,96,monk,mistweaver,6,1,5
11106,Jusex,stormreaver,96,monk,mistweaver,6,1,5
11107,Whoszeus,archimonde,96,monk,mistweaver,6,1,5
11108,Àómìñêdâìkí,lightnings-blade,96,monk,mistweaver,6,1,5
11109,Bænkai,naxxramas,96,monk,mistweaver,6,1,5
11110,Renegatt,twisting-nether,96,monk,mistweaver,6,1,5
11111,Assaalaria,argent-dawn,96,monk,mistweaver,6,1,5
11112,Chîca,ysondre,96,monk,mistweaver,6,1,5
11113,Shîïna,ysondre,96,monk,mistweaver,6,1,5
11114,Capos,wrathbringer,96,monk,mistweaver,11,1,10
11115,Xiâomèi,dun-modr,96,monk,mistweaver,12,1,11
11116,Upbringer,ragnaros,96,monk,mistweaver,12,1,11
11117,Griffens,argent-dawn,79,monk,mistweaver,5,1,4
11118,Moreløs,stormscale,42,monk,mistweaver,12,3,9
11119,Monkeykung,defias-brotherhood,40,monk,mistweaver,16,3,13
11120,Padawang,twisting-nether,767,monk,brewmaster,24,8,16
11121,Tayoo,aegwynn,192,monk,brewmaster,6,2,4
11122,Lubeï,kirin-tor,96,monk,brewmaster,6,1,5
11123,Tylee,tarren-mill,96,monk,brewmaster,6,1,5
11124,Lòthbar,confrérie-du-thorium,63,monk,brewmaster,2,2,0
11125,Fistyw,stormscale,2313,monk,windwalker,104,60,44
11126,Sîxmonths,stormscale,2263,monk,windwalker,72,48,24
11127,Queteapie,stormscale,2192,monk,windwalker,82,48,34
11128,Plaww,dalaran,2172,monk,windwalker,120,75,45
11129,Unpruneable,stormscale,2147,monk,windwalker,84,45,39
11130,Hitsuwalker,archimonde,2127,monk,windwalker,84,52,32
11131,Tabetai,tarren-mill,2125,monk,windwalker,90,46,44
11132,Lilcatlife,tyrande,2123,monk,windwalker,66,36,30
11133,Ewynamonk,silvermoon,2121,monk,windwalker,102,51,51
11134,Snusochnocco,the-maelstrom,2120,monk,windwalker,78,39,39
11135,Pichouhuahua,elune,2096,monk,windwalker,120,63,57
11136,Ilovehim,antonidas,2092,monk,windwalker,66,41,25
11137,Brñ,twisting-nether,2073,monk,windwalker,66,36,30
11138,Fistinguhuhu,outland,2067,monk,windwalker,84,45,39
11139,Váinz,ravencrest,2046,monk,windwalker,66,37,29
11140,Rivazsunkick,archimonde,2035,monk,windwalker,124,59,65
11141,Rmtexter,ravencrest,2034,monk,windwalker,59,31,28
11142,Redundänt,kazzak,2014,monk,windwalker,60,36,24
11143,Pandamoniun,aggra-português,2014,monk,windwalker,90,48,42
11144,Stepsyzz,stormscale,1996,monk,windwalker,77,37,40
11145,Senretsu,shattered-halls,1994,monk,windwalker,66,34,32
11146,Troopmonk,ravencrest,1989,monk,windwalker,96,50,46
11147,Enerchi,ravencrest,1988,monk,windwalker,72,42,30
11148,Niamix,archimonde,1985,monk,windwalker,110,55,55
11149,Мистмастер,soulflayer,1984,monk,windwalker,48,30,18
11150,Hurricrane,kazzak,1982,monk,windwalker,135,70,65
11151,Sørann,drekthar,1973,monk,windwalker,76,44,32
11152,Jájsemshadow,drakthul,1971,monk,windwalker,66,36,30
11153,Balia,blackrock,1971,monk,windwalker,60,29,31
11154,Eth,nagrand,1968,monk,windwalker,72,37,35
11155,Daosh,nemesis,1968,monk,windwalker,73,37,36
11156,Soulja,bloodfeather,1965,monk,windwalker,70,42,28
11157,Щищ,gordunni,1958,monk,windwalker,78,46,32
11158,Monkmeta,frostwolf,1952,monk,windwalker,66,38,28
11159,Yassøux,archimonde,1948,monk,windwalker,172,90,82
11160,Zukatan,tarren-mill,1937,monk,windwalker,82,42,40
11161,Riskcapcap,dentarg,1935,monk,windwalker,66,35,31
11162,Projectasura,draenor,1923,monk,windwalker,114,63,51
11163,Нелегитимный,howling-fjord,1923,monk,windwalker,190,96,94
11164,Melyda,ravencrest,1922,monk,windwalker,108,59,49
11165,Bulluh,blackmoore,1919,monk,windwalker,47,27,20
11166,Muix,draenor,1906,monk,windwalker,30,20,10
11167,Theoww,dragonblight,1903,monk,windwalker,60,29,31
11168,Инрэйджинкап,soulflayer,1900,monk,windwalker,108,52,56
11169,Hastewalker,dun-morogh,1898,monk,windwalker,42,23,19
11170,Gyto,archimonde,1893,monk,windwalker,54,33,21
11171,Муррчалкин,howling-fjord,1880,monk,windwalker,48,28,20
11172,Ellipirelli,doomhammer,1880,monk,windwalker,70,30,40
11173,Санварион,eversong,1875,monk,windwalker,72,36,36
11174,Аррани,thermaplugg,1874,monk,windwalker,58,33,25
11175,Domww,outland,1871,monk,windwalker,108,59,49
11176,Ztl,twisting-nether,1861,monk,windwalker,101,59,42
11177,Edenmonk,dun-morogh,1855,monk,windwalker,48,27,21
11178,Pitball,ravencrest,1853,monk,windwalker,60,29,31
11179,Kokushibo,cthun,1850,monk,windwalker,54,28,26
11180,Яагрессивный,howling-fjord,1850,monk,windwalker,74,36,38
11181,Flunkefar,defias-brotherhood,1845,monk,windwalker,90,42,48
11182,Pàrádìsé,ravencrest,1835,monk,windwalker,78,42,36
11183,Santanax,ravencrest,1834,monk,windwalker,42,27,15
11184,Linuxx,ravencrest,1832,monk,windwalker,90,45,45
11185,Shpunk,ravencrest,1821,monk,windwalker,54,27,27
11186,Heran,ravencrest,1818,monk,windwalker,63,32,31
11187,Fotmwalker,ragnaros,1817,monk,windwalker,72,37,35
11188,Monkees,twisting-nether,1815,monk,windwalker,65,33,32
11189,Ароба,blackscar,1814,monk,windwalker,78,38,40
11190,Калестонз,howling-fjord,1811,monk,windwalker,54,31,23
11191,Lullerull,silvermoon,1810,monk,windwalker,51,31,20
11192,Фодз,soulflayer,1809,monk,windwalker,58,26,32
11193,Тихийпук,deathguard,1807,monk,windwalker,116,67,49
11194,Mebrin,ragnaros,1805,monk,windwalker,71,37,34
11195,Sushiroll,stormrage,1805,monk,windwalker,99,49,50
11196,Åbyssgòd,kazzak,1805,monk,windwalker,60,24,36
11197,Unangebracht,silvermoon,1803,monk,windwalker,227,121,106
11198,Notmelo,dun-modr,1801,monk,windwalker,48,25,23
11199,Windwanker,eredar,1800,monk,windwalker,36,22,14
11200,Teressah,argent-dawn,1800,monk,windwalker,42,22,20
11201,Tommypistol,runetotem,1800,monk,windwalker,78,39,39
11202,Gararasu,eredar,1798,monk,windwalker,36,19,17
11203,Twinny,drakthul,1793,monk,windwalker,90,52,38
11204,Kitcheneer,twisting-nether,1791,monk,windwalker,42,24,18
11205,Mikedcrybaby,tarren-mill,1790,monk,windwalker,131,69,62
11206,Skailzkrt,hyjal,1779,monk,windwalker,42,22,20
11207,Saltotriks,tarren-mill,1772,monk,windwalker,56,26,30
11208,Reõ,argent-dawn,1769,monk,windwalker,83,50,33
11209,Такюн,howling-fjord,1766,monk,windwalker,114,60,54
11210,Rêshi,draenor,1760,monk,windwalker,66,44,22
11211,Меняубило,howling-fjord,1757,monk,windwalker,60,32,28
11212,Xiâomèi,dun-modr,1755,monk,windwalker,60,28,32
11213,Эльморо,goldrinn,1752,monk,windwalker,42,20,22
11214,Sobadzlolz,alexstrasza,1751,monk,windwalker,64,39,25
11215,Yukfou,tarren-mill,1749,monk,windwalker,53,26,27
11216,Ackken,twisting-nether,1748,monk,windwalker,51,26,25
11217,Niyka,silvermoon,1740,monk,windwalker,48,29,19
11218,Маруты,soulflayer,1740,monk,windwalker,65,26,39
11219,Dwdw,aerie-peak,1737,monk,windwalker,54,28,26
11220,Pwaff,kazzak,1736,monk,windwalker,66,34,32
11221,Klumpenx,draenor,1735,monk,windwalker,62,31,31
11222,Лазанья,grom,1731,monk,windwalker,60,27,33
11223,Sororicide,stormscale,1729,monk,windwalker,118,56,62
11224,Mionoor,aegwynn,1725,monk,windwalker,172,85,87
11225,Möîne,arathi,1718,monk,windwalker,48,23,25
11226,Трэйци,blackscar,1716,monk,windwalker,39,23,16
11227,Yiannischan,draenor,1715,monk,windwalker,92,49,43
11228,Виноипиво,soulflayer,1713,monk,windwalker,60,30,30
11229,Elinalia,burning-legion,1712,monk,windwalker,42,21,21
11230,Stillwater,thrall,1711,monk,windwalker,54,26,28
11231,Dansaam,tarren-mill,1706,monk,windwalker,24,18,6
11232,Osalot,ravencrest,1695,monk,windwalker,60,30,30
11233,Ashânti,eredar,1691,monk,windwalker,62,30,32
11234,Димакарма,howling-fjord,1691,monk,windwalker,65,26,39
11235,Pazü,ysondre,1689,monk,windwalker,59,28,31
11236,Ninadobrév,stormscale,1686,monk,windwalker,56,32,24
11237,Miløøx,silvermoon,1683,monk,windwalker,59,33,26
11238,Tisaki,blackhand,1680,monk,windwalker,41,25,16
11239,Fistofrage,ravencrest,1677,monk,windwalker,42,25,17
11240,Gonkun,outland,1676,monk,windwalker,55,29,26
11241,Sàitama,hyjal,1676,monk,windwalker,42,18,24
11242,Beernie,tarren-mill,1675,monk,windwalker,36,21,15
11243,Ratslayerz,dun-modr,1669,monk,windwalker,42,24,18
11244,Гладастар,soulflayer,1665,monk,windwalker,66,33,33
11245,Дуэльныйчел,howling-fjord,1662,monk,windwalker,62,28,34
11246,Zéroneufsix,silvermoon,1658,monk,windwalker,50,19,31
11247,Chaospilot,sylvanas,1654,monk,windwalker,54,24,30
11248,Faxax,draenor,1651,monk,windwalker,42,21,21
11249,Bîmbâmboom,blackmoore,1650,monk,windwalker,48,25,23
11250,Thérez,les-sentinelles,1648,monk,windwalker,42,22,20
11251,Sylicia,alleria,1648,monk,windwalker,97,47,50
11252,Hunkfur,ravencrest,1647,monk,windwalker,44,25,19
11253,Monkini,kazzak,1647,monk,windwalker,36,18,18
11254,Гуппер,howling-fjord,1646,monk,windwalker,54,23,31
11255,Cheethfu,ragnaros,1645,monk,windwalker,30,21,9
11256,Deretrox,twisting-nether,1645,monk,windwalker,36,21,15
11257,Ocëane,sanguino,1644,monk,windwalker,42,22,20
11258,Idiot,outland,1644,monk,windwalker,42,22,20
11259,Mîsts,aszune,1624,monk,windwalker,35,18,17
11260,Hôllowx,archimonde,1621,monk,windwalker,30,17,13
11261,Yacum,blackrock,1616,monk,windwalker,47,21,26
11262,Тринх,ashenvale,1613,monk,windwalker,54,31,23
11263,Heyami,ravencrest,1613,monk,windwalker,36,17,19
11264,Ravelbaby,blackrock,1613,monk,windwalker,45,21,24
11265,Moistpocket,stormscale,1613,monk,windwalker,42,17,25
11266,Zandoy,draenor,1611,monk,windwalker,52,26,26
11267,Nigu,dun-modr,1606,monk,windwalker,67,38,29
11268,Vayarah,antonidas,1605,monk,windwalker,54,28,26
11269,Акумах,blackscar,1605,monk,windwalker,99,48,51
11270,Rivaz,archimonde,1603,monk,windwalker,36,19,17
11271,Fistu,silvermoon,1602,monk,windwalker,31,18,13
11272,Carbozø,archimonde,1600,monk,windwalker,24,17,7
11273,Fistedx,twisting-nether,1598,monk,windwalker,36,17,19
11274,Rismonk,twisting-nether,1597,monk,windwalker,36,19,17
11275,Pelou,culte-de-la-rive-noire,1597,monk,windwalker,48,25,23
11276,Thyf,drakthul,1596,monk,windwalker,48,20,28
11277,Тэсти,blackscar,1590,monk,windwalker,34,19,15
11278,Skiplegsweeb,stormscale,1579,monk,windwalker,30,21,9
11279,Эвэйжион,gordunni,1579,monk,windwalker,42,25,17
11280,Doktormonk,blackrock,1568,monk,windwalker,70,37,33
11281,Erenaar,nemesis,1563,monk,windwalker,36,29,7
11282,Jeydi,ravencrest,1563,monk,windwalker,53,36,17
11283,Ютуми,soulflayer,1557,monk,windwalker,36,17,19
11284,Sòftx,stormscale,1549,monk,windwalker,34,22,12
11285,Steros,die-aldor,1546,monk,windwalker,36,17,19
11286,Akuuji,silvermoon,1544,monk,windwalker,36,17,19
11287,Xullon,dragonblight,1542,monk,windwalker,60,27,33
11288,Bastos,blackrock,1540,monk,windwalker,216,110,106
11289,Хекмуги,borean-tundra,1535,monk,windwalker,91,44,47
11290,Plsnerfmemor,hyjal,1532,monk,windwalker,58,31,27
11291,Shaolinthug,stormscale,1531,monk,windwalker,36,16,20
11292,Mynokxu,blackmoore,1526,monk,windwalker,27,18,9
11293,Тшейши,howling-fjord,1526,monk,windwalker,54,28,26
11294,Senshí,stormscale,1525,monk,windwalker,36,19,17
11295,Scribzw,twisting-nether,1524,monk,windwalker,24,16,8
11296,Kixxus,blackmoore,1522,monk,windwalker,42,21,21
11297,Naschitüte,blackrock,1517,monk,windwalker,78,39,39
11298,Bèrïth,kazzak,1517,monk,windwalker,36,18,18
11299,Shardonay,ravencrest,1512,monk,windwalker,30,16,14
11300,Peaceweaver,ravencrest,1510,monk,windwalker,23,16,7
11301,Анпапаяя,galakrond,1507,monk,windwalker,47,26,21
11302,Jolbucheron,hyjal,1507,monk,windwalker,66,34,32
11303,Дивипи,blackscar,1506,monk,windwalker,54,24,30
11304,Recklusa,stormscale,1496,monk,windwalker,48,29,19
11305,Eonyzi,kazzak,1491,monk,windwalker,42,20,22
11306,Домудароги,gordunni,1484,monk,windwalker,30,16,14
11307,Кишмякмонк,howling-fjord,1473,monk,windwalker,36,16,20
11308,Fungamelol,blackhand,1459,monk,windwalker,30,19,11
11309,Sagewhisper,ravencrest,1458,monk,windwalker,57,27,30
11310,Agitoyamissj,burning-legion,1453,monk,windwalker,45,20,25
11311,Луэнн,gordunni,1449,monk,windwalker,36,18,18
11312,Xuuan,argent-dawn,1440,monk,windwalker,65,38,27
11313,Ladderfiend,stormscale,1439,monk,windwalker,30,15,15
11314,Имортарион,howling-fjord,1438,monk,windwalker,24,15,9
11315,Рэйвх,howling-fjord,1438,monk,windwalker,30,15,15
11316,Артемиоксх,blackscar,1437,monk,windwalker,37,15,22
11317,Spinntowin,blackmoore,1433,monk,windwalker,63,31,32
11318,Freehelper,stormscale,1433,monk,windwalker,42,15,27
11319,Oberháupt,blackrock,1432,monk,windwalker,30,15,15
11320,Anhox,ragnaros,1425,monk,windwalker,30,15,15
11321,Notsmol,quelthalas,1422,monk,windwalker,30,15,15
11322,Darré,sylvanas,1413,monk,windwalker,72,30,42
11323,Ryle,forscherliga,1409,monk,windwalker,30,15,15
11324,Dræk,twisting-nether,1406,monk,windwalker,35,18,17
11325,Добраядушка,gordunni,1400,monk,windwalker,36,19,17
11326,Ívó,ragnaros,1400,monk,windwalker,42,17,25
11327,Lucaspires,sylvanas,1399,monk,windwalker,42,15,27
11328,Pipatvs,drakthul,1398,monk,windwalker,31,21,10
11329,Azato,hyjal,1398,monk,windwalker,48,23,25
11330,Uffsmaul,blackhand,1395,monk,windwalker,49,27,22
11331,Vixia,outland,1390,monk,windwalker,29,15,14
11332,Kanõ,outland,1381,monk,windwalker,30,17,13
11333,Keskonriz,ysondre,1381,monk,windwalker,84,36,48
11334,Wakmo,bladefist,1380,monk,windwalker,44,22,22
11335,Kyraxs,silvermoon,1379,monk,windwalker,36,17,19
11336,Кюзичка,gordunni,1379,monk,windwalker,83,38,45
11337,Icecoldish,tarren-mill,1378,monk,windwalker,72,39,33
11338,Swiftmonky,azuremyst,1376,monk,windwalker,48,27,21
11339,Malutkie,defias-brotherhood,1363,monk,windwalker,66,33,33
11340,Янакаблуках,howling-fjord,1360,monk,windwalker,65,34,31
11341,Doobly,kazzak,1359,monk,windwalker,89,44,45
11342,Îrønfist,blackmoore,1358,monk,windwalker,29,17,12
11343,Bandiya,archimonde,1358,monk,windwalker,61,28,33
11344,Bakash,ysondre,1353,monk,windwalker,128,57,71
11345,Mirôku,onyxia,1352,monk,windwalker,42,22,20
11346,Boutarzi,hyjal,1347,monk,windwalker,54,25,29
11347,Exikûsh,frostwolf,1341,monk,windwalker,30,16,14
11348,Yungdrippy,eredar,1340,monk,windwalker,24,14,10
11349,Schmidti,kazzak,1340,monk,windwalker,30,14,16
11350,Moultsou,hyjal,1339,monk,windwalker,24,14,10
11351,Domiqx,blackhand,1339,monk,windwalker,30,14,16
11352,Nicesky,ravencrest,1339,monk,windwalker,36,14,22
11353,Vexíllum,sylvanas,1338,monk,windwalker,30,14,16
11354,Saduh,thrall,1338,monk,windwalker,30,14,16
11355,Nodzomi,shadowsong,1337,monk,windwalker,39,20,19
11356,Undefinedid,ravencrest,1335,monk,windwalker,110,57,53
11357,Moonkeeye,stormscale,1332,monk,windwalker,60,36,24
11358,Iastyn,kazzak,1328,monk,windwalker,30,14,16
11359,Valduri,stormscale,1327,monk,windwalker,36,14,22
11360,Коркирас,howling-fjord,1322,monk,windwalker,84,47,37
11361,Сандерстрайк,howling-fjord,1315,monk,windwalker,30,14,16
11362,Kîngjungeîle,dalaran,1301,monk,windwalker,24,14,10
11363,Djînns,blackmoore,1296,monk,windwalker,30,15,15
11364,Hampocket,ravencrest,1290,monk,windwalker,38,15,23
11365,Mycki,dalaran,1289,monk,windwalker,29,15,14
11366,Яшкациган,howling-fjord,1285,monk,windwalker,40,16,24
11367,Lemmeportbk,ravencrest,1279,monk,windwalker,32,15,17
11368,Bobbyknuckls,ravencrest,1278,monk,windwalker,96,41,55
11369,Miyaghï,dun-modr,1269,monk,windwalker,31,16,15
11370,Mønkeydluffy,blackmoore,1269,monk,windwalker,66,33,33
11371,Matlahon,kazzak,1269,monk,windwalker,29,14,15
11372,Kungfumite,twisting-nether,1266,monk,windwalker,83,42,41
11373,Монголгодх,howling-fjord,1265,monk,windwalker,36,19,17
11374,Djpunchable,blackrock,1247,monk,windwalker,24,13,11
11375,Iceym,stormscale,1244,monk,windwalker,33,14,19
11376,Кирокко,gordunni,1242,monk,windwalker,18,14,4
11377,Brandy,kazzak,1242,monk,windwalker,30,13,17
11378,Чвка,booty-bay,1240,monk,windwalker,37,19,18
11379,Pandermann,antonidas,1238,monk,windwalker,30,16,14
11380,Kouradoskylo,twisting-nether,1234,monk,windwalker,29,16,13
11381,Meltfistqt,ravencrest,1234,monk,windwalker,30,13,17
11382,Kegrøll,doomhammer,1231,monk,windwalker,42,21,21
11383,Янасру,gordunni,1230,monk,windwalker,243,121,122
11384,Yesman,quelthalas,1229,monk,windwalker,74,35,39
11385,Vushao,blackmoore,1228,monk,windwalker,156,72,84
11386,Fûràxx,hyjal,1221,monk,windwalker,36,16,20
11387,Nikchi,destromath,1221,monk,windwalker,36,13,23
11388,Bruzuh,outland,1215,monk,windwalker,31,15,16
11389,Akÿo,archimonde,1213,monk,windwalker,29,13,16
11390,Imvengeance,stormscale,1204,monk,windwalker,28,14,14
11391,Диванн,howling-fjord,1198,monk,windwalker,29,13,16
11392,Yobo,archimonde,1196,monk,windwalker,23,13,10
11393,Vercya,dun-morogh,1168,monk,windwalker,37,19,18
11394,Bellarika,nemesis,1152,monk,windwalker,12,12,0
11395,Sponkas,tarren-mill,1152,monk,windwalker,24,12,12
11396,Милыйколян,soulflayer,1152,monk,windwalker,24,12,12
11397,Дезмимонк,ashenvale,1152,monk,windwalker,28,13,15
11398,Arsonists,argent-dawn,1151,monk,windwalker,18,12,6
11399,Çhina,twisting-nether,1151,monk,windwalker,24,12,12
11400,Джэкичача,soulflayer,1151,monk,windwalker,24,12,12
11401,Healbotzweik,frostwolf,1151,monk,windwalker,24,12,12
11402,Jinpachi,ravencrest,1151,monk,windwalker,30,12,18
11403,Ksâin,ravencrest,1151,monk,windwalker,30,12,18
11404,Йетисан,gordunni,1149,monk,windwalker,18,12,6
11405,Brorsantuck,frostmane,1147,monk,windwalker,18,12,6
11406,Sesi,drakthul,1147,monk,windwalker,42,12,30
11407,Hosh,ysondre,1146,monk,windwalker,30,12,18
11408,Gúerrilla,tarren-mill,1138,monk,windwalker,54,29,25
11409,Yøøps,dalaran,1134,monk,windwalker,53,22,31
11410,Elfisto,baelgun,1132,monk,windwalker,24,12,12
11411,Ехерех,blackscar,1084,monk,windwalker,36,21,15
11412,Hilzaxsub,archimonde,1083,monk,windwalker,23,12,11
11413,Euronymesis,silvermoon,1065,monk,windwalker,23,12,11
11414,Daybaobao,the-maelstrom,1062,monk,windwalker,22,12,10
11415,Ðâvàizskÿ,ysondre,1056,monk,windwalker,18,11,7
11416,Orkamonka,burning-legion,1056,monk,windwalker,18,11,7
11417,Hôllowx,throkferoth,1056,monk,windwalker,24,11,13
11418,Cirixx,outland,1055,monk,windwalker,18,11,7
11419,Chigre,hyjal,1055,monk,windwalker,18,11,7
11420,Djshady,sylvanas,1054,monk,windwalker,18,11,7
11421,Tiaqa,aegwynn,1053,monk,windwalker,12,11,1
11422,Mink,uldum,1053,monk,windwalker,24,11,13
11423,Gatyz,archimonde,1051,monk,windwalker,27,11,16
11424,Samantonah,nemesis,1050,monk,windwalker,16,12,4
11425,Вамптолкер,howling-fjord,1049,monk,windwalker,18,11,7
11426,Непорядочная,gordunni,1047,monk,windwalker,30,12,18
11427,Malarie,magtheridon,1035,monk,windwalker,66,34,32
11428,Одиниз,gordunni,1031,monk,windwalker,42,27,15
11429,Napqi,malganis,1023,monk,windwalker,17,11,6
11430,Broner,dunemaul,1022,monk,windwalker,23,11,12
11431,Томтью,gordunni,1017,monk,windwalker,23,11,12
11432,Trunks,turalyon,1014,monk,windwalker,24,11,13
11433,Hefners,grim-batol,991,monk,windwalker,23,11,12
11434,Marcianorock,archimonde,987,monk,windwalker,30,13,17
11435,Stronkman,frostwhisper,979,monk,windwalker,18,11,7
11436,Вагонюлеера,howling-fjord,974,monk,windwalker,22,11,11
11437,Wolmachégodx,archimonde,960,monk,windwalker,12,10,2
11438,Sqoobie,tarren-mill,960,monk,windwalker,18,10,8
11439,Shînøbi,dalaran,960,monk,windwalker,18,10,8
11440,Ðävàizskó,ysondre,960,monk,windwalker,18,10,8
11441,Vtx,blackrock,959,monk,windwalker,18,10,8
11442,Атакцуки,gordunni,959,monk,windwalker,18,10,8
11443,Shoenk,blackhand,959,monk,windwalker,18,10,8
11444,Nycea,blackrock,959,monk,windwalker,18,10,8
11445,Narstie,kazzak,959,monk,windwalker,18,10,8
11446,Rorkito,sanguino,959,monk,windwalker,30,10,20
11447,Realiaze,tichondrius,958,monk,windwalker,24,10,14
11448,Waîzen,uldaman,955,monk,windwalker,18,10,8
11449,Agress,sanguino,932,monk,windwalker,48,19,29
11450,Wazari,nemesis,922,monk,windwalker,23,10,13
11451,Dionee,twisting-nether,877,monk,windwalker,21,12,9
11452,Venuki,blackrock,864,monk,windwalker,12,9,3
11453,Thänkky,kazzak,864,monk,windwalker,12,9,3
11454,Mcscrub,ragnaros,864,monk,windwalker,12,9,3
11455,Bossdog,mugthol,864,monk,windwalker,12,9,3
11456,Blizò,tarren-mill,864,monk,windwalker,18,9,9
11457,Цеска,howling-fjord,864,monk,windwalker,18,9,9
11458,Snookzlol,aegwynn,864,monk,windwalker,18,9,9
11459,Lrizz,argent-dawn,864,monk,windwalker,18,9,9
11460,Weaverman,ragnaros,864,monk,windwalker,18,9,9
11461,Gankplank,nemesis,864,monk,windwalker,18,9,9
11462,Otp,hyjal,863,monk,windwalker,18,9,9
11463,Рокебайбейби,howling-fjord,863,monk,windwalker,18,9,9
11464,Мионелолл,goldrinn,863,monk,windwalker,18,9,9
11465,Fisty,lightbringer,863,monk,windwalker,24,9,15
11466,Lin,nathrezim,861,monk,windwalker,18,9,9
11467,Monkgol,stormscale,861,monk,windwalker,18,9,9
11468,Blumonk,argent-dawn,857,monk,windwalker,18,9,9
11469,Joaquuin,sylvanas,855,monk,windwalker,18,9,9
11470,Gidmonk,darkspear,836,monk,windwalker,18,9,9
11471,Apprentice,ravencrest,815,monk,windwalker,17,9,8
11472,Okilexsan,sanguino,797,monk,windwalker,11,9,2
11473,Karatiy,doomhammer,795,monk,windwalker,99,33,66
11474,Wladqz,stormscale,768,monk,windwalker,12,8,4
11475,Такиера,gordunni,768,monk,windwalker,12,8,4
11476,Tðptier,drakthul,768,monk,windwalker,12,8,4
11477,Plånck,archimonde,768,monk,windwalker,12,8,4
11478,Karels,archimonde,768,monk,windwalker,12,8,4
11479,Eggroll,archimonde,768,monk,windwalker,12,8,4
11480,Slayh,archimonde,768,monk,windwalker,12,8,4
11481,Runefists,twisting-nether,768,monk,windwalker,12,8,4
11482,Fistyfast,hyjal,768,monk,windwalker,12,8,4
11483,Лагвай,gordunni,768,monk,windwalker,12,8,4
11484,Toyless,ravencrest,768,monk,windwalker,12,8,4
11485,Ðìør,kazzak,768,monk,windwalker,12,8,4
11486,Anteric,sylvanas,768,monk,windwalker,12,8,4
11487,Shoura,blackmoore,768,monk,windwalker,12,8,4
11488,Jeppehmonk,stormscale,768,monk,windwalker,12,8,4
11489,Karmaisabich,ragnaros,768,monk,windwalker,12,8,4
11490,Wonkeed,hyjal,768,monk,windwalker,18,8,10
11491,Kåtsumi,sanguino,768,monk,windwalker,18,8,10
11492,Monk,shattered-hand,768,monk,windwalker,18,8,10
11493,Gdkz,tarren-mill,768,monk,windwalker,18,8,10
11494,Stÿvww,archimonde,768,monk,windwalker,24,8,16
11495,ßibip,hyjal,767,monk,windwalker,14,10,4
11496,Merilwyn,argent-dawn,767,monk,windwalker,12,8,4
11497,Дыня,gordunni,767,monk,windwalker,12,8,4
11498,Earendil,culte-de-la-rive-noire,767,monk,windwalker,12,8,4
11499,Heffertonne,eredar,767,monk,windwalker,12,8,4
11500,Risomonk,blackrock,767,monk,windwalker,18,8,10
11501,Kneecapper,ravencrest,767,monk,windwalker,18,8,10
11502,Pocaa,arakarahm,766,monk,windwalker,18,8,10
11503,Rollah,ravencrest,765,monk,windwalker,18,8,10
11504,Nggz,archimonde,764,monk,windwalker,12,8,4
11505,Czvibuh,drakthul,763,monk,windwalker,24,8,16
11506,Gaehitmonlee,ravencrest,734,monk,windwalker,17,8,9
11507,Saodiseng,outland,672,monk,windwalker,12,7,5
11508,Lesauceboss,kazzak,672,monk,windwalker,12,7,5
11509,Wuux,tarren-mill,672,monk,windwalker,12,7,5
11510,Zenothar,ravencrest,672,monk,windwalker,12,7,5
11511,Uwuhehe,ravencrest,672,monk,windwalker,12,7,5
11512,Rayokhen,kazzak,672,monk,windwalker,12,7,5
11513,Potsymist,twisting-nether,672,monk,windwalker,12,7,5
11514,Gorskie,silvermoon,672,monk,windwalker,12,7,5
11515,Kármo,thrall,672,monk,windwalker,12,7,5
11516,Pêterpump,blackrock,672,monk,windwalker,12,7,5
11517,Arthanaar,drakthul,672,monk,windwalker,12,7,5
11518,Njursten,twilights-hammer,672,monk,windwalker,12,7,5
11519,Sayozz,hyjal,672,monk,windwalker,12,7,5
11520,Dopi,frostmane,672,monk,windwalker,12,7,5
11521,Mefîsto,blackrock,672,monk,windwalker,18,7,11
11522,Galexuz,blackrock,672,monk,windwalker,18,7,11
11523,Flowér,auchindoun,672,monk,windwalker,18,7,11
11524,Kåýðø,archimonde,672,monk,windwalker,18,7,11
11525,Inkegomonk,draenor,672,monk,windwalker,24,7,17
11526,Chæli,tarren-mill,671,monk,windwalker,12,7,5
11527,Ролитта,gordunni,671,monk,windwalker,12,7,5
11528,Bierdame,blackhand,671,monk,windwalker,12,7,5
11529,Sonofelrond,twisting-nether,671,monk,windwalker,12,7,5
11530,Эзархадон,lich-king,671,monk,windwalker,12,7,5
11531,Discosean,frostmane,671,monk,windwalker,18,7,11
11532,Монахнехилит,howling-fjord,671,monk,windwalker,18,7,11
11533,Duches,tarren-mill,671,monk,windwalker,18,7,11
11534,Dummars,ragnaros,670,monk,windwalker,18,7,11
11535,Kirara,talnivarr,668,monk,windwalker,12,7,5
11536,Bal,tyrande,667,monk,windwalker,15,8,7
11537,Fusetonww,tarren-mill,623,monk,windwalker,11,7,4
11538,Rezuz,draenor,576,monk,windwalker,6,6,0
11539,Coollann,drakthul,576,monk,windwalker,12,6,6
11540,Balance,laughing-skull,576,monk,windwalker,12,6,6
11541,Dokuziq,twisting-nether,576,monk,windwalker,12,6,6
11542,Waaks,archimonde,576,monk,windwalker,12,6,6
11543,Fln,blackrock,576,monk,windwalker,12,6,6
11544,Testmonial,hyjal,576,monk,windwalker,12,6,6
11545,Kryzu,ragnaros,576,monk,windwalker,12,6,6
11546,Lycké,silvermoon,576,monk,windwalker,12,6,6
11547,Weezé,outland,576,monk,windwalker,12,6,6
11548,Xàrslòulolz,kazzak,576,monk,windwalker,12,6,6
11549,Miridius,silvermoon,576,monk,windwalker,12,6,6
11550,Ferree,tarren-mill,576,monk,windwalker,12,6,6
11551,Jollyzug,blackrock,576,monk,windwalker,12,6,6
11552,Turbofistsqt,kazzak,576,monk,windwalker,12,6,6
11553,Ijji,argent-dawn,576,monk,windwalker,12,6,6
11554,Мэрджик,soulflayer,576,monk,windwalker,12,6,6
11555,Nyrkkikylpy,ravencrest,576,monk,windwalker,12,6,6
11556,Niyatî,draenor,576,monk,windwalker,12,6,6
11557,Ampm,ravencrest,576,monk,windwalker,12,6,6
11558,Форгетх,soulflayer,576,monk,windwalker,12,6,6
11559,Däemon,twisting-nether,576,monk,windwalker,15,7,8
11560,Bbcmonkinc,aegwynn,576,monk,windwalker,16,7,9
11561,Galaxyfists,blackhand,576,monk,windwalker,18,6,12
11562,Norgamx,alakir,576,monk,windwalker,18,6,12
11563,Blickx,draenor,576,monk,windwalker,18,6,12
11564,Fiststowin,blackrock,576,monk,windwalker,18,6,12
11565,Woknroll,draenor,575,monk,windwalker,12,6,6
11566,Fantasiløs,twisting-nether,575,monk,windwalker,12,6,6
11567,Raychi,draenor,575,monk,windwalker,12,6,6
11568,Iluvatareru,twisting-nether,575,monk,windwalker,12,6,6
11569,Doreese,moonglade,575,monk,windwalker,12,6,6
11570,Chiroidz,kazzak,575,monk,windwalker,12,6,6
11571,Teetoor,argent-dawn,575,monk,windwalker,12,6,6
11572,Mönchdog,blackmoore,573,monk,windwalker,12,6,6
11573,Mullan,eonar,573,monk,windwalker,24,6,18
11574,Cptfist,argent-dawn,543,monk,windwalker,17,6,11
11575,Merjis,stormscale,527,monk,windwalker,11,6,5
11576,Жекадобряк,howling-fjord,503,monk,windwalker,15,7,8
11577,Bryggarn,draenor,480,monk,windwalker,6,5,1
11578,Shapzxd,archimonde,480,monk,windwalker,6,5,1
11579,Emptyeyés,kazzak,480,monk,windwalker,6,5,1
11580,Fijiwater,draenor,480,monk,windwalker,6,5,1
11581,Tauti,dun-morogh,480,monk,windwalker,6,5,1
11582,Madelnheaven,burning-legion,480,monk,windwalker,6,5,1
11583,Kungfuhkyou,tarren-mill,480,monk,windwalker,6,5,1
11584,Wilywolxx,silvermoon,480,monk,windwalker,6,5,1
11585,Zhiothe,argent-dawn,480,monk,windwalker,6,5,1
11586,Zmile,ragnaros,480,monk,windwalker,6,5,1
11587,Kapud,twisting-nether,480,monk,windwalker,6,5,1
11588,Hàtéppl,ravencrest,480,monk,windwalker,6,5,1
11589,Ноупэйн,soulflayer,480,monk,windwalker,6,5,1
11590,Alandriai,blackmoore,480,monk,windwalker,6,5,1
11591,Larsowns,ragnaros,480,monk,windwalker,6,5,1
11592,Минимонахх,blackscar,480,monk,windwalker,6,5,1
11593,Jukei,blackmoore,480,monk,windwalker,6,5,1
11594,Энвишь,soulflayer,480,monk,windwalker,6,5,1
11595,Tubørg,ravencrest,480,monk,windwalker,12,5,7
11596,Archnun,stormscale,480,monk,windwalker,12,5,7
11597,Tempestu,twisting-nether,480,monk,windwalker,12,5,7
11598,Vivvy,argent-dawn,480,monk,windwalker,12,5,7
11599,Monk,dun-modr,480,monk,windwalker,12,5,7
11600,Nevertouch,blackrock,480,monk,windwalker,12,5,7
11601,Fistus,dentarg,480,monk,windwalker,12,5,7
11602,Kaelwind,burning-legion,480,monk,windwalker,12,5,7
11603,Badcøwboy,archimonde,480,monk,windwalker,12,5,7
11604,Diagmonk,kazzak,480,monk,windwalker,12,5,7
11605,Mayliene,stormscale,480,monk,windwalker,12,5,7
11606,Johnsôn,blackmoore,480,monk,windwalker,12,5,7
11607,Øbamakush,archimonde,480,monk,windwalker,12,5,7
11608,Käsefäuste,azshara,480,monk,windwalker,12,5,7
11609,Xialongbao,khaz-modan,480,monk,windwalker,12,5,7
11610,Omnibar,kazzak,480,monk,windwalker,12,5,7
11611,Babyfax,draenor,480,monk,windwalker,12,5,7
11612,Blyatfast,draenor,480,monk,windwalker,12,5,7
11613,Greenshortea,aegwynn,480,monk,windwalker,12,5,7
11614,Кунфумастер,gordunni,480,monk,windwalker,12,5,7
11615,Bimberta,argent-dawn,480,monk,windwalker,12,5,7
11616,Nerd,argent-dawn,480,monk,windwalker,12,5,7
11617,Drfistalot,blackrock,480,monk,windwalker,12,5,7
11618,Onlypressw,tarren-mill,480,monk,windwalker,12,5,7
11619,Nicetrybuddy,draenor,480,monk,windwalker,12,5,7
11620,Mónkâs,tarren-mill,480,monk,windwalker,18,5,13
11621,Fatlazypanda,argent-dawn,479,monk,windwalker,6,5,1
11622,Tetetete,silvermoon,479,monk,windwalker,12,5,7
11623,Sadwhi,turalyon,472,monk,windwalker,12,5,7
11624,Sebbii,twisting-nether,447,monk,windwalker,11,5,6
11625,Камагами,howling-fjord,400,monk,windwalker,7,5,2
11626,Shagzy,ravencrest,399,monk,windwalker,5,5,0
11627,Gøøgodx,tarren-mill,384,monk,windwalker,6,4,2
11628,Laggedfist,kazzak,384,monk,windwalker,6,4,2
11629,Soulspar,ragnaros,384,monk,windwalker,6,4,2
11630,Rerowine,magtheridon,384,monk,windwalker,6,4,2
11631,Blazeuu,drakthul,384,monk,windwalker,6,4,2
11632,Hertel,boulderfist,384,monk,windwalker,6,4,2
11633,Palarîns,dalaran,384,monk,windwalker,6,4,2
11634,Twinkletoe,twisting-nether,384,monk,windwalker,6,4,2
11635,Iminzww,ravencrest,384,monk,windwalker,6,4,2
11636,Dubhira,blackmoore,384,monk,windwalker,6,4,2
11637,Mabkww,ravencrest,384,monk,windwalker,6,4,2
11638,Rugys,ravenholdt,384,monk,windwalker,6,4,2
11639,Onn,outland,384,monk,windwalker,6,4,2
11640,Tàlo,anachronos,384,monk,windwalker,6,4,2
11641,Clìtfister,silvermoon,384,monk,windwalker,6,4,2
11642,Baisi,blackhand,384,monk,windwalker,6,4,2
11643,Dadrael,argent-dawn,384,monk,windwalker,6,4,2
11644,Monkflexi,draenor,384,monk,windwalker,6,4,2
11645,Gramkin,ravencrest,384,monk,windwalker,6,4,2
11646,Âdonis,twisting-nether,384,monk,windwalker,6,4,2
11647,Diagmonk,arathi,384,monk,windwalker,6,4,2
11648,Orenichi,antonidas,384,monk,windwalker,6,4,2
11649,Нежненький,gordunni,384,monk,windwalker,6,4,2
11650,Tysonwonka,thrall,384,monk,windwalker,6,4,2
11651,Pandafuki,ravencrest,384,monk,windwalker,6,4,2
11652,Емопацан,gordunni,384,monk,windwalker,6,4,2
11653,Yeol,ravencrest,384,monk,windwalker,6,4,2
11654,Erazhen,blackrock,384,monk,windwalker,6,4,2
11655,Вэилэй,gordunni,384,monk,windwalker,6,4,2
11656,Okpm,marécage-de-zangar,384,monk,windwalker,6,4,2
11657,Windstormcro,ragnaros,384,monk,windwalker,6,4,2
11658,Pili,aegwynn,384,monk,windwalker,6,4,2
11659,Goremancey,draenor,384,monk,windwalker,12,4,8
11660,Risingspud,frostmane,384,monk,windwalker,12,4,8
11661,Крэйзимедвед,howling-fjord,384,monk,windwalker,12,4,8
11662,Кианасоломид,gordunni,384,monk,windwalker,12,4,8
11663,Blutáar,khazgoroth,384,monk,windwalker,12,4,8
11664,Пампич,borean-tundra,384,monk,windwalker,12,4,8
11665,Sori,mazrigos,384,monk,windwalker,12,4,8
11666,Байтли,gordunni,384,monk,windwalker,12,4,8
11667,Desmî,ravencrest,384,monk,windwalker,12,4,8
11668,Salt,suramar,384,monk,windwalker,12,4,8
11669,Кириешек,deathguard,384,monk,windwalker,12,4,8
11670,Räyh,outland,384,monk,windwalker,12,4,8
11671,Mwoinesamdi,hyjal,384,monk,windwalker,12,4,8
11672,Scribzz,twisting-nether,384,monk,windwalker,12,4,8
11673,Andrah,blackmoore,384,monk,windwalker,12,4,8
11674,Likethat,hyjal,384,monk,windwalker,12,4,8
11675,Panzeerotto,nemesis,384,monk,windwalker,18,4,14
11676,Bbinzu,lothar,383,monk,windwalker,6,4,2
11677,Lòthbar,confrérie-du-thorium,383,monk,windwalker,6,4,2
11678,Апесиинка,gordunni,383,monk,windwalker,8,4,4
11679,Югэн,azuregos,383,monk,windwalker,12,4,8
11680,Benkkei,ysondre,336,monk,windwalker,15,4,11
11681,Choje,blackmoore,319,monk,windwalker,5,4,1
11682,Alë,argent-dawn,319,monk,windwalker,8,4,4
11683,Hazzat,nordrassil,288,monk,windwalker,6,3,3
11684,Gîø,blackmoore,288,monk,windwalker,6,3,3
11685,Bigfistah,tarren-mill,288,monk,windwalker,6,3,3
11686,Realfighter,arathor,288,monk,windwalker,6,3,3
11687,Monkacek,drakthul,288,monk,windwalker,6,3,3
11688,Dänÿww,elune,288,monk,windwalker,6,3,3
11689,Ðoom,sylvanas,288,monk,windwalker,6,3,3
11690,Lokregar,blackmoore,288,monk,windwalker,6,3,3
11691,Karmachi,ravencrest,288,monk,windwalker,6,3,3
11692,Sizok,blackmoore,288,monk,windwalker,6,3,3
11693,Zunixxww,terrordar,288,monk,windwalker,6,3,3
11694,Рендикаое,soulflayer,288,monk,windwalker,6,3,3
11695,Tinjihn,magtheridon,288,monk,windwalker,6,3,3
11696,Iluvfistinjk,sylvanas,288,monk,windwalker,6,3,3
11697,Расселкроу,galakrond,288,monk,windwalker,6,3,3
11698,Mezz,ahnqiraj,288,monk,windwalker,6,3,3
11699,Räpeltäjä,stormreaver,288,monk,windwalker,6,3,3
11700,Dennismansix,sylvanas,288,monk,windwalker,6,3,3
11701,Velduin,dun-modr,288,monk,windwalker,6,3,3
11702,Hästgodx,the-maelstrom,288,monk,windwalker,6,3,3
11703,Qdwdwqerdads,ravencrest,288,monk,windwalker,6,3,3
11704,Verfa,twisting-nether,288,monk,windwalker,6,3,3
11705,Zenified,ragnaros,288,monk,windwalker,6,3,3
11706,Lørðbrøñkø,blackrock,288,monk,windwalker,6,3,3
11707,Pabu,emeriss,288,monk,windwalker,6,3,3
11708,Zelraqt,burning-steppes,288,monk,windwalker,6,3,3
11709,Ktrina,ravencrest,288,monk,windwalker,6,3,3
11710,Adewelee,dalaran,288,monk,windwalker,6,3,3
11711,Piedliés,ravencrest,288,monk,windwalker,6,3,3
11712,Sajin,la-croisade-écarlate,288,monk,windwalker,6,3,3
11713,Zéná,gilneas,288,monk,windwalker,6,3,3
11714,Bg,blackhand,288,monk,windwalker,6,3,3
11715,Jakfuki,ragnaros,288,monk,windwalker,6,3,3
11716,Arisua,blackhand,288,monk,windwalker,6,3,3
11717,Ragobd,argent-dawn,288,monk,windwalker,6,3,3
11718,Sàlêxz,ysondre,288,monk,windwalker,6,3,3
11719,Vajawalkerx,twisting-nether,288,monk,windwalker,6,3,3
11720,Aaronm,tarren-mill,288,monk,windwalker,6,3,3
11721,Aslêyia,antonidas,288,monk,windwalker,6,3,3
11722,Daltailr,silvermoon,288,monk,windwalker,6,3,3
11723,Smørc,the-maelstrom,288,monk,windwalker,6,3,3
11724,Alkanphel,kazzak,288,monk,windwalker,6,3,3
11725,Azangar,kazzak,288,monk,windwalker,6,3,3
11726,Droozy,silvermoon,288,monk,windwalker,6,3,3
11727,Ratfacè,outland,288,monk,windwalker,6,3,3
11728,Nightingalê,silvermoon,288,monk,windwalker,6,3,3
11729,Mönchfatih,blackhand,288,monk,windwalker,12,3,9
11730,Barylen,outland,288,monk,windwalker,12,3,9
11731,Халиосфа,gordunni,288,monk,windwalker,12,3,9
11732,Geliôs,kazzak,288,monk,windwalker,12,3,9
11733,Clamps,darkspear,288,monk,windwalker,12,3,9
11734,Votbo,kazzak,288,monk,windwalker,12,3,9
11735,Roxmonk,ravencrest,288,monk,windwalker,12,3,9
11736,Ayyee,blackmoore,288,monk,windwalker,18,3,15
11737,Lewimoäne,khaz-modan,287,monk,windwalker,6,3,3
11738,Brucilli,dalaran,287,monk,windwalker,6,3,3
11739,Syaóran,exodar,286,monk,windwalker,12,3,9
11740,Пкмлкм,gordunni,255,monk,windwalker,11,3,8
11741,Dolkenm,tarren-mill,240,monk,windwalker,9,4,5
11742,Iamzra,kazzak,239,monk,windwalker,11,3,8
11743,Trolleurz,archimonde,224,monk,windwalker,16,3,13
11744,Мишадуротар,borean-tundra,192,monk,windwalker,4,3,1
11745,Bignessb,draenor,192,monk,windwalker,4,3,1
11746,Idointcare,ravencrest,192,monk,windwalker,4,3,1
11747,Kano,burning-legion,192,monk,windwalker,9,3,6
11748,Джийви,goldrinn,192,monk,windwalker,6,2,4
11749,Belobe,stormscale,192,monk,windwalker,6,2,4
11750,Dodoglad,hyjal,192,monk,windwalker,6,2,4
11751,Kenjibsen,blackhand,192,monk,windwalker,6,2,4
11752,Купейчик,gordunni,192,monk,windwalker,6,2,4
11753,Monkiki,hyjal,192,monk,windwalker,6,2,4
11754,Bloodychi,ravencrest,192,monk,windwalker,6,2,4
11755,Frajer,auchindoun,192,monk,windwalker,6,2,4
11756,Tayoo,aegwynn,192,monk,windwalker,6,2,4
11757,Dianly,ravencrest,192,monk,windwalker,6,2,4
11758,Bensil,ravencrest,192,monk,windwalker,6,2,4
11759,Майамибитч,howling-fjord,192,monk,windwalker,6,2,4
11760,Såliten,tarren-mill,192,monk,windwalker,6,2,4
11761,Brewroll,ravencrest,192,monk,windwalker,6,2,4
11762,Mtmonk,tarren-mill,192,monk,windwalker,6,2,4
11763,Joachi,outland,192,monk,windwalker,6,2,4
11764,Savecdfornxt,blackmoore,192,monk,windwalker,6,2,4
11765,Stenhård,azjolnerub,192,monk,windwalker,6,2,4
11766,Musclorww,ysondre,192,monk,windwalker,6,2,4
11767,Devilmønk,thrall,192,monk,windwalker,6,2,4
11768,Mcflaïe,ysondre,192,monk,windwalker,6,2,4
11769,Khirazim,ysondre,192,monk,windwalker,6,2,4
11770,Eynodiggity,blackmoore,192,monk,windwalker,6,2,4
11771,Friidam,lightbringer,192,monk,windwalker,6,2,4
11772,Woalter,silvermoon,192,monk,windwalker,6,2,4
11773,Zýru,ragnaros,192,monk,windwalker,6,2,4
11774,Chireapz,blackrock,192,monk,windwalker,6,2,4
11775,Orcword,ragnaros,192,monk,windwalker,6,2,4
11776,Legeend,dun-modr,192,monk,windwalker,6,2,4
11777,Geochi,tarren-mill,192,monk,windwalker,6,2,4
11778,Walterwayne,blackrock,192,monk,windwalker,6,2,4
11779,Wwisalright,burning-legion,192,monk,windwalker,6,2,4
11780,Bamboosnack,kazzak,192,monk,windwalker,6,2,4
11781,Miamausebär,blackmoore,192,monk,windwalker,6,2,4
11782,Fistingfury,burning-blade,192,monk,windwalker,6,2,4
11783,Cac,argent-dawn,192,monk,windwalker,6,2,4
11784,Andyww,doomhammer,192,monk,windwalker,6,2,4
11785,Bobthewild,draenor,192,monk,windwalker,6,2,4
11786,Loriodas,tarren-mill,192,monk,windwalker,6,2,4
11787,Tongat,ravencrest,192,monk,windwalker,12,2,10
11788,Тифуя,gordunni,192,monk,windwalker,12,2,10
11789,Mollytov,tarren-mill,192,monk,windwalker,18,2,16
11790,Yianjih,blackmoore,191,monk,windwalker,6,2,4
11791,Соловьюх,gordunni,191,monk,windwalker,6,2,4
11792,Ahlu,argent-dawn,144,monk,windwalker,9,2,7
11793,Jafandmeja,tarren-mill,96,monk,windwalker,8,2,6
11794,Dìó,tarren-mill,96,monk,windwalker,6,1,5
11795,Бладмонки,soulflayer,96,monk,windwalker,6,1,5
11796,Ilovecravmag,draenor,96,monk,windwalker,6,1,5
11797,Umbrâsyl,ravencrest,96,monk,windwalker,6,1,5
11798,Синнэрли,soulflayer,96,monk,windwalker,6,1,5
11799,Drlightorc,tarren-mill,96,monk,windwalker,6,1,5
11800,Lîlpumpx,outland,96,monk,windwalker,6,1,5
11801,Konnîchîwa,kazzak,96,monk,windwalker,6,1,5
11802,Волкейн,soulflayer,96,monk,windwalker,6,1,5
11803,Kickboxer,burning-legion,96,monk,windwalker,6,1,5
11804,Néroburnsred,eredar,96,monk,windwalker,6,1,5
11805,Kaizenthor,runetotem,96,monk,windwalker,6,1,5
11806,Betelgeuse,jaedenar,96,monk,windwalker,6,1,5
11807,Реброперо,gordunni,96,monk,windwalker,6,1,5
11808,Kinføu,hyjal,96,monk,windwalker,6,1,5
11809,Жъёь,howling-fjord,96,monk,windwalker,6,1,5
11810,Bigkim,khadgar,96,monk,windwalker,6,1,5
11811,Bâsarä,archimonde,96,monk,windwalker,6,1,5
11812,Kaipo,ragnaros,96,monk,windwalker,6,1,5
11813,Smâsh,blackhand,96,monk,windwalker,6,1,5
11814,Mjaweaver,stormscale,96,monk,windwalker,6,1,5
11815,Мяяумяу,gordunni,96,monk,windwalker,6,1,5
11816,Embodimonk,twisting-nether,96,monk,windwalker,6,1,5
11817,Olympeá,silvermoon,96,monk,windwalker,6,1,5
11818,Zugzuwg,ahnqiraj,96,monk,windwalker,6,1,5
11819,Mìcrøb,blackmoore,96,monk,windwalker,6,1,5
11820,Cøbrakaï,archimonde,96,monk,windwalker,6,1,5
11821,Olgachocolat,blackmoore,96,monk,windwalker,6,1,5
11822,Мяуки,soulflayer,96,monk,windwalker,6,1,5
11823,Musaya,chamber-of-aspects,96,monk,windwalker,6,1,5
11824,Dadeldo,blackrock,96,monk,windwalker,6,1,5
11825,Onisakebi,nemesis,96,monk,windwalker,10,1,9
11826,Linocence,draenor,95,monk,windwalker,6,1,5
11827,Odanobunaga,ravencrest,79,monk,windwalker,5,1,4
11828,Xtcc,kazzak,79,monk,windwalker,5,1,4
11829,Xámell,ravencrest,48,monk,windwalker,3,1,2
11830,Огненныйкит,blackscar,48,monk,windwalker,3,1,2
11831,Scedadle,outland,48,monk,windwalker,3,1,2
11832,Shamarinator,kazzak,42,monk,windwalker,9,2,7
11833,Åbx,argent-dawn,2191,paladin,holy,113,59,54
11834,Crewxdlolz,frostmane,2123,paladin,holy,211,118,93
11835,Likkik,ravencrest,2121,paladin,holy,86,42,44
11836,Wiriday,draenor,2033,paladin,holy,156,78,78
11837,Ranchiek,ravencrest,2019,paladin,holy,60,31,29
11838,Lickssi,outland,2001,paladin,holy,94,56,38
11839,Goyimslayer,ravencrest,1990,paladin,holy,72,41,31
11840,Kyoma,burning-legion,1929,paladin,holy,93,44,49
11841,Vaîjin,aegwynn,1921,paladin,holy,71,37,34
11842,Jìmjim,ysondre,1916,paladin,holy,114,53,61
11843,Tipmax,ravencrest,1856,paladin,holy,61,37,24
11844,Goodpeace,kazzak,1855,paladin,holy,73,35,38
11845,Niwariel,silvermoon,1852,paladin,holy,60,37,23
11846,Типмакс,howling-fjord,1851,paladin,holy,42,25,17
11847,Welivewewin,defias-brotherhood,1845,paladin,holy,54,32,22
11848,Wheelybin,argent-dawn,1843,paladin,holy,53,23,30
11849,Måvé,tarren-mill,1829,paladin,holy,72,40,32
11850,Алексендлер,howling-fjord,1824,paladin,holy,48,27,21
11851,Phalphlingo,stormscale,1824,paladin,holy,78,37,41
11852,Jeø,stormscale,1823,paladin,holy,54,28,26
11853,Eldorín,blackmoore,1823,paladin,holy,54,20,34
11854,Galaxys,blackhand,1818,paladin,holy,128,62,66
11855,Neverlostx,ravencrest,1816,paladin,holy,48,31,17
11856,Ránchìek,ravencrest,1812,paladin,holy,54,26,28
11857,Aww,anachronos,1808,paladin,holy,102,50,52
11858,Pêacerainer,stormscale,1804,paladin,holy,72,29,43
11859,Runtheshôw,tarren-mill,1790,paladin,holy,72,34,38
11860,Popecrusade,archimonde,1781,paladin,holy,95,59,36
11861,Jûliâ,archimonde,1777,paladin,holy,88,49,39
11862,Optîmuslîme,veklor,1774,paladin,holy,30,19,11
11863,Valia,argent-dawn,1754,paladin,holy,63,36,27
11864,Holysacx,aegwynn,1745,paladin,holy,42,25,17
11865,Powertilt,ravencrest,1743,paladin,holy,123,55,68
11866,Everflame,blackmoore,1739,paladin,holy,84,50,34
11867,Dbblou,draenor,1739,paladin,holy,42,20,22
11868,Vindîcator,defias-brotherhood,1736,paladin,holy,191,91,100
11869,Аришалисичка,blackscar,1727,paladin,holy,70,36,34
11870,Svyata,twisting-nether,1721,paladin,holy,53,27,26
11871,Holylightxz,runetotem,1717,paladin,holy,75,36,39
11872,Faíren,mugthol,1697,paladin,holy,66,36,30
11873,Emloses,outland,1690,paladin,holy,90,48,42
11874,Rettyfield,blackrock,1689,paladin,holy,30,18,12
11875,Акунделар,gordunni,1689,paladin,holy,119,59,60
11876,Thaderyl,auchindoun,1678,paladin,holy,66,31,35
11877,Гигашмяк,howling-fjord,1677,paladin,holy,54,30,24
11878,Wokyo,tarren-mill,1676,paladin,holy,89,55,34
11879,Voklane,tarren-mill,1676,paladin,holy,48,23,25
11880,Holysac,aegwynn,1669,paladin,holy,48,26,22
11881,Andûrîl,tarren-mill,1668,paladin,holy,71,37,34
11882,Макстипчик,howling-fjord,1647,paladin,holy,45,22,23
11883,Emlight,kazzak,1646,paladin,holy,41,24,17
11884,Tibelious,ravencrest,1646,paladin,holy,60,22,38
11885,Kakii,gorgonnash,1645,paladin,holy,59,24,35
11886,Holychît,sanguino,1631,paladin,holy,105,50,55
11887,Baazil,ragnaros,1631,paladin,holy,84,38,46
11888,Insanevegan,ravencrest,1628,paladin,holy,66,33,33
11889,Лайтпалочка,soulflayer,1628,paladin,holy,101,48,53
11890,Arysur,defias-brotherhood,1619,paladin,holy,96,43,53
11891,Tyrsa,defias-brotherhood,1615,paladin,holy,36,17,19
11892,Nezâ,thrall,1613,paladin,holy,52,23,29
11893,Skyf,outland,1613,paladin,holy,95,41,54
11894,Smightypal,silvermoon,1607,paladin,holy,111,57,54
11895,Острит,gordunni,1605,paladin,holy,78,45,33
11896,Джонниджага,blackscar,1604,paladin,holy,58,28,30
11897,Lexó,ravencrest,1604,paladin,holy,42,20,22
11898,Judgejuryexe,kazzak,1600,paladin,holy,92,44,48
11899,Blazerlolz,kazzak,1593,paladin,holy,54,29,25
11900,Сэлфхил,gordunni,1591,paladin,holy,107,47,60
11901,Erathoor,grim-batol,1589,paladin,holy,66,32,34
11902,Itsjulie,sylvanas,1588,paladin,holy,40,20,20
11903,Тошанич,soulflayer,1587,paladin,holy,48,23,25
11904,Hirolde,zenedar,1586,paladin,holy,80,41,39
11905,Xenyaa,arygos,1581,paladin,holy,103,53,50
11906,Shabbyy,bronzebeard,1580,paladin,holy,66,36,30
11907,Rùfus,tarren-mill,1574,paladin,holy,54,32,22
11908,Грор,galakrond,1565,paladin,holy,34,21,13
11909,Tuoppi,steamwheedle-cartel,1562,paladin,holy,29,17,12
11910,Isøri,antonidas,1562,paladin,holy,96,45,51
11911,Blessedpapi,draenor,1561,paladin,holy,48,26,22
11912,Astollfo,hyjal,1559,paladin,holy,36,22,14
11913,Потокденег,howling-fjord,1554,paladin,holy,92,40,52
11914,Skurly,ragnaros,1551,paladin,holy,42,19,23
11915,Rëtnuhka,drakthul,1546,paladin,holy,47,24,23
11916,Myssa,uldum,1545,paladin,holy,36,18,18
11917,Strûgglebûs,outland,1543,paladin,holy,47,25,22
11918,Алукартик,deathguard,1543,paladin,holy,59,29,30
11919,Срувтапкизз,blackscar,1543,paladin,holy,83,29,54
11920,Rekieuna,archimonde,1538,paladin,holy,252,122,130
11921,Gasilol,frostwolf,1537,paladin,holy,81,41,40
11922,Scrimple,stormscale,1537,paladin,holy,36,18,18
11923,Aíe,draenor,1536,paladin,holy,45,28,17
11924,Глиндес,gordunni,1536,paladin,holy,84,42,42
11925,Pooncy,ragnaros,1530,paladin,holy,60,27,33
11926,Бадбх,howling-fjord,1527,paladin,holy,90,39,51
11927,Флэшкапро,soulflayer,1521,paladin,holy,190,95,95
11928,Jambbo,twisting-nether,1518,paladin,holy,69,37,32
11929,Buntqt,kazzak,1516,paladin,holy,83,41,42
11930,Dàrckness,ravencrest,1514,paladin,holy,180,94,86
11931,Jajmentx,kazzak,1509,paladin,holy,54,31,23
11932,Sonil,les-sentinelles,1507,paladin,holy,57,24,33
11933,Curtfizzle,kazzak,1505,paladin,holy,53,24,29
11934,Narkal,archimonde,1504,paladin,holy,30,16,14
11935,Nåmï,culte-de-la-rive-noire,1501,paladin,holy,30,18,12
11936,Easypala,blackrock,1500,paladin,holy,90,34,56
11937,Aese,dun-modr,1499,paladin,holy,102,51,51
11938,Dömötörp,ragnaros,1492,paladin,holy,42,20,22
11939,Xsÿde,archimonde,1489,paladin,holy,48,17,31
11940,Arenalena,sylvanas,1488,paladin,holy,107,51,56
11941,Chocòbon,archimonde,1487,paladin,holy,36,21,15
11942,Devinèqt,tarren-mill,1481,paladin,holy,43,24,19
11943,Сашафистинг,gordunni,1481,paladin,holy,129,65,64
11944,Drdeus,kazzak,1471,paladin,holy,74,34,40
11945,Injection,khaz-modan,1464,paladin,holy,69,32,37
11946,Bécasszelium,varimathras,1462,paladin,holy,108,55,53
11947,Dathróhán,silvermoon,1458,paladin,holy,219,109,110
11948,Lóde,silvermoon,1454,paladin,holy,84,42,42
11949,Deodas,kazzak,1454,paladin,holy,78,33,45
11950,Realpalla,ravenholdt,1452,paladin,holy,126,62,64
11951,Marygueguete,archimonde,1449,paladin,holy,60,27,33
11952,Mitsaklas,grim-batol,1440,paladin,holy,45,18,27
11953,Паладинас,lich-king,1438,paladin,holy,52,17,35
11954,Уретроград,soulflayer,1436,paladin,holy,72,36,36
11955,Lycerax,antonidas,1427,paladin,holy,24,15,9
11956,Taiso,alonsus,1422,paladin,holy,132,64,68
11957,Fourshaw,ravencrest,1422,paladin,holy,77,35,42
11958,Enemylosers,stormscale,1421,paladin,holy,42,20,22
11959,Preyy,eredar,1414,paladin,holy,54,30,24
11960,Хегия,gordunni,1414,paladin,holy,30,15,15
11961,Hazø,silvermoon,1413,paladin,holy,30,18,12
11962,Blazeberg,tirion,1411,paladin,holy,36,20,16
11963,Itsgossiplol,twisting-nether,1409,paladin,holy,32,18,14
11964,Ðenlox,destromath,1408,paladin,holy,104,53,51
11965,Hotub,twisting-nether,1404,paladin,holy,77,40,37
11966,Салфеточник,thermaplugg,1403,paladin,holy,60,23,37
11967,Аяпал,blackscar,1401,paladin,holy,72,39,33
11968,Леонящер,gordunni,1400,paladin,holy,138,75,63
11969,Watras,drakthul,1400,paladin,holy,36,15,21
11970,Xenaké,kazzak,1391,paladin,holy,74,26,48
11971,Skengdaddy,ragnaros,1390,paladin,holy,36,18,18
11972,Реколори,gordunni,1389,paladin,holy,165,90,75
11973,Эсерпи,gordunni,1389,paladin,holy,88,45,43
11974,Kantfyrste,ravencrest,1388,paladin,holy,139,59,80
11975,Stinkepieet,blackmoore,1387,paladin,holy,42,17,25
11976,Noliferx,ravencrest,1383,paladin,holy,82,49,33
11977,Zycqo,silvermoon,1377,paladin,holy,174,84,90
11978,Vivalabeef,stormscale,1374,paladin,holy,42,18,24
11979,Cykadin,dun-modr,1372,paladin,holy,54,20,34
11980,Athenewins,tarren-mill,1371,paladin,holy,117,59,58
11981,Maitrelampe,argent-dawn,1369,paladin,holy,66,31,35
11982,Alldo,drakthul,1366,paladin,holy,66,30,36
11983,Locofatguy,drakthul,1366,paladin,holy,60,26,34
11984,Mecah,hyjal,1365,paladin,holy,42,21,21
11985,Lastaid,azshara,1365,paladin,holy,60,28,32
11986,Zilu,kazzak,1364,paladin,holy,29,15,14
11987,Зондарк,booty-bay,1364,paladin,holy,53,22,31
11988,Pullheavy,silvermoon,1363,paladin,holy,83,35,48
11989,Sacbøt,stormscale,1362,paladin,holy,211,105,106
11990,Xelqt,draenor,1361,paladin,holy,36,15,21
11991,Callístó,amanthul,1357,paladin,holy,77,24,53
11992,Shakalol,dun-modr,1355,paladin,holy,60,23,37
11993,Heilgaharald,blackrock,1351,paladin,holy,110,51,59
11994,Freaak,dethecus,1351,paladin,holy,36,15,21
11995,Снупарь,blackscar,1351,paladin,holy,45,18,27
11996,Arlette,moonglade,1345,paladin,holy,72,32,40
11997,Satipal,sargeras,1343,paladin,holy,81,33,48
11998,Keele,stormscale,1341,paladin,holy,69,32,37
11999,Wollymolly,ravencrest,1338,paladin,holy,24,14,10
12000,Nde,silvermoon,1333,paladin,holy,29,15,14
12001,Бэнкли,soulflayer,1332,paladin,holy,30,19,11
12002,Steggeh,argent-dawn,1331,paladin,holy,120,48,72
12003,Rotana,eredar,1328,paladin,holy,18,14,4
12004,Lightbrîng,hyjal,1327,paladin,holy,53,26,27
12005,Кольт,borean-tundra,1324,paladin,holy,73,36,37
12006,Demecir,twisting-nether,1323,paladin,holy,166,83,83
12007,Danepala,defias-brotherhood,1322,paladin,holy,29,15,14
12008,Эллиарэй,gordunni,1321,paladin,holy,30,14,16
12009,Skinstructor,silvermoon,1319,paladin,holy,30,14,16
12010,Kayndornek,ravencrest,1316,paladin,holy,36,19,17
12011,Erao,the-maelstrom,1313,paladin,holy,36,14,22
12012,Emistesía,stormscale,1312,paladin,holy,36,14,22
12013,Bigfailure,blackmoore,1309,paladin,holy,65,21,44
12014,Лимфома,goldrinn,1307,paladin,holy,53,18,35
12015,Sangriul,outland,1306,paladin,holy,75,27,48
12016,Wíw,kazzak,1304,paladin,holy,36,14,22
12017,Valkhana,draenor,1301,paladin,holy,36,21,15
12018,Nudzolini,tarren-mill,1300,paladin,holy,30,17,13
12019,Elohim,echsenkessel,1293,paladin,holy,142,64,78
12020,Kerven,doomhammer,1293,paladin,holy,42,16,26
12021,Daizen,blackrock,1289,paladin,holy,61,41,20
12022,Polydeukis,stormscale,1288,paladin,holy,78,29,49
12023,Алекхей,gordunni,1282,paladin,holy,66,28,38
12024,Alard,sanguino,1280,paladin,holy,66,25,41
12025,Ggiwastheret,kazzak,1277,paladin,holy,23,14,9
12026,Анбели,gordunni,1270,paladin,holy,36,15,21
12027,Делатор,gordunni,1267,paladin,holy,48,22,26
12028,Ромерл,gordunni,1265,paladin,holy,159,74,85
12029,Tyktyk,draenor,1264,paladin,holy,30,17,13
12030,Necrozi,stormscale,1263,paladin,holy,48,27,21
12031,Tíep,blackmoore,1262,paladin,holy,71,36,35
12032,Pajtash,doomhammer,1261,paladin,holy,59,29,30
12033,Pigpiss,ravencrest,1260,paladin,holy,34,14,20
12034,Amolan,drakthul,1259,paladin,holy,39,24,15
12035,Bloodsoldier,twisting-nether,1258,paladin,holy,88,45,43
12036,Kaitlyne,tarren-mill,1252,paladin,holy,91,46,45
12037,Dawnforged,stormscale,1244,paladin,holy,60,28,32
12038,Wrathlol,ravencrest,1241,paladin,holy,119,55,64
12039,Demonskiller,alakir,1240,paladin,holy,83,44,39
12040,Ostardo,blackhand,1237,paladin,holy,18,13,5
12041,Pupsihasi,kelthuzad,1237,paladin,holy,29,16,13
12042,Skailzpal,hyjal,1236,paladin,holy,36,21,15
12043,Présidential,grim-batol,1235,paladin,holy,24,13,11
12044,Wingcomandêr,aegwynn,1235,paladin,holy,30,13,17
12045,Nerdpallyx,tarren-mill,1234,paladin,holy,24,13,11
12046,Ramos,aggra-português,1234,paladin,holy,30,13,17
12047,Jarroshdin,stormscale,1232,paladin,holy,60,38,22
12048,Farata,ravencrest,1230,paladin,holy,160,78,82
12049,Regis,dragonblight,1228,paladin,holy,46,26,20
12050,Hîfi,blackmoore,1227,paladin,holy,124,66,58
12051,Ritiv,stormreaver,1219,paladin,holy,72,30,42
12052,Pussdocta,ravencrest,1218,paladin,holy,36,15,21
12053,Weserwehr,laughing-skull,1214,paladin,holy,54,27,27
12054,Stuzzyy,ravencrest,1209,paladin,holy,36,16,20
12055,Strykar,aggra-português,1207,paladin,holy,30,17,13
12056,Keryann,argent-dawn,1205,paladin,holy,102,51,51
12057,Bovinequeef,twisting-nether,1202,paladin,holy,24,13,11
12058,Xastur,rexxar,1201,paladin,holy,33,17,16
12059,Boric,bloodhoof,1184,paladin,holy,29,16,13
12060,Crispydixx,draenor,1183,paladin,holy,59,29,30
12061,Baubble,silvermoon,1181,paladin,holy,24,14,10
12062,Shiidori,aegwynn,1175,paladin,holy,57,23,34
12063,Rhulana,blackrock,1171,paladin,holy,50,32,18
12064,Pokébowl,outland,1166,paladin,holy,30,14,16
12065,Kambood,twisting-nether,1162,paladin,holy,117,52,65
12066,Ragua,tarren-mill,1159,paladin,holy,60,23,37
12067,Kaki,gorgonnash,1151,paladin,holy,18,12,6
12068,Echooes,ravencrest,1151,paladin,holy,150,62,88
12069,Lrnz,tarren-mill,1151,paladin,holy,30,12,18
12070,Haylø,archimonde,1150,paladin,holy,24,12,12
12071,Chryme,thrall,1149,paladin,holy,18,12,6
12072,Алексендлерх,soulflayer,1149,paladin,holy,18,12,6
12073,Catali,sanguino,1149,paladin,holy,99,50,49
12074,Мифариан,blackscar,1147,paladin,holy,24,12,12
12075,Strudell,terrordar,1146,paladin,holy,23,13,10
12076,Elsewhere,archimonde,1146,paladin,holy,30,12,18
12077,Rookbeef,eredar,1145,paladin,holy,18,12,6
12078,Quezkal,dun-modr,1144,paladin,holy,39,18,21
12079,Leon,veknilash,1144,paladin,holy,93,39,54
12080,Коварное,borean-tundra,1141,paladin,holy,24,12,12
12081,Gromezrael,elune,1141,paladin,holy,42,19,23
12082,Cadila,silvermoon,1141,paladin,holy,42,19,23
12083,Archaegis,silvermoon,1141,paladin,holy,30,12,18
12084,Talimañ,kazzak,1140,paladin,holy,18,12,6
12085,Holymax,gorgonnash,1140,paladin,holy,30,17,13
12086,Konane,drekthar,1139,paladin,holy,31,12,19
12087,Uzuriel,chogall,1138,paladin,holy,190,76,114
12088,Wedervärdig,twilights-hammer,1132,paladin,holy,36,14,22
12089,Skolisse,kazzak,1129,paladin,holy,66,32,34
12090,Mikemyers,blackhand,1127,paladin,holy,30,12,18
12091,Zebramann,silvermoon,1121,paladin,holy,48,20,28
12092,Serim,dun-modr,1119,paladin,holy,54,23,31
12093,Kanina,outland,1114,paladin,holy,58,23,35
12094,Kapikøoqt,suramar,1111,paladin,holy,63,36,27
12095,Tscheba,kazzak,1109,paladin,holy,82,42,40
12096,Trístesse,tarren-mill,1109,paladin,holy,88,42,46
12097,Unithral,durotan,1107,paladin,holy,24,12,12
12098,Puiçanpal,archimonde,1105,paladin,holy,24,12,12
12099,Minui,onyxia,1100,paladin,holy,30,12,18
12100,Nosn,ravencrest,1087,paladin,holy,66,34,32
12101,Dabstar,antonidas,1086,paladin,holy,88,41,47
12102,Jaezlin,tarren-mill,1077,paladin,holy,70,33,37
12103,Palanolmal,dun-modr,1068,paladin,holy,33,16,17
12104,Trisunonvaki,khazgoroth,1065,paladin,holy,108,52,56
12105,Johnaggro,outland,1060,paladin,holy,31,13,18
12106,Casmira,blackrock,1055,paladin,holy,18,11,7
12107,Holeck,aegwynn,1054,paladin,holy,33,11,22
12108,Heyley,twisting-nether,1053,paladin,holy,18,11,7
12109,Çrúsader,frostmane,1053,paladin,holy,24,14,10
12110,Andronar,blackmoore,1053,paladin,holy,24,11,13
12111,Pablok,minahonda,1053,paladin,holy,36,11,25
12112,Kaktuszfüge,ragnaros,1052,paladin,holy,58,35,23
12113,Emistesia,stormscale,1050,paladin,holy,24,11,13
12114,Cmen,silvermoon,1043,paladin,holy,109,54,55
12115,Babybeater,outland,1043,paladin,holy,37,14,23
12116,Grimbold,hellfire,1042,paladin,holy,18,11,7
12117,Karnwield,kirin-tor,1039,paladin,holy,34,16,18
12118,Kuhs,eredar,1038,paladin,holy,59,23,36
12119,Flashyplays,silvermoon,1037,paladin,holy,30,21,9
12120,Neithi,twisting-nether,1033,paladin,holy,24,11,13
12121,Billkop,silvermoon,1030,paladin,holy,43,20,23
12122,Guidone,sylvanas,1029,paladin,holy,24,11,13
12123,Høpé,malganis,1028,paladin,holy,68,32,36
12124,Zerfleddern,aegwynn,1026,paladin,holy,65,27,38
12125,Darhuun,antonidas,1012,paladin,holy,60,23,37
12126,Rafox,malygos,1010,paladin,holy,24,12,12
12127,Palir,ysondre,1010,paladin,holy,24,11,13
12128,Golldy,burning-legion,1008,paladin,holy,21,12,9
12129,Paliester,stormscale,1007,paladin,holy,18,12,6
12130,Satip,archimonde,993,paladin,holy,36,22,14
12131,Vintar,quelthalas,993,paladin,holy,36,18,18
12132,Poundcake,stormscale,990,paladin,holy,68,30,38
12133,Buddy,conseil-des-ombres,988,paladin,holy,50,24,26
12134,Legenda,grim-batol,979,paladin,holy,30,14,16
12135,Psycholas,ysondre,969,paladin,holy,23,11,12
12136,Byoß,ravencrest,960,paladin,holy,18,10,8
12137,Seabrook,stormscale,960,paladin,holy,36,10,26
12138,Drohim,aegwynn,959,paladin,holy,18,10,8
12139,Umirinbruv,zenedar,959,paladin,holy,26,10,16
12140,Fannypoo,sylvanas,959,paladin,holy,30,10,20
12141,Whórainzóne,eredar,958,paladin,holy,36,10,26
12142,Mercedes,arthas,957,paladin,holy,18,10,8
12143,Elians,outland,955,paladin,holy,24,10,14
12144,Tömmÿ,draenor,954,paladin,holy,30,13,17
12145,Crusadelight,alakir,953,paladin,holy,68,29,39
12146,Roshï,tarren-mill,953,paladin,holy,30,10,20
12147,Keltinne,ysondre,952,paladin,holy,18,10,8
12148,Bcrp,ragnaros,950,paladin,holy,24,10,14
12149,Кейлол,soulflayer,949,paladin,holy,21,10,11
12150,Skwáru,burning-legion,949,paladin,holy,24,10,14
12151,Sweestance,minahonda,949,paladin,holy,30,10,20
12152,Cmelacek,wildhammer,948,paladin,holy,18,10,8
12153,Lightmamba,draenor,947,paladin,holy,30,10,20
12154,Ударник,soulflayer,946,paladin,holy,18,11,7
12155,Lightmachine,kirin-tor,945,paladin,holy,12,10,2
12156,Messîah,outland,939,paladin,holy,43,19,24
12157,Миллагрессия,soulflayer,938,paladin,holy,36,17,19
12158,Badckes,sylvanas,937,paladin,holy,29,10,19
12159,Clerik,eredar,934,paladin,holy,64,30,34
12160,Thickets,argent-dawn,934,paladin,holy,24,10,14
12161,Manole,ravencrest,933,paladin,holy,29,12,17
12162,Yasmira,frostmourne,930,paladin,holy,30,16,14
12163,Gabriev,twisting-nether,925,paladin,holy,14,11,3
12164,Kaleto,ragnaros,923,paladin,holy,18,10,8
12165,Paladons,darksorrow,922,paladin,holy,30,16,14
12166,Reeceboss,ravencrest,906,paladin,holy,29,12,17
12167,Toradin,thunderhorn,905,paladin,holy,21,10,11
12168,Öbedö,malganis,902,paladin,holy,27,10,17
12169,Яполковник,gordunni,887,paladin,holy,53,30,23
12170,Theisixtus,drakthul,883,paladin,holy,23,12,11
12171,Veelris,kazzak,865,paladin,holy,60,28,32
12172,Pisr,draenor,864,paladin,holy,18,9,9
12173,Мылонеуроних,deathguard,864,paladin,holy,18,9,9
12174,Áfx,blackmoore,864,paladin,holy,37,14,23
12175,Думгохан,howling-fjord,864,paladin,holy,24,9,15
12176,Deathsfate,defias-brotherhood,863,paladin,holy,12,9,3
12177,Ashbrìnger,aegwynn,861,paladin,holy,18,9,9
12178,Рэймета,soulflayer,861,paladin,holy,18,9,9
12179,Expot,blackmoore,859,paladin,holy,18,9,9
12180,Smirk,aggra-português,857,paladin,holy,12,9,3
12181,Elganwar,hyjal,856,paladin,holy,18,9,9
12182,Goodbit,dentarg,855,paladin,holy,18,9,9
12183,Kocovic,tarren-mill,855,paladin,holy,24,9,15
12184,Dunka,twisting-nether,854,paladin,holy,12,9,3
12185,Faildin,arathor,853,paladin,holy,30,9,21
12186,Burkaal,antonidas,852,paladin,holy,24,9,15
12187,Ланиакеа,deathguard,845,paladin,holy,18,9,9
12188,Fract,aggramar,838,paladin,holy,18,9,9
12189,Kárlsberg,aegwynn,833,paladin,holy,30,12,18
12190,Ridethelight,nemesis,823,paladin,holy,18,9,9
12191,Salubrifie,archimonde,817,paladin,holy,18,9,9
12192,Derpe,hellscream,768,paladin,holy,18,8,10
12193,Percocetx,tarren-mill,768,paladin,holy,24,8,16
12194,Crucifiction,balnazzar,768,paladin,holy,24,8,16
12195,Curufin,grim-batol,767,paladin,holy,12,8,4
12196,Böllerbarbie,silvermoon,767,paladin,holy,12,8,4
12197,Qpax,twisting-nether,767,paladin,holy,18,8,10
12198,Ванябублгам,soulflayer,767,paladin,holy,18,8,10
12199,Claudîax,kazzak,767,paladin,holy,18,8,10
12200,Micrøsi,thrall,767,paladin,holy,18,8,10
12201,Asenae,draenor,767,paladin,holy,24,8,16
12202,Dunutunicorn,argent-dawn,766,paladin,holy,12,8,4
12203,Bezvakost,thunderhorn,766,paladin,holy,18,8,10
12204,Bighammerx,ravencrest,765,paladin,holy,18,8,10
12205,Coopz,defias-brotherhood,765,paladin,holy,18,8,10
12206,Rébél,argent-dawn,763,paladin,holy,24,8,16
12207,Ikbenmani,tarren-mill,760,paladin,holy,18,8,10
12208,Galadørn,elune,760,paladin,holy,24,8,16
12209,Паландис,howling-fjord,757,paladin,holy,18,8,10
12210,Jaesa,lordaeron,735,paladin,holy,17,8,9
12211,Agadin,ysondre,732,paladin,holy,17,8,9
12212,Anemonaa,argent-dawn,722,paladin,holy,18,8,10
12213,Churrucuca,minahonda,713,paladin,holy,15,9,6
12214,Gegge,kazzak,701,paladin,holy,32,8,24
12215,Haros,xavius,686,paladin,holy,13,8,5
12216,Heartbroken,blackrock,672,paladin,holy,12,7,5
12217,Ирестли,azuregos,672,paladin,holy,12,7,5
12218,Faíren,blackrock,672,paladin,holy,18,7,11
12219,Papasito,tarren-mill,672,paladin,holy,24,7,17
12220,Delmothounet,ysondre,671,paladin,holy,12,7,5
12221,Daddysiliam,ravencrest,671,paladin,holy,12,7,5
12222,Tiffanyqt,frostwolf,671,paladin,holy,12,7,5
12223,Skatiaringos,silvermoon,671,paladin,holy,18,7,11
12224,Mohamedx,tarren-mill,671,paladin,holy,18,7,11
12225,Skarn,pozzo-delleternità,670,paladin,holy,18,7,11
12226,Mjølnîr,eredar,670,paladin,holy,18,7,11
12227,Lènnja,baelgun,670,paladin,holy,18,7,11
12228,Mestgone,dalaran,670,paladin,holy,30,7,23
12229,Seinz,talnivarr,668,paladin,holy,18,7,11
12230,Luminix,ragnaros,667,paladin,holy,12,7,5
12231,Edwín,tichondrius,667,paladin,holy,12,7,5
12232,Juicemachine,silvermoon,663,paladin,holy,12,7,5
12233,Langibo,malfurion,658,paladin,holy,12,7,5
12234,Chantal,gilneas,648,paladin,holy,18,7,11
12235,Витёнокь,howling-fjord,637,paladin,holy,14,8,6
12236,Jüther,pozzo-delleternità,623,paladin,holy,17,7,10
12237,Торсгард,howling-fjord,622,paladin,holy,15,8,7
12238,Meive,sanguino,622,paladin,holy,17,7,10
12239,Ubiquitous,kazzak,606,paladin,holy,17,7,10
12240,Bapêe,thrall,576,paladin,holy,12,6,6
12241,Jinyssa,silvermoon,576,paladin,holy,12,6,6
12242,Mðnsterz,archimonde,576,paladin,holy,12,6,6
12243,Kiingen,ragnaros,576,paladin,holy,12,6,6
12244,Holypapa,argent-dawn,576,paladin,holy,12,6,6
12245,Рустиктоп,gordunni,576,paladin,holy,12,6,6
12246,Istani,twisting-nether,576,paladin,holy,12,6,6
12247,Nádrüstál,kazzak,576,paladin,holy,12,6,6
12248,Powerpufgirl,blackrock,576,paladin,holy,12,6,6
12249,Zabrok,outland,576,paladin,holy,12,6,6
12250,Ben,ghostlands,576,paladin,holy,12,6,6
12251,Holyfuchsia,ravencrest,576,paladin,holy,12,6,6
12252,Dogmatic,blackmoore,576,paladin,holy,12,6,6
12253,Verlinya,archimonde,576,paladin,holy,12,6,6
12254,Язвавгорле,soulflayer,576,paladin,holy,18,6,12
12255,Neverbuble,archimonde,576,paladin,holy,18,6,12
12256,Westranspal,ravencrest,576,paladin,holy,18,6,12
12257,Elfaza,uldum,576,paladin,holy,24,6,18
12258,Dragonwingz,kazzak,575,paladin,holy,12,6,6
12259,Paliat,silvermoon,575,paladin,holy,13,6,7
12260,Нинтендо,grom,575,paladin,holy,18,6,12
12261,Pussas,burning-legion,575,paladin,holy,18,6,12
12262,Fleshoflight,arathor,575,paladin,holy,24,6,18
12263,Jeyløl,antonidas,574,paladin,holy,12,6,6
12264,Elsirosel,dun-modr,574,paladin,holy,12,6,6
12265,Darthdin,stormscale,572,paladin,holy,12,6,6
12266,Purificatoru,draenor,569,paladin,holy,18,6,12
12267,Thaifo,silvermoon,528,paladin,holy,9,7,2
12268,Heavel,thrall,527,paladin,holy,17,6,11
12269,Cunix,draenor,480,paladin,holy,6,5,1
12270,Teksor,frostmourne,480,paladin,holy,6,5,1
12271,Ðelusion,sanguino,480,paladin,holy,6,5,1
12272,Лайхтни,gordunni,480,paladin,holy,12,5,7
12273,Hogma,hyjal,480,paladin,holy,12,5,7
12274,Demytxx,silvermoon,480,paladin,holy,12,5,7
12275,Holydeals,silvermoon,480,paladin,holy,12,5,7
12276,Холиэвил,gordunni,480,paladin,holy,12,5,7
12277,Alennya,dalaran,480,paladin,holy,12,5,7
12278,Fluentx,ravencrest,480,paladin,holy,12,5,7
12279,Stepsislana,tarren-mill,480,paladin,holy,12,5,7
12280,Niou,alleria,480,paladin,holy,12,5,7
12281,Bossedin,aszune,480,paladin,holy,12,5,7
12282,Gayestpala,ravencrest,480,paladin,holy,12,5,7
12283,Аффикстинка,soulflayer,480,paladin,holy,12,5,7
12284,Holydhanas,outland,480,paladin,holy,18,5,13
12285,Гола,gordunni,480,paladin,holy,18,5,13
12286,Zymotíx,stormscale,480,paladin,holy,18,5,13
12287,Ðeswynd,hyjal,480,paladin,holy,24,5,19
12288,Tarhal,guldan,479,paladin,holy,6,5,1
12289,Stinkytoes,draenor,479,paladin,holy,12,5,7
12290,Руслаанеш,soulflayer,479,paladin,holy,12,5,7
12291,Dreamwatcher,outland,479,paladin,holy,12,5,7
12292,Лазуриса,deathguard,479,paladin,holy,12,5,7
12293,Brøadway,eredar,479,paladin,holy,12,5,7
12294,Малимон,soulflayer,479,paladin,holy,12,5,7
12295,Liadry,sylvanas,479,paladin,holy,12,5,7
12296,Gavril,bloodfeather,479,paladin,holy,12,5,7
12297,Perpon,exodar,479,paladin,holy,12,5,7
12298,Truthbearer,darksorrow,479,paladin,holy,16,5,11
12299,Bellamy,vashj,479,paladin,holy,18,5,13
12300,Groove,colinas-pardas,478,paladin,holy,16,6,10
12301,Bubblegum,dentarg,478,paladin,holy,18,5,13
12302,Warkyria,sanguino,477,paladin,holy,13,6,7
12303,Menagron,tarren-mill,476,paladin,holy,13,5,8
12304,Styflor,dalaran,476,paladin,holy,18,5,13
12305,Ázot,burning-legion,475,paladin,holy,18,5,13
12306,Jargot,antonidas,472,paladin,holy,12,5,7
12307,Árcangel,minahonda,447,paladin,holy,17,5,12
12308,Memewings,tarren-mill,426,paladin,holy,17,7,10
12309,Тейдехан,gordunni,426,paladin,holy,21,6,15
12310,Eastranspal,ravencrest,426,paladin,holy,24,6,18
12311,Bloednicht,dentarg,384,paladin,holy,6,4,2
12312,Holydawnx,kazzak,384,paladin,holy,6,4,2
12313,Дезоиль,gordunni,384,paladin,holy,6,4,2
12314,Первыйпал,blackscar,384,paladin,holy,6,4,2
12315,Elp,ysondre,384,paladin,holy,6,4,2
12316,Chewwaka,bloodhoof,384,paladin,holy,6,4,2
12317,Dragg,kirin-tor,384,paladin,holy,6,4,2
12318,Shamoo,archimonde,384,paladin,holy,6,4,2
12319,Lapew,eredar,384,paladin,holy,6,4,2
12320,Nemesisbot,dun-modr,384,paladin,holy,6,4,2
12321,Zunis,jaedenar,384,paladin,holy,6,4,2
12322,Wiffy,ravencrest,384,paladin,holy,6,4,2
12323,Fluv,ravencrest,384,paladin,holy,6,4,2
12324,Rikiji,ravencrest,384,paladin,holy,6,4,2
12325,Lexolex,ravencrest,384,paladin,holy,6,4,2
12326,Norandel,turalyon,384,paladin,holy,12,4,8
12327,Stratarxis,kazzak,384,paladin,holy,12,4,8
12328,Lianndrin,blackhand,384,paladin,holy,12,4,8
12329,Подлыйдим,fordragon,384,paladin,holy,12,4,8
12330,Sebatrøz,ravencrest,384,paladin,holy,12,4,8
12331,Дэнриэль,howling-fjord,384,paladin,holy,12,4,8
12332,Psikatchuu,hyjal,384,paladin,holy,12,4,8
12333,Hammarfall,ravencrest,384,paladin,holy,12,4,8
12334,Visersion,tarren-mill,384,paladin,holy,12,4,8
12335,Cerseï,frostmane,384,paladin,holy,12,4,8
12336,Vânwêêd,thrall,384,paladin,holy,12,4,8
12337,Imitrex,hyjal,384,paladin,holy,12,4,8
12338,Shívah,auchindoun,384,paladin,holy,12,4,8
12339,Tyrø,ravencrest,384,paladin,holy,12,4,8
12340,Eline,zenedar,384,paladin,holy,12,4,8
12341,Талрэн,howling-fjord,384,paladin,holy,18,4,14
12342,Tôra,hyjal,383,paladin,holy,6,4,2
12343,Maxôr,norgannon,383,paladin,holy,12,4,8
12344,Caumon,los-errantes,383,paladin,holy,12,4,8
12345,Anfe,silvermoon,383,paladin,holy,12,4,8
12346,Кэлви,blackscar,383,paladin,holy,12,4,8
12347,Scissors,dun-morogh,383,paladin,holy,18,4,14
12348,Superpaladin,draenor,383,paladin,holy,18,4,14
12349,Santtox,dun-modr,383,paladin,holy,18,4,14
12350,Zetla,khaz-modan,382,paladin,holy,12,4,8
12351,Avengilo,silvermoon,382,paladin,holy,12,4,8
12352,Konpala,blackmoore,367,paladin,holy,11,4,7
12353,Lezoom,draenor,367,paladin,holy,11,4,7
12354,Justyowx,archimonde,352,paladin,holy,16,5,11
12355,Pepegasensei,ravencrest,330,paladin,holy,7,5,2
12356,Zeret,twisting-nether,329,paladin,holy,16,6,10
12357,Ysnee,sanguino,320,paladin,holy,16,4,12
12358,Wäsabi,khaz-modan,288,paladin,holy,6,3,3
12359,Matagladis,dun-modr,288,paladin,holy,6,3,3
12360,Tacodin,blackrock,288,paladin,holy,6,3,3
12361,Preamx,blackrock,288,paladin,holy,6,3,3
12362,Demytx,burning-legion,288,paladin,holy,6,3,3
12363,Lunalovesyou,blackmoore,288,paladin,holy,6,3,3
12364,Эвердрим,soulflayer,288,paladin,holy,6,3,3
12365,Kristelle,argent-dawn,288,paladin,holy,6,3,3
12366,Solumon,gorgonnash,288,paladin,holy,6,3,3
12367,Бладиполи,soulflayer,288,paladin,holy,6,3,3
12368,Bandrogina,shattered-hand,288,paladin,holy,6,3,3
12369,Tyn,dragonmaw,288,paladin,holy,6,3,3
12370,Вивай,howling-fjord,288,paladin,holy,6,3,3
12371,Grafes,sanguino,288,paladin,holy,6,3,3
12372,Rohanan,blackrock,288,paladin,holy,6,3,3
12373,Reeley,drakthul,288,paladin,holy,6,3,3
12374,Breez,die-aldor,288,paladin,holy,6,3,3
12375,Gtgpiscine,kirin-tor,288,paladin,holy,6,3,3
12376,Padrak,eredar,288,paladin,holy,6,3,3
12377,Veléxis,outland,288,paladin,holy,6,3,3
12378,Vôltuxx,outland,288,paladin,holy,6,3,3
12379,Snoogléface,grim-batol,288,paladin,holy,6,3,3
12380,Krayzier,nordrassil,288,paladin,holy,12,3,9
12381,Tyraïa,archimonde,288,paladin,holy,12,3,9
12382,Linxo,argent-dawn,288,paladin,holy,12,3,9
12383,Jctp,ravencrest,288,paladin,holy,12,3,9
12384,Brölin,sanguino,288,paladin,holy,12,3,9
12385,Arbuzno,draenor,288,paladin,holy,12,3,9
12386,Zerohour,kilrogg,288,paladin,holy,12,3,9
12387,Rezvaya,tarren-mill,288,paladin,holy,12,3,9
12388,Kapsloch,twisting-nether,288,paladin,holy,12,3,9
12389,Влажныйбоб,soulflayer,288,paladin,holy,12,3,9
12390,Heldarim,ysondre,288,paladin,holy,12,3,9
12391,Bigdamjudge,argent-dawn,288,paladin,holy,12,3,9
12392,Telarii,die-nachtwache,288,paladin,holy,12,3,9
12393,Kelmarr,blackmoore,288,paladin,holy,12,3,9
12394,Amôn,outland,288,paladin,holy,16,3,13
12395,Kaelorian,silvermoon,288,paladin,holy,18,3,15
12396,Palolog,burning-legion,288,paladin,holy,18,3,15
12397,Averyholycow,the-maelstrom,287,paladin,holy,6,3,3
12398,Alastrr,hyjal,287,paladin,holy,6,3,3
12399,Макспал,lich-king,287,paladin,holy,6,3,3
12400,Даурия,soulflayer,287,paladin,holy,12,3,9
12401,Toxií,argent-dawn,287,paladin,holy,12,3,9
12402,Kcore,blackrock,287,paladin,holy,12,3,9
12403,Mozzie,archimonde,282,paladin,holy,23,5,18
12404,Европпа,soulflayer,271,paladin,holy,16,3,13
12405,Gaskohle,blackmoore,255,paladin,holy,11,3,8
12406,Xaérulus,draenor,239,paladin,holy,5,3,2
12407,Xila,blackrock,234,paladin,holy,9,4,5
12408,Mustardio,tarren-mill,234,paladin,holy,14,4,10
12409,Dewastør,blackmoore,234,paladin,holy,15,4,11
12410,Ниссида,blackscar,224,paladin,holy,10,3,7
12411,Teflonmagìc,ravencrest,192,paladin,holy,6,2,4
12412,Прожектор,gordunni,192,paladin,holy,6,2,4
12413,Elrack,blackhand,192,paladin,holy,6,2,4
12414,Truko,frostwolf,192,paladin,holy,6,2,4
12415,Durnell,sylvanas,192,paladin,holy,6,2,4
12416,Ришардебюр,soulflayer,192,paladin,holy,6,2,4
12417,Datz,nerathor,192,paladin,holy,6,2,4
12418,Pârabellum,the-maelstrom,192,paladin,holy,6,2,4
12419,Benedikt,stormscale,192,paladin,holy,6,2,4
12420,Pagadi,blackhand,192,paladin,holy,6,2,4
12421,Zeiserig,antonidas,192,paladin,holy,6,2,4
12422,Ðuïvel,grim-batol,192,paladin,holy,6,2,4
12423,Rdypaladin,ravencrest,192,paladin,holy,6,2,4
12424,Envli,ragnaros,192,paladin,holy,6,2,4
12425,Lompe,karazhan,192,paladin,holy,6,2,4
12426,Conker,malganis,192,paladin,holy,6,2,4
12427,Дюве,blackscar,192,paladin,holy,6,2,4
12428,Padraic,scarshield-legion,192,paladin,holy,6,2,4
12429,Alisonquínn,defias-brotherhood,192,paladin,holy,6,2,4
12430,Lafrogge,culte-de-la-rive-noire,192,paladin,holy,6,2,4
12431,Jeromesavile,tarren-mill,192,paladin,holy,6,2,4
12432,Bígmachine,draenor,192,paladin,holy,6,2,4
12433,Léinãd,kazzak,192,paladin,holy,6,2,4
12434,Poonky,dun-modr,192,paladin,holy,6,2,4
12435,Fleshgraft,drakthul,192,paladin,holy,6,2,4
12436,Galadrion,dun-modr,192,paladin,holy,6,2,4
12437,Calipse,outland,192,paladin,holy,6,2,4
12438,Nirvanä,drakthul,192,paladin,holy,6,2,4
12439,Vadomar,emerald-dream,192,paladin,holy,6,2,4
12440,Edgï,confrérie-du-thorium,192,paladin,holy,6,2,4
12441,Pátish,terenas,192,paladin,holy,6,2,4
12442,Rulîx,blackmoore,192,paladin,holy,6,2,4
12443,Realdeal,argent-dawn,192,paladin,holy,6,2,4
12444,Zeleron,darksorrow,192,paladin,holy,12,2,10
12445,Silvers,steamwheedle-cartel,192,paladin,holy,12,2,10
12446,Холидугги,howling-fjord,192,paladin,holy,12,2,10
12447,Croptol,dun-modr,192,paladin,holy,12,2,10
12448,Essina,argent-dawn,192,paladin,holy,12,2,10
12449,Vulgati,kazzak,192,paladin,holy,12,2,10
12450,Eky,stormreaver,192,paladin,holy,18,2,16
12451,Tiboeufpéi,archimonde,191,paladin,holy,6,2,4
12452,Àkí,blackmoore,191,paladin,holy,6,2,4
12453,Zuplex,deathwing,191,paladin,holy,6,2,4
12454,Pïñkñætðøðÿ,tarren-mill,138,paladin,holy,14,3,11
12455,Paladzor,twisting-nether,128,paladin,holy,4,2,2
12456,Bittersweex,stormscale,96,paladin,holy,6,1,5
12457,Rehtu,malganis,96,paladin,holy,6,1,5
12458,Playprist,aegwynn,96,paladin,holy,6,1,5
12459,Mybadvibes,tarren-mill,96,paladin,holy,6,1,5
12460,Демига,ashenvale,96,paladin,holy,6,1,5
12461,Bubblebun,kazzak,96,paladin,holy,6,1,5
12462,Agorasieya,frostwolf,96,paladin,holy,6,1,5
12463,Wingcomander,aegwynn,96,paladin,holy,6,1,5
12464,Colpadeltank,kazzak,96,paladin,holy,6,1,5
12465,Penth,doomhammer,96,paladin,holy,6,1,5
12466,Fükdîscláss,ravencrest,96,paladin,holy,6,1,5
12467,Bubbleheart,ahnqiraj,96,paladin,holy,6,1,5
12468,Minirempart,khaz-modan,96,paladin,holy,6,1,5
12469,Whiskeypal,draenor,96,paladin,holy,6,1,5
12470,Shiøn,zuljin,96,paladin,holy,6,1,5
12471,Iamyellow,silvermoon,96,paladin,holy,6,1,5
12472,Zerafic,sylvanas,96,paladin,holy,6,1,5
12473,Acongojante,zuljin,96,paladin,holy,6,1,5
12474,Shanik,zuljin,96,paladin,holy,6,1,5
12475,Aggressìon,twisting-nether,96,paladin,holy,6,1,5
12476,Înphy,cthun,96,paladin,holy,6,1,5
12477,Switchflip,frostmane,96,paladin,holy,6,1,5
12478,Flashhèart,draenor,96,paladin,holy,6,1,5
12479,Andrøiz,dun-modr,96,paladin,holy,6,1,5
12480,Aienest,ragnaros,96,paladin,holy,6,1,5
12481,Lichbörnè,outland,96,paladin,holy,6,1,5
12482,Enriel,temple-noir,96,paladin,holy,6,1,5
12483,Xephiroxus,the-venture-co,96,paladin,holy,6,1,5
12484,Dedicatèd,draenor,96,paladin,holy,6,1,5
12485,Holyfalls,blackmoore,96,paladin,holy,6,1,5
12486,Jasiv,draenor,96,paladin,holy,12,1,11
12487,Hasler,drakthul,96,paladin,holy,12,1,11
12488,Lunaary,antonidas,96,paladin,holy,12,1,11
12489,Fúrion,burning-blade,96,paladin,holy,12,1,11
12490,Лейфи,howling-fjord,96,paladin,holy,12,1,11
12491,Goldenstern,blackhand,96,paladin,holy,12,1,11
12492,Callon,das-syndikat,95,paladin,holy,6,1,5
12493,Hitaki,tarren-mill,64,paladin,holy,4,1,3
12494,Holymerda,grim-batol,42,paladin,holy,8,2,6
12495,Yijania,argent-dawn,42,paladin,holy,9,2,7
12496,Stracciatell,archimonde,2177,paladin,retribution,79,64,15
12497,Cosmicstâr,kazzak,2152,paladin,retribution,101,53,48
12498,Steelsuit,argent-dawn,2132,paladin,retribution,176,98,78
12499,Ðâny,elune,2128,paladin,retribution,135,68,67
12500,Аеррис,gordunni,2106,paladin,retribution,113,57,56
12501,Bigspin,ravencrest,2099,paladin,retribution,108,59,49
12502,Miilicium,archimonde,2091,paladin,retribution,83,41,42
12503,Peiker,blackrock,2073,paladin,retribution,112,54,58
12504,Elypsia,tarren-mill,2058,paladin,retribution,104,53,51
12505,Mýstíc,ravencrest,2049,paladin,retribution,118,56,62
12506,Ufø,magtheridon,2029,paladin,retribution,78,39,39
12507,Miriokekw,archimonde,2020,paladin,retribution,96,45,51
12508,Sacredwrath,burning-legion,2017,paladin,retribution,59,30,29
12509,Аполодориан,gordunni,2012,paladin,retribution,102,56,46
12510,Drkp,blackrock,1993,paladin,retribution,49,32,17
12511,Retwar,ravencrest,1986,paladin,retribution,77,49,28
12512,Nedith,pozzo-delleternità,1985,paladin,retribution,108,57,51
12513,Sonne,tarren-mill,1985,paladin,retribution,72,36,36
12514,Нейтхигерс,howling-fjord,1974,paladin,retribution,83,43,40
12515,Xillindion,blackhand,1958,paladin,retribution,110,56,54
12516,Monkeytm,archimonde,1957,paladin,retribution,58,27,31
12517,Zerørespect,ravencrest,1954,paladin,retribution,83,39,44
12518,Ðeathron,blackmoore,1953,paladin,retribution,122,61,61
12519,Jowanno,stormscale,1945,paladin,retribution,84,43,41
12520,Синодх,eversong,1943,paladin,retribution,95,42,53
12521,Günykoloke,blackrock,1939,paladin,retribution,54,33,21
12522,Bersercute,sylvanas,1939,paladin,retribution,96,48,48
12523,Kriszi,burning-legion,1938,paladin,retribution,90,39,51
12524,Xourens,twisting-nether,1937,paladin,retribution,56,25,31
12525,Durenai,aegwynn,1925,paladin,retribution,96,46,50
12526,Mayhemx,ravencrest,1923,paladin,retribution,130,65,65
12527,Bernhoftxd,ravencrest,1923,paladin,retribution,134,60,74
12528,Nîhil,silvermoon,1920,paladin,retribution,76,34,42
12529,Harridin,ravencrest,1917,paladin,retribution,66,33,33
12530,Royki,the-maelstrom,1916,paladin,retribution,72,32,40
12531,Phix,outland,1912,paladin,retribution,123,62,61
12532,Ricexoxo,blackhand,1904,paladin,retribution,56,25,31
12533,Ctierpala,ravencrest,1903,paladin,retribution,60,30,30
12534,Nastalia,elune,1896,paladin,retribution,24,20,4
12535,Brassaren,stormscale,1890,paladin,retribution,67,36,31
12536,Pancakee,the-maelstrom,1889,paladin,retribution,66,32,34
12537,Âlßêdø,ravencrest,1888,paladin,retribution,89,38,51
12538,Толвард,gordunni,1881,paladin,retribution,25,21,4
12539,Yungboii,kazzak,1881,paladin,retribution,71,48,23
12540,Bakawolf,burning-legion,1879,paladin,retribution,66,32,34
12541,Vabz,blackrock,1867,paladin,retribution,47,23,24
12542,Дэнискарз,gordunni,1866,paladin,retribution,48,26,22
12543,Лиспорий,gordunni,1862,paladin,retribution,48,24,24
12544,Swahadon,stormscale,1862,paladin,retribution,60,29,31
12545,Martoretard,archimonde,1861,paladin,retribution,154,76,78
12546,Mezor,dun-modr,1860,paladin,retribution,66,34,32
12547,Dasar,twisting-nether,1851,paladin,retribution,72,31,41
12548,Djstompyamom,stormscale,1850,paladin,retribution,81,38,43
12549,Nein,blackhand,1848,paladin,retribution,102,47,55
12550,Dibzi,argent-dawn,1845,paladin,retribution,54,27,27
12551,Risingfi,kult-der-verdammten,1844,paladin,retribution,78,47,31
12552,Astilia,sylvanas,1843,paladin,retribution,84,43,41
12553,Hornyret,kazzak,1839,paladin,retribution,96,46,50
12554,Стьюпидбой,howling-fjord,1837,paladin,retribution,131,66,65
12555,Vadya,ravencrest,1835,paladin,retribution,53,28,25
12556,Yuber,ravencrest,1833,paladin,retribution,78,34,44
12557,Hódle,silvermoon,1831,paladin,retribution,42,29,13
12558,Melantus,eredar,1831,paladin,retribution,48,25,23
12559,Kazuroo,blackmoore,1830,paladin,retribution,48,25,23
12560,Ilòvekris,draenor,1830,paladin,retribution,183,93,90
12561,Декионзхц,howling-fjord,1830,paladin,retribution,78,29,49
12562,Hojinson,blackrock,1828,paladin,retribution,48,34,14
12563,Holzer,azshara,1826,paladin,retribution,65,35,30
12564,Tremelay,silvermoon,1825,paladin,retribution,240,122,118
12565,Eimaqt,stormscale,1825,paladin,retribution,70,33,37
12566,Gluttön,tarren-mill,1824,paladin,retribution,31,20,11
12567,Pâsla,hyjal,1824,paladin,retribution,95,48,47
12568,Denastys,nemesis,1824,paladin,retribution,60,28,32
12569,Cqt,ravencrest,1823,paladin,retribution,66,30,36
12570,Beautýbeast,ravencrest,1821,paladin,retribution,65,32,33
12571,Дюрьвючыф,razuvious,1819,paladin,retribution,143,74,69
12572,Âtlas,ragnaros,1819,paladin,retribution,48,24,24
12573,Bulkpwders,burning-legion,1818,paladin,retribution,42,20,22
12574,Taurski,sylvanas,1817,paladin,retribution,48,35,13
12575,Angryturk,ravencrest,1816,paladin,retribution,36,19,17
12576,Фемдом,blackscar,1814,paladin,retribution,48,27,21
12577,Morri,ravencrest,1814,paladin,retribution,171,83,88
12578,Сотранокинг,soulflayer,1813,paladin,retribution,30,19,11
12579,Ktk,ravencrest,1813,paladin,retribution,121,67,54
12580,Granfort,argent-dawn,1813,paladin,retribution,114,55,59
12581,Yungboihoj,twisting-nether,1813,paladin,retribution,131,63,68
12582,Rankoneretri,arathor,1812,paladin,retribution,30,19,11
12583,Doomsoom,kazzak,1810,paladin,retribution,34,26,8
12584,Коварное,borean-tundra,1810,paladin,retribution,66,36,30
12585,Syruplol,blackrock,1809,paladin,retribution,48,25,23
12586,Делимнаноль,blackscar,1809,paladin,retribution,66,34,32
12587,Vylnoa,twisting-nether,1809,paladin,retribution,67,33,34
12588,Малиновыйбох,gordunni,1808,paladin,retribution,84,50,34
12589,Zscrew,nemesis,1807,paladin,retribution,30,19,11
12590,Ðaegos,blackmoore,1807,paladin,retribution,89,39,50
12591,Matriarchxd,kazzak,1805,paladin,retribution,48,24,24
12592,Vhardan,archimonde,1805,paladin,retribution,143,71,72
12593,Магрейм,gordunni,1805,paladin,retribution,77,35,42
12594,Wingsmode,kazzak,1805,paladin,retribution,72,27,45
12595,Netharia,antonidas,1804,paladin,retribution,120,59,61
12596,Aqualisse,hyjal,1804,paladin,retribution,66,30,36
12597,Meruem,blackrock,1802,paladin,retribution,53,26,27
12598,Karadøc,archimonde,1802,paladin,retribution,90,41,49
12599,Wingsteak,draenor,1801,paladin,retribution,51,25,26
12600,Lesterqt,thrall,1801,paladin,retribution,114,54,60
12601,Delgato,kazzak,1800,paladin,retribution,152,80,72
12602,Antou,twisting-nether,1800,paladin,retribution,159,76,83
12603,Tauskiz,sylvanas,1800,paladin,retribution,48,19,29
12604,Icekissz,hyjal,1795,paladin,retribution,24,19,5
12605,Simjon,defias-brotherhood,1788,paladin,retribution,159,91,68
12606,Ниашес,howling-fjord,1788,paladin,retribution,65,29,36
12607,Holysiah,kazzak,1782,paladin,retribution,42,19,23
12608,Arígato,argent-dawn,1780,paladin,retribution,143,79,64
12609,Skyrose,ravencrest,1778,paladin,retribution,90,51,39
12610,Zion,runetotem,1777,paladin,retribution,36,21,15
12611,Halevia,kazzak,1776,paladin,retribution,41,24,17
12612,Мрч,howling-fjord,1775,paladin,retribution,42,21,21
12613,Rekktadin,grim-batol,1775,paladin,retribution,83,41,42
12614,Vankwok,stormscale,1771,paladin,retribution,33,20,13
12615,Thyrec,thrall,1765,paladin,retribution,48,27,21
12616,Sofhiya,silvermoon,1759,paladin,retribution,42,24,18
12617,Блэканус,blackscar,1759,paladin,retribution,54,25,29
12618,Опгоп,gordunni,1758,paladin,retribution,89,45,44
12619,Tanny,kazzak,1758,paladin,retribution,66,29,37
12620,Kinvqt,tarren-mill,1756,paladin,retribution,52,26,26
12621,Игры,gordunni,1755,paladin,retribution,59,28,31
12622,Bigdblaster,twisting-nether,1752,paladin,retribution,48,23,25
12623,Охоху,gordunni,1751,paladin,retribution,83,47,36
12624,Данхайк,gordunni,1750,paladin,retribution,114,68,46
12625,Réaxon,archimonde,1749,paladin,retribution,63,27,36
12626,Alphaladin,stormscale,1744,paladin,retribution,42,23,19
12627,Pætter,aggra-português,1743,paladin,retribution,48,27,21
12628,Thedarksteel,ravencrest,1742,paladin,retribution,60,28,32
12629,Мегопалл,blackscar,1738,paladin,retribution,90,38,52
12630,Selina,burning-legion,1737,paladin,retribution,71,36,35
12631,Rígel,silvermoon,1736,paladin,retribution,28,19,9
12632,Legodudex,ravencrest,1736,paladin,retribution,48,25,23
12633,Qarak,argent-dawn,1732,paladin,retribution,65,30,35
12634,Zazalamel,hyjal,1731,paladin,retribution,48,28,20
12635,Nikkibenzqt,blackmoore,1730,paladin,retribution,66,26,40
12636,Пинкпуссибой,howling-fjord,1729,paladin,retribution,50,29,21
12637,Bregowine,doomhammer,1726,paladin,retribution,137,81,56
12638,Mordar,ravencrest,1726,paladin,retribution,49,25,24
12639,Tadashì,aegwynn,1726,paladin,retribution,60,25,35
12640,Freshreroll,tarren-mill,1723,paladin,retribution,36,24,12
12641,Salti,magtheridon,1723,paladin,retribution,136,75,61
12642,Ruath,xavius,1721,paladin,retribution,90,46,44
12643,Xeaa,tarren-mill,1718,paladin,retribution,42,18,24
12644,Zubxp,ravencrest,1713,paladin,retribution,48,24,24
12645,Prex,dun-modr,1712,paladin,retribution,54,25,29
12646,Dannyvye,outland,1712,paladin,retribution,48,21,27
12647,Msharix,kazzak,1711,paladin,retribution,36,21,15
12648,Paakz,stormscale,1708,paladin,retribution,102,55,47
12649,Deadholland,ravencrest,1706,paladin,retribution,52,29,23
12650,Чупаа,howling-fjord,1704,paladin,retribution,42,26,16
12651,Foreskinx,draenor,1704,paladin,retribution,30,18,12
12652,Justyowx,archimonde,1704,paladin,retribution,36,18,18
12653,Pestomp,tarren-mill,1704,paladin,retribution,53,24,29
12654,Модрит,soulflayer,1703,paladin,retribution,41,26,15
12655,Nutqtgodx,archimonde,1702,paladin,retribution,36,21,15
12656,Mhehø,hyjal,1702,paladin,retribution,132,62,70
12657,Dudjaw,stormscale,1702,paladin,retribution,42,18,24
12658,Rli,twisting-nether,1698,paladin,retribution,59,31,28
12659,Tsorig,tarren-mill,1697,paladin,retribution,132,72,60
12660,Tazken,tarren-mill,1697,paladin,retribution,54,25,29
12661,Rullatôrsven,stormscale,1697,paladin,retribution,48,18,30
12662,Surian,kazzak,1693,paladin,retribution,48,28,20
12663,Warmâchiine,burning-legion,1692,paladin,retribution,48,29,19
12664,Eysn,blackrock,1689,paladin,retribution,42,20,22
12665,Kêkbûrâgol,kazzak,1688,paladin,retribution,30,20,10
12666,Bigbuffdaddy,draenor,1687,paladin,retribution,166,82,84
12667,Зондарк,booty-bay,1687,paladin,retribution,59,24,35
12668,Losër,ravencrest,1687,paladin,retribution,54,20,34
12669,Zachäus,kirin-tor,1683,paladin,retribution,48,22,26
12670,Dréamypie,silvermoon,1681,paladin,retribution,47,18,29
12671,Анофарин,gordunni,1680,paladin,retribution,49,18,31
12672,Мяумяухх,soulflayer,1678,paladin,retribution,63,40,23
12673,Аскеттх,gordunni,1678,paladin,retribution,48,27,21
12674,Katanaclówn,eredar,1677,paladin,retribution,54,30,24
12675,Fullsendbro,ravencrest,1676,paladin,retribution,30,20,10
12676,Staticdeath,ravencrest,1676,paladin,retribution,78,42,36
12677,Gùtz,xavius,1676,paladin,retribution,51,23,28
12678,Кавайнекс,azuregos,1675,paladin,retribution,68,35,33
12679,Misako,sanguino,1669,paladin,retribution,90,45,45
12680,Littlelíght,silvermoon,1666,paladin,retribution,36,22,14
12681,Singlemomdtf,argent-dawn,1665,paladin,retribution,54,24,30
12682,Стимулин,howling-fjord,1662,paladin,retribution,42,22,20
12683,Pruntadin,silvermoon,1661,paladin,retribution,78,36,42
12684,Trølled,aegwynn,1660,paladin,retribution,60,25,35
12685,Milkyavenger,sylvanas,1659,paladin,retribution,53,35,18
12686,Номос,soulflayer,1659,paladin,retribution,42,23,19
12687,Smirk,aggra-português,1659,paladin,retribution,48,22,26
12688,Ярослэйв,howling-fjord,1658,paladin,retribution,45,21,24
12689,Vanthael,chamber-of-aspects,1654,paladin,retribution,138,76,62
12690,Сводимиаое,soulflayer,1654,paladin,retribution,45,22,23
12691,Сёмаигрок,soulflayer,1654,paladin,retribution,54,26,28
12692,Akrobatka,sanguino,1654,paladin,retribution,54,23,31
12693,Íbossít,doomhammer,1652,paladin,retribution,66,36,30
12694,Солошафл,howling-fjord,1652,paladin,retribution,36,19,17
12695,Xila,blackrock,1652,paladin,retribution,60,24,36
12696,Gaalarr,burning-legion,1650,paladin,retribution,36,20,16
12697,Baxuz,draenor,1648,paladin,retribution,42,22,20
12698,Spegepølse,silvermoon,1647,paladin,retribution,74,42,32
12699,Ðenlox,destromath,1647,paladin,retribution,54,23,31
12700,Wakke,outland,1646,paladin,retribution,32,23,9
12701,Bjornulfr,ravencrest,1643,paladin,retribution,101,42,59
12702,Powerpuffret,antonidas,1640,paladin,retribution,72,40,32
12703,Valkûn,rexxar,1638,paladin,retribution,48,21,27
12704,Afhvahj,tichondrius,1635,paladin,retribution,52,29,23
12705,Breakdøwñ,blackrock,1634,paladin,retribution,148,63,85
12706,Ønlyfâns,dragonblight,1633,paladin,retribution,54,23,31
12707,Draizor,twisting-nether,1631,paladin,retribution,89,42,47
12708,Shmndr,kazzak,1630,paladin,retribution,30,18,12
12709,Lightsaint,kazzak,1630,paladin,retribution,48,26,22
12710,Sübôvîñ,ravencrest,1629,paladin,retribution,44,26,18
12711,Bobiwan,ravencrest,1629,paladin,retribution,30,17,13
12712,Krîstal,aegwynn,1629,paladin,retribution,41,20,21
12713,Gilet,argent-dawn,1628,paladin,retribution,30,18,12
12714,Wyllian,grim-batol,1628,paladin,retribution,48,23,25
12715,Zarrex,blackrock,1628,paladin,retribution,42,20,22
12716,Фэйсрол,gordunni,1628,paladin,retribution,59,21,38
12717,Отловщик,gordunni,1627,paladin,retribution,36,17,19
12718,Атикинс,gordunni,1626,paladin,retribution,60,28,32
12719,Cauze,ravencrest,1624,paladin,retribution,66,38,28
12720,Lisma,bloodfeather,1623,paladin,retribution,47,26,21
12721,Shinøaa,wrathbringer,1620,paladin,retribution,30,17,13
12722,Mâterîa,antonidas,1619,paladin,retribution,48,27,21
12723,Charmxx,stormscale,1618,paladin,retribution,30,18,12
12724,Lonesolo,sylvanas,1618,paladin,retribution,36,20,16
12725,Liendry,antonidas,1618,paladin,retribution,41,19,22
12726,Ças,quelthalas,1618,paladin,retribution,42,17,25
12727,Hýox,malganis,1617,paladin,retribution,37,18,19
12728,Azlaya,sargeras,1617,paladin,retribution,54,25,29
12729,Утипутя,goldrinn,1616,paladin,retribution,30,17,13
12730,Nizzlee,eredar,1616,paladin,retribution,36,20,16
12731,Holyblast,archimonde,1615,paladin,retribution,42,22,20
12732,Malianterø,ravencrest,1615,paladin,retribution,40,19,21
12733,Kayøz,aegwynn,1613,paladin,retribution,60,30,30
12734,Leoxander,outland,1613,paladin,retribution,42,21,21
12735,Nanisunda,thrall,1613,paladin,retribution,132,63,69
12736,Батллграунт,soulflayer,1612,paladin,retribution,85,56,29
12737,Valhella,stormscale,1611,paladin,retribution,111,57,54
12738,Murkyxd,sanguino,1611,paladin,retribution,42,17,25
12739,Discølove,blackmoore,1610,paladin,retribution,43,21,22
12740,Snødunkern,outland,1609,paladin,retribution,96,41,55
12741,Асканиэль,howling-fjord,1608,paladin,retribution,60,25,35
12742,Biggboii,twisting-nether,1608,paladin,retribution,48,19,29
12743,Mcret,ravencrest,1607,paladin,retribution,46,19,27
12744,Akoumb,twisting-nether,1606,paladin,retribution,42,20,22
12745,Frankostyle,sanguino,1606,paladin,retribution,47,22,25
12746,Fisslol,kazzak,1606,paladin,retribution,60,28,32
12747,Кронкс,howling-fjord,1604,paladin,retribution,141,73,68
12748,Анастэриан,thermaplugg,1604,paladin,retribution,48,24,24
12749,Hargreeve,ravencrest,1602,paladin,retribution,48,24,24
12750,Saabnaab,outland,1600,paladin,retribution,96,59,37
12751,Skippadin,ravencrest,1600,paladin,retribution,59,30,29
12752,Wootschi,arthas,1595,paladin,retribution,35,19,16
12753,Русэльф,howling-fjord,1593,paladin,retribution,59,32,27
12754,Tyri,silvermoon,1590,paladin,retribution,66,32,34
12755,Djcrusade,twisting-nether,1588,paladin,retribution,104,58,46
12756,Телканапалке,blackscar,1587,paladin,retribution,30,21,9
12757,Altundrdel,ravencrest,1587,paladin,retribution,48,25,23
12758,Johannx,tarren-mill,1587,paladin,retribution,80,32,48
12759,Meìster,blackmoore,1586,paladin,retribution,48,20,28
12760,Batteldin,blackmoore,1584,paladin,retribution,101,61,40
12761,Джамбит,howling-fjord,1584,paladin,retribution,42,22,20
12762,Malthred,ravenholdt,1583,paladin,retribution,47,22,25
12763,Glàdiator,outland,1583,paladin,retribution,41,18,23
12764,Дезоиль,gordunni,1582,paladin,retribution,42,19,23
12765,Holyshet,blackrock,1581,paladin,retribution,32,18,14
12766,Ämÿcüs,zuljin,1581,paladin,retribution,66,37,29
12767,Knigh,draenor,1578,paladin,retribution,66,35,31
12768,Hammarfall,ravencrest,1578,paladin,retribution,63,31,32
12769,Uliko,twisting-nether,1577,paladin,retribution,48,26,22
12770,Blówout,tarren-mill,1575,paladin,retribution,30,19,11
12771,Emostylex,draenor,1575,paladin,retribution,77,27,50
12772,Râoh,arathi,1570,paladin,retribution,36,20,16
12773,Screws,dun-modr,1570,paladin,retribution,42,18,24
12774,Kaileena,archimonde,1569,paladin,retribution,36,19,17
12775,Isora,twisting-nether,1569,paladin,retribution,42,18,24
12776,Биоразлагаем,gordunni,1568,paladin,retribution,78,41,37
12777,Мистеравадон,gordunni,1568,paladin,retribution,48,19,29
12778,Auriuss,defias-brotherhood,1567,paladin,retribution,30,20,10
12779,Lightbrîng,hyjal,1564,paladin,retribution,60,28,32
12780,Kathí,kazzak,1563,paladin,retribution,24,18,6
12781,Trixzie,blackhand,1563,paladin,retribution,36,18,18
12782,Rugila,ragnaros,1562,paladin,retribution,51,33,18
12783,Jiraaqi,silvermoon,1562,paladin,retribution,53,27,26
12784,Раффаэло,borean-tundra,1562,paladin,retribution,60,28,32
12785,Lyraestra,hyjal,1562,paladin,retribution,54,20,34
12786,Opsyoudie,kazzak,1561,paladin,retribution,51,21,30
12787,Термотравка,grom,1558,paladin,retribution,108,51,57
12788,Аилерия,howling-fjord,1555,paladin,retribution,112,62,50
12789,Theodór,antonidas,1555,paladin,retribution,59,24,35
12790,Kaleyra,argent-dawn,1555,paladin,retribution,42,17,25
12791,Kènpachî,blackrock,1554,paladin,retribution,36,19,17
12792,Ùthér,sylvanas,1554,paladin,retribution,43,22,21
12793,Taiso,alonsus,1552,paladin,retribution,59,30,29
12794,Sántouryu,ravencrest,1552,paladin,retribution,122,54,68
12795,Кузькинамать,greymane,1552,paladin,retribution,84,34,50
12796,Azûl,archimonde,1547,paladin,retribution,60,30,30
12797,Gulinborsti,aegwynn,1544,paladin,retribution,42,29,13
12798,Maybach,onyxia,1543,paladin,retribution,66,31,35
12799,Ertheus,argent-dawn,1542,paladin,retribution,42,17,25
12800,Starworkal,ragnaros,1541,paladin,retribution,30,17,13
12801,Zeldalòl,outland,1541,paladin,retribution,59,25,34
12802,Бэйгреон,gordunni,1540,paladin,retribution,92,52,40
12803,Karyouka,archimonde,1538,paladin,retribution,48,27,21
12804,Tóxicpaladín,kazzak,1537,paladin,retribution,39,20,19
12805,Dabeefchief,outland,1535,paladin,retribution,22,17,5
12806,Daybreak,kazzak,1535,paladin,retribution,33,17,16
12807,Naneno,silvermoon,1535,paladin,retribution,40,18,22
12808,Jorhall,antonidas,1531,paladin,retribution,97,51,46
12809,Palior,sylvanas,1530,paladin,retribution,30,16,14
12810,Tharizod,nagrand,1530,paladin,retribution,68,34,34
12811,Sitekx,burning-legion,1530,paladin,retribution,45,17,28
12812,Tyrael,darksorrow,1529,paladin,retribution,140,66,74
12813,Malemanlad,silvermoon,1528,paladin,retribution,66,37,29
12814,Ришардебюр,soulflayer,1528,paladin,retribution,71,34,37
12815,Elrandil,kazzak,1528,paladin,retribution,72,33,39
12816,Xawier,ghostlands,1524,paladin,retribution,54,28,26
12817,Unschúld,blackrock,1523,paladin,retribution,73,40,33
12818,Drakingsang,blackhand,1522,paladin,retribution,36,16,20
12819,Guccishock,twisting-nether,1520,paladin,retribution,36,21,15
12820,Tazkaz,archimonde,1520,paladin,retribution,30,17,13
12821,Créo,draenor,1520,paladin,retribution,36,17,19
12822,Campo,tarren-mill,1519,paladin,retribution,48,20,28
12823,Таптыгин,gordunni,1518,paladin,retribution,36,16,20
12824,Rapwnzel,sylvanas,1515,paladin,retribution,60,30,30
12825,Paellysuir,blackmoore,1515,paladin,retribution,66,31,35
12826,Волатбай,gordunni,1513,paladin,retribution,48,29,19
12827,Jøøs,sargeras,1513,paladin,retribution,63,38,25
12828,Røck,aggra-português,1512,paladin,retribution,47,27,20
12829,Mélli,eredar,1512,paladin,retribution,45,25,20
12830,Snibsxpala,silvermoon,1512,paladin,retribution,36,19,17
12831,Деленка,gordunni,1511,paladin,retribution,24,16,8
12832,Runhexi,silvermoon,1511,paladin,retribution,48,23,25
12833,Impaross,shattrath,1509,paladin,retribution,159,87,72
12834,Threathor,outland,1509,paladin,retribution,81,41,40
12835,Саймум,blackscar,1509,paladin,retribution,45,19,26
12836,Kaitlyne,tarren-mill,1508,paladin,retribution,77,35,42
12837,Hys,stormscale,1505,paladin,retribution,36,19,17
12838,Qïkarï,antonidas,1504,paladin,retribution,37,21,16
12839,Nergigante,drekthar,1503,paladin,retribution,36,16,20
12840,Osïrïs,kazzak,1502,paladin,retribution,35,17,18
12841,Doomgape,alakir,1502,paladin,retribution,48,18,30
12842,Wuzzle,azshara,1499,paladin,retribution,24,16,8
12843,Jathx,silvermoon,1498,paladin,retribution,62,36,26
12844,Ralphias,twisting-nether,1498,paladin,retribution,72,32,40
12845,Stelanâal,archimonde,1497,paladin,retribution,36,18,18
12846,Колсет,soulflayer,1496,paladin,retribution,37,17,20
12847,Elganwar,hyjal,1495,paladin,retribution,42,24,18
12848,Zwergicus,alexstrasza,1494,paladin,retribution,41,17,24
12849,Aethelwold,ragnaros,1494,paladin,retribution,84,29,55
12850,Argonak,sanguino,1493,paladin,retribution,24,17,7
12851,Ajkulaa,kazzak,1493,paladin,retribution,38,17,21
12852,Ben,ghostlands,1492,paladin,retribution,24,16,8
12853,Honorkill,silvermoon,1492,paladin,retribution,109,58,51
12854,Testør,ragnaros,1489,paladin,retribution,41,16,25
12855,Sonarix,blackrock,1488,paladin,retribution,51,26,25
12856,Менетиил,galakrond,1488,paladin,retribution,52,17,35
12857,Baldivar,silvermoon,1484,paladin,retribution,66,38,28
12858,Luhae,archimonde,1483,paladin,retribution,60,35,25
12859,Баблспула,soulflayer,1483,paladin,retribution,54,26,28
12860,Catar,arathor,1482,paladin,retribution,157,87,70
12861,Тюрр,lich-king,1480,paladin,retribution,43,21,22
12862,Shockashy,stormscale,1480,paladin,retribution,38,18,20
12863,Истенен,blackscar,1479,paladin,retribution,78,32,46
12864,Àræs,archimonde,1479,paladin,retribution,42,17,25
12865,Mystixd,talnivarr,1477,paladin,retribution,24,18,6
12866,Ветрум,gordunni,1477,paladin,retribution,30,17,13
12867,Ârev,antonidas,1477,paladin,retribution,35,19,16
12868,Shröömïë,silvermoon,1477,paladin,retribution,111,56,55
12869,Shtaladin,sylvanas,1472,paladin,retribution,53,24,29
12870,Alithyra,earthen-ring,1464,paladin,retribution,43,22,21
12871,Io,frostwolf,1464,paladin,retribution,72,28,44
12872,Ceccil,dun-modr,1462,paladin,retribution,30,19,11
12873,Kayllan,ravencrest,1462,paladin,retribution,29,16,13
12874,Jac,nemesis,1462,paladin,retribution,78,37,41
12875,Argentø,ravencrest,1461,paladin,retribution,59,29,30
12876,Ulrhik,nemesis,1461,paladin,retribution,45,17,28
12877,Йосяфлексер,howling-fjord,1459,paladin,retribution,42,22,20
12878,Ysell,sargeras,1458,paladin,retribution,38,18,20
12879,Grobididi,malygos,1457,paladin,retribution,42,22,20
12880,Palwig,tarren-mill,1455,paladin,retribution,72,33,39
12881,Elinmogz,kazzak,1454,paladin,retribution,26,16,10
12882,Синфуледи,gordunni,1454,paladin,retribution,48,17,31
12883,Владыкасвета,borean-tundra,1452,paladin,retribution,54,26,28
12884,Oldsqlmofu,blackrock,1448,paladin,retribution,36,17,19
12885,Bloodaxjr,archimonde,1446,paladin,retribution,38,20,18
12886,Mattiesko,kazzak,1446,paladin,retribution,113,57,56
12887,Sieghard,aegwynn,1446,paladin,retribution,42,19,23
12888,Valarians,nemesis,1443,paladin,retribution,30,16,14
12889,Olivaresx,ravencrest,1443,paladin,retribution,48,17,31
12890,Lawtõn,argent-dawn,1442,paladin,retribution,90,44,46
12891,Nothonnest,archimonde,1440,paladin,retribution,34,23,11
12892,Ibnkrook,archimonde,1439,paladin,retribution,30,15,15
12893,Youmistpew,antonidas,1438,paladin,retribution,36,15,21
12894,Майлайт,gordunni,1437,paladin,retribution,42,24,18
12895,Jessrabit,tarren-mill,1437,paladin,retribution,36,15,21
12896,Exceed,blackmoore,1436,paladin,retribution,30,15,15
12897,Antimov,twisting-nether,1435,paladin,retribution,30,15,15
12898,Ahnaa,argent-dawn,1434,paladin,retribution,57,32,25
12899,Vendikor,nemesis,1433,paladin,retribution,78,32,46
12900,Ironquist,doomhammer,1432,paladin,retribution,30,15,15
12901,Merkury,sanguino,1432,paladin,retribution,36,15,21
12902,Galenhad,kazzak,1432,paladin,retribution,36,15,21
12903,Combinecka,chamber-of-aspects,1432,paladin,retribution,54,21,33
12904,Teryanna,ragnaros,1431,paladin,retribution,56,19,37
12905,Gymly,kazzak,1430,paladin,retribution,96,56,40
12906,Duckiboy,ragnaros,1429,paladin,retribution,70,42,28
12907,Xyzl,argent-dawn,1429,paladin,retribution,42,23,19
12908,Nìcky,stormscale,1427,paladin,retribution,48,15,33
12909,Сазар,gordunni,1426,paladin,retribution,51,21,30
12910,Reito,eredar,1425,paladin,retribution,30,15,15
12911,Valin,frostmane,1425,paladin,retribution,36,15,21
12912,Ðivine,stormscale,1424,paladin,retribution,48,26,22
12913,Shenwarr,twisting-nether,1423,paladin,retribution,30,15,15
12914,Джагадаптер,gordunni,1422,paladin,retribution,47,28,19
12915,Uxxer,sanguino,1421,paladin,retribution,29,17,12
12916,Flaweldin,ravencrest,1420,paladin,retribution,18,15,3
12917,Ljumá,kazzak,1420,paladin,retribution,51,23,28
12918,Jackub,draenor,1419,paladin,retribution,38,22,16
12919,Modeladin,ragnaros,1418,paladin,retribution,36,15,21
12920,Zanreti,outland,1417,paladin,retribution,82,41,41
12921,Offa,draenor,1416,paladin,retribution,48,23,25
12922,Codindio,silvermoon,1415,paladin,retribution,48,21,27
12923,Carlash,draenor,1414,paladin,retribution,24,15,9
12924,Dvouklik,burning-blade,1413,paladin,retribution,41,24,17
12925,Arfeniel,stormscale,1413,paladin,retribution,60,22,38
12926,Günselsen,antonidas,1409,paladin,retribution,96,49,47
12927,Angelcore,tarren-mill,1408,paladin,retribution,48,23,25
12928,Holyblast,shattered-hand,1407,paladin,retribution,30,23,7
12929,Блейзерфайт,eversong,1407,paladin,retribution,36,17,19
12930,Splasher,grim-batol,1405,paladin,retribution,30,15,15
12931,Maltazar,arygos,1404,paladin,retribution,24,15,9
12932,Sickbolt,eredar,1404,paladin,retribution,54,30,24
12933,Hagën,minahonda,1404,paladin,retribution,47,26,21
12934,Briman,neptulon,1403,paladin,retribution,24,15,9
12935,Crazzylight,kazzak,1403,paladin,retribution,74,35,39
12936,Loscar,silvermoon,1402,paladin,retribution,30,15,15
12937,Zélix,bronzebeard,1401,paladin,retribution,36,18,18
12938,Hàsbulla,khaz-modan,1400,paladin,retribution,36,19,17
12939,Astragore,archimonde,1400,paladin,retribution,41,15,26
12940,Joniopala,stormreaver,1399,paladin,retribution,35,15,20
12941,Thazyru,frostmane,1395,paladin,retribution,24,16,8
12942,Белкоксю,booty-bay,1395,paladin,retribution,48,22,26
12943,Дракула,howling-fjord,1393,paladin,retribution,36,15,21
12944,Dantrag,eredar,1391,paladin,retribution,42,15,27
12945,Aasimar,twilights-hammer,1390,paladin,retribution,88,47,41
12946,Артреал,blackscar,1387,paladin,retribution,18,15,3
12947,Gashqx,hyjal,1386,paladin,retribution,27,18,9
12948,Рэгнволд,deathguard,1385,paladin,retribution,40,20,20
12949,Rudî,sanguino,1384,paladin,retribution,34,25,9
12950,Izolated,aegwynn,1383,paladin,retribution,60,24,36
12951,Vlodthar,uldum,1378,paladin,retribution,24,15,9
12952,Vorsip,tarren-mill,1378,paladin,retribution,30,15,15
12953,Walladin,stormscale,1375,paladin,retribution,75,36,39
12954,Morniarn,argent-dawn,1374,paladin,retribution,54,29,25
12955,Telredor,rexxar,1372,paladin,retribution,42,15,27
12956,Teho,dragonblight,1370,paladin,retribution,63,33,30
12957,Zipoohun,arathor,1369,paladin,retribution,65,36,29
12958,Viiri,burning-legion,1368,paladin,retribution,53,33,20
12959,Goldhand,vashj,1368,paladin,retribution,66,31,35
12960,Джибути,soulflayer,1368,paladin,retribution,77,35,42
12961,Násty,twisting-nether,1368,paladin,retribution,90,40,50
12962,Svetijuju,kazzak,1367,paladin,retribution,60,29,31
12963,Bloodsworn,stormrage,1365,paladin,retribution,36,22,14
12964,Âlßêdø,silvermoon,1360,paladin,retribution,48,25,23
12965,Aegend,antonidas,1360,paladin,retribution,157,76,81
12966,Эзарх,gordunni,1359,paladin,retribution,58,29,29
12967,Unohana,shattered-halls,1358,paladin,retribution,72,27,45
12968,Гучив,howling-fjord,1354,paladin,retribution,48,27,21
12969,Apolomaeuz,blackhand,1354,paladin,retribution,36,20,16
12970,Ashent,stormscale,1353,paladin,retribution,42,19,23
12971,Борссалино,gordunni,1352,paladin,retribution,77,35,42
12972,Taiiki,archimonde,1349,paladin,retribution,36,22,14
12973,Илюшагодх,gordunni,1349,paladin,retribution,48,26,22
12974,Koami,blackmoore,1348,paladin,retribution,30,15,15
12975,Mimsy,dalaran,1348,paladin,retribution,35,15,20
12976,Kreyvin,argent-dawn,1348,paladin,retribution,47,20,27
12977,Кветирон,soulflayer,1348,paladin,retribution,48,17,31
12978,Vatix,trollbane,1344,paladin,retribution,24,14,10
12979,Inkzen,silvermoon,1343,paladin,retribution,24,14,10
12980,Мевар,gordunni,1343,paladin,retribution,30,14,16
12981,Retdead,nordrassil,1342,paladin,retribution,30,14,16
12982,Рикшак,howling-fjord,1342,paladin,retribution,30,14,16
12983,Ослепителен,eversong,1342,paladin,retribution,36,14,22
12984,Davewins,dragonblight,1341,paladin,retribution,18,14,4
12985,Geneundreitt,dethecus,1341,paladin,retribution,30,14,16
12986,Chocbear,tarren-mill,1341,paladin,retribution,30,14,16
12987,Blekadin,ragnaros,1340,paladin,retribution,32,15,17
12988,Kaizêr,silvermoon,1339,paladin,retribution,42,20,22
12989,Витурус,howling-fjord,1339,paladin,retribution,42,14,28
12990,Dainan,blackmoore,1338,paladin,retribution,30,14,16
12991,Mustach,aggra-português,1337,paladin,retribution,41,20,21
12992,Aisnil,twilights-hammer,1337,paladin,retribution,47,21,26
12993,Proletardk,draenor,1336,paladin,retribution,102,51,51
12994,Xciepo,rexxar,1336,paladin,retribution,36,14,22
12995,Варблэйз,gordunni,1335,paladin,retribution,24,14,10
12996,Cowwithspell,stormscale,1335,paladin,retribution,30,14,16
12997,Мэибибэиби,howling-fjord,1335,paladin,retribution,36,14,22
12998,Angelisho,zuljin,1335,paladin,retribution,36,14,22
12999,Хилерскийхил,soulflayer,1332,paladin,retribution,32,14,18
13000,Yrgin,ravencrest,1330,paladin,retribution,60,32,28
13001,Миоцуки,gordunni,1330,paladin,retribution,34,16,18
13002,Гневнебес,howling-fjord,1330,paladin,retribution,36,14,22
13003,Кливерти,gordunni,1325,paladin,retribution,36,14,22
13004,Хеллкик,howling-fjord,1325,paladin,retribution,37,14,23
13005,Grimstark,argent-dawn,1324,paladin,retribution,24,14,10
13006,Enriel,temple-noir,1324,paladin,retribution,30,16,14
13007,Æthëlflæd,ravencrest,1320,paladin,retribution,27,20,7
13008,Rothmans,aggra-português,1319,paladin,retribution,36,20,16
13009,Lawlight,frostmane,1315,paladin,retribution,30,14,16
13010,Holylimx,draenor,1314,paladin,retribution,96,48,48
13011,Sparrda,dun-modr,1314,paladin,retribution,48,24,24
13012,Foxare,burning-legion,1312,paladin,retribution,53,29,24
13013,Джекадамс,gordunni,1311,paladin,retribution,139,49,90
13014,Мизиола,galakrond,1310,paladin,retribution,60,30,30
13015,Uwelist,arathor,1306,paladin,retribution,43,17,26
13016,Беймикс,gordunni,1303,paladin,retribution,72,36,36
13017,Mendril,malorne,1302,paladin,retribution,24,17,7
13018,Booyaahh,ravencrest,1301,paladin,retribution,36,17,19
13019,Elení,thrall,1296,paladin,retribution,37,15,22
13020,Ретриванлав,gordunni,1296,paladin,retribution,72,24,48
13021,Хиккудоджер,eversong,1295,paladin,retribution,60,31,29
13022,Veckra,kazzak,1295,paladin,retribution,30,14,16
13023,Nardindindou,ysondre,1292,paladin,retribution,86,44,42
13024,Orseis,anubarak,1291,paladin,retribution,29,15,14
13025,Mantinel,hellfire,1290,paladin,retribution,32,20,12
13026,Deloréane,archimonde,1285,paladin,retribution,27,14,13
13027,Vvaarok,blackmoore,1285,paladin,retribution,57,22,35
13028,Angrykorean,blackmoore,1284,paladin,retribution,59,28,31
13029,Faithsmemory,silvermoon,1284,paladin,retribution,41,15,26
13030,Darhuun,antonidas,1281,paladin,retribution,93,43,50
13031,Vickdicator,stormscale,1281,paladin,retribution,34,15,19
13032,Dieversity,stormscale,1280,paladin,retribution,41,16,25
13033,Freyjä,turalyon,1279,paladin,retribution,30,15,15
13034,Синерина,blackscar,1278,paladin,retribution,35,15,20
13035,Ïdø,hyjal,1277,paladin,retribution,40,16,24
13036,Hammexõr,sylvanas,1271,paladin,retribution,87,39,48
13037,Эльбабло,lich-king,1268,paladin,retribution,45,21,24
13038,Перизкопец,gordunni,1267,paladin,retribution,30,16,14
13039,Hydarr,twisting-nether,1262,paladin,retribution,35,18,17
13040,Owiganowi,ulduar,1260,paladin,retribution,30,19,11
13041,Aikm,tarren-mill,1260,paladin,retribution,56,26,30
13042,Блэквилл,howling-fjord,1256,paladin,retribution,60,26,34
13043,Elitest,hyjal,1256,paladin,retribution,43,14,29
13044,Tønyx,les-clairvoyants,1253,paladin,retribution,32,14,18
13045,Hollylady,outland,1251,paladin,retribution,30,19,11
13046,Lightppl,outland,1249,paladin,retribution,36,19,17
13047,Bigducc,draenor,1248,paladin,retribution,24,13,11
13048,Кошкотяночка,ashenvale,1248,paladin,retribution,30,13,17
13049,Lübu,archimonde,1248,paladin,retribution,30,13,17
13050,Wickedret,kazzak,1247,paladin,retribution,18,13,5
13051,Ревирант,gordunni,1247,paladin,retribution,24,13,11
13052,Ërzã,outland,1247,paladin,retribution,30,13,17
13053,Тардариус,gordunni,1247,paladin,retribution,30,13,17
13054,Lorex,grim-batol,1247,paladin,retribution,30,13,17
13055,Paladiodinos,hyjal,1247,paladin,retribution,42,16,26
13056,Saintseiya,pozzo-delleternità,1246,paladin,retribution,18,13,5
13057,Spacknas,blackmoore,1246,paladin,retribution,18,13,5
13058,Korendil,frostmane,1246,paladin,retribution,24,13,11
13059,Mistérion,archimonde,1246,paladin,retribution,30,13,17
13060,Gromzed,ravencrest,1245,paladin,retribution,30,13,17
13061,Réfractio,die-aldor,1245,paladin,retribution,30,13,17
13062,Hito,sylvanas,1245,paladin,retribution,30,13,17
13063,Bezúziusz,ragnaros,1244,paladin,retribution,36,16,20
13064,Sukinsin,aegwynn,1244,paladin,retribution,30,13,17
13065,Raoun,archimonde,1242,paladin,retribution,30,13,17
13066,Endar,drakthul,1242,paladin,retribution,36,14,22
13067,Shroomez,frostmane,1240,paladin,retribution,24,13,11
13068,Zaaen,burning-legion,1240,paladin,retribution,24,13,11
13069,Æe,blackmoore,1236,paladin,retribution,37,22,15
13070,Teliriyon,blackrock,1236,paladin,retribution,32,14,18
13071,Lewp,tarren-mill,1234,paladin,retribution,18,13,5
13072,Anatorka,drakthul,1234,paladin,retribution,78,39,39
13073,Aurroraa,doomhammer,1233,paladin,retribution,27,14,13
13074,Yaoiri,argent-dawn,1232,paladin,retribution,18,13,5
13075,Unkillablee,stormscale,1231,paladin,retribution,28,14,14
13076,Edyk,silvermoon,1229,paladin,retribution,65,37,28
13077,Wumbo,sinstralis,1229,paladin,retribution,36,19,17
13078,Наваляка,deathguard,1228,paladin,retribution,24,13,11
13079,Flawx,blackmoore,1228,paladin,retribution,24,13,11
13080,Painshield,outland,1228,paladin,retribution,35,13,22
13081,Enveador,garrosh,1227,paladin,retribution,25,13,12
13082,Вандиир,soulflayer,1226,paladin,retribution,24,13,11
13083,Trisunonvaki,khazgoroth,1226,paladin,retribution,41,16,25
13084,Velkar,frostmane,1221,paladin,retribution,50,26,24
13085,Windsor,argent-dawn,1221,paladin,retribution,30,13,17
13086,Юлец,galakrond,1220,paladin,retribution,30,13,17
13087,Ylvannka,blackmoore,1219,paladin,retribution,36,18,18
13088,Nomurabeta,naxxramas,1219,paladin,retribution,30,13,17
13089,Zeyz,defias-brotherhood,1217,paladin,retribution,24,13,11
13090,Ragnarük,khaz-modan,1217,paladin,retribution,42,20,22
13091,Beastyblodne,sylvanas,1215,paladin,retribution,30,17,13
13092,Moodý,ragnaros,1214,paladin,retribution,51,19,32
13093,Hornox,ragnaros,1211,paladin,retribution,42,19,23
13094,Keith,dragonmaw,1210,paladin,retribution,30,14,16
13095,Хен,blackscar,1209,paladin,retribution,32,15,17
13096,Альфазеро,howling-fjord,1208,paladin,retribution,28,13,15
13097,Hemdâl,kirin-tor,1207,paladin,retribution,24,13,11
13098,Kýrp,stormreaver,1207,paladin,retribution,43,16,27
13099,Snottybrat,draenor,1205,paladin,retribution,54,29,25
13100,Светлыйкит,blackscar,1204,paladin,retribution,48,25,23
13101,Forneus,nemesis,1204,paladin,retribution,34,16,18
13102,Цвандр,gordunni,1201,paladin,retribution,46,20,26
13103,Лейфи,howling-fjord,1199,paladin,retribution,36,15,21
13104,Calaestra,twisting-nether,1193,paladin,retribution,21,15,6
13105,Whiffy,silvermoon,1193,paladin,retribution,36,13,23
13106,Helmed,tarren-mill,1190,paladin,retribution,39,21,18
13107,Hïto,dun-modr,1189,paladin,retribution,24,14,10
13108,Ункаль,ashenvale,1186,paladin,retribution,78,35,43
13109,Fredas,hyjal,1185,paladin,retribution,30,13,17
13110,Retrystyle,ragnaros,1182,paladin,retribution,35,18,17
13111,Perfectum,burning-legion,1182,paladin,retribution,28,13,15
13112,Irinor,rashgarroth,1181,paladin,retribution,30,14,16
13113,Steakenstein,nathrezim,1181,paladin,retribution,30,14,16
13114,Runkpaladin,kazzak,1180,paladin,retribution,36,23,13
13115,Raweo,kilrogg,1178,paladin,retribution,36,24,12
13116,Cigyal,hyjal,1178,paladin,retribution,42,23,19
13117,Mystíque,die-todeskrallen,1177,paladin,retribution,48,27,21
13118,Truezero,draenor,1176,paladin,retribution,30,14,16
13119,Dinøx,archimonde,1171,paladin,retribution,74,33,41
13120,Khrotos,draenor,1166,paladin,retribution,66,30,36
13121,Palagray,blackmoore,1166,paladin,retribution,36,16,20
13122,Zemoss,kazzak,1164,paladin,retribution,24,14,10
13123,Vrgingamer,kazzak,1158,paladin,retribution,48,16,32
13124,Rileys,turalyon,1156,paladin,retribution,36,15,21
13125,Franclovis,hyjal,1152,paladin,retribution,29,12,17
13126,Sessian,bronze-dragonflight,1151,paladin,retribution,30,19,11
13127,Vorthir,khaz-modan,1151,paladin,retribution,32,16,16
13128,Lipsvirgin,kazzak,1151,paladin,retribution,24,12,12
13129,Fordragon,twisting-nether,1151,paladin,retribution,30,12,18
13130,Оззмо,howling-fjord,1150,paladin,retribution,18,12,6
13131,Gigasack,ravencrest,1150,paladin,retribution,18,12,6
13132,Brabop,zirkel-des-cenarius,1150,paladin,retribution,18,12,6
13133,Ruotollo,ravencrest,1150,paladin,retribution,24,12,12
13134,Hirako,nemesis,1150,paladin,retribution,24,12,12
13135,Torvik,eredar,1150,paladin,retribution,24,12,12
13136,Dominikcro,sylvanas,1149,paladin,retribution,24,12,12
13137,Muhnnin,archimonde,1149,paladin,retribution,30,12,18
13138,Tinyandy,blackrock,1149,paladin,retribution,30,12,18
13139,Прожектор,gordunni,1149,paladin,retribution,30,12,18
13140,Swàyz,archimonde,1149,paladin,retribution,36,12,24
13141,Ædrenn,archimonde,1148,paladin,retribution,36,12,24
13142,Búbbles,nerathor,1147,paladin,retribution,18,12,6
13143,Crusshqt,silvermoon,1147,paladin,retribution,24,12,12
13144,Paradoax,quelthalas,1147,paladin,retribution,24,12,12
13145,Холихит,gordunni,1147,paladin,retribution,30,12,18
13146,Daoht,ysondre,1146,paladin,retribution,24,12,12
13147,Иродиада,gordunni,1146,paladin,retribution,24,12,12
13148,Algoric,suramar,1146,paladin,retribution,24,12,12
13149,Хельдотер,howling-fjord,1146,paladin,retribution,25,12,13
13150,Kreselia,ravencrest,1146,paladin,retribution,30,12,18
13151,Palitard,turalyon,1145,paladin,retribution,36,20,16
13152,Kollak,dun-modr,1144,paladin,retribution,42,18,24
13153,Росиель,soulflayer,1144,paladin,retribution,30,12,18
13154,Асшура,howling-fjord,1143,paladin,retribution,24,12,12
13155,Bigdamjudge,argent-dawn,1142,paladin,retribution,18,12,6
13156,Rayshield,tarren-mill,1142,paladin,retribution,47,23,24
13157,Eywinn,silvermoon,1141,paladin,retribution,30,12,18
13158,Dijkie,boulderfist,1139,paladin,retribution,30,12,18
13159,Zandorath,argent-dawn,1135,paladin,retribution,36,12,24
13160,Holybubo,tarren-mill,1133,paladin,retribution,60,30,30
13161,Диваин,gordunni,1133,paladin,retribution,24,12,12
13162,Лютыйчпок,fordragon,1133,paladin,retribution,49,18,31
13163,Pytha,nozdormu,1132,paladin,retribution,49,25,24
13164,Juliea,aegwynn,1132,paladin,retribution,36,14,22
13165,Questos,burning-legion,1130,paladin,retribution,45,25,20
13166,Cästiël,arathor,1130,paladin,retribution,29,13,16
13167,Yunax,silvermoon,1127,paladin,retribution,18,12,6
13168,Nelasson,eredar,1126,paladin,retribution,26,13,13
13169,Deathzinger,aszune,1126,paladin,retribution,24,12,12
13170,Самерваль,borean-tundra,1122,paladin,retribution,18,12,6
13171,Burstyléz,silvermoon,1121,paladin,retribution,24,12,12
13172,Buckfizz,ysondre,1115,paladin,retribution,18,13,5
13173,Judgement,quelthalas,1114,paladin,retribution,24,16,8
13174,Teogrim,blackmoore,1114,paladin,retribution,24,13,11
13175,Лусейд,howling-fjord,1112,paladin,retribution,23,13,10
13176,Troj,ahnqiraj,1112,paladin,retribution,30,14,16
13177,Мистерху,gordunni,1111,paladin,retribution,73,34,39
13178,Ghostfacê,khaz-modan,1105,paladin,retribution,36,17,19
13179,Shädyss,hyjal,1105,paladin,retribution,76,34,42
13180,Mataleo,archimonde,1104,paladin,retribution,22,14,8
13181,Rilledread,stormscale,1103,paladin,retribution,48,20,28
13182,Leyawin,sanguino,1099,paladin,retribution,30,15,15
13183,Kaljir,archimonde,1098,paladin,retribution,21,13,8
13184,Sylazz,blackrock,1094,paladin,retribution,97,43,54
13185,Lavawraith,argent-dawn,1086,paladin,retribution,22,12,10
13186,Valgar,ragnaros,1081,paladin,retribution,17,12,5
13187,Obé,argent-dawn,1080,paladin,retribution,78,40,38
13188,Sandorr,area-52,1079,paladin,retribution,30,17,13
13189,Böb,garona,1078,paladin,retribution,36,14,22
13190,Sunsaiy,doomhammer,1074,paladin,retribution,48,26,22
13191,Mosih,bloodfeather,1061,paladin,retribution,38,21,17
13192,Lytza,frostwolf,1059,paladin,retribution,30,15,15
13193,Soossi,silvermoon,1056,paladin,retribution,18,11,7
13194,Jedzy,ragnaros,1056,paladin,retribution,18,11,7
13195,Carlá,silvermoon,1056,paladin,retribution,25,13,12
13196,Pia,twisting-nether,1056,paladin,retribution,24,11,13
13197,Dalemiar,ravencrest,1056,paladin,retribution,24,11,13
13198,Zayaka,ragnaros,1056,paladin,retribution,30,11,19
13199,Havefunzqt,archimonde,1055,paladin,retribution,12,11,1
13200,Retaxx,outland,1055,paladin,retribution,18,11,7
13201,Mirøku,silvermoon,1055,paladin,retribution,18,11,7
13202,Bürd,rajaxx,1055,paladin,retribution,24,11,13
13203,Stukker,silvermoon,1055,paladin,retribution,24,11,13
13204,Kalimgor,theradras,1055,paladin,retribution,24,11,13
13205,Okcså,ragnaros,1055,paladin,retribution,28,12,16
13206,Wingsuit,eredar,1055,paladin,retribution,26,11,15
13207,Relius,outland,1055,paladin,retribution,30,11,19
13208,Zialo,ravencrest,1055,paladin,retribution,36,11,25
13209,Ilikejudge,blackmoore,1055,paladin,retribution,36,11,25
13210,Highfivè,ravencrest,1054,paladin,retribution,18,11,7
13211,Addwyr,blackrock,1054,paladin,retribution,18,11,7
13212,Myridan,bloodhoof,1054,paladin,retribution,18,11,7
13213,Báldür,silvermoon,1054,paladin,retribution,18,11,7
13214,Bloodyret,outland,1054,paladin,retribution,18,11,7
13215,Sinthoràs,shattered-hand,1054,paladin,retribution,36,20,16
13216,Blademàster,twisting-nether,1054,paladin,retribution,22,12,10
13217,Jout,tarren-mill,1054,paladin,retribution,24,11,13
13218,Pallidino,antonidas,1054,paladin,retribution,24,11,13
13219,Phalex,outland,1054,paladin,retribution,30,11,19
13220,Sünlight,nemesis,1054,paladin,retribution,30,11,19
13221,Nillenkäse,antonidas,1053,paladin,retribution,18,11,7
13222,Vleisboom,ravencrest,1053,paladin,retribution,18,11,7
13223,Deceneü,kazzak,1053,paladin,retribution,24,11,13
13224,Хаспадин,gordunni,1053,paladin,retribution,24,11,13
13225,Boomboomciao,draenor,1052,paladin,retribution,12,11,1
13226,Racduck,dunemaul,1052,paladin,retribution,30,11,19
13227,Alard,sanguino,1052,paladin,retribution,30,11,19
13228,Ayàhuazka,ysondre,1051,paladin,retribution,24,11,13
13229,Johnßlake,dun-modr,1051,paladin,retribution,24,11,13
13230,Llaynn,argent-dawn,1051,paladin,retribution,36,11,25
13231,Рипкарт,gordunni,1050,paladin,retribution,18,11,7
13232,Balthassar,kirin-tor,1050,paladin,retribution,24,11,13
13233,Lagaminë,dalaran,1050,paladin,retribution,63,23,40
13234,Auditõr,argent-dawn,1050,paladin,retribution,36,11,25
13235,Nevermoore,doomhammer,1047,paladin,retribution,24,11,13
13236,Kealen,nemesis,1046,paladin,retribution,54,20,34
13237,Kaelron,sanguino,1044,paladin,retribution,18,11,7
13238,Traqnbilkarq,stormscale,1044,paladin,retribution,24,12,12
13239,Fumaça,dun-modr,1043,paladin,retribution,18,11,7
13240,Darnero,blackrock,1043,paladin,retribution,18,11,7
13241,Paillasson,nerzhul,1043,paladin,retribution,28,15,13
13242,Dildotbagins,argent-dawn,1041,paladin,retribution,47,29,18
13243,Línke,sanguino,1040,paladin,retribution,25,12,13
13244,Gazïel,kaelthas,1040,paladin,retribution,30,11,19
13245,Lightmonger,drakthul,1038,paladin,retribution,18,11,7
13246,Хоулишит,blackscar,1037,paladin,retribution,18,11,7
13247,Nomeel,twisting-nether,1037,paladin,retribution,85,47,38
13248,Saró,ravencrest,1035,paladin,retribution,22,12,10
13249,Jagen,tyrande,1035,paladin,retribution,24,11,13
13250,Fëanôr,tarren-mill,1033,paladin,retribution,182,91,91
13251,Lliissaa,kazzak,1027,paladin,retribution,36,21,15
13252,Арморих,gordunni,1024,paladin,retribution,22,11,11
13253,Hateless,tarren-mill,1024,paladin,retribution,28,11,17
13254,Молотоборец,gordunni,1019,paladin,retribution,24,11,13
13255,Gerannan,kirin-tor,1018,paladin,retribution,30,14,16
13256,Krïstâlùlz,archimonde,1014,paladin,retribution,34,15,19
13257,Quasimotto,turalyon,1014,paladin,retribution,36,13,23
13258,Paladie,dalaran,1013,paladin,retribution,141,72,69
13259,Crynó,blackmoore,1010,paladin,retribution,30,13,17
13260,Aégon,archimonde,1010,paladin,retribution,36,13,23
13261,Kipperb,kazzak,1007,paladin,retribution,23,11,12
13262,Renaseh,twisting-nether,1007,paladin,retribution,23,11,12
13263,Beyma,twisting-nether,1006,paladin,retribution,17,11,6
13264,Bryllks,die-todeskrallen,1006,paladin,retribution,30,19,11
13265,Snaty,khaz-modan,1004,paladin,retribution,47,25,22
13266,Ilovemylay,area-52,1004,paladin,retribution,21,11,10
13267,Ollebala,ravencrest,1002,paladin,retribution,23,11,12
13268,Эксвайп,howling-fjord,997,paladin,retribution,23,11,12
13269,Crazypits,silvermoon,993,paladin,retribution,36,14,22
13270,Âchîle,garona,991,paladin,retribution,43,23,20
13271,Tríbunus,blackmoore,970,paladin,retribution,19,11,8
13272,Killtauren,kazzak,966,paladin,retribution,54,23,31
13273,Raerk,dalaran,962,paladin,retribution,25,11,14
13274,Eltruite,archimonde,962,paladin,retribution,60,25,35
13275,Retbùll,stormscale,960,paladin,retribution,12,10,2
13276,Weekly,outland,960,paladin,retribution,18,10,8
13277,Blazerlolz,kazzak,960,paladin,retribution,18,10,8
13278,Exolis,archimonde,960,paladin,retribution,18,10,8
13279,Daveboss,dragonblight,960,paladin,retribution,24,10,14
13280,ßlacklight,archimonde,960,paladin,retribution,24,10,14
13281,Ганка,blackscar,960,paladin,retribution,30,10,20
13282,Screâm,eredar,960,paladin,retribution,30,10,20
13283,Pallyprinces,dentarg,960,paladin,retribution,30,10,20
13284,Trenvendor,ravencrest,959,paladin,retribution,16,11,5
13285,Khadet,draenor,959,paladin,retribution,18,10,8
13286,Apokalipsnik,drakthul,959,paladin,retribution,18,10,8
13287,Яправ,borean-tundra,959,paladin,retribution,18,10,8
13288,Bunurata,silvermoon,959,paladin,retribution,18,10,8
13289,Gangb,ravencrest,959,paladin,retribution,18,10,8
13290,Makakí,twisting-nether,959,paladin,retribution,18,10,8
13291,Беспощадие,gordunni,959,paladin,retribution,18,10,8
13292,Lonesoul,tarren-mill,959,paladin,retribution,18,10,8
13293,Хексали,soulflayer,959,paladin,retribution,21,11,10
13294,Plarbo,blackmoore,959,paladin,retribution,24,10,14
13295,Razrpal,tarren-mill,959,paladin,retribution,24,10,14
13296,Рамзеса,soulflayer,959,paladin,retribution,24,10,14
13297,Нижмубабл,soulflayer,959,paladin,retribution,27,11,16
13298,Lightlogic,ravencrest,959,paladin,retribution,30,10,20
13299,Arcardi,dun-morogh,958,paladin,retribution,18,10,8
13300,Béhèlit,sargeras,958,paladin,retribution,18,10,8
13301,Rhyvar,outland,958,paladin,retribution,24,10,14
13302,Hydrath,ysondre,958,paladin,retribution,24,10,14
13303,Mashijudge,blackhand,957,paladin,retribution,12,10,2
13304,Pyrogon,malorne,957,paladin,retribution,73,35,38
13305,Immortalkrux,archimonde,957,paladin,retribution,53,18,35
13306,Syracx,blackhand,956,paladin,retribution,24,10,14
13307,Holypurger,shattered-hand,955,paladin,retribution,25,10,15
13308,Duragon,khaz-modan,954,paladin,retribution,21,12,9
13309,Aisolôn,thrall,954,paladin,retribution,18,10,8
13310,Kyríé,tarren-mill,953,paladin,retribution,18,10,8
13311,Nözderg,archimonde,951,paladin,retribution,24,10,14
13312,Dafe,zuluhed,950,paladin,retribution,33,13,20
13313,Barakisback,silvermoon,949,paladin,retribution,18,10,8
13314,Xemoth,kazzak,947,paladin,retribution,18,10,8
13315,Buddabob,antonidas,946,paladin,retribution,56,12,44
13316,Ziggyz,kul-tiras,945,paladin,retribution,19,10,9
13317,Valpen,veknilash,943,paladin,retribution,24,10,14
13318,Shorella,malganis,941,paladin,retribution,18,10,8
13319,Diøstemplar,dun-modr,941,paladin,retribution,18,10,8
13320,Vexxus,blackrock,937,paladin,retribution,24,12,12
13321,Plato,arthas,933,paladin,retribution,18,10,8
13322,Lifepower,nemesis,927,paladin,retribution,16,10,6
13323,Justrhino,kazzak,927,paladin,retribution,23,10,13
13324,Caladys,silvermoon,926,paladin,retribution,23,10,13
13325,Patzi,die-todeskrallen,925,paladin,retribution,48,23,25
13326,Coelslaw,azjolnerub,915,paladin,retribution,29,10,19
13327,Liliong,draenor,910,paladin,retribution,18,10,8
13328,Rulîx,blackmoore,904,paladin,retribution,39,11,28
13329,Lumino,twilights-hammer,901,paladin,retribution,23,10,13
13330,Vuzetevacabo,doomhammer,899,paladin,retribution,54,24,30
13331,Gurutze,ragnaros,896,paladin,retribution,16,10,6
13332,Pârabellum,the-maelstrom,896,paladin,retribution,28,10,18
13333,Лакоста,ashenvale,894,paladin,retribution,26,10,16
13334,Tánk,twilights-hammer,888,paladin,retribution,48,22,26
13335,Pepsimaxpvp,blackmoore,880,paladin,retribution,25,10,15
13336,Baé,drakthul,878,paladin,retribution,25,10,15
13337,Holysnickers,tarren-mill,864,paladin,retribution,12,9,3
13338,Terrozina,stormscale,864,paladin,retribution,12,9,3
13339,Атмх,soulflayer,864,paladin,retribution,12,9,3
13340,Kilô,sylvanas,864,paladin,retribution,18,9,9
13341,Justivo,tarren-mill,864,paladin,retribution,18,9,9
13342,Menephannt,outland,864,paladin,retribution,18,9,9
13343,Pesterci,draenor,864,paladin,retribution,18,9,9
13344,Loratheon,stormscale,864,paladin,retribution,18,9,9
13345,Мэднессх,howling-fjord,864,paladin,retribution,18,9,9
13346,Dreamwatcher,outland,864,paladin,retribution,18,9,9
13347,Djcurry,archimonde,864,paladin,retribution,18,9,9
13348,Ассайоу,soulflayer,864,paladin,retribution,18,9,9
13349,Supergallows,shattered-hand,864,paladin,retribution,18,9,9
13350,Djandja,blackrock,864,paladin,retribution,18,9,9
13351,Cùpìdstunt,draenor,864,paladin,retribution,18,9,9
13352,Hølypwnjk,forscherliga,864,paladin,retribution,18,9,9
13353,Kaarsius,defias-brotherhood,864,paladin,retribution,18,9,9
13354,Lecutus,sunstrider,864,paladin,retribution,22,10,12
13355,Thoriz,elune,864,paladin,retribution,24,9,15
13356,Holymerda,grim-batol,864,paladin,retribution,24,9,15
13357,Socx,outland,864,paladin,retribution,24,9,15
13358,Kæycc,blackmoore,864,paladin,retribution,24,9,15
13359,Elisabeth,kazzak,864,paladin,retribution,24,9,15
13360,Лакостик,howling-fjord,864,paladin,retribution,24,9,15
13361,Блэкхарм,gordunni,864,paladin,retribution,24,9,15
13362,Umirinbruv,zenedar,864,paladin,retribution,30,9,21
13363,Nakedholy,draenor,863,paladin,retribution,12,9,3
13364,Инфернох,howling-fjord,863,paladin,retribution,18,9,9
13365,Nordkreuz,aegwynn,863,paladin,retribution,18,9,9
13366,Trollilolz,eredar,863,paladin,retribution,18,9,9
13367,Durnell,sylvanas,863,paladin,retribution,18,9,9
13368,Sildrit,draenor,863,paladin,retribution,18,9,9
13369,Vitacé,burning-legion,863,paladin,retribution,18,9,9
13370,Arayël,archimonde,863,paladin,retribution,18,9,9
13371,Fujszi,arathor,863,paladin,retribution,18,9,9
13372,Retenki,silvermoon,863,paladin,retribution,24,9,15
13373,Каштоуны,soulflayer,863,paladin,retribution,24,9,15
13374,Данбро,borean-tundra,863,paladin,retribution,24,9,15
13375,Deriøt,dun-modr,863,paladin,retribution,24,9,15
13376,Obsidyen,outland,863,paladin,retribution,26,9,17
13377,Hornybìlly,stormscale,863,paladin,retribution,30,9,21
13378,Primle,thrall,862,paladin,retribution,12,9,3
13379,Димасгачи,gordunni,862,paladin,retribution,12,9,3
13380,Blatrix,kazzak,862,paladin,retribution,12,9,3
13381,Lìmier,ysondre,862,paladin,retribution,18,9,9
13382,Darkenorr,silvermoon,862,paladin,retribution,18,9,9
13383,Роллита,gordunni,862,paladin,retribution,24,9,15
13384,Маркант,gordunni,861,paladin,retribution,18,9,9
13385,Portgas,hyjal,861,paladin,retribution,24,9,15
13386,Bootybanger,thrall,860,paladin,retribution,18,9,9
13387,Radamanthes,ysondre,860,paladin,retribution,18,9,9
13388,Vaníos,nazjatar,860,paladin,retribution,18,9,9
13389,Proxidus,blackmoore,859,paladin,retribution,24,9,15
13390,Jêzus,blackrock,858,paladin,retribution,12,9,3
13391,Thëone,exodar,858,paladin,retribution,16,10,6
13392,Durwin,mazrigos,855,paladin,retribution,24,9,15
13393,Injustice,chamber-of-aspects,847,paladin,retribution,19,9,10
13394,Rafflesia,sanguino,847,paladin,retribution,29,9,20
13395,Ocgynle,alonsus,844,paladin,retribution,18,9,9
13396,Dôrä,ysondre,830,paladin,retribution,23,9,14
13397,Jebenatreba,sporeggar,827,paladin,retribution,23,9,14
13398,Pàlàthor,khaz-modan,826,paladin,retribution,18,9,9
13399,Sunfather,twilights-hammer,820,paladin,retribution,18,9,9
13400,Монбиин,soulflayer,810,paladin,retribution,18,10,8
13401,Ararion,tarren-mill,809,paladin,retribution,18,10,8
13402,Zerohour,kilrogg,799,paladin,retribution,28,9,19
13403,Helvirya,defias-brotherhood,787,paladin,retribution,83,35,48
13404,Fleshoflight,arathor,779,paladin,retribution,22,10,12
13405,Ÿani,argent-dawn,768,paladin,retribution,12,8,4
13406,Siuras,blackmoore,768,paladin,retribution,12,8,4
13407,Mitsoû,archimonde,768,paladin,retribution,12,8,4
13408,Flaapz,hyjal,768,paladin,retribution,12,8,4
13409,Needel,argent-dawn,768,paladin,retribution,12,8,4
13410,Sigmud,turalyon,768,paladin,retribution,12,8,4
13411,Zeggayodax,nemesis,768,paladin,retribution,12,8,4
13412,Vindicatê,stormscale,768,paladin,retribution,12,8,4
13413,Clessington,die-aldor,768,paladin,retribution,12,8,4
13414,Дохлаяженах,gordunni,768,paladin,retribution,12,8,4
13415,Erasdin,silvermoon,768,paladin,retribution,12,8,4
13416,Eléndrên,blackrock,768,paladin,retribution,12,8,4
13417,Lazaraat,antonidas,768,paladin,retribution,12,8,4
13418,Hülä,antonidas,768,paladin,retribution,12,8,4
13419,Pakór,blackrock,768,paladin,retribution,12,8,4
13420,Holyinstinct,bronze-dragonflight,768,paladin,retribution,18,8,10
13421,Irenita,kazzak,768,paladin,retribution,18,8,10
13422,Мидэас,gordunni,768,paladin,retribution,18,8,10
13423,Чемеряк,gordunni,768,paladin,retribution,18,8,10
13424,Thaddios,burning-blade,768,paladin,retribution,18,8,10
13425,Roostersucka,stormreaver,768,paladin,retribution,18,8,10
13426,Нормвал,gordunni,768,paladin,retribution,18,8,10
13427,Hislifelmao,kazzak,768,paladin,retribution,18,8,10
13428,Baxxster,blackhand,768,paladin,retribution,18,8,10
13429,Dankin,pozzo-delleternità,768,paladin,retribution,18,8,10
13430,Tcret,sanguino,768,paladin,retribution,18,8,10
13431,Rb,twisting-nether,768,paladin,retribution,18,8,10
13432,Tyristrum,kilrogg,768,paladin,retribution,18,8,10
13433,Iiwar,silvermoon,768,paladin,retribution,18,8,10
13434,Tjabo,burning-blade,768,paladin,retribution,24,8,16
13435,Nabbi,ravencrest,768,paladin,retribution,24,8,16
13436,Powerphally,outland,768,paladin,retribution,24,8,16
13437,Chyve,tarren-mill,768,paladin,retribution,24,8,16
13438,ßancu,ragnaros,768,paladin,retribution,30,8,22
13439,Toxií,argent-dawn,768,paladin,retribution,30,8,22
13440,Spinzr,draenor,767,paladin,retribution,12,8,4
13441,Dawnnslayer,kazzak,767,paladin,retribution,12,8,4
13442,Hutimeni,turalyon,767,paladin,retribution,12,8,4
13443,Seraphyonhd,blackmoore,767,paladin,retribution,12,8,4
13444,Nfxx,argent-dawn,767,paladin,retribution,12,8,4
13445,Akâshi,dalaran,767,paladin,retribution,12,8,4
13446,Baxteria,dun-modr,767,paladin,retribution,18,8,10
13447,Xersys,draenor,767,paladin,retribution,18,8,10
13448,Mooses,stormscale,767,paladin,retribution,18,8,10
13449,Hôrrible,ravencrest,767,paladin,retribution,18,8,10
13450,Ruftadin,ragnaros,767,paladin,retribution,18,8,10
13451,Aleixodolphi,argent-dawn,767,paladin,retribution,30,10,20
13452,Puré,festung-der-stürme,767,paladin,retribution,24,8,16
13453,Krustenkaese,kelthuzad,766,paladin,retribution,12,8,4
13454,Ryozupala,frostwolf,766,paladin,retribution,12,8,4
13455,Laugan,ysondre,766,paladin,retribution,12,8,4
13456,Fremuduin,argent-dawn,766,paladin,retribution,12,8,4
13457,Grapaladin,sanguino,766,paladin,retribution,18,8,10
13458,Hogan,blackmoore,766,paladin,retribution,18,8,10
13459,Evililz,kazzak,766,paladin,retribution,18,8,10
13460,Террорх,blackscar,766,paladin,retribution,30,8,22
13461,Raê,hyjal,765,paladin,retribution,18,8,10
13462,Mikipaki,tarren-mill,765,paladin,retribution,18,8,10
13463,Killa,stormrage,764,paladin,retribution,18,8,10
13464,Andocay,das-syndikat,764,paladin,retribution,24,8,16
13465,Wingedguard,ragnaros,763,paladin,retribution,12,8,4
13466,Torczy,frostwhisper,760,paladin,retribution,12,8,4
13467,Tripani,twisting-nether,760,paladin,retribution,18,8,10
13468,Goungokuhrbo,doomhammer,755,paladin,retribution,12,8,4
13469,Thorold,earthen-ring,755,paladin,retribution,22,10,12
13470,Ericafontës,kazzak,751,paladin,retribution,17,8,9
13471,Nazaninez,tarren-mill,749,paladin,retribution,18,8,10
13472,Klikas,twisting-nether,746,paladin,retribution,18,8,10
13473,Grayparser,silvermoon,735,paladin,retribution,14,9,5
13474,Lynaé,blackhand,735,paladin,retribution,13,8,5
13475,Craaw,archimonde,735,paladin,retribution,23,8,15
13476,Guckzu,malganis,733,paladin,retribution,19,8,11
13477,Hella,dunemaul,717,paladin,retribution,17,8,9
13478,Darkironpala,argent-dawn,717,paladin,retribution,21,8,13
13479,Byths,blackmoore,714,paladin,retribution,26,9,17
13480,Äthénâ,archimonde,713,paladin,retribution,23,9,14
13481,Драгун,gordunni,707,paladin,retribution,25,9,16
13482,Aelthir,kazzak,703,paladin,retribution,11,8,3
13483,Nexzz,outland,703,paladin,retribution,11,8,3
13484,Zerad,quelthalas,702,paladin,retribution,44,8,36
13485,Gradepal,drakthul,687,paladin,retribution,19,8,11
13486,Thebestpala,tarren-mill,686,paladin,retribution,19,8,11
13487,Vircy,outland,672,paladin,retribution,12,7,5
13488,Gimly,anachronos,672,paladin,retribution,12,7,5
13489,Миллиционер,razuvious,672,paladin,retribution,12,7,5
13490,Шоринг,gordunni,672,paladin,retribution,12,7,5
13491,Dideta,colinas-pardas,672,paladin,retribution,12,7,5
13492,Bubblor,ravencrest,672,paladin,retribution,12,7,5
13493,Ilpreside,nemesis,672,paladin,retribution,12,7,5
13494,Lazone,ysondre,672,paladin,retribution,12,7,5
13495,Sunwalker,bronzebeard,672,paladin,retribution,12,7,5
13496,Shjami,rexxar,672,paladin,retribution,12,7,5
13497,Dälaghetto,kilrogg,672,paladin,retribution,12,7,5
13498,Miriem,twisting-nether,672,paladin,retribution,12,7,5
13499,Promise,dun-modr,672,paladin,retribution,12,7,5
13500,Anatollia,silvermoon,672,paladin,retribution,12,7,5
13501,Pïkachû,ravencrest,672,paladin,retribution,12,7,5
13502,Даракар,deathguard,672,paladin,retribution,12,7,5
13503,Sletlana,burning-blade,672,paladin,retribution,12,7,5
13504,Akaasix,stormscale,672,paladin,retribution,12,7,5
13505,Fatherabdul,ravencrest,672,paladin,retribution,12,7,5
13506,Neverdeath,stormscale,672,paladin,retribution,12,7,5
13507,Лиривель,howling-fjord,672,paladin,retribution,12,7,5
13508,Vhalkur,dun-modr,672,paladin,retribution,12,7,5
13509,Hammertime,guldan,672,paladin,retribution,12,7,5
13510,Archibäld,silvermoon,672,paladin,retribution,12,7,5
13511,Ellünca,ravencrest,672,paladin,retribution,12,7,5
13512,Arshiaa,ravencrest,672,paladin,retribution,15,8,7
13513,Auryel,nemesis,672,paladin,retribution,18,7,11
13514,Lysander,antonidas,672,paladin,retribution,18,7,11
13515,Vodax,argent-dawn,672,paladin,retribution,18,7,11
13516,Ritaora,aggramar,672,paladin,retribution,18,7,11
13517,Dinønuggets,ravencrest,672,paladin,retribution,18,7,11
13518,Мериатас,soulflayer,672,paladin,retribution,18,7,11
13519,Apocalypsé,twisting-nether,672,paladin,retribution,18,7,11
13520,Романтик,deathweaver,672,paladin,retribution,18,7,11
13521,Tezmodian,antonidas,672,paladin,retribution,18,7,11
13522,Scairtin,ravencrest,672,paladin,retribution,18,7,11
13523,Galadrion,dun-modr,672,paladin,retribution,18,7,11
13524,Jíyü,blackmoore,672,paladin,retribution,18,7,11
13525,Ivarladin,draenor,672,paladin,retribution,18,7,11
13526,Bíceron,sanguino,672,paladin,retribution,18,7,11
13527,Nyxbane,kazzak,672,paladin,retribution,18,7,11
13528,Bubbledøtcøm,blackmoore,672,paladin,retribution,18,7,11
13529,Norganpala,die-aldor,672,paladin,retribution,18,7,11
13530,Arbuzno,draenor,672,paladin,retribution,18,7,11
13531,Lílou,blackmoore,672,paladin,retribution,18,7,11
13532,Lindrone,aggra-português,672,paladin,retribution,18,7,11
13533,Pìnkyy,draenor,672,paladin,retribution,18,7,11
13534,Mufuqa,ragnaros,672,paladin,retribution,18,7,11
13535,Shownómercy,stormscale,672,paladin,retribution,18,7,11
13536,Коссандра,greymane,672,paladin,retribution,23,7,16
13537,Akelad,arathor,672,paladin,retribution,24,7,17
13538,Crysania,twisting-nether,672,paladin,retribution,24,7,17
13539,Ящеры,gordunni,672,paladin,retribution,24,7,17
13540,Cianna,shattered-hand,672,paladin,retribution,28,7,21
13541,Aranael,nemesis,672,paladin,retribution,30,7,23
13542,Jooki,drakthul,671,paladin,retribution,12,7,5
13543,Uraraka,burning-blade,671,paladin,retribution,12,7,5
13544,Demsi,ravencrest,671,paladin,retribution,12,7,5
13545,Wolfpala,drakthul,671,paladin,retribution,12,7,5
13546,Samueel,blackmoore,671,paladin,retribution,12,7,5
13547,Mazekiel,archimonde,671,paladin,retribution,12,7,5
13548,Bubblefett,ysera,671,paladin,retribution,12,7,5
13549,Imreallybadx,blackrock,671,paladin,retribution,12,7,5
13550,Vâskt,dun-modr,671,paladin,retribution,12,7,5
13551,Sakred,hellscream,671,paladin,retribution,12,7,5
13552,Bajheeroth,kazzak,671,paladin,retribution,12,7,5
13553,Gbejr,xavius,671,paladin,retribution,12,7,5
13554,Retgaffeooku,conseil-des-ombres,671,paladin,retribution,12,7,5
13555,Laenira,nemesis,671,paladin,retribution,18,7,11
13556,Alvíss,sanguino,671,paladin,retribution,18,7,11
13557,Asorte,chants-éternels,671,paladin,retribution,18,7,11
13558,Спидфрик,blackscar,671,paladin,retribution,18,7,11
13559,Eken,hyjal,671,paladin,retribution,18,7,11
13560,Galevar,argent-dawn,671,paladin,retribution,18,7,11
13561,Öbedö,malganis,671,paladin,retribution,24,7,17
13562,Keol,sanguino,670,paladin,retribution,12,7,5
13563,Atrexie,lightbringer,670,paladin,retribution,12,7,5
13564,Aistor,burning-legion,670,paladin,retribution,18,7,11
13565,Kawakii,outland,669,paladin,retribution,12,7,5
13566,Ghallandre,khaz-modan,669,paladin,retribution,12,7,5
13567,Starstríder,aszune,669,paladin,retribution,12,7,5
13568,Палочка,howling-fjord,669,paladin,retribution,18,7,11
13569,Zebramann,silvermoon,669,paladin,retribution,18,7,11
13570,Rangorian,defias-brotherhood,669,paladin,retribution,24,7,17
13571,Bärghest,sanguino,668,paladin,retribution,12,7,5
13572,Фокспро,lich-king,668,paladin,retribution,18,7,11
13573,Gxdéon,hyjal,667,paladin,retribution,12,7,5
13574,Rocaviva,sanguino,666,paladin,retribution,12,7,5
13575,Messîah,outland,666,paladin,retribution,12,7,5
13576,Quoque,turalyon,664,paladin,retribution,15,8,7
13577,Chikaz,archimonde,664,paladin,retribution,20,10,10
13578,Halimox,terokkar,664,paladin,retribution,18,7,11
13579,Wolya,blackrock,663,paladin,retribution,15,8,7
13580,Mechoka,auchindoun,661,paladin,retribution,13,7,6
13581,Belzed,draenor,660,paladin,retribution,15,8,7
13582,Luxor,sporeggar,658,paladin,retribution,12,7,5
13583,Bigdamjudgee,outland,655,paladin,retribution,17,7,10
13584,Keele,stormscale,639,paladin,retribution,17,7,10
13585,Boabux,draenor,638,paladin,retribution,17,7,10
13586,Diamir,rajaxx,624,paladin,retribution,15,7,8
13587,Denounce,defias-brotherhood,624,paladin,retribution,21,7,14
13588,Rustig,talnivarr,623,paladin,retribution,11,7,4
13589,Samànta,nemesis,623,paladin,retribution,11,7,4
13590,Jaro,alleria,623,paladin,retribution,21,7,14
13591,Fufenzee,stormscale,620,paladin,retribution,17,7,10
13592,Goofyaf,ravencrest,618,paladin,retribution,16,9,7
13593,Mariaremarc,silvermoon,617,paladin,retribution,25,8,17
13594,Ressler,tichondrius,616,paladin,retribution,15,7,8
13595,Skénder,kazzak,615,paladin,retribution,35,8,27
13596,Nollieflip,tarren-mill,607,paladin,retribution,11,7,4
13597,Crohnox,nemesis,607,paladin,retribution,14,7,7
13598,Альмор,blackscar,607,paladin,retribution,20,7,13
13599,Блатш,greymane,592,paladin,retribution,25,7,18
13600,Twomog,ravencrest,576,paladin,retribution,6,6,0
13601,Lóyal,kazzak,576,paladin,retribution,6,6,0
13602,Blagori,blackhand,576,paladin,retribution,6,6,0
13603,Mawrâ,twisting-nether,576,paladin,retribution,12,6,6
13604,Диджейнобабл,howling-fjord,576,paladin,retribution,12,6,6
13605,Bloodlord,twisting-nether,576,paladin,retribution,12,6,6
13606,Clamjam,sylvanas,576,paladin,retribution,12,6,6
13607,Seekêr,tarren-mill,576,paladin,retribution,12,6,6
13608,Леаркус,blackscar,576,paladin,retribution,12,6,6
13609,Humphry,vashj,576,paladin,retribution,12,6,6
13610,Wingdude,ysera,576,paladin,retribution,12,6,6
13611,Exolix,archimonde,576,paladin,retribution,12,6,6
13612,Gabrîel,sanguino,576,paladin,retribution,12,6,6
13613,Exolie,archimonde,576,paladin,retribution,12,6,6
13614,Mekluba,twisting-nether,576,paladin,retribution,12,6,6
13615,Ryxxii,ravencrest,576,paladin,retribution,12,6,6
13616,Mouncake,archimonde,576,paladin,retribution,12,6,6
13617,Raceper,the-maelstrom,576,paladin,retribution,12,6,6
13618,Eldrial,argent-dawn,576,paladin,retribution,12,6,6
13619,Pallachyrk,kazzak,576,paladin,retribution,12,6,6
13620,Ibanez,lightnings-blade,576,paladin,retribution,12,6,6
13621,Shaylaru,tarren-mill,576,paladin,retribution,12,6,6
13622,Pappnas,aegwynn,576,paladin,retribution,12,6,6
13623,Czachadymii,defias-brotherhood,576,paladin,retribution,12,6,6
13624,Neêsoldr,blackmoore,576,paladin,retribution,12,6,6
13625,Elohim,echsenkessel,576,paladin,retribution,12,6,6
13626,Ruggero,stormscale,576,paladin,retribution,12,6,6
13627,Timal,eitrigg,576,paladin,retribution,12,6,6
13628,Elendíl,azjolnerub,576,paladin,retribution,12,6,6
13629,Luciter,silvermoon,576,paladin,retribution,12,6,6
13630,Notnerb,outland,576,paladin,retribution,12,6,6
13631,Veejxo,silvermoon,576,paladin,retribution,12,6,6
13632,Melverti,kazzak,576,paladin,retribution,12,6,6
13633,Vuutnëx,twisting-nether,576,paladin,retribution,12,6,6
13634,Retgodx,eredar,576,paladin,retribution,12,6,6
13635,Ryaz,blackrock,576,paladin,retribution,12,6,6
13636,Sölaria,silvermoon,576,paladin,retribution,12,6,6
13637,Søulréaper,stormscale,576,paladin,retribution,12,6,6
13638,Blindhoj,ravencrest,576,paladin,retribution,12,6,6
13639,Stève,ravencrest,576,paladin,retribution,12,6,6
13640,Elyrax,nemesis,576,paladin,retribution,12,6,6
13641,Askmy,stormscale,576,paladin,retribution,12,6,6
13642,Скварлетх,howling-fjord,576,paladin,retribution,12,6,6
13643,Gigajudge,ravencrest,576,paladin,retribution,12,6,6
13644,Drdax,wildhammer,576,paladin,retribution,12,6,6
13645,Palamauka,kazzak,576,paladin,retribution,12,6,6
13646,Dodgerwilly,outland,576,paladin,retribution,12,6,6
13647,Válé,silvermoon,576,paladin,retribution,12,6,6
13648,Керантий,gordunni,576,paladin,retribution,12,6,6
13649,Ridethelight,nemesis,576,paladin,retribution,12,6,6
13650,Vysavo,draenor,576,paladin,retribution,12,6,6
13651,Bloodbeard,twisting-nether,576,paladin,retribution,12,6,6
13652,Teshkipowa,kazzak,576,paladin,retribution,12,6,6
13653,Sinclo,hyjal,576,paladin,retribution,12,6,6
13654,Paliax,outland,576,paladin,retribution,12,6,6
13655,Bigdaddypump,ravencrest,576,paladin,retribution,12,6,6
13656,Deresos,anetheron,576,paladin,retribution,12,6,6
13657,Snowife,drakthul,576,paladin,retribution,12,6,6
13658,Exolia,archimonde,576,paladin,retribution,12,6,6
13659,Croptol,dun-modr,576,paladin,retribution,12,6,6
13660,Cycodin,garrosh,576,paladin,retribution,12,6,6
13661,Smirky,silvermoon,576,paladin,retribution,12,6,6
13662,Xairo,twisting-nether,576,paladin,retribution,12,6,6
13663,Feelmylight,tarren-mill,576,paladin,retribution,12,6,6
13664,Tosá,antonidas,576,paladin,retribution,18,6,12
13665,Думклиф,gordunni,576,paladin,retribution,18,6,12
13666,Thickets,argent-dawn,576,paladin,retribution,18,6,12
13667,Lolladin,blackmoore,576,paladin,retribution,18,6,12
13668,Paradoxiâ,thrall,576,paladin,retribution,18,6,12
13669,Mâêdhrøsx,ravencrest,576,paladin,retribution,18,6,12
13670,Кхабелех,howling-fjord,576,paladin,retribution,18,6,12
13671,Батллграунд,soulflayer,576,paladin,retribution,18,6,12
13672,Âtom,outland,576,paladin,retribution,18,6,12
13673,Hermmes,alakir,576,paladin,retribution,18,6,12
13674,Zuveron,the-maelstrom,576,paladin,retribution,18,6,12
13675,Генатрамбон,howling-fjord,576,paladin,retribution,18,6,12
13676,Gwynel,argent-dawn,576,paladin,retribution,18,6,12
13677,Sîlversun,grim-batol,576,paladin,retribution,18,6,12
13678,Curtwizz,silvermoon,576,paladin,retribution,18,6,12
13679,Lusugo,alakir,576,paladin,retribution,18,6,12
13680,Imaturtle,darksorrow,576,paladin,retribution,24,6,18
13681,Actionjack,area-52,576,paladin,retribution,24,6,18
13682,Sacredlol,blackmoore,576,paladin,retribution,24,6,18
13683,Huevo,frostmane,576,paladin,retribution,24,6,18
13684,Kyrokonserve,blackmoore,575,paladin,retribution,14,7,7
13685,Vaako,blackrock,575,paladin,retribution,12,6,6
13686,Antón,dun-modr,575,paladin,retribution,12,6,6
13687,Pewpews,twisting-nether,575,paladin,retribution,12,6,6
13688,Тамплиир,gordunni,575,paladin,retribution,12,6,6
13689,Ahramanyu,blackrock,575,paladin,retribution,12,6,6
13690,Kendomendo,ravencrest,575,paladin,retribution,12,6,6
13691,Phillipe,illidan,575,paladin,retribution,12,6,6
13692,Hypothalamus,silvermoon,575,paladin,retribution,12,6,6
13693,Iqso,argent-dawn,575,paladin,retribution,12,6,6
13694,Aeyalana,ragnaros,575,paladin,retribution,12,6,6
13695,Trøllørd,shattrath,575,paladin,retribution,12,6,6
13696,Faventu,ragnaros,575,paladin,retribution,12,6,6
13697,Orti,sanguino,575,paladin,retribution,18,6,12
13698,Bonzai,blackrock,575,paladin,retribution,18,6,12
13699,Edathar,argent-dawn,575,paladin,retribution,24,6,18
13700,Nykothpn,ghostlands,574,paladin,retribution,6,6,0
13701,Vondarkmoor,magtheridon,574,paladin,retribution,12,6,6
13702,Mírato,blackhand,574,paladin,retribution,12,6,6
13703,Babarush,nozdormu,574,paladin,retribution,18,6,12
13704,Humaladi,draenor,574,paladin,retribution,18,6,12
13705,Takaret,hyjal,574,paladin,retribution,24,6,18
13706,Cinderlight,aszune,573,paladin,retribution,12,6,6
13707,Cpsuper,azuremyst,573,paladin,retribution,12,6,6
13708,Nhum,destromath,572,paladin,retribution,12,6,6
13709,Boaka,outland,571,paladin,retribution,18,6,12
13710,Exiztant,ravencrest,571,paladin,retribution,18,6,12
13711,Vibeer,ravencrest,568,paladin,retribution,12,6,6
13712,Схемас,gordunni,568,paladin,retribution,18,6,12
13713,Nicgr,nemesis,566,paladin,retribution,12,6,6
13714,Raptasenda,archimonde,566,paladin,retribution,26,9,17
13715,Benkenoah,ragnaros,566,paladin,retribution,24,6,18
13716,Ràwx,twisting-nether,559,paladin,retribution,23,6,17
13717,Knygnesys,silvermoon,558,paladin,retribution,9,8,1
13718,Tavyy,sylvanas,551,paladin,retribution,15,9,6
13719,Ryüü,uldaman,537,paladin,retribution,23,6,17
13720,Pak,amanthul,527,paladin,retribution,15,7,8
13721,Тошши,soulflayer,522,paladin,retribution,28,8,20
13722,Råckamoo,emerald-dream,512,paladin,retribution,22,6,16
13723,Vell,bronze-dragonflight,511,paladin,retribution,11,6,5
13724,Budgetcara,stormscale,511,paladin,retribution,11,6,5
13725,Babypic,ambossar,511,paladin,retribution,14,6,8
13726,Vanyon,malganis,511,paladin,retribution,14,6,8
13727,Hanterus,antonidas,507,paladin,retribution,14,6,8
13728,Sabríel,ragnaros,480,paladin,retribution,6,5,1
13729,Hølypowah,tarren-mill,480,paladin,retribution,6,5,1
13730,Takálus,eredar,480,paladin,retribution,6,5,1
13731,Harlequina,argent-dawn,480,paladin,retribution,6,5,1
13732,Abukasol,kazzak,480,paladin,retribution,6,5,1
13733,Dioxius,stormscale,480,paladin,retribution,6,5,1
13734,Rqd,blackrock,480,paladin,retribution,6,5,1
13735,Ryven,stormscale,480,paladin,retribution,6,5,1
13736,Тенькопыт,howling-fjord,480,paladin,retribution,6,5,1
13737,Фэнон,gordunni,480,paladin,retribution,6,5,1
13738,Percocetx,tarren-mill,480,paladin,retribution,6,5,1
13739,Röland,sanguino,480,paladin,retribution,6,5,1
13740,Легейнда,soulflayer,480,paladin,retribution,6,5,1
13741,Bikkuz,kazzak,480,paladin,retribution,6,5,1
13742,Jacadin,sunstrider,480,paladin,retribution,6,5,1
13743,Derian,antonidas,480,paladin,retribution,6,5,1
13744,Mipendz,draenor,480,paladin,retribution,6,5,1
13745,Yezitzme,blackrock,480,paladin,retribution,6,5,1
13746,Walorez,ragnaros,480,paladin,retribution,6,5,1
13747,Voycetwo,frostwolf,480,paladin,retribution,6,5,1
13748,Xoriun,norgannon,480,paladin,retribution,6,5,1
13749,Yull,twisting-nether,480,paladin,retribution,6,5,1
13750,Milojcica,kazzak,480,paladin,retribution,6,5,1
13751,Сынбогов,gordunni,480,paladin,retribution,6,5,1
13752,Ландри,greymane,480,paladin,retribution,6,5,1
13753,Архемор,ashenvale,480,paladin,retribution,6,5,1
13754,Mma,sylvanas,480,paladin,retribution,6,5,1
13755,Xëlâ,archimonde,480,paladin,retribution,6,5,1
13756,Пивняк,eversong,480,paladin,retribution,6,5,1
13757,Melvòó,blackrock,480,paladin,retribution,9,6,3
13758,Angelynor,ysondre,480,paladin,retribution,12,5,7
13759,Froxies,drakthul,480,paladin,retribution,12,5,7
13760,Bascelik,outland,480,paladin,retribution,12,5,7
13761,Rînedaman,ysondre,480,paladin,retribution,12,5,7
13762,Hugins,chamber-of-aspects,480,paladin,retribution,12,5,7
13763,Milenia,nemesis,480,paladin,retribution,12,5,7
13764,Dêstî,silvermoon,480,paladin,retribution,12,5,7
13765,Asgardietis,kazzak,480,paladin,retribution,12,5,7
13766,Zethhx,stormscale,480,paladin,retribution,12,5,7
13767,Bornir,khaz-modan,480,paladin,retribution,12,5,7
13768,Earendìl,blackmoore,480,paladin,retribution,12,5,7
13769,Bugo,drakthul,480,paladin,retribution,12,5,7
13770,Bancu,outland,480,paladin,retribution,12,5,7
13771,Morggann,drakthul,480,paladin,retribution,12,5,7
13772,Kírin,drakthul,480,paladin,retribution,12,5,7
13773,Freedomwinds,kazzak,480,paladin,retribution,12,5,7
13774,Drylands,ravencrest,480,paladin,retribution,12,5,7
13775,Endavour,ravencrest,480,paladin,retribution,12,5,7
13776,Serjudge,kazzak,480,paladin,retribution,12,5,7
13777,Nessùm,hyjal,480,paladin,retribution,12,5,7
13778,Destroyér,blackmoore,480,paladin,retribution,12,5,7
13779,Roklim,blackhand,480,paladin,retribution,12,5,7
13780,Sytrexxer,frostwolf,480,paladin,retribution,12,5,7
13781,Paterymon,ravencrest,480,paladin,retribution,12,5,7
13782,Hazura,blackmoore,480,paladin,retribution,12,5,7
13783,Onishu,blackhand,480,paladin,retribution,12,5,7
13784,Наолина,gordunni,480,paladin,retribution,12,5,7
13785,Jkøø,sanguino,480,paladin,retribution,12,5,7
13786,Meriween,ravencrest,480,paladin,retribution,12,5,7
13787,Гниленький,razuvious,480,paladin,retribution,12,5,7
13788,Qpala,quelthalas,480,paladin,retribution,12,5,7
13789,Thun,azjolnerub,480,paladin,retribution,12,5,7
13790,Lighttitan,ravencrest,480,paladin,retribution,12,5,7
13791,Retlikeme,ravencrest,480,paladin,retribution,12,5,7
13792,Pav,eredar,480,paladin,retribution,12,5,7
13793,Héphäistos,silvermoon,480,paladin,retribution,12,5,7
13794,Torpala,burning-legion,480,paladin,retribution,12,5,7
13795,Ritoru,drekthar,480,paladin,retribution,12,5,7
13796,Bobilous,twisting-nether,480,paladin,retribution,12,5,7
13797,Ênma,archimonde,480,paladin,retribution,12,5,7
13798,Wingzy,hyjal,480,paladin,retribution,12,5,7
13799,Roflemente,bladefist,480,paladin,retribution,12,5,7
13800,Llighthand,ravencrest,480,paladin,retribution,12,5,7
13801,Dobbygotsock,kazzak,480,paladin,retribution,12,5,7
13802,Vaalé,aegwynn,480,paladin,retribution,12,5,7
13803,Агинон,gordunni,480,paladin,retribution,12,5,7
13804,Корсаро,deepholm,480,paladin,retribution,12,5,7
13805,Mecah,hyjal,480,paladin,retribution,12,5,7
13806,Naexea,archimonde,480,paladin,retribution,12,5,7
13807,Mozaiczny,burning-legion,480,paladin,retribution,12,5,7
13808,Zaopink,blackhand,480,paladin,retribution,12,5,7
13809,Jeriiret,khaz-modan,480,paladin,retribution,12,5,7
13810,Каплясвета,gordunni,480,paladin,retribution,12,5,7
13811,Equityy,burning-legion,480,paladin,retribution,12,5,7
13812,Cêa,blackrock,480,paladin,retribution,12,5,7
13813,Апония,gordunni,480,paladin,retribution,12,5,7
13814,Боремир,borean-tundra,480,paladin,retribution,12,5,7
13815,Enary,zuljin,480,paladin,retribution,12,5,7
13816,Yuvile,destromath,480,paladin,retribution,12,5,7
13817,Ophillan,draenor,480,paladin,retribution,12,5,7
13818,Kylaz,die-ewige-wacht,480,paladin,retribution,12,5,7
13819,Nalaea,arathor,480,paladin,retribution,12,5,7
13820,Скадих,soulflayer,480,paladin,retribution,12,5,7
13821,Hydrolic,blackrock,480,paladin,retribution,12,5,7
13822,Vanithar,thrall,480,paladin,retribution,12,5,7
13823,Ноулайфир,eversong,480,paladin,retribution,12,5,7
13824,Babaluga,blackrock,480,paladin,retribution,12,5,7
13825,Ретроградий,howling-fjord,480,paladin,retribution,12,5,7
13826,Алепос,soulflayer,480,paladin,retribution,18,5,13
13827,Fleckige,nethersturm,480,paladin,retribution,18,5,13
13828,Вэндрик,azuregos,480,paladin,retribution,18,5,13
13829,Strätholme,drakthul,480,paladin,retribution,18,5,13
13830,Posttal,aggra-português,480,paladin,retribution,18,5,13
13831,Xiuya,dun-modr,480,paladin,retribution,18,5,13
13832,Копранесса,soulflayer,480,paladin,retribution,18,5,13
13833,Thoreas,perenolde,480,paladin,retribution,18,5,13
13834,Juicycheeks,frostwolf,480,paladin,retribution,18,5,13
13835,Deidâra,blackhand,480,paladin,retribution,18,5,13
13836,Ramhal,stormscale,480,paladin,retribution,18,5,13
13837,Axone,ravencrest,480,paladin,retribution,18,5,13
13838,Pliscken,kazzak,480,paladin,retribution,18,5,13
13839,Exobyte,stormscale,480,paladin,retribution,24,5,19
13840,Itsgossiplol,twisting-nether,480,paladin,retribution,24,5,19
13841,Trainingdumy,aszune,479,paladin,retribution,6,5,1
13842,Zvirblis,chamber-of-aspects,479,paladin,retribution,9,6,3
13843,Майнстер,gordunni,479,paladin,retribution,12,5,7
13844,Dykopala,doomhammer,479,paladin,retribution,12,5,7
13845,Rettarded,draenor,479,paladin,retribution,12,5,7
13846,Notholy,defias-brotherhood,479,paladin,retribution,12,5,7
13847,Эллессар,howling-fjord,479,paladin,retribution,12,5,7
13848,Ðarkjøjø,hyjal,479,paladin,retribution,12,5,7
13849,Baymanda,tarren-mill,479,paladin,retribution,12,5,7
13850,Solyra,blackhand,479,paladin,retribution,12,5,7
13851,Stepamusicz,stormreaver,479,paladin,retribution,12,5,7
13852,Gropleindsup,ysondre,479,paladin,retribution,12,5,7
13853,Joelosteen,neptulon,479,paladin,retribution,12,5,7
13854,Edwards,sanguino,479,paladin,retribution,12,5,7
13855,Taffz,burning-legion,479,paladin,retribution,12,5,7
13856,Сасмен,blackscar,479,paladin,retribution,12,5,7
13857,Пропала,greymane,479,paladin,retribution,18,5,13
13858,Almohalhil,tarren-mill,478,paladin,retribution,6,5,1
13859,Mysticlight,sylvanas,478,paladin,retribution,18,8,10
13860,Purpledurple,twisting-nether,478,paladin,retribution,12,5,7
13861,Mirelaw,drakthul,478,paladin,retribution,12,5,7
13862,Четкийчервь,soulflayer,478,paladin,retribution,18,5,13
13863,Fardahr,ravencrest,476,paladin,retribution,12,5,7
13864,Zantria,alleria,476,paladin,retribution,12,5,7
13865,Morhgain,kazzak,476,paladin,retribution,18,5,13
13866,Yeohinyiu,khaz-modan,472,paladin,retribution,12,5,7
13867,Баблыч,borean-tundra,472,paladin,retribution,12,5,7
13868,Zingler,norgannon,472,paladin,retribution,12,5,7
13869,Грайндсет,galakrond,447,paladin,retribution,11,5,6
13870,Slayton,twisting-nether,447,paladin,retribution,11,5,6
13871,Гкм,howling-fjord,447,paladin,retribution,11,5,6
13872,Kevlar,frostmane,446,paladin,retribution,12,6,6
13873,Æïs,blackrock,432,paladin,retribution,9,5,4
13874,Sunnyboy,tarren-mill,431,paladin,retribution,11,5,6
13875,Dragonwingz,kazzak,431,paladin,retribution,11,5,6
13876,Îiî,archimonde,426,paladin,retribution,21,6,15
13877,Нероблр,gordunni,416,paladin,retribution,10,5,5
13878,Qshadow,frostwhisper,416,paladin,retribution,16,5,11
13879,Сильвернайт,soulflayer,400,paladin,retribution,13,5,8
13880,Panicmaker,ravencrest,384,paladin,retribution,6,4,2
13881,Dragon,zenedar,384,paladin,retribution,6,4,2
13882,Hanknpank,quelthalas,384,paladin,retribution,6,4,2
13883,Volkai,zuljin,384,paladin,retribution,6,4,2
13884,Бабичпал,soulflayer,384,paladin,retribution,6,4,2
13885,Blader,darksorrow,384,paladin,retribution,6,4,2
13886,Shevøçk,ravencrest,384,paladin,retribution,6,4,2
13887,Bâbass,sargeras,384,paladin,retribution,6,4,2
13888,Lovetospoonn,ravencrest,384,paladin,retribution,6,4,2
13889,Bcrp,ragnaros,384,paladin,retribution,6,4,2
13890,Arcillus,stormscale,384,paladin,retribution,6,4,2
13891,Trefino,blackrock,384,paladin,retribution,6,4,2
13892,Òlymp,blackhand,384,paladin,retribution,6,4,2
13893,Veldora,zuljin,384,paladin,retribution,6,4,2
13894,Tdchopa,ravencrest,384,paladin,retribution,6,4,2
13895,Guskey,draenor,384,paladin,retribution,6,4,2
13896,Tillak,draenor,384,paladin,retribution,6,4,2
13897,Nicolae,colinas-pardas,384,paladin,retribution,6,4,2
13898,Petsadin,ravencrest,384,paladin,retribution,6,4,2
13899,Pállis,ravencrest,384,paladin,retribution,6,4,2
13900,Xinxin,azshara,384,paladin,retribution,6,4,2
13901,Tigurius,zuljin,384,paladin,retribution,6,4,2
13902,Stitchup,argent-dawn,384,paladin,retribution,6,4,2
13903,Skittlespala,twisting-nether,384,paladin,retribution,6,4,2
13904,Marmotaxx,dun-modr,384,paladin,retribution,6,4,2
13905,Serenityxo,twisting-nether,384,paladin,retribution,6,4,2
13906,Pâlâpâm,blackmoore,384,paladin,retribution,6,4,2
13907,Skrýmir,marécage-de-zangar,384,paladin,retribution,6,4,2
13908,Rölfchen,frostwolf,384,paladin,retribution,6,4,2
13909,Joti,proudmoore,384,paladin,retribution,6,4,2
13910,Swânn,sanguino,384,paladin,retribution,6,4,2
13911,Лиадринель,howling-fjord,384,paladin,retribution,6,4,2
13912,Refuse,blackrock,384,paladin,retribution,6,4,2
13913,Соулерт,ashenvale,384,paladin,retribution,6,4,2
13914,Судья,greymane,384,paladin,retribution,6,4,2
13915,Drownlord,eredar,384,paladin,retribution,6,4,2
13916,Clementine,spinebreaker,384,paladin,retribution,6,4,2
13917,Âyasê,blackhand,384,paladin,retribution,6,4,2
13918,Иев,howling-fjord,384,paladin,retribution,6,4,2
13919,Ямыч,ashenvale,384,paladin,retribution,6,4,2
13920,Zhàø,ysondre,384,paladin,retribution,6,4,2
13921,Angeal,ysondre,384,paladin,retribution,6,4,2
13922,Ibuc,blackrock,384,paladin,retribution,6,4,2
13923,Lighteousnes,blackmoore,384,paladin,retribution,6,4,2
13924,Luckyman,aszune,384,paladin,retribution,6,4,2
13925,Neverknõw,draenor,384,paladin,retribution,6,4,2
13926,Dragongîrl,lothar,384,paladin,retribution,6,4,2
13927,Ðesolace,twisting-nether,384,paladin,retribution,6,4,2
13928,Velikor,dun-modr,384,paladin,retribution,6,4,2
13929,Пепсекольный,soulflayer,384,paladin,retribution,6,4,2
13930,Aylion,blackrock,384,paladin,retribution,6,4,2
13931,Atanasum,dun-modr,384,paladin,retribution,6,4,2
13932,Dornu,tarren-mill,384,paladin,retribution,6,4,2
13933,Wiither,argent-dawn,384,paladin,retribution,6,4,2
13934,Spizz,dun-modr,384,paladin,retribution,6,4,2
13935,Pelbo,ravencrest,384,paladin,retribution,6,4,2
13936,Holyhi,silvermoon,384,paladin,retribution,6,4,2
13937,Dìe,silvermoon,384,paladin,retribution,6,4,2
13938,Sabriaña,silvermoon,384,paladin,retribution,6,4,2
13939,Shakkur,varimathras,384,paladin,retribution,6,4,2
13940,Нефростинг,gordunni,384,paladin,retribution,6,4,2
13941,Позабытый,deathweaver,384,paladin,retribution,6,4,2
13942,Holydhanas,outland,384,paladin,retribution,6,4,2
13943,Emloses,outland,384,paladin,retribution,6,4,2
13944,Zeportpala,archimonde,384,paladin,retribution,6,4,2
13945,Светонносец,gordunni,384,paladin,retribution,6,4,2
13946,Imtheßoss,pozzo-delleternità,384,paladin,retribution,6,4,2
13947,Драгмитухел,gordunni,384,paladin,retribution,6,4,2
13948,Caleel,nemesis,384,paladin,retribution,6,4,2
13949,Érléuchtas,kazzak,384,paladin,retribution,6,4,2
13950,Хилоретка,blackscar,384,paladin,retribution,6,4,2
13951,Franc,aggra-português,384,paladin,retribution,6,4,2
13952,Missmyhoj,archimonde,384,paladin,retribution,6,4,2
13953,Гуэргос,gordunni,384,paladin,retribution,6,4,2
13954,Zeusp,archimonde,384,paladin,retribution,6,4,2
13955,Dalbo,aegwynn,384,paladin,retribution,6,4,2
13956,Zeggayoda,nemesis,384,paladin,retribution,6,4,2
13957,Kaähz,archimonde,384,paladin,retribution,6,4,2
13958,Arrious,frostmane,384,paladin,retribution,6,4,2
13959,Colpadeltank,kazzak,384,paladin,retribution,6,4,2
13960,Timoxas,kazzak,384,paladin,retribution,6,4,2
13961,Crussaden,stormscale,384,paladin,retribution,7,4,3
13962,Olaghkan,dun-modr,384,paladin,retribution,8,4,4
13963,Shoogle,alonsus,384,paladin,retribution,9,4,5
13964,Хилвкд,blackscar,384,paladin,retribution,11,4,7
13965,Athênâ,azjolnerub,384,paladin,retribution,15,5,10
13966,Celerius,trollbane,384,paladin,retribution,12,4,8
13967,Almighty,ravencrest,384,paladin,retribution,12,4,8
13968,Lucretius,kilrogg,384,paladin,retribution,12,4,8
13969,Denlow,silvermoon,384,paladin,retribution,12,4,8
13970,Vazayo,ravencrest,384,paladin,retribution,12,4,8
13971,Shuukz,blackmoore,384,paladin,retribution,12,4,8
13972,Madeofsteel,silvermoon,384,paladin,retribution,12,4,8
13973,Andrøiz,dun-modr,384,paladin,retribution,12,4,8
13974,Artoriaz,ravencrest,384,paladin,retribution,12,4,8
13975,Serim,dun-modr,384,paladin,retribution,12,4,8
13976,Kiriel,dun-modr,384,paladin,retribution,12,4,8
13977,Avengence,dragonblight,384,paladin,retribution,12,4,8
13978,Vilayesyo,ravencrest,384,paladin,retribution,12,4,8
13979,Ippex,silvermoon,384,paladin,retribution,12,4,8
13980,Crowdev,zuljin,384,paladin,retribution,12,4,8
13981,Notpitball,kazzak,384,paladin,retribution,12,4,8
13982,Bundagains,silvermoon,384,paladin,retribution,12,4,8
13983,Kjobergen,tarren-mill,384,paladin,retribution,12,4,8
13984,Freeloliipop,darksorrow,384,paladin,retribution,12,4,8
13985,Yakuron,blackhand,384,paladin,retribution,12,4,8
13986,Xòtrios,argent-dawn,384,paladin,retribution,12,4,8
13987,Arkkipiispa,outland,384,paladin,retribution,12,4,8
13988,Eîon,argent-dawn,384,paladin,retribution,12,4,8
13989,Cyban,twisting-nether,384,paladin,retribution,12,4,8
13990,Pålegg,emerald-dream,384,paladin,retribution,12,4,8
13991,Шэйкер,blackscar,384,paladin,retribution,12,4,8
13992,Waks,dalaran,384,paladin,retribution,12,4,8
13993,Xsÿde,archimonde,384,paladin,retribution,12,4,8
13994,Phazio,twisting-nether,384,paladin,retribution,12,4,8
13995,Diaéna,kirin-tor,384,paladin,retribution,12,4,8
13996,Popelarr,burning-blade,384,paladin,retribution,12,4,8
13997,Thiccdeeps,aegwynn,384,paladin,retribution,12,4,8
13998,Hasart,tarren-mill,384,paladin,retribution,12,4,8
13999,Øazimutø,archimonde,384,paladin,retribution,12,4,8
14000,Moløk,ysondre,384,paladin,retribution,12,4,8
14001,Gladiator,die-aldor,384,paladin,retribution,12,4,8
14002,Pecar,stormscale,384,paladin,retribution,12,4,8
14003,Ngel,marécage-de-zangar,384,paladin,retribution,12,4,8
14004,Baldarlyset,tarren-mill,384,paladin,retribution,12,4,8
14005,Зираэлис,gordunni,384,paladin,retribution,12,4,8
14006,Donttaskwhy,sylvanas,384,paladin,retribution,12,4,8
14007,Розовыйбабл,gordunni,384,paladin,retribution,12,4,8
14008,Dennyboy,sylvanas,384,paladin,retribution,12,4,8
14009,Minfa,argent-dawn,384,paladin,retribution,12,4,8
14010,Juozas,argent-dawn,384,paladin,retribution,12,4,8
14011,Kuhfleisch,eredar,384,paladin,retribution,12,4,8
14012,Drhammerdin,antonidas,384,paladin,retribution,12,4,8
14013,Trainors,chamber-of-aspects,384,paladin,retribution,12,4,8
14014,Palapaye,archimonde,384,paladin,retribution,12,4,8
14015,Yasfy,stormscale,384,paladin,retribution,12,4,8
14016,Inkuboss,nemesis,384,paladin,retribution,12,4,8
14017,Сандалар,gordunni,384,paladin,retribution,12,4,8
14018,Ficsuur,ragnaros,384,paladin,retribution,12,4,8
14019,Decain,twisting-nether,384,paladin,retribution,12,4,8
14020,Stoneð,antonidas,384,paladin,retribution,12,4,8
14021,Холирайз,gordunni,384,paladin,retribution,12,4,8
14022,Neiiz,ragnaros,384,paladin,retribution,12,4,8
14023,Xavios,eredar,384,paladin,retribution,12,4,8
14024,Perxx,stormscale,384,paladin,retribution,12,4,8
14025,Benzimus,ragnaros,384,paladin,retribution,12,4,8
14026,Douglazz,tarren-mill,384,paladin,retribution,13,4,9
14027,Artonus,sylvanas,384,paladin,retribution,14,4,10
14028,Orbia,draenor,384,paladin,retribution,18,4,14
14029,Forthy,drakthul,384,paladin,retribution,18,4,14
14030,Руказакона,deathguard,384,paladin,retribution,18,4,14
14031,Eniste,silvermoon,384,paladin,retribution,18,4,14
14032,Cadearas,antonidas,384,paladin,retribution,18,4,14
14033,Anesthesiax,ravencrest,384,paladin,retribution,18,4,14
14034,Halldòr,ravencrest,384,paladin,retribution,18,4,14
14035,Møøgødx,bronzebeard,384,paladin,retribution,18,4,14
14036,Алекхей,gordunni,384,paladin,retribution,18,4,14
14037,Fløki,blackrock,383,paladin,retribution,6,4,2
14038,Ahritea,blackrock,383,paladin,retribution,6,4,2
14039,Supersnubben,grim-batol,383,paladin,retribution,6,4,2
14040,Tank,uldum,383,paladin,retribution,6,4,2
14041,Рукаф,soulflayer,383,paladin,retribution,6,4,2
14042,Bubblemama,aegwynn,383,paladin,retribution,6,4,2
14043,Ренегадер,thermaplugg,383,paladin,retribution,6,4,2
14044,Krögerelf,garrosh,383,paladin,retribution,6,4,2
14045,Tobebryant,eonar,383,paladin,retribution,6,4,2
14046,Buddy,conseil-des-ombres,383,paladin,retribution,9,5,4
14047,Paladoon,ravencrest,383,paladin,retribution,12,4,8
14048,Donfilippo,burning-legion,383,paladin,retribution,12,4,8
14049,Nenenita,cthun,383,paladin,retribution,12,4,8
14050,Vonryan,defias-brotherhood,383,paladin,retribution,12,4,8
14051,Käylä,silvermoon,383,paladin,retribution,12,4,8
14052,Ратомир,howling-fjord,383,paladin,retribution,14,4,10
14053,Anamary,ravencrest,383,paladin,retribution,15,4,11
14054,Ságé,thrall,383,paladin,retribution,16,4,12
14055,Lavacalistar,turalyon,383,paladin,retribution,21,5,16
14056,Бунча,gordunni,383,paladin,retribution,18,4,14
14057,Dragonous,darkmoon-faire,383,paladin,retribution,26,4,22
14058,Fumatelo,tyrande,382,paladin,retribution,6,4,2
14059,Shurikèn,khaz-modan,382,paladin,retribution,6,4,2
14060,Rockymarcian,hyjal,382,paladin,retribution,12,4,8
14061,Куоширо,goldrinn,381,paladin,retribution,12,4,8
14062,Palastratos,turalyon,379,paladin,retribution,12,4,8
14063,Bellight,sinstralis,376,paladin,retribution,19,4,15
14064,Spóntaneous,ravencrest,351,paladin,retribution,8,5,3
14065,Madzy,archimonde,351,paladin,retribution,11,4,7
14066,Joeintkaa,ragnaros,351,paladin,retribution,11,4,7
14067,Kantfyrste,ravencrest,351,paladin,retribution,11,4,7
14068,Arear,kazzak,336,paladin,retribution,9,5,4
14069,Freemain,doomhammer,336,paladin,retribution,9,4,5
14070,Malagat,die-todeskrallen,335,paladin,retribution,11,4,7
14071,Sunsera,blackrock,330,paladin,retribution,8,5,3
14072,Alanore,tarren-mill,330,paladin,retribution,13,6,7
14073,Stonebeard,ahnqiraj,329,paladin,retribution,25,5,20
14074,Bafbaf,arathi,329,paladin,retribution,30,5,25
14075,Reiwyn,archimonde,320,paladin,retribution,10,4,6
14076,Kyazar,sylvanas,319,paladin,retribution,5,4,1
14077,Strìke,ragnaros,319,paladin,retribution,8,4,4
14078,Kýríl,antonidas,319,paladin,retribution,14,4,10
14079,Адептустер,gordunni,319,paladin,retribution,14,4,10
14080,Palädörette,dalaran,318,paladin,retribution,5,4,1
14081,Legitpower,silvermoon,318,paladin,retribution,23,10,13
14082,Beefdaddyy,kazzak,288,paladin,retribution,11,6,5
14083,Zeltose,uldaman,288,paladin,retribution,6,3,3
14084,Xirôs,zirkel-des-cenarius,288,paladin,retribution,6,3,3
14085,Митахо,gordunni,288,paladin,retribution,6,3,3
14086,Братстепина,gordunni,288,paladin,retribution,6,3,3
14087,Antidrasi,turalyon,288,paladin,retribution,6,3,3
14088,Stárchy,terenas,288,paladin,retribution,6,3,3
14089,Бигтедо,gordunni,288,paladin,retribution,6,3,3
14090,Veo,sylvanas,288,paladin,retribution,6,3,3
14091,Kelsumi,draenor,288,paladin,retribution,6,3,3
14092,ßßæßßæßß,stormscale,288,paladin,retribution,6,3,3
14093,Golgel,turalyon,288,paladin,retribution,6,3,3
14094,Лайсен,gordunni,288,paladin,retribution,6,3,3
14095,Æternal,arathor,288,paladin,retribution,6,3,3
14096,Holyshêêt,draenor,288,paladin,retribution,6,3,3
14097,Fabsy,frostwolf,288,paladin,retribution,6,3,3
14098,Рамстафарай,gordunni,288,paladin,retribution,6,3,3
14099,Skølir,rashgarroth,288,paladin,retribution,6,3,3
14100,Кс,greymane,288,paladin,retribution,6,3,3
14101,Мортлайт,soulflayer,288,paladin,retribution,6,3,3
14102,Moolurk,stormscale,288,paladin,retribution,6,3,3
14103,Mayhem,area-52,288,paladin,retribution,6,3,3
14104,Kawabanga,the-maelstrom,288,paladin,retribution,6,3,3
14105,Finñ,sylvanas,288,paladin,retribution,6,3,3
14106,Лефша,soulflayer,288,paladin,retribution,6,3,3
14107,Рукибудды,soulflayer,288,paladin,retribution,6,3,3
14108,Nympa,sylvanas,288,paladin,retribution,6,3,3
14109,Fogell,ravencrest,288,paladin,retribution,6,3,3
14110,Animegifx,ragnaros,288,paladin,retribution,6,3,3
14111,Lotheirid,antonidas,288,paladin,retribution,6,3,3
14112,Synthesis,uldum,288,paladin,retribution,6,3,3
14113,Hione,burning-legion,288,paladin,retribution,6,3,3
14114,Темплеар,gordunni,288,paladin,retribution,6,3,3
14115,Зеппели,gordunni,288,paladin,retribution,6,3,3
14116,Holythore,shadowsong,288,paladin,retribution,6,3,3
14117,Apolloos,grim-batol,288,paladin,retribution,6,3,3
14118,Partysyster,defias-brotherhood,288,paladin,retribution,6,3,3
14119,Mortty,ravencrest,288,paladin,retribution,6,3,3
14120,Divineovic,ravencrest,288,paladin,retribution,6,3,3
14121,Névér,steamwheedle-cartel,288,paladin,retribution,6,3,3
14122,Tsunà,antonidas,288,paladin,retribution,6,3,3
14123,Freakks,twisting-nether,288,paladin,retribution,6,3,3
14124,Palá,dun-modr,288,paladin,retribution,6,3,3
14125,Cîzzar,burning-legion,288,paladin,retribution,6,3,3
14126,Véngeance,twilights-hammer,288,paladin,retribution,6,3,3
14127,Sarunan,ravencrest,288,paladin,retribution,6,3,3
14128,Partur,stormreaver,288,paladin,retribution,6,3,3
14129,Лаитнем,gordunni,288,paladin,retribution,6,3,3
14130,Петуретрик,gordunni,288,paladin,retribution,6,3,3
14131,Shaká,ravencrest,288,paladin,retribution,6,3,3
14132,Reptoglad,archimonde,288,paladin,retribution,6,3,3
14133,Tyn,dragonmaw,288,paladin,retribution,6,3,3
14134,Yaldly,dun-modr,288,paladin,retribution,6,3,3
14135,Paidi,die-todeskrallen,288,paladin,retribution,6,3,3
14136,Retroxy,stormreaver,288,paladin,retribution,6,3,3
14137,Eyebluee,tarren-mill,288,paladin,retribution,6,3,3
14138,Gulyas,tarren-mill,288,paladin,retribution,6,3,3
14139,Cilodin,blackrock,288,paladin,retribution,6,3,3
14140,Astralenigma,hyjal,288,paladin,retribution,6,3,3
14141,Jpally,ravencrest,288,paladin,retribution,6,3,3
14142,Lixîa,hyjal,288,paladin,retribution,6,3,3
14143,Eldivin,hyjal,288,paladin,retribution,6,3,3
14144,Neithi,twisting-nether,288,paladin,retribution,6,3,3
14145,Vultrix,tarren-mill,288,paladin,retribution,6,3,3
14146,Arkhàn,ravencrest,288,paladin,retribution,6,3,3
14147,Fumbz,alakir,288,paladin,retribution,6,3,3
14148,Emet,twisting-nether,288,paladin,retribution,6,3,3
14149,Steínsgate,ravencrest,288,paladin,retribution,6,3,3
14150,Tonynox,hyjal,288,paladin,retribution,6,3,3
14151,Fahrèl,hyjal,288,paladin,retribution,6,3,3
14152,Дджаб,booty-bay,288,paladin,retribution,6,3,3
14153,Qpalax,outland,288,paladin,retribution,6,3,3
14154,Малоко,thermaplugg,288,paladin,retribution,6,3,3
14155,Krýptø,ravencrest,288,paladin,retribution,6,3,3
14156,Rothus,bronze-dragonflight,288,paladin,retribution,6,3,3
14157,Cloudlight,argent-dawn,288,paladin,retribution,6,3,3
14158,Ketherian,blutkessel,288,paladin,retribution,6,3,3
14159,Kielonpala,kazzak,288,paladin,retribution,6,3,3
14160,Lyrïcs,ysondre,288,paladin,retribution,6,3,3
14161,Cursedd,sanguino,288,paladin,retribution,6,3,3
14162,Synexy,kazzak,288,paladin,retribution,6,3,3
14163,Ïrönhämmër,argent-dawn,288,paladin,retribution,6,3,3
14164,Astralz,aegwynn,288,paladin,retribution,6,3,3
14165,Revinox,silvermoon,288,paladin,retribution,6,3,3
14166,Raketenreiko,blackrock,288,paladin,retribution,6,3,3
14167,Illmindofyou,twisting-nether,288,paladin,retribution,6,3,3
14168,Molgran,defias-brotherhood,288,paladin,retribution,6,3,3
14169,Harycon,thrall,288,paladin,retribution,6,3,3
14170,Lolsurprise,twisting-nether,288,paladin,retribution,6,3,3
14171,Nînaninja,silvermoon,288,paladin,retribution,6,3,3
14172,Xirac,antonidas,288,paladin,retribution,6,3,3
14173,Evölution,frostmane,288,paladin,retribution,6,3,3
14174,Palapouffe,khaz-modan,288,paladin,retribution,6,3,3
14175,Minirempart,khaz-modan,288,paladin,retribution,6,3,3
14176,Ozen,blackrock,288,paladin,retribution,6,3,3
14177,Silverglaze,defias-brotherhood,288,paladin,retribution,6,3,3
14178,Bämschi,blackrock,288,paladin,retribution,6,3,3
14179,Strangerx,blackrock,288,paladin,retribution,6,3,3
14180,Muieiulica,twisting-nether,288,paladin,retribution,6,3,3
14181,Киэрсис,howling-fjord,288,paladin,retribution,6,3,3
14182,Unforsakenx,silvermoon,288,paladin,retribution,6,3,3
14183,Retisfine,silvermoon,288,paladin,retribution,6,3,3
14184,Ксинем,howling-fjord,288,paladin,retribution,6,3,3
14185,Uriel,scarshield-legion,288,paladin,retribution,6,3,3
14186,Zehnya,grim-batol,288,paladin,retribution,6,3,3
14187,Талрэн,howling-fjord,288,paladin,retribution,6,3,3
14188,Торсгард,howling-fjord,288,paladin,retribution,6,3,3
14189,Sakulchan,antonidas,288,paladin,retribution,6,3,3
14190,Tyranius,bronzebeard,288,paladin,retribution,6,3,3
14191,Enmà,archimonde,288,paladin,retribution,6,3,3
14192,Belnadris,eredar,288,paladin,retribution,6,3,3
14193,Маразоточка,howling-fjord,288,paladin,retribution,6,3,3
14194,Sekztokio,blackmoore,288,paladin,retribution,6,3,3
14195,Aoldur,ragnaros,288,paladin,retribution,6,3,3
14196,Êxood,archimonde,288,paladin,retribution,6,3,3
14197,Heallgodxx,ragnaros,288,paladin,retribution,6,3,3
14198,Dwangl,silvermoon,288,paladin,retribution,6,3,3
14199,Sangiorgio,nemesis,288,paladin,retribution,6,3,3
14200,Hèmera,archimonde,288,paladin,retribution,6,3,3
14201,Zynuwu,blackmoore,288,paladin,retribution,6,3,3
14202,Elesmerias,dalaran,288,paladin,retribution,6,3,3
14203,Tîrana,ysondre,288,paladin,retribution,6,3,3
14204,Løøktår,ysondre,288,paladin,retribution,6,3,3
14205,Aipal,silvermoon,288,paladin,retribution,6,3,3
14206,Lóde,silvermoon,288,paladin,retribution,6,3,3
14207,Rômtone,dalaran,288,paladin,retribution,6,3,3
14208,Lbj,eredar,288,paladin,retribution,6,3,3
14209,Ksama,ysondre,288,paladin,retribution,6,3,3
14210,Akcope,thunderhorn,288,paladin,retribution,6,3,3
14211,Obackbarama,outland,288,paladin,retribution,6,3,3
14212,Fufth,pozzo-delleternità,288,paladin,retribution,6,3,3
14213,Aklime,blackmoore,288,paladin,retribution,6,3,3
14214,Prâtox,blackmoore,288,paladin,retribution,6,3,3
14215,Sämaelia,ysondre,288,paladin,retribution,6,3,3
14216,Mcfëë,ysondre,288,paladin,retribution,6,3,3
14217,Holycide,twisting-nether,288,paladin,retribution,6,3,3
14218,Pigma,outland,288,paladin,retribution,9,4,5
14219,Aenhel,zuljin,288,paladin,retribution,11,4,7
14220,Parlma,naxxramas,288,paladin,retribution,13,4,9
14221,Dragg,kirin-tor,288,paladin,retribution,10,3,7
14222,Whórainzóne,eredar,288,paladin,retribution,12,3,9
14223,Quaterbâck,antonidas,288,paladin,retribution,12,3,9
14224,Deholyloa,frostwhisper,288,paladin,retribution,12,3,9
14225,Mandingbull,stormscale,288,paladin,retribution,12,3,9
14226,Dmascus,blackrock,288,paladin,retribution,12,3,9
14227,Масачусетсс,gordunni,288,paladin,retribution,12,3,9
14228,Simsaii,stormscale,288,paladin,retribution,12,3,9
14229,Ашилолпро,soulflayer,288,paladin,retribution,12,3,9
14230,Majk,hellscream,288,paladin,retribution,12,3,9
14231,Lättäkamerus,ravencrest,288,paladin,retribution,12,3,9
14232,Найдэкер,gordunni,288,paladin,retribution,12,3,9
14233,Wolluna,frostwolf,288,paladin,retribution,12,3,9
14234,Эеомли,blackscar,288,paladin,retribution,12,3,9
14235,Daddysiliam,ravencrest,288,paladin,retribution,12,3,9
14236,Milisha,the-maelstrom,288,paladin,retribution,12,3,9
14237,Dufftroll,kazzak,288,paladin,retribution,12,3,9
14238,Ауё,blackscar,288,paladin,retribution,12,3,9
14239,Boyard,silvermoon,288,paladin,retribution,12,3,9
14240,Strikè,stormscale,288,paladin,retribution,12,3,9
14241,Skuzee,archimonde,288,paladin,retribution,12,3,9
14242,Cydor,khaz-modan,288,paladin,retribution,12,3,9
14243,Claymore,ravenholdt,288,paladin,retribution,12,3,9
14244,Niou,alleria,288,paladin,retribution,12,3,9
14245,Çolette,silvermoon,288,paladin,retribution,12,3,9
14246,Kraakz,sanguino,288,paladin,retribution,12,3,9
14247,Swagged,kazzak,288,paladin,retribution,12,3,9
14248,Dalaly,kazzak,288,paladin,retribution,12,3,9
14249,Tj,sanguino,288,paladin,retribution,12,3,9
14250,Lylennâ,argent-dawn,288,paladin,retribution,12,3,9
14251,Turbopal,burning-blade,288,paladin,retribution,12,3,9
14252,Trollpaladin,blackmoore,288,paladin,retribution,12,3,9
14253,Moriex,drakthul,288,paladin,retribution,12,3,9
14254,Kypamop,argent-dawn,288,paladin,retribution,12,3,9
14255,Таурмакус,howling-fjord,288,paladin,retribution,12,3,9
14256,Ahreesh,blackrock,288,paladin,retribution,12,3,9
14257,Thoorval,silvermoon,288,paladin,retribution,12,3,9
14258,Lightwitcher,silvermoon,288,paladin,retribution,12,3,9
14259,Smilé,sylvanas,288,paladin,retribution,12,3,9
14260,Cigoveth,sylvanas,288,paladin,retribution,12,3,9
14261,Nordiusek,drakthul,288,paladin,retribution,12,3,9
14262,Dathea,aegwynn,288,paladin,retribution,12,3,9
14263,Pikoman,hellfire,288,paladin,retribution,12,3,9
14264,Pascual,magtheridon,288,paladin,retribution,12,3,9
14265,Diccari,stormreaver,288,paladin,retribution,12,3,9
14266,Calluk,turalyon,288,paladin,retribution,12,3,9
14267,Miqee,burning-legion,288,paladin,retribution,12,3,9
14268,Luridity,argent-dawn,288,paladin,retribution,12,3,9
14269,Annurra,quelthalas,288,paladin,retribution,12,3,9
14270,Lacrossé,kazzak,288,paladin,retribution,12,3,9
14271,Legâin,twisting-nether,288,paladin,retribution,12,3,9
14272,Blecheîmer,aegwynn,288,paladin,retribution,12,3,9
14273,Arthàs,blackmoore,288,paladin,retribution,12,3,9
14274,Аладушок,gordunni,288,paladin,retribution,12,3,9
14275,Загошслакер,howling-fjord,288,paladin,retribution,12,3,9
14276,Ragen,kazzak,288,paladin,retribution,12,3,9
14277,Мува,soulflayer,288,paladin,retribution,14,3,11
14278,Cilise,bronzebeard,288,paladin,retribution,18,3,15
14279,Ллосла,howling-fjord,288,paladin,retribution,18,3,15
14280,Ulderoth,dun-modr,288,paladin,retribution,18,3,15
14281,Davoss,outland,288,paladin,retribution,18,3,15
14282,Lééroÿ,sylvanas,287,paladin,retribution,8,4,4
14283,Nauriell,blackmoore,287,paladin,retribution,6,3,3
14284,Themlstake,kazzak,287,paladin,retribution,6,3,3
14285,Hrubo,drakthul,287,paladin,retribution,6,3,3
14286,Taomeba,runetotem,287,paladin,retribution,6,3,3
14287,Lewanor,tarren-mill,287,paladin,retribution,6,3,3
14288,Ïwâ,hyjal,287,paladin,retribution,6,3,3
14289,Fortplus,pozzo-delleternità,287,paladin,retribution,6,3,3
14290,Choyoki,blackmoore,287,paladin,retribution,7,3,4
14291,Артуроэльф,eversong,287,paladin,retribution,9,3,6
14292,Voraxpa,draenor,287,paladin,retribution,12,3,9
14293,Cajikpal,drakthul,287,paladin,retribution,12,3,9
14294,Trevorion,argent-dawn,287,paladin,retribution,12,3,9
14295,Bore,culte-de-la-rive-noire,287,paladin,retribution,12,3,9
14296,Rsanchez,frostwolf,286,paladin,retribution,6,3,3
14297,Yeretria,krasus,286,paladin,retribution,6,3,3
14298,Tofrus,kazzak,271,paladin,retribution,11,3,8
14299,Рбгхил,howling-fjord,271,paladin,retribution,11,3,8
14300,Brictom,tarren-mill,271,paladin,retribution,11,3,8
14301,Tivv,blackhand,239,paladin,retribution,5,3,2
14302,Erannor,kirin-tor,239,paladin,retribution,5,3,2
14303,Pooncy,ragnaros,239,paladin,retribution,5,3,2
14304,Loire,blackmoore,239,paladin,retribution,5,3,2
14305,Tÿy,sylvanas,234,paladin,retribution,8,4,4
14306,Dørvâp,culte-de-la-rive-noire,234,paladin,retribution,11,4,7
14307,Palabido,nemesis,234,paladin,retribution,15,5,10
14308,Tomkü,burning-legion,234,paladin,retribution,16,5,11
14309,Rettalius,ravencrest,234,paladin,retribution,16,4,12
14310,Jcpd,drakthul,224,paladin,retribution,10,3,7
14311,Aimee,draenor,192,paladin,retribution,4,3,1
14312,Toruk,burning-legion,192,paladin,retribution,4,3,1
14313,Pitux,dun-modr,192,paladin,retribution,4,3,1
14314,Тайела,gordunni,192,paladin,retribution,4,3,1
14315,Kirkmeister,terokkar,192,paladin,retribution,9,3,6
14316,Trainwréck,ravencrest,192,paladin,retribution,6,2,4
14317,Vans,nazjatar,192,paladin,retribution,6,2,4
14318,Noxy,thrall,192,paladin,retribution,6,2,4
14319,Эйлара,howling-fjord,192,paladin,retribution,6,2,4
14320,Бордюрчег,howling-fjord,192,paladin,retribution,6,2,4
14321,Drasir,nemesis,192,paladin,retribution,6,2,4
14322,Пепескарлет,howling-fjord,192,paladin,retribution,6,2,4
14323,Боевикс,ashenvale,192,paladin,retribution,6,2,4
14324,Ijego,silvermoon,192,paladin,retribution,6,2,4
14325,Всеволорд,howling-fjord,192,paladin,retribution,6,2,4
14326,Maxunius,antonidas,192,paladin,retribution,6,2,4
14327,Canihavesome,sylvanas,192,paladin,retribution,6,2,4
14328,Кадаврициан,howling-fjord,192,paladin,retribution,6,2,4
14329,Aelaris,dunemaul,192,paladin,retribution,6,2,4
14330,Олегсудья,howling-fjord,192,paladin,retribution,6,2,4
14331,Oldsurehand,blackmoore,192,paladin,retribution,6,2,4
14332,Скруддж,howling-fjord,192,paladin,retribution,6,2,4
14333,Омникнайтх,howling-fjord,192,paladin,retribution,6,2,4
14334,Wingsftw,blackhand,192,paladin,retribution,6,2,4
14335,Туларион,grom,192,paladin,retribution,6,2,4
14336,Waramo,eredar,192,paladin,retribution,6,2,4
14337,Dàk,grim-batol,192,paladin,retribution,6,2,4
14338,Némesis,frostmane,192,paladin,retribution,6,2,4
14339,Postî,eredar,192,paladin,retribution,6,2,4
14340,Yømø,antonidas,192,paladin,retribution,6,2,4
14341,Gaab,aggra-português,192,paladin,retribution,6,2,4
14342,Quennten,grim-batol,192,paladin,retribution,6,2,4
14343,Легионор,galakrond,192,paladin,retribution,6,2,4
14344,Strøb,antonidas,192,paladin,retribution,6,2,4
14345,Дрейв,soulflayer,192,paladin,retribution,6,2,4
14346,Далходж,soulflayer,192,paladin,retribution,6,2,4
14347,Swapxyr,aegwynn,192,paladin,retribution,6,2,4
14348,Aal,eredar,192,paladin,retribution,6,2,4
14349,Breakafly,doomhammer,192,paladin,retribution,6,2,4
14350,Fannypoo,sylvanas,192,paladin,retribution,6,2,4
14351,Hännó,malganis,192,paladin,retribution,6,2,4
14352,Ashariah,die-aldor,192,paladin,retribution,6,2,4
14353,Bozznamaan,thrall,192,paladin,retribution,6,2,4
14354,Bumboombeem,stormscale,192,paladin,retribution,6,2,4
14355,Фэрплэйн,gordunni,192,paladin,retribution,6,2,4
14356,Потрепал,blackscar,192,paladin,retribution,6,2,4
14357,Djstompyasis,blackmoore,192,paladin,retribution,6,2,4
14358,Stjusmussel,ragnaros,192,paladin,retribution,6,2,4
14359,Starr,confrérie-du-thorium,192,paladin,retribution,6,2,4
14360,Pyronort,eredar,192,paladin,retribution,6,2,4
14361,Drident,die-nachtwache,192,paladin,retribution,6,2,4
14362,Ustex,argent-dawn,192,paladin,retribution,6,2,4
14363,Unzufrieden,silvermoon,192,paladin,retribution,6,2,4
14364,Refléx,zirkel-des-cenarius,192,paladin,retribution,6,2,4
14365,Холигор,deathguard,192,paladin,retribution,6,2,4
14366,Konori,mannoroth,192,paladin,retribution,6,2,4
14367,Níthag,ragnaros,192,paladin,retribution,6,2,4
14368,Holyape,argent-dawn,192,paladin,retribution,6,2,4
14369,Загадзуга,howling-fjord,192,paladin,retribution,6,2,4
14370,Azapala,kazzak,192,paladin,retribution,6,2,4
14371,Bálerion,bronze-dragonflight,192,paladin,retribution,6,2,4
14372,Vallorum,ravencrest,192,paladin,retribution,6,2,4
14373,Jimrogier,argent-dawn,192,paladin,retribution,6,2,4
14374,Alto,nordrassil,192,paladin,retribution,6,2,4
14375,Thrinea,blackrock,192,paladin,retribution,6,2,4
14376,Benø,malganis,192,paladin,retribution,6,2,4
14377,Fatâl,antonidas,192,paladin,retribution,6,2,4
14378,Fortination,dalaran,192,paladin,retribution,6,2,4
14379,Gornim,die-nachtwache,192,paladin,retribution,6,2,4
14380,Manole,ravencrest,192,paladin,retribution,6,2,4
14381,Summuno,eredar,192,paladin,retribution,6,2,4
14382,Ghéttørèt,das-konsortium,192,paladin,retribution,6,2,4
14383,Knusern,dunemaul,192,paladin,retribution,6,2,4
14384,Panomecon,magtheridon,192,paladin,retribution,6,2,4
14385,Llya,blackrock,192,paladin,retribution,6,2,4
14386,Bakasnoop,hyjal,192,paladin,retribution,6,2,4
14387,Myrmidan,magtheridon,192,paladin,retribution,6,2,4
14388,Maxximuss,drekthar,192,paladin,retribution,6,2,4
14389,Alus,blackmoore,192,paladin,retribution,6,2,4
14390,Daviaa,silvermoon,192,paladin,retribution,6,2,4
14391,Grìmmjøw,silvermoon,192,paladin,retribution,6,2,4
14392,Ainnamash,twisting-nether,192,paladin,retribution,6,2,4
14393,Phaenre,pozzo-delleternità,192,paladin,retribution,6,2,4
14394,Arator,terenas,192,paladin,retribution,6,2,4
14395,Mathrixo,silvermoon,192,paladin,retribution,6,2,4
14396,Антитеррор,greymane,192,paladin,retribution,6,2,4
14397,Jicob,ravencrest,192,paladin,retribution,6,2,4
14398,Jâybee,ravencrest,192,paladin,retribution,6,2,4
14399,Yumhi,dun-modr,192,paladin,retribution,6,2,4
14400,Slymm,archimonde,192,paladin,retribution,6,2,4
14401,Vcd,kazzak,192,paladin,retribution,6,2,4
14402,Zephale,sunstrider,192,paladin,retribution,6,2,4
14403,Девствениица,gordunni,192,paladin,retribution,6,2,4
14404,Rdypaladin,ravencrest,192,paladin,retribution,6,2,4
14405,Ðeswynd,hyjal,192,paladin,retribution,6,2,4
14406,Altoangelo,outland,192,paladin,retribution,6,2,4
14407,Zarispal,tarren-mill,192,paladin,retribution,6,2,4
14408,Víii,outland,192,paladin,retribution,6,2,4
14409,Vikingensven,silvermoon,192,paladin,retribution,6,2,4
14410,Rinocerb,ravencrest,192,paladin,retribution,6,2,4
14411,Apolytos,laughing-skull,192,paladin,retribution,6,2,4
14412,Wordup,senjin,192,paladin,retribution,6,2,4
14413,Takezop,dun-modr,192,paladin,retribution,6,2,4
14414,Leroya,blackrock,192,paladin,retribution,6,2,4
14415,Heilgaharald,blackrock,192,paladin,retribution,6,2,4
14416,Blazeê,blackrock,192,paladin,retribution,6,2,4
14417,Palacheatlol,ysondre,192,paladin,retribution,6,2,4
14418,Palidos,blackrock,192,paladin,retribution,6,2,4
14419,Heidfield,draenor,192,paladin,retribution,6,2,4
14420,Shápzx,draenor,192,paladin,retribution,6,2,4
14421,Paxillustral,twisting-nether,192,paladin,retribution,6,2,4
14422,Memororo,stormscale,192,paladin,retribution,6,2,4
14423,Legendaryxw,drakthul,192,paladin,retribution,6,2,4
14424,Shufflee,drakthul,192,paladin,retribution,6,2,4
14425,Tomforøl,aggramar,192,paladin,retribution,6,2,4
14426,Razarus,sylvanas,192,paladin,retribution,6,2,4
14427,Galaerøn,elune,192,paladin,retribution,6,2,4
14428,Måxrajoy,dun-modr,192,paladin,retribution,6,2,4
14429,Wellick,ravencrest,192,paladin,retribution,6,2,4
14430,Serethor,blackrock,192,paladin,retribution,6,2,4
14431,Mozg,silvermoon,192,paladin,retribution,6,2,4
14432,Caribbean,outland,192,paladin,retribution,6,2,4
14433,Valzyffs,twisting-nether,192,paladin,retribution,6,2,4
14434,Japsee,runetotem,192,paladin,retribution,6,2,4
14435,Гачипаладинн,galakrond,192,paladin,retribution,6,2,4
14436,Dollicia,outland,192,paladin,retribution,6,2,4
14437,Rodakinos,outland,192,paladin,retribution,6,2,4
14438,Flashhèart,draenor,192,paladin,retribution,6,2,4
14439,Ultrabenzo,ravencrest,192,paladin,retribution,6,2,4
14440,Cøygonne,archimonde,192,paladin,retribution,6,2,4
14441,Rétalin,blackhand,192,paladin,retribution,6,2,4
14442,Aguerx,alleria,192,paladin,retribution,6,2,4
14443,Blurengo,blackrock,192,paladin,retribution,6,2,4
14444,Blinkdrink,ragnaros,192,paladin,retribution,6,2,4
14445,Greko,ysera,192,paladin,retribution,6,2,4
14446,Zbykmasta,burning-legion,192,paladin,retribution,6,2,4
14447,Logmár,sanguino,192,paladin,retribution,6,2,4
14448,Whitebreeze,sanguino,192,paladin,retribution,6,2,4
14449,Riares,darkspear,192,paladin,retribution,6,2,4
14450,Stinkytoes,draenor,192,paladin,retribution,6,2,4
14451,Støøk,shendralar,192,paladin,retribution,6,2,4
14452,Zuldekk,sanguino,192,paladin,retribution,6,2,4
14453,Moraru,neptulon,192,paladin,retribution,6,2,4
14454,Døgpaladin,outland,192,paladin,retribution,6,2,4
14455,Saulencio,zuljin,192,paladin,retribution,6,2,4
14456,Valanyr,kazzak,192,paladin,retribution,6,2,4
14457,Плат,gordunni,192,paladin,retribution,7,2,5
14458,Кольт,borean-tundra,192,paladin,retribution,10,2,8
14459,Instaquez,stormscale,192,paladin,retribution,11,2,9
14460,Samious,draenor,192,paladin,retribution,12,2,10
14461,Remedios,archimonde,192,paladin,retribution,12,2,10
14462,Galaadh,archimonde,192,paladin,retribution,12,2,10
14463,Hordium,doomhammer,192,paladin,retribution,12,2,10
14464,Limitles,nemesis,192,paladin,retribution,12,2,10
14465,Muuclear,twisting-nether,192,paladin,retribution,12,2,10
14466,Lamohru,argent-dawn,192,paladin,retribution,12,2,10
14467,Rhyua,eredar,192,paladin,retribution,12,2,10
14468,Neyd,hyjal,192,paladin,retribution,12,2,10
14469,Pârâsite,hyjal,192,paladin,retribution,12,2,10
14470,Мунрейм,gordunni,192,paladin,retribution,12,2,10
14471,Leriell,ravencrest,192,paladin,retribution,12,2,10
14472,Konardos,burning-legion,192,paladin,retribution,12,2,10
14473,Böserbube,tarren-mill,192,paladin,retribution,12,2,10
14474,Rîex,alleria,192,paladin,retribution,12,2,10
14475,Lightian,twisting-nether,192,paladin,retribution,12,2,10
14476,Wigbilly,tarren-mill,192,paladin,retribution,12,2,10
14477,Vivike,silvermoon,192,paladin,retribution,12,2,10
14478,Erathör,sanguino,192,paladin,retribution,12,2,10
14479,Skemfar,sanguino,192,paladin,retribution,12,2,10
14480,Mariuhûna,blackmoore,192,paladin,retribution,12,2,10
14481,Лимфома,goldrinn,192,paladin,retribution,12,2,10
14482,Verix,thrall,192,paladin,retribution,12,2,10
14483,Cunix,draenor,192,paladin,retribution,12,2,10
14484,Tressðr,dun-modr,192,paladin,retribution,12,2,10
14485,Reinwaltz,the-maelstrom,192,paladin,retribution,12,2,10
14486,Kökslaktarn,sylvanas,192,paladin,retribution,21,3,18
14487,Stillgard,ghostlands,192,paladin,retribution,15,2,13
14488,Cyxanacma,silvermoon,192,paladin,retribution,18,2,16
14489,Duckula,ravenholdt,191,paladin,retribution,6,2,4
14490,Milicos,sylvanas,191,paladin,retribution,6,2,4
14491,Supou,twisting-nether,191,paladin,retribution,6,2,4
14492,Севенола,galakrond,191,paladin,retribution,6,2,4
14493,Ârthâstrâs,terrordar,191,paladin,retribution,6,2,4
14494,Broziopath,blackrock,191,paladin,retribution,6,2,4
14495,Derbrècher,azshara,191,paladin,retribution,6,2,4
14496,Maitrelampe,argent-dawn,180,paladin,retribution,29,7,22
14497,Thelronis,kelthuzad,175,paladin,retribution,11,2,9
14498,Aerathil,nethersturm,159,paladin,retribution,5,2,3
14499,Geronimooh,vashj,159,paladin,retribution,5,2,3
14500,Heiemdall,azuremyst,159,paladin,retribution,5,2,3
14501,Trístesse,tarren-mill,159,paladin,retribution,11,2,9
14502,Амнон,goldrinn,144,paladin,retribution,9,2,7
14503,Öwai,dun-modr,143,paladin,retribution,3,3,0
14504,Еребор,howling-fjord,143,paladin,retribution,15,2,13
14505,Braiinafk,thrall,138,paladin,retribution,6,3,3
14506,Скелфер,soulflayer,138,paladin,retribution,8,3,5
14507,Jesamine,blackmoore,138,paladin,retribution,9,3,6
14508,Danneris,sanguino,137,paladin,retribution,7,3,4
14509,Qpax,twisting-nether,128,paladin,retribution,4,2,2
14510,Tigerherz,antonidas,128,paladin,retribution,4,2,2
14511,Aalyaah,zirkel-des-cenarius,96,paladin,retribution,3,2,1
14512,Kelianna,drakthul,96,paladin,retribution,3,2,1
14513,Маефис,gordunni,96,paladin,retribution,3,2,1
14514,Elbígotes,dun-modr,96,paladin,retribution,6,1,5
14515,Хилтонепта,gordunni,96,paladin,retribution,6,1,5
14516,Édèn,les-sentinelles,96,paladin,retribution,6,1,5
14517,Scorebit,draenor,96,paladin,retribution,6,1,5
14518,Patsani,twilights-hammer,96,paladin,retribution,6,1,5
14519,Powericius,drakthul,96,paladin,retribution,6,1,5
14520,Lezoom,draenor,96,paladin,retribution,6,1,5
14521,Nøvå,ravencrest,96,paladin,retribution,6,1,5
14522,Rataxes,stormreaver,96,paladin,retribution,6,1,5
14523,Fatalism,draenor,96,paladin,retribution,6,1,5
14524,Yséria,kirin-tor,96,paladin,retribution,6,1,5
14525,Popolelo,dun-modr,96,paladin,retribution,6,1,5
14526,Skarium,hyjal,96,paladin,retribution,6,1,5
14527,Zeroskills,tarren-mill,96,paladin,retribution,6,1,5
14528,Perrinaybull,magtheridon,96,paladin,retribution,6,1,5
14529,Davairabotai,kazzak,96,paladin,retribution,6,1,5
14530,Hyggë,sanguino,96,paladin,retribution,6,1,5
14531,Diggs,draenor,96,paladin,retribution,6,1,5
14532,Lowfi,argent-dawn,96,paladin,retribution,6,1,5
14533,Shanilia,argent-dawn,96,paladin,retribution,6,1,5
14534,Pussas,burning-legion,96,paladin,retribution,6,1,5
14535,Amoxapine,hyjal,96,paladin,retribution,6,1,5
14536,Blazix,kazzak,96,paladin,retribution,6,1,5
14537,Quarrel,kul-tiras,96,paladin,retribution,6,1,5
14538,Hipo,zuljin,96,paladin,retribution,6,1,5
14539,Kimozabie,ravencrest,96,paladin,retribution,6,1,5
14540,Ashreaver,burning-legion,96,paladin,retribution,6,1,5
14541,Kefalas,ravencrest,96,paladin,retribution,6,1,5
14542,Винзерг,ashenvale,96,paladin,retribution,6,1,5
14543,Dananas,draenor,96,paladin,retribution,6,1,5
14544,Harvel,outland,96,paladin,retribution,6,1,5
14545,Tozzey,defias-brotherhood,96,paladin,retribution,6,1,5
14546,Methynox,khaz-modan,96,paladin,retribution,6,1,5
14547,Фатумм,howling-fjord,96,paladin,retribution,6,1,5
14548,Меварх,howling-fjord,96,paladin,retribution,6,1,5
14549,Bigfatpig,ravencrest,96,paladin,retribution,6,1,5
14550,Светиздырки,howling-fjord,96,paladin,retribution,6,1,5
14551,Xanrian,kazzak,96,paladin,retribution,6,1,5
14552,Prínce,blackmoore,96,paladin,retribution,6,1,5
14553,Évo,drakthul,96,paladin,retribution,6,1,5
14554,Crawini,ragnaros,96,paladin,retribution,6,1,5
14555,Notingvar,doomhammer,96,paladin,retribution,6,1,5
14556,Fintros,silvermoon,96,paladin,retribution,6,1,5
14557,Miawyn,blackmoore,96,paladin,retribution,6,1,5
14558,Пашштет,gordunni,96,paladin,retribution,6,1,5
14559,Steelrose,auchindoun,96,paladin,retribution,6,1,5
14560,Старыйграф,gordunni,96,paladin,retribution,6,1,5
14561,Nijówka,burning-legion,96,paladin,retribution,6,1,5
14562,Thaderyl,auchindoun,96,paladin,retribution,6,1,5
14563,Vindorus,archimonde,96,paladin,retribution,6,1,5
14564,Holyhannes,blackmoore,96,paladin,retribution,6,1,5
14565,Pianiste,sinstralis,96,paladin,retribution,6,1,5
14566,Hølyshøckz,blackmoore,96,paladin,retribution,6,1,5
14567,Cazzanova,draenor,96,paladin,retribution,6,1,5
14568,Blakethorn,silvermoon,96,paladin,retribution,6,1,5
14569,Atacan,twisting-nether,96,paladin,retribution,6,1,5
14570,Zlätän,outland,96,paladin,retribution,6,1,5
14571,Vokesh,silvermoon,96,paladin,retribution,6,1,5
14572,Battlelord,terokkar,96,paladin,retribution,6,1,5
14573,Aggressìon,twisting-nether,96,paladin,retribution,6,1,5
14574,Bôomayé,archimonde,96,paladin,retribution,6,1,5
14575,Kavíár,kazzak,96,paladin,retribution,6,1,5
14576,Flashyo,archimonde,96,paladin,retribution,6,1,5
14577,Ironstealman,shattered-hand,96,paladin,retribution,6,1,5
14578,Taraniah,argent-dawn,96,paladin,retribution,6,1,5
14579,Bobsing,silvermoon,96,paladin,retribution,6,1,5
14580,Zerlat,twisting-nether,96,paladin,retribution,6,1,5
14581,Defuzes,twisting-nether,96,paladin,retribution,6,1,5
14582,Veshnu,blackrock,96,paladin,retribution,6,1,5
14583,Dänie,silvermoon,96,paladin,retribution,6,1,5
14584,Блейзр,ashenvale,96,paladin,retribution,6,1,5
14585,Holyloa,laughing-skull,96,paladin,retribution,6,1,5
14586,Monmo,emerald-dream,96,paladin,retribution,6,1,5
14587,Rekkt,ravenholdt,96,paladin,retribution,6,1,5
14588,Жмышенко,gordunni,96,paladin,retribution,6,1,5
14589,Graphpora,argent-dawn,96,paladin,retribution,6,1,5
14590,Paladzor,twisting-nether,96,paladin,retribution,6,1,5
14591,Мэркес,fordragon,96,paladin,retribution,6,1,5
14592,Sumecbtw,aegwynn,96,paladin,retribution,6,1,5
14593,Ragie,twisting-nether,96,paladin,retribution,6,1,5
14594,Lagrops,chants-éternels,96,paladin,retribution,6,1,5
14595,Пилоттыч,gordunni,96,paladin,retribution,6,1,5
14596,Bubblebuttx,ghostlands,96,paladin,retribution,6,1,5
14597,Omranator,stormscale,96,paladin,retribution,6,1,5
14598,Kambood,twisting-nether,96,paladin,retribution,6,1,5
14599,Jûliâ,archimonde,96,paladin,retribution,6,1,5
14600,Saedrick,nemesis,96,paladin,retribution,6,1,5
14601,Zandathor,chamber-of-aspects,96,paladin,retribution,6,1,5
14602,Akagami,ysondre,96,paladin,retribution,6,1,5
14603,Aion,chamber-of-aspects,96,paladin,retribution,6,1,5
14604,Friemelaar,silvermoon,96,paladin,retribution,6,1,5
14605,Møg,blackrock,96,paladin,retribution,6,1,5
14606,Karo,wildhammer,96,paladin,retribution,6,1,5
14607,Nîcolascage,stormscale,96,paladin,retribution,6,1,5
14608,Traxxces,ravencrest,96,paladin,retribution,6,1,5
14609,Destya,eredar,96,paladin,retribution,6,1,5
14610,Hiilton,silvermoon,96,paladin,retribution,6,1,5
14611,Naska,nemesis,96,paladin,retribution,6,1,5
14612,Stabilisator,blackrock,96,paladin,retribution,6,1,5
14613,Dawnbringer,stormscale,96,paladin,retribution,6,1,5
14614,Моррзито,soulflayer,96,paladin,retribution,6,1,5
14615,Sâfcon,eredar,96,paladin,retribution,6,1,5
14616,Tíríón,nethersturm,96,paladin,retribution,6,1,5
14617,Bázer,antonidas,96,paladin,retribution,6,1,5
14618,Palamaister,stormscale,96,paladin,retribution,6,1,5
14619,Xvoodoo,antonidas,96,paladin,retribution,6,1,5
14620,Эльтарус,soulflayer,96,paladin,retribution,6,1,5
14621,Phlakorn,blackhand,96,paladin,retribution,6,1,5
14622,Trwwsano,stormscale,96,paladin,retribution,6,1,5
14623,Chelan,thrall,96,paladin,retribution,6,1,5
14624,Artplex,ravencrest,96,paladin,retribution,6,1,5
14625,Valiscar,antonidas,96,paladin,retribution,6,1,5
14626,Highlòrd,silvermoon,96,paladin,retribution,6,1,5
14627,Serberen,ravencrest,96,paladin,retribution,6,1,5
14628,Ansonia,ravencrest,96,paladin,retribution,6,1,5
14629,Azmocore,blackhand,96,paladin,retribution,6,1,5
14630,Dildodin,ravencrest,96,paladin,retribution,6,1,5
14631,Borons,silvermoon,96,paladin,retribution,9,1,8
14632,Snakedubaby,blackrock,96,paladin,retribution,12,1,11
14633,Медверус,gordunni,96,paladin,retribution,12,1,11
14634,Kaelorian,silvermoon,96,paladin,retribution,12,1,11
14635,Fenik,dun-modr,96,paladin,retribution,12,1,11
14636,Jaexpaladin,draenor,96,paladin,retribution,12,1,11
14637,Nauy,korgall,96,paladin,retribution,12,1,11
14638,Charlybrown,archimonde,95,paladin,retribution,6,1,5
14639,Uriziel,the-shatar,95,paladin,retribution,6,1,5
14640,Rhauk,dun-modr,79,paladin,retribution,5,1,4
14641,Snobypala,onyxia,64,paladin,retribution,4,1,3
14642,Pastaflwras,twisting-nether,64,paladin,retribution,4,1,3
14643,Emakk,darksorrow,63,paladin,retribution,2,2,0
14644,Serawyn,twisting-nether,48,paladin,retribution,3,1,2
14645,Reliikt,blackrock,48,paladin,retribution,3,1,2
14646,Leköngen,ravencrest,48,paladin,retribution,3,1,2
14647,Lafrogge,culte-de-la-rive-noire,48,paladin,retribution,3,1,2
14648,Doruk,stormscale,48,paladin,retribution,9,1,8
14649,Plsdøntusemd,ravencrest,42,paladin,retribution,11,3,8
14650,Ranish,aegwynn,42,paladin,retribution,9,2,7
14651,Окилан,gordunni,42,paladin,retribution,9,2,7
14652,Matharr,kazzak,42,paladin,retribution,13,2,11
14653,Vengryn,turalyon,42,paladin,retribution,26,2,24
14654,Кранштейн,gordunni,31,paladin,retribution,2,1,1
14655,Irondawg,rajaxx,31,paladin,retribution,8,1,7
14656,Davidas,drakthul,16,paladin,retribution,1,1,0
14657,Arbuzno,draenor,1955,paladin,protection,66,48,18
14658,Leotheron,boulderfist,1763,paladin,protection,156,104,52
14659,Sterben,aegwynn,1750,paladin,protection,72,35,37
14660,Гниленький,razuvious,1712,paladin,protection,29,20,9
14661,Maximumtaste,ravencrest,1662,paladin,protection,30,22,8
14662,Collinnawin,aegwynn,1658,paladin,protection,96,45,51
14663,Elitest,hyjal,1560,paladin,protection,195,75,120
14664,Schrikii,archimonde,1556,paladin,protection,72,44,28
14665,Phlakorn,blackhand,1514,paladin,protection,36,22,14
14666,Силугор,soulflayer,1498,paladin,protection,48,26,22
14667,Galevar,argent-dawn,1453,paladin,protection,128,63,65
14668,Haringoth,argent-dawn,1448,paladin,protection,48,25,23
14669,Gabubex,tarren-mill,1430,paladin,protection,99,59,40
14670,Lóu,hyjal,1408,paladin,protection,35,20,15
14671,Ðivine,stormscale,1371,paladin,protection,60,27,33
14672,Velkar,frostmane,1331,paladin,protection,82,42,40
14673,Trufetteuh,hyjal,1283,paladin,protection,178,90,88
14674,Ichbin,sanguino,1262,paladin,protection,77,33,44
14675,Augroni,antonidas,1260,paladin,protection,75,32,43
14676,Xrules,blackhand,1201,paladin,protection,47,21,26
14677,Flakkson,stormscale,1201,paladin,protection,77,28,49
14678,Âmba,blackrock,1150,paladin,protection,18,12,6
14679,Sonnywalkman,twisting-nether,1055,paladin,protection,12,11,1
14680,Justífiéd,kazzak,1055,paladin,protection,24,11,13
14681,Medium,frostwolf,958,paladin,protection,18,10,8
14682,Проц,soulflayer,952,paladin,protection,18,10,8
14683,Lotheriem,argent-dawn,934,paladin,protection,36,10,26
14684,Zerhakz,ysondre,861,paladin,protection,18,9,9
14685,Бранв,gordunni,860,paladin,protection,12,9,3
14686,Fumbz,alakir,767,paladin,protection,12,8,4
14687,Leadfoot,argent-dawn,763,paladin,protection,18,8,10
14688,Tíríón,nethersturm,763,paladin,protection,18,8,10
14689,Yunalêsca,mugthol,760,paladin,protection,18,8,10
14690,Statscowski,thrall,672,paladin,protection,12,7,5
14691,Kraljevic,silvermoon,672,paladin,protection,12,7,5
14692,Ванябублгам,soulflayer,672,paladin,protection,18,7,11
14693,Tippressure,ravencrest,640,paladin,protection,10,7,3
14694,Marihuána,ragnaros,576,paladin,protection,18,6,12
14695,Lägolas,thrall,511,paladin,protection,11,6,5
14696,Supremerage,silvermoon,480,paladin,protection,12,5,7
14697,Onefrostyboi,defias-brotherhood,479,paladin,protection,12,5,7
14698,Elkka,azjolnerub,415,paladin,protection,11,5,6
14699,Galadrion,dun-modr,384,paladin,protection,6,4,2
14700,Fleshoflight,arathor,384,paladin,protection,6,4,2
14701,Røse,argent-dawn,384,paladin,protection,12,4,8
14702,Figustyle,archimonde,318,paladin,protection,10,4,6
14703,Æero,blackhand,288,paladin,protection,6,3,3
14704,Craft,frostwolf,288,paladin,protection,6,3,3
14705,Whiteraven,rexxar,288,paladin,protection,6,3,3
14706,Ekenpala,kazzak,288,paladin,protection,6,3,3
14707,Снайпик,azuregos,288,paladin,protection,6,3,3
14708,Zuplex,deathwing,288,paladin,protection,6,3,3
14709,Swäagg,hyjal,288,paladin,protection,6,3,3
14710,Ðizzmo,bloodfeather,288,paladin,protection,12,3,9
14711,Yourmomz,kazzak,239,paladin,protection,5,3,2
14712,Emakk,darksorrow,192,paladin,protection,6,2,4
14713,Helladin,haomarush,192,paladin,protection,6,2,4
14714,Arkera,blackrock,192,paladin,protection,6,2,4
14715,Gornim,die-nachtwache,192,paladin,protection,6,2,4
14716,Синерина,blackscar,192,paladin,protection,6,2,4
14717,Derina,silvermoon,192,paladin,protection,6,2,4
14718,Quantox,frostwolf,192,paladin,protection,12,2,10
14719,Exion,ravenholdt,159,paladin,protection,5,2,3
14720,Kawakai,blackrock,96,paladin,protection,6,1,5
14721,Thôrwald,les-sentinelles,96,paladin,protection,12,1,11
14722,Bobilous,twisting-nether,79,paladin,protection,5,1,4
14723,Køzukï,ravencrest,2202,priest,holy,119,60,59
14724,Candrä,archimonde,2164,priest,holy,90,47,43
14725,Leadeur,kazzak,2148,priest,holy,80,42,38
14726,Yötönyö,ravencrest,2043,priest,holy,60,32,28
14727,Кальвейт,deathweaver,1968,priest,holy,69,34,35
14728,Výra,der-rat-von-dalaran,1939,priest,holy,71,46,25
14729,Ladá,stormscale,1939,priest,holy,138,73,65
14730,Шотыказау,blackscar,1912,priest,holy,66,38,28
14731,Lenyp,sanguino,1909,priest,holy,96,50,46
14732,Лоаресс,gordunni,1868,priest,holy,72,33,39
14733,Kunen,sanguino,1854,priest,holy,96,60,36
14734,Weezing,ysondre,1849,priest,holy,72,36,36
14735,Servêy,twisting-nether,1845,priest,holy,42,22,20
14736,Dmnz,blackrock,1840,priest,holy,75,34,41
14737,Grafius,stormscale,1826,priest,holy,42,23,19
14738,Yateh,blackmoore,1824,priest,holy,62,32,30
14739,Катккат,soulflayer,1823,priest,holy,48,27,21
14740,Siign,ravencrest,1820,priest,holy,54,27,27
14741,Sayne,arathor,1815,priest,holy,168,91,77
14742,Maruh,malganis,1812,priest,holy,113,60,53
14743,Eriónd,ravencrest,1811,priest,holy,66,34,32
14744,Kaalu,frostmane,1809,priest,holy,254,131,123
14745,Muchos,blackrock,1807,priest,holy,66,31,35
14746,Teatime,aegwynn,1800,priest,holy,84,42,42
14747,Imbitterx,stormscale,1777,priest,holy,30,21,9
14748,Carlitastock,eredar,1777,priest,holy,41,22,19
14749,Гоплзнекст,gordunni,1760,priest,holy,228,121,107
14750,Dolens,argent-dawn,1746,priest,holy,106,54,52
14751,Smïlë,ravencrest,1714,priest,holy,168,88,80
14752,Jim,saurfang,1711,priest,holy,257,127,130
14753,Tangent,ravencrest,1707,priest,holy,60,30,30
14754,Psi,hakkar,1702,priest,holy,229,125,104
14755,Kaiikoo,ravencrest,1701,priest,holy,42,24,18
14756,Holyholy,stormscale,1697,priest,holy,56,20,36
14757,Itsmeminglee,ravencrest,1694,priest,holy,42,20,22
14758,Meanbabe,argent-dawn,1683,priest,holy,48,22,26
14759,Gladíator,blackhand,1677,priest,holy,102,58,44
14760,Wåtrux,alakir,1677,priest,holy,130,70,60
14761,Phobò,blackrock,1676,priest,holy,66,30,36
14762,Stinkydog,kazzak,1673,priest,holy,119,59,60
14763,Kÿokó,ravencrest,1670,priest,holy,72,40,32
14764,Weezïng,ysondre,1668,priest,holy,42,24,18
14765,Alpháømegá,outland,1653,priest,holy,81,42,39
14766,Beatrixz,twisting-nether,1650,priest,holy,127,62,65
14767,Câlyr,ragnaros,1647,priest,holy,48,21,27
14768,Løøney,kazzak,1635,priest,holy,36,25,11
14769,Друмги,gordunni,1635,priest,holy,54,19,35
14770,Calithria,kazzak,1631,priest,holy,95,53,42
14771,Ilenna,dun-morogh,1618,priest,holy,54,32,22
14772,Alchemïst,ravencrest,1617,priest,holy,46,21,25
14773,Dranbor,argent-dawn,1615,priest,holy,82,43,39
14774,Cosines,ravencrest,1614,priest,holy,36,17,19
14775,Affro,drakthul,1613,priest,holy,54,27,27
14776,Sïxsïxsïx,ravencrest,1613,priest,holy,43,21,22
14777,Shanya,thrall,1612,priest,holy,251,124,127
14778,Нубстрим,gordunni,1611,priest,holy,60,28,32
14779,Salvatíon,sanguino,1607,priest,holy,106,46,60
14780,Eox,kazzak,1602,priest,holy,36,20,16
14781,Zxø,ravencrest,1601,priest,holy,160,88,72
14782,Anníng,tarren-mill,1594,priest,holy,144,81,63
14783,Atiyesh,arthas,1589,priest,holy,141,82,59
14784,Phobò,antonidas,1583,priest,holy,84,36,48
14785,Dény,ravencrest,1573,priest,holy,90,50,40
14786,Highn,anetheron,1570,priest,holy,60,33,27
14787,Suxino,stormscale,1568,priest,holy,120,66,54
14788,Anabananaa,ravencrest,1561,priest,holy,40,24,16
14789,Elmaestrø,aegwynn,1558,priest,holy,48,25,23
14790,Senkín,aegwynn,1553,priest,holy,78,39,39
14791,Wilby,archimonde,1550,priest,holy,42,20,22
14792,Hiimgreen,blackhand,1546,priest,holy,42,18,24
14793,Womanwonderf,ravencrest,1542,priest,holy,48,23,25
14794,Møhammed,wrathbringer,1537,priest,holy,138,65,73
14795,Hyonra,kazzak,1536,priest,holy,66,34,32
14796,Gnomemonk,stormscale,1533,priest,holy,120,55,65
14797,Vregoa,twisting-nether,1532,priest,holy,36,17,19
14798,Jiffie,twisting-nether,1528,priest,holy,30,16,14
14799,Sehlia,kazzak,1526,priest,holy,126,64,62
14800,Xianxia,twisting-nether,1523,priest,holy,90,41,49
14801,Evabae,the-maelstrom,1520,priest,holy,42,22,20
14802,Koíré,defias-brotherhood,1519,priest,holy,90,51,39
14803,Divinetouch,ravencrest,1516,priest,holy,78,35,43
14804,Dokkaebì,kazzak,1514,priest,holy,135,67,68
14805,Camina,shattered-hand,1510,priest,holy,63,34,29
14806,Joeasaurs,ragnaros,1510,priest,holy,60,24,36
14807,Rines,thrall,1505,priest,holy,143,72,71
14808,Zlejkadlec,drakthul,1504,priest,holy,87,45,42
14809,Заволончик,blackscar,1494,priest,holy,102,48,54
14810,Ksn,silvermoon,1485,priest,holy,42,18,24
14811,Alphacub,ragnaros,1478,priest,holy,60,27,33
14812,Mcdeady,tarren-mill,1477,priest,holy,36,17,19
14813,Maah,defias-brotherhood,1471,priest,holy,80,46,34
14814,Symbolofhope,ravencrest,1460,priest,holy,117,62,55
14815,Вакидзачи,gordunni,1459,priest,holy,96,49,47
14816,Byzzi,draenor,1447,priest,holy,30,19,11
14817,Hydraximus,garrosh,1439,priest,holy,340,169,171
14818,Boonlai,ravencrest,1438,priest,holy,30,15,15
14819,Fizzlesp,tarren-mill,1425,priest,holy,30,15,15
14820,Kbakå,kazzak,1419,priest,holy,78,37,41
14821,Pigdestroyin,frostmane,1418,priest,holy,30,15,15
14822,Nomakprst,sanguino,1417,priest,holy,42,24,18
14823,Prëdz,stormscale,1416,priest,holy,36,20,16
14824,Markianos,silvermoon,1412,priest,holy,114,58,56
14825,Aykò,blackmoore,1412,priest,holy,36,15,21
14826,Nastylex,magtheridon,1410,priest,holy,24,15,9
14827,Мектран,gordunni,1408,priest,holy,54,27,27
14828,Bifs,blackmoore,1405,priest,holy,50,32,18
14829,Scartay,outland,1405,priest,holy,29,15,14
14830,Инзора,gordunni,1400,priest,holy,30,15,15
14831,Neoark,archimonde,1395,priest,holy,134,67,67
14832,Cøvu,draenor,1378,priest,holy,94,41,53
14833,Madcole,blackhand,1371,priest,holy,85,43,42
14834,Seladine,ravencrest,1367,priest,holy,125,64,61
14835,Orcid,chogall,1347,priest,holy,96,50,46
14836,Alros,elune,1346,priest,holy,54,26,28
14837,Tyrhaa,blackmoore,1345,priest,holy,102,52,50
14838,Cherron,argent-dawn,1344,priest,holy,49,23,26
14839,Alú,draenor,1344,priest,holy,62,29,33
14840,Мамкалол,soulflayer,1341,priest,holy,24,14,10
14841,Alizeé,nazjatar,1341,priest,holy,48,24,24
14842,Migam,kazzak,1341,priest,holy,54,25,29
14843,Jaz,ysondre,1339,priest,holy,30,15,15
14844,Shizzlol,silvermoon,1339,priest,holy,30,14,16
14845,Angrk,kazzak,1338,priest,holy,42,26,16
14846,Virginmaris,sanguino,1337,priest,holy,48,28,20
14847,Karpiest,stormscale,1336,priest,holy,30,16,14
14848,Rägà,archimonde,1335,priest,holy,61,32,29
14849,Ezechiel,twisting-nether,1331,priest,holy,41,25,16
14850,Hmanco,burning-legion,1329,priest,holy,54,34,20
14851,Delphina,archimonde,1326,priest,holy,83,44,39
14852,Libetha,ysondre,1323,priest,holy,35,20,15
14853,Síuu,kazzak,1322,priest,holy,60,31,29
14854,Phénylanine,khaz-modan,1320,priest,holy,129,64,65
14855,Tëmärï,ravencrest,1317,priest,holy,54,36,18
14856,Lasuora,nemesis,1315,priest,holy,60,26,34
14857,Misscure,draenor,1314,priest,holy,60,28,32
14858,Gloxina,argent-dawn,1305,priest,holy,66,34,32
14859,Catstretch,ravencrest,1300,priest,holy,89,38,51
14860,Asare,outland,1286,priest,holy,60,35,25
14861,Moirgana,minahonda,1279,priest,holy,23,14,9
14862,Draconux,terenas,1273,priest,holy,48,18,30
14863,Nosgot,earthen-ring,1272,priest,holy,60,31,29
14864,Wintercurse,twisting-nether,1272,priest,holy,52,24,28
14865,Djdesha,tarren-mill,1272,priest,holy,35,16,19
14866,Zakhun,stormrage,1271,priest,holy,82,42,40
14867,Ethery,argent-dawn,1266,priest,holy,65,33,32
14868,Lykarion,argent-dawn,1265,priest,holy,72,37,35
14869,Mylini,silvermoon,1262,priest,holy,72,39,33
14870,Возхд,soulflayer,1258,priest,holy,30,15,15
14871,Soapie,defias-brotherhood,1249,priest,holy,24,14,10
14872,Zên,argent-dawn,1248,priest,holy,21,14,7
14873,Åluneth,kazzak,1247,priest,holy,75,34,41
14874,Fabs,laughing-skull,1246,priest,holy,24,14,10
14875,Sisko,stormscale,1246,priest,holy,24,13,11
14876,Fedorah,ragnaros,1242,priest,holy,84,44,40
14877,Adare,sanguino,1241,priest,holy,30,13,17
14878,Tudiiheals,frostwolf,1236,priest,holy,39,20,19
14879,Midycine,ysondre,1235,priest,holy,75,35,40
14880,Ниеса,lich-king,1229,priest,holy,68,34,34
14881,Lómesilme,dun-modr,1226,priest,holy,24,13,11
14882,Nykah,antonidas,1224,priest,holy,61,22,39
14883,Usw,outland,1224,priest,holy,51,14,37
14884,Certe,twisting-nether,1221,priest,holy,78,31,47
14885,Morrydin,stormreaver,1217,priest,holy,48,18,30
14886,Maybelline,ravencrest,1215,priest,holy,36,16,20
14887,Пингзеро,soulflayer,1215,priest,holy,56,23,33
14888,Neenä,ravencrest,1214,priest,holy,50,25,25
14889,Harlemsfnest,blackrock,1204,priest,holy,21,13,8
14890,Скартэикс,howling-fjord,1200,priest,holy,42,20,22
14891,Torcena,garrosh,1198,priest,holy,128,66,62
14892,Kbakå,stormscale,1193,priest,holy,65,27,38
14893,Lhyria,baelgun,1189,priest,holy,48,21,27
14894,Nino,gorgonnash,1184,priest,holy,36,13,23
14895,Dathlight,argent-dawn,1183,priest,holy,71,37,34
14896,Иннерон,soulflayer,1171,priest,holy,70,33,37
14897,Meatyshaft,doomhammer,1166,priest,holy,51,19,32
14898,Asraje,eredar,1163,priest,holy,18,15,3
14899,Xzklolz,twisting-nether,1161,priest,holy,23,13,10
14900,Lyla,frostwolf,1149,priest,holy,48,27,21
14901,Преттисмайл,gordunni,1149,priest,holy,30,12,18
14902,Dúréx,sanguino,1147,priest,holy,24,18,6
14903,Alloktonos,ravencrest,1146,priest,holy,91,38,53
14904,Эилинг,gordunni,1138,priest,holy,18,12,6
14905,Pridepriest,twisting-nether,1137,priest,holy,24,12,12
14906,Andreel,ravencrest,1131,priest,holy,24,12,12
14907,Nou,aegwynn,1127,priest,holy,30,12,18
14908,Sücre,dalaran,1125,priest,holy,30,16,14
14909,Eazzyy,kazzak,1115,priest,holy,27,12,15
14910,Brigied,turalyon,1110,priest,holy,30,12,18
14911,Hara,elune,1107,priest,holy,29,12,17
14912,Morphuz,tarren-mill,1102,priest,holy,102,44,58
14913,Асггард,borean-tundra,1072,priest,holy,18,13,5
14914,Anàriel,elune,1070,priest,holy,36,13,23
14915,Lobogaust,kargath,1067,priest,holy,30,19,11
14916,Copperplume,ravenholdt,1067,priest,holy,60,21,39
14917,Covidios,twisting-nether,1056,priest,holy,51,26,25
14918,Ludriel,turalyon,1056,priest,holy,54,26,28
14919,Zen,talnivarr,1056,priest,holy,24,11,13
14920,Stickpas,ysondre,1056,priest,holy,24,11,13
14921,Boomixed,twisting-nether,1055,priest,holy,18,11,7
14922,Laewen,die-aldor,1054,priest,holy,45,22,23
14923,Тевтонка,goldrinn,1054,priest,holy,48,22,26
14924,Рейеан,soulflayer,1054,priest,holy,24,11,13
14925,Uro,tirion,1053,priest,holy,30,11,19
14926,Fjonnski,blackmoore,1050,priest,holy,18,11,7
14927,Hoeneygodx,antonidas,1050,priest,holy,24,11,13
14928,Gï,blackmoore,1048,priest,holy,18,11,7
14929,Kímbérléy,argent-dawn,1042,priest,holy,36,19,17
14930,Ломаюключики,gordunni,1042,priest,holy,39,16,23
14931,Hipnotika,nemesis,1042,priest,holy,47,17,30
14932,Leyea,kazzak,1037,priest,holy,31,15,16
14933,Türapea,draenor,1033,priest,holy,18,12,6
14934,Deeforce,argent-dawn,1019,priest,holy,79,42,37
14935,Penitence,drekthar,1018,priest,holy,26,12,14
14936,Orcü,tarren-mill,1017,priest,holy,42,18,24
14937,Ankhepope,outland,1013,priest,holy,56,33,23
14938,Dampfwalze,nozdormu,1002,priest,holy,38,19,19
14939,Siarai,pozzo-delleternità,1001,priest,holy,37,19,18
14940,Melancholly,thunderhorn,998,priest,holy,23,13,10
14941,Baabaak,frostmane,994,priest,holy,21,14,7
14942,Краббожий,greymane,987,priest,holy,29,11,18
14943,Valtessian,medivh,982,priest,holy,63,30,33
14944,Ksn,argent-dawn,959,priest,holy,24,10,14
14945,Xlhealscptn,arathor,959,priest,holy,60,19,41
14946,Kotipope,silvermoon,956,priest,holy,24,10,14
14947,Rennic,stormscale,955,priest,holy,18,10,8
14948,Sickheals,doomhammer,954,priest,holy,36,20,16
14949,Speltmor,stormscale,953,priest,holy,24,10,14
14950,Archangel,terokkar,942,priest,holy,42,22,20
14951,Kæos,blackrock,936,priest,holy,67,29,38
14952,Ripjuice,sylvanas,930,priest,holy,28,11,17
14953,Discxqt,ysondre,924,priest,holy,14,11,3
14954,Thingsy,draenor,911,priest,holy,24,10,14
14955,Eurydike,blackrock,887,priest,holy,16,10,6
14956,Jaisuu,ravencrest,864,priest,holy,12,9,3
14957,Testdeath,ravencrest,864,priest,holy,18,9,9
14958,Rhæveth,ravencrest,864,priest,holy,18,9,9
14959,Âlolexx,archimonde,863,priest,holy,12,9,3
14960,Ankî,aegwynn,863,priest,holy,18,9,9
14961,Åzjol,magtheridon,862,priest,holy,24,9,15
14962,Sodatsu,cthun,859,priest,holy,18,9,9
14963,Hyonzy,silvermoon,859,priest,holy,24,9,15
14964,Omnissiiah,silvermoon,856,priest,holy,24,9,15
14965,Melissasky,ragnaros,828,priest,holy,36,17,19
14966,Kanki,haomarush,828,priest,holy,60,25,35
14967,Infinitiy,sylvanas,827,priest,holy,18,9,9
14968,Nálá,nethersturm,805,priest,holy,22,10,12
14969,Rahela,dun-modr,793,priest,holy,17,9,8
14970,Iliridan,pozzo-delleternità,784,priest,holy,60,19,41
14971,Evílz,tarren-mill,768,priest,holy,12,8,4
14972,Ltmp,ravencrest,768,priest,holy,18,8,10
14973,Budgetdp,archimonde,768,priest,holy,18,8,10
14974,Ÿolo,nemesis,768,priest,holy,24,8,16
14975,Sak,uldaman,767,priest,holy,18,8,10
14976,Mcmuffin,runetotem,761,priest,holy,12,8,4
14977,Sohryø,drekthar,761,priest,holy,18,8,10
14978,Avinci,blackrock,757,priest,holy,18,8,10
14979,Valentinus,dragonmaw,702,priest,holy,26,8,18
14980,Mélínâ,blackmoore,691,priest,holy,28,9,19
14981,Willzah,outland,672,priest,holy,12,7,5
14982,Darkoul,conseil-des-ombres,672,priest,holy,12,7,5
14983,Ainadaxz,ravencrest,672,priest,holy,12,7,5
14984,Гшд,gordunni,672,priest,holy,12,7,5
14985,Jedimind,kazzak,672,priest,holy,12,7,5
14986,Cleoana,blackhand,672,priest,holy,12,7,5
14987,Malkàv,hyjal,672,priest,holy,12,7,5
14988,Penvon,ravencrest,672,priest,holy,24,7,17
14989,Veurjin,uldaman,671,priest,holy,12,7,5
14990,Yuhé,elune,671,priest,holy,12,7,5
14991,Cartøøns,ravencrest,671,priest,holy,12,7,5
14992,Gintøníc,blackmoore,671,priest,holy,12,7,5
14993,Хасгерион,gordunni,671,priest,holy,12,7,5
14994,Nemista,hyjal,671,priest,holy,18,7,11
14995,Thalane,das-konsortium,671,priest,holy,24,7,17
14996,Holydolly,doomhammer,669,priest,holy,12,7,5
14997,Zinary,silvermoon,667,priest,holy,18,7,11
14998,Sâtânica,kelthuzad,610,priest,holy,27,8,19
14999,Blâdes,gorgonnash,589,priest,holy,17,7,10
15000,Zoophobîa,stormscale,576,priest,holy,12,6,6
15001,Danina,outland,576,priest,holy,12,6,6
15002,Найтингеилл,gordunni,576,priest,holy,12,6,6
15003,Darkoul,ravencrest,576,priest,holy,12,6,6
15004,Nancey,draenor,576,priest,holy,12,6,6
15005,Bij,outland,576,priest,holy,12,6,6
15006,Englishheart,auchindoun,576,priest,holy,12,6,6
15007,Yamai,thrall,576,priest,holy,12,6,6
15008,Мотд,gordunni,576,priest,holy,18,6,12
15009,Nathamo,archimonde,575,priest,holy,12,6,6
15010,Spàgno,nemesis,571,priest,holy,18,6,12
15011,Dazé,ravencrest,563,priest,holy,19,9,10
15012,Bloodelfoula,draenor,563,priest,holy,18,6,12
15013,Priestxx,twilights-hammer,543,priest,holy,11,6,5
15014,Ralek,hyjal,495,priest,holy,17,6,11
15015,Felaenna,argent-dawn,480,priest,holy,6,5,1
15016,Secundis,silvermoon,480,priest,holy,6,5,1
15017,Darkoulito,dalaran,480,priest,holy,12,5,7
15018,Velenthan,ragnaros,480,priest,holy,12,5,7
15019,Quiwzx,blackrock,480,priest,holy,12,5,7
15020,Ogiez,sylvanas,480,priest,holy,12,5,7
15021,Mazeari,sylvanas,480,priest,holy,12,5,7
15022,Jagardoden,stormscale,480,priest,holy,18,5,13
15023,Nicksiz,silvermoon,479,priest,holy,12,5,7
15024,Árcadoom,quelthalas,479,priest,holy,12,5,7
15025,Двакамня,soulflayer,479,priest,holy,12,5,7
15026,Alaeddin,kazzak,479,priest,holy,24,5,19
15027,Amemiya,ragnaros,478,priest,holy,12,5,7
15028,Shanny,kazzak,384,priest,holy,6,4,2
15029,Tyene,voljin,384,priest,holy,6,4,2
15030,Yredias,dalaran,384,priest,holy,6,4,2
15031,Experimentix,silvermoon,384,priest,holy,6,4,2
15032,Skíps,sylvanas,384,priest,holy,6,4,2
15033,Arithon,blackrock,384,priest,holy,6,4,2
15034,Даймэн,gordunni,384,priest,holy,6,4,2
15035,Badguymike,ragnaros,384,priest,holy,12,4,8
15036,Lylska,stormreaver,384,priest,holy,12,4,8
15037,Gertie,blackhand,384,priest,holy,12,4,8
15038,Disillusíon,tarren-mill,384,priest,holy,12,4,8
15039,Blazekk,sylvanas,384,priest,holy,12,4,8
15040,Bebwaz,kazzak,384,priest,holy,12,4,8
15041,Vitae,gorgonnash,384,priest,holy,12,4,8
15042,Sayash,chamber-of-aspects,384,priest,holy,12,4,8
15043,Zarez,stormscale,384,priest,holy,12,4,8
15044,Flurri,tarren-mill,384,priest,holy,12,4,8
15045,Skytheory,eredar,384,priest,holy,13,4,9
15046,Ømegagødx,outland,384,priest,holy,18,4,14
15047,Ðlcz,blackrock,384,priest,holy,18,4,14
15048,Applecrumßle,ragnaros,383,priest,holy,6,4,2
15049,Ruebi,blackmoore,383,priest,holy,12,4,8
15050,Sîanah,archimonde,383,priest,holy,12,4,8
15051,Hodza,frostmane,382,priest,holy,6,4,2
15052,Sarafîsthole,ysondre,380,priest,holy,12,4,8
15053,Nxtlvl,stormscale,352,priest,holy,10,5,5
15054,Голнар,deathguard,351,priest,holy,14,5,9
15055,Shyvi,ravencrest,319,priest,holy,5,4,1
15056,Фионыч,blackscar,288,priest,holy,6,3,3
15057,Ahilarry,tarren-mill,288,priest,holy,6,3,3
15058,Jeboc,ravencrest,288,priest,holy,6,3,3
15059,Nerfnerf,kazzak,288,priest,holy,6,3,3
15060,Bobitä,ravencrest,288,priest,holy,6,3,3
15061,Caz,cthun,288,priest,holy,6,3,3
15062,Shmoly,stormscale,288,priest,holy,6,3,3
15063,Novella,kult-der-verdammten,288,priest,holy,6,3,3
15064,Goytka,tarren-mill,288,priest,holy,6,3,3
15065,Missdemerè,nemesis,288,priest,holy,6,3,3
15066,Namsolo,kazzak,288,priest,holy,6,3,3
15067,Hilerki,draenor,288,priest,holy,6,3,3
15068,Arabpriest,draenor,288,priest,holy,6,3,3
15069,Миррен,gordunni,288,priest,holy,6,3,3
15070,Drdiscospec,tarren-mill,288,priest,holy,6,3,3
15071,Blackwidow,chromaggus,288,priest,holy,6,3,3
15072,Hotforus,silvermoon,288,priest,holy,6,3,3
15073,Avelynn,ravencrest,288,priest,holy,6,3,3
15074,Góli,argent-dawn,288,priest,holy,6,3,3
15075,Ariyia,argent-dawn,288,priest,holy,6,3,3
15076,ßestworld,draenor,288,priest,holy,6,3,3
15077,Holyheartx,argent-dawn,288,priest,holy,6,3,3
15078,Bambus,shattered-hand,288,priest,holy,6,3,3
15079,Shâru,frostmourne,288,priest,holy,6,3,3
15080,Fratio,krasus,288,priest,holy,6,3,3
15081,Quami,dun-modr,288,priest,holy,12,3,9
15082,Eihran,stormscale,288,priest,holy,12,3,9
15083,Dotreveal,ravencrest,288,priest,holy,12,3,9
15084,Fatherliam,emerald-dream,288,priest,holy,12,3,9
15085,Chibrausorus,archimonde,288,priest,holy,12,3,9
15086,Protegee,draenor,288,priest,holy,12,3,9
15087,Javvi,sylvanas,288,priest,holy,12,3,9
15088,Lurri,tarren-mill,288,priest,holy,12,3,9
15089,Drminduskâ,ysondre,288,priest,holy,12,3,9
15090,Farae,arathor,288,priest,holy,24,3,21
15091,Ларуса,gordunni,287,priest,holy,6,3,3
15092,Lr,aszune,240,priest,holy,9,3,6
15093,Prästpojken,frostwhisper,192,priest,holy,6,2,4
15094,Ibunnyqt,aegwynn,192,priest,holy,6,2,4
15095,Bamboleon,blackrock,192,priest,holy,6,2,4
15096,Noukeé,blackrock,192,priest,holy,6,2,4
15097,Grøums,blackmoore,192,priest,holy,6,2,4
15098,Dami,defias-brotherhood,192,priest,holy,6,2,4
15099,Korzec,dun-modr,192,priest,holy,6,2,4
15100,Troedelsuppe,destromath,192,priest,holy,6,2,4
15101,Burnex,thrall,192,priest,holy,6,2,4
15102,Yukirito,drakthul,192,priest,holy,6,2,4
15103,Dangerfred,stormscale,192,priest,holy,6,2,4
15104,Haxxøn,die-nachtwache,192,priest,holy,6,2,4
15105,Ebolaidman,ravencrest,192,priest,holy,6,2,4
15106,Dîakon,antonidas,192,priest,holy,6,2,4
15107,Eyllise,ragnaros,192,priest,holy,6,2,4
15108,Krematorio,twisting-nether,192,priest,holy,6,2,4
15109,Nýkah,antonidas,192,priest,holy,6,2,4
15110,Discobrill,silvermoon,192,priest,holy,6,2,4
15111,Mayalolz,chogall,192,priest,holy,8,2,6
15112,Бранлор,howling-fjord,192,priest,holy,8,2,6
15113,Bøij,pozzo-delleternità,192,priest,holy,8,2,6
15114,Nøfear,tarren-mill,192,priest,holy,11,2,9
15115,Stanyú,tarren-mill,192,priest,holy,12,2,10
15116,Hónòr,sylvanas,192,priest,holy,12,2,10
15117,Gød,magtheridon,192,priest,holy,18,2,16
15118,Meynola,ysondre,191,priest,holy,6,2,4
15119,Apuessii,dun-modr,159,priest,holy,5,2,3
15120,Benificent,argent-dawn,159,priest,holy,5,2,3
15121,Spae,twisting-nether,138,priest,holy,11,4,7
15122,Isendriel,outland,96,priest,holy,6,1,5
15123,Herwin,twisting-nether,96,priest,holy,6,1,5
15124,Systerstål,twisting-nether,96,priest,holy,6,1,5
15125,Ylenae,twisting-nether,96,priest,holy,6,1,5
15126,Laadyybirkee,blackhand,96,priest,holy,6,1,5
15127,Батлджес,gordunni,96,priest,holy,6,1,5
15128,Сакредлайв,gordunni,96,priest,holy,6,1,5
15129,Lujka,outland,96,priest,holy,6,1,5
15130,Tÿona,hyjal,96,priest,holy,6,1,5
15131,Jaatjak,ravencrest,96,priest,holy,6,1,5
15132,Itstooney,doomhammer,96,priest,holy,6,1,5
15133,Pattie,ragnaros,96,priest,holy,6,1,5
15134,Larisä,uldum,96,priest,holy,6,1,5
15135,Remkoja,blackrock,96,priest,holy,6,1,5
15136,Bowie,frostwhisper,96,priest,holy,6,1,5
15137,Plaguestrike,darkspear,96,priest,holy,6,1,5
15138,Saheila,defias-brotherhood,96,priest,holy,6,1,5
15139,Zongiz,azjolnerub,96,priest,holy,6,1,5
15140,Bubbleup,defias-brotherhood,96,priest,holy,6,1,5
15141,Felvytwo,stormscale,96,priest,holy,12,1,11
15142,Syntara,twisting-nether,96,priest,holy,12,1,11
15143,Maxý,ravencrest,96,priest,holy,12,1,11
15144,Åme,kirin-tor,96,priest,holy,12,1,11
15145,Kæzm,blackrock,96,priest,holy,12,1,11
15146,Mswagner,outland,79,priest,holy,5,1,4
15147,Darkyos,azshara,42,priest,holy,6,2,4
15148,Vanostsp,kazzak,2230,priest,discipline,102,56,46
15149,Jayti,ravencrest,2205,priest,discipline,115,65,50
15150,Dripcheck,draenor,2180,priest,discipline,133,73,60
15151,Èfflux,ravencrest,2172,priest,discipline,86,54,32
15152,Bedfirez,ravencrest,2161,priest,discipline,211,122,89
15153,Holypoppa,ravencrest,2145,priest,discipline,115,64,51
15154,Saentainen,kazzak,2133,priest,discipline,95,68,27
15155,Cylizx,stormscale,2133,priest,discipline,114,62,52
15156,Jackiqt,nemesis,2132,priest,discipline,113,73,40
15157,Moonriver,archimonde,2132,priest,discipline,66,39,27
15158,Artle,sanguino,2131,priest,discipline,83,44,39
15159,Azrpr,ravencrest,2128,priest,discipline,82,45,37
15160,Vengefulmaze,ravencrest,2124,priest,discipline,96,49,47
15161,Rébörn,tarren-mill,2123,priest,discipline,71,44,27
15162,Twinkboyx,ragnaros,2121,priest,discipline,93,50,43
15163,Jidammy,ravencrest,2120,priest,discipline,80,41,39
15164,Rñd,ravencrest,2117,priest,discipline,78,40,38
15165,Gaalonikus,blackmoore,2115,priest,discipline,80,45,35
15166,Klonyaryk,ravencrest,2100,priest,discipline,78,47,31
15167,Mentalboom,emerald-dream,2090,priest,discipline,143,75,68
15168,Sèco,sylvanas,2085,priest,discipline,84,44,40
15169,Shøy,nemesis,2046,priest,discipline,78,43,35
15170,Duckiethot,twisting-nether,2039,priest,discipline,106,52,54
15171,Thelïght,ravencrest,2034,priest,discipline,111,54,57
15172,Bindw,tarren-mill,2025,priest,discipline,41,22,19
15173,Crinji,blackmoore,2021,priest,discipline,157,77,80
15174,Vajadisc,twisting-nether,2019,priest,discipline,118,52,66
15175,Разрухаз,gordunni,2017,priest,discipline,77,43,34
15176,Гопикзашквар,blackscar,2017,priest,discipline,104,47,57
15177,Priestqtx,kelthuzad,2016,priest,discipline,60,34,26
15178,Salvinia,kelthuzad,2011,priest,discipline,96,51,45
15179,Trialight,ravencrest,2009,priest,discipline,89,57,32
15180,Хомячпочка,gordunni,2003,priest,discipline,76,40,36
15181,Shmoly,stormscale,2001,priest,discipline,91,47,44
15182,Stavfel,stormscale,1993,priest,discipline,93,51,42
15183,Djsüssi,frostwolf,1989,priest,discipline,121,56,65
15184,Unréål,ravencrest,1987,priest,discipline,108,49,59
15185,Underdogx,eredar,1980,priest,discipline,109,58,51
15186,Kâiøxx,outland,1979,priest,discipline,48,31,17
15187,Dpriesta,aegwynn,1979,priest,discipline,88,52,36
15188,Acondisc,kazzak,1977,priest,discipline,76,43,33
15189,Ekman,twisting-nether,1977,priest,discipline,128,67,61
15190,Sinetrax,tarren-mill,1973,priest,discipline,96,57,39
15191,Neverdome,ravencrest,1973,priest,discipline,128,75,53
15192,Mercilégion,sargeras,1971,priest,discipline,66,34,32
15193,Eliriya,thrall,1964,priest,discipline,222,118,104
15194,Charlotten,shattered-hand,1963,priest,discipline,84,42,42
15195,Synxii,ravencrest,1961,priest,discipline,58,35,23
15196,Spinebuster,frostwolf,1958,priest,discipline,78,38,40
15197,Wetnpuffy,ravencrest,1950,priest,discipline,114,58,56
15198,Алинкалол,howling-fjord,1948,priest,discipline,162,96,66
15199,Primayodbain,archimonde,1947,priest,discipline,58,33,25
15200,Карпинчо,soulflayer,1941,priest,discipline,82,43,39
15201,Kekkons,sylvanas,1941,priest,discipline,89,46,43
15202,Ebuglatatrov,ravencrest,1941,priest,discipline,120,57,63
15203,Concetto,nazjatar,1939,priest,discipline,48,27,21
15204,Mysterymucus,draenor,1938,priest,discipline,102,61,41
15205,Porkhunt,stormscale,1938,priest,discipline,90,52,38
15206,Хомяктьмы,gordunni,1938,priest,discipline,72,37,35
15207,Senga,kazzak,1937,priest,discipline,78,38,40
15208,Summerfinn,ravencrest,1937,priest,discipline,93,44,49
15209,Önnÿ,dun-modr,1933,priest,discipline,78,39,39
15210,Psyheea,stormscale,1926,priest,discipline,139,62,77
15211,Infamoussftw,drakthul,1924,priest,discipline,96,43,53
15212,Akaria,kelthuzad,1922,priest,discipline,66,30,36
15213,Ilumiinatrix,dun-modr,1921,priest,discipline,169,86,83
15214,Фанпау,soulflayer,1919,priest,discipline,72,34,38
15215,Kleot,ragnaros,1918,priest,discipline,90,46,44
15216,Lyrvanax,ravencrest,1918,priest,discipline,205,98,107
15217,Ananous,hyjal,1917,priest,discipline,73,39,34
15218,Asanti,die-aldor,1915,priest,discipline,78,49,29
15219,Syreet,silvermoon,1915,priest,discipline,266,137,129
15220,Dermaul,kazzak,1913,priest,discipline,42,24,18
15221,Ävbmârsík,kazzak,1913,priest,discipline,89,50,39
15222,Aeogon,kazzak,1913,priest,discipline,149,68,81
15223,Lloreen,ravencrest,1905,priest,discipline,48,28,20
15224,Pheen,kazzak,1904,priest,discipline,108,55,53
15225,Georgeshxx,ravencrest,1903,priest,discipline,95,50,45
15226,Sfÿ,ysondre,1903,priest,discipline,60,28,32
15227,Свэпи,blackscar,1901,priest,discipline,59,32,27
15228,Kangaroogodx,ravencrest,1901,priest,discipline,78,35,43
15229,Dabalthazar,ravencrest,1900,priest,discipline,117,58,59
15230,Maxfly,archimonde,1898,priest,discipline,54,29,25
15231,ßrb,sylvanas,1896,priest,discipline,126,75,51
15232,Sleepypriest,frostmane,1893,priest,discipline,30,20,10
15233,Potatojuicer,argent-dawn,1893,priest,discipline,75,38,37
15234,Rippertmepls,ravencrest,1891,priest,discipline,89,52,37
15235,Разорлайтх,gordunni,1890,priest,discipline,29,21,8
15236,Мамкалол,soulflayer,1888,priest,discipline,204,105,99
15237,Ronnyvandamm,destromath,1887,priest,discipline,88,58,30
15238,Voxtwo,blackrock,1887,priest,discipline,42,26,16
15239,Xghj,sylvanas,1887,priest,discipline,72,36,36
15240,Clapped,ravencrest,1887,priest,discipline,72,32,40
15241,Nêxt,ravencrest,1884,priest,discipline,60,42,18
15242,Asdfghqwezxc,twisting-nether,1884,priest,discipline,53,30,23
15243,Spaanseslof,silvermoon,1884,priest,discipline,78,39,39
15244,Neffty,aegwynn,1882,priest,discipline,114,61,53
15245,Norganp,die-aldor,1881,priest,discipline,50,31,19
15246,Voideffsucks,stormscale,1881,priest,discipline,60,32,28
15247,Mavisqt,draenor,1880,priest,discipline,42,24,18
15248,Merylle,ragnaros,1880,priest,discipline,60,29,31
15249,Ziknait,sargeras,1879,priest,discipline,48,29,19
15250,Elethia,blackmoore,1872,priest,discipline,38,21,17
15251,Verti,outland,1872,priest,discipline,89,41,48
15252,Discishârd,ravencrest,1871,priest,discipline,99,50,49
15253,Egî,azshara,1870,priest,discipline,42,20,22
15254,Saniqt,kazzak,1865,priest,discipline,57,35,22
15255,Mswagner,outland,1864,priest,discipline,36,20,16
15256,Painchampion,draenor,1864,priest,discipline,54,23,31
15257,Gerryqt,draenor,1863,priest,discipline,48,26,22
15258,Asyncx,ravencrest,1862,priest,discipline,68,35,33
15259,Flao,ravencrest,1860,priest,discipline,52,28,24
15260,Кошечка,deathguard,1860,priest,discipline,41,21,20
15261,Thalanas,ravencrest,1859,priest,discipline,158,90,68
15262,Sublab,kazzak,1859,priest,discipline,60,33,27
15263,Citadelle,blackmoore,1858,priest,discipline,59,36,23
15264,Мефодийприст,howling-fjord,1858,priest,discipline,102,62,40
15265,Wernou,archimonde,1858,priest,discipline,48,29,19
15266,Bigextendo,blackmoore,1857,priest,discipline,66,35,31
15267,Unfaithful,twisting-nether,1854,priest,discipline,70,43,27
15268,Rlyeh,argent-dawn,1854,priest,discipline,54,30,24
15269,Sdn,twisting-nether,1853,priest,discipline,64,36,28
15270,Dieterdose,tarren-mill,1852,priest,discipline,44,29,15
15271,Rynnegan,zuljin,1849,priest,discipline,72,31,41
15272,Jacknapier,kazzak,1848,priest,discipline,36,24,12
15273,Çhåosgòddess,kazzak,1848,priest,discipline,42,25,17
15274,Oioiio,kazzak,1846,priest,discipline,72,33,39
15275,Andrë,ragnaros,1845,priest,discipline,46,29,17
15276,Jagardoden,stormscale,1845,priest,discipline,59,33,26
15277,Leahbtw,ravencrest,1844,priest,discipline,54,30,24
15278,Soyloverjuan,auchindoun,1843,priest,discipline,52,27,25
15279,Bæsts,ravencrest,1842,priest,discipline,47,35,12
15280,Minilove,ravencrest,1842,priest,discipline,36,22,14
15281,Ostrogami,silvermoon,1842,priest,discipline,232,112,120
15282,Hamsicam,frostwolf,1842,priest,discipline,116,56,60
15283,Kianprie,silvermoon,1842,priest,discipline,101,46,55
15284,Cdplz,archimonde,1841,priest,discipline,107,52,55
15285,Mend,tarren-mill,1841,priest,discipline,77,34,43
15286,Kàrèm,blutkessel,1839,priest,discipline,48,28,20
15287,Shîn,zirkel-des-cenarius,1839,priest,discipline,72,32,40
15288,Втильте,blackscar,1838,priest,discipline,138,77,61
15289,Андерприст,soulflayer,1838,priest,discipline,116,64,52
15290,Sheelah,ravencrest,1838,priest,discipline,66,32,34
15291,Nasdaq,ravencrest,1837,priest,discipline,60,30,30
15292,Azoran,dentarg,1836,priest,discipline,72,33,39
15293,Nevercared,aegwynn,1835,priest,discipline,30,25,5
15294,Shonsized,argent-dawn,1835,priest,discipline,142,82,60
15295,Видзар,blackscar,1834,priest,discipline,42,27,15
15296,Alwaysøøm,kazzak,1834,priest,discipline,120,77,43
15297,Goldensp,sanguino,1834,priest,discipline,75,42,33
15298,Owrly,bladefist,1833,priest,discipline,166,85,81
15299,Azaciúx,sylvanas,1832,priest,discipline,48,29,19
15300,Feeqamikka,ragnaros,1832,priest,discipline,61,32,29
15301,Sazuki,sylvanas,1830,priest,discipline,119,71,48
15302,Kaizza,burning-legion,1829,priest,discipline,48,30,18
15303,Alusiepriest,ravencrest,1829,priest,discipline,164,102,62
15304,Mainputa,pozzo-delleternità,1829,priest,discipline,58,28,30
15305,Akeno,sylvanas,1829,priest,discipline,70,31,39
15306,Pradrak,eredar,1828,priest,discipline,54,31,23
15307,Chivalryy,argent-dawn,1828,priest,discipline,119,64,55
15308,Jconnelly,antonidas,1828,priest,discipline,62,32,30
15309,Chasx,ravencrest,1828,priest,discipline,65,30,35
15310,Ltmp,ravencrest,1827,priest,discipline,48,24,24
15311,Nadøney,hyjal,1826,priest,discipline,172,87,85
15312,Eau,quelthalas,1826,priest,discipline,64,30,34
15313,Sinetrax,draenor,1825,priest,discipline,48,30,18
15314,Sathie,ravencrest,1825,priest,discipline,60,29,31
15315,Ayõu,ravencrest,1824,priest,discipline,60,36,24
15316,Nalakis,archimonde,1824,priest,discipline,109,62,47
15317,Collinna,aegwynn,1824,priest,discipline,105,57,48
15318,Sláin,outland,1824,priest,discipline,54,29,25
15319,Lanata,blackrock,1823,priest,discipline,60,34,26
15320,Мухаглот,soulflayer,1823,priest,discipline,71,37,34
15321,Ihefyehvjrm,ravencrest,1823,priest,discipline,83,41,42
15322,Mamaa,stormscale,1822,priest,discipline,72,40,32
15323,Rickerstrike,stormscale,1822,priest,discipline,90,47,43
15324,Tecc,draenor,1822,priest,discipline,130,65,65
15325,Georgesheenx,ravencrest,1822,priest,discipline,124,58,66
15326,Mèlindra,tarren-mill,1821,priest,discipline,35,28,7
15327,Билет,borean-tundra,1821,priest,discipline,42,26,16
15328,Aâraks,khaz-modan,1821,priest,discipline,134,82,52
15329,Virulence,twisting-nether,1821,priest,discipline,193,108,85
15330,Mommymilkrx,argent-dawn,1821,priest,discipline,239,124,115
15331,Miklós,die-aldor,1821,priest,discipline,54,28,26
15332,Racecar,executus,1821,priest,discipline,132,66,66
15333,Flongoletta,xavius,1821,priest,discipline,54,25,29
15334,Прощайдуде,gordunni,1820,priest,discipline,47,26,21
15335,Enteja,outland,1820,priest,discipline,287,148,139
15336,Kripteksx,ravencrest,1819,priest,discipline,47,27,20
15337,Омилая,gordunni,1819,priest,discipline,42,24,18
15338,Дорогасмеха,howling-fjord,1819,priest,discipline,66,36,30
15339,Vibéz,outland,1819,priest,discipline,54,27,27
15340,Лёнятреппер,blackscar,1818,priest,discipline,93,53,40
15341,Egi,lothar,1818,priest,discipline,51,27,24
15342,Monsterzx,outland,1818,priest,discipline,90,44,46
15343,Spiritina,darkmoon-faire,1817,priest,discipline,76,52,24
15344,Holycuddles,ysondre,1817,priest,discipline,78,47,31
15345,Lakeworth,argent-dawn,1817,priest,discipline,104,48,56
15346,Hanniri,archimonde,1816,priest,discipline,48,28,20
15347,Aenon,argent-dawn,1816,priest,discipline,129,72,57
15348,Thaeres,stormscale,1816,priest,discipline,65,31,34
15349,Оченьнеочень,howling-fjord,1816,priest,discipline,72,33,39
15350,Moglimeister,blackrock,1815,priest,discipline,42,27,15
15351,Jowaba,ravencrest,1815,priest,discipline,60,38,22
15352,Виллавелл,blackscar,1815,priest,discipline,48,24,24
15353,Svakkanxd,kazzak,1815,priest,discipline,58,27,31
15354,Zyzx,blackrock,1815,priest,discipline,66,29,37
15355,Neliica,silvermoon,1815,priest,discipline,60,26,34
15356,Discusting,anachronos,1814,priest,discipline,66,34,32
15357,Фенджидисплх,blackscar,1814,priest,discipline,78,37,41
15358,Debeo,ragnaros,1812,priest,discipline,75,44,31
15359,Elataqt,silvermoon,1812,priest,discipline,79,45,34
15360,Eedazap,argent-dawn,1812,priest,discipline,58,32,26
15361,ßlinkytwinky,outland,1812,priest,discipline,36,19,17
15362,Discoqt,aegwynn,1812,priest,discipline,60,30,30
15363,Isalvation,stormscale,1812,priest,discipline,78,38,40
15364,Mïserygødx,nemesis,1811,priest,discipline,84,57,27
15365,Maxmoto,blackrock,1811,priest,discipline,92,56,36
15366,Yzïam,ravencrest,1811,priest,discipline,45,27,18
15367,Cæsifer,blackrock,1811,priest,discipline,100,55,45
15368,Leahuwu,ravencrest,1811,priest,discipline,72,37,35
15369,Arthezz,ravencrest,1811,priest,discipline,80,40,40
15370,Miraña,kazzak,1810,priest,discipline,24,19,5
15371,Øxxgodx,blackrock,1810,priest,discipline,81,43,38
15372,Wet,twisting-nether,1810,priest,discipline,66,29,37
15373,Xrq,stormscale,1809,priest,discipline,36,27,9
15374,Джагонх,soulflayer,1809,priest,discipline,60,31,29
15375,Comedii,blackmoore,1809,priest,discipline,261,132,129
15376,Kuxk,stormscale,1809,priest,discipline,48,24,24
15377,Stola,archimonde,1809,priest,discipline,101,41,60
15378,Xutira,silvermoon,1808,priest,discipline,195,109,86
15379,Ohlinsqt,outland,1808,priest,discipline,66,36,30
15380,Фастэксп,razuvious,1808,priest,discipline,60,31,29
15381,Aprilfalls,blackmoore,1808,priest,discipline,54,25,29
15382,Råcòøñ,ravencrest,1808,priest,discipline,42,19,23
15383,Ÿolo,nemesis,1807,priest,discipline,80,47,33
15384,Seasonf,tarren-mill,1807,priest,discipline,60,28,32
15385,Izzý,antonidas,1806,priest,discipline,30,19,11
15386,Zarahard,draenor,1806,priest,discipline,120,65,55
15387,Zeruhphin,eredar,1806,priest,discipline,54,28,26
15388,Brigittë,ravencrest,1806,priest,discipline,66,29,37
15389,Mentalist,dun-modr,1806,priest,discipline,81,33,48
15390,Светжрец,blackscar,1805,priest,discipline,36,26,10
15391,Tattum,ragnaros,1805,priest,discipline,84,57,27
15392,Pricemg,thrall,1805,priest,discipline,42,26,16
15393,Поршкаенн,gordunni,1805,priest,discipline,60,32,28
15394,Andaar,ravencrest,1805,priest,discipline,60,32,28
15395,Шкурюклады,gordunni,1805,priest,discipline,60,27,33
15396,Ïcön,ravencrest,1804,priest,discipline,60,43,17
15397,Boltygnome,blades-edge,1804,priest,discipline,30,19,11
15398,Bennyjamin,kazzak,1804,priest,discipline,74,45,29
15399,Floyyd,kazzak,1804,priest,discipline,42,24,18
15400,Remkoja,blackrock,1804,priest,discipline,102,52,50
15401,Chaxxpriest,blackrock,1804,priest,discipline,101,45,56
15402,Gehrke,silvermoon,1803,priest,discipline,105,51,54
15403,Faderfarbror,tarren-mill,1802,priest,discipline,97,59,38
15404,Галюхах,soulflayer,1802,priest,discipline,36,19,17
15405,Bassepriest,tarren-mill,1802,priest,discipline,101,53,48
15406,Cx,mazrigos,1801,priest,discipline,65,42,23
15407,Shínx,illidan,1801,priest,discipline,90,52,38
15408,Artístx,twisting-nether,1801,priest,discipline,53,29,24
15409,Rngånxiety,ravencrest,1801,priest,discipline,60,28,32
15410,Wardshield,ravencrest,1800,priest,discipline,29,20,9
15411,Felwy,stormscale,1800,priest,discipline,48,31,17
15412,Mautiya,blackrock,1800,priest,discipline,96,52,44
15413,Соникида,gordunni,1800,priest,discipline,70,36,34
15414,Некрогуро,gordunni,1800,priest,discipline,54,27,27
15415,Lazyx,tarren-mill,1800,priest,discipline,59,29,30
15416,Prsx,ravencrest,1798,priest,discipline,54,28,26
15417,Gaussqt,ravencrest,1797,priest,discipline,78,39,39
15418,Niniell,blackmoore,1796,priest,discipline,54,34,20
15419,Bigballer,stormscale,1795,priest,discipline,51,26,25
15420,Healseri,defias-brotherhood,1794,priest,discipline,114,56,58
15421,Legiondisc,blackmoore,1794,priest,discipline,151,69,82
15422,Некронево,howling-fjord,1793,priest,discipline,45,27,18
15423,Thedisco,kazzak,1792,priest,discipline,72,49,23
15424,Evpisces,archimonde,1792,priest,discipline,207,96,111
15425,Tacochrist,kazzak,1789,priest,discipline,65,35,30
15426,Hopesallgone,stormscale,1787,priest,discipline,96,58,38
15427,Touchmypink,ragnaros,1785,priest,discipline,96,43,53
15428,Anheduanna,outland,1783,priest,discipline,237,122,115
15429,Abømination,hyjal,1782,priest,discipline,93,56,37
15430,Dreifearfünf,arygos,1778,priest,discipline,84,48,36
15431,Scortie,blackrock,1771,priest,discipline,37,21,16
15432,Roxeal,archimonde,1770,priest,discipline,174,100,74
15433,Sekker,silvermoon,1770,priest,discipline,232,125,107
15434,Fitu,drakthul,1770,priest,discipline,83,42,41
15435,Src,ravencrest,1768,priest,discipline,48,29,19
15436,Maulerion,tarren-mill,1768,priest,discipline,72,40,32
15437,Wóllo,stormscale,1767,priest,discipline,42,23,19
15438,Magetrainer,tarren-mill,1765,priest,discipline,60,42,18
15439,Talbyslegacý,blackmoore,1764,priest,discipline,84,47,37
15440,Nissha,stormscale,1764,priest,discipline,60,28,32
15441,Aruna,ravencrest,1761,priest,discipline,70,35,35
15442,Нед,greymane,1759,priest,discipline,207,119,88
15443,Ironqt,malfurion,1758,priest,discipline,112,48,64
15444,Rpriest,outland,1757,priest,discipline,42,25,17
15445,Aòo,twisting-nether,1756,priest,discipline,60,29,31
15446,Slimcharles,ravencrest,1755,priest,discipline,155,89,66
15447,Merylle,outland,1751,priest,discipline,41,27,14
15448,Mautijr,blackrock,1751,priest,discipline,201,117,84
15449,Swoptoplong,blackhand,1751,priest,discipline,360,193,167
15450,Kimspriest,ragnaros,1751,priest,discipline,36,19,17
15451,Уровеньб,soulflayer,1750,priest,discipline,42,22,20
15452,Yunusgødx,kazzak,1748,priest,discipline,72,47,25
15453,Stazqt,conseil-des-ombres,1747,priest,discipline,136,69,67
15454,Nooxid,eredar,1746,priest,discipline,130,70,60
15455,Devoura,sylvanas,1746,priest,discipline,48,23,25
15456,Mystz,dun-modr,1744,priest,discipline,63,34,29
15457,Wangewover,ravencrest,1744,priest,discipline,87,46,41
15458,Giatros,kazzak,1743,priest,discipline,48,25,23
15459,Artle,dun-modr,1741,priest,discipline,24,20,4
15460,Holytop,aegwynn,1740,priest,discipline,48,25,23
15461,Ssjfoxyo,sylvanas,1740,priest,discipline,62,27,35
15462,Xeldrania,azshara,1739,priest,discipline,41,22,19
15463,Justyø,archimonde,1738,priest,discipline,148,88,60
15464,Ingelosi,eredar,1736,priest,discipline,154,82,72
15465,Xzep,archimonde,1736,priest,discipline,133,69,64
15466,Milania,ravencrest,1735,priest,discipline,66,35,31
15467,Фокусшвд,soulflayer,1735,priest,discipline,132,68,64
15468,Tanlytwo,ravencrest,1735,priest,discipline,46,22,24
15469,Iwariel,blackmoore,1734,priest,discipline,78,39,39
15470,Kuusistöö,kazzak,1733,priest,discipline,54,28,26
15471,Drillin,ravencrest,1731,priest,discipline,42,19,23
15472,Doublefreak,draenor,1730,priest,discipline,48,31,17
15473,Fandac,sylvanas,1730,priest,discipline,48,29,19
15474,Смотривнебоь,soulflayer,1730,priest,discipline,63,32,31
15475,Snuskong,kazzak,1730,priest,discipline,54,25,29
15476,Emryth,blackhand,1729,priest,discipline,234,118,116
15477,Akzar,blackrock,1728,priest,discipline,303,161,142
15478,Denunciation,argent-dawn,1727,priest,discipline,191,101,90
15479,Prips,bladefist,1725,priest,discipline,213,108,105
15480,Holymoly,talnivarr,1725,priest,discipline,84,37,47
15481,Twinkerz,ravencrest,1724,priest,discipline,72,44,28
15482,Ipâ,hyjal,1724,priest,discipline,143,65,78
15483,Justdänce,hyjal,1723,priest,discipline,46,23,23
15484,Holyshiiet,stormscale,1722,priest,discipline,57,36,21
15485,Healêl,sanguino,1721,priest,discipline,54,26,28
15486,Gothicpriest,blackrock,1720,priest,discipline,42,25,17
15487,Folelli,ysondre,1720,priest,discipline,113,58,55
15488,Smilézz,eredar,1720,priest,discipline,66,32,34
15489,Kedrack,draenor,1719,priest,discipline,42,27,15
15490,Leffie,outland,1719,priest,discipline,51,26,25
15491,Eukmassus,archimonde,1719,priest,discipline,58,29,29
15492,Mndvx,sylvanas,1718,priest,discipline,60,29,31
15493,Ashenflexj,draenor,1718,priest,discipline,111,53,58
15494,Kàalyx,archimonde,1718,priest,discipline,66,31,35
15495,Mixoo,throkferoth,1718,priest,discipline,84,36,48
15496,Keryin,draenor,1718,priest,discipline,109,45,64
15497,Deadandugly,eredar,1718,priest,discipline,48,19,29
15498,Chèéks,kazzak,1717,priest,discipline,60,40,20
15499,Èightsix,draenor,1717,priest,discipline,119,71,48
15500,Psjk,blackrock,1717,priest,discipline,41,22,19
15501,Билетлолпро,borean-tundra,1717,priest,discipline,42,21,21
15502,Scaryolol,blackmoore,1717,priest,discipline,143,69,74
15503,Cylantharia,eredar,1716,priest,discipline,102,57,45
15504,Smiteyoudown,blackrock,1716,priest,discipline,42,21,21
15505,Berseenreikä,the-venture-co,1715,priest,discipline,48,24,24
15506,Scarletstory,ravencrest,1715,priest,discipline,130,63,67
15507,Артжрец,soulflayer,1713,priest,discipline,76,43,33
15508,Mitha,tarren-mill,1713,priest,discipline,74,41,33
15509,Abudhabi,blackhand,1713,priest,discipline,264,136,128
15510,Assiduous,stormreaver,1712,priest,discipline,34,21,13
15511,Анстахоуп,grom,1708,priest,discipline,120,80,40
15512,Kèvin,das-syndikat,1707,priest,discipline,71,43,28
15513,Kijhun,uldaman,1707,priest,discipline,72,40,32
15514,Mafakor,ravencrest,1707,priest,discipline,78,34,44
15515,Vigodis,alleria,1706,priest,discipline,103,63,40
15516,Cyabish,twisting-nether,1706,priest,discipline,78,44,34
15517,Yukasa,silvermoon,1705,priest,discipline,78,34,44
15518,Kaldhor,ysondre,1705,priest,discipline,71,29,42
15519,Ðês,ravencrest,1703,priest,discipline,30,18,12
15520,Убикрофт,soulflayer,1703,priest,discipline,49,24,25
15521,Grouptherpst,draenor,1703,priest,discipline,142,66,76
15522,Вашачесть,gordunni,1702,priest,discipline,114,59,55
15523,Swdjack,blackrock,1702,priest,discipline,156,78,78
15524,Deathgodx,archimonde,1701,priest,discipline,80,43,37
15525,Znàdix,silvermoon,1701,priest,discipline,170,89,81
15526,Gurgaue,argent-dawn,1701,priest,discipline,53,24,29
15527,Elsieexø,ravencrest,1700,priest,discipline,48,21,27
15528,Kollis,twilights-hammer,1699,priest,discipline,147,76,71
15529,Lorimac,dun-modr,1699,priest,discipline,111,55,56
15530,Verjin,kazzak,1699,priest,discipline,90,36,54
15531,Ampara,thrall,1698,priest,discipline,72,35,37
15532,Areyqt,ravencrest,1697,priest,discipline,36,22,14
15533,Gòldfinger,norgannon,1697,priest,discipline,162,76,86
15534,Døppëlápfèl,tarren-mill,1696,priest,discipline,30,20,10
15535,Cptisus,draenor,1696,priest,discipline,72,31,41
15536,Tÿona,hyjal,1695,priest,discipline,134,78,56
15537,Swdommeil,aegwynn,1695,priest,discipline,48,24,24
15538,Alicewhydel,blackhand,1694,priest,discipline,36,18,18
15539,Deepsea,kazzak,1694,priest,discipline,212,103,109
15540,Flào,draenor,1694,priest,discipline,42,20,22
15541,Лизагодх,howling-fjord,1693,priest,discipline,61,32,29
15542,Сонясоукьют,gordunni,1693,priest,discipline,54,26,28
15543,Elsuzette,hyjal,1692,priest,discipline,34,21,13
15544,Verweven,twisting-nether,1692,priest,discipline,47,26,21
15545,Aelisendi,draenor,1692,priest,discipline,53,28,25
15546,Pierrebourne,blackmoore,1692,priest,discipline,48,23,25
15547,Apuessii,dun-modr,1692,priest,discipline,65,28,37
15548,Blazingad,kazzak,1691,priest,discipline,149,75,74
15549,Samaya,blackrock,1691,priest,discipline,92,41,51
15550,Rêstlêss,blackrock,1690,priest,discipline,65,36,29
15551,Utrd,kazzak,1690,priest,discipline,126,58,68
15552,Rhauru,tyrande,1690,priest,discipline,48,20,28
15553,Шестьнадцать,gordunni,1689,priest,discipline,107,60,47
15554,Swdswdswdswd,blackmoore,1689,priest,discipline,47,21,26
15555,Афганский,gordunni,1688,priest,discipline,46,24,22
15556,Аскеронх,howling-fjord,1688,priest,discipline,54,23,31
15557,Hrtbrxkn,ravencrest,1687,priest,discipline,64,39,25
15558,Wérrýxs,kazzak,1687,priest,discipline,142,80,62
15559,Pinipom,kazzak,1686,priest,discipline,26,19,7
15560,Vänskap,kazzak,1684,priest,discipline,42,23,19
15561,Awcute,kazzak,1684,priest,discipline,161,79,82
15562,Roshmanoff,stormscale,1683,priest,discipline,36,18,18
15563,Barackomana,blackrock,1683,priest,discipline,114,53,61
15564,Hwren,auchindoun,1682,priest,discipline,90,41,49
15565,Kevinsorbo,destromath,1681,priest,discipline,36,20,16
15566,Lizka,kazzak,1681,priest,discipline,54,26,28
15567,Donipriest,ravencrest,1680,priest,discipline,66,39,27
15568,Ljusmor,silvermoon,1680,priest,discipline,57,33,24
15569,Tricavla,frostmane,1679,priest,discipline,72,38,34
15570,Hoses,twisting-nether,1679,priest,discipline,88,42,46
15571,Mohammedx,tarren-mill,1678,priest,discipline,42,19,23
15572,Sutenör,kazzak,1678,priest,discipline,108,43,65
15573,Nihpolz,ragnaros,1677,priest,discipline,39,24,15
15574,Bercxu,ragnaros,1677,priest,discipline,81,45,36
15575,Savagex,dun-modr,1677,priest,discipline,72,40,32
15576,Шайтсунг,soulflayer,1677,priest,discipline,56,30,26
15577,Дъикиймвп,deepholm,1676,priest,discipline,36,20,16
15578,Clownspec,twisting-nether,1676,priest,discipline,54,26,28
15579,Mindx,sylvanas,1676,priest,discipline,72,33,39
15580,Holytopp,aegwynn,1675,priest,discipline,42,25,17
15581,Файкахохо,soulflayer,1675,priest,discipline,59,24,35
15582,Blackbertha,ravencrest,1674,priest,discipline,138,64,74
15583,Scurrp,aegwynn,1673,priest,discipline,72,36,36
15584,Scarified,aggramar,1673,priest,discipline,48,23,25
15585,Eluveitieq,kazzak,1672,priest,discipline,77,44,33
15586,Ladderpolice,blackmoore,1672,priest,discipline,42,22,20
15587,Свдпро,soulflayer,1672,priest,discipline,35,18,17
15588,Byef,kazzak,1671,priest,discipline,56,31,25
15589,Anotu,tarren-mill,1670,priest,discipline,36,21,15
15590,Devotedape,draenor,1670,priest,discipline,53,30,23
15591,Zaak,kazzak,1670,priest,discipline,59,26,33
15592,Walkmydome,twisting-nether,1669,priest,discipline,114,59,55
15593,Lobbygriefer,ravencrest,1668,priest,discipline,143,76,67
15594,Lindvorm,tarren-mill,1667,priest,discipline,120,61,59
15595,Loví,twisting-nether,1666,priest,discipline,48,22,26
15596,Salvatíon,sanguino,1666,priest,discipline,236,105,131
15597,Bambus,shattered-hand,1665,priest,discipline,36,23,13
15598,Dállas,ravencrest,1664,priest,discipline,36,23,13
15599,Worldgamer,blackrock,1664,priest,discipline,84,43,41
15600,Duelistfied,blackrock,1664,priest,discipline,39,19,20
15601,Gepeitschter,frostwolf,1662,priest,discipline,108,59,49
15602,Sikaanyo,blackhand,1662,priest,discipline,66,35,31
15603,Cätälin,twisting-nether,1662,priest,discipline,181,88,93
15604,Kaksel,blackrock,1661,priest,discipline,72,38,34
15605,Fearxyz,aegwynn,1661,priest,discipline,48,22,26
15606,Krystynal,archimonde,1659,priest,discipline,47,24,23
15607,Nzothapostle,baelgun,1659,priest,discipline,90,41,49
15608,Seranà,hyjal,1658,priest,discipline,96,51,45
15609,Xangha,burning-legion,1658,priest,discipline,228,117,111
15610,Dispelgodxx,eredar,1658,priest,discipline,54,25,29
15611,Ew,shattered-halls,1658,priest,discipline,58,26,32
15612,Trashedd,outland,1658,priest,discipline,54,22,32
15613,Nyxoqtxd,ravencrest,1657,priest,discipline,76,43,33
15614,Karanas,archimonde,1657,priest,discipline,42,21,21
15615,Nocdsusage,draenor,1656,priest,discipline,192,95,97
15616,Kaleycuoco,blackrock,1656,priest,discipline,78,36,42
15617,Эвэргарден,eversong,1655,priest,discipline,54,20,34
15618,Yënâs,hyjal,1654,priest,discipline,91,57,34
15619,Hellhammer,stormreaver,1654,priest,discipline,102,50,52
15620,Киллус,ashenvale,1654,priest,discipline,60,25,35
15621,Krottus,antonidas,1653,priest,discipline,36,20,16
15622,Йефа,gordunni,1653,priest,discipline,42,23,19
15623,Efeslol,dun-modr,1653,priest,discipline,96,48,48
15624,Healdeal,stormscale,1653,priest,discipline,178,84,94
15625,Mopriest,eredar,1652,priest,discipline,36,24,12
15626,Tryhàrdx,stormscale,1652,priest,discipline,54,25,29
15627,Yûnalescá,blackmoore,1651,priest,discipline,76,42,34
15628,Illuminarexo,sylvanas,1651,priest,discipline,65,34,31
15629,Qhub,sylvanas,1650,priest,discipline,90,47,43
15630,Yugemilkers,kazzak,1650,priest,discipline,74,37,37
15631,Dendegodx,kazzak,1650,priest,discipline,48,24,24
15632,Arlekin,ravencrest,1649,priest,discipline,72,47,25
15633,Mnu,blackrock,1649,priest,discipline,46,28,18
15634,Zoophobîa,stormscale,1649,priest,discipline,42,22,20
15635,Violentha,kazzak,1649,priest,discipline,96,50,46
15636,Элишана,deathguard,1649,priest,discipline,111,54,57
15637,Wonderdispel,ragnaros,1649,priest,discipline,78,31,47
15638,Angrypiex,stormscale,1648,priest,discipline,41,21,20
15639,Двачх,soulflayer,1648,priest,discipline,48,22,26
15640,Immortalled,twisting-nether,1647,priest,discipline,102,49,53
15641,Naphell,outland,1647,priest,discipline,72,34,38
15642,Sills,twisting-nether,1647,priest,discipline,53,23,30
15643,Følísh,hyjal,1646,priest,discipline,54,38,16
15644,Géèk,alakir,1646,priest,discipline,46,27,19
15645,Tøxicboy,ravencrest,1646,priest,discipline,89,48,41
15646,Watchmedark,ravencrest,1646,priest,discipline,42,21,21
15647,Cathocrasty,draenor,1644,priest,discipline,69,40,29
15648,Syntara,twisting-nether,1644,priest,discipline,175,96,79
15649,Rmt,darksorrow,1644,priest,discipline,42,23,19
15650,Репабликуес,gordunni,1641,priest,discipline,36,18,18
15651,Duqes,stormreaver,1640,priest,discipline,24,19,5
15652,Xtracheesy,ragnaros,1640,priest,discipline,72,45,27
15653,Priewyn,ragnaros,1640,priest,discipline,114,61,53
15654,Imsaltyxd,tarren-mill,1639,priest,discipline,36,22,14
15655,Шаастраха,gordunni,1639,priest,discipline,50,22,28
15656,Mantra,blackmoore,1638,priest,discipline,42,23,19
15657,Dzyxx,ravencrest,1638,priest,discipline,42,23,19
15658,Felaenna,argent-dawn,1638,priest,discipline,88,43,45
15659,Vorynax,silvermoon,1637,priest,discipline,56,31,25
15660,Miikkap,blackhand,1637,priest,discipline,48,26,22
15661,Schlämpie,blackmoore,1637,priest,discipline,67,29,38
15662,Mentaldeadp,draenor,1636,priest,discipline,82,50,32
15663,Ванальная,soulflayer,1636,priest,discipline,42,21,21
15664,Marôs,antonidas,1636,priest,discipline,54,23,31
15665,Простосори,gordunni,1635,priest,discipline,378,186,192
15666,Yugata,archimonde,1635,priest,discipline,45,19,26
15667,Tylér,stormscale,1634,priest,discipline,48,29,19
15668,Аая,blackscar,1634,priest,discipline,96,49,47
15669,Amtoxic,stormscale,1634,priest,discipline,311,155,156
15670,Wasnezov,blackhand,1634,priest,discipline,70,32,38
15671,Glyss,draenor,1633,priest,discipline,42,24,18
15672,Диспайзх,gordunni,1633,priest,discipline,114,53,61
15673,Аэтпио,soulflayer,1633,priest,discipline,54,23,31
15674,Yameru,stormreaver,1633,priest,discipline,60,22,38
15675,Misántropo,dun-modr,1632,priest,discipline,59,38,21
15676,Keyfear,kazzak,1632,priest,discipline,63,36,27
15677,Mythrixia,draenor,1632,priest,discipline,52,29,23
15678,Sakulus,malganis,1632,priest,discipline,42,21,21
15679,Ahpøual,archimonde,1632,priest,discipline,168,82,86
15680,Ankus,tarren-mill,1631,priest,discipline,48,23,25
15681,Zloyvrach,ravencrest,1630,priest,discipline,54,25,29
15682,Botstyleswdx,ravencrest,1630,priest,discipline,112,51,61
15683,Fricia,zuljin,1629,priest,discipline,53,32,21
15684,Inoru,stormreaver,1629,priest,discipline,78,41,37
15685,Acidrops,hyjal,1629,priest,discipline,48,22,26
15686,Frojka,outland,1629,priest,discipline,42,19,23
15687,Ödriaell,the-venture-co,1629,priest,discipline,48,21,27
15688,Leviakerman,blackrock,1628,priest,discipline,42,18,24
15689,Sølvfox,stormscale,1627,priest,discipline,42,25,17
15690,Aleluia,alonsus,1627,priest,discipline,99,43,56
15691,Хомие,soulflayer,1626,priest,discipline,85,44,41
15692,Élsias,blackmoore,1626,priest,discipline,42,21,21
15693,Spìrít,ghostlands,1626,priest,discipline,42,20,22
15694,Eestpr,tarren-mill,1626,priest,discipline,45,20,25
15695,Pestmorran,sylvanas,1626,priest,discipline,150,66,84
15696,Jtî,ravencrest,1625,priest,discipline,30,20,10
15697,Discxqt,ysondre,1625,priest,discipline,83,51,32
15698,Pepeflex,draenor,1625,priest,discipline,79,38,41
15699,Bijaqt,blackmoore,1625,priest,discipline,42,17,25
15700,Demora,ysondre,1624,priest,discipline,24,17,7
15701,Garsdal,tarren-mill,1624,priest,discipline,78,43,35
15702,Пристижнаяя,gordunni,1624,priest,discipline,50,25,25
15703,Echonic,aegwynn,1624,priest,discipline,111,51,60
15704,Wifta,ravencrest,1623,priest,discipline,36,21,15
15705,Rezzurrectum,doomhammer,1623,priest,discipline,36,20,16
15706,Мплехибои,gordunni,1622,priest,discipline,54,30,24
15707,Såra,ravencrest,1622,priest,discipline,48,22,26
15708,Двелегитоп,howling-fjord,1621,priest,discipline,36,23,13
15709,Zinzor,archimonde,1621,priest,discipline,61,37,24
15710,Líluqt,sanguino,1621,priest,discipline,30,17,13
15711,Babybelle,arakarahm,1621,priest,discipline,61,33,28
15712,Carnegi,burning-legion,1621,priest,discipline,54,28,26
15713,Mindfiend,stormscale,1621,priest,discipline,81,37,44
15714,Veltrag,sanguino,1620,priest,discipline,48,31,17
15715,Dhassy,sanguino,1620,priest,discipline,35,21,14
15716,Hukkuvahirvi,ravencrest,1620,priest,discipline,48,20,28
15717,Outtloor,twisting-nether,1619,priest,discipline,39,25,14
15718,Aêalama,argent-dawn,1619,priest,discipline,36,17,19
15719,Mønsterx,kazzak,1618,priest,discipline,64,37,27
15720,Mobcal,twisting-nether,1618,priest,discipline,42,17,25
15721,Edoran,ragnaros,1617,priest,discipline,66,39,27
15722,Uivi,azjolnerub,1617,priest,discipline,30,17,13
15723,Isweariheal,twisting-nether,1616,priest,discipline,58,37,21
15724,Saniss,tarren-mill,1616,priest,discipline,78,39,39
15725,Cinri,argent-dawn,1616,priest,discipline,175,87,88
15726,Eliverax,outland,1616,priest,discipline,74,33,41
15727,Flensu,stormscale,1615,priest,discipline,24,17,7
15728,Eagrh,ravencrest,1615,priest,discipline,84,56,28
15729,Gehrketwo,silvermoon,1615,priest,discipline,36,21,15
15730,Athelsta,alleria,1615,priest,discipline,75,40,35
15731,Pshan,blackmoore,1615,priest,discipline,170,87,83
15732,Troedelsuppe,destromath,1615,priest,discipline,144,61,83
15733,Assacine,aegwynn,1614,priest,discipline,42,23,19
15734,Jeanprêtre,ysondre,1614,priest,discipline,48,20,28
15735,Gnzysan,blackrock,1613,priest,discipline,66,39,27
15736,Burningheatx,kazzak,1612,priest,discipline,65,44,21
15737,Matwucss,outland,1611,priest,discipline,42,25,17
15738,Southyz,stormscale,1611,priest,discipline,87,50,37
15739,Shadowboness,twisting-nether,1611,priest,discipline,58,31,27
15740,Rezzdar,lightnings-blade,1611,priest,discipline,36,17,19
15741,Blazekk,sylvanas,1611,priest,discipline,66,29,37
15742,Lolylights,tarren-mill,1611,priest,discipline,48,20,28
15743,Viu,eredar,1610,priest,discipline,51,22,29
15744,Zychopriest,antonidas,1610,priest,discipline,42,17,25
15745,Holyshiz,stormrage,1609,priest,discipline,42,24,18
15746,Fazzy,nagrand,1609,priest,discipline,76,41,35
15747,Darkshdwbrst,malorne,1608,priest,discipline,63,39,24
15748,Horrðr,kazzak,1608,priest,discipline,60,34,26
15749,Grzmocillaa,burning-legion,1608,priest,discipline,42,23,19
15750,Beabanane,aegwynn,1608,priest,discipline,50,24,26
15751,Fakecats,sargeras,1608,priest,discipline,51,22,29
15752,Coqa,blackrock,1607,priest,discipline,30,17,13
15753,Felvytwo,stormscale,1607,priest,discipline,36,17,19
15754,Altruistx,ravencrest,1607,priest,discipline,36,17,19
15755,Llamamepadre,dun-modr,1606,priest,discipline,42,20,22
15756,Bizqit,tarren-mill,1604,priest,discipline,125,65,60
15757,Rabbai,twisting-nether,1604,priest,discipline,42,21,21
15758,Kolinamenuss,dun-morogh,1604,priest,discipline,48,21,27
15759,Tabaç,stormscale,1603,priest,discipline,36,21,15
15760,Хилботгодикс,borean-tundra,1602,priest,discipline,42,32,10
15761,Шатолюгран,soulflayer,1602,priest,discipline,76,51,25
15762,Антошашвп,gordunni,1602,priest,discipline,36,19,17
15763,Pokahonta,silvermoon,1602,priest,discipline,225,116,109
15764,Lahammy,kazzak,1601,priest,discipline,50,30,20
15765,Мастди,ashenvale,1601,priest,discipline,41,20,21
15766,Xîz,silvermoon,1601,priest,discipline,66,32,34
15767,Yro,gorgonnash,1601,priest,discipline,42,20,22
15768,Enzysama,sanguino,1601,priest,discipline,48,21,27
15769,Lgbtgodx,archimonde,1600,priest,discipline,61,45,16
15770,Dêrbómbêr,guldan,1600,priest,discipline,54,30,24
15771,Interrupted,kazzak,1600,priest,discipline,66,30,36
15772,Noviriel,argent-dawn,1600,priest,discipline,47,19,28
15773,Мэдсанван,howling-fjord,1598,priest,discipline,72,44,28
15774,Eyllise,ragnaros,1598,priest,discipline,118,64,54
15775,Alexpriest,twisting-nether,1598,priest,discipline,139,72,67
15776,Vregoa,twisting-nether,1596,priest,discipline,54,32,22
15777,Sebikpri,ravencrest,1596,priest,discipline,60,34,26
15778,Баблби,soulflayer,1596,priest,discipline,169,73,96
15779,Aédeira,blackhand,1596,priest,discipline,47,20,27
15780,Alèxy,tarren-mill,1596,priest,discipline,48,19,29
15781,Ðæððÿsgïrl,ravencrest,1595,priest,discipline,132,67,65
15782,Badorange,kazzak,1592,priest,discipline,59,29,30
15783,Effectx,stormscale,1590,priest,discipline,66,33,33
15784,Alessana,antonidas,1588,priest,discipline,35,19,16
15785,Nolnilian,archimonde,1587,priest,discipline,36,19,17
15786,Mcdced,archimonde,1587,priest,discipline,78,38,40
15787,Cptatonement,draenor,1586,priest,discipline,36,21,15
15788,Toba,hellscream,1585,priest,discipline,113,65,48
15789,Sosabgd,azjolnerub,1585,priest,discipline,30,17,13
15790,Sahorie,archimonde,1584,priest,discipline,135,79,56
15791,Copperpriest,draenor,1584,priest,discipline,68,35,33
15792,Skynoxx,ragnaros,1584,priest,discipline,114,56,58
15793,Vanillå,silvermoon,1584,priest,discipline,58,28,30
15794,Enoriya,blackrock,1583,priest,discipline,212,119,93
15795,Èzì,burning-legion,1583,priest,discipline,36,18,18
15796,Hateyeleison,burning-legion,1582,priest,discipline,40,21,19
15797,Амберис,gordunni,1581,priest,discipline,54,27,27
15798,Jhaazx,nemesis,1580,priest,discipline,143,76,67
15799,Пальтишко,howling-fjord,1580,priest,discipline,72,34,38
15800,Fuzzymerge,ravencrest,1579,priest,discipline,30,19,11
15801,Spoggle,kazzak,1579,priest,discipline,72,41,31
15802,Blindmymind,malganis,1578,priest,discipline,59,30,29
15803,Averagenoob,ragnaros,1578,priest,discipline,54,25,29
15804,Maccz,hyjal,1577,priest,discipline,68,32,36
15805,Соулвардинг,soulflayer,1577,priest,discipline,42,18,24
15806,Shadowfishey,grim-batol,1577,priest,discipline,42,17,25
15807,Twosugars,sylvanas,1576,priest,discipline,84,44,40
15808,Tuitio,blackmoore,1576,priest,discipline,65,34,31
15809,Флафика,deathguard,1575,priest,discipline,72,42,30
15810,Scodây,blackmoore,1575,priest,discipline,176,90,86
15811,Chamelthoe,the-maelstrom,1575,priest,discipline,96,47,49
15812,Xaey,ravencrest,1574,priest,discipline,30,17,13
15813,Verminous,ravencrest,1574,priest,discipline,56,30,26
15814,Japral,blackhand,1573,priest,discipline,30,21,9
15815,Medipack,khaz-modan,1573,priest,discipline,48,33,15
15816,Надийя,gordunni,1573,priest,discipline,102,60,42
15817,Aia,tyrande,1573,priest,discipline,88,41,47
15818,Babywayn,onyxia,1572,priest,discipline,87,48,39
15819,Ðarkan,kaelthas,1572,priest,discipline,102,55,47
15820,Nyarlatothep,boulderfist,1572,priest,discipline,148,77,71
15821,Targolina,argent-dawn,1571,priest,discipline,166,81,85
15822,Notnøw,silvermoon,1570,priest,discipline,29,17,12
15823,Hèmera,tichondrius,1568,priest,discipline,55,41,14
15824,Tritíana,blackrock,1567,priest,discipline,126,76,50
15825,Chuckline,eredar,1566,priest,discipline,36,20,16
15826,Denyz,blackrock,1566,priest,discipline,54,21,33
15827,Shalvy,aegwynn,1565,priest,discipline,122,63,59
15828,Могулас,soulflayer,1565,priest,discipline,173,89,84
15829,Labadudala,aegwynn,1564,priest,discipline,30,24,6
15830,Yøløswagg,silvermoon,1564,priest,discipline,48,21,27
15831,Rasha,kazzak,1563,priest,discipline,69,41,28
15832,Alicanx,twisting-nether,1563,priest,discipline,84,37,47
15833,Unfaker,drakthul,1562,priest,discipline,36,23,13
15834,Hamati,blackhand,1562,priest,discipline,84,47,37
15835,Parzivál,argent-dawn,1560,priest,discipline,95,40,55
15836,Grêy,dun-modr,1559,priest,discipline,41,23,18
15837,Рвотка,gordunni,1559,priest,discipline,124,68,56
15838,Nooway,kazzak,1559,priest,discipline,72,34,38
15839,Gød,magtheridon,1559,priest,discipline,48,20,28
15840,Raffá,blackhand,1559,priest,discipline,48,17,31
15841,Чилюнахиле,gordunni,1559,priest,discipline,59,19,40
15842,Нз,soulflayer,1558,priest,discipline,41,19,22
15843,Raawri,blackmoore,1557,priest,discipline,54,24,30
15844,Tansk,stormscale,1556,priest,discipline,96,57,39
15845,Tamy,draenor,1556,priest,discipline,62,33,29
15846,Lyrina,twisting-nether,1556,priest,discipline,268,142,126
15847,Расспутана,howling-fjord,1555,priest,discipline,114,57,57
15848,Wencis,kazzak,1555,priest,discipline,54,25,29
15849,Vhim,hyjal,1555,priest,discipline,52,24,28
15850,Holyasprin,sylvanas,1554,priest,discipline,42,21,21
15851,Frednshield,tarren-mill,1554,priest,discipline,69,34,35
15852,Khâléd,kazzak,1553,priest,discipline,36,17,19
15853,Juggster,bloodhoof,1552,priest,discipline,168,88,80
15854,Skevitche,hyjal,1552,priest,discipline,150,72,78
15855,Blackbox,burning-legion,1552,priest,discipline,113,54,59
15856,Cresellia,twisting-nether,1552,priest,discipline,170,81,89
15857,Люблюкофе,deathguard,1552,priest,discipline,47,22,25
15858,Strawhât,eredar,1550,priest,discipline,29,17,12
15859,Korzec,dun-modr,1550,priest,discipline,108,57,51
15860,Sinîra,frostwolf,1550,priest,discipline,104,54,50
15861,Jandice,blackrock,1550,priest,discipline,36,18,18
15862,Exoduz,stormscale,1550,priest,discipline,117,58,59
15863,Acrio,die-ewige-wacht,1550,priest,discipline,54,26,28
15864,Xaerah,blackmoore,1549,priest,discipline,78,41,37
15865,Darkprofit,aegwynn,1549,priest,discipline,60,30,30
15866,Arkkinunna,outland,1549,priest,discipline,124,59,65
15867,Sonics,antonidas,1548,priest,discipline,66,31,35
15868,Elämäntypy,stormscale,1547,priest,discipline,54,28,26
15869,Bubbelchên,blackhand,1547,priest,discipline,66,28,38
15870,Mtbalt,tarren-mill,1546,priest,discipline,96,59,37
15871,Systerstål,twisting-nether,1546,priest,discipline,78,45,33
15872,Alphabreyf,tarren-mill,1545,priest,discipline,83,43,40
15873,Holycrapx,chromaggus,1545,priest,discipline,62,32,30
15874,Lishado,twisting-nether,1545,priest,discipline,90,45,45
15875,Nevor,nemesis,1545,priest,discipline,70,30,40
15876,Diszi,norgannon,1544,priest,discipline,58,28,30
15877,Uo,kilrogg,1543,priest,discipline,48,25,23
15878,Enimao,tarren-mill,1542,priest,discipline,37,20,17
15879,Jmp,tarren-mill,1542,priest,discipline,34,17,17
15880,Admiration,eredar,1542,priest,discipline,41,20,21
15881,Cyberlunatic,antonidas,1542,priest,discipline,66,28,38
15882,Enigam,alakir,1541,priest,discipline,54,33,21
15883,Tjat,silvermoon,1540,priest,discipline,66,34,32
15884,Whiskie,twisting-nether,1540,priest,discipline,60,30,30
15885,Liviúss,draenor,1540,priest,discipline,42,20,22
15886,Voidsnitch,antonidas,1540,priest,discipline,66,30,36
15887,Grautesk,chogall,1539,priest,discipline,48,23,25
15888,Fatishcribe,twisting-nether,1538,priest,discipline,84,48,36
15889,Влажныйшп,soulflayer,1538,priest,discipline,66,37,29
15890,Апититька,soulflayer,1538,priest,discipline,42,23,19
15891,Alesthion,silvermoon,1538,priest,discipline,80,42,38
15892,Burnex,thrall,1537,priest,discipline,54,26,28
15893,Hâlez,antonidas,1536,priest,discipline,290,148,142
15894,Goblex,hyjal,1535,priest,discipline,63,28,35
15895,Разрухаовнз,gordunni,1534,priest,discipline,24,16,8
15896,Майндоф,howling-fjord,1534,priest,discipline,60,34,26
15897,Gûardianwisp,ravencrest,1534,priest,discipline,111,56,55
15898,Lunatique,shadowsong,1534,priest,discipline,32,16,16
15899,Ptsd,argent-dawn,1533,priest,discipline,60,26,34
15900,Cizer,kazzak,1532,priest,discipline,83,38,45
15901,Фыбра,soulflayer,1531,priest,discipline,30,16,14
15902,Wiildsy,tarren-mill,1531,priest,discipline,53,24,29
15903,Амбракадабра,blackscar,1530,priest,discipline,36,26,10
15904,Avengëd,nagrand,1530,priest,discipline,34,18,16
15905,Ohbenji,ravencrest,1530,priest,discipline,74,36,38
15906,Remkojatwo,blackrock,1529,priest,discipline,30,16,14
15907,Mêmphìs,twisting-nether,1529,priest,discipline,65,29,36
15908,Gulch,blackmoore,1528,priest,discipline,54,26,28
15909,Джелесана,gordunni,1528,priest,discipline,69,31,38
15910,Freaki,blackrock,1527,priest,discipline,30,19,11
15911,Limeslayerx,veklor,1527,priest,discipline,30,17,13
15912,Dêxter,hyjal,1527,priest,discipline,102,51,51
15913,Valnor,pozzo-delleternità,1527,priest,discipline,54,25,29
15914,Místerbiceps,outland,1527,priest,discipline,36,16,20
15915,Фейкай,blackscar,1526,priest,discipline,48,28,20
15916,Kamiyasa,blackmoore,1526,priest,discipline,48,27,21
15917,Dyliz,stormscale,1526,priest,discipline,99,50,49
15918,Cnqz,archimonde,1526,priest,discipline,36,16,20
15919,Forcedtoheal,sylvanas,1525,priest,discipline,37,22,15
15920,Ёджих,blackscar,1525,priest,discipline,85,43,42
15921,Xoxogg,burning-blade,1524,priest,discipline,84,53,31
15922,Whýççpèrx,ravencrest,1524,priest,discipline,30,16,14
15923,Darudo,kazzak,1524,priest,discipline,66,31,35
15924,Bockx,ragnaros,1524,priest,discipline,42,16,26
15925,Виспх,eversong,1523,priest,discipline,269,120,149
15926,Lythi,eredar,1522,priest,discipline,118,52,66
15927,Thejambura,ragnaros,1520,priest,discipline,74,47,27
15928,Drxz,twilights-hammer,1520,priest,discipline,46,24,22
15929,Chrispriest,argent-dawn,1520,priest,discipline,38,18,20
15930,Mamis,anetheron,1520,priest,discipline,48,22,26
15931,Nexìan,ravencrest,1520,priest,discipline,42,18,24
15932,Chôrdi,aegwynn,1519,priest,discipline,100,49,51
15933,Cbsad,madmortem,1518,priest,discipline,78,45,33
15934,Laxímink,sylvanas,1518,priest,discipline,65,26,39
15935,Ssol,tarren-mill,1517,priest,discipline,49,29,20
15936,Senpumara,malganis,1517,priest,discipline,264,133,131
15937,Kolinamenus,dun-morogh,1517,priest,discipline,66,31,35
15938,Менестрели,gordunni,1516,priest,discipline,94,60,34
15939,Хеликси,gordunni,1516,priest,discipline,128,69,59
15940,Shyria,argent-dawn,1515,priest,discipline,53,25,28
15941,Aestina,silvermoon,1514,priest,discipline,102,49,53
15942,Prästpojken,frostwhisper,1514,priest,discipline,78,36,42
15943,Saintpri,twisting-nether,1513,priest,discipline,84,45,39
15944,Foobi,the-maelstrom,1513,priest,discipline,303,158,145
15945,Raesd,argent-dawn,1513,priest,discipline,58,30,28
15946,Kuqezi,archimonde,1513,priest,discipline,42,21,21
15947,Kratzîgel,blackmoore,1512,priest,discipline,120,69,51
15948,Erupyks,archimonde,1512,priest,discipline,36,18,18
15949,Ciri,die-aldor,1511,priest,discipline,31,18,13
15950,Virdeo,aegwynn,1511,priest,discipline,30,16,14
15951,Sehek,sanguino,1510,priest,discipline,42,18,24
15952,Poonies,silvermoon,1509,priest,discipline,106,50,56
15953,Zehakky,tarren-mill,1508,priest,discipline,24,17,7
15954,Tinpr,sanguino,1507,priest,discipline,105,48,57
15955,Zealtron,darksorrow,1507,priest,discipline,47,19,28
15956,Prost,aerie-peak,1506,priest,discipline,47,30,17
15957,Lïnkz,kazzak,1506,priest,discipline,48,26,22
15958,Bandulskii,twisting-nether,1506,priest,discipline,216,98,118
15959,Эйвиг,blackscar,1505,priest,discipline,54,26,28
15960,Mortarz,ragnaros,1505,priest,discipline,71,31,40
15961,Dench,azjolnerub,1505,priest,discipline,60,25,35
15962,Shadowbread,tarren-mill,1504,priest,discipline,30,16,14
15963,Lethalhealz,outland,1503,priest,discipline,149,75,74
15964,Huffinctus,tarren-mill,1502,priest,discipline,94,49,45
15965,Rizzlerx,blackmoore,1501,priest,discipline,48,28,20
15966,Cryksî,eredar,1501,priest,discipline,51,27,24
15967,Shînnøk,silvermoon,1501,priest,discipline,84,42,42
15968,Dreythan,stormrage,1501,priest,discipline,50,19,31
15969,Мьюсх,deathguard,1500,priest,discipline,77,42,35
15970,Dreamhatcher,deathwing,1500,priest,discipline,42,18,24
15971,Ilovedisc,kazzak,1499,priest,discipline,33,19,14
15972,Holineß,burning-blade,1496,priest,discipline,54,33,21
15973,Menda,eredar,1496,priest,discipline,112,63,49
15974,Alz,rashgarroth,1496,priest,discipline,134,65,69
15975,Холиблэк,blackscar,1496,priest,discipline,36,16,20
15976,Nurbanu,ravencrest,1495,priest,discipline,59,39,20
15977,Sheshan,destromath,1494,priest,discipline,53,29,24
15978,Targoviste,archimonde,1494,priest,discipline,235,127,108
15979,Akemmì,sylvanas,1494,priest,discipline,138,69,69
15980,Hïstërïä,silvermoon,1494,priest,discipline,57,28,29
15981,Olio,outland,1494,priest,discipline,76,35,41
15982,Evõmax,sylvanas,1493,priest,discipline,143,76,67
15983,Viagrà,outland,1493,priest,discipline,62,26,36
15984,Tarellia,argent-dawn,1491,priest,discipline,90,61,29
15985,Grimdream,ragnaros,1491,priest,discipline,98,43,55
15986,Themistia,kazzak,1491,priest,discipline,48,20,28
15987,Minipõppy,ravencrest,1491,priest,discipline,60,21,39
15988,Holysheett,magtheridon,1490,priest,discipline,48,28,20
15989,Остроухх,howling-fjord,1490,priest,discipline,52,29,23
15990,Holycrit,aszune,1490,priest,discipline,53,26,27
15991,Nêlumar,aegwynn,1490,priest,discipline,48,21,27
15992,Fiskpung,draenor,1489,priest,discipline,36,22,14
15993,Ziv,grim-batol,1488,priest,discipline,74,46,28
15994,Phreyst,draenor,1488,priest,discipline,56,34,22
15995,Khazidhea,frostwolf,1488,priest,discipline,87,41,46
15996,Flaskandeux,tarren-mill,1488,priest,discipline,62,17,45
15997,Orophar,antonidas,1487,priest,discipline,53,29,24
15998,Nomakprst,sanguino,1486,priest,discipline,130,63,67
15999,Mewpew,azjolnerub,1486,priest,discipline,54,23,31
16000,Kåstå,archimonde,1485,priest,discipline,74,44,30
16001,Lurri,tarren-mill,1485,priest,discipline,96,48,48
16002,Feed,burning-legion,1484,priest,discipline,36,18,18
16003,Klituriis,twisting-nether,1483,priest,discipline,77,41,36
16004,Zedrus,azshara,1483,priest,discipline,99,49,50
16005,Hannirï,archimonde,1481,priest,discipline,53,34,19
16006,Jumperlawl,khaz-modan,1481,priest,discipline,48,26,22
16007,Вилайф,galakrond,1479,priest,discipline,58,27,31
16008,Aurosa,argent-dawn,1478,priest,discipline,79,37,42
16009,Kdot,drakthul,1477,priest,discipline,48,23,25
16010,Kanî,eredar,1477,priest,discipline,60,27,33
16011,Кэндимен,gordunni,1475,priest,discipline,70,42,28
16012,Chankilolx,dun-modr,1475,priest,discipline,163,76,87
16013,Kurt,blackrock,1475,priest,discipline,42,18,24
16014,Flurri,tarren-mill,1474,priest,discipline,108,59,49
16015,Mzpriest,dalaran,1474,priest,discipline,76,41,35
16016,Prezica,stormscale,1474,priest,discipline,137,72,65
16017,Олегстразза,howling-fjord,1474,priest,discipline,93,44,49
16018,Licktheheal,outland,1473,priest,discipline,30,17,13
16019,Ruly,ragnaros,1472,priest,discipline,30,17,13
16020,Ðiscobiscuit,argent-dawn,1472,priest,discipline,92,50,42
16021,Санггвиний,soulflayer,1472,priest,discipline,90,46,44
16022,Aurunea,blackrock,1471,priest,discipline,36,24,12
16023,Шпангл,gordunni,1470,priest,discipline,54,25,29
16024,Джахия,soulflayer,1469,priest,discipline,35,21,14
16025,Battra,argent-dawn,1468,priest,discipline,78,41,37
16026,Drwlad,archimonde,1468,priest,discipline,66,26,40
16027,Brutapriestx,stormscale,1467,priest,discipline,35,16,19
16028,Panoio,aggra-português,1466,priest,discipline,77,33,44
16029,Yákizå,darksorrow,1466,priest,discipline,72,30,42
16030,Krasawìtch,onyxia,1465,priest,discipline,66,28,38
16031,Geierlol,blackrock,1464,priest,discipline,42,17,25
16032,Eßola,silvermoon,1463,priest,discipline,38,18,20
16033,Мненосина,goldrinn,1462,priest,discipline,46,21,25
16034,Krayziest,tarren-mill,1461,priest,discipline,42,26,16
16035,Lemontea,frostwolf,1461,priest,discipline,30,17,13
16036,Scade,kazzak,1461,priest,discipline,92,44,48
16037,Ahmnesia,archimonde,1460,priest,discipline,138,72,66
16038,Daddyfinger,argent-dawn,1458,priest,discipline,97,56,41
16039,Dalylla,aggra-português,1457,priest,discipline,42,24,18
16040,Avaichquirit,tarren-mill,1457,priest,discipline,36,17,19
16041,Zoe,aegwynn,1456,priest,discipline,153,79,74
16042,Dotdotggwp,stormscale,1456,priest,discipline,84,39,45
16043,Anzil,dun-modr,1456,priest,discipline,60,27,33
16044,Nyxalia,silvermoon,1455,priest,discipline,30,18,12
16045,Synoé,la-croisade-écarlate,1455,priest,discipline,65,33,32
16046,Terno,sylvanas,1455,priest,discipline,100,45,55
16047,Laonar,silvermoon,1454,priest,discipline,103,59,44
16048,Dejica,kult-der-verdammten,1454,priest,discipline,72,33,39
16049,Hiereia,khadgar,1453,priest,discipline,76,33,43
16050,Gravebrain,draenor,1452,priest,discipline,160,71,89
16051,Marllen,twisting-nether,1450,priest,discipline,65,30,35
16052,Artì,kazzak,1449,priest,discipline,53,18,35
16053,Шарадин,gordunni,1448,priest,discipline,110,59,51
16054,Vqny,archimonde,1446,priest,discipline,40,24,16
16055,Холишитс,gordunni,1446,priest,discipline,97,57,40
16056,Gïanna,archimonde,1446,priest,discipline,54,30,24
16057,Kâltak,aegwynn,1446,priest,discipline,48,24,24
16058,Sáshagrey,arathor,1446,priest,discipline,49,24,25
16059,Diva,malfurion,1445,priest,discipline,40,20,20
16060,Spirítbox,argent-dawn,1444,priest,discipline,100,51,49
16061,Preachyjeg,ravencrest,1444,priest,discipline,78,30,48
16062,Dtpe,kazzak,1443,priest,discipline,39,26,13
16063,Troublemaker,durotan,1443,priest,discipline,54,30,24
16064,Sombralúz,sanguino,1442,priest,discipline,36,20,16
16065,Soulreapper,blackhand,1442,priest,discipline,156,84,72
16066,Shanny,kazzak,1442,priest,discipline,89,43,46
16067,Трэй,deathguard,1441,priest,discipline,84,46,38
16068,Laurent,sanguino,1441,priest,discipline,36,16,20
16069,Смегмачет,soulflayer,1440,priest,discipline,122,63,59
16070,Sensor,kazzak,1440,priest,discipline,51,26,25
16071,Kyseki,ravencrest,1440,priest,discipline,382,192,190
16072,Sprutch,kazzak,1439,priest,discipline,50,28,22
16073,Chaosxo,draenor,1439,priest,discipline,36,19,17
16074,Bedkara,ravencrest,1439,priest,discipline,30,15,15
16075,Cáss,archimonde,1439,priest,discipline,30,15,15
16076,Donvyto,blackmoore,1438,priest,discipline,30,15,15
16077,Snutz,draenor,1437,priest,discipline,24,15,9
16078,Mjamc,stormscale,1437,priest,discipline,78,33,45
16079,Yonkerz,frostmane,1437,priest,discipline,108,43,65
16080,Amysantiàgo,sylvanas,1436,priest,discipline,65,33,32
16081,Timbsheal,tarren-mill,1436,priest,discipline,30,15,15
16082,Dzoo,kazzak,1436,priest,discipline,58,27,31
16083,Pàndoràh,nemesis,1435,priest,discipline,42,22,20
16084,Jâde,bloodhoof,1435,priest,discipline,30,15,15
16085,Makesnosense,kilrogg,1435,priest,discipline,48,22,26
16086,Kæyc,blackmoore,1434,priest,discipline,71,35,36
16087,Bubidiblumpr,twisting-nether,1433,priest,discipline,66,40,26
16088,Fantästic,kazzak,1433,priest,discipline,56,31,25
16089,Selëne,blackrock,1433,priest,discipline,42,22,20
16090,Tynsxd,silvermoon,1432,priest,discipline,54,30,24
16091,Swera,twisting-nether,1431,priest,discipline,24,15,9
16092,Mamabeer,draenor,1431,priest,discipline,33,20,13
16093,Jupiter,silvermoon,1431,priest,discipline,84,45,39
16094,Zýgzäg,hyjal,1431,priest,discipline,30,15,15
16095,Vaetrilla,doomhammer,1430,priest,discipline,37,20,17
16096,Littleheal,ghostlands,1430,priest,discipline,30,16,14
16097,Karoopi,ysondre,1430,priest,discipline,89,44,45
16098,Holypepper,outland,1429,priest,discipline,65,34,31
16099,Íhðly,silvermoon,1429,priest,discipline,60,29,31
16100,Ivysaurus,ravencrest,1428,priest,discipline,54,31,23
16101,Alinone,uldum,1428,priest,discipline,49,20,29
16102,Menarille,kazzak,1427,priest,discipline,18,15,3
16103,Diddlefiddle,stormscale,1427,priest,discipline,64,36,28
16104,Gbpjr,xavius,1427,priest,discipline,104,49,55
16105,Discobrill,silvermoon,1427,priest,discipline,48,19,29
16106,Amanojakü,ravencrest,1426,priest,discipline,48,34,14
16107,Fatalx,grim-batol,1426,priest,discipline,34,16,18
16108,Dímension,ragnaros,1425,priest,discipline,79,46,33
16109,Krolox,blackhand,1425,priest,discipline,30,15,15
16110,Урголиафа,howling-fjord,1425,priest,discipline,54,25,29
16111,Maerlene,nemesis,1425,priest,discipline,39,16,23
16112,Lukéy,silvermoon,1425,priest,discipline,42,17,25
16113,Zymai,ravencrest,1424,priest,discipline,42,15,27
16114,Nirsis,dun-modr,1423,priest,discipline,63,30,33
16115,Zzbleh,stormscale,1422,priest,discipline,24,15,9
16116,Nøheall,ysondre,1422,priest,discipline,42,17,25
16117,Vaewyn,ravencrest,1420,priest,discipline,42,26,16
16118,Тэтэшник,ashenvale,1419,priest,discipline,42,21,21
16119,Destinychild,norgannon,1419,priest,discipline,35,15,20
16120,Подчинись,ashenvale,1418,priest,discipline,54,30,24
16121,Нэстикус,gordunni,1418,priest,discipline,30,16,14
16122,Медиив,deepholm,1418,priest,discipline,66,32,34
16123,Мдзшка,gordunni,1418,priest,discipline,221,107,114
16124,Гачибунта,blackscar,1417,priest,discipline,41,27,14
16125,Блексебет,soulflayer,1417,priest,discipline,90,46,44
16126,Légít,argent-dawn,1417,priest,discipline,42,15,27
16127,Softie,zuljin,1416,priest,discipline,24,15,9
16128,Øbz,sylvanas,1415,priest,discipline,42,15,27
16129,Kaeldara,ysondre,1413,priest,discipline,24,15,9
16130,Convulsiveq,silvermoon,1413,priest,discipline,184,94,90
16131,Oxborn,thrall,1413,priest,discipline,83,40,43
16132,Ledania,aegwynn,1412,priest,discipline,24,15,9
16133,Asolan,drakthul,1412,priest,discipline,60,35,25
16134,Adev,drakthul,1412,priest,discipline,47,25,22
16135,Joniop,stormreaver,1410,priest,discipline,60,29,31
16136,Shanya,thrall,1410,priest,discipline,42,20,22
16137,Kaémon,twisting-nether,1410,priest,discipline,88,37,51
16138,Getötet,blackrock,1409,priest,discipline,36,21,15
16139,Dunderprälle,outland,1409,priest,discipline,30,15,15
16140,Deathchicka,draenor,1408,priest,discipline,52,31,21
16141,Lévention,stormscale,1408,priest,discipline,36,20,16
16142,Bolflo,khaz-modan,1407,priest,discipline,108,59,49
16143,Gothixs,draenor,1406,priest,discipline,44,26,18
16144,Garfriest,aggra-português,1406,priest,discipline,78,46,32
16145,Neoni,blackmoore,1406,priest,discipline,136,64,72
16146,Golletz,twisting-nether,1405,priest,discipline,24,15,9
16147,Putinkuilo,outland,1405,priest,discipline,42,21,21
16148,Youngfade,twisting-nether,1405,priest,discipline,40,16,24
16149,Dragovic,chogall,1404,priest,discipline,80,38,42
16150,Selenee,scarshield-legion,1404,priest,discipline,72,32,40
16151,Naïlu,hyjal,1403,priest,discipline,54,33,21
16152,Aiewn,elune,1403,priest,discipline,51,31,20
16153,Carnacia,tarren-mill,1402,priest,discipline,42,27,15
16154,Kbakå,kazzak,1402,priest,discipline,32,15,17
16155,Acidpills,hyjal,1402,priest,discipline,40,17,23
16156,Virulent,nemesis,1402,priest,discipline,36,15,21
16157,Angelofdeàth,kazzak,1401,priest,discipline,72,40,32
16158,Syro,defias-brotherhood,1400,priest,discipline,33,19,14
16159,Nerfnerf,kazzak,1400,priest,discipline,245,123,122
16160,Вурти,howling-fjord,1400,priest,discipline,65,28,37
16161,Overhealzz,blackmoore,1399,priest,discipline,60,30,30
16162,Chibrausorus,archimonde,1399,priest,discipline,54,22,32
16163,Laadyybirkee,blackhand,1398,priest,discipline,140,70,70
16164,Алуриэлия,gordunni,1397,priest,discipline,71,31,40
16165,Velles,nazjatar,1396,priest,discipline,303,156,147
16166,Rahan,stormscale,1396,priest,discipline,93,46,47
16167,Derylium,kazzak,1395,priest,discipline,47,29,18
16168,Banshzz,ragnaros,1395,priest,discipline,42,15,27
16169,Сашадвасм,gordunni,1394,priest,discipline,42,24,18
16170,Alakkiria,ravencrest,1394,priest,discipline,77,38,39
16171,Kroa,ragnaros,1393,priest,discipline,24,15,9
16172,Tiktokdancér,kazzak,1393,priest,discipline,48,29,19
16173,Ceraghk,tichondrius,1393,priest,discipline,64,32,32
16174,Alliora,dalaran,1393,priest,discipline,87,36,51
16175,Rher,blackmoore,1392,priest,discipline,24,15,9
16176,Phasmöphobia,zuljin,1392,priest,discipline,96,38,58
16177,Noobpriest,blackrock,1391,priest,discipline,58,23,35
16178,Zombîe,draenor,1390,priest,discipline,42,16,26
16179,Unholyfield,draenor,1389,priest,discipline,90,41,49
16180,Discipleotl,stormscale,1388,priest,discipline,24,16,8
16181,Praybro,blackmoore,1388,priest,discipline,24,16,8
16182,Yoii,nemesis,1386,priest,discipline,22,16,6
16183,Nakali,the-maelstrom,1386,priest,discipline,30,16,14
16184,Дядяврач,howling-fjord,1386,priest,discipline,60,28,32
16185,Pyropenance,twisting-nether,1386,priest,discipline,83,35,48
16186,Brilho,frostmane,1386,priest,discipline,57,16,41
16187,Benificent,argent-dawn,1384,priest,discipline,75,36,39
16188,Thrakoun,twilights-hammer,1383,priest,discipline,104,51,53
16189,Phórkys,kazzak,1382,priest,discipline,78,50,28
16190,Animepfp,stormreaver,1381,priest,discipline,78,35,43
16191,Onelovexx,thrall,1380,priest,discipline,36,15,21
16192,Streety,nethersturm,1378,priest,discipline,90,43,47
16193,Gangreana,kazzak,1377,priest,discipline,78,42,36
16194,Annisa,kazzak,1376,priest,discipline,131,71,60
16195,Verzeichnis,thrall,1376,priest,discipline,65,35,30
16196,Dolifrius,dalaran,1375,priest,discipline,50,30,20
16197,Invexx,tarren-mill,1375,priest,discipline,90,35,55
16198,Psyfir,outland,1374,priest,discipline,224,117,107
16199,Otheym,the-maelstrom,1374,priest,discipline,39,18,21
16200,Crazyname,outland,1373,priest,discipline,78,39,39
16201,Arize,dun-modr,1373,priest,discipline,30,15,15
16202,Blackheal,sanguino,1373,priest,discipline,68,29,39
16203,Rabbît,stormscale,1372,priest,discipline,82,42,40
16204,Geesuz,outland,1372,priest,discipline,39,16,23
16205,Kutjeskopper,silvermoon,1371,priest,discipline,36,19,17
16206,Drawun,burning-legion,1370,priest,discipline,42,25,17
16207,Скизма,gordunni,1370,priest,discipline,42,25,17
16208,Маимморта,howling-fjord,1368,priest,discipline,42,25,17
16209,Elosen,darkspear,1368,priest,discipline,36,20,16
16210,Salzgehalt,antonidas,1366,priest,discipline,58,38,20
16211,Jordí,darkspear,1366,priest,discipline,149,72,77
16212,Ximenia,eredar,1364,priest,discipline,25,18,7
16213,Spiochpr,burning-legion,1361,priest,discipline,72,39,33
16214,Sephìrøth,malganis,1361,priest,discipline,48,24,24
16215,Aisha,rajaxx,1361,priest,discipline,69,32,37
16216,Ræpriestx,ragnaros,1360,priest,discipline,75,36,39
16217,Докторпэйн,howling-fjord,1360,priest,discipline,86,41,45
16218,Sissi,blackmoore,1359,priest,discipline,52,29,23
16219,Enduring,darksorrow,1359,priest,discipline,72,33,39
16220,Kbakå,stormscale,1359,priest,discipline,60,22,38
16221,Nestélle,drakthul,1357,priest,discipline,30,18,12
16222,Priesless,sylvanas,1357,priest,discipline,34,20,14
16223,Yvaini,xavius,1357,priest,discipline,30,16,14
16224,Antainis,silvermoon,1357,priest,discipline,59,30,29
16225,Лимоняшечка,soulflayer,1356,priest,discipline,92,48,44
16226,Massbimba,tarren-mill,1356,priest,discipline,108,56,52
16227,Hardcode,twisting-nether,1356,priest,discipline,32,16,16
16228,Nésha,dun-modr,1354,priest,discipline,41,21,20
16229,Byxoph,sanguino,1353,priest,discipline,66,32,34
16230,Девственен,soulflayer,1353,priest,discipline,36,17,19
16231,Solarïah,garona,1352,priest,discipline,32,19,13
16232,Littlehelper,shendralar,1352,priest,discipline,39,16,23
16233,Isore,culte-de-la-rive-noire,1351,priest,discipline,34,20,14
16234,Feelmypainn,kazzak,1350,priest,discipline,42,23,19
16235,Smilyface,sylvanas,1350,priest,discipline,47,20,27
16236,Xypri,nordrassil,1350,priest,discipline,48,19,29
16237,Devot,outland,1349,priest,discipline,52,31,21
16238,Chowhone,archimonde,1349,priest,discipline,100,53,47
16239,Raî,durotan,1349,priest,discipline,36,18,18
16240,Frekio,eitrigg,1348,priest,discipline,77,36,41
16241,Dstars,archimonde,1348,priest,discipline,42,16,26
16242,Maidie,stormscale,1347,priest,discipline,43,26,17
16243,Nuklash,burning-legion,1347,priest,discipline,30,15,15
16244,Greedyaf,stormscale,1347,priest,discipline,101,48,53
16245,Enerpriest,ysondre,1346,priest,discipline,30,19,11
16246,Holyfussell,antonidas,1346,priest,discipline,54,25,29
16247,Pwjetlifelol,grim-batol,1345,priest,discipline,97,52,45
16248,Sâtânica,kelthuzad,1345,priest,discipline,72,33,39
16249,Noxr,ravencrest,1344,priest,discipline,50,18,32
16250,Fsnx,sylvanas,1343,priest,discipline,18,14,4
16251,Kenzah,ysondre,1343,priest,discipline,18,14,4
16252,Efflúx,ravencrest,1343,priest,discipline,24,14,10
16253,Outcast,korgall,1343,priest,discipline,42,24,18
16254,Ецци,howling-fjord,1343,priest,discipline,38,18,20
16255,Reflector,sunstrider,1343,priest,discipline,30,14,16
16256,Kêkwshádêzz,blackmoore,1343,priest,discipline,36,14,22
16257,Kevokko,silvermoon,1342,priest,discipline,24,14,10
16258,Krematorio,twisting-nether,1342,priest,discipline,24,14,10
16259,Rightx,outland,1342,priest,discipline,48,26,22
16260,Nameit,eredar,1342,priest,discipline,30,14,16
16261,Бенджаминлол,blackscar,1342,priest,discipline,36,14,22
16262,Поднялбабки,deathguard,1342,priest,discipline,36,14,22
16263,Cutename,burning-blade,1340,priest,discipline,36,18,18
16264,Halastrâ,tarren-mill,1339,priest,discipline,20,15,5
16265,Árî,dun-modr,1338,priest,discipline,51,30,21
16266,Kirtarah,aegwynn,1338,priest,discipline,30,14,16
16267,Kahir,ravencrest,1337,priest,discipline,18,14,4
16268,Logath,archimonde,1336,priest,discipline,24,14,10
16269,Diarolz,sanguino,1336,priest,discipline,34,16,18
16270,Luuña,ravencrest,1336,priest,discipline,88,41,47
16271,Chealsey,thrall,1335,priest,discipline,45,30,15
16272,Styrbjörn,shattered-hand,1335,priest,discipline,50,27,23
16273,Kojee,blackrock,1335,priest,discipline,48,18,30
16274,Biscuits,ravencrest,1335,priest,discipline,48,14,34
16275,Гшд,gordunni,1334,priest,discipline,42,23,19
16276,Jerzay,hyjal,1332,priest,discipline,40,16,24
16277,Gajos,frostwolf,1331,priest,discipline,24,14,10
16278,Cleancf,blackhand,1331,priest,discipline,133,57,76
16279,Aroghul,eredar,1331,priest,discipline,54,23,31
16280,Waafa,kazzak,1331,priest,discipline,42,14,28
16281,Кролс,gordunni,1330,priest,discipline,30,14,16
16282,Snuifje,azjolnerub,1330,priest,discipline,81,33,48
16283,Winnever,dun-modr,1329,priest,discipline,111,58,53
16284,Rose,darksorrow,1328,priest,discipline,37,21,16
16285,Аквариусс,gordunni,1327,priest,discipline,42,24,18
16286,Nou,aegwynn,1327,priest,discipline,36,14,22
16287,Valaç,turalyon,1326,priest,discipline,125,64,61
16288,Vedina,bronze-dragonflight,1326,priest,discipline,84,42,42
16289,Èlysium,grim-batol,1326,priest,discipline,42,15,27
16290,Seinaruki,emerald-dream,1325,priest,discipline,34,18,16
16291,Skrnz,turalyon,1325,priest,discipline,59,26,33
16292,Buszeekk,outland,1324,priest,discipline,34,19,15
16293,Jodge,ravencrest,1324,priest,discipline,48,26,22
16294,Kalisy,ravencrest,1324,priest,discipline,52,27,25
16295,Hashoko,draenor,1323,priest,discipline,18,15,3
16296,Kizzorde,ragnaros,1323,priest,discipline,36,25,11
16297,Jempi,argent-dawn,1323,priest,discipline,24,14,10
16298,Centaurio,nemesis,1323,priest,discipline,74,36,38
16299,Arkkupiispa,stormreaver,1323,priest,discipline,187,86,101
16300,Mungam,draenor,1322,priest,discipline,35,15,20
16301,Kotipope,silvermoon,1321,priest,discipline,71,41,30
16302,Niholie,sinstralis,1321,priest,discipline,36,14,22
16303,Safemode,ravencrest,1320,priest,discipline,24,14,10
16304,Nirvánabang,sylvanas,1320,priest,discipline,42,21,21
16305,Lãwh,hyjal,1319,priest,discipline,54,30,24
16306,Eileengu,silvermoon,1318,priest,discipline,46,27,19
16307,Chimara,eredar,1318,priest,discipline,66,32,34
16308,Batsu,hyjal,1318,priest,discipline,82,36,46
16309,Ràthaløs,sanguino,1317,priest,discipline,47,28,19
16310,Sabaxdxd,dun-modr,1317,priest,discipline,42,18,24
16311,Meanazer,antonidas,1316,priest,discipline,30,14,16
16312,Ashérs,ravencrest,1315,priest,discipline,33,21,12
16313,Yugo,outland,1314,priest,discipline,41,15,26
16314,Jakeow,auchindoun,1313,priest,discipline,27,15,12
16315,Shilôz,hyjal,1313,priest,discipline,59,29,30
16316,Onicolla,terokkar,1312,priest,discipline,102,49,53
16317,Relaxmom,bloodhoof,1312,priest,discipline,30,14,16
16318,Форсибучи,soulflayer,1312,priest,discipline,66,30,36
16319,Tintapri,aszune,1311,priest,discipline,93,44,49
16320,Suzziee,silvermoon,1310,priest,discipline,48,25,23
16321,Violentha,silvermoon,1310,priest,discipline,30,15,15
16322,Pawriest,draenor,1309,priest,discipline,42,25,17
16323,Elfarity,tarren-mill,1308,priest,discipline,24,14,10
16324,Фурлена,blackscar,1308,priest,discipline,73,38,35
16325,Dirtydoc,area-52,1307,priest,discipline,39,20,19
16326,Patriamore,jaedenar,1306,priest,discipline,28,15,13
16327,Buzzingg,tarren-mill,1305,priest,discipline,41,26,15
16328,Lalgorithme,hyjal,1305,priest,discipline,24,14,10
16329,Paine,pozzo-delleternità,1305,priest,discipline,31,18,13
16330,Асади,gordunni,1305,priest,discipline,60,33,27
16331,Ассарх,lich-king,1305,priest,discipline,48,24,24
16332,Shadowmend,aegwynn,1305,priest,discipline,29,14,15
16333,Prellish,draenor,1305,priest,discipline,48,19,29
16334,Простойа,deathguard,1304,priest,discipline,30,16,14
16335,Rodshun,dun-modr,1304,priest,discipline,58,25,33
16336,Missdreavus,draenor,1301,priest,discipline,40,24,16
16337,Ahree,sargeras,1301,priest,discipline,100,46,54
16338,Fullymetalz,defias-brotherhood,1300,priest,discipline,58,32,26
16339,Elûnä,ysondre,1300,priest,discipline,66,36,30
16340,Fatherliam,emerald-dream,1299,priest,discipline,54,24,30
16341,Mirelaw,stormscale,1298,priest,discipline,53,29,24
16342,Agorasii,frostwolf,1298,priest,discipline,42,22,20
16343,Тварьгосподя,gordunni,1298,priest,discipline,203,100,103
16344,Sykra,magtheridon,1297,priest,discipline,70,38,32
16345,Шкуропльот,gordunni,1296,priest,discipline,88,46,42
16346,Бомжскадилом,gordunni,1295,priest,discipline,174,89,85
16347,Arenarooky,eredar,1293,priest,discipline,30,18,12
16348,Reticlel,kazzak,1293,priest,discipline,26,15,11
16349,Pl,sunstrider,1293,priest,discipline,42,22,20
16350,Kaktosz,ragnaros,1293,priest,discipline,54,21,33
16351,Vès,stormscale,1292,priest,discipline,54,30,24
16352,Bandgap,antonidas,1292,priest,discipline,98,44,54
16353,Ixdeadxl,stormscale,1291,priest,discipline,30,16,14
16354,Mustatomi,stormreaver,1291,priest,discipline,27,14,13
16355,Nukksch,antonidas,1291,priest,discipline,170,79,91
16356,Тэвиель,gordunni,1291,priest,discipline,54,19,35
16357,Yuuvi,ravencrest,1290,priest,discipline,48,20,28
16358,Darkweed,twilights-hammer,1289,priest,discipline,24,15,9
16359,Brainwash,darksorrow,1289,priest,discipline,53,18,35
16360,Jerolol,sanguino,1288,priest,discipline,56,22,34
16361,Рэйкар,razuvious,1286,priest,discipline,23,14,9
16362,Sílvana,nordrassil,1284,priest,discipline,76,39,37
16363,Pregrip,twisting-nether,1284,priest,discipline,236,116,120
16364,Alaeddin,kazzak,1283,priest,discipline,200,93,107
16365,Olereo,blackhand,1282,priest,discipline,54,24,30
16366,Mynameisebe,twisting-nether,1282,priest,discipline,42,18,24
16367,Vannax,arygos,1282,priest,discipline,54,23,31
16368,Jimmyhoffa,stormscale,1281,priest,discipline,54,32,22
16369,Инстенли,howling-fjord,1281,priest,discipline,60,25,35
16370,Bomzhik,silvermoon,1280,priest,discipline,73,43,30
16371,Superfelyn,ragnaros,1280,priest,discipline,51,27,24
16372,Limerençe,ravencrest,1279,priest,discipline,20,14,6
16373,Wortgottes,blackrock,1277,priest,discipline,28,16,12
16374,Healyourmum,stormscale,1277,priest,discipline,42,23,19
16375,Asuriyan,grim-batol,1276,priest,discipline,69,34,35
16376,Хаварь,gordunni,1275,priest,discipline,75,38,37
16377,Valeriana,stormreaver,1275,priest,discipline,36,18,18
16378,Boulotpas,hyjal,1273,priest,discipline,55,38,17
16379,Empí,sanguino,1272,priest,discipline,36,18,18
16380,Overshadowed,kazzak,1272,priest,discipline,175,80,95
16381,Cring,kirin-tor,1271,priest,discipline,42,24,18
16382,Jbte,silvermoon,1270,priest,discipline,66,38,28
16383,Mishas,draenor,1270,priest,discipline,42,24,18
16384,Zùt,ysondre,1269,priest,discipline,48,28,20
16385,Мегаствол,howling-fjord,1269,priest,discipline,60,28,32
16386,Micobra,dalaran,1267,priest,discipline,24,14,10
16387,Пофанчику,gordunni,1266,priest,discipline,58,27,31
16388,Hêsêkiêl,eredar,1265,priest,discipline,48,23,25
16389,Акктуальная,deepholm,1263,priest,discipline,48,25,23
16390,Sacerfull,sanguino,1263,priest,discipline,48,23,25
16391,Nìak,ysondre,1263,priest,discipline,94,38,56
16392,Seum,ravencrest,1260,priest,discipline,44,25,19
16393,Søînx,archimonde,1259,priest,discipline,27,17,10
16394,Pocketissue,ravencrest,1258,priest,discipline,26,17,9
16395,Alexnator,malganis,1258,priest,discipline,54,22,32
16396,Pleistras,magtheridon,1257,priest,discipline,100,61,39
16397,Jeuwls,argent-dawn,1257,priest,discipline,76,45,31
16398,Añgêl,ravencrest,1257,priest,discipline,117,60,57
16399,Ruderali,blackmoore,1257,priest,discipline,52,26,26
16400,Brach,nazjatar,1255,priest,discipline,49,26,23
16401,Даркфолс,soulflayer,1251,priest,discipline,59,30,29
16402,Fkup,twisting-nether,1250,priest,discipline,30,15,15
16403,Littleabs,the-maelstrom,1249,priest,discipline,65,34,31
16404,Buan,outland,1248,priest,discipline,18,13,5
16405,Lekadolplusc,doomhammer,1248,priest,discipline,80,45,35
16406,Suprenext,draenor,1248,priest,discipline,24,13,11
16407,Mazikeen,stormscale,1248,priest,discipline,24,13,11
16408,Удзумукец,howling-fjord,1248,priest,discipline,90,36,54
16409,Stmichael,silvermoon,1248,priest,discipline,38,15,23
16410,Dêmôn,stormscale,1247,priest,discipline,18,13,5
16411,Zathada,twisting-nether,1247,priest,discipline,30,19,11
16412,Swdömmel,aegwynn,1247,priest,discipline,24,13,11
16413,Krokkete,hyjal,1247,priest,discipline,24,13,11
16414,Feedergodx,dun-modr,1247,priest,discipline,24,13,11
16415,Hardloker,ravencrest,1247,priest,discipline,72,31,41
16416,Sùzy,ravencrest,1247,priest,discipline,36,13,23
16417,Maylà,aegwynn,1247,priest,discipline,60,20,40
16418,Judgementdaý,kazzak,1246,priest,discipline,18,13,5
16419,Bakony,ravencrest,1246,priest,discipline,24,17,7
16420,Psychoboris,outland,1246,priest,discipline,72,39,33
16421,Xraid,blackmoore,1246,priest,discipline,24,13,11
16422,Ishkà,stormscale,1246,priest,discipline,24,13,11
16423,Deliâz,aegwynn,1246,priest,discipline,36,14,22
16424,Леддигага,gordunni,1245,priest,discipline,24,13,11
16425,Mcdodgens,auchindoun,1245,priest,discipline,36,13,23
16426,Hotdog,kult-der-verdammten,1244,priest,discipline,30,17,13
16427,Jämar,archimonde,1244,priest,discipline,24,13,11
16428,Silvdarr,hyjal,1244,priest,discipline,68,34,34
16429,Ùçù,dalaran,1244,priest,discipline,34,16,18
16430,Jumby,outland,1244,priest,discipline,30,13,17
16431,Шадоухоррор,gordunni,1244,priest,discipline,51,20,31
16432,Takeoff,dun-morogh,1243,priest,discipline,36,23,13
16433,Vokuheala,tarren-mill,1243,priest,discipline,29,16,13
16434,Rngamer,silvermoon,1242,priest,discipline,18,13,5
16435,Nintendó,sylvanas,1242,priest,discipline,24,13,11
16436,Luziaa,outland,1242,priest,discipline,30,13,17
16437,Артфуул,howling-fjord,1242,priest,discipline,30,13,17
16438,Lavendertown,tarren-mill,1241,priest,discipline,24,13,11
16439,Pedopräst,stormscale,1241,priest,discipline,24,13,11
16440,Алуан,blackscar,1240,priest,discipline,42,13,29
16441,Wandéline,arathi,1238,priest,discipline,35,15,20
16442,Tarîs,archimonde,1237,priest,discipline,30,13,17
16443,Fulgus,sanguino,1237,priest,discipline,42,13,29
16444,Miileys,arthas,1235,priest,discipline,18,13,5
16445,Speltmor,stormscale,1235,priest,discipline,24,13,11
16446,Disturbdtwo,archimonde,1235,priest,discipline,24,13,11
16447,Discovery,aggra-português,1235,priest,discipline,54,28,26
16448,Flygar,outland,1235,priest,discipline,36,13,23
16449,Holybunny,blackrock,1234,priest,discipline,54,27,27
16450,Héternel,ysondre,1234,priest,discipline,56,27,29
16451,Divaz,eredar,1234,priest,discipline,48,18,30
16452,Deneye,thunderhorn,1233,priest,discipline,21,15,6
16453,Liliashet,sanguino,1233,priest,discipline,32,19,13
16454,Nethenielle,malganis,1233,priest,discipline,30,17,13
16455,Kätsulol,ysondre,1233,priest,discipline,24,13,11
16456,Janinw,sylvanas,1232,priest,discipline,30,13,17
16457,Samtig,malganis,1232,priest,discipline,57,23,34
16458,Umbraya,blackhand,1232,priest,discipline,60,18,42
16459,Aladorius,la-croisade-écarlate,1231,priest,discipline,40,20,20
16460,Lucianßk,sanguino,1230,priest,discipline,48,27,21
16461,Deadpxlz,ravencrest,1230,priest,discipline,24,13,11
16462,Cntrl,frostmane,1229,priest,discipline,60,30,30
16463,Топчикс,gordunni,1229,priest,discipline,76,37,39
16464,Pètunia,ravencrest,1228,priest,discipline,145,75,70
16465,Werita,frostmane,1228,priest,discipline,98,45,53
16466,Avázàr,stormscale,1228,priest,discipline,30,13,17
16467,Ggsus,outland,1228,priest,discipline,66,25,41
16468,Drsmort,blackrock,1227,priest,discipline,60,31,29
16469,Duem,kazzak,1225,priest,discipline,54,27,27
16470,Durness,argent-dawn,1224,priest,discipline,24,13,11
16471,Baglet,ravencrest,1224,priest,discipline,24,13,11
16472,Therezzer,burning-legion,1224,priest,discipline,36,16,20
16473,Nobbisnice,drakthul,1223,priest,discipline,52,28,24
16474,Gobie,sunstrider,1223,priest,discipline,30,13,17
16475,Mediumheals,tarren-mill,1221,priest,discipline,75,35,40
16476,Blagovesta,ragnaros,1221,priest,discipline,36,13,23
16477,Amphôra,archimonde,1220,priest,discipline,30,14,16
16478,Discoprillan,twisting-nether,1219,priest,discipline,39,21,18
16479,Howaya,la-croisade-écarlate,1219,priest,discipline,48,25,23
16480,Kïmbo,kazzak,1219,priest,discipline,56,19,37
16481,Xghazo,sylvanas,1218,priest,discipline,45,25,20
16482,Лолиэль,soulflayer,1218,priest,discipline,57,31,26
16483,Talonjean,conseil-des-ombres,1218,priest,discipline,24,13,11
16484,Perdítá,thrall,1218,priest,discipline,106,51,55
16485,Reìdood,stormscale,1217,priest,discipline,24,14,10
16486,Pvpriestess,silvermoon,1217,priest,discipline,36,17,19
16487,Капляболи,gordunni,1216,priest,discipline,51,28,23
16488,Diçkhëad,ravencrest,1215,priest,discipline,61,31,30
16489,Danucd,ragnaros,1214,priest,discipline,100,52,48
16490,Nymrasus,ravencrest,1213,priest,discipline,24,13,11
16491,Trimégiste,hyjal,1213,priest,discipline,107,56,51
16492,Sandaal,drakthul,1213,priest,discipline,72,36,36
16493,Elderiel,turalyon,1212,priest,discipline,66,29,37
16494,Myrmeen,silvermoon,1210,priest,discipline,78,39,39
16495,Vempress,neptulon,1210,priest,discipline,48,24,24
16496,Nikotyna,doomhammer,1209,priest,discipline,89,39,50
16497,Gertie,blackhand,1208,priest,discipline,46,29,17
16498,Øwlsoo,confrérie-du-thorium,1208,priest,discipline,90,46,44
16499,Freezydot,silvermoon,1207,priest,discipline,63,37,26
16500,Palitox,kazzak,1207,priest,discipline,24,13,11
16501,Nostramo,kirin-tor,1206,priest,discipline,54,19,35
16502,Selenar,neptulon,1205,priest,discipline,36,19,17
16503,Voidvania,drakthul,1205,priest,discipline,29,14,15
16504,Dezriah,tarren-mill,1203,priest,discipline,34,23,11
16505,Simbaba,archimonde,1203,priest,discipline,36,19,17
16506,Filtro,eredar,1203,priest,discipline,30,14,16
16507,Свежага,howling-fjord,1203,priest,discipline,76,33,43
16508,Mamaoh,ravencrest,1203,priest,discipline,30,13,17
16509,Beaglep,blackrock,1203,priest,discipline,53,13,40
16510,Janclod,pozzo-delleternità,1202,priest,discipline,24,14,10
16511,Bekareth,archimonde,1201,priest,discipline,48,26,22
16512,Hetha,tarren-mill,1199,priest,discipline,44,31,13
16513,Xieen,outland,1199,priest,discipline,66,27,39
16514,Holyswift,dun-morogh,1198,priest,discipline,163,84,79
16515,Drtickomaru,drakthul,1197,priest,discipline,32,16,16
16516,Türapea,draenor,1194,priest,discipline,53,27,26
16517,Ráka,earthen-ring,1193,priest,discipline,24,13,11
16518,Seneth,twisting-nether,1192,priest,discipline,30,13,17
16519,Дайбчик,gordunni,1191,priest,discipline,28,15,13
16520,Whitepitch,doomhammer,1190,priest,discipline,35,14,21
16521,Uro,tirion,1190,priest,discipline,41,14,27
16522,Triksas,sylvanas,1187,priest,discipline,24,19,5
16523,Megalodön,draenor,1187,priest,discipline,45,17,28
16524,Lillthya,kazzak,1186,priest,discipline,58,24,34
16525,Verrottênd,frostwolf,1185,priest,discipline,64,27,37
16526,Lighter,dragonblight,1183,priest,discipline,58,35,23
16527,Аэрэта,deathguard,1181,priest,discipline,24,15,9
16528,Lalola,tarren-mill,1181,priest,discipline,24,14,10
16529,Drioz,ysondre,1180,priest,discipline,36,22,14
16530,Duaijhutari,outland,1179,priest,discipline,24,14,10
16531,Valnaya,draenor,1178,priest,discipline,55,31,24
16532,Attenna,ravencrest,1178,priest,discipline,69,26,43
16533,Nnaoy,ysondre,1177,priest,discipline,26,13,13
16534,Парикнахер,soulflayer,1171,priest,discipline,36,23,13
16535,Captn,draenor,1171,priest,discipline,54,22,32
16536,Dartheon,twisting-nether,1171,priest,discipline,58,19,39
16537,Cøøbrà,hyjal,1170,priest,discipline,70,38,32
16538,Aeo,twisting-nether,1166,priest,discipline,47,20,27
16539,Aléhyl,la-croisade-écarlate,1164,priest,discipline,30,14,16
16540,Flyingdutch,tarren-mill,1164,priest,discipline,247,115,132
16541,Olîra,hyjal,1163,priest,discipline,30,14,16
16542,Yojoyo,draenor,1163,priest,discipline,97,44,53
16543,Eyecry,sylvanas,1162,priest,discipline,23,13,10
16544,Klaura,blackmoore,1161,priest,discipline,30,15,15
16545,Blàckângel,blackrock,1160,priest,discipline,306,153,153
16546,Монесса,howling-fjord,1159,priest,discipline,36,16,20
16547,Javvi,sylvanas,1158,priest,discipline,78,44,34
16548,Veecna,the-maelstrom,1158,priest,discipline,48,22,26
16549,Brunestùd,pozzo-delleternità,1157,priest,discipline,62,30,32
16550,Milessa,steamwheedle-cartel,1157,priest,discipline,42,17,25
16551,Ноубадди,howling-fjord,1155,priest,discipline,43,19,24
16552,Coldyxz,blackrock,1152,priest,discipline,18,12,6
16553,Найтингеилл,gordunni,1152,priest,discipline,24,12,12
16554,Donpedrila,kazzak,1152,priest,discipline,24,12,12
16555,Djokui,uldum,1152,priest,discipline,30,12,18
16556,Djrussia,tarren-mill,1152,priest,discipline,30,12,18
16557,Nàlak,archimonde,1151,priest,discipline,18,12,6
16558,Yesdaddypls,draenor,1151,priest,discipline,25,13,12
16559,Arythc,ahnqiraj,1151,priest,discipline,24,12,12
16560,Ксенонх,gordunni,1151,priest,discipline,24,12,12
16561,Deadsloth,hyjal,1151,priest,discipline,24,12,12
16562,Listrix,frostmane,1151,priest,discipline,30,12,18
16563,Trevorlahey,draenor,1150,priest,discipline,18,12,6
16564,Hasnoaim,dun-morogh,1150,priest,discipline,18,12,6
16565,Naomirussell,sylvanas,1150,priest,discipline,24,12,12
16566,Plsdontcry,blackrock,1150,priest,discipline,24,12,12
16567,Cadierna,argent-dawn,1150,priest,discipline,24,12,12
16568,Olurin,rajaxx,1150,priest,discipline,30,12,18
16569,Soloqbob,kazzak,1149,priest,discipline,30,12,18
16570,Discmoo,kazzak,1148,priest,discipline,20,12,8
16571,Neverlandx,bladefist,1147,priest,discipline,18,12,6
16572,Ashuramaru,drakthul,1147,priest,discipline,24,12,12
16573,Sameec,drakthul,1147,priest,discipline,24,12,12
16574,Indicta,darksorrow,1147,priest,discipline,27,13,14
16575,Péntagón,festung-der-stürme,1147,priest,discipline,30,12,18
16576,Deicidex,blackrock,1147,priest,discipline,36,12,24
16577,Holyskull,magtheridon,1146,priest,discipline,63,26,37
16578,Deeforce,argent-dawn,1146,priest,discipline,64,26,38
16579,Laërhia,archimonde,1146,priest,discipline,30,12,18
16580,Toorree,stormscale,1145,priest,discipline,18,12,6
16581,Darkest,ysondre,1145,priest,discipline,24,12,12
16582,Трихоманиаз,ashenvale,1145,priest,discipline,24,12,12
16583,Ballsbrawlz,sylvanas,1144,priest,discipline,18,12,6
16584,Ticklebell,ravencrest,1144,priest,discipline,48,30,18
16585,Dysko,alakir,1144,priest,discipline,24,12,12
16586,Fluvnidi,ravencrest,1144,priest,discipline,24,12,12
16587,Dankopriest,drakthul,1143,priest,discipline,18,12,6
16588,Eördög,ragnaros,1143,priest,discipline,24,12,12
16589,Keimohansio,twisting-nether,1143,priest,discipline,30,14,16
16590,Noskan,silvermoon,1141,priest,discipline,21,13,8
16591,Karzin,aggra-português,1141,priest,discipline,66,32,34
16592,Fåtkidx,ravencrest,1141,priest,discipline,30,12,18
16593,Daesa,defias-brotherhood,1140,priest,discipline,24,14,10
16594,Убивал,soulflayer,1140,priest,discipline,24,12,12
16595,Dotterin,draenor,1140,priest,discipline,24,12,12
16596,Тодохил,gordunni,1140,priest,discipline,30,12,18
16597,Healy,blackrock,1140,priest,discipline,36,13,23
16598,Ebolaidman,ravencrest,1139,priest,discipline,18,12,6
16599,Mädmän,draenor,1139,priest,discipline,72,38,34
16600,Vividots,draenor,1139,priest,discipline,24,12,12
16601,Kaydenkross,eredar,1139,priest,discipline,42,12,30
16602,Didinini,outland,1138,priest,discipline,36,21,15
16603,Alfaböna,outland,1138,priest,discipline,116,62,54
16604,Svevo,ravencrest,1138,priest,discipline,24,12,12
16605,Quinax,shattered-hand,1138,priest,discipline,24,12,12
16606,Boyraz,argent-dawn,1138,priest,discipline,48,21,27
16607,Chankro,sanguino,1137,priest,discipline,24,12,12
16608,Canthms,twisting-nether,1136,priest,discipline,36,22,14
16609,Drissz,archimonde,1135,priest,discipline,24,12,12
16610,Серыйлог,galakrond,1135,priest,discipline,24,12,12
16611,Lapinvicieux,archimonde,1135,priest,discipline,24,12,12
16612,Dotsin,kazzak,1135,priest,discipline,151,74,77
16613,Darkheall,sanguino,1135,priest,discipline,50,21,29
16614,Seras,bloodfeather,1134,priest,discipline,84,37,47
16615,Арабет,galakrond,1133,priest,discipline,73,40,33
16616,Taiyöshin,silvermoon,1132,priest,discipline,30,12,18
16617,Angusbeêf,blackrock,1131,priest,discipline,48,26,22
16618,Frittê,anetheron,1130,priest,discipline,39,20,19
16619,Miralou,ravencrest,1129,priest,discipline,120,63,57
16620,Ðøð,dalaran,1128,priest,discipline,30,18,12
16621,Ожившийприст,soulflayer,1128,priest,discipline,42,21,21
16622,Jeez,twilights-hammer,1127,priest,discipline,36,12,24
16623,Praystatîon,dragonblight,1125,priest,discipline,77,46,31
16624,Zenoo,argent-dawn,1122,priest,discipline,18,12,6
16625,Kurtse,archimonde,1121,priest,discipline,28,14,14
16626,Biblebabe,tarren-mill,1121,priest,discipline,24,12,12
16627,Марджелла,howling-fjord,1119,priest,discipline,28,13,15
16628,Iømÿnudir,archimonde,1119,priest,discipline,30,13,17
16629,Necromania,cthun,1118,priest,discipline,49,21,28
16630,Limpopon,doomhammer,1118,priest,discipline,36,14,22
16631,Алеброн,gordunni,1117,priest,discipline,29,12,17
16632,Sphard,ysondre,1113,priest,discipline,36,12,24
16633,Залупский,gordunni,1111,priest,discipline,24,12,12
16634,Пакетикдот,gordunni,1111,priest,discipline,42,19,23
16635,Стаминабаф,gordunni,1108,priest,discipline,21,13,8
16636,Glärë,burning-legion,1108,priest,discipline,29,16,13
16637,Chega,malganis,1108,priest,discipline,36,13,23
16638,Дракулесса,gordunni,1107,priest,discipline,23,12,11
16639,Lanaineuwu,archimonde,1105,priest,discipline,20,13,7
16640,Deckardkain,pozzo-delleternità,1105,priest,discipline,60,33,27
16641,Unleet,sylvanas,1105,priest,discipline,38,17,21
16642,Valente,twisting-nether,1105,priest,discipline,60,22,38
16643,Dinma,argent-dawn,1103,priest,discipline,59,27,32
16644,Lydîâ,blackhand,1102,priest,discipline,23,12,11
16645,Seherbazqt,twisting-nether,1101,priest,discipline,23,12,11
16646,Kyrédan,dalaran,1100,priest,discipline,80,40,40
16647,Möd,ragnaros,1100,priest,discipline,30,13,17
16648,Popegoat,ragnaros,1099,priest,discipline,29,23,6
16649,Mambanero,nemesis,1095,priest,discipline,53,23,30
16650,Mjölkpelle,twisting-nether,1092,priest,discipline,18,14,4
16651,Mønti,onyxia,1092,priest,discipline,33,17,16
16652,Praywingsebb,nazjatar,1091,priest,discipline,24,13,11
16653,Çiione,archimonde,1086,priest,discipline,29,12,17
16654,Trashpriest,blackrock,1086,priest,discipline,35,12,23
16655,Prognosis,frostwhisper,1083,priest,discipline,36,17,19
16656,Saénna,burning-legion,1083,priest,discipline,26,12,14
16657,Tristar,nethersturm,1081,priest,discipline,23,12,11
16658,Nellytaa,dalaran,1080,priest,discipline,33,17,16
16659,Salskagripme,ragnaros,1079,priest,discipline,18,12,6
16660,Гомотряс,howling-fjord,1079,priest,discipline,102,54,48
16661,Bálíé,blackmoore,1077,priest,discipline,48,23,25
16662,Zerula,outland,1077,priest,discipline,90,41,49
16663,Waxosc,silvermoon,1076,priest,discipline,62,25,37
16664,Ghostroller,ravencrest,1075,priest,discipline,23,12,11
16665,Enilion,draenor,1071,priest,discipline,32,13,19
16666,Gudrinieks,shattered-halls,1070,priest,discipline,32,13,19
16667,Lunairess,silvermoon,1069,priest,discipline,84,28,56
16668,Mournus,defias-brotherhood,1065,priest,discipline,17,12,5
16669,Юкич,soulflayer,1065,priest,discipline,34,12,22
16670,Sisdenna,doomhammer,1063,priest,discipline,108,54,54
16671,Prazefin,twisting-nether,1060,priest,discipline,22,13,9
16672,Yânùx,aegwynn,1056,priest,discipline,12,11,1
16673,Asgà,stormscale,1056,priest,discipline,18,11,7
16674,Schwypsvnr,garona,1056,priest,discipline,18,11,7
16675,Bindww,tarren-mill,1056,priest,discipline,18,11,7
16676,Prïstië,drakthul,1056,priest,discipline,54,26,28
16677,Stormmyy,kazzak,1056,priest,discipline,24,11,13
16678,Secø,sylvanas,1056,priest,discipline,24,11,13
16679,Tazn,thrall,1056,priest,discipline,24,11,13
16680,Bølzer,blackrock,1056,priest,discipline,24,11,13
16681,Carpathîan,blackhand,1056,priest,discipline,72,25,47
16682,Гоплзнекст,gordunni,1055,priest,discipline,18,11,7
16683,Depridolens,argent-dawn,1055,priest,discipline,18,11,7
16684,Yungblessing,stormscale,1055,priest,discipline,24,11,13
16685,Pureàngel,ravencrest,1055,priest,discipline,24,11,13
16686,Oscoolytb,archimonde,1055,priest,discipline,30,11,19
16687,Baptized,baelgun,1055,priest,discipline,30,11,19
16688,Ylenae,twisting-nether,1055,priest,discipline,30,11,19
16689,Piperxp,ravencrest,1054,priest,discipline,18,11,7
16690,Shallteár,doomhammer,1054,priest,discipline,24,11,13
16691,Yuukii,kult-der-verdammten,1054,priest,discipline,24,11,13
16692,Faintly,emeriss,1054,priest,discipline,24,11,13
16693,Anzee,tarren-mill,1054,priest,discipline,24,11,13
16694,Азмоддан,azuregos,1054,priest,discipline,36,11,25
16695,Szycho,burning-legion,1054,priest,discipline,36,11,25
16696,Lerión,ravencrest,1053,priest,discipline,18,11,7
16697,Zeatt,ysera,1053,priest,discipline,18,11,7
16698,Snusprällen,sylvanas,1053,priest,discipline,24,11,13
16699,Drwho,zuljin,1053,priest,discipline,33,12,21
16700,Trénboloné,tarren-mill,1052,priest,discipline,24,11,13
16701,Cajolîne,archimonde,1052,priest,discipline,24,11,13
16702,Inaeries,argent-dawn,1051,priest,discipline,35,20,15
16703,Ihaveibs,doomhammer,1051,priest,discipline,24,11,13
16704,Nevermyndz,blackmoore,1051,priest,discipline,24,11,13
16705,Cursedme,blackrock,1050,priest,discipline,18,11,7
16706,Junglepriest,ravencrest,1050,priest,discipline,24,11,13
16707,Baloopriest,grim-batol,1050,priest,discipline,30,11,19
16708,Angelic,ragnaros,1050,priest,discipline,30,11,19
16709,Icyc,outland,1049,priest,discipline,42,11,31
16710,Nøwénna,ravencrest,1049,priest,discipline,42,11,31
16711,Grausami,zuluhed,1048,priest,discipline,18,11,7
16712,Sanril,ragnaros,1048,priest,discipline,24,11,13
16713,Neseig,blutkessel,1047,priest,discipline,18,11,7
16714,Yurrij,thrall,1047,priest,discipline,18,11,7
16715,Ilostmybible,runetotem,1047,priest,discipline,28,12,16
16716,Hellsaya,ysondre,1046,priest,discipline,16,12,4
16717,Мерседулька,howling-fjord,1046,priest,discipline,22,12,10
16718,Ichpvpeuch,eredar,1046,priest,discipline,24,11,13
16719,Eowins,blackmoore,1046,priest,discipline,28,12,16
16720,Болътвоя,gordunni,1045,priest,discipline,18,11,7
16721,Jeanpipe,khaz-modan,1044,priest,discipline,12,11,1
16722,Ginebra,archimonde,1044,priest,discipline,18,11,7
16723,Needmana,hyjal,1044,priest,discipline,36,15,21
16724,Kaos,anetheron,1043,priest,discipline,15,13,2
16725,Apeist,outland,1042,priest,discipline,24,11,13
16726,Chocopríest,blackmoore,1041,priest,discipline,24,11,13
16727,Barracuda,burning-legion,1041,priest,discipline,24,11,13
16728,Soupana,darksorrow,1041,priest,discipline,24,11,13
16729,Thörbjorn,confrérie-du-thorium,1039,priest,discipline,24,12,12
16730,Worstdisceu,draenor,1039,priest,discipline,24,11,13
16731,Джейнкелли,borean-tundra,1038,priest,discipline,18,15,3
16732,Joebando,ravencrest,1038,priest,discipline,62,29,33
16733,Spoc,blackrock,1037,priest,discipline,18,11,7
16734,Juhduss,tarren-mill,1036,priest,discipline,18,11,7
16735,Whitemané,argent-dawn,1033,priest,discipline,50,25,25
16736,Cheja,ravencrest,1033,priest,discipline,30,11,19
16737,Loetharion,archimonde,1032,priest,discipline,18,11,7
16738,Pandalulz,turalyon,1031,priest,discipline,22,14,8
16739,Devîlcry,nordrassil,1030,priest,discipline,36,18,18
16740,Pasalacabra,zuljin,1030,priest,discipline,24,11,13
16741,Îndura,drakthul,1029,priest,discipline,70,33,37
16742,Nupzie,stormscale,1029,priest,discipline,39,15,24
16743,Rydzyk,laughing-skull,1028,priest,discipline,24,13,11
16744,Mocnymaco,burning-blade,1024,priest,discipline,115,59,56
16745,Bakris,twisting-nether,1024,priest,discipline,24,11,13
16746,Noserenity,outland,1023,priest,discipline,17,11,6
16747,Tmnewho,outland,1022,priest,discipline,22,12,10
16748,Tori,marécage-de-zangar,1021,priest,discipline,20,12,8
16749,Kæzm,blackrock,1020,priest,discipline,23,11,12
16750,Ylvanna,arthas,1020,priest,discipline,28,11,17
16751,Massdispell,silvermoon,1018,priest,discipline,22,11,11
16752,Sòsò,archimonde,1018,priest,discipline,60,25,35
16753,Deathspawn,hellscream,1016,priest,discipline,39,20,19
16754,Gronni,argent-dawn,1014,priest,discipline,24,13,11
16755,Xanndro,argent-dawn,1014,priest,discipline,34,13,21
16756,Фрустрациия,soulflayer,1013,priest,discipline,20,12,8
16757,Chukwundi,ravencrest,1013,priest,discipline,36,12,24
16758,Yøzø,blackhand,1009,priest,discipline,63,27,36
16759,Hinkelstein,defias-brotherhood,1008,priest,discipline,32,18,14
16760,Zurlyne,ravencrest,1007,priest,discipline,21,12,9
16761,Discoruzki,ravencrest,1007,priest,discipline,23,11,12
16762,Vebbysor,sylvanas,1007,priest,discipline,24,11,13
16763,Howlscastie,stormscale,1007,priest,discipline,54,22,32
16764,Darknun,aggra-português,1004,priest,discipline,29,11,18
16765,Boomhilde,aegwynn,1003,priest,discipline,182,89,93
16766,Sixeus,outland,1002,priest,discipline,26,12,14
16767,Mijuuk,zuljin,1000,priest,discipline,36,23,13
16768,Buzzard,frostmourne,998,priest,discipline,18,12,6
16769,Rrpriest,silvermoon,998,priest,discipline,68,23,45
16770,Вальдемарс,howling-fjord,996,priest,discipline,29,11,18
16771,Kenderke,ragnaros,994,priest,discipline,23,11,12
16772,Negativeapm,archimonde,991,priest,discipline,17,11,6
16773,Therealopa,blackmoore,991,priest,discipline,98,45,53
16774,Huzlin,kazzak,983,priest,discipline,28,11,17
16775,Lichtelaaie,quelthalas,980,priest,discipline,24,15,9
16776,Satanspawn,neptulon,977,priest,discipline,64,23,41
16777,Semper,sylvanas,974,priest,discipline,22,11,11
16778,Borrex,sanguino,971,priest,discipline,13,11,2
16779,Shalacho,blackrock,970,priest,discipline,52,23,29
16780,Эрьеро,gordunni,970,priest,discipline,36,11,25
16781,Snoopqt,dalaran,965,priest,discipline,31,11,20
16782,Presbyter,mazrigos,961,priest,discipline,21,11,10
16783,Piccolamorte,ysondre,960,priest,discipline,12,10,2
16784,Hopeso,silvermoon,960,priest,discipline,12,10,2
16785,Ghettonelf,sylvanas,960,priest,discipline,12,10,2
16786,Stargal,blackmoore,960,priest,discipline,12,10,2
16787,Teradros,blackhand,960,priest,discipline,18,10,8
16788,Rîeka,antonidas,960,priest,discipline,18,10,8
16789,Lowery,argent-dawn,960,priest,discipline,18,10,8
16790,Theythem,stormscale,960,priest,discipline,18,10,8
16791,Asýnc,ravencrest,960,priest,discipline,18,10,8
16792,Ринкуку,howling-fjord,960,priest,discipline,18,10,8
16793,Пухлаясвинка,fordragon,960,priest,discipline,18,10,8
16794,Bekznfiend,ragnaros,960,priest,discipline,18,10,8
16795,Фотосз,soulflayer,960,priest,discipline,18,10,8
16796,Plsdontnerf,onyxia,960,priest,discipline,18,10,8
16797,Rmpriest,blackhand,960,priest,discipline,24,10,14
16798,Лэсивэснэс,soulflayer,960,priest,discipline,30,10,20
16799,Alicanx,silvermoon,959,priest,discipline,12,10,2
16800,Casic,blackhand,959,priest,discipline,12,10,2
16801,Yaoz,sanguino,959,priest,discipline,18,10,8
16802,Luckystar,grim-batol,959,priest,discipline,18,10,8
16803,Ðaala,blackrock,959,priest,discipline,18,10,8
16804,Towelie,stormscale,959,priest,discipline,18,10,8
16805,Рыжаякискис,soulflayer,959,priest,discipline,18,10,8
16806,Healbotmvp,ravencrest,959,priest,discipline,18,10,8
16807,Waffur,twisting-nether,959,priest,discipline,18,10,8
16808,Giggí,malganis,959,priest,discipline,18,10,8
16809,Joeasaurs,ragnaros,959,priest,discipline,21,11,10
16810,Aurorä,burning-legion,959,priest,discipline,24,10,14
16811,Loarderonx,stormscale,959,priest,discipline,24,10,14
16812,Loliheal,blackmoore,959,priest,discipline,28,11,17
16813,Ykiotonegawa,twisting-nether,959,priest,discipline,30,10,20
16814,Zarez,stormscale,959,priest,discipline,38,12,26
16815,Mêduse,ravencrest,959,priest,discipline,39,11,28
16816,Joeelz,blackmoore,958,priest,discipline,18,10,8
16817,Vynivan,korgall,958,priest,discipline,18,10,8
16818,Vo,dentarg,958,priest,discipline,18,10,8
16819,Ezcobar,twilights-hammer,958,priest,discipline,18,10,8
16820,Sadgelands,outland,958,priest,discipline,18,10,8
16821,Goldgot,tarren-mill,958,priest,discipline,18,10,8
16822,Gingerflexay,archimonde,958,priest,discipline,18,10,8
16823,Radiancekey,sanguino,958,priest,discipline,24,10,14
16824,Manau,culte-de-la-rive-noire,958,priest,discipline,24,10,14
16825,Ømñyx,outland,958,priest,discipline,24,10,14
16826,Dotreveal,ravencrest,958,priest,discipline,27,11,16
16827,Aboû,archimonde,957,priest,discipline,18,10,8
16828,Anyndra,twisting-nether,957,priest,discipline,18,10,8
16829,Mackópriest,ragnaros,957,priest,discipline,30,10,20
16830,Вейтарен,gordunni,957,priest,discipline,30,10,20
16831,Cidrea,saurfang,956,priest,discipline,18,10,8
16832,Nastynina,frostwhisper,956,priest,discipline,24,10,14
16833,Nunnis,kazzak,955,priest,discipline,114,59,55
16834,Zyrexan,defias-brotherhood,955,priest,discipline,30,10,20
16835,Linara,frostmane,954,priest,discipline,12,10,2
16836,Chilltcaster,blackrock,954,priest,discipline,26,10,16
16837,Calsote,sanguino,952,priest,discipline,30,10,20
16838,Matsipri,sylvanas,951,priest,discipline,24,10,14
16839,Фионыч,blackscar,951,priest,discipline,24,10,14
16840,Voidjutsu,draenor,950,priest,discipline,18,10,8
16841,Desperion,ragnaros,949,priest,discipline,24,10,14
16842,Mallkie,ysondre,947,priest,discipline,18,10,8
16843,Priincess,ragnaros,947,priest,discipline,22,12,10
16844,Vecaya,blackrock,945,priest,discipline,18,10,8
16845,Заплетальщик,howling-fjord,942,priest,discipline,40,20,20
16846,Togx,silvermoon,942,priest,discipline,24,10,14
16847,Felbs,defias-brotherhood,941,priest,discipline,51,16,35
16848,Perlo,sanguino,940,priest,discipline,83,44,39
16849,Moinmeister,frostmourne,939,priest,discipline,29,15,14
16850,Khai,tarren-mill,935,priest,discipline,65,27,38
16851,Sednâ,conseil-des-ombres,931,priest,discipline,23,10,13
16852,Eleveno,ravencrest,928,priest,discipline,48,24,24
16853,Лайбаси,howling-fjord,927,priest,discipline,24,11,13
16854,Yante,ragnaros,926,priest,discipline,24,12,12
16855,Pavyone,twisting-nether,926,priest,discipline,23,10,13
16856,Taili,ysondre,925,priest,discipline,20,11,9
16857,Meodor,antonidas,923,priest,discipline,24,14,10
16858,Kallsen,ravencrest,920,priest,discipline,27,15,12
16859,Pulttipiispa,ravencrest,916,priest,discipline,23,10,13
16860,Elba,defias-brotherhood,916,priest,discipline,24,10,14
16861,Kashmirweed,ravencrest,916,priest,discipline,48,17,31
16862,Аргла,soulflayer,912,priest,discipline,66,24,42
16863,Titibolls,sanguino,908,priest,discipline,23,10,13
16864,Immórtal,tarren-mill,908,priest,discipline,30,10,20
16865,Ebashuvkashu,stormscale,906,priest,discipline,23,10,13
16866,Morgoh,die-arguswacht,906,priest,discipline,54,23,31
16867,Steadyog,doomhammer,905,priest,discipline,18,11,7
16868,Mércíless,ravencrest,905,priest,discipline,17,10,7
16869,Vepa,blackrock,903,priest,discipline,34,15,19
16870,Theunknown,stormscale,903,priest,discipline,29,11,18
16871,Nosgot,earthen-ring,898,priest,discipline,24,12,12
16872,Absinthamos,eredar,895,priest,discipline,16,10,6
16873,Aliciakeys,twilights-hammer,892,priest,discipline,28,10,18
16874,Wynkx,zuljin,891,priest,discipline,23,10,13
16875,Shnookfour,agamaggan,882,priest,discipline,22,12,10
16876,Blååb,draenor,879,priest,discipline,19,10,9
16877,Priezeke,aggramar,878,priest,discipline,18,10,8
16878,Chillx,blackmoore,878,priest,discipline,85,45,40
16879,Pnsl,dun-morogh,873,priest,discipline,33,11,22
16880,Amaretta,perenolde,872,priest,discipline,32,13,19
16881,Borgír,burning-legion,871,priest,discipline,27,11,16
16882,Toks,stormscale,871,priest,discipline,45,10,35
16883,Elfiontko,burning-legion,870,priest,discipline,24,11,13
16884,Bilbobanging,aggramar,864,priest,discipline,12,9,3
16885,Slovak,stormscale,864,priest,discipline,12,9,3
16886,Qpapi,quelthalas,864,priest,discipline,12,9,3
16887,Lexojam,ravencrest,864,priest,discipline,12,9,3
16888,Priéstitude,kazzak,864,priest,discipline,12,9,3
16889,Pohja,veknilash,864,priest,discipline,12,9,3
16890,Jpucciù,ysondre,864,priest,discipline,12,9,3
16891,Cinnamoroll,ravencrest,864,priest,discipline,12,9,3
16892,Жентельмен,deathguard,864,priest,discipline,18,9,9
16893,Dexlolo,stormscale,864,priest,discipline,18,9,9
16894,Zyrean,bronzebeard,864,priest,discipline,18,9,9
16895,Størmblaze,stormreaver,864,priest,discipline,18,9,9
16896,Lexìì,archimonde,864,priest,discipline,18,9,9
16897,Myggsparv,stormscale,864,priest,discipline,18,9,9
16898,Djros,magtheridon,864,priest,discipline,18,9,9
16899,Kavrack,dalaran,864,priest,discipline,18,9,9
16900,Muant,twisting-nether,864,priest,discipline,18,9,9
16901,Undeathy,ravencrest,864,priest,discipline,18,9,9
16902,Svetozarov,wildhammer,864,priest,discipline,18,9,9
16903,Sørcedote,dun-modr,864,priest,discipline,18,9,9
16904,Choron,kult-der-verdammten,864,priest,discipline,18,9,9
16905,Антошашвп,azuregos,864,priest,discipline,18,9,9
16906,Yroe,gorgonnash,864,priest,discipline,18,9,9
16907,Падлез,howling-fjord,864,priest,discipline,24,9,15
16908,Próxs,ravencrest,864,priest,discipline,24,9,15
16909,Notnowelf,silvermoon,864,priest,discipline,24,9,15
16910,Itsdiscobaby,auchindoun,864,priest,discipline,24,9,15
16911,Frígídhealz,outland,864,priest,discipline,24,9,15
16912,Smitebone,tarren-mill,864,priest,discipline,24,9,15
16913,Chocomiette,archimonde,864,priest,discipline,25,9,16
16914,Radiance,emeriss,864,priest,discipline,28,10,18
16915,Devastris,ravencrest,864,priest,discipline,30,9,21
16916,Elinaa,die-aldor,863,priest,discipline,12,9,3
16917,Fearadelia,thrall,863,priest,discipline,12,9,3
16918,Ectria,ravencrest,863,priest,discipline,18,9,9
16919,Øk,draenor,863,priest,discipline,18,9,9
16920,Markianos,silvermoon,863,priest,discipline,18,9,9
16921,Sacreth,ragnaros,863,priest,discipline,18,9,9
16922,Mïxa,eitrigg,863,priest,discipline,18,9,9
16923,Giily,archimonde,863,priest,discipline,18,9,9
16924,Ratingfeeder,tarren-mill,863,priest,discipline,18,9,9
16925,Naberus,ragnaros,863,priest,discipline,19,9,10
16926,Sctheal,outland,863,priest,discipline,24,9,15
16927,Intentoso,nemesis,863,priest,discipline,24,9,15
16928,Rixis,la-croisade-écarlate,863,priest,discipline,24,9,15
16929,Xyliqa,aegwynn,863,priest,discipline,24,9,15
16930,Mysticforces,silvermoon,863,priest,discipline,24,9,15
16931,Gnomeeater,silvermoon,862,priest,discipline,12,9,3
16932,Joeshmoex,blackrock,862,priest,discipline,12,9,3
16933,Vandansk,kazzak,862,priest,discipline,12,9,3
16934,Søkariss,elune,862,priest,discipline,12,9,3
16935,Sandcastles,ravencrest,862,priest,discipline,18,9,9
16936,Carlye,stormreaver,862,priest,discipline,18,9,9
16937,Skyalpha,silvermoon,862,priest,discipline,18,9,9
16938,Сегуната,howling-fjord,862,priest,discipline,24,9,15
16939,Vædan,drakthul,861,priest,discipline,12,9,3
16940,Reäzx,archimonde,861,priest,discipline,18,9,9
16941,Drüdkh,tarren-mill,861,priest,discipline,30,9,21
16942,Brênos,blackmoore,860,priest,discipline,18,9,9
16943,Symeria,sylvanas,859,priest,discipline,18,9,9
16944,Shadoomed,kazzak,859,priest,discipline,24,9,15
16945,Nhajÿ,hyjal,859,priest,discipline,24,9,15
16946,Priestige,spinebreaker,858,priest,discipline,18,9,9
16947,Щявыхилим,howling-fjord,857,priest,discipline,13,9,4
16948,Fatalyse,ysondre,857,priest,discipline,36,16,20
16949,Pénancé,defias-brotherhood,856,priest,discipline,24,9,15
16950,Plaguetale,archimonde,855,priest,discipline,12,9,3
16951,Пофанчику,soulflayer,855,priest,discipline,18,9,9
16952,Nilsatis,grim-batol,855,priest,discipline,59,25,34
16953,Fingerblast,sanguino,853,priest,discipline,18,9,9
16954,Reighl,drakthul,850,priest,discipline,18,9,9
16955,Drynte,blackmoore,847,priest,discipline,23,9,14
16956,Cav,archimonde,846,priest,discipline,23,9,14
16957,Evastemplar,turalyon,836,priest,discipline,24,9,15
16958,Socratés,antonidas,834,priest,discipline,66,27,39
16959,Spooka,ravencrest,831,priest,discipline,17,9,8
16960,Mílérí,ravencrest,830,priest,discipline,23,9,14
16961,Тэслос,howling-fjord,829,priest,discipline,23,9,14
16962,Waikiki,ambossar,827,priest,discipline,16,10,6
16963,Zthul,draenor,815,priest,discipline,21,10,11
16964,Ladá,stormscale,815,priest,discipline,19,9,10
16965,Squidlicker,twisting-nether,814,priest,discipline,17,9,8
16966,Lauriinda,culte-de-la-rive-noire,809,priest,discipline,19,10,9
16967,Zofa,sunstrider,809,priest,discipline,21,9,12
16968,Solaní,antonidas,808,priest,discipline,26,11,15
16969,Давалкасвета,gordunni,807,priest,discipline,27,10,17
16970,Djleffe,stormscale,799,priest,discipline,11,9,2
16971,Pillian,nordrassil,799,priest,discipline,16,9,7
16972,Tremrfinger,dun-modr,798,priest,discipline,14,9,5
16973,Gandzaa,silvermoon,785,priest,discipline,21,9,12
16974,Протомуу,gordunni,783,priest,discipline,11,9,2
16975,Homxcxde,ravencrest,777,priest,discipline,26,10,16
16976,Ewamlf,drakthul,768,priest,discipline,12,8,4
16977,Killafoolx,silvermoon,768,priest,discipline,12,8,4
16978,Shdwxy,blackrock,768,priest,discipline,12,8,4
16979,Gobblestick,draenor,768,priest,discipline,12,8,4
16980,Raeratwo,archimonde,768,priest,discipline,12,8,4
16981,Ltr,tarren-mill,768,priest,discipline,12,8,4
16982,Oldnbad,archimonde,768,priest,discipline,12,8,4
16983,Makrophage,mannoroth,768,priest,discipline,12,8,4
16984,Omgitshuux,blackmoore,768,priest,discipline,12,8,4
16985,Csúforck,ragnaros,768,priest,discipline,12,8,4
16986,Joeblowx,blackrock,768,priest,discipline,12,8,4
16987,Anabølix,ravencrest,768,priest,discipline,12,8,4
16988,Lmnsqzy,ravencrest,768,priest,discipline,12,8,4
16989,Voxqt,blackrock,768,priest,discipline,12,8,4
16990,Absôlutvôdka,twisting-nether,768,priest,discipline,12,8,4
16991,Orkanwal,ravencrest,768,priest,discipline,12,8,4
16992,Xandrial,blackmoore,768,priest,discipline,12,8,4
16993,Iyannà,blackrock,768,priest,discipline,12,8,4
16994,Nyell,silvermoon,768,priest,discipline,12,8,4
16995,Nazo,sylvanas,768,priest,discipline,19,9,10
16996,Asherá,kazzak,768,priest,discipline,18,8,10
16997,Nstp,zuljin,768,priest,discipline,18,8,10
16998,Azpr,ravencrest,768,priest,discipline,18,8,10
16999,Uanna,ravencrest,768,priest,discipline,18,8,10
17000,Manäka,hyjal,768,priest,discipline,18,8,10
17001,Aelíth,archimonde,768,priest,discipline,18,8,10
17002,Louiepr,outland,768,priest,discipline,18,8,10
17003,Jp,gorgonnash,768,priest,discipline,18,8,10
17004,Pikaboom,the-maelstrom,768,priest,discipline,18,8,10
17005,Preme,blackhand,768,priest,discipline,18,8,10
17006,Yânux,aegwynn,768,priest,discipline,18,8,10
17007,Theblank,pozzo-delleternità,768,priest,discipline,18,8,10
17008,Ssjx,ravencrest,768,priest,discipline,18,8,10
17009,Kristianburn,arathi,768,priest,discipline,18,8,10
17010,Blerd,eredar,768,priest,discipline,18,8,10
17011,Phyxiusx,stormscale,768,priest,discipline,18,8,10
17012,Hurtless,ravencrest,768,priest,discipline,21,8,13
17013,Zuniqa,die-aldor,768,priest,discipline,24,8,16
17014,Trickyteè,tarren-mill,768,priest,discipline,24,8,16
17015,Chabih,ravencrest,768,priest,discipline,24,8,16
17016,Rmp,stormscale,768,priest,discipline,24,8,16
17017,Nuriva,frostmane,768,priest,discipline,30,8,22
17018,Cainactor,drakthul,767,priest,discipline,12,8,4
17019,Pumpkin,aggramar,767,priest,discipline,12,8,4
17020,Ðelftware,tarren-mill,767,priest,discipline,12,8,4
17021,Neeti,kazzak,767,priest,discipline,12,8,4
17022,Ompala,shattered-hand,767,priest,discipline,12,8,4
17023,Apøcalypso,antonidas,767,priest,discipline,12,8,4
17024,Rihx,ysondre,767,priest,discipline,12,8,4
17025,Kletroll,archimonde,767,priest,discipline,12,8,4
17026,Durinko,thunderhorn,767,priest,discipline,18,8,10
17027,Døgfîsh,stormscale,767,priest,discipline,18,8,10
17028,Kitanai,silvermoon,767,priest,discipline,18,8,10
17029,Diskogoblin,drakthul,767,priest,discipline,18,8,10
17030,Dathanosx,outland,767,priest,discipline,18,8,10
17031,Pìkachù,stormscale,767,priest,discipline,18,8,10
17032,Smokäy,blackhand,767,priest,discipline,18,8,10
17033,Velosp,defias-brotherhood,767,priest,discipline,18,8,10
17034,Luminouzilla,tarren-mill,767,priest,discipline,18,8,10
17035,Gumer,antonidas,767,priest,discipline,18,8,10
17036,Spèrman,frostwolf,767,priest,discipline,18,8,10
17037,Holyshifts,silvermoon,767,priest,discipline,18,8,10
17038,Arwén,zuljin,767,priest,discipline,18,8,10
17039,Khaag,korgall,767,priest,discipline,18,8,10
17040,Prästbaazil,ragnaros,767,priest,discipline,18,8,10
17041,Saskiaa,doomhammer,767,priest,discipline,24,9,15
17042,Healenax,ravencrest,767,priest,discipline,24,8,16
17043,Nahni,teldrassil,767,priest,discipline,24,8,16
17044,Aerosoll,drakthul,766,priest,discipline,12,8,4
17045,Smålbenör,stormreaver,766,priest,discipline,12,8,4
17046,Drennaria,draenor,766,priest,discipline,17,8,9
17047,Chuntriest,shadowsong,766,priest,discipline,18,8,10
17048,Lianny,sylvanas,766,priest,discipline,18,8,10
17049,Letmehêal,archimonde,766,priest,discipline,18,8,10
17050,Appox,amanthul,766,priest,discipline,18,8,10
17051,Baybe,ravencrest,765,priest,discipline,12,8,4
17052,Amambo,chamber-of-aspects,765,priest,discipline,12,8,4
17053,Pure,kazzak,765,priest,discipline,12,8,4
17054,Akadras,blackmoore,765,priest,discipline,12,8,4
17055,Pocketsimp,stormscale,765,priest,discipline,18,8,10
17056,Thakjing,bladefist,765,priest,discipline,24,8,16
17057,Uglypriest,grim-batol,764,priest,discipline,12,8,4
17058,Buttafly,archimonde,764,priest,discipline,18,8,10
17059,Sytawa,blackmoore,764,priest,discipline,18,8,10
17060,Irenedwen,silvermoon,764,priest,discipline,18,8,10
17061,Leønix,malfurion,763,priest,discipline,15,9,6
17062,Жрицазла,soulflayer,763,priest,discipline,18,8,10
17063,Mefeon,draenor,763,priest,discipline,18,8,10
17064,Nightshådøw,silvermoon,762,priest,discipline,22,10,12
17065,Xmassdispel,tarren-mill,762,priest,discipline,18,8,10
17066,Rashyd,sylvanas,761,priest,discipline,12,8,4
17067,Sîanah,archimonde,754,priest,discipline,12,8,4
17068,Попячебрило,gordunni,754,priest,discipline,18,8,10
17069,Healheal,outland,753,priest,discipline,18,8,10
17070,Omened,nemesis,751,priest,discipline,17,8,9
17071,Tïniebla,dun-modr,750,priest,discipline,18,8,10
17072,Carcaz,blackmoore,750,priest,discipline,23,10,13
17073,Йуп,ashenvale,735,priest,discipline,16,9,7
17074,Ислейн,howling-fjord,735,priest,discipline,29,8,21
17075,Blorpan,tarren-mill,734,priest,discipline,26,9,17
17076,Bigfnatlund,silvermoon,733,priest,discipline,17,8,9
17077,Cthultist,dun-modr,728,priest,discipline,26,9,17
17078,Abstauberin,blackrock,723,priest,discipline,22,8,14
17079,Lyim,stormscale,719,priest,discipline,11,8,3
17080,Bigwoopsie,stormscale,719,priest,discipline,19,9,10
17081,Hidary,ysondre,717,priest,discipline,21,9,12
17082,Chnechnechne,outland,714,priest,discipline,23,10,13
17083,Telpriest,blackrock,710,priest,discipline,25,9,16
17084,Greenlizard,stormreaver,704,priest,discipline,22,8,14
17085,Mindcrackr,stormscale,702,priest,discipline,12,9,3
17086,Sacerdotini,outland,702,priest,discipline,19,9,10
17087,Disconsick,vashj,702,priest,discipline,32,8,24
17088,Pristerline,antonidas,687,priest,discipline,13,8,5
17089,Trixix,ragnaros,684,priest,discipline,14,8,6
17090,Pattie,ragnaros,672,priest,discipline,12,7,5
17091,Bebydaniwey,eredar,672,priest,discipline,12,7,5
17092,Sinnestrike,tarren-mill,672,priest,discipline,12,7,5
17093,Sydnex,blackmoore,672,priest,discipline,12,7,5
17094,Mdmaster,stormreaver,672,priest,discipline,12,7,5
17095,Iloveilka,madmortem,672,priest,discipline,12,7,5
17096,Lèss,ysondre,672,priest,discipline,12,7,5
17097,Смайтвайфу,howling-fjord,672,priest,discipline,12,7,5
17098,Dealtime,ysondre,672,priest,discipline,12,7,5
17099,Xians,alakir,672,priest,discipline,12,7,5
17100,Furtnajebany,tarren-mill,672,priest,discipline,12,7,5
17101,Binkx,tarren-mill,672,priest,discipline,12,7,5
17102,Nightsøul,ragnaros,672,priest,discipline,12,7,5
17103,Swd,dun-morogh,672,priest,discipline,12,7,5
17104,Moppriest,twisting-nether,672,priest,discipline,12,7,5
17105,Obbdasknob,ravencrest,672,priest,discipline,12,7,5
17106,Cøvu,draenor,672,priest,discipline,12,7,5
17107,Wurstpriest,silvermoon,672,priest,discipline,12,7,5
17108,Feniyxa,die-aldor,672,priest,discipline,12,7,5
17109,Gladíator,blackhand,672,priest,discipline,12,7,5
17110,Healicious,teldrassil,672,priest,discipline,12,7,5
17111,Vicwix,draenor,672,priest,discipline,12,7,5
17112,Bunnygxrl,ravencrest,672,priest,discipline,12,7,5
17113,Smiteweaver,drakthul,672,priest,discipline,12,7,5
17114,Kapts,twisting-nether,672,priest,discipline,12,7,5
17115,Wyrofear,ragnaros,672,priest,discipline,12,7,5
17116,Fkitweball,argent-dawn,672,priest,discipline,12,7,5
17117,Morphics,silvermoon,672,priest,discipline,12,7,5
17118,Arjak,stormscale,672,priest,discipline,12,7,5
17119,Longheals,stormscale,672,priest,discipline,12,7,5
17120,Magiclands,twisting-nether,672,priest,discipline,12,7,5
17121,Tifa,ravencrest,672,priest,discipline,12,7,5
17122,Yarok,anubarak,672,priest,discipline,12,7,5
17123,Yungmazikeen,archimonde,672,priest,discipline,12,7,5
17124,Goodra,sylvanas,672,priest,discipline,12,7,5
17125,Infandus,pozzo-delleternità,672,priest,discipline,12,7,5
17126,Dombili,frostmane,672,priest,discipline,12,7,5
17127,Striderz,outland,672,priest,discipline,12,7,5
17128,Plåster,dunemaul,672,priest,discipline,12,7,5
17129,Gudjon,dragonblight,672,priest,discipline,12,7,5
17130,Xourin,blackrock,672,priest,discipline,16,8,8
17131,Soziy,silvermoon,672,priest,discipline,15,7,8
17132,Ominoushell,twisting-nether,672,priest,discipline,15,7,8
17133,Halysis,chamber-of-aspects,672,priest,discipline,16,7,9
17134,Holysjodin,tarren-mill,672,priest,discipline,18,7,11
17135,Nancey,draenor,672,priest,discipline,18,7,11
17136,Cház,sanguino,672,priest,discipline,18,7,11
17137,Опрометчивый,soulflayer,672,priest,discipline,18,7,11
17138,Zërøx,ysondre,672,priest,discipline,18,7,11
17139,Mythasz,archimonde,672,priest,discipline,18,7,11
17140,Träskfarfar,tarren-mill,672,priest,discipline,18,7,11
17141,Bij,outland,672,priest,discipline,18,7,11
17142,Faithz,ragnaros,672,priest,discipline,18,7,11
17143,Nidetha,draenor,672,priest,discipline,18,7,11
17144,Bubblebuddy,draenor,672,priest,discipline,18,7,11
17145,Undeadpriest,aegwynn,672,priest,discipline,18,7,11
17146,Priszt,arathor,672,priest,discipline,18,7,11
17147,Ðanilosp,dun-modr,672,priest,discipline,18,7,11
17148,Exaneo,ragnaros,672,priest,discipline,24,7,17
17149,Ptrspriest,twisting-nether,672,priest,discipline,24,7,17
17150,Skinandbones,sylvanas,672,priest,discipline,24,7,17
17151,Hónòr,sylvanas,672,priest,discipline,24,7,17
17152,Helikipope,kazzak,671,priest,discipline,12,7,5
17153,Bromine,twisting-nether,671,priest,discipline,12,7,5
17154,Chokmâh,sanguino,671,priest,discipline,12,7,5
17155,Xvpr,trollbane,671,priest,discipline,12,7,5
17156,Svistis,ravencrest,671,priest,discipline,12,7,5
17157,Saltfeskball,tarren-mill,671,priest,discipline,12,7,5
17158,Ylivoima,stormscale,671,priest,discipline,12,7,5
17159,Aeritha,blackmoore,671,priest,discipline,12,7,5
17160,Balhlin,argent-dawn,671,priest,discipline,12,7,5
17161,Fargall,eonar,671,priest,discipline,12,7,5
17162,Сайларс,howling-fjord,671,priest,discipline,12,7,5
17163,Gagai,ravencrest,671,priest,discipline,12,7,5
17164,Chilie,ravencrest,671,priest,discipline,12,7,5
17165,Phoskitos,sanguino,671,priest,discipline,12,7,5
17166,Ezhealing,ravencrest,671,priest,discipline,12,7,5
17167,Sokratina,ragnaros,671,priest,discipline,12,7,5
17168,Pipperxp,ravencrest,671,priest,discipline,12,7,5
17169,Quecum,draenor,671,priest,discipline,12,7,5
17170,Эски,howling-fjord,671,priest,discipline,12,7,5
17171,Rines,thrall,671,priest,discipline,12,7,5
17172,Xharyo,ravencrest,671,priest,discipline,16,7,9
17173,Cúrt,sanguino,671,priest,discipline,18,7,11
17174,Lillaego,ragnaros,671,priest,discipline,18,7,11
17175,Zïn,silvermoon,671,priest,discipline,18,7,11
17176,Sebatröz,ravencrest,671,priest,discipline,18,7,11
17177,Lysium,sylvanas,671,priest,discipline,18,7,11
17178,Lezz,ragnaros,671,priest,discipline,18,7,11
17179,Viì,ravencrest,671,priest,discipline,18,7,11
17180,Рукатёмная,soulflayer,671,priest,discipline,18,7,11
17181,Elusivv,blackhand,671,priest,discipline,18,7,11
17182,Ministry,tirion,671,priest,discipline,18,7,11
17183,Zatón,dun-modr,671,priest,discipline,24,7,17
17184,Møldark,silvermoon,671,priest,discipline,24,7,17
17185,Orqz,anetheron,670,priest,discipline,12,7,5
17186,Fathermaxii,stormrage,670,priest,discipline,12,7,5
17187,Raptichou,hyjal,670,priest,discipline,12,7,5
17188,Noralía,die-aldor,670,priest,discipline,12,7,5
17189,Clua,draenor,670,priest,discipline,12,7,5
17190,Хемех,soulflayer,670,priest,discipline,12,7,5
17191,Guérissolog,kaelthas,670,priest,discipline,18,7,11
17192,Olikharma,archimonde,670,priest,discipline,18,7,11
17193,Fiilaaja,stormreaver,670,priest,discipline,18,7,11
17194,Nimuëh,ragnaros,670,priest,discipline,22,8,14
17195,Makkalisser,kazzak,670,priest,discipline,24,7,17
17196,Johnnypleb,blackrock,669,priest,discipline,12,7,5
17197,Sytrix,frostwolf,669,priest,discipline,12,7,5
17198,Belithia,argent-dawn,669,priest,discipline,12,7,5
17199,Фрит,lich-king,669,priest,discipline,12,7,5
17200,Enlîl,zuljin,669,priest,discipline,12,7,5
17201,Sadira,malganis,669,priest,discipline,18,7,11
17202,Абсорберша,gordunni,668,priest,discipline,12,7,5
17203,Rhåenyra,ravencrest,668,priest,discipline,12,7,5
17204,Lacaena,deathwing,668,priest,discipline,18,7,11
17205,Mescaminator,blackmoore,668,priest,discipline,18,7,11
17206,Jagersmite,twisting-nether,668,priest,discipline,18,7,11
17207,Míjagí,blackhand,668,priest,discipline,22,8,14
17208,Quepimquepam,tarren-mill,668,priest,discipline,24,7,17
17209,Crazyhemsire,twisting-nether,667,priest,discipline,12,7,5
17210,Sadkitten,sylvanas,667,priest,discipline,18,7,11
17211,Stigy,auchindoun,667,priest,discipline,18,7,11
17212,Avor,hellfire,665,priest,discipline,12,7,5
17213,Rhésùs,archimonde,664,priest,discipline,12,7,5
17214,Ãbømînåtîøn,blackrock,660,priest,discipline,12,7,5
17215,Redøm,stormreaver,655,priest,discipline,18,8,10
17216,Женяшилд,howling-fjord,655,priest,discipline,17,7,10
17217,Søb,silvermoon,655,priest,discipline,23,7,16
17218,Tarana,mannoroth,639,priest,discipline,17,7,10
17219,Góldfinger,norgannon,639,priest,discipline,17,7,10
17220,Dapope,drakthul,639,priest,discipline,17,7,10
17221,Yazzyz,eredar,639,priest,discipline,23,7,16
17222,Voidwaffel,blackmoore,638,priest,discipline,14,8,6
17223,Rulz,zuluhed,636,priest,discipline,17,7,10
17224,Sigor,hellfire,634,priest,discipline,11,7,4
17225,Nomorelight,stormscale,634,priest,discipline,26,8,18
17226,Ysteriagødx,twisting-nether,624,priest,discipline,15,8,7
17227,Submexoxo,archimonde,624,priest,discipline,15,7,8
17228,Luxumbra,quelthalas,623,priest,discipline,21,8,13
17229,Darktattoo,twisting-nether,621,priest,discipline,21,8,13
17230,Voilencia,kazzak,620,priest,discipline,21,7,14
17231,Triuna,sylvanas,618,priest,discipline,23,9,14
17232,Lacrum,ragnaros,613,priest,discipline,14,8,6
17233,Dush,draenor,607,priest,discipline,11,7,4
17234,Atibarát,hellfire,605,priest,discipline,16,7,9
17235,Diccen,twilights-hammer,592,priest,discipline,13,7,6
17236,Andhoras,dalaran,591,priest,discipline,11,7,4
17237,Táliss,arthas,576,priest,discipline,6,6,0
17238,Arkatina,outland,576,priest,discipline,6,6,0
17239,Vèrcs,silvermoon,576,priest,discipline,6,6,0
17240,Lish,dun-modr,576,priest,discipline,6,6,0
17241,Pouffi,garona,576,priest,discipline,6,6,0
17242,Grandpatea,silvermoon,576,priest,discipline,6,6,0
17243,Ballarr,burning-legion,576,priest,discipline,12,6,6
17244,Seemywatch,ungoro,576,priest,discipline,12,6,6
17245,Zyreenx,blackrock,576,priest,discipline,12,6,6
17246,Utsuro,stormscale,576,priest,discipline,12,6,6
17247,Äliénør,khaz-modan,576,priest,discipline,12,6,6
17248,Йодтс,soulflayer,576,priest,discipline,12,6,6
17249,Claudefrollo,the-maelstrom,576,priest,discipline,12,6,6
17250,Nelyø,destromath,576,priest,discipline,12,6,6
17251,Fléxéd,burning-legion,576,priest,discipline,12,6,6
17252,Stuhlgänger,blackhand,576,priest,discipline,12,6,6
17253,Srakabot,burning-legion,576,priest,discipline,12,6,6
17254,Ðèvì,ravencrest,576,priest,discipline,12,6,6
17255,Popor,archimonde,576,priest,discipline,12,6,6
17256,Animalrescue,draenor,576,priest,discipline,12,6,6
17257,Bebwaz,kazzak,576,priest,discipline,12,6,6
17258,Saitani,stormscale,576,priest,discipline,12,6,6
17259,Ènma,archimonde,576,priest,discipline,12,6,6
17260,Сосиска,deathguard,576,priest,discipline,12,6,6
17261,Randmbare,nemesis,576,priest,discipline,12,6,6
17262,Dõrà,ravencrest,576,priest,discipline,12,6,6
17263,Lectrá,kazzak,576,priest,discipline,12,6,6
17264,Исусиприст,deepholm,576,priest,discipline,12,6,6
17265,Rylpriest,blackmoore,576,priest,discipline,12,6,6
17266,Kankstery,kazzak,576,priest,discipline,12,6,6
17267,Mitasdi,stormscale,576,priest,discipline,12,6,6
17268,Далайна,galakrond,576,priest,discipline,12,6,6
17269,Tutoress,stormscale,576,priest,discipline,12,6,6
17270,Swkunz,dun-modr,576,priest,discipline,12,6,6
17271,Boysa,earthen-ring,576,priest,discipline,12,6,6
17272,Nyxara,outland,576,priest,discipline,12,6,6
17273,Dotmaker,sanguino,576,priest,discipline,12,6,6
17274,Msbald,shattered-hand,576,priest,discipline,12,6,6
17275,Hunfall,stormscale,576,priest,discipline,12,6,6
17276,Родохрозит,blackscar,576,priest,discipline,12,6,6
17277,Vulreth,culte-de-la-rive-noire,576,priest,discipline,12,6,6
17278,Johnblack,dun-morogh,576,priest,discipline,12,6,6
17279,Melcarth,blades-edge,576,priest,discipline,12,6,6
17280,Dunkelseele,ahnqiraj,576,priest,discipline,12,6,6
17281,Supernal,twisting-nether,576,priest,discipline,12,6,6
17282,Artìst,ravencrest,576,priest,discipline,12,6,6
17283,Ryyne,ravencrest,576,priest,discipline,12,6,6
17284,Chalecø,dun-modr,576,priest,discipline,12,6,6
17285,Papynou,garona,576,priest,discipline,12,6,6
17286,Stee,sylvanas,576,priest,discipline,12,6,6
17287,Shadowzrip,twilights-hammer,576,priest,discipline,12,6,6
17288,Fästrak,dalaran,576,priest,discipline,12,6,6
17289,Sensimiya,dalaran,576,priest,discipline,12,6,6
17290,Дакимакурах,gordunni,576,priest,discipline,12,6,6
17291,Tyrhaa,blackmoore,576,priest,discipline,12,6,6
17292,Legitha,blackmoore,576,priest,discipline,12,6,6
17293,Ranagöl,ragnaros,576,priest,discipline,12,6,6
17294,Rune,ravencrest,576,priest,discipline,12,6,6
17295,Velri,runetotem,576,priest,discipline,12,6,6
17296,Sheeash,kazzak,576,priest,discipline,12,6,6
17297,Prarch,sylvanas,576,priest,discipline,12,6,6
17298,Monataamis,kazzak,576,priest,discipline,12,6,6
17299,Artist,outland,576,priest,discipline,12,6,6
17300,Axewound,neptulon,576,priest,discipline,13,6,7
17301,Волия,gordunni,576,priest,discipline,17,6,11
17302,Mxcey,ravencrest,576,priest,discipline,18,6,12
17303,Noukeé,blackrock,576,priest,discipline,18,6,12
17304,Disillusíon,tarren-mill,576,priest,discipline,18,6,12
17305,Kîlo,sylvanas,576,priest,discipline,18,6,12
17306,Omnissiiah,silvermoon,576,priest,discipline,18,6,12
17307,Eclaír,blackhand,576,priest,discipline,18,6,12
17308,Gimeurgold,aegwynn,576,priest,discipline,18,6,12
17309,Alros,elune,576,priest,discipline,18,6,12
17310,Frida,blackrock,576,priest,discipline,18,6,12
17311,Limbas,dun-modr,576,priest,discipline,18,6,12
17312,Ilovelily,antonidas,576,priest,discipline,18,6,12
17313,Theycmedotin,blackhand,576,priest,discipline,18,6,12
17314,Arctoczax,ravencrest,576,priest,discipline,18,6,12
17315,Bochonok,stormrage,576,priest,discipline,18,6,12
17316,Yoloswaglørd,blackmoore,576,priest,discipline,18,6,12
17317,Artymox,sylvanas,576,priest,discipline,18,6,12
17318,Cinjá,thrall,576,priest,discipline,19,6,13
17319,Klugzy,silvermoon,576,priest,discipline,24,6,18
17320,Sørney,aegwynn,575,priest,discipline,9,7,2
17321,Ðotgød,nemesis,575,priest,discipline,12,6,6
17322,Чикхоп,blackscar,575,priest,discipline,12,6,6
17323,Zaradana,tarren-mill,575,priest,discipline,12,6,6
17324,Юбич,soulflayer,575,priest,discipline,12,6,6
17325,Hâmmel,blackrock,575,priest,discipline,12,6,6
17326,Hensynsløs,draenor,575,priest,discipline,12,6,6
17327,Zembowae,drakthul,575,priest,discipline,12,6,6
17328,Priestvnr,hyjal,575,priest,discipline,12,6,6
17329,Elfdarkholme,stormscale,575,priest,discipline,12,6,6
17330,Lichtl,ysera,575,priest,discipline,12,6,6
17331,Vastüdö,ragnaros,575,priest,discipline,12,6,6
17332,Makariotatos,xavius,575,priest,discipline,12,6,6
17333,Bauscia,nemesis,575,priest,discipline,12,6,6
17334,Tira,darksorrow,575,priest,discipline,12,6,6
17335,Handmännchen,kelthuzad,575,priest,discipline,12,6,6
17336,Kipnuggetz,burning-legion,575,priest,discipline,12,6,6
17337,Ponpon,onyxia,575,priest,discipline,12,6,6
17338,Hidr,nemesis,575,priest,discipline,12,6,6
17339,Zák,sylvanas,575,priest,discipline,12,6,6
17340,Hmanco,burning-legion,575,priest,discipline,12,6,6
17341,Insicompany,antonidas,575,priest,discipline,12,6,6
17342,Ostberger,twisting-nether,575,priest,discipline,12,6,6
17343,Flackiepi,tarren-mill,575,priest,discipline,12,6,6
17344,Hypnòz,archimonde,575,priest,discipline,12,6,6
17345,Nasirjones,outland,575,priest,discipline,12,6,6
17346,Пэйтен,deathguard,575,priest,discipline,18,6,12
17347,Juco,draenor,575,priest,discipline,18,6,12
17348,Priestbiyy,sunstrider,575,priest,discipline,18,6,12
17349,Вэстервилли,howling-fjord,575,priest,discipline,24,6,18
17350,Vebuya,blackmoore,574,priest,discipline,12,6,6
17351,Draenera,silvermoon,574,priest,discipline,12,6,6
17352,Tindoriel,bronzebeard,574,priest,discipline,12,6,6
17353,Nygel,kazzak,574,priest,discipline,12,6,6
17354,Preacia,twisting-nether,574,priest,discipline,12,6,6
17355,Leonard,nemesis,574,priest,discipline,12,6,6
17356,Prigart,sylvanas,574,priest,discipline,18,6,12
17357,Muftl,thrall,574,priest,discipline,18,6,12
17358,Nerul,twisting-nether,574,priest,discipline,19,6,13
17359,Kreem,frostmane,573,priest,discipline,12,6,6
17360,Камшотхил,gordunni,573,priest,discipline,18,6,12
17361,Timmemeep,outland,572,priest,discipline,12,6,6
17362,Loriny,ragnaros,572,priest,discipline,14,6,8
17363,Sildane,kirin-tor,572,priest,discipline,18,6,12
17364,Bolíngbroke,argent-dawn,572,priest,discipline,24,6,18
17365,Äwësömë,aggra-português,571,priest,discipline,12,6,6
17366,Пристохилю,gordunni,571,priest,discipline,12,6,6
17367,Glutenhode,stormscale,571,priest,discipline,12,6,6
17368,Германий,deathguard,558,priest,discipline,17,6,11
17369,Ünholy,burning-legion,556,priest,discipline,17,6,11
17370,Lemowae,doomhammer,542,priest,discipline,22,6,16
17371,Stormééz,bronzebeard,541,priest,discipline,26,7,19
17372,Leahx,dalvengyr,527,priest,discipline,11,6,5
17373,Adare,sanguino,527,priest,discipline,11,6,5
17374,Gailiugà,kazzak,527,priest,discipline,11,6,5
17375,Healsquad,draenor,524,priest,discipline,20,6,14
17376,Demmi,dun-modr,522,priest,discipline,22,7,15
17377,Полуниця,galakrond,522,priest,discipline,23,7,16
17378,Xotz,thrall,521,priest,discipline,15,8,7
17379,Cummask,silvermoon,512,priest,discipline,16,6,10
17380,Tepevelf,dun-modr,512,priest,discipline,22,6,16
17381,Никорете,soulflayer,511,priest,discipline,11,6,5
17382,Thimble,blackhand,510,priest,discipline,14,6,8
17383,Teyranamin,defias-brotherhood,496,priest,discipline,7,6,1
17384,Hexybtw,stormscale,480,priest,discipline,6,5,1
17385,Whopzi,blackmoore,480,priest,discipline,6,5,1
17386,Sorchad,hyjal,480,priest,discipline,6,5,1
17387,Sloee,kazzak,480,priest,discipline,6,5,1
17388,Shieldyblaze,frostwolf,480,priest,discipline,6,5,1
17389,Aaron,aegwynn,480,priest,discipline,6,5,1
17390,Trippinorbs,stormscale,480,priest,discipline,6,5,1
17391,Noodlesoup,daggerspine,480,priest,discipline,6,5,1
17392,Lidlpriest,frostwolf,480,priest,discipline,6,5,1
17393,Astralscare,outland,480,priest,discipline,6,5,1
17394,Sethp,hyjal,480,priest,discipline,6,5,1
17395,Rixfoulah,ysondre,480,priest,discipline,6,5,1
17396,Paìnz,blackhand,480,priest,discipline,6,5,1
17397,Nttyfromohio,ravencrest,480,priest,discipline,6,5,1
17398,Lamp,terokkar,480,priest,discipline,6,5,1
17399,Eladri,silvermoon,480,priest,discipline,6,5,1
17400,Warm,auchindoun,480,priest,discipline,6,5,1
17401,Гачидварфич,gordunni,480,priest,discipline,6,5,1
17402,Bec,ragnaros,480,priest,discipline,6,5,1
17403,Nayballistic,tarren-mill,480,priest,discipline,6,5,1
17404,Moonacky,bronze-dragonflight,480,priest,discipline,6,5,1
17405,Ronnmoss,defias-brotherhood,480,priest,discipline,6,5,1
17406,Docpower,twisting-nether,480,priest,discipline,6,5,1
17407,Loldisc,arthas,480,priest,discipline,6,5,1
17408,Trntypr,senjin,480,priest,discipline,6,5,1
17409,Swep,ragnaros,480,priest,discipline,6,5,1
17410,Ounxx,blackrock,480,priest,discipline,6,5,1
17411,Нэриэлл,gordunni,480,priest,discipline,6,5,1
17412,Pollution,ragnaros,480,priest,discipline,6,5,1
17413,Уер,galakrond,480,priest,discipline,12,5,7
17414,Bejud,tarren-mill,480,priest,discipline,12,5,7
17415,Donbas,tarren-mill,480,priest,discipline,12,5,7
17416,Chaapsbbq,archimonde,480,priest,discipline,12,5,7
17417,Fabuliciøus,blackrock,480,priest,discipline,12,5,7
17418,Yukîna,blackrock,480,priest,discipline,12,5,7
17419,Shadew,stormscale,480,priest,discipline,12,5,7
17420,Elwing,darkmoon-faire,480,priest,discipline,12,5,7
17421,Grozozo,tarren-mill,480,priest,discipline,12,5,7
17422,Fainttnt,stormscale,480,priest,discipline,12,5,7
17423,Øbserverx,stormscale,480,priest,discipline,12,5,7
17424,Вайтбласт,howling-fjord,480,priest,discipline,12,5,7
17425,Drumont,kelthuzad,480,priest,discipline,12,5,7
17426,Døtzillah,kazzak,480,priest,discipline,12,5,7
17427,Seskipr,stormreaver,480,priest,discipline,12,5,7
17428,Ajaxfreak,blackmoore,480,priest,discipline,12,5,7
17429,Madkes,ravencrest,480,priest,discipline,12,5,7
17430,Katsikatsika,silvermoon,480,priest,discipline,12,5,7
17431,Kaleshiry,kazzak,480,priest,discipline,12,5,7
17432,Yö,stormscale,480,priest,discipline,12,5,7
17433,Mayday,silvermoon,480,priest,discipline,12,5,7
17434,Porklifer,tarren-mill,480,priest,discipline,12,5,7
17435,Litera,silvermoon,480,priest,discipline,12,5,7
17436,Bimbax,dun-modr,480,priest,discipline,12,5,7
17437,Забейка,howling-fjord,480,priest,discipline,12,5,7
17438,Buzzy,twisting-nether,480,priest,discipline,12,5,7
17439,Suaakypriest,tyrande,480,priest,discipline,12,5,7
17440,Magthalor,twisting-nether,480,priest,discipline,12,5,7
17441,Nayballsp,tarren-mill,480,priest,discipline,12,5,7
17442,Абсорбиболь,howling-fjord,480,priest,discipline,12,5,7
17443,Тенсаи,howling-fjord,480,priest,discipline,12,5,7
17444,Allaría,bronze-dragonflight,480,priest,discipline,12,5,7
17445,Jeboc,ravencrest,480,priest,discipline,12,5,7
17446,Sbj,bronze-dragonflight,480,priest,discipline,12,5,7
17447,Hollylicious,kazzak,480,priest,discipline,12,5,7
17448,Roylian,ravencrest,480,priest,discipline,12,5,7
17449,Hyonra,kazzak,480,priest,discipline,12,5,7
17450,Seankingkong,ravencrest,480,priest,discipline,12,5,7
17451,Lunatrix,sanguino,480,priest,discipline,12,5,7
17452,Borgamor,frostmane,480,priest,discipline,12,5,7
17453,Doncamïllo,blackrock,480,priest,discipline,12,5,7
17454,Swiftdemise,sylvanas,480,priest,discipline,12,5,7
17455,Discgødx,thrall,480,priest,discipline,12,5,7
17456,Supemi,stormscale,480,priest,discipline,12,5,7
17457,Саксесфул,howling-fjord,480,priest,discipline,12,5,7
17458,Medivs,blackmoore,480,priest,discipline,12,5,7
17459,Pwsx,draenor,480,priest,discipline,12,5,7
17460,Shyvi,ravencrest,480,priest,discipline,12,5,7
17461,Evolís,blackmoore,480,priest,discipline,12,5,7
17462,Epa,zuljin,480,priest,discipline,12,5,7
17463,Meheal,lothar,480,priest,discipline,12,5,7
17464,Brøwney,blackmoore,480,priest,discipline,12,5,7
17465,Fakebob,draenor,480,priest,discipline,12,5,7
17466,Navihato,silvermoon,480,priest,discipline,12,5,7
17467,Самурайко,booty-bay,480,priest,discipline,12,5,7
17468,Floorpovx,blackmoore,480,priest,discipline,12,5,7
17469,Nyù,kazzak,480,priest,discipline,12,5,7
17470,Azrella,ravencrest,480,priest,discipline,12,5,7
17471,Shììnx,hyjal,480,priest,discipline,12,5,7
17472,Saphèa,burning-legion,480,priest,discipline,12,5,7
17473,Bibleenjoyer,blackmoore,480,priest,discipline,12,5,7
17474,Paterfisl,ragnaros,480,priest,discipline,12,5,7
17475,Kaiikoo,ravencrest,480,priest,discipline,12,5,7
17476,Ameja,sylvanas,480,priest,discipline,13,5,8
17477,Neagica,kazzak,480,priest,discipline,15,5,10
17478,Kehz,ysondre,480,priest,discipline,18,5,13
17479,Taimani,burning-legion,480,priest,discipline,18,5,13
17480,Chekkó,blackrock,480,priest,discipline,18,5,13
17481,Valirda,twisting-nether,480,priest,discipline,18,5,13
17482,Äkvä,ragnaros,480,priest,discipline,18,5,13
17483,Карбонит,fordragon,480,priest,discipline,18,5,13
17484,Faouzia,argent-dawn,480,priest,discipline,18,5,13
17485,Ча,thermaplugg,480,priest,discipline,18,5,13
17486,Góli,argent-dawn,480,priest,discipline,18,5,13
17487,Володябигуди,howling-fjord,480,priest,discipline,18,5,13
17488,Clergy,nagrand,479,priest,discipline,6,5,1
17489,Elpitiimigré,sinstralis,479,priest,discipline,6,5,1
17490,Perxonx,twisting-nether,479,priest,discipline,6,5,1
17491,Velenthøs,argent-dawn,479,priest,discipline,12,5,7
17492,Piotrek,hyjal,479,priest,discipline,12,5,7
17493,Шпалкоклоб,soulflayer,479,priest,discipline,12,5,7
17494,Slight,aggra-português,479,priest,discipline,12,5,7
17495,Oohopeoo,blackmoore,479,priest,discipline,12,5,7
17496,Røläck,ragnaros,479,priest,discipline,12,5,7
17497,Helming,magtheridon,479,priest,discipline,12,5,7
17498,Velenthan,stormrage,479,priest,discipline,12,5,7
17499,Cobrix,nemesis,479,priest,discipline,12,5,7
17500,Calenberhtil,burning-legion,479,priest,discipline,12,5,7
17501,Tumlaa,ravencrest,479,priest,discipline,12,5,7
17502,Darknëss,malganis,479,priest,discipline,12,5,7
17503,Pluf,nefarian,479,priest,discipline,12,5,7
17504,Sanoe,twisting-nether,479,priest,discipline,12,5,7
17505,Sewerperson,doomhammer,479,priest,discipline,12,5,7
17506,Konantenshi,doomhammer,479,priest,discipline,12,5,7
17507,Дэйвора,ashenvale,479,priest,discipline,12,5,7
17508,Bòóny,ravencrest,479,priest,discipline,12,5,7
17509,Texstil,blackmoore,479,priest,discipline,12,5,7
17510,Shyvannas,antonidas,479,priest,discipline,12,5,7
17511,Tota,frostmane,479,priest,discipline,12,5,7
17512,Aká,kazzak,479,priest,discipline,18,5,13
17513,Antiexhile,kazzak,479,priest,discipline,18,5,13
17514,Celero,silvermoon,479,priest,discipline,18,5,13
17515,Seehz,ysondre,479,priest,discipline,18,5,13
17516,Sleeyz,blackmoore,479,priest,discipline,24,5,19
17517,Ruebi,blackmoore,478,priest,discipline,12,5,7
17518,Hotwheal,ysondre,478,priest,discipline,12,5,7
17519,Patoroch,terokkar,478,priest,discipline,18,5,13
17520,Oknelim,blackmoore,477,priest,discipline,12,5,7
17521,Feloriya,antonidas,476,priest,discipline,12,5,7
17522,Phosphorus,blackhand,476,priest,discipline,12,5,7
17523,Lazzariah,ravencrest,475,priest,discipline,12,5,7
17524,Rettsche,eredar,475,priest,discipline,12,5,7
17525,Wipipi,draenor,474,priest,discipline,12,5,7
17526,Spookyfive,blackhand,472,priest,discipline,26,8,18
17527,Приствалера,howling-fjord,463,priest,discipline,17,5,12
17528,Drë,daggerspine,447,priest,discipline,11,5,6
17529,Makemyday,dun-modr,447,priest,discipline,11,5,6
17530,Nioubèy,archimonde,447,priest,discipline,11,5,6
17531,Dhed,turalyon,447,priest,discipline,14,6,8
17532,Aykò,blackmoore,447,priest,discipline,14,6,8
17533,Leyasu,eredar,447,priest,discipline,15,6,9
17534,Sandgambler,draenor,432,priest,discipline,9,5,4
17535,Kak,gorgonnash,426,priest,discipline,19,6,13
17536,Holybøi,ragnaros,426,priest,discipline,29,7,22
17537,Cestrial,sylvanas,415,priest,discipline,14,5,9
17538,Holyheartx,argent-dawn,408,priest,discipline,22,6,16
17539,Шруня,howling-fjord,400,priest,discipline,24,5,19
17540,Colèy,blackhand,384,priest,discipline,6,4,2
17541,Sebbi,ragnaros,384,priest,discipline,6,4,2
17542,Телоури,galakrond,384,priest,discipline,6,4,2
17543,Schnîttchen,blackrock,384,priest,discipline,6,4,2
17544,Ziaz,the-maelstrom,384,priest,discipline,6,4,2
17545,Onaltnoqs,silvermoon,384,priest,discipline,6,4,2
17546,Imaut,emerald-dream,384,priest,discipline,6,4,2
17547,Gorti,ravencrest,384,priest,discipline,6,4,2
17548,Nesar,stormscale,384,priest,discipline,6,4,2
17549,Zumbae,tarren-mill,384,priest,discipline,6,4,2
17550,Monstretpr,dragonblight,384,priest,discipline,6,4,2
17551,Awön,stormscale,384,priest,discipline,6,4,2
17552,Бархомелфой,gordunni,384,priest,discipline,6,4,2
17553,ßlinkywinky,outland,384,priest,discipline,6,4,2
17554,Кхарли,howling-fjord,384,priest,discipline,6,4,2
17555,Frekko,outland,384,priest,discipline,6,4,2
17556,Petshopboi,sylvanas,384,priest,discipline,6,4,2
17557,Hadk,blackrock,384,priest,discipline,6,4,2
17558,Daniweyy,eredar,384,priest,discipline,6,4,2
17559,Reól,blackmoore,384,priest,discipline,6,4,2
17560,Dødy,hyjal,384,priest,discipline,6,4,2
17561,Healinrbglol,blackmoore,384,priest,discipline,6,4,2
17562,Ilovecala,ravencrest,384,priest,discipline,6,4,2
17563,Хъи,gordunni,384,priest,discipline,6,4,2
17564,Gravedoll,draenor,384,priest,discipline,6,4,2
17565,Cheesegód,outland,384,priest,discipline,6,4,2
17566,Pínx,nerathor,384,priest,discipline,6,4,2
17567,Büssi,blackrock,384,priest,discipline,6,4,2
17568,Шадия,ashenvale,384,priest,discipline,6,4,2
17569,Серью,booty-bay,384,priest,discipline,6,4,2
17570,Umbralx,ragnaros,384,priest,discipline,6,4,2
17571,Babambaba,sylvanas,384,priest,discipline,6,4,2
17572,Tâmshi,dun-modr,384,priest,discipline,6,4,2
17573,Papêrcut,kazzak,384,priest,discipline,6,4,2
17574,Ocastia,antonidas,384,priest,discipline,6,4,2
17575,Healmebaby,kiljaeden,384,priest,discipline,6,4,2
17576,Above,hyjal,384,priest,discipline,6,4,2
17577,Rawelf,ravencrest,384,priest,discipline,6,4,2
17578,Petitogré,silvermoon,384,priest,discipline,6,4,2
17579,Piixld,aegwynn,384,priest,discipline,6,4,2
17580,Woid,aegwynn,384,priest,discipline,6,4,2
17581,Yukirito,drakthul,384,priest,discipline,6,4,2
17582,Gimcho,magtheridon,384,priest,discipline,6,4,2
17583,Byzzi,draenor,384,priest,discipline,6,4,2
17584,Døline,hyjal,384,priest,discipline,6,4,2
17585,Mylox,blackrock,384,priest,discipline,6,4,2
17586,Experimentix,silvermoon,384,priest,discipline,6,4,2
17587,Ghorfindel,kaelthas,384,priest,discipline,6,4,2
17588,Priestutute,tarren-mill,384,priest,discipline,6,4,2
17589,Buerak,tarren-mill,384,priest,discipline,6,4,2
17590,Pankp,kazzak,384,priest,discipline,6,4,2
17591,Iirina,draenor,384,priest,discipline,6,4,2
17592,Giffelgrethe,sylvanas,384,priest,discipline,6,4,2
17593,Miabelle,argent-dawn,384,priest,discipline,6,4,2
17594,Thean,twilights-hammer,384,priest,discipline,6,4,2
17595,Touchypunk,ravencrest,384,priest,discipline,6,4,2
17596,Badguymike,ragnaros,384,priest,discipline,6,4,2
17597,Wixzyx,ravencrest,384,priest,discipline,10,4,6
17598,Stepsisstuck,ragnaros,384,priest,discipline,12,4,8
17599,Druzhok,sylvanas,384,priest,discipline,12,4,8
17600,Sweity,dun-modr,384,priest,discipline,12,4,8
17601,Заак,howling-fjord,384,priest,discipline,12,4,8
17602,Solerona,blackmoore,384,priest,discipline,12,4,8
17603,Mérce,kazzak,384,priest,discipline,12,4,8
17604,Drdré,blackrock,384,priest,discipline,12,4,8
17605,Goatrocker,kazzak,384,priest,discipline,12,4,8
17606,Killerkende,ragnaros,384,priest,discipline,12,4,8
17607,Deathtrapx,draenor,384,priest,discipline,12,4,8
17608,Bldnl,ragnaros,384,priest,discipline,12,4,8
17609,Kimozabi,ravencrest,384,priest,discipline,12,4,8
17610,Malíficent,draenor,384,priest,discipline,12,4,8
17611,Asdfgfhtjy,stormscale,384,priest,discipline,12,4,8
17612,Skyløl,dun-modr,384,priest,discipline,12,4,8
17613,Melord,thunderhorn,384,priest,discipline,12,4,8
17614,Touchmé,blackmoore,384,priest,discipline,12,4,8
17615,Шимату,howling-fjord,384,priest,discipline,12,4,8
17616,Predpriest,twisting-nether,384,priest,discipline,12,4,8
17617,Rîîper,khaz-modan,384,priest,discipline,12,4,8
17618,Spezzato,nemesis,384,priest,discipline,12,4,8
17619,Tsunadesaama,silvermoon,384,priest,discipline,12,4,8
17620,Vicetøne,stormscale,384,priest,discipline,12,4,8
17621,Mariio,blackmoore,384,priest,discipline,12,4,8
17622,Lothbruke,twisting-nether,384,priest,discipline,12,4,8
17623,Zivl,blackrock,384,priest,discipline,12,4,8
17624,Prêtresacré,archimonde,384,priest,discipline,12,4,8
17625,Jaywie,twisting-nether,384,priest,discipline,12,4,8
17626,Sabakk,archimonde,384,priest,discipline,12,4,8
17627,Сайлентхилл,howling-fjord,384,priest,discipline,12,4,8
17628,Amèn,archimonde,384,priest,discipline,12,4,8
17629,Kalestharia,blackmoore,384,priest,discipline,12,4,8
17630,Absolution,stormscale,384,priest,discipline,12,4,8
17631,Марина,howling-fjord,384,priest,discipline,12,4,8
17632,Ревентонх,howling-fjord,384,priest,discipline,12,4,8
17633,Сашашвд,howling-fjord,384,priest,discipline,12,4,8
17634,Euphorius,blackmoore,384,priest,discipline,12,4,8
17635,Asdfsds,kazzak,384,priest,discipline,12,4,8
17636,Bebsenpai,hyjal,384,priest,discipline,12,4,8
17637,Xayona,argent-dawn,384,priest,discipline,12,4,8
17638,Toasttrii,outland,384,priest,discipline,12,4,8
17639,Sweetxq,tarren-mill,384,priest,discipline,12,4,8
17640,Sorrop,sanguino,384,priest,discipline,12,4,8
17641,Eitukaeitai,outland,384,priest,discipline,12,4,8
17642,Abrakahudder,tarren-mill,384,priest,discipline,12,4,8
17643,Xaeroow,archimonde,384,priest,discipline,12,4,8
17644,ßlowska,hyjal,384,priest,discipline,12,4,8
17645,Ankî,aegwynn,384,priest,discipline,12,4,8
17646,Hombre,anetheron,384,priest,discipline,12,4,8
17647,Luznywiesiek,burning-legion,384,priest,discipline,12,4,8
17648,Chigreru,uldum,384,priest,discipline,12,4,8
17649,Celestias,sanguino,384,priest,discipline,15,4,11
17650,Zeröone,silvermoon,384,priest,discipline,17,4,13
17651,Dubai,silvermoon,384,priest,discipline,18,4,14
17652,Shyvàree,les-clairvoyants,384,priest,discipline,18,4,14
17653,Blackwidow,chromaggus,384,priest,discipline,18,4,14
17654,Sbubbi,ravencrest,384,priest,discipline,18,4,14
17655,Moonary,ravencrest,383,priest,discipline,6,4,2
17656,Enchanttress,burning-legion,383,priest,discipline,6,4,2
17657,Vishnoo,hyjal,383,priest,discipline,6,4,2
17658,Пахад,blackscar,383,priest,discipline,6,4,2
17659,Ravend,sylvanas,383,priest,discipline,6,4,2
17660,Kinn,kaelthas,383,priest,discipline,6,4,2
17661,Kelras,grim-batol,383,priest,discipline,6,4,2
17662,Hðly,doomhammer,383,priest,discipline,6,4,2
17663,Xpect,terokkar,383,priest,discipline,12,4,8
17664,Miriàl,outland,383,priest,discipline,12,4,8
17665,Søs,eldrethalas,383,priest,discipline,12,4,8
17666,Jezlung,frostmane,383,priest,discipline,12,4,8
17667,Havanna,dethecus,382,priest,discipline,6,4,2
17668,Seiigops,ysondre,382,priest,discipline,6,4,2
17669,Тэтсу,greymane,382,priest,discipline,12,4,8
17670,Camellight,stormscale,382,priest,discipline,12,4,8
17671,Lierie,kazzak,382,priest,discipline,24,4,20
17672,Grommyr,eredar,381,priest,discipline,12,4,8
17673,Thanil,bloodfeather,367,priest,discipline,11,4,7
17674,Tephutes,ravencrest,367,priest,discipline,11,4,7
17675,Maskinjundre,bronzebeard,352,priest,discipline,10,4,6
17676,Sickbo,eredar,351,priest,discipline,11,4,7
17677,Pjuww,outland,351,priest,discipline,11,4,7
17678,Farae,arathor,351,priest,discipline,14,5,9
17679,Doxxi,argent-dawn,336,priest,discipline,9,5,4
17680,Salvatör,quelthalas,336,priest,discipline,15,5,10
17681,Sneed,moonglade,335,priest,discipline,12,5,7
17682,Vicønia,tarren-mill,335,priest,discipline,11,4,7
17683,Runay,draenor,330,priest,discipline,13,5,8
17684,Impmvp,kazzak,330,priest,discipline,17,6,11
17685,Косн,razuvious,330,priest,discipline,16,5,11
17686,Tyog,khazgoroth,320,priest,discipline,10,4,6
17687,Кирюшасэмпай,gordunni,320,priest,discipline,10,4,6
17688,Brainðead,aegwynn,319,priest,discipline,5,4,1
17689,Enaches,twisting-nether,304,priest,discipline,7,4,3
17690,Fønss,sanguino,288,priest,discipline,6,3,3
17691,Eros,illidan,288,priest,discipline,6,3,3
17692,Deppara,twisting-nether,288,priest,discipline,6,3,3
17693,Шлёндрик,gordunni,288,priest,discipline,6,3,3
17694,Immutable,twisting-nether,288,priest,discipline,6,3,3
17695,Eyesønyou,nemesis,288,priest,discipline,6,3,3
17696,Effot,twisting-nether,288,priest,discipline,6,3,3
17697,Саммерфинн,gordunni,288,priest,discipline,6,3,3
17698,Karmev,twisting-nether,288,priest,discipline,6,3,3
17699,Tyarande,tarren-mill,288,priest,discipline,6,3,3
17700,Kamiðßlesing,sanguino,288,priest,discipline,6,3,3
17701,Jazty,sanguino,288,priest,discipline,6,3,3
17702,Josva,sanguino,288,priest,discipline,6,3,3
17703,Evilangèl,ravenholdt,288,priest,discipline,6,3,3
17704,Pristel,twisting-nether,288,priest,discipline,6,3,3
17705,Dezless,tarren-mill,288,priest,discipline,6,3,3
17706,Bridélight,archimonde,288,priest,discipline,6,3,3
17707,Stahpit,twisting-nether,288,priest,discipline,6,3,3
17708,Semagdnim,aggra-português,288,priest,discipline,6,3,3
17709,Knazh,twisting-nether,288,priest,discipline,6,3,3
17710,Психоз,gordunni,288,priest,discipline,6,3,3
17711,Moistmidget,frostmane,288,priest,discipline,6,3,3
17712,Батлджес,gordunni,288,priest,discipline,6,3,3
17713,Фруктовыйса,gordunni,288,priest,discipline,6,3,3
17714,Sâmba,pozzo-delleternità,288,priest,discipline,6,3,3
17715,Нагп,gordunni,288,priest,discipline,6,3,3
17716,Tsunê,ysondre,288,priest,discipline,6,3,3
17717,Hôllÿ,ysondre,288,priest,discipline,6,3,3
17718,Lerissea,argent-dawn,288,priest,discipline,6,3,3
17719,Qpops,twisting-nether,288,priest,discipline,6,3,3
17720,Микаса,howling-fjord,288,priest,discipline,6,3,3
17721,Húlda,auchindoun,288,priest,discipline,6,3,3
17722,Purpl,tarren-mill,288,priest,discipline,6,3,3
17723,Elmaestrø,aegwynn,288,priest,discipline,6,3,3
17724,Palrins,dalaran,288,priest,discipline,6,3,3
17725,Shieldop,eredar,288,priest,discipline,6,3,3
17726,Laradiel,dun-modr,288,priest,discipline,6,3,3
17727,Maikzky,stormreaver,288,priest,discipline,6,3,3
17728,Tzúú,ravencrest,288,priest,discipline,6,3,3
17729,Cbbigbape,thrall,288,priest,discipline,6,3,3
17730,Sapue,aegwynn,288,priest,discipline,6,3,3
17731,Séfaron,blackmoore,288,priest,discipline,6,3,3
17732,Noonex,hakkar,288,priest,discipline,6,3,3
17733,Hanagaki,ragnaros,288,priest,discipline,6,3,3
17734,Maiel,die-aldor,288,priest,discipline,6,3,3
17735,Mahist,ravencrest,288,priest,discipline,6,3,3
17736,Spaghettoni,tarren-mill,288,priest,discipline,6,3,3
17737,Pilgram,twilights-hammer,288,priest,discipline,6,3,3
17738,Paphahaha,ragnaros,288,priest,discipline,6,3,3
17739,Applepiez,ravencrest,288,priest,discipline,6,3,3
17740,Shádøwx,ravencrest,288,priest,discipline,6,3,3
17741,Куольхд,gordunni,288,priest,discipline,6,3,3
17742,Disfinkacze,drakthul,288,priest,discipline,6,3,3
17743,Windieqt,drakthul,288,priest,discipline,6,3,3
17744,Заволончик,blackscar,288,priest,discipline,6,3,3
17745,Haffination,frostmane,288,priest,discipline,6,3,3
17746,Биркох,blackscar,288,priest,discipline,6,3,3
17747,Qzrx,draenor,288,priest,discipline,6,3,3
17748,Chayz,thrall,288,priest,discipline,6,3,3
17749,Wontdispel,ravencrest,288,priest,discipline,6,3,3
17750,Nedex,thrall,288,priest,discipline,6,3,3
17751,Hiimpinxî,ragnaros,288,priest,discipline,6,3,3
17752,Rhàenyra,ravencrest,288,priest,discipline,6,3,3
17753,Xyfas,azshara,288,priest,discipline,6,3,3
17754,Bigdamsmitex,draenor,288,priest,discipline,6,3,3
17755,Confess,archimonde,288,priest,discipline,6,3,3
17756,Iløvelena,ravencrest,288,priest,discipline,6,3,3
17757,Neosix,sanguino,288,priest,discipline,6,3,3
17758,Dumix,shadowsong,288,priest,discipline,6,3,3
17759,Depleeky,blackmoore,288,priest,discipline,6,3,3
17760,Sardine,ravencrest,288,priest,discipline,6,3,3
17761,Lolipopheal,blackmoore,288,priest,discipline,6,3,3
17762,Azazzel,nathrezim,288,priest,discipline,6,3,3
17763,Pietyberi,tichondrius,288,priest,discipline,6,3,3
17764,Holycowheals,the-maelstrom,288,priest,discipline,6,3,3
17765,ßrûm,archimonde,288,priest,discipline,6,3,3
17766,Mariahcarey,blackmoore,288,priest,discipline,6,3,3
17767,Tiphereth,blackmoore,288,priest,discipline,6,3,3
17768,Nefufangirl,ravencrest,288,priest,discipline,6,3,3
17769,Indrades,blackmoore,288,priest,discipline,6,3,3
17770,Эннхэтэуэй,soulflayer,288,priest,discipline,6,3,3
17771,ßestworld,draenor,288,priest,discipline,6,3,3
17772,Олдмэнсэйд,soulflayer,288,priest,discipline,6,3,3
17773,Fatyoyo,frostwolf,288,priest,discipline,6,3,3
17774,ßøunty,dun-modr,288,priest,discipline,6,3,3
17775,Justjuice,hyjal,288,priest,discipline,6,3,3
17776,Jaylove,frostwolf,288,priest,discipline,6,3,3
17777,Santainphy,cthun,288,priest,discipline,6,3,3
17778,Felon,burning-legion,288,priest,discipline,6,3,3
17779,Aasgard,frostwolf,288,priest,discipline,6,3,3
17780,Hængøver,blackmoore,288,priest,discipline,6,3,3
17781,Mariahscarey,blackhand,288,priest,discipline,6,3,3
17782,Eldrathir,burning-legion,288,priest,discipline,6,3,3
17783,Shadoxx,malganis,288,priest,discipline,6,3,3
17784,Релакз,soulflayer,288,priest,discipline,6,3,3
17785,Элизабетшорт,soulflayer,288,priest,discipline,6,3,3
17786,Àlucárd,blackhand,288,priest,discipline,6,3,3
17787,Таравера,soulflayer,288,priest,discipline,6,3,3
17788,Ðopebwøy,burning-legion,288,priest,discipline,6,3,3
17789,Deternity,stormscale,288,priest,discipline,6,3,3
17790,Argaar,burning-legion,288,priest,discipline,6,3,3
17791,Challengepro,burning-legion,288,priest,discipline,6,3,3
17792,Ансор,lich-king,288,priest,discipline,6,3,3
17793,Rektom,archimonde,288,priest,discipline,6,3,3
17794,Eník,blackrock,288,priest,discipline,6,3,3
17795,Чилюотферала,eversong,288,priest,discipline,6,3,3
17796,Gødisc,blackrock,288,priest,discipline,6,3,3
17797,Matiagmenh,stormscale,288,priest,discipline,6,3,3
17798,Figoluh,hyjal,288,priest,discipline,6,3,3
17799,Аридел,ashenvale,288,priest,discipline,6,3,3
17800,Ribberull,darksorrow,288,priest,discipline,6,3,3
17801,Mindflayér,stormscale,288,priest,discipline,6,3,3
17802,Henreita,darksorrow,288,priest,discipline,6,3,3
17803,Hôtseitdank,blackrock,288,priest,discipline,6,3,3
17804,Discobeb,les-clairvoyants,288,priest,discipline,6,3,3
17805,Deathspren,stormscale,288,priest,discipline,6,3,3
17806,Acik,bladefist,288,priest,discipline,6,3,3
17807,Avinci,blackrock,288,priest,discipline,6,3,3
17808,Ardeë,dun-modr,288,priest,discipline,6,3,3
17809,Víd,dun-morogh,288,priest,discipline,6,3,3
17810,Flet,emerald-dream,288,priest,discipline,6,3,3
17811,Watchmepray,stormscale,288,priest,discipline,6,3,3
17812,Löspajen,stormscale,288,priest,discipline,6,3,3
17813,Këller,hyjal,288,priest,discipline,6,3,3
17814,Realdead,blackrock,288,priest,discipline,6,3,3
17815,Vaurork,stormscale,288,priest,discipline,6,3,3
17816,Psychout,ravencrest,288,priest,discipline,6,3,3
17817,Ríeka,proudmoore,288,priest,discipline,6,3,3
17818,Pxescalol,aegwynn,288,priest,discipline,6,3,3
17819,Milderyp,kazzak,288,priest,discipline,6,3,3
17820,Starships,kazzak,288,priest,discipline,6,3,3
17821,Zeuws,kazzak,288,priest,discipline,6,3,3
17822,Villagegirlx,stormscale,288,priest,discipline,6,3,3
17823,Åtømîç,kazzak,288,priest,discipline,6,3,3
17824,Decimerad,kazzak,288,priest,discipline,6,3,3
17825,Frëija,ravencrest,288,priest,discipline,6,3,3
17826,Hampådenbååd,kazzak,288,priest,discipline,6,3,3
17827,Imprøved,outland,288,priest,discipline,6,3,3
17828,Kenobai,kazzak,288,priest,discipline,6,3,3
17829,Delinsx,outland,288,priest,discipline,6,3,3
17830,Ònasou,silvermoon,288,priest,discipline,6,3,3
17831,Preodek,kazzak,288,priest,discipline,6,3,3
17832,Velanrous,kazzak,288,priest,discipline,6,3,3
17833,Zikár,kazzak,288,priest,discipline,6,3,3
17834,Byshadow,silvermoon,288,priest,discipline,6,3,3
17835,Shockpriest,grim-batol,288,priest,discipline,12,3,9
17836,Momomomomomo,aegwynn,288,priest,discipline,12,3,9
17837,Tubercurass,hyjal,288,priest,discipline,12,3,9
17838,Tsuser,blackrock,288,priest,discipline,12,3,9
17839,Doombrew,blackmoore,288,priest,discipline,12,3,9
17840,Anadyia,aegwynn,288,priest,discipline,12,3,9
17841,Choosunghoon,silvermoon,288,priest,discipline,12,3,9
17842,Âlígés,outland,288,priest,discipline,12,3,9
17843,Èlvis,dun-morogh,288,priest,discipline,12,3,9
17844,Biierlip,twisting-nether,288,priest,discipline,12,3,9
17845,Senza,ysondre,288,priest,discipline,12,3,9
17846,Djezà,archimonde,288,priest,discipline,12,3,9
17847,Yzina,archimonde,288,priest,discipline,12,3,9
17848,Ðènnis,argent-dawn,288,priest,discipline,12,3,9
17849,Nyxém,blackmoore,288,priest,discipline,12,3,9
17850,Tazting,stormscale,288,priest,discipline,12,3,9
17851,Malaboost,archimonde,288,priest,discipline,12,3,9
17852,Svartochelak,stormscale,288,priest,discipline,12,3,9
17853,Sins,defias-brotherhood,288,priest,discipline,12,3,9
17854,Kitazu,draenor,288,priest,discipline,12,3,9
17855,Honompa,darkmoon-faire,288,priest,discipline,12,3,9
17856,Kilmin,ravencrest,288,priest,discipline,12,3,9
17857,Blasfemo,nemesis,288,priest,discipline,12,3,9
17858,Fluxyqt,ravencrest,288,priest,discipline,12,3,9
17859,Krãtos,kazzak,288,priest,discipline,12,3,9
17860,Dooga,draenor,288,priest,discipline,12,3,9
17861,Yaaoz,dun-modr,288,priest,discipline,12,3,9
17862,Maybeexp,ravencrest,288,priest,discipline,12,3,9
17863,Knobibobby,blackrock,288,priest,discipline,12,3,9
17864,Arathelle,chromaggus,288,priest,discipline,12,3,9
17865,Výra,der-rat-von-dalaran,288,priest,discipline,12,3,9
17866,Orkall,sylvanas,288,priest,discipline,12,3,9
17867,Toratorap,burning-legion,288,priest,discipline,12,3,9
17868,Piitixd,burning-legion,288,priest,discipline,12,3,9
17869,Летиин,gordunni,288,priest,discipline,12,3,9
17870,Crazyhealsqt,hellfire,288,priest,discipline,12,3,9
17871,Moth,kazzak,288,priest,discipline,12,3,9
17872,Dizzaer,terokkar,288,priest,discipline,12,3,9
17873,Ælæx,alleria,288,priest,discipline,12,3,9
17874,Kalamh,marécage-de-zangar,288,priest,discipline,12,3,9
17875,Хуанкарлосс,soulflayer,288,priest,discipline,12,3,9
17876,Венэма,azuregos,288,priest,discipline,12,3,9
17877,Sarinà,archimonde,288,priest,discipline,18,3,15
17878,Rhanira,aegwynn,287,priest,discipline,6,3,3
17879,Xkv,blackmoore,287,priest,discipline,6,3,3
17880,Pontifex,baelgun,287,priest,discipline,6,3,3
17881,Bunetu,blackmoore,287,priest,discipline,6,3,3
17882,Hulluh,tarren-mill,287,priest,discipline,6,3,3
17883,Rotems,korgall,287,priest,discipline,12,3,9
17884,Sacabocaos,dun-modr,287,priest,discipline,12,3,9
17885,Orioz,tarren-mill,287,priest,discipline,12,3,9
17886,Eritreea,stormscale,287,priest,discipline,12,3,9
17887,Tíffanny,ragnaros,287,priest,discipline,12,3,9
17888,Elraine,ravencrest,287,priest,discipline,12,3,9
17889,Willibad,executus,286,priest,discipline,6,3,3
17890,Kårejonny,tarren-mill,275,priest,discipline,13,6,7
17891,Czee,draenor,255,priest,discipline,11,3,8
17892,Alphakillerz,sanguino,255,priest,discipline,11,3,8
17893,Zlothax,blackrock,255,priest,discipline,11,3,8
17894,Kikoke,sanguino,240,priest,discipline,9,3,6
17895,Sánta,blackmoore,240,priest,discipline,9,3,6
17896,Iloa,dun-morogh,239,priest,discipline,5,3,2
17897,Tyeldine,ragnaros,239,priest,discipline,9,4,5
17898,Паратузов,gordunni,239,priest,discipline,29,3,26
17899,Zargoss,sylvanas,234,priest,discipline,8,4,4
17900,Zxèlá,tarren-mill,234,priest,discipline,13,6,7
17901,Paandosa,outland,234,priest,discipline,9,4,5
17902,Sologrifer,sylvanas,234,priest,discipline,9,4,5
17903,Katwizro,hyjal,234,priest,discipline,16,6,10
17904,Mineshadow,argent-dawn,234,priest,discipline,11,4,7
17905,Jael,frostmane,234,priest,discipline,14,4,10
17906,Krakjak,twisting-nether,234,priest,discipline,15,4,11
17907,Shadowpeste,aggra-português,233,priest,discipline,11,4,7
17908,Хилогайка,howling-fjord,233,priest,discipline,16,4,12
17909,Flexelzz,argent-dawn,227,priest,discipline,18,6,12
17910,Dutchstuff,karazhan,192,priest,discipline,4,3,1
17911,Кфень,soulflayer,192,priest,discipline,4,3,1
17912,Cultaken,kazzak,192,priest,discipline,4,3,1
17913,Маджори,azuregos,192,priest,discipline,6,2,4
17914,Illüminaty,sylvanas,192,priest,discipline,6,2,4
17915,Soreboners,stormscale,192,priest,discipline,6,2,4
17916,Колдунская,soulflayer,192,priest,discipline,6,2,4
17917,Piedl,aegwynn,192,priest,discipline,6,2,4
17918,Wâneis,stormscale,192,priest,discipline,6,2,4
17919,Nitroze,stormscale,192,priest,discipline,6,2,4
17920,Ilovedomo,stormscale,192,priest,discipline,6,2,4
17921,Remyy,jaedenar,192,priest,discipline,6,2,4
17922,Chukapi,stormscale,192,priest,discipline,6,2,4
17923,Amayko,kazzak,192,priest,discipline,6,2,4
17924,Numa,stormscale,192,priest,discipline,6,2,4
17925,Pidarkgogo,stormscale,192,priest,discipline,6,2,4
17926,Tofsy,stormscale,192,priest,discipline,6,2,4
17927,Mcx,stormscale,192,priest,discipline,6,2,4
17928,Rallzken,stormscale,192,priest,discipline,6,2,4
17929,Maquivel,aggra-português,192,priest,discipline,6,2,4
17930,Vanadii,blackhand,192,priest,discipline,6,2,4
17931,Uncleben,grim-batol,192,priest,discipline,6,2,4
17932,Chrònos,das-konsortium,192,priest,discipline,6,2,4
17933,Prodan,frostmane,192,priest,discipline,6,2,4
17934,Somai,aegwynn,192,priest,discipline,6,2,4
17935,Toxicx,aegwynn,192,priest,discipline,6,2,4
17936,Zxø,ravencrest,192,priest,discipline,6,2,4
17937,Unreal,nagrand,192,priest,discipline,6,2,4
17938,Pøh,kilrogg,192,priest,discipline,6,2,4
17939,Побьюкадилом,gordunni,192,priest,discipline,6,2,4
17940,Доминантрикс,soulflayer,192,priest,discipline,6,2,4
17941,Sachikø,sylvanas,192,priest,discipline,6,2,4
17942,Ølle,ravencrest,192,priest,discipline,6,2,4
17943,Jaduheart,ravencrest,192,priest,discipline,6,2,4
17944,Мэдмод,gordunni,192,priest,discipline,6,2,4
17945,Артэта,blackscar,192,priest,discipline,6,2,4
17946,Lirrydoz,ravencrest,192,priest,discipline,6,2,4
17947,Paterpaisios,kazzak,192,priest,discipline,6,2,4
17948,Каэден,blackscar,192,priest,discipline,6,2,4
17949,Qku,ravencrest,192,priest,discipline,6,2,4
17950,Tacøgxd,ravencrest,192,priest,discipline,6,2,4
17951,Terstyana,hyjal,192,priest,discipline,6,2,4
17952,Ascindra,ravencrest,192,priest,discipline,6,2,4
17953,Radulfus,stormrage,192,priest,discipline,6,2,4
17954,Ægirl,chamber-of-aspects,192,priest,discipline,6,2,4
17955,Jøjmenejøj,ravencrest,192,priest,discipline,6,2,4
17956,Anvena,elune,192,priest,discipline,6,2,4
17957,Nálá,nethersturm,192,priest,discipline,6,2,4
17958,Skytheory,eredar,192,priest,discipline,6,2,4
17959,Derathon,eredar,192,priest,discipline,6,2,4
17960,Mlii,the-maelstrom,192,priest,discipline,6,2,4
17961,Dîablø,eredar,192,priest,discipline,6,2,4
17962,Vadhänder,the-maelstrom,192,priest,discipline,6,2,4
17963,Ethylene,ysondre,192,priest,discipline,6,2,4
17964,Cctw,archimonde,192,priest,discipline,6,2,4
17965,Thyrandis,dragonblight,192,priest,discipline,6,2,4
17966,Рэпру,galakrond,192,priest,discipline,6,2,4
17967,Spectriums,twisting-nether,192,priest,discipline,6,2,4
17968,Clastro,outland,192,priest,discipline,6,2,4
17969,Sebiarchie,lightnings-blade,192,priest,discipline,6,2,4
17970,Thehealer,twisting-nether,192,priest,discipline,6,2,4
17971,Shalabox,twisting-nether,192,priest,discipline,6,2,4
17972,Døtgdx,archimonde,192,priest,discipline,6,2,4
17973,Chópsuey,stormscale,192,priest,discipline,6,2,4
17974,Xblue,outland,192,priest,discipline,6,2,4
17975,Malapriest,dalaran,192,priest,discipline,6,2,4
17976,Tinúvielle,dalaran,192,priest,discipline,6,2,4
17977,Elëctra,vashj,192,priest,discipline,6,2,4
17978,Shaomi,eldrethalas,192,priest,discipline,6,2,4
17979,Missright,ragnaros,192,priest,discipline,6,2,4
17980,Aidkit,burning-legion,192,priest,discipline,6,2,4
17981,Perrín,blackrock,192,priest,discipline,6,2,4
17982,Methslinger,draenor,192,priest,discipline,6,2,4
17983,Niikki,blackrock,192,priest,discipline,6,2,4
17984,Dqt,ragnaros,192,priest,discipline,6,2,4
17985,Groaxx,ragnaros,192,priest,discipline,6,2,4
17986,Quïzzler,ragnaros,192,priest,discipline,6,2,4
17987,Hormgal,blackmoore,192,priest,discipline,6,2,4
17988,Wumtris,ragnaros,192,priest,discipline,6,2,4
17989,Várósh,blackmoore,192,priest,discipline,6,2,4
17990,Zéró,gorgonnash,192,priest,discipline,6,2,4
17991,Ичисанчик,howling-fjord,192,priest,discipline,6,2,4
17992,Kopfsache,blackmoore,192,priest,discipline,6,2,4
17993,Xýz,tarren-mill,192,priest,discipline,6,2,4
17994,Bigbootyheal,silvermoon,192,priest,discipline,6,2,4
17995,Тейдехан,howling-fjord,192,priest,discipline,6,2,4
17996,Servaas,silvermoon,192,priest,discipline,6,2,4
17997,Titiqr,naxxramas,192,priest,discipline,6,2,4
17998,Rickermortis,defias-brotherhood,192,priest,discipline,6,2,4
17999,Alexwinkwink,kazzak,192,priest,discipline,6,2,4
18000,Insufrible,minahonda,192,priest,discipline,6,2,4
18001,Quintanaro,thrall,192,priest,discipline,6,2,4
18002,Coldxzera,tarren-mill,192,priest,discipline,6,2,4
18003,Adägïo,dun-modr,192,priest,discipline,6,2,4
18004,Shadowlander,dun-modr,192,priest,discipline,6,2,4
18005,Idén,quelthalas,192,priest,discipline,6,2,4
18006,Sipriest,silvermoon,192,priest,discipline,6,2,4
18007,Calah,frostwhisper,192,priest,discipline,6,2,4
18008,Dxlkekss,blackmoore,192,priest,discipline,6,2,4
18009,Nekros,agamaggan,192,priest,discipline,6,2,4
18010,Tigrok,burning-legion,192,priest,discipline,6,2,4
18011,Jupiminaj,tarren-mill,192,priest,discipline,6,2,4
18012,Superogór,burning-legion,192,priest,discipline,6,2,4
18013,Stanyú,tarren-mill,192,priest,discipline,6,2,4
18014,Phantombride,silvermoon,192,priest,discipline,6,2,4
18015,Bigpinkballs,tarren-mill,192,priest,discipline,6,2,4
18016,Ponting,kazzak,192,priest,discipline,6,2,4
18017,Prîëstìtütê,doomhammer,192,priest,discipline,6,2,4
18018,Kaamiluus,burning-legion,192,priest,discipline,6,2,4
18019,Zubrowkâ,kazzak,192,priest,discipline,6,2,4
18020,Mehhx,burning-legion,192,priest,discipline,6,2,4
18021,Tiefergelegt,arthas,192,priest,discipline,6,2,4
18022,Hexonite,burning-legion,192,priest,discipline,6,2,4
18023,Hoon,destromath,192,priest,discipline,6,2,4
18024,Pristara,bloodhoof,192,priest,discipline,6,2,4
18025,Grduebel,tirion,192,priest,discipline,6,2,4
18026,Taschigi,rexxar,192,priest,discipline,6,2,4
18027,Draconux,terenas,192,priest,discipline,6,2,4
18028,Calling,nozdormu,192,priest,discipline,6,2,4
18029,Kironm,kazzak,192,priest,discipline,6,2,4
18030,Sazo,drakthul,192,priest,discipline,6,2,4
18031,Øxx,blackrock,192,priest,discipline,6,2,4
18032,Fadehojwnabe,the-shatar,192,priest,discipline,6,2,4
18033,Декорий,soulflayer,192,priest,discipline,6,2,4
18034,Uwuslayerx,stormscale,192,priest,discipline,7,2,5
18035,Flayin,kazzak,192,priest,discipline,7,2,5
18036,Meatyshaft,doomhammer,192,priest,discipline,11,3,8
18037,Иванвай,soulflayer,192,priest,discipline,9,2,7
18038,Джулибуба,borean-tundra,192,priest,discipline,12,2,10
18039,Balan,argent-dawn,192,priest,discipline,12,2,10
18040,Ulfsarkaom,turalyon,192,priest,discipline,12,2,10
18041,Zêlða,ravencrest,192,priest,discipline,12,2,10
18042,Xlia,argent-dawn,192,priest,discipline,12,2,10
18043,Aist,ragnaros,192,priest,discipline,12,2,10
18044,Norah,kirin-tor,192,priest,discipline,12,2,10
18045,Shacoat,draenor,192,priest,discipline,12,2,10
18046,Trickfulzqt,stormscale,192,priest,discipline,12,2,10
18047,Sevinho,twisting-nether,192,priest,discipline,12,2,10
18048,Chenandler,aggra-português,192,priest,discipline,12,2,10
18049,Miind,tarren-mill,192,priest,discipline,12,2,10
18050,Adallon,blackmoore,192,priest,discipline,12,2,10
18051,Aldebrand,dun-modr,192,priest,discipline,12,2,10
18052,Petjouli,darksorrow,192,priest,discipline,12,2,10
18053,Chizu,alakir,192,priest,discipline,12,2,10
18054,Zinary,silvermoon,192,priest,discipline,18,2,16
18055,Yhraeliaegh,defias-brotherhood,192,priest,discipline,18,2,16
18056,Adolosh,thrall,191,priest,discipline,6,2,4
18057,Jumpaxx,archimonde,159,priest,discipline,5,2,3
18058,Smyx,blackhand,159,priest,discipline,5,2,3
18059,Munche,blackmoore,159,priest,discipline,5,2,3
18060,Djem,argent-dawn,144,priest,discipline,3,3,0
18061,Discopriestt,outland,144,priest,discipline,9,2,7
18062,Sotanax,khazgoroth,144,priest,discipline,9,2,7
18063,Magister,sanguino,138,priest,discipline,9,4,5
18064,Xire,outland,138,priest,discipline,8,3,5
18065,Ohhowpretty,ravencrest,138,priest,discipline,11,4,7
18066,Majestíc,blackmoore,138,priest,discipline,9,3,6
18067,Barbiemeth,silvermoon,138,priest,discipline,21,6,15
18068,Шорон,howling-fjord,138,priest,discipline,11,3,8
18069,Rushax,ravencrest,137,priest,discipline,7,3,4
18070,Xakala,cthun,137,priest,discipline,13,3,10
18071,Rosalina,ravencrest,128,priest,discipline,4,2,2
18072,Darzul,conseil-des-ombres,127,priest,discipline,8,2,6
18073,Lucerna,defias-brotherhood,112,priest,discipline,7,2,5
18074,Sdw,kargath,96,priest,discipline,3,2,1
18075,Midy,drakthul,96,priest,discipline,3,2,1
18076,Wizzp,magtheridon,96,priest,discipline,9,2,7
18077,Guiliman,chamber-of-aspects,96,priest,discipline,11,2,9
18078,Miraçlê,kazzak,96,priest,discipline,6,1,5
18079,Sonyl,les-sentinelles,96,priest,discipline,6,1,5
18080,Madcole,blackhand,96,priest,discipline,6,1,5
18081,Героиннарбг,soulflayer,96,priest,discipline,6,1,5
18082,Хоббитсон,soulflayer,96,priest,discipline,6,1,5
18083,Jaimee,zirkel-des-cenarius,96,priest,discipline,6,1,5
18084,Aprima,culte-de-la-rive-noire,96,priest,discipline,6,1,5
18085,Erkay,kazzak,96,priest,discipline,6,1,5
18086,Hiliom,ahnqiraj,96,priest,discipline,6,1,5
18087,Teri,taerar,96,priest,discipline,6,1,5
18088,Rennic,stormscale,96,priest,discipline,6,1,5
18089,Redblue,onyxia,96,priest,discipline,6,1,5
18090,Myxeh,ravencrest,96,priest,discipline,6,1,5
18091,Немонте,gordunni,96,priest,discipline,6,1,5
18092,Могвайи,soulflayer,96,priest,discipline,6,1,5
18093,Leykop,ravencrest,96,priest,discipline,6,1,5
18094,Liendro,stormscale,96,priest,discipline,6,1,5
18095,Peez,stormscale,96,priest,discipline,6,1,5
18096,Жрецдуши,gordunni,96,priest,discipline,6,1,5
18097,Olqp,tarren-mill,96,priest,discipline,6,1,5
18098,Joncartagena,sanguino,96,priest,discipline,6,1,5
18099,Оумега,gordunni,96,priest,discipline,6,1,5
18100,Lyssandre,stormreaver,96,priest,discipline,6,1,5
18101,Alsalty,stormscale,96,priest,discipline,6,1,5
18102,Graveyards,tarren-mill,96,priest,discipline,6,1,5
18103,Yogastretch,ravencrest,96,priest,discipline,6,1,5
18104,Шишищ,gordunni,96,priest,discipline,6,1,5
18105,Promiqt,drakthul,96,priest,discipline,6,1,5
18106,Марриаза,blackscar,96,priest,discipline,6,1,5
18107,Arttos,antonidas,96,priest,discipline,6,1,5
18108,Sende,tarren-mill,96,priest,discipline,6,1,5
18109,Pellé,stormscale,96,priest,discipline,6,1,5
18110,Iololololxd,eredar,96,priest,discipline,6,1,5
18111,Huhu,defias-brotherhood,96,priest,discipline,6,1,5
18112,Dami,defias-brotherhood,96,priest,discipline,6,1,5
18113,Iovely,stormscale,96,priest,discipline,6,1,5
18114,Бидоноприст,fordragon,96,priest,discipline,6,1,5
18115,Pristürk,burning-legion,96,priest,discipline,6,1,5
18116,Namï,darksorrow,96,priest,discipline,6,1,5
18117,Dionegativ,draenor,96,priest,discipline,6,1,5
18118,Xälis,ysondre,96,priest,discipline,6,1,5
18119,Listenlisten,archimonde,96,priest,discipline,6,1,5
18120,Æsia,archimonde,96,priest,discipline,6,1,5
18121,Йоййо,gordunni,96,priest,discipline,6,1,5
18122,Ascendare,tarren-mill,96,priest,discipline,6,1,5
18123,Миррен,gordunni,96,priest,discipline,6,1,5
18124,Récko,blackmoore,96,priest,discipline,6,1,5
18125,Cysco,blackmoore,96,priest,discipline,6,1,5
18126,Yixi,blackmoore,96,priest,discipline,6,1,5
18127,Filit,hyjal,96,priest,discipline,6,1,5
18128,Stickpas,ysondre,96,priest,discipline,6,1,5
18129,Larisä,uldum,96,priest,discipline,6,1,5
18130,Missah,archimonde,96,priest,discipline,6,1,5
18131,Nondi,frostmane,96,priest,discipline,6,1,5
18132,Xyret,blackmoore,96,priest,discipline,6,1,5
18133,Cptncarrot,blackmoore,96,priest,discipline,6,1,5
18134,Jônb,tarren-mill,96,priest,discipline,6,1,5
18135,Shinesomnya,aegwynn,96,priest,discipline,6,1,5
18136,Vampirito,ragnaros,96,priest,discipline,6,1,5
18137,Anethron,ragnaros,96,priest,discipline,6,1,5
18138,Menjo,silvermoon,96,priest,discipline,6,1,5
18139,Broncos,twisting-nether,96,priest,discipline,6,1,5
18140,Sayala,dalaran,96,priest,discipline,6,1,5
18141,Réaper,twilights-hammer,96,priest,discipline,6,1,5
18142,Senkín,aegwynn,96,priest,discipline,6,1,5
18143,Скартэикс,howling-fjord,96,priest,discipline,6,1,5
18144,Holzí,frostmourne,96,priest,discipline,6,1,5
18145,Jaatjak,ravencrest,96,priest,discipline,6,1,5
18146,Dnsxx,thrall,96,priest,discipline,6,1,5
18147,Sorprendente,cthun,96,priest,discipline,12,1,11
18148,Kelarai,azjolnerub,96,priest,discipline,12,1,11
18149,Epokalarm,ragnaros,96,priest,discipline,12,1,11
18150,Alwiel,kazzak,96,priest,discipline,12,1,11
18151,Architectx,ravencrest,96,priest,discipline,14,1,13
18152,Ccatchme,sylvanas,96,priest,discipline,18,1,17
18153,Priestin,dun-modr,79,priest,discipline,5,1,4
18154,Elián,silvermoon,79,priest,discipline,5,1,4
18155,Tiinia,hyjal,74,priest,discipline,13,3,10
18156,Tronte,dun-modr,64,priest,discipline,4,1,3
18157,Faithful,emerald-dream,64,priest,discipline,8,1,7
18158,Jaimeê,der-rat-von-dalaran,63,priest,discipline,2,2,0
18159,Pushup,drakthul,48,priest,discipline,3,1,2
18160,Bossku,kazzak,48,priest,discipline,3,1,2
18161,Piacolada,aegwynn,48,priest,discipline,3,1,2
18162,Triip,argent-dawn,42,priest,discipline,7,2,5
18163,Хаахаахаа,gordunni,42,priest,discipline,11,3,8
18164,Ronk,outland,42,priest,discipline,9,2,7
18165,Xxddxd,draenor,42,priest,discipline,17,3,14
18166,Yggdra,ragnaros,2229,priest,shadow,66,44,22
18167,Хедмэнмвп,gordunni,2203,priest,shadow,156,80,76
18168,Dollyboo,tarren-mill,2152,priest,shadow,125,77,48
18169,Ilovemycat,silvermoon,2152,priest,shadow,78,47,31
18170,Hanic,kazzak,2151,priest,shadow,68,43,25
18171,Permafeetup,aegwynn,2151,priest,shadow,78,45,33
18172,Cheesecake,defias-brotherhood,2143,priest,shadow,78,47,31
18173,Blacktrain,burning-blade,2136,priest,shadow,118,60,58
18174,Crainoo,ravencrest,2136,priest,shadow,152,77,75
18175,Даняпампгодх,soulflayer,2127,priest,shadow,170,86,84
18176,Voidfi,kult-der-verdammten,2111,priest,shadow,114,64,50
18177,Rzkp,eredar,2110,priest,shadow,93,50,43
18178,Yuzuflex,hyjal,2110,priest,shadow,81,43,38
18179,Standtall,blackrock,2103,priest,shadow,78,44,34
18180,Sphero,earthen-ring,2101,priest,shadow,130,73,57
18181,Stjärtsten,tarren-mill,2097,priest,shadow,159,96,63
18182,Syedi,drakthul,2077,priest,shadow,117,55,62
18183,Сделайсам,gordunni,2071,priest,shadow,75,42,33
18184,Bönfire,silvermoon,2071,priest,shadow,134,70,64
18185,Èxtêrmìnätör,kazzak,2059,priest,shadow,66,41,25
18186,Walterwhite,stormscale,2059,priest,shadow,66,36,30
18187,Notsoholy,blackmoore,2056,priest,shadow,60,37,23
18188,Purpl,tarren-mill,2045,priest,shadow,114,62,52
18189,Pu,outland,2039,priest,shadow,90,43,47
18190,Миладиель,gordunni,2033,priest,shadow,101,52,49
18191,Thanatae,kazzak,2030,priest,shadow,79,44,35
18192,Pepeshadow,twisting-nether,2020,priest,shadow,93,48,45
18193,Destinyhero,aegwynn,2015,priest,shadow,82,42,40
18194,Shåmssv,kazzak,1997,priest,shadow,60,32,28
18195,Zhadum,stormscale,1990,priest,shadow,107,57,50
18196,Rzktwo,eredar,1988,priest,shadow,59,33,26
18197,Sethÿr,sanguino,1982,priest,shadow,126,66,60
18198,Justtpro,twisting-nether,1978,priest,shadow,116,74,42
18199,Tremrfinger,dun-modr,1969,priest,shadow,62,42,20
18200,Dbeezy,tarren-mill,1961,priest,shadow,58,33,25
18201,Nousey,twisting-nether,1959,priest,shadow,54,32,22
18202,Infuséd,aegwynn,1956,priest,shadow,54,30,24
18203,Moretti,ravencrest,1953,priest,shadow,54,32,22
18204,Gorholm,argent-dawn,1949,priest,shadow,52,36,16
18205,Vaccineboost,silvermoon,1944,priest,shadow,84,40,44
18206,Dhurza,shendralar,1938,priest,shadow,66,39,27
18207,Бвонсаамди,soulflayer,1928,priest,shadow,107,58,49
18208,Estragon,quelthalas,1912,priest,shadow,75,40,35
18209,Dippy,blackrock,1910,priest,shadow,42,27,15
18210,Heal,hyjal,1900,priest,shadow,194,109,85
18211,Xsß,dun-modr,1900,priest,shadow,65,34,31
18212,Hansmaul,thrall,1897,priest,shadow,36,20,16
18213,Maryhugette,archimonde,1892,priest,shadow,84,43,41
18214,Shádówý,kazzak,1889,priest,shadow,36,20,16
18215,Melábufeis,dun-modr,1887,priest,shadow,60,34,26
18216,Rrj,ravencrest,1886,priest,shadow,46,29,17
18217,Lâughing,ravencrest,1883,priest,shadow,55,32,23
18218,Хьёх,blackscar,1882,priest,shadow,54,33,21
18219,Qoryn,ravencrest,1882,priest,shadow,42,25,17
18220,Genjutzux,kazzak,1882,priest,shadow,54,32,22
18221,Heffer,outland,1880,priest,shadow,93,58,35
18222,Akibom,drakthul,1879,priest,shadow,47,31,16
18223,Бхонсамди,blackscar,1872,priest,shadow,65,40,25
18224,Knútx,stormscale,1867,priest,shadow,60,30,30
18225,Râvyn,silvermoon,1866,priest,shadow,44,35,9
18226,Rãpidi,hyjal,1866,priest,shadow,77,48,29
18227,Simôc,eredar,1864,priest,shadow,48,25,23
18228,Weekfortyone,blackhand,1864,priest,shadow,56,27,29
18229,Perché,silvermoon,1863,priest,shadow,54,39,15
18230,Tentoumushi,ravencrest,1861,priest,shadow,42,27,15
18231,Zuhä,twisting-nether,1861,priest,shadow,60,34,26
18232,Prøphetx,thrall,1861,priest,shadow,105,52,53
18233,Angsty,blackrock,1860,priest,shadow,52,30,22
18234,Léandrä,magtheridon,1860,priest,shadow,60,28,32
18235,Milkysmite,twisting-nether,1856,priest,shadow,52,32,20
18236,Ансор,lich-king,1856,priest,shadow,89,50,39
18237,Iodjsaiojoij,kazzak,1856,priest,shadow,54,30,24
18238,Buøbuarns,sanguino,1856,priest,shadow,51,23,28
18239,Rockness,blackmoore,1854,priest,shadow,131,88,43
18240,Термидор,booty-bay,1851,priest,shadow,83,52,31
18241,Physxd,blackrock,1848,priest,shadow,36,28,8
18242,Animesenpai,kazzak,1847,priest,shadow,60,32,28
18243,Deathlý,blackrock,1846,priest,shadow,54,30,24
18244,Akolyte,blackmoore,1843,priest,shadow,36,22,14
18245,Trisks,ravencrest,1843,priest,shadow,34,20,14
18246,Arendt,blackhand,1837,priest,shadow,48,29,19
18247,Zoodiacp,blackrock,1837,priest,shadow,58,28,30
18248,Sadix,ravencrest,1835,priest,shadow,66,38,28
18249,Безрассудица,howling-fjord,1834,priest,shadow,55,29,26
18250,Either,kazzak,1833,priest,shadow,59,33,26
18251,Ымц,gordunni,1832,priest,shadow,66,33,33
18252,Schmetter,tarren-mill,1829,priest,shadow,65,29,36
18253,Selëne,blackrock,1827,priest,shadow,72,43,29
18254,Игорянатакуе,eversong,1826,priest,shadow,154,86,68
18255,Rakamain,ravencrest,1825,priest,shadow,48,31,17
18256,Anateoris,turalyon,1825,priest,shadow,76,43,33
18257,Quezaris,stormscale,1825,priest,shadow,48,23,25
18258,Cantsqell,silvermoon,1823,priest,shadow,48,34,14
18259,Ûñträînablê,outland,1822,priest,shadow,48,34,14
18260,Swdjkbad,kazzak,1822,priest,shadow,47,28,19
18261,Староезло,gordunni,1821,priest,shadow,68,33,35
18262,Marbellexd,pozzo-delleternità,1818,priest,shadow,157,91,66
18263,Raikup,ravencrest,1816,priest,shadow,41,19,22
18264,Zodzín,ragnaros,1815,priest,shadow,36,19,17
18265,Theunknown,thrall,1814,priest,shadow,42,30,12
18266,Luvlyrah,draenor,1812,priest,shadow,81,52,29
18267,Namsolo,kazzak,1811,priest,shadow,78,42,36
18268,Skillmåsterx,ravencrest,1810,priest,shadow,54,29,25
18269,Gymbró,kazzak,1809,priest,shadow,54,31,23
18270,Айсиоу,howling-fjord,1807,priest,shadow,30,19,11
18271,Salkerer,stormscale,1807,priest,shadow,30,19,11
18272,Becknarbritt,stormscale,1807,priest,shadow,178,106,72
18273,Snarks,sylvanas,1806,priest,shadow,36,20,16
18274,Galatea,les-sentinelles,1805,priest,shadow,78,44,34
18275,Vajainap,outland,1804,priest,shadow,30,19,11
18276,Mataî,kazzak,1803,priest,shadow,84,49,35
18277,Devoura,sylvanas,1802,priest,shadow,36,25,11
18278,Margots,kazzak,1802,priest,shadow,42,22,20
18279,Bidraget,ravencrest,1797,priest,shadow,36,23,13
18280,Nyotux,blackrock,1795,priest,shadow,60,41,19
18281,Homxcxde,ravencrest,1794,priest,shadow,42,24,18
18282,Djops,outland,1792,priest,shadow,78,41,37
18283,Sepharis,runetotem,1776,priest,shadow,167,100,67
18284,Theoniss,draenor,1773,priest,shadow,48,32,16
18285,Hellscon,kazzak,1771,priest,shadow,72,39,33
18286,Dingopriest,blackrock,1761,priest,shadow,66,37,29
18287,Darthmantle,silvermoon,1758,priest,shadow,53,26,27
18288,Garycash,outland,1754,priest,shadow,82,42,40
18289,Ninjajane,sylvanas,1753,priest,shadow,53,32,21
18290,Staljon,burning-legion,1751,priest,shadow,36,23,13
18291,Erenndriel,twisting-nether,1744,priest,shadow,48,29,19
18292,Versio,dalvengyr,1739,priest,shadow,36,22,14
18293,Magicstarss,the-maelstrom,1733,priest,shadow,36,23,13
18294,Klosso,anachronos,1732,priest,shadow,107,49,58
18295,Ankî,aegwynn,1731,priest,shadow,78,42,36
18296,Zhyn,turalyon,1729,priest,shadow,110,65,45
18297,Mizulol,ravencrest,1727,priest,shadow,48,24,24
18298,Johnnybanana,argent-dawn,1722,priest,shadow,30,21,9
18299,Ptxd,alakir,1716,priest,shadow,40,26,14
18300,Всезнайка,soulflayer,1715,priest,shadow,114,61,53
18301,Перекованный,soulflayer,1713,priest,shadow,105,57,48
18302,Xayona,argent-dawn,1713,priest,shadow,36,18,18
18303,Voidshuffle,laughing-skull,1708,priest,shadow,30,18,12
18304,Dümbledore,aggra-português,1704,priest,shadow,24,18,6
18305,Helín,hellfire,1702,priest,shadow,84,48,36
18306,Ageyr,ragnaros,1701,priest,shadow,53,34,19
18307,Atahalni,argent-dawn,1700,priest,shadow,36,18,18
18308,Фиброз,blackscar,1695,priest,shadow,66,41,25
18309,Sÿrax,ysondre,1693,priest,shadow,30,18,12
18310,Goodsuck,tarren-mill,1693,priest,shadow,48,27,21
18311,Кломми,gordunni,1688,priest,shadow,66,35,31
18312,Iessei,outland,1686,priest,shadow,30,18,12
18313,Mojibien,burning-legion,1683,priest,shadow,92,54,38
18314,Víppe,stormreaver,1682,priest,shadow,53,32,21
18315,Geløpr,eredar,1681,priest,shadow,36,23,13
18316,Трейдарк,blackscar,1673,priest,shadow,48,23,25
18317,Dezerta,nozdormu,1667,priest,shadow,68,37,31
18318,Zeythz,ravencrest,1665,priest,shadow,88,51,37
18319,Yêl,thrall,1662,priest,shadow,137,76,61
18320,Tosem,antonidas,1661,priest,shadow,30,19,11
18321,Киндзер,blackscar,1658,priest,shadow,54,29,25
18322,Buffholy,dun-modr,1657,priest,shadow,60,36,24
18323,Bréézee,ravencrest,1654,priest,shadow,35,18,17
18324,Cnsnn,ysondre,1653,priest,shadow,72,49,23
18325,Финдовский,gordunni,1649,priest,shadow,102,54,48
18326,Ruhe,silvermoon,1648,priest,shadow,48,27,21
18327,Akroama,archimonde,1648,priest,shadow,41,20,21
18328,Cdplz,archimonde,1647,priest,shadow,30,20,10
18329,Kylähullu,ravencrest,1641,priest,shadow,50,25,25
18330,Lindp,stormreaver,1640,priest,shadow,30,21,9
18331,Weebi,silvermoon,1640,priest,shadow,65,39,26
18332,Milo,argent-dawn,1640,priest,shadow,102,61,41
18333,Mikizu,die-aldor,1638,priest,shadow,42,21,21
18334,Spklooril,hyjal,1635,priest,shadow,151,79,72
18335,Undefined,chamber-of-aspects,1634,priest,shadow,40,28,12
18336,Lênax,arthas,1633,priest,shadow,40,23,17
18337,Дикаях,gordunni,1633,priest,shadow,106,51,55
18338,Jaimë,ravencrest,1630,priest,shadow,30,17,13
18339,Ðanilox,dun-modr,1629,priest,shadow,24,17,7
18340,Mérce,kazzak,1629,priest,shadow,30,20,10
18341,Билетлолпро,borean-tundra,1627,priest,shadow,30,17,13
18342,Ксерф,soulflayer,1627,priest,shadow,84,40,44
18343,Медовыедотки,soulflayer,1627,priest,shadow,42,20,22
18344,Liptonolda,blackhand,1624,priest,shadow,30,17,13
18345,Трубишоп,howling-fjord,1624,priest,shadow,76,38,38
18346,Affex,tarren-mill,1622,priest,shadow,30,18,12
18347,Tacøgxd,ravencrest,1621,priest,shadow,30,21,9
18348,Toesxcker,stormscale,1616,priest,shadow,35,21,14
18349,Priestazie,madmortem,1616,priest,shadow,96,57,39
18350,Knoffp,blackhand,1614,priest,shadow,72,41,31
18351,Mehtz,ravencrest,1613,priest,shadow,132,63,69
18352,Rnkz,sanguino,1612,priest,shadow,36,20,16
18353,Ревентонх,howling-fjord,1611,priest,shadow,130,72,58
18354,Sheto,burning-legion,1609,priest,shadow,114,56,58
18355,Nabøøbies,blackmoore,1607,priest,shadow,32,18,14
18356,Faminé,outland,1606,priest,shadow,47,22,25
18357,Empz,thrall,1605,priest,shadow,59,25,34
18358,Kujiua,ravencrest,1603,priest,shadow,55,28,27
18359,Basicpr,ravencrest,1601,priest,shadow,45,30,15
18360,Sudeki,blackmoore,1601,priest,shadow,42,20,22
18361,Ottii,thrall,1599,priest,shadow,29,19,10
18362,Синатро,deathguard,1597,priest,shadow,124,79,45
18363,Llothx,ravencrest,1597,priest,shadow,62,34,28
18364,Máv,tarren-mill,1594,priest,shadow,48,27,21
18365,Tbs,sylvanas,1592,priest,shadow,57,31,26
18366,Dyshexia,bronze-dragonflight,1590,priest,shadow,48,27,21
18367,Vatikanet,ravencrest,1589,priest,shadow,81,49,32
18368,Pombär,ragnaros,1587,priest,shadow,54,36,18
18369,Spamplague,stormscale,1583,priest,shadow,36,20,16
18370,Milamati,kazzak,1576,priest,shadow,60,28,32
18371,Levitation,alakir,1575,priest,shadow,48,27,21
18372,Rasha,kazzak,1574,priest,shadow,32,20,12
18373,Priestfive,stormscale,1574,priest,shadow,36,20,16
18374,Charmebolzen,blackrock,1571,priest,shadow,36,18,18
18375,Imøteph,ragnaros,1569,priest,shadow,54,32,22
18376,Momomomomomo,aegwynn,1568,priest,shadow,60,30,30
18377,Zászàsmaster,kazzak,1565,priest,shadow,72,45,27
18378,Эззи,soulflayer,1565,priest,shadow,48,29,19
18379,Asterixsu,sylvanas,1556,priest,shadow,30,20,10
18380,Seneth,twisting-nether,1553,priest,shadow,60,31,29
18381,Xangha,burning-legion,1551,priest,shadow,72,41,31
18382,Skypray,burning-legion,1549,priest,shadow,36,20,16
18383,Sháady,ravencrest,1549,priest,shadow,42,23,19
18384,Деплитфофан,gordunni,1548,priest,shadow,59,39,20
18385,Strunkiin,defias-brotherhood,1548,priest,shadow,36,20,16
18386,Kêrrýgold,blackrock,1547,priest,shadow,67,37,30
18387,Valirda,twisting-nether,1544,priest,shadow,57,29,28
18388,Coupdekaraté,sylvanas,1543,priest,shadow,36,18,18
18389,Baldracca,shendralar,1542,priest,shadow,36,19,17
18390,Кхэрри,goldrinn,1540,priest,shadow,30,19,11
18391,Амгар,galakrond,1540,priest,shadow,125,69,56
18392,Ankhh,bloodscalp,1539,priest,shadow,42,19,23
18393,Absolution,stormscale,1538,priest,shadow,137,74,63
18394,Hâicu,antonidas,1535,priest,shadow,57,36,21
18395,Саксесфул,howling-fjord,1535,priest,shadow,97,53,44
18396,Bøts,ravencrest,1534,priest,shadow,55,27,28
18397,Синфал,blackscar,1533,priest,shadow,30,16,14
18398,Йоййо,gordunni,1532,priest,shadow,58,32,26
18399,Zekonja,doomhammer,1532,priest,shadow,82,42,40
18400,Kightz,twisting-nether,1530,priest,shadow,63,32,31
18401,Yirico,argent-dawn,1527,priest,shadow,24,16,8
18402,Мишатемный,gordunni,1526,priest,shadow,42,25,17
18403,Thmas,outland,1525,priest,shadow,71,32,39
18404,Everdark,twisting-nether,1524,priest,shadow,114,61,53
18405,Psycos,kazzak,1523,priest,shadow,66,33,33
18406,Chrønös,hyjal,1520,priest,shadow,30,18,12
18407,Казуямисима,gordunni,1520,priest,shadow,104,53,51
18408,Framesxøxø,ravencrest,1518,priest,shadow,24,16,8
18409,Даняпампх,soulflayer,1516,priest,shadow,83,49,34
18410,Umbralx,ragnaros,1513,priest,shadow,77,45,32
18411,Selaria,magtheridon,1512,priest,shadow,30,16,14
18412,Kellen,burning-blade,1509,priest,shadow,106,62,44
18413,Holyshadów,azjolnerub,1509,priest,shadow,48,24,24
18414,Beonin,tarren-mill,1508,priest,shadow,37,23,14
18415,Hemaplex,dun-modr,1508,priest,shadow,35,21,14
18416,Cylantharia,eredar,1506,priest,shadow,30,16,14
18417,Энвиньяттар,howling-fjord,1501,priest,shadow,24,17,7
18418,Cykdwojeczka,burning-legion,1499,priest,shadow,66,31,35
18419,Babarøqa,blackmoore,1493,priest,shadow,92,46,46
18420,Blasphemiia,outland,1492,priest,shadow,42,29,13
18421,Anathemas,draenor,1490,priest,shadow,30,22,8
18422,Kajifoxi,frostmane,1490,priest,shadow,60,38,22
18423,Bercxu,ragnaros,1487,priest,shadow,60,34,26
18424,Bierbändiger,blackhand,1487,priest,shadow,30,17,13
18425,Isusgaspodi,argent-dawn,1486,priest,shadow,66,42,24
18426,Kamish,twisting-nether,1481,priest,shadow,54,25,29
18427,Ecquidozx,ravencrest,1480,priest,shadow,29,16,13
18428,Зонкк,thermaplugg,1477,priest,shadow,114,62,52
18429,Dotsin,kazzak,1476,priest,shadow,107,55,52
18430,Mightyfool,aegwynn,1475,priest,shadow,36,18,18
18431,Massbimba,tarren-mill,1475,priest,shadow,41,19,22
18432,Pregrip,twisting-nether,1473,priest,shadow,43,21,22
18433,Thawx,stormscale,1472,priest,shadow,30,16,14
18434,Êttân,ravencrest,1467,priest,shadow,50,25,25
18435,Sandcastles,ravencrest,1463,priest,shadow,36,24,12
18436,Nygel,kazzak,1459,priest,shadow,65,35,30
18437,Adägïo,dun-modr,1457,priest,shadow,66,31,35
18438,Fiftyfives,hyjal,1456,priest,shadow,39,18,21
18439,Tyene,voljin,1455,priest,shadow,52,31,21
18440,Ounxx,blackrock,1454,priest,shadow,23,16,7
18441,Cinaedus,stormreaver,1449,priest,shadow,51,27,24
18442,Sanebassoff,kazzak,1447,priest,shadow,94,55,39
18443,Багбери,eversong,1442,priest,shadow,121,68,53
18444,Клаима,soulflayer,1441,priest,shadow,35,17,18
18445,Drarianna,nemesis,1439,priest,shadow,18,15,3
18446,Palitox,kazzak,1439,priest,shadow,70,38,32
18447,Ondskabsfuld,kazzak,1439,priest,shadow,30,15,15
18448,Voidgodx,blackrock,1438,priest,shadow,30,15,15
18449,Bubbleup,defias-brotherhood,1437,priest,shadow,24,16,8
18450,Lr,aszune,1436,priest,shadow,18,15,3
18451,Miruh,malganis,1433,priest,shadow,47,34,13
18452,Пристатеист,howling-fjord,1431,priest,shadow,36,15,21
18453,Yaoshih,draenor,1430,priest,shadow,53,28,25
18454,Billybay,argent-dawn,1429,priest,shadow,18,15,3
18455,Raspberrypíe,silvermoon,1428,priest,shadow,30,16,14
18456,Jaimee,zirkel-des-cenarius,1425,priest,shadow,24,15,9
18457,Vhayna,kazzak,1417,priest,shadow,53,32,21
18458,Sebbepriest,twisting-nether,1416,priest,shadow,30,18,12
18459,Unerfedsp,archimonde,1414,priest,shadow,63,27,36
18460,Shopify,nagrand,1412,priest,shadow,30,15,15
18461,Saintethérez,archimonde,1410,priest,shadow,45,30,15
18462,Рэнфан,fordragon,1409,priest,shadow,26,17,9
18463,Melanore,sylvanas,1407,priest,shadow,72,34,38
18464,Xooxl,ragnaros,1406,priest,shadow,24,17,7
18465,Dopey,kazzak,1406,priest,shadow,24,17,7
18466,Insaniro,argent-dawn,1405,priest,shadow,30,15,15
18467,Baihoi,twilights-hammer,1404,priest,shadow,36,24,12
18468,Maxhima,defias-brotherhood,1404,priest,shadow,66,34,32
18469,Experimentix,silvermoon,1402,priest,shadow,30,16,14
18470,Voidbro,grim-batol,1401,priest,shadow,29,15,14
18471,Vedina,bronze-dragonflight,1399,priest,shadow,75,32,43
18472,Nightshådøw,silvermoon,1398,priest,shadow,122,64,58
18473,Rogmisa,cthun,1394,priest,shadow,36,22,14
18474,Genthus,kazzak,1393,priest,shadow,48,19,29
18475,Дэспира,howling-fjord,1391,priest,shadow,28,16,12
18476,Bubidiblumpr,twisting-nether,1388,priest,shadow,42,27,15
18477,Kertith,argent-dawn,1388,priest,shadow,97,48,49
18478,Meshen,ysondre,1386,priest,shadow,76,42,34
18479,Дикрия,eversong,1386,priest,shadow,30,15,15
18480,Hek,sylvanas,1384,priest,shadow,72,36,36
18481,Damyo,eredar,1381,priest,shadow,54,29,25
18482,Kendea,silvermoon,1378,priest,shadow,93,50,43
18483,Kourroucé,archimonde,1377,priest,shadow,36,20,16
18484,Astangia,nemesis,1369,priest,shadow,117,64,53
18485,Офелла,howling-fjord,1369,priest,shadow,83,42,41
18486,Ваккарий,gordunni,1368,priest,shadow,43,27,16
18487,Apuessii,dun-modr,1366,priest,shadow,41,23,18
18488,Eryxial,antonidas,1365,priest,shadow,47,22,25
18489,Shizo,blutkessel,1364,priest,shadow,29,20,9
18490,Erkay,kazzak,1362,priest,shadow,36,17,19
18491,Cringelørd,alakir,1357,priest,shadow,24,15,9
18492,Míjagí,blackhand,1352,priest,shadow,47,25,22
18493,Ankus,tarren-mill,1350,priest,shadow,42,19,23
18494,Saviour,spinebreaker,1346,priest,shadow,30,19,11
18495,Shinígamí,frostmane,1346,priest,shadow,48,24,24
18496,Польскийбуль,gordunni,1343,priest,shadow,24,14,10
18497,Mafiasnipers,ravencrest,1343,priest,shadow,24,14,10
18498,Voidlink,kazzak,1342,priest,shadow,24,14,10
18499,Velenthøs,argent-dawn,1338,priest,shadow,41,23,18
18500,Xxede,dun-modr,1338,priest,shadow,51,23,28
18501,Hecaté,blackhand,1337,priest,shadow,55,31,24
18502,Seni,gilneas,1336,priest,shadow,55,26,29
18503,Settemsen,tarren-mill,1334,priest,shadow,18,14,4
18504,Sodomix,tarren-mill,1333,priest,shadow,76,44,32
18505,Bimboxo,argent-dawn,1332,priest,shadow,89,53,36
18506,Megajuicy,blackmoore,1332,priest,shadow,66,30,36
18507,Broncos,twisting-nether,1331,priest,shadow,58,33,25
18508,Inei,doomhammer,1329,priest,shadow,30,16,14
18509,Daltheria,daggerspine,1328,priest,shadow,59,34,25
18510,Baptizer,nemesis,1324,priest,shadow,67,43,24
18511,Poposy,hyjal,1324,priest,shadow,24,14,10
18512,Chinko,blackmoore,1319,priest,shadow,18,14,4
18513,Mackings,the-maelstrom,1319,priest,shadow,32,14,18
18514,Littlebugger,argent-dawn,1317,priest,shadow,63,28,35
18515,Twøpac,hyjal,1305,priest,shadow,59,32,27
18516,Kåz,argent-dawn,1301,priest,shadow,35,21,14
18517,Ammp,outland,1298,priest,shadow,92,51,41
18518,Сариандра,gordunni,1295,priest,shadow,24,15,9
18519,Kasyrra,sylvanas,1294,priest,shadow,30,17,13
18520,Hexmon,tarren-mill,1292,priest,shadow,30,21,9
18521,Hârlequin,draenor,1288,priest,shadow,150,81,69
18522,Prøfesor,nemesis,1284,priest,shadow,33,15,18
18523,Søcrax,blackrock,1276,priest,shadow,30,15,15
18524,Babarøga,blackrock,1274,priest,shadow,23,14,9
18525,Farseerx,ravencrest,1267,priest,shadow,90,54,36
18526,Odium,alakir,1264,priest,shadow,36,18,18
18527,Evilspel,ravencrest,1261,priest,shadow,33,18,15
18528,Hëllokitty,sanguino,1253,priest,shadow,86,42,44
18529,Cornflays,outland,1248,priest,shadow,18,13,5
18530,Yaboyboompie,blackrock,1248,priest,shadow,24,13,11
18531,Cutepangolin,khaz-modan,1247,priest,shadow,18,13,5
18532,Been,ravencrest,1247,priest,shadow,18,13,5
18533,Morteous,twisting-nether,1247,priest,shadow,241,121,120
18534,Shyvi,ravencrest,1246,priest,shadow,18,13,5
18535,Caballococo,dun-modr,1245,priest,shadow,46,18,28
18536,Angleka,argent-dawn,1243,priest,shadow,41,20,21
18537,Raisedbyrap,blackrock,1243,priest,shadow,30,13,17
18538,Dotreveal,ravencrest,1241,priest,shadow,24,13,11
18539,Greyford,blackhand,1240,priest,shadow,18,13,5
18540,Peikkousva,twisting-nether,1240,priest,shadow,24,13,11
18541,Putríd,sylvanas,1239,priest,shadow,18,13,5
18542,Lilyrosemary,arathor,1239,priest,shadow,24,13,11
18543,Morsy,alleria,1235,priest,shadow,27,14,13
18544,Varjomies,ragnaros,1234,priest,shadow,24,13,11
18545,Voidlord,hyjal,1232,priest,shadow,34,17,17
18546,Lilakaii,chamber-of-aspects,1231,priest,shadow,24,13,11
18547,Secundis,silvermoon,1219,priest,shadow,24,13,11
18548,Даркфолс,soulflayer,1219,priest,shadow,30,15,15
18549,Tesz,perenolde,1217,priest,shadow,36,16,20
18550,Bromiaris,dun-morogh,1217,priest,shadow,30,13,17
18551,Lowisa,sylvanas,1212,priest,shadow,23,13,10
18552,Thergozar,stormscale,1208,priest,shadow,48,33,15
18553,Cthulou,tarren-mill,1207,priest,shadow,99,53,46
18554,Zedrus,azshara,1206,priest,shadow,29,13,16
18555,Ggdoll,twisting-nether,1204,priest,shadow,60,28,32
18556,Psycoscream,blackmoore,1198,priest,shadow,29,13,16
18557,Nagatary,blackmoore,1192,priest,shadow,48,23,25
18558,Флэшх,soulflayer,1177,priest,shadow,22,13,9
18559,Tiinia,hyjal,1165,priest,shadow,40,15,25
18560,Sayash,chamber-of-aspects,1158,priest,shadow,26,13,13
18561,Scaryman,ravencrest,1157,priest,shadow,23,14,9
18562,Pandacore,frostmane,1152,priest,shadow,24,12,12
18563,Hotdog,kult-der-verdammten,1152,priest,shadow,42,20,22
18564,Julîane,aegwynn,1151,priest,shadow,18,12,6
18565,Smxkÿÿ,eredar,1151,priest,shadow,18,12,6
18566,Facemeltina,kiljaeden,1151,priest,shadow,24,12,12
18567,Døubtful,kazzak,1151,priest,shadow,24,12,12
18568,Jacep,kazzak,1150,priest,shadow,18,12,6
18569,Zindrix,silvermoon,1150,priest,shadow,18,12,6
18570,Mydianá,aegwynn,1149,priest,shadow,18,12,6
18571,Onlyfansp,ravencrest,1149,priest,shadow,30,12,18
18572,Fakecastguru,ravencrest,1148,priest,shadow,24,12,12
18573,Ølle,ravencrest,1147,priest,shadow,24,12,12
18574,Cederpriest,tarren-mill,1143,priest,shadow,39,13,26
18575,Eliana,blackrock,1136,priest,shadow,18,12,6
18576,Cerbero,doomhammer,1128,priest,shadow,18,12,6
18577,Chillx,blackmoore,1127,priest,shadow,30,19,11
18578,Lathas,bloodfeather,1127,priest,shadow,24,13,11
18579,Shiannâ,malganis,1118,priest,shadow,26,13,13
18580,Inzàné,kazzak,1114,priest,shadow,18,12,6
18581,Bodeeney,hellfire,1111,priest,shadow,36,15,21
18582,Nellytaa,dalaran,1103,priest,shadow,35,18,17
18583,Yuhé,elune,1100,priest,shadow,24,16,8
18584,Noremorze,ravencrest,1099,priest,shadow,35,16,19
18585,Voodkaa,drakthul,1098,priest,shadow,21,13,8
18586,Ðizzi,dun-modr,1096,priest,shadow,21,14,7
18587,Ladouce,archimonde,1096,priest,shadow,27,13,14
18588,Cabalist,silvermoon,1094,priest,shadow,60,30,30
18589,Амфетаминная,howling-fjord,1069,priest,shadow,20,13,7
18590,Equalìzer,ravencrest,1056,priest,shadow,12,11,1
18591,Yoe,twisting-nether,1056,priest,shadow,24,11,13
18592,Omedo,stormscale,1056,priest,shadow,24,11,13
18593,Talbatex,blackmoore,1056,priest,shadow,24,11,13
18594,Adub,tarren-mill,1055,priest,shadow,18,11,7
18595,Actionjezuz,shattered-hand,1055,priest,shadow,18,11,7
18596,Terrored,ravencrest,1055,priest,shadow,18,11,7
18597,Abjure,silvermoon,1053,priest,shadow,18,11,7
18598,Neitter,zuljin,1053,priest,shadow,18,11,7
18599,Санятруу,blackscar,1053,priest,shadow,78,42,36
18600,Блюмсик,blackscar,1052,priest,shadow,30,18,12
18601,Kwolinger,norgannon,1052,priest,shadow,24,11,13
18602,Îndura,drakthul,1051,priest,shadow,18,11,7
18603,Gauge,frostmane,1048,priest,shadow,31,12,19
18604,Fåith,twilights-hammer,1043,priest,shadow,18,11,7
18605,Zubrowkâ,kazzak,1043,priest,shadow,24,11,13
18606,Holypowér,twisting-nether,1041,priest,shadow,24,11,13
18607,Tsunadesaama,silvermoon,1037,priest,shadow,23,11,12
18608,Flayin,kazzak,1035,priest,shadow,24,11,13
18609,Festiz,tichondrius,1024,priest,shadow,30,14,16
18610,Shinesomnya,aegwynn,1017,priest,shadow,22,11,11
18611,Minabonxx,silvermoon,1002,priest,shadow,51,14,37
18612,Тэтсу,greymane,1001,priest,shadow,30,16,14
18613,Hypnocat,blackrock,991,priest,shadow,22,11,11
18614,Цитамин,deathguard,989,priest,shadow,33,11,22
18615,Vavulya,blackhand,988,priest,shadow,16,11,5
18616,Asdaprice,hellfire,986,priest,shadow,18,12,6
18617,Mylox,blackrock,984,priest,shadow,17,11,6
18618,Dayowe,antonidas,975,priest,shadow,28,13,15
18619,Уртримас,gordunni,975,priest,shadow,30,11,19
18620,Мргорсан,eversong,974,priest,shadow,30,16,14
18621,Кинраналь,eversong,964,priest,shadow,24,12,12
18622,Maedhrós,ravencrest,960,priest,shadow,12,10,2
18623,Даняпимпгадх,soulflayer,960,priest,shadow,18,10,8
18624,Blindöts,tarren-mill,960,priest,shadow,18,10,8
18625,Петушшара,gordunni,960,priest,shadow,21,10,11
18626,Шадоупуз,soulflayer,960,priest,shadow,24,10,14
18627,Pórt,kazzak,959,priest,shadow,15,11,4
18628,Snoopý,dun-modr,959,priest,shadow,18,10,8
18629,Cathrix,kazzak,959,priest,shadow,18,10,8
18630,Dreamhatcher,deathwing,959,priest,shadow,24,10,14
18631,Goodison,outland,959,priest,shadow,24,10,14
18632,Supriest,alakir,959,priest,shadow,24,10,14
18633,Rakkha,ravencrest,959,priest,shadow,24,10,14
18634,Miruvai,tarren-mill,958,priest,shadow,18,10,8
18635,Juxtapose,argent-dawn,957,priest,shadow,12,10,2
18636,Shadowsister,burning-blade,955,priest,shadow,18,10,8
18637,Mylini,silvermoon,954,priest,shadow,18,10,8
18638,Иннй,howling-fjord,947,priest,shadow,24,11,13
18639,Силабездны,deathguard,946,priest,shadow,38,20,18
18640,Syfl,defias-brotherhood,935,priest,shadow,24,10,14
18641,Abrakahudder,tarren-mill,927,priest,shadow,17,10,7
18642,Priestoll,draenor,911,priest,shadow,21,10,11
18643,Blóódfart,kazzak,904,priest,shadow,35,13,22
18644,Æäõ,turalyon,864,priest,shadow,12,9,3
18645,Ekkfwiedrice,ragnaros,864,priest,shadow,12,9,3
18646,Slimcharles,ravencrest,864,priest,shadow,12,9,3
18647,Shucks,stormscale,864,priest,shadow,18,9,9
18648,Manyus,archimonde,864,priest,shadow,18,9,9
18649,Scade,kazzak,864,priest,shadow,18,9,9
18650,Spyrono,kazzak,864,priest,shadow,18,9,9
18651,Vibéz,outland,864,priest,shadow,18,9,9
18652,Dogstav,kazzak,864,priest,shadow,18,9,9
18653,Insanious,skullcrusher,864,priest,shadow,18,9,9
18654,Ðrwiz,ravencrest,864,priest,shadow,18,9,9
18655,Schmatzy,blackmoore,864,priest,shadow,24,9,15
18656,Lostcause,alakir,863,priest,shadow,12,9,3
18657,Yoggies,tarren-mill,863,priest,shadow,15,10,5
18658,Dazé,ravencrest,863,priest,shadow,17,10,7
18659,Jadæ,ragnaros,863,priest,shadow,18,9,9
18660,Imaut,emerald-dream,863,priest,shadow,18,9,9
18661,Nomorelight,stormscale,863,priest,shadow,18,9,9
18662,Zayden,ragnaros,863,priest,shadow,18,9,9
18663,Jonig,blackmoore,863,priest,shadow,24,9,15
18664,Healiea,outland,863,priest,shadow,30,9,21
18665,Элдерле,gordunni,862,priest,shadow,18,9,9
18666,Hörror,twisting-nether,862,priest,shadow,18,9,9
18667,Ilostmybible,runetotem,862,priest,shadow,24,9,15
18668,Dívíne,ravenholdt,861,priest,shadow,12,9,3
18669,Smiles,burning-steppes,861,priest,shadow,18,9,9
18670,Dutchstuff,karazhan,861,priest,shadow,18,9,9
18671,Kavie,ravencrest,861,priest,shadow,18,9,9
18672,Adssdfhjgh,outland,860,priest,shadow,12,9,3
18673,Dumámày,silvermoon,860,priest,shadow,12,9,3
18674,ßeastx,nethersturm,859,priest,shadow,18,9,9
18675,Maximandreic,kazzak,859,priest,shadow,30,9,21
18676,Fordöbroo,ragnaros,858,priest,shadow,18,9,9
18677,Дроус,borean-tundra,858,priest,shadow,30,12,18
18678,Sacher,shendralar,853,priest,shadow,18,9,9
18679,Alfredosauce,ravencrest,831,priest,shadow,17,9,8
18680,Pipen,stormscale,820,priest,shadow,23,9,14
18681,Csksablanca,sargeras,815,priest,shadow,11,9,2
18682,Lightform,twisting-nether,814,priest,shadow,15,10,5
18683,Sigor,hellfire,802,priest,shadow,23,9,14
18684,Alicanx,silvermoon,798,priest,shadow,17,9,8
18685,Sypnos,zuljin,797,priest,shadow,16,9,7
18686,Magicalme,kult-der-verdammten,768,priest,shadow,12,8,4
18687,Necrofeel,silvermoon,768,priest,shadow,12,8,4
18688,Shyasianpr,area-52,768,priest,shadow,12,8,4
18689,Rýzera,aegwynn,768,priest,shadow,12,8,4
18690,Syreet,silvermoon,768,priest,shadow,12,8,4
18691,Прыст,howling-fjord,768,priest,shadow,12,8,4
18692,Bigdogone,arathor,768,priest,shadow,12,8,4
18693,Morseeii,baelgun,768,priest,shadow,12,8,4
18694,Hilerki,draenor,768,priest,shadow,18,8,10
18695,Jaanny,defias-brotherhood,768,priest,shadow,18,8,10
18696,Хелектро,deathweaver,768,priest,shadow,18,8,10
18697,Возрождающее,soulflayer,768,priest,shadow,18,8,10
18698,Qiandra,argent-dawn,768,priest,shadow,18,8,10
18699,Холиспирт,deathguard,767,priest,shadow,12,8,4
18700,Бомжскадилом,gordunni,767,priest,shadow,12,8,4
18701,Zappikpriest,silvermoon,767,priest,shadow,12,8,4
18702,Jegred,draenor,767,priest,shadow,12,8,4
18703,Flexzpriest,destromath,767,priest,shadow,18,8,10
18704,Äiri,blackmoore,767,priest,shadow,18,8,10
18705,Unreal,nagrand,767,priest,shadow,18,8,10
18706,Aereza,darkspear,767,priest,shadow,18,8,10
18707,Lynseanna,ravencrest,767,priest,shadow,18,8,10
18708,Priestlolx,aegwynn,767,priest,shadow,24,8,16
18709,Maskinjundre,bronzebeard,767,priest,shadow,24,8,16
18710,Ехереу,blackscar,766,priest,shadow,12,8,4
18711,Powna,blackrock,765,priest,shadow,12,8,4
18712,Johnnysp,eredar,765,priest,shadow,12,8,4
18713,Géèk,alakir,765,priest,shadow,19,8,11
18714,Holyface,twisting-nether,764,priest,shadow,12,8,4
18715,Sucukpriest,blackrock,764,priest,shadow,18,8,10
18716,Sammel,moonglade,763,priest,shadow,18,8,10
18717,Omnissiiah,silvermoon,763,priest,shadow,24,8,16
18718,Ixdeadxl,stormscale,761,priest,shadow,18,8,10
18719,Семмэр,gordunni,759,priest,shadow,27,9,18
18720,Shíàpríést,kazzak,734,priest,shadow,29,8,21
18721,Onskansmoder,shattered-hand,733,priest,shadow,22,8,14
18722,Aeo,twisting-nether,732,priest,shadow,17,8,9
18723,Raetwo,stormscale,703,priest,shadow,14,8,6
18724,Ниомана,gordunni,698,priest,shadow,12,9,3
18725,Dolens,argent-dawn,672,priest,shadow,12,7,5
18726,Миррен,gordunni,672,priest,shadow,12,7,5
18727,Donenigma,stormscale,672,priest,shadow,12,7,5
18728,Priestgrade,darkspear,672,priest,shadow,12,7,5
18729,Енотхд,soulflayer,672,priest,shadow,12,7,5
18730,Räke,blackrock,672,priest,shadow,12,7,5
18731,Sundae,nemesis,672,priest,shadow,12,7,5
18732,Sadgepriest,draenor,672,priest,shadow,12,7,5
18733,Solítu9D6529,tarren-mill,672,priest,shadow,12,7,5
18734,Donkyrobert,tarren-mill,672,priest,shadow,12,7,5
18735,Froffzy,tarren-mill,672,priest,shadow,12,7,5
18736,Марриаза,blackscar,672,priest,shadow,12,7,5
18737,Spherics,ravencrest,672,priest,shadow,12,7,5
18738,Bizzlebabe,lightbringer,672,priest,shadow,12,7,5
18739,Gød,magtheridon,672,priest,shadow,12,7,5
18740,Systerstål,twisting-nether,672,priest,shadow,12,7,5
18741,Fueguchi,anubarak,672,priest,shadow,12,7,5
18742,Zevulós,ravencrest,672,priest,shadow,12,7,5
18743,Говорун,grom,672,priest,shadow,12,7,5
18744,Uria,moonglade,672,priest,shadow,12,7,5
18745,Laradiel,dun-modr,672,priest,shadow,12,7,5
18746,Leggat,draenor,672,priest,shadow,15,8,7
18747,Majinbuù,sargeras,672,priest,shadow,18,7,11
18748,Heygoogle,ravencrest,672,priest,shadow,18,7,11
18749,Irlfatguy,ravencrest,672,priest,shadow,20,7,13
18750,Syam,dun-morogh,672,priest,shadow,24,7,17
18751,Слышуфонк,howling-fjord,671,priest,shadow,12,7,5
18752,Cryptoniite,kazzak,671,priest,shadow,12,7,5
18753,Мариаглорум,gordunni,671,priest,shadow,12,7,5
18754,Абсорб,gordunni,671,priest,shadow,12,7,5
18755,Badomens,draenor,671,priest,shadow,12,7,5
18756,Elarya,zenedar,671,priest,shadow,12,7,5
18757,Neggan,chamber-of-aspects,671,priest,shadow,18,7,11
18758,Jerolol,sanguino,671,priest,shadow,18,7,11
18759,Gooflord,ravencrest,671,priest,shadow,18,7,11
18760,Офинсия,deathguard,671,priest,shadow,24,7,17
18761,Calor,nemesis,670,priest,shadow,12,7,5
18762,Haxxøn,die-nachtwache,670,priest,shadow,12,7,5
18763,Kitasia,tarren-mill,670,priest,shadow,12,7,5
18764,Hiela,outland,670,priest,shadow,12,7,5
18765,Morgoh,die-arguswacht,670,priest,shadow,12,7,5
18766,Sáro,ravencrest,669,priest,shadow,12,7,5
18767,Hotsanddots,auchindoun,668,priest,shadow,12,7,5
18768,Некросиний,eversong,667,priest,shadow,12,7,5
18769,Phasmofobia,ragnaros,666,priest,shadow,12,7,5
18770,Bonbonici,sylvanas,666,priest,shadow,12,7,5
18771,Hulluh,tarren-mill,665,priest,shadow,12,7,5
18772,Redfield,frostmane,663,priest,shadow,24,7,17
18773,Ruhoniy,ysondre,658,priest,shadow,12,7,5
18774,Sadskîx,dun-modr,624,priest,shadow,9,8,1
18775,Brainwash,darksorrow,608,priest,shadow,16,7,9
18776,Sxynix,thrall,607,priest,shadow,11,7,4
18777,Reeflix,blackmoore,607,priest,shadow,17,8,9
18778,Kirrako,tarren-mill,576,priest,shadow,6,6,0
18779,Physx,blackrock,576,priest,shadow,6,6,0
18780,Inavea,hyjal,576,priest,shadow,6,6,0
18781,Xceliann,stormscale,576,priest,shadow,6,6,0
18782,Shacoat,draenor,576,priest,shadow,6,6,0
18783,Uselessxasel,sanguino,576,priest,shadow,6,6,0
18784,Шандресса,deepholm,576,priest,shadow,6,6,0
18785,Криптика,soulflayer,576,priest,shadow,6,6,0
18786,Stèálth,sylvanas,576,priest,shadow,6,6,0
18787,Uzü,ysondre,576,priest,shadow,10,7,3
18788,Saliâ,blackmoore,576,priest,shadow,12,6,6
18789,Cryptoflame,silvermoon,576,priest,shadow,12,6,6
18790,Тарренмилл,gordunni,576,priest,shadow,12,6,6
18791,Anabølix,ravencrest,576,priest,shadow,12,6,6
18792,Fluffieh,ravencrest,576,priest,shadow,12,6,6
18793,Miraçlê,kazzak,576,priest,shadow,12,6,6
18794,Voidpbody,nerathor,576,priest,shadow,12,6,6
18795,Babydark,ravencrest,576,priest,shadow,12,6,6
18796,Prästjäväln,stormscale,576,priest,shadow,12,6,6
18797,Seehz,ysondre,576,priest,shadow,12,6,6
18798,Ктулсотум,soulflayer,576,priest,shadow,12,6,6
18799,Skyfour,blackmoore,576,priest,shadow,12,6,6
18800,Cluelêss,blackrock,576,priest,shadow,12,6,6
18801,Бранлор,howling-fjord,576,priest,shadow,12,6,6
18802,Tùcøcø,archimonde,576,priest,shadow,12,6,6
18803,Shadoxx,malganis,576,priest,shadow,12,6,6
18804,Lløthx,ravencrest,576,priest,shadow,12,6,6
18805,Carmechanic,defias-brotherhood,576,priest,shadow,12,6,6
18806,Lilsayx,blackrock,576,priest,shadow,12,6,6
18807,Kimosabee,kazzak,576,priest,shadow,12,6,6
18808,Cultist,defias-brotherhood,576,priest,shadow,12,6,6
18809,Gbc,emerald-dream,576,priest,shadow,12,6,6
18810,Despéri,ysondre,576,priest,shadow,12,6,6
18811,Papie,kazzak,576,priest,shadow,12,6,6
18812,Khäñ,ravencrest,576,priest,shadow,24,6,18
18813,Нитровина,howling-fjord,575,priest,shadow,12,6,6
18814,Princéssà,aegwynn,575,priest,shadow,12,6,6
18815,Люблюкофе,deathguard,575,priest,shadow,12,6,6
18816,Wintercurse,twisting-nether,575,priest,shadow,18,6,12
18817,Sacreth,ragnaros,574,priest,shadow,24,6,18
18818,Reptika,tichondrius,573,priest,shadow,12,6,6
18819,Bloodimand,terenas,572,priest,shadow,12,6,6
18820,Trencharse,draenor,559,priest,shadow,17,6,11
18821,Skeida,bloodhoof,543,priest,shadow,11,6,5
18822,Spideypap,ragnaros,521,priest,shadow,16,7,9
18823,Õðæßìùa,kazzak,511,priest,shadow,11,6,5
18824,Lildiggy,outland,511,priest,shadow,14,6,8
18825,Potati,defias-brotherhood,480,priest,shadow,6,5,1
18826,Wérrýxs,kazzak,480,priest,shadow,6,5,1
18827,Kurzik,zuljin,480,priest,shadow,6,5,1
18828,Raeratwo,archimonde,480,priest,shadow,6,5,1
18829,Jingling,kazzak,480,priest,shadow,6,5,1
18830,Debbski,tarren-mill,480,priest,shadow,6,5,1
18831,Huffle,argent-dawn,480,priest,shadow,6,5,1
18832,Zeto,blackmoore,480,priest,shadow,6,5,1
18833,Tigrok,burning-legion,480,priest,shadow,6,5,1
18834,Скизма,gordunni,480,priest,shadow,6,5,1
18835,Rinkahands,silvermoon,480,priest,shadow,6,5,1
18836,Sharmidix,kazzak,480,priest,shadow,6,5,1
18837,Attilerg,stormscale,480,priest,shadow,6,5,1
18838,Døtgdx,archimonde,480,priest,shadow,6,5,1
18839,Gladíator,blackhand,480,priest,shadow,6,5,1
18840,Basxcbxtchx,ravencrest,480,priest,shadow,6,5,1
18841,Øhlø,ysondre,480,priest,shadow,6,5,1
18842,Anabølixx,ravencrest,480,priest,shadow,6,5,1
18843,Aleetheia,silvermoon,480,priest,shadow,6,5,1
18844,Makethemstop,bronzebeard,480,priest,shadow,6,5,1
18845,Darkqt,ravencrest,480,priest,shadow,6,5,1
18846,Darrianna,outland,480,priest,shadow,12,5,7
18847,Jarkk,ysondre,480,priest,shadow,12,5,7
18848,Valaç,turalyon,480,priest,shadow,12,5,7
18849,Felaenna,argent-dawn,480,priest,shadow,12,5,7
18850,Nairima,argent-dawn,480,priest,shadow,12,5,7
18851,Smâshëd,stormscale,480,priest,shadow,12,5,7
18852,Môrtïciâ,tarren-mill,480,priest,shadow,12,5,7
18853,Mentax,kazzak,480,priest,shadow,12,5,7
18854,Taikki,stormreaver,480,priest,shadow,12,5,7
18855,Lyssandre,stormreaver,480,priest,shadow,12,5,7
18856,Nanna,agamaggan,480,priest,shadow,12,5,7
18857,Shadowful,drakthul,480,priest,shadow,12,5,7
18858,Bonsoin,kirin-tor,480,priest,shadow,12,5,7
18859,Wewo,drakthul,480,priest,shadow,12,5,7
18860,Qwertyuioasd,ravencrest,480,priest,shadow,12,5,7
18861,Whocare,tarren-mill,480,priest,shadow,12,5,7
18862,Rokil,ravencrest,480,priest,shadow,12,5,7
18863,Skûggpräst,silvermoon,480,priest,shadow,12,5,7
18864,Singularity,ravencrest,480,priest,shadow,12,5,7
18865,Ryik,ravencrest,480,priest,shadow,12,5,7
18866,Seenoend,neptulon,480,priest,shadow,12,5,7
18867,Rovensin,ravencrest,480,priest,shadow,12,5,7
18868,Svenskabarn,twisting-nether,480,priest,shadow,12,5,7
18869,Korzec,dun-modr,480,priest,shadow,12,5,7
18870,Дакимакурах,gordunni,480,priest,shadow,12,5,7
18871,Cmonbro,hyjal,480,priest,shadow,12,5,7
18872,Claudefrollo,the-maelstrom,480,priest,shadow,13,5,8
18873,Lasdrael,dun-modr,479,priest,shadow,6,5,1
18874,Kíssme,archimonde,479,priest,shadow,6,5,1
18875,Pawriest,draenor,479,priest,shadow,6,5,1
18876,Вэйворс,blackscar,479,priest,shadow,10,6,4
18877,Crishroc,stormreaver,479,priest,shadow,12,5,7
18878,Heinricht,ragnaros,479,priest,shadow,12,5,7
18879,Soulsuckerr,silvermoon,479,priest,shadow,18,5,13
18880,Zák,sylvanas,478,priest,shadow,12,5,7
18881,Карбираторх,gordunni,447,priest,shadow,11,5,6
18882,Twisty,malganis,426,priest,shadow,17,9,8
18883,Grainbames,sylvanas,384,priest,shadow,6,4,2
18884,Looó,los-errantes,384,priest,shadow,6,4,2
18885,Drë,daggerspine,384,priest,shadow,6,4,2
18886,Lysium,sylvanas,384,priest,shadow,6,4,2
18887,Îzî,sanguino,384,priest,shadow,6,4,2
18888,Atropin,silvermoon,384,priest,shadow,6,4,2
18889,Шучунекошмар,soulflayer,384,priest,shadow,6,4,2
18890,Neverfade,dun-modr,384,priest,shadow,6,4,2
18891,Raëkon,nemesis,384,priest,shadow,6,4,2
18892,Diha,argent-dawn,384,priest,shadow,6,4,2
18893,Liloz,eredar,384,priest,shadow,6,4,2
18894,Фьюриреидж,soulflayer,384,priest,shadow,6,4,2
18895,Наярда,howling-fjord,384,priest,shadow,6,4,2
18896,Achára,ravencrest,384,priest,shadow,6,4,2
18897,Evílshadows,tarren-mill,384,priest,shadow,6,4,2
18898,Velence,ravencrest,384,priest,shadow,6,4,2
18899,Nebunia,twisting-nether,384,priest,shadow,6,4,2
18900,Syrïal,hyjal,384,priest,shadow,6,4,2
18901,Squîzz,archimonde,384,priest,shadow,6,4,2
18902,Êlectron,ravencrest,384,priest,shadow,6,4,2
18903,Duzurîx,burning-blade,384,priest,shadow,6,4,2
18904,Satin,twilights-hammer,384,priest,shadow,6,4,2
18905,Spae,twisting-nether,384,priest,shadow,6,4,2
18906,Tokkz,kelthuzad,384,priest,shadow,6,4,2
18907,Libstik,hyjal,384,priest,shadow,6,4,2
18908,Shadowboness,twisting-nether,384,priest,shadow,6,4,2
18909,Alicanx,twisting-nether,384,priest,shadow,6,4,2
18910,Ylenae,twisting-nether,384,priest,shadow,6,4,2
18911,Hòllymèdx,blackmoore,384,priest,shadow,6,4,2
18912,Daftî,twisting-nether,384,priest,shadow,6,4,2
18913,Alusiepriest,ravencrest,384,priest,shadow,6,4,2
18914,Cyrená,ravencrest,384,priest,shadow,6,4,2
18915,Æåeåeåé,twisting-nether,384,priest,shadow,6,4,2
18916,Vantek,antonidas,384,priest,shadow,6,4,2
18917,Claritycraft,twisting-nether,384,priest,shadow,6,4,2
18918,Majestíc,blackmoore,384,priest,shadow,6,4,2
18919,Alinfinito,ravencrest,384,priest,shadow,6,4,2
18920,Thogrey,archimonde,384,priest,shadow,6,4,2
18921,Controlled,tarren-mill,384,priest,shadow,6,4,2
18922,Jpxoxo,blackhand,384,priest,shadow,6,4,2
18923,Holineß,burning-blade,384,priest,shadow,6,4,2
18924,Peprama,stormscale,384,priest,shadow,6,4,2
18925,Torino,kazzak,384,priest,shadow,6,4,2
18926,Roastie,frostmane,384,priest,shadow,6,4,2
18927,Lumex,aegwynn,384,priest,shadow,6,4,2
18928,Temtem,ravencrest,384,priest,shadow,6,4,2
18929,Kobiden,stormreaver,384,priest,shadow,6,4,2
18930,Umayyaa,sylvanas,384,priest,shadow,6,4,2
18931,Вэстервилли,howling-fjord,384,priest,shadow,6,4,2
18932,Draryanna,nemesis,384,priest,shadow,6,4,2
18933,Ihaveibs,doomhammer,384,priest,shadow,13,5,8
18934,Strvnge,stormreaver,384,priest,shadow,11,4,7
18935,Nìak,ysondre,384,priest,shadow,15,5,10
18936,Apèx,blackrock,384,priest,shadow,12,4,8
18937,Shadøwz,grim-batol,384,priest,shadow,12,4,8
18938,Psystorm,frostmane,384,priest,shadow,12,4,8
18939,Bacovia,tarren-mill,384,priest,shadow,12,4,8
18940,Самоэль,gordunni,384,priest,shadow,12,4,8
18941,Swoptoplong,blackhand,384,priest,shadow,12,4,8
18942,Dotmaster,darkspear,384,priest,shadow,12,4,8
18943,Ларчшп,gordunni,384,priest,shadow,12,4,8
18944,Dpriesta,aegwynn,384,priest,shadow,12,4,8
18945,Lfgarcatraz,aegwynn,384,priest,shadow,12,4,8
18946,Отчепадре,gordunni,384,priest,shadow,12,4,8
18947,Gerase,blackrock,384,priest,shadow,12,4,8
18948,Grayraven,azjolnerub,384,priest,shadow,12,4,8
18949,Jellypie,blackrock,384,priest,shadow,12,4,8
18950,Szpinx,stormscale,384,priest,shadow,12,4,8
18951,Umbrazoid,sanguino,384,priest,shadow,12,4,8
18952,Fùkøff,stormscale,384,priest,shadow,12,4,8
18953,Chlorohhkine,chogall,384,priest,shadow,13,4,9
18954,Zultor,ragnaros,384,priest,shadow,13,4,9
18955,Tobirama,stormscale,384,priest,shadow,17,4,13
18956,Zerim,blackmoore,384,priest,shadow,18,4,14
18957,Brainmuscle,ravencrest,383,priest,shadow,6,4,2
18958,Shikamarudmx,burning-legion,383,priest,shadow,15,5,10
18959,Sphard,ysondre,383,priest,shadow,12,4,8
18960,Stoffig,aggramar,382,priest,shadow,6,4,2
18961,Мараес,howling-fjord,382,priest,shadow,6,4,2
18962,Намдандар,howling-fjord,382,priest,shadow,12,4,8
18963,Perchédue,silvermoon,367,priest,shadow,11,4,7
18964,Levitating,argent-dawn,336,priest,shadow,9,5,4
18965,Tweediertie,argent-dawn,335,priest,shadow,11,4,7
18966,Solaní,antonidas,335,priest,shadow,11,4,7
18967,Xaviá,blackrock,288,priest,shadow,6,3,3
18968,Notra,shattrath,288,priest,shadow,6,3,3
18969,Voideffsucks,stormscale,288,priest,shadow,6,3,3
18970,Skymning,tarren-mill,288,priest,shadow,6,3,3
18971,Barthólomew,doomhammer,288,priest,shadow,6,3,3
18972,Shadowchunks,argent-dawn,288,priest,shadow,6,3,3
18973,Dunkelseele,ahnqiraj,288,priest,shadow,6,3,3
18974,Dboi,tarren-mill,288,priest,shadow,6,3,3
18975,Presbyter,mazrigos,288,priest,shadow,6,3,3
18976,Maela,uldum,288,priest,shadow,6,3,3
18977,Allanna,talnivarr,288,priest,shadow,6,3,3
18978,Roxfer,ysondre,288,priest,shadow,6,3,3
18979,Ragwitch,draenor,288,priest,shadow,6,3,3
18980,Wkid,draenor,288,priest,shadow,6,3,3
18981,Sàyaa,draenor,288,priest,shadow,6,3,3
18982,Kallsen,ravencrest,288,priest,shadow,6,3,3
18983,Chandria,veknilash,288,priest,shadow,6,3,3
18984,Papynou,garona,288,priest,shadow,6,3,3
18985,Linara,frostmane,288,priest,shadow,6,3,3
18986,Svettvrede,sylvanas,288,priest,shadow,6,3,3
18987,Stepsisstuck,ragnaros,288,priest,shadow,6,3,3
18988,Chaarronn,drakthul,288,priest,shadow,6,3,3
18989,Vilayetko,ravencrest,288,priest,shadow,6,3,3
18990,Смегмачет,soulflayer,288,priest,shadow,6,3,3
18991,Imadîa,dalaran,288,priest,shadow,6,3,3
18992,Holybestie,eredar,288,priest,shadow,6,3,3
18993,Nukyo,blackmoore,288,priest,shadow,6,3,3
18994,Aliocha,dalaran,288,priest,shadow,6,3,3
18995,Cðsima,blackmoore,288,priest,shadow,6,3,3
18996,Liliashet,sanguino,288,priest,shadow,6,3,3
18997,Nhajÿ,hyjal,288,priest,shadow,6,3,3
18998,Fuzzydude,ravencrest,288,priest,shadow,6,3,3
18999,Лиройгеморой,gordunni,288,priest,shadow,6,3,3
19000,Arratør,ysondre,288,priest,shadow,6,3,3
19001,Abyssonmind,dun-modr,288,priest,shadow,6,3,3
19002,Sweedensp,hyjal,288,priest,shadow,6,3,3
19003,Montane,wrathbringer,288,priest,shadow,6,3,3
19004,Zøid,ysondre,288,priest,shadow,6,3,3
19005,Lethaa,twisting-nether,288,priest,shadow,6,3,3
19006,Skillmåster,ravencrest,288,priest,shadow,6,3,3
19007,Syntara,twisting-nether,288,priest,shadow,6,3,3
19008,Andreel,ravencrest,288,priest,shadow,6,3,3
19009,Ahle,darkspear,288,priest,shadow,6,3,3
19010,Stinkycreep,executus,288,priest,shadow,6,3,3
19011,Balthe,defias-brotherhood,288,priest,shadow,6,3,3
19012,Chaddius,stormscale,288,priest,shadow,6,3,3
19013,Rippeep,emerald-dream,288,priest,shadow,6,3,3
19014,Nitza,silvermoon,288,priest,shadow,6,3,3
19015,Dimorinny,silvermoon,288,priest,shadow,6,3,3
19016,Grocx,kazzak,288,priest,shadow,6,3,3
19017,Pbwser,silvermoon,288,priest,shadow,6,3,3
19018,Xpy,kazzak,288,priest,shadow,6,3,3
19019,Exörcíst,outland,288,priest,shadow,6,3,3
19020,Fnúggí,kazzak,288,priest,shadow,6,3,3
19021,Freezydot,silvermoon,288,priest,shadow,6,3,3
19022,Ggsus,outland,288,priest,shadow,6,3,3
19023,Mindboorst,kazzak,288,priest,shadow,6,3,3
19024,Anexxia,outland,288,priest,shadow,6,3,3
19025,Jlox,stormscale,288,priest,shadow,9,4,5
19026,Kopfsache,blackmoore,288,priest,shadow,7,3,4
19027,Freshpope,ravencrest,288,priest,shadow,10,4,6
19028,Damnedangel,drakthul,288,priest,shadow,12,3,9
19029,Aaluvor,blackmoore,288,priest,shadow,12,3,9
19030,Hâstur,ravencrest,288,priest,shadow,12,3,9
19031,Atelstan,drakthul,288,priest,shadow,12,3,9
19032,Cthultist,dun-modr,288,priest,shadow,12,3,9
19033,Nesar,stormscale,288,priest,shadow,12,3,9
19034,Shreedz,blackmoore,288,priest,shadow,12,3,9
19035,Elumi,the-maelstrom,288,priest,shadow,12,3,9
19036,Lapinvicieux,archimonde,288,priest,shadow,12,3,9
19037,Kaenlin,the-maelstrom,288,priest,shadow,18,3,15
19038,Васпохилить,howling-fjord,288,priest,shadow,18,3,15
19039,Mimox,kaelthas,287,priest,shadow,6,3,3
19040,Jês,thrall,287,priest,shadow,6,3,3
19041,Акциуми,howling-fjord,287,priest,shadow,6,3,3
19042,Rulna,die-aldor,287,priest,shadow,12,3,9
19043,Irrtum,nozdormu,286,priest,shadow,6,3,3
19044,Endchor,eredar,286,priest,shadow,12,3,9
19045,Czikibriki,ravenholdt,256,priest,shadow,4,4,0
19046,Guccimaane,twisting-nether,239,priest,shadow,5,3,2
19047,Deeforce,argent-dawn,234,priest,shadow,6,4,2
19048,Shadowflamè,outland,192,priest,shadow,4,3,1
19049,Szycho,burning-legion,192,priest,shadow,9,3,6
19050,Безмездная,gordunni,192,priest,shadow,6,2,4
19051,Ичисанчик,howling-fjord,192,priest,shadow,6,2,4
19052,Tuljan,twisting-nether,192,priest,shadow,6,2,4
19053,Vregoa,twisting-nether,192,priest,shadow,6,2,4
19054,Сорвиголов,howling-fjord,192,priest,shadow,6,2,4
19055,Zikár,kazzak,192,priest,shadow,6,2,4
19056,Дашажмитучу,howling-fjord,192,priest,shadow,6,2,4
19057,Низара,deathguard,192,priest,shadow,6,2,4
19058,Xîneâ,outland,192,priest,shadow,6,2,4
19059,Otheym,the-maelstrom,192,priest,shadow,6,2,4
19060,Sotriggered,sylvanas,192,priest,shadow,6,2,4
19061,Tankeløs,kazzak,192,priest,shadow,6,2,4
19062,Lugburzz,draenor,192,priest,shadow,6,2,4
19063,Мсикатана,gordunni,192,priest,shadow,6,2,4
19064,Triinkett,doomhammer,192,priest,shadow,6,2,4
19065,Calïxløve,der-rat-von-dalaran,192,priest,shadow,6,2,4
19066,Шарадин,gordunni,192,priest,shadow,6,2,4
19067,Xiä,archimonde,192,priest,shadow,6,2,4
19068,Rallzken,stormscale,192,priest,shadow,6,2,4
19069,Xaeroow,archimonde,192,priest,shadow,6,2,4
19070,Omejan,frostmane,192,priest,shadow,6,2,4
19071,Crazyname,outland,192,priest,shadow,6,2,4
19072,Clemexyo,stormscale,192,priest,shadow,6,2,4
19073,Slimshadey,malganis,192,priest,shadow,6,2,4
19074,Nomarak,drakthul,192,priest,shadow,6,2,4
19075,Misántropo,dun-modr,192,priest,shadow,6,2,4
19076,Vittelk,stormscale,192,priest,shadow,6,2,4
19077,Hadsup,stormscale,192,priest,shadow,6,2,4
19078,Arunp,magtheridon,192,priest,shadow,6,2,4
19079,Happychap,stormreaver,192,priest,shadow,6,2,4
19080,Preast,aegwynn,192,priest,shadow,6,2,4
19081,Nyróx,malganis,192,priest,shadow,6,2,4
19082,Kidkuddo,blackmoore,192,priest,shadow,6,2,4
19083,Bòóny,ravencrest,192,priest,shadow,6,2,4
19084,Vengigodxx,ravencrest,192,priest,shadow,6,2,4
19085,Cto,gorgonnash,192,priest,shadow,6,2,4
19086,Crzzy,dun-modr,192,priest,shadow,6,2,4
19087,Kaleshiry,kazzak,192,priest,shadow,6,2,4
19088,Notdespo,kazzak,192,priest,shadow,6,2,4
19089,Aruna,ravencrest,192,priest,shadow,6,2,4
19090,Alpharîus,argent-dawn,192,priest,shadow,6,2,4
19091,Ràthaløs,sanguino,192,priest,shadow,6,2,4
19092,Elëctra,vashj,192,priest,shadow,6,2,4
19093,Bandgap,antonidas,192,priest,shadow,6,2,4
19094,Oknelim,blackmoore,192,priest,shadow,6,2,4
19095,Daven,ysondre,192,priest,shadow,6,2,4
19096,Lythra,burning-legion,192,priest,shadow,6,2,4
19097,Phobò,blackrock,192,priest,shadow,6,2,4
19098,Wiglere,argent-dawn,192,priest,shadow,6,2,4
19099,Harleyquiñ,burning-legion,192,priest,shadow,6,2,4
19100,Velansera,argent-dawn,192,priest,shadow,6,2,4
19101,Önnÿ,dun-modr,192,priest,shadow,12,2,10
19102,Karmapollys,silvermoon,191,priest,shadow,6,2,4
19103,Girlidlion,twisting-nether,159,priest,shadow,5,2,3
19104,Shidoya,tarren-mill,159,priest,shadow,5,2,3
19105,Edoran,ragnaros,159,priest,shadow,5,2,3
19106,Qku,ravencrest,144,priest,shadow,9,3,6
19107,Alswynn,draenor,138,priest,shadow,13,3,10
19108,Inferius,shadowsong,138,priest,shadow,16,3,13
19109,Yologrumples,tarren-mill,128,priest,shadow,4,2,2
19110,Leckpriest,sanguino,128,priest,shadow,4,2,2
19111,Atheniss,drakthul,96,priest,shadow,6,1,5
19112,Мегаствол,howling-fjord,96,priest,shadow,6,1,5
19113,Jakepriest,twisting-nether,96,priest,shadow,6,1,5
19114,Uwucatgir,silvermoon,96,priest,shadow,6,1,5
19115,Zukatana,tarren-mill,96,priest,shadow,6,1,5
19116,Kristiflicka,kazzak,96,priest,shadow,6,1,5
19117,Абсорбиболь,howling-fjord,96,priest,shadow,6,1,5
19118,Enduring,darksorrow,96,priest,shadow,6,1,5
19119,Maddøc,die-aldor,96,priest,shadow,6,1,5
19120,Winstõn,sanguino,96,priest,shadow,6,1,5
19121,Vès,stormscale,96,priest,shadow,6,1,5
19122,Meatyshaft,doomhammer,96,priest,shadow,6,1,5
19123,Nerfnerf,kazzak,96,priest,shadow,6,1,5
19124,Baltrom,ravencrest,96,priest,shadow,6,1,5
19125,Kianprie,silvermoon,96,priest,shadow,6,1,5
19126,Tryagain,ravencrest,96,priest,shadow,6,1,5
19127,Abudhabi,blackhand,96,priest,shadow,6,1,5
19128,Vtqt,outland,96,priest,shadow,6,1,5
19129,Shifune,blackhand,96,priest,shadow,6,1,5
19130,Skitcy,ghostlands,96,priest,shadow,6,1,5
19131,Koíré,defias-brotherhood,96,priest,shadow,6,1,5
19132,Gobie,sunstrider,96,priest,shadow,6,1,5
19133,Príêstjklòl,stormscale,96,priest,shadow,6,1,5
19134,Rines,thrall,96,priest,shadow,6,1,5
19135,Stola,archimonde,96,priest,shadow,6,1,5
19136,Mynithir,chants-éternels,96,priest,shadow,6,1,5
19137,Nûtqt,archimonde,96,priest,shadow,6,1,5
19138,Deicidex,blackrock,96,priest,shadow,6,1,5
19139,Oniakusa,outland,96,priest,shadow,6,1,5
19140,Tiras,argent-dawn,96,priest,shadow,12,1,11
19141,Yonaka,amanthul,96,priest,shadow,12,1,11
19142,Эсттелла,gordunni,96,priest,shadow,18,1,17
19143,Gandals,shadowsong,64,priest,shadow,4,1,3
19144,Xharyo,ravencrest,64,priest,shadow,4,1,3
19145,Achesita,sylvanas,48,priest,shadow,3,1,2
19146,Rãz,stormscale,2130,rogue,outlaw,66,36,30
19147,Kekuriix,vashj,1877,rogue,outlaw,112,60,52
19148,Макевин,gordunni,1750,rogue,outlaw,52,24,28
19149,Феинт,galakrond,1739,rogue,outlaw,48,19,29
19150,Yessa,argent-dawn,1721,rogue,outlaw,36,18,18
19151,Koopa,argent-dawn,1696,rogue,outlaw,48,24,24
19152,Дизелюжн,howling-fjord,1673,rogue,outlaw,99,45,54
19153,Jalsket,tarren-mill,1666,rogue,outlaw,36,20,16
19154,Radiogodx,stormscale,1649,rogue,outlaw,60,27,33
19155,Syrn,ravencrest,1579,rogue,outlaw,54,25,29
19156,Kreay,tarren-mill,1576,rogue,outlaw,40,29,11
19157,Bonelesschic,silvermoon,1510,rogue,outlaw,107,60,47
19158,Deevoll,tarren-mill,1481,rogue,outlaw,102,45,57
19159,Sigleif,argent-dawn,1468,rogue,outlaw,66,33,33
19160,Loubina,silvermoon,1446,rogue,outlaw,36,16,20
19161,Зувер,blackscar,1443,rogue,outlaw,94,49,45
19162,Kreayx,ysondre,1438,rogue,outlaw,30,15,15
19163,Lidiaubaro,ravencrest,1438,rogue,outlaw,179,83,96
19164,Nèwt,aggramar,1419,rogue,outlaw,84,40,44
19165,Scotlander,argent-dawn,1401,rogue,outlaw,30,15,15
19166,Cryneth,ravencrest,1373,rogue,outlaw,51,25,26
19167,Jasolo,silvermoon,1370,rogue,outlaw,204,117,87
19168,Kreay,ysondre,1343,rogue,outlaw,30,14,16
19169,Shredfngrz,garona,1337,rogue,outlaw,32,15,17
19170,Murkyy,gilneas,1329,rogue,outlaw,32,16,16
19171,Djeud,archimonde,1293,rogue,outlaw,52,27,25
19172,Tidløs,dun-morogh,1270,rogue,outlaw,41,15,26
19173,Carvyn,defias-brotherhood,1255,rogue,outlaw,33,15,18
19174,Шторкаа,gordunni,1214,rogue,outlaw,33,19,14
19175,Jinzou,blackmoore,1153,rogue,outlaw,39,19,20
19176,Spiochrr,burning-legion,1064,rogue,outlaw,44,17,27
19177,Lättja,hyjal,1059,rogue,outlaw,24,12,12
19178,Déjávu,ravencrest,1054,rogue,outlaw,24,11,13
19179,Svddendeath,ragnaros,1034,rogue,outlaw,24,11,13
19180,Génn,silvermoon,1009,rogue,outlaw,38,17,21
19181,Melahl,kazzak,909,rogue,outlaw,18,11,7
19182,Bxtchslayer,blackmoore,876,rogue,outlaw,18,10,8
19183,Bannedfrigid,outland,864,rogue,outlaw,24,9,15
19184,Ранконх,lich-king,863,rogue,outlaw,30,9,21
19185,Bikrut,hyjal,768,rogue,outlaw,12,8,4
19186,Lïke,frostwolf,768,rogue,outlaw,12,8,4
19187,Gerzy,drakthul,768,rogue,outlaw,18,8,10
19188,Джулт,soulflayer,767,rogue,outlaw,24,8,16
19189,Blàckbèàrd,silvermoon,753,rogue,outlaw,36,13,23
19190,Kidneyou,ragnaros,672,rogue,outlaw,18,7,11
19191,Rogiko,twisting-nether,672,rogue,outlaw,18,7,11
19192,Omgjkgtfo,ravencrest,671,rogue,outlaw,18,7,11
19193,Åråmsëß,grim-batol,670,rogue,outlaw,12,7,5
19194,Shichi,archimonde,655,rogue,outlaw,17,7,10
19195,Pistolpete,grim-batol,576,rogue,outlaw,12,6,6
19196,Vokhun,outland,576,rogue,outlaw,12,6,6
19197,Pidroseus,argent-dawn,575,rogue,outlaw,12,6,6
19198,Badabôôm,wrathbringer,575,rogue,outlaw,12,6,6
19199,Noodlegoose,tarren-mill,575,rogue,outlaw,12,6,6
19200,Anom,kargath,575,rogue,outlaw,12,6,6
19201,Кингксу,gordunni,575,rogue,outlaw,24,6,18
19202,Okani,hyjal,574,rogue,outlaw,12,6,6
19203,Тимареканец,eversong,572,rogue,outlaw,18,6,12
19204,Omuspan,magtheridon,558,rogue,outlaw,18,6,12
19205,Zômbiê,blackrock,491,rogue,outlaw,13,6,7
19206,Eukaryot,aggra-português,480,rogue,outlaw,6,5,1
19207,Featfawkes,ragnaros,480,rogue,outlaw,12,5,7
19208,Fivepoint,blackmoore,480,rogue,outlaw,12,5,7
19209,Faoil,defias-brotherhood,480,rogue,outlaw,12,5,7
19210,Krixor,ravencrest,480,rogue,outlaw,18,5,13
19211,Nocrath,blades-edge,479,rogue,outlaw,12,5,7
19212,Chillo,ravencrest,384,rogue,outlaw,6,4,2
19213,Delrøq,draenor,384,rogue,outlaw,6,4,2
19214,Zep,auchindoun,384,rogue,outlaw,6,4,2
19215,Synexo,sylvanas,384,rogue,outlaw,12,4,8
19216,Trímønâ,gorgonnash,351,rogue,outlaw,11,4,7
19217,Masteez,ahnqiraj,318,rogue,outlaw,5,4,1
19218,Cigarette,emeriss,288,rogue,outlaw,6,3,3
19219,Shadxwstep,ravencrest,288,rogue,outlaw,6,3,3
19220,Играючестно,howling-fjord,288,rogue,outlaw,6,3,3
19221,Zyreanxy,blackrock,288,rogue,outlaw,6,3,3
19222,Onlyluvhurt,dun-modr,288,rogue,outlaw,6,3,3
19223,Finisher,sanguino,288,rogue,outlaw,12,3,9
19224,Szpachela,burning-legion,288,rogue,outlaw,12,3,9
19225,Heulleise,die-ewige-wacht,288,rogue,outlaw,12,3,9
19226,Mcgora,doomhammer,286,rogue,outlaw,6,3,3
19227,Tipok,tarren-mill,286,rogue,outlaw,12,3,9
19228,Rivso,auchindoun,255,rogue,outlaw,14,4,10
19229,Soothinqq,emerald-dream,238,rogue,outlaw,5,3,2
19230,Banaulikode,twisting-nether,192,rogue,outlaw,6,2,4
19231,Mawrat,mazrigos,192,rogue,outlaw,6,2,4
19232,Zind,dalaran,192,rogue,outlaw,6,2,4
19233,Оргельна,gordunni,192,rogue,outlaw,6,2,4
19234,Sneakysteve,bloodfeather,192,rogue,outlaw,6,2,4
19235,Nyxal,argent-dawn,192,rogue,outlaw,6,2,4
19236,Alvoriace,hyjal,192,rogue,outlaw,12,2,10
19237,Hânnäh,hyjal,191,rogue,outlaw,6,2,4
19238,Matchfixer,moonglade,138,rogue,outlaw,10,3,7
19239,Ñøway,archimonde,96,rogue,outlaw,3,2,1
19240,Dredge,kaelthas,96,rogue,outlaw,6,1,5
19241,Vaze,ravencrest,96,rogue,outlaw,6,1,5
19242,Ótsutsukí,kazzak,96,rogue,outlaw,6,1,5
19243,Yüm,burning-blade,96,rogue,outlaw,6,1,5
19244,Sty,aerie-peak,96,rogue,outlaw,6,1,5
19245,Mallaurya,dalaran,96,rogue,outlaw,6,1,5
19246,Ciaordel,sylvanas,96,rogue,outlaw,6,1,5
19247,Nabatean,magtheridon,48,rogue,outlaw,3,1,2
19248,Фофламидзе,gordunni,47,rogue,outlaw,3,1,2
19249,Getbleeded,stormscale,31,rogue,outlaw,2,1,1
19250,Cazzette,ravencrest,2204,rogue,subtlety,81,48,33
19251,Лолелт,borean-tundra,2131,rogue,subtlety,104,53,51
19252,Denjinx,culte-de-la-rive-noire,2107,rogue,subtlety,78,43,35
19253,Pridå,thrall,2107,rogue,subtlety,78,41,37
19254,Sunø,archimonde,2063,rogue,subtlety,106,51,55
19255,Смертьвсмоке,gordunni,1989,rogue,subtlety,122,61,61
19256,Lfgenjoyer,tarren-mill,1980,rogue,subtlety,78,48,30
19257,Nàsklolz,hyjal,1971,rogue,subtlety,60,31,29
19258,Renhri,burning-legion,1968,rogue,subtlety,220,122,98
19259,Флексити,soulflayer,1939,rogue,subtlety,114,59,55
19260,Chatdisabled,drakthul,1913,rogue,subtlety,102,53,49
19261,Asterisyup,silvermoon,1909,rogue,subtlety,89,55,34
19262,Zuqzwang,outland,1901,rogue,subtlety,54,30,24
19263,Clawdíte,blackrock,1895,rogue,subtlety,48,21,27
19264,Makethemrog,archimonde,1887,rogue,subtlety,68,34,34
19265,Пожилойпупь,gordunni,1869,rogue,subtlety,36,20,16
19266,Sapécomejaja,archimonde,1866,rogue,subtlety,38,24,14
19267,Asumah,ravencrest,1863,rogue,subtlety,36,22,14
19268,Brensø,nemesis,1857,rogue,subtlety,99,60,39
19269,Âkame,argent-dawn,1853,rogue,subtlety,59,32,27
19270,Shadezlöl,ravencrest,1838,rogue,subtlety,130,65,65
19271,Illmatíc,ravencrest,1828,rogue,subtlety,56,29,27
19272,Тохуо,lich-king,1822,rogue,subtlety,42,20,22
19273,Radiogodx,stormscale,1817,rogue,subtlety,60,31,29
19274,Iqws,ravencrest,1811,rogue,subtlety,54,29,25
19275,Lilaven,turalyon,1810,rogue,subtlety,78,40,38
19276,Troxerboxer,tarren-mill,1806,rogue,subtlety,42,22,20
19277,Xtoyo,zuljin,1804,rogue,subtlety,54,29,25
19278,Chatbann,blackrock,1802,rogue,subtlety,112,63,49
19279,Røgger,ragnaros,1798,rogue,subtlety,107,52,55
19280,Sly,emerald-dream,1788,rogue,subtlety,42,24,18
19281,Insomnla,silvermoon,1786,rogue,subtlety,96,52,44
19282,Malasap,archimonde,1770,rogue,subtlety,140,77,63
19283,Naïmitsu,hyjal,1762,rogue,subtlety,60,34,26
19284,Aythusha,twisting-nether,1759,rogue,subtlety,36,20,16
19285,Эмилилавс,galakrond,1759,rogue,subtlety,136,75,61
19286,Vulkos,lightbringer,1758,rogue,subtlety,42,20,22
19287,Stonyhavana,ravencrest,1757,rogue,subtlety,60,36,24
19288,Stråwberrý,archimonde,1753,rogue,subtlety,57,28,29
19289,Tracersxrude,ravencrest,1750,rogue,subtlety,48,20,28
19290,Погибайдуде,gordunni,1749,rogue,subtlety,35,28,7
19291,Lówskill,outland,1746,rogue,subtlety,66,32,34
19292,Инфера,lich-king,1741,rogue,subtlety,72,33,39
19293,Îlîlîlîlîlî,azuremyst,1736,rogue,subtlety,104,58,46
19294,Shadowprank,ravencrest,1731,rogue,subtlety,48,27,21
19295,Ccedox,stormscale,1729,rogue,subtlety,30,20,10
19296,Китей,howling-fjord,1723,rogue,subtlety,78,40,38
19297,Trîçk,aegwynn,1719,rogue,subtlety,36,23,13
19298,Sábros,ravencrest,1714,rogue,subtlety,108,50,58
19299,Guççí,blackrock,1700,rogue,subtlety,35,23,12
19300,Yumiee,arygos,1697,rogue,subtlety,80,44,36
19301,Сильфитт,gordunni,1696,rogue,subtlety,52,28,24
19302,Лайнэл,deathweaver,1694,rogue,subtlety,30,19,11
19303,Бладстейн,blackscar,1684,rogue,subtlety,64,37,27
19304,Роземсти,gordunni,1678,rogue,subtlety,98,50,48
19305,Иждолк,gordunni,1674,rogue,subtlety,36,18,18
19306,Rhayesh,silvermoon,1665,rogue,subtlety,100,47,53
19307,Ccedolol,stormscale,1662,rogue,subtlety,59,32,27
19308,Handuil,blackmoore,1652,rogue,subtlety,84,47,37
19309,Subsònik,tarren-mill,1645,rogue,subtlety,52,31,21
19310,Getschwîfty,ravencrest,1639,rogue,subtlety,27,18,9
19311,Namelless,twisting-nether,1637,rogue,subtlety,60,29,31
19312,Bleakhøuse,ravencrest,1635,rogue,subtlety,40,20,20
19313,Dancex,kazzak,1634,rogue,subtlety,42,28,14
19314,Liarø,archimonde,1633,rogue,subtlety,42,24,18
19315,Lânnïster,kazzak,1626,rogue,subtlety,42,20,22
19316,Путьказаха,gordunni,1625,rogue,subtlety,30,18,12
19317,Ishízu,exodar,1625,rogue,subtlety,54,24,30
19318,Keophz,tarren-mill,1623,rogue,subtlety,54,41,13
19319,Asm,the-maelstrom,1622,rogue,subtlety,40,20,20
19320,Sariena,sylvanas,1621,rogue,subtlety,60,29,31
19321,Tinylol,dun-morogh,1620,rogue,subtlety,48,29,19
19322,Mâêl,blackmoore,1620,rogue,subtlety,107,54,53
19323,Baldoh,kazzak,1614,rogue,subtlety,30,22,8
19324,Tanssy,ragnaros,1610,rogue,subtlety,50,28,22
19325,Ratirl,kult-der-verdammten,1603,rogue,subtlety,30,19,11
19326,Ipresskidney,tarren-mill,1601,rogue,subtlety,99,58,41
19327,Кишмякх,howling-fjord,1599,rogue,subtlety,72,24,48
19328,Vensq,drakthul,1596,rogue,subtlety,36,19,17
19329,Säxnthecrity,blackmoore,1595,rogue,subtlety,128,65,63
19330,Txm,argent-dawn,1590,rogue,subtlety,36,18,18
19331,Морзо,howling-fjord,1582,rogue,subtlety,66,39,27
19332,Oxyrog,ravencrest,1580,rogue,subtlety,42,22,20
19333,Брайнз,gordunni,1575,rogue,subtlety,30,23,7
19334,Shyy,dun-modr,1568,rogue,subtlety,42,20,22
19335,Evivalarte,burning-legion,1542,rogue,subtlety,36,20,16
19336,Xzr,stormscale,1539,rogue,subtlety,24,17,7
19337,Kidknee,outland,1537,rogue,subtlety,30,17,13
19338,Zzemzza,kazzak,1533,rogue,subtlety,29,17,12
19339,Sinist,twisting-nether,1531,rogue,subtlety,50,23,27
19340,Sniiky,kazzak,1530,rogue,subtlety,66,39,27
19341,Zilemjr,stormscale,1522,rogue,subtlety,30,19,11
19342,Rogueas,stormscale,1521,rogue,subtlety,41,25,16
19343,Trapstar,stormscale,1520,rogue,subtlety,48,23,25
19344,Абисиан,soulflayer,1519,rogue,subtlety,72,40,32
19345,Ninjaassasin,aegwynn,1515,rogue,subtlety,58,32,26
19346,Exanimu,ravencrest,1515,rogue,subtlety,120,51,69
19347,Skýfire,ravencrest,1512,rogue,subtlety,42,19,23
19348,Calestrian,tarren-mill,1512,rogue,subtlety,36,16,20
19349,Chimp,darksorrow,1505,rogue,subtlety,35,21,14
19350,Ramses,onyxia,1505,rogue,subtlety,42,18,24
19351,Cøntrøl,stormreaver,1503,rogue,subtlety,84,45,39
19352,Azirios,kazzak,1503,rogue,subtlety,30,16,14
19353,Ванэйти,gordunni,1502,rogue,subtlety,223,117,106
19354,Shaeni,silvermoon,1501,rogue,subtlety,54,30,24
19355,Elfreyja,archimonde,1501,rogue,subtlety,51,27,24
19356,Meccura,silvermoon,1484,rogue,subtlety,39,22,17
19357,Tonaxstab,ragnaros,1484,rogue,subtlety,36,19,17
19358,Ibizå,ravencrest,1477,rogue,subtlety,36,18,18
19359,Grifika,outland,1476,rogue,subtlety,41,24,17
19360,Sashikorosu,archimonde,1471,rogue,subtlety,45,30,15
19361,Yourexwifey,ravencrest,1470,rogue,subtlety,65,37,28
19362,Aszaryn,magtheridon,1467,rogue,subtlety,42,21,21
19363,Шпилля,gordunni,1459,rogue,subtlety,71,34,37
19364,Voki,dalaran,1458,rogue,subtlety,69,37,32
19365,Шадовкилер,blackscar,1458,rogue,subtlety,66,34,32
19366,Johnnyprep,ravencrest,1454,rogue,subtlety,54,29,25
19367,Kire,daggerspine,1452,rogue,subtlety,35,17,18
19368,Nightq,tarren-mill,1450,rogue,subtlety,57,34,23
19369,Lilrookie,argent-dawn,1447,rogue,subtlety,74,46,28
19370,Zømbië,kazzak,1445,rogue,subtlety,54,19,35
19371,Susquehanna,ragnaros,1443,rogue,subtlety,36,16,20
19372,Inyria,outland,1438,rogue,subtlety,118,61,57
19373,Dêlaral,blackhand,1437,rogue,subtlety,30,15,15
19374,Jáyjay,antonidas,1437,rogue,subtlety,54,23,31
19375,Ruck,madmortem,1434,rogue,subtlety,30,18,12
19376,Morgan,argent-dawn,1431,rogue,subtlety,60,35,25
19377,Starfighter,pozzo-delleternità,1431,rogue,subtlety,36,16,20
19378,Зенофар,soulflayer,1431,rogue,subtlety,53,23,30
19379,Absol,hellscream,1430,rogue,subtlety,36,22,14
19380,Críppléz,ravencrest,1429,rogue,subtlety,30,16,14
19381,Deathcvlt,hyjal,1428,rogue,subtlety,72,35,37
19382,Cheapshôt,archimonde,1427,rogue,subtlety,81,43,38
19383,Magepèt,tarren-mill,1426,rogue,subtlety,30,15,15
19384,Дернирог,howling-fjord,1418,rogue,subtlety,30,17,13
19385,Onlyluvhurt,dun-modr,1418,rogue,subtlety,76,40,36
19386,Grzech,burning-legion,1408,rogue,subtlety,60,28,32
19387,Memphismp,drakthul,1404,rogue,subtlety,29,15,14
19388,Svddendeath,ragnaros,1401,rogue,subtlety,42,21,21
19389,Sumsarx,ravencrest,1400,rogue,subtlety,77,38,39
19390,Эдкенуэй,gordunni,1395,rogue,subtlety,59,33,26
19391,Xblackhole,tarren-mill,1395,rogue,subtlety,47,23,24
19392,Daggerdashx,ravencrest,1394,rogue,subtlety,108,67,41
19393,Gankbang,frostmane,1393,rogue,subtlety,66,30,36
19394,Teba,cthun,1391,rogue,subtlety,28,16,12
19395,Ñavy,archimonde,1391,rogue,subtlety,66,29,37
19396,Эренх,gordunni,1382,rogue,subtlety,74,37,37
19397,Wraithh,minahonda,1380,rogue,subtlety,36,21,15
19398,Billybang,outland,1372,rogue,subtlety,65,36,29
19399,Tripx,ravencrest,1370,rogue,subtlety,85,47,38
19400,Appatras,tarren-mill,1369,rogue,subtlety,23,15,8
19401,Zx,frostmane,1368,rogue,subtlety,30,15,15
19402,Зорго,deathguard,1366,rogue,subtlety,30,15,15
19403,Loopermann,silvermoon,1366,rogue,subtlety,34,16,18
19404,Tripleníne,silvermoon,1363,rogue,subtlety,47,24,23
19405,Жабоклик,gordunni,1363,rogue,subtlety,56,27,29
19406,Spr,malfurion,1362,rogue,subtlety,64,35,29
19407,Huej,tarren-mill,1353,rogue,subtlety,48,32,16
19408,Gamezcorex,aegwynn,1353,rogue,subtlety,52,22,30
19409,Trimøná,gorgonnash,1351,rogue,subtlety,24,15,9
19410,Dàwn,boulderfist,1349,rogue,subtlety,46,25,21
19411,Dölf,archimonde,1343,rogue,subtlety,47,26,21
19412,Smøkyyx,eredar,1342,rogue,subtlety,30,14,16
19413,Лолелт,howling-fjord,1341,rogue,subtlety,24,14,10
19414,Lechatbotté,tarren-mill,1339,rogue,subtlety,24,16,8
19415,Achterom,tarren-mill,1338,rogue,subtlety,68,26,42
19416,Knutten,wildhammer,1334,rogue,subtlety,24,14,10
19417,Nexieane,ravencrest,1324,rogue,subtlety,72,39,33
19418,Bleeds,thrall,1324,rogue,subtlety,47,24,23
19419,Солевыегубки,gordunni,1322,rogue,subtlety,24,14,10
19420,Рестинписер,soulflayer,1322,rogue,subtlety,72,38,34
19421,Сабик,howling-fjord,1318,rogue,subtlety,18,14,4
19422,Leepz,outland,1314,rogue,subtlety,30,17,13
19423,Mxx,stormscale,1300,rogue,subtlety,81,45,36
19424,Luckeri,antonidas,1300,rogue,subtlety,66,32,34
19425,Ewynarog,silvermoon,1295,rogue,subtlety,23,14,9
19426,Ракфорн,howling-fjord,1289,rogue,subtlety,48,21,27
19427,Бэтх,soulflayer,1286,rogue,subtlety,30,17,13
19428,Tyrly,ravencrest,1283,rogue,subtlety,34,16,18
19429,Прошмандэ,gordunni,1282,rogue,subtlety,30,15,15
19430,Sénsorium,draenor,1279,rogue,subtlety,71,34,37
19431,Winwin,silvermoon,1278,rogue,subtlety,61,40,21
19432,Xeggy,turalyon,1278,rogue,subtlety,70,43,27
19433,Althieves,ravencrest,1272,rogue,subtlety,41,22,19
19434,Guiltythief,stormscale,1272,rogue,subtlety,37,18,19
19435,Старллесс,gordunni,1270,rogue,subtlety,89,44,45
19436,Azovrouge,terokkar,1266,rogue,subtlety,60,31,29
19437,Шикорро,soulflayer,1265,rogue,subtlety,30,15,15
19438,Kïdney,stormscale,1264,rogue,subtlety,42,24,18
19439,Zanaken,stormscale,1263,rogue,subtlety,48,24,24
19440,Subzy,burning-legion,1260,rogue,subtlety,54,30,24
19441,Calpic,sanguino,1259,rogue,subtlety,36,17,19
19442,Usainßreak,chogall,1258,rogue,subtlety,24,14,10
19443,Callboy,turalyon,1256,rogue,subtlety,42,20,22
19444,Zourkan,archimonde,1250,rogue,subtlety,65,36,29
19445,Swâggerino,kazzak,1250,rogue,subtlety,44,22,22
19446,Denjastwo,archimonde,1248,rogue,subtlety,18,13,5
19447,Shoxy,ravencrest,1248,rogue,subtlety,27,14,13
19448,Sunå,archimonde,1247,rogue,subtlety,24,13,11
19449,Grindz,ravencrest,1247,rogue,subtlety,96,47,49
19450,Binbág,draenor,1245,rogue,subtlety,36,22,14
19451,Тучёна,soulflayer,1243,rogue,subtlety,42,25,17
19452,Pfourtwenty,eredar,1243,rogue,subtlety,24,13,11
19453,Levíeus,blackrock,1241,rogue,subtlety,48,29,19
19454,Wøølfgang,archimonde,1240,rogue,subtlety,54,25,29
19455,Mishøna,kazzak,1239,rogue,subtlety,72,40,32
19456,Norlix,ravencrest,1239,rogue,subtlety,24,13,11
19457,Ÿøßø,archimonde,1238,rogue,subtlety,24,13,11
19458,Ézzah,blackhand,1236,rogue,subtlety,69,27,42
19459,Jugalos,ravencrest,1230,rogue,subtlety,35,13,22
19460,Yakio,silvermoon,1229,rogue,subtlety,30,13,17
19461,Чайрлайн,blackscar,1227,rogue,subtlety,34,16,18
19462,Adwl,archimonde,1226,rogue,subtlety,45,20,25
19463,Monoxid,eredar,1222,rogue,subtlety,30,14,16
19464,Ксионас,gordunni,1212,rogue,subtlety,82,36,46
19465,Lotorr,burning-legion,1209,rogue,subtlety,23,13,10
19466,Sicariø,argent-dawn,1209,rogue,subtlety,36,15,21
19467,Architeggt,eredar,1209,rogue,subtlety,38,14,24
19468,Gansull,nemesis,1207,rogue,subtlety,30,13,17
19469,Коффемолка,ashenvale,1204,rogue,subtlety,48,19,29
19470,Ganker,antonidas,1202,rogue,subtlety,30,15,15
19471,Сладкийперец,borean-tundra,1202,rogue,subtlety,46,22,24
19472,Avøry,antonidas,1201,rogue,subtlety,30,13,17
19473,Skillissuex,tarren-mill,1200,rogue,subtlety,54,31,23
19474,Hashlund,stormscale,1181,rogue,subtlety,38,17,21
19475,Cesârion,antonidas,1180,rogue,subtlety,69,26,43
19476,Ryzem,archimonde,1178,rogue,subtlety,90,49,41
19477,Knoffchad,blackhand,1174,rogue,subtlety,32,13,19
19478,Счастливое,howling-fjord,1170,rogue,subtlety,26,13,13
19479,Arrzhan,silvermoon,1167,rogue,subtlety,18,14,4
19480,Darkan,kaelthas,1159,rogue,subtlety,48,29,19
19481,Howton,archimonde,1152,rogue,subtlety,18,12,6
19482,Тира,grom,1151,rogue,subtlety,24,12,12
19483,Salakelmi,sylvanas,1149,rogue,subtlety,18,12,6
19484,Darksilencee,blackmoore,1146,rogue,subtlety,24,12,12
19485,Kickcake,ravencrest,1144,rogue,subtlety,30,12,18
19486,Хавиа,gordunni,1143,rogue,subtlety,24,12,12
19487,Jaydeeñ,ravencrest,1142,rogue,subtlety,30,12,18
19488,Sâybyëbæ,dun-modr,1142,rogue,subtlety,30,12,18
19489,Veryscaryguý,twisting-nether,1140,rogue,subtlety,18,12,6
19490,ßøß,ysondre,1135,rogue,subtlety,44,21,23
19491,Stuxothug,silvermoon,1126,rogue,subtlety,43,25,18
19492,Thehand,eonar,1126,rogue,subtlety,42,24,18
19493,Ултра,gordunni,1123,rogue,subtlety,69,30,39
19494,Faelylanea,argent-dawn,1122,rogue,subtlety,36,16,20
19495,Попочке,soulflayer,1116,rogue,subtlety,18,13,5
19496,Coronababy,argent-dawn,1111,rogue,subtlety,24,13,11
19497,Unreallx,silvermoon,1102,rogue,subtlety,80,36,44
19498,Stâr,archimonde,1077,rogue,subtlety,28,13,15
19499,Löka,amanthul,1071,rogue,subtlety,117,59,58
19500,Псиихооз,eversong,1070,rogue,subtlety,25,13,12
19501,Stin,blackrock,1069,rogue,subtlety,64,19,45
19502,Daekrun,argent-dawn,1068,rogue,subtlety,26,12,14
19503,Скорпеон,deathguard,1059,rogue,subtlety,24,17,7
19504,Çhimaev,ravencrest,1056,rogue,subtlety,16,12,4
19505,Djswaghetti,stormscale,1056,rogue,subtlety,18,11,7
19506,Флеймсфорт,gordunni,1055,rogue,subtlety,35,16,19
19507,Kleptomancy,sylvanas,1054,rogue,subtlety,18,11,7
19508,Exiv,ragnaros,1053,rogue,subtlety,30,11,19
19509,Blantek,defias-brotherhood,1048,rogue,subtlety,24,13,11
19510,Пораменяться,gordunni,1048,rogue,subtlety,24,11,13
19511,Maam,ravencrest,1046,rogue,subtlety,18,11,7
19512,Cuckboy,chogall,1042,rogue,subtlety,37,24,13
19513,Behindü,frostmane,1042,rogue,subtlety,24,11,13
19514,Ithru,twisting-nether,1035,rogue,subtlety,102,51,51
19515,Drakaess,archimonde,1032,rogue,subtlety,24,11,13
19516,Зебол,howling-fjord,1024,rogue,subtlety,36,17,19
19517,Yamoshí,sanguino,1024,rogue,subtlety,34,15,19
19518,Mercìles,kazzak,1009,rogue,subtlety,37,22,15
19519,Сабанутый,howling-fjord,1002,rogue,subtlety,72,38,34
19520,Nirvána,outland,991,rogue,subtlety,47,21,26
19521,Thicck,twisting-nether,980,rogue,subtlety,48,13,35
19522,Yüm,burning-blade,979,rogue,subtlety,39,13,26
19523,Niinim,draenor,971,rogue,subtlety,81,42,39
19524,Mannheim,kazzak,968,rogue,subtlety,42,23,19
19525,Pochîta,blackrock,964,rogue,subtlety,35,13,22
19526,Нойсеен,gordunni,960,rogue,subtlety,18,10,8
19527,Naláa,ravencrest,960,rogue,subtlety,18,10,8
19528,Sákiqt,ravencrest,960,rogue,subtlety,18,10,8
19529,Noboorstsub,ravencrest,959,rogue,subtlety,12,10,2
19530,Meldee,burning-legion,958,rogue,subtlety,18,10,8
19531,Fugly,ragnaros,955,rogue,subtlety,26,10,16
19532,Rêve,the-maelstrom,954,rogue,subtlety,18,10,8
19533,Воруюнарынке,gordunni,953,rogue,subtlety,32,19,13
19534,Káríc,draenor,953,rogue,subtlety,18,10,8
19535,Sacrehptit,naxxramas,952,rogue,subtlety,18,10,8
19536,Oazo,ysondre,951,rogue,subtlety,35,13,22
19537,Qiiss,stormscale,949,rogue,subtlety,18,10,8
19538,Lovetospoon,ravencrest,937,rogue,subtlety,25,11,14
19539,Kezaay,silvermoon,923,rogue,subtlety,24,13,11
19540,Aeønaxx,hyjal,915,rogue,subtlety,48,21,27
19541,Hemorhoid,outland,912,rogue,subtlety,48,25,23
19542,Whaiipy,ravencrest,905,rogue,subtlety,56,29,27
19543,Sentaria,argent-dawn,903,rogue,subtlety,36,18,18
19544,Saroumani,eitrigg,891,rogue,subtlety,30,16,14
19545,Katarïnä,khaz-modan,887,rogue,subtlety,24,11,13
19546,Беточка,gordunni,883,rogue,subtlety,24,11,13
19547,Kouru,outland,871,rogue,subtlety,25,10,15
19548,Фрозенденс,gordunni,864,rogue,subtlety,12,9,3
19549,Rantie,eredar,864,rogue,subtlety,12,9,3
19550,Randomidiot,ravencrest,864,rogue,subtlety,12,9,3
19551,Whaazlysnipz,tarren-mill,864,rogue,subtlety,12,9,3
19552,Slapshot,das-konsortium,864,rogue,subtlety,18,9,9
19553,Cørek,blackhand,863,rogue,subtlety,18,9,9
19554,Miiløx,silvermoon,863,rogue,subtlety,18,9,9
19555,Márto,archimonde,863,rogue,subtlety,24,9,15
19556,Xãwé,kazzak,862,rogue,subtlety,18,9,9
19557,Crixor,blackrock,861,rogue,subtlety,12,9,3
19558,Дакоока,soulflayer,861,rogue,subtlety,12,9,3
19559,Opaska,ravencrest,861,rogue,subtlety,24,9,15
19560,Jaqenhghar,pozzo-delleternità,859,rogue,subtlety,18,9,9
19561,Eightball,frostmane,859,rogue,subtlety,18,9,9
19562,Ithilyien,blackmoore,859,rogue,subtlety,24,9,15
19563,Sequoja,blackrock,858,rogue,subtlety,24,9,15
19564,Zergroidz,kazzak,856,rogue,subtlety,24,9,15
19565,Vampor,sylvanas,852,rogue,subtlety,30,9,21
19566,Хасилей,booty-bay,847,rogue,subtlety,17,9,8
19567,Горланг,ashenvale,841,rogue,subtlety,18,9,9
19568,Liquidgaba,ravencrest,828,rogue,subtlety,48,20,28
19569,Anr,burning-legion,815,rogue,subtlety,17,9,8
19570,Тайнушка,soulflayer,806,rogue,subtlety,30,9,21
19571,Фрозенблейдс,gordunni,768,rogue,subtlety,12,8,4
19572,Djdillá,kazzak,768,rogue,subtlety,12,8,4
19573,Danori,grim-batol,768,rogue,subtlety,12,8,4
19574,Devourswine,argent-dawn,768,rogue,subtlety,12,8,4
19575,Whoton,archimonde,768,rogue,subtlety,16,9,7
19576,Ач,gordunni,768,rogue,subtlety,18,8,10
19577,Amuini,magtheridon,768,rogue,subtlety,18,8,10
19578,Zygzäg,hyjal,768,rogue,subtlety,18,8,10
19579,Zëkke,sanguino,767,rogue,subtlety,12,8,4
19580,Ferrãof,aggra-português,767,rogue,subtlety,12,8,4
19581,Mortnoïre,naxxramas,767,rogue,subtlety,12,8,4
19582,Bamsejuicee,kazzak,767,rogue,subtlety,12,8,4
19583,Aahz,tarren-mill,767,rogue,subtlety,18,8,10
19584,Jenz,blackmoore,767,rogue,subtlety,18,8,10
19585,Madisonivyqt,blackmoore,767,rogue,subtlety,18,8,10
19586,Mdadx,stormreaver,767,rogue,subtlety,18,8,10
19587,Akwaaba,ravencrest,767,rogue,subtlety,21,9,12
19588,Vanéry,ravencrest,766,rogue,subtlety,12,8,4
19589,Jkrx,draenor,766,rogue,subtlety,18,8,10
19590,Poughkeepsie,outland,765,rogue,subtlety,18,8,10
19591,Byonics,durotan,763,rogue,subtlety,12,8,4
19592,Deprress,silvermoon,762,rogue,subtlety,12,8,4
19593,Jomoama,norgannon,762,rogue,subtlety,24,8,16
19594,Xaiko,baelgun,757,rogue,subtlety,15,9,6
19595,Narar,stormscale,756,rogue,subtlety,12,8,4
19596,Drakhez,sanguino,752,rogue,subtlety,12,8,4
19597,Faable,silvermoon,742,rogue,subtlety,47,16,31
19598,Abomïñatïøñ,ravencrest,735,rogue,subtlety,30,10,20
19599,Rmp,khaz-modan,720,rogue,subtlety,30,9,21
19600,Petsakos,ravencrest,713,rogue,subtlety,21,9,12
19601,Смекрус,soulflayer,687,rogue,subtlety,19,8,11
19602,Лэйкиро,gordunni,672,rogue,subtlety,12,7,5
19603,Änanké,outland,672,rogue,subtlety,12,7,5
19604,Рэкрейвон,gordunni,672,rogue,subtlety,12,7,5
19605,Ncrø,aszune,672,rogue,subtlety,13,7,6
19606,Nihilix,dalaran,672,rogue,subtlety,18,7,11
19607,Belwarx,darksorrow,672,rogue,subtlety,18,7,11
19608,Kenjí,silvermoon,672,rogue,subtlety,18,7,11
19609,Социалистсс,gordunni,672,rogue,subtlety,18,7,11
19610,Drydamage,kazzak,672,rogue,subtlety,24,7,17
19611,Azziinoth,ragnaros,672,rogue,subtlety,24,7,17
19612,Nairobii,tarren-mill,671,rogue,subtlety,12,7,5
19613,Monero,thrall,671,rogue,subtlety,12,7,5
19614,Hyake,zuljin,671,rogue,subtlety,12,7,5
19615,Maroshko,argent-dawn,671,rogue,subtlety,18,7,11
19616,Teralala,kazzak,671,rogue,subtlety,18,7,11
19617,Daggoth,kiljaeden,671,rogue,subtlety,24,7,17
19618,Cataleýa,outland,670,rogue,subtlety,12,7,5
19619,Pepperbox,twisting-nether,667,rogue,subtlety,12,7,5
19620,Рэйбэк,howling-fjord,667,rogue,subtlety,24,7,17
19621,Cacucoxpahu,kazzak,666,rogue,subtlety,12,7,5
19622,Leylaris,argent-dawn,663,rogue,subtlety,18,7,11
19623,Ratolí,dun-modr,658,rogue,subtlety,12,7,5
19624,Пузэн,howling-fjord,658,rogue,subtlety,12,7,5
19625,Fizgaroth,argent-dawn,657,rogue,subtlety,12,7,5
19626,Skene,sanguino,648,rogue,subtlety,18,7,11
19627,Frequenzalfa,silvermoon,640,rogue,subtlety,10,8,2
19628,Nineball,frostmane,638,rogue,subtlety,17,7,10
19629,Obsçuritý,ragnaros,630,rogue,subtlety,17,7,10
19630,Actualcarry,dentarg,617,rogue,subtlety,12,8,4
19631,Subzerõ,archimonde,608,rogue,subtlety,22,7,15
19632,Strangeboy,ravencrest,576,rogue,subtlety,6,6,0
19633,Naiikaii,antonidas,576,rogue,subtlety,6,6,0
19634,Smílèy,ravencrest,576,rogue,subtlety,12,6,6
19635,Feradelia,thrall,576,rogue,subtlety,12,6,6
19636,Ладжо,gordunni,576,rogue,subtlety,12,6,6
19637,Geá,ravencrest,576,rogue,subtlety,12,6,6
19638,Jljr,twisting-nether,576,rogue,subtlety,12,6,6
19639,Bizzarerogue,tarren-mill,576,rogue,subtlety,12,6,6
19640,Àlleyezonme,ravencrest,576,rogue,subtlety,12,6,6
19641,Ðéstr,ravencrest,576,rogue,subtlety,12,6,6
19642,Dópamine,hyjal,576,rogue,subtlety,12,6,6
19643,Briggo,silvermoon,576,rogue,subtlety,12,6,6
19644,Ibizà,ravencrest,576,rogue,subtlety,12,6,6
19645,Ðelvin,dalaran,576,rogue,subtlety,12,6,6
19646,Rinj,antonidas,576,rogue,subtlety,12,6,6
19647,Jqmie,ravencrest,576,rogue,subtlety,12,6,6
19648,Denjas,archimonde,576,rogue,subtlety,12,6,6
19649,Carvyn,defias-brotherhood,576,rogue,subtlety,12,6,6
19650,Elnyasha,ravencrest,576,rogue,subtlety,12,6,6
19651,Amén,sanguino,576,rogue,subtlety,18,6,12
19652,Blihhubba,silvermoon,576,rogue,subtlety,24,6,18
19653,Пусякиллерх,gordunni,575,rogue,subtlety,12,6,6
19654,Stabymoose,draenor,575,rogue,subtlety,12,6,6
19655,Niapro,dun-morogh,575,rogue,subtlety,12,6,6
19656,Hersuub,blackmoore,574,rogue,subtlety,12,6,6
19657,Jisz,doomhammer,574,rogue,subtlety,12,6,6
19658,Sassasine,amanthul,572,rogue,subtlety,12,6,6
19659,Розбэйник,gordunni,572,rogue,subtlety,12,6,6
19660,Freddybst,twisting-nether,571,rogue,subtlety,12,6,6
19661,Lêvî,sanguino,569,rogue,subtlety,12,6,6
19662,Thiranor,cthun,569,rogue,subtlety,12,6,6
19663,Grikra,argent-dawn,566,rogue,subtlety,12,6,6
19664,Geroge,sylvanas,566,rogue,subtlety,12,6,6
19665,Drspectres,tarren-mill,543,rogue,subtlety,30,6,24
19666,Zobrak,twisting-nether,542,rogue,subtlety,14,7,7
19667,Malignance,drakthul,511,rogue,subtlety,14,7,7
19668,Knifeex,ravencrest,509,rogue,subtlety,20,6,14
19669,Draytonlove,nemesis,480,rogue,subtlety,6,5,1
19670,Фэйкуои,gordunni,480,rogue,subtlety,6,5,1
19671,Бонястелс,gordunni,480,rogue,subtlety,6,5,1
19672,Zep,auchindoun,480,rogue,subtlety,6,5,1
19673,Cheapshotwin,nethersturm,480,rogue,subtlety,6,5,1
19674,Silnce,outland,480,rogue,subtlety,6,5,1
19675,Meshay,kazzak,480,rogue,subtlety,7,5,2
19676,Khepaso,sanguino,480,rogue,subtlety,12,5,7
19677,Blazestórm,stormscale,480,rogue,subtlety,12,5,7
19678,Киднитучер,fordragon,480,rogue,subtlety,12,5,7
19679,Янимагу,soulflayer,480,rogue,subtlety,12,5,7
19680,Ryvz,ravencrest,480,rogue,subtlety,12,5,7
19681,Jdç,tarren-mill,480,rogue,subtlety,12,5,7
19682,Mzaa,ravencrest,480,rogue,subtlety,12,5,7
19683,Akyô,archimonde,480,rogue,subtlety,12,5,7
19684,Kleptomaniac,aggra-português,480,rogue,subtlety,12,5,7
19685,Анивиана,howling-fjord,480,rogue,subtlety,12,5,7
19686,Løre,blackrock,480,rogue,subtlety,12,5,7
19687,Фрозеншедов,gordunni,480,rogue,subtlety,12,5,7
19688,Darkveil,xavius,480,rogue,subtlety,12,5,7
19689,Deevoll,tarren-mill,480,rogue,subtlety,12,5,7
19690,Стеллакокс,howling-fjord,480,rogue,subtlety,12,5,7
19691,Lurk,saurfang,480,rogue,subtlety,12,5,7
19692,Decoyed,sylvanas,480,rogue,subtlety,12,5,7
19693,Кашеварить,gordunni,480,rogue,subtlety,12,5,7
19694,Loznah,outland,480,rogue,subtlety,12,5,7
19695,Slayered,burning-legion,480,rogue,subtlety,18,5,13
19696,Ajwenx,ravencrest,480,rogue,subtlety,18,5,13
19697,Zodracir,scarshield-legion,480,rogue,subtlety,18,5,13
19698,Распяздяй,gordunni,479,rogue,subtlety,12,5,7
19699,Smorcoolio,stormscale,479,rogue,subtlety,12,5,7
19700,Houston,aegwynn,479,rogue,subtlety,12,5,7
19701,Ryxon,arathor,479,rogue,subtlety,12,5,7
19702,Jailkaz,thrall,479,rogue,subtlety,12,5,7
19703,Моямайя,eversong,479,rogue,subtlety,12,5,7
19704,Smoothiè,twisting-nether,479,rogue,subtlety,12,5,7
19705,Mozenn,draenor,478,rogue,subtlety,19,5,14
19706,Strikes,eredar,477,rogue,subtlety,6,5,1
19707,Эльтаэрон,gordunni,477,rogue,subtlety,12,5,7
19708,Mallaurya,dalaran,474,rogue,subtlety,12,5,7
19709,Cortzy,stormscale,448,rogue,subtlety,16,5,11
19710,Кумаме,howling-fjord,447,rogue,subtlety,11,5,6
19711,Roguebot,draenor,447,rogue,subtlety,11,5,6
19712,Райан,fordragon,431,rogue,subtlety,11,5,6
19713,Maxtnulaujeu,archimonde,431,rogue,subtlety,11,5,6
19714,Ålleyézonme,ravencrest,415,rogue,subtlety,11,5,6
19715,Algopyrin,ragnaros,396,rogue,subtlety,13,5,8
19716,Dainhek,gilneas,394,rogue,subtlety,13,5,8
19717,Ocklol,archimonde,384,rogue,subtlety,6,4,2
19718,Ënd,ravencrest,384,rogue,subtlety,6,4,2
19719,Cucumber,laughing-skull,384,rogue,subtlety,6,4,2
19720,Xkebyzlobg,outland,384,rogue,subtlety,6,4,2
19721,Asmodal,antonidas,384,rogue,subtlety,6,4,2
19722,Seeralex,anetheron,384,rogue,subtlety,6,4,2
19723,Grekén,bronze-dragonflight,384,rogue,subtlety,6,4,2
19724,Ciosy,blackrock,384,rogue,subtlety,6,4,2
19725,Marcel,blackrock,384,rogue,subtlety,6,4,2
19726,Нунас,soulflayer,384,rogue,subtlety,6,4,2
19727,Siele,twisting-nether,384,rogue,subtlety,6,4,2
19728,Nxnja,silvermoon,384,rogue,subtlety,6,4,2
19729,Kostik,ravencrest,384,rogue,subtlety,6,4,2
19730,Йованов,gordunni,384,rogue,subtlety,6,4,2
19731,Mol,defias-brotherhood,384,rogue,subtlety,6,4,2
19732,Sebik,ravencrest,384,rogue,subtlety,6,4,2
19733,Qylu,argent-dawn,384,rogue,subtlety,6,4,2
19734,Blckrogue,bloodfeather,384,rogue,subtlety,6,4,2
19735,Featfawkes,ragnaros,384,rogue,subtlety,6,4,2
19736,Mega,nordrassil,384,rogue,subtlety,6,4,2
19737,Джеанит,gordunni,384,rogue,subtlety,6,4,2
19738,Pérplèxîty,thrall,384,rogue,subtlety,6,4,2
19739,Læffgøðx,stormscale,384,rogue,subtlety,6,4,2
19740,Smörkniven,argent-dawn,384,rogue,subtlety,6,4,2
19741,Nâzaar,antonidas,384,rogue,subtlety,6,4,2
19742,Whiteløtûs,dun-modr,384,rogue,subtlety,12,4,8
19743,Snack,burning-legion,384,rogue,subtlety,12,4,8
19744,Erenyeagerx,kazzak,384,rogue,subtlety,12,4,8
19745,Ambushmike,gorgonnash,384,rogue,subtlety,12,4,8
19746,Zordochrog,kazzak,384,rogue,subtlety,12,4,8
19747,Sxpped,stormscale,384,rogue,subtlety,12,4,8
19748,Máuul,ravencrest,384,rogue,subtlety,12,4,8
19749,Szabina,outland,384,rogue,subtlety,12,4,8
19750,Bloodwraith,stormscale,384,rogue,subtlety,12,4,8
19751,Бллейз,gordunni,384,rogue,subtlety,18,4,14
19752,Очч,blackscar,384,rogue,subtlety,18,4,14
19753,Akira,outland,383,rogue,subtlety,6,4,2
19754,Vanishdotcom,blackrock,383,rogue,subtlety,6,4,2
19755,Anala,stormreaver,383,rogue,subtlety,6,4,2
19756,Protolink,zuljin,383,rogue,subtlety,18,4,14
19757,Lolblizard,gorgonnash,382,rogue,subtlety,6,4,2
19758,Wurzelzepp,blackrock,335,rogue,subtlety,11,4,7
19759,Cozu,stormrage,317,rogue,subtlety,10,4,6
19760,Opiïum,ysondre,303,rogue,subtlety,7,4,3
19761,Taishani,thrall,288,rogue,subtlety,6,3,3
19762,Shadxwstep,ravencrest,288,rogue,subtlety,6,3,3
19763,Kolto,argent-dawn,288,rogue,subtlety,6,3,3
19764,Swiftyfan,silvermoon,288,rogue,subtlety,6,3,3
19765,Элисандресса,gordunni,288,rogue,subtlety,6,3,3
19766,Sneakysáp,ravencrest,288,rogue,subtlety,6,3,3
19767,Knifeparty,silvermoon,288,rogue,subtlety,6,3,3
19768,Jawen,silvermoon,288,rogue,subtlety,6,3,3
19769,Alexandra,kazzak,288,rogue,subtlety,6,3,3
19770,Nahj,ravencrest,288,rogue,subtlety,6,3,3
19771,Ezk,eredar,288,rogue,subtlety,6,3,3
19772,Garou,blackhand,288,rogue,subtlety,6,3,3
19773,Faptastíc,blackmoore,288,rogue,subtlety,6,3,3
19774,Sheldowws,tarren-mill,288,rogue,subtlety,6,3,3
19775,Synthaetic,draenor,288,rogue,subtlety,6,3,3
19776,Sicu,malganis,288,rogue,subtlety,6,3,3
19777,Sadgexd,draenor,288,rogue,subtlety,6,3,3
19778,Botnet,blackmoore,288,rogue,subtlety,6,3,3
19779,Кейнилин,gordunni,288,rogue,subtlety,6,3,3
19780,Baradiir,defias-brotherhood,288,rogue,subtlety,6,3,3
19781,Xhemil,tarren-mill,288,rogue,subtlety,6,3,3
19782,Mekóz,draenor,288,rogue,subtlety,6,3,3
19783,Checkormate,aegwynn,288,rogue,subtlety,6,3,3
19784,Jabbz,blackhand,288,rogue,subtlety,6,3,3
19785,Бэрнии,howling-fjord,288,rogue,subtlety,6,3,3
19786,Izzyb,auchindoun,288,rogue,subtlety,6,3,3
19787,Zayøn,outland,288,rogue,subtlety,6,3,3
19788,Pretylo,marécage-de-zangar,288,rogue,subtlety,6,3,3
19789,Kryptonite,nemesis,288,rogue,subtlety,6,3,3
19790,Roronao,sanguino,288,rogue,subtlety,6,3,3
19791,Pulvèr,dalaran,288,rogue,subtlety,6,3,3
19792,Tinyshank,drakthul,288,rogue,subtlety,6,3,3
19793,Qira,burning-blade,288,rogue,subtlety,6,3,3
19794,Бейнс,howling-fjord,288,rogue,subtlety,6,3,3
19795,Roguanal,hyjal,288,rogue,subtlety,6,3,3
19796,Røguøross,archimonde,288,rogue,subtlety,6,3,3
19797,Dimidimi,wildhammer,288,rogue,subtlety,6,3,3
19798,Viiltäjäjack,stormscale,288,rogue,subtlety,6,3,3
19799,Vanisshh,hyjal,288,rogue,subtlety,6,3,3
19800,Валанбалас,soulflayer,288,rogue,subtlety,6,3,3
19801,Waakie,frostmane,288,rogue,subtlety,6,3,3
19802,Lepreuchan,archimonde,288,rogue,subtlety,6,3,3
19803,Exbandit,sanguino,288,rogue,subtlety,6,3,3
19804,Uareincombat,drakthul,288,rogue,subtlety,11,3,8
19805,Xéshon,tarren-mill,288,rogue,subtlety,12,3,9
19806,Taniwa,archimonde,288,rogue,subtlety,12,3,9
19807,Mns,drakthul,288,rogue,subtlety,12,3,9
19808,Helcof,emerald-dream,288,rogue,subtlety,12,3,9
19809,Pestctrl,argent-dawn,288,rogue,subtlety,12,3,9
19810,Bú,nemesis,288,rogue,subtlety,12,3,9
19811,Кэйтлис,howling-fjord,288,rogue,subtlety,12,3,9
19812,Abej,malygos,288,rogue,subtlety,12,3,9
19813,Cbrook,sylvanas,288,rogue,subtlety,12,3,9
19814,Ристоврация,gordunni,288,rogue,subtlety,12,3,9
19815,Vancleéf,sylvanas,288,rogue,subtlety,12,3,9
19816,Zoldyck,bloodhoof,288,rogue,subtlety,12,3,9
19817,Воробнальщик,soulflayer,288,rogue,subtlety,12,3,9
19818,Princip,drakthul,288,rogue,subtlety,12,3,9
19819,Kongnognog,ragnaros,288,rogue,subtlety,12,3,9
19820,Siktiritos,malganis,288,rogue,subtlety,12,3,9
19821,Koutzai,stormscale,288,rogue,subtlety,12,3,9
19822,Djinnx,malganis,288,rogue,subtlety,12,3,9
19823,Xyúmopjoßblú,ravencrest,288,rogue,subtlety,12,3,9
19824,Plot,zenedar,288,rogue,subtlety,12,3,9
19825,Kïbs,dalaran,288,rogue,subtlety,12,3,9
19826,Coolspot,archimonde,288,rogue,subtlety,12,3,9
19827,Zavebe,nathrezim,288,rogue,subtlety,12,3,9
19828,Местьбучи,howling-fjord,288,rogue,subtlety,12,3,9
19829,Ñú,ravencrest,288,rogue,subtlety,12,3,9
19830,Skíll,sanguino,288,rogue,subtlety,12,3,9
19831,Rufinol,twisting-nether,288,rogue,subtlety,12,3,9
19832,Liirja,twisting-nether,288,rogue,subtlety,18,3,15
19833,Gingahboy,doomhammer,287,rogue,subtlety,6,3,3
19834,Fastspectre,ravencrest,287,rogue,subtlety,6,3,3
19835,Styggvanas,tarren-mill,287,rogue,subtlety,15,4,11
19836,Боузи,howling-fjord,287,rogue,subtlety,12,3,9
19837,Cesar,blackhand,286,rogue,subtlety,6,3,3
19838,Rhaacvar,magtheridon,286,rogue,subtlety,6,3,3
19839,Jontor,deathwing,286,rogue,subtlety,12,3,9
19840,Wìzléy,ravencrest,284,rogue,subtlety,12,3,9
19841,Madlain,jaedenar,255,rogue,subtlety,8,4,4
19842,Juuzou,outland,239,rogue,subtlety,5,3,2
19843,Iwillberone,ravencrest,239,rogue,subtlety,11,3,8
19844,Nakli,antonidas,234,rogue,subtlety,15,4,11
19845,Igel,antonidas,192,rogue,subtlety,6,2,4
19846,Deadchivalry,argent-dawn,192,rogue,subtlety,6,2,4
19847,Mojojina,theradras,192,rogue,subtlety,6,2,4
19848,Bananashow,aegwynn,192,rogue,subtlety,6,2,4
19849,Skaterboy,stormscale,192,rogue,subtlety,6,2,4
19850,Giftknirps,silvermoon,192,rogue,subtlety,6,2,4
19851,Røxxilly,blackmoore,192,rogue,subtlety,6,2,4
19852,Stormhardt,stormscale,192,rogue,subtlety,6,2,4
19853,Шмарамышь,soulflayer,192,rogue,subtlety,6,2,4
19854,Ilyrya,azuremyst,192,rogue,subtlety,6,2,4
19855,Sigleif,argent-dawn,192,rogue,subtlety,6,2,4
19856,Elnos,conseil-des-ombres,192,rogue,subtlety,6,2,4
19857,Feylia,terenas,192,rogue,subtlety,6,2,4
19858,Рогаупорога,howling-fjord,192,rogue,subtlety,6,2,4
19859,Katara,antonidas,192,rogue,subtlety,6,2,4
19860,Fatnutsac,eredar,192,rogue,subtlety,6,2,4
19861,Режупополам,howling-fjord,192,rogue,subtlety,6,2,4
19862,Dedka,hyjal,192,rogue,subtlety,6,2,4
19863,Slicéndicé,wildhammer,192,rogue,subtlety,6,2,4
19864,Скиррона,gordunni,192,rogue,subtlety,6,2,4
19865,Decrios,outland,192,rogue,subtlety,6,2,4
19866,Ît,stormscale,192,rogue,subtlety,6,2,4
19867,Gosleep,stormscale,192,rogue,subtlety,6,2,4
19868,Голадриель,gordunni,192,rogue,subtlety,6,2,4
19869,Selecta,bloodhoof,192,rogue,subtlety,6,2,4
19870,Inviscuz,draenor,192,rogue,subtlety,6,2,4
19871,Galore,azjolnerub,192,rogue,subtlety,6,2,4
19872,Stealthyist,darkmoon-faire,192,rogue,subtlety,6,2,4
19873,Xanders,draenor,192,rogue,subtlety,6,2,4
19874,Vanisha,outland,192,rogue,subtlety,6,2,4
19875,Wrathed,stormreaver,192,rogue,subtlety,6,2,4
19876,Fatedancer,outland,192,rogue,subtlety,6,2,4
19877,Melfîce,blackhand,192,rogue,subtlety,6,2,4
19878,Lenwe,blackmoore,192,rogue,subtlety,6,2,4
19879,Xiro,dalaran,192,rogue,subtlety,6,2,4
19880,Skeeto,blackmoore,192,rogue,subtlety,6,2,4
19881,Рикимартини,gordunni,192,rogue,subtlety,6,2,4
19882,Botsrogue,kazzak,192,rogue,subtlety,6,2,4
19883,Stigh,twisting-nether,192,rogue,subtlety,6,2,4
19884,Haikyu,blackhand,192,rogue,subtlety,6,2,4
19885,Aikaza,blackmoore,192,rogue,subtlety,6,2,4
19886,Фордрэн,deathguard,192,rogue,subtlety,10,3,7
19887,Greiskull,cthun,192,rogue,subtlety,15,3,12
19888,Acheravar,antonidas,192,rogue,subtlety,12,2,10
19889,Refundlands,kazzak,192,rogue,subtlety,12,2,10
19890,Destrektor,kazzak,192,rogue,subtlety,12,2,10
19891,Jackpot,sargeras,192,rogue,subtlety,12,2,10
19892,Delenor,stormscale,192,rogue,subtlety,12,2,10
19893,Cabalion,draenor,191,rogue,subtlety,6,2,4
19894,Mamus,tarren-mill,191,rogue,subtlety,6,2,4
19895,Ecray,burning-legion,191,rogue,subtlety,6,2,4
19896,Singularität,silvermoon,191,rogue,subtlety,6,2,4
19897,Энвитио,gordunni,191,rogue,subtlety,6,2,4
19898,Lêgòlàs,blackmoore,191,rogue,subtlety,12,2,10
19899,Feinted,kazzak,159,rogue,subtlety,11,2,9
19900,Bandèra,ragnaros,138,rogue,subtlety,15,3,12
19901,Idrîl,rashgarroth,137,rogue,subtlety,9,3,6
19902,Эбиб,soulflayer,128,rogue,subtlety,4,2,2
19903,Songoro,tirion,96,rogue,subtlety,3,2,1
19904,Kidneyou,ragnaros,96,rogue,subtlety,6,1,5
19905,Элонли,gordunni,96,rogue,subtlety,6,1,5
19906,Stealthi,stormscale,96,rogue,subtlety,6,1,5
19907,Àrléngødx,kazzak,96,rogue,subtlety,6,1,5
19908,Könän,dalaran,96,rogue,subtlety,6,1,5
19909,Twinkyzzö,archimonde,96,rogue,subtlety,6,1,5
19910,Takenòtes,nemesis,96,rogue,subtlety,6,1,5
19911,Стронг,soulflayer,96,rogue,subtlety,6,1,5
19912,Davshadows,magtheridon,96,rogue,subtlety,6,1,5
19913,Outride,outland,96,rogue,subtlety,6,1,5
19914,Imnotnice,terenas,96,rogue,subtlety,6,1,5
19915,Fintex,ravencrest,96,rogue,subtlety,6,1,5
19916,Malborko,ravencrest,96,rogue,subtlety,6,1,5
19917,Letheus,stormscale,96,rogue,subtlety,6,1,5
19918,Lëmönhäzë,dun-modr,96,rogue,subtlety,6,1,5
19919,Chøsen,stormscale,96,rogue,subtlety,6,1,5
19920,Nerkmind,ragnaros,96,rogue,subtlety,6,1,5
19921,Verk,twilights-hammer,96,rogue,subtlety,6,1,5
19922,Neskagrall,aegwynn,96,rogue,subtlety,6,1,5
19923,Fivepoint,blackmoore,96,rogue,subtlety,6,1,5
19924,Edaniel,draenor,96,rogue,subtlety,6,1,5
19925,Rhûlf,ravencrest,96,rogue,subtlety,6,1,5
19926,Rímen,archimonde,96,rogue,subtlety,6,1,5
19927,Bauwten,ravencrest,96,rogue,subtlety,6,1,5
19928,Nohks,blackmoore,96,rogue,subtlety,6,1,5
19929,Hyrule,onyxia,96,rogue,subtlety,6,1,5
19930,Kunigunde,shattered-hand,96,rogue,subtlety,6,1,5
19931,Тварьебаная,howling-fjord,96,rogue,subtlety,6,1,5
19932,Tàazz,archimonde,96,rogue,subtlety,6,1,5
19933,Гламурятина,gordunni,96,rogue,subtlety,6,1,5
19934,Çåñçér,sylvanas,96,rogue,subtlety,12,1,11
19935,Альдинг,howling-fjord,96,rogue,subtlety,12,1,11
19936,Calmrusgirl,ravenholdt,96,rogue,subtlety,12,1,11
19937,Digmorre,drakthul,79,rogue,subtlety,5,1,4
19938,Nesth,silvermoon,79,rogue,subtlety,5,1,4
19939,Domiqs,blackhand,63,rogue,subtlety,2,2,0
19940,Mâtâtâ,die-ewige-wacht,63,rogue,subtlety,2,2,0
19941,Dendriodidit,kazzak,31,rogue,subtlety,2,1,1
19942,Aæ,stormscale,2112,rogue,assassination,125,65,60
19943,Rightplay,outland,2112,rogue,assassination,90,45,45
19944,Ewyna,silvermoon,2103,rogue,assassination,93,49,44
19945,Fánsly,silvermoon,2102,rogue,assassination,78,40,38
19946,Shadenox,ravencrest,1973,rogue,assassination,269,129,140
19947,Visuáls,antonidas,1950,rogue,assassination,81,38,43
19948,Buffassa,ravencrest,1943,rogue,assassination,83,53,30
19949,Mentol,stormscale,1928,rogue,assassination,53,41,12
19950,Naláa,ravencrest,1924,rogue,assassination,52,31,21
19951,Chínerox,thunderhorn,1920,rogue,assassination,188,94,94
19952,Vulrin,argent-dawn,1899,rogue,assassination,77,44,33
19953,Venomblood,sanguino,1899,rogue,assassination,59,27,32
19954,Oggish,tarren-mill,1890,rogue,assassination,72,28,44
19955,Vayyel,silvermoon,1854,rogue,assassination,166,78,88
19956,Ohdaesu,aegwynn,1854,rogue,assassination,84,36,48
19957,Asàd,draenor,1841,rogue,assassination,47,30,17
19958,Sadgexd,draenor,1814,rogue,assassination,52,26,26
19959,Prei,hyjal,1812,rogue,assassination,72,36,36
19960,Shadeco,ravencrest,1811,rogue,assassination,60,29,31
19961,Пожилойпуп,gordunni,1811,rogue,assassination,54,26,28
19962,Lookåtme,ravencrest,1808,rogue,assassination,48,20,28
19963,Eiscreme,blackmoore,1802,rogue,assassination,95,50,45
19964,Heavý,argent-dawn,1802,rogue,assassination,97,46,51
19965,Ридлли,soulflayer,1783,rogue,assassination,59,29,30
19966,Dáydreamín,draenor,1772,rogue,assassination,60,27,33
19967,Warbell,ravencrest,1757,rogue,assassination,66,27,39
19968,Watchmeyoe,ravencrest,1738,rogue,assassination,54,28,26
19969,Варэль,borean-tundra,1727,rogue,assassination,150,78,72
19970,Çhïñêsémøñkè,argent-dawn,1721,rogue,assassination,42,26,16
19971,Awaaylol,stormscale,1716,rogue,assassination,112,52,60
19972,Youcrymydear,outland,1711,rogue,assassination,66,31,35
19973,Drenched,turalyon,1703,rogue,assassination,72,33,39
19974,Blindlol,emerald-dream,1702,rogue,assassination,54,27,27
19975,Rinj,antonidas,1693,rogue,assassination,89,37,52
19976,Войенх,gordunni,1692,rogue,assassination,168,82,86
19977,Акиоми,gordunni,1691,rogue,assassination,102,57,45
19978,Çhïñêsérøqüè,tarren-mill,1691,rogue,assassination,77,33,44
19979,Sotro,dun-modr,1690,rogue,assassination,66,26,40
19980,Mazeken,kazzak,1688,rogue,assassination,53,21,32
19981,Fíìp,drakthul,1670,rogue,assassination,54,21,33
19982,Skali,tarren-mill,1669,rogue,assassination,54,27,27
19983,Shipshot,blackrock,1664,rogue,assassination,45,26,19
19984,Richï,outland,1639,rogue,assassination,54,20,34
19985,Monski,ravencrest,1631,rogue,assassination,54,21,33
19986,Gøldzahn,antonidas,1627,rogue,assassination,76,29,47
19987,Кэпс,blackscar,1625,rogue,assassination,66,39,27
19988,Naiikaii,antonidas,1624,rogue,assassination,42,17,25
19989,Мистеркрэпс,howling-fjord,1624,rogue,assassination,47,19,28
19990,Костялом,howling-fjord,1623,rogue,assassination,36,17,19
19991,Cander,kazzak,1621,rogue,assassination,72,32,40
19992,Keeke,outland,1619,rogue,assassination,54,28,26
19993,Shookyz,zuljin,1615,rogue,assassination,54,27,27
19994,Pheq,ravencrest,1615,rogue,assassination,42,17,25
19995,Nîllá,blackmoore,1600,rogue,assassination,42,18,24
19996,Ockzy,archimonde,1592,rogue,assassination,75,39,36
19997,Peeon,drakthul,1572,rogue,assassination,61,20,41
19998,Howfastiam,ravencrest,1569,rogue,assassination,30,19,11
19999,Precious,sylvanas,1567,rogue,assassination,72,28,44
20000,Weakrat,kult-der-verdammten,1538,rogue,assassination,30,20,10
20001,Kãlí,blackmoore,1537,rogue,assassination,90,44,46
20002,Shikamouflé,archimonde,1537,rogue,assassination,136,65,71
20003,Cntrlld,ravencrest,1532,rogue,assassination,36,16,20
20004,Knutten,wildhammer,1526,rogue,assassination,102,47,55
20005,Zaintsas,tarren-mill,1509,rogue,assassination,45,23,22
20006,Пусякиллерх,gordunni,1509,rogue,assassination,55,20,35
20007,Synergize,stormreaver,1508,rogue,assassination,115,54,61
20008,Pieksig,blackmoore,1507,rogue,assassination,42,20,22
20009,Silesi,kazzak,1499,rogue,assassination,70,37,33
20010,Nùgz,area-52,1498,rogue,assassination,119,65,54
20011,Ванэйти,gordunni,1487,rogue,assassination,42,24,18
20012,Hidinginash,twisting-nether,1486,rogue,assassination,56,31,25
20013,Shaokiz,sylvanas,1485,rogue,assassination,48,25,23
20014,ßênz,archimonde,1483,rogue,assassination,54,25,29
20015,Волнорес,eversong,1481,rogue,assassination,76,39,37
20016,Freemmr,draenor,1471,rogue,assassination,64,36,28
20017,Diazz,aegwynn,1470,rogue,assassination,114,53,61
20018,Шмарамышь,soulflayer,1463,rogue,assassination,66,31,35
20019,Argapu,stormscale,1455,rogue,assassination,42,16,26
20020,Eizan,outland,1450,rogue,assassination,42,23,19
20021,Axoic,ravencrest,1433,rogue,assassination,48,23,25
20022,Vennomous,darkspear,1429,rogue,assassination,66,32,34
20023,Nìghtwalker,ravencrest,1428,rogue,assassination,50,24,26
20024,Negrim,dun-modr,1427,rogue,assassination,56,24,32
20025,Søsaboy,nemesis,1425,rogue,assassination,48,21,27
20026,Belsazar,azshara,1418,rogue,assassination,138,67,71
20027,Grzech,burning-legion,1408,rogue,assassination,76,40,36
20028,Koreanrogue,archimonde,1406,rogue,assassination,24,15,9
20029,Патайчик,soulflayer,1403,rogue,assassination,54,29,25
20030,Arkblenderx,silvermoon,1401,rogue,assassination,82,41,41
20031,Piñotxo,sanguino,1377,rogue,assassination,41,17,24
20032,Ciaordel,sylvanas,1372,rogue,assassination,75,36,39
20033,Teseiga,aegwynn,1364,rogue,assassination,96,37,59
20034,Candycc,burning-legion,1353,rogue,assassination,49,25,24
20035,Синигурай,soulflayer,1353,rogue,assassination,36,18,18
20036,Alnaddafrog,outland,1352,rogue,assassination,42,25,17
20037,Cýphia,amanthul,1351,rogue,assassination,69,32,37
20038,Batsu,alleria,1346,rogue,assassination,42,18,24
20039,Dirtyz,dun-modr,1344,rogue,assassination,30,17,13
20040,Synthaetic,draenor,1341,rogue,assassination,76,40,36
20041,Слаадкий,gordunni,1338,rogue,assassination,36,14,22
20042,Йа,gordunni,1335,rogue,assassination,24,14,10
20043,Haikyu,blackhand,1334,rogue,assassination,54,21,33
20044,Iwillcapyou,twisting-nether,1331,rogue,assassination,30,14,16
20045,Ppollito,hyjal,1310,rogue,assassination,66,30,36
20046,Sigleif,argent-dawn,1309,rogue,assassination,61,28,33
20047,Gadûz,kazzak,1295,rogue,assassination,44,17,27
20048,Flawlesser,kazzak,1294,rogue,assassination,39,19,20
20049,Effectz,ragnaros,1290,rogue,assassination,55,28,27
20050,Zizmo,deathwing,1284,rogue,assassination,60,20,40
20051,Mexxn,antonidas,1273,rogue,assassination,37,18,19
20052,Izze,thrall,1265,rogue,assassination,48,17,31
20053,Raiyqyu,archimonde,1263,rogue,assassination,63,29,34
20054,Veronkierto,stormreaver,1259,rogue,assassination,78,42,36
20055,Nukubu,draenor,1255,rogue,assassination,70,27,43
20056,Djnelly,stormreaver,1253,rogue,assassination,42,25,17
20057,Сайгакк,galakrond,1248,rogue,assassination,58,30,28
20058,Роземсти,gordunni,1247,rogue,assassination,36,19,17
20059,Sumiftw,drakthul,1244,rogue,assassination,36,13,23
20060,Zerocell,kazzak,1240,rogue,assassination,54,26,28
20061,Dime,silvermoon,1239,rogue,assassination,90,47,43
20062,Sáinz,malganis,1233,rogue,assassination,35,15,20
20063,Markø,twisting-nether,1229,rogue,assassination,30,13,17
20064,Nuguri,blackrock,1223,rogue,assassination,24,13,11
20065,Trollohlol,malganis,1220,rogue,assassination,36,17,19
20066,Luftpumpe,blackrock,1214,rogue,assassination,24,13,11
20067,Pitøu,outland,1205,rogue,assassination,36,17,19
20068,Kariinthuul,aegwynn,1205,rogue,assassination,48,20,28
20069,Bennyweth,argent-dawn,1205,rogue,assassination,42,16,26
20070,Sùbzerø,archimonde,1186,rogue,assassination,23,13,10
20071,Röllz,ysondre,1172,rogue,assassination,36,13,23
20072,Finanzamtlg,blackrock,1169,rogue,assassination,30,16,14
20073,Lelíth,ravencrest,1167,rogue,assassination,29,13,16
20074,Зоти,lich-king,1146,rogue,assassination,24,12,12
20075,Unshaken,dun-modr,1145,rogue,assassination,30,12,18
20076,Bonejaw,tarren-mill,1137,rogue,assassination,30,14,16
20077,Matchfixer,moonglade,1136,rogue,assassination,68,29,39
20078,Stôrpîx,drakthul,1131,rogue,assassination,26,12,14
20079,Цилана,gordunni,1122,rogue,assassination,24,14,10
20080,Missesinvis,blackmoore,1118,rogue,assassination,25,14,11
20081,Petsakos,ravencrest,1113,rogue,assassination,35,12,23
20082,Lastsight,burning-legion,1102,rogue,assassination,27,13,14
20083,Oshä,dalaran,1102,rogue,assassination,30,13,17
20084,Yvÿ,archimonde,1101,rogue,assassination,24,12,12
20085,Elûnè,silvermoon,1097,rogue,assassination,30,14,16
20086,Nevelon,chogall,1095,rogue,assassination,54,23,31
20087,Krimos,archimonde,1090,rogue,assassination,30,17,13
20088,Gravestam,sunstrider,1085,rogue,assassination,36,17,19
20089,Yokze,ravencrest,1085,rogue,assassination,36,12,24
20090,Alltaïr,ravencrest,1076,rogue,assassination,81,44,37
20091,Nighteshift,silvermoon,1064,rogue,assassination,36,14,22
20092,Azonaticus,hyjal,1059,rogue,assassination,28,13,15
20093,Boskönigt,ragnaros,1056,rogue,assassination,36,17,19
20094,Goshîmoshî,stormscale,1056,rogue,assassination,30,11,19
20095,Fatnutsac,eredar,1055,rogue,assassination,24,11,13
20096,Кайдарра,eversong,1045,rogue,assassination,24,11,13
20097,Zélla,twisting-nether,1044,rogue,assassination,24,11,13
20098,Pasarelo,dun-modr,1041,rogue,assassination,95,45,50
20099,Кэйлфрут,gordunni,1040,rogue,assassination,18,11,7
20100,Subyo,eredar,1038,rogue,assassination,30,11,19
20101,Sladen,ghostlands,1032,rogue,assassination,24,11,13
20102,Jupitor,argent-dawn,1030,rogue,assassination,36,16,20
20103,Dykumah,sanguino,1016,rogue,assassination,24,11,13
20104,Maroshko,argent-dawn,1015,rogue,assassination,23,11,12
20105,Swarge,silvermoon,1012,rogue,assassination,128,54,74
20106,Lesale,turalyon,1011,rogue,assassination,36,16,20
20107,Фуллблайнд,gordunni,1006,rogue,assassination,27,11,16
20108,Pinchoto,sanguino,1002,rogue,assassination,24,13,11
20109,Purplereign,frostmane,982,rogue,assassination,42,23,19
20110,Tirgo,aegwynn,961,rogue,assassination,72,34,38
20111,Blawann,argent-dawn,959,rogue,assassination,18,10,8
20112,Moneylake,stormscale,959,rogue,assassination,18,10,8
20113,Играючестно,howling-fjord,959,rogue,assassination,18,10,8
20114,Koopa,argent-dawn,959,rogue,assassination,42,10,32
20115,Лёнтролль,blackscar,958,rogue,assassination,18,10,8
20116,Кайсити,gordunni,958,rogue,assassination,18,10,8
20117,Poughkeepsie,outland,956,rogue,assassination,18,10,8
20118,Редфилд,blackscar,956,rogue,assassination,18,10,8
20119,Eightball,frostmane,954,rogue,assassination,18,10,8
20120,Gârrík,blackhand,954,rogue,assassination,18,10,8
20121,Noxxra,blackhand,954,rogue,assassination,24,10,14
20122,Raetoc,turalyon,951,rogue,assassination,18,10,8
20123,Джэкман,soulflayer,950,rogue,assassination,12,10,2
20124,Прнхабочка,gordunni,937,rogue,assassination,30,17,13
20125,Unterweger,die-aldor,902,rogue,assassination,17,10,7
20126,Dallrend,stormscale,902,rogue,assassination,48,17,31
20127,Márto,archimonde,896,rogue,assassination,22,10,12
20128,Jústina,die-aldor,894,rogue,assassination,48,19,29
20129,Ороти,greymane,891,rogue,assassination,20,12,8
20130,Макггара,soulflayer,884,rogue,assassination,131,58,73
20131,Løuvees,archimonde,881,rogue,assassination,64,29,35
20132,Undîsputed,blackmoore,879,rogue,assassination,33,10,23
20133,Skýhigh,ravencrest,864,rogue,assassination,12,9,3
20134,Ålùnæh,azjolnerub,864,rogue,assassination,18,9,9
20135,Sadìra,echsenkessel,864,rogue,assassination,18,9,9
20136,Mortecieca,ravencrest,864,rogue,assassination,18,9,9
20137,Grøax,ragnaros,864,rogue,assassination,18,9,9
20138,Tyreall,drakthul,864,rogue,assassination,24,9,15
20139,Angeldarky,silvermoon,864,rogue,assassination,24,9,15
20140,Xeeana,ravencrest,863,rogue,assassination,12,9,3
20141,Npkx,outland,863,rogue,assassination,24,9,15
20142,Erion,silvermoon,863,rogue,assassination,24,9,15
20143,Artésia,archimonde,862,rogue,assassination,18,9,9
20144,Асиксх,blackscar,859,rogue,assassination,24,9,15
20145,Babysteps,the-maelstrom,856,rogue,assassination,18,9,9
20146,Norlix,ravencrest,856,rogue,assassination,18,9,9
20147,Seleyese,draenor,849,rogue,assassination,18,9,9
20148,Kuxion,zuljin,847,rogue,assassination,24,10,14
20149,Паштетмашин,booty-bay,841,rogue,assassination,18,9,9
20150,Reginlief,argent-dawn,835,rogue,assassination,44,22,22
20151,Dmfd,darksorrow,835,rogue,assassination,75,30,45
20152,Lorena,ravencrest,826,rogue,assassination,17,9,8
20153,Îlihad,zuljin,824,rogue,assassination,42,16,26
20154,Gillette,guldan,821,rogue,assassination,54,21,33
20155,Yuffi,ysondre,803,rogue,assassination,23,11,12
20156,Sospiro,nemesis,779,rogue,assassination,22,9,13
20157,Mewen,sanguino,768,rogue,assassination,12,8,4
20158,Kidneyou,ragnaros,768,rogue,assassination,12,8,4
20159,Limítless,tarren-mill,768,rogue,assassination,12,8,4
20160,Botsrogue,kazzak,768,rogue,assassination,18,8,10
20161,Onlyluvhurt,dun-modr,768,rogue,assassination,24,8,16
20162,Meldee,burning-legion,767,rogue,assassination,18,8,10
20163,Obsçuritý,ragnaros,765,rogue,assassination,16,9,7
20164,Zobrak,twisting-nether,765,rogue,assassination,18,8,10
20165,Lixht,the-maelstrom,764,rogue,assassination,18,8,10
20166,Giftknirps,silvermoon,758,rogue,assassination,18,8,10
20167,Parker,frostmane,758,rogue,assassination,24,8,16
20168,Куррвабобер,borean-tundra,756,rogue,assassination,18,8,10
20169,Tre,eredar,746,rogue,assassination,24,8,16
20170,Rahes,stormscale,731,rogue,assassination,35,8,27
20171,Dredge,kaelthas,675,rogue,assassination,31,11,20
20172,Stabbinu,burning-legion,672,rogue,assassination,12,7,5
20173,Köna,archimonde,672,rogue,assassination,18,7,11
20174,Zilemjr,stormscale,672,rogue,assassination,18,7,11
20175,Eeros,kazzak,672,rogue,assassination,18,7,11
20176,Luketherogue,twisting-nether,672,rogue,assassination,24,7,17
20177,Ámbush,sylvanas,672,rogue,assassination,24,7,17
20178,Загляденье,gordunni,672,rogue,assassination,24,7,17
20179,Rikdy,kazzak,672,rogue,assassination,30,7,23
20180,Givewallet,ravencrest,671,rogue,assassination,12,7,5
20181,Kuzmin,die-aldor,671,rogue,assassination,18,7,11
20182,Yassu,archimonde,671,rogue,assassination,18,7,11
20183,Поздоровайся,howling-fjord,670,rogue,assassination,12,7,5
20184,Скулипёс,howling-fjord,667,rogue,assassination,12,7,5
20185,Rogunelf,stormreaver,666,rogue,assassination,12,7,5
20186,Ashami,genjuros,666,rogue,assassination,18,7,11
20187,Imdma,defias-brotherhood,658,rogue,assassination,18,7,11
20188,Niapro,dun-morogh,653,rogue,assassination,17,7,10
20189,Ripgore,sylvanas,639,rogue,assassination,17,7,10
20190,Mozenn,draenor,622,rogue,assassination,15,7,8
20191,Bensollo,tarren-mill,622,rogue,assassination,17,7,10
20192,Attylaria,rexxar,576,rogue,assassination,12,6,6
20193,Mollyperph,ravencrest,576,rogue,assassination,12,6,6
20194,Lôre,blackrock,576,rogue,assassination,12,6,6
20195,Dîspatchx,defias-brotherhood,576,rogue,assassination,12,6,6
20196,Voetdown,blackmoore,576,rogue,assassination,12,6,6
20197,Shadowcralls,blackmoore,576,rogue,assassination,12,6,6
20198,Lildretch,dun-morogh,576,rogue,assassination,12,6,6
20199,Diagnoze,silvermoon,576,rogue,assassination,12,6,6
20200,Sachsun,outland,576,rogue,assassination,12,6,6
20201,Flopsy,archimonde,576,rogue,assassination,12,6,6
20202,Sneakypeeki,sylvanas,576,rogue,assassination,12,6,6
20203,Ритор,deathguard,576,rogue,assassination,12,6,6
20204,Изифаза,deathguard,576,rogue,assassination,12,6,6
20205,Røler,ravencrest,576,rogue,assassination,18,6,12
20206,Blooddance,ragnaros,576,rogue,assassination,18,6,12
20207,Malvaxxs,tarren-mill,575,rogue,assassination,12,6,6
20208,Rbgdowngrade,ravencrest,575,rogue,assassination,12,6,6
20209,Madlain,jaedenar,575,rogue,assassination,12,6,6
20210,Peqpen,ravencrest,575,rogue,assassination,12,6,6
20211,Hmwow,kazzak,575,rogue,assassination,12,6,6
20212,Mystykal,twisting-nether,575,rogue,assassination,12,6,6
20213,Chalkbag,blackrock,575,rogue,assassination,18,6,12
20214,Cbrook,sylvanas,575,rogue,assassination,18,6,12
20215,Fkuwu,dalaran,575,rogue,assassination,24,6,18
20216,Kuttunga,ravencrest,574,rogue,assassination,12,6,6
20217,Outofstuns,earthen-ring,574,rogue,assassination,18,7,11
20218,Tubes,dun-morogh,573,rogue,assassination,6,6,0
20219,Letheus,stormscale,573,rogue,assassination,18,6,12
20220,Snakeshiv,ravenholdt,569,rogue,assassination,12,6,6
20221,Tc,doomhammer,568,rogue,assassination,12,6,6
20222,Симус,lich-king,568,rogue,assassination,12,6,6
20223,Dezxxyox,dun-modr,568,rogue,assassination,18,6,12
20224,Mores,anetheron,565,rogue,assassination,18,6,12
20225,Ûltraaxx,ysondre,528,rogue,assassination,15,6,9
20226,Stonyhavana,ravencrest,527,rogue,assassination,11,6,5
20227,Babouill,ysondre,480,rogue,assassination,6,5,1
20228,Ðescartes,antonidas,480,rogue,assassination,6,5,1
20229,Fixsap,aegwynn,480,rogue,assassination,12,5,7
20230,Ghðst,stormscale,480,rogue,assassination,12,5,7
20231,Рэкрейвон,gordunni,480,rogue,assassination,12,5,7
20232,Bronxbomber,tarren-mill,480,rogue,assassination,12,5,7
20233,Patryk,silvermoon,480,rogue,assassination,12,5,7
20234,Йоио,howling-fjord,480,rogue,assassination,12,5,7
20235,Иллвилл,soulflayer,480,rogue,assassination,12,5,7
20236,Liraia,eredar,480,rogue,assassination,12,5,7
20237,Кишмякх,howling-fjord,480,rogue,assassination,12,5,7
20238,Gögel,draenor,480,rogue,assassination,12,5,7
20239,Uzrigu,tarren-mill,480,rogue,assassination,12,5,7
20240,Morgan,argent-dawn,480,rogue,assassination,12,5,7
20241,Malatang,thrall,480,rogue,assassination,12,5,7
20242,Aikaza,blackmoore,480,rogue,assassination,12,5,7
20243,Sneakysloth,ravencrest,480,rogue,assassination,17,5,12
20244,Stealthi,stormscale,480,rogue,assassination,18,5,13
20245,Gankbang,frostmane,480,rogue,assassination,18,5,13
20246,Republicano,cthun,480,rogue,assassination,18,5,13
20247,Ambushgirl,ravencrest,480,rogue,assassination,18,5,13
20248,Wrathed,stormreaver,480,rogue,assassination,18,5,13
20249,Exanimu,ravencrest,480,rogue,assassination,18,5,13
20250,Vizifyx,ravencrest,480,rogue,assassination,24,5,19
20251,Траста,fordragon,480,rogue,assassination,24,5,19
20252,Хэресс,soulflayer,479,rogue,assassination,6,5,1
20253,Shadowfangs,ravencrest,479,rogue,assassination,12,5,7
20254,Nargun,archimonde,479,rogue,assassination,12,5,7
20255,Leÿji,archimonde,479,rogue,assassination,12,5,7
20256,Pathicus,stormreaver,479,rogue,assassination,12,5,7
20257,Azovrouge,terokkar,478,rogue,assassination,12,5,7
20258,Razboy,dun-morogh,475,rogue,assassination,12,5,7
20259,Owlcat,argent-dawn,475,rogue,assassination,12,5,7
20260,Deragur,antonidas,474,rogue,assassination,12,5,7
20261,Наджийа,lich-king,473,rogue,assassination,12,5,7
20262,Blackone,nemesis,473,rogue,assassination,18,5,13
20263,Tranxéne,hyjal,472,rogue,assassination,12,5,7
20264,Intecto,twisting-nether,448,rogue,assassination,10,5,5
20265,Griveous,kazzak,447,rogue,assassination,8,6,2
20266,Якунька,soulflayer,447,rogue,assassination,11,5,6
20267,Deevoll,tarren-mill,447,rogue,assassination,20,6,14
20268,Refundlands,kazzak,426,rogue,assassination,15,6,9
20269,Mâêl,blackmoore,426,rogue,assassination,16,6,10
20270,Bluehell,sanguino,415,rogue,assassination,10,5,5
20271,Bauwten,ravencrest,392,rogue,assassination,18,7,11
20272,Parawietje,twilights-hammer,384,rogue,assassination,6,4,2
20273,Jaxck,sylvanas,384,rogue,assassination,6,4,2
20274,Mouchess,hyjal,384,rogue,assassination,6,4,2
20275,Дикийминус,howling-fjord,384,rogue,assassination,6,4,2
20276,Бейнс,howling-fjord,384,rogue,assassination,6,4,2
20277,Sayianwho,ravencrest,384,rogue,assassination,6,4,2
20278,Tebzr,ravencrest,384,rogue,assassination,6,4,2
20279,Аязлаая,blackscar,384,rogue,assassination,6,4,2
20280,Лиринэлла,soulflayer,384,rogue,assassination,6,4,2
20281,Ebayscammer,ravencrest,384,rogue,assassination,6,4,2
20282,Whosmanz,ragnaros,384,rogue,assassination,6,4,2
20283,Имилиона,blackscar,384,rogue,assassination,6,4,2
20284,Justkiddning,blackmoore,384,rogue,assassination,6,4,2
20285,Zerfex,eredar,384,rogue,assassination,6,4,2
20286,Биокарлик,soulflayer,384,rogue,assassination,6,4,2
20287,Juicedaddy,argent-dawn,384,rogue,assassination,6,4,2
20288,Sîccarîus,ravencrest,384,rogue,assassination,6,4,2
20289,Myk,ravencrest,384,rogue,assassination,6,4,2
20290,Awakeaf,outland,384,rogue,assassination,6,4,2
20291,Brunhityx,ravencrest,384,rogue,assassination,6,4,2
20292,Mïkasa,ysondre,384,rogue,assassination,6,4,2
20293,Brñ,ravencrest,384,rogue,assassination,6,4,2
20294,Únk,dalaran,384,rogue,assassination,9,5,4
20295,Juxtapose,ravencrest,384,rogue,assassination,12,4,8
20296,Achterom,tarren-mill,384,rogue,assassination,12,4,8
20297,Fálke,dun-modr,384,rogue,assassination,12,4,8
20298,Röguetönerö,dun-modr,384,rogue,assassination,12,4,8
20299,Stepbrogue,tarren-mill,384,rogue,assassination,12,4,8
20300,Crimatoria,rajaxx,384,rogue,assassination,12,4,8
20301,Гранетанцор,blackscar,384,rogue,assassination,12,4,8
20302,Darkchomeur,archimonde,384,rogue,assassination,12,4,8
20303,Honeycakes,ravencrest,384,rogue,assassination,12,4,8
20304,Paidaki,kazzak,384,rogue,assassination,12,4,8
20305,Pizzayamyam,aegwynn,384,rogue,assassination,12,4,8
20306,Stepkickgodx,blackmoore,384,rogue,assassination,12,4,8
20307,Doomdagger,chamber-of-aspects,384,rogue,assassination,12,4,8
20308,Meimei,sanguino,384,rogue,assassination,12,4,8
20309,Feucht,argent-dawn,384,rogue,assassination,12,4,8
20310,Noxxy,archimonde,384,rogue,assassination,12,4,8
20311,Лайнэл,deathweaver,384,rogue,assassination,18,4,14
20312,Ibizà,ravencrest,384,rogue,assassination,18,4,14
20313,Zerö,tarren-mill,384,rogue,assassination,18,4,14
20314,Gorgeousréd,aegwynn,384,rogue,assassination,18,4,14
20315,Vexedancer,stormscale,383,rogue,assassination,6,4,2
20316,Opiïum,ysondre,383,rogue,assassination,6,4,2
20317,Килларан,howling-fjord,383,rogue,assassination,6,4,2
20318,Whiz,alexstrasza,383,rogue,assassination,15,5,10
20319,Silksneak,kazzak,383,rogue,assassination,12,4,8
20320,Obbexd,outland,383,rogue,assassination,12,4,8
20321,Kyzzo,dalaran,383,rogue,assassination,12,4,8
20322,Töbïï,sylvanas,383,rogue,assassination,12,4,8
20323,Satiiva,terokkar,383,rogue,assassination,18,4,14
20324,Twinkyzzö,archimonde,382,rogue,assassination,12,4,8
20325,Sessanali,silvermoon,382,rogue,assassination,24,4,20
20326,Møkkagnom,darkspear,381,rogue,assassination,12,4,8
20327,Stealtheous,arathor,367,rogue,assassination,11,4,7
20328,Ressputini,emeriss,366,rogue,assassination,11,4,7
20329,Стронг,soulflayer,352,rogue,assassination,10,4,6
20330,Stælf,argent-dawn,352,rogue,assassination,16,4,12
20331,Lilbubblegum,emerald-dream,351,rogue,assassination,11,4,7
20332,Voraq,blackhand,350,rogue,assassination,11,4,7
20333,Riskyx,draenor,304,rogue,assassination,7,4,3
20334,Jupezii,stormreaver,288,rogue,assassination,6,3,3
20335,Izzyb,auchindoun,288,rogue,assassination,6,3,3
20336,Охотникведьм,soulflayer,288,rogue,assassination,6,3,3
20337,Redcutter,silvermoon,288,rogue,assassination,6,3,3
20338,Smorcoolio,stormscale,288,rogue,assassination,6,3,3
20339,Dnw,ravencrest,288,rogue,assassination,6,3,3
20340,Anhduy,blackrock,288,rogue,assassination,6,3,3
20341,Exiv,ragnaros,288,rogue,assassination,6,3,3
20342,Luciferx,stormscale,288,rogue,assassination,6,3,3
20343,Mordred,stormscale,288,rogue,assassination,6,3,3
20344,Ingesa,blackhand,288,rogue,assassination,6,3,3
20345,Tiazx,outland,288,rogue,assassination,6,3,3
20346,Psg,argent-dawn,288,rogue,assassination,6,3,3
20347,Shâdowfreeze,onyxia,288,rogue,assassination,6,3,3
20348,Stealthyist,darkmoon-faire,288,rogue,assassination,6,3,3
20349,Котянкахд,howling-fjord,288,rogue,assassination,6,3,3
20350,Lïhtêñßërg,ravencrest,288,rogue,assassination,6,3,3
20351,Myxx,ravencrest,288,rogue,assassination,6,3,3
20352,Brazi,dalaran,288,rogue,assassination,6,3,3
20353,Lättja,hyjal,288,rogue,assassination,6,3,3
20354,Dé,ragnaros,288,rogue,assassination,6,3,3
20355,Ракфорн,howling-fjord,288,rogue,assassination,6,3,3
20356,Hì,bronzebeard,288,rogue,assassination,6,3,3
20357,Sâtýr,ravencrest,288,rogue,assassination,6,3,3
20358,Stroògz,ysondre,288,rogue,assassination,6,3,3
20359,Bumaqt,silvermoon,288,rogue,assassination,12,3,9
20360,Mindset,eredar,288,rogue,assassination,12,3,9
20361,Kyropth,eredar,288,rogue,assassination,12,3,9
20362,Rîg,draenor,288,rogue,assassination,12,3,9
20363,Nezuko,gilneas,288,rogue,assassination,12,3,9
20364,Курога,howling-fjord,288,rogue,assassination,12,3,9
20365,Ryurfy,archimonde,288,rogue,assassination,12,3,9
20366,Hersuub,blackmoore,288,rogue,assassination,12,3,9
20367,Madisonivyqt,blackmoore,288,rogue,assassination,12,3,9
20368,Persës,outland,288,rogue,assassination,12,3,9
20369,Lacusdark,draenor,288,rogue,assassination,12,3,9
20370,Milenia,thrall,288,rogue,assassination,12,3,9
20371,Jáyjay,antonidas,288,rogue,assassination,18,3,15
20372,Экичу,howling-fjord,287,rogue,assassination,6,3,3
20373,Willin,kazzak,287,rogue,assassination,6,3,3
20374,Pumpy,blades-edge,287,rogue,assassination,6,3,3
20375,Гламурятина,gordunni,287,rogue,assassination,6,3,3
20376,Nastyrogue,burning-legion,287,rogue,assassination,12,3,9
20377,Jacksoon,dun-morogh,287,rogue,assassination,12,3,9
20378,Verbb,turalyon,284,rogue,assassination,12,3,9
20379,Fizzkhalifa,zuljin,284,rogue,assassination,12,3,9
20380,Blckrogue,bloodfeather,240,rogue,assassination,9,3,6
20381,Alpinestars,dun-modr,239,rogue,assassination,5,3,2
20382,Starkad,archimonde,239,rogue,assassination,5,3,2
20383,Rhâpsødýx,twisting-nether,234,rogue,assassination,8,4,4
20384,Psybelette,khaz-modan,192,rogue,assassination,9,3,6
20385,Highz,zenedar,192,rogue,assassination,6,2,4
20386,Ichiegoichie,draenor,192,rogue,assassination,6,2,4
20387,Althieves,ravencrest,192,rogue,assassination,6,2,4
20388,Fushimi,ravencrest,192,rogue,assassination,6,2,4
20389,Rearmer,burning-legion,192,rogue,assassination,6,2,4
20390,Bangerstab,draenor,192,rogue,assassination,6,2,4
20391,Кашеварить,gordunni,192,rogue,assassination,6,2,4
20392,Ач,gordunni,192,rogue,assassination,6,2,4
20393,Нойсеен,gordunni,192,rogue,assassination,6,2,4
20394,Snurry,tarren-mill,192,rogue,assassination,6,2,4
20395,Diliu,doomhammer,192,rogue,assassination,6,2,4
20396,Лунари,blackscar,192,rogue,assassination,6,2,4
20397,Hideout,ravencrest,192,rogue,assassination,6,2,4
20398,Synexo,sylvanas,192,rogue,assassination,6,2,4
20399,Tinta,aszune,192,rogue,assassination,6,2,4
20400,Horvathzu,ravencrest,192,rogue,assassination,6,2,4
20401,Eriksonn,drakthul,192,rogue,assassination,6,2,4
20402,Bhabì,uldaman,192,rogue,assassination,6,2,4
20403,Helcof,emerald-dream,192,rogue,assassination,6,2,4
20404,Teldã,archimonde,192,rogue,assassination,6,2,4
20405,Díddz,tarren-mill,192,rogue,assassination,6,2,4
20406,Xanyy,bloodfeather,192,rogue,assassination,6,2,4
20407,Сабстрайк,soulflayer,192,rogue,assassination,6,2,4
20408,Zyphion,ragnaros,192,rogue,assassination,6,2,4
20409,Maxrizzx,ravencrest,192,rogue,assassination,6,2,4
20410,Китей,howling-fjord,192,rogue,assassination,6,2,4
20411,Kikitaklk,uldum,192,rogue,assassination,6,2,4
20412,Flogue,area-52,192,rogue,assassination,6,2,4
20413,Katara,antonidas,192,rogue,assassination,6,2,4
20414,Jonewrld,ravencrest,192,rogue,assassination,6,2,4
20415,Yanlu,ysondre,192,rogue,assassination,6,2,4
20416,Schníttchen,antonidas,192,rogue,assassination,6,2,4
20417,Хулиганнчег,galakrond,192,rogue,assassination,6,2,4
20418,Mallaurya,dalaran,192,rogue,assassination,6,2,4
20419,Саулите,deathguard,192,rogue,assassination,6,2,4
20420,Xeggy,turalyon,192,rogue,assassination,6,2,4
20421,Norpz,aggra-português,192,rogue,assassination,6,2,4
20422,Gane,sanguino,192,rogue,assassination,6,2,4
20423,Tofix,tarren-mill,192,rogue,assassination,6,2,4
20424,Kenjí,silvermoon,192,rogue,assassination,6,2,4
20425,Naí,zuljin,192,rogue,assassination,6,2,4
20426,Zømbië,kazzak,192,rogue,assassination,6,2,4
20427,Eazmode,outland,192,rogue,assassination,6,2,4
20428,Sokillu,silvermoon,192,rogue,assassination,6,2,4
20429,Vanisha,outland,192,rogue,assassination,6,2,4
20430,Halucinogeno,silvermoon,192,rogue,assassination,6,2,4
20431,Jeruna,veklor,192,rogue,assassination,6,2,4
20432,Saix,blackrock,192,rogue,assassination,6,2,4
20433,Waltër,tyrande,192,rogue,assassination,6,2,4
20434,Fälke,dun-modr,192,rogue,assassination,6,2,4
20435,Nudelholz,blackrock,192,rogue,assassination,6,2,4
20436,Shúrae,blackmoore,192,rogue,assassination,6,2,4
20437,Стеллакокс,howling-fjord,192,rogue,assassination,8,2,6
20438,Sythex,archimonde,192,rogue,assassination,12,2,10
20439,Mingzhu,ravencrest,192,rogue,assassination,12,2,10
20440,Cacucoxpahu,kazzak,192,rogue,assassination,12,2,10
20441,Sneakzy,sylvanas,192,rogue,assassination,12,2,10
20442,Romiel,ravencrest,192,rogue,assassination,12,2,10
20443,Лэйкиро,gordunni,192,rogue,assassination,12,2,10
20444,Baboonx,burning-legion,192,rogue,assassination,12,2,10
20445,Azzmodia,aegwynn,192,rogue,assassination,12,2,10
20446,Vezinia,ravencrest,192,rogue,assassination,12,2,10
20447,Бонасера,blackscar,192,rogue,assassination,12,2,10
20448,Sheyrrà,aegwynn,192,rogue,assassination,12,2,10
20449,Stonecold,twilights-hammer,192,rogue,assassination,12,2,10
20450,Coopér,argent-dawn,192,rogue,assassination,18,2,16
20451,Вотымразь,howling-fjord,191,rogue,assassination,6,2,4
20452,Drexxo,drakthul,191,rogue,assassination,6,2,4
20453,Nhot,kazzak,191,rogue,assassination,6,2,4
20454,Rêdbello,dun-morogh,191,rogue,assassination,6,2,4
20455,Easy,kult-der-verdammten,190,rogue,assassination,12,2,10
20456,Eljana,amanthul,185,rogue,assassination,14,4,10
20457,Sanzoo,blackmoore,175,rogue,assassination,11,2,9
20458,Icyicé,kazzak,175,rogue,assassination,11,2,9
20459,Knockyz,khaz-modan,135,rogue,assassination,13,3,10
20460,Totentánz,silvermoon,96,rogue,assassination,9,2,7
20461,Drillss,ravencrest,96,rogue,assassination,10,2,8
20462,Myk,xavius,96,rogue,assassination,6,1,5
20463,Ристоврация,gordunni,96,rogue,assassination,6,1,5
20464,Yörgs,eredar,96,rogue,assassination,6,1,5
20465,Трисися,gordunni,96,rogue,assassination,6,1,5
20466,Mol,defias-brotherhood,96,rogue,assassination,6,1,5
20467,Shåkø,tarren-mill,96,rogue,assassination,6,1,5
20468,Azotix,archimonde,96,rogue,assassination,6,1,5
20469,Метаболикх,gordunni,96,rogue,assassination,6,1,5
20470,Ðiè,frostmane,96,rogue,assassination,6,1,5
20471,Penetrantos,eredar,96,rogue,assassination,6,1,5
20472,Кейнилин,gordunni,96,rogue,assassination,6,1,5
20473,Chokee,blackrock,96,rogue,assassination,6,1,5
20474,Ñavy,archimonde,96,rogue,assassination,6,1,5
20475,Aknana,vashj,96,rogue,assassination,6,1,5
20476,Msrogue,eredar,96,rogue,assassination,6,1,5
20477,Kilabre,twisting-nether,96,rogue,assassination,6,1,5
20478,Dravenfoot,defias-brotherhood,96,rogue,assassination,6,1,5
20479,Kenko,aerie-peak,96,rogue,assassination,6,1,5
20480,Asmodal,antonidas,96,rogue,assassination,6,1,5
20481,Krymziàâ,hyjal,96,rogue,assassination,6,1,5
20482,Vanisshh,hyjal,96,rogue,assassination,6,1,5
20483,Ohmydotz,archimonde,96,rogue,assassination,6,1,5
20484,Wøølfgang,archimonde,96,rogue,assassination,6,1,5
20485,Рестинписер,soulflayer,96,rogue,assassination,6,1,5
20486,Hitogoroshi,hyjal,96,rogue,assassination,6,1,5
20487,Chøsen,stormscale,96,rogue,assassination,6,1,5
20488,Jimaal,stormscale,96,rogue,assassination,6,1,5
20489,Missàh,archimonde,96,rogue,assassination,6,1,5
20490,Ogc,draenor,96,rogue,assassination,6,1,5
20491,Frequenzalfa,silvermoon,96,rogue,assassination,6,1,5
20492,Yamoshí,sanguino,96,rogue,assassination,6,1,5
20493,Royalflüx,grim-batol,96,rogue,assassination,6,1,5
20494,Sickko,stormscale,96,rogue,assassination,6,1,5
20495,Miiløx,silvermoon,96,rogue,assassination,6,1,5
20496,Matarocho,ravencrest,96,rogue,assassination,6,1,5
20497,Sly,emerald-dream,96,rogue,assassination,6,1,5
20498,Jawen,silvermoon,96,rogue,assassination,12,1,11
20499,Tybiereus,argent-dawn,96,rogue,assassination,12,1,11
20500,Elvís,chamber-of-aspects,95,rogue,assassination,6,1,5
20501,Trashcarlitâ,eredar,79,rogue,assassination,5,1,4
20502,Layson,les-clairvoyants,79,rogue,assassination,5,1,4
20503,Maelithas,archimonde,79,rogue,assassination,11,1,10
20504,Kebabgodx,sanguino,31,rogue,assassination,2,1,1
20505,Shadrak,eredar,2123,shaman,restoration,84,46,38
20506,Crnine,pozzo-delleternità,2112,shaman,restoration,75,49,26
20507,Дольчих,deathguard,2103,shaman,restoration,110,53,57
20508,Josë,twisting-nether,2095,shaman,restoration,95,52,43
20509,Benpai,eredar,2076,shaman,restoration,72,36,36
20510,Ultrahound,twisting-nether,2057,shaman,restoration,48,39,9
20511,Trashgame,kazzak,2050,shaman,restoration,66,36,30
20512,Мефодийшаман,howling-fjord,2038,shaman,restoration,72,51,21
20513,Джексобед,soulflayer,2026,shaman,restoration,132,69,63
20514,Deepwithyou,blackhand,2005,shaman,restoration,135,76,59
20515,Yararsiz,twisting-nether,2004,shaman,restoration,159,86,73
20516,Bmbx,archimonde,1979,shaman,restoration,185,100,85
20517,Драгенхз,gordunni,1970,shaman,restoration,304,154,150
20518,Sentûn,blackrock,1960,shaman,restoration,103,56,47
20519,Цукерок,soulflayer,1958,shaman,restoration,84,56,28
20520,Epsylone,kazzak,1953,shaman,restoration,101,51,50
20521,Linkx,stormscale,1948,shaman,restoration,40,22,18
20522,Thunderrock,stormreaver,1942,shaman,restoration,122,61,61
20523,Valko,hellfire,1931,shaman,restoration,42,27,15
20524,Daretodream,blackrock,1921,shaman,restoration,48,24,24
20525,Cylantarus,blackrock,1913,shaman,restoration,83,50,33
20526,Carlpeant,drakthul,1913,shaman,restoration,95,49,46
20527,Skreewu,outland,1908,shaman,restoration,78,37,41
20528,Adroda,kazzak,1907,shaman,restoration,81,46,35
20529,Трс,razuvious,1892,shaman,restoration,122,69,53
20530,Frshprn,hyjal,1883,shaman,restoration,54,31,23
20531,Mininini,ravencrest,1880,shaman,restoration,60,29,31
20532,Sèfìx,tarren-mill,1879,shaman,restoration,38,21,17
20533,Owrly,stormscale,1878,shaman,restoration,106,51,55
20534,Jackypink,ragnaros,1878,shaman,restoration,99,45,54
20535,Kïllard,archimonde,1872,shaman,restoration,74,37,37
20536,Timide,ravencrest,1870,shaman,restoration,48,28,20
20537,Teldathree,archimonde,1866,shaman,restoration,95,51,44
20538,Keenxd,burning-legion,1861,shaman,restoration,42,23,19
20539,Louler,ragnaros,1860,shaman,restoration,124,69,55
20540,Tallyx,ravencrest,1855,shaman,restoration,72,34,38
20541,Yachiru,sylvanas,1854,shaman,restoration,73,59,14
20542,Swkx,dun-modr,1848,shaman,restoration,58,34,24
20543,Sugarfreé,ragnaros,1848,shaman,restoration,48,26,22
20544,Cæsífer,blackrock,1844,shaman,restoration,72,32,40
20545,Helloiamdoni,ravencrest,1843,shaman,restoration,101,63,38
20546,Sinzzu,ragnaros,1838,shaman,restoration,150,76,74
20547,Zhull,ravencrest,1836,shaman,restoration,144,65,79
20548,Centralc,twisting-nether,1833,shaman,restoration,41,26,15
20549,Ggnore,kazzak,1832,shaman,restoration,72,47,25
20550,Shiranoye,blackrock,1831,shaman,restoration,120,65,55
20551,Jawje,tarren-mill,1831,shaman,restoration,102,49,53
20552,Shamuunn,ravencrest,1830,shaman,restoration,54,28,26
20553,Sethrøllins,hyjal,1829,shaman,restoration,114,53,61
20554,Fitnessdavid,ravencrest,1826,shaman,restoration,53,29,24
20555,Zergønk,ravencrest,1824,shaman,restoration,42,28,14
20556,Bladeyx,ragnaros,1824,shaman,restoration,207,117,90
20557,Lunarsloths,hyjal,1823,shaman,restoration,48,28,20
20558,Shamrockx,outland,1816,shaman,restoration,83,42,41
20559,Shockmelone,blackrock,1812,shaman,restoration,84,45,39
20560,Carpetmaster,ragnaros,1812,shaman,restoration,51,27,24
20561,Нойзблок,gordunni,1811,shaman,restoration,36,19,17
20562,Tidepog,ravencrest,1810,shaman,restoration,60,28,32
20563,Fuzzynuts,ravencrest,1808,shaman,restoration,132,74,58
20564,Онеоне,deathweaver,1807,shaman,restoration,53,31,22
20565,Kreamcake,bladefist,1807,shaman,restoration,96,43,53
20566,Nokster,twisting-nether,1806,shaman,restoration,84,60,24
20567,Greggyb,twisting-nether,1805,shaman,restoration,36,22,14
20568,Neou,archimonde,1803,shaman,restoration,54,27,27
20569,Luckymê,blackrock,1802,shaman,restoration,51,27,24
20570,Милфшама,blackscar,1802,shaman,restoration,239,123,116
20571,Stensham,stormreaver,1801,shaman,restoration,48,28,20
20572,Kiansham,silvermoon,1801,shaman,restoration,47,26,21
20573,Rottulos,stormrage,1797,shaman,restoration,53,32,21
20574,Kisshots,the-maelstrom,1794,shaman,restoration,48,23,25
20575,Awcchampion,stormscale,1793,shaman,restoration,179,106,73
20576,Phaynozx,cthun,1790,shaman,restoration,90,38,52
20577,Wíllz,ravencrest,1787,shaman,restoration,48,25,23
20578,Fufupartyxx,blackrock,1785,shaman,restoration,30,19,11
20579,Hexe,kazzak,1783,shaman,restoration,75,32,43
20580,Midgetfizzle,kazzak,1778,shaman,restoration,100,50,50
20581,Szellento,darksorrow,1770,shaman,restoration,60,30,30
20582,Johncoltrane,archimonde,1765,shaman,restoration,84,57,27
20583,Kraksham,ravencrest,1765,shaman,restoration,106,58,48
20584,Shamolili,stormscale,1764,shaman,restoration,96,48,48
20585,Bstr,frostmane,1763,shaman,restoration,60,30,30
20586,Ihealbro,blackrock,1762,shaman,restoration,66,41,25
20587,Windfúhrèr,tarren-mill,1759,shaman,restoration,60,26,34
20588,Эоя,howling-fjord,1758,shaman,restoration,132,66,66
20589,Harmony,outland,1746,shaman,restoration,30,22,8
20590,Palfe,khaz-modan,1746,shaman,restoration,93,46,47
20591,Karakoram,ysondre,1742,shaman,restoration,53,32,21
20592,Purgeluxe,aegwynn,1740,shaman,restoration,59,32,27
20593,Hugox,outland,1740,shaman,restoration,48,20,28
20594,Donv,blackmoore,1739,shaman,restoration,42,26,16
20595,Somethingnew,azuremyst,1739,shaman,restoration,52,25,27
20596,Waramors,eredar,1738,shaman,restoration,125,62,63
20597,Machmacan,argent-dawn,1735,shaman,restoration,86,47,39
20598,Ixxmre,blackrock,1731,shaman,restoration,125,68,57
20599,Lavalavalava,blackrock,1728,shaman,restoration,231,124,107
20600,Агентхолинки,gordunni,1726,shaman,restoration,24,18,6
20601,Arslos,twisting-nether,1723,shaman,restoration,30,24,6
20602,Sheargodx,blackmoore,1723,shaman,restoration,42,21,21
20603,Wess,archimonde,1722,shaman,restoration,36,18,18
20604,Bezixx,ravencrest,1715,shaman,restoration,120,69,51
20605,Lahey,draenor,1711,shaman,restoration,140,73,67
20606,Totembaws,blackmoore,1708,shaman,restoration,54,26,28
20607,Ларкуш,howling-fjord,1707,shaman,restoration,82,44,38
20608,Чинанрук,howling-fjord,1706,shaman,restoration,89,45,44
20609,Darnast,draenor,1706,shaman,restoration,52,25,27
20610,Connecting,hyjal,1704,shaman,restoration,39,21,18
20611,Мвнз,soulflayer,1700,shaman,restoration,54,22,32
20612,Goeller,stormscale,1698,shaman,restoration,42,23,19
20613,Wacomtablet,kazzak,1690,shaman,restoration,24,18,6
20614,Вишняблэйз,soulflayer,1684,shaman,restoration,41,24,17
20615,Сорит,blackscar,1678,shaman,restoration,45,28,17
20616,Dóómhammer,jaedenar,1677,shaman,restoration,30,18,12
20617,Learningsham,destromath,1676,shaman,restoration,30,21,9
20618,Turboeddy,blackmoore,1675,shaman,restoration,49,32,17
20619,Mbembe,blackhand,1674,shaman,restoration,48,26,22
20620,Hexmeqt,frostwolf,1673,shaman,restoration,78,47,31
20621,Indeed,frostmourne,1672,shaman,restoration,36,23,13
20622,Porkzzila,aggra-português,1671,shaman,restoration,60,34,26
20623,Skrewu,stormscale,1671,shaman,restoration,79,39,40
20624,Кикподхвост,soulflayer,1670,shaman,restoration,54,26,28
20625,Sérx,sanguino,1669,shaman,restoration,47,20,27
20626,Tùiðhânâ,ravencrest,1668,shaman,restoration,42,22,20
20627,Reäz,archimonde,1665,shaman,restoration,42,21,21
20628,Héxdóctór,ravencrest,1664,shaman,restoration,86,48,38
20629,Meöw,nemesis,1664,shaman,restoration,172,84,88
20630,Atwâ,ravencrest,1663,shaman,restoration,51,31,20
20631,Brandiløve,nemesis,1663,shaman,restoration,36,19,17
20632,Crmx,blackrock,1657,shaman,restoration,51,23,28
20633,Мвнзх,gordunni,1656,shaman,restoration,54,24,30
20634,Hypéra,kazzak,1655,shaman,restoration,156,84,72
20635,Рамаксбосс,gordunni,1651,shaman,restoration,36,22,14
20636,Seasick,frostmane,1648,shaman,restoration,90,47,43
20637,Gargro,kazzak,1646,shaman,restoration,41,22,19
20638,Shamandoino,wildhammer,1644,shaman,restoration,198,91,107
20639,Phoenííx,twisting-nether,1643,shaman,restoration,42,20,22
20640,Kyogre,auchindoun,1636,shaman,restoration,42,22,20
20641,Rxs,thunderhorn,1635,shaman,restoration,54,28,26
20642,Thald,ragnaros,1634,shaman,restoration,78,49,29
20643,Pøwertoto,dalaran,1632,shaman,restoration,54,24,30
20644,Bonshaman,ahnqiraj,1632,shaman,restoration,48,19,29
20645,Invadé,stormscale,1630,shaman,restoration,30,17,13
20646,Elmezz,aggra-português,1628,shaman,restoration,30,17,13
20647,Izir,archimonde,1628,shaman,restoration,42,18,24
20648,Inspektør,kazzak,1627,shaman,restoration,41,23,18
20649,Hjod,outland,1627,shaman,restoration,83,45,38
20650,Urshak,alleria,1624,shaman,restoration,30,20,10
20651,Askagain,sylvanas,1624,shaman,restoration,28,18,10
20652,Xhanon,kazzak,1624,shaman,restoration,36,20,16
20653,Fersok,zuljin,1624,shaman,restoration,36,17,19
20654,Chäväman,archimonde,1624,shaman,restoration,48,17,31
20655,Thyroideus,argent-dawn,1622,shaman,restoration,90,56,34
20656,Atomstrom,frostwolf,1621,shaman,restoration,62,34,28
20657,Инкуль,howling-fjord,1621,shaman,restoration,42,20,22
20658,Igly,antonidas,1620,shaman,restoration,30,17,13
20659,Sûckmytotem,ragnaros,1619,shaman,restoration,30,17,13
20660,Zwergmann,blackrock,1618,shaman,restoration,54,36,18
20661,Vajaele,twisting-nether,1618,shaman,restoration,53,25,28
20662,Carlitosham,eredar,1618,shaman,restoration,44,17,27
20663,Тафельшпиц,soulflayer,1617,shaman,restoration,40,18,22
20664,Earthhulk,thrall,1615,shaman,restoration,89,52,37
20665,Сладкийстас,soulflayer,1613,shaman,restoration,48,20,28
20666,Mcktavish,silvermoon,1612,shaman,restoration,48,31,17
20667,Yzeldan,hyjal,1611,shaman,restoration,130,82,48
20668,Bullezno,kazzak,1611,shaman,restoration,87,50,37
20669,Makkalisse,kazzak,1609,shaman,restoration,24,17,7
20670,Upisi,burning-legion,1609,shaman,restoration,84,42,42
20671,Blowlips,argent-dawn,1609,shaman,restoration,42,17,25
20672,Koraél,dun-modr,1608,shaman,restoration,60,24,36
20673,Ezilol,blackhand,1606,shaman,restoration,77,46,31
20674,Rexatar,blackrock,1606,shaman,restoration,36,21,15
20675,Sanamaxx,colinas-pardas,1605,shaman,restoration,44,24,20
20676,Ebøbøla,terokkar,1602,shaman,restoration,158,74,84
20677,Djosershamy,draenor,1602,shaman,restoration,42,19,23
20678,Whiskiy,kazzak,1598,shaman,restoration,26,18,8
20679,Lechii,stormscale,1598,shaman,restoration,95,51,44
20680,Martuscielöl,drakthul,1598,shaman,restoration,88,32,56
20681,Laskopivo,doomhammer,1593,shaman,restoration,60,37,23
20682,Bîlunder,arygos,1593,shaman,restoration,41,19,22
20683,Zorcs,silvermoon,1589,shaman,restoration,138,70,68
20684,Firenanajkm,dun-modr,1586,shaman,restoration,48,28,20
20685,Variablelol,outland,1584,shaman,restoration,29,20,9
20686,Vioception,blackrock,1584,shaman,restoration,48,19,29
20687,Denastyo,nemesis,1581,shaman,restoration,36,21,15
20688,Tupato,kazzak,1581,shaman,restoration,68,34,34
20689,Thorenal,blackmoore,1577,shaman,restoration,24,21,3
20690,Mìcrøs,thrall,1571,shaman,restoration,47,27,20
20691,Sixtyone,stormscale,1569,shaman,restoration,75,42,33
20692,Mamacitá,eredar,1568,shaman,restoration,277,124,153
20693,Zinjk,nemesis,1567,shaman,restoration,126,66,60
20694,Beastmodex,eredar,1567,shaman,restoration,132,68,64
20695,Шсаваннх,blackscar,1566,shaman,restoration,165,83,82
20696,Uzze,drakthul,1564,shaman,restoration,60,26,34
20697,Отчима,howling-fjord,1562,shaman,restoration,89,48,41
20698,Horokeu,blackrock,1560,shaman,restoration,30,17,13
20699,Shockair,frostwolf,1559,shaman,restoration,75,34,41
20700,Exolnard,twisting-nether,1557,shaman,restoration,60,28,32
20701,Sebubu,twisting-nether,1556,shaman,restoration,38,23,15
20702,Tartorno,antonidas,1556,shaman,restoration,65,26,39
20703,Kuhnedy,blackrock,1553,shaman,restoration,88,46,42
20704,Discoranger,ravencrest,1552,shaman,restoration,54,27,27
20705,Shuzman,emeriss,1550,shaman,restoration,48,23,25
20706,Velkin,thrall,1549,shaman,restoration,121,63,58
20707,Zanezu,stormscale,1547,shaman,restoration,102,45,57
20708,Paidactor,kazzak,1546,shaman,restoration,54,30,24
20709,Reilah,drakthul,1546,shaman,restoration,66,33,33
20710,Märthalouise,twisting-nether,1546,shaman,restoration,43,18,25
20711,Linkedink,tarren-mill,1545,shaman,restoration,23,17,6
20712,Bullfox,aszune,1545,shaman,restoration,66,28,38
20713,Gjernhard,stormreaver,1542,shaman,restoration,60,30,30
20714,Кичисанчик,howling-fjord,1541,shaman,restoration,126,57,69
20715,Ларисашерсть,blackscar,1539,shaman,restoration,29,21,8
20716,Pädagogeig,antonidas,1536,shaman,restoration,54,30,24
20717,Anöuchkâ,ysondre,1535,shaman,restoration,42,19,23
20718,Blowxd,aegwynn,1534,shaman,restoration,116,63,53
20719,Ugard,burning-legion,1533,shaman,restoration,37,18,19
20720,Mypakypa,outland,1532,shaman,restoration,48,20,28
20721,Urzza,stormscale,1530,shaman,restoration,18,16,2
20722,Neovim,trollbane,1530,shaman,restoration,42,20,22
20723,Collînna,aegwynn,1529,shaman,restoration,62,34,28
20724,Nassîî,antonidas,1528,shaman,restoration,95,37,58
20725,Bumblebeec,tarren-mill,1526,shaman,restoration,54,29,25
20726,Reezex,silvermoon,1526,shaman,restoration,65,34,31
20727,Bombasthicc,ravencrest,1523,shaman,restoration,30,16,14
20728,Ilovejamie,sylvanas,1522,shaman,restoration,54,30,24
20729,Allysidewtf,archimonde,1521,shaman,restoration,22,17,5
20730,Кислаябуба,howling-fjord,1520,shaman,restoration,61,28,33
20731,Schain,eredar,1518,shaman,restoration,36,24,12
20732,Incredibade,stormscale,1517,shaman,restoration,36,16,20
20733,Remony,pozzo-delleternità,1512,shaman,restoration,39,27,12
20734,Mydpsrbad,stormscale,1511,shaman,restoration,60,33,27
20735,Kuis,sanguino,1510,shaman,restoration,54,22,32
20736,Fuzzywaagh,silvermoon,1507,shaman,restoration,29,18,11
20737,Enzopotenzo,blackrock,1506,shaman,restoration,42,22,20
20738,Vaizii,silvermoon,1505,shaman,restoration,53,26,27
20739,Coldlean,haomarush,1504,shaman,restoration,146,69,77
20740,Krovogor,silvermoon,1501,shaman,restoration,54,31,23
20741,Remkoo,blackrock,1498,shaman,restoration,24,17,7
20742,Cobbel,argent-dawn,1494,shaman,restoration,138,74,64
20743,Apaorkaxyz,ragnaros,1493,shaman,restoration,60,27,33
20744,Хэйзл,ashenvale,1492,shaman,restoration,74,32,42
20745,Lexos,ravencrest,1490,shaman,restoration,30,16,14
20746,Чанголист,soulflayer,1489,shaman,restoration,65,28,37
20747,Diix,archimonde,1489,shaman,restoration,66,27,39
20748,Kalaris,stormscale,1488,shaman,restoration,36,20,16
20749,Светшам,howling-fjord,1486,shaman,restoration,29,16,13
20750,Pacio,alakir,1481,shaman,restoration,78,40,38
20751,Monstermunch,ravencrest,1481,shaman,restoration,93,43,50
20752,Schweízer,blackrock,1479,shaman,restoration,48,20,28
20753,Gützli,blackmoore,1474,shaman,restoration,93,35,58
20754,Ünknownz,archimonde,1464,shaman,restoration,71,37,34
20755,Biggiebig,ravencrest,1458,shaman,restoration,42,21,21
20756,Stòrmbreakèr,nemesis,1458,shaman,restoration,37,18,19
20757,Духсалата,grom,1454,shaman,restoration,30,16,14
20758,Cuzzer,drakthul,1454,shaman,restoration,77,39,38
20759,Hexoffender,alakir,1454,shaman,restoration,106,50,56
20760,Zlingx,auchindoun,1454,shaman,restoration,48,22,26
20761,Ironkraw,stormscale,1453,shaman,restoration,60,22,38
20762,Djxyoloswag,silvermoon,1451,shaman,restoration,81,36,45
20763,Redoms,stormreaver,1449,shaman,restoration,63,31,32
20764,Gspót,twisting-nether,1447,shaman,restoration,98,47,51
20765,Trustlemac,onyxia,1444,shaman,restoration,24,19,5
20766,Sucøre,die-nachtwache,1444,shaman,restoration,52,27,25
20767,Bonraptor,kirin-tor,1443,shaman,restoration,41,20,21
20768,Nickygodx,stormscale,1439,shaman,restoration,24,15,9
20769,Mjukiz,tarren-mill,1439,shaman,restoration,111,65,46
20770,Zaiyoxgodx,thrall,1439,shaman,restoration,30,16,14
20771,Helloitsmee,thrall,1439,shaman,restoration,40,20,20
20772,Боунсе,howling-fjord,1438,shaman,restoration,36,15,21
20773,Roineé,draenor,1436,shaman,restoration,30,15,15
20774,Okdar,stormscale,1435,shaman,restoration,54,34,20
20775,Emochka,ravencrest,1435,shaman,restoration,130,60,70
20776,Kataretic,kazzak,1433,shaman,restoration,24,17,7
20777,Vioceptîon,blackrock,1432,shaman,restoration,24,19,5
20778,Pacho,alakir,1432,shaman,restoration,42,16,26
20779,Шарюпокд,soulflayer,1431,shaman,restoration,36,18,18
20780,Squixi,tarren-mill,1429,shaman,restoration,30,15,15
20781,Mcbloob,kazzak,1425,shaman,restoration,40,19,21
20782,Shemanrolf,outland,1425,shaman,restoration,57,26,31
20783,Kalypsø,arthas,1423,shaman,restoration,36,15,21
20784,Vorkanyx,ysondre,1421,shaman,restoration,52,26,26
20785,Prizærn,tarren-mill,1415,shaman,restoration,42,15,27
20786,Diya,karazhan,1414,shaman,restoration,72,33,39
20787,Mightgethexd,tarren-mill,1412,shaman,restoration,24,16,8
20788,Deadstill,ysondre,1412,shaman,restoration,24,15,9
20789,Wôdân,blackrock,1412,shaman,restoration,54,21,33
20790,Сёмабро,ashenvale,1411,shaman,restoration,178,100,78
20791,Zhulnaar,hyjal,1409,shaman,restoration,42,21,21
20792,Bénathon,ravencrest,1407,shaman,restoration,33,21,12
20793,Tèysh,ysondre,1407,shaman,restoration,66,35,31
20794,Кразтор,howling-fjord,1405,shaman,restoration,35,18,17
20795,Splashgodx,frostwolf,1401,shaman,restoration,29,15,14
20796,Yomuchacha,dun-modr,1398,shaman,restoration,94,44,50
20797,Дагод,booty-bay,1393,shaman,restoration,30,22,8
20798,Yois,nemesis,1393,shaman,restoration,66,37,29
20799,Damex,thunderhorn,1390,shaman,restoration,108,38,70
20800,Johnblånn,stormscale,1389,shaman,restoration,51,30,21
20801,Шиока,borean-tundra,1382,shaman,restoration,30,18,12
20802,Джонпсинаа,gordunni,1379,shaman,restoration,36,18,18
20803,Warianis,ravencrest,1374,shaman,restoration,51,27,24
20804,Elamentaly,draenor,1371,shaman,restoration,54,29,25
20805,Phêbz,archimonde,1371,shaman,restoration,48,25,23
20806,Jazzrod,stormscale,1369,shaman,restoration,168,81,87
20807,Hulcky,grim-batol,1363,shaman,restoration,48,27,21
20808,Nwäar,archimonde,1362,shaman,restoration,36,21,15
20809,Murmaiderz,draenor,1362,shaman,restoration,66,32,34
20810,Akrobata,silvermoon,1360,shaman,restoration,180,83,97
20811,Lustmasterx,grim-batol,1357,shaman,restoration,54,26,28
20812,Shago,archimonde,1356,shaman,restoration,95,43,52
20813,Elombrion,destromath,1355,shaman,restoration,30,16,14
20814,Ketzersend,alleria,1351,shaman,restoration,30,18,12
20815,Asumix,illidan,1347,shaman,restoration,71,38,33
20816,Rhakhatheckh,nemesis,1340,shaman,restoration,30,16,14
20817,Nestre,kazzak,1339,shaman,restoration,30,14,16
20818,Виелетта,gordunni,1338,shaman,restoration,24,14,10
20819,Shapperdin,darksorrow,1336,shaman,restoration,24,14,10
20820,Ксмо,gordunni,1331,shaman,restoration,24,14,10
20821,Vodoochild,hyjal,1327,shaman,restoration,43,17,26
20822,Jarvís,gilneas,1327,shaman,restoration,50,19,31
20823,Sadfemecraft,aggramar,1326,shaman,restoration,105,45,60
20824,Showman,archimonde,1325,shaman,restoration,146,72,74
20825,Bíìerlip,twisting-nether,1324,shaman,restoration,29,17,12
20826,Antey,ravencrest,1324,shaman,restoration,84,42,42
20827,Schaname,rajaxx,1323,shaman,restoration,30,14,16
20828,Slowtem,draenor,1318,shaman,restoration,41,20,21
20829,Nogag,kazzak,1318,shaman,restoration,30,14,16
20830,Patuljak,outland,1317,shaman,restoration,59,29,30
20831,Beyp,sylvanas,1315,shaman,restoration,41,22,19
20832,Littledorf,ravencrest,1314,shaman,restoration,66,36,30
20833,Macchiavelli,blades-edge,1313,shaman,restoration,41,20,21
20834,Шайнинлайт,soulflayer,1311,shaman,restoration,83,32,51
20835,Navezi,twisting-nether,1310,shaman,restoration,72,41,31
20836,Aceofraphy,thrall,1308,shaman,restoration,125,53,72
20837,Gnackbretzn,eredar,1305,shaman,restoration,36,15,21
20838,Durek,aerie-peak,1304,shaman,restoration,24,14,10
20839,Teccatwo,outland,1302,shaman,restoration,76,40,36
20840,Shôk,ravencrest,1302,shaman,restoration,68,35,33
20841,Makaria,emerald-dream,1299,shaman,restoration,58,31,27
20842,Шаеман,soulflayer,1298,shaman,restoration,36,20,16
20843,Lerosh,twisting-nether,1297,shaman,restoration,48,26,22
20844,Murmelï,stormreaver,1297,shaman,restoration,51,26,25
20845,Крэгнор,gordunni,1295,shaman,restoration,81,43,38
20846,Shamanmode,twisting-nether,1292,shaman,restoration,42,17,25
20847,Onlytides,doomhammer,1290,shaman,restoration,36,14,22
20848,Thundersioux,ravencrest,1288,shaman,restoration,39,24,15
20849,Eduorde,silvermoon,1286,shaman,restoration,32,19,13
20850,Vuls,blackmoore,1283,shaman,restoration,42,24,18
20851,Samantouz,archimonde,1282,shaman,restoration,63,27,36
20852,Umbraverfaa,twisting-nether,1278,shaman,restoration,36,15,21
20853,Iamnyka,blackrock,1276,shaman,restoration,24,17,7
20854,Ishkadar,twisting-nether,1270,shaman,restoration,33,15,18
20855,Fulminare,ravencrest,1264,shaman,restoration,48,26,22
20856,Жижелье,howling-fjord,1263,shaman,restoration,52,28,24
20857,Sjamanisme,silvermoon,1262,shaman,restoration,84,40,44
20858,Kbakasham,ravencrest,1262,shaman,restoration,32,15,17
20859,Малекулакота,soulflayer,1261,shaman,restoration,35,14,21
20860,Azifox,hyjal,1260,shaman,restoration,25,14,11
20861,Bigrambo,draenor,1259,shaman,restoration,18,15,3
20862,Daboó,vashj,1250,shaman,restoration,73,38,35
20863,Arathoir,ravencrest,1247,shaman,restoration,24,13,11
20864,Swineflowing,ysondre,1247,shaman,restoration,24,13,11
20865,Karlurban,outland,1247,shaman,restoration,30,13,17
20866,Reparagos,sanguino,1246,shaman,restoration,25,14,11
20867,Руикси,howling-fjord,1246,shaman,restoration,30,13,17
20868,Linknvm,thrall,1245,shaman,restoration,39,27,12
20869,Keisser,ravencrest,1244,shaman,restoration,24,13,11
20870,Shambulancex,tarren-mill,1243,shaman,restoration,24,13,11
20871,Dgshîtdwarf,ravencrest,1242,shaman,restoration,30,13,17
20872,Anlaki,silvermoon,1241,shaman,restoration,18,13,5
20873,Leunam,draenor,1241,shaman,restoration,52,26,26
20874,Egí,azshara,1241,shaman,restoration,30,13,17
20875,Jenkem,hyjal,1240,shaman,restoration,30,13,17
20876,Sîggý,eredar,1237,shaman,restoration,24,13,11
20877,Alisàn,teldrassil,1235,shaman,restoration,109,48,61
20878,Kaletore,ragnaros,1233,shaman,restoration,48,28,20
20879,Санрэйн,soulflayer,1233,shaman,restoration,36,19,17
20880,Alexmiamosch,thrall,1226,shaman,restoration,78,48,30
20881,Gaelic,frostmourne,1226,shaman,restoration,24,13,11
20882,Panicsc,twisting-nether,1226,shaman,restoration,65,28,37
20883,Sugardad,khaz-modan,1225,shaman,restoration,113,52,61
20884,Moonbotico,blackrock,1220,shaman,restoration,36,18,18
20885,Schnessert,silvermoon,1220,shaman,restoration,30,13,17
20886,Alakan,saurfang,1219,shaman,restoration,52,22,30
20887,Sickbrain,silvermoon,1216,shaman,restoration,45,19,26
20888,Lechirurgien,elune,1215,shaman,restoration,95,48,47
20889,Yasharshammy,tarren-mill,1215,shaman,restoration,36,13,23
20890,Перегной,ashenvale,1212,shaman,restoration,93,39,54
20891,Deadwoodz,tarren-mill,1209,shaman,restoration,36,14,22
20892,Ephase,burning-blade,1207,shaman,restoration,55,16,39
20893,Morttes,burning-legion,1205,shaman,restoration,27,14,13
20894,Nakenfeigy,stormreaver,1204,shaman,restoration,29,16,13
20895,Baelee,sylvanas,1204,shaman,restoration,60,27,33
20896,Semrix,blackhand,1202,shaman,restoration,30,13,17
20897,Blöödfist,drakthul,1200,shaman,restoration,35,14,21
20898,Snobas,kazzak,1198,shaman,restoration,29,13,16
20899,Lolafløres,dun-modr,1194,shaman,restoration,53,37,16
20900,Jimmybuffett,kazzak,1193,shaman,restoration,55,26,29
20901,Yuliy,arathor,1191,shaman,restoration,30,13,17
20902,Братишкапинг,soulflayer,1190,shaman,restoration,98,50,48
20903,Kickvando,blackmoore,1184,shaman,restoration,38,18,20
20904,Oldrym,blackrock,1183,shaman,restoration,64,25,39
20905,Fußpilzmann,blackmoore,1182,shaman,restoration,90,46,44
20906,Watashij,outland,1179,shaman,restoration,45,22,23
20907,Biztor,jaedenar,1178,shaman,restoration,48,26,22
20908,Kvekkis,argent-dawn,1175,shaman,restoration,30,17,13
20909,Arabesk,arygos,1174,shaman,restoration,102,49,53
20910,Darnok,quelthalas,1173,shaman,restoration,60,29,31
20911,Elijaá,nordrassil,1169,shaman,restoration,60,33,27
20912,Tegellera,ravencrest,1168,shaman,restoration,53,27,26
20913,Thenasil,stormscale,1165,shaman,restoration,42,19,23
20914,Shinui,twisting-nether,1163,shaman,restoration,33,17,16
20915,Drman,shattered-hand,1162,shaman,restoration,42,25,17
20916,Bèx,twisting-nether,1159,shaman,restoration,30,13,17
20917,Pituu,tarren-mill,1158,shaman,restoration,36,15,21
20918,Ðøminantx,stormscale,1155,shaman,restoration,30,14,16
20919,Quòr,antonidas,1154,shaman,restoration,30,23,7
20920,Alcam,twisting-nether,1154,shaman,restoration,77,33,44
20921,Светшамка,howling-fjord,1152,shaman,restoration,18,12,6
20922,Olînours,archimonde,1152,shaman,restoration,36,20,16
20923,Snusy,stormscale,1152,shaman,restoration,24,12,12
20924,Lexxthree,blackrock,1151,shaman,restoration,18,12,6
20925,Htagagain,archimonde,1151,shaman,restoration,18,12,6
20926,Dêblâzê,thrall,1151,shaman,restoration,24,12,12
20927,Teldarian,archimonde,1151,shaman,restoration,24,12,12
20928,Ripperdoc,stormreaver,1151,shaman,restoration,30,12,18
20929,Souqixo,drakthul,1150,shaman,restoration,18,12,6
20930,Lolalovexo,kazzak,1150,shaman,restoration,30,14,16
20931,Ripstorm,sylvanas,1149,shaman,restoration,24,12,12
20932,Dmgccbot,outland,1149,shaman,restoration,30,12,18
20933,Putzè,blackrock,1148,shaman,restoration,18,12,6
20934,Bedouín,draenor,1148,shaman,restoration,24,14,10
20935,Kaherad,antonidas,1148,shaman,restoration,72,33,39
20936,Octon,dun-modr,1147,shaman,restoration,24,12,12
20937,Vaweñ,ravencrest,1147,shaman,restoration,30,12,18
20938,Kärríegold,blackrock,1146,shaman,restoration,18,12,6
20939,Schamazon,tarren-mill,1145,shaman,restoration,18,12,6
20940,Нитрочка,soulflayer,1143,shaman,restoration,24,12,12
20941,Gehrké,silvermoon,1142,shaman,restoration,18,12,6
20942,Rêêza,blackhand,1140,shaman,restoration,36,19,17
20943,Laïnàà,archimonde,1136,shaman,restoration,65,27,38
20944,Сновидений,soulflayer,1135,shaman,restoration,24,12,12
20945,Cloovster,magtheridon,1132,shaman,restoration,24,12,12
20946,Suntpraf,kazzak,1131,shaman,restoration,35,14,21
20947,Holshammy,nemesis,1127,shaman,restoration,90,39,51
20948,Jävlajävel,draenor,1126,shaman,restoration,33,20,13
20949,Jimkopf,eredar,1123,shaman,restoration,24,14,10
20950,Ogrilza,uldaman,1120,shaman,restoration,24,13,11
20951,Lemontea,burning-blade,1112,shaman,restoration,30,12,18
20952,Woade,silvermoon,1108,shaman,restoration,30,12,18
20953,Hazufel,kaelthas,1106,shaman,restoration,38,17,21
20954,Sáltý,ravencrest,1103,shaman,restoration,21,12,9
20955,Qjie,argent-dawn,1102,shaman,restoration,41,21,20
20956,Ivaccineyou,blackmoore,1099,shaman,restoration,24,12,12
20957,Nafay,lordaeron,1097,shaman,restoration,42,21,21
20958,Thuknala,tarren-mill,1094,shaman,restoration,23,13,10
20959,Bennycooch,silvermoon,1081,shaman,restoration,107,42,65
20960,Pocahøntas,archimonde,1078,shaman,restoration,32,12,20
20961,Smyke,magtheridon,1069,shaman,restoration,66,34,32
20962,Сорнинай,soulflayer,1068,shaman,restoration,36,15,21
20963,Checkpoint,defias-brotherhood,1065,shaman,restoration,30,15,15
20964,Hikigane,marécage-de-zangar,1061,shaman,restoration,48,17,31
20965,Кодитян,gordunni,1056,shaman,restoration,24,11,13
20966,Nyzo,tarren-mill,1056,shaman,restoration,24,11,13
20967,Fotmherøqtx,ravencrest,1055,shaman,restoration,18,11,7
20968,Pilinham,aggra-português,1055,shaman,restoration,24,11,13
20969,Garuga,dun-morogh,1055,shaman,restoration,24,11,13
20970,Aioñ,kazzak,1055,shaman,restoration,27,11,16
20971,Dmgaddict,kazzak,1054,shaman,restoration,18,11,7
20972,Elshamino,ravencrest,1054,shaman,restoration,24,11,13
20973,Tiddles,arathor,1053,shaman,restoration,18,11,7
20974,Kacamaz,twisting-nether,1053,shaman,restoration,24,11,13
20975,Gronash,sunstrider,1051,shaman,restoration,18,11,7
20976,Spartecøbra,dalaran,1051,shaman,restoration,30,13,17
20977,Kíkjo,aegwynn,1050,shaman,restoration,18,11,7
20978,Waterboi,blackmoore,1050,shaman,restoration,30,11,19
20979,Оперочек,howling-fjord,1050,shaman,restoration,42,12,30
20980,Flikus,aggra-português,1048,shaman,restoration,30,11,19
20981,Cukkerberg,ragnaros,1047,shaman,restoration,36,15,21
20982,Oscar,khaz-modan,1046,shaman,restoration,18,11,7
20983,Chokeonme,blackrock,1046,shaman,restoration,63,37,26
20984,Mandoloriana,sylvanas,1041,shaman,restoration,24,11,13
20985,Idkteam,stormscale,1037,shaman,restoration,24,11,13
20986,Slutie,stormscale,1036,shaman,restoration,23,11,12
20987,Roxxo,frostwolf,1032,shaman,restoration,18,11,7
20988,Haginathor,twisting-nether,1032,shaman,restoration,72,40,32
20989,Corbo,ysondre,1029,shaman,restoration,63,34,29
20990,Dasce,sylvanas,1017,shaman,restoration,30,14,16
20991,Mantoon,doomhammer,1013,shaman,restoration,30,12,18
20992,Blainehammer,arathor,1006,shaman,restoration,30,12,18
20993,Noulol,aegwynn,1005,shaman,restoration,23,12,11
20994,Selrin,blackrock,1005,shaman,restoration,77,28,49
20995,Subaki,die-aldor,1003,shaman,restoration,17,11,6
20996,Венжии,soulflayer,1002,shaman,restoration,30,12,18
20997,Lanzatotems,dun-modr,997,shaman,restoration,24,11,13
20998,Wernøz,archimonde,991,shaman,restoration,20,11,9
20999,Быковат,booty-bay,986,shaman,restoration,33,12,21
21000,Henchtotem,draenor,980,shaman,restoration,20,11,9
21001,Teada,aegwynn,980,shaman,restoration,34,12,22
21002,Knasta,malygos,978,shaman,restoration,30,11,19
21003,Garifus,dun-modr,970,shaman,restoration,90,44,46
21004,Mearu,bronze-dragonflight,961,shaman,restoration,30,18,12
21005,Милжон,soulflayer,961,shaman,restoration,31,17,14
21006,Qobq,ravencrest,960,shaman,restoration,12,10,2
21007,Eurocad,draenor,960,shaman,restoration,18,10,8
21008,Dremlok,burning-legion,959,shaman,restoration,12,10,2
21009,Ðtxkeks,onyxia,959,shaman,restoration,13,10,3
21010,Bananis,outland,959,shaman,restoration,18,10,8
21011,Teldatwo,archimonde,959,shaman,restoration,18,10,8
21012,Monstacookie,stormreaver,959,shaman,restoration,18,10,8
21013,Crysisx,sanguino,959,shaman,restoration,18,10,8
21014,Hydrolîc,blackrock,959,shaman,restoration,18,10,8
21015,Raketenrieke,blackrock,959,shaman,restoration,18,10,8
21016,Amnéshaman,ysondre,959,shaman,restoration,24,10,14
21017,Ugáa,malganis,959,shaman,restoration,24,10,14
21018,Loay,blackrock,959,shaman,restoration,24,10,14
21019,Drohx,ysondre,958,shaman,restoration,18,10,8
21020,Bosskwtt,kazzak,958,shaman,restoration,18,10,8
21021,Чаиро,howling-fjord,958,shaman,restoration,24,10,14
21022,Neejtjak,ravencrest,958,shaman,restoration,24,10,14
21023,Назульчике,razuvious,957,shaman,restoration,18,10,8
21024,Zoolza,kirin-tor,957,shaman,restoration,36,10,26
21025,Valdraxx,ravencrest,956,shaman,restoration,88,43,45
21026,Orcinterface,tarren-mill,955,shaman,restoration,21,11,10
21027,Shrekcho,twisting-nether,942,shaman,restoration,18,10,8
21028,Bloodvaron,zuljin,942,shaman,restoration,29,10,19
21029,Swedishmeat,kazzak,940,shaman,restoration,26,13,13
21030,Morty,tarren-mill,939,shaman,restoration,30,10,20
21031,Nexolok,alleria,933,shaman,restoration,54,30,24
21032,Bullvai,dun-morogh,929,shaman,restoration,62,28,34
21033,Hacyria,archimonde,924,shaman,restoration,24,13,11
21034,Schamannen,outland,916,shaman,restoration,24,11,13
21035,Blumy,skullcrusher,884,shaman,restoration,78,36,42
21036,Bobanrajovic,silvermoon,864,shaman,restoration,12,9,3
21037,Mysterqt,nemesis,864,shaman,restoration,12,9,3
21038,Batmanmain,twisting-nether,864,shaman,restoration,16,10,6
21039,Shamiinn,ravencrest,864,shaman,restoration,18,9,9
21040,Фатнир,soulflayer,864,shaman,restoration,18,9,9
21041,Holyshamixz,dun-modr,864,shaman,restoration,18,9,9
21042,Shounx,hyjal,864,shaman,restoration,18,9,9
21043,Nothexy,stormscale,864,shaman,restoration,18,9,9
21044,Котенокмур,soulflayer,864,shaman,restoration,24,9,15
21045,Blamy,auchindoun,863,shaman,restoration,12,9,3
21046,Shamantistik,ravencrest,863,shaman,restoration,12,9,3
21047,Geminate,stormscale,863,shaman,restoration,12,9,3
21048,Snickersx,blackrock,863,shaman,restoration,12,9,3
21049,Redomsh,stormreaver,863,shaman,restoration,18,9,9
21050,Draáx,ravencrest,863,shaman,restoration,18,9,9
21051,Милыйдед,gordunni,863,shaman,restoration,36,9,27
21052,Stolen,skullcrusher,862,shaman,restoration,12,9,3
21053,Syreer,silvermoon,862,shaman,restoration,19,9,10
21054,Pprx,tarren-mill,862,shaman,restoration,24,9,15
21055,Cjay,dunemaul,861,shaman,restoration,12,9,3
21056,Tonifo,nemesis,861,shaman,restoration,12,9,3
21057,Shamanopaf,tarren-mill,861,shaman,restoration,18,9,9
21058,Amu,ravencrest,860,shaman,restoration,18,9,9
21059,Freizeitler,antonidas,860,shaman,restoration,18,9,9
21060,Mansquidgoat,darksorrow,859,shaman,restoration,15,10,5
21061,Orchal,defias-brotherhood,859,shaman,restoration,18,9,9
21062,Sunsham,illidan,858,shaman,restoration,18,9,9
21063,Düsterlotus,dalvengyr,857,shaman,restoration,12,9,3
21064,Wayoa,defias-brotherhood,856,shaman,restoration,12,9,3
21065,Vukroth,argent-dawn,852,shaman,restoration,20,10,10
21066,Poggsham,twisting-nether,852,shaman,restoration,24,9,15
21067,Лялори,gordunni,845,shaman,restoration,18,9,9
21068,Ambrosioss,kazzak,841,shaman,restoration,12,9,3
21069,Yàra,throkferoth,837,shaman,restoration,24,10,14
21070,Numdog,stormreaver,831,shaman,restoration,17,9,8
21071,Shafallen,tarren-mill,829,shaman,restoration,14,10,4
21072,Stkk,ravencrest,818,shaman,restoration,24,10,14
21073,Bahane,frostwolf,815,shaman,restoration,15,9,6
21074,Дрфэка,soulflayer,815,shaman,restoration,36,9,27
21075,Crixuss,argent-dawn,809,shaman,restoration,17,9,8
21076,Arshak,stormscale,800,shaman,restoration,16,9,7
21077,Akwa,stormscale,799,shaman,restoration,20,9,11
21078,Rostislav,ravencrest,768,shaman,restoration,12,8,4
21079,Socialfailur,archimonde,768,shaman,restoration,12,8,4
21080,Vërÿßåðxd,silvermoon,768,shaman,restoration,12,8,4
21081,Lilcake,ravencrest,768,shaman,restoration,12,8,4
21082,Navajito,tarren-mill,768,shaman,restoration,12,8,4
21083,Vibesham,outland,768,shaman,restoration,12,8,4
21084,Lontarita,tarren-mill,768,shaman,restoration,12,8,4
21085,Zelent,thrall,768,shaman,restoration,12,8,4
21086,Ivnashaman,drakthul,768,shaman,restoration,12,8,4
21087,Squixi,ravencrest,768,shaman,restoration,12,8,4
21088,Enchancement,ragnaros,768,shaman,restoration,12,8,4
21089,Vivaldi,varimathras,768,shaman,restoration,14,8,6
21090,Nøraa,ravencrest,768,shaman,restoration,18,8,10
21091,Iloveléa,ravencrest,768,shaman,restoration,18,8,10
21092,Wibra,nagrand,768,shaman,restoration,18,8,10
21093,Qoekke,uldum,768,shaman,restoration,18,8,10
21094,Тотембот,soulflayer,768,shaman,restoration,18,8,10
21095,Sprühkot,aegwynn,768,shaman,restoration,18,8,10
21096,Lorko,twisting-nether,768,shaman,restoration,18,8,10
21097,Eisei,stormscale,767,shaman,restoration,12,8,4
21098,Torxii,antonidas,767,shaman,restoration,12,8,4
21099,Magma,kazzak,767,shaman,restoration,12,8,4
21100,Berasham,dalaran,767,shaman,restoration,12,8,4
21101,Lauree,terokkar,767,shaman,restoration,12,8,4
21102,Jänis,ragnaros,767,shaman,restoration,12,8,4
21103,Aliatës,sanguino,767,shaman,restoration,18,8,10
21104,Juyina,ravencrest,767,shaman,restoration,18,8,10
21105,Iwaa,dalaran,767,shaman,restoration,18,8,10
21106,Nexian,kazzak,767,shaman,restoration,24,8,16
21107,Shamhingo,stormscale,767,shaman,restoration,30,8,22
21108,Aldron,tirion,766,shaman,restoration,12,8,4
21109,Kryuxs,blackrock,766,shaman,restoration,12,8,4
21110,Джоукх,howling-fjord,766,shaman,restoration,12,8,4
21111,Cleansing,nemesis,766,shaman,restoration,12,8,4
21112,Eero,darksorrow,766,shaman,restoration,12,8,4
21113,Penetrierer,blackrock,765,shaman,restoration,12,8,4
21114,Xamic,twisting-nether,765,shaman,restoration,18,8,10
21115,Naargie,outland,765,shaman,restoration,20,8,12
21116,Gundersen,stormscale,763,shaman,restoration,18,8,10
21117,Saviothewise,aggra-português,761,shaman,restoration,12,8,4
21118,Rórekk,aegwynn,761,shaman,restoration,18,8,10
21119,Thunderberg,antonidas,746,shaman,restoration,24,8,16
21120,Дарьюша,fordragon,744,shaman,restoration,12,8,4
21121,Xogor,kazzak,720,shaman,restoration,21,8,13
21122,Kuubskii,ravencrest,719,shaman,restoration,11,8,3
21123,Purgérkíng,silvermoon,713,shaman,restoration,15,9,6
21124,Onkens,ravencrest,712,shaman,restoration,21,9,12
21125,Mltx,twilights-hammer,703,shaman,restoration,14,8,6
21126,Thangog,ragnaros,703,shaman,restoration,16,8,8
21127,Грейсаша,howling-fjord,695,shaman,restoration,22,8,14
21128,Pvegame,tarren-mill,672,shaman,restoration,12,7,5
21129,Berly,stormscale,672,shaman,restoration,12,7,5
21130,Тубалкайн,soulflayer,672,shaman,restoration,12,7,5
21131,Alëxx,hyjal,672,shaman,restoration,12,7,5
21132,Madytz,eredar,672,shaman,restoration,12,7,5
21133,Dôppel,archimonde,672,shaman,restoration,12,7,5
21134,Defonceboby,archimonde,672,shaman,restoration,12,7,5
21135,Raintlordx,twisting-nether,672,shaman,restoration,12,7,5
21136,Shamidrak,eredar,672,shaman,restoration,12,7,5
21137,Awumbahway,outland,672,shaman,restoration,12,7,5
21138,Rôwdy,kazzak,672,shaman,restoration,12,7,5
21139,Winshear,twisting-nether,672,shaman,restoration,12,7,5
21140,Гарантийный,lich-king,672,shaman,restoration,12,7,5
21141,Voodoonerd,twisting-nether,672,shaman,restoration,12,7,5
21142,Pogchampz,nemesis,672,shaman,restoration,12,7,5
21143,Spiirit,tarren-mill,672,shaman,restoration,12,7,5
21144,Gigawashed,archimonde,672,shaman,restoration,12,7,5
21145,Sháme,azjolnerub,672,shaman,restoration,18,7,11
21146,Крэйвхх,howling-fjord,672,shaman,restoration,18,7,11
21147,Daykên,kazzak,672,shaman,restoration,18,7,11
21148,Reticlol,kazzak,672,shaman,restoration,18,7,11
21149,Viinny,dun-modr,672,shaman,restoration,18,7,11
21150,Barbebiendur,archimonde,672,shaman,restoration,18,7,11
21151,Çøynx,aegwynn,672,shaman,restoration,20,7,13
21152,Багсбанних,soulflayer,672,shaman,restoration,24,7,17
21153,Matsudah,ragnaros,671,shaman,restoration,12,7,5
21154,Alàstor,kazzak,671,shaman,restoration,12,7,5
21155,Bufuxx,kazzak,671,shaman,restoration,12,7,5
21156,Lariralol,malorne,671,shaman,restoration,12,7,5
21157,Mestgonee,draenor,671,shaman,restoration,12,7,5
21158,Megumín,darksorrow,671,shaman,restoration,12,7,5
21159,Elshimano,ravencrest,671,shaman,restoration,12,7,5
21160,Zippidizap,ulduar,671,shaman,restoration,18,7,11
21161,Shâdôwlîght,antonidas,671,shaman,restoration,18,7,11
21162,Sdkpwns,draenor,671,shaman,restoration,18,7,11
21163,Skullføck,argent-dawn,671,shaman,restoration,21,8,13
21164,Shámpain,antonidas,670,shaman,restoration,12,7,5
21165,Bluelasso,ysondre,670,shaman,restoration,24,7,17
21166,Woew,tarren-mill,669,shaman,restoration,12,7,5
21167,Shacharcaspi,blackmoore,669,shaman,restoration,24,7,17
21168,Millacki,blackrock,667,shaman,restoration,18,7,11
21169,Omeletteoeuf,silvermoon,666,shaman,restoration,12,7,5
21170,Fivezax,tarren-mill,665,shaman,restoration,12,7,5
21171,Bogmagnus,the-maelstrom,659,shaman,restoration,39,13,26
21172,Ayesapik,dalaran,657,shaman,restoration,12,7,5
21173,Nojiko,blackrock,638,shaman,restoration,17,7,10
21174,Иоч,soulflayer,623,shaman,restoration,11,7,4
21175,Енотикусь,soulflayer,618,shaman,restoration,12,8,4
21176,Disharmony,outland,618,shaman,restoration,12,8,4
21177,Hexewar,kazzak,618,shaman,restoration,17,8,9
21178,Randomuwu,stormscale,616,shaman,restoration,22,8,14
21179,Мке,howling-fjord,615,shaman,restoration,29,11,18
21180,Martiinii,dragonmaw,606,shaman,restoration,11,7,4
21181,Flowèn,twisting-nether,576,shaman,restoration,6,6,0
21182,Imdarat,hyjal,576,shaman,restoration,6,6,0
21183,Oldveteran,eredar,576,shaman,restoration,6,6,0
21184,Horcsog,ravencrest,576,shaman,restoration,12,6,6
21185,Purgecleave,dalvengyr,576,shaman,restoration,12,6,6
21186,Bordellgast,thrall,576,shaman,restoration,12,6,6
21187,Draredemolen,archimonde,576,shaman,restoration,12,6,6
21188,Skottkärrà,ravencrest,576,shaman,restoration,12,6,6
21189,Erepmad,ravencrest,576,shaman,restoration,12,6,6
21190,Lortihalsen,outland,576,shaman,restoration,12,6,6
21191,Kaluna,outland,576,shaman,restoration,12,6,6
21192,Blipster,tarren-mill,576,shaman,restoration,12,6,6
21193,Katwio,hyjal,576,shaman,restoration,12,6,6
21194,Tether,twisting-nether,576,shaman,restoration,12,6,6
21195,Runbrorun,hyjal,576,shaman,restoration,12,6,6
21196,Dimront,gorgonnash,576,shaman,restoration,12,6,6
21197,Mêrowinger,blackhand,576,shaman,restoration,12,6,6
21198,Rckfeller,burning-legion,576,shaman,restoration,12,6,6
21199,Lmnn,ravencrest,576,shaman,restoration,12,6,6
21200,Monamour,twisting-nether,576,shaman,restoration,12,6,6
21201,Gromaburst,stormscale,576,shaman,restoration,12,6,6
21202,Quizx,blackrock,576,shaman,restoration,12,6,6
21203,Embodiment,blackrock,576,shaman,restoration,12,6,6
21204,Jodel,tarren-mill,576,shaman,restoration,12,6,6
21205,Wintradezki,tarren-mill,576,shaman,restoration,12,6,6
21206,Bigdaddyxo,tarren-mill,576,shaman,restoration,12,6,6
21207,Канамаш,borean-tundra,576,shaman,restoration,12,6,6
21208,Khidon,silvermoon,576,shaman,restoration,12,6,6
21209,Гоэл,ashenvale,576,shaman,restoration,12,6,6
21210,Enoughh,the-maelstrom,576,shaman,restoration,12,6,6
21211,Nêmônin,perenolde,576,shaman,restoration,12,6,6
21212,Ambuu,kazzak,576,shaman,restoration,12,6,6
21213,Goodevening,tarren-mill,576,shaman,restoration,12,6,6
21214,Komodski,kazzak,576,shaman,restoration,12,6,6
21215,Амальтейх,soulflayer,576,shaman,restoration,12,6,6
21216,Superthomas,archimonde,576,shaman,restoration,23,9,14
21217,Floki,emerald-dream,576,shaman,restoration,18,6,12
21218,Bresidendo,frostwhisper,576,shaman,restoration,18,6,12
21219,Muril,argent-dawn,576,shaman,restoration,18,6,12
21220,Patsham,wildhammer,576,shaman,restoration,18,6,12
21221,Hyflex,alakir,576,shaman,restoration,24,6,18
21222,Smørbar,kazzak,575,shaman,restoration,6,6,0
21223,Crymere,chamber-of-aspects,575,shaman,restoration,12,6,6
21224,Shamnox,blackrock,575,shaman,restoration,12,6,6
21225,Outerspace,silvermoon,575,shaman,restoration,12,6,6
21226,Sjearthen,defias-brotherhood,575,shaman,restoration,12,6,6
21227,Stortvloed,twisting-nether,575,shaman,restoration,12,6,6
21228,Shazefin,twisting-nether,575,shaman,restoration,12,6,6
21229,Whatsup,aggramar,575,shaman,restoration,12,6,6
21230,Turbokrapka,tarren-mill,574,shaman,restoration,12,6,6
21231,Tidushears,thrall,574,shaman,restoration,12,6,6
21232,Polystrath,silvermoon,573,shaman,restoration,18,6,12
21233,Shammzy,mannoroth,573,shaman,restoration,18,6,12
21234,Alïsyo,nemesis,570,shaman,restoration,18,6,12
21235,Greenguard,argent-dawn,540,shaman,restoration,23,6,17
21236,Totemglad,drakthul,528,shaman,restoration,9,7,2
21237,Télapou,ragnaros,527,shaman,restoration,11,6,5
21238,Манрото,soulflayer,526,shaman,restoration,9,6,3
21239,Arigolds,twilights-hammer,511,shaman,restoration,11,6,5
21240,Jakesmistake,stormscale,494,shaman,restoration,11,7,4
21241,Эйвуа,gordunni,486,shaman,restoration,22,8,14
21242,Fernashaman,aggra-português,480,shaman,restoration,6,5,1
21243,Pepegahex,blackmoore,480,shaman,restoration,6,5,1
21244,Schamfxx,blackrock,480,shaman,restoration,6,5,1
21245,Doubleshamz,the-maelstrom,480,shaman,restoration,6,5,1
21246,Ub,garona,480,shaman,restoration,6,5,1
21247,Kelvok,silvermoon,480,shaman,restoration,6,5,1
21248,Antikahraman,blackrock,480,shaman,restoration,6,5,1
21249,Geneazytwo,silvermoon,480,shaman,restoration,6,5,1
21250,Shamsteaks,thrall,480,shaman,restoration,6,5,1
21251,Costakislolz,twisting-nether,480,shaman,restoration,6,5,1
21252,Терату,howling-fjord,480,shaman,restoration,6,5,1
21253,Qwauzinator,silvermoon,480,shaman,restoration,6,5,1
21254,Djschamihaar,blackrock,480,shaman,restoration,6,5,1
21255,Holytidezx,aegwynn,480,shaman,restoration,10,6,4
21256,Papskalla,ravencrest,480,shaman,restoration,12,5,7
21257,Uanl,stormscale,480,shaman,restoration,12,5,7
21258,Tooltip,tarren-mill,480,shaman,restoration,12,5,7
21259,Shamarco,nemesis,480,shaman,restoration,12,5,7
21260,Kaptt,twisting-nether,480,shaman,restoration,12,5,7
21261,Aeknor,ravencrest,480,shaman,restoration,12,5,7
21262,Nevagonalink,archimonde,480,shaman,restoration,12,5,7
21263,Nøný,gorgonnash,480,shaman,restoration,12,5,7
21264,Sørum,grim-batol,480,shaman,restoration,12,5,7
21265,Caliqueños,sanguino,480,shaman,restoration,12,5,7
21266,Lumière,alonsus,480,shaman,restoration,12,5,7
21267,Shamins,outland,480,shaman,restoration,12,5,7
21268,Flandersx,archimonde,480,shaman,restoration,12,5,7
21269,Soger,mannoroth,480,shaman,restoration,12,5,7
21270,Evííl,tarren-mill,480,shaman,restoration,12,5,7
21271,Volwerin,blackhand,480,shaman,restoration,12,5,7
21272,Maelynda,argent-dawn,480,shaman,restoration,12,5,7
21273,Spaceboy,archimonde,480,shaman,restoration,12,5,7
21274,Skrimisher,draenor,480,shaman,restoration,12,5,7
21275,Burrowabuser,nemesis,480,shaman,restoration,12,5,7
21276,Totemiclol,aegwynn,480,shaman,restoration,12,5,7
21277,Ironmack,outland,480,shaman,restoration,12,5,7
21278,Leafplsx,blackrock,480,shaman,restoration,12,5,7
21279,Cheerz,ravencrest,480,shaman,restoration,12,5,7
21280,Évileye,silvermoon,480,shaman,restoration,12,5,7
21281,Libano,archimonde,480,shaman,restoration,12,5,7
21282,Maestralink,aegwynn,480,shaman,restoration,12,5,7
21283,Adzkímo,tarren-mill,480,shaman,restoration,12,5,7
21284,Lontarsdaddy,twisting-nether,480,shaman,restoration,12,5,7
21285,Markboymint,earthen-ring,480,shaman,restoration,12,5,7
21286,Sliiderr,draenor,480,shaman,restoration,12,5,7
21287,Unleashme,sylvanas,480,shaman,restoration,12,5,7
21288,Hakunax,twisting-nether,480,shaman,restoration,12,5,7
21289,Xentic,kazzak,480,shaman,restoration,12,5,7
21290,Bandyy,magtheridon,480,shaman,restoration,12,5,7
21291,Tigo,tarren-mill,480,shaman,restoration,12,5,7
21292,Nübs,aegwynn,480,shaman,restoration,12,5,7
21293,Bruho,mazrigos,480,shaman,restoration,18,5,13
21294,Vickeshaman,stormreaver,480,shaman,restoration,18,5,13
21295,Селфлессх,soulflayer,480,shaman,restoration,18,5,13
21296,Nêgan,ravencrest,480,shaman,restoration,22,5,17
21297,Banilikum,tarren-mill,480,shaman,restoration,24,5,19
21298,Jelincic,ravencrest,480,shaman,restoration,24,5,19
21299,Savan,darkspear,480,shaman,restoration,24,5,19
21300,Rawtex,draenor,480,shaman,restoration,26,5,21
21301,Ominouslove,twisting-nether,479,shaman,restoration,12,5,7
21302,Donnerbubele,aegwynn,479,shaman,restoration,12,5,7
21303,Рёнтар,howling-fjord,478,shaman,restoration,12,5,7
21304,Asahi,arthas,447,shaman,restoration,11,5,6
21305,Altesh,die-todeskrallen,446,shaman,restoration,10,5,5
21306,Xerinas,eredar,432,shaman,restoration,15,6,9
21307,Cømedian,ragnaros,431,shaman,restoration,9,6,3
21308,Suculenta,zuljin,426,shaman,restoration,11,5,6
21309,Shamakerr,tarren-mill,426,shaman,restoration,17,7,10
21310,Äppelpaj,earthen-ring,426,shaman,restoration,15,6,9
21311,Blixtlasse,magtheridon,400,shaman,restoration,13,5,8
21312,Электро,thermaplugg,384,shaman,restoration,6,4,2
21313,Puffeh,emeriss,384,shaman,restoration,6,4,2
21314,Kempfer,blackrock,384,shaman,restoration,6,4,2
21315,Viallinen,stormreaver,384,shaman,restoration,6,4,2
21316,Хотдевил,gordunni,384,shaman,restoration,6,4,2
21317,Lingz,auchindoun,384,shaman,restoration,6,4,2
21318,Eras,ragnaros,384,shaman,restoration,6,4,2
21319,Kekke,uldum,384,shaman,restoration,6,4,2
21320,Totembeard,frostmourne,384,shaman,restoration,6,4,2
21321,Johnnysîns,blackhand,384,shaman,restoration,6,4,2
21322,Prup,tarren-mill,384,shaman,restoration,6,4,2
21323,Robbie,dentarg,384,shaman,restoration,6,4,2
21324,Greatørc,tarren-mill,384,shaman,restoration,6,4,2
21325,Kundt,dalaran,384,shaman,restoration,6,4,2
21326,Holytidez,aegwynn,384,shaman,restoration,6,4,2
21327,Axéron,blackhand,384,shaman,restoration,6,4,2
21328,Hamuksha,nerathor,384,shaman,restoration,6,4,2
21329,Oldandslow,sylvanas,384,shaman,restoration,6,4,2
21330,Ruvxy,twisting-nether,384,shaman,restoration,6,4,2
21331,Pank,kazzak,384,shaman,restoration,6,4,2
21332,Zhead,aggramar,384,shaman,restoration,6,4,2
21333,Soffsittaren,kazzak,384,shaman,restoration,6,4,2
21334,Роджермур,howling-fjord,384,shaman,restoration,6,4,2
21335,Ærthgød,stormscale,384,shaman,restoration,6,4,2
21336,Thriveqt,nemesis,384,shaman,restoration,6,4,2
21337,Artîe,archimonde,384,shaman,restoration,6,4,2
21338,Yozgatlilan,aegwynn,384,shaman,restoration,6,4,2
21339,Flùffy,nemesis,384,shaman,restoration,6,4,2
21340,Invade,darkspear,384,shaman,restoration,6,4,2
21341,Grimn,burning-legion,384,shaman,restoration,6,4,2
21342,Nellytko,aegwynn,384,shaman,restoration,6,4,2
21343,Bountiti,dun-modr,384,shaman,restoration,6,4,2
21344,Bandulski,twisting-nether,384,shaman,restoration,6,4,2
21345,Pasjeop,ravencrest,384,shaman,restoration,6,4,2
21346,Captaínduck,garrosh,384,shaman,restoration,11,5,6
21347,Criticalx,eredar,384,shaman,restoration,15,5,10
21348,Agrok,jaedenar,384,shaman,restoration,12,4,8
21349,Numbs,tarren-mill,384,shaman,restoration,12,4,8
21350,Keén,burning-legion,384,shaman,restoration,12,4,8
21351,Zyphiz,twisting-nether,384,shaman,restoration,12,4,8
21352,Daklickshamy,blackmoore,384,shaman,restoration,12,4,8
21353,Sempaihentai,draenor,384,shaman,restoration,12,4,8
21354,Archsha,burning-legion,384,shaman,restoration,12,4,8
21355,Serasol,sylvanas,384,shaman,restoration,12,4,8
21356,Omgodofwar,burning-blade,384,shaman,restoration,12,4,8
21357,Lavababe,blackmoore,384,shaman,restoration,12,4,8
21358,Lorthargol,chamber-of-aspects,384,shaman,restoration,12,4,8
21359,Энхай,azuregos,384,shaman,restoration,12,4,8
21360,Naphe,ysondre,384,shaman,restoration,12,4,8
21361,Roverlos,blackrock,384,shaman,restoration,12,4,8
21362,Maluch,burning-legion,384,shaman,restoration,12,4,8
21363,Wagaluu,ravencrest,384,shaman,restoration,12,4,8
21364,Gharn,sanguino,384,shaman,restoration,12,4,8
21365,Kerfo,ragnaros,384,shaman,restoration,12,4,8
21366,Vey,hyjal,384,shaman,restoration,12,4,8
21367,Ранняяпташка,soulflayer,384,shaman,restoration,12,4,8
21368,Saksyl,zuljin,384,shaman,restoration,12,4,8
21369,Notwhoheals,executus,384,shaman,restoration,12,4,8
21370,Kaffekask,stormscale,384,shaman,restoration,12,4,8
21371,Smahamtwo,stormscale,384,shaman,restoration,12,4,8
21372,Fünkchn,zuluhed,384,shaman,restoration,12,4,8
21373,Bobaléh,ravencrest,384,shaman,restoration,12,4,8
21374,Shinds,archimonde,384,shaman,restoration,12,4,8
21375,Gards,sylvanas,384,shaman,restoration,18,4,14
21376,Khattla,outland,383,shaman,restoration,6,4,2
21377,Darthshox,outland,383,shaman,restoration,10,5,5
21378,Sleyvarian,chamber-of-aspects,383,shaman,restoration,12,4,8
21379,Fîmbo,defias-brotherhood,383,shaman,restoration,12,4,8
21380,Jhaky,dun-modr,383,shaman,restoration,12,4,8
21381,Protv,ravencrest,382,shaman,restoration,6,4,2
21382,Killhorn,malganis,382,shaman,restoration,6,4,2
21383,Slippyjim,azshara,382,shaman,restoration,12,4,8
21384,Xpone,blackrock,380,shaman,restoration,12,4,8
21385,Icytide,kazzak,378,shaman,restoration,18,7,11
21386,Zboubii,archimonde,351,shaman,restoration,11,4,7
21387,Rokatotem,ysondre,336,shaman,restoration,9,4,5
21388,Gunhyld,hyjal,335,shaman,restoration,11,4,7
21389,Mycameltotem,ravencrest,330,shaman,restoration,15,5,10
21390,Xoxoxoxoa,twisting-nether,328,shaman,restoration,29,6,23
21391,Zhangliyi,ravencrest,319,shaman,restoration,5,4,1
21392,Murog,dalaran,319,shaman,restoration,8,4,4
21393,Turbohulk,blackrock,304,shaman,restoration,7,4,3
21394,Oldmanrena,stormscale,288,shaman,restoration,6,3,3
21395,Cristhor,nemesis,288,shaman,restoration,6,3,3
21396,Tarzh,dalaran,288,shaman,restoration,6,3,3
21397,Abalenn,kazzak,288,shaman,restoration,6,3,3
21398,Ханикс,blackscar,288,shaman,restoration,6,3,3
21399,Abercrômbx,blackmoore,288,shaman,restoration,6,3,3
21400,Mefl,tarren-mill,288,shaman,restoration,6,3,3
21401,Rndshaman,thrall,288,shaman,restoration,6,3,3
21402,Prepegahex,blackmoore,288,shaman,restoration,6,3,3
21403,Вэллкомм,gordunni,288,shaman,restoration,6,3,3
21404,Nizzarrathur,argent-dawn,288,shaman,restoration,6,3,3
21405,Chainbeef,blackmoore,288,shaman,restoration,6,3,3
21406,Меготип,deathweaver,288,shaman,restoration,6,3,3
21407,Tenror,ragnaros,288,shaman,restoration,6,3,3
21408,Mustabrutus,tarren-mill,288,shaman,restoration,6,3,3
21409,Kataclysm,nemesis,288,shaman,restoration,6,3,3
21410,Bingo,tarren-mill,288,shaman,restoration,6,3,3
21411,Jilyu,blackmoore,288,shaman,restoration,6,3,3
21412,Stormfreg,quelthalas,288,shaman,restoration,6,3,3
21413,Ярусскийй,howling-fjord,288,shaman,restoration,6,3,3
21414,Brandbombe,frostwolf,288,shaman,restoration,6,3,3
21415,Blboz,grim-batol,288,shaman,restoration,6,3,3
21416,Stibs,silvermoon,288,shaman,restoration,6,3,3
21417,Votie,tarren-mill,288,shaman,restoration,6,3,3
21418,Shànnón,kazzak,288,shaman,restoration,6,3,3
21419,Totemboyuk,tarren-mill,288,shaman,restoration,6,3,3
21420,Бриз,blackscar,288,shaman,restoration,6,3,3
21421,Shamamamin,argent-dawn,288,shaman,restoration,6,3,3
21422,Horiq,kazzak,288,shaman,restoration,6,3,3
21423,Grosgourdin,la-croisade-écarlate,288,shaman,restoration,6,3,3
21424,Kocaina,kazzak,288,shaman,restoration,6,3,3
21425,Groundcslol,kazzak,288,shaman,restoration,6,3,3
21426,Драмкул,soulflayer,288,shaman,restoration,6,3,3
21427,Wealey,drakthul,288,shaman,restoration,6,3,3
21428,Muddy,argent-dawn,288,shaman,restoration,6,3,3
21429,Binslagala,zuljin,288,shaman,restoration,6,3,3
21430,Ravenshock,bloodfeather,288,shaman,restoration,6,3,3
21431,Kilazz,twisting-nether,288,shaman,restoration,6,3,3
21432,Jazzcore,twisting-nether,288,shaman,restoration,6,3,3
21433,Shamoobob,archimonde,288,shaman,restoration,6,3,3
21434,Pépón,dun-modr,288,shaman,restoration,6,3,3
21435,Yarali,argent-dawn,288,shaman,restoration,6,3,3
21436,Stinkyfînger,draenor,288,shaman,restoration,6,3,3
21437,Soulsh,die-ewige-wacht,288,shaman,restoration,6,3,3
21438,Shamansh,draenor,288,shaman,restoration,6,3,3
21439,Кхуздуфар,blackscar,288,shaman,restoration,6,3,3
21440,Majinbeb,hyjal,288,shaman,restoration,6,3,3
21441,Cøkka,hyjal,288,shaman,restoration,6,3,3
21442,Kalinn,sylvanas,288,shaman,restoration,6,3,3
21443,Shèshe,uldaman,288,shaman,restoration,6,3,3
21444,Questionable,antonidas,288,shaman,restoration,6,3,3
21445,Richtigfies,kazzak,288,shaman,restoration,6,3,3
21446,Thísisrestø,sanguino,288,shaman,restoration,12,3,9
21447,Charquanda,argent-dawn,288,shaman,restoration,12,3,9
21448,Sorcerus,burning-legion,288,shaman,restoration,12,3,9
21449,Aboveaverage,stormscale,288,shaman,restoration,12,3,9
21450,Magicflames,draenor,288,shaman,restoration,12,3,9
21451,Madrävëngodx,ragnaros,288,shaman,restoration,12,3,9
21452,Kuzsham,archimonde,288,shaman,restoration,12,3,9
21453,Wtbtoes,ravencrest,288,shaman,restoration,12,3,9
21454,Nixxy,magtheridon,288,shaman,restoration,12,3,9
21455,Flameshock,area-52,288,shaman,restoration,12,3,9
21456,Kandrox,blackmoore,288,shaman,restoration,12,3,9
21457,Feizhousa,outland,288,shaman,restoration,12,3,9
21458,Колбаскофф,gordunni,288,shaman,restoration,12,3,9
21459,Volstorm,ysondre,288,shaman,restoration,12,3,9
21460,Pòcho,kazzak,288,shaman,restoration,17,3,14
21461,Quiec,kazzak,288,shaman,restoration,18,3,15
21462,Patites,twisting-nether,287,shaman,restoration,6,3,3
21463,Sakoon,twisting-nether,287,shaman,restoration,6,3,3
21464,Deeblu,nemesis,287,shaman,restoration,12,3,9
21465,Mwnci,anachronos,287,shaman,restoration,18,3,15
21466,Mimsy,hyjal,285,shaman,restoration,12,3,9
21467,Crazypurgeqt,arathor,255,shaman,restoration,17,3,14
21468,Whibbler,ravencrest,240,shaman,restoration,9,4,5
21469,Elliesham,kazzak,239,shaman,restoration,5,3,2
21470,Brigantino,burning-legion,239,shaman,restoration,5,3,2
21471,Tickly,blackhand,239,shaman,restoration,5,3,2
21472,Yukîmøn,hyjal,234,shaman,restoration,11,4,7
21473,Ikó,kazzak,234,shaman,restoration,22,6,16
21474,Fridafrog,malganis,192,shaman,restoration,6,2,4
21475,Wåe,outland,192,shaman,restoration,6,2,4
21476,Shamdren,outland,192,shaman,restoration,6,2,4
21477,Lêss,ysondre,192,shaman,restoration,6,2,4
21478,Maybeyes,twisting-nether,192,shaman,restoration,6,2,4
21479,Khayac,ravencrest,192,shaman,restoration,6,2,4
21480,Mosterx,stormscale,192,shaman,restoration,6,2,4
21481,Mcgrêgor,aegwynn,192,shaman,restoration,6,2,4
21482,Боргирх,soulflayer,192,shaman,restoration,6,2,4
21483,Coöld,archimonde,192,shaman,restoration,6,2,4
21484,Lycburst,twisting-nether,192,shaman,restoration,6,2,4
21485,Basegrandpa,ravencrest,192,shaman,restoration,6,2,4
21486,Элементаликс,ashenvale,192,shaman,restoration,6,2,4
21487,Jacquisham,archimonde,192,shaman,restoration,6,2,4
21488,Ðiezz,ysondre,192,shaman,restoration,6,2,4
21489,Bumbummann,blackmoore,192,shaman,restoration,6,2,4
21490,Natasz,burning-legion,192,shaman,restoration,6,2,4
21491,Srøgg,archimonde,192,shaman,restoration,6,2,4
21492,Nassîî,blackhand,192,shaman,restoration,6,2,4
21493,Palarins,dalaran,192,shaman,restoration,6,2,4
21494,Kàji,ravencrest,192,shaman,restoration,6,2,4
21495,Mikhey,archimonde,192,shaman,restoration,6,2,4
21496,Sniipy,blackmoore,192,shaman,restoration,6,2,4
21497,Jps,gorgonnash,192,shaman,restoration,6,2,4
21498,Oladoda,archimonde,192,shaman,restoration,6,2,4
21499,Sablolix,ravencrest,192,shaman,restoration,6,2,4
21500,Hímars,ragnaros,192,shaman,restoration,6,2,4
21501,Renátosz,ragnaros,192,shaman,restoration,6,2,4
21502,Wahya,stormscale,192,shaman,restoration,6,2,4
21503,Lexus,nordrassil,192,shaman,restoration,6,2,4
21504,Baboss,blutkessel,192,shaman,restoration,6,2,4
21505,Schmamane,blutkessel,192,shaman,restoration,6,2,4
21506,Урахарочка,soulflayer,192,shaman,restoration,6,2,4
21507,Raincaller,archimonde,192,shaman,restoration,6,2,4
21508,Domo,stormscale,192,shaman,restoration,6,2,4
21509,Kevox,malganis,192,shaman,restoration,6,2,4
21510,Cragouz,archimonde,192,shaman,restoration,6,2,4
21511,Shupp,stormscale,192,shaman,restoration,6,2,4
21512,Vyrá,onyxia,192,shaman,restoration,6,2,4
21513,Berascendz,argent-dawn,192,shaman,restoration,6,2,4
21514,Aciel,magtheridon,192,shaman,restoration,6,2,4
21515,Dapawz,defias-brotherhood,192,shaman,restoration,6,2,4
21516,Chêlëx,silvermoon,192,shaman,restoration,6,2,4
21517,Thanasiss,kazzak,192,shaman,restoration,6,2,4
21518,Liferqt,nemesis,192,shaman,restoration,6,2,4
21519,Pumanii,silvermoon,192,shaman,restoration,6,2,4
21520,Tobbey,tarren-mill,192,shaman,restoration,6,2,4
21521,Shàwyn,sylvanas,192,shaman,restoration,6,2,4
21522,Pûrge,tarren-mill,192,shaman,restoration,6,2,4
21523,Rheax,tarren-mill,192,shaman,restoration,6,2,4
21524,Pebble,blackrock,192,shaman,restoration,6,2,4
21525,Пучмек,gordunni,192,shaman,restoration,6,2,4
21526,Vulkan,kirin-tor,192,shaman,restoration,6,2,4
21527,Grende,sylvanas,192,shaman,restoration,6,2,4
21528,Strikerz,aggra-português,192,shaman,restoration,7,2,5
21529,Mostachin,dun-modr,192,shaman,restoration,10,2,8
21530,Ozzlac,thrall,192,shaman,restoration,12,2,10
21531,Nêôô,blackrock,192,shaman,restoration,12,2,10
21532,Cptnkirby,malganis,192,shaman,restoration,12,2,10
21533,Shamanarama,sylvanas,192,shaman,restoration,12,2,10
21534,Saarroo,ravencrest,192,shaman,restoration,12,2,10
21535,Ekxr,kazzak,192,shaman,restoration,12,2,10
21536,Killatotem,kazzak,192,shaman,restoration,12,2,10
21537,Muntark,thrall,192,shaman,restoration,12,2,10
21538,Nuekx,sanguino,192,shaman,restoration,12,2,10
21539,Jøw,dun-modr,191,shaman,restoration,6,2,4
21540,Valuriya,blackhand,191,shaman,restoration,6,2,4
21541,Zenzua,twisting-nether,159,shaman,restoration,5,2,3
21542,Jecastyle,sanguino,138,shaman,restoration,8,3,5
21543,Belldandý,archimonde,128,shaman,restoration,4,2,2
21544,Shamaray,stormscale,127,shaman,restoration,8,2,6
21545,Kelshaj,thrall,96,shaman,restoration,3,2,1
21546,Eclaîr,thrall,96,shaman,restoration,6,1,5
21547,Фистинктотем,soulflayer,96,shaman,restoration,6,1,5
21548,Gauss,agamaggan,96,shaman,restoration,6,1,5
21549,Reflux,outland,96,shaman,restoration,6,1,5
21550,Garulf,twisting-nether,96,shaman,restoration,6,1,5
21551,Zethh,antonidas,96,shaman,restoration,6,1,5
21552,Diabolous,drakthul,96,shaman,restoration,6,1,5
21553,Dvrg,antonidas,96,shaman,restoration,6,1,5
21554,Zeiger,minahonda,96,shaman,restoration,6,1,5
21555,Shamgott,silvermoon,96,shaman,restoration,6,1,5
21556,Таззикшок,soulflayer,96,shaman,restoration,6,1,5
21557,Hotstorm,bronzebeard,96,shaman,restoration,6,1,5
21558,Porke,moonglade,96,shaman,restoration,6,1,5
21559,Efdemin,blackmoore,96,shaman,restoration,6,1,5
21560,Rëazx,archimonde,96,shaman,restoration,6,1,5
21561,Greenbo,burning-blade,96,shaman,restoration,6,1,5
21562,Zimzalabling,kazzak,96,shaman,restoration,6,1,5
21563,Mòónz,kazzak,96,shaman,restoration,6,1,5
21564,Kimpa,minahonda,96,shaman,restoration,6,1,5
21565,Happyjuice,silvermoon,96,shaman,restoration,6,1,5
21566,Samisu,blackmoore,96,shaman,restoration,6,1,5
21567,Ronell,argent-dawn,96,shaman,restoration,6,1,5
21568,Elchivo,blackrock,96,shaman,restoration,6,1,5
21569,Dälon,thrall,96,shaman,restoration,6,1,5
21570,Chênoya,blackrock,96,shaman,restoration,6,1,5
21571,Jaeslin,tarren-mill,96,shaman,restoration,6,1,5
21572,Tteïl,archimonde,96,shaman,restoration,6,1,5
21573,Mystico,sanguino,96,shaman,restoration,6,1,5
21574,Picklechris,tarren-mill,96,shaman,restoration,6,1,5
21575,Freeleys,silvermoon,96,shaman,restoration,12,1,11
21576,Ikeaboy,eredar,96,shaman,restoration,12,1,11
21577,Goldhand,ravencrest,96,shaman,restoration,12,1,11
21578,Porre,zuljin,96,shaman,restoration,12,1,11
21579,Tiamât,culte-de-la-rive-noire,96,shaman,restoration,12,1,11
21580,Akuha,dun-modr,96,shaman,restoration,12,1,11
21581,Íss,cthun,96,shaman,restoration,12,1,11
21582,Chunkss,argent-dawn,96,shaman,restoration,12,1,11
21583,Penumbrah,kazzak,96,shaman,restoration,20,1,19
21584,Hairball,turalyon,95,shaman,restoration,6,2,4
21585,Twotwozero,defias-brotherhood,95,shaman,restoration,6,1,5
21586,Taiki,sylvanas,90,shaman,restoration,13,4,9
21587,Realiz,ysondre,79,shaman,restoration,5,1,4
21588,Destrosoul,kazzak,64,shaman,restoration,4,1,3
21589,Yakee,doomhammer,63,shaman,restoration,2,2,0
21590,Icozy,stormscale,48,shaman,restoration,3,1,2
21591,Icanbreathe,ravencrest,42,shaman,restoration,9,2,7
21592,Shammez,ravencrest,42,shaman,restoration,11,2,9
21593,Gerlo,thrall,41,shaman,restoration,7,2,5
21594,Rungõo,blackrock,2267,shaman,elemental,84,48,36
21595,Reibanit,twisting-nether,2250,shaman,elemental,141,82,59
21596,Proccit,blackrock,2226,shaman,elemental,90,50,40
21597,Lexila,doomhammer,2225,shaman,elemental,191,110,81
21598,Silden,thrall,2157,shaman,elemental,97,55,42
21599,Shamanazor,twisting-nether,2153,shaman,elemental,66,41,25
21600,Lavaole,blackrock,2144,shaman,elemental,72,39,33
21601,Space,stormscale,2144,shaman,elemental,126,66,60
21602,Trickful,kazzak,2136,shaman,elemental,60,42,18
21603,Theglue,kilrogg,2124,shaman,elemental,60,36,24
21604,Shiggenbasta,kazzak,2099,shaman,elemental,72,42,30
21605,Маигваза,soulflayer,2067,shaman,elemental,54,37,17
21606,Wisplol,ravencrest,2060,shaman,elemental,88,49,39
21607,Lavayoshi,kazzak,2026,shaman,elemental,72,48,24
21608,Båkka,ysondre,2005,shaman,elemental,42,28,14
21609,Edshearen,stormscale,2004,shaman,elemental,57,34,23
21610,Rngo,blackrock,1992,shaman,elemental,42,27,15
21611,Satisfya,ambossar,1957,shaman,elemental,59,34,25
21612,Eyi,ambossar,1955,shaman,elemental,86,46,40
21613,Drshock,blackmoore,1950,shaman,elemental,66,35,31
21614,Onceinalife,ambossar,1944,shaman,elemental,71,40,31
21615,Tommybanger,kazzak,1921,shaman,elemental,57,33,24
21616,Suldaro,aegwynn,1913,shaman,elemental,67,36,31
21617,Eupra,archimonde,1902,shaman,elemental,48,29,19
21618,Punished,blackrock,1901,shaman,elemental,72,41,31
21619,Smorchamp,sanguino,1898,shaman,elemental,60,32,28
21620,Totemlié,ravencrest,1887,shaman,elemental,42,27,15
21621,Baldcreep,blackrock,1885,shaman,elemental,36,22,14
21622,Gungo,deathwing,1880,shaman,elemental,36,20,16
21623,Teslashock,outland,1879,shaman,elemental,30,20,10
21624,Obryss,tarren-mill,1876,shaman,elemental,36,20,16
21625,Nevershearx,blackrock,1873,shaman,elemental,48,25,23
21626,Nekhros,sargeras,1867,shaman,elemental,114,63,51
21627,Borbor,argent-dawn,1858,shaman,elemental,46,23,23
21628,Kärríegold,blackrock,1850,shaman,elemental,111,59,52
21629,Pipousham,blackhand,1849,shaman,elemental,35,20,15
21630,Crazyshaman,ravencrest,1829,shaman,elemental,53,26,27
21631,Kæzx,blackrock,1822,shaman,elemental,78,45,33
21632,Штормкрашер,howling-fjord,1810,shaman,elemental,48,30,18
21633,Agrero,auchindoun,1810,shaman,elemental,48,26,22
21634,Chamel,draenor,1808,shaman,elemental,30,19,11
21635,Kailash,defias-brotherhood,1808,shaman,elemental,54,26,28
21636,Thyeori,stormscale,1806,shaman,elemental,36,19,17
21637,Fabslx,archimonde,1806,shaman,elemental,69,31,38
21638,Burstraze,tarren-mill,1801,shaman,elemental,58,32,26
21639,Spajry,drakthul,1800,shaman,elemental,48,32,16
21640,Anqe,twisting-nether,1800,shaman,elemental,66,34,32
21641,Raintlordx,twisting-nether,1799,shaman,elemental,24,19,5
21642,Хеллбат,howling-fjord,1794,shaman,elemental,30,19,11
21643,Blackyx,cthun,1794,shaman,elemental,42,25,17
21644,Psÿkz,kazzak,1790,shaman,elemental,57,25,32
21645,Chênoya,blackrock,1789,shaman,elemental,61,28,33
21646,Naorgot,uldaman,1785,shaman,elemental,54,27,27
21647,Pitsamestari,frostmane,1780,shaman,elemental,122,68,54
21648,Uselesslaso,sanguino,1779,shaman,elemental,41,22,19
21649,Volcanò,outland,1778,shaman,elemental,134,66,68
21650,Naskezz,kazzak,1776,shaman,elemental,89,42,47
21651,Novoz,ysondre,1775,shaman,elemental,36,19,17
21652,Mjorè,twisting-nether,1765,shaman,elemental,55,28,27
21653,Thorleíf,silvermoon,1763,shaman,elemental,54,30,24
21654,Transcendent,malorne,1761,shaman,elemental,67,52,15
21655,Healyoa,blackmoore,1759,shaman,elemental,123,58,65
21656,Eledelede,blackhand,1758,shaman,elemental,42,26,16
21657,Voydetesto,sanguino,1753,shaman,elemental,84,39,45
21658,Mcmxcvi,ravencrest,1750,shaman,elemental,36,23,13
21659,Djlavaburst,malganis,1741,shaman,elemental,149,73,76
21660,Blyatifulday,malganis,1736,shaman,elemental,42,22,20
21661,Paulbaniel,alonsus,1734,shaman,elemental,54,26,28
21662,Zest,hyjal,1733,shaman,elemental,47,25,22
21663,Ryysham,ravencrest,1729,shaman,elemental,57,27,30
21664,Braíntas,norgannon,1727,shaman,elemental,66,31,35
21665,Doyah,eredar,1717,shaman,elemental,30,19,11
21666,Starelement,draenor,1716,shaman,elemental,42,18,24
21667,Чойсе,deathguard,1711,shaman,elemental,51,26,25
21668,Xtremeshaman,blackmoore,1709,shaman,elemental,24,18,6
21669,Crespó,alakir,1708,shaman,elemental,36,18,18
21670,Шумноватт,howling-fjord,1700,shaman,elemental,42,19,23
21671,Lianitus,tarren-mill,1699,shaman,elemental,46,24,22
21672,Nalaadu,stormscale,1686,shaman,elemental,30,18,12
21673,Sáàd,ravencrest,1681,shaman,elemental,42,20,22
21674,Tasoro,sanguino,1678,shaman,elemental,41,18,23
21675,Barbarra,stormscale,1673,shaman,elemental,42,22,20
21676,Esal,blackrock,1665,shaman,elemental,31,21,10
21677,Lavatherapy,grim-batol,1664,shaman,elemental,42,25,17
21678,Xorron,archimonde,1658,shaman,elemental,90,40,50
21679,Elektron,malganis,1657,shaman,elemental,42,24,18
21680,Ungabungha,stormscale,1657,shaman,elemental,102,58,44
21681,Haasshaman,ravencrest,1656,shaman,elemental,91,41,50
21682,Malybou,ysondre,1651,shaman,elemental,36,18,18
21683,Электро,thermaplugg,1648,shaman,elemental,47,24,23
21684,Карбонатрикс,soulflayer,1641,shaman,elemental,30,19,11
21685,Axahavregryn,kazzak,1640,shaman,elemental,66,40,26
21686,Urshak,alleria,1639,shaman,elemental,36,24,12
21687,Ânuk,blackrock,1639,shaman,elemental,126,61,65
21688,Zaarok,voljin,1639,shaman,elemental,91,41,50
21689,Dakyele,ravencrest,1636,shaman,elemental,35,20,15
21690,Proccq,twisting-nether,1632,shaman,elemental,34,18,16
21691,Rrtyui,twisting-nether,1628,shaman,elemental,30,17,13
21692,Valgø,twisting-nether,1626,shaman,elemental,58,35,23
21693,Murdá,ravencrest,1624,shaman,elemental,42,20,22
21694,Eppîx,lightnings-blade,1622,shaman,elemental,34,18,16
21695,Suirz,dun-modr,1620,shaman,elemental,36,24,12
21696,Kemurus,kazzak,1610,shaman,elemental,77,42,35
21697,Shibol,ravencrest,1609,shaman,elemental,46,23,23
21698,Alwaysangry,silvermoon,1603,shaman,elemental,42,25,17
21699,Matmonai,hyjal,1603,shaman,elemental,42,19,23
21700,Løun,archimonde,1602,shaman,elemental,54,31,23
21701,Mcbloob,kazzak,1602,shaman,elemental,70,36,34
21702,Elrayitos,shendralar,1601,shaman,elemental,42,26,16
21703,Regnever,draenor,1596,shaman,elemental,84,30,54
21704,Мистеркутёж,gordunni,1593,shaman,elemental,47,25,22
21705,Гудлаик,soulflayer,1584,shaman,elemental,58,32,26
21706,Smorclelx,khadgar,1583,shaman,elemental,30,19,11
21707,Brugdar,tarren-mill,1574,shaman,elemental,30,22,8
21708,Twiva,silvermoon,1572,shaman,elemental,76,45,31
21709,Blízzilassø,malygos,1572,shaman,elemental,179,93,86
21710,Anøüchkä,ysondre,1572,shaman,elemental,42,21,21
21711,Neotrax,outland,1571,shaman,elemental,60,31,29
21712,Sniffix,ysondre,1566,shaman,elemental,91,47,44
21713,Harod,suramar,1558,shaman,elemental,66,34,32
21714,Hapkin,defias-brotherhood,1558,shaman,elemental,54,27,27
21715,Deeck,ravencrest,1557,shaman,elemental,60,38,22
21716,Sunsong,twisting-nether,1557,shaman,elemental,42,21,21
21717,Nykhara,sanguino,1554,shaman,elemental,30,17,13
21718,Jímmy,frostwhisper,1548,shaman,elemental,42,28,14
21719,Aviciix,sanguino,1547,shaman,elemental,68,26,42
21720,Rungozvs,blackrock,1535,shaman,elemental,24,16,8
21721,Batan,kazzak,1535,shaman,elemental,71,31,40
21722,Connecting,hyjal,1534,shaman,elemental,30,16,14
21723,Élé,twisting-nether,1528,shaman,elemental,30,16,14
21724,Lilmarco,stormreaver,1526,shaman,elemental,36,16,20
21725,Máui,korgall,1525,shaman,elemental,66,34,32
21726,Essneces,burning-legion,1523,shaman,elemental,36,18,18
21727,Mariomental,draenor,1517,shaman,elemental,36,16,20
21728,Kohnân,hyjal,1516,shaman,elemental,30,16,14
21729,Mezzoblu,sanguino,1507,shaman,elemental,78,38,40
21730,Ralokar,blackrock,1505,shaman,elemental,42,23,19
21731,Милфшама,blackscar,1505,shaman,elemental,35,17,18
21732,Касикандрэра,soulflayer,1491,shaman,elemental,66,38,28
21733,Хэйзл,ashenvale,1490,shaman,elemental,44,25,19
21734,Robofat,ravencrest,1490,shaman,elemental,30,17,13
21735,Valunii,lordaeron,1488,shaman,elemental,100,44,56
21736,Zna,archimonde,1474,shaman,elemental,52,25,27
21737,Waaghbozz,eredar,1468,shaman,elemental,36,20,16
21738,Hemradi,blackmoore,1467,shaman,elemental,30,20,10
21739,Lafia,blackrock,1463,shaman,elemental,42,16,26
21740,Athul,theradras,1456,shaman,elemental,43,23,20
21741,Kirak,anetheron,1455,shaman,elemental,72,40,32
21742,Тыщатристах,howling-fjord,1453,shaman,elemental,42,29,13
21743,Томёрк,gordunni,1448,shaman,elemental,118,55,63
21744,Тессельхоф,howling-fjord,1446,shaman,elemental,28,16,12
21745,Дестройбэйби,gordunni,1441,shaman,elemental,66,37,29
21746,Mèåtbåll,ravencrest,1439,shaman,elemental,18,15,3
21747,Alèks,forscherliga,1437,shaman,elemental,74,46,28
21748,Baarona,neptulon,1434,shaman,elemental,27,17,10
21749,Skrbkic,tarren-mill,1429,shaman,elemental,91,48,43
21750,Cracklord,outland,1427,shaman,elemental,30,17,13
21751,Fúth,ysondre,1420,shaman,elemental,34,17,17
21752,Reignisover,silvermoon,1415,shaman,elemental,33,17,16
21753,Flubberman,blackrock,1402,shaman,elemental,33,18,15
21754,Olawizard,draenor,1401,shaman,elemental,43,22,21
21755,Xesti,twisting-nether,1394,shaman,elemental,63,32,31
21756,Сепич,gordunni,1386,shaman,elemental,42,26,16
21757,Pórçé,shattered-hand,1377,shaman,elemental,90,47,43
21758,Rohknar,ragnaros,1374,shaman,elemental,30,17,13
21759,Kimpa,minahonda,1373,shaman,elemental,66,37,29
21760,Naturexz,silvermoon,1372,shaman,elemental,26,16,10
21761,Lantbruk,twisting-nether,1362,shaman,elemental,28,15,13
21762,Chøurøx,hyjal,1358,shaman,elemental,37,21,16
21763,Canjo,aegwynn,1350,shaman,elemental,36,15,21
21764,Onlyfansmod,uldum,1349,shaman,elemental,36,16,20
21765,Tempest,kul-tiras,1346,shaman,elemental,41,23,18
21766,Дашажмихекс,howling-fjord,1343,shaman,elemental,18,14,4
21767,Jelvin,tarren-mill,1343,shaman,elemental,24,14,10
21768,Tâsty,blackmoore,1343,shaman,elemental,24,14,10
21769,Херург,soulflayer,1342,shaman,elemental,30,14,16
21770,Флоррэт,gordunni,1340,shaman,elemental,78,33,45
21771,Horizons,the-maelstrom,1338,shaman,elemental,24,14,10
21772,Sshaasam,tarren-mill,1337,shaman,elemental,24,14,10
21773,Totemlyhot,blackrock,1333,shaman,elemental,24,14,10
21774,Kapïtão,aggra-português,1332,shaman,elemental,24,14,10
21775,Гексанол,soulflayer,1332,shaman,elemental,34,16,18
21776,Screwz,archimonde,1327,shaman,elemental,44,21,23
21777,Microb,blackmoore,1326,shaman,elemental,30,14,16
21778,Vulcainn,marécage-de-zangar,1324,shaman,elemental,77,49,28
21779,Bâllz,anetheron,1314,shaman,elemental,54,23,31
21780,Amanishama,twisting-nether,1313,shaman,elemental,42,21,21
21781,Lavamann,blackmoore,1313,shaman,elemental,36,18,18
21782,Doneteasy,blackrock,1310,shaman,elemental,52,24,28
21783,Prêxy,kazzak,1307,shaman,elemental,35,14,21
21784,Aldonatello,blackrock,1306,shaman,elemental,30,17,13
21785,Elshifotrem,throkferoth,1282,shaman,elemental,52,28,24
21786,Xfiles,garona,1278,shaman,elemental,48,24,24
21787,Pawsh,dun-modr,1273,shaman,elemental,33,17,16
21788,Liluzivert,mannoroth,1271,shaman,elemental,23,14,9
21789,Bigboisham,outland,1260,shaman,elemental,59,27,32
21790,Blackyx,dun-modr,1247,shaman,elemental,18,13,5
21791,Dretch,dun-morogh,1247,shaman,elemental,24,13,11
21792,Starpior,stormscale,1246,shaman,elemental,33,14,19
21793,Pxsquals,ravencrest,1245,shaman,elemental,24,13,11
21794,Quizx,blackrock,1245,shaman,elemental,60,25,35
21795,Fullavaids,grim-batol,1243,shaman,elemental,24,13,11
21796,Gagné,hyjal,1239,shaman,elemental,24,13,11
21797,Ласара,eversong,1239,shaman,elemental,30,13,17
21798,Makgoa,ysondre,1237,shaman,elemental,18,13,5
21799,Couldar,stormscale,1236,shaman,elemental,18,13,5
21800,Vladraxes,draenor,1222,shaman,elemental,18,13,5
21801,Scurvy,malganis,1222,shaman,elemental,75,41,34
21802,Bigheal,quelthalas,1222,shaman,elemental,30,13,17
21803,Waterboi,blackmoore,1219,shaman,elemental,24,13,11
21804,Сосмыслом,howling-fjord,1217,shaman,elemental,30,13,17
21805,Maggoshishi,blackmoore,1214,shaman,elemental,66,34,32
21806,Dropdattotem,stormscale,1209,shaman,elemental,30,13,17
21807,Rekhtar,burning-legion,1201,shaman,elemental,56,29,27
21808,Märthalouise,twisting-nether,1191,shaman,elemental,29,15,14
21809,Valdera,dun-morogh,1189,shaman,elemental,24,14,10
21810,Lechirurgien,elune,1184,shaman,elemental,74,39,35
21811,Кирагаз,gordunni,1176,shaman,elemental,29,13,16
21812,Superkee,kazzak,1169,shaman,elemental,53,28,25
21813,Фистинктотем,soulflayer,1162,shaman,elemental,35,16,19
21814,Велгур,soulflayer,1161,shaman,elemental,50,23,27
21815,Azmerloth,outland,1152,shaman,elemental,18,12,6
21816,Feetenjoyerx,kazzak,1151,shaman,elemental,24,12,12
21817,Neverplayele,kazzak,1151,shaman,elemental,24,12,12
21818,Dräpàrn,sylvanas,1151,shaman,elemental,24,12,12
21819,Мэморисс,gordunni,1149,shaman,elemental,24,12,12
21820,Justweirdaf,blackmoore,1148,shaman,elemental,45,20,25
21821,Diaba,sylvanas,1146,shaman,elemental,24,12,12
21822,Dzielnysham,silvermoon,1145,shaman,elemental,21,13,8
21823,Headthirst,ragnaros,1145,shaman,elemental,24,12,12
21824,Goromar,kirin-tor,1144,shaman,elemental,54,22,32
21825,Carusø,thrall,1139,shaman,elemental,27,15,12
21826,Boxo,frostwolf,1137,shaman,elemental,70,38,32
21827,Djent,outland,1133,shaman,elemental,24,12,12
21828,Bowtenstorm,ravencrest,1120,shaman,elemental,25,16,9
21829,Farùk,ravencrest,1102,shaman,elemental,21,13,8
21830,Earthtjockis,ragnaros,1087,shaman,elemental,17,12,5
21831,Houmpf,hyjal,1056,shaman,elemental,18,11,7
21832,Pheazka,outland,1056,shaman,elemental,18,11,7
21833,Bärtigeberta,aegwynn,1056,shaman,elemental,18,11,7
21834,Matmons,hyjal,1056,shaman,elemental,24,11,13
21835,Èrò,blackhand,1053,shaman,elemental,24,11,13
21836,Monstermunch,ravencrest,1053,shaman,elemental,30,11,19
21837,Manaphi,arthas,1052,shaman,elemental,24,11,13
21838,Smort,frostwolf,1051,shaman,elemental,24,11,13
21839,Louler,ragnaros,1049,shaman,elemental,24,11,13
21840,Magnetoe,ravencrest,1049,shaman,elemental,24,11,13
21841,Kylas,die-ewige-wacht,1047,shaman,elemental,18,11,7
21842,Магмарончик,gordunni,1035,shaman,elemental,60,21,39
21843,Ormanthep,hyjal,1029,shaman,elemental,18,11,7
21844,Flochy,argent-dawn,1027,shaman,elemental,53,31,22
21845,Magath,nethersturm,1027,shaman,elemental,24,11,13
21846,Alfang,turalyon,1005,shaman,elemental,35,11,24
21847,Laquium,blackmoore,990,shaman,elemental,29,11,18
21848,Ximid,doomhammer,978,shaman,elemental,59,28,31
21849,Shrmful,dun-modr,960,shaman,elemental,12,10,2
21850,Nëllaqt,archimonde,960,shaman,elemental,18,10,8
21851,Iavalavalava,tarren-mill,960,shaman,elemental,18,10,8
21852,Haumx,blackrock,960,shaman,elemental,24,10,14
21853,Muscade,silvermoon,959,shaman,elemental,12,10,2
21854,Дзод,deathweaver,959,shaman,elemental,18,10,8
21855,Aspên,archimonde,959,shaman,elemental,18,10,8
21856,Stickix,malganis,959,shaman,elemental,18,10,8
21857,Smashz,stormscale,959,shaman,elemental,18,10,8
21858,Incredibade,stormscale,958,shaman,elemental,18,10,8
21859,Minasa,saurfang,958,shaman,elemental,30,10,20
21860,Atuaßëlha,grim-batol,957,shaman,elemental,24,10,14
21861,Elevlach,drakthul,957,shaman,elemental,30,10,20
21862,Sojee,ysondre,956,shaman,elemental,18,10,8
21863,Ххенеси,soulflayer,947,shaman,elemental,24,10,14
21864,Blackmuamba,tarren-mill,946,shaman,elemental,18,10,8
21865,Obesisham,outland,943,shaman,elemental,30,11,19
21866,Smorcxx,kazzak,934,shaman,elemental,30,10,20
21867,Orishimaru,blackrock,932,shaman,elemental,23,10,13
21868,Соленый,booty-bay,883,shaman,elemental,81,36,45
21869,Bambustic,kazzak,864,shaman,elemental,12,9,3
21870,Plazmorc,stormscale,864,shaman,elemental,12,9,3
21871,ßaraky,kazzak,864,shaman,elemental,12,9,3
21872,Elegodx,ravencrest,864,shaman,elemental,12,9,3
21873,Elvalya,archimonde,864,shaman,elemental,18,9,9
21874,Jøhnwick,ysondre,864,shaman,elemental,18,9,9
21875,Psyku,outland,864,shaman,elemental,24,9,15
21876,Johncoltrane,archimonde,863,shaman,elemental,12,9,3
21877,Raknoxye,blackrock,863,shaman,elemental,12,9,3
21878,Гивми,blackscar,863,shaman,elemental,16,10,6
21879,Думсия,gordunni,863,shaman,elemental,18,9,9
21880,Drainergødx,ragnaros,863,shaman,elemental,18,9,9
21881,Belsazar,frostwolf,863,shaman,elemental,24,9,15
21882,Torouk,rashgarroth,862,shaman,elemental,18,9,9
21883,Рэйвантотем,soulflayer,862,shaman,elemental,18,9,9
21884,Shkook,archimonde,862,shaman,elemental,24,9,15
21885,Bunnz,kazzak,861,shaman,elemental,12,9,3
21886,Rakzhaza,blackmoore,860,shaman,elemental,18,9,9
21887,Штормбайт,azuregos,858,shaman,elemental,12,9,3
21888,Tiamât,culte-de-la-rive-noire,835,shaman,elemental,30,9,21
21889,Незнаком,booty-bay,811,shaman,elemental,30,12,18
21890,Holdafstand,tarren-mill,798,shaman,elemental,14,9,5
21891,Dumpaman,frostmane,768,shaman,elemental,12,8,4
21892,Guzzelinare,tarren-mill,768,shaman,elemental,12,8,4
21893,Zoomar,tarren-mill,768,shaman,elemental,12,8,4
21894,Grapefruit,blackmoore,768,shaman,elemental,12,8,4
21895,Visboer,stormscale,768,shaman,elemental,12,8,4
21896,Strór,twisting-nether,768,shaman,elemental,12,8,4
21897,Adamyo,stormscale,768,shaman,elemental,18,8,10
21898,Thundergødx,nemesis,768,shaman,elemental,18,8,10
21899,Òoòoòoòoòoòo,silvermoon,768,shaman,elemental,18,8,10
21900,Naphe,ysondre,768,shaman,elemental,18,8,10
21901,Thorunir,sylvanas,768,shaman,elemental,24,8,16
21902,Yang,der-rat-von-dalaran,767,shaman,elemental,12,8,4
21903,Ædshearan,blackmoore,767,shaman,elemental,12,8,4
21904,Skeiilz,hyjal,767,shaman,elemental,12,8,4
21905,Nachtary,blackmoore,767,shaman,elemental,12,8,4
21906,Shaakez,kazzak,767,shaman,elemental,18,8,10
21907,Totempoo,the-maelstrom,766,shaman,elemental,12,8,4
21908,Parthon,ravencrest,765,shaman,elemental,12,8,4
21909,Noyá,argent-dawn,764,shaman,elemental,18,8,10
21910,Itsnasty,blackmoore,753,shaman,elemental,18,8,10
21911,Эфирад,blackscar,708,shaman,elemental,20,9,11
21912,Wacomtablet,kazzak,703,shaman,elemental,11,8,3
21913,Koífish,ravencrest,672,shaman,elemental,12,7,5
21914,Ðãvê,veknilash,672,shaman,elemental,12,7,5
21915,Replicusele,doomhammer,672,shaman,elemental,12,7,5
21916,Dócshock,blackmoore,672,shaman,elemental,12,7,5
21917,Hothand,thrall,672,shaman,elemental,12,7,5
21918,Eðualc,hyjal,672,shaman,elemental,12,7,5
21919,Thordes,forscherliga,672,shaman,elemental,12,7,5
21920,Bosslikex,ravencrest,672,shaman,elemental,12,7,5
21921,Jehae,archimonde,672,shaman,elemental,12,7,5
21922,Davinshhe,kazzak,672,shaman,elemental,12,7,5
21923,Shamandoino,wildhammer,672,shaman,elemental,12,7,5
21924,Bigblué,tarren-mill,672,shaman,elemental,12,7,5
21925,Kæde,dun-morogh,672,shaman,elemental,12,7,5
21926,Dòrfy,silvermoon,672,shaman,elemental,12,7,5
21927,Reburdacoxis,sanguino,672,shaman,elemental,12,7,5
21928,Гарбаджи,galakrond,672,shaman,elemental,12,7,5
21929,Rawside,thrall,672,shaman,elemental,18,7,11
21930,Endry,elune,672,shaman,elemental,18,7,11
21931,Støya,archimonde,672,shaman,elemental,18,7,11
21932,Thriveqt,nemesis,672,shaman,elemental,24,7,17
21933,Hotis,onyxia,672,shaman,elemental,24,7,17
21934,Fâro,dun-modr,671,shaman,elemental,12,7,5
21935,Xiomora,argent-dawn,671,shaman,elemental,12,7,5
21936,Lêmberger,eredar,671,shaman,elemental,12,7,5
21937,Ulfax,argent-dawn,671,shaman,elemental,24,7,17
21938,Griins,ravencrest,670,shaman,elemental,12,7,5
21939,Apolomaeuz,frostwolf,670,shaman,elemental,18,7,11
21940,Hugzy,argent-dawn,665,shaman,elemental,12,7,5
21941,Watson,conseil-des-ombres,660,shaman,elemental,18,7,11
21942,Федосик,galakrond,658,shaman,elemental,18,7,11
21943,Айвимэдисон,howling-fjord,623,shaman,elemental,17,7,10
21944,Ангустиа,galakrond,607,shaman,elemental,11,7,4
21945,Zanyun,burning-legion,607,shaman,elemental,14,7,7
21946,Trastamar,dun-modr,576,shaman,elemental,6,6,0
21947,Jåime,ravencrest,576,shaman,elemental,6,6,0
21948,Forrak,argent-dawn,576,shaman,elemental,12,6,6
21949,Bigrambo,draenor,576,shaman,elemental,12,6,6
21950,Woof,culte-de-la-rive-noire,576,shaman,elemental,12,6,6
21951,Nokster,twisting-nether,576,shaman,elemental,12,6,6
21952,Windfúhrèr,tarren-mill,576,shaman,elemental,12,6,6
21953,Legended,tarren-mill,576,shaman,elemental,12,6,6
21954,Simppe,stormreaver,576,shaman,elemental,12,6,6
21955,Localicious,ragnaros,576,shaman,elemental,12,6,6
21956,Lavalava,blackmoore,576,shaman,elemental,12,6,6
21957,Nobrac,rajaxx,576,shaman,elemental,12,6,6
21958,Веег,deathweaver,576,shaman,elemental,12,6,6
21959,Cïgänää,archimonde,576,shaman,elemental,12,6,6
21960,Trixxsham,twisting-nether,576,shaman,elemental,12,6,6
21961,Totemkahmun,kazzak,576,shaman,elemental,12,6,6
21962,Xelphia,frostmane,576,shaman,elemental,12,6,6
21963,Dsgrc,tarren-mill,576,shaman,elemental,18,6,12
21964,Unding,azshara,576,shaman,elemental,24,6,18
21965,Blyátmán,twisting-nether,575,shaman,elemental,12,6,6
21966,Layonne,ysondre,575,shaman,elemental,12,6,6
21967,Syndia,das-konsortium,575,shaman,elemental,12,6,6
21968,Sunraiser,blackmoore,575,shaman,elemental,12,6,6
21969,Blancc,kazzak,575,shaman,elemental,13,6,7
21970,Озверею,goldrinn,573,shaman,elemental,12,6,6
21971,Cleandann,stormscale,559,shaman,elemental,17,6,11
21972,Isheartears,outland,543,shaman,elemental,11,6,5
21973,Hanatopikeur,grim-batol,527,shaman,elemental,17,6,11
21974,Turbokrapka,tarren-mill,522,shaman,elemental,17,8,9
21975,Grambozz,blackrock,480,shaman,elemental,6,5,1
21976,Тандерхх,howling-fjord,480,shaman,elemental,6,5,1
21977,Autopanne,malganis,480,shaman,elemental,6,5,1
21978,Bumstead,ragnaros,480,shaman,elemental,6,5,1
21979,Shocknrun,sylvanas,480,shaman,elemental,6,5,1
21980,Rhonix,blackmoore,480,shaman,elemental,6,5,1
21981,Смоуктли,howling-fjord,480,shaman,elemental,6,5,1
21982,Highfaî,tarren-mill,480,shaman,elemental,6,5,1
21983,Эртирон,howling-fjord,480,shaman,elemental,6,5,1
21984,Hexina,ragnaros,480,shaman,elemental,6,5,1
21985,Minimalist,stormscale,480,shaman,elemental,6,5,1
21986,Navyblue,sylvanas,480,shaman,elemental,6,5,1
21987,Phobiatics,thrall,480,shaman,elemental,6,5,1
21988,Efdemin,blackmoore,480,shaman,elemental,6,5,1
21989,Lovelyshaman,silvermoon,480,shaman,elemental,7,5,2
21990,Khalamity,ravencrest,480,shaman,elemental,9,6,3
21991,Ejx,arthas,480,shaman,elemental,10,6,4
21992,Xereús,kazzak,480,shaman,elemental,10,6,4
21993,Swapxy,outland,480,shaman,elemental,12,5,7
21994,Loshohealva,stormscale,480,shaman,elemental,12,5,7
21995,Owrly,stormscale,480,shaman,elemental,12,5,7
21996,Kelvok,silvermoon,480,shaman,elemental,12,5,7
21997,Élémentyum,archimonde,480,shaman,elemental,12,5,7
21998,Matmodir,hyjal,480,shaman,elemental,12,5,7
21999,Дваллинн,gordunni,480,shaman,elemental,12,5,7
22000,Skullføck,argent-dawn,480,shaman,elemental,12,5,7
22001,Velkin,thrall,480,shaman,elemental,12,5,7
22002,Clickerboy,ravencrest,480,shaman,elemental,18,5,13
22003,Fûchsí,blackhand,479,shaman,elemental,6,5,1
22004,Sinwithin,ravencrest,478,shaman,elemental,12,5,7
22005,Aslakki,turalyon,478,shaman,elemental,30,5,25
22006,Novka,eredar,447,shaman,elemental,11,5,6
22007,Jâydizzle,draenor,431,shaman,elemental,17,5,12
22008,Disharmony,outland,426,shaman,elemental,13,6,7
22009,Blùé,tarren-mill,399,shaman,elemental,5,5,0
22010,Jacc,sunstrider,384,shaman,elemental,6,4,2
22011,Kévinn,draenor,384,shaman,elemental,6,4,2
22012,Nyed,hyjal,384,shaman,elemental,6,4,2
22013,Føxï,pozzo-delleternità,384,shaman,elemental,6,4,2
22014,Xatis,aegwynn,384,shaman,elemental,6,4,2
22015,Selonthyx,ravencrest,384,shaman,elemental,6,4,2
22016,Ruvxy,twisting-nether,384,shaman,elemental,6,4,2
22017,Kraksham,ravencrest,384,shaman,elemental,6,4,2
22018,Whizjy,sanguino,384,shaman,elemental,6,4,2
22019,Bkdgoodz,aegwynn,384,shaman,elemental,6,4,2
22020,Шоу,gordunni,384,shaman,elemental,6,4,2
22021,Sebubu,twisting-nether,384,shaman,elemental,6,4,2
22022,Jacklupin,ravencrest,384,shaman,elemental,6,4,2
22023,Trustlemac,onyxia,384,shaman,elemental,6,4,2
22024,Unangemessen,silvermoon,384,shaman,elemental,6,4,2
22025,Shafallen,tarren-mill,384,shaman,elemental,6,4,2
22026,Alëxx,hyjal,384,shaman,elemental,6,4,2
22027,Thëtis,chogall,384,shaman,elemental,6,4,2
22028,Ludo,lothar,384,shaman,elemental,6,4,2
22029,Daemp,draenor,384,shaman,elemental,6,4,2
22030,Ezala,blackhand,384,shaman,elemental,6,4,2
22031,Ehlaina,outland,384,shaman,elemental,6,4,2
22032,Klicken,tarren-mill,384,shaman,elemental,6,4,2
22033,Voltyum,zuljin,384,shaman,elemental,6,4,2
22034,Schamîx,blackrock,384,shaman,elemental,6,4,2
22035,Hobblefoot,stormscale,384,shaman,elemental,6,4,2
22036,Shamurky,kazzak,384,shaman,elemental,6,4,2
22037,Voymir,kazzak,384,shaman,elemental,6,4,2
22038,Апинсмок,soulflayer,384,shaman,elemental,12,4,8
22039,Eskìmo,malganis,384,shaman,elemental,12,4,8
22040,Hí,bronzebeard,384,shaman,elemental,12,4,8
22041,Goitbate,azuremyst,384,shaman,elemental,12,4,8
22042,Réläx,kazzak,384,shaman,elemental,12,4,8
22043,Snusy,stormscale,384,shaman,elemental,12,4,8
22044,Chrached,kargath,384,shaman,elemental,12,4,8
22045,Вензеро,howling-fjord,384,shaman,elemental,12,4,8
22046,Zengã,kazzak,384,shaman,elemental,12,4,8
22047,Setac,stormscale,384,shaman,elemental,12,4,8
22048,Zokah,emeriss,383,shaman,elemental,6,4,2
22049,Kennyo,uldum,379,shaman,elemental,12,4,8
22050,Gnark,dun-modr,350,shaman,elemental,8,5,3
22051,Fàkecast,outland,320,shaman,elemental,10,4,6
22052,Easyplay,kazzak,319,shaman,elemental,8,4,4
22053,Ankzul,exodar,319,shaman,elemental,14,4,10
22054,Firella,the-maelstrom,288,shaman,elemental,6,3,3
22055,Санрэйн,soulflayer,288,shaman,elemental,6,3,3
22056,Родохрозид,blackscar,288,shaman,elemental,6,3,3
22057,Nerdshockz,blackhand,288,shaman,elemental,6,3,3
22058,Qenninka,drakthul,288,shaman,elemental,6,3,3
22059,Mòra,silvermoon,288,shaman,elemental,6,3,3
22060,Ghostwolfgg,archimonde,288,shaman,elemental,6,3,3
22061,Jagblade,neptulon,288,shaman,elemental,6,3,3
22062,Энхай,azuregos,288,shaman,elemental,6,3,3
22063,Крто,thermaplugg,288,shaman,elemental,6,3,3
22064,Vanrake,ravencrest,288,shaman,elemental,6,3,3
22065,Lunarsloth,hyjal,288,shaman,elemental,6,3,3
22066,Shoewalker,ragnaros,288,shaman,elemental,6,3,3
22067,Khaleeya,blackmoore,288,shaman,elemental,6,3,3
22068,Jeelypink,dalaran,288,shaman,elemental,6,3,3
22069,Kärdyo,archimonde,288,shaman,elemental,6,3,3
22070,Kónjo,kazzak,288,shaman,elemental,6,3,3
22071,Дудивтф,soulflayer,288,shaman,elemental,6,3,3
22072,Реалайзер,blackscar,288,shaman,elemental,6,3,3
22073,Wàve,stormscale,288,shaman,elemental,6,3,3
22074,Nightingäle,silvermoon,288,shaman,elemental,6,3,3
22075,Brandbombe,frostwolf,288,shaman,elemental,6,3,3
22076,Solosüper,ravencrest,288,shaman,elemental,6,3,3
22077,Volvíc,tichondrius,288,shaman,elemental,6,3,3
22078,Херургх,soulflayer,288,shaman,elemental,6,3,3
22079,Bhargonen,silvermoon,288,shaman,elemental,6,3,3
22080,Amu,ravencrest,288,shaman,elemental,6,3,3
22081,Hotstorm,bronzebeard,288,shaman,elemental,6,3,3
22082,Наладчик,gordunni,288,shaman,elemental,6,3,3
22083,Dagra,twisting-nether,288,shaman,elemental,6,3,3
22084,Ironbuttrfly,magtheridon,288,shaman,elemental,6,3,3
22085,Rottulos,stormrage,288,shaman,elemental,6,3,3
22086,Hethne,kazzak,288,shaman,elemental,6,3,3
22087,Fufupartyxx,blackrock,288,shaman,elemental,6,3,3
22088,Joeyexe,outland,288,shaman,elemental,6,3,3
22089,Teccatwo,outland,288,shaman,elemental,6,3,3
22090,Symy,draenor,288,shaman,elemental,6,3,3
22091,Gissary,drakthul,288,shaman,elemental,6,3,3
22092,Shamanmans,grim-batol,288,shaman,elemental,6,3,3
22093,Rolftheswine,defias-brotherhood,288,shaman,elemental,6,3,3
22094,Spruehkot,aegwynn,288,shaman,elemental,6,3,3
22095,Рокутаро,gordunni,288,shaman,elemental,6,3,3
22096,Vukroth,argent-dawn,288,shaman,elemental,6,3,3
22097,Naix,silvermoon,288,shaman,elemental,12,3,9
22098,Tonto,frostmane,288,shaman,elemental,12,3,9
22099,Jaeslin,tarren-mill,288,shaman,elemental,12,3,9
22100,Gammeldunder,shattered-hand,288,shaman,elemental,12,3,9
22101,Gethrok,rajaxx,288,shaman,elemental,12,3,9
22102,Samlik,antonidas,288,shaman,elemental,12,3,9
22103,Megaherz,sanguino,287,shaman,elemental,6,3,3
22104,Twotwozero,defias-brotherhood,286,shaman,elemental,6,3,3
22105,Вещун,deathguard,284,shaman,elemental,12,3,9
22106,Zarakuda,magtheridon,233,shaman,elemental,16,4,12
22107,Stíckíx,malganis,192,shaman,elemental,4,3,1
22108,Krahg,garona,192,shaman,elemental,4,3,1
22109,Ratatakéas,archimonde,192,shaman,elemental,6,2,4
22110,Nuekx,sanguino,192,shaman,elemental,6,2,4
22111,Dormido,sanguino,192,shaman,elemental,6,2,4
22112,Sgf,stormscale,192,shaman,elemental,6,2,4
22113,Rezervoir,bladefist,192,shaman,elemental,6,2,4
22114,Ishkadar,twisting-nether,192,shaman,elemental,6,2,4
22115,Bluéshirtguy,blackhand,192,shaman,elemental,6,2,4
22116,Дагод,booty-bay,192,shaman,elemental,6,2,4
22117,Dodododfewal,stormscale,192,shaman,elemental,6,2,4
22118,Macetoyaface,darksorrow,192,shaman,elemental,6,2,4
22119,Huyø,stormscale,192,shaman,elemental,6,2,4
22120,Thomz,aggra-português,192,shaman,elemental,6,2,4
22121,Xyckas,terrordar,192,shaman,elemental,6,2,4
22122,Ìløvêxÿú,ravencrest,192,shaman,elemental,6,2,4
22123,Squixi,ravencrest,192,shaman,elemental,6,2,4
22124,Драгенхз,gordunni,192,shaman,elemental,6,2,4
22125,Rok,darkspear,192,shaman,elemental,6,2,4
22126,Cloovster,magtheridon,192,shaman,elemental,6,2,4
22127,Shàmeonyou,dun-morogh,192,shaman,elemental,6,2,4
22128,Albatroz,the-maelstrom,192,shaman,elemental,6,2,4
22129,Zbysiu,ravencrest,192,shaman,elemental,6,2,4
22130,Naathir,magtheridon,192,shaman,elemental,6,2,4
22131,Шаеман,soulflayer,192,shaman,elemental,6,2,4
22132,Windspêaker,outland,192,shaman,elemental,6,2,4
22133,Präsi,die-aldor,192,shaman,elemental,6,2,4
22134,Шлолка,gordunni,192,shaman,elemental,6,2,4
22135,Rakermän,dun-modr,192,shaman,elemental,6,2,4
22136,Thornyberrý,outland,192,shaman,elemental,6,2,4
22137,Attm,twisting-nether,192,shaman,elemental,6,2,4
22138,Nnekalol,twisting-nether,192,shaman,elemental,6,2,4
22139,Renegad,archimonde,192,shaman,elemental,6,2,4
22140,Zackyboi,tarren-mill,192,shaman,elemental,6,2,4
22141,Fuzzbolt,silvermoon,192,shaman,elemental,6,2,4
22142,Mikecrybaby,tarren-mill,192,shaman,elemental,6,2,4
22143,Zinlay,tarren-mill,192,shaman,elemental,6,2,4
22144,Nuvet,argent-dawn,192,shaman,elemental,6,2,4
22145,Ahrim,argent-dawn,192,shaman,elemental,6,2,4
22146,Shockbestie,eredar,192,shaman,elemental,7,2,5
22147,Максобман,howling-fjord,192,shaman,elemental,12,2,10
22148,Lycburst,twisting-nether,192,shaman,elemental,12,2,10
22149,Ærö,outland,192,shaman,elemental,12,2,10
22150,Виспепешам,gordunni,192,shaman,elemental,12,2,10
22151,Sweetcåndy,stormscale,192,shaman,elemental,12,2,10
22152,Nakenfeigy,stormreaver,192,shaman,elemental,12,2,10
22153,Jazzrod,stormscale,192,shaman,elemental,12,2,10
22154,Zíp,archimonde,192,shaman,elemental,12,2,10
22155,Thunderstryk,sylvanas,191,shaman,elemental,6,2,4
22156,Aspirio,ravencrest,175,shaman,elemental,11,2,9
22157,Lavaburstx,antonidas,138,shaman,elemental,10,3,7
22158,Fattmorte,hyjal,96,shaman,elemental,3,2,1
22159,Bram,aggra-português,96,shaman,elemental,3,2,1
22160,Nopivøt,hyjal,96,shaman,elemental,7,2,5
22161,Champïx,archimonde,96,shaman,elemental,9,2,7
22162,Flurpz,outland,96,shaman,elemental,6,1,5
22163,Ânne,blackrock,96,shaman,elemental,6,1,5
22164,Pomegranate,arthas,96,shaman,elemental,6,1,5
22165,Izir,archimonde,96,shaman,elemental,6,1,5
22166,Freexx,aegwynn,96,shaman,elemental,6,1,5
22167,Hästdvärg,the-maelstrom,96,shaman,elemental,6,1,5
22168,Skailzcham,hyjal,96,shaman,elemental,6,1,5
22169,Heheheyup,ravencrest,96,shaman,elemental,6,1,5
22170,Альтегро,blackscar,96,shaman,elemental,6,1,5
22171,Shaminista,ravencrest,96,shaman,elemental,6,1,5
22172,Helloitsmee,thrall,96,shaman,elemental,6,1,5
22173,Takkenuma,hyjal,96,shaman,elemental,6,1,5
22174,Shamira,nethersturm,96,shaman,elemental,6,1,5
22175,Fatflop,sylvanas,96,shaman,elemental,6,1,5
22176,Vodoochild,hyjal,96,shaman,elemental,6,1,5
22177,Sayokô,grim-batol,96,shaman,elemental,6,1,5
22178,Пэппивкашке,howling-fjord,96,shaman,elemental,6,1,5
22179,Woolysocks,draenor,96,shaman,elemental,6,1,5
22180,Shamsteaks,ysera,96,shaman,elemental,6,1,5
22181,Сентес,soulflayer,96,shaman,elemental,6,1,5
22182,Depucova,silvermoon,96,shaman,elemental,6,1,5
22183,Magmamartin,antonidas,96,shaman,elemental,6,1,5
22184,Elijaá,nordrassil,96,shaman,elemental,6,1,5
22185,Magicmekoz,draenor,96,shaman,elemental,6,1,5
22186,Bonestompamc,blackmoore,96,shaman,elemental,6,1,5
22187,Kyst,elune,95,shaman,elemental,6,1,5
22188,Torepåsporet,deathwing,79,shaman,elemental,5,1,4
22189,Шиока,borean-tundra,63,shaman,elemental,2,2,0
22190,Snusyy,ravencrest,31,shaman,elemental,2,1,1
22191,Memourian,drakthul,16,shaman,elemental,7,1,6
22192,Mûnch,kazzak,2369,shaman,enhancement,104,69,35
22193,Крааули,soulflayer,2270,shaman,enhancement,204,106,98
22194,Fatpig,stormscale,2238,shaman,enhancement,83,47,36
22195,Axdn,ravencrest,2229,shaman,enhancement,80,47,33
22196,Дудивтф,soulflayer,2220,shaman,enhancement,93,54,39
22197,Avines,twisting-nether,2217,shaman,enhancement,164,85,79
22198,Bredare,ravencrest,2198,shaman,enhancement,82,66,16
22199,Myguns,silvermoon,2164,shaman,enhancement,78,47,31
22200,Baconbazooka,tarren-mill,2147,shaman,enhancement,101,60,41
22201,Sillaas,ysondre,2131,shaman,enhancement,102,50,52
22202,Shïnnkøk,stormscale,2130,shaman,enhancement,72,43,29
22203,Fckumen,blackmoore,2124,shaman,enhancement,106,61,45
22204,Shadi,stormscale,2119,shaman,enhancement,84,44,40
22205,Strippzz,stormscale,2116,shaman,enhancement,78,46,32
22206,Karpsham,stormscale,2110,shaman,enhancement,85,44,41
22207,Buffdraventy,archimonde,2105,shaman,enhancement,66,40,26
22208,Sparkyxd,twisting-nether,2102,shaman,enhancement,78,40,38
22209,Ruffepuffe,twisting-nether,2096,shaman,enhancement,150,85,65
22210,Áä,stormscale,2085,shaman,enhancement,42,37,5
22211,Trulylove,tarren-mill,2085,shaman,enhancement,66,34,32
22212,Читорра,gordunni,2062,shaman,enhancement,66,37,29
22213,Hermerejildo,stormscale,2048,shaman,enhancement,78,38,40
22214,Maelstrom,eredar,2035,shaman,enhancement,264,146,118
22215,Yüri,stormscale,2030,shaman,enhancement,247,124,123
22216,Voodoodoouu,stormscale,2028,shaman,enhancement,72,40,32
22217,Viablous,ravencrest,2007,shaman,enhancement,142,94,48
22218,Milheroj,tarren-mill,1999,shaman,enhancement,69,41,28
22219,Тандерстарк,howling-fjord,1995,shaman,enhancement,83,50,33
22220,Joeyexe,outland,1985,shaman,enhancement,61,34,27
22221,Shïnnøk,stormscale,1984,shaman,enhancement,193,99,94
22222,Инсэйнгод,soulflayer,1983,shaman,enhancement,63,32,31
22223,Hexmex,stormreaver,1973,shaman,enhancement,59,34,25
22224,Smorcshamyy,kazzak,1973,shaman,enhancement,90,47,43
22225,Ниу,thermaplugg,1949,shaman,enhancement,54,32,22
22226,Shadiqt,stormscale,1942,shaman,enhancement,60,31,29
22227,Morguk,zuljin,1936,shaman,enhancement,91,53,38
22228,Plsdontpress,stormscale,1929,shaman,enhancement,79,46,33
22229,Alterem,kazzak,1914,shaman,enhancement,84,48,36
22230,Etox,darksorrow,1907,shaman,enhancement,72,34,38
22231,Sozetwo,tarren-mill,1904,shaman,enhancement,28,22,6
22232,Panzarkamp,stormscale,1894,shaman,enhancement,95,58,37
22233,Gottiy,blackhand,1893,shaman,enhancement,102,50,52
22234,Бафамет,blackscar,1890,shaman,enhancement,36,20,16
22235,Turbostruck,ravencrest,1886,shaman,enhancement,66,27,39
22236,Вацунвец,goldrinn,1883,shaman,enhancement,98,54,44
22237,Xa,blackrock,1882,shaman,enhancement,30,20,10
22238,Azifox,hyjal,1872,shaman,enhancement,48,25,23
22239,Нарленд,gordunni,1871,shaman,enhancement,60,31,29
22240,Jäy,twisting-nether,1867,shaman,enhancement,58,31,27
22241,Ниокумибейт,soulflayer,1866,shaman,enhancement,52,34,18
22242,Stribbzz,stormscale,1866,shaman,enhancement,71,44,27
22243,Disciplé,blackmoore,1862,shaman,enhancement,65,34,31
22244,Horelio,sanguino,1860,shaman,enhancement,93,56,37
22245,Rabalalaha,twisting-nether,1856,shaman,enhancement,140,77,63
22246,Mustakrakish,terokkar,1855,shaman,enhancement,36,24,12
22247,Nopre,blackrock,1855,shaman,enhancement,70,39,31
22248,Radåhn,outland,1854,shaman,enhancement,72,44,28
22249,Gúîtårgøð,sanguino,1854,shaman,enhancement,60,31,29
22250,Enhshamanop,draenor,1851,shaman,enhancement,90,44,46
22251,Gromzog,twisting-nether,1849,shaman,enhancement,42,28,14
22252,Arhitopg,silvermoon,1847,shaman,enhancement,102,53,49
22253,Totemofgreed,rexxar,1843,shaman,enhancement,84,40,44
22254,Сахарокь,soulflayer,1840,shaman,enhancement,42,27,15
22255,Shamanyxx,tarren-mill,1838,shaman,enhancement,60,31,29
22256,Actionhank,area-52,1834,shaman,enhancement,57,30,27
22257,Zetorgg,burning-legion,1832,shaman,enhancement,71,36,35
22258,Yacu,blackrock,1828,shaman,enhancement,48,30,18
22259,Друггрумилей,soulflayer,1828,shaman,enhancement,42,24,18
22260,Mírídíuss,silvermoon,1827,shaman,enhancement,35,25,10
22261,Salvadr,zuljin,1827,shaman,enhancement,62,35,27
22262,Stormkiler,defias-brotherhood,1826,shaman,enhancement,83,36,47
22263,Uhøfligeulf,draenor,1824,shaman,enhancement,42,23,19
22264,Chakafuyo,dun-modr,1822,shaman,enhancement,42,25,17
22265,Пэппивкашке,howling-fjord,1818,shaman,enhancement,38,23,15
22266,Argotan,drakthul,1817,shaman,enhancement,71,43,28
22267,Brokenguyman,defias-brotherhood,1817,shaman,enhancement,35,20,15
22268,Пеклоь,soulflayer,1817,shaman,enhancement,65,30,35
22269,Mckoy,kazzak,1816,shaman,enhancement,40,27,13
22270,Frankone,outland,1815,shaman,enhancement,66,42,24
22271,Naochí,silvermoon,1813,shaman,enhancement,29,20,9
22272,Bikdig,dun-modr,1812,shaman,enhancement,78,47,31
22273,Mèátßãllgøðx,kazzak,1812,shaman,enhancement,117,59,58
22274,Вацустайл,goldrinn,1810,shaman,enhancement,48,32,16
22275,Dshaman,aegwynn,1810,shaman,enhancement,36,23,13
22276,Taktouka,archimonde,1810,shaman,enhancement,54,24,30
22277,Wishstêên,stormscale,1809,shaman,enhancement,64,29,35
22278,Ятебясмету,gordunni,1808,shaman,enhancement,42,29,13
22279,Yombaï,archimonde,1806,shaman,enhancement,90,39,51
22280,Deaslow,hyjal,1803,shaman,enhancement,59,36,23
22281,Реактиватор,soulflayer,1803,shaman,enhancement,47,27,20
22282,Syllaas,ysondre,1800,shaman,enhancement,54,28,26
22283,Lokes,drakthul,1799,shaman,enhancement,54,29,25
22284,Proccq,twisting-nether,1795,shaman,enhancement,48,24,24
22285,Talrall,twisting-nether,1789,shaman,enhancement,60,31,29
22286,Xôàrqt,eredar,1776,shaman,enhancement,191,103,88
22287,Marohk,uldum,1774,shaman,enhancement,36,19,17
22288,Shamarach,sylvanas,1773,shaman,enhancement,30,22,8
22289,Pýthøn,silvermoon,1772,shaman,enhancement,54,27,27
22290,Ananasanax,twisting-nether,1770,shaman,enhancement,90,49,41
22291,Grende,sylvanas,1764,shaman,enhancement,66,35,31
22292,Чаапалах,blackscar,1760,shaman,enhancement,61,28,33
22293,Sígrun,aegwynn,1758,shaman,enhancement,42,28,14
22294,Shamtard,frostwhisper,1758,shaman,enhancement,54,26,28
22295,Senroxx,blackrock,1757,shaman,enhancement,42,27,15
22296,Wóllff,archimonde,1757,shaman,enhancement,42,21,21
22297,Китраст,soulflayer,1756,shaman,enhancement,34,19,15
22298,Бренненд,howling-fjord,1753,shaman,enhancement,47,27,20
22299,Falseshepard,kazzak,1751,shaman,enhancement,42,23,19
22300,Yashëa,ysondre,1749,shaman,enhancement,32,30,2
22301,Echoingshock,argent-dawn,1746,shaman,enhancement,48,32,16
22302,Ázøk,stormscale,1745,shaman,enhancement,112,56,56
22303,Vayshibro,turalyon,1740,shaman,enhancement,48,26,22
22304,Рэггдолл,soulflayer,1739,shaman,enhancement,72,28,44
22305,Wacomtablet,kazzak,1736,shaman,enhancement,36,19,17
22306,Basz,aegwynn,1732,shaman,enhancement,37,21,16
22307,Tobanga,malganis,1730,shaman,enhancement,48,29,19
22308,Boombastíc,ravencrest,1728,shaman,enhancement,47,23,24
22309,Jtouni,outland,1728,shaman,enhancement,42,20,22
22310,Халльбьерн,howling-fjord,1726,shaman,enhancement,60,36,24
22311,Floorislava,culte-de-la-rive-noire,1723,shaman,enhancement,48,24,24
22312,Asaakira,blackmoore,1721,shaman,enhancement,79,36,43
22313,Snëakyboom,stormscale,1717,shaman,enhancement,96,46,50
22314,Тралси,howling-fjord,1715,shaman,enhancement,24,18,6
22315,Enhx,ravencrest,1707,shaman,enhancement,36,23,13
22316,Fotmburstwin,blackmoore,1704,shaman,enhancement,42,27,15
22317,Bluetide,ravencrest,1699,shaman,enhancement,45,32,13
22318,Херургх,soulflayer,1698,shaman,enhancement,38,25,13
22319,Lersham,the-maelstrom,1698,shaman,enhancement,54,32,22
22320,Ozilie,khaz-modan,1695,shaman,enhancement,48,31,17
22321,Veloudinos,twisting-nether,1692,shaman,enhancement,78,53,25
22322,Sangoma,frostmane,1688,shaman,enhancement,107,47,60
22323,Naïda,conseil-des-ombres,1686,shaman,enhancement,53,27,26
22324,Ripstorm,sylvanas,1685,shaman,enhancement,48,24,24
22325,Tinysalmon,hyjal,1681,shaman,enhancement,30,18,12
22326,Gelthan,zuljin,1680,shaman,enhancement,86,47,39
22327,Wheygodx,ravencrest,1679,shaman,enhancement,87,46,41
22328,Moini,eredar,1674,shaman,enhancement,42,21,21
22329,Greythunda,archimonde,1672,shaman,enhancement,36,23,13
22330,Testosterone,dun-modr,1665,shaman,enhancement,36,23,13
22331,Lurkmon,twisting-nether,1665,shaman,enhancement,88,47,41
22332,Isucklasso,aegwynn,1664,shaman,enhancement,54,32,22
22333,Neurax,sanguino,1663,shaman,enhancement,88,47,41
22334,Recaim,outland,1663,shaman,enhancement,36,19,17
22335,Khelyyn,tarren-mill,1662,shaman,enhancement,76,39,37
22336,Rayoton,burning-legion,1662,shaman,enhancement,72,35,37
22337,Oldveteran,eredar,1661,shaman,enhancement,36,22,14
22338,Spicemélange,archimonde,1658,shaman,enhancement,30,18,12
22339,Царьбер,soulflayer,1658,shaman,enhancement,74,41,33
22340,Nînadobrevx,stormscale,1657,shaman,enhancement,111,65,46
22341,Casualhex,argent-dawn,1656,shaman,enhancement,60,35,25
22342,Painshock,outland,1653,shaman,enhancement,42,24,18
22343,Tartakos,ravencrest,1652,shaman,enhancement,61,36,25
22344,Ludwigson,tarren-mill,1652,shaman,enhancement,98,57,41
22345,Stormbreáker,twisting-nether,1650,shaman,enhancement,105,67,38
22346,Взалходил,soulflayer,1650,shaman,enhancement,35,19,16
22347,Халльбиорн,gordunni,1648,shaman,enhancement,56,25,31
22348,Kanaky,hyjal,1644,shaman,enhancement,42,24,18
22349,Слакербэдбой,gordunni,1644,shaman,enhancement,54,23,31
22350,Энха,howling-fjord,1641,shaman,enhancement,36,21,15
22351,Fözk,outland,1641,shaman,enhancement,36,21,15
22352,Ryhèn,stormscale,1637,shaman,enhancement,93,54,39
22353,Shambamm,stormscale,1637,shaman,enhancement,54,31,23
22354,Порнёреф,howling-fjord,1636,shaman,enhancement,99,65,34
22355,Tornis,terokkar,1635,shaman,enhancement,66,37,29
22356,Elemoont,tarren-mill,1633,shaman,enhancement,42,25,17
22357,Legitbro,ravencrest,1633,shaman,enhancement,48,22,26
22358,Joanna,frostwolf,1632,shaman,enhancement,42,19,23
22359,Láynert,dun-modr,1630,shaman,enhancement,189,92,97
22360,Dennismanone,tarren-mill,1628,shaman,enhancement,42,20,22
22361,Äijä,chromaggus,1626,shaman,enhancement,54,32,22
22362,Kammek,tarren-mill,1624,shaman,enhancement,63,41,22
22363,Канамаш,borean-tundra,1624,shaman,enhancement,42,27,15
22364,Chamkalix,sanguino,1623,shaman,enhancement,72,37,35
22365,Toteemikylpy,argent-dawn,1622,shaman,enhancement,30,22,8
22366,Phobiatics,thrall,1622,shaman,enhancement,24,17,7
22367,Reparagos,sanguino,1622,shaman,enhancement,47,27,20
22368,Xestil,blackmoore,1622,shaman,enhancement,37,20,17
22369,Úpli,blackmoore,1621,shaman,enhancement,30,18,12
22370,Hezdnalien,aegwynn,1620,shaman,enhancement,36,18,18
22371,Чухансмент,gordunni,1617,shaman,enhancement,54,29,25
22372,Madmadbro,tarren-mill,1616,shaman,enhancement,36,24,12
22373,Spetsnazz,archimonde,1613,shaman,enhancement,78,35,43
22374,Defiaz,stormscale,1612,shaman,enhancement,46,34,12
22375,Typhoön,sanguino,1612,shaman,enhancement,139,71,68
22376,Totemticks,aegwynn,1609,shaman,enhancement,48,25,23
22377,Obrijames,tarren-mill,1606,shaman,enhancement,36,22,14
22378,Raveell,defias-brotherhood,1606,shaman,enhancement,46,22,24
22379,Darkning,kazzak,1604,shaman,enhancement,30,19,11
22380,Элементи,gordunni,1604,shaman,enhancement,66,41,25
22381,Grrud,draenor,1604,shaman,enhancement,42,23,19
22382,Kynaz,sanguino,1604,shaman,enhancement,57,22,35
22383,Shocktopussi,stormscale,1603,shaman,enhancement,51,32,19
22384,Elèon,blackrock,1603,shaman,enhancement,48,22,26
22385,Moaxtyr,blackmoore,1601,shaman,enhancement,42,29,13
22386,Venomos,kazzak,1601,shaman,enhancement,39,18,21
22387,Mmsalatik,nemesis,1600,shaman,enhancement,36,19,17
22388,Pontifhkas,ragnaros,1597,shaman,enhancement,33,22,11
22389,Thalir,aegwynn,1597,shaman,enhancement,33,18,15
22390,Sndheal,kazzak,1596,shaman,enhancement,24,19,5
22391,Jabaraklol,stormscale,1596,shaman,enhancement,88,54,34
22392,Belroc,ravencrest,1591,shaman,enhancement,36,19,17
22393,Calvey,magtheridon,1589,shaman,enhancement,34,17,17
22394,Hexwife,archimonde,1588,shaman,enhancement,62,32,30
22395,Bumbummann,blackmoore,1588,shaman,enhancement,100,50,50
22396,Monamour,twisting-nether,1583,shaman,enhancement,48,27,21
22397,Pumanii,silvermoon,1583,shaman,enhancement,48,23,25
22398,Элетеми,soulflayer,1581,shaman,enhancement,60,34,26
22399,Purgelord,tarren-mill,1580,shaman,enhancement,40,27,13
22400,Цс,azuregos,1579,shaman,enhancement,116,63,53
22401,Ancestro,kazzak,1579,shaman,enhancement,54,28,26
22402,Cåmilis,archimonde,1579,shaman,enhancement,48,24,24
22403,Ubies,silvermoon,1578,shaman,enhancement,54,31,23
22404,Krovn,aszune,1578,shaman,enhancement,54,26,28
22405,Azzizael,argent-dawn,1577,shaman,enhancement,72,37,35
22406,Nerfrets,malganis,1575,shaman,enhancement,24,20,4
22407,Nexdown,archimonde,1571,shaman,enhancement,30,17,13
22408,Chendra,scarshield-legion,1571,shaman,enhancement,95,46,49
22409,Voodoohexman,kazzak,1569,shaman,enhancement,48,29,19
22410,Автозакзак,soulflayer,1563,shaman,enhancement,35,17,18
22411,Argarok,argent-dawn,1561,shaman,enhancement,30,18,12
22412,Chêlëx,silvermoon,1559,shaman,enhancement,92,48,44
22413,Kosface,tarren-mill,1557,shaman,enhancement,83,44,39
22414,Ашхикиган,howling-fjord,1556,shaman,enhancement,54,19,35
22415,Mõrax,ysondre,1550,shaman,enhancement,43,20,23
22416,Лолимин,borean-tundra,1548,shaman,enhancement,33,21,12
22417,Эбгерсон,soulflayer,1548,shaman,enhancement,102,55,47
22418,Apexpredlol,blackmoore,1546,shaman,enhancement,90,42,48
22419,Кинговели,soulflayer,1543,shaman,enhancement,84,40,44
22420,Nibblez,aegwynn,1539,shaman,enhancement,42,27,15
22421,Toxicnux,nemesis,1539,shaman,enhancement,36,20,16
22422,Ореганно,howling-fjord,1539,shaman,enhancement,66,34,32
22423,Bolgrath,blackmoore,1538,shaman,enhancement,30,18,12
22424,Rocktopus,outland,1538,shaman,enhancement,33,19,14
22425,Oronakgladx,ravencrest,1538,shaman,enhancement,60,32,28
22426,Enhahaha,tarren-mill,1535,shaman,enhancement,24,16,8
22427,Testogodx,defias-brotherhood,1535,shaman,enhancement,45,23,22
22428,Smozze,grim-batol,1534,shaman,enhancement,78,38,40
22429,Skullstorm,talnivarr,1530,shaman,enhancement,24,16,8
22430,Онеоне,deathweaver,1530,shaman,enhancement,36,17,19
22431,Kutipaperi,stormscale,1526,shaman,enhancement,30,18,12
22432,Ïï,archimonde,1522,shaman,enhancement,72,37,35
22433,Szublime,stormscale,1520,shaman,enhancement,36,20,16
22434,Shamrún,sylvanas,1517,shaman,enhancement,36,21,15
22435,Patsham,wildhammer,1516,shaman,enhancement,78,45,33
22436,Tarantan,eredar,1510,shaman,enhancement,61,32,29
22437,Paintball,kazzak,1508,shaman,enhancement,42,21,21
22438,Voodooms,laughing-skull,1507,shaman,enhancement,29,20,9
22439,Барракудах,gordunni,1504,shaman,enhancement,102,45,57
22440,Zayliha,ravencrest,1500,shaman,enhancement,24,16,8
22441,Kijin,kirin-tor,1500,shaman,enhancement,42,21,21
22442,Heeze,doomhammer,1494,shaman,enhancement,112,60,52
22443,Sházam,destromath,1493,shaman,enhancement,24,16,8
22444,Blackibird,garona,1489,shaman,enhancement,33,17,16
22445,Vascodagama,twisting-nether,1488,shaman,enhancement,42,25,17
22446,Gerethor,burning-legion,1484,shaman,enhancement,57,25,32
22447,Shyrion,onyxia,1479,shaman,enhancement,48,21,27
22448,Xxloon,blackrock,1477,shaman,enhancement,54,33,21
22449,Chimp,lightnings-blade,1475,shaman,enhancement,36,21,15
22450,Lumii,azshara,1471,shaman,enhancement,42,21,21
22451,Enigmar,stormscale,1471,shaman,enhancement,93,43,50
22452,Mcbloob,kazzak,1469,shaman,enhancement,81,39,42
22453,Дефибо,howling-fjord,1468,shaman,enhancement,72,36,36
22454,Shamãn,draenor,1467,shaman,enhancement,42,19,23
22455,Shockxy,norgannon,1464,shaman,enhancement,34,16,18
22456,Estasham,stormscale,1461,shaman,enhancement,78,42,36
22457,Totemlover,draenor,1459,shaman,enhancement,58,37,21
22458,Nyxoqtx,draenor,1454,shaman,enhancement,24,21,3
22459,Шторсонг,gordunni,1451,shaman,enhancement,74,48,26
22460,Alphas,draenor,1443,shaman,enhancement,32,20,12
22461,Arkaos,exodar,1439,shaman,enhancement,43,24,19
22462,Perunya,tarren-mill,1438,shaman,enhancement,53,27,26
22463,Shaayys,archimonde,1438,shaman,enhancement,78,35,43
22464,Thorâ,frostmane,1435,shaman,enhancement,30,21,9
22465,Курси,gordunni,1435,shaman,enhancement,66,30,36
22466,Jondil,das-syndikat,1433,shaman,enhancement,36,16,20
22467,Царьколтрэйн,blackscar,1432,shaman,enhancement,36,16,20
22468,Hayvaan,blackrock,1431,shaman,enhancement,78,46,32
22469,Dcanne,outland,1428,shaman,enhancement,99,52,47
22470,Шокмужик,gordunni,1428,shaman,enhancement,30,15,15
22471,Yurkën,uldum,1428,shaman,enhancement,60,29,31
22472,Shambambum,blackrock,1426,shaman,enhancement,66,29,37
22473,Zuvx,ravencrest,1420,shaman,enhancement,66,38,28
22474,Zarkab,ysondre,1419,shaman,enhancement,22,16,6
22475,Tescriamelio,ysondre,1418,shaman,enhancement,24,15,9
22476,Îzanami,ravencrest,1407,shaman,enhancement,72,37,35
22477,Shambolicc,ravencrest,1404,shaman,enhancement,35,15,20
22478,Kenseienh,kazzak,1402,shaman,enhancement,121,61,60
22479,Vulkân,silvermoon,1398,shaman,enhancement,42,23,19
22480,Clembute,cthun,1391,shaman,enhancement,42,28,14
22481,Argonautt,drakthul,1389,shaman,enhancement,90,37,53
22482,Nakenfeigy,stormreaver,1383,shaman,enhancement,42,27,15
22483,Shockthat,draenor,1375,shaman,enhancement,40,26,14
22484,Sparkarse,argent-dawn,1374,shaman,enhancement,24,17,7
22485,Tahsus,blackmoore,1372,shaman,enhancement,36,17,19
22486,Cahuna,stormscale,1371,shaman,enhancement,63,24,39
22487,Panicblast,stormscale,1366,shaman,enhancement,29,15,14
22488,Notoxus,antonidas,1364,shaman,enhancement,78,39,39
22489,Ðezûga,antonidas,1361,shaman,enhancement,48,22,26
22490,Басари,gordunni,1357,shaman,enhancement,41,20,21
22491,Neptun,twisting-nether,1353,shaman,enhancement,60,29,31
22492,Дрегтан,howling-fjord,1344,shaman,enhancement,61,23,38
22493,Faydé,stormscale,1343,shaman,enhancement,30,14,16
22494,Lassolasse,sylvanas,1341,shaman,enhancement,18,14,4
22495,Stensham,stormreaver,1340,shaman,enhancement,24,14,10
22496,Лапища,soulflayer,1338,shaman,enhancement,42,21,21
22497,Gurtok,drakthul,1336,shaman,enhancement,36,22,14
22498,Dalgia,tarren-mill,1335,shaman,enhancement,24,14,10
22499,Chämalö,archimonde,1332,shaman,enhancement,90,47,43
22500,Turbopuddi,kazzak,1329,shaman,enhancement,30,14,16
22501,Shawck,ravencrest,1326,shaman,enhancement,24,14,10
22502,Juliaroberts,ragnaros,1325,shaman,enhancement,75,38,37
22503,Thrâwl,kazzak,1324,shaman,enhancement,18,14,4
22504,Ørgus,aegwynn,1321,shaman,enhancement,179,99,80
22505,Ошиндра,gordunni,1320,shaman,enhancement,28,15,13
22506,Плаглорд,howling-fjord,1317,shaman,enhancement,24,14,10
22507,Maajo,tarren-mill,1312,shaman,enhancement,42,16,26
22508,Tyrox,kirin-tor,1310,shaman,enhancement,24,14,10
22509,Sangvinus,outland,1308,shaman,enhancement,30,14,16
22510,Mcslammer,kazzak,1305,shaman,enhancement,36,14,22
22511,Trîkill,hyjal,1304,shaman,enhancement,54,23,31
22512,Wedís,outland,1299,shaman,enhancement,42,22,20
22513,Sunetee,kazzak,1294,shaman,enhancement,54,23,31
22514,Verlas,kazzak,1293,shaman,enhancement,52,26,26
22515,Manrod,tarren-mill,1279,shaman,enhancement,66,34,32
22516,Madboys,kazzak,1279,shaman,enhancement,31,15,16
22517,Katastrofuss,stormscale,1273,shaman,enhancement,35,21,14
22518,Lavashnikov,burning-legion,1269,shaman,enhancement,43,21,22
22519,Другалёк,howling-fjord,1263,shaman,enhancement,30,17,13
22520,Shamaneo,outland,1260,shaman,enhancement,39,26,13
22521,Noiduttu,tarren-mill,1257,shaman,enhancement,60,36,24
22522,Acidtrips,thrall,1248,shaman,enhancement,24,13,11
22523,Ùseless,archimonde,1248,shaman,enhancement,24,13,11
22524,Видарх,soulflayer,1247,shaman,enhancement,24,13,11
22525,Маелштромс,soulflayer,1246,shaman,enhancement,24,13,11
22526,Максобман,howling-fjord,1243,shaman,enhancement,24,13,11
22527,Stormasaurus,anachronos,1242,shaman,enhancement,22,14,8
22528,Виндфуриа,gordunni,1242,shaman,enhancement,42,22,20
22529,Nêmônin,perenolde,1241,shaman,enhancement,18,13,5
22530,Traktorchox,draenor,1241,shaman,enhancement,24,13,11
22531,Чёкнутое,soulflayer,1236,shaman,enhancement,45,26,19
22532,Mesrines,archimonde,1236,shaman,enhancement,24,13,11
22533,Ecclîpce,archimonde,1235,shaman,enhancement,24,13,11
22534,Pvegame,tarren-mill,1233,shaman,enhancement,30,13,17
22535,Convîcted,grim-batol,1230,shaman,enhancement,22,14,8
22536,Tashunka,twisting-nether,1225,shaman,enhancement,66,29,37
22537,Stromkek,eredar,1223,shaman,enhancement,24,13,11
22538,Zandali,tarren-mill,1222,shaman,enhancement,54,30,24
22539,Mazokuu,ragnaros,1222,shaman,enhancement,75,36,39
22540,Lokresh,azjolnerub,1220,shaman,enhancement,24,13,11
22541,Dendyre,outland,1214,shaman,enhancement,29,13,16
22542,Shamaray,stormscale,1212,shaman,enhancement,42,22,20
22543,Yeemayne,outland,1206,shaman,enhancement,18,13,5
22544,Шалман,thermaplugg,1203,shaman,enhancement,150,73,77
22545,Grimtøtem,defias-brotherhood,1198,shaman,enhancement,30,14,16
22546,Kuzsham,archimonde,1195,shaman,enhancement,27,13,14
22547,Saduria,antonidas,1194,shaman,enhancement,78,44,34
22548,Броаркар,razuvious,1190,shaman,enhancement,48,24,24
22549,Trenhard,wildhammer,1188,shaman,enhancement,23,13,10
22550,Prømetheüs,sanguino,1176,shaman,enhancement,40,23,17
22551,Плюжка,greymane,1176,shaman,enhancement,116,61,55
22552,Тленозавр,gordunni,1173,shaman,enhancement,33,13,20
22553,Тиидишам,blackscar,1152,shaman,enhancement,18,12,6
22554,Teknorave,dun-modr,1152,shaman,enhancement,18,12,6
22555,Treyway,dun-modr,1151,shaman,enhancement,18,12,6
22556,Cløke,stormscale,1151,shaman,enhancement,18,12,6
22557,Commadore,korgall,1151,shaman,enhancement,24,12,12
22558,Kulefesk,grim-batol,1151,shaman,enhancement,24,12,12
22559,Daybidaybi,stormscale,1151,shaman,enhancement,28,13,15
22560,Pumpcok,durotan,1150,shaman,enhancement,18,12,6
22561,Kezron,aegwynn,1150,shaman,enhancement,18,12,6
22562,Altotem,blackmoore,1150,shaman,enhancement,18,12,6
22563,Møldør,tarren-mill,1150,shaman,enhancement,18,12,6
22564,Dmgaddict,kazzak,1149,shaman,enhancement,24,12,12
22565,Zulmalis,twisting-nether,1149,shaman,enhancement,24,12,12
22566,Barbebiendur,archimonde,1148,shaman,enhancement,24,12,12
22567,Shamira,nethersturm,1148,shaman,enhancement,30,12,18
22568,Porphy,kazzak,1147,shaman,enhancement,18,12,6
22569,Famepolîce,blackrock,1147,shaman,enhancement,18,12,6
22570,Gøretterøg,ysondre,1147,shaman,enhancement,19,12,7
22571,Garulf,twisting-nether,1147,shaman,enhancement,24,12,12
22572,Atée,silvermoon,1146,shaman,enhancement,24,12,12
22573,Kargos,stormscale,1146,shaman,enhancement,24,12,12
22574,Sêarix,aegwynn,1144,shaman,enhancement,18,12,6
22575,Экспатриот,greymane,1143,shaman,enhancement,18,12,6
22576,Hexd,defias-brotherhood,1142,shaman,enhancement,24,12,12
22577,Shock,magtheridon,1140,shaman,enhancement,29,17,12
22578,Sg,la-croisade-écarlate,1135,shaman,enhancement,37,18,19
22579,Filigran,ragnaros,1132,shaman,enhancement,24,12,12
22580,Justweirdaf,blackmoore,1129,shaman,enhancement,30,12,18
22581,Arcura,twisting-nether,1127,shaman,enhancement,24,13,11
22582,Амг,booty-bay,1127,shaman,enhancement,26,13,13
22583,Aquæ,suramar,1125,shaman,enhancement,83,44,39
22584,Igniis,frostmane,1120,shaman,enhancement,18,12,6
22585,Волкк,soulflayer,1117,shaman,enhancement,18,12,6
22586,Атл,deathguard,1117,shaman,enhancement,20,13,7
22587,Precíous,sporeggar,1115,shaman,enhancement,34,19,15
22588,Windfury,sylvanas,1112,shaman,enhancement,41,19,22
22589,Tâktoukâ,archimonde,1101,shaman,enhancement,23,12,11
22590,Быковат,booty-bay,1101,shaman,enhancement,30,12,18
22591,Kringspierce,twisting-nether,1086,shaman,enhancement,55,34,21
22592,Хмелецкий,soulflayer,1085,shaman,enhancement,30,18,12
22593,Wargriman,kelthuzad,1081,shaman,enhancement,24,15,9
22594,Zmech,chamber-of-aspects,1068,shaman,enhancement,25,12,13
22595,Stormrex,magtheridon,1062,shaman,enhancement,42,20,22
22596,Лэнгипас,gordunni,1057,shaman,enhancement,93,41,52
22597,Kärmá,stormscale,1056,shaman,enhancement,18,11,7
22598,Ипа,thermaplugg,1056,shaman,enhancement,30,15,15
22599,Pusspatrol,kazzak,1056,shaman,enhancement,24,11,13
22600,Pay,stormscale,1055,shaman,enhancement,18,11,7
22601,Trobø,ravencrest,1055,shaman,enhancement,33,12,21
22602,Khrin,blackmoore,1054,shaman,enhancement,18,11,7
22603,Lavarage,kazzak,1054,shaman,enhancement,18,11,7
22604,Elémenta,turalyon,1053,shaman,enhancement,18,11,7
22605,Hitmeagain,blackhand,1053,shaman,enhancement,24,11,13
22606,Palmalecki,ravencrest,1053,shaman,enhancement,30,11,19
22607,Hulcky,grim-batol,1051,shaman,enhancement,18,11,7
22608,Boidarbre,sargeras,1051,shaman,enhancement,24,11,13
22609,Hopefully,eredar,1050,shaman,enhancement,18,11,7
22610,Biglynx,sanguino,1049,shaman,enhancement,66,36,30
22611,Rorenth,blackhand,1049,shaman,enhancement,68,35,33
22612,Дромгрон,howling-fjord,1049,shaman,enhancement,24,11,13
22613,Erupted,draenor,1049,shaman,enhancement,30,11,19
22614,Щцц,soulflayer,1047,shaman,enhancement,18,11,7
22615,Shamrøck,archimonde,1042,shaman,enhancement,30,15,15
22616,Ipbar,blackrock,1038,shaman,enhancement,18,11,7
22617,Элетар,gordunni,1031,shaman,enhancement,30,11,19
22618,Krakennm,dalaran,1027,shaman,enhancement,24,13,11
22619,Moodoo,antonidas,1016,shaman,enhancement,29,11,18
22620,Cimer,sargeras,1005,shaman,enhancement,36,13,23
22621,Rether,nemesis,1003,shaman,enhancement,27,11,16
22622,Beletili,chogall,997,shaman,enhancement,25,12,13
22623,Khamo,twisting-nether,990,shaman,enhancement,17,11,6
22624,Jeki,ysondre,989,shaman,enhancement,34,11,23
22625,Yunero,argent-dawn,975,shaman,enhancement,19,11,8
22626,Kushme,silvermoon,970,shaman,enhancement,36,12,24
22627,Worstshamy,sanguino,960,shaman,enhancement,12,10,2
22628,Dumhuvud,stormscale,960,shaman,enhancement,12,10,2
22629,Dumbasha,ravencrest,960,shaman,enhancement,18,10,8
22630,Chatbanned,blackmoore,960,shaman,enhancement,18,10,8
22631,Crysis,sanguino,960,shaman,enhancement,18,10,8
22632,Mëditåtïøñ,blackrock,960,shaman,enhancement,24,10,14
22633,Matchstíck,draenor,960,shaman,enhancement,24,10,14
22634,Cripxo,sanguino,959,shaman,enhancement,12,10,2
22635,Skyróxx,blackrock,959,shaman,enhancement,18,10,8
22636,Enoughh,the-maelstrom,959,shaman,enhancement,18,10,8
22637,Шампуньхан,blackscar,959,shaman,enhancement,24,10,14
22638,Jasnäh,ysondre,958,shaman,enhancement,18,10,8
22639,Buuddha,drakthul,958,shaman,enhancement,18,10,8
22640,Myngo,thrall,958,shaman,enhancement,18,10,8
22641,Towi,krasus,955,shaman,enhancement,12,10,2
22642,Bourdieu,thrall,955,shaman,enhancement,18,10,8
22643,Rushfabi,aegwynn,948,shaman,enhancement,24,10,14
22644,Janserey,burning-legion,947,shaman,enhancement,24,10,14
22645,Shamanigans,terrordar,945,shaman,enhancement,12,10,2
22646,Tosemist,stormscale,943,shaman,enhancement,17,10,7
22647,Nethershock,blackmoore,942,shaman,enhancement,60,33,27
22648,Fòóxi,ravencrest,935,shaman,enhancement,42,20,22
22649,Чухмандос,gordunni,932,shaman,enhancement,23,11,12
22650,Бойкийкот,gordunni,926,shaman,enhancement,24,10,14
22651,Mendoz,nazjatar,921,shaman,enhancement,60,27,33
22652,Izaarleus,argent-dawn,920,shaman,enhancement,23,10,13
22653,Mimsy,hyjal,915,shaman,enhancement,47,19,28
22654,Chronochrome,chamber-of-aspects,900,shaman,enhancement,39,18,21
22655,Agathoulis,burning-legion,864,shaman,enhancement,12,9,3
22656,Sonnestorm,tarren-mill,864,shaman,enhancement,12,9,3
22657,Blaukraut,stormscale,864,shaman,enhancement,12,9,3
22658,Мсет,soulflayer,864,shaman,enhancement,12,9,3
22659,Kilomanjaro,bloodfeather,864,shaman,enhancement,12,9,3
22660,Axilary,tarren-mill,864,shaman,enhancement,12,9,3
22661,Blackyx,dun-modr,864,shaman,enhancement,12,9,3
22662,Politemanner,stormscale,864,shaman,enhancement,18,9,9
22663,Johncoltrane,archimonde,863,shaman,enhancement,12,9,3
22664,Maddogxz,frostwolf,863,shaman,enhancement,12,9,3
22665,Tijae,ravencrest,863,shaman,enhancement,12,9,3
22666,Shyne,vashj,863,shaman,enhancement,18,9,9
22667,Qauter,hellfire,863,shaman,enhancement,18,9,9
22668,Kættmæck,tarren-mill,863,shaman,enhancement,18,9,9
22669,Taraesh,blackhand,863,shaman,enhancement,18,9,9
22670,Faltygo,drakthul,863,shaman,enhancement,24,9,15
22671,Sgtspyke,ragnaros,863,shaman,enhancement,24,9,15
22672,Моктрогтар,ashenvale,862,shaman,enhancement,12,9,3
22673,Romacherry,aegwynn,862,shaman,enhancement,12,9,3
22674,Laix,khaz-modan,862,shaman,enhancement,18,9,9
22675,Relampago,eredar,861,shaman,enhancement,18,9,9
22676,Zzadoxor,doomhammer,860,shaman,enhancement,18,9,9
22677,Furioous,ravencrest,857,shaman,enhancement,18,9,9
22678,Vaesk,auchindoun,850,shaman,enhancement,18,9,9
22679,Рэйпушка,gordunni,847,shaman,enhancement,23,9,14
22680,Ryujìñjakka,culte-de-la-rive-noire,812,shaman,enhancement,18,9,9
22681,Twotwozero,defias-brotherhood,803,shaman,enhancement,24,9,15
22682,Nubokesel,ragnaros,796,shaman,enhancement,20,9,11
22683,Watzocham,archimonde,782,shaman,enhancement,19,9,10
22684,Драгенхз,gordunni,768,shaman,enhancement,12,8,4
22685,Lytningx,ravencrest,768,shaman,enhancement,12,8,4
22686,Dêblâzê,thrall,768,shaman,enhancement,12,8,4
22687,Dhedge,draenor,768,shaman,enhancement,12,8,4
22688,Aswøg,kazzak,768,shaman,enhancement,12,8,4
22689,Bobonbu,forscherliga,768,shaman,enhancement,12,8,4
22690,Qätär,ravencrest,768,shaman,enhancement,12,8,4
22691,Mehex,tarren-mill,768,shaman,enhancement,12,8,4
22692,Thunderdøme,stormscale,768,shaman,enhancement,12,8,4
22693,Noboorst,stormscale,768,shaman,enhancement,12,8,4
22694,Healníx,ravencrest,768,shaman,enhancement,12,8,4
22695,Tdogfx,blackhand,768,shaman,enhancement,12,8,4
22696,Gnomecake,vashj,768,shaman,enhancement,18,8,10
22697,Paschol,aegwynn,768,shaman,enhancement,18,8,10
22698,Ekinoz,outland,768,shaman,enhancement,18,8,10
22699,Bmtotem,twisting-nether,768,shaman,enhancement,18,8,10
22700,Critonian,twisting-nether,768,shaman,enhancement,18,8,10
22701,Shámi,gilneas,768,shaman,enhancement,18,8,10
22702,Eclaîr,thrall,768,shaman,enhancement,18,8,10
22703,Babal,outland,768,shaman,enhancement,24,8,16
22704,Zró,blackrock,768,shaman,enhancement,24,8,16
22705,Wonderman,jaedenar,767,shaman,enhancement,12,8,4
22706,Spacelazers,twisting-nether,767,shaman,enhancement,12,8,4
22707,Wertih,burning-legion,767,shaman,enhancement,12,8,4
22708,Darhgan,argent-dawn,767,shaman,enhancement,12,8,4
22709,Faxsham,draenor,767,shaman,enhancement,12,8,4
22710,Иннреи,howling-fjord,767,shaman,enhancement,12,8,4
22711,Carlos,magtheridon,767,shaman,enhancement,18,8,10
22712,Tufftnamn,frostmane,767,shaman,enhancement,18,8,10
22713,Alethea,frostmane,767,shaman,enhancement,18,8,10
22714,Nâs,kazzak,767,shaman,enhancement,18,8,10
22715,Tschacô,malganis,767,shaman,enhancement,18,8,10
22716,Gandy,the-maelstrom,767,shaman,enhancement,18,8,10
22717,Voodoodocter,kazzak,767,shaman,enhancement,29,8,21
22718,Шанья,gordunni,767,shaman,enhancement,30,8,22
22719,Durek,sylvanas,765,shaman,enhancement,12,8,4
22720,Твалор,soulflayer,765,shaman,enhancement,18,8,10
22721,Strygwyrl,doomhammer,764,shaman,enhancement,18,8,10
22722,Рыргаск,howling-fjord,764,shaman,enhancement,18,8,10
22723,Carusø,thrall,764,shaman,enhancement,18,8,10
22724,Hectoraïus,ysondre,763,shaman,enhancement,18,8,10
22725,Murog,dalaran,762,shaman,enhancement,12,8,4
22726,Шамблабла,soulflayer,756,shaman,enhancement,30,8,22
22727,Fotmslave,laughing-skull,749,shaman,enhancement,15,10,5
22728,Arslos,twisting-nether,735,shaman,enhancement,14,9,5
22729,Тотемныйчад,gordunni,731,shaman,enhancement,16,8,8
22730,Kunancementa,ravencrest,718,shaman,enhancement,17,8,9
22731,Ihealbro,blackrock,714,shaman,enhancement,16,11,5
22732,Thossa,draenor,695,shaman,enhancement,17,8,9
22733,Tiamât,culte-de-la-rive-noire,685,shaman,enhancement,19,8,11
22734,Bärtigeberta,aegwynn,672,shaman,enhancement,10,8,2
22735,Akatuseiwah,blackrock,672,shaman,enhancement,12,7,5
22736,Tuncha,runetotem,672,shaman,enhancement,12,7,5
22737,Metalbeef,xavius,672,shaman,enhancement,12,7,5
22738,Ubramovitch,hyjal,672,shaman,enhancement,12,7,5
22739,Proper,tichondrius,672,shaman,enhancement,12,7,5
22740,Kyshka,tarren-mill,672,shaman,enhancement,12,7,5
22741,Roineé,draenor,672,shaman,enhancement,12,7,5
22742,Koiru,argent-dawn,672,shaman,enhancement,12,7,5
22743,Krishun,blackmoore,672,shaman,enhancement,18,7,11
22744,Иллюминэйшн,soulflayer,672,shaman,enhancement,18,7,11
22745,Джоннси,howling-fjord,671,shaman,enhancement,12,7,5
22746,Spajry,drakthul,671,shaman,enhancement,12,7,5
22747,Dwarfofwar,ravencrest,671,shaman,enhancement,12,7,5
22748,Birnenpfeffi,malfurion,671,shaman,enhancement,12,7,5
22749,Rutil,blackhand,671,shaman,enhancement,12,7,5
22750,Dénekha,zuljin,671,shaman,enhancement,12,7,5
22751,Sajma,silvermoon,671,shaman,enhancement,18,7,11
22752,Florgegoyd,eredar,670,shaman,enhancement,12,7,5
22753,Палачок,eversong,670,shaman,enhancement,18,7,11
22754,Elijaá,nordrassil,670,shaman,enhancement,18,7,11
22755,Crespouu,doomhammer,667,shaman,enhancement,12,7,5
22756,Viandehachee,dalaran,667,shaman,enhancement,12,7,5
22757,Bumm,twisting-nether,665,shaman,enhancement,24,7,17
22758,Øzy,sanguino,660,shaman,enhancement,12,7,5
22759,Dakotasham,ravencrest,623,shaman,enhancement,11,7,4
22760,Oldstorm,ravencrest,618,shaman,enhancement,22,10,12
22761,Nuluadroguri,twisting-nether,605,shaman,enhancement,16,7,9
22762,Babalahziz,ysondre,576,shaman,enhancement,6,6,0
22763,Crowness,ragnaros,576,shaman,enhancement,6,6,0
22764,Ugory,die-aldor,576,shaman,enhancement,6,6,0
22765,Shamflurry,ravencrest,576,shaman,enhancement,6,6,0
22766,Chancè,tarren-mill,576,shaman,enhancement,12,6,6
22767,Kelvok,silvermoon,576,shaman,enhancement,12,6,6
22768,Purada,blackrock,576,shaman,enhancement,12,6,6
22769,Dwarfstil,blackmoore,576,shaman,enhancement,12,6,6
22770,Tharma,blackmoore,576,shaman,enhancement,12,6,6
22771,Tzaish,blackmoore,576,shaman,enhancement,12,6,6
22772,Puumbaa,defias-brotherhood,576,shaman,enhancement,12,6,6
22773,Bullx,magtheridon,576,shaman,enhancement,12,6,6
22774,Szelenamoonx,outland,576,shaman,enhancement,12,6,6
22775,Searfang,korgall,576,shaman,enhancement,12,6,6
22776,Ayame,burning-steppes,576,shaman,enhancement,12,6,6
22777,Юрахафанбой,blackscar,576,shaman,enhancement,12,6,6
22778,Nìno,azshara,576,shaman,enhancement,12,6,6
22779,Purgerooni,haomarush,576,shaman,enhancement,12,6,6
22780,Elemefayoh,tarren-mill,576,shaman,enhancement,12,6,6
22781,Ягном,soulflayer,576,shaman,enhancement,12,6,6
22782,Dami,die-aldor,576,shaman,enhancement,12,6,6
22783,Pinkylol,stormscale,576,shaman,enhancement,12,6,6
22784,Otacboziji,sylvanas,576,shaman,enhancement,12,6,6
22785,Kolbászlelkü,ragnaros,576,shaman,enhancement,12,6,6
22786,Haasshaman,ravencrest,576,shaman,enhancement,18,6,12
22787,Javaburst,ragnaros,576,shaman,enhancement,24,6,18
22788,Nazma,blackhand,575,shaman,enhancement,6,6,0
22789,Apolomaeuz,frostwolf,575,shaman,enhancement,12,6,6
22790,Литлсмурф,gordunni,575,shaman,enhancement,12,6,6
22791,Finni,hyjal,575,shaman,enhancement,12,6,6
22792,Киллдрак,howling-fjord,575,shaman,enhancement,12,6,6
22793,Мамонтшам,howling-fjord,575,shaman,enhancement,12,6,6
22794,Hexrated,draenor,575,shaman,enhancement,15,7,8
22795,Nurychic,twisting-nether,575,shaman,enhancement,24,6,18
22796,Mahlga,argent-dawn,574,shaman,enhancement,18,6,12
22797,Дядяшаман,gordunni,573,shaman,enhancement,24,6,18
22798,Shaminista,ravencrest,571,shaman,enhancement,12,6,6
22799,Earthhulk,thrall,544,shaman,enhancement,10,7,3
22800,Juniyaa,blackrock,543,shaman,enhancement,14,7,7
22801,Narevoqi,madmortem,542,shaman,enhancement,13,7,6
22802,Yaar,alleria,542,shaman,enhancement,17,6,11
22803,Kireekoura,tarren-mill,527,shaman,enhancement,15,6,9
22804,Капарис,deathweaver,527,shaman,enhancement,15,6,9
22805,Шаманутый,soulflayer,522,shaman,enhancement,14,7,7
22806,Whizjy,sanguino,521,shaman,enhancement,22,9,13
22807,Lavashock,tarren-mill,511,shaman,enhancement,22,6,16
22808,Ruintotems,twisting-nether,510,shaman,enhancement,11,7,4
22809,Ðevi,ravencrest,480,shaman,enhancement,6,5,1
22810,Таиров,soulflayer,480,shaman,enhancement,6,5,1
22811,Evííl,tarren-mill,480,shaman,enhancement,6,5,1
22812,Electricgødx,tarren-mill,480,shaman,enhancement,6,5,1
22813,Øutfox,silvermoon,480,shaman,enhancement,6,5,1
22814,Genrok,burning-blade,480,shaman,enhancement,6,5,1
22815,Complete,hyjal,480,shaman,enhancement,6,5,1
22816,Velkin,thrall,480,shaman,enhancement,6,5,1
22817,Synergizer,kazzak,480,shaman,enhancement,6,5,1
22818,Medoje,argent-dawn,480,shaman,enhancement,6,5,1
22819,Windsòng,stormscale,480,shaman,enhancement,6,5,1
22820,Wolfwesti,outland,480,shaman,enhancement,6,5,1
22821,Earthquaker,the-maelstrom,480,shaman,enhancement,6,5,1
22822,Wooyoungsham,sylvanas,480,shaman,enhancement,6,5,1
22823,Zulren,draenor,480,shaman,enhancement,6,5,1
22824,Ðexx,stormscale,480,shaman,enhancement,6,5,1
22825,Martini,tichondrius,480,shaman,enhancement,9,6,3
22826,Itswoland,tarren-mill,480,shaman,enhancement,10,6,4
22827,Schoølbøyq,blackrock,480,shaman,enhancement,12,5,7
22828,Duhdelido,ravencrest,480,shaman,enhancement,12,5,7
22829,Neroty,blackmoore,480,shaman,enhancement,12,5,7
22830,Тыпроиграл,gordunni,480,shaman,enhancement,12,5,7
22831,Hiron,sylvanas,480,shaman,enhancement,12,5,7
22832,Frostýx,draenor,480,shaman,enhancement,12,5,7
22833,Fanatroka,ravencrest,480,shaman,enhancement,12,5,7
22834,Kabard,silvermoon,480,shaman,enhancement,12,5,7
22835,Tonifo,nemesis,480,shaman,enhancement,12,5,7
22836,Жуксик,greymane,480,shaman,enhancement,12,5,7
22837,Lilmarco,stormreaver,480,shaman,enhancement,12,5,7
22838,Ogmehu,stormreaver,480,shaman,enhancement,12,5,7
22839,Pank,kazzak,480,shaman,enhancement,12,5,7
22840,Grosgourdin,la-croisade-écarlate,480,shaman,enhancement,12,5,7
22841,Batan,kazzak,480,shaman,enhancement,12,5,7
22842,Mistahbeard,stormscale,480,shaman,enhancement,12,5,7
22843,Kaimountain,defias-brotherhood,480,shaman,enhancement,12,5,7
22844,Chamirox,ysondre,480,shaman,enhancement,12,5,7
22845,Deathshamãn,stormscale,480,shaman,enhancement,12,5,7
22846,Bowtenstorm,ravencrest,480,shaman,enhancement,12,5,7
22847,Volcanò,outland,480,shaman,enhancement,12,5,7
22848,Satanloveme,stormscale,480,shaman,enhancement,18,5,13
22849,Акер,deathguard,479,shaman,enhancement,6,5,1
22850,Xakum,stormscale,479,shaman,enhancement,6,5,1
22851,Chamrøck,hyjal,479,shaman,enhancement,12,5,7
22852,Yasan,kazzak,479,shaman,enhancement,13,5,8
22853,Kaybiel,magtheridon,478,shaman,enhancement,12,5,7
22854,Asstroy,sanguino,477,shaman,enhancement,6,5,1
22855,Sardemar,defias-brotherhood,472,shaman,enhancement,12,5,7
22856,Pøllemodex,frostwhisper,431,shaman,enhancement,11,5,6
22857,Даблпамп,howling-fjord,431,shaman,enhancement,17,5,12
22858,Hodir,bronzebeard,415,shaman,enhancement,10,5,5
22859,Shamomo,hyjal,400,shaman,enhancement,13,5,8
22860,Jaykezap,kazzak,384,shaman,enhancement,6,4,2
22861,Россаврн,galakrond,384,shaman,enhancement,6,4,2
22862,Lilmozart,twisting-nether,384,shaman,enhancement,6,4,2
22863,Lovèless,stormscale,384,shaman,enhancement,6,4,2
22864,Bantzer,twisting-nether,384,shaman,enhancement,6,4,2
22865,Abordoga,twisting-nether,384,shaman,enhancement,6,4,2
22866,Rakermän,dun-modr,384,shaman,enhancement,6,4,2
22867,Richtigfies,kazzak,384,shaman,enhancement,6,4,2
22868,Shds,blackmoore,384,shaman,enhancement,6,4,2
22869,Шамунчез,gordunni,384,shaman,enhancement,6,4,2
22870,Чифсоса,soulflayer,384,shaman,enhancement,6,4,2
22871,Baldurr,sylvanas,384,shaman,enhancement,6,4,2
22872,Piripolkka,defias-brotherhood,384,shaman,enhancement,6,4,2
22873,Yasaburo,silvermoon,384,shaman,enhancement,6,4,2
22874,Биттерлинкс,soulflayer,384,shaman,enhancement,6,4,2
22875,Simularcum,kazzak,384,shaman,enhancement,6,4,2
22876,Мистерэнх,soulflayer,384,shaman,enhancement,6,4,2
22877,Ilkim,hyjal,384,shaman,enhancement,6,4,2
22878,Runè,azjolnerub,384,shaman,enhancement,6,4,2
22879,Нийрагонго,gordunni,384,shaman,enhancement,6,4,2
22880,Abdegor,burning-legion,384,shaman,enhancement,6,4,2
22881,Олешао,howling-fjord,384,shaman,enhancement,6,4,2
22882,Xalta,eldrethalas,384,shaman,enhancement,6,4,2
22883,Fyrkaz,aegwynn,384,shaman,enhancement,6,4,2
22884,Isogrind,archimonde,384,shaman,enhancement,6,4,2
22885,Draugrinns,tarren-mill,384,shaman,enhancement,6,4,2
22886,Rodneymullen,tarren-mill,384,shaman,enhancement,6,4,2
22887,Vutututututu,ragnaros,384,shaman,enhancement,6,4,2
22888,Robzn,blackrock,384,shaman,enhancement,6,4,2
22889,Mustabrutus,tarren-mill,384,shaman,enhancement,6,4,2
22890,Hermerejildo,tarren-mill,384,shaman,enhancement,6,4,2
22891,Sinwithin,ravencrest,384,shaman,enhancement,6,4,2
22892,Sûckmytotem,ragnaros,384,shaman,enhancement,6,4,2
22893,Фролыч,deathguard,384,shaman,enhancement,6,4,2
22894,Rykarn,eredar,384,shaman,enhancement,9,5,4
22895,Drade,aegwynn,384,shaman,enhancement,8,4,4
22896,Xhahal,hyjal,384,shaman,enhancement,10,4,6
22897,Claodze,stormscale,384,shaman,enhancement,12,4,8
22898,Courtney,sylvanas,384,shaman,enhancement,12,4,8
22899,Votie,tarren-mill,384,shaman,enhancement,12,4,8
22900,Рокмару,soulflayer,384,shaman,enhancement,12,4,8
22901,Brooce,sylvanas,384,shaman,enhancement,12,4,8
22902,Yelawolf,shattered-hand,384,shaman,enhancement,12,4,8
22903,Kanabi,darkspear,384,shaman,enhancement,12,4,8
22904,Johnisplay,tarren-mill,384,shaman,enhancement,12,4,8
22905,Апинсмок,soulflayer,384,shaman,enhancement,12,4,8
22906,Дюнволкер,razuvious,384,shaman,enhancement,12,4,8
22907,Chamtroulku,ysondre,384,shaman,enhancement,12,4,8
22908,Blixtnedslag,shattered-hand,384,shaman,enhancement,12,4,8
22909,Meatballspam,stormscale,384,shaman,enhancement,12,4,8
22910,Asçele,kazzak,384,shaman,enhancement,12,4,8
22911,Waterboi,blackmoore,384,shaman,enhancement,12,4,8
22912,Бигмамуля,booty-bay,384,shaman,enhancement,12,4,8
22913,Türak,tarren-mill,384,shaman,enhancement,12,4,8
22914,Dóómd,kazzak,384,shaman,enhancement,12,4,8
22915,Видсон,soulflayer,384,shaman,enhancement,12,4,8
22916,Domiro,ravencrest,384,shaman,enhancement,18,4,14
22917,Derryo,silvermoon,384,shaman,enhancement,18,4,14
22918,Burghezu,magtheridon,383,shaman,enhancement,6,4,2
22919,Màverìck,nemesis,383,shaman,enhancement,6,4,2
22920,Bubbschock,antonidas,383,shaman,enhancement,6,4,2
22921,Goblaman,pozzo-delleternità,383,shaman,enhancement,6,4,2
22922,Wolkano,zuljin,383,shaman,enhancement,10,5,5
22923,Аеесо,gordunni,383,shaman,enhancement,12,4,8
22924,Châmanco,dun-modr,383,shaman,enhancement,12,4,8
22925,Blutshock,zuluhed,382,shaman,enhancement,12,4,8
22926,Asogg,archimonde,379,shaman,enhancement,12,4,8
22927,Hurtigtotem,ravencrest,320,shaman,enhancement,10,4,6
22928,Nargrul,tarren-mill,319,shaman,enhancement,5,4,1
22929,Gigamuscle,ravencrest,304,shaman,enhancement,7,4,3
22930,Azrs,ravencrest,288,shaman,enhancement,6,3,3
22931,Rejrax,ravencrest,288,shaman,enhancement,6,3,3
22932,Kafese,uldaman,288,shaman,enhancement,6,3,3
22933,Loshohealva,stormscale,288,shaman,enhancement,6,3,3
22934,Millesabords,dun-morogh,288,shaman,enhancement,6,3,3
22935,Litenrolixd,tarren-mill,288,shaman,enhancement,6,3,3
22936,Depucova,silvermoon,288,shaman,enhancement,6,3,3
22937,Рыганский,blackscar,288,shaman,enhancement,6,3,3
22938,Zuziki,argent-dawn,288,shaman,enhancement,6,3,3
22939,Lilkazamm,blackrock,288,shaman,enhancement,6,3,3
22940,Medistød,draenor,288,shaman,enhancement,6,3,3
22941,Ñax,silvermoon,288,shaman,enhancement,6,3,3
22942,Неутолимыйх,blackscar,288,shaman,enhancement,6,3,3
22943,Furrymane,blackmoore,288,shaman,enhancement,6,3,3
22944,Magosh,blackmoore,288,shaman,enhancement,6,3,3
22945,Xfiles,garona,288,shaman,enhancement,6,3,3
22946,Lahur,blackmoore,288,shaman,enhancement,6,3,3
22947,Kemurus,kazzak,288,shaman,enhancement,6,3,3
22948,Kedall,archimonde,288,shaman,enhancement,6,3,3
22949,Sodor,laughing-skull,288,shaman,enhancement,6,3,3
22950,Stormfury,balnazzar,288,shaman,enhancement,6,3,3
22951,Ccedtodeath,sylvanas,288,shaman,enhancement,6,3,3
22952,Reggard,drakthul,288,shaman,enhancement,6,3,3
22953,Hansdieter,antonidas,288,shaman,enhancement,6,3,3
22954,Eomsham,magtheridon,288,shaman,enhancement,6,3,3
22955,Shambolicc,kazzak,288,shaman,enhancement,6,3,3
22956,Даркгрон,thermaplugg,288,shaman,enhancement,6,3,3
22957,Ronctaha,blackrock,288,shaman,enhancement,6,3,3
22958,Uomae,dun-modr,288,shaman,enhancement,6,3,3
22959,Chehkhan,archimonde,288,shaman,enhancement,6,3,3
22960,Ñtk,dun-modr,288,shaman,enhancement,6,3,3
22961,Тыщатристах,howling-fjord,288,shaman,enhancement,6,3,3
22962,Kulho,stormscale,288,shaman,enhancement,6,3,3
22963,Мэлик,howling-fjord,288,shaman,enhancement,6,3,3
22964,Lurtax,outland,288,shaman,enhancement,6,3,3
22965,Айбьорн,gordunni,288,shaman,enhancement,6,3,3
22966,Blazingfiré,tarren-mill,288,shaman,enhancement,6,3,3
22967,Xesti,twisting-nether,288,shaman,enhancement,6,3,3
22968,Guqin,ravencrest,288,shaman,enhancement,6,3,3
22969,Chrisbrownx,outland,288,shaman,enhancement,6,3,3
22970,Pelicius,sanguino,288,shaman,enhancement,6,3,3
22971,Thëhêxfäçtør,tarren-mill,288,shaman,enhancement,6,3,3
22972,Ostbumsdirne,stormscale,288,shaman,enhancement,6,3,3
22973,Wakoteh,quelthalas,288,shaman,enhancement,6,3,3
22974,Likê,aegwynn,288,shaman,enhancement,6,3,3
22975,Китрасст,soulflayer,288,shaman,enhancement,6,3,3
22976,Epicenter,bloodscalp,288,shaman,enhancement,6,3,3
22977,Håõkåh,hyjal,288,shaman,enhancement,6,3,3
22978,Funkins,hyjal,288,shaman,enhancement,6,3,3
22979,Zokah,emeriss,288,shaman,enhancement,6,3,3
22980,Shockaibo,drakthul,288,shaman,enhancement,6,3,3
22981,Nëÿrën,drakthul,288,shaman,enhancement,6,3,3
22982,Totoostoy,burning-legion,288,shaman,enhancement,6,3,3
22983,Caelx,ragnaros,288,shaman,enhancement,6,3,3
22984,Lorthargol,chamber-of-aspects,288,shaman,enhancement,12,3,9
22985,Veteroth,argent-dawn,288,shaman,enhancement,12,3,9
22986,Dastarus,archimonde,288,shaman,enhancement,12,3,9
22987,Rhakhatheckh,nemesis,288,shaman,enhancement,12,3,9
22988,Sacrx,dalaran,288,shaman,enhancement,12,3,9
22989,Enormo,eredar,288,shaman,enhancement,12,3,9
22990,Brunütansol,sylvanas,288,shaman,enhancement,12,3,9
22991,Hurbi,twisting-nether,288,shaman,enhancement,12,3,9
22992,Maybeyes,twisting-nether,288,shaman,enhancement,12,3,9
22993,Занги,soulflayer,288,shaman,enhancement,12,3,9
22994,Æskalatiøn,aegwynn,288,shaman,enhancement,12,3,9
22995,Jorny,burning-legion,288,shaman,enhancement,12,3,9
22996,Лорикок,grom,288,shaman,enhancement,18,3,15
22997,Slappybag,ravencrest,287,shaman,enhancement,6,3,3
22998,Biphrost,nemesis,287,shaman,enhancement,6,3,3
22999,Korzo,amanthul,287,shaman,enhancement,6,3,3
23000,Gibspark,twisting-nether,287,shaman,enhancement,6,3,3
23001,Deeblu,nemesis,287,shaman,enhancement,6,3,3
23002,Nothìnto,pozzo-delleternità,287,shaman,enhancement,6,3,3
23003,Trotzig,aegwynn,287,shaman,enhancement,6,3,3
23004,Laghärta,dun-modr,286,shaman,enhancement,6,3,3
23005,Madbud,stormscale,271,shaman,enhancement,11,3,8
23006,Jehae,archimonde,239,shaman,enhancement,5,3,2
23007,Ивми,gordunni,239,shaman,enhancement,5,3,2
23008,Nefasti,stormscale,223,shaman,enhancement,8,3,5
23009,Mooshock,balnazzar,223,shaman,enhancement,8,3,5
23010,Elektekk,blackrock,192,shaman,enhancement,4,3,1
23011,Bonethugdex,bladefist,192,shaman,enhancement,6,2,4
23012,Idxbi,kazzak,192,shaman,enhancement,6,2,4
23013,Urshak,alleria,192,shaman,enhancement,6,2,4
23014,Tornadozzer,burning-legion,192,shaman,enhancement,6,2,4
23015,Bladeyx,ragnaros,192,shaman,enhancement,6,2,4
23016,Patites,twisting-nether,192,shaman,enhancement,6,2,4
23017,Chàrlord,twisting-nether,192,shaman,enhancement,6,2,4
23018,Søló,stormscale,192,shaman,enhancement,6,2,4
23019,Dogfrog,silvermoon,192,shaman,enhancement,6,2,4
23020,Амфеминка,gordunni,192,shaman,enhancement,6,2,4
23021,Aubesombre,dalaran,192,shaman,enhancement,6,2,4
23022,Savan,darkspear,192,shaman,enhancement,6,2,4
23023,Elsassi,ravencrest,192,shaman,enhancement,6,2,4
23024,Elektrikci,silvermoon,192,shaman,enhancement,6,2,4
23025,Bram,aggra-português,192,shaman,enhancement,6,2,4
23026,Kohzen,outland,192,shaman,enhancement,6,2,4
23027,Restmuell,blackmoore,192,shaman,enhancement,6,2,4
23028,Acces,stormscale,192,shaman,enhancement,6,2,4
23029,Ostosmvp,ravencrest,192,shaman,enhancement,6,2,4
23030,Borindor,silvermoon,192,shaman,enhancement,6,2,4
23031,Thunderstørm,chogall,192,shaman,enhancement,6,2,4
23032,Ghostkod,burning-legion,192,shaman,enhancement,6,2,4
23033,Hightotem,sanguino,192,shaman,enhancement,6,2,4
23034,Thunderwill,sanguino,192,shaman,enhancement,6,2,4
23035,Shrektar,outland,192,shaman,enhancement,6,2,4
23036,Diya,karazhan,192,shaman,enhancement,6,2,4
23037,Lokkrag,archimonde,192,shaman,enhancement,6,2,4
23038,Thralgr,sylvanas,192,shaman,enhancement,6,2,4
23039,Реалайзер,blackscar,192,shaman,enhancement,6,2,4
23040,Destroilleur,archimonde,192,shaman,enhancement,6,2,4
23041,Pulvêrizêr,agamaggan,192,shaman,enhancement,6,2,4
23042,Саксаул,fordragon,192,shaman,enhancement,6,2,4
23043,Spiritualx,argent-dawn,192,shaman,enhancement,6,2,4
23044,Jhagy,archimonde,192,shaman,enhancement,6,2,4
23045,Sgf,stormscale,192,shaman,enhancement,6,2,4
23046,Turbinká,burning-legion,192,shaman,enhancement,6,2,4
23047,Lafia,blackrock,192,shaman,enhancement,6,2,4
23048,Dalgorr,magtheridon,192,shaman,enhancement,6,2,4
23049,Shambamty,thrall,192,shaman,enhancement,6,2,4
23050,Palarins,dalaran,192,shaman,enhancement,6,2,4
23051,Volvíc,tichondrius,192,shaman,enhancement,6,2,4
23052,Родохрозид,blackscar,192,shaman,enhancement,6,2,4
23053,Zarosh,los-errantes,192,shaman,enhancement,6,2,4
23054,Layonne,ysondre,192,shaman,enhancement,6,2,4
23055,Fufupartyxx,blackrock,192,shaman,enhancement,6,2,4
23056,Тенав,blackscar,192,shaman,enhancement,6,2,4
23057,Louvreparis,frostwolf,192,shaman,enhancement,6,2,4
23058,Xharnel,defias-brotherhood,192,shaman,enhancement,6,2,4
23059,Bennycooch,silvermoon,192,shaman,enhancement,6,2,4
23060,Elementhor,archimonde,192,shaman,enhancement,6,2,4
23061,Lovros,kazzak,192,shaman,enhancement,6,2,4
23062,Bábbajaggí,blackrock,192,shaman,enhancement,6,2,4
23063,Snapbábe,blackmoore,192,shaman,enhancement,6,2,4
23064,Stratholmee,drakthul,192,shaman,enhancement,12,2,10
23065,Скерлайн,blackscar,192,shaman,enhancement,12,2,10
23066,Blutschrei,tarren-mill,192,shaman,enhancement,12,2,10
23067,Shamaniak,tarren-mill,192,shaman,enhancement,12,2,10
23068,Isladinks,draenor,192,shaman,enhancement,12,2,10
23069,Blautorkel,amanthul,159,shaman,enhancement,5,2,3
23070,Tookaageeroo,burning-legion,159,shaman,enhancement,8,3,5
23071,Tianoele,drakthul,144,shaman,enhancement,3,3,0
23072,Lekthar,draenor,138,shaman,enhancement,10,3,7
23073,Lavalew,lightbringer,96,shaman,enhancement,6,1,5
23074,Bambustic,kazzak,96,shaman,enhancement,6,1,5
23075,Corvux,tarren-mill,96,shaman,enhancement,6,1,5
23076,Halliane,ysondre,96,shaman,enhancement,6,1,5
23077,Réläx,kazzak,96,shaman,enhancement,6,1,5
23078,Casarú,arthas,96,shaman,enhancement,6,1,5
23079,Ghaargrim,tarren-mill,96,shaman,enhancement,6,1,5
23080,Eneel,blackmoore,96,shaman,enhancement,6,1,5
23081,Thoranis,kazzak,96,shaman,enhancement,6,1,5
23082,Grabmytotemz,tarren-mill,96,shaman,enhancement,6,1,5
23083,Sïlvek,sanguino,96,shaman,enhancement,6,1,5
23084,Goldhand,ravencrest,96,shaman,enhancement,6,1,5
23085,Zoogang,ragnaros,96,shaman,enhancement,6,1,5
23086,Sparkygødx,twisting-nether,96,shaman,enhancement,6,1,5
23087,Shøckz,azjolnerub,96,shaman,enhancement,6,1,5
23088,Nnele,sanguino,96,shaman,enhancement,6,1,5
23089,Maskinett,stormscale,96,shaman,enhancement,6,1,5
23090,Zugzie,draenor,96,shaman,enhancement,6,1,5
23091,Avattar,twisting-nether,96,shaman,enhancement,6,1,5
23092,Vladraxes,draenor,96,shaman,enhancement,6,1,5
23093,Cryptotem,ragnaros,96,shaman,enhancement,6,1,5
23094,Нерезшок,soulflayer,96,shaman,enhancement,6,1,5
23095,Weaslêy,frostwolf,96,shaman,enhancement,6,1,5
23096,Vrontes,kazzak,96,shaman,enhancement,6,1,5
23097,Hyamala,chamber-of-aspects,96,shaman,enhancement,6,1,5
23098,Preshear,twisting-nether,96,shaman,enhancement,6,1,5
23099,Naahma,hyjal,96,shaman,enhancement,6,1,5
23100,Kappatotem,silvermoon,96,shaman,enhancement,6,1,5
23101,Freexx,aegwynn,96,shaman,enhancement,8,1,7
23102,Awsomo,ravencrest,96,shaman,enhancement,12,1,11
23103,Ymiras,argent-dawn,96,shaman,enhancement,12,1,11
23104,Gälädhan,ysondre,95,shaman,enhancement,6,1,5
23105,Blitzviech,aegwynn,79,shaman,enhancement,5,1,4
23106,Wenesday,ysondre,48,shaman,enhancement,3,1,2
23107,Rký,outland,48,shaman,enhancement,3,1,2
23108,Lesnitt,kazzak,42,shaman,enhancement,9,2,7
23109,Hanumanas,kazzak,31,shaman,enhancement,2,1,1
23110,Arabesk,arygos,31,shaman,enhancement,2,1,1
23111,Guzguzguz,blackhand,31,shaman,enhancement,2,1,1
23112,Rikkërt,draenor,2207,warlock,demonology,89,49,40
23113,Dotjürgen,blackrock,2205,warlock,demonology,84,48,36
23114,Tuskawl,stormreaver,2154,warlock,demonology,91,51,40
23115,Kimkold,twisting-nether,2146,warlock,demonology,102,61,41
23116,Firochektro,ravencrest,2141,warlock,demonology,69,42,27
23117,Nayolana,argent-dawn,2140,warlock,demonology,60,43,17
23118,Syntaxzwo,blackmoore,2116,warlock,demonology,78,44,34
23119,Rumour,sunstrider,2115,warlock,demonology,72,39,33
23120,Supergeîl,blackrock,2112,warlock,demonology,71,38,33
23121,Pogbõss,kazzak,2092,warlock,demonology,69,40,29
23122,Млечный,blackscar,2092,warlock,demonology,89,51,38
23123,Demoner,tarren-mill,2081,warlock,demonology,84,46,38
23124,Anthh,doomhammer,2076,warlock,demonology,66,36,30
23125,Whøknøws,twisting-nether,2070,warlock,demonology,72,37,35
23126,Хаосболик,gordunni,2069,warlock,demonology,60,35,25
23127,Shablagoo,twisting-nether,2063,warlock,demonology,84,49,35
23128,Lankycheese,kazzak,2048,warlock,demonology,59,33,26
23129,Sad,lightnings-blade,2010,warlock,demonology,114,61,53
23130,Britneý,stormscale,2008,warlock,demonology,118,58,60
23131,Maintarget,blackrock,2000,warlock,demonology,106,54,52
23132,Locktrainer,tarren-mill,1991,warlock,demonology,74,34,40
23133,Cørpse,burning-legion,1988,warlock,demonology,67,39,28
23134,Конидэмико,blackscar,1954,warlock,demonology,83,38,45
23135,Jimboneutron,stormscale,1946,warlock,demonology,29,21,8
23136,Badapow,stormscale,1943,warlock,demonology,48,27,21
23137,Амеаль,eversong,1941,warlock,demonology,207,104,103
23138,Purplemonkey,burning-blade,1927,warlock,demonology,35,24,11
23139,Juicybolt,chogall,1917,warlock,demonology,70,40,30
23140,Zerulian,ragnaros,1915,warlock,demonology,42,32,10
23141,Kamorilock,blackhand,1912,warlock,demonology,36,20,16
23142,Dabezdwl,outland,1904,warlock,demonology,54,31,23
23143,Anúki,kazzak,1900,warlock,demonology,25,21,4
23144,Ravendoor,grim-batol,1900,warlock,demonology,76,39,37
23145,Outofcurses,earthen-ring,1892,warlock,demonology,77,41,36
23146,Xenastro,silvermoon,1882,warlock,demonology,36,20,16
23147,Stafar,kazzak,1875,warlock,demonology,60,33,27
23148,Höfmänn,kazzak,1865,warlock,demonology,39,25,14
23149,Адво,howling-fjord,1863,warlock,demonology,53,28,25
23150,Tyrantlol,sylvanas,1862,warlock,demonology,54,32,22
23151,Тёмабиль,gordunni,1862,warlock,demonology,149,82,67
23152,Nemwl,draenor,1861,warlock,demonology,54,32,22
23153,Bluh,twisting-nether,1860,warlock,demonology,36,22,14
23154,Dhärc,sanguino,1854,warlock,demonology,54,31,23
23155,Fearrari,ragnaros,1853,warlock,demonology,54,32,22
23156,Smaúg,archimonde,1851,warlock,demonology,60,28,32
23157,Дёмын,howling-fjord,1850,warlock,demonology,60,30,30
23158,Capsloq,la-croisade-écarlate,1849,warlock,demonology,48,28,20
23159,Höfmänn,grim-batol,1847,warlock,demonology,48,31,17
23160,Shakuroz,frostwolf,1847,warlock,demonology,68,41,27
23161,Динодотз,howling-fjord,1847,warlock,demonology,54,27,27
23162,Attritiona,stormscale,1838,warlock,demonology,60,32,28
23163,Инфезиус,deathweaver,1834,warlock,demonology,59,33,26
23164,Zouglougou,archimonde,1829,warlock,demonology,48,25,23
23165,Тьмазвёздная,gordunni,1828,warlock,demonology,45,26,19
23166,Benne,stormscale,1825,warlock,demonology,49,31,18
23167,Онлидемон,gordunni,1824,warlock,demonology,44,26,18
23168,Malificus,silvermoon,1823,warlock,demonology,114,67,47
23169,Cellfear,kazzak,1818,warlock,demonology,42,24,18
23170,Onlylock,outland,1817,warlock,demonology,36,26,10
23171,Stankaemayne,blackhand,1817,warlock,demonology,49,29,20
23172,Bualock,tarren-mill,1815,warlock,demonology,36,22,14
23173,Devilfluffy,blackhand,1815,warlock,demonology,59,35,24
23174,Cigänä,archimonde,1815,warlock,demonology,36,19,17
23175,Bonnieparkêr,onyxia,1814,warlock,demonology,42,22,20
23176,Blackdog,argent-dawn,1814,warlock,demonology,48,23,25
23177,Bibiflexberg,eredar,1812,warlock,demonology,30,19,11
23178,Kopfkissen,azshara,1810,warlock,demonology,51,29,22
23179,Crathar,kazzak,1809,warlock,demonology,64,32,32
23180,Lúcìfér,stormscale,1806,warlock,demonology,66,34,32
23181,Splicer,eredar,1803,warlock,demonology,49,29,20
23182,Киёкка,howling-fjord,1803,warlock,demonology,90,53,37
23183,Nyotu,antonidas,1802,warlock,demonology,48,25,23
23184,Htaedfo,tarren-mill,1802,warlock,demonology,74,32,42
23185,Apple,scarshield-legion,1797,warlock,demonology,60,28,32
23186,Alotami,frostwolf,1796,warlock,demonology,36,22,14
23187,Dontargetme,draenor,1794,warlock,demonology,36,24,12
23188,Оброссыш,gordunni,1790,warlock,demonology,42,24,18
23189,Dotyboi,tarren-mill,1788,warlock,demonology,30,21,9
23190,Malzeva,ravencrest,1784,warlock,demonology,65,29,36
23191,Stalowwy,silvermoon,1777,warlock,demonology,102,53,49
23192,Fiveyearque,sylvanas,1773,warlock,demonology,48,30,18
23193,Catchlock,tarren-mill,1752,warlock,demonology,36,20,16
23194,Dæhli,argent-dawn,1744,warlock,demonology,36,22,14
23195,Храбзар,gordunni,1744,warlock,demonology,76,34,42
23196,Dâedra,argent-dawn,1743,warlock,demonology,48,27,21
23197,Lïñglïñg,twisting-nether,1730,warlock,demonology,30,22,8
23198,Ambitions,hyjal,1728,warlock,demonology,40,24,16
23199,Adafbhf,tichondrius,1723,warlock,demonology,41,22,19
23200,Кварий,howling-fjord,1718,warlock,demonology,137,64,73
23201,Годнодх,gordunni,1716,warlock,demonology,30,18,12
23202,Zelieknight,ysondre,1711,warlock,demonology,54,25,29
23203,Шекигами,gordunni,1701,warlock,demonology,36,24,12
23204,Glavy,burning-legion,1699,warlock,demonology,66,36,30
23205,Totephia,kazzak,1696,warlock,demonology,72,33,39
23206,Rune,aegwynn,1695,warlock,demonology,52,29,23
23207,Jinusek,burning-legion,1682,warlock,demonology,43,23,20
23208,Grêenbull,eredar,1680,warlock,demonology,49,27,22
23209,Hellguards,silvermoon,1678,warlock,demonology,36,21,15
23210,Osbaa,bladefist,1668,warlock,demonology,42,22,20
23211,Darcîa,destromath,1666,warlock,demonology,83,48,35
23212,Tjockoloco,tarren-mill,1663,warlock,demonology,86,49,37
23213,Kemel,thrall,1655,warlock,demonology,30,21,9
23214,Niyyu,blackmoore,1654,warlock,demonology,48,22,26
23215,Shugglock,draenor,1653,warlock,demonology,42,23,19
23216,Alphalock,mannoroth,1652,warlock,demonology,39,21,18
23217,Djshyasiañ,perenolde,1650,warlock,demonology,170,88,82
23218,Utsus,tarren-mill,1645,warlock,demonology,36,23,13
23219,Eleriya,argent-dawn,1639,warlock,demonology,54,27,27
23220,Snackstickz,twisting-nether,1637,warlock,demonology,42,26,16
23221,Tiffyilock,blackrock,1637,warlock,demonology,42,20,22
23222,Ájszmen,ravencrest,1635,warlock,demonology,42,24,18
23223,Summonit,blackmoore,1629,warlock,demonology,42,23,19
23224,Dimmybyrger,stormreaver,1627,warlock,demonology,30,17,13
23225,Interceptêr,blackrock,1627,warlock,demonology,42,22,20
23226,Егосяхаос,soulflayer,1627,warlock,demonology,120,61,59
23227,Dispeluapls,blackmoore,1627,warlock,demonology,36,17,19
23228,Neuth,draenor,1627,warlock,demonology,50,21,29
23229,Indrâxx,hyjal,1626,warlock,demonology,18,17,1
23230,Malowix,outland,1625,warlock,demonology,36,17,19
23231,Dasda,defias-brotherhood,1623,warlock,demonology,89,49,40
23232,Dualla,aegwynn,1623,warlock,demonology,36,17,19
23233,Firochek,ravencrest,1622,warlock,demonology,36,20,16
23234,Itspoint,draenor,1618,warlock,demonology,53,29,24
23235,Smâûhg,blackrock,1617,warlock,demonology,24,17,7
23236,Hâres,anetheron,1614,warlock,demonology,69,32,37
23237,Proßlock,kazzak,1612,warlock,demonology,33,22,11
23238,Eroszakolock,ragnaros,1611,warlock,demonology,24,17,7
23239,Санявахтовик,blackscar,1610,warlock,demonology,30,17,13
23240,Kody,blackmoore,1609,warlock,demonology,24,17,7
23241,Shuggul,draenor,1606,warlock,demonology,37,22,15
23242,Sedryn,turalyon,1606,warlock,demonology,292,153,139
23243,Demonjoker,blackhand,1604,warlock,demonology,51,31,20
23244,Impaler,tarren-mill,1604,warlock,demonology,158,73,85
23245,Havexis,tichondrius,1602,warlock,demonology,42,32,10
23246,Vultzbolt,draenor,1601,warlock,demonology,30,19,11
23247,Despépêche,garona,1601,warlock,demonology,30,19,11
23248,Gemors,ravenholdt,1599,warlock,demonology,72,38,34
23249,Moffguldan,sanguino,1597,warlock,demonology,30,20,10
23250,Nerzhull,stormscale,1596,warlock,demonology,81,43,38
23251,Potatowl,ravencrest,1582,warlock,demonology,36,18,18
23252,Бельведерчи,blackscar,1581,warlock,demonology,42,27,15
23253,Мамхаус,howling-fjord,1579,warlock,demonology,36,22,14
23254,Erøne,archimonde,1576,warlock,demonology,112,59,53
23255,Tekron,blackhand,1568,warlock,demonology,24,18,6
23256,Импака,howling-fjord,1563,warlock,demonology,174,90,84
23257,Altffeer,blackmoore,1561,warlock,demonology,41,25,16
23258,Dotsyoudown,kelthuzad,1560,warlock,demonology,36,18,18
23259,Ahollic,frostwolf,1535,warlock,demonology,24,16,8
23260,Synthiax,silvermoon,1534,warlock,demonology,24,16,8
23261,Fsandtwo,ravencrest,1534,warlock,demonology,30,16,14
23262,Lokmonji,perenolde,1533,warlock,demonology,30,16,14
23263,Tonin,antonidas,1528,warlock,demonology,41,25,16
23264,Musallat,argent-dawn,1527,warlock,demonology,30,16,14
23265,Deamonsmith,silvermoon,1518,warlock,demonology,36,20,16
23266,Ayóó,doomhammer,1513,warlock,demonology,136,71,65
23267,Abdelkarime,khaz-modan,1511,warlock,demonology,30,16,14
23268,Roedin,tarren-mill,1507,warlock,demonology,90,33,57
23269,Эволюционист,gordunni,1483,warlock,demonology,42,22,20
23270,Sïlïthuss,ravencrest,1476,warlock,demonology,36,19,17
23271,Solitariøus,arathi,1473,warlock,demonology,30,16,14
23272,Bakýra,dun-modr,1461,warlock,demonology,36,26,10
23273,Шэдоубёрн,soulflayer,1449,warlock,demonology,48,27,21
23274,Esgül,draenor,1446,warlock,demonology,65,35,30
23275,Нгага,howling-fjord,1443,warlock,demonology,227,111,116
23276,Panic,stormrage,1442,warlock,demonology,48,29,19
23277,Jesez,aegwynn,1436,warlock,demonology,24,15,9
23278,Kalinowa,burning-legion,1435,warlock,demonology,60,31,29
23279,Weso,grim-batol,1435,warlock,demonology,30,15,15
23280,Nerigo,senjin,1435,warlock,demonology,30,15,15
23281,Silenozz,ragnaros,1434,warlock,demonology,67,38,29
23282,Mendozaah,kazzak,1426,warlock,demonology,30,15,15
23283,Corbiejr,tarren-mill,1425,warlock,demonology,70,29,41
23284,Ilarizium,ysondre,1419,warlock,demonology,47,25,22
23285,Épidémie,outland,1419,warlock,demonology,47,18,29
23286,Sevastus,argent-dawn,1409,warlock,demonology,78,40,38
23287,Dominvs,silvermoon,1408,warlock,demonology,46,25,21
23288,Sineko,twisting-nether,1404,warlock,demonology,84,39,45
23289,Tudii,frostwolf,1401,warlock,demonology,54,32,22
23290,Nimh,azjolnerub,1393,warlock,demonology,33,20,13
23291,Absúrd,turalyon,1390,warlock,demonology,132,75,57
23292,Wítchær,blackhand,1370,warlock,demonology,48,28,20
23293,Ädarä,cthun,1370,warlock,demonology,36,18,18
23294,Olsel,draenor,1349,warlock,demonology,36,16,20
23295,Gulldan,bloodfeather,1342,warlock,demonology,48,25,23
23296,Warth,silvermoon,1339,warlock,demonology,18,14,4
23297,Dedalus,zuluhed,1336,warlock,demonology,76,47,29
23298,Auxi,the-maelstrom,1335,warlock,demonology,25,15,10
23299,Фортэр,ashenvale,1332,warlock,demonology,30,14,16
23300,Иллугис,gordunni,1323,warlock,demonology,30,14,16
23301,Stormblast,azshara,1321,warlock,demonology,30,19,11
23302,Wåfa,kazzak,1318,warlock,demonology,30,17,13
23303,Erkai,kazzak,1286,warlock,demonology,27,15,12
23304,Jondi,blackmoore,1274,warlock,demonology,25,15,10
23305,Priszcilla,twisting-nether,1270,warlock,demonology,24,14,10
23306,Инсип,blackscar,1256,warlock,demonology,42,18,24
23307,Mesîkatayut,outland,1247,warlock,demonology,45,24,21
23308,Cmzdalock,ravencrest,1245,warlock,demonology,24,16,8
23309,Бриант,gordunni,1245,warlock,demonology,35,14,21
23310,Sanguinis,theradras,1243,warlock,demonology,24,13,11
23311,Greeylock,blackhand,1243,warlock,demonology,24,13,11
23312,Джердхаус,fordragon,1242,warlock,demonology,24,13,11
23313,Нэкрил,howling-fjord,1241,warlock,demonology,21,13,8
23314,Стокыч,soulflayer,1241,warlock,demonology,36,13,23
23315,Morgan,jaedenar,1240,warlock,demonology,30,13,17
23316,Felburrn,twisting-nether,1238,warlock,demonology,24,13,11
23317,Чутьчутьзлая,gordunni,1237,warlock,demonology,24,13,11
23318,Tsumde,dalaran,1230,warlock,demonology,24,13,11
23319,Расмурът,soulflayer,1201,warlock,demonology,30,13,17
23320,Vorgoth,argent-dawn,1179,warlock,demonology,28,13,15
23321,Valadair,sanguino,1164,warlock,demonology,36,17,19
23322,Scallington,shattered-hand,1152,warlock,demonology,18,12,6
23323,Zehirisalari,twisting-nether,1152,warlock,demonology,18,12,6
23324,Bloodlock,onyxia,1152,warlock,demonology,24,12,12
23325,Benvyx,twisting-nether,1152,warlock,demonology,24,12,12
23326,Инфес,deathweaver,1151,warlock,demonology,18,12,6
23327,Ffpiiras,dunemaul,1151,warlock,demonology,36,12,24
23328,Жериновсский,gordunni,1149,warlock,demonology,24,12,12
23329,Мешшугга,howling-fjord,1148,warlock,demonology,24,12,12
23330,Зажиженный,soulflayer,1147,warlock,demonology,18,12,6
23331,Kolskegg,doomhammer,1147,warlock,demonology,30,12,18
23332,Favorizlmp,archimonde,1146,warlock,demonology,24,12,12
23333,Паникс,gordunni,1145,warlock,demonology,24,12,12
23334,Gulzot,turalyon,1143,warlock,demonology,18,12,6
23335,Cahoa,archimonde,1139,warlock,demonology,18,12,6
23336,Арон,soulflayer,1119,warlock,demonology,23,12,11
23337,Golborg,draenor,1117,warlock,demonology,34,12,22
23338,Synlockiax,silvermoon,1116,warlock,demonology,14,13,1
23339,Гулдарий,howling-fjord,1115,warlock,demonology,48,23,25
23340,Razzguul,blackmoore,1112,warlock,demonology,22,12,10
23341,Rpez,archimonde,1104,warlock,demonology,109,51,58
23342,Ишла,gordunni,1086,warlock,demonology,29,12,17
23343,Bicuriousdad,tarren-mill,1056,warlock,demonology,12,11,1
23344,Adellara,draenor,1056,warlock,demonology,18,11,7
23345,Glooness,burning-legion,1056,warlock,demonology,18,11,7
23346,Tamatóax,tarren-mill,1055,warlock,demonology,12,11,1
23347,Khavar,antonidas,1055,warlock,demonology,18,11,7
23348,Dàrksoul,thrall,1054,warlock,demonology,18,11,7
23349,Algolagniac,stormscale,1054,warlock,demonology,18,11,7
23350,Dabulock,blackmoore,1050,warlock,demonology,27,12,15
23351,Zanzarismo,nemesis,1049,warlock,demonology,21,12,9
23352,Tripleshache,elune,1043,warlock,demonology,48,22,26
23353,Forthewin,stormreaver,1042,warlock,demonology,24,11,13
23354,Trellaras,bloodfeather,1028,warlock,demonology,23,11,12
23355,Flocca,archimonde,990,warlock,demonology,20,11,9
23356,Krøl,nemesis,960,warlock,demonology,12,10,2
23357,Демоник,deathguard,960,warlock,demonology,18,10,8
23358,Oggelock,tarren-mill,960,warlock,demonology,18,10,8
23359,Lonelock,blackrock,960,warlock,demonology,18,10,8
23360,Yamadea,stormscale,960,warlock,demonology,18,10,8
23361,Jopasiski,draenor,960,warlock,demonology,24,10,14
23362,Míkæ,ravencrest,959,warlock,demonology,18,10,8
23363,Katâra,tarren-mill,959,warlock,demonology,18,10,8
23364,Seriasa,blackmoore,959,warlock,demonology,24,10,14
23365,Nécron,ysondre,959,warlock,demonology,24,10,14
23366,Xtyran,blackmoore,959,warlock,demonology,24,10,14
23367,Xanatas,nemesis,958,warlock,demonology,18,10,8
23368,Stormytrumpy,twisting-nether,957,warlock,demonology,21,11,10
23369,Ablas,bladefist,940,warlock,demonology,35,10,25
23370,Fearmydear,alleria,926,warlock,demonology,17,10,7
23371,Acuacx,drakthul,909,warlock,demonology,17,10,7
23372,Rngmåchinêx,ravencrest,896,warlock,demonology,16,10,6
23373,Netcownt,silvermoon,886,warlock,demonology,25,11,14
23374,Migyardondup,exodar,872,warlock,demonology,18,10,8
23375,Ooroothothz,frostwolf,864,warlock,demonology,12,9,3
23376,Yazurí,ravencrest,864,warlock,demonology,12,9,3
23377,Öbsury,hyjal,864,warlock,demonology,12,9,3
23378,Aladèèn,tarren-mill,864,warlock,demonology,12,9,3
23379,Nargøf,outland,864,warlock,demonology,18,9,9
23380,Deaddydoo,kazzak,864,warlock,demonology,18,9,9
23381,Fandirxd,draenor,864,warlock,demonology,18,9,9
23382,Fedpikkefar,kazzak,864,warlock,demonology,18,9,9
23383,Fîgøk,conseil-des-ombres,864,warlock,demonology,24,9,15
23384,Darksoll,hyjal,864,warlock,demonology,24,9,15
23385,Hellbboy,azjolnerub,863,warlock,demonology,12,9,3
23386,Ashzu,quelthalas,863,warlock,demonology,18,9,9
23387,Khalkazar,darkspear,863,warlock,demonology,18,9,9
23388,Nosoulnoprob,sylvanas,863,warlock,demonology,24,9,15
23389,Lunden,drakthul,862,warlock,demonology,18,9,9
23390,Waltrude,conseil-des-ombres,860,warlock,demonology,30,9,21
23391,Sabiocalvo,dun-modr,858,warlock,demonology,12,9,3
23392,Lifesteal,auchindoun,858,warlock,demonology,18,9,9
23393,Анрали,soulflayer,831,warlock,demonology,17,9,8
23394,Azraëlle,drekthar,815,warlock,demonology,15,10,5
23395,Бирел,soulflayer,799,warlock,demonology,16,9,7
23396,Shadowvirus,auchindoun,799,warlock,demonology,17,9,8
23397,Dotosgyörgy,ragnaros,768,warlock,demonology,12,8,4
23398,Xerkh,thrall,768,warlock,demonology,12,8,4
23399,Chromagnus,drakthul,768,warlock,demonology,12,8,4
23400,Staenkymayne,blackhand,768,warlock,demonology,12,8,4
23401,Devildodo,elune,768,warlock,demonology,12,8,4
23402,Topmodelx,eredar,768,warlock,demonology,12,8,4
23403,Котрх,gordunni,768,warlock,demonology,12,8,4
23404,Biest,drakthul,768,warlock,demonology,18,8,10
23405,Jarodshadow,stormscale,768,warlock,demonology,18,8,10
23406,Djezzick,stormscale,768,warlock,demonology,18,8,10
23407,Koldarr,blackmoore,768,warlock,demonology,18,8,10
23408,Idkdot,ravencrest,768,warlock,demonology,18,8,10
23409,Slockoló,ragnaros,768,warlock,demonology,24,8,16
23410,Tojezlo,drakthul,767,warlock,demonology,12,8,4
23411,Sovrìn,blackrock,767,warlock,demonology,12,8,4
23412,Chimera,mugthol,767,warlock,demonology,18,8,10
23413,Guccie,ravencrest,766,warlock,demonology,17,10,7
23414,Zeddy,draenor,766,warlock,demonology,18,8,10
23415,Merzavka,kazzak,765,warlock,demonology,12,8,4
23416,Njutbar,ragnaros,765,warlock,demonology,18,8,10
23417,Ясяшотлав,soulflayer,761,warlock,demonology,22,11,11
23418,Wanderingowl,blackmoore,760,warlock,demonology,12,8,4
23419,Ambralia,blackmoore,755,warlock,demonology,18,8,10
23420,Nedivh,stormscale,751,warlock,demonology,23,8,15
23421,Warlockyo,blackrock,735,warlock,demonology,17,8,9
23422,Vreyax,aegwynn,719,warlock,demonology,11,8,3
23423,Dotwhat,ravencrest,719,warlock,demonology,17,8,9
23424,Lifetap,tarren-mill,703,warlock,demonology,14,8,6
23425,Простоседой,gordunni,703,warlock,demonology,17,8,9
23426,Aldhelm,draenor,701,warlock,demonology,16,8,8
23427,Immolleria,frostmane,672,warlock,demonology,12,7,5
23428,Гвоздяшка,blackscar,672,warlock,demonology,12,7,5
23429,Dalamon,draenor,672,warlock,demonology,12,7,5
23430,Framelock,draenor,672,warlock,demonology,12,7,5
23431,Bigbagelbob,archimonde,672,warlock,demonology,12,7,5
23432,Blekspel,outland,672,warlock,demonology,12,7,5
23433,Ipetsincl,kazzak,672,warlock,demonology,12,7,5
23434,Fearfearfear,archimonde,672,warlock,demonology,12,7,5
23435,Wiitchdoktor,twisting-nether,672,warlock,demonology,12,7,5
23436,Ravenglass,argent-dawn,672,warlock,demonology,12,7,5
23437,Ballerlock,ravencrest,672,warlock,demonology,12,7,5
23438,Louên,dun-modr,672,warlock,demonology,12,7,5
23439,Dirtytyrant,sanguino,672,warlock,demonology,12,7,5
23440,Spongebobx,kazzak,672,warlock,demonology,12,7,5
23441,Morgána,outland,672,warlock,demonology,12,7,5
23442,Plâytïmè,stormscale,672,warlock,demonology,12,7,5
23443,Shazem,tarren-mill,672,warlock,demonology,12,7,5
23444,Fearu,kazzak,672,warlock,demonology,18,7,11
23445,Enviroq,burning-legion,671,warlock,demonology,12,7,5
23446,Lockaria,zuljin,671,warlock,demonology,12,7,5
23447,Dedobozhe,ravencrest,671,warlock,demonology,12,7,5
23448,Bewbys,draenor,671,warlock,demonology,24,7,17
23449,Honetia,ravencrest,655,warlock,demonology,17,7,10
23450,Гупперлок,howling-fjord,618,warlock,demonology,21,10,11
23451,Snoggä,antonidas,617,warlock,demonology,20,8,12
23452,Warlockxx,ravencrest,607,warlock,demonology,11,7,4
23453,Нафлэпил,gordunni,585,warlock,demonology,18,8,10
23454,Onewarlock,kazzak,576,warlock,demonology,6,6,0
23455,Stafar,outland,576,warlock,demonology,6,6,0
23456,Rikkért,draenor,576,warlock,demonology,6,6,0
23457,Keybump,outland,576,warlock,demonology,6,6,0
23458,Kennÿfõx,ysondre,576,warlock,demonology,6,6,0
23459,Ogrez,nemesis,576,warlock,demonology,12,6,6
23460,Rikmeyzter,burning-blade,576,warlock,demonology,12,6,6
23461,Rîas,hyjal,576,warlock,demonology,12,6,6
23462,Hamnam,blackrock,576,warlock,demonology,12,6,6
23463,Darcol,archimonde,576,warlock,demonology,12,6,6
23464,Nephystø,archimonde,576,warlock,demonology,12,6,6
23465,Wacamolymojo,tarren-mill,576,warlock,demonology,12,6,6
23466,Vîmø,antonidas,576,warlock,demonology,12,6,6
23467,Элси,howling-fjord,576,warlock,demonology,12,6,6
23468,Сладкийпир,soulflayer,576,warlock,demonology,12,6,6
23469,Емс,gordunni,576,warlock,demonology,12,6,6
23470,Smallpee,kazzak,576,warlock,demonology,12,6,6
23471,Аоепампгодх,howling-fjord,576,warlock,demonology,12,6,6
23472,Кьютсанни,howling-fjord,576,warlock,demonology,12,6,6
23473,Devour,magtheridon,576,warlock,demonology,12,6,6
23474,Beloezoloto,deathwing,576,warlock,demonology,12,6,6
23475,Gruldran,khaz-modan,576,warlock,demonology,12,6,6
23476,Mustasheen,stormscale,576,warlock,demonology,12,6,6
23477,Cringetamer,silvermoon,576,warlock,demonology,12,6,6
23478,Redshíne,hyjal,576,warlock,demonology,18,6,12
23479,Sublînê,blackmoore,576,warlock,demonology,18,6,12
23480,Icò,ravencrest,576,warlock,demonology,18,6,12
23481,Oldasianman,blackrock,576,warlock,demonology,18,6,12
23482,Zatella,ravencrest,576,warlock,demonology,18,6,12
23483,Deadleth,blackrock,575,warlock,demonology,10,7,3
23484,Profylaxis,arathor,575,warlock,demonology,12,6,6
23485,Truckpunch,defias-brotherhood,575,warlock,demonology,18,6,12
23486,Xerxia,blackrock,575,warlock,demonology,18,6,12
23487,Methmuncher,twisting-nether,574,warlock,demonology,24,6,18
23488,Remthorn,frostmane,570,warlock,demonology,12,6,6
23489,Absurdd,turalyon,568,warlock,demonology,14,9,5
23490,Raez,burning-blade,559,warlock,demonology,17,6,11
23491,Mércé,stormscale,480,warlock,demonology,6,5,1
23492,Syntax,blackmoore,480,warlock,demonology,6,5,1
23493,Chromex,dentarg,480,warlock,demonology,6,5,1
23494,Khaleth,dun-modr,480,warlock,demonology,6,5,1
23495,Rektube,sanguino,480,warlock,demonology,6,5,1
23496,Froschhaxen,blackhand,480,warlock,demonology,6,5,1
23497,Bibilockbert,aegwynn,480,warlock,demonology,6,5,1
23498,Désolaté,kazzak,480,warlock,demonology,6,5,1
23499,Фирвебало,soulflayer,480,warlock,demonology,6,5,1
23500,Longdickie,ravencrest,480,warlock,demonology,6,5,1
23501,Köftemec,blackrock,480,warlock,demonology,6,5,1
23502,Britneÿ,stormscale,480,warlock,demonology,12,5,7
23503,Wëndigo,stormscale,480,warlock,demonology,12,5,7
23504,Kukcaryfuk,drakthul,480,warlock,demonology,12,5,7
23505,Khâmélÿa,culte-de-la-rive-noire,480,warlock,demonology,12,5,7
23506,Purepkbob,quelthalas,480,warlock,demonology,12,5,7
23507,Agaton,twisting-nether,480,warlock,demonology,12,5,7
23508,Boomlok,tarren-mill,480,warlock,demonology,12,5,7
23509,Durátor,ravencrest,480,warlock,demonology,12,5,7
23510,Msßeckinsale,tarren-mill,480,warlock,demonology,12,5,7
23511,Törtidotcom,blackrock,480,warlock,demonology,12,5,7
23512,Døwz,ysondre,480,warlock,demonology,12,5,7
23513,Morwëk,ysondre,480,warlock,demonology,12,5,7
23514,Morshax,ysondre,480,warlock,demonology,12,5,7
23515,Søcraqt,blackrock,480,warlock,demonology,13,5,8
23516,Brodoh,dun-modr,480,warlock,demonology,18,5,13
23517,Zartax,kazzak,480,warlock,demonology,18,5,13
23518,Déemón,draenor,480,warlock,demonology,18,5,13
23519,Gúldn,outland,480,warlock,demonology,18,5,13
23520,Jag,neptulon,479,warlock,demonology,6,5,1
23521,Ezekîél,blackhand,479,warlock,demonology,6,5,1
23522,Аттропа,gordunni,477,warlock,demonology,6,5,1
23523,Lokko,nemesis,415,warlock,demonology,14,5,9
23524,Mundunugu,sanguino,400,warlock,demonology,7,5,2
23525,Незерлок,soulflayer,384,warlock,demonology,6,4,2
23526,Lamboo,tarren-mill,384,warlock,demonology,6,4,2
23527,Endherkonk,sanguino,384,warlock,demonology,6,4,2
23528,Zzooxx,silvermoon,384,warlock,demonology,6,4,2
23529,Zoreck,uldum,384,warlock,demonology,6,4,2
23530,Chedipes,stormscale,384,warlock,demonology,6,4,2
23531,Absurdity,twisting-nether,384,warlock,demonology,6,4,2
23532,Rövsmärta,ragnaros,384,warlock,demonology,6,4,2
23533,Kfo,ragnaros,384,warlock,demonology,6,4,2
23534,Llilithh,draenor,384,warlock,demonology,6,4,2
23535,Otemlock,sanguino,384,warlock,demonology,6,4,2
23536,Bigballerguy,sylvanas,384,warlock,demonology,6,4,2
23537,Vêzor,twisting-nether,384,warlock,demonology,6,4,2
23538,Nekhar,twisting-nether,384,warlock,demonology,6,4,2
23539,Ahollic,antonidas,384,warlock,demonology,6,4,2
23540,Marador,drakthul,384,warlock,demonology,6,4,2
23541,Eatherial,twilights-hammer,384,warlock,demonology,6,4,2
23542,Bankstair,stormscale,384,warlock,demonology,6,4,2
23543,Indiasummerx,turalyon,384,warlock,demonology,6,4,2
23544,Watii,stormscale,384,warlock,demonology,6,4,2
23545,Fredé,kazzak,384,warlock,demonology,6,4,2
23546,Demosteaks,thrall,384,warlock,demonology,6,4,2
23547,Æternallock,nemesis,384,warlock,demonology,6,4,2
23548,Tropìcal,grim-batol,384,warlock,demonology,6,4,2
23549,Nattû,outland,384,warlock,demonology,6,4,2
23550,Куськысь,gordunni,384,warlock,demonology,9,5,4
23551,Babayagâ,sanguino,384,warlock,demonology,12,4,8
23552,Graveshaker,quelthalas,384,warlock,demonology,12,4,8
23553,Drerlord,tarren-mill,384,warlock,demonology,12,4,8
23554,Tuz,blackrock,384,warlock,demonology,12,4,8
23555,Acererak,thunderhorn,384,warlock,demonology,12,4,8
23556,Môrgán,draenor,384,warlock,demonology,18,4,14
23557,Millhaus,gorgonnash,384,warlock,demonology,18,4,14
23558,Monroé,hellfire,367,warlock,demonology,11,4,7
23559,Nili,dethecus,351,warlock,demonology,11,4,7
23560,Floriae,argent-dawn,329,warlock,demonology,13,5,8
23561,Shadaw,kilrogg,319,warlock,demonology,5,4,1
23562,Infernion,stormscale,288,warlock,demonology,6,3,3
23563,Mombo,the-maelstrom,288,warlock,demonology,6,3,3
23564,Факлок,gordunni,288,warlock,demonology,6,3,3
23565,Wombsa,blackmoore,288,warlock,demonology,6,3,3
23566,Лысыйлокоть,soulflayer,288,warlock,demonology,6,3,3
23567,Mingingclass,stormscale,288,warlock,demonology,6,3,3
23568,Myliege,kilrogg,288,warlock,demonology,6,3,3
23569,Immaginare,sylvanas,288,warlock,demonology,6,3,3
23570,Väladar,sanguino,288,warlock,demonology,6,3,3
23571,Локистраик,borean-tundra,288,warlock,demonology,6,3,3
23572,Парачо,eversong,288,warlock,demonology,6,3,3
23573,Wendetta,stormreaver,288,warlock,demonology,6,3,3
23574,Elmîr,blackmoore,288,warlock,demonology,6,3,3
23575,Talindra,stormscale,288,warlock,demonology,6,3,3
23576,Waîdo,blackhand,288,warlock,demonology,6,3,3
23577,Kosfáce,kazzak,288,warlock,demonology,6,3,3
23578,Xjms,darksorrow,288,warlock,demonology,6,3,3
23579,Bono,frostwhisper,288,warlock,demonology,6,3,3
23580,Zerx,malganis,288,warlock,demonology,6,3,3
23581,Matheus,zenedar,288,warlock,demonology,6,3,3
23582,Suucc,draenor,288,warlock,demonology,6,3,3
23583,Xiraq,nathrezim,288,warlock,demonology,6,3,3
23584,Alcringe,kazzak,288,warlock,demonology,6,3,3
23585,Jegfaller,wildhammer,288,warlock,demonology,6,3,3
23586,Jetset,moonglade,288,warlock,demonology,6,3,3
23587,Sidragasoss,drakthul,288,warlock,demonology,6,3,3
23588,Комочеро,soulflayer,288,warlock,demonology,6,3,3
23589,Prekt,ragnaros,288,warlock,demonology,6,3,3
23590,Дотботх,howling-fjord,288,warlock,demonology,6,3,3
23591,Buserella,eredar,288,warlock,demonology,6,3,3
23592,Alotadot,ravencrest,288,warlock,demonology,6,3,3
23593,Requeims,outland,288,warlock,demonology,6,3,3
23594,Klaab,hyjal,288,warlock,demonology,6,3,3
23595,Horststenzl,blackrock,288,warlock,demonology,6,3,3
23596,Osyx,ravencrest,288,warlock,demonology,6,3,3
23597,Pipoûc,archimonde,288,warlock,demonology,6,3,3
23598,Císuh,stormreaver,288,warlock,demonology,6,3,3
23599,Opiumers,kazzak,288,warlock,demonology,6,3,3
23600,Afflimoomoo,tarren-mill,288,warlock,demonology,6,3,3
23601,Bionic,eredar,288,warlock,demonology,6,3,3
23602,Hannens,blackrock,288,warlock,demonology,6,3,3
23603,Rushkush,ravencrest,288,warlock,demonology,7,3,4
23604,Tunrîda,illidan,288,warlock,demonology,10,3,7
23605,Nâzgrel,tarren-mill,288,warlock,demonology,12,3,9
23606,Dardec,hyjal,288,warlock,demonology,12,3,9
23607,Зарлог,soulflayer,288,warlock,demonology,12,3,9
23608,Themengh,stormscale,288,warlock,demonology,12,3,9
23609,Ftpete,argent-dawn,288,warlock,demonology,12,3,9
23610,Cassen,outland,288,warlock,demonology,12,3,9
23611,Kamí,sanguino,288,warlock,demonology,12,3,9
23612,Hartee,argent-dawn,288,warlock,demonology,18,3,15
23613,Ydidntuwait,ragnaros,288,warlock,demonology,18,3,15
23614,Petrosk,sanguino,287,warlock,demonology,6,3,3
23615,Calypso,korgall,239,warlock,demonology,5,3,2
23616,Irnx,tarren-mill,192,warlock,demonology,6,2,4
23617,Кайрана,blackscar,192,warlock,demonology,6,2,4
23618,Flatwolenzy,blackrock,192,warlock,demonology,6,2,4
23619,Jkz,blackrock,192,warlock,demonology,6,2,4
23620,Ïvar,ysondre,192,warlock,demonology,6,2,4
23621,Baradür,sanguino,192,warlock,demonology,6,2,4
23622,Zyréx,eredar,192,warlock,demonology,6,2,4
23623,Gammalgubbe,stormscale,192,warlock,demonology,6,2,4
23624,Kasztyk,grim-batol,192,warlock,demonology,6,2,4
23625,Médeâ,ravencrest,192,warlock,demonology,6,2,4
23626,Ukjjkhj,frostmane,192,warlock,demonology,6,2,4
23627,Äåäåäåäåäåäå,ravencrest,192,warlock,demonology,6,2,4
23628,Kumamoto,tarren-mill,192,warlock,demonology,6,2,4
23629,Incesticide,ragnaros,192,warlock,demonology,6,2,4
23630,Epoku,stormscale,192,warlock,demonology,6,2,4
23631,Nastychâtøn,ysondre,192,warlock,demonology,6,2,4
23632,Iblis,grim-batol,192,warlock,demonology,6,2,4
23633,Bowti,ravencrest,192,warlock,demonology,6,2,4
23634,Belzedan,blackrock,192,warlock,demonology,6,2,4
23635,Salvatoríy,outland,192,warlock,demonology,6,2,4
23636,Dust,argent-dawn,192,warlock,demonology,6,2,4
23637,Hypotax,ragnaros,192,warlock,demonology,6,2,4
23638,Lokelicious,ragnaros,192,warlock,demonology,6,2,4
23639,Xoky,argent-dawn,192,warlock,demonology,6,2,4
23640,Retrosatanas,archimonde,192,warlock,demonology,6,2,4
23641,Fatkkroth,ravencrest,192,warlock,demonology,6,2,4
23642,Эссминет,soulflayer,192,warlock,demonology,6,2,4
23643,Кхадгард,howling-fjord,192,warlock,demonology,6,2,4
23644,Kaobolt,archimonde,192,warlock,demonology,6,2,4
23645,Indifférence,archimonde,192,warlock,demonology,6,2,4
23646,Nazw,ravencrest,192,warlock,demonology,6,2,4
23647,Surfingbirdz,ragnaros,192,warlock,demonology,6,2,4
23648,Cali,ahnqiraj,192,warlock,demonology,6,2,4
23649,Desolador,tyrande,192,warlock,demonology,6,2,4
23650,Скверногрик,fordragon,192,warlock,demonology,6,2,4
23651,Azurma,tarren-mill,192,warlock,demonology,6,2,4
23652,Bu,zirkel-des-cenarius,192,warlock,demonology,6,2,4
23653,Repah,doomhammer,192,warlock,demonology,6,2,4
23654,Seldonn,pozzo-delleternità,192,warlock,demonology,6,2,4
23655,Saruna,azshara,192,warlock,demonology,6,2,4
23656,Sneptics,draenor,192,warlock,demonology,6,2,4
23657,Tepelkwastje,twisting-nether,192,warlock,demonology,6,2,4
23658,Skrana,kazzak,192,warlock,demonology,6,2,4
23659,Prestige,nemesis,192,warlock,demonology,6,2,4
23660,Ismenia,silvermoon,192,warlock,demonology,6,2,4
23661,Stromzii,silvermoon,192,warlock,demonology,6,2,4
23662,Chram,uldum,192,warlock,demonology,7,2,5
23663,Xanatar,blackhand,192,warlock,demonology,12,2,10
23664,Grimmwald,stormreaver,192,warlock,demonology,12,2,10
23665,Déadwish,ravencrest,192,warlock,demonology,12,2,10
23666,Henriett,ravencrest,192,warlock,demonology,12,2,10
23667,Letzterlude,thrall,159,warlock,demonology,5,2,3
23668,Bolt,stormscale,96,warlock,demonology,6,1,5
23669,Militianu,sylvanas,96,warlock,demonology,6,1,5
23670,Ароматныйх,howling-fjord,96,warlock,demonology,6,1,5
23671,Gulderrf,kirin-tor,96,warlock,demonology,6,1,5
23672,Utuklululu,archimonde,96,warlock,demonology,6,1,5
23673,Necroless,shadowsong,96,warlock,demonology,6,1,5
23674,Nécromancér,doomhammer,96,warlock,demonology,6,1,5
23675,Tid,burning-legion,96,warlock,demonology,6,1,5
23676,Marann,dun-morogh,96,warlock,demonology,6,1,5
23677,Divvaa,tarren-mill,96,warlock,demonology,6,1,5
23678,Árkan,thrall,96,warlock,demonology,6,1,5
23679,Ðßøhßäøùí,blackmoore,96,warlock,demonology,6,1,5
23680,Xydar,stormscale,42,warlock,demonology,10,2,8
23681,Infïnitýx,silvermoon,31,warlock,demonology,2,1,1
23682,Кайзершлафен,fordragon,31,warlock,demonology,2,1,1
23683,Loghit,ravencrest,16,warlock,demonology,1,1,0
23684,Грешъник,gordunni,16,warlock,demonology,1,1,0
23685,Papilena,turalyon,16,warlock,demonology,1,1,0
23686,Inferniøn,ravencrest,2339,warlock,destruction,69,52,17
23687,Lopari,aegwynn,2275,warlock,destruction,106,65,41
23688,Фаерморн,blackscar,2269,warlock,destruction,60,44,16
23689,Canabolic,stormscale,2269,warlock,destruction,90,55,35
23690,Боуман,howling-fjord,2243,warlock,destruction,96,56,40
23691,Acentro,stormscale,2231,warlock,destruction,71,46,25
23692,Creatúre,drakthul,2224,warlock,destruction,48,38,10
23693,Yùna,frostwolf,2209,warlock,destruction,72,48,24
23694,Телола,gordunni,2208,warlock,destruction,72,48,24
23695,Dæhli,argent-dawn,2204,warlock,destruction,102,56,46
23696,Azurma,tarren-mill,2203,warlock,destruction,72,44,28
23697,Steckenpferd,blackmoore,2190,warlock,destruction,54,37,17
23698,Zélroth,argent-dawn,2178,warlock,destruction,120,72,48
23699,Rootzlx,ravencrest,2177,warlock,destruction,103,61,42
23700,Bóbtown,stormscale,2160,warlock,destruction,102,60,42
23701,Handicapped,burning-legion,2158,warlock,destruction,78,47,31
23702,Rexløck,nozdormu,2156,warlock,destruction,111,76,35
23703,Absurdity,twisting-nether,2155,warlock,destruction,90,47,43
23704,Erutaerc,drakthul,2154,warlock,destruction,48,32,16
23705,Glooness,burning-legion,2151,warlock,destruction,78,43,35
23706,Anihli,kazzak,2149,warlock,destruction,78,45,33
23707,Snapperz,stormscale,2145,warlock,destruction,102,55,47
23708,Tópdogg,twisting-nether,2140,warlock,destruction,54,43,11
23709,Ønlyfans,blackhand,2136,warlock,destruction,72,45,27
23710,Паилка,galakrond,2133,warlock,destruction,123,70,53
23711,Jâzggz,twisting-nether,2130,warlock,destruction,54,37,17
23712,Legionlockxd,twisting-nether,2129,warlock,destruction,88,48,40
23713,Arfdispo,hyjal,2120,warlock,destruction,101,55,46
23714,Velv,nagrand,2112,warlock,destruction,90,45,45
23715,Рауваскх,howling-fjord,2110,warlock,destruction,53,31,22
23716,Cryzzbad,stormscale,2109,warlock,destruction,36,29,7
23717,Císuh,stormreaver,2108,warlock,destruction,96,56,40
23718,Xeremas,blackrock,2104,warlock,destruction,59,45,14
23719,Lywov,stormscale,2103,warlock,destruction,60,34,26
23720,Артик,gordunni,2101,warlock,destruction,48,37,11
23721,Amdead,sylvanas,2101,warlock,destruction,73,52,21
23722,Ìpen,bloodfeather,2101,warlock,destruction,71,40,31
23723,Фримех,soulflayer,2095,warlock,destruction,59,45,14
23724,Djmcwarlock,kazzak,2095,warlock,destruction,65,37,28
23725,Bäle,stormreaver,2093,warlock,destruction,84,50,34
23726,Kimkold,twisting-nether,2087,warlock,destruction,90,46,44
23727,Dabzw,twisting-nether,2075,warlock,destruction,67,43,24
23728,Necromanya,ravencrest,2074,warlock,destruction,132,79,53
23729,Vitus,malganis,2067,warlock,destruction,84,54,30
23730,Voldby,kazzak,2064,warlock,destruction,66,33,33
23731,Zàkx,silvermoon,2057,warlock,destruction,208,121,87
23732,Bewegen,frostwolf,2055,warlock,destruction,60,37,23
23733,Простишутках,gordunni,2051,warlock,destruction,48,30,18
23734,Bankstair,stormscale,2049,warlock,destruction,48,33,15
23735,Héffer,outland,2044,warlock,destruction,121,80,41
23736,Chaosbuster,magtheridon,2041,warlock,destruction,84,56,28
23737,Кенгарь,howling-fjord,2032,warlock,destruction,90,52,38
23738,Laedreth,argent-dawn,2031,warlock,destruction,128,75,53
23739,Влицотьмой,gordunni,2023,warlock,destruction,66,37,29
23740,Bualock,sylvanas,2019,warlock,destruction,54,30,24
23741,Felcamino,outland,2019,warlock,destruction,72,36,36
23742,Wldot,ravencrest,2016,warlock,destruction,66,41,25
23743,Geluwu,tarren-mill,2015,warlock,destruction,60,35,25
23744,Nellyvato,eredar,2012,warlock,destruction,60,35,25
23745,Ánderxyo,dun-modr,2010,warlock,destruction,36,29,7
23746,Drainsouls,stormscale,2009,warlock,destruction,159,86,73
23747,Кишмякхб,howling-fjord,2008,warlock,destruction,60,32,28
23748,Corbbolt,drakthul,2005,warlock,destruction,60,37,23
23749,Gulwer,blackmoore,1997,warlock,destruction,42,26,16
23750,Shangalar,burning-legion,1994,warlock,destruction,66,40,26
23751,Bigbolt,arathor,1994,warlock,destruction,74,41,33
23752,Johanan,ravencrest,1987,warlock,destruction,30,24,6
23753,Шархихохо,gordunni,1986,warlock,destruction,72,37,35
23754,Инферналках,gordunni,1983,warlock,destruction,59,39,20
23755,Haedache,tarren-mill,1976,warlock,destruction,42,25,17
23756,Hotdoghomie,tarren-mill,1974,warlock,destruction,36,28,8
23757,Кириланскил,gordunni,1974,warlock,destruction,48,30,18
23758,Ffpiiras,dunemaul,1972,warlock,destruction,63,37,26
23759,Kwoleriker,norgannon,1969,warlock,destruction,64,38,26
23760,Asáel,blackrock,1968,warlock,destruction,78,44,34
23761,Lhestér,outland,1967,warlock,destruction,57,35,22
23762,Whakkx,blackrock,1967,warlock,destruction,42,25,17
23763,Koisk,tarren-mill,1966,warlock,destruction,60,34,26
23764,Gogmorok,dunemaul,1962,warlock,destruction,154,80,74
23765,Zèlêph,archimonde,1961,warlock,destruction,126,80,46
23766,Zarisya,blackmoore,1961,warlock,destruction,48,29,19
23767,Drowlý,twisting-nether,1961,warlock,destruction,54,32,22
23768,Portlock,kazzak,1959,warlock,destruction,66,39,27
23769,Vvj,ravencrest,1959,warlock,destruction,72,39,33
23770,Hladankurac,twisting-nether,1956,warlock,destruction,42,26,16
23771,Looneytoonz,blackrock,1956,warlock,destruction,84,50,34
23772,Блакхен,blackscar,1956,warlock,destruction,54,29,25
23773,Malgarøth,tarren-mill,1955,warlock,destruction,60,28,32
23774,Сумракк,gordunni,1954,warlock,destruction,66,35,31
23775,Stefcheto,twilights-hammer,1953,warlock,destruction,78,43,35
23776,Сильвиос,howling-fjord,1943,warlock,destruction,100,49,51
23777,Онлидемон,gordunni,1942,warlock,destruction,73,38,35
23778,Ryûsuke,dun-modr,1941,warlock,destruction,36,24,12
23779,Logicdotexé,tarren-mill,1940,warlock,destruction,61,39,22
23780,Madridistaß,outland,1939,warlock,destruction,78,40,38
23781,Aestheatic,draenor,1938,warlock,destruction,143,77,66
23782,Rhüd,twisting-nether,1934,warlock,destruction,66,38,28
23783,Vîmø,antonidas,1929,warlock,destruction,89,59,30
23784,Suprezz,sylvanas,1929,warlock,destruction,60,36,24
23785,Supergeîl,blackrock,1920,warlock,destruction,78,41,37
23786,Bfaexpert,ravencrest,1917,warlock,destruction,24,20,4
23787,Magonyth,ravencrest,1909,warlock,destruction,90,49,41
23788,Zoodíac,blackrock,1904,warlock,destruction,48,32,16
23789,Healylockx,stormscale,1904,warlock,destruction,48,28,20
23790,Рашчер,gordunni,1901,warlock,destruction,42,24,18
23791,Rúbs,sylvanas,1897,warlock,destruction,102,55,47
23792,Mxxmmllm,kargath,1896,warlock,destruction,101,62,39
23793,Kaktakto,ravencrest,1895,warlock,destruction,54,30,24
23794,Vregor,twisting-nether,1892,warlock,destruction,36,26,10
23795,Twisted,malganis,1891,warlock,destruction,90,51,39
23796,Juhpz,blackrock,1888,warlock,destruction,52,24,28
23797,Nëismz,hyjal,1884,warlock,destruction,42,25,17
23798,Whøîäm,kazzak,1883,warlock,destruction,42,31,11
23799,Hânex,ravencrest,1883,warlock,destruction,42,28,14
23800,Мспечень,howling-fjord,1882,warlock,destruction,42,32,10
23801,Henmur,stormscale,1879,warlock,destruction,64,37,27
23802,Eboyclass,twisting-nether,1875,warlock,destruction,33,23,10
23803,Ulora,zirkel-des-cenarius,1875,warlock,destruction,59,33,26
23804,Tschapatalpi,blackhand,1875,warlock,destruction,64,31,33
23805,Kumamoto,tarren-mill,1874,warlock,destruction,42,27,15
23806,Тагочи,gordunni,1872,warlock,destruction,56,31,25
23807,Rockbèll,blackmoore,1871,warlock,destruction,36,28,8
23808,Ðènnis,tarren-mill,1870,warlock,destruction,42,28,14
23809,Isuckwarlock,aegwynn,1870,warlock,destruction,48,26,22
23810,Djdampening,bloodhoof,1868,warlock,destruction,34,27,7
23811,Dooms,antonidas,1868,warlock,destruction,42,31,11
23812,Аоепампгодх,howling-fjord,1866,warlock,destruction,80,57,23
23813,Lockisbadx,draenor,1866,warlock,destruction,48,26,22
23814,Rohyna,archimonde,1865,warlock,destruction,36,27,9
23815,Limoges,archimonde,1865,warlock,destruction,35,26,9
23816,Djhanzó,outland,1865,warlock,destruction,39,24,15
23817,Lockchonk,kazzak,1864,warlock,destruction,66,45,21
23818,Fearo,kazzak,1864,warlock,destruction,54,32,22
23819,Spookytouch,draenor,1864,warlock,destruction,94,47,47
23820,Sheitana,ysondre,1863,warlock,destruction,60,39,21
23821,Rokkarn,kazzak,1863,warlock,destruction,48,29,19
23822,Decimus,darkspear,1863,warlock,destruction,90,52,38
23823,Kuckacocucka,outland,1861,warlock,destruction,59,34,25
23824,Makîø,hyjal,1860,warlock,destruction,53,27,26
23825,Deathfløw,draenor,1859,warlock,destruction,48,35,13
23826,Блейдап,razuvious,1859,warlock,destruction,54,31,23
23827,Drdoit,blackrock,1859,warlock,destruction,60,31,29
23828,Beebs,aegwynn,1858,warlock,destruction,42,31,11
23829,Homerbamboom,hyjal,1857,warlock,destruction,41,32,9
23830,Chaoscrit,eredar,1856,warlock,destruction,62,37,25
23831,Hairyporta,blackmoore,1855,warlock,destruction,101,59,42
23832,Djfearbot,kazzak,1854,warlock,destruction,78,49,29
23833,Darksoll,hyjal,1853,warlock,destruction,41,31,10
23834,Påsqúåls,ravencrest,1853,warlock,destruction,42,26,16
23835,Wankdiesel,der-rat-von-dalaran,1853,warlock,destruction,114,57,57
23836,Jawoxoxo,rexxar,1852,warlock,destruction,48,20,28
23837,Tuplajekku,sylvanas,1851,warlock,destruction,59,29,30
23838,Johnylock,draenor,1850,warlock,destruction,116,71,45
23839,Themut,draenor,1847,warlock,destruction,76,49,27
23840,Кобре,howling-fjord,1847,warlock,destruction,42,26,16
23841,Noomaca,drakthul,1847,warlock,destruction,60,36,24
23842,Ayperos,tyrande,1847,warlock,destruction,72,38,34
23843,Ilovemimi,hyjal,1846,warlock,destruction,35,20,15
23844,Шрэкс,blackscar,1846,warlock,destruction,42,22,20
23845,Gorillabolts,tarren-mill,1846,warlock,destruction,48,21,27
23846,Nekrosd,tarren-mill,1843,warlock,destruction,126,68,58
23847,Fîgøk,conseil-des-ombres,1841,warlock,destruction,72,42,30
23848,Attilergg,stormscale,1839,warlock,destruction,32,23,9
23849,Ecoxx,aegwynn,1839,warlock,destruction,48,34,14
23850,Nògg,frostwhisper,1839,warlock,destruction,36,24,12
23851,Ñila,ravencrest,1839,warlock,destruction,36,23,13
23852,Ripnsew,ravencrest,1839,warlock,destruction,41,26,15
23853,Nayolana,argent-dawn,1839,warlock,destruction,75,35,40
23854,Wällaar,ragnaros,1837,warlock,destruction,60,33,27
23855,Sïeur,archimonde,1835,warlock,destruction,107,67,40
23856,Belial,minahonda,1835,warlock,destruction,57,33,24
23857,Гивмисоул,soulflayer,1835,warlock,destruction,54,31,23
23858,Médeâ,ravencrest,1834,warlock,destruction,76,42,34
23859,Bluefungirl,stormscale,1833,warlock,destruction,41,26,15
23860,Válýrá,blackhand,1832,warlock,destruction,41,30,11
23861,Carelock,chamber-of-aspects,1832,warlock,destruction,36,25,11
23862,Ganjubass,tarren-mill,1832,warlock,destruction,74,46,28
23863,Garlan,dun-modr,1832,warlock,destruction,118,64,54
23864,Indraxx,hyjal,1832,warlock,destruction,62,28,34
23865,Noobgg,kazzak,1831,warlock,destruction,36,26,10
23866,Ftpete,argent-dawn,1831,warlock,destruction,98,58,40
23867,Umbraz,blackmoore,1829,warlock,destruction,48,26,22
23868,Extingul,tarren-mill,1828,warlock,destruction,30,23,7
23869,Someonepro,tarren-mill,1828,warlock,destruction,53,25,28
23870,Plaguee,outland,1826,warlock,destruction,62,37,25
23871,Alphazero,zuluhed,1826,warlock,destruction,53,29,24
23872,Жасминдос,blackscar,1825,warlock,destruction,45,31,14
23873,Freddaxd,outland,1825,warlock,destruction,52,33,19
23874,Соргосор,gordunni,1825,warlock,destruction,53,30,23
23875,Saffíe,ravencrest,1825,warlock,destruction,64,36,28
23876,Asilock,eredar,1824,warlock,destruction,48,32,16
23877,Worse,kazzak,1823,warlock,destruction,48,29,19
23878,Maderto,burning-legion,1823,warlock,destruction,185,101,84
23879,Killáksi,ravencrest,1821,warlock,destruction,42,26,16
23880,Merçedesa,tarren-mill,1820,warlock,destruction,35,20,15
23881,Mocha,ravencrest,1819,warlock,destruction,48,31,17
23882,Kivilock,dun-modr,1819,warlock,destruction,67,43,24
23883,Juppi,blackrock,1819,warlock,destruction,138,82,56
23884,Bàbyløck,archimonde,1819,warlock,destruction,64,38,26
23885,Killning,medivh,1819,warlock,destruction,114,65,49
23886,Ethiq,blackrock,1818,warlock,destruction,30,19,11
23887,Srkzlol,durotan,1817,warlock,destruction,66,35,31
23888,Keybump,outland,1816,warlock,destruction,108,65,43
23889,Alcringe,kazzak,1816,warlock,destruction,158,90,68
23890,Schrimz,blackrock,1816,warlock,destruction,54,26,28
23891,Matsuei,tarren-mill,1816,warlock,destruction,48,23,25
23892,Louloudots,ragnaros,1815,warlock,destruction,36,22,14
23893,Hafufxd,runetotem,1814,warlock,destruction,36,30,6
23894,Тьмазвёздная,gordunni,1814,warlock,destruction,42,31,11
23895,Кейкегенкай,gordunni,1814,warlock,destruction,69,40,29
23896,Nemwl,draenor,1814,warlock,destruction,66,31,35
23897,Kamoriwl,blackhand,1813,warlock,destruction,30,19,11
23898,Asbest,blackrock,1813,warlock,destruction,48,28,20
23899,Whisperer,defias-brotherhood,1812,warlock,destruction,54,29,25
23900,Smaúg,archimonde,1811,warlock,destruction,69,33,36
23901,Gregwyn,hellscream,1809,warlock,destruction,24,19,5
23902,Tàkaz,drekthar,1809,warlock,destruction,64,39,25
23903,Cujo,draenor,1807,warlock,destruction,48,29,19
23904,Mangolicious,twisting-nether,1807,warlock,destruction,54,28,26
23905,Tikondrus,ravencrest,1806,warlock,destruction,24,19,5
23906,Ispankmysuc,korgall,1806,warlock,destruction,57,35,22
23907,Rûttna,kazzak,1806,warlock,destruction,53,27,26
23908,Pumpelumpe,twisting-nether,1806,warlock,destruction,45,20,25
23909,Yøshinø,wildhammer,1805,warlock,destruction,48,36,12
23910,Visceris,ravencrest,1804,warlock,destruction,36,19,17
23911,Laolife,twisting-nether,1803,warlock,destruction,60,30,30
23912,Ertogrul,draenor,1802,warlock,destruction,24,19,5
23913,Richerdgir,ravencrest,1802,warlock,destruction,39,25,14
23914,Kerídiin,twisting-nether,1801,warlock,destruction,42,23,19
23915,Infý,ravencrest,1800,warlock,destruction,38,25,13
23916,Skrana,kazzak,1800,warlock,destruction,65,39,26
23917,Xesh,kiljaeden,1796,warlock,destruction,54,27,27
23918,Junakot,silvermoon,1795,warlock,destruction,42,24,18
23919,Robertóó,burning-legion,1792,warlock,destruction,64,34,30
23920,Hebbxw,kazzak,1790,warlock,destruction,60,38,22
23921,Depressedkid,ravencrest,1788,warlock,destruction,54,27,27
23922,Ërîkå,ravencrest,1785,warlock,destruction,99,59,40
23923,Doodle,the-maelstrom,1785,warlock,destruction,60,34,26
23924,Kayloo,archimonde,1784,warlock,destruction,48,28,20
23925,Gøzù,antonidas,1783,warlock,destruction,36,21,15
23926,Knoxwhite,stormscale,1781,warlock,destruction,42,28,14
23927,Orgebixx,blackmoore,1781,warlock,destruction,42,26,16
23928,Andtheysay,outland,1780,warlock,destruction,60,38,22
23929,Kikeri,blackhand,1775,warlock,destruction,42,26,16
23930,Tajit,eredar,1773,warlock,destruction,66,32,34
23931,Crse,antonidas,1772,warlock,destruction,79,52,27
23932,Immaginare,sylvanas,1772,warlock,destruction,54,32,22
23933,Demoner,tarren-mill,1769,warlock,destruction,156,90,66
23934,Motcha,kazzak,1769,warlock,destruction,36,20,16
23935,Wintheirl,argent-dawn,1765,warlock,destruction,96,54,42
23936,Демоник,deathguard,1763,warlock,destruction,42,24,18
23937,Olympïe,archimonde,1761,warlock,destruction,46,32,14
23938,Tuskawl,stormreaver,1760,warlock,destruction,30,19,11
23939,Khoug,blackmoore,1758,warlock,destruction,48,26,22
23940,Slytherim,stormscale,1757,warlock,destruction,75,49,26
23941,Dogoon,sylvanas,1757,warlock,destruction,89,51,38
23942,Vmorghuliss,sanguino,1757,warlock,destruction,84,38,46
23943,Èlton,tarren-mill,1756,warlock,destruction,72,42,30
23944,Mønarch,argent-dawn,1755,warlock,destruction,67,40,27
23945,Jegfaller,wildhammer,1754,warlock,destruction,206,105,101
23946,Хирацука,howling-fjord,1749,warlock,destruction,45,31,14
23947,Mércé,stormscale,1748,warlock,destruction,30,22,8
23948,Якурюимнепох,gordunni,1748,warlock,destruction,83,45,38
23949,Büm,kazzak,1746,warlock,destruction,54,28,26
23950,Cmdxo,malganis,1746,warlock,destruction,60,29,31
23951,Kiwibob,defias-brotherhood,1745,warlock,destruction,53,32,21
23952,Bianchii,stormscale,1743,warlock,destruction,27,20,7
23953,Fizzydark,malganis,1743,warlock,destruction,48,26,22
23954,Fearfearfear,archimonde,1743,warlock,destruction,84,41,43
23955,Ícekíss,hyjal,1742,warlock,destruction,30,21,9
23956,Dualla,aegwynn,1740,warlock,destruction,60,35,25
23957,Ванадий,soulflayer,1739,warlock,destruction,47,23,24
23958,Rivmuu,argent-dawn,1737,warlock,destruction,76,49,27
23959,Shadöwmäre,draenor,1737,warlock,destruction,48,26,22
23960,Brainac,blackrock,1736,warlock,destruction,30,19,11
23961,Сумракз,soulflayer,1736,warlock,destruction,36,19,17
23962,Взорг,soulflayer,1736,warlock,destruction,60,30,30
23963,Cencible,twisting-nether,1734,warlock,destruction,72,42,30
23964,Dotalike,kazzak,1734,warlock,destruction,42,22,20
23965,Десло,thermaplugg,1731,warlock,destruction,42,25,17
23966,Ilovebronko,blackrock,1729,warlock,destruction,64,36,28
23967,Upsahl,twisting-nether,1729,warlock,destruction,110,61,49
23968,Айхопъюдай,blackscar,1724,warlock,destruction,30,18,12
23969,Olsel,draenor,1723,warlock,destruction,35,24,11
23970,Dersdog,twisting-nether,1723,warlock,destruction,28,19,9
23971,Killerbolt,blackmoore,1720,warlock,destruction,42,28,14
23972,Drututt,the-maelstrom,1720,warlock,destruction,36,21,15
23973,Silmerion,twilights-hammer,1719,warlock,destruction,54,32,22
23974,Бжк,gordunni,1717,warlock,destruction,54,31,23
23975,Öbsury,hyjal,1715,warlock,destruction,43,23,20
23976,Stromzii,silvermoon,1714,warlock,destruction,66,35,31
23977,Ràzek,kazzak,1712,warlock,destruction,77,38,39
23978,Koldarr,blackmoore,1711,warlock,destruction,64,38,26
23979,Depressor,ragnaros,1709,warlock,destruction,42,23,19
23980,Neoe,stormscale,1709,warlock,destruction,48,24,24
23981,Boumbye,ysondre,1707,warlock,destruction,38,23,15
23982,Barneyboi,tarren-mill,1704,warlock,destruction,53,38,15
23983,Sneptics,draenor,1704,warlock,destruction,121,75,46
23984,Nineinchlock,silvermoon,1704,warlock,destruction,42,18,24
23985,Laokoon,blackmoore,1702,warlock,destruction,24,18,6
23986,Xunzu,drakthul,1702,warlock,destruction,42,18,24
23987,Tîllz,kargath,1698,warlock,destruction,24,22,2
23988,Twiseqtt,stormscale,1697,warlock,destruction,30,18,12
23989,Xfz,stormscale,1697,warlock,destruction,36,20,16
23990,Amited,drakthul,1696,warlock,destruction,48,29,19
23991,Dayken,silvermoon,1694,warlock,destruction,27,23,4
23992,Fløkee,blackmoore,1694,warlock,destruction,30,18,12
23993,Kerway,outland,1694,warlock,destruction,48,26,22
23994,Sargus,drakthul,1692,warlock,destruction,68,35,33
23995,Hellguards,silvermoon,1692,warlock,destruction,48,24,24
23996,Таксидермия,gordunni,1691,warlock,destruction,49,29,20
23997,Väladar,sanguino,1690,warlock,destruction,47,23,24
23998,Véstheim,saurfang,1685,warlock,destruction,48,29,19
23999,Ôlo,rajaxx,1684,warlock,destruction,36,23,13
24000,Fredé,kazzak,1684,warlock,destruction,47,24,23
24001,Fearlessgødx,ravencrest,1683,warlock,destruction,64,35,29
24002,Delumia,tarren-mill,1680,warlock,destruction,78,42,36
24003,Røiheenøk,archimonde,1680,warlock,destruction,114,54,60
24004,Nutyx,twisting-nether,1679,warlock,destruction,36,23,13
24005,Raepist,terokkar,1679,warlock,destruction,42,25,17
24006,Sad,lightnings-blade,1677,warlock,destruction,30,18,12
24007,Whiteðevil,draenor,1677,warlock,destruction,36,21,15
24008,Acidmvp,ravencrest,1676,warlock,destruction,72,38,34
24009,Feardotbye,stormscale,1675,warlock,destruction,27,18,9
24010,Variu,blackhand,1675,warlock,destruction,101,60,41
24011,Opiumers,kazzak,1674,warlock,destruction,53,28,25
24012,Wåfa,kazzak,1673,warlock,destruction,24,18,6
24013,Dogdrakex,tarren-mill,1672,warlock,destruction,34,20,14
24014,Boomsparkle,blackrock,1671,warlock,destruction,36,23,13
24015,Zloezlo,ravencrest,1670,warlock,destruction,96,54,42
24016,Shádóws,nagrand,1669,warlock,destruction,62,36,26
24017,Колодун,gordunni,1669,warlock,destruction,36,20,16
24018,Raverboyy,blackrock,1669,warlock,destruction,36,20,16
24019,Boltzer,archimonde,1668,warlock,destruction,36,23,13
24020,Nybbx,frostmane,1668,warlock,destruction,132,64,68
24021,Yukokotier,archimonde,1667,warlock,destruction,66,38,28
24022,Porchpirate,draenor,1667,warlock,destruction,54,27,27
24023,Idfearthat,ragnaros,1664,warlock,destruction,30,22,8
24024,Shadock,scarshield-legion,1664,warlock,destruction,30,20,10
24025,Rêctûmsêêkêr,ravencrest,1664,warlock,destruction,36,19,17
24026,Dotshok,aegwynn,1664,warlock,destruction,42,22,20
24027,Bono,frostwhisper,1663,warlock,destruction,47,29,18
24028,Aajora,malganis,1662,warlock,destruction,84,53,31
24029,Ghachi,draenor,1662,warlock,destruction,48,23,25
24030,Nherthul,sanguino,1661,warlock,destruction,96,52,44
24031,Беллулар,howling-fjord,1660,warlock,destruction,36,22,14
24032,Limity,nozdormu,1660,warlock,destruction,42,24,18
24033,Fluugew,tarren-mill,1658,warlock,destruction,42,20,22
24034,Chaozvx,kazzak,1655,warlock,destruction,24,18,6
24035,Rustos,ravencrest,1654,warlock,destruction,36,21,15
24036,Magonyth,tarren-mill,1652,warlock,destruction,31,22,9
24037,Ceu,tarren-mill,1651,warlock,destruction,27,19,8
24038,Boltonez,outland,1651,warlock,destruction,54,25,29
24039,Kaspersdame,ravencrest,1650,warlock,destruction,47,24,23
24040,Profesorr,defias-brotherhood,1650,warlock,destruction,42,21,21
24041,Psýcholoc,kazzak,1648,warlock,destruction,38,25,13
24042,Quarimathras,antonidas,1648,warlock,destruction,54,28,26
24043,Ltheory,aegwynn,1647,warlock,destruction,54,32,22
24044,Boltilicious,kazzak,1646,warlock,destruction,36,21,15
24045,Danidelarge,aegwynn,1645,warlock,destruction,58,29,29
24046,Sleethy,destromath,1642,warlock,destruction,36,20,16
24047,Banishedone,stormreaver,1641,warlock,destruction,86,50,36
24048,Shérlock,ravencrest,1640,warlock,destruction,42,22,20
24049,Diablist,kazzak,1638,warlock,destruction,42,23,19
24050,Htaedfo,tarren-mill,1634,warlock,destruction,90,41,49
24051,Bónz,outland,1630,warlock,destruction,30,17,13
24052,Áutísm,silvermoon,1630,warlock,destruction,84,46,38
24053,Kasualdot,stormscale,1629,warlock,destruction,24,17,7
24054,Telodotto,nemesis,1629,warlock,destruction,30,17,13
24055,Порртвейн,howling-fjord,1628,warlock,destruction,29,18,11
24056,Litox,twisting-nether,1627,warlock,destruction,63,32,31
24057,Rakshazza,eredar,1626,warlock,destruction,48,28,20
24058,Dótstuff,draenor,1625,warlock,destruction,30,17,13
24059,Isodjdojk,ravencrest,1624,warlock,destruction,18,17,1
24060,Verson,silvermoon,1624,warlock,destruction,42,21,21
24061,Armellixd,dun-modr,1624,warlock,destruction,42,20,22
24062,Pørtal,aggra-português,1622,warlock,destruction,30,17,13
24063,Essealaes,stormscale,1621,warlock,destruction,35,18,17
24064,Kìmar,amanthul,1620,warlock,destruction,78,42,36
24065,Beåtrìce,archimonde,1620,warlock,destruction,57,28,29
24066,Elyö,dalaran,1620,warlock,destruction,71,28,43
24067,Exitlock,thrall,1619,warlock,destruction,24,17,7
24068,Reeween,argent-dawn,1619,warlock,destruction,30,18,12
24069,Pprwl,tarren-mill,1619,warlock,destruction,72,43,29
24070,Evylock,draenor,1619,warlock,destruction,30,17,13
24071,Marti,blackrock,1617,warlock,destruction,36,22,14
24072,Nerfbolts,archimonde,1615,warlock,destruction,24,17,7
24073,Laciewaifu,silvermoon,1615,warlock,destruction,36,20,16
24074,Biest,drakthul,1615,warlock,destruction,36,17,19
24075,Xuthil,korgall,1614,warlock,destruction,48,25,23
24076,Gogonash,ravencrest,1613,warlock,destruction,42,17,25
24077,Tjl,kazzak,1611,warlock,destruction,35,17,18
24078,Davyjonessx,twisting-nether,1610,warlock,destruction,56,20,36
24079,Meatbot,tarren-mill,1609,warlock,destruction,46,31,15
24080,Lockyswag,draenor,1609,warlock,destruction,66,37,29
24081,Badguldan,blackmoore,1609,warlock,destruction,39,20,19
24082,Ryssäbotti,stormscale,1608,warlock,destruction,31,23,8
24083,Purexlock,dragonblight,1608,warlock,destruction,30,19,11
24084,Esmuel,argent-dawn,1608,warlock,destruction,71,43,28
24085,Ketamol,ravencrest,1607,warlock,destruction,42,24,18
24086,Azthral,nemesis,1607,warlock,destruction,124,64,60
24087,Kognah,defias-brotherhood,1606,warlock,destruction,30,21,9
24088,Zoradiale,twisting-nether,1606,warlock,destruction,36,24,12
24089,Ðîâblô,silvermoon,1606,warlock,destruction,41,22,19
24090,Rotinhell,kazzak,1605,warlock,destruction,64,33,31
24091,Dreamnyâsha,tarren-mill,1603,warlock,destruction,42,19,23
24092,Çamille,ulduar,1602,warlock,destruction,34,20,14
24093,Xtleonidas,uldum,1602,warlock,destruction,78,41,37
24094,Flawzo,blackmoore,1601,warlock,destruction,30,19,11
24095,Skrikipanik,kazzak,1601,warlock,destruction,36,21,15
24096,Despayr,tarren-mill,1601,warlock,destruction,42,19,23
24097,Ignittes,ragnaros,1599,warlock,destruction,30,21,9
24098,Blakstorm,archimonde,1599,warlock,destruction,30,19,11
24099,Kenthal,nemesis,1599,warlock,destruction,57,28,29
24100,Vultzbolt,draenor,1596,warlock,destruction,60,35,25
24101,Napoloen,kazzak,1596,warlock,destruction,36,19,17
24102,Bonemetz,blackmoore,1595,warlock,destruction,41,25,16
24103,Edrahil,lordaeron,1595,warlock,destruction,60,33,27
24104,Malame,hyjal,1593,warlock,destruction,42,22,20
24105,Zarastro,sunstrider,1587,warlock,destruction,45,23,22
24106,Ajgreedyy,grim-batol,1586,warlock,destruction,30,18,12
24107,Réxz,ravencrest,1586,warlock,destruction,72,36,36
24108,Dödkärringx,auchindoun,1585,warlock,destruction,30,19,11
24109,Mallevs,outland,1585,warlock,destruction,36,20,16
24110,Kenachaos,twisting-nether,1585,warlock,destruction,89,47,42
24111,Ðemonsoul,stormscale,1585,warlock,destruction,132,60,72
24112,Bolt,stormscale,1584,warlock,destruction,46,32,14
24113,Isata,ravencrest,1584,warlock,destruction,48,30,18
24114,Dotsyoudown,kelthuzad,1584,warlock,destruction,49,29,20
24115,Kenjix,blackrock,1584,warlock,destruction,48,20,28
24116,Deezbolts,kazzak,1582,warlock,destruction,30,18,12
24117,Døtàndrun,archimonde,1582,warlock,destruction,30,17,13
24118,Neirah,stormscale,1581,warlock,destruction,35,20,15
24119,Plamena,neptulon,1579,warlock,destruction,37,26,11
24120,Watchdots,blackrock,1578,warlock,destruction,36,19,17
24121,Rumour,sunstrider,1578,warlock,destruction,42,18,24
24122,Wewondak,drakthul,1577,warlock,destruction,62,36,26
24123,Ludé,eredar,1577,warlock,destruction,66,32,34
24124,Aloof,outland,1574,warlock,destruction,139,74,65
24125,Ánárchy,stormscale,1572,warlock,destruction,42,22,20
24126,Spoíl,tarren-mill,1571,warlock,destruction,48,27,21
24127,Nøl,sargeras,1571,warlock,destruction,315,158,157
24128,Plâytïmè,stormscale,1570,warlock,destruction,36,18,18
24129,Hongkonger,kazzak,1568,warlock,destruction,150,79,71
24130,Noahh,kazzak,1567,warlock,destruction,101,60,41
24131,Gimlidota,tarren-mill,1565,warlock,destruction,59,35,24
24132,Kerthan,malorne,1563,warlock,destruction,42,29,13
24133,Дэнаа,fordragon,1560,warlock,destruction,59,28,31
24134,Rackare,darksorrow,1556,warlock,destruction,27,19,8
24135,Horsewarlock,stormscale,1556,warlock,destruction,38,19,19
24136,Britneyfears,burning-legion,1556,warlock,destruction,36,18,18
24137,Forcas,archimonde,1551,warlock,destruction,42,25,17
24138,Белвет,blackscar,1550,warlock,destruction,51,25,26
24139,Nijva,silvermoon,1550,warlock,destruction,36,17,19
24140,Abbzey,tarren-mill,1549,warlock,destruction,36,18,18
24141,Jinxme,tarren-mill,1548,warlock,destruction,48,28,20
24142,Dzey,drakthul,1546,warlock,destruction,63,35,28
24143,Trainindummy,ravencrest,1544,warlock,destruction,35,27,8
24144,Chaøs,thrall,1543,warlock,destruction,24,19,5
24145,Xârtôr,blackrock,1540,warlock,destruction,126,73,53
24146,Bazoo,nathrezim,1540,warlock,destruction,48,22,26
24147,Lysanruth,la-croisade-écarlate,1537,warlock,destruction,60,28,32
24148,Skillførçé,kazzak,1536,warlock,destruction,18,16,2
24149,Pipêz,blackmoore,1536,warlock,destruction,71,45,26
24150,Героуд,howling-fjord,1536,warlock,destruction,58,35,23
24151,Spõk,ysondre,1536,warlock,destruction,101,55,46
24152,Rawsauce,outland,1535,warlock,destruction,18,16,2
24153,Senkai,kelthuzad,1535,warlock,destruction,24,16,8
24154,Faermorn,kazzak,1535,warlock,destruction,24,16,8
24155,Quickccast,draenor,1535,warlock,destruction,64,38,26
24156,Dsï,outland,1534,warlock,destruction,30,16,14
24157,Zoh,archimonde,1534,warlock,destruction,51,26,25
24158,Kasuni,sanguino,1534,warlock,destruction,48,19,29
24159,Höfmänn,kazzak,1532,warlock,destruction,49,32,17
24160,Osîrîs,aegwynn,1532,warlock,destruction,30,16,14
24161,Tehkorrum,archimonde,1531,warlock,destruction,30,16,14
24162,Notben,outland,1529,warlock,destruction,18,16,2
24163,Aoea,draenor,1529,warlock,destruction,24,16,8
24164,Felcollíns,ravencrest,1529,warlock,destruction,24,16,8
24165,Varaxxis,twisting-nether,1528,warlock,destruction,30,16,14
24166,Nospamcliqu,ysondre,1527,warlock,destruction,30,16,14
24167,Murdee,kazzak,1526,warlock,destruction,42,16,26
24168,Shaterz,dun-modr,1524,warlock,destruction,18,16,2
24169,Колдунишка,fordragon,1523,warlock,destruction,63,36,27
24170,Garbageclass,outland,1523,warlock,destruction,30,16,14
24171,Sadixxqt,ravencrest,1521,warlock,destruction,24,16,8
24172,Bisacodyl,outland,1521,warlock,destruction,101,53,48
24173,Schøkøbasher,blackrock,1519,warlock,destruction,30,16,14
24174,Veracruza,draenor,1516,warlock,destruction,89,45,44
24175,Coilxo,ravencrest,1515,warlock,destruction,24,16,8
24176,Usianbølts,blackmoore,1513,warlock,destruction,30,16,14
24177,Belastiz,blackmoore,1510,warlock,destruction,24,16,8
24178,Deathscréam,burning-legion,1508,warlock,destruction,78,38,40
24179,Atraped,zuljin,1507,warlock,destruction,84,45,39
24180,Tóuché,aegwynn,1505,warlock,destruction,42,20,22
24181,Sickening,twilights-hammer,1502,warlock,destruction,31,23,8
24182,Импака,howling-fjord,1502,warlock,destruction,64,35,29
24183,Tzeeñtch,tarren-mill,1501,warlock,destruction,65,31,34
24184,Моргоника,howling-fjord,1500,warlock,destruction,48,18,30
24185,Naemys,archimonde,1496,warlock,destruction,27,21,6
24186,Interceptêr,blackrock,1496,warlock,destruction,36,18,18
24187,Warlocat,the-maelstrom,1493,warlock,destruction,72,34,38
24188,Fiveyearque,sylvanas,1489,warlock,destruction,36,16,20
24189,Kamí,sanguino,1487,warlock,destruction,53,24,29
24190,Спаводах,soulflayer,1486,warlock,destruction,23,16,7
24191,Зеленаямразь,soulflayer,1486,warlock,destruction,33,16,17
24192,Сайзэр,soulflayer,1485,warlock,destruction,33,17,16
24193,Juïcylucy,kazzak,1484,warlock,destruction,34,21,13
24194,Jawdrop,blackrock,1483,warlock,destruction,30,16,14
24195,Славеномен,howling-fjord,1480,warlock,destruction,113,56,57
24196,Cørleen,eredar,1480,warlock,destruction,58,22,36
24197,Demonkïng,archimonde,1477,warlock,destruction,54,31,23
24198,Иванфаков,soulflayer,1475,warlock,destruction,29,17,12
24199,Samyoung,kazzak,1470,warlock,destruction,60,35,25
24200,Маларгас,soulflayer,1470,warlock,destruction,60,34,26
24201,Diablotiin,hyjal,1470,warlock,destruction,78,41,37
24202,Kïng,elune,1467,warlock,destruction,54,27,27
24203,Blackiouz,stormscale,1467,warlock,destruction,54,21,33
24204,Noxsix,gorgonnash,1465,warlock,destruction,48,26,22
24205,Holaw,tarren-mill,1464,warlock,destruction,84,41,43
24206,Алхун,razuvious,1463,warlock,destruction,30,17,13
24207,Datendariza,kazzak,1462,warlock,destruction,38,20,18
24208,Chaosprophet,argent-dawn,1459,warlock,destruction,32,18,14
24209,Aleê,twisting-nether,1454,warlock,destruction,47,23,24
24210,Achluophobiå,ravencrest,1451,warlock,destruction,25,16,9
24211,Wicherson,burning-legion,1451,warlock,destruction,37,18,19
24212,Czx,twisting-nether,1447,warlock,destruction,30,18,12
24213,Satanizm,silvermoon,1446,warlock,destruction,36,18,18
24214,Мицуру,howling-fjord,1443,warlock,destruction,30,19,11
24215,Lockybàlboa,tarren-mill,1443,warlock,destruction,36,22,14
24216,Stürmer,thrall,1443,warlock,destruction,42,23,19
24217,Trickyy,azjolnerub,1440,warlock,destruction,30,20,10
24218,Panda,aegwynn,1440,warlock,destruction,24,15,9
24219,Unrealia,hyjal,1440,warlock,destruction,36,19,17
24220,Ignorantduck,sunstrider,1440,warlock,destruction,39,19,20
24221,Fornaio,nemesis,1439,warlock,destruction,24,15,9
24222,Kitchiarû,uldaman,1437,warlock,destruction,24,15,9
24223,Wester,blackmoore,1435,warlock,destruction,30,15,15
24224,Calli,blackrock,1432,warlock,destruction,22,16,6
24225,Dexterr,sylvanas,1432,warlock,destruction,62,36,26
24226,Salazaros,die-silberne-hand,1432,warlock,destruction,42,21,21
24227,Nedivh,stormscale,1432,warlock,destruction,35,17,18
24228,Slëydark,sanguino,1431,warlock,destruction,24,15,9
24229,Manhart,burning-legion,1431,warlock,destruction,24,15,9
24230,Nitmoredots,dun-modr,1427,warlock,destruction,24,15,9
24231,Nerzhull,stormscale,1427,warlock,destruction,115,55,60
24232,Lewdrumpslap,kazzak,1425,warlock,destruction,48,31,17
24233,Shufflous,ghostlands,1424,warlock,destruction,28,16,12
24234,Asmonmald,stormscale,1424,warlock,destruction,70,36,34
24235,Sesoumaru,azshara,1424,warlock,destruction,42,16,26
24236,Dastey,stormscale,1423,warlock,destruction,30,15,15
24237,Thugsupreme,ravencrest,1422,warlock,destruction,36,19,17
24238,Ablas,bladefist,1421,warlock,destruction,118,53,65
24239,Kosfáce,kazzak,1420,warlock,destruction,44,19,25
24240,Dreadnogg,tarren-mill,1416,warlock,destruction,52,26,26
24241,Nekros,archimonde,1415,warlock,destruction,24,17,7
24242,Veoxohr,argent-dawn,1411,warlock,destruction,63,41,22
24243,Frilante,terokkar,1410,warlock,destruction,33,24,9
24244,Kumas,hyjal,1406,warlock,destruction,30,16,14
24245,Zlohell,drakthul,1405,warlock,destruction,48,30,18
24246,Obrusik,burning-legion,1405,warlock,destruction,34,15,19
24247,Sinsemilla,turalyon,1404,warlock,destruction,29,19,10
24248,Peardrax,draenor,1402,warlock,destruction,24,15,9
24249,Voidislife,alakir,1402,warlock,destruction,99,49,50
24250,Гупперлок,howling-fjord,1400,warlock,destruction,48,21,27
24251,Voltadol,dun-modr,1397,warlock,destruction,48,22,26
24252,Грань,ashenvale,1396,warlock,destruction,102,53,49
24253,Faro,trollbane,1396,warlock,destruction,78,32,46
24254,Nàughty,ragnaros,1395,warlock,destruction,36,15,21
24255,Çhãøsførÿã,blackmoore,1392,warlock,destruction,90,43,47
24256,Moelock,frostmane,1391,warlock,destruction,35,17,18
24257,Zivalelia,silvermoon,1389,warlock,destruction,102,49,53
24258,Zeddy,draenor,1377,warlock,destruction,66,36,30
24259,Islazoldyck,draenor,1372,warlock,destruction,42,16,26
24260,Nibblez,shadowsong,1370,warlock,destruction,46,25,21
24261,Qaripidia,ravencrest,1368,warlock,destruction,28,15,13
24262,Fêars,blackrock,1364,warlock,destruction,40,25,15
24263,Vakgu,blackmoore,1362,warlock,destruction,41,25,16
24264,Strikeførce,ravencrest,1361,warlock,destruction,23,15,8
24265,Gricorby,drakthul,1360,warlock,destruction,23,16,7
24266,Сатенекс,soulflayer,1358,warlock,destruction,47,28,19
24267,Запрещаю,galakrond,1353,warlock,destruction,36,19,17
24268,Worgonzolâ,madmortem,1349,warlock,destruction,48,30,18
24269,Wedlock,stormscale,1345,warlock,destruction,42,23,19
24270,Èmøgøðqt,ravencrest,1344,warlock,destruction,24,14,10
24271,Эвилакс,gordunni,1343,warlock,destruction,18,14,4
24272,Sjödin,tarren-mill,1343,warlock,destruction,18,14,4
24273,Isata,blackhand,1343,warlock,destruction,24,14,10
24274,Anthraxus,argent-dawn,1343,warlock,destruction,24,14,10
24275,Setyouinfear,ravencrest,1343,warlock,destruction,30,14,16
24276,Инсинирейтх,gordunni,1342,warlock,destruction,18,14,4
24277,Pommeslock,blackmoore,1341,warlock,destruction,30,15,15
24278,Alphå,blackmoore,1340,warlock,destruction,18,14,4
24279,Tsumde,dalaran,1340,warlock,destruction,38,22,16
24280,Dìablò,sylvanas,1339,warlock,destruction,36,24,12
24281,Likeqtz,thrall,1339,warlock,destruction,24,14,10
24282,Dimmybyrger,stormreaver,1339,warlock,destruction,30,14,16
24283,Shaxlock,draenor,1338,warlock,destruction,46,21,25
24284,Kasztyk,grim-batol,1337,warlock,destruction,18,14,4
24285,Zetsubo,drakthul,1337,warlock,destruction,28,15,13
24286,Кварий,howling-fjord,1337,warlock,destruction,36,14,22
24287,Oloki,kazzak,1336,warlock,destruction,36,23,13
24288,Spectarlock,tarren-mill,1335,warlock,destruction,30,14,16
24289,Anomen,sanguino,1334,warlock,destruction,30,14,16
24290,Brokengodx,dun-modr,1333,warlock,destruction,24,14,10
24291,Nimbin,taerar,1333,warlock,destruction,29,16,13
24292,Ínsidióus,tarren-mill,1329,warlock,destruction,24,14,10
24293,Vegetita,stormscale,1329,warlock,destruction,63,35,28
24294,Äsmødée,dalaran,1328,warlock,destruction,54,31,23
24295,Divvaa,tarren-mill,1328,warlock,destruction,71,35,36
24296,Wilog,silvermoon,1327,warlock,destruction,24,14,10
24297,Üserper,chamber-of-aspects,1319,warlock,destruction,47,18,29
24298,Soulgünter,blackmoore,1317,warlock,destruction,34,23,11
24299,Tuz,blackrock,1316,warlock,destruction,90,40,50
24300,Blackjackk,tarren-mill,1315,warlock,destruction,54,20,34
24301,Mazaear,stormscale,1314,warlock,destruction,28,15,13
24302,Ghostfiend,tarren-mill,1313,warlock,destruction,21,15,6
24303,Vicktorious,stormscale,1312,warlock,destruction,48,23,25
24304,Chram,uldum,1311,warlock,destruction,53,33,20
24305,Chaoxz,outland,1311,warlock,destruction,36,19,17
24306,Ryurans,cthun,1310,warlock,destruction,92,45,47
24307,Unkash,zuljin,1302,warlock,destruction,47,26,21
24308,Lodem,darksorrow,1298,warlock,destruction,36,15,21
24309,Kaedinx,twisting-nether,1297,warlock,destruction,187,91,96
24310,Skruios,anetheron,1290,warlock,destruction,34,16,18
24311,Azrail,anubarak,1290,warlock,destruction,66,31,35
24312,Valcan,ragnaros,1288,warlock,destruction,43,21,22
24313,Sorxez,thrall,1286,warlock,destruction,36,16,20
24314,Rottend,aggra-português,1285,warlock,destruction,65,29,36
24315,Märtas,burning-blade,1283,warlock,destruction,29,14,15
24316,Zxò,twisting-nether,1276,warlock,destruction,22,14,8
24317,Ocaya,kazzak,1275,warlock,destruction,30,16,14
24318,Sovrìn,blackrock,1264,warlock,destruction,20,14,6
24319,Nopower,dun-morogh,1264,warlock,destruction,29,16,13
24320,Tabarnak,archimonde,1264,warlock,destruction,30,14,16
24321,Terris,khaz-modan,1263,warlock,destruction,57,27,30
24322,Pookabee,ravencrest,1263,warlock,destruction,30,14,16
24323,Critchlock,tarren-mill,1259,warlock,destruction,23,14,9
24324,Untactful,tarren-mill,1253,warlock,destruction,53,31,22
24325,Nicolino,doomhammer,1251,warlock,destruction,30,20,10
24326,Pensiblesie,runetotem,1251,warlock,destruction,132,62,70
24327,Anderxyo,sanguino,1248,warlock,destruction,18,13,5
24328,Twork,tarren-mill,1248,warlock,destruction,24,13,11
24329,Mudwalkin,ravencrest,1248,warlock,destruction,24,13,11
24330,Nyiks,blackhand,1247,warlock,destruction,24,13,11
24331,Xxjz,ravencrest,1247,warlock,destruction,24,13,11
24332,Slavecry,silvermoon,1246,warlock,destruction,18,13,5
24333,Artys,tarren-mill,1246,warlock,destruction,18,13,5
24334,Kwoh,saurfang,1246,warlock,destruction,24,13,11
24335,Todesgurke,alleria,1245,warlock,destruction,24,13,11
24336,Slf,the-maelstrom,1245,warlock,destruction,30,13,17
24337,Jisera,kiljaeden,1245,warlock,destruction,30,13,17
24338,Withered,nagrand,1244,warlock,destruction,18,13,5
24339,Krachol,emeriss,1244,warlock,destruction,24,13,11
24340,Alxor,archimonde,1243,warlock,destruction,24,13,11
24341,Demoz,sanguino,1243,warlock,destruction,52,27,25
24342,Berkobaggins,ravencrest,1242,warlock,destruction,24,13,11
24343,Salouppio,archimonde,1242,warlock,destruction,30,13,17
24344,Zeinth,sanguino,1241,warlock,destruction,18,13,5
24345,Shugglock,draenor,1241,warlock,destruction,24,13,11
24346,Shutupkid,ravencrest,1240,warlock,destruction,24,13,11
24347,Чиназис,gordunni,1240,warlock,destruction,78,36,42
24348,Nerfmebro,tarren-mill,1239,warlock,destruction,18,13,5
24349,Unstablemind,nemesis,1238,warlock,destruction,27,14,13
24350,Кулутха,soulflayer,1237,warlock,destruction,18,13,5
24351,Baz,frostmane,1237,warlock,destruction,18,13,5
24352,Päwzy,kazzak,1237,warlock,destruction,24,13,11
24353,Scrim,laughing-skull,1236,warlock,destruction,20,14,6
24354,Sirmic,hyjal,1235,warlock,destruction,30,13,17
24355,Zollon,norgannon,1230,warlock,destruction,18,13,5
24356,Инсип,blackscar,1230,warlock,destruction,24,14,10
24357,Nerokin,blackrock,1226,warlock,destruction,30,22,8
24358,Jobbymancer,twisting-nether,1225,warlock,destruction,30,18,12
24359,Onetwobolt,archimonde,1222,warlock,destruction,30,13,17
24360,Гулдас,thermaplugg,1221,warlock,destruction,42,21,21
24361,Chickoz,eredar,1219,warlock,destruction,97,51,46
24362,Babayagâ,sanguino,1218,warlock,destruction,24,14,10
24363,Lokajci,outland,1217,warlock,destruction,25,15,10
24364,Westfaliu,blackhand,1217,warlock,destruction,66,24,42
24365,Карьерщица,booty-bay,1215,warlock,destruction,36,18,18
24366,Guntok,tarren-mill,1211,warlock,destruction,37,22,15
24367,Symbiosis,kazzak,1207,warlock,destruction,24,13,11
24368,Felbunni,silvermoon,1205,warlock,destruction,49,21,28
24369,Rizzbolt,ravencrest,1195,warlock,destruction,47,21,26
24370,Hejhana,drakthul,1193,warlock,destruction,48,17,31
24371,Emoriy,blackmoore,1190,warlock,destruction,64,34,30
24372,Ayóó,doomhammer,1187,warlock,destruction,65,36,29
24373,Neetlock,suramar,1185,warlock,destruction,30,14,16
24374,Sylrathas,burning-legion,1184,warlock,destruction,58,30,28
24375,Fromfuneral,anetheron,1180,warlock,destruction,65,42,23
24376,Kaeos,ravencrest,1176,warlock,destruction,24,15,9
24377,Lokko,nemesis,1173,warlock,destruction,24,14,10
24378,Lovrog,twisting-nether,1169,warlock,destruction,21,13,8
24379,Thorenss,medivh,1164,warlock,destruction,36,15,21
24380,Vulgrim,kirin-tor,1162,warlock,destruction,33,15,18
24381,Artyrus,burning-legion,1158,warlock,destruction,60,30,30
24382,Rmpfarmer,kazzak,1152,warlock,destruction,18,12,6
24383,Soundmagic,silvermoon,1152,warlock,destruction,18,12,6
24384,Ниезвестнно,soulflayer,1152,warlock,destruction,24,12,12
24385,Ekàti,ravencrest,1152,warlock,destruction,24,12,12
24386,Teiser,nemesis,1152,warlock,destruction,24,12,12
24387,Консидёро,gordunni,1152,warlock,destruction,30,12,18
24388,Leman,sylvanas,1151,warlock,destruction,18,12,6
24389,Marador,drakthul,1151,warlock,destruction,18,12,6
24390,Debz,twisting-nether,1151,warlock,destruction,19,12,7
24391,Mohihi,ravencrest,1151,warlock,destruction,24,12,12
24392,Хастла,ashenvale,1151,warlock,destruction,24,12,12
24393,Elldialock,draenor,1151,warlock,destruction,24,12,12
24394,Kikaikek,stormscale,1150,warlock,destruction,18,12,6
24395,Hannahowo,garona,1150,warlock,destruction,18,12,6
24396,Estefanía,tarren-mill,1150,warlock,destruction,18,12,6
24397,Boglock,argent-dawn,1150,warlock,destruction,18,12,6
24398,Gjallarbrù,archimonde,1150,warlock,destruction,18,12,6
24399,Kyliân,blackmoore,1150,warlock,destruction,24,12,12
24400,Scadar,kazzak,1149,warlock,destruction,18,12,6
24401,Autocannon,stormscale,1149,warlock,destruction,24,12,12
24402,Maikus,stormscale,1148,warlock,destruction,18,12,6
24403,Kritcheq,alakir,1147,warlock,destruction,72,35,37
24404,Nebulus,lightnings-blade,1146,warlock,destruction,18,12,6
24405,Егосяхаос,soulflayer,1144,warlock,destruction,24,12,12
24406,Jinxzed,frostwhisper,1143,warlock,destruction,18,12,6
24407,Hipiwl,silvermoon,1142,warlock,destruction,24,12,12
24408,Nosoulnoprob,sylvanas,1142,warlock,destruction,24,12,12
24409,Lobotomic,argent-dawn,1140,warlock,destruction,18,12,6
24410,Sylvxgodx,kazzak,1137,warlock,destruction,18,12,6
24411,Gengada,blackhand,1134,warlock,destruction,24,12,12
24412,Niszoght,dun-modr,1132,warlock,destruction,35,24,11
24413,Kospar,dun-morogh,1132,warlock,destruction,24,12,12
24414,Блэкмайндер,howling-fjord,1131,warlock,destruction,18,12,6
24415,Toffifae,argent-dawn,1129,warlock,destruction,18,12,6
24416,Drillingsdad,dun-morogh,1126,warlock,destruction,24,12,12
24417,Riitaall,khaz-modan,1125,warlock,destruction,49,18,31
24418,Fiddlock,draenor,1117,warlock,destruction,22,13,9
24419,Нгага,howling-fjord,1111,warlock,destruction,23,12,11
24420,Ruul,sanguino,1109,warlock,destruction,44,18,26
24421,Insanely,kazzak,1091,warlock,destruction,57,30,27
24422,Kartanos,stormscale,1086,warlock,destruction,17,12,5
24423,Razek,eredar,1086,warlock,destruction,23,12,11
24424,Atruruz,antonidas,1084,warlock,destruction,59,29,30
24425,Maxxilla,twisting-nether,1081,warlock,destruction,113,50,63
24426,Mizxxta,zuljin,1071,warlock,destruction,17,12,5
24427,Troyana,chants-éternels,1067,warlock,destruction,26,19,7
24428,Nëismz,azuremyst,1056,warlock,destruction,12,11,1
24429,Exephia,laughing-skull,1056,warlock,destruction,12,11,1
24430,Rabasta,blackmoore,1056,warlock,destruction,12,11,1
24431,Envizer,ravencrest,1056,warlock,destruction,18,11,7
24432,Zâyo,ravencrest,1056,warlock,destruction,18,11,7
24433,Avenueat,kazzak,1056,warlock,destruction,18,11,7
24434,Secretx,kazzak,1056,warlock,destruction,18,11,7
24435,Sterlock,sylvanas,1056,warlock,destruction,18,11,7
24436,Kalwyn,stormscale,1056,warlock,destruction,18,11,7
24437,Кремация,blackscar,1056,warlock,destruction,18,11,7
24438,Fjutta,outland,1056,warlock,destruction,18,11,7
24439,Calypso,korgall,1056,warlock,destruction,18,11,7
24440,Zila,sylvanas,1056,warlock,destruction,24,11,13
24441,Raknoxyeyeye,blackrock,1055,warlock,destruction,18,11,7
24442,Óop,outland,1055,warlock,destruction,18,11,7
24443,Imforcedtowl,aegwynn,1055,warlock,destruction,18,11,7
24444,Fulcanelli,sargeras,1055,warlock,destruction,18,11,7
24445,Borrìs,blackhand,1055,warlock,destruction,106,50,56
24446,Omegazero,zuluhed,1055,warlock,destruction,24,11,13
24447,Xiraq,nathrezim,1055,warlock,destruction,24,11,13
24448,Shena,chogall,1055,warlock,destruction,24,11,13
24449,Helldoom,drakthul,1055,warlock,destruction,30,11,19
24450,Jørdanna,blackrock,1054,warlock,destruction,18,11,7
24451,Hydrôlîc,blackrock,1054,warlock,destruction,24,11,13
24452,Коилсестры,blackscar,1053,warlock,destruction,21,12,9
24453,Vimb,archimonde,1053,warlock,destruction,24,11,13
24454,Koffey,twisting-nether,1052,warlock,destruction,18,11,7
24455,Бирел,soulflayer,1051,warlock,destruction,18,11,7
24456,Katâra,tarren-mill,1051,warlock,destruction,30,11,19
24457,Peterpaîn,blackmoore,1050,warlock,destruction,22,14,8
24458,Yoplen,drakthul,1050,warlock,destruction,18,11,7
24459,Whine,uldum,1050,warlock,destruction,54,24,30
24460,Gåylørd,ravencrest,1050,warlock,destruction,30,11,19
24461,Скул,soulflayer,1049,warlock,destruction,24,11,13
24462,Waandi,ravencrest,1047,warlock,destruction,18,11,7
24463,Yénnéfér,ravencrest,1046,warlock,destruction,33,11,22
24464,Äbsalom,hyjal,1045,warlock,destruction,50,30,20
24465,Orisess,bronze-dragonflight,1044,warlock,destruction,36,20,16
24466,Somanydots,twisting-nether,1039,warlock,destruction,24,11,13
24467,Buserella,eredar,1036,warlock,destruction,24,11,13
24468,Demonoulis,bloodhoof,1026,warlock,destruction,18,11,7
24469,Naniika,blackmoore,1025,warlock,destruction,24,17,7
24470,Salastro,ragnaros,1022,warlock,destruction,17,11,6
24471,Cráxx,onyxia,1014,warlock,destruction,26,12,14
24472,Whitebanshee,turalyon,1012,warlock,destruction,24,13,11
24473,Sublînê,blackmoore,1007,warlock,destruction,24,11,13
24474,Jaqqy,blackmoore,1005,warlock,destruction,18,12,6
24475,Diseased,darksorrow,1005,warlock,destruction,26,14,12
24476,Babayagaa,drakthul,1002,warlock,destruction,26,11,15
24477,Iltharian,die-todeskrallen,1000,warlock,destruction,17,11,6
24478,Daubi,ravencrest,991,warlock,destruction,18,12,6
24479,Loveløck,blackrock,991,warlock,destruction,23,11,12
24480,Yudy,burning-legion,987,warlock,destruction,20,11,9
24481,Lynchéd,argent-dawn,986,warlock,destruction,17,11,6
24482,Dubbzy,outland,973,warlock,destruction,26,11,15
24483,Eisenkiefer,thrall,961,warlock,destruction,65,22,43
24484,Ðêmøñîc,ravencrest,960,warlock,destruction,12,10,2
24485,Nerfmeplz,archimonde,960,warlock,destruction,12,10,2
24486,Muleerox,kazzak,960,warlock,destruction,12,10,2
24487,Аймох,gordunni,960,warlock,destruction,12,10,2
24488,Harefrøken,ravencrest,960,warlock,destruction,12,10,2
24489,Slomg,sylvanas,960,warlock,destruction,12,10,2
24490,Graystache,blackhand,960,warlock,destruction,12,10,2
24491,Ñia,ravencrest,960,warlock,destruction,12,10,2
24492,Fyxs,talnivarr,960,warlock,destruction,12,10,2
24493,Hopéléss,aggra-português,960,warlock,destruction,12,10,2
24494,Korialstraz,sylvanas,960,warlock,destruction,12,10,2
24495,Gishor,burning-legion,960,warlock,destruction,12,10,2
24496,Jazggzkxx,twisting-nether,960,warlock,destruction,12,10,2
24497,Brokenearman,defias-brotherhood,960,warlock,destruction,12,10,2
24498,Шедон,soulflayer,960,warlock,destruction,12,10,2
24499,Бауглирх,howling-fjord,960,warlock,destruction,12,10,2
24500,Destrolockz,tarren-mill,960,warlock,destruction,16,11,5
24501,Tbs,blackhand,960,warlock,destruction,18,10,8
24502,Mafteryo,blackrock,960,warlock,destruction,18,10,8
24503,Balding,blackhand,960,warlock,destruction,18,10,8
24504,Anniefuchsia,ravencrest,960,warlock,destruction,18,10,8
24505,Gödisdëäd,sanguino,960,warlock,destruction,18,10,8
24506,Eviil,tarren-mill,960,warlock,destruction,18,10,8
24507,Adoxilock,twisting-nether,960,warlock,destruction,18,10,8
24508,Lìmè,silvermoon,960,warlock,destruction,18,10,8
24509,Ashlÿn,draenor,960,warlock,destruction,18,10,8
24510,Trickytée,tarren-mill,960,warlock,destruction,18,10,8
24511,Dalyvan,blackrock,960,warlock,destruction,18,10,8
24512,Mirenli,kazzak,960,warlock,destruction,18,10,8
24513,Kyiüû,archimonde,960,warlock,destruction,22,12,10
24514,Cursecannon,outland,959,warlock,destruction,12,10,2
24515,Zízýéró,sylvanas,959,warlock,destruction,12,10,2
24516,Boterham,kilrogg,959,warlock,destruction,12,10,2
24517,Kekbólt,twisting-nether,959,warlock,destruction,18,10,8
24518,Иренхх,gordunni,959,warlock,destruction,18,10,8
24519,Favorizlmp,archimonde,959,warlock,destruction,18,10,8
24520,Wlistoohard,stormscale,959,warlock,destruction,24,10,14
24521,Proßlock,kazzak,959,warlock,destruction,24,10,14
24522,Adipure,blackrock,959,warlock,destruction,24,10,14
24523,Sluba,stormscale,959,warlock,destruction,24,10,14
24524,Slâyâ,blackrock,958,warlock,destruction,12,10,2
24525,Annihilatîon,aegwynn,958,warlock,destruction,18,10,8
24526,Чернокнжник,soulflayer,958,warlock,destruction,18,10,8
24527,Ragequit,xavius,958,warlock,destruction,18,10,8
24528,Адво,howling-fjord,958,warlock,destruction,18,10,8
24529,Belnea,draenor,958,warlock,destruction,18,10,8
24530,Thebigsuck,tarren-mill,958,warlock,destruction,18,10,8
24531,Kenybalajze,the-maelstrom,958,warlock,destruction,18,10,8
24532,Osyx,ravencrest,958,warlock,destruction,22,12,10
24533,Blackmagic,stormscale,957,warlock,destruction,18,10,8
24534,Schmexer,blutkessel,957,warlock,destruction,18,10,8
24535,Baloc,kirin-tor,957,warlock,destruction,18,10,8
24536,Saloninus,argent-dawn,957,warlock,destruction,24,10,14
24537,Parley,frostmane,956,warlock,destruction,24,10,14
24538,Absurdd,turalyon,955,warlock,destruction,16,11,5
24539,Vâgg,blackmoore,955,warlock,destruction,24,10,14
24540,Thranerm,ravencrest,955,warlock,destruction,24,10,14
24541,Realshady,kazzak,954,warlock,destruction,18,10,8
24542,Арцах,soulflayer,954,warlock,destruction,24,10,14
24543,Grôteskûs,tarren-mill,953,warlock,destruction,18,10,8
24544,Gerart,tarren-mill,953,warlock,destruction,18,10,8
24545,Millhaus,gorgonnash,952,warlock,destruction,18,10,8
24546,Drfóx,draenor,952,warlock,destruction,24,10,14
24547,Gehirnwäsche,frostwolf,951,warlock,destruction,16,11,5
24548,Aftxrlife,arathor,951,warlock,destruction,16,11,5
24549,Paranoid,sylvanas,951,warlock,destruction,18,10,8
24550,Kääk,sylvanas,947,warlock,destruction,18,10,8
24551,Крутизол,fordragon,944,warlock,destruction,25,11,14
24552,Бигтедок,gordunni,944,warlock,destruction,69,30,39
24553,Бомбшелл,soulflayer,942,warlock,destruction,20,11,9
24554,Äzarel,khaz-modan,933,warlock,destruction,12,10,2
24555,Mýlìfêbélike,kazzak,927,warlock,destruction,14,11,3
24556,Racursed,outland,927,warlock,destruction,16,10,6
24557,Demowlition,archimonde,908,warlock,destruction,24,10,14
24558,Debbskidjur,tarren-mill,896,warlock,destruction,16,10,6
24559,Fandirxd,draenor,894,warlock,destruction,17,10,7
24560,Bèkshà,blackrock,894,warlock,destruction,20,10,10
24561,Chàsx,archimonde,864,warlock,destruction,12,9,3
24562,Brødo,dun-modr,864,warlock,destruction,12,9,3
24563,Soulboltx,ragnaros,864,warlock,destruction,12,9,3
24564,Øßey,magtheridon,864,warlock,destruction,12,9,3
24565,Reizouka,twisting-nether,864,warlock,destruction,12,9,3
24566,Peon,blackrock,864,warlock,destruction,12,9,3
24567,Howtofake,doomhammer,864,warlock,destruction,12,9,3
24568,Надсх,soulflayer,864,warlock,destruction,12,9,3
24569,Boltmaster,burning-legion,864,warlock,destruction,12,9,3
24570,Märkähuikka,stormreaver,864,warlock,destruction,12,9,3
24571,Vamanos,stormscale,864,warlock,destruction,12,9,3
24572,Веномхх,lich-king,864,warlock,destruction,12,9,3
24573,Raxan,stormscale,864,warlock,destruction,15,10,5
24574,Zikozor,ravencrest,864,warlock,destruction,16,10,6
24575,Potatowl,ragnaros,864,warlock,destruction,18,9,9
24576,Чернокок,blackscar,864,warlock,destruction,18,9,9
24577,Nògg,kazzak,864,warlock,destruction,18,9,9
24578,Doomwrath,tarren-mill,864,warlock,destruction,18,9,9
24579,Stopdaddyplz,ravencrest,864,warlock,destruction,18,9,9
24580,Köftemec,blackrock,864,warlock,destruction,18,9,9
24581,Gis,laughing-skull,864,warlock,destruction,18,9,9
24582,Reznör,archimonde,864,warlock,destruction,18,9,9
24583,Силорий,howling-fjord,864,warlock,destruction,18,9,9
24584,Фейкгодх,soulflayer,864,warlock,destruction,24,9,15
24585,Mxdojsrvqxzq,ravencrest,864,warlock,destruction,24,9,15
24586,Mooncrushed,stormscale,863,warlock,destruction,12,9,3
24587,Covariance,nemesis,863,warlock,destruction,12,9,3
24588,Zelyx,archimonde,863,warlock,destruction,12,9,3
24589,Robertóoo,burning-legion,863,warlock,destruction,12,9,3
24590,Narzok,kazzak,863,warlock,destruction,12,9,3
24591,Elerodril,ysondre,863,warlock,destruction,12,9,3
24592,Skrabblel,tarren-mill,863,warlock,destruction,18,9,9
24593,Burningdemon,kazzak,863,warlock,destruction,18,9,9
24594,Andrealphus,outland,863,warlock,destruction,18,9,9
24595,Гвоздяшка,blackscar,863,warlock,destruction,18,9,9
24596,Brútality,nethersturm,863,warlock,destruction,36,9,27
24597,Miltuast,blackrock,862,warlock,destruction,12,9,3
24598,Lokibra,antonidas,862,warlock,destruction,12,9,3
24599,Bíggun,outland,862,warlock,destruction,12,9,3
24600,Банкапевка,howling-fjord,862,warlock,destruction,18,9,9
24601,Гринлайм,howling-fjord,861,warlock,destruction,12,9,3
24602,Делегент,deathguard,861,warlock,destruction,24,9,15
24603,Xhartus,argent-dawn,860,warlock,destruction,18,9,9
24604,Oldemoilépti,hyjal,859,warlock,destruction,18,9,9
24605,Soultwist,twisting-nether,858,warlock,destruction,24,9,15
24606,Galath,wrathbringer,857,warlock,destruction,22,10,12
24607,Synnox,blackrock,844,warlock,destruction,18,9,9
24608,Архидрако,gordunni,832,warlock,destruction,24,9,15
24609,Avogeiñ,tarren-mill,831,warlock,destruction,17,9,8
24610,Tid,burning-legion,830,warlock,destruction,17,9,8
24611,Flocca,archimonde,830,warlock,destruction,17,9,8
24612,Indynamo,blackrock,815,warlock,destruction,17,9,8
24613,Shakuroz,frostwolf,815,warlock,destruction,27,10,17
24614,Krestox,blackmoore,814,warlock,destruction,23,9,14
24615,Merloc,magtheridon,801,warlock,destruction,20,10,10
24616,Makaspam,stormscale,799,warlock,destruction,22,9,13
24617,Willthehoe,alonsus,798,warlock,destruction,17,9,8
24618,Konradcurz,silvermoon,768,warlock,destruction,12,8,4
24619,Maxlox,tarren-mill,768,warlock,destruction,12,8,4
24620,Overbuffed,wildhammer,768,warlock,destruction,12,8,4
24621,Квейдсан,howling-fjord,768,warlock,destruction,12,8,4
24622,Fearu,kazzak,768,warlock,destruction,12,8,4
24623,Whitebøy,hyjal,768,warlock,destruction,12,8,4
24624,Imissbfa,stormscale,768,warlock,destruction,12,8,4
24625,Cigänä,archimonde,768,warlock,destruction,12,8,4
24626,Nodavé,stormscale,768,warlock,destruction,12,8,4
24627,Fsandtwo,ravencrest,768,warlock,destruction,12,8,4
24628,Nephystø,archimonde,768,warlock,destruction,12,8,4
24629,Linuviel,argent-dawn,768,warlock,destruction,12,8,4
24630,Korbendallas,anubarak,768,warlock,destruction,12,8,4
24631,Freshademic,tarren-mill,768,warlock,destruction,12,8,4
24632,Zilalol,sylvanas,768,warlock,destruction,12,8,4
24633,Coeurnichon,archimonde,768,warlock,destruction,12,8,4
24634,Imbalockzwei,aegwynn,768,warlock,destruction,12,8,4
24635,Nunomendes,archimonde,768,warlock,destruction,12,8,4
24636,Dmonlock,hyjal,768,warlock,destruction,12,8,4
24637,Firecast,kazzak,768,warlock,destruction,12,8,4
24638,Kaeb,archimonde,768,warlock,destruction,12,8,4
24639,Boccebelle,pozzo-delleternità,768,warlock,destruction,12,8,4
24640,Fiddyp,kazzak,768,warlock,destruction,12,8,4
24641,Fearbeachx,ravencrest,768,warlock,destruction,12,8,4
24642,Wìtçhßlåðes,ysondre,768,warlock,destruction,12,8,4
24643,Sizexl,silvermoon,768,warlock,destruction,12,8,4
24644,Høliax,archimonde,768,warlock,destruction,12,8,4
24645,Dejin,tarren-mill,768,warlock,destruction,12,8,4
24646,Garimberas,silvermoon,768,warlock,destruction,18,8,10
24647,Flatulenzus,blackrock,768,warlock,destruction,18,8,10
24648,Zelieknight,ysondre,768,warlock,destruction,18,8,10
24649,Deadlyrust,ragnaros,768,warlock,destruction,18,8,10
24650,Odenbest,silvermoon,768,warlock,destruction,18,8,10
24651,Horststenzl,blackrock,768,warlock,destruction,18,8,10
24652,Hexdoctor,ravencrest,768,warlock,destruction,24,8,16
24653,Nili,dethecus,767,warlock,destruction,12,8,4
24654,Eotlid,shattered-hand,767,warlock,destruction,12,8,4
24655,Enydible,frostmane,767,warlock,destruction,12,8,4
24656,Wurdulock,silvermoon,767,warlock,destruction,12,8,4
24657,Shadowburst,outland,767,warlock,destruction,12,8,4
24658,Lorelèi,silvermoon,767,warlock,destruction,12,8,4
24659,Ammathrel,moonglade,767,warlock,destruction,12,8,4
24660,Darcîa,destromath,767,warlock,destruction,12,8,4
24661,Jaimê,thrall,767,warlock,destruction,12,8,4
24662,Fearster,twisting-nether,767,warlock,destruction,12,8,4
24663,Nerfwarriors,stormscale,767,warlock,destruction,18,8,10
24664,Talriun,kazzak,767,warlock,destruction,20,8,12
24665,Lockedaway,ravencrest,766,warlock,destruction,12,8,4
24666,Antoniolm,cthun,766,warlock,destruction,16,9,7
24667,Mavelya,blackmoore,766,warlock,destruction,24,8,16
24668,Thicklock,twisting-nether,765,warlock,destruction,12,8,4
24669,Sidragasoss,drakthul,765,warlock,destruction,18,8,10
24670,Shutdown,sylvanas,756,warlock,destruction,18,8,10
24671,Lémonz,stormscale,751,warlock,destruction,17,8,9
24672,Shaodul,stormscale,735,warlock,destruction,17,8,9
24673,Хиёрис,eversong,731,warlock,destruction,18,9,9
24674,Warlocklordx,ravencrest,713,warlock,destruction,22,9,13
24675,Amyw,magtheridon,712,warlock,destruction,20,9,11
24676,Джастсак,gordunni,703,warlock,destruction,11,8,3
24677,Kycknosa,archimonde,703,warlock,destruction,20,8,12
24678,Shadowrey,blackrock,702,warlock,destruction,16,8,8
24679,Börsenborisq,aegwynn,687,warlock,destruction,11,8,3
24680,Limecqt,dun-morogh,672,warlock,destruction,12,7,5
24681,Scud,frostwolf,672,warlock,destruction,12,7,5
24682,Незерлок,soulflayer,672,warlock,destruction,12,7,5
24683,Pelkopeelo,tarren-mill,672,warlock,destruction,12,7,5
24684,Veríty,kazzak,672,warlock,destruction,12,7,5
24685,Анкхзул,howling-fjord,672,warlock,destruction,12,7,5
24686,Lúcìfér,stormscale,672,warlock,destruction,12,7,5
24687,Trîppîn,blackrock,672,warlock,destruction,12,7,5
24688,Брузир,gordunni,672,warlock,destruction,12,7,5
24689,Veridy,kazzak,672,warlock,destruction,12,7,5
24690,Çüñ,shattered-hand,672,warlock,destruction,12,7,5
24691,Bladey,ragnaros,672,warlock,destruction,12,7,5
24692,Mowxll,blackrock,672,warlock,destruction,12,7,5
24693,Lottopallo,arathor,672,warlock,destruction,12,7,5
24694,Vilenia,doomhammer,672,warlock,destruction,12,7,5
24695,Pöhz,archimonde,672,warlock,destruction,12,7,5
24696,Filippö,eredar,672,warlock,destruction,12,7,5
24697,Holiax,archimonde,672,warlock,destruction,12,7,5
24698,Fellord,chants-éternels,672,warlock,destruction,12,7,5
24699,Necrobtch,quelthalas,672,warlock,destruction,12,7,5
24700,Матрикспз,soulflayer,672,warlock,destruction,12,7,5
24701,Otemlock,sanguino,672,warlock,destruction,12,7,5
24702,Midnigthh,sanguino,672,warlock,destruction,12,7,5
24703,Hell,twisting-nether,672,warlock,destruction,12,7,5
24704,Fraky,frostwhisper,672,warlock,destruction,12,7,5
24705,Vileclass,ravencrest,672,warlock,destruction,12,7,5
24706,Исверон,howling-fjord,672,warlock,destruction,12,7,5
24707,Артисона,gordunni,672,warlock,destruction,12,7,5
24708,Мэрджис,soulflayer,672,warlock,destruction,12,7,5
24709,Inflicts,frostmane,672,warlock,destruction,12,7,5
24710,Altffeer,blackmoore,672,warlock,destruction,12,7,5
24711,Snackstickz,twisting-nether,672,warlock,destruction,12,7,5
24712,Chapo,alleria,672,warlock,destruction,12,7,5
24713,Denasty,nemesis,672,warlock,destruction,12,7,5
24714,Mempricious,ravencrest,672,warlock,destruction,12,7,5
24715,Cigarrette,draenor,672,warlock,destruction,12,7,5
24716,Andrewdaniel,twisting-nether,672,warlock,destruction,18,7,11
24717,Milfhaunter,aegwynn,672,warlock,destruction,18,7,11
24718,Fatbëlly,argent-dawn,672,warlock,destruction,18,7,11
24719,Hædês,antonidas,672,warlock,destruction,18,7,11
24720,Topmodelx,eredar,672,warlock,destruction,18,7,11
24721,Belakh,draenor,672,warlock,destruction,18,7,11
24722,Ðôtgøðx,ravencrest,672,warlock,destruction,18,7,11
24723,Vulluin,blackrock,672,warlock,destruction,18,7,11
24724,Chromagnus,drakthul,672,warlock,destruction,18,7,11
24725,Britnèyfears,twisting-nether,672,warlock,destruction,18,7,11
24726,Marripa,sanguino,672,warlock,destruction,24,7,17
24727,Fauxshow,ravencrest,671,warlock,destruction,12,7,5
24728,Evaksiá,draenor,671,warlock,destruction,12,7,5
24729,Cømps,blackrock,671,warlock,destruction,12,7,5
24730,Galardodric,outland,671,warlock,destruction,12,7,5
24731,Saadq,draenor,671,warlock,destruction,12,7,5
24732,Afflicted,trollbane,671,warlock,destruction,12,7,5
24733,Panicbolt,ravencrest,671,warlock,destruction,12,7,5
24734,Proflock,drakthul,671,warlock,destruction,12,7,5
24735,Postymalony,kazzak,671,warlock,destruction,12,7,5
24736,Zillinzy,frostmane,671,warlock,destruction,12,7,5
24737,Baladas,nemesis,671,warlock,destruction,12,7,5
24738,Margincalled,kazzak,671,warlock,destruction,18,7,11
24739,Enragelock,tarren-mill,671,warlock,destruction,18,7,11
24740,Vengidotcom,outland,671,warlock,destruction,18,7,11
24741,Gillgarres,twisting-nether,671,warlock,destruction,18,7,11
24742,Natsume,ragnaros,671,warlock,destruction,18,7,11
24743,Qloss,burning-legion,670,warlock,destruction,12,7,5
24744,Valkiá,earthen-ring,670,warlock,destruction,12,7,5
24745,Нафлэпил,gordunni,670,warlock,destruction,12,7,5
24746,Mortori,tarren-mill,668,warlock,destruction,12,7,5
24747,Gâlvâtorix,frostmourne,668,warlock,destruction,18,7,11
24748,Vladlevad,argent-dawn,667,warlock,destruction,12,7,5
24749,Johntrabolta,chogall,667,warlock,destruction,12,7,5
24750,Ахпорбес,gordunni,661,warlock,destruction,12,7,5
24751,Corbiejr,tarren-mill,660,warlock,destruction,18,7,11
24752,Ternisia,draenor,655,warlock,destruction,14,8,6
24753,Dobonard,sylvanas,639,warlock,destruction,16,7,9
24754,Гангстахохо,soulflayer,622,warlock,destruction,16,7,9
24755,Tydra,die-aldor,618,warlock,destruction,20,8,12
24756,Bryanz,sanguino,608,warlock,destruction,10,7,3
24757,Érunali,archimonde,607,warlock,destruction,11,7,4
24758,Askanios,twisting-nether,590,warlock,destruction,7,7,0
24759,Popecandy,archimonde,576,warlock,destruction,6,6,0
24760,Peacedust,grim-batol,576,warlock,destruction,6,6,0
24761,Cafardcancer,archimonde,576,warlock,destruction,6,6,0
24762,Whøknøws,twisting-nether,576,warlock,destruction,6,6,0
24763,Ceryss,argent-dawn,576,warlock,destruction,6,6,0
24764,Voukserys,tarren-mill,576,warlock,destruction,6,6,0
24765,Sinofbum,stormscale,576,warlock,destruction,6,6,0
24766,Solosuperr,ravencrest,576,warlock,destruction,6,6,0
24767,Skuvee,archimonde,576,warlock,destruction,6,6,0
24768,Malddog,turalyon,576,warlock,destruction,6,6,0
24769,Morathy,drekthar,576,warlock,destruction,6,6,0
24770,Catchlock,tarren-mill,576,warlock,destruction,6,6,0
24771,Whaii,ravencrest,576,warlock,destruction,6,6,0
24772,Jupp,blackrock,576,warlock,destruction,6,6,0
24773,Sulnar,burning-legion,576,warlock,destruction,6,6,0
24774,Phobilock,guldan,576,warlock,destruction,6,6,0
24775,Klaier,dun-modr,576,warlock,destruction,9,7,2
24776,Sharhý,kazzak,576,warlock,destruction,10,7,3
24777,Akumako,stormscale,576,warlock,destruction,12,6,6
24778,Ilikebolts,blackmoore,576,warlock,destruction,12,6,6
24779,Súícìdèbøy,colinas-pardas,576,warlock,destruction,12,6,6
24780,ßenäfflock,ragnaros,576,warlock,destruction,12,6,6
24781,Enaio,mannoroth,576,warlock,destruction,12,6,6
24782,Incesticide,ragnaros,576,warlock,destruction,12,6,6
24783,Ðåñtåy,ravencrest,576,warlock,destruction,12,6,6
24784,Hepheisto,blackmoore,576,warlock,destruction,12,6,6
24785,Keibo,drakthul,576,warlock,destruction,12,6,6
24786,Эннинотбэд,howling-fjord,576,warlock,destruction,12,6,6
24787,Drainforlife,blackrock,576,warlock,destruction,12,6,6
24788,Dotg,blackrock,576,warlock,destruction,12,6,6
24789,Dèv,draenor,576,warlock,destruction,12,6,6
24790,Mocfernando,ravencrest,576,warlock,destruction,12,6,6
24791,Kukkojapallo,ravencrest,576,warlock,destruction,12,6,6
24792,Ezdotggwp,stormscale,576,warlock,destruction,12,6,6
24793,Mayden,uldum,576,warlock,destruction,12,6,6
24794,Diabolics,twisting-nether,576,warlock,destruction,12,6,6
24795,Gatewatcher,argent-dawn,576,warlock,destruction,12,6,6
24796,Kalagorn,azshara,576,warlock,destruction,12,6,6
24797,Lyâ,ravencrest,576,warlock,destruction,12,6,6
24798,Skarløck,blackmoore,576,warlock,destruction,12,6,6
24799,Warlockyo,blackrock,576,warlock,destruction,12,6,6
24800,Staudi,eredar,576,warlock,destruction,12,6,6
24801,Chafir,kazzak,576,warlock,destruction,12,6,6
24802,Mosslock,silvermoon,576,warlock,destruction,12,6,6
24803,Loulou,nagrand,576,warlock,destruction,12,6,6
24804,Liwerno,dunemaul,576,warlock,destruction,12,6,6
24805,Uneedtherapy,silvermoon,576,warlock,destruction,12,6,6
24806,Dotacy,kazzak,576,warlock,destruction,12,6,6
24807,Marenov,kazzak,576,warlock,destruction,12,6,6
24808,Enyras,nemesis,576,warlock,destruction,12,6,6
24809,Zartax,kazzak,576,warlock,destruction,12,6,6
24810,Felcollins,sylvanas,576,warlock,destruction,12,6,6
24811,Benzakenta,sylvanas,576,warlock,destruction,12,6,6
24812,Noobtamer,kazzak,576,warlock,destruction,12,6,6
24813,Forgepower,ghostlands,576,warlock,destruction,12,6,6
24814,Klasikas,kazzak,576,warlock,destruction,16,7,9
24815,Letswreck,outland,576,warlock,destruction,18,6,12
24816,Naitix,argent-dawn,576,warlock,destruction,18,6,12
24817,Kïrah,ysondre,576,warlock,destruction,24,6,18
24818,Solomohn,steamwheedle-cartel,575,warlock,destruction,6,6,0
24819,Шелруа,howling-fjord,575,warlock,destruction,10,7,3
24820,Brarvile,zuljin,575,warlock,destruction,12,6,6
24821,Arnoediad,twisting-nether,575,warlock,destruction,12,6,6
24822,Maveri,tarren-mill,575,warlock,destruction,12,6,6
24823,Swagzz,silvermoon,575,warlock,destruction,12,6,6
24824,Rhaznor,frostwolf,575,warlock,destruction,12,6,6
24825,Nemssy,dun-modr,575,warlock,destruction,18,6,12
24826,Ramurox,rexxar,575,warlock,destruction,18,6,12
24827,Lucîfear,silvermoon,574,warlock,destruction,12,6,6
24828,Marann,dun-morogh,569,warlock,destruction,12,6,6
24829,Fearylia,aegwynn,543,warlock,destruction,8,7,1
24830,Epzi,outland,543,warlock,destruction,11,6,5
24831,Lolock,archimonde,543,warlock,destruction,14,7,7
24832,Pouletmicuie,archimonde,527,warlock,destruction,11,6,5
24833,Sicktir,aerie-peak,527,warlock,destruction,11,6,5
24834,Стафилокок,deepholm,527,warlock,destruction,11,6,5
24835,Wolferand,argent-dawn,521,warlock,destruction,24,7,17
24836,Nøxxlock,blackhand,511,warlock,destruction,8,6,2
24837,Baxiaz,kazzak,511,warlock,destruction,11,6,5
24838,Evilhippie,kazzak,511,warlock,destruction,11,6,5
24839,Asmodaî,anubarak,510,warlock,destruction,14,6,8
24840,Nëismz,ravencrest,496,warlock,destruction,7,6,1
24841,Beepbepp,grim-batol,496,warlock,destruction,7,6,1
24842,Sâlty,stormscale,480,warlock,destruction,6,5,1
24843,Scandalfogel,frostmane,480,warlock,destruction,6,5,1
24844,Møärdötd,aggra-português,480,warlock,destruction,6,5,1
24845,Exiled,dragonblight,480,warlock,destruction,6,5,1
24846,Destinyz,dun-modr,480,warlock,destruction,6,5,1
24847,ßualock,sylvanas,480,warlock,destruction,6,5,1
24848,Theronas,tarren-mill,480,warlock,destruction,6,5,1
24849,Verminosiss,stormscale,480,warlock,destruction,6,5,1
24850,Kaakmasta,der-abyssische-rat,480,warlock,destruction,6,5,1
24851,Lilbolty,outland,480,warlock,destruction,6,5,1
24852,Trollgubbe,twilights-hammer,480,warlock,destruction,6,5,1
24853,Barbyqueue,kazzak,480,warlock,destruction,6,5,1
24854,Vankraken,silvermoon,480,warlock,destruction,6,5,1
24855,Alexindorf,silvermoon,480,warlock,destruction,6,5,1
24856,Lyndi,nerathor,480,warlock,destruction,6,5,1
24857,Stazox,drakthul,480,warlock,destruction,6,5,1
24858,Zurael,mannoroth,480,warlock,destruction,6,5,1
24859,Xeró,quelthalas,480,warlock,destruction,6,5,1
24860,Sqx,veklor,480,warlock,destruction,6,5,1
24861,Mïllâïneeqtx,archimonde,480,warlock,destruction,6,5,1
24862,Lazytown,silvermoon,480,warlock,destruction,6,5,1
24863,Журанайсбой,blackscar,480,warlock,destruction,6,5,1
24864,Phît,kilrogg,480,warlock,destruction,6,5,1
24865,Shortyi,thrall,480,warlock,destruction,6,5,1
24866,Lockukaracha,malganis,480,warlock,destruction,6,5,1
24867,Азерок,howling-fjord,480,warlock,destruction,6,5,1
24868,Sotapen,ragnaros,480,warlock,destruction,6,5,1
24869,Warlololock,malganis,480,warlock,destruction,6,5,1
24870,Avadakèdavra,kazzak,480,warlock,destruction,6,5,1
24871,Ragïa,archimonde,480,warlock,destruction,6,5,1
24872,Mazuto,outland,480,warlock,destruction,6,5,1
24873,Drainurlife,zenedar,480,warlock,destruction,6,5,1
24874,Файрусх,soulflayer,480,warlock,destruction,6,5,1
24875,Demonmilf,ysondre,480,warlock,destruction,6,5,1
24876,Höglund,twisting-nether,480,warlock,destruction,6,5,1
24877,Whatamellown,aegwynn,480,warlock,destruction,6,5,1
24878,Letmecast,sylvanas,480,warlock,destruction,6,5,1
24879,Lînden,magtheridon,480,warlock,destruction,6,5,1
24880,Aritrosyo,ravencrest,480,warlock,destruction,6,5,1
24881,Андаинг,soulflayer,480,warlock,destruction,6,5,1
24882,Levinbrz,ravencrest,480,warlock,destruction,6,5,1
24883,Lísbeth,sylvanas,480,warlock,destruction,6,5,1
24884,Osbaa,darksorrow,480,warlock,destruction,6,5,1
24885,Бриант,gordunni,480,warlock,destruction,6,5,1
24886,Веберх,howling-fjord,480,warlock,destruction,6,5,1
24887,Náwwk,blackmoore,480,warlock,destruction,6,5,1
24888,Southylolz,stormscale,480,warlock,destruction,6,5,1
24889,Wÿvërnn,archimonde,480,warlock,destruction,6,5,1
24890,Djløckgødx,ravencrest,480,warlock,destruction,6,5,1
24891,Jkz,blackrock,480,warlock,destruction,6,5,1
24892,Deruud,defias-brotherhood,480,warlock,destruction,6,5,1
24893,Rensayy,ysondre,480,warlock,destruction,6,5,1
24894,Ампе,blackscar,480,warlock,destruction,6,5,1
24895,Xjay,malorne,480,warlock,destruction,6,5,1
24896,Salvatoriy,outland,480,warlock,destruction,6,5,1
24897,Domdon,stormscale,480,warlock,destruction,12,5,7
24898,Yeluna,alleria,480,warlock,destruction,12,5,7
24899,Fluxlight,frostmourne,480,warlock,destruction,12,5,7
24900,Моориус,soulflayer,480,warlock,destruction,12,5,7
24901,Nanotrik,draenor,480,warlock,destruction,12,5,7
24902,Yokûjin,twisting-nether,480,warlock,destruction,12,5,7
24903,Динодотз,howling-fjord,480,warlock,destruction,12,5,7
24904,Bricktot,ragnaros,480,warlock,destruction,12,5,7
24905,Hexdoc,alakir,480,warlock,destruction,12,5,7
24906,Kigro,burning-legion,480,warlock,destruction,12,5,7
24907,Локизло,gordunni,480,warlock,destruction,12,5,7
24908,Tomiaa,burning-legion,480,warlock,destruction,12,5,7
24909,Bajsibyx,tarren-mill,480,warlock,destruction,12,5,7
24910,Kimwexler,ravencrest,480,warlock,destruction,12,5,7
24911,Shadowscurse,sylvanas,480,warlock,destruction,12,5,7
24912,Kieman,tarren-mill,480,warlock,destruction,12,5,7
24913,Shreedlock,blackmoore,480,warlock,destruction,12,5,7
24914,Claralock,silvermoon,480,warlock,destruction,12,5,7
24915,Gravedîgger,aggra-português,480,warlock,destruction,12,5,7
24916,Asper,ragnaros,480,warlock,destruction,12,5,7
24917,Voodooskull,kazzak,480,warlock,destruction,12,5,7
24918,Voidzero,hyjal,480,warlock,destruction,12,5,7
24919,Janemba,ysondre,480,warlock,destruction,12,5,7
24920,Käristäjä,outland,480,warlock,destruction,12,5,7
24921,Zêngâ,kazzak,480,warlock,destruction,12,5,7
24922,Yhwäch,archimonde,480,warlock,destruction,12,5,7
24923,Brugo,zuljin,480,warlock,destruction,12,5,7
24924,Lokelicious,ragnaros,480,warlock,destruction,12,5,7
24925,Zeanort,zuljin,480,warlock,destruction,12,5,7
24926,Infectius,kazzak,480,warlock,destruction,18,5,13
24927,Maledictio,blackrock,480,warlock,destruction,18,5,13
24928,Birimbau,outland,480,warlock,destruction,18,5,13
24929,Kresyda,dun-modr,480,warlock,destruction,18,5,13
24930,Fredysimo,silvermoon,479,warlock,destruction,6,5,1
24931,Эктос,soulflayer,479,warlock,destruction,6,5,1
24932,Öyo,outland,479,warlock,destruction,12,5,7
24933,Archélion,silvermoon,479,warlock,destruction,12,5,7
24934,Сенсация,ashenvale,479,warlock,destruction,12,5,7
24935,Bope,the-maelstrom,479,warlock,destruction,18,5,13
24936,Soulsdeads,sylvanas,478,warlock,destruction,12,5,7
24937,Снчч,soulflayer,463,warlock,destruction,11,5,6
24938,Favris,antonidas,447,warlock,destruction,11,5,6
24939,Winterx,argent-dawn,447,warlock,destruction,11,5,6
24940,Acrion,blackrock,432,warlock,destruction,9,6,3
24941,Daeyon,ravencrest,432,warlock,destruction,9,5,4
24942,Chornota,ravencrest,431,warlock,destruction,17,5,12
24943,Charmine,tarren-mill,400,warlock,destruction,7,5,2
24944,Predlocktwo,twisting-nether,384,warlock,destruction,6,4,2
24945,Psykøø,shendralar,384,warlock,destruction,6,4,2
24946,Nilsa,eredar,384,warlock,destruction,6,4,2
24947,Trembly,alakir,384,warlock,destruction,6,4,2
24948,Ädarä,cthun,384,warlock,destruction,6,4,2
24949,Simony,ravencrest,384,warlock,destruction,6,4,2
24950,Sïlïthuss,ravencrest,384,warlock,destruction,6,4,2
24951,Cloud,kazzak,384,warlock,destruction,6,4,2
24952,Drshegs,darkspear,384,warlock,destruction,6,4,2
24953,Korupcijax,kazzak,384,warlock,destruction,6,4,2
24954,Corano,ravencrest,384,warlock,destruction,6,4,2
24955,Xskyrov,blackmoore,384,warlock,destruction,6,4,2
24956,Feyreah,blackmoore,384,warlock,destruction,6,4,2
24957,Danidelarge,kazzak,384,warlock,destruction,6,4,2
24958,Chaotick,burning-legion,384,warlock,destruction,6,4,2
24959,Кичи,gordunni,384,warlock,destruction,6,4,2
24960,Cajnik,sylvanas,384,warlock,destruction,6,4,2
24961,Diemilch,blackmoore,384,warlock,destruction,6,4,2
24962,Harrydotterx,alakir,384,warlock,destruction,6,4,2
24963,Precogbtw,ravencrest,384,warlock,destruction,6,4,2
24964,Flayør,ravencrest,384,warlock,destruction,6,4,2
24965,Äri,blackmoore,384,warlock,destruction,6,4,2
24966,Zéik,archimonde,384,warlock,destruction,6,4,2
24967,Rénna,twisting-nether,384,warlock,destruction,6,4,2
24968,Вешка,azuregos,384,warlock,destruction,6,4,2
24969,Iulu,sylvanas,384,warlock,destruction,6,4,2
24970,Yifu,ravencrest,384,warlock,destruction,6,4,2
24971,Patirass,sanguino,384,warlock,destruction,6,4,2
24972,Síggýy,eredar,384,warlock,destruction,6,4,2
24973,Allêgrâ,blackrock,384,warlock,destruction,6,4,2
24974,Onekxz,blackrock,384,warlock,destruction,6,4,2
24975,Smithlock,blackrock,384,warlock,destruction,6,4,2
24976,Анрали,soulflayer,384,warlock,destruction,6,4,2
24977,Hulagirl,ravencrest,384,warlock,destruction,6,4,2
24978,Zilthon,dragonblight,384,warlock,destruction,6,4,2
24979,Discordîân,twisting-nether,384,warlock,destruction,6,4,2
24980,Siyaa,eredar,384,warlock,destruction,6,4,2
24981,Uqrlock,twisting-nether,384,warlock,destruction,6,4,2
24982,Azae,outland,384,warlock,destruction,6,4,2
24983,Purplemonkey,burning-blade,384,warlock,destruction,6,4,2
24984,Zekarat,blackrock,384,warlock,destruction,6,4,2
24985,Ðuß,nemesis,384,warlock,destruction,6,4,2
24986,Darkwìngduck,ravencrest,384,warlock,destruction,6,4,2
24987,Gambos,kazzak,384,warlock,destruction,6,4,2
24988,Hachishaku,ravencrest,384,warlock,destruction,6,4,2
24989,Sehk,stormreaver,384,warlock,destruction,6,4,2
24990,Kar,haomarush,384,warlock,destruction,6,4,2
24991,Døxz,blackrock,384,warlock,destruction,6,4,2
24992,Darkwíngduck,aegwynn,384,warlock,destruction,6,4,2
24993,Gorthunz,kazzak,384,warlock,destruction,6,4,2
24994,Vêzor,twisting-nether,384,warlock,destruction,6,4,2
24995,Lockteb,tarren-mill,384,warlock,destruction,6,4,2
24996,Dotritos,tarren-mill,384,warlock,destruction,6,4,2
24997,Íntikam,blackrock,384,warlock,destruction,6,4,2
24998,Chochliko,silvermoon,384,warlock,destruction,6,4,2
24999,Aldiac,aegwynn,384,warlock,destruction,6,4,2
25000,Rikkai,anubarak,384,warlock,destruction,6,4,2
25001,Póssiblyreef,silvermoon,384,warlock,destruction,6,4,2
25002,Ðênnis,tarren-mill,384,warlock,destruction,6,4,2
25003,Xarfoul,grim-batol,384,warlock,destruction,6,4,2
25004,Acilock,outland,384,warlock,destruction,6,4,2
25005,Warlockery,argent-dawn,384,warlock,destruction,6,4,2
25006,Deßra,stormscale,384,warlock,destruction,6,4,2
25007,Unfeared,blackhand,384,warlock,destruction,6,4,2
25008,Weso,grim-batol,384,warlock,destruction,6,4,2
25009,Edgyrpname,argent-dawn,384,warlock,destruction,6,4,2
25010,Zevil,emerald-dream,384,warlock,destruction,6,4,2
25011,Яичнаялапша,soulflayer,384,warlock,destruction,6,4,2
25012,Boltyboi,chamber-of-aspects,384,warlock,destruction,6,4,2
25013,Raddikal,archimonde,384,warlock,destruction,6,4,2
25014,Kalaslars,draenor,384,warlock,destruction,6,4,2
25015,Xenastro,silvermoon,384,warlock,destruction,6,4,2
25016,Malinki,silvermoon,384,warlock,destruction,6,4,2
25017,Striks,ragnaros,384,warlock,destruction,6,4,2
25018,Falel,das-konsortium,384,warlock,destruction,6,4,2
25019,Notloveless,stormscale,384,warlock,destruction,6,4,2
25020,Fatburner,draenor,384,warlock,destruction,6,4,2
25021,Worro,eredar,384,warlock,destruction,6,4,2
25022,Arthesia,archimonde,384,warlock,destruction,6,4,2
25023,Пчелокнижник,howling-fjord,384,warlock,destruction,6,4,2
25024,Abdulrahim,archimonde,384,warlock,destruction,6,4,2
25025,Sneltjej,draenor,384,warlock,destruction,6,4,2
25026,Rayfears,draenor,384,warlock,destruction,6,4,2
25027,Боуманн,howling-fjord,384,warlock,destruction,6,4,2
25028,Рыжевласочка,eversong,384,warlock,destruction,9,5,4
25029,Sindown,the-maelstrom,384,warlock,destruction,12,4,8
25030,Юникна,gordunni,384,warlock,destruction,12,4,8
25031,Лоллиторпеда,gordunni,384,warlock,destruction,12,4,8
25032,Tekron,blackhand,384,warlock,destruction,12,4,8
25033,Уфц,grom,384,warlock,destruction,12,4,8
25034,Palihatschi,eredar,384,warlock,destruction,12,4,8
25035,Kaobolt,archimonde,384,warlock,destruction,12,4,8
25036,Azmondan,ahnqiraj,384,warlock,destruction,12,4,8
25037,Sædotern,stormscale,384,warlock,destruction,12,4,8
25038,Icritmore,stormscale,384,warlock,destruction,12,4,8
25039,Чиззихаос,soulflayer,384,warlock,destruction,12,4,8
25040,Visable,kazzak,384,warlock,destruction,12,4,8
25041,Hòbó,outland,384,warlock,destruction,12,4,8
25042,Nahamma,tarren-mill,384,warlock,destruction,12,4,8
25043,Lugnalennart,tarren-mill,384,warlock,destruction,12,4,8
25044,Yandihimir,silvermoon,384,warlock,destruction,12,4,8
25045,Reidonk,blackrock,384,warlock,destruction,12,4,8
25046,Стокыч,soulflayer,384,warlock,destruction,12,4,8
25047,Shadowflare,blackmoore,384,warlock,destruction,12,4,8
25048,Darkmaw,drakthul,384,warlock,destruction,12,4,8
25049,Neburlock,dun-modr,384,warlock,destruction,12,4,8
25050,Gulzot,turalyon,384,warlock,destruction,12,4,8
25051,Xshay,dun-modr,384,warlock,destruction,12,4,8
25052,Mustalol,outland,384,warlock,destruction,12,4,8
25053,Impvader,argent-dawn,384,warlock,destruction,12,4,8
25054,Axy,dun-modr,384,warlock,destruction,12,4,8
25055,Hellíc,kazzak,384,warlock,destruction,12,4,8
25056,Happysrme,thrall,384,warlock,destruction,18,4,14
25057,Lifetapped,tarren-mill,384,warlock,destruction,18,4,14
25058,Angrynoob,silvermoon,383,warlock,destruction,6,4,2
25059,Okulus,quelthalas,383,warlock,destruction,6,4,2
25060,Demirchayan,twisting-nether,383,warlock,destruction,6,4,2
25061,Stunspectoo,turalyon,383,warlock,destruction,6,4,2
25062,Dathos,ragnaros,383,warlock,destruction,12,4,8
25063,Zøhaz,burning-legion,383,warlock,destruction,12,4,8
25064,Britneyfear,aegwynn,351,warlock,destruction,8,5,3
25065,Khano,twisting-nether,336,warlock,destruction,15,4,11
25066,Рейнджр,eversong,330,warlock,destruction,15,6,9
25067,Würrzag,kazzak,319,warlock,destruction,5,4,1
25068,Chev,nemesis,319,warlock,destruction,5,4,1
25069,Sapheâ,burning-legion,319,warlock,destruction,5,4,1
25070,Krokator,draenor,319,warlock,destruction,5,4,1
25071,Grolder,terokkar,319,warlock,destruction,8,4,4
25072,Líok,eredar,319,warlock,destruction,11,4,7
25073,Empra,stormscale,304,warlock,destruction,7,4,3
25074,Esthrella,thrall,302,warlock,destruction,7,4,3
25075,Djshyasiañ,perenolde,288,warlock,destruction,6,3,3
25076,Yasagoth,chamber-of-aspects,288,warlock,destruction,6,3,3
25077,Drozhna,kaelthas,288,warlock,destruction,6,3,3
25078,Herador,draenor,288,warlock,destruction,6,3,3
25079,Bte,draenor,288,warlock,destruction,6,3,3
25080,Bh,ragnaros,288,warlock,destruction,6,3,3
25081,Sateerik,draenor,288,warlock,destruction,6,3,3
25082,Macchíato,ragnaros,288,warlock,destruction,6,3,3
25083,Gulleigh,draenor,288,warlock,destruction,6,3,3
25084,Saymore,ragnaros,288,warlock,destruction,6,3,3
25085,Кайдзуки,howling-fjord,288,warlock,destruction,6,3,3
25086,Sehere,ragnaros,288,warlock,destruction,6,3,3
25087,Huaian,darksorrow,288,warlock,destruction,6,3,3
25088,Phántom,frostmane,288,warlock,destruction,6,3,3
25089,Kiritsugi,aszune,288,warlock,destruction,6,3,3
25090,Doublebolt,the-maelstrom,288,warlock,destruction,6,3,3
25091,Wauwish,stormscale,288,warlock,destruction,6,3,3
25092,Dieger,thunderhorn,288,warlock,destruction,6,3,3
25093,Hiroyukí,frostmane,288,warlock,destruction,6,3,3
25094,Zuldanius,stormscale,288,warlock,destruction,6,3,3
25095,Rokudaime,stormscale,288,warlock,destruction,6,3,3
25096,Palmtri,stormscale,288,warlock,destruction,6,3,3
25097,Exitumos,eredar,288,warlock,destruction,6,3,3
25098,Ghosthound,stormscale,288,warlock,destruction,6,3,3
25099,Xoregar,nemesis,288,warlock,destruction,6,3,3
25100,Nkwango,blackmoore,288,warlock,destruction,6,3,3
25101,Finlock,kult-der-verdammten,288,warlock,destruction,6,3,3
25102,Nargøf,outland,288,warlock,destruction,6,3,3
25103,Wajiggity,ravencrest,288,warlock,destruction,6,3,3
25104,Cursè,stormscale,288,warlock,destruction,6,3,3
25105,Hairylock,outland,288,warlock,destruction,6,3,3
25106,Mewarlock,bronze-dragonflight,288,warlock,destruction,6,3,3
25107,Talt,dalaran,288,warlock,destruction,6,3,3
25108,Aoeenjoer,tarren-mill,288,warlock,destruction,6,3,3
25109,Moonpoxlock,nerathor,288,warlock,destruction,6,3,3
25110,Pcbbwarlock,sylvanas,288,warlock,destruction,6,3,3
25111,Oldasiangirl,blackrock,288,warlock,destruction,6,3,3
25112,Chroll,nerathor,288,warlock,destruction,6,3,3
25113,Brodoh,dun-modr,288,warlock,destruction,6,3,3
25114,Læssêkøñgð,twisting-nether,288,warlock,destruction,6,3,3
25115,Waryald,dun-modr,288,warlock,destruction,6,3,3
25116,Бешентумай,goldrinn,288,warlock,destruction,6,3,3
25117,Cpump,twisting-nether,288,warlock,destruction,6,3,3
25118,Lamboo,tarren-mill,288,warlock,destruction,6,3,3
25119,Issyl,kazzak,288,warlock,destruction,6,3,3
25120,Elmîr,blackmoore,288,warlock,destruction,6,3,3
25121,Bluh,twisting-nether,288,warlock,destruction,6,3,3
25122,Zow,dun-modr,288,warlock,destruction,6,3,3
25123,Demónfire,sylvanas,288,warlock,destruction,6,3,3
25124,Chubson,tarren-mill,288,warlock,destruction,6,3,3
25125,Maxiabe,hyjal,288,warlock,destruction,6,3,3
25126,Blazed,dentarg,288,warlock,destruction,6,3,3
25127,Dragmetohêll,blackhand,288,warlock,destruction,6,3,3
25128,Lockskalle,tarren-mill,288,warlock,destruction,6,3,3
25129,Dement,sanguino,288,warlock,destruction,6,3,3
25130,Dexterlol,blackmoore,288,warlock,destruction,6,3,3
25131,Deamheòlas,ravencrest,288,warlock,destruction,6,3,3
25132,Maevex,stormscale,288,warlock,destruction,6,3,3
25133,Глотающий,gordunni,288,warlock,destruction,6,3,3
25134,Ragdoll,twisting-nether,288,warlock,destruction,6,3,3
25135,Chaosborn,ravencrest,288,warlock,destruction,6,3,3
25136,Icq,ravencrest,288,warlock,destruction,6,3,3
25137,Darkleci,archimonde,288,warlock,destruction,6,3,3
25138,Arizyoxot,twisting-nether,288,warlock,destruction,6,3,3
25139,Zabani,das-syndikat,288,warlock,destruction,6,3,3
25140,Boltez,twisting-nether,288,warlock,destruction,6,3,3
25141,Колмидедди,gordunni,288,warlock,destruction,6,3,3
25142,Feardotfive,frostwolf,288,warlock,destruction,6,3,3
25143,Funcky,terokkar,288,warlock,destruction,6,3,3
25144,Besthun,drakthul,288,warlock,destruction,6,3,3
25145,Laanik,twisting-nether,288,warlock,destruction,6,3,3
25146,Flaming,ravencrest,288,warlock,destruction,6,3,3
25147,Huaraches,stormscale,288,warlock,destruction,6,3,3
25148,Oimera,frostwolf,288,warlock,destruction,6,3,3
25149,Wdauwg,nazjatar,288,warlock,destruction,6,3,3
25150,Koramu,blackrock,288,warlock,destruction,6,3,3
25151,Lockki,blades-edge,288,warlock,destruction,6,3,3
25152,Fandusttwo,drakthul,288,warlock,destruction,6,3,3
25153,Frankieboi,drakthul,288,warlock,destruction,6,3,3
25154,Contemtus,frostwhisper,288,warlock,destruction,6,3,3
25155,Truckpunch,defias-brotherhood,288,warlock,destruction,6,3,3
25156,Helvetica,darksorrow,288,warlock,destruction,6,3,3
25157,Demox,arathor,288,warlock,destruction,6,3,3
25158,Динодотх,gordunni,288,warlock,destruction,6,3,3
25159,Flatwolenzy,blackrock,288,warlock,destruction,6,3,3
25160,Toskanoamani,blackmoore,288,warlock,destruction,6,3,3
25161,Wäisted,ravencrest,288,warlock,destruction,6,3,3
25162,Stopfëar,ysondre,288,warlock,destruction,6,3,3
25163,Шеизла,borean-tundra,288,warlock,destruction,6,3,3
25164,Epoku,stormscale,288,warlock,destruction,6,3,3
25165,Pixelz,twisting-nether,288,warlock,destruction,6,3,3
25166,Dotsfired,aegwynn,288,warlock,destruction,12,3,9
25167,Nathgar,drakthul,288,warlock,destruction,12,3,9
25168,Killerbeez,burning-blade,288,warlock,destruction,12,3,9
25169,Haedri,kazzak,288,warlock,destruction,12,3,9
25170,Jumbodot,tarren-mill,288,warlock,destruction,12,3,9
25171,Phéar,deathwing,288,warlock,destruction,12,3,9
25172,Gnargamehl,nemesis,288,warlock,destruction,12,3,9
25173,Quief,silvermoon,288,warlock,destruction,12,3,9
25174,Svartalfen,outland,288,warlock,destruction,12,3,9
25175,Ðæthpäct,dalaran,288,warlock,destruction,12,3,9
25176,Voib,silvermoon,288,warlock,destruction,12,3,9
25177,Èrmes,eldrethalas,288,warlock,destruction,12,3,9
25178,Мирмех,gordunni,288,warlock,destruction,12,3,9
25179,Mitrela,ravencrest,288,warlock,destruction,12,3,9
25180,Dreameater,twilights-hammer,288,warlock,destruction,12,3,9
25181,Tiffyilock,blackrock,288,warlock,destruction,12,3,9
25182,Fewton,eonar,288,warlock,destruction,18,3,15
25183,Грашек,soulflayer,287,warlock,destruction,6,3,3
25184,Destri,blackmoore,286,warlock,destruction,6,3,3
25185,Fearing,malganis,255,warlock,destruction,11,3,8
25186,Telaldrah,argent-dawn,239,warlock,destruction,5,3,2
25187,Smíkz,blackhand,239,warlock,destruction,5,3,2
25188,Insertchaos,draenor,239,warlock,destruction,5,3,2
25189,Kelek,anachronos,239,warlock,destruction,5,3,2
25190,Вроман,fordragon,234,warlock,destruction,10,5,5
25191,Neffy,sinstralis,234,warlock,destruction,10,4,6
25192,Oxypvp,ravencrest,192,warlock,destruction,9,3,6
25193,Vortëxx,tarren-mill,192,warlock,destruction,9,3,6
25194,Jetset,moonglade,192,warlock,destruction,6,2,4
25195,Хашонмвп,gordunni,192,warlock,destruction,6,2,4
25196,Kabowie,twisting-nether,192,warlock,destruction,6,2,4
25197,Locknroll,terokkar,192,warlock,destruction,6,2,4
25198,Jaliyah,outland,192,warlock,destruction,6,2,4
25199,Astralvoid,outland,192,warlock,destruction,6,2,4
25200,Олимта,blackscar,192,warlock,destruction,6,2,4
25201,Degdeehei,draenor,192,warlock,destruction,6,2,4
25202,Cindela,eredar,192,warlock,destruction,6,2,4
25203,Saabnoolock,ragnaros,192,warlock,destruction,6,2,4
25204,Емс,gordunni,192,warlock,destruction,6,2,4
25205,Guldän,quelthalas,192,warlock,destruction,6,2,4
25206,Мерседэсс,gordunni,192,warlock,destruction,6,2,4
25207,Zeelotko,drakthul,192,warlock,destruction,6,2,4
25208,Zenaidaa,doomhammer,192,warlock,destruction,6,2,4
25209,Kleing,dragonblight,192,warlock,destruction,6,2,4
25210,Zagana,neptulon,192,warlock,destruction,6,2,4
25211,Splojf,the-maelstrom,192,warlock,destruction,6,2,4
25212,Адоха,howling-fjord,192,warlock,destruction,6,2,4
25213,Houndread,kazzak,192,warlock,destruction,6,2,4
25214,Jillyãen,hyjal,192,warlock,destruction,6,2,4
25215,Kotihoitaja,stormreaver,192,warlock,destruction,6,2,4
25216,Prestige,nemesis,192,warlock,destruction,6,2,4
25217,Lockpup,draenor,192,warlock,destruction,6,2,4
25218,Piouturass,hyjal,192,warlock,destruction,6,2,4
25219,Creamcleaner,tarren-mill,192,warlock,destruction,6,2,4
25220,Bailerlock,antonidas,192,warlock,destruction,6,2,4
25221,Legiozock,draenor,192,warlock,destruction,6,2,4
25222,Sinlockz,tarren-mill,192,warlock,destruction,6,2,4
25223,Daeneerys,skullcrusher,192,warlock,destruction,6,2,4
25224,Уставок,soulflayer,192,warlock,destruction,6,2,4
25225,Chaotìc,nemesis,192,warlock,destruction,6,2,4
25226,Absúrd,turalyon,192,warlock,destruction,6,2,4
25227,Snoggä,antonidas,192,warlock,destruction,6,2,4
25228,Парачо,eversong,192,warlock,destruction,6,2,4
25229,Werkx,archimonde,192,warlock,destruction,6,2,4
25230,Guldån,twisting-nether,192,warlock,destruction,6,2,4
25231,Kontanthjælp,tarren-mill,192,warlock,destruction,6,2,4
25232,Merengue,uldum,192,warlock,destruction,6,2,4
25233,Kvanmor,kaelthas,192,warlock,destruction,6,2,4
25234,Levitibus,argent-dawn,192,warlock,destruction,6,2,4
25235,Vitrolizz,twilights-hammer,192,warlock,destruction,6,2,4
25236,Ravendoor,grim-batol,192,warlock,destruction,6,2,4
25237,Aurelíá,ravencrest,192,warlock,destruction,6,2,4
25238,Ketriicken,argent-dawn,192,warlock,destruction,6,2,4
25239,Ívânguldán,twisting-nether,192,warlock,destruction,6,2,4
25240,Ooze,kazzak,192,warlock,destruction,6,2,4
25241,Stepwarlock,kazzak,192,warlock,destruction,6,2,4
25242,Belzedan,blackrock,192,warlock,destruction,6,2,4
25243,Евнухоидизм,gordunni,192,warlock,destruction,6,2,4
25244,Necrofearz,sylvanas,192,warlock,destruction,6,2,4
25245,Bloodysûgar,blackmoore,192,warlock,destruction,6,2,4
25246,Grandulf,ravencrest,192,warlock,destruction,6,2,4
25247,Ðiavel,kazzak,192,warlock,destruction,6,2,4
25248,Майдум,soulflayer,192,warlock,destruction,6,2,4
25249,Darthvder,sylvanas,192,warlock,destruction,6,2,4
25250,Colevid,blackmoore,192,warlock,destruction,6,2,4
25251,Bulgyeøng,archimonde,192,warlock,destruction,6,2,4
25252,Yourdeaath,ravencrest,192,warlock,destruction,6,2,4
25253,Ðaddyy,stormscale,192,warlock,destruction,6,2,4
25254,Diddia,malganis,192,warlock,destruction,6,2,4
25255,Fatkkroth,ravencrest,192,warlock,destruction,6,2,4
25256,Mákas,draenor,192,warlock,destruction,6,2,4
25257,Rojas,trollbane,192,warlock,destruction,6,2,4
25258,Valthorion,arthas,192,warlock,destruction,6,2,4
25259,Warlockxx,ravencrest,192,warlock,destruction,6,2,4
25260,Benztruck,blackhand,192,warlock,destruction,6,2,4
25261,Adafbhf,tichondrius,192,warlock,destruction,6,2,4
25262,Joemontana,blackrock,192,warlock,destruction,6,2,4
25263,Валак,greymane,192,warlock,destruction,6,2,4
25264,Fearfearfear,blackhand,192,warlock,destruction,6,2,4
25265,Костикк,howling-fjord,192,warlock,destruction,6,2,4
25266,Шэдоубёрн,soulflayer,192,warlock,destruction,6,2,4
25267,Zigfipszen,blackmoore,192,warlock,destruction,6,2,4
25268,Lockned,outland,192,warlock,destruction,6,2,4
25269,Kemel,thrall,192,warlock,destruction,6,2,4
25270,Hheavens,ragnaros,192,warlock,destruction,6,2,4
25271,Thîras,tarren-mill,192,warlock,destruction,7,2,5
25272,Noctiz,pozzo-delleternità,192,warlock,destruction,7,2,5
25273,Kokainas,dun-modr,192,warlock,destruction,12,2,10
25274,Punishteens,blackmoore,192,warlock,destruction,12,2,10
25275,Amnésïa,eldrethalas,192,warlock,destruction,12,2,10
25276,Línkéd,blackmoore,192,warlock,destruction,12,2,10
25277,Нэйрокризиз,howling-fjord,192,warlock,destruction,12,2,10
25278,Nimwyn,argent-dawn,192,warlock,destruction,12,2,10
25279,Àbraxàs,nemesis,192,warlock,destruction,12,2,10
25280,Kopfkissen,azshara,192,warlock,destruction,12,2,10
25281,Мглавечная,soulflayer,192,warlock,destruction,12,2,10
25282,Zùrghan,elune,191,warlock,destruction,4,3,1
25283,Arlu,blackrock,191,warlock,destruction,6,2,4
25284,Watchlock,burning-legion,191,warlock,destruction,6,2,4
25285,Karjarock,hyjal,191,warlock,destruction,12,2,10
25286,Helikopter,shattered-hand,175,warlock,destruction,6,3,3
25287,Геролин,goldrinn,169,warlock,destruction,18,6,12
25288,Grimlòck,antonidas,159,warlock,destruction,5,2,3
25289,Dony,dun-morogh,159,warlock,destruction,5,2,3
25290,Starlok,nemesis,159,warlock,destruction,5,2,3
25291,Hahahahah,draenor,159,warlock,destruction,5,2,3
25292,Hp,ysondre,159,warlock,destruction,5,2,3
25293,Jiltoks,blackmoore,159,warlock,destruction,5,2,3
25294,Alucena,silvermoon,138,warlock,destruction,10,4,6
25295,Rb,anachronos,138,warlock,destruction,8,3,5
25296,Delen,ravencrest,128,warlock,destruction,4,2,2
25297,Перегном,blackscar,127,warlock,destruction,8,2,6
25298,Mqsxw,stormscale,112,warlock,destruction,7,2,5
25299,Mulimarus,die-todeskrallen,96,warlock,destruction,3,2,1
25300,Mergon,ravencrest,96,warlock,destruction,3,2,1
25301,Oggelock,tarren-mill,96,warlock,destruction,3,2,1
25302,Иммолэйтх,gordunni,96,warlock,destruction,6,1,5
25303,Werlock,sanguino,96,warlock,destruction,6,1,5
25304,Hørcrux,ravencrest,96,warlock,destruction,6,1,5
25305,Dabezdwl,outland,96,warlock,destruction,6,1,5
25306,Matheus,zenedar,96,warlock,destruction,6,1,5
25307,Jaines,forscherliga,96,warlock,destruction,6,1,5
25308,Chaostheory,stormscale,96,warlock,destruction,6,1,5
25309,Neuth,draenor,96,warlock,destruction,6,1,5
25310,Стоишьвфире,gordunni,96,warlock,destruction,6,1,5
25311,Satânius,les-sentinelles,96,warlock,destruction,6,1,5
25312,Kneereap,antonidas,96,warlock,destruction,6,1,5
25313,Киёкка,howling-fjord,96,warlock,destruction,6,1,5
25314,Pilock,stormscale,96,warlock,destruction,6,1,5
25315,Mariahscary,auchindoun,96,warlock,destruction,6,1,5
25316,Snollerboy,antonidas,96,warlock,destruction,6,1,5
25317,Tanatos,tarren-mill,96,warlock,destruction,6,1,5
25318,Wt,twisting-nether,96,warlock,destruction,6,1,5
25319,Srhal,blackmoore,96,warlock,destruction,6,1,5
25320,Lomendro,blackmoore,96,warlock,destruction,6,1,5
25321,Bytethisx,aggra-português,96,warlock,destruction,6,1,5
25322,Dalfgan,wildhammer,96,warlock,destruction,6,1,5
25323,Darlih,ravencrest,96,warlock,destruction,6,1,5
25324,Indifférence,archimonde,96,warlock,destruction,6,1,5
25325,Kokonix,defias-brotherhood,96,warlock,destruction,6,1,5
25326,Lilskunk,draenor,96,warlock,destruction,6,1,5
25327,Vsmna,ragnaros,96,warlock,destruction,6,1,5
25328,Tiig,blackrock,96,warlock,destruction,6,1,5
25329,Ramuhn,antonidas,96,warlock,destruction,6,1,5
25330,Musallat,argent-dawn,96,warlock,destruction,6,1,5
25331,Daemonic,shattered-hand,96,warlock,destruction,6,1,5
25332,Wuahlock,doomhammer,96,warlock,destruction,6,1,5
25333,Tropìcal,grim-batol,96,warlock,destruction,6,1,5
25334,Gothgul,sanguino,96,warlock,destruction,6,1,5
25335,Demohoror,stormscale,96,warlock,destruction,6,1,5
25336,Rigour,silvermoon,96,warlock,destruction,6,1,5
25337,Alithia,sylvanas,96,warlock,destruction,12,1,11
25338,Malagate,sylvanas,96,warlock,destruction,12,1,11
25339,Grêenbull,eredar,96,warlock,destruction,15,1,14
25340,Néca,blackmoore,64,warlock,destruction,4,1,3
25341,Anthor,tarren-mill,42,warlock,destruction,8,2,6
25342,Obichamcici,tarren-mill,42,warlock,destruction,8,2,6
25343,Khrym,stormscale,16,warlock,destruction,1,1,0
25344,Orkamorfin,silvermoon,16,warlock,destruction,1,1,0
25345,Dyingdog,kazzak,2173,warrior,fury,67,38,29
25346,Gottdustin,lothar,2124,warrior,fury,143,78,65
25347,Níghtfúry,ravencrest,2102,warrior,fury,84,43,41
25348,Quanny,die-aldor,2078,warrior,fury,108,63,45
25349,Corvínus,blackrock,2025,warrior,fury,102,55,47
25350,Schultze,kazzak,1941,warrior,fury,113,49,64
25351,Gregorez,silvermoon,1938,warrior,fury,60,36,24
25352,Thezug,blackmoore,1935,warrior,fury,96,48,48
25353,Sublex,blackrock,1933,warrior,fury,60,34,26
25354,Thorana,twisting-nether,1917,warrior,fury,186,87,99
25355,Pflanzling,nozdormu,1912,warrior,fury,60,31,29
25356,Дахирарг,fordragon,1872,warrior,fury,54,28,26
25357,Insanedmg,dun-modr,1864,warrior,fury,72,40,32
25358,Brythwyn,antonidas,1856,warrior,fury,54,30,24
25359,Wruxar,bronzebeard,1856,warrior,fury,54,29,25
25360,Kwesta,kazzak,1850,warrior,fury,60,34,26
25361,Sockerbagarn,zenedar,1849,warrior,fury,43,23,20
25362,Jeco,tarren-mill,1846,warrior,fury,66,39,27
25363,Castlevania,ravencrest,1840,warrior,fury,66,36,30
25364,Sublex,aegwynn,1838,warrior,fury,60,36,24
25365,Kenryu,argent-dawn,1825,warrior,fury,60,32,28
25366,Sonnyzz,sanguino,1824,warrior,fury,36,21,15
25367,Timewarrior,ravencrest,1824,warrior,fury,54,30,24
25368,Deatheart,ysondre,1824,warrior,fury,76,41,35
25369,Sporctaco,nemesis,1824,warrior,fury,112,57,55
25370,Трэйдар,blackscar,1823,warrior,fury,48,27,21
25371,Letiis,blackrock,1816,warrior,fury,105,57,48
25372,Adian,ravencrest,1813,warrior,fury,42,26,16
25373,Zednos,twilights-hammer,1812,warrior,fury,184,102,82
25374,Schlauberg,azshara,1811,warrior,fury,48,29,19
25375,Мигнт,howling-fjord,1810,warrior,fury,42,23,19
25376,Zyalen,stormscale,1806,warrior,fury,60,32,28
25377,Nóvamh,draenor,1802,warrior,fury,42,24,18
25378,Gladius,blutkessel,1791,warrior,fury,90,46,44
25379,Badon,burning-legion,1783,warrior,fury,54,35,19
25380,Råzor,blackhand,1783,warrior,fury,135,81,54
25381,Robycoleman,nemesis,1775,warrior,fury,72,40,32
25382,Tóffèl,thrall,1773,warrior,fury,48,32,16
25383,Rïmxøxø,haomarush,1773,warrior,fury,48,32,16
25384,Ryonâgai,aegwynn,1773,warrior,fury,54,30,24
25385,Unstopablle,twisting-nether,1755,warrior,fury,78,47,31
25386,Kizzyo,draenor,1751,warrior,fury,78,40,38
25387,Clellin,silvermoon,1750,warrior,fury,127,72,55
25388,Ranmaru,kazzak,1747,warrior,fury,55,28,27
25389,Эйримор,gordunni,1742,warrior,fury,113,61,52
25390,Рыгатрон,galakrond,1732,warrior,fury,36,19,17
25391,Juna,hellscream,1726,warrior,fury,91,47,44
25392,Даймонддогс,gordunni,1725,warrior,fury,64,36,28
25393,Кавайтити,blackscar,1718,warrior,fury,39,19,20
25394,Варынеопэ,gordunni,1717,warrior,fury,65,35,30
25395,Тьмасвятая,gordunni,1710,warrior,fury,42,22,20
25396,Yawalad,stormscale,1707,warrior,fury,51,26,25
25397,Stansmash,kazzak,1704,warrior,fury,30,18,12
25398,Capitalista,das-konsortium,1694,warrior,fury,66,35,31
25399,Yodabär,blackmoore,1690,warrior,fury,120,62,58
25400,Elsensor,sylvanas,1685,warrior,fury,60,23,37
25401,Slaycon,sanguino,1680,warrior,fury,63,26,37
25402,Даркслеерх,howling-fjord,1674,warrior,fury,36,18,18
25403,Бубаигавар,gordunni,1673,warrior,fury,42,22,20
25404,Vÿnk,ysondre,1669,warrior,fury,80,45,35
25405,Osha,hyjal,1667,warrior,fury,108,55,53
25406,Протектор,soulflayer,1665,warrior,fury,106,52,54
25407,Luxurious,argent-dawn,1661,warrior,fury,42,24,18
25408,Averenx,frostwolf,1659,warrior,fury,110,57,53
25409,Imolderthenu,blackrock,1658,warrior,fury,125,65,60
25410,Vesnãpusic,draenor,1655,warrior,fury,45,29,16
25411,Lífelover,tarren-mill,1655,warrior,fury,60,29,31
25412,Megalann,silvermoon,1654,warrior,fury,60,30,30
25413,Очепенец,soulflayer,1652,warrior,fury,129,66,63
25414,Kocmochka,tarren-mill,1651,warrior,fury,36,22,14
25415,Noproblem,ragnaros,1650,warrior,fury,65,34,31
25416,Peli,burning-blade,1648,warrior,fury,150,75,75
25417,Ðènlos,destromath,1647,warrior,fury,36,21,15
25418,Broley,blackhand,1645,warrior,fury,43,27,16
25419,Гринфинч,galakrond,1640,warrior,fury,36,21,15
25420,Футжисубо,razuvious,1639,warrior,fury,42,20,22
25421,Späns,ragnaros,1637,warrior,fury,41,19,22
25422,Шлифую,howling-fjord,1636,warrior,fury,60,30,30
25423,Вадло,soulflayer,1635,warrior,fury,54,27,27
25424,Bastquirage,dalaran,1633,warrior,fury,42,24,18
25425,Pouckette,hyjal,1631,warrior,fury,42,24,18
25426,Iagô,argent-dawn,1627,warrior,fury,48,28,20
25427,Zupkaztrópka,burning-legion,1627,warrior,fury,83,45,38
25428,Криккс,greymane,1625,warrior,fury,66,32,34
25429,Warrez,azuremyst,1624,warrior,fury,41,25,16
25430,Níká,bronzebeard,1622,warrior,fury,31,19,12
25431,Злопиканка,gordunni,1618,warrior,fury,43,22,21
25432,Dronikos,ravencrest,1612,warrior,fury,36,22,14
25433,Walexmaryk,ragnaros,1610,warrior,fury,107,58,49
25434,Celn,silvermoon,1608,warrior,fury,145,80,65
25435,Jetman,ravencrest,1605,warrior,fury,40,19,21
25436,Abnôrmus,tarren-mill,1604,warrior,fury,96,44,52
25437,Ebonheart,argent-dawn,1599,warrior,fury,41,23,18
25438,Дарккардинал,deathguard,1598,warrior,fury,35,19,16
25439,Kwedrowar,burning-legion,1594,warrior,fury,48,25,23
25440,Methodxd,outland,1592,warrior,fury,72,35,37
25441,Azazelslayer,dethecus,1591,warrior,fury,48,33,15
25442,Ðønøvan,sanguino,1588,warrior,fury,52,28,24
25443,Yaler,alakir,1587,warrior,fury,30,19,11
25444,Байсал,gordunni,1579,warrior,fury,42,22,20
25445,Grâkul,twisting-nether,1578,warrior,fury,82,44,38
25446,Evrybodydown,draenor,1576,warrior,fury,124,68,56
25447,Méido,argent-dawn,1576,warrior,fury,186,94,92
25448,Koljach,sylvanas,1574,warrior,fury,121,62,59
25449,Хенгард,gordunni,1566,warrior,fury,36,20,16
25450,Discoklaus,blackmoore,1566,warrior,fury,138,66,72
25451,ßbç,ysondre,1565,warrior,fury,72,36,36
25452,Stahlhund,silvermoon,1564,warrior,fury,87,47,40
25453,Мурмадонио,soulflayer,1562,warrior,fury,42,19,23
25454,Сариату,soulflayer,1556,warrior,fury,72,34,38
25455,Lair,zuljin,1552,warrior,fury,30,19,11
25456,Wabisabì,silvermoon,1534,warrior,fury,35,18,17
25457,Hejduk,frostmane,1533,warrior,fury,30,20,10
25458,Slidmacka,twisting-nether,1525,warrior,fury,30,20,10
25459,Telrion,silvermoon,1525,warrior,fury,30,16,14
25460,Bözzy,stormreaver,1518,warrior,fury,120,60,60
25461,Skylexs,burning-legion,1517,warrior,fury,36,16,20
25462,Halfbroken,moonglade,1511,warrior,fury,48,19,29
25463,Pokopo,blackrock,1510,warrior,fury,42,23,19
25464,Втораянатура,howling-fjord,1508,warrior,fury,36,22,14
25465,Вменяемый,gordunni,1506,warrior,fury,42,20,22
25466,Truckfury,ravencrest,1504,warrior,fury,82,43,39
25467,Âshnâzgðûr,burning-blade,1501,warrior,fury,42,16,26
25468,Jarggyül,culte-de-la-rive-noire,1500,warrior,fury,36,21,15
25469,Sebastian,ravencrest,1498,warrior,fury,60,29,31
25470,Wøokz,argent-dawn,1490,warrior,fury,111,53,58
25471,Добиватель,howling-fjord,1488,warrior,fury,24,16,8
25472,Ärmodäuss,norgannon,1486,warrior,fury,63,31,32
25473,Варрвик,howling-fjord,1486,warrior,fury,39,19,20
25474,Garlogar,twisting-nether,1482,warrior,fury,96,50,46
25475,Hrodulf,moonglade,1476,warrior,fury,72,33,39
25476,Вундеркитти,soulflayer,1470,warrior,fury,36,17,19
25477,Арестант,soulflayer,1469,warrior,fury,65,39,26
25478,Harbee,stormscale,1466,warrior,fury,30,19,11
25479,Craghak,twisting-nether,1463,warrior,fury,76,38,38
25480,Grubshak,burning-legion,1460,warrior,fury,47,22,25
25481,Анакронокс,howling-fjord,1458,warrior,fury,40,20,20
25482,Bobitybob,ravencrest,1457,warrior,fury,30,19,11
25483,Thagzar,burning-legion,1449,warrior,fury,26,16,10
25484,Sonnylolxd,dun-modr,1438,warrior,fury,24,15,9
25485,Mustar,alexstrasza,1434,warrior,fury,59,35,24
25486,Zaximos,twisting-nether,1433,warrior,fury,33,17,16
25487,Tweegles,argent-dawn,1433,warrior,fury,65,31,34
25488,Boos,burning-legion,1432,warrior,fury,24,15,9
25489,Cuzyxtwo,blackrock,1431,warrior,fury,24,15,9
25490,Хуфхорнс,soulflayer,1425,warrior,fury,27,16,11
25491,Reidunøks,kazzak,1422,warrior,fury,59,32,27
25492,Madaxe,kazzak,1421,warrior,fury,24,15,9
25493,Susugar,ysondre,1421,warrior,fury,30,15,15
25494,Roidspam,outland,1414,warrior,fury,47,16,31
25495,Corrin,frostmourne,1413,warrior,fury,87,48,39
25496,Zeliøn,elune,1400,warrior,fury,60,36,24
25497,Akînos,kazzak,1400,warrior,fury,57,27,30
25498,Hidaykus,bronzebeard,1399,warrior,fury,70,35,35
25499,Borntothis,zuljin,1388,warrior,fury,53,32,21
25500,Krauus,silvermoon,1377,warrior,fury,91,49,42
25501,Terisá,blackmoore,1377,warrior,fury,40,20,20
25502,Dragão,kazzak,1373,warrior,fury,48,20,28
25503,Torok,antonidas,1372,warrior,fury,30,21,9
25504,Inconcussae,drakthul,1369,warrior,fury,24,16,8
25505,Touguro,aggra-português,1366,warrior,fury,45,18,27
25506,Gruttak,aegwynn,1361,warrior,fury,24,16,8
25507,Toundrâa,archimonde,1360,warrior,fury,105,51,54
25508,Wärfäcë,blades-edge,1357,warrior,fury,40,23,17
25509,Zíreael,ravencrest,1342,warrior,fury,60,29,31
25510,Stretch,thrall,1341,warrior,fury,31,15,16
25511,Mitu,sanguino,1338,warrior,fury,24,14,10
25512,Kundrak,blackhand,1334,warrior,fury,37,19,18
25513,Акози,fordragon,1332,warrior,fury,60,33,27
25514,Èscøbar,dalaran,1332,warrior,fury,39,16,23
25515,Kragar,anetheron,1329,warrior,fury,45,25,20
25516,Джелорд,howling-fjord,1326,warrior,fury,30,14,16
25517,Jyukei,archimonde,1324,warrior,fury,18,14,4
25518,Ribastur,blackmoore,1321,warrior,fury,72,39,33
25519,Buzzingwarr,tarren-mill,1318,warrior,fury,60,29,31
25520,Вархаус,blackscar,1313,warrior,fury,39,21,18
25521,Ninja,bronze-dragonflight,1312,warrior,fury,87,42,45
25522,Барабумм,soulflayer,1310,warrior,fury,77,41,36
25523,Ælvstan,argent-dawn,1310,warrior,fury,59,30,29
25524,Ryù,dun-modr,1310,warrior,fury,30,14,16
25525,Bigrooster,argent-dawn,1303,warrior,fury,102,52,50
25526,Tragix,hyjal,1301,warrior,fury,36,16,20
25527,Kirkwood,terokkar,1297,warrior,fury,41,23,18
25528,Deusi,garrosh,1293,warrior,fury,36,21,15
25529,Машамеч,blackscar,1289,warrior,fury,84,42,42
25530,Usz,thunderhorn,1284,warrior,fury,30,19,11
25531,Xsasuke,ragnaros,1282,warrior,fury,24,14,10
25532,Sammäel,eldrethalas,1281,warrior,fury,36,19,17
25533,Trollboii,ravencrest,1274,warrior,fury,27,14,13
25534,Watntietnn,burning-blade,1268,warrior,fury,49,24,25
25535,Toughwar,tarren-mill,1267,warrior,fury,30,17,13
25536,Gritzi,dragonblight,1262,warrior,fury,60,29,31
25537,Аштау,howling-fjord,1262,warrior,fury,85,38,47
25538,Бормормуш,gordunni,1261,warrior,fury,73,30,43
25539,Antismoke,silvermoon,1259,warrior,fury,33,15,18
25540,Dundulinka,outland,1255,warrior,fury,46,17,29
25541,Immørtálx,tarren-mill,1248,warrior,fury,24,13,11
25542,Рагнарульв,gordunni,1248,warrior,fury,36,15,21
25543,Stóna,blackmoore,1247,warrior,fury,36,13,23
25544,Uretirips,archimonde,1245,warrior,fury,18,13,5
25545,Thors,deathwing,1243,warrior,fury,64,33,31
25546,Читора,blackscar,1242,warrior,fury,24,13,11
25547,Латахо,gordunni,1241,warrior,fury,24,13,11
25548,Eygón,silvermoon,1241,warrior,fury,24,13,11
25549,Рсдрпб,eversong,1241,warrior,fury,30,15,15
25550,Lâmy,khaz-modan,1240,warrior,fury,60,26,34
25551,Mamox,archimonde,1236,warrior,fury,25,14,11
25552,Profär,archimonde,1233,warrior,fury,24,13,11
25553,Reckless,tarren-mill,1231,warrior,fury,30,15,15
25554,Dizzyndumb,draenor,1228,warrior,fury,80,38,42
25555,Кимиюки,gordunni,1228,warrior,fury,30,13,17
25556,Skullfondler,argent-dawn,1226,warrior,fury,24,13,11
25557,Quigatron,frostmane,1225,warrior,fury,42,25,17
25558,Старопрамен,thermaplugg,1225,warrior,fury,73,35,38
25559,Rìsàs,draenor,1225,warrior,fury,119,52,67
25560,Schmetterina,proudmoore,1223,warrior,fury,49,28,21
25561,Нириэла,howling-fjord,1218,warrior,fury,30,13,17
25562,Svênsk,argent-dawn,1211,warrior,fury,24,13,11
25563,Delinde,cthun,1209,warrior,fury,93,45,48
25564,Warrmax,darksorrow,1208,warrior,fury,42,22,20
25565,Oughn,silvermoon,1207,warrior,fury,35,16,19
25566,Lillebibbi,tarren-mill,1206,warrior,fury,29,13,16
25567,Buzzingorc,tarren-mill,1198,warrior,fury,42,20,22
25568,Keriane,garona,1195,warrior,fury,35,14,21
25569,Blaying,ravencrest,1192,warrior,fury,23,13,10
25570,Tàuruss,blackhand,1188,warrior,fury,22,13,9
25571,Wariio,khaz-modan,1186,warrior,fury,24,13,11
25572,Agitoyami,defias-brotherhood,1180,warrior,fury,36,21,15
25573,Ragecap,rexxar,1178,warrior,fury,30,14,16
25574,Coyle,eredar,1175,warrior,fury,98,42,56
25575,Hobbó,draenor,1175,warrior,fury,48,13,35
25576,Номер,eversong,1174,warrior,fury,126,56,70
25577,Nubá,burning-legion,1164,warrior,fury,24,17,7
25578,Säl,ragnaros,1160,warrior,fury,31,17,14
25579,Joeférnandes,ragnaros,1152,warrior,fury,18,12,6
25580,Dyingdogs,kazzak,1152,warrior,fury,24,12,12
25581,Исскатель,gordunni,1150,warrior,fury,12,12,0
25582,Cesr,bloodhoof,1150,warrior,fury,18,12,6
25583,Asmoche,archimonde,1149,warrior,fury,18,12,6
25584,Roxxyy,stormreaver,1148,warrior,fury,18,12,6
25585,Лимор,howling-fjord,1146,warrior,fury,30,12,18
25586,Baoni,hyjal,1144,warrior,fury,30,12,18
25587,Нордгаар,howling-fjord,1143,warrior,fury,18,12,6
25588,Gìlgamesh,dun-modr,1141,warrior,fury,18,12,6
25589,Bluemango,ragnaros,1141,warrior,fury,24,12,12
25590,Васильна,soulflayer,1137,warrior,fury,18,12,6
25591,Exhumator,blackhand,1135,warrior,fury,36,12,24
25592,Plackø,draenor,1133,warrior,fury,23,12,11
25593,Skefe,archimonde,1130,warrior,fury,18,12,6
25594,Суммрак,grom,1130,warrior,fury,24,12,12
25595,Kebra,blackmoore,1122,warrior,fury,34,19,15
25596,Nykyro,draenor,1119,warrior,fury,54,23,31
25597,Moustachu,kirin-tor,1118,warrior,fury,27,14,13
25598,Rayeron,sanguino,1117,warrior,fury,24,12,12
25599,Bønecleaver,blackrock,1105,warrior,fury,32,14,18
25600,Sabrewølf,blackmoore,1096,warrior,fury,48,24,24
25601,Красемир,deepholm,1094,warrior,fury,35,17,18
25602,Floppikatten,kazzak,1091,warrior,fury,18,13,5
25603,Копенгаген,ashenvale,1087,warrior,fury,30,16,14
25604,Shadowcacau,aggra-português,1079,warrior,fury,23,12,11
25605,Ragnòk,eredar,1079,warrior,fury,36,13,23
25606,Seka,nozdormu,1068,warrior,fury,60,32,28
25607,Shieldlord,kazzak,1058,warrior,fury,53,15,38
25608,Maroux,malganis,1055,warrior,fury,18,11,7
25609,Hirbz,silvermoon,1055,warrior,fury,24,13,11
25610,Мастерион,soulflayer,1054,warrior,fury,18,11,7
25611,Грамол,soulflayer,1054,warrior,fury,18,11,7
25612,Chidòri,tarren-mill,1054,warrior,fury,18,11,7
25613,Snuzzygeezer,ravencrest,1053,warrior,fury,18,11,7
25614,Stratoz,ragnaros,1052,warrior,fury,27,12,15
25615,Murgrimm,die-silberne-hand,1051,warrior,fury,45,26,19
25616,Æsterius,blackmoore,1051,warrior,fury,21,12,9
25617,Hítmachine,outland,1051,warrior,fury,24,11,13
25618,Amagaddon,draenor,1050,warrior,fury,28,12,16
25619,Ranndall,blackrock,1050,warrior,fury,30,12,18
25620,Orcgrim,nozdormu,1047,warrior,fury,30,15,15
25621,Dríppy,aegwynn,1046,warrior,fury,18,11,7
25622,Whysospicey,lightbringer,1043,warrior,fury,21,12,9
25623,Вардеспетчер,razuvious,1040,warrior,fury,24,11,13
25624,Zerm,draenor,1038,warrior,fury,18,11,7
25625,Tigron,burning-legion,1037,warrior,fury,18,11,7
25626,Помойник,gordunni,1032,warrior,fury,53,33,20
25627,Tdanielt,burning-legion,1032,warrior,fury,18,11,7
25628,Falaliss,elune,1030,warrior,fury,36,18,18
25629,Azzog,archimonde,1028,warrior,fury,48,21,27
25630,Valhrann,dalaran,1024,warrior,fury,24,11,13
25631,Achonar,draenor,1012,warrior,fury,23,11,12
25632,Kungeen,silvermoon,1010,warrior,fury,36,12,24
25633,Fknmoo,kazzak,997,warrior,fury,78,39,39
25634,Kurko,blackmoore,997,warrior,fury,23,11,12
25635,Sairos,kirin-tor,988,warrior,fury,36,19,17
25636,Niozihex,the-maelstrom,984,warrior,fury,36,15,21
25637,Krlebajker,tarren-mill,977,warrior,fury,27,14,13
25638,Эребб,howling-fjord,966,warrior,fury,60,29,31
25639,Pj,sanguino,960,warrior,fury,12,10,2
25640,Borndet,eredar,959,warrior,fury,12,10,2
25641,Highoverlord,aggra-português,959,warrior,fury,18,10,8
25642,Geez,burning-blade,959,warrior,fury,18,10,8
25643,Arkataz,argent-dawn,959,warrior,fury,18,10,8
25644,Груббоб,booty-bay,958,warrior,fury,18,10,8
25645,Гронвер,soulflayer,957,warrior,fury,18,10,8
25646,Budwise,stormscale,957,warrior,fury,18,10,8
25647,Botgrinder,blackhand,955,warrior,fury,12,10,2
25648,Tyrâdus,kiljaeden,953,warrior,fury,18,10,8
25649,Борзило,howling-fjord,953,warrior,fury,18,10,8
25650,Well,kult-der-verdammten,951,warrior,fury,18,10,8
25651,Draxxann,ravencrest,946,warrior,fury,12,10,2
25652,Izmadfurax,archimonde,944,warrior,fury,18,10,8
25653,Xaturesw,twisting-nether,943,warrior,fury,12,10,2
25654,Sadjoke,draenor,943,warrior,fury,24,10,14
25655,Macgull,ysondre,934,warrior,fury,24,10,14
25656,Rédsonja,chamber-of-aspects,914,warrior,fury,36,18,18
25657,Иктиннос,gordunni,911,warrior,fury,23,10,13
25658,Ogerit,blackmoore,898,warrior,fury,30,14,16
25659,Sperta,frostmourne,896,warrior,fury,30,13,17
25660,Суферна,howling-fjord,894,warrior,fury,27,13,14
25661,Bëlzé,les-clairvoyants,887,warrior,fury,36,13,23
25662,Enzja,nazjatar,878,warrior,fury,19,10,9
25663,Jâbs,hyjal,875,warrior,fury,36,11,25
25664,Sparkzu,twisting-nether,864,warrior,fury,12,9,3
25665,Kihili,twisting-nether,864,warrior,fury,12,9,3
25666,Азктор,soulflayer,864,warrior,fury,18,9,9
25667,Рэйвисмашина,gordunni,864,warrior,fury,24,9,15
25668,Broksigarr,ragnaros,863,warrior,fury,12,9,3
25669,Веоленс,gordunni,863,warrior,fury,12,9,3
25670,Wornag,argent-dawn,863,warrior,fury,18,9,9
25671,Нейв,blackscar,863,warrior,fury,18,9,9
25672,Zyzie,argent-dawn,863,warrior,fury,24,9,15
25673,Tandrall,rexxar,863,warrior,fury,24,9,15
25674,Picciocino,nemesis,863,warrior,fury,24,9,15
25675,Itchiiz,alonsus,862,warrior,fury,18,9,9
25676,Grimleaper,twisting-nether,862,warrior,fury,18,9,9
25677,Слайдус,gordunni,862,warrior,fury,27,12,15
25678,Throck,drakthul,861,warrior,fury,18,9,9
25679,Жироштемп,gordunni,861,warrior,fury,24,9,15
25680,Bukisan,sylvanas,861,warrior,fury,24,9,15
25681,Honeymew,draenor,860,warrior,fury,24,9,15
25682,Valkirya,arthas,859,warrior,fury,24,9,15
25683,Alevucerdaa,draenor,858,warrior,fury,24,9,15
25684,Taurras,nathrezim,850,warrior,fury,41,20,21
25685,Ânaxi,silvermoon,831,warrior,fury,14,10,4
25686,Bolss,silvermoon,828,warrior,fury,28,9,19
25687,Jøtawarrior,sanguino,815,warrior,fury,17,9,8
25688,Варриорнир,howling-fjord,814,warrior,fury,14,10,4
25689,Flexbot,blackmoore,809,warrior,fury,20,10,10
25690,Gamepresa,silvermoon,783,warrior,fury,13,9,4
25691,Zern,draenor,768,warrior,fury,12,8,4
25692,Oksimbillah,blackrock,768,warrior,fury,12,8,4
25693,Émalkay,tarren-mill,768,warrior,fury,12,8,4
25694,Артен,ashenvale,768,warrior,fury,12,8,4
25695,Killhound,argent-dawn,768,warrior,fury,12,8,4
25696,Spokowar,hyjal,768,warrior,fury,12,8,4
25697,Arthoc,sanguino,768,warrior,fury,12,8,4
25698,Gôrilla,kazzak,768,warrior,fury,18,8,10
25699,Prixor,grim-batol,768,warrior,fury,18,8,10
25700,Wgdx,ravencrest,768,warrior,fury,18,8,10
25701,Joéfernandés,sylvanas,768,warrior,fury,18,8,10
25702,Báshx,outland,767,warrior,fury,12,8,4
25703,Баджераа,soulflayer,767,warrior,fury,12,8,4
25704,Gronos,silvermoon,767,warrior,fury,12,8,4
25705,Alexandrrior,rexxar,767,warrior,fury,12,8,4
25706,Settin,silvermoon,767,warrior,fury,12,8,4
25707,Míngxuan,tarren-mill,767,warrior,fury,12,8,4
25708,Ананаслорд,blackscar,767,warrior,fury,12,8,4
25709,Skeptikal,argent-dawn,767,warrior,fury,12,8,4
25710,Мастерпве,blackscar,767,warrior,fury,12,8,4
25711,Ðíscøwârrìør,nethersturm,767,warrior,fury,18,8,10
25712,Divyx,tarren-mill,767,warrior,fury,18,8,10
25713,Elainax,eredar,767,warrior,fury,18,8,10
25714,Глинм,gordunni,767,warrior,fury,18,8,10
25715,Dallion,azjolnerub,767,warrior,fury,18,8,10
25716,Ампутиль,gordunni,766,warrior,fury,12,8,4
25717,Thebiggreen,twisting-nether,766,warrior,fury,12,8,4
25718,Лазба,gordunni,766,warrior,fury,16,9,7
25719,Неуно,howling-fjord,766,warrior,fury,18,8,10
25720,Midvînter,silvermoon,766,warrior,fury,21,9,12
25721,Сэч,gordunni,765,warrior,fury,12,8,4
25722,Cuuz,outland,765,warrior,fury,18,8,10
25723,Hangovar,thrall,764,warrior,fury,15,9,6
25724,Greatsword,turalyon,763,warrior,fury,12,8,4
25725,Ipes,blackmoore,763,warrior,fury,15,9,6
25726,Cazzpowa,frostmane,762,warrior,fury,12,8,4
25727,Ikkr,kazzak,762,warrior,fury,24,8,16
25728,Khaalo,blackhand,760,warrior,fury,12,8,4
25729,Blaktarr,dunemaul,719,warrior,fury,15,8,7
25730,Вагранна,soulflayer,719,warrior,fury,17,8,9
25731,Rèckless,argent-dawn,714,warrior,fury,15,9,6
25732,Осгаард,gordunni,711,warrior,fury,21,10,11
25733,Quadfather,kazzak,672,warrior,fury,12,7,5
25734,Thorken,ragnaros,672,warrior,fury,12,7,5
25735,Avgorcgodx,stormscale,672,warrior,fury,12,7,5
25736,Yserá,auchindoun,672,warrior,fury,12,7,5
25737,Где,blackscar,672,warrior,fury,12,7,5
25738,Zwareboy,frostmane,672,warrior,fury,12,7,5
25739,Tanja,bronzebeard,672,warrior,fury,12,7,5
25740,Faraam,sunstrider,672,warrior,fury,16,8,8
25741,Toporceanul,kazzak,672,warrior,fury,18,7,11
25742,Тактоядобрый,ashenvale,672,warrior,fury,18,7,11
25743,Emcix,aszune,672,warrior,fury,18,7,11
25744,Андервульф,booty-bay,672,warrior,fury,18,7,11
25745,Biturboo,blackrock,672,warrior,fury,22,8,14
25746,Buffury,twisting-nether,671,warrior,fury,12,7,5
25747,Cocojumbo,azuremyst,671,warrior,fury,12,7,5
25748,Sniperwølf,tyrande,671,warrior,fury,12,7,5
25749,Dgyfh,dun-morogh,671,warrior,fury,12,7,5
25750,Теокрафт,howling-fjord,671,warrior,fury,12,7,5
25751,Unn,ragnaros,671,warrior,fury,12,7,5
25752,Broknagar,draenor,671,warrior,fury,12,7,5
25753,Diioxyde,temple-noir,671,warrior,fury,12,7,5
25754,Hagoxfit,los-errantes,671,warrior,fury,18,7,11
25755,Jaowa,blackmoore,671,warrior,fury,18,7,11
25756,Toecutter,defias-brotherhood,670,warrior,fury,15,8,7
25757,Напутанность,soulflayer,670,warrior,fury,18,7,11
25758,Téldrus,blackrock,667,warrior,fury,12,7,5
25759,Garosh,drakthul,666,warrior,fury,12,7,5
25760,Merdé,blackhand,658,warrior,fury,12,7,5
25761,Tiapollo,dun-modr,653,warrior,fury,23,7,16
25762,Blutwar,kazzak,649,warrior,fury,23,11,12
25763,Gabbz,aggra-português,637,warrior,fury,15,8,7
25764,Warinator,ravencrest,615,warrior,fury,13,8,5
25765,Fatspacka,argent-dawn,607,warrior,fury,14,7,7
25766,Aleextrasza,silvermoon,607,warrior,fury,14,7,7
25767,Tato,frostmourne,606,warrior,fury,11,7,4
25768,Берззлой,gordunni,576,warrior,fury,6,6,0
25769,Frozenliøn,twisting-nether,576,warrior,fury,6,6,0
25770,Thrallhall,kazzak,576,warrior,fury,6,6,0
25771,Licious,outland,576,warrior,fury,6,6,0
25772,Féélmyfury,tarren-mill,576,warrior,fury,6,6,0
25773,Exeldians,burning-legion,576,warrior,fury,6,6,0
25774,Артэкриогг,soulflayer,576,warrior,fury,6,6,0
25775,Dírectdash,draenor,576,warrior,fury,12,6,6
25776,Circumcist,dragonblight,576,warrior,fury,12,6,6
25777,Showerfresh,silvermoon,576,warrior,fury,12,6,6
25778,Nallepúh,silvermoon,576,warrior,fury,12,6,6
25779,Honzakesl,drakthul,576,warrior,fury,12,6,6
25780,Shintuargar,blackrock,576,warrior,fury,12,6,6
25781,Humanboi,ravencrest,576,warrior,fury,12,6,6
25782,Ralzung,twisting-nether,576,warrior,fury,12,6,6
25783,Xzwarr,silvermoon,576,warrior,fury,12,6,6
25784,Stanfury,sylvanas,576,warrior,fury,12,6,6
25785,Thodak,blackrock,576,warrior,fury,12,6,6
25786,Crandalius,kazzak,576,warrior,fury,12,6,6
25787,Dhloos,kazzak,576,warrior,fury,12,6,6
25788,Monbun,silvermoon,576,warrior,fury,12,6,6
25789,Redwraith,stormscale,576,warrior,fury,12,6,6
25790,Løktær,blackmoore,576,warrior,fury,12,6,6
25791,Zadirich,burning-blade,576,warrior,fury,12,6,6
25792,Shurubel,outland,576,warrior,fury,12,6,6
25793,Рэйлет,gordunni,576,warrior,fury,12,6,6
25794,Mazzkze,silvermoon,576,warrior,fury,18,6,12
25795,Elsensør,thrall,576,warrior,fury,18,6,12
25796,Сталиран,gordunni,576,warrior,fury,18,6,12
25797,Prettyangel,aegwynn,576,warrior,fury,18,6,12
25798,Flaggerware,stormscale,575,warrior,fury,12,6,6
25799,Malasortë,sylvanas,575,warrior,fury,12,6,6
25800,Oravedenes,draenor,575,warrior,fury,12,6,6
25801,Bigmercy,ragnaros,575,warrior,fury,12,6,6
25802,Realz,malganis,575,warrior,fury,12,6,6
25803,Daramir,turalyon,575,warrior,fury,12,6,6
25804,Fightinghell,stormrage,575,warrior,fury,12,6,6
25805,Jâmâli,malganis,575,warrior,fury,12,6,6
25806,Esegryel,argent-dawn,575,warrior,fury,12,6,6
25807,Richymorty,los-errantes,575,warrior,fury,12,6,6
25808,Nmwar,turalyon,575,warrior,fury,12,6,6
25809,Somalisktjur,tarren-mill,575,warrior,fury,12,6,6
25810,Блиблоб,eversong,574,warrior,fury,12,6,6
25811,Вкусныисыр,soulflayer,574,warrior,fury,12,6,6
25812,Guinnasse,khaz-modan,567,warrior,fury,12,6,6
25813,Арнвальд,galakrond,566,warrior,fury,12,6,6
25814,Miina,blutkessel,566,warrior,fury,12,6,6
25815,Discølove,frostwolf,543,warrior,fury,11,6,5
25816,Skeptikal,tarren-mill,527,warrior,fury,11,6,5
25817,Dûrøtan,marécage-de-zangar,527,warrior,fury,15,6,9
25818,Balsor,frostmane,526,warrior,fury,11,6,5
25819,Retmain,draenor,522,warrior,fury,20,8,12
25820,Mortalclaw,kazzak,521,warrior,fury,27,7,20
25821,Ptp,argent-dawn,480,warrior,fury,6,5,1
25822,Ézélya,dalaran,480,warrior,fury,6,5,1
25823,Ганахан,soulflayer,480,warrior,fury,6,5,1
25824,Спайкуссь,goldrinn,480,warrior,fury,6,5,1
25825,Tweran,drakthul,480,warrior,fury,6,5,1
25826,Дайбек,howling-fjord,480,warrior,fury,6,5,1
25827,Easypoîntsx,tarren-mill,480,warrior,fury,6,5,1
25828,Timmyda,dalaran,480,warrior,fury,6,5,1
25829,Flówér,auchindoun,480,warrior,fury,6,5,1
25830,Horovoko,kazzak,480,warrior,fury,6,5,1
25831,Astreimehns,sanguino,480,warrior,fury,6,5,1
25832,Релайк,gordunni,480,warrior,fury,6,5,1
25833,Кроуфури,gordunni,480,warrior,fury,6,5,1
25834,Jugg,emerald-dream,480,warrior,fury,12,5,7
25835,Nightmareb,magtheridon,480,warrior,fury,12,5,7
25836,Hellocritty,blackmoore,480,warrior,fury,12,5,7
25837,Soullmike,drakthul,480,warrior,fury,12,5,7
25838,Savarøx,blackmoore,480,warrior,fury,12,5,7
25839,Sodium,pozzo-delleternità,480,warrior,fury,12,5,7
25840,Axamo,ragnaros,480,warrior,fury,12,5,7
25841,Касюлин,gordunni,480,warrior,fury,12,5,7
25842,Eddíemòrphin,kazzak,480,warrior,fury,12,5,7
25843,Darthmalgus,stormscale,480,warrior,fury,12,5,7
25844,Ulthrak,archimonde,480,warrior,fury,12,5,7
25845,Гатал,howling-fjord,480,warrior,fury,12,5,7
25846,Whimbux,stormscale,480,warrior,fury,12,5,7
25847,Soakmybeet,archimonde,480,warrior,fury,12,5,7
25848,Kondomi,stormreaver,480,warrior,fury,12,5,7
25849,Kagsteelfist,twisting-nether,480,warrior,fury,12,5,7
25850,Альмас,galakrond,480,warrior,fury,12,5,7
25851,Fîlzlaus,area-52,480,warrior,fury,12,5,7
25852,Arthayl,eredar,480,warrior,fury,12,5,7
25853,Stkacha,sanguino,480,warrior,fury,12,5,7
25854,Rageaholic,blackmoore,480,warrior,fury,12,5,7
25855,Штормскейл,soulflayer,480,warrior,fury,12,5,7
25856,Punahabe,draenor,480,warrior,fury,12,5,7
25857,Orkoje,argent-dawn,480,warrior,fury,12,5,7
25858,Beznacaj,outland,480,warrior,fury,12,5,7
25859,Котаче,soulflayer,480,warrior,fury,12,5,7
25860,Ødên,frostmane,480,warrior,fury,12,5,7
25861,Luciferkhan,twisting-nether,479,warrior,fury,12,5,7
25862,Дерзкаяфурия,gordunni,479,warrior,fury,12,5,7
25863,Элейд,thermaplugg,479,warrior,fury,12,5,7
25864,Solidier,archimonde,479,warrior,fury,12,5,7
25865,Варёнок,soulflayer,479,warrior,fury,12,5,7
25866,Prime,outland,479,warrior,fury,12,5,7
25867,Rqyz,tarren-mill,479,warrior,fury,12,5,7
25868,Kaerz,ysondre,479,warrior,fury,12,5,7
25869,Motorhead,tirion,479,warrior,fury,12,5,7
25870,Offpants,drakthul,479,warrior,fury,18,5,13
25871,Destrzadora,exodar,477,warrior,fury,12,5,7
25872,Roostai,shattered-hand,476,warrior,fury,12,5,7
25873,Stroj,aerie-peak,472,warrior,fury,12,5,7
25874,Horymir,ravencrest,463,warrior,fury,11,5,6
25875,Moggorr,nemesis,462,warrior,fury,17,5,12
25876,Fenr,sanguino,444,warrior,fury,11,7,4
25877,Piinte,naxxramas,444,warrior,fury,11,5,6
25878,Yugoslav,argent-dawn,426,warrior,fury,16,6,10
25879,Nogo,nagrand,425,warrior,fury,9,6,3
25880,Djranji,kazzak,416,warrior,fury,10,5,5
25881,Famous,argent-dawn,400,warrior,fury,7,5,2
25882,Vullgrîm,blackmoore,384,warrior,fury,6,4,2
25883,Вульрайс,deepholm,384,warrior,fury,6,4,2
25884,Нерморрог,howling-fjord,384,warrior,fury,6,4,2
25885,Chipstjuven,tarren-mill,384,warrior,fury,6,4,2
25886,Irontouch,draenor,384,warrior,fury,6,4,2
25887,Bartins,magtheridon,384,warrior,fury,6,4,2
25888,Стано,booty-bay,384,warrior,fury,6,4,2
25889,Madvlad,twisting-nether,384,warrior,fury,6,4,2
25890,Dominow,ysondre,384,warrior,fury,6,4,2
25891,Nihroxis,blackrock,384,warrior,fury,6,4,2
25892,Скехит,blackscar,384,warrior,fury,6,4,2
25893,Кэйкан,gordunni,384,warrior,fury,6,4,2
25894,Sanngridr,defias-brotherhood,384,warrior,fury,6,4,2
25895,Stickifrån,darkspear,384,warrior,fury,6,4,2
25896,Dollystyle,kazzak,384,warrior,fury,6,4,2
25897,Suzzon,hyjal,384,warrior,fury,6,4,2
25898,Lôcutus,thrall,384,warrior,fury,6,4,2
25899,Gandosh,blackmoore,384,warrior,fury,6,4,2
25900,Впижаме,gordunni,384,warrior,fury,6,4,2
25901,Duarel,blackmoore,384,warrior,fury,6,4,2
25902,Bravest,ragnaros,384,warrior,fury,6,4,2
25903,Кайзерчиф,soulflayer,384,warrior,fury,6,4,2
25904,Bloódángel,frostwolf,384,warrior,fury,6,4,2
25905,Imora,silvermoon,384,warrior,fury,6,4,2
25906,Ränchiëk,ravencrest,384,warrior,fury,6,4,2
25907,Pierøne,nemesis,384,warrior,fury,6,4,2
25908,Extasceh,turalyon,384,warrior,fury,6,4,2
25909,Executte,zuljin,384,warrior,fury,6,4,2
25910,Bersurker,draenor,384,warrior,fury,6,4,2
25911,Razzani,nathrezim,384,warrior,fury,6,4,2
25912,Daldiee,ravencrest,384,warrior,fury,6,4,2
25913,Bravestar,ungoro,384,warrior,fury,6,4,2
25914,Orkboii,ravencrest,384,warrior,fury,6,4,2
25915,Vivaladirt,argent-dawn,384,warrior,fury,6,4,2
25916,Zeldius,ravencrest,384,warrior,fury,6,4,2
25917,Fortressa,ravencrest,384,warrior,fury,12,4,8
25918,Kurenn,tarren-mill,384,warrior,fury,12,4,8
25919,Råkeff,tarren-mill,384,warrior,fury,12,4,8
25920,Янесними,soulflayer,384,warrior,fury,12,4,8
25921,Drswing,kazzak,384,warrior,fury,12,4,8
25922,Изберг,soulflayer,384,warrior,fury,12,4,8
25923,Колобочек,eversong,384,warrior,fury,12,4,8
25924,Аркашевич,gordunni,384,warrior,fury,12,4,8
25925,Darriuso,kazzak,384,warrior,fury,12,4,8
25926,Nemecic,arathor,384,warrior,fury,12,4,8
25927,Andjuu,doomhammer,384,warrior,fury,12,4,8
25928,Elian,ragnaros,384,warrior,fury,12,4,8
25929,Bwonsàmdí,ragnaros,384,warrior,fury,12,4,8
25930,Nekerka,burning-legion,384,warrior,fury,12,4,8
25931,Gromrigg,draenor,384,warrior,fury,12,4,8
25932,Garradoom,stormscale,384,warrior,fury,17,5,12
25933,Romanondo,doomhammer,383,warrior,fury,6,4,2
25934,Thibow,hyjal,383,warrior,fury,6,4,2
25935,Siltiel,marécage-de-zangar,383,warrior,fury,6,4,2
25936,Sparkss,sylvanas,383,warrior,fury,6,4,2
25937,Dullegriet,veknilash,383,warrior,fury,12,4,8
25938,Solatika,alexstrasza,382,warrior,fury,6,4,2
25939,Tiscanno,nemesis,382,warrior,fury,6,4,2
25940,Beogor,grim-batol,367,warrior,fury,11,4,7
25941,Greensmash,hyjal,351,warrior,fury,14,5,9
25942,Bossít,doomhammer,336,warrior,fury,9,4,5
25943,Skillissues,argent-dawn,330,warrior,fury,11,7,4
25944,Ragedotcom,archimonde,320,warrior,fury,10,4,6
25945,Hawkman,outland,319,warrior,fury,5,4,1
25946,Limejuicer,argent-dawn,319,warrior,fury,8,4,4
25947,Manelar,draenor,319,warrior,fury,8,4,4
25948,Anaba,voljin,318,warrior,fury,10,4,6
25949,Furyre,ysondre,304,warrior,fury,7,4,3
25950,Bindera,silvermoon,288,warrior,fury,6,3,3
25951,Sakumo,sylvanas,288,warrior,fury,6,3,3
25952,Vory,ravencrest,288,warrior,fury,6,3,3
25953,Гацс,soulflayer,288,warrior,fury,6,3,3
25954,Tabboonishka,draenor,288,warrior,fury,6,3,3
25955,Ibunnyone,blackrock,288,warrior,fury,6,3,3
25956,Afk,emeriss,288,warrior,fury,6,3,3
25957,Obox,ravencrest,288,warrior,fury,6,3,3
25958,Lâppön,blackmoore,288,warrior,fury,6,3,3
25959,Frankytank,antonidas,288,warrior,fury,6,3,3
25960,Spitonem,blackrock,288,warrior,fury,6,3,3
25961,Aìrwave,blackmoore,288,warrior,fury,6,3,3
25962,Cryze,ravencrest,288,warrior,fury,6,3,3
25963,Geicoo,dalaran,288,warrior,fury,6,3,3
25964,Kapuchino,twisting-nether,288,warrior,fury,6,3,3
25965,Waroworgen,terokkar,288,warrior,fury,6,3,3
25966,Jengaa,draenor,288,warrior,fury,6,3,3
25967,Whàtsup,stormscale,288,warrior,fury,6,3,3
25968,Immera,silvermoon,288,warrior,fury,6,3,3
25969,Xerone,doomhammer,288,warrior,fury,6,3,3
25970,Skullsmasher,stormscale,288,warrior,fury,6,3,3
25971,Тегриско,goldrinn,288,warrior,fury,6,3,3
25972,Honör,sylvanas,288,warrior,fury,6,3,3
25973,Dangeruos,ragnaros,288,warrior,fury,6,3,3
25974,Shán,defias-brotherhood,288,warrior,fury,6,3,3
25975,Ntouziera,silvermoon,288,warrior,fury,6,3,3
25976,Лаинвуд,soulflayer,288,warrior,fury,6,3,3
25977,Hazarku,colinas-pardas,288,warrior,fury,6,3,3
25978,Uncledazzo,quelthalas,288,warrior,fury,6,3,3
25979,Friendlytwo,quelthalas,288,warrior,fury,6,3,3
25980,Cosmoses,mazrigos,288,warrior,fury,6,3,3
25981,Morganãrogán,ragnaros,288,warrior,fury,6,3,3
25982,Izrael,alakir,288,warrior,fury,6,3,3
25983,Damonx,draenor,288,warrior,fury,6,3,3
25984,Mfdoöm,draenor,288,warrior,fury,6,3,3
25985,Васяжелезо,gordunni,288,warrior,fury,6,3,3
25986,Léonie,arakarahm,288,warrior,fury,6,3,3
25987,Waralert,kazzak,288,warrior,fury,6,3,3
25988,Wunderwaffle,xavius,288,warrior,fury,6,3,3
25989,Taeshalach,der-abyssische-rat,288,warrior,fury,6,3,3
25990,Balltas,drakthul,288,warrior,fury,6,3,3
25991,Drfeelgud,twisting-nether,288,warrior,fury,6,3,3
25992,Gramrosh,eredar,288,warrior,fury,6,3,3
25993,Madhardy,chamber-of-aspects,288,warrior,fury,6,3,3
25994,Ivailowar,ravencrest,288,warrior,fury,6,3,3
25995,Eleborn,tarren-mill,288,warrior,fury,6,3,3
25996,Zerberos,drakthul,288,warrior,fury,6,3,3
25997,Eekz,haomarush,288,warrior,fury,6,3,3
25998,Cleavyera,tarren-mill,288,warrior,fury,6,3,3
25999,Mïîäm,archimonde,288,warrior,fury,6,3,3
26000,Berzzerker,tarren-mill,288,warrior,fury,6,3,3
26001,Ruixxted,stormreaver,288,warrior,fury,6,3,3
26002,Grinrok,thrall,288,warrior,fury,6,3,3
26003,Barrocket,aegwynn,288,warrior,fury,6,3,3
26004,Didgedelik,archimonde,288,warrior,fury,6,3,3
26005,Hortswarr,drakthul,288,warrior,fury,6,3,3
26006,Bstgame,frostmane,288,warrior,fury,6,3,3
26007,Kronmw,dun-modr,288,warrior,fury,6,3,3
26008,Septymyya,eredar,288,warrior,fury,9,4,5
26009,Xeraaya,kirin-tor,288,warrior,fury,12,3,9
26010,Grobler,blackhand,288,warrior,fury,12,3,9
26011,Bäiley,drakthul,288,warrior,fury,12,3,9
26012,Grommer,dentarg,288,warrior,fury,12,3,9
26013,Rofos,hellscream,288,warrior,fury,12,3,9
26014,Джондо,gordunni,288,warrior,fury,12,3,9
26015,Pamila,outland,288,warrior,fury,12,3,9
26016,Ganian,stormscale,288,warrior,fury,12,3,9
26017,Valldi,argent-dawn,288,warrior,fury,12,3,9
26018,Nightvision,skullcrusher,288,warrior,fury,12,3,9
26019,Urabrask,stormscale,288,warrior,fury,12,3,9
26020,Aphae,defias-brotherhood,288,warrior,fury,12,3,9
26021,Kiryn,draenor,288,warrior,fury,12,3,9
26022,Zercher,tarren-mill,288,warrior,fury,12,3,9
26023,Confliction,outland,288,warrior,fury,12,3,9
26024,Dabliu,burning-legion,288,warrior,fury,12,3,9
26025,Xonnico,ravencrest,287,warrior,fury,6,3,3
26026,Arnnau,dun-modr,287,warrior,fury,6,3,3
26027,Mistawolf,ravencrest,287,warrior,fury,6,3,3
26028,Atelier,magtheridon,287,warrior,fury,6,3,3
26029,Agunnai,karazhan,286,warrior,fury,6,3,3
26030,Execute,sanguino,239,warrior,fury,5,3,2
26031,Hazl,balnazzar,238,warrior,fury,5,3,2
26032,Xqt,laughing-skull,234,warrior,fury,9,4,5
26033,Iarsonn,drakthul,223,warrior,fury,8,3,5
26034,Флокт,howling-fjord,208,warrior,fury,7,3,4
26035,Имбанутыйвар,soulflayer,192,warrior,fury,4,3,1
26036,Jriddyzug,ravencrest,192,warrior,fury,6,2,4
26037,Mîcî,tarren-mill,192,warrior,fury,6,2,4
26038,Skykrow,ysondre,192,warrior,fury,6,2,4
26039,Саркон,ashenvale,192,warrior,fury,6,2,4
26040,Piixxz,hyjal,192,warrior,fury,6,2,4
26041,Frowenn,ravencrest,192,warrior,fury,6,2,4
26042,Eyolf,thunderhorn,192,warrior,fury,6,2,4
26043,Кентафурик,soulflayer,192,warrior,fury,6,2,4
26044,Ifir,hyjal,192,warrior,fury,6,2,4
26045,Velgur,ravencrest,192,warrior,fury,6,2,4
26046,Amédé,ysondre,192,warrior,fury,6,2,4
26047,Чпонькмашина,soulflayer,192,warrior,fury,6,2,4
26048,Hulkzmash,tarren-mill,192,warrior,fury,6,2,4
26049,Jorund,archimonde,192,warrior,fury,6,2,4
26050,Zirvey,tarren-mill,192,warrior,fury,6,2,4
26051,Buntstift,thrall,192,warrior,fury,6,2,4
26052,Chrissey,argent-dawn,192,warrior,fury,6,2,4
26053,Rayyes,stormscale,192,warrior,fury,6,2,4
26054,Чюнилингус,soulflayer,192,warrior,fury,6,2,4
26055,Alxqt,outland,192,warrior,fury,6,2,4
26056,Apacolata,outland,192,warrior,fury,6,2,4
26057,Picklejuicer,argent-dawn,192,warrior,fury,6,2,4
26058,Miotyz,ahnqiraj,192,warrior,fury,6,2,4
26059,Ruz,defias-brotherhood,192,warrior,fury,6,2,4
26060,Helleon,twisting-nether,192,warrior,fury,6,2,4
26061,Warrzor,auchindoun,192,warrior,fury,6,2,4
26062,Shownomercy,blackrock,192,warrior,fury,6,2,4
26063,Suichôken,archimonde,192,warrior,fury,6,2,4
26064,Bulletpants,argent-dawn,192,warrior,fury,6,2,4
26065,Basingaa,pozzo-delleternità,192,warrior,fury,6,2,4
26066,Wembley,proudmoore,192,warrior,fury,6,2,4
26067,Gregórry,eredar,192,warrior,fury,6,2,4
26068,Гудмунт,borean-tundra,192,warrior,fury,6,2,4
26069,Khòrne,sanguino,192,warrior,fury,6,2,4
26070,Onykat,aegwynn,192,warrior,fury,6,2,4
26071,Maniaco,kazzak,192,warrior,fury,6,2,4
26072,Durrüti,sanguino,192,warrior,fury,6,2,4
26073,Nabucadnozor,illidan,192,warrior,fury,6,2,4
26074,Evilweraz,turalyon,192,warrior,fury,6,2,4
26075,Lianore,sanguino,192,warrior,fury,6,2,4
26076,Nokturnâl,silvermoon,192,warrior,fury,6,2,4
26077,Artheim,silvermoon,192,warrior,fury,6,2,4
26078,Souler,burning-legion,192,warrior,fury,6,2,4
26079,Grenad,kazzak,192,warrior,fury,6,2,4
26080,Freddie,baelgun,192,warrior,fury,6,2,4
26081,Zalazain,burning-legion,192,warrior,fury,6,2,4
26082,Malalulu,burning-legion,192,warrior,fury,6,2,4
26083,Hördê,zuljin,192,warrior,fury,6,2,4
26084,Angrethar,tarren-mill,192,warrior,fury,12,2,10
26085,Altroox,malorne,192,warrior,fury,12,2,10
26086,Sycon,chamber-of-aspects,192,warrior,fury,12,2,10
26087,Pakusrage,defias-brotherhood,192,warrior,fury,12,2,10
26088,Arzes,draenor,192,warrior,fury,12,2,10
26089,Mane,thunderhorn,191,warrior,fury,6,2,4
26090,Торакусу,gordunni,191,warrior,fury,6,2,4
26091,Dorinaz,die-aldor,191,warrior,fury,6,2,4
26092,Omosha,burning-legion,191,warrior,fury,6,2,4
26093,Tömahawk,defias-brotherhood,191,warrior,fury,6,2,4
26094,Кереешка,howling-fjord,175,warrior,fury,11,2,9
26095,Brülldozer,kargath,159,warrior,fury,5,2,3
26096,Mybigcow,darkspear,159,warrior,fury,5,2,3
26097,Æxcoast,ravencrest,128,warrior,fury,4,2,2
26098,Krunchä,ragnaros,96,warrior,fury,3,2,1
26099,Wanzzeur,hyjal,96,warrior,fury,6,1,5
26100,Zyn,outland,96,warrior,fury,6,1,5
26101,Swordluw,argent-dawn,96,warrior,fury,6,1,5
26102,Juanvaco,tarren-mill,96,warrior,fury,6,1,5
26103,Naspy,stormscale,96,warrior,fury,6,1,5
26104,Spacemachine,kazzak,96,warrior,fury,6,1,5
26105,Mot,terenas,96,warrior,fury,6,1,5
26106,Dp,area-52,96,warrior,fury,6,1,5
26107,Dauderup,aerie-peak,96,warrior,fury,6,1,5
26108,Galenthor,ravencrest,96,warrior,fury,6,1,5
26109,Utharis,stormscale,96,warrior,fury,6,1,5
26110,Bladewound,draenor,96,warrior,fury,6,1,5
26111,Riptide,aggra-português,96,warrior,fury,6,1,5
26112,Greekazi,kazzak,96,warrior,fury,6,1,5
26113,Фиббоначи,deathguard,96,warrior,fury,6,1,5
26114,Temprament,ravencrest,96,warrior,fury,6,1,5
26115,Армапипец,soulflayer,96,warrior,fury,6,1,5
26116,Raakalainen,vashj,96,warrior,fury,6,1,5
26117,Feltias,drakthul,96,warrior,fury,6,1,5
26118,Azrail,xavius,96,warrior,fury,6,1,5
26119,Ruuddy,draenor,96,warrior,fury,6,1,5
26120,Furyfame,darksorrow,96,warrior,fury,6,1,5
26121,Marícan,blackmoore,96,warrior,fury,6,1,5
26122,Moldamis,blackhand,96,warrior,fury,6,1,5
26123,Dolora,ragnaros,96,warrior,fury,6,1,5
26124,Coldstory,draenor,96,warrior,fury,6,1,5
26125,Albabhaltair,quelthalas,96,warrior,fury,6,1,5
26126,Raixxon,ragnaros,96,warrior,fury,6,1,5
26127,Stratic,blackmoore,96,warrior,fury,6,1,5
26128,Sorkk,kazzak,96,warrior,fury,6,1,5
26129,Hágríd,ragnaros,96,warrior,fury,12,1,11
26130,Pitii,burning-legion,63,warrior,fury,2,2,0
26131,Хоркан,blackscar,31,warrior,fury,2,1,1
26132,Vivrya,silvermoon,31,warrior,fury,2,1,1
26133,Thomasman,nerathor,2148,warrior,arms,84,45,39
26134,Marcus,ravencrest,2144,warrior,arms,90,46,44
26135,Réckx,twisting-nether,2136,warrior,arms,69,39,30
26136,Blîxtgordon,tarren-mill,2133,warrior,arms,78,42,36
26137,Palianytsia,ravencrest,2125,warrior,arms,77,40,37
26138,Noragrets,stormscale,2116,warrior,arms,80,41,39
26139,Regnarok,sylvanas,2115,warrior,arms,154,90,64
26140,Dunecrab,tarren-mill,2112,warrior,arms,66,45,21
26141,Grkpwh,silvermoon,2105,warrior,arms,88,48,40
26142,Immørtálx,tarren-mill,2102,warrior,arms,72,38,34
26143,Mitu,sanguino,2096,warrior,arms,203,107,96
26144,Скварх,howling-fjord,2095,warrior,arms,102,64,38
26145,Midgetdamis,blackhand,2093,warrior,arms,78,56,22
26146,Elwarroo,dun-modr,2083,warrior,arms,124,71,53
26147,Nikkí,naxxramas,2074,warrior,arms,96,50,46
26148,Кокдиллак,soulflayer,2073,warrior,arms,122,62,60
26149,Комочекгнева,howling-fjord,2052,warrior,arms,73,42,31
26150,Ulrid,draenor,2052,warrior,arms,66,36,30
26151,Оркабал,howling-fjord,2045,warrior,arms,124,68,56
26152,Sickjackenn,executus,2038,warrior,arms,87,41,46
26153,Savesta,dalaran,2030,warrior,arms,138,71,67
26154,Gabrijel,draenor,2021,warrior,arms,77,38,39
26155,Gewyon,ragnaros,2009,warrior,arms,54,31,23
26156,Scardrex,defias-brotherhood,2008,warrior,arms,70,37,33
26157,Trâshwarriør,blackhand,1998,warrior,arms,62,27,35
26158,Manaskhan,tarren-mill,1985,warrior,arms,90,49,41
26159,Alegral,ravencrest,1973,warrior,arms,99,49,50
26160,Pentagramlol,twisting-nether,1955,warrior,arms,64,34,30
26161,Zak,stormscale,1955,warrior,arms,78,37,41
26162,Disarmed,auchindoun,1945,warrior,arms,54,31,23
26163,Myonmyonmyon,blackmoore,1937,warrior,arms,68,41,27
26164,Wràthfúl,kazzak,1937,warrior,arms,119,60,59
26165,Seifcham,ragnaros,1926,warrior,arms,72,35,37
26166,Kapuchino,twisting-nether,1921,warrior,arms,48,27,21
26167,Cerry,ravencrest,1919,warrior,arms,81,39,42
26168,Вэшикх,soulflayer,1913,warrior,arms,65,34,31
26169,Merked,kazzak,1912,warrior,arms,60,31,29
26170,Timpey,kazzak,1911,warrior,arms,54,30,24
26171,Naronnas,drakthul,1910,warrior,arms,104,58,46
26172,Pivcuga,kazzak,1901,warrior,arms,128,67,61
26173,Julololo,archimonde,1893,warrior,arms,72,40,32
26174,Courageous,ravencrest,1889,warrior,arms,66,39,27
26175,Ástriax,ravencrest,1888,warrior,arms,135,68,67
26176,Drclapit,blackrock,1884,warrior,arms,42,23,19
26177,Theryk,sanguino,1884,warrior,arms,77,34,43
26178,Qtcockxx,stormscale,1883,warrior,arms,54,27,27
26179,Sagethi,blackrock,1883,warrior,arms,77,37,40
26180,Schaufelørc,blackrock,1881,warrior,arms,60,31,29
26181,Куесэс,howling-fjord,1880,warrior,arms,36,20,16
26182,Cathériné,drakthul,1875,warrior,arms,48,27,21
26183,Doomqt,terokkar,1873,warrior,arms,47,27,20
26184,Хэйре,howling-fjord,1873,warrior,arms,119,64,55
26185,Hellguard,archimonde,1872,warrior,arms,84,47,37
26186,Emix,arygos,1871,warrior,arms,54,31,23
26187,Karny,ravencrest,1870,warrior,arms,48,31,17
26188,Bigboomer,frostmane,1861,warrior,arms,72,31,41
26189,Длоордпро,soulflayer,1859,warrior,arms,41,20,21
26190,Sekwar,twisting-nether,1858,warrior,arms,42,21,21
26191,Брокскрим,soulflayer,1854,warrior,arms,54,28,26
26192,Mômsboy,tarren-mill,1853,warrior,arms,64,33,31
26193,Ланро,gordunni,1853,warrior,arms,65,33,32
26194,Skorm,mugthol,1849,warrior,arms,36,27,9
26195,Thenx,tarren-mill,1849,warrior,arms,63,30,33
26196,Krônm,dun-modr,1847,warrior,arms,78,33,45
26197,Messermozart,blackmoore,1844,warrior,arms,48,25,23
26198,Daredevìl,eredar,1843,warrior,arms,83,40,43
26199,Xvlanter,silvermoon,1841,warrior,arms,78,41,37
26200,Jriddyzug,ravencrest,1840,warrior,arms,62,33,29
26201,Хиро,deathweaver,1839,warrior,arms,54,27,27
26202,Ozrenac,kazzak,1838,warrior,arms,60,34,26
26203,Ässholedamis,blackhand,1837,warrior,arms,48,35,13
26204,Sneakydrm,kazzak,1837,warrior,arms,40,23,17
26205,Khalimov,tarren-mill,1837,warrior,arms,90,48,42
26206,Gguts,archimonde,1836,warrior,arms,67,37,30
26207,Вандэрбой,howling-fjord,1836,warrior,arms,102,48,54
26208,Аэска,deathweaver,1836,warrior,arms,60,28,32
26209,Tozzhug,ragnaros,1835,warrior,arms,48,28,20
26210,Chaddimus,draenor,1833,warrior,arms,42,28,14
26211,Bàrbandit,archimonde,1832,warrior,arms,42,24,18
26212,Blåvingad,kazzak,1831,warrior,arms,56,34,22
26213,Боссберс,soulflayer,1831,warrior,arms,89,44,45
26214,Watrux,outland,1831,warrior,arms,66,31,35
26215,Khÿze,ysondre,1829,warrior,arms,58,39,19
26216,Rhâpsodyw,ravencrest,1829,warrior,arms,48,29,19
26217,Agoen,silvermoon,1829,warrior,arms,48,23,25
26218,Бодибилдерыч,gordunni,1828,warrior,arms,89,50,39
26219,Aerês,tarren-mill,1828,warrior,arms,90,45,45
26220,Kamked,burning-legion,1828,warrior,arms,107,50,57
26221,Blazefüry,ravencrest,1827,warrior,arms,61,33,28
26222,Jenkinzz,stormscale,1826,warrior,arms,36,23,13
26223,Варбоссец,soulflayer,1825,warrior,arms,66,35,31
26224,Lanstus,silvermoon,1823,warrior,arms,72,42,30
26225,Crîxús,silvermoon,1822,warrior,arms,60,25,35
26226,Greenblób,kazzak,1821,warrior,arms,60,25,35
26227,Rngmonster,kazzak,1820,warrior,arms,100,68,32
26228,Uzamaki,bronzebeard,1820,warrior,arms,48,32,16
26229,Knutrex,tarren-mill,1820,warrior,arms,61,35,26
26230,Лилиофаныч,soulflayer,1820,warrior,arms,35,20,15
26231,Лимпс,gordunni,1819,warrior,arms,30,19,11
26232,Флагмэн,gordunni,1819,warrior,arms,65,36,29
26233,Ðênnis,ravencrest,1818,warrior,arms,30,19,11
26234,Pürporcc,archimonde,1818,warrior,arms,97,48,49
26235,Экзекьютлол,soulflayer,1816,warrior,arms,47,25,22
26236,Joéfernandés,sylvanas,1816,warrior,arms,36,19,17
26237,Apacolata,outland,1816,warrior,arms,45,23,22
26238,Gnømércy,stormscale,1815,warrior,arms,36,19,17
26239,Klonyarik,ravencrest,1815,warrior,arms,36,19,17
26240,Thorana,twisting-nether,1814,warrior,arms,59,32,27
26241,Leethal,outland,1814,warrior,arms,60,27,33
26242,Juank,minahonda,1814,warrior,arms,48,21,27
26243,Joeférnandes,ragnaros,1813,warrior,arms,53,28,25
26244,Vic,tarren-mill,1813,warrior,arms,47,20,27
26245,Axinit,blackrock,1811,warrior,arms,42,23,19
26246,Idiotplay,drekthar,1811,warrior,arms,42,19,23
26247,Johnmeadows,ravencrest,1810,warrior,arms,36,23,13
26248,Ðiscordia,blackhand,1810,warrior,arms,84,43,41
26249,Jokkul,tarren-mill,1810,warrior,arms,46,21,25
26250,Connorzw,blackmoore,1809,warrior,arms,36,23,13
26251,Komissarecks,aegwynn,1809,warrior,arms,51,29,22
26252,Oldchap,nordrassil,1807,warrior,arms,48,31,17
26253,Олдборовс,soulflayer,1807,warrior,arms,53,29,24
26254,Bloodhorn,blackhand,1807,warrior,arms,107,54,53
26255,Варзила,blackscar,1807,warrior,arms,53,22,31
26256,Piccante,nemesis,1806,warrior,arms,36,26,10
26257,Wayneson,tarren-mill,1806,warrior,arms,108,58,50
26258,Книфэк,howling-fjord,1806,warrior,arms,76,40,36
26259,Куртфорренс,gordunni,1805,warrior,arms,43,19,24
26260,Toscothegoat,ravencrest,1804,warrior,arms,36,24,12
26261,Çatàclysmíc,kazzak,1804,warrior,arms,60,30,30
26262,Zheaks,kazzak,1804,warrior,arms,60,30,30
26263,Hanìbal,ravencrest,1803,warrior,arms,60,32,28
26264,Ghakra,kazzak,1802,warrior,arms,36,25,11
26265,Маклецкий,gordunni,1802,warrior,arms,144,68,76
26266,Zombossio,tarren-mill,1801,warrior,arms,62,33,29
26267,Phalek,argent-dawn,1800,warrior,arms,48,28,20
26268,Shortcvnt,ravencrest,1800,warrior,arms,48,28,20
26269,Azudaddy,blackmoore,1800,warrior,arms,59,34,25
26270,Böggzbunny,tarren-mill,1800,warrior,arms,42,24,18
26271,Dairøx,blackrock,1800,warrior,arms,60,31,29
26272,Oswáld,defias-brotherhood,1793,warrior,arms,24,19,5
26273,Maarshl,ysondre,1789,warrior,arms,121,67,54
26274,Ezøn,aegwynn,1786,warrior,arms,59,31,28
26275,Nedåh,blackrock,1785,warrior,arms,36,19,17
26276,Кладбошаа,gordunni,1779,warrior,arms,77,45,32
26277,Selenez,outland,1779,warrior,arms,67,30,37
26278,Zcell,kazzak,1776,warrior,arms,30,21,9
26279,Shookyx,ravencrest,1775,warrior,arms,42,24,18
26280,Stupidz,hyjal,1773,warrior,arms,48,21,27
26281,Kiyomaro,stormscale,1771,warrior,arms,48,25,23
26282,Gatts,krasus,1770,warrior,arms,137,65,72
26283,Cherserker,ragnaros,1767,warrior,arms,58,34,24
26284,Poolboyx,tarren-mill,1767,warrior,arms,87,48,39
26285,Enøt,kazzak,1767,warrior,arms,41,20,21
26286,Zhangbeihai,ravencrest,1766,warrior,arms,54,26,28
26287,Eidzo,tarren-mill,1765,warrior,arms,36,22,14
26288,Барсток,soulflayer,1765,warrior,arms,66,34,32
26289,Hulkensmash,kazzak,1765,warrior,arms,163,82,81
26290,Вокилог,soulflayer,1765,warrior,arms,197,98,99
26291,Chucho,argent-dawn,1761,warrior,arms,48,26,22
26292,Shilix,twisting-nether,1758,warrior,arms,91,38,53
26293,Мелькорт,gordunni,1755,warrior,arms,36,25,11
26294,Voxz,stormscale,1755,warrior,arms,141,70,71
26295,Yosiwa,draenor,1753,warrior,arms,60,36,24
26296,Шурпач,deathguard,1753,warrior,arms,42,20,22
26297,Cleaver,tarren-mill,1752,warrior,arms,54,29,25
26298,Ущипнузатитю,deathguard,1752,warrior,arms,66,29,37
26299,Pj,sanguino,1750,warrior,arms,68,30,38
26300,Воинлета,howling-fjord,1748,warrior,arms,91,52,39
26301,Nozuki,archimonde,1747,warrior,arms,167,84,83
26302,Gigadot,arathor,1743,warrior,arms,156,80,76
26303,Mojotsche,taerar,1738,warrior,arms,64,36,28
26304,Cesr,bloodhoof,1738,warrior,arms,106,47,59
26305,Cisataker,hyjal,1737,warrior,arms,24,20,4
26306,Rageco,ravencrest,1737,warrior,arms,48,31,17
26307,Nitheriá,draenor,1734,warrior,arms,221,112,109
26308,Galeron,kazzak,1734,warrior,arms,48,22,26
26309,Троммтар,howling-fjord,1733,warrior,arms,72,29,43
26310,Magnî,auchindoun,1731,warrior,arms,54,29,25
26311,Jengaa,draenor,1731,warrior,arms,78,40,38
26312,Оксенфурт,soulflayer,1731,warrior,arms,60,28,32
26313,Xgs,archimonde,1728,warrior,arms,119,63,56
26314,Sharpen,chamber-of-aspects,1727,warrior,arms,62,26,36
26315,Dõxqt,kazzak,1726,warrior,arms,44,24,20
26316,Donquiexote,ravencrest,1725,warrior,arms,48,29,19
26317,Yorgal,arakarahm,1723,warrior,arms,36,18,18
26318,Dannyp,twisting-nether,1722,warrior,arms,36,18,18
26319,Mystylez,silvermoon,1720,warrior,arms,48,22,26
26320,Flinta,blackmoore,1719,warrior,arms,36,20,16
26321,Омепразол,gordunni,1719,warrior,arms,119,62,57
26322,Гатсберсерк,gordunni,1718,warrior,arms,119,64,55
26323,Urasli,doomhammer,1717,warrior,arms,42,24,18
26324,Xxeqtr,kazzak,1717,warrior,arms,53,26,27
26325,Gucciwarrior,blackhand,1716,warrior,arms,66,26,40
26326,Arkataz,argent-dawn,1715,warrior,arms,60,30,30
26327,Kaieh,argent-dawn,1713,warrior,arms,36,23,13
26328,Ридиусх,gordunni,1713,warrior,arms,30,18,12
26329,ßloodz,hyjal,1712,warrior,arms,54,27,27
26330,Lyriae,argent-dawn,1711,warrior,arms,60,34,26
26331,Robou,hyjal,1711,warrior,arms,92,39,53
26332,Ítikovan,aegwynn,1710,warrior,arms,127,61,66
26333,Karuck,tarren-mill,1709,warrior,arms,30,19,11
26334,Otp,ravencrest,1708,warrior,arms,42,22,20
26335,Grimlok,sylvanas,1708,warrior,arms,47,21,26
26336,Caméltoe,frostwolf,1707,warrior,arms,66,32,34
26337,Wardruine,dun-modr,1704,warrior,arms,107,52,55
26338,Palmsweaty,stormrage,1704,warrior,arms,60,24,36
26339,Thrux,dalaran,1701,warrior,arms,36,26,10
26340,Wasro,norgannon,1701,warrior,arms,48,25,23
26341,Therealman,kazzak,1699,warrior,arms,38,23,15
26342,Klonyarika,ravencrest,1699,warrior,arms,36,20,16
26343,Fràgile,ravencrest,1699,warrior,arms,54,28,26
26344,Yellowjuice,stormscale,1697,warrior,arms,126,74,52
26345,Bigboyx,kazzak,1697,warrior,arms,38,21,17
26346,Dríx,hyjal,1697,warrior,arms,54,29,25
26347,Dnoire,ravencrest,1697,warrior,arms,48,21,27
26348,Ragëë,tarren-mill,1696,warrior,arms,48,31,17
26349,Vratranzhul,kirin-tor,1695,warrior,arms,144,75,69
26350,Jakim,tarren-mill,1694,warrior,arms,90,48,42
26351,Riptack,anetheron,1693,warrior,arms,104,62,42
26352,Balltas,drakthul,1693,warrior,arms,56,28,28
26353,Hasbullá,kazzak,1693,warrior,arms,86,42,44
26354,Maldark,scarshield-legion,1693,warrior,arms,94,44,50
26355,Вуриор,howling-fjord,1692,warrior,arms,84,44,40
26356,Sørêy,aegwynn,1691,warrior,arms,36,25,11
26357,Grántor,eredar,1691,warrior,arms,42,29,13
26358,Oluwafunmila,tarren-mill,1691,warrior,arms,50,26,24
26359,Дайбайхенд,howling-fjord,1691,warrior,arms,60,30,30
26360,Bôlufonâ,dun-modr,1690,warrior,arms,47,25,22
26361,Quotx,stormscale,1690,warrior,arms,58,23,35
26362,Trôth,kazzak,1689,warrior,arms,30,20,10
26363,Фелпир,soulflayer,1688,warrior,arms,96,56,40
26364,Ønogal,archimonde,1687,warrior,arms,48,23,25
26365,Crandalius,kazzak,1686,warrior,arms,81,49,32
26366,Xiiver,burning-legion,1685,warrior,arms,68,41,27
26367,Pazùzu,twisting-nether,1684,warrior,arms,54,24,30
26368,Spártacus,kazzak,1683,warrior,arms,76,33,43
26369,Nargez,outland,1682,warrior,arms,36,22,14
26370,Toroespaña,draenor,1682,warrior,arms,54,30,24
26371,Rbbx,tarren-mill,1682,warrior,arms,44,24,20
26372,Skädy,dun-modr,1682,warrior,arms,36,18,18
26373,Cerßere,archimonde,1682,warrior,arms,72,33,39
26374,Shooky,blackrock,1681,warrior,arms,41,22,19
26375,Warmâchine,burning-legion,1681,warrior,arms,102,47,55
26376,Rumer,tarren-mill,1679,warrior,arms,41,20,21
26377,Solezte,tarren-mill,1678,warrior,arms,84,50,34
26378,Аоетакси,soulflayer,1678,warrior,arms,66,34,32
26379,Reckqtw,eredar,1677,warrior,arms,48,25,23
26380,Thyréc,blackmoore,1676,warrior,arms,48,24,24
26381,Reccey,blackrock,1675,warrior,arms,105,50,55
26382,Aeyon,burning-blade,1672,warrior,arms,33,20,13
26383,Woobaby,outland,1672,warrior,arms,54,30,24
26384,Odenscolddry,kazzak,1672,warrior,arms,65,32,33
26385,Mazaharine,archimonde,1671,warrior,arms,42,20,22
26386,Yelanx,twisting-nether,1670,warrior,arms,36,25,11
26387,Sahl,sylvanas,1669,warrior,arms,93,50,43
26388,Шагах,soulflayer,1669,warrior,arms,89,44,45
26389,Xendyo,frostmourne,1669,warrior,arms,84,38,46
26390,Klearr,silvermoon,1668,warrior,arms,48,28,20
26391,Khanox,twisting-nether,1668,warrior,arms,54,29,25
26392,Picciocino,nemesis,1668,warrior,arms,70,28,42
26393,Nikoma,silvermoon,1667,warrior,arms,36,20,16
26394,Туранк,howling-fjord,1667,warrior,arms,49,26,23
26395,Кибервайфу,howling-fjord,1665,warrior,arms,30,21,9
26396,Mirageous,tarren-mill,1664,warrior,arms,53,25,28
26397,Drilley,blackmoore,1663,warrior,arms,32,20,12
26398,Nardoch,archimonde,1663,warrior,arms,46,23,23
26399,Mortalfist,stormscale,1662,warrior,arms,31,19,12
26400,Maikouyes,archimonde,1662,warrior,arms,48,26,22
26401,Kelhim,blackrock,1659,warrior,arms,48,26,22
26402,Киссмиплис,gordunni,1655,warrior,arms,57,29,28
26403,Asquare,stormscale,1655,warrior,arms,40,18,22
26404,Spartaz,eredar,1653,warrior,arms,60,28,32
26405,Javakt,stormscale,1649,warrior,arms,54,22,32
26406,Kobeni,ysondre,1646,warrior,arms,59,29,30
26407,Fruitdealer,shattrath,1646,warrior,arms,55,23,32
26408,Поршекаен,howling-fjord,1645,warrior,arms,71,29,42
26409,Untiltèd,ravencrest,1644,warrior,arms,77,55,22
26410,Flaãy,ravencrest,1644,warrior,arms,88,50,38
26411,Gigasmash,pozzo-delleternità,1640,warrior,arms,102,50,52
26412,Renwíck,burning-legion,1639,warrior,arms,35,18,17
26413,Фенилэфрин,gordunni,1639,warrior,arms,110,56,54
26414,Морнстар,gordunni,1638,warrior,arms,40,20,20
26415,Atlizz,twisting-nether,1635,warrior,arms,78,41,37
26416,Krew,drakthul,1634,warrior,arms,66,33,33
26417,Spijkerbroek,alakir,1633,warrior,arms,83,46,37
26418,Lyroe,blackrock,1633,warrior,arms,42,21,21
26419,Reapo,blackhand,1632,warrior,arms,137,67,70
26420,Lyes,uldaman,1631,warrior,arms,113,57,56
26421,Blayr,tarren-mill,1631,warrior,arms,71,33,38
26422,Атаир,deathweaver,1630,warrior,arms,58,30,28
26423,Wargoth,draenor,1627,warrior,arms,22,18,4
26424,Facestomper,onyxia,1627,warrior,arms,66,37,29
26425,Zëhef,hyjal,1626,warrior,arms,42,26,16
26426,Ebonheart,argent-dawn,1626,warrior,arms,104,50,54
26427,Amokdamis,blackhand,1626,warrior,arms,45,21,24
26428,Æriø,dalaran,1624,warrior,arms,30,17,13
26429,Civok,kult-der-verdammten,1624,warrior,arms,30,17,13
26430,Watashilfy,ravencrest,1624,warrior,arms,48,24,24
26431,Wlãð,archimonde,1624,warrior,arms,48,23,25
26432,Frozenliøn,twisting-nether,1624,warrior,arms,42,19,23
26433,Донтрелиз,howling-fjord,1622,warrior,arms,42,22,20
26434,Мастерион,soulflayer,1622,warrior,arms,54,28,26
26435,Malebolia,mugthol,1622,warrior,arms,93,47,46
26436,Sefty,tarren-mill,1622,warrior,arms,35,17,18
26437,Asenine,sylvanas,1621,warrior,arms,193,91,102
26438,Aeldran,argent-dawn,1617,warrior,arms,42,23,19
26439,Дроктул,howling-fjord,1617,warrior,arms,137,64,73
26440,Gladius,ysera,1615,warrior,arms,86,43,43
26441,Cazaril,kazzak,1615,warrior,arms,119,57,62
26442,Марльин,howling-fjord,1615,warrior,arms,36,17,19
26443,Zexa,tarren-mill,1615,warrior,arms,36,17,19
26444,Manoito,argent-dawn,1615,warrior,arms,48,22,26
26445,Damagz,tarren-mill,1615,warrior,arms,53,22,31
26446,Ðezia,tarren-mill,1614,warrior,arms,84,45,39
26447,Regnarøk,sylvanas,1614,warrior,arms,35,18,17
26448,Гримг,lich-king,1610,warrior,arms,51,25,26
26449,Benzemá,sanguino,1609,warrior,arms,24,17,7
26450,Strife,ravencrest,1609,warrior,arms,81,51,30
26451,Vallahan,argent-dawn,1609,warrior,arms,143,72,71
26452,Wismerx,kazzak,1609,warrior,arms,42,20,22
26453,Whoosah,ragnaros,1608,warrior,arms,105,54,51
26454,Кофесмолоком,ashenvale,1608,warrior,arms,53,20,33
26455,Jambaz,ravencrest,1607,warrior,arms,47,23,24
26456,Дугмар,gordunni,1607,warrior,arms,105,50,55
26457,Ryle,anubarak,1607,warrior,arms,72,34,38
26458,Erikeverhard,nathrezim,1607,warrior,arms,36,17,19
26459,Белхэнд,soulflayer,1607,warrior,arms,56,23,33
26460,Штурмгешутц,deathweaver,1605,warrior,arms,96,51,45
26461,Haraldjuhnke,frostwolf,1605,warrior,arms,53,27,26
26462,Nerfmyrage,hyjal,1603,warrior,arms,30,20,10
26463,Андреевич,blackscar,1603,warrior,arms,140,71,69
26464,Batïk,blackmoore,1603,warrior,arms,71,31,40
26465,Eselhirte,blackmoore,1602,warrior,arms,85,46,39
26466,Хэлслэйтэр,gordunni,1602,warrior,arms,118,61,57
26467,Kupr,outland,1601,warrior,arms,40,21,19
26468,Ragnou,tarren-mill,1601,warrior,arms,54,27,27
26469,Naait,draenor,1600,warrior,arms,45,24,21
26470,Lrb,tarren-mill,1600,warrior,arms,46,23,23
26471,Trashman,bronzebeard,1598,warrior,arms,66,32,34
26472,Hellespont,hellscream,1598,warrior,arms,65,24,41
26473,Луновоин,gordunni,1597,warrior,arms,36,24,12
26474,Вагранна,soulflayer,1597,warrior,arms,54,26,28
26475,Sonìe,kazzak,1595,warrior,arms,71,45,26
26476,Shirøx,blackrock,1595,warrior,arms,67,38,29
26477,Giganza,outland,1595,warrior,arms,60,27,33
26478,Бурчун,deathguard,1594,warrior,arms,54,34,20
26479,Sorkk,kazzak,1593,warrior,arms,36,19,17
26480,Rakuna,tarren-mill,1592,warrior,arms,60,30,30
26481,Haanok,ravencrest,1591,warrior,arms,59,34,25
26482,Bruxus,blackhand,1590,warrior,arms,118,59,59
26483,Everdipper,outland,1590,warrior,arms,48,20,28
26484,Aestheticon,burning-blade,1589,warrior,arms,30,19,11
26485,Grezlyk,drakthul,1589,warrior,arms,42,20,22
26486,Lazytowl,outland,1588,warrior,arms,69,34,35
26487,Alexandrrior,rexxar,1588,warrior,arms,66,31,35
26488,Btr,archimonde,1588,warrior,arms,42,19,23
26489,Paranoiás,ragnaros,1588,warrior,arms,44,19,25
26490,Mckinseybcg,outland,1585,warrior,arms,30,21,9
26491,Friskos,dalaran,1585,warrior,arms,64,32,32
26492,Skrawarr,das-syndikat,1584,warrior,arms,78,41,37
26493,Hortswarr,drakthul,1582,warrior,arms,37,24,13
26494,Fragmeista,ragnaros,1582,warrior,arms,36,17,19
26495,Krigipigi,antonidas,1582,warrior,arms,48,20,28
26496,Samîr,arthas,1578,warrior,arms,30,17,13
26497,Lockmagewar,burning-legion,1577,warrior,arms,39,20,19
26498,Taistelumage,stormreaver,1576,warrior,arms,35,17,18
26499,Dógmòdex,stormscale,1575,warrior,arms,30,20,10
26500,Mypzo,kazzak,1575,warrior,arms,66,31,35
26501,Erotixboi,blackrock,1573,warrior,arms,48,29,19
26502,Оргнар,ashenvale,1573,warrior,arms,48,27,21
26503,Monbun,silvermoon,1570,warrior,arms,101,51,50
26504,Rîdler,ravencrest,1569,warrior,arms,193,97,96
26505,Yeahq,kazzak,1569,warrior,arms,42,19,23
26506,Thundersword,sylvanas,1567,warrior,arms,48,18,30
26507,Дейдулус,soulflayer,1566,warrior,arms,60,24,36
26508,Serastul,rajaxx,1565,warrior,arms,86,42,44
26509,Tyrasîà,hyjal,1565,warrior,arms,48,18,30
26510,Едигейй,gordunni,1564,warrior,arms,58,32,26
26511,Gozga,twisting-nether,1564,warrior,arms,75,39,36
26512,Istyos,hyjal,1563,warrior,arms,42,18,24
26513,Bloodbrother,blackmoore,1562,warrior,arms,36,20,16
26514,Pajalousta,elune,1562,warrior,arms,74,36,38
26515,Daýz,draenor,1561,warrior,arms,48,18,30
26516,Lollydhur,nemesis,1559,warrior,arms,24,17,7
26517,Darksídex,silvermoon,1559,warrior,arms,152,79,73
26518,Zhoti,outland,1559,warrior,arms,34,17,17
26519,Anthalar,argent-dawn,1559,warrior,arms,42,19,23
26520,Imfiñe,outland,1558,warrior,arms,107,51,56
26521,Boldinq,ravencrest,1556,warrior,arms,78,31,47
26522,Arandyr,archimonde,1553,warrior,arms,42,18,24
26523,Reider,twisting-nether,1553,warrior,arms,119,47,72
26524,Nevergladx,kazzak,1551,warrior,arms,42,19,23
26525,Genjutsubeat,blackmoore,1548,warrior,arms,48,28,20
26526,Pangowar,elune,1548,warrior,arms,33,17,16
26527,Brizeis,malganis,1548,warrior,arms,36,17,19
26528,Banîsher,drakthul,1548,warrior,arms,53,19,34
26529,Philatou,antonidas,1547,warrior,arms,35,20,15
26530,Nightmareowl,tarren-mill,1547,warrior,arms,42,19,23
26531,Blackfrosty,stormscale,1545,warrior,arms,44,23,21
26532,Mazutov,outland,1542,warrior,arms,24,17,7
26533,Wrynir,archimonde,1541,warrior,arms,78,38,40
26534,Blackwólf,bloodhoof,1541,warrior,arms,106,50,56
26535,Pachipachi,blackmoore,1540,warrior,arms,32,17,15
26536,Оргрриммар,soulflayer,1540,warrior,arms,168,80,88
26537,Гуорг,howling-fjord,1538,warrior,arms,75,32,43
26538,Kurbá,stormscale,1535,warrior,arms,24,16,8
26539,Anakhas,archimonde,1535,warrior,arms,30,16,14
26540,Bluto,dunemaul,1534,warrior,arms,30,18,12
26541,Lpa,stormscale,1534,warrior,arms,36,19,17
26542,Gargaflike,aggra-português,1533,warrior,arms,60,22,38
26543,Tiwâz,eredar,1531,warrior,arms,57,29,28
26544,Èzekiel,dalaran,1530,warrior,arms,36,18,18
26545,Áäáäáäáä,aegwynn,1529,warrior,arms,30,16,14
26546,Nyxz,blackhand,1529,warrior,arms,32,17,15
26547,Morthôr,grim-batol,1529,warrior,arms,57,27,30
26548,Громпузан,galakrond,1529,warrior,arms,48,21,27
26549,Чпокерз,gordunni,1528,warrior,arms,48,25,23
26550,Брок,soulflayer,1528,warrior,arms,36,16,20
26551,Gravityfalls,blackmoore,1527,warrior,arms,78,39,39
26552,Киллдекс,gordunni,1527,warrior,arms,72,32,40
26553,Bumoletroll,draenor,1526,warrior,arms,33,17,16
26554,Miko,ysondre,1524,warrior,arms,42,20,22
26555,Chargeurface,ragnaros,1522,warrior,arms,24,16,8
26556,Zeddone,drakthul,1522,warrior,arms,30,16,14
26557,Zheq,ragnaros,1522,warrior,arms,30,16,14
26558,Darshan,grim-batol,1522,warrior,arms,36,16,20
26559,Shrekwarr,kazzak,1521,warrior,arms,95,46,49
26560,Norwegian,silvermoon,1521,warrior,arms,80,37,43
26561,Aurélus,rexxar,1520,warrior,arms,30,20,10
26562,Каосвар,howling-fjord,1520,warrior,arms,24,16,8
26563,Мэйрил,lich-king,1519,warrior,arms,190,99,91
26564,Shownomercy,blackrock,1519,warrior,arms,48,23,25
26565,Arcreign,kazzak,1519,warrior,arms,60,28,32
26566,Authar,tarren-mill,1518,warrior,arms,61,33,28
26567,Spärtan,dun-modr,1515,warrior,arms,66,34,32
26568,Думхаммер,howling-fjord,1514,warrior,arms,47,30,17
26569,Craghak,twisting-nether,1513,warrior,arms,102,52,50
26570,Aizy,blackhand,1510,warrior,arms,24,16,8
26571,Wildblue,sylvanas,1510,warrior,arms,54,30,24
26572,Cyruk,blackmoore,1509,warrior,arms,36,16,20
26573,Трешконтент,gordunni,1508,warrior,arms,36,17,19
26574,Chromoly,aegwynn,1508,warrior,arms,36,16,20
26575,Кефтеме,fordragon,1507,warrior,arms,69,35,34
26576,Raakalainen,vashj,1505,warrior,arms,41,20,21
26577,Savh,silvermoon,1503,warrior,arms,36,22,14
26578,Gely,silvermoon,1503,warrior,arms,36,17,19
26579,Варгана,soulflayer,1502,warrior,arms,46,24,22
26580,Sumprunkare,stormscale,1502,warrior,arms,35,18,17
26581,Nighat,sanguino,1500,warrior,arms,152,77,75
26582,Svënja,ysondre,1496,warrior,arms,84,37,47
26583,Dragoons,tyrande,1495,warrior,arms,36,16,20
26584,Slidmacka,twisting-nether,1495,warrior,arms,97,42,55
26585,Llestatl,hyjal,1494,warrior,arms,59,32,27
26586,Nameless,ysondre,1492,warrior,arms,30,16,14
26587,Divyx,tarren-mill,1491,warrior,arms,60,31,29
26588,Pumpadzhîja,outland,1491,warrior,arms,66,32,34
26589,Romanul,terokkar,1490,warrior,arms,42,20,22
26590,Bastrick,argent-dawn,1490,warrior,arms,69,32,37
26591,Hôrn,stormscale,1489,warrior,arms,54,32,22
26592,Endeawour,ravencrest,1489,warrior,arms,129,75,54
26593,Hefthyn,sanguino,1488,warrior,arms,36,20,16
26594,Massiveape,argent-dawn,1488,warrior,arms,30,16,14
26595,Gorocpt,doomhammer,1488,warrior,arms,44,20,24
26596,Hindbærsaft,stormscale,1487,warrior,arms,55,32,23
26597,Мускулатор,soulflayer,1487,warrior,arms,60,30,30
26598,Lizzybigtits,kazzak,1486,warrior,arms,42,25,17
26599,Заверчу,soulflayer,1485,warrior,arms,30,17,13
26600,Çon,ravencrest,1485,warrior,arms,85,39,46
26601,Franzbardon,archimonde,1482,warrior,arms,42,23,19
26602,Scrèàm,tarren-mill,1481,warrior,arms,42,22,20
26603,Арткес,gordunni,1477,warrior,arms,45,23,22
26604,Trenbullone,kazzak,1476,warrior,arms,51,32,19
26605,Varyian,sporeggar,1475,warrior,arms,119,54,65
26606,Geforce,hellscream,1474,warrior,arms,48,21,27
26607,Gromkarg,draenor,1474,warrior,arms,42,16,26
26608,Leomance,hyjal,1473,warrior,arms,30,18,12
26609,Icekissx,hyjal,1473,warrior,arms,76,37,39
26610,Phenowarri,blackhand,1470,warrior,arms,73,39,34
26611,Tmp,blackrock,1470,warrior,arms,42,22,20
26612,Clellin,silvermoon,1469,warrior,arms,75,37,38
26613,Dárkhammer,tarren-mill,1465,warrior,arms,54,24,30
26614,Raley,ragnaros,1464,warrior,arms,54,26,28
26615,Notinfa,draenor,1460,warrior,arms,54,30,24
26616,Cutting,burning-legion,1459,warrior,arms,35,18,17
26617,Ordwinz,silvermoon,1458,warrior,arms,55,29,26
26618,Togas,silvermoon,1456,warrior,arms,99,51,48
26619,Furukawa,ravencrest,1456,warrior,arms,36,16,20
26620,Ckz,ysondre,1455,warrior,arms,24,16,8
26621,Crriminal,ravencrest,1454,warrior,arms,42,17,25
26622,Omgihithard,draenor,1452,warrior,arms,36,17,19
26623,Dzvenyhora,darkspear,1449,warrior,arms,78,36,42
26624,Fizzywarrior,blackmoore,1449,warrior,arms,57,25,32
26625,Norinhell,ravencrest,1448,warrior,arms,48,20,28
26626,Ajax,defias-brotherhood,1447,warrior,arms,36,16,20
26627,Endan,kelthuzad,1446,warrior,arms,66,37,29
26628,Dokô,twisting-nether,1446,warrior,arms,72,36,36
26629,Tyëlin,elune,1446,warrior,arms,77,38,39
26630,Irén,hellfire,1446,warrior,arms,44,20,24
26631,Faustà,nemesis,1445,warrior,arms,54,23,31
26632,Рыгулька,gordunni,1443,warrior,arms,35,16,19
26633,Karimlebrave,hyjal,1440,warrior,arms,68,33,35
26634,Markers,twisting-nether,1439,warrior,arms,30,15,15
26635,Doxinator,silvermoon,1439,warrior,arms,75,31,44
26636,Makerrw,ravencrest,1438,warrior,arms,50,26,24
26637,Ardmoo,burning-legion,1437,warrior,arms,39,20,19
26638,Ганблейд,eversong,1437,warrior,arms,47,19,28
26639,Alyx,mugthol,1436,warrior,arms,66,33,33
26640,Mazzkze,silvermoon,1435,warrior,arms,180,91,89
26641,Lachandrius,blackhand,1435,warrior,arms,72,33,39
26642,Europ,silvermoon,1435,warrior,arms,36,15,21
26643,Зеленыйжмых,thermaplugg,1434,warrior,arms,33,17,16
26644,Мерсилессх,gordunni,1433,warrior,arms,54,24,30
26645,Pakusrage,defias-brotherhood,1432,warrior,arms,48,21,27
26646,Jínro,draenor,1432,warrior,arms,36,15,21
26647,Otiep,blackmoore,1430,warrior,arms,36,24,12
26648,Dataçasé,silvermoon,1430,warrior,arms,24,15,9
26649,Андэрс,gordunni,1429,warrior,arms,106,51,55
26650,Asuramaru,aegwynn,1428,warrior,arms,47,24,23
26651,Trapoulas,kazzak,1428,warrior,arms,48,15,33
26652,Qvate,twisting-nether,1427,warrior,arms,59,31,28
26653,Alinash,aegwynn,1427,warrior,arms,51,24,27
26654,Kantarion,stormscale,1427,warrior,arms,36,16,20
26655,Pokopo,blackrock,1425,warrior,arms,211,103,108
26656,Marcnky,stormscale,1424,warrior,arms,51,26,25
26657,Напутанность,soulflayer,1422,warrior,arms,251,127,124
26658,Skokuxx,silvermoon,1422,warrior,arms,30,15,15
26659,Icybladez,kazzak,1422,warrior,arms,46,22,24
26660,Smoothbrian,ravencrest,1421,warrior,arms,24,15,9
26661,Nucleargrab,twilights-hammer,1421,warrior,arms,85,42,43
26662,Informatica,doomhammer,1420,warrior,arms,36,18,18
26663,Mljecho,kazzak,1420,warrior,arms,71,35,36
26664,Zellxd,stormscale,1418,warrior,arms,36,20,16
26665,Avelyr,pozzo-delleternità,1418,warrior,arms,30,15,15
26666,Dragão,kazzak,1417,warrior,arms,36,16,20
26667,Nuahka,blackmoore,1416,warrior,arms,28,17,11
26668,Lyarinsky,tyrande,1416,warrior,arms,48,26,22
26669,Madaxe,kazzak,1414,warrior,arms,24,20,4
26670,Altimáte,antonidas,1414,warrior,arms,24,15,9
26671,Дообрыйшмель,soulflayer,1414,warrior,arms,45,28,17
26672,Paow,tarren-mill,1414,warrior,arms,35,16,19
26673,Oruka,mannoroth,1412,warrior,arms,42,24,18
26674,Drushíí,shattrath,1411,warrior,arms,35,17,18
26675,Teronth,burning-legion,1410,warrior,arms,42,15,27
26676,Zerberos,drakthul,1409,warrior,arms,24,15,9
26677,Megtorló,ragnaros,1408,warrior,arms,51,24,27
26678,Stormfist,tarren-mill,1403,warrior,arms,36,19,17
26679,Bjösk,stormscale,1403,warrior,arms,45,23,22
26680,Chakrator,la-croisade-écarlate,1401,warrior,arms,42,20,22
26681,Éls,argent-dawn,1401,warrior,arms,36,17,19
26682,Северот,deepholm,1401,warrior,arms,35,16,19
26683,Diz,terokkar,1400,warrior,arms,67,38,29
26684,Peack,ravencrest,1400,warrior,arms,65,35,30
26685,Джасткипинг,gordunni,1399,warrior,arms,84,45,39
26686,Taylorswifty,twisting-nether,1398,warrior,arms,60,34,26
26687,Абабоба,gordunni,1398,warrior,arms,30,16,14
26688,Zosska,burning-legion,1398,warrior,arms,36,17,19
26689,ßladex,azshara,1395,warrior,arms,35,21,14
26690,Bládez,ravencrest,1394,warrior,arms,66,36,30
26691,Nekerka,burning-legion,1394,warrior,arms,65,33,32
26692,Papipulki,zuljin,1394,warrior,arms,56,23,33
26693,Mgw,blackrock,1393,warrior,arms,24,15,9
26694,Mfdoöm,draenor,1392,warrior,arms,42,16,26
26695,Dranush,onyxia,1391,warrior,arms,68,35,33
26696,Алексвайтт,gordunni,1391,warrior,arms,47,23,24
26697,Hradball,twilights-hammer,1390,warrior,arms,60,28,32
26698,Jumbodolmen,tarren-mill,1389,warrior,arms,30,16,14
26699,Jáson,kazzak,1389,warrior,arms,53,23,30
26700,Tarkosha,terokkar,1388,warrior,arms,192,92,100
26701,Diástasi,twisting-nether,1384,warrior,arms,90,48,42
26702,Dafok,rashgarroth,1384,warrior,arms,36,15,21
26703,Кэфтэмэ,soulflayer,1382,warrior,arms,73,35,38
26704,Malalulu,burning-legion,1382,warrior,arms,101,48,53
26705,Okoru,stormscale,1381,warrior,arms,48,17,31
26706,Qiz,silvermoon,1378,warrior,arms,128,66,62
26707,Xaheld,blackrock,1376,warrior,arms,30,16,14
26708,Temprament,ravencrest,1375,warrior,arms,36,21,15
26709,Beelzebuu,blackhand,1374,warrior,arms,30,17,13
26710,Cléàvage,silvermoon,1374,warrior,arms,81,32,49
26711,Iljaana,blackrock,1373,warrior,arms,48,24,24
26712,Bleckwarrior,ravencrest,1371,warrior,arms,78,39,39
26713,Weareinspace,stormscale,1369,warrior,arms,52,29,23
26714,Mograinê,blackmoore,1368,warrior,arms,60,31,29
26715,Jigsar,argent-dawn,1366,warrior,arms,48,29,19
26716,Gacel,dun-modr,1364,warrior,arms,54,24,30
26717,Ènteqt,antonidas,1361,warrior,arms,31,21,10
26718,Vølverinwar,thrall,1361,warrior,arms,82,37,45
26719,Hatefury,twisting-nether,1360,warrior,arms,78,36,42
26720,Nabul,thunderhorn,1359,warrior,arms,30,16,14
26721,Палачубийца,deathguard,1356,warrior,arms,48,27,21
26722,Bonesz,jaedenar,1356,warrior,arms,63,32,31
26723,Tealbell,chamber-of-aspects,1354,warrior,arms,101,55,46
26724,Bxnx,aegwynn,1353,warrior,arms,36,21,15
26725,Reider,kazzak,1353,warrior,arms,34,16,18
26726,Ormert,sylvanas,1352,warrior,arms,30,16,14
26727,Staribrko,outland,1348,warrior,arms,114,51,63
26728,Einherjer,burning-legion,1346,warrior,arms,58,32,26
26729,Vagor,aegwynn,1346,warrior,arms,42,19,23
26730,Zargor,kazzak,1345,warrior,arms,46,28,18
26731,Pazl,outland,1344,warrior,arms,36,17,19
26732,Belattor,silvermoon,1343,warrior,arms,30,14,16
26733,Colard,ravencrest,1343,warrior,arms,30,14,16
26734,Buyya,ravencrest,1342,warrior,arms,58,31,27
26735,Infernion,jaedenar,1341,warrior,arms,24,14,10
26736,Zzeed,auchindoun,1341,warrior,arms,48,19,29
26737,Zandawar,drakthul,1339,warrior,arms,59,33,26
26738,Pacosky,burning-legion,1339,warrior,arms,45,24,21
26739,Креспекс,soulflayer,1339,warrior,arms,44,14,30
26740,Grahatia,magtheridon,1338,warrior,arms,63,35,28
26741,Nassir,stormscale,1338,warrior,arms,30,14,16
26742,Raixxon,ragnaros,1336,warrior,arms,48,20,28
26743,Taikyokuken,hyjal,1333,warrior,arms,54,24,30
26744,Carras,confrérie-du-thorium,1332,warrior,arms,89,38,51
26745,Ricssonz,burning-legion,1331,warrior,arms,24,14,10
26746,Флэксик,soulflayer,1331,warrior,arms,24,14,10
26747,Mortalik,silvermoon,1330,warrior,arms,139,64,75
26748,Arreat,chogall,1328,warrior,arms,90,36,54
26749,Лисерк,howling-fjord,1328,warrior,arms,36,14,22
26750,Behemothwr,kazzak,1327,warrior,arms,75,37,38
26751,Nàsher,frostwolf,1327,warrior,arms,30,14,16
26752,Greekazi,kazzak,1327,warrior,arms,48,21,27
26753,Chádtóurps,drakthul,1326,warrior,arms,29,14,15
26754,Swefy,sanguino,1326,warrior,arms,139,62,77
26755,Нетконечно,howling-fjord,1325,warrior,arms,30,14,16
26756,Highz,grim-batol,1324,warrior,arms,30,16,14
26757,Fantasý,burning-legion,1324,warrior,arms,35,14,21
26758,Ähäkutti,frostmane,1323,warrior,arms,42,23,19
26759,Gorchak,blackmoore,1323,warrior,arms,113,52,61
26760,Kirowarrior,silvermoon,1322,warrior,arms,34,18,16
26761,Nelthôr,alleria,1321,warrior,arms,71,34,37
26762,Ashiku,zuljin,1321,warrior,arms,54,23,31
26763,Crayz,twisting-nether,1320,warrior,arms,30,14,16
26764,Throck,drakthul,1320,warrior,arms,41,18,23
26765,Неосим,gordunni,1319,warrior,arms,24,15,9
26766,Lostbull,kazzak,1317,warrior,arms,30,14,16
26767,Astven,blackmoore,1316,warrior,arms,40,16,24
26768,Exot,eredar,1315,warrior,arms,36,22,14
26769,Guruntar,kirin-tor,1315,warrior,arms,62,29,33
26770,Ràgnarok,chogall,1314,warrior,arms,60,33,27
26771,Unarde,silvermoon,1314,warrior,arms,137,69,68
26772,Imora,silvermoon,1314,warrior,arms,36,18,18
26773,Kmica,khadgar,1314,warrior,arms,61,27,34
26774,Адво,gordunni,1312,warrior,arms,36,15,21
26775,Lebronjones,sylvanas,1311,warrior,arms,42,21,21
26776,Оморальный,soulflayer,1311,warrior,arms,88,39,49
26777,Malevolént,silvermoon,1310,warrior,arms,48,23,25
26778,Carsannies,stormscale,1310,warrior,arms,48,22,26
26779,Скользкийбро,gordunni,1310,warrior,arms,54,24,30
26780,Гардринг,howling-fjord,1309,warrior,arms,30,17,13
26781,Roctah,auchindoun,1309,warrior,arms,46,24,22
26782,Neverkind,twisting-nether,1307,warrior,arms,66,37,29
26783,Dirtyjoe,khaz-modan,1307,warrior,arms,89,44,45
26784,Tucomessuelo,cthun,1306,warrior,arms,30,15,15
26785,Lyfttokyo,tarren-mill,1306,warrior,arms,42,17,25
26786,Piksitron,silvermoon,1305,warrior,arms,40,28,12
26787,Xunaakt,nemesis,1305,warrior,arms,45,23,22
26788,Bossít,doomhammer,1301,warrior,arms,80,44,36
26789,Jisoowar,blackhand,1301,warrior,arms,36,17,19
26790,Tazdingowar,antonidas,1301,warrior,arms,58,23,35
26791,Агамемнан,soulflayer,1300,warrior,arms,82,40,42
26792,Arithael,dun-modr,1300,warrior,arms,96,46,50
26793,Hobo,ravencrest,1298,warrior,arms,29,14,15
26794,Zaatar,draenor,1296,warrior,arms,54,27,27
26795,Ovcharq,steamwheedle-cartel,1295,warrior,arms,61,31,30
26796,Seliasbro,kazzak,1295,warrior,arms,30,15,15
26797,Сэлфиш,lich-king,1295,warrior,arms,29,14,15
26798,Chippéd,draenor,1294,warrior,arms,23,14,9
26799,Espröc,kazzak,1294,warrior,arms,113,56,57
26800,Ylana,eldrethalas,1291,warrior,arms,51,20,31
26801,Inelegant,tarren-mill,1290,warrior,arms,60,32,28
26802,Ghorglukk,lightnings-blade,1290,warrior,arms,60,28,32
26803,Perkoulator,archimonde,1290,warrior,arms,69,30,39
26804,Huscar,thrall,1290,warrior,arms,35,14,21
26805,Ingensan,lightbringer,1288,warrior,arms,51,22,29
26806,Безбожник,eversong,1286,warrior,arms,30,17,13
26807,Blackbiird,blackmoore,1286,warrior,arms,29,14,15
26808,Zool,madmortem,1285,warrior,arms,45,20,25
26809,Lûckystríké,blackmoore,1283,warrior,arms,46,21,25
26810,Thisguyfax,the-venture-co,1281,warrior,arms,54,27,27
26811,Diggawhat,antonidas,1280,warrior,arms,52,24,28
26812,Гогрикк,ashenvale,1279,warrior,arms,72,35,37
26813,Kloppnîx,blackmoore,1278,warrior,arms,50,31,19
26814,Propanex,kazzak,1276,warrior,arms,33,18,15
26815,Авентадорх,deathguard,1275,warrior,arms,66,21,45
26816,Ragnacore,ravencrest,1274,warrior,arms,41,22,19
26817,Инелутабл,eversong,1273,warrior,arms,23,14,9
26818,Ангрол,grom,1273,warrior,arms,35,14,21
26819,Rahaaxhia,kaelthas,1271,warrior,arms,24,15,9
26820,Дикийппц,gordunni,1271,warrior,arms,24,14,10
26821,Kaîsaschnitt,malganis,1269,warrior,arms,22,14,8
26822,Рестат,soulflayer,1265,warrior,arms,83,31,52
26823,Ranran,emerald-dream,1264,warrior,arms,32,14,18
26824,Colosius,stormscale,1262,warrior,arms,48,29,19
26825,Silabozija,ravencrest,1262,warrior,arms,60,29,31
26826,Sertigan,dun-modr,1262,warrior,arms,39,16,23
26827,Zeroskllz,outland,1257,warrior,arms,58,26,32
26828,Apôlyon,antonidas,1256,warrior,arms,29,14,15
26829,Soulcleaver,stormreaver,1255,warrior,arms,44,23,21
26830,Aggamemnus,ravencrest,1254,warrior,arms,38,23,15
26831,Кентаныч,howling-fjord,1254,warrior,arms,48,22,26
26832,Buntstift,thrall,1254,warrior,arms,42,14,28
26833,Соджиро,howling-fjord,1248,warrior,arms,24,13,11
26834,Semmino,nemesis,1248,warrior,arms,24,13,11
26835,Leroxius,ragnaros,1248,warrior,arms,78,34,44
26836,Kanté,burning-blade,1247,warrior,arms,18,13,5
26837,Leeches,aggramar,1247,warrior,arms,24,13,11
26838,Mastodøntes,hyjal,1247,warrior,arms,30,13,17
26839,Aixer,archimonde,1247,warrior,arms,30,13,17
26840,Абырабыр,howling-fjord,1246,warrior,arms,18,13,5
26841,Fruiittyy,ravencrest,1245,warrior,arms,24,13,11
26842,Nurekin,argent-dawn,1245,warrior,arms,30,13,17
26843,Pummelthru,burning-legion,1244,warrior,arms,30,13,17
26844,Morrzerk,sylvanas,1243,warrior,arms,23,14,9
26845,Zaerna,draenor,1243,warrior,arms,24,13,11
26846,Tinkaton,sylvanas,1243,warrior,arms,30,13,17
26847,Soundso,blackmoore,1242,warrior,arms,26,15,11
26848,Narcx,kazzak,1242,warrior,arms,24,13,11
26849,Nazhar,kult-der-verdammten,1242,warrior,arms,24,13,11
26850,Orn,tarren-mill,1242,warrior,arms,30,13,17
26851,Shiqo,ravencrest,1242,warrior,arms,30,13,17
26852,Кхаррнн,gordunni,1242,warrior,arms,30,13,17
26853,Phóó,thrall,1242,warrior,arms,30,13,17
26854,Nèssa,outland,1242,warrior,arms,30,13,17
26855,Gonutz,sylvanas,1241,warrior,arms,24,13,11
26856,Eyeslicer,quelthalas,1241,warrior,arms,24,13,11
26857,Ðræms,eldrethalas,1241,warrior,arms,60,27,33
26858,Laavapoeg,outland,1240,warrior,arms,24,13,11
26859,Архиватор,gordunni,1239,warrior,arms,24,13,11
26860,Màb,antonidas,1239,warrior,arms,24,13,11
26861,Exoblade,silvermoon,1238,warrior,arms,36,14,22
26862,Vilass,silvermoon,1237,warrior,arms,24,13,11
26863,Rorix,blackrock,1237,warrior,arms,24,13,11
26864,Remen,archimonde,1237,warrior,arms,42,13,29
26865,Tahzwolf,stormscale,1236,warrior,arms,18,13,5
26866,Makgorei,outland,1236,warrior,arms,39,14,25
26867,Endermite,magtheridon,1234,warrior,arms,35,20,15
26868,Plt,talnivarr,1233,warrior,arms,41,25,16
26869,Funknîco,wrathbringer,1233,warrior,arms,37,19,18
26870,Ральдвин,gordunni,1230,warrior,arms,34,17,17
26871,Bráïnléss,silvermoon,1230,warrior,arms,30,13,17
26872,Ахиллслэм,howling-fjord,1228,warrior,arms,35,13,22
26873,Zhulgar,azjolnerub,1227,warrior,arms,30,13,17
26874,Кизуми,gordunni,1227,warrior,arms,33,14,19
26875,Azëlls,archimonde,1225,warrior,arms,82,42,40
26876,Элейд,thermaplugg,1225,warrior,arms,47,23,24
26877,Yuriko,onyxia,1222,warrior,arms,24,13,11
26878,Zøom,ysondre,1222,warrior,arms,40,20,20
26879,Solaría,garona,1222,warrior,arms,30,15,15
26880,Draleckx,sanguino,1222,warrior,arms,94,43,51
26881,Átlás,blackmoore,1222,warrior,arms,37,16,21
26882,Галактозар,soulflayer,1220,warrior,arms,54,22,32
26883,Дрейсен,gordunni,1219,warrior,arms,24,14,10
26884,Tontonsmoky,hyjal,1219,warrior,arms,37,13,24
26885,Raznon,magtheridon,1218,warrior,arms,36,13,23
26886,Kravaiski,argent-dawn,1217,warrior,arms,72,32,40
26887,Joka,dun-modr,1216,warrior,arms,37,19,18
26888,Ghostwarx,blackmoore,1215,warrior,arms,38,19,19
26889,Uclat,archimonde,1215,warrior,arms,42,20,22
26890,Troma,archimonde,1213,warrior,arms,35,13,22
26891,Youokhun,kazzak,1212,warrior,arms,24,13,11
26892,Maggisauce,aegwynn,1209,warrior,arms,57,32,25
26893,Karden,doomhammer,1206,warrior,arms,42,16,26
26894,Lûxn,silvermoon,1204,warrior,arms,116,56,60
26895,Excutíé,twisting-nether,1202,warrior,arms,30,18,12
26896,Beans,argent-dawn,1202,warrior,arms,60,22,38
26897,Aiarm,twisting-nether,1200,warrior,arms,48,31,17
26898,Quarantino,ysondre,1199,warrior,arms,64,30,34
26899,Mañtís,argent-dawn,1198,warrior,arms,80,41,39
26900,Grinrok,thrall,1197,warrior,arms,66,29,37
26901,Mozterwar,ravencrest,1197,warrior,arms,66,28,38
26902,Reapersrage,twisting-nether,1195,warrior,arms,27,13,14
26903,Sway,eonar,1193,warrior,arms,33,15,18
26904,Rèâpèr,kazzak,1192,warrior,arms,36,24,12
26905,Клайминг,soulflayer,1190,warrior,arms,18,13,5
26906,Slaughteredd,kazzak,1190,warrior,arms,48,17,31
26907,Garosh,drakthul,1187,warrior,arms,54,25,29
26908,Pyret,outland,1185,warrior,arms,40,14,26
26909,Sýkz,exodar,1181,warrior,arms,35,13,22
26910,Hellzint,sanguino,1179,warrior,arms,129,50,79
26911,Виднокрай,gordunni,1177,warrior,arms,36,13,23
26912,Elyalol,ragnaros,1174,warrior,arms,33,15,18
26913,Whàtsup,stormscale,1166,warrior,arms,36,17,19
26914,Sistabossen,magtheridon,1165,warrior,arms,24,13,11
26915,Daguangming,outland,1165,warrior,arms,59,23,36
26916,Tercio,exodar,1162,warrior,arms,66,30,36
26917,Kerisandra,silvermoon,1157,warrior,arms,31,18,13
26918,Дрейтон,eversong,1157,warrior,arms,42,20,22
26919,Regna,eredar,1157,warrior,arms,90,42,48
26920,Kurzen,voljin,1153,warrior,arms,30,13,17
26921,Belfodiris,stormscale,1152,warrior,arms,18,12,6
26922,Azotz,archimonde,1152,warrior,arms,24,12,12
26923,Dõxlol,kazzak,1152,warrior,arms,24,12,12
26924,Grimogør,stormscale,1152,warrior,arms,24,12,12
26925,Сладкаяхурма,howling-fjord,1152,warrior,arms,30,12,18
26926,Мираккл,borean-tundra,1151,warrior,arms,18,12,6
26927,Xurainzone,eredar,1151,warrior,arms,18,12,6
26928,Valoo,malganis,1151,warrior,arms,24,12,12
26929,Konebankærn,ravencrest,1151,warrior,arms,30,12,18
26930,Kronmw,dun-modr,1151,warrior,arms,30,12,18
26931,Saidi,outland,1151,warrior,arms,31,12,19
26932,Eidzø,tarren-mill,1150,warrior,arms,18,12,6
26933,Crazykind,kazzak,1150,warrior,arms,24,12,12
26934,Downpipe,twisting-nether,1150,warrior,arms,24,12,12
26935,Cassândrä,dalaran,1150,warrior,arms,30,12,18
26936,Kleidaria,stormscale,1149,warrior,arms,18,12,6
26937,Bamme,archimonde,1149,warrior,arms,24,12,12
26938,Crushonyou,aegwynn,1149,warrior,arms,24,12,12
26939,ßigarms,ravencrest,1148,warrior,arms,18,12,6
26940,Соловейч,howling-fjord,1148,warrior,arms,24,13,11
26941,Jonalina,gilneas,1148,warrior,arms,84,42,42
26942,Seraphys,ravencrest,1148,warrior,arms,24,12,12
26943,Chillycheesy,blackmoore,1148,warrior,arms,42,12,30
26944,Zwerk,rajaxx,1147,warrior,arms,24,12,12
26945,Ïnahö,hyjal,1147,warrior,arms,24,12,12
26946,Trenôdeca,stormscale,1147,warrior,arms,24,12,12
26947,Neoh,onyxia,1146,warrior,arms,51,29,22
26948,Jøtawarrior,sanguino,1146,warrior,arms,24,12,12
26949,Riyan,lothar,1146,warrior,arms,24,12,12
26950,Senshin,sanguino,1146,warrior,arms,24,12,12
26951,Эпитафорх,blackscar,1146,warrior,arms,24,12,12
26952,Bucketheadde,thrall,1144,warrior,arms,36,12,24
26953,Hùmøngöúslåm,ravencrest,1143,warrior,arms,18,12,6
26954,Ràkar,stormscale,1142,warrior,arms,24,12,12
26955,Brahlus,frostwolf,1142,warrior,arms,30,13,17
26956,Скрежет,gordunni,1142,warrior,arms,30,12,18
26957,Xanatos,khazgoroth,1140,warrior,arms,36,12,24
26958,Narox,arathor,1139,warrior,arms,30,13,17
26959,Dreamkil,archimonde,1138,warrior,arms,62,29,33
26960,Hoomeer,sylvanas,1138,warrior,arms,30,12,18
26961,Баварриор,greymane,1137,warrior,arms,30,12,18
26962,Téldrus,blackrock,1135,warrior,arms,24,12,12
26963,Погоныч,soulflayer,1135,warrior,arms,30,13,17
26964,Haewon,burning-legion,1135,warrior,arms,30,12,18
26965,Grimhew,argent-dawn,1134,warrior,arms,30,12,18
26966,Миранир,soulflayer,1132,warrior,arms,40,21,19
26967,Eekz,haomarush,1132,warrior,arms,24,12,12
26968,Газрош,howling-fjord,1130,warrior,arms,28,14,14
26969,Крахгал,soulflayer,1128,warrior,arms,88,42,46
26970,Tajiri,alakir,1126,warrior,arms,64,32,32
26971,Фикпопадешь,lich-king,1124,warrior,arms,39,13,26
26972,Фастод,greymane,1123,warrior,arms,36,16,20
26973,Pawn,twisting-nether,1122,warrior,arms,30,12,18
26974,Aliasus,outland,1122,warrior,arms,30,12,18
26975,Yüle,uldaman,1121,warrior,arms,30,15,15
26976,Ferpylél,ragnaros,1119,warrior,arms,25,13,12
26977,Diliul,doomhammer,1118,warrior,arms,28,15,13
26978,Meistersykes,silvermoon,1118,warrior,arms,26,13,13
26979,Draktul,aegwynn,1116,warrior,arms,24,14,10
26980,Wyshh,silvermoon,1115,warrior,arms,63,27,36
26981,Sûgma,blackhand,1108,warrior,arms,44,23,21
26982,Atelier,magtheridon,1106,warrior,arms,24,14,10
26983,Ironsteve,blackmoore,1105,warrior,arms,130,51,79
26984,Ordínaryname,blackrock,1102,warrior,arms,162,83,79
26985,Doveloo,kazzak,1102,warrior,arms,30,15,15
26986,Argadea,archimonde,1102,warrior,arms,36,15,21
26987,Iluwar,ragnaros,1099,warrior,arms,76,25,51
26988,Mélindà,silvermoon,1098,warrior,arms,15,12,3
26989,Нифро,fordragon,1098,warrior,arms,17,12,5
26990,Хазгора,howling-fjord,1096,warrior,arms,30,13,17
26991,Røiivar,hyjal,1094,warrior,arms,78,29,49
26992,Perykø,sanguino,1094,warrior,arms,34,12,22
26993,Sloppychoppy,silvermoon,1093,warrior,arms,47,19,28
26994,Garwarr,twisting-nether,1092,warrior,arms,25,13,12
26995,Gladiattus,drakthul,1091,warrior,arms,30,14,16
26996,Копенгаген,ashenvale,1091,warrior,arms,33,13,20
26997,Ragark,quelthalas,1087,warrior,arms,30,13,17
26998,Learningwarr,eredar,1085,warrior,arms,20,12,8
26999,Thehans,grim-batol,1081,warrior,arms,32,15,17
27000,Gèrralt,hyjal,1081,warrior,arms,29,12,17
27001,Ugardosh,burning-legion,1077,warrior,arms,34,12,22
27002,Stuble,blackhand,1076,warrior,arms,41,19,22
27003,Cárlsberg,pozzo-delleternità,1073,warrior,arms,36,12,24
27004,Obscurìa,argent-dawn,1068,warrior,arms,84,35,49
27005,Inticam,durotan,1066,warrior,arms,26,14,12
27006,Дикийлёха,soulflayer,1064,warrior,arms,36,18,18
27007,Jasperr,nemesis,1063,warrior,arms,61,27,34
27008,Áosr,ravencrest,1057,warrior,arms,47,24,23
27009,Рексторм,soulflayer,1056,warrior,arms,12,11,1
27010,Àlexander,ravencrest,1056,warrior,arms,18,11,7
27011,Klnrk,ravencrest,1056,warrior,arms,18,11,7
27012,Pummelpete,grim-batol,1056,warrior,arms,18,11,7
27013,Schwän,twisting-nether,1056,warrior,arms,18,11,7
27014,Rexonawarr,kazzak,1056,warrior,arms,18,11,7
27015,Anahkas,archimonde,1056,warrior,arms,24,11,13
27016,Kásúxøxøw,ravencrest,1056,warrior,arms,24,11,13
27017,Iameconomist,twisting-nether,1056,warrior,arms,24,11,13
27018,Êphêý,kazzak,1056,warrior,arms,24,11,13
27019,Xåb,dun-morogh,1056,warrior,arms,30,11,19
27020,Westwyde,hyjal,1055,warrior,arms,18,11,7
27021,Brogre,stormrage,1055,warrior,arms,18,11,7
27022,Анархорок,howling-fjord,1055,warrior,arms,18,11,7
27023,Sanerion,antonidas,1055,warrior,arms,18,11,7
27024,Huyer,stormscale,1055,warrior,arms,24,11,13
27025,Wake,eredar,1055,warrior,arms,24,11,13
27026,Scormash,burning-legion,1055,warrior,arms,24,11,13
27027,Neoballac,uldum,1055,warrior,arms,24,11,13
27028,Aemox,silvermoon,1054,warrior,arms,18,11,7
27029,Markorok,kazzak,1054,warrior,arms,18,11,7
27030,Râmi,perenolde,1054,warrior,arms,24,11,13
27031,Apollos,der-mithrilorden,1054,warrior,arms,30,11,19
27032,Orgi,drakthul,1053,warrior,arms,30,11,19
27033,Khoroc,die-aldor,1053,warrior,arms,30,11,19
27034,Scusi,burning-blade,1053,warrior,arms,30,11,19
27035,Salamandar,zenedar,1053,warrior,arms,30,11,19
27036,Сика,blackscar,1052,warrior,arms,24,11,13
27037,Swayzze,frostwolf,1052,warrior,arms,30,11,19
27038,Deviousjr,ragnaros,1051,warrior,arms,18,11,7
27039,Шорпит,howling-fjord,1051,warrior,arms,66,26,40
27040,Thaldrys,blackhand,1051,warrior,arms,30,11,19
27041,Spargebuci,draenor,1051,warrior,arms,30,11,19
27042,Chrekk,khaz-modan,1050,warrior,arms,24,11,13
27043,Farrusco,nemesis,1050,warrior,arms,24,11,13
27044,Nexpwns,blackhand,1050,warrior,arms,24,11,13
27045,Grumpy,lightbringer,1050,warrior,arms,30,11,19
27046,Ironsíde,alakir,1050,warrior,arms,30,11,19
27047,Kilsorrow,silvermoon,1050,warrior,arms,30,11,19
27048,Krigsdunken,draenor,1047,warrior,arms,48,15,33
27049,Kestialezin,archimonde,1046,warrior,arms,18,11,7
27050,Batalius,dalaran,1046,warrior,arms,30,11,19
27051,Rodenet,dun-modr,1045,warrior,arms,24,11,13
27052,Джондо,gordunni,1045,warrior,arms,24,11,13
27053,Roponmatsu,draenor,1045,warrior,arms,24,11,13
27054,Bigboibeeper,draenor,1045,warrior,arms,30,11,19
27055,Arkcules,ghostlands,1044,warrior,arms,24,11,13
27056,Zeldaixi,twisting-nether,1043,warrior,arms,18,11,7
27057,Odonko,blackmoore,1042,warrior,arms,30,16,14
27058,Peldreas,silvermoon,1041,warrior,arms,29,11,18
27059,Nokturnâl,silvermoon,1037,warrior,arms,18,11,7
27060,Issatank,frostmane,1037,warrior,arms,24,11,13
27061,Pwettygal,tarren-mill,1037,warrior,arms,36,13,23
27062,Crixusxx,sanguino,1035,warrior,arms,19,11,8
27063,Ruga,echsenkessel,1034,warrior,arms,37,20,17
27064,Степанычь,gordunni,1034,warrior,arms,24,11,13
27065,Katzz,dun-morogh,1031,warrior,arms,24,11,13
27066,Teraa,the-maelstrom,1030,warrior,arms,30,16,14
27067,Kugghalfswor,doomhammer,1030,warrior,arms,87,32,55
27068,Dariusvolt,argent-dawn,1028,warrior,arms,53,27,26
27069,Velinde,outland,1019,warrior,arms,23,11,12
27070,Oralinde,silvermoon,1017,warrior,arms,78,43,35
27071,Tazkax,archimonde,1016,warrior,arms,22,11,11
27072,Jebzmiecza,kazzak,1015,warrior,arms,24,11,13
27073,Роккар,gordunni,1012,warrior,arms,24,11,13
27074,Merdé,blackhand,1007,warrior,arms,90,43,47
27075,Conanh,pozzo-delleternità,1007,warrior,arms,32,13,19
27076,Rejectofrage,ragnaros,1000,warrior,arms,30,15,15
27077,Adrï,draenor,993,warrior,arms,64,35,29
27078,Ezjau,blackmoore,993,warrior,arms,78,39,39
27079,Szelenamoon,outland,988,warrior,arms,20,11,9
27080,Geicoo,dalaran,988,warrior,arms,56,29,27
27081,Chilp,archimonde,981,warrior,arms,25,12,13
27082,Oldhatreds,twisting-nether,979,warrior,arms,22,11,11
27083,Зед,blackscar,977,warrior,arms,25,13,12
27084,Onee,terrordar,971,warrior,arms,19,11,8
27085,Chipstjuven,tarren-mill,963,warrior,arms,25,11,14
27086,Wintertimex,stormscale,960,warrior,arms,12,10,2
27087,Bigschnäbi,blackhand,960,warrior,arms,12,10,2
27088,Екзобайт,gordunni,960,warrior,arms,18,10,8
27089,Andabad,silvermoon,960,warrior,arms,18,10,8
27090,Орданис,deathguard,960,warrior,arms,18,10,8
27091,Sponkss,tarren-mill,960,warrior,arms,18,10,8
27092,Proeliator,argent-dawn,960,warrior,arms,18,10,8
27093,Hirurg,thrall,960,warrior,arms,18,10,8
27094,Крипочёк,gordunni,960,warrior,arms,18,10,8
27095,Broarextiger,ragnaros,960,warrior,arms,18,10,8
27096,Hammerfíst,kazzak,960,warrior,arms,41,18,23
27097,Элетий,soulflayer,960,warrior,arms,24,10,14
27098,Salpaaja,frostwhisper,960,warrior,arms,24,10,14
27099,Bravopla,silvermoon,960,warrior,arms,24,10,14
27100,Zirêael,kazzak,960,warrior,arms,30,10,20
27101,Sindrener,ysondre,960,warrior,arms,30,10,20
27102,Jaythegodx,blackrock,960,warrior,arms,30,10,20
27103,Искристый,howling-fjord,959,warrior,arms,12,10,2
27104,Mbappé,dragonblight,959,warrior,arms,12,10,2
27105,Hasmocaru,silvermoon,959,warrior,arms,18,10,8
27106,Fearmedear,sylvanas,959,warrior,arms,18,10,8
27107,Zdi,blackrock,959,warrior,arms,18,10,8
27108,Axxtm,ravencrest,959,warrior,arms,18,10,8
27109,Badwarr,blackhand,959,warrior,arms,18,10,8
27110,Rookian,blackrock,959,warrior,arms,18,10,8
27111,Rabaozi,blackhand,959,warrior,arms,18,10,8
27112,Geckoo,emerald-dream,959,warrior,arms,24,10,14
27113,Enzja,nazjatar,959,warrior,arms,24,10,14
27114,Micromachine,argent-dawn,959,warrior,arms,30,10,20
27115,Убитаякорова,soulflayer,958,warrior,arms,18,10,8
27116,Krônôs,thrall,958,warrior,arms,18,10,8
27117,Braindeady,burning-legion,958,warrior,arms,18,10,8
27118,Rogersrage,ragnaros,958,warrior,arms,18,10,8
27119,Gorlemar,blackmoore,958,warrior,arms,18,10,8
27120,Nøcturnaqq,silvermoon,958,warrior,arms,18,10,8
27121,Dreadshanks,doomhammer,958,warrior,arms,30,16,14
27122,Gruxx,ragnaros,958,warrior,arms,24,10,14
27123,Фктпх,blackscar,958,warrior,arms,24,10,14
27124,Vymd,archimonde,958,warrior,arms,28,11,17
27125,Testonator,outland,957,warrior,arms,24,10,14
27126,Gipsyjoe,ragnaros,957,warrior,arms,24,10,14
27127,Латексник,booty-bay,957,warrior,arms,30,10,20
27128,Pag,hyjal,956,warrior,arms,12,10,2
27129,Lucasqt,magtheridon,956,warrior,arms,18,10,8
27130,Utero,drakthul,956,warrior,arms,24,10,14
27131,Mllmmxxm,kargath,956,warrior,arms,24,10,14
27132,Ciocaboca,draenor,955,warrior,arms,18,10,8
27133,Genç,ysondre,955,warrior,arms,18,10,8
27134,Xarmog,hyjal,955,warrior,arms,24,10,14
27135,Hellrokk,drakthul,954,warrior,arms,18,10,8
27136,Труперсила,howling-fjord,954,warrior,arms,24,10,14
27137,Ayelsyssup,silvermoon,954,warrior,arms,24,10,14
27138,Ôwndbylx,aegwynn,954,warrior,arms,27,11,16
27139,Cliwar,ragnaros,951,warrior,arms,18,11,7
27140,Berzzerker,tarren-mill,951,warrior,arms,24,10,14
27141,Warriornrv,ysondre,950,warrior,arms,18,10,8
27142,Волрок,howling-fjord,950,warrior,arms,25,13,12
27143,Jaru,alleria,949,warrior,arms,18,10,8
27144,Zerm,draenor,949,warrior,arms,18,10,8
27145,Taurosk,burning-legion,949,warrior,arms,24,10,14
27146,Warsky,archimonde,948,warrior,arms,18,12,6
27147,Зуботычник,gordunni,948,warrior,arms,18,10,8
27148,Bòónki,ravencrest,948,warrior,arms,40,17,23
27149,Доминатори,grom,948,warrior,arms,24,10,14
27150,Axedingus,tarren-mill,947,warrior,arms,18,10,8
27151,Balyndâ,aegwynn,945,warrior,arms,20,10,10
27152,Draemmer,minahonda,943,warrior,arms,18,10,8
27153,Ragedotcom,archimonde,940,warrior,arms,18,10,8
27154,Mågne,tarren-mill,939,warrior,arms,30,10,20
27155,Fdmachine,kazzak,934,warrior,arms,24,10,14
27156,Tabboonishka,draenor,927,warrior,arms,16,11,5
27157,Ganik,malganis,927,warrior,arms,23,10,13
27158,Shavoi,die-aldor,926,warrior,arms,29,10,19
27159,Raldjorn,hyjal,924,warrior,arms,18,10,8
27160,Unkmòr,pozzo-delleternità,921,warrior,arms,30,15,15
27161,Dearmooses,stormscale,920,warrior,arms,36,18,18
27162,Bluntsword,twisting-nether,919,warrior,arms,24,11,13
27163,Ethem,twisting-nether,913,warrior,arms,34,17,17
27164,Matti,magtheridon,911,warrior,arms,17,10,7
27165,Juoppó,tarren-mill,908,warrior,arms,17,10,7
27166,Grroom,tarren-mill,908,warrior,arms,27,10,17
27167,Durmithor,silvermoon,906,warrior,arms,35,10,25
27168,Discogoon,twilights-hammer,897,warrior,arms,60,20,40
27169,Perseó,minahonda,888,warrior,arms,54,16,38
27170,Ispor,shattered-halls,887,warrior,arms,47,24,23
27171,Рагнарульв,gordunni,885,warrior,arms,14,10,4
27172,Дотрен,galakrond,883,warrior,arms,42,20,22
27173,Pigleto,ravencrest,870,warrior,arms,22,12,10
27174,Antìcìdè,ravencrest,864,warrior,arms,12,9,3
27175,Drvx,twisting-nether,864,warrior,arms,12,9,3
27176,Zaedt,tarren-mill,864,warrior,arms,12,9,3
27177,Preliator,outland,864,warrior,arms,12,9,3
27178,Noitoved,outland,864,warrior,arms,20,10,10
27179,Allthèwayup,kazzak,864,warrior,arms,18,9,9
27180,Ken,twisting-nether,864,warrior,arms,18,9,9
27181,Brutilda,antonidas,864,warrior,arms,18,9,9
27182,Puremëtal,silvermoon,864,warrior,arms,18,9,9
27183,Purpórc,archimonde,864,warrior,arms,18,9,9
27184,Кимлий,deathweaver,864,warrior,arms,18,9,9
27185,Summerkarma,wildhammer,864,warrior,arms,18,9,9
27186,Quadfather,kazzak,864,warrior,arms,18,9,9
27187,Skylåw,archimonde,864,warrior,arms,18,9,9
27188,Prøject,archimonde,864,warrior,arms,18,9,9
27189,Purporcc,archimonde,864,warrior,arms,21,10,11
27190,Vôx,sylvanas,864,warrior,arms,24,9,15
27191,Oplarxigos,kazzak,864,warrior,arms,24,9,15
27192,Devidz,outland,864,warrior,arms,24,9,15
27193,Vikktor,doomhammer,864,warrior,arms,24,9,15
27194,Mercey,stormscale,864,warrior,arms,24,9,15
27195,Витодпс,howling-fjord,864,warrior,arms,24,9,15
27196,Rilor,burning-legion,864,warrior,arms,30,9,21
27197,Morbaac,archimonde,864,warrior,arms,30,9,21
27198,Nakro,hyjal,863,warrior,arms,12,9,3
27199,Пиапиа,gordunni,863,warrior,arms,12,9,3
27200,Billorc,twisting-nether,863,warrior,arms,18,9,9
27201,Грэйм,gordunni,863,warrior,arms,18,9,9
27202,Saofang,twisting-nether,863,warrior,arms,18,9,9
27203,Skaylulz,ragnaros,863,warrior,arms,18,9,9
27204,Puurplecloud,kazzak,863,warrior,arms,18,9,9
27205,Дейниксис,howling-fjord,863,warrior,arms,18,9,9
27206,Heltslut,tarren-mill,863,warrior,arms,24,9,15
27207,Zoefernandes,kazzak,863,warrior,arms,30,9,21
27208,Royoxo,blackrock,862,warrior,arms,12,9,3
27209,Bellator,arakarahm,862,warrior,arms,18,9,9
27210,Bobloblaww,doomhammer,862,warrior,arms,18,9,9
27211,Yayoflauta,sanguino,862,warrior,arms,18,9,9
27212,Scarloc,archimonde,862,warrior,arms,24,9,15
27213,Fluffycute,blackhand,862,warrior,arms,24,9,15
27214,Démigodx,stormscale,862,warrior,arms,24,9,15
27215,Nêgan,stormscale,861,warrior,arms,18,9,9
27216,Elyrax,dun-modr,861,warrior,arms,18,9,9
27217,Dûrøtan,marécage-de-zangar,861,warrior,arms,18,9,9
27218,Üs,blackhand,861,warrior,arms,24,9,15
27219,Bigbaduglyy,twisting-nether,861,warrior,arms,30,9,21
27220,Arriess,drakthul,860,warrior,arms,18,9,9
27221,Atus,dun-modr,860,warrior,arms,19,9,10
27222,Orwêll,uldum,860,warrior,arms,24,9,15
27223,Woopzi,twisting-nether,860,warrior,arms,36,9,27
27224,Synrosh,hyjal,859,warrior,arms,18,9,9
27225,Wolfgladius,cthun,859,warrior,arms,18,9,9
27226,Маханхет,soulflayer,859,warrior,arms,24,9,15
27227,Дрекзот,howling-fjord,858,warrior,arms,15,10,5
27228,Kval,kazzak,858,warrior,arms,18,9,9
27229,Агтеррокк,deathweaver,858,warrior,arms,24,9,15
27230,Kianit,ravencrest,858,warrior,arms,37,9,28
27231,Варбыкмашина,howling-fjord,857,warrior,arms,18,9,9
27232,Etelä,stormreaver,856,warrior,arms,18,9,9
27233,Kixx,twisting-nether,855,warrior,arms,30,14,16
27234,Nøiir,malfurion,854,warrior,arms,18,9,9
27235,Syforce,ravencrest,850,warrior,arms,18,9,9
27236,Pawnerlol,mannoroth,847,warrior,arms,17,9,8
27237,Киефси,howling-fjord,847,warrior,arms,18,9,9
27238,Bordi,nemesis,847,warrior,arms,29,9,20
27239,Luunk,ravencrest,846,warrior,arms,24,9,15
27240,Sanhaevel,ravencrest,838,warrior,arms,21,10,11
27241,Furanos,blackrock,831,warrior,arms,17,9,8
27242,Ajgreedy,grim-batol,829,warrior,arms,23,9,14
27243,Overdose,anetheron,827,warrior,arms,17,10,7
27244,Actuallyorc,twisting-nether,799,warrior,arms,14,9,5
27245,Vyctimz,ravencrest,799,warrior,arms,16,9,7
27246,Bumbx,kazzak,796,warrior,arms,14,9,5
27247,Knego,ragnaros,793,warrior,arms,11,9,2
27248,Кейнорин,howling-fjord,789,warrior,arms,28,9,19
27249,Finalsmasher,thrall,784,warrior,arms,42,16,26
27250,Psinovich,sylvanas,768,warrior,arms,12,8,4
27251,Skullrage,tarren-mill,768,warrior,arms,12,8,4
27252,Chadsmorc,twisting-nether,768,warrior,arms,12,8,4
27253,Иктиннос,gordunni,768,warrior,arms,12,8,4
27254,Ballin,dragonblight,768,warrior,arms,12,8,4
27255,Notvisionary,ravencrest,768,warrior,arms,12,8,4
27256,Muyubu,eredar,768,warrior,arms,12,8,4
27257,Liptonxecute,blackhand,768,warrior,arms,12,8,4
27258,Littlebugger,ravencrest,768,warrior,arms,12,8,4
27259,Rayner,illidan,768,warrior,arms,12,8,4
27260,Solaje,dun-modr,768,warrior,arms,12,8,4
27261,Liked,tarren-mill,768,warrior,arms,12,8,4
27262,Kennyföx,ysondre,768,warrior,arms,12,8,4
27263,Éliøkor,outland,768,warrior,arms,12,8,4
27264,Bulfwart,zuljin,768,warrior,arms,12,8,4
27265,Feckdech,blackrock,768,warrior,arms,12,8,4
27266,Maisner,stormscale,768,warrior,arms,15,9,6
27267,Warounet,hyjal,768,warrior,arms,18,8,10
27268,Vlorgboi,drakthul,768,warrior,arms,18,8,10
27269,Crawly,aegwynn,768,warrior,arms,18,8,10
27270,Visari,kiljaeden,768,warrior,arms,18,8,10
27271,Néxtlølz,twisting-nether,768,warrior,arms,18,8,10
27272,Planina,ravencrest,768,warrior,arms,18,8,10
27273,Ragestarved,ragnaros,768,warrior,arms,18,8,10
27274,Aauv,twisting-nether,768,warrior,arms,18,8,10
27275,Dreadbanga,blackmoore,768,warrior,arms,18,8,10
27276,Borndet,eredar,768,warrior,arms,18,8,10
27277,Brunodressed,aegwynn,768,warrior,arms,18,8,10
27278,Røidrage,stormscale,768,warrior,arms,18,8,10
27279,Hulksmsh,hyjal,768,warrior,arms,24,8,16
27280,Jackyred,silvermoon,768,warrior,arms,24,8,16
27281,Guts,frostwhisper,768,warrior,arms,24,8,16
27282,Уэсгар,blackscar,768,warrior,arms,24,8,16
27283,Fosler,frostmane,768,warrior,arms,24,8,16
27284,Yoilenno,argent-dawn,767,warrior,arms,12,8,4
27285,Khireebonk,hyjal,767,warrior,arms,12,8,4
27286,Prolyx,doomhammer,767,warrior,arms,12,8,4
27287,Zyzy,arathor,767,warrior,arms,12,8,4
27288,Mkazy,kirin-tor,767,warrior,arms,12,8,4
27289,Valíon,outland,767,warrior,arms,12,8,4
27290,Abnôrmus,tarren-mill,767,warrior,arms,12,8,4
27291,Бокалпивка,soulflayer,767,warrior,arms,15,9,6
27292,Draer,sanguino,767,warrior,arms,17,9,8
27293,Ríta,silvermoon,767,warrior,arms,18,8,10
27294,Shædøw,archimonde,767,warrior,arms,18,8,10
27295,Folsack,sanguino,767,warrior,arms,18,8,10
27296,Bekkey,lightbringer,767,warrior,arms,18,8,10
27297,Hermosse,dalaran,767,warrior,arms,18,8,10
27298,Alphachadwar,azjolnerub,767,warrior,arms,18,8,10
27299,Ronoh,kazzak,767,warrior,arms,18,8,10
27300,Арбузикхаха,soulflayer,767,warrior,arms,18,8,10
27301,Øfè,ysondre,767,warrior,arms,18,8,10
27302,Akim,ysondre,767,warrior,arms,18,8,10
27303,Lortèn,stormscale,767,warrior,arms,18,8,10
27304,Каутто,howling-fjord,767,warrior,arms,18,8,10
27305,Waegon,twisting-nether,767,warrior,arms,18,8,10
27306,Broxiw,darkspear,767,warrior,arms,18,8,10
27307,Horseye,eredar,767,warrior,arms,18,8,10
27308,Футжисубо,razuvious,767,warrior,arms,18,8,10
27309,Shoesmith,outland,767,warrior,arms,30,8,22
27310,Aomen,ravencrest,766,warrior,arms,12,8,4
27311,Shehalk,stormscale,766,warrior,arms,12,8,4
27312,Rageaholic,blackmoore,766,warrior,arms,18,8,10
27313,Beamis,ragnaros,766,warrior,arms,18,8,10
27314,Vohok,jaedenar,766,warrior,arms,18,8,10
27315,Liper,silvermoon,766,warrior,arms,27,9,18
27316,Opseagull,defias-brotherhood,765,warrior,arms,12,8,4
27317,Tyragon,thrall,765,warrior,arms,12,8,4
27318,Wärfäcë,blades-edge,765,warrior,arms,18,8,10
27319,Trajkovic,ravencrest,764,warrior,arms,18,8,10
27320,Ferrum,sunstrider,763,warrior,arms,18,8,10
27321,Giggadaddy,tarren-mill,763,warrior,arms,18,8,10
27322,Fatbeard,twilights-hammer,762,warrior,arms,18,8,10
27323,Korvjnus,burning-blade,762,warrior,arms,18,8,10
27324,Øruch,draenor,761,warrior,arms,18,8,10
27325,Shinydjuwlz,turalyon,760,warrior,arms,12,8,4
27326,Methaniwths,twisting-nether,760,warrior,arms,24,8,16
27327,Машамеч,blackscar,760,warrior,arms,30,8,22
27328,Satanås,silvermoon,758,warrior,arms,18,8,10
27329,Upturn,ravencrest,757,warrior,arms,24,8,16
27330,Calipp,die-aldor,750,warrior,arms,24,8,16
27331,Shadrassil,eonar,747,warrior,arms,18,8,10
27332,Punishers,ysondre,746,warrior,arms,102,37,65
27333,Rivah,tarren-mill,735,warrior,arms,18,9,9
27334,Tinkley,quelthalas,734,warrior,arms,16,8,8
27335,Grimsong,antonidas,733,warrior,arms,14,9,5
27336,Madict,outland,733,warrior,arms,18,8,10
27337,Takashia,ravencrest,731,warrior,arms,16,9,7
27338,Antraex,zuljin,726,warrior,arms,24,10,14
27339,Grolbein,blackhand,719,warrior,arms,17,9,8
27340,Anaxiam,drakthul,719,warrior,arms,17,8,9
27341,Hamez,thunderhorn,719,warrior,arms,17,8,9
27342,Zíreael,ravencrest,718,warrior,arms,29,8,21
27343,Zelwar,drakthul,714,warrior,arms,14,10,4
27344,Fáro,ravencrest,704,warrior,arms,16,8,8
27345,Ferv,tarren-mill,703,warrior,arms,17,8,9
27346,Stratic,blackmoore,697,warrior,arms,26,8,18
27347,Melców,eredar,687,warrior,arms,11,8,3
27348,Xiennas,stormscale,679,warrior,arms,19,9,10
27349,Бигдэмс,soulflayer,672,warrior,arms,12,7,5
27350,Трэйдар,blackscar,672,warrior,arms,12,7,5
27351,Ufu,outland,672,warrior,arms,12,7,5
27352,Wargak,stormscale,672,warrior,arms,12,7,5
27353,Ødên,frostmane,672,warrior,arms,12,7,5
27354,Biscuitoliva,hyjal,672,warrior,arms,12,7,5
27355,Хашонвар,gordunni,672,warrior,arms,12,7,5
27356,Antïsøcial,thrall,672,warrior,arms,12,7,5
27357,Fiveboy,tarren-mill,672,warrior,arms,12,7,5
27358,Gramr,silvermoon,672,warrior,arms,12,7,5
27359,Incendix,stormscale,672,warrior,arms,12,7,5
27360,Engalxsol,tarren-mill,672,warrior,arms,12,7,5
27361,Warriovar,draenor,672,warrior,arms,12,7,5
27362,Shchoor,ravencrest,672,warrior,arms,12,7,5
27363,Masakerr,ragnaros,672,warrior,arms,12,7,5
27364,Fiverare,stormscale,672,warrior,arms,12,7,5
27365,Tamesulo,silvermoon,672,warrior,arms,12,7,5
27366,Smèdbérg,ravencrest,672,warrior,arms,12,7,5
27367,Malgár,argent-dawn,672,warrior,arms,12,7,5
27368,Tenvee,outland,672,warrior,arms,12,7,5
27369,Krionos,ravencrest,672,warrior,arms,12,7,5
27370,Dréngr,blackrock,672,warrior,arms,12,7,5
27371,Арсон,soulflayer,672,warrior,arms,12,7,5
27372,Kriticah,sanguino,672,warrior,arms,12,7,5
27373,Azarek,blackmoore,672,warrior,arms,12,7,5
27374,Демолишеер,howling-fjord,672,warrior,arms,12,7,5
27375,Boonur,arthas,672,warrior,arms,12,7,5
27376,Cleavnseagal,ravencrest,672,warrior,arms,12,7,5
27377,Eskiler,burning-legion,672,warrior,arms,12,7,5
27378,Kwasimodo,blackmoore,672,warrior,arms,12,7,5
27379,Джераса,borean-tundra,672,warrior,arms,12,7,5
27380,Sickjackenx,executus,672,warrior,arms,12,7,5
27381,Midnightrain,archimonde,672,warrior,arms,12,7,5
27382,Devìlscandy,stormscale,672,warrior,arms,12,7,5
27383,Crøwñd,twisting-nether,672,warrior,arms,12,7,5
27384,Tìera,ravencrest,672,warrior,arms,15,8,7
27385,Chàrgex,blackrock,672,warrior,arms,15,8,7
27386,Kamilfury,burning-legion,672,warrior,arms,16,8,8
27387,Skullsmasher,stormscale,672,warrior,arms,18,7,11
27388,Panggy,ragnaros,672,warrior,arms,18,7,11
27389,Hollydeffs,blackmoore,672,warrior,arms,18,7,11
27390,Tomsom,sanguino,672,warrior,arms,18,7,11
27391,Cyanerd,bronzebeard,672,warrior,arms,18,7,11
27392,Warrieron,stormscale,672,warrior,arms,18,7,11
27393,Стефанидзе,soulflayer,672,warrior,arms,18,7,11
27394,Jeonsoyeon,argent-dawn,672,warrior,arms,18,7,11
27395,Bufdefstance,kazzak,672,warrior,arms,18,7,11
27396,Johnfogerty,twisting-nether,672,warrior,arms,18,7,11
27397,Twoonewin,ragnaros,672,warrior,arms,18,7,11
27398,Bacioleggero,nemesis,672,warrior,arms,18,7,11
27399,Silencxý,blackrock,672,warrior,arms,18,7,11
27400,Trilon,blackrock,672,warrior,arms,18,7,11
27401,Rightversion,sylvanas,672,warrior,arms,18,7,11
27402,Mezugzugyou,draenor,672,warrior,arms,18,7,11
27403,Swàck,mazrigos,672,warrior,arms,18,7,11
27404,Lusan,sylvanas,672,warrior,arms,18,7,11
27405,Warhero,burning-legion,672,warrior,arms,18,7,11
27406,Kryszii,ragnaros,672,warrior,arms,18,7,11
27407,Oxay,alakir,672,warrior,arms,18,7,11
27408,Luxurious,argent-dawn,672,warrior,arms,27,8,19
27409,Vøidwalker,ragnaros,672,warrior,arms,24,7,17
27410,Veav,norgannon,672,warrior,arms,24,7,17
27411,Gôrilla,kazzak,672,warrior,arms,30,7,23
27412,Escà,archimonde,671,warrior,arms,12,7,5
27413,Shedzo,tarren-mill,671,warrior,arms,12,7,5
27414,Semanor,aegwynn,671,warrior,arms,12,7,5
27415,Fluxerella,azjolnerub,671,warrior,arms,12,7,5
27416,Когарт,gordunni,671,warrior,arms,12,7,5
27417,Hexzo,ravencrest,671,warrior,arms,12,7,5
27418,Vez,arathor,671,warrior,arms,12,7,5
27419,Lågærtha,blackmoore,671,warrior,arms,12,7,5
27420,Dukhe,sanguino,671,warrior,arms,12,7,5
27421,Rawne,kirin-tor,671,warrior,arms,12,7,5
27422,Bonnaventure,hyjal,671,warrior,arms,12,7,5
27423,Hades,kazzak,671,warrior,arms,12,7,5
27424,Deanx,ragnaros,671,warrior,arms,12,7,5
27425,Schneklinge,blutkessel,671,warrior,arms,12,7,5
27426,Roshas,twisting-nether,671,warrior,arms,12,7,5
27427,Dosenbier,gorgonnash,671,warrior,arms,12,7,5
27428,Kishkamen,ravencrest,671,warrior,arms,18,7,11
27429,Haris,malganis,671,warrior,arms,18,7,11
27430,Tempii,ragnaros,671,warrior,arms,18,7,11
27431,Segovaxx,twisting-nether,671,warrior,arms,18,7,11
27432,Армсец,howling-fjord,671,warrior,arms,18,7,11
27433,Unstorm,drakthul,671,warrior,arms,18,7,11
27434,Бубаигавар,gordunni,671,warrior,arms,24,7,17
27435,Lightit,aegwynn,670,warrior,arms,12,7,5
27436,Mysteryman,defias-brotherhood,670,warrior,arms,12,7,5
27437,Nurychïc,twisting-nether,670,warrior,arms,12,7,5
27438,Eldfast,bladefist,670,warrior,arms,12,7,5
27439,Prs,defias-brotherhood,670,warrior,arms,12,7,5
27440,Contrariety,ravencrest,670,warrior,arms,12,7,5
27441,Ismellurfeet,ravencrest,670,warrior,arms,12,7,5
27442,Grunwi,burning-legion,670,warrior,arms,12,7,5
27443,Kilsera,blackmoore,670,warrior,arms,12,7,5
27444,Nixtor,defias-brotherhood,670,warrior,arms,18,7,11
27445,Rayeron,sanguino,670,warrior,arms,18,7,11
27446,Jackycoke,blackhand,670,warrior,arms,18,7,11
27447,Rhonack,ragnaros,670,warrior,arms,18,7,11
27448,Eyesonly,blackmoore,670,warrior,arms,18,7,11
27449,Infusione,nemesis,669,warrior,arms,12,7,5
27450,Lø,chogall,669,warrior,arms,20,7,13
27451,Кимиюки,gordunni,669,warrior,arms,24,7,17
27452,Árkantos,ravencrest,668,warrior,arms,12,7,5
27453,Releave,draenor,668,warrior,arms,18,7,11
27454,Woukong,blackmoore,668,warrior,arms,18,7,11
27455,Математик,razuvious,667,warrior,arms,12,7,5
27456,Papati,twisting-nether,667,warrior,arms,18,7,11
27457,Bubciu,burning-legion,667,warrior,arms,24,7,17
27458,Dlstroyer,eonar,657,warrior,arms,12,7,5
27459,Dorya,aegwynn,655,warrior,arms,17,7,10
27460,Казньшалав,gordunni,655,warrior,arms,17,7,10
27461,Xienia,dun-morogh,655,warrior,arms,24,7,17
27462,Дедсдрыном,howling-fjord,654,warrior,arms,17,7,10
27463,Alothar,khaz-modan,646,warrior,arms,18,7,11
27464,Broarexlion,ragnaros,639,warrior,arms,17,7,10
27465,Мегаяйца,gordunni,639,warrior,arms,23,7,16
27466,Râsk,kazzak,638,warrior,arms,16,8,8
27467,Набосуюногу,gordunni,623,warrior,arms,17,7,10
27468,Kwesta,kazzak,607,warrior,arms,11,7,4
27469,Facepálm,kazzak,607,warrior,arms,14,7,7
27470,Matatorero,uldum,607,warrior,arms,16,7,9
27471,Trundledaddy,silvermoon,607,warrior,arms,17,7,10
27472,Слуфен,galakrond,592,warrior,arms,8,7,1
27473,Dulex,draenor,576,warrior,arms,6,6,0
27474,Jethiss,ravencrest,576,warrior,arms,6,6,0
27475,Marqinios,archimonde,576,warrior,arms,6,6,0
27476,Whýsøsîleñt,ragnaros,576,warrior,arms,10,7,3
27477,Slám,burning-legion,576,warrior,arms,12,6,6
27478,Melfis,aegwynn,576,warrior,arms,12,6,6
27479,Tddyy,silvermoon,576,warrior,arms,12,6,6
27480,Flurie,sylvanas,576,warrior,arms,12,6,6
27481,Pathocend,kazzak,576,warrior,arms,12,6,6
27482,Boshim,ravencrest,576,warrior,arms,12,6,6
27483,Belfodil,outland,576,warrior,arms,12,6,6
27484,Toqk,draenor,576,warrior,arms,12,6,6
27485,Darkseid,burning-legion,576,warrior,arms,12,6,6
27486,Radîtz,blackmoore,576,warrior,arms,12,6,6
27487,Hycate,blackrock,576,warrior,arms,12,6,6
27488,Finmajor,frostwhisper,576,warrior,arms,12,6,6
27489,Eren,todeswache,576,warrior,arms,12,6,6
27490,Sydre,nerathor,576,warrior,arms,12,6,6
27491,Whýsøsîlêñt,ragnaros,576,warrior,arms,12,6,6
27492,Naskez,kazzak,576,warrior,arms,12,6,6
27493,Rînus,aegwynn,576,warrior,arms,12,6,6
27494,Hamilton,bronzebeard,576,warrior,arms,12,6,6
27495,Moldamis,blackhand,576,warrior,arms,12,6,6
27496,Gíu,blackhand,576,warrior,arms,12,6,6
27497,Architectman,twisting-nether,576,warrior,arms,12,6,6
27498,Coolaa,kazzak,576,warrior,arms,12,6,6
27499,Малаятварь,gordunni,576,warrior,arms,12,6,6
27500,Fankululu,kragjin,576,warrior,arms,12,6,6
27501,Xqt,laughing-skull,576,warrior,arms,12,6,6
27502,Juggawumba,kazzak,576,warrior,arms,12,6,6
27503,Bismárck,nathrezim,576,warrior,arms,12,6,6
27504,Audítóre,proudmoore,576,warrior,arms,12,6,6
27505,Oneoneseven,archimonde,576,warrior,arms,12,6,6
27506,Fookyoup,stormscale,576,warrior,arms,12,6,6
27507,Deadlyanger,kazzak,576,warrior,arms,12,6,6
27508,Goringbame,draenor,576,warrior,arms,12,6,6
27509,Nørst,draenor,576,warrior,arms,12,6,6
27510,Голдибитч,gordunni,576,warrior,arms,12,6,6
27511,Тассэй,eversong,576,warrior,arms,12,6,6
27512,Данзетар,howling-fjord,576,warrior,arms,12,6,6
27513,Долирия,gordunni,576,warrior,arms,12,6,6
27514,Злопиканка,gordunni,576,warrior,arms,12,6,6
27515,Братишкаа,gordunni,576,warrior,arms,12,6,6
27516,Bigdamtosco,ravencrest,576,warrior,arms,12,6,6
27517,Qurujaa,kirin-tor,576,warrior,arms,12,6,6
27518,Нерморрог,howling-fjord,576,warrior,arms,12,6,6
27519,Airowar,drakthul,576,warrior,arms,12,6,6
27520,Лёшавор,howling-fjord,576,warrior,arms,12,6,6
27521,Majestatix,doomhammer,576,warrior,arms,12,6,6
27522,Josem,sanguino,576,warrior,arms,12,6,6
27523,Dedewawa,ysondre,576,warrior,arms,12,6,6
27524,Lostday,blackrock,576,warrior,arms,12,6,6
27525,Grimarg,drakthul,576,warrior,arms,12,6,6
27526,Keshâr,blackhand,576,warrior,arms,12,6,6
27527,Rakhaldin,blackhand,576,warrior,arms,12,6,6
27528,Шизам,howling-fjord,576,warrior,arms,12,6,6
27529,Wøokz,argent-dawn,576,warrior,arms,12,6,6
27530,Reacôn,twisting-nether,576,warrior,arms,12,6,6
27531,Pitii,burning-legion,576,warrior,arms,14,6,8
27532,Shaked,dun-modr,576,warrior,arms,18,6,12
27533,Мопк,howling-fjord,576,warrior,arms,18,6,12
27534,Hazzaogx,draenor,576,warrior,arms,18,6,12
27535,Velcorn,ravencrest,576,warrior,arms,18,6,12
27536,Fracto,draenor,576,warrior,arms,18,6,12
27537,Garouzo,hellfire,576,warrior,arms,18,6,12
27538,Kímó,silvermoon,576,warrior,arms,18,6,12
27539,Skumslag,blackmoore,576,warrior,arms,18,6,12
27540,Slunecniq,azjolnerub,576,warrior,arms,18,6,12
27541,Бавовник,howling-fjord,576,warrior,arms,18,6,12
27542,Autumnfálls,kazzak,576,warrior,arms,18,6,12
27543,Jeriko,archimonde,576,warrior,arms,18,6,12
27544,Steroidkidx,stormscale,576,warrior,arms,24,6,18
27545,Thiccrich,argent-dawn,575,warrior,arms,6,6,0
27546,Pesroc,blackmoore,575,warrior,arms,9,7,2
27547,Бэдбрэйнс,soulflayer,575,warrior,arms,12,6,6
27548,Elénir,dalaran,575,warrior,arms,12,6,6
27549,Euforija,kazzak,575,warrior,arms,12,6,6
27550,Ozok,blackrock,575,warrior,arms,12,6,6
27551,Wørgenn,hyjal,575,warrior,arms,12,6,6
27552,Zutto,conseil-des-ombres,575,warrior,arms,12,6,6
27553,Donátos,aegwynn,575,warrior,arms,12,6,6
27554,Stweye,frostmane,575,warrior,arms,12,6,6
27555,Fótm,sylvanas,575,warrior,arms,12,6,6
27556,Oneshót,norgannon,575,warrior,arms,12,6,6
27557,Ràgnàmetàl,tarren-mill,575,warrior,arms,12,6,6
27558,Critycall,drakthul,575,warrior,arms,12,6,6
27559,Golonko,burning-legion,575,warrior,arms,12,6,6
27560,Ireincarnate,argent-dawn,575,warrior,arms,12,6,6
27561,Soofies,madmortem,575,warrior,arms,12,6,6
27562,Tarbhfathach,draenor,575,warrior,arms,12,6,6
27563,Mödhan,archimonde,575,warrior,arms,12,6,6
27564,Bravest,ragnaros,575,warrior,arms,12,6,6
27565,Акози,fordragon,575,warrior,arms,12,6,6
27566,Wfx,kazzak,575,warrior,arms,12,6,6
27567,Шлифую,howling-fjord,575,warrior,arms,12,6,6
27568,Vauster,draenor,575,warrior,arms,16,7,9
27569,Shuraj,hyjal,575,warrior,arms,16,6,10
27570,Nicperh,dun-modr,575,warrior,arms,18,6,12
27571,Gervvand,burning-legion,575,warrior,arms,18,6,12
27572,Vegäpunk,nemesis,575,warrior,arms,18,6,12
27573,Kosttya,argent-dawn,575,warrior,arms,18,6,12
27574,Cramatao,shadowsong,575,warrior,arms,18,6,12
27575,Кудесмяу,soulflayer,575,warrior,arms,18,6,12
27576,Goldins,drakthul,575,warrior,arms,18,6,12
27577,Hirbus,ravencrest,575,warrior,arms,19,6,13
27578,Solatika,alexstrasza,574,warrior,arms,12,6,6
27579,Gnuhl,eredar,574,warrior,arms,15,7,8
27580,Dicaprios,silvermoon,574,warrior,arms,18,6,12
27581,Zogyall,ysondre,574,warrior,arms,18,6,12
27582,Pips,minahonda,574,warrior,arms,24,6,18
27583,Manymen,outland,572,warrior,arms,12,6,6
27584,Raduriel,antonidas,571,warrior,arms,12,6,6
27585,Dj,ragnaros,568,warrior,arms,12,6,6
27586,Liferuiner,rexxar,543,warrior,arms,14,7,7
27587,Kalarar,blackrock,543,warrior,arms,26,7,19
27588,Energo,drakthul,542,warrior,arms,12,6,6
27589,Zugstorm,outland,528,warrior,arms,9,7,2
27590,Kåñéthy,outland,528,warrior,arms,15,7,8
27591,Imabeatyoass,kazzak,527,warrior,arms,11,6,5
27592,Манндалорец,gordunni,527,warrior,arms,15,6,9
27593,Titanhaut,frostwolf,525,warrior,arms,11,6,5
27594,Богадорога,howling-fjord,522,warrior,arms,17,8,9
27595,Брамон,gordunni,512,warrior,arms,10,6,4
27596,Лысыч,gordunni,495,warrior,arms,13,6,7
27597,Фоссбро,gordunni,494,warrior,arms,21,6,15
27598,Tørrminator,stormscale,480,warrior,arms,6,5,1
27599,Гневныйвиги,howling-fjord,480,warrior,arms,6,5,1
27600,Karmaloop,stormscale,480,warrior,arms,6,5,1
27601,Warbigboss,draenor,480,warrior,arms,6,5,1
27602,Хэрест,gordunni,480,warrior,arms,6,5,1
27603,Рвбстох,blackscar,480,warrior,arms,6,5,1
27604,Tekmali,archimonde,480,warrior,arms,6,5,1
27605,Asasius,ravencrest,480,warrior,arms,6,5,1
27606,Megatronman,ravencrest,480,warrior,arms,6,5,1
27607,Bashuk,grim-batol,480,warrior,arms,6,5,1
27608,Rockygifll,sinstralis,480,warrior,arms,6,5,1
27609,Lurion,malganis,480,warrior,arms,6,5,1
27610,Mertik,twisting-nether,480,warrior,arms,6,5,1
27611,Shînsø,dalaran,480,warrior,arms,6,5,1
27612,Okcool,twisting-nether,480,warrior,arms,6,5,1
27613,Murp,lightnings-blade,480,warrior,arms,6,5,1
27614,Дядядмг,blackscar,480,warrior,arms,6,5,1
27615,Babovic,aegwynn,480,warrior,arms,6,5,1
27616,Himarsenko,silvermoon,480,warrior,arms,6,5,1
27617,Remylacroix,blackrock,480,warrior,arms,6,5,1
27618,Newgáte,silvermoon,480,warrior,arms,6,5,1
27619,Halsandre,hyjal,480,warrior,arms,6,5,1
27620,Warbringer,burning-blade,480,warrior,arms,6,5,1
27621,Pihvikostaja,stormreaver,480,warrior,arms,6,5,1
27622,Maniackz,tarren-mill,480,warrior,arms,6,5,1
27623,Cuzyxtwo,blackrock,480,warrior,arms,6,5,1
27624,Slg,tarren-mill,480,warrior,arms,6,5,1
27625,Prymebeevz,blackmoore,480,warrior,arms,6,5,1
27626,Sjozug,tarren-mill,480,warrior,arms,12,5,7
27627,Lîlsaint,dun-morogh,480,warrior,arms,12,5,7
27628,Warristyles,arygos,480,warrior,arms,12,5,7
27629,Succel,drakthul,480,warrior,arms,12,5,7
27630,Dmgsponge,stormscale,480,warrior,arms,12,5,7
27631,Kalopsia,drakthul,480,warrior,arms,12,5,7
27632,Horsewarrior,stormscale,480,warrior,arms,12,5,7
27633,Alexwar,draenor,480,warrior,arms,12,5,7
27634,Ragingclue,draenor,480,warrior,arms,12,5,7
27635,Huxies,draenor,480,warrior,arms,12,5,7
27636,Sanca,naxxramas,480,warrior,arms,12,5,7
27637,Wazraf,khaz-modan,480,warrior,arms,12,5,7
27638,Rohäc,drakthul,480,warrior,arms,12,5,7
27639,Sinbuay,malygos,480,warrior,arms,12,5,7
27640,Foxxzorr,aszune,480,warrior,arms,12,5,7
27641,Dortenz,ragnaros,480,warrior,arms,12,5,7
27642,Olesbawro,ragnaros,480,warrior,arms,12,5,7
27643,Chadgrave,argent-dawn,480,warrior,arms,12,5,7
27644,Lïyah,eldrethalas,480,warrior,arms,12,5,7
27645,Rowr,argent-dawn,480,warrior,arms,12,5,7
27646,Agoobagoo,alakir,480,warrior,arms,12,5,7
27647,Nazgrosh,burning-legion,480,warrior,arms,12,5,7
27648,Buckiesøde,twisting-nether,480,warrior,arms,12,5,7
27649,Whysobold,quelthalas,480,warrior,arms,12,5,7
27650,Mesmash,uldum,480,warrior,arms,12,5,7
27651,Budwise,stormscale,480,warrior,arms,12,5,7
27652,Vitezandro,stormscale,480,warrior,arms,12,5,7
27653,Oplix,antonidas,480,warrior,arms,12,5,7
27654,Nuckii,antonidas,480,warrior,arms,12,5,7
27655,Lüund,ravencrest,480,warrior,arms,12,5,7
27656,Cortix,blackmoore,480,warrior,arms,12,5,7
27657,Klonyarikjr,ravencrest,480,warrior,arms,12,5,7
27658,Deathbleeder,argent-dawn,480,warrior,arms,12,5,7
27659,Nyamnyamnyam,blackmoore,480,warrior,arms,12,5,7
27660,Arakhu,blackmoore,480,warrior,arms,12,5,7
27661,Binsaueramk,ravencrest,480,warrior,arms,12,5,7
27662,Xintha,frostwolf,480,warrior,arms,12,5,7
27663,Síúkanto,blackrock,480,warrior,arms,12,5,7
27664,Neíd,malganis,480,warrior,arms,12,5,7
27665,Horizonx,blackrock,480,warrior,arms,12,5,7
27666,Whiteowlx,argent-dawn,480,warrior,arms,12,5,7
27667,Zeryyo,blackrock,480,warrior,arms,12,5,7
27668,Cryhoof,ragnaros,480,warrior,arms,12,5,7
27669,Adzipotlewap,burning-legion,480,warrior,arms,12,5,7
27670,Garradoom,stormscale,480,warrior,arms,12,5,7
27671,ßzv,veklor,480,warrior,arms,12,5,7
27672,Zkou,wrathbringer,480,warrior,arms,12,5,7
27673,Leroyluca,gilneas,480,warrior,arms,12,5,7
27674,Ilovealma,kiljaeden,480,warrior,arms,12,5,7
27675,Najjs,eredar,480,warrior,arms,12,5,7
27676,Фуджитаку,gordunni,480,warrior,arms,12,5,7
27677,Древилгод,gordunni,480,warrior,arms,12,5,7
27678,Бейлеор,gordunni,480,warrior,arms,12,5,7
27679,Victôr,silvermoon,480,warrior,arms,12,5,7
27680,Alborozie,archimonde,480,warrior,arms,12,5,7
27681,Gerrmund,silvermoon,480,warrior,arms,12,5,7
27682,Шифик,soulflayer,480,warrior,arms,12,5,7
27683,Лилиофанныч,soulflayer,480,warrior,arms,12,5,7
27684,Keäghan,kazzak,480,warrior,arms,12,5,7
27685,Gnomekek,sylvanas,480,warrior,arms,12,5,7
27686,Reìvah,silvermoon,480,warrior,arms,12,5,7
27687,Ràgê,silvermoon,480,warrior,arms,12,5,7
27688,Земибор,soulflayer,480,warrior,arms,12,5,7
27689,Tenthøusand,sylvanas,480,warrior,arms,12,5,7
27690,Ехрерау,gordunni,480,warrior,arms,12,5,7
27691,Тевивар,gordunni,480,warrior,arms,12,5,7
27692,Delfrion,pozzo-delleternità,480,warrior,arms,12,5,7
27693,Zirriox,wildhammer,480,warrior,arms,12,5,7
27694,Apacho,outland,480,warrior,arms,12,5,7
27695,Жестокус,gordunni,480,warrior,arms,12,5,7
27696,Supersonîc,aegwynn,480,warrior,arms,12,5,7
27697,Отнулядоста,gordunni,480,warrior,arms,12,5,7
27698,Eggsecutor,stormscale,480,warrior,arms,15,6,9
27699,Развалочка,howling-fjord,480,warrior,arms,16,6,10
27700,Séphi,archimonde,480,warrior,arms,18,5,13
27701,Larrydankin,draenor,480,warrior,arms,18,5,13
27702,Phovoss,stormscale,480,warrior,arms,18,5,13
27703,Unßörn,archimonde,480,warrior,arms,18,5,13
27704,Huullkk,nazjatar,480,warrior,arms,18,5,13
27705,Zeepp,ravencrest,480,warrior,arms,18,5,13
27706,Roykór,auchindoun,480,warrior,arms,18,5,13
27707,Belzebud,kazzak,480,warrior,arms,18,5,13
27708,Lahzar,krasus,480,warrior,arms,18,5,13
27709,Тандэр,borean-tundra,480,warrior,arms,18,5,13
27710,Leàn,nemesis,480,warrior,arms,18,5,13
27711,Esegryel,argent-dawn,480,warrior,arms,18,5,13
27712,Курящийпро,blackscar,480,warrior,arms,18,5,13
27713,Voidteen,argent-dawn,480,warrior,arms,18,5,13
27714,Vhy,antonidas,480,warrior,arms,25,5,20
27715,Leyon,blades-edge,479,warrior,arms,6,5,1
27716,Ceteris,eredar,479,warrior,arms,6,5,1
27717,Serakhan,argent-dawn,479,warrior,arms,6,5,1
27718,Neltharon,silvermoon,479,warrior,arms,6,5,1
27719,Krostapunk,colinas-pardas,479,warrior,arms,12,5,7
27720,Etharedon,kul-tiras,479,warrior,arms,12,5,7
27721,Тычо,soulflayer,479,warrior,arms,12,5,7
27722,Dúg,tarren-mill,479,warrior,arms,12,5,7
27723,Kllinac,kazzak,479,warrior,arms,12,5,7
27724,Pappkopf,rexxar,479,warrior,arms,12,5,7
27725,Grèèn,turalyon,479,warrior,arms,12,5,7
27726,Shpitzu,stormscale,479,warrior,arms,12,5,7
27727,Meresin,madmortem,479,warrior,arms,12,5,7
27728,Swtparanoid,sylvanas,479,warrior,arms,12,5,7
27729,Izestyi,blackrock,479,warrior,arms,18,5,13
27730,Qvil,sanguino,479,warrior,arms,24,5,19
27731,Sfarpi,burning-legion,478,warrior,arms,12,5,7
27732,Sahaminho,draenor,478,warrior,arms,18,5,13
27733,Swordluw,argent-dawn,478,warrior,arms,18,5,13
27734,Милославский,gordunni,477,warrior,arms,12,5,7
27735,Лидоний,gordunni,477,warrior,arms,12,5,7
27736,Àke,darksorrow,476,warrior,arms,18,5,13
27737,Execútioner,sylvanas,463,warrior,arms,11,5,6
27738,Bigtulipe,archimonde,463,warrior,arms,11,5,6
27739,Duarel,blackmoore,448,warrior,arms,10,5,5
27740,Henzelhoff,stormreaver,447,warrior,arms,10,5,5
27741,Kviqr,auchindoun,447,warrior,arms,11,5,6
27742,Takethisduck,stormscale,447,warrior,arms,11,5,6
27743,Corlo,uldaman,447,warrior,arms,14,6,8
27744,Чпонькмашина,soulflayer,447,warrior,arms,17,5,12
27745,Spoofie,doomhammer,432,warrior,arms,15,5,10
27746,Nalx,tarren-mill,432,warrior,arms,15,5,10
27747,Madswarrior,tarren-mill,431,warrior,arms,11,5,6
27748,Leizey,stormscale,426,warrior,arms,15,6,9
27749,Knî,archimonde,426,warrior,arms,15,6,9
27750,Prime,outland,416,warrior,arms,16,5,11
27751,Dodgeslam,eredar,416,warrior,arms,16,5,11
27752,Ironbutter,ravencrest,415,warrior,arms,8,6,2
27753,Kìrìtosan,pozzo-delleternità,415,warrior,arms,8,5,3
27754,Rhxy,burning-legion,415,warrior,arms,10,5,5
27755,Brùtus,exodar,415,warrior,arms,11,5,6
27756,Ball,zirkel-des-cenarius,415,warrior,arms,14,5,9
27757,Danx,culte-de-la-rive-noire,413,warrior,arms,16,5,11
27758,Xzm,stormscale,384,warrior,arms,6,4,2
27759,Kevlarsusan,the-maelstrom,384,warrior,arms,6,4,2
27760,Pillu,stormscale,384,warrior,arms,6,4,2
27761,Zarrgash,blackhand,384,warrior,arms,6,4,2
27762,Arsinal,blackhand,384,warrior,arms,6,4,2
27763,Фиббоначи,deathguard,384,warrior,arms,6,4,2
27764,Sveñor,the-maelstrom,384,warrior,arms,6,4,2
27765,Pelicos,grim-batol,384,warrior,arms,6,4,2
27766,Bigbosscho,draenor,384,warrior,arms,6,4,2
27767,Banshor,ysondre,384,warrior,arms,6,4,2
27768,Rebiy,ravencrest,384,warrior,arms,6,4,2
27769,Kymari,sanguino,384,warrior,arms,6,4,2
27770,Bronn,defias-brotherhood,384,warrior,arms,6,4,2
27771,Bubawarrior,silvermoon,384,warrior,arms,6,4,2
27772,Capigo,tarren-mill,384,warrior,arms,6,4,2
27773,Schawar,draenor,384,warrior,arms,6,4,2
27774,Litlijón,ravencrest,384,warrior,arms,6,4,2
27775,Zbra,draenor,384,warrior,arms,6,4,2
27776,Cmonbrah,ravencrest,384,warrior,arms,6,4,2
27777,Psychðtïc,archimonde,384,warrior,arms,6,4,2
27778,Varzeluu,sylvanas,384,warrior,arms,6,4,2
27779,Kaylì,ravencrest,384,warrior,arms,6,4,2
27780,Ceen,alakir,384,warrior,arms,6,4,2
27781,Døkidøki,silvermoon,384,warrior,arms,6,4,2
27782,Tolga,draenor,384,warrior,arms,6,4,2
27783,Думрайт,gordunni,384,warrior,arms,6,4,2
27784,Susugar,ysondre,384,warrior,arms,6,4,2
27785,Swaàg,archimonde,384,warrior,arms,6,4,2
27786,Гигасмэш,gordunni,384,warrior,arms,6,4,2
27787,Kamatâ,kazzak,384,warrior,arms,6,4,2
27788,Thorbjør,silvermoon,384,warrior,arms,6,4,2
27789,Ddfxz,draenor,384,warrior,arms,6,4,2
27790,Becca,rexxar,384,warrior,arms,6,4,2
27791,Arnnau,dun-modr,384,warrior,arms,6,4,2
27792,Hamonbophis,kirin-tor,384,warrior,arms,6,4,2
27793,Zonash,kazzak,384,warrior,arms,6,4,2
27794,Fizé,blackmoore,384,warrior,arms,6,4,2
27795,Zidbi,argent-dawn,384,warrior,arms,6,4,2
27796,Gór,area-52,384,warrior,arms,6,4,2
27797,Ricovega,kazzak,384,warrior,arms,6,4,2
27798,Rastaj,defias-brotherhood,384,warrior,arms,6,4,2
27799,Dräparren,ragnaros,384,warrior,arms,6,4,2
27800,Braveorc,kazzak,384,warrior,arms,6,4,2
27801,Ollyaa,ravencrest,384,warrior,arms,6,4,2
27802,Deathgreyø,nemesis,384,warrior,arms,6,4,2
27803,Mold,nemesis,384,warrior,arms,6,4,2
27804,Dianâ,der-abyssische-rat,384,warrior,arms,6,4,2
27805,Grimoire,drakthul,384,warrior,arms,6,4,2
27806,Tandrak,ravencrest,384,warrior,arms,6,4,2
27807,Polak,tirion,384,warrior,arms,6,4,2
27808,Surthur,magtheridon,384,warrior,arms,6,4,2
27809,Beznacaj,outland,384,warrior,arms,6,4,2
27810,Dallion,azjolnerub,384,warrior,arms,6,4,2
27811,Imondiet,ragnaros,384,warrior,arms,6,4,2
27812,Anndersen,defias-brotherhood,384,warrior,arms,6,4,2
27813,Eseishard,hyjal,384,warrior,arms,6,4,2
27814,Hackamore,suramar,384,warrior,arms,6,4,2
27815,Lanahan,argent-dawn,384,warrior,arms,6,4,2
27816,Лагалиер,borean-tundra,384,warrior,arms,6,4,2
27817,Sucemabanner,hyjal,384,warrior,arms,6,4,2
27818,Takeashower,hyjal,384,warrior,arms,6,4,2
27819,Slâkkxz,outland,384,warrior,arms,6,4,2
27820,Rongh,saurfang,384,warrior,arms,6,4,2
27821,Bonza,blackrock,384,warrior,arms,6,4,2
27822,Roadsick,outland,384,warrior,arms,6,4,2
27823,Yseras,aegwynn,384,warrior,arms,6,4,2
27824,Rázgriz,argent-dawn,384,warrior,arms,6,4,2
27825,Strapnslap,argent-dawn,384,warrior,arms,6,4,2
27826,Abunai,thrall,384,warrior,arms,6,4,2
27827,Swig,twisting-nether,384,warrior,arms,6,4,2
27828,Huuln,outland,384,warrior,arms,6,4,2
27829,Måydåy,twisting-nether,384,warrior,arms,6,4,2
27830,Беспонятия,blackscar,384,warrior,arms,6,4,2
27831,Sokarbey,twisting-nether,384,warrior,arms,6,4,2
27832,Тролльвоен,gordunni,384,warrior,arms,9,4,5
27833,Equality,ragnaros,384,warrior,arms,10,4,6
27834,Merkakis,argent-dawn,384,warrior,arms,15,5,10
27835,Deathwingx,azuremyst,384,warrior,arms,15,5,10
27836,Yakhshar,silvermoon,384,warrior,arms,12,4,8
27837,Salpaaja,tarren-mill,384,warrior,arms,12,4,8
27838,Palthor,drakthul,384,warrior,arms,12,4,8
27839,Sorô,antonidas,384,warrior,arms,12,4,8
27840,Suduri,drakthul,384,warrior,arms,12,4,8
27841,Schjøtt,ravencrest,384,warrior,arms,12,4,8
27842,Karbeg,ravencrest,384,warrior,arms,12,4,8
27843,Osteskanken,ravencrest,384,warrior,arms,12,4,8
27844,Amarthon,sylvanas,384,warrior,arms,12,4,8
27845,Mârcxb,antonidas,384,warrior,arms,12,4,8
27846,Mortus,baelgun,384,warrior,arms,12,4,8
27847,Darkchao,madmortem,384,warrior,arms,12,4,8
27848,Sztixi,silvermoon,384,warrior,arms,12,4,8
27849,Rieku,kazzak,384,warrior,arms,12,4,8
27850,Swaxx,ravencrest,384,warrior,arms,12,4,8
27851,Vooice,sylvanas,384,warrior,arms,12,4,8
27852,Fàlconry,kazzak,384,warrior,arms,12,4,8
27853,Minetaur,burning-legion,384,warrior,arms,12,4,8
27854,Ellissari,tirion,384,warrior,arms,12,4,8
27855,Tommia,burning-legion,384,warrior,arms,12,4,8
27856,Raynorwarr,tarren-mill,384,warrior,arms,12,4,8
27857,Ezop,burning-blade,384,warrior,arms,12,4,8
27858,Веоленс,gordunni,384,warrior,arms,12,4,8
27859,Ærion,die-aldor,384,warrior,arms,12,4,8
27860,Sebotagelol,twisting-nether,384,warrior,arms,12,4,8
27861,Syel,sinstralis,384,warrior,arms,12,4,8
27862,Хамерртайм,goldrinn,384,warrior,arms,12,4,8
27863,Дахирарг,fordragon,384,warrior,arms,12,4,8
27864,Hubusan,blackmoore,384,warrior,arms,12,4,8
27865,Ðræberen,kazzak,384,warrior,arms,12,4,8
27866,Ambraxon,blackmoore,384,warrior,arms,12,4,8
27867,Xállek,veknilash,384,warrior,arms,12,4,8
27868,Khvor,blackmoore,384,warrior,arms,12,4,8
27869,Adorlyna,silvermoon,384,warrior,arms,12,4,8
27870,Hiraclès,archimonde,384,warrior,arms,12,4,8
27871,Kaliroll,ysondre,384,warrior,arms,12,4,8
27872,Казгримм,howling-fjord,384,warrior,arms,12,4,8
27873,Invictàs,hyjal,384,warrior,arms,12,4,8
27874,Ansi,argent-dawn,384,warrior,arms,12,4,8
27875,Седлайккеану,howling-fjord,384,warrior,arms,12,4,8
27876,Kgx,argent-dawn,384,warrior,arms,12,4,8
27877,Borion,blackmoore,384,warrior,arms,12,4,8
27878,Gromock,the-maelstrom,384,warrior,arms,12,4,8
27879,Gorok,culte-de-la-rive-noire,384,warrior,arms,12,4,8
27880,Модныйклык,eversong,384,warrior,arms,12,4,8
27881,Ruuster,norgannon,384,warrior,arms,12,4,8
27882,Bladestorm,dun-morogh,384,warrior,arms,12,4,8
27883,Rumbldore,ragnaros,384,warrior,arms,12,4,8
27884,Realdrdob,kazzak,384,warrior,arms,12,4,8
27885,Haldrium,malganis,384,warrior,arms,12,4,8
27886,Dwarfdruine,dun-modr,384,warrior,arms,12,4,8
27887,Nerfslam,stormscale,384,warrior,arms,12,4,8
27888,Endagon,ravencrest,384,warrior,arms,12,4,8
27889,Hogu,nemesis,384,warrior,arms,12,4,8
27890,Jjokkerr,magtheridon,384,warrior,arms,12,4,8
27891,Blackzor,ragnaros,384,warrior,arms,12,4,8
27892,Starkz,hellscream,384,warrior,arms,12,4,8
27893,Vaxillium,argent-dawn,384,warrior,arms,12,4,8
27894,Mórghúlís,aegwynn,384,warrior,arms,12,4,8
27895,Grunkor,eldrethalas,384,warrior,arms,12,4,8
27896,Heubba,hyjal,384,warrior,arms,12,4,8
27897,Bélløne,dalaran,384,warrior,arms,12,4,8
27898,Executorä,stormscale,384,warrior,arms,12,4,8
27899,Фаллопиев,borean-tundra,384,warrior,arms,12,4,8
27900,Wilko,twisting-nether,384,warrior,arms,12,4,8
27901,Amar,defias-brotherhood,384,warrior,arms,14,4,10
27902,Gnolimits,antonidas,384,warrior,arms,18,4,14
27903,Pantsupic,archimonde,384,warrior,arms,18,4,14
27904,Jorund,archimonde,384,warrior,arms,18,4,14
27905,Vazzle,nethersturm,384,warrior,arms,18,4,14
27906,Vanaxd,blackrock,384,warrior,arms,20,4,16
27907,Бежа,gordunni,383,warrior,arms,6,4,2
27908,Angrytmyself,silvermoon,383,warrior,arms,6,4,2
27909,Dazed,kazzak,383,warrior,arms,6,4,2
27910,Adelphi,blackrock,383,warrior,arms,6,4,2
27911,Freestýlz,archimonde,383,warrior,arms,6,4,2
27912,Ironstep,silvermoon,383,warrior,arms,6,4,2
27913,Халиоссф,gordunni,383,warrior,arms,9,5,4
27914,Иалаи,howling-fjord,383,warrior,arms,8,4,4
27915,Scill,silvermoon,383,warrior,arms,12,4,8
27916,Zêrklatscher,lordaeron,383,warrior,arms,12,4,8
27917,Dundee,sanguino,383,warrior,arms,12,4,8
27918,Pøps,hyjal,383,warrior,arms,12,4,8
27919,Nélow,khaz-modan,383,warrior,arms,12,4,8
27920,Xonnico,ravencrest,383,warrior,arms,18,4,14
27921,Nêithan,dun-modr,383,warrior,arms,18,4,14
27922,Cowlunderowl,tarren-mill,383,warrior,arms,18,4,14
27923,Orchëstre,eitrigg,382,warrior,arms,6,4,2
27924,Aethwa,stormscale,382,warrior,arms,6,4,2
27925,Fatbob9D64A4,tarren-mill,382,warrior,arms,6,4,2
27926,Smkw,kazzak,380,warrior,arms,12,4,8
27927,Ruppydeluxe,frostwolf,367,warrior,arms,11,4,7
27928,Отсекатель,howling-fjord,367,warrior,arms,17,4,13
27929,Shãne,ysondre,352,warrior,arms,10,4,6
27930,Megaloddon,ravencrest,351,warrior,arms,11,4,7
27931,Shînta,hyjal,351,warrior,arms,11,4,7
27932,Krevó,ragnaros,351,warrior,arms,11,4,7
27933,Vizn,emerald-dream,351,warrior,arms,17,4,13
27934,Dolforden,burning-legion,335,warrior,arms,11,4,7
27935,Железныйбард,gordunni,335,warrior,arms,17,4,13
27936,Scarlettjo,outland,320,warrior,arms,10,4,6
27937,Dyingdog,kazzak,320,warrior,arms,10,4,6
27938,Párta,ravencrest,320,warrior,arms,10,4,6
27939,Stancenation,draenor,320,warrior,arms,16,4,12
27940,Mobyl,twisting-nether,288,warrior,arms,6,3,3
27941,Plzdontkite,blackrock,288,warrior,arms,6,3,3
27942,Lödbrök,dalaran,288,warrior,arms,6,3,3
27943,Xqty,ravencrest,288,warrior,arms,6,3,3
27944,Чтота,gordunni,288,warrior,arms,6,3,3
27945,Suizix,blackrock,288,warrior,arms,6,3,3
27946,Тарартзу,soulflayer,288,warrior,arms,6,3,3
27947,Warwarsat,ysondre,288,warrior,arms,6,3,3
27948,Notthateasy,blackrock,288,warrior,arms,6,3,3
27949,Sergra,ysondre,288,warrior,arms,6,3,3
27950,Sóuler,blackhand,288,warrior,arms,6,3,3
27951,Mfull,tarren-mill,288,warrior,arms,6,3,3
27952,Hydracleave,ravencrest,288,warrior,arms,6,3,3
27953,Фогивэн,gordunni,288,warrior,arms,6,3,3
27954,Moorgoth,ysondre,288,warrior,arms,6,3,3
27955,Elainax,eredar,288,warrior,arms,6,3,3
27956,Miniwitts,ravencrest,288,warrior,arms,6,3,3
27957,Eradya,ravencrest,288,warrior,arms,6,3,3
27958,Resttanis,arathor,288,warrior,arms,6,3,3
27959,Кроуфури,gordunni,288,warrior,arms,6,3,3
27960,Willywolxx,silvermoon,288,warrior,arms,6,3,3
27961,Lisera,thrall,288,warrior,arms,6,3,3
27962,Krisusama,ravencrest,288,warrior,arms,6,3,3
27963,Exeqty,the-maelstrom,288,warrior,arms,6,3,3
27964,Hitt,ysondre,288,warrior,arms,6,3,3
27965,Fnoon,taerar,288,warrior,arms,6,3,3
27966,Бигдэм,howling-fjord,288,warrior,arms,6,3,3
27967,Lydianite,stormrage,288,warrior,arms,6,3,3
27968,Бардеон,gordunni,288,warrior,arms,6,3,3
27969,Savaski,thrall,288,warrior,arms,6,3,3
27970,Tùcky,ysondre,288,warrior,arms,6,3,3
27971,Mävïs,ravencrest,288,warrior,arms,6,3,3
27972,Грассфеникс,gordunni,288,warrior,arms,6,3,3
27973,Ваншотч,blackscar,288,warrior,arms,6,3,3
27974,Khorgash,ravencrest,288,warrior,arms,6,3,3
27975,Хирошка,gordunni,288,warrior,arms,6,3,3
27976,Oesche,frostmourne,288,warrior,arms,6,3,3
27977,Bootyclapper,runetotem,288,warrior,arms,6,3,3
27978,Alphyn,veknilash,288,warrior,arms,6,3,3
27979,Raikaz,ravencrest,288,warrior,arms,6,3,3
27980,Антурим,howling-fjord,288,warrior,arms,6,3,3
27981,Онлихелл,howling-fjord,288,warrior,arms,6,3,3
27982,Mauricet,elune,288,warrior,arms,6,3,3
27983,Fidicenz,ysondre,288,warrior,arms,6,3,3
27984,Неомх,howling-fjord,288,warrior,arms,6,3,3
27985,Суферна,howling-fjord,288,warrior,arms,6,3,3
27986,Роули,blackscar,288,warrior,arms,6,3,3
27987,Nonow,silvermoon,288,warrior,arms,6,3,3
27988,Arnoldr,ysondre,288,warrior,arms,6,3,3
27989,Kindface,the-maelstrom,288,warrior,arms,6,3,3
27990,Schmelzlord,thrall,288,warrior,arms,6,3,3
27991,Xaidos,antonidas,288,warrior,arms,6,3,3
27992,Qweoamsd,sylvanas,288,warrior,arms,6,3,3
27993,Ghostlord,dunemaul,288,warrior,arms,6,3,3
27994,Nøøbisator,archimonde,288,warrior,arms,6,3,3
27995,Дуухаст,gordunni,288,warrior,arms,6,3,3
27996,Гатсх,blackscar,288,warrior,arms,6,3,3
27997,Ashkandur,antonidas,288,warrior,arms,6,3,3
27998,Xanco,ravencrest,288,warrior,arms,6,3,3
27999,Mightyzuv,the-maelstrom,288,warrior,arms,6,3,3
28000,Boig,ragnaros,288,warrior,arms,6,3,3
28001,Imglad,ragnaros,288,warrior,arms,6,3,3
28002,Jimei,temple-noir,288,warrior,arms,6,3,3
28003,Greifax,eredar,288,warrior,arms,6,3,3
28004,Waron,dalaran,288,warrior,arms,6,3,3
28005,Sydian,burning-legion,288,warrior,arms,6,3,3
28006,Warriorri,haomarush,288,warrior,arms,6,3,3
28007,Pwncallxx,kazzak,288,warrior,arms,6,3,3
28008,Zuggizug,draenor,288,warrior,arms,6,3,3
28009,Rhinobob,kazzak,288,warrior,arms,6,3,3
28010,Precel,burning-legion,288,warrior,arms,6,3,3
28011,Rézinplin,archimonde,288,warrior,arms,6,3,3
28012,Krigarjag,kazzak,288,warrior,arms,6,3,3
28013,Venturez,stormscale,288,warrior,arms,6,3,3
28014,Toby,rexxar,288,warrior,arms,6,3,3
28015,Cárbo,silvermoon,288,warrior,arms,6,3,3
28016,Nahkampfnoob,blackmoore,288,warrior,arms,6,3,3
28017,Tinydik,stormscale,288,warrior,arms,6,3,3
28018,Bloodx,archimonde,288,warrior,arms,6,3,3
28019,Wuifly,dun-modr,288,warrior,arms,6,3,3
28020,Naskwar,archimonde,288,warrior,arms,6,3,3
28021,Kunodontas,draenor,288,warrior,arms,6,3,3
28022,Difalco,archimonde,288,warrior,arms,6,3,3
28023,Béhrus,blackmoore,288,warrior,arms,6,3,3
28024,Mâlitek,archimonde,288,warrior,arms,6,3,3
28025,Cerßêre,archimonde,288,warrior,arms,6,3,3
28026,Dðni,archimonde,288,warrior,arms,6,3,3
28027,Sktnsilv,malfurion,288,warrior,arms,6,3,3
28028,Hanibalbarca,tarren-mill,288,warrior,arms,6,3,3
28029,Sonyd,tarren-mill,288,warrior,arms,6,3,3
28030,Tojaraa,kazzak,288,warrior,arms,6,3,3
28031,Bânkai,aegwynn,288,warrior,arms,6,3,3
28032,Threnewar,kazzak,288,warrior,arms,6,3,3
28033,Matrixer,aegwynn,288,warrior,arms,6,3,3
28034,Raistwar,magtheridon,288,warrior,arms,6,3,3
28035,Gorejaws,draenor,288,warrior,arms,6,3,3
28036,Warriur,outland,288,warrior,arms,6,3,3
28037,Bigdstance,outland,288,warrior,arms,6,3,3
28038,Barbatos,saurfang,288,warrior,arms,6,3,3
28039,Runout,outland,288,warrior,arms,6,3,3
28040,Bladesmiths,argent-dawn,288,warrior,arms,6,3,3
28041,Zersei,los-errantes,288,warrior,arms,6,3,3
28042,Frenzyqt,zuljin,288,warrior,arms,6,3,3
28043,Koliastra,magtheridon,288,warrior,arms,6,3,3
28044,Afes,kazzak,288,warrior,arms,6,3,3
28045,Bonkonator,stormscale,288,warrior,arms,6,3,3
28046,Spearmisser,argent-dawn,288,warrior,arms,6,3,3
28047,Arashicage,emeriss,288,warrior,arms,6,3,3
28048,Balthew,defias-brotherhood,288,warrior,arms,6,3,3
28049,Ланат,ashenvale,288,warrior,arms,6,3,3
28050,Greatsword,turalyon,288,warrior,arms,6,3,3
28051,Doloresvp,zuljin,288,warrior,arms,6,3,3
28052,Pyxis,argent-dawn,288,warrior,arms,6,3,3
28053,Valus,earthen-ring,288,warrior,arms,6,3,3
28054,Shïn,kaelthas,288,warrior,arms,6,3,3
28055,Twelvearmsun,tarren-mill,288,warrior,arms,6,3,3
28056,Goochi,turalyon,288,warrior,arms,6,3,3
28057,Somalisktjur,tarren-mill,288,warrior,arms,6,3,3
28058,Mønzie,outland,288,warrior,arms,6,3,3
28059,Issus,aggra-português,288,warrior,arms,6,3,3
28060,Варбаул,soulflayer,288,warrior,arms,6,3,3
28061,Klistertejp,argent-dawn,288,warrior,arms,6,3,3
28062,Lìcious,outland,288,warrior,arms,6,3,3
28063,Chépérøs,kaelthas,288,warrior,arms,6,3,3
28064,Thickslam,argent-dawn,288,warrior,arms,6,3,3
28065,Hatefull,onyxia,288,warrior,arms,6,3,3
28066,Flürix,outland,288,warrior,arms,6,3,3
28067,Rianhh,tarren-mill,288,warrior,arms,6,3,3
28068,Nipes,nozdormu,288,warrior,arms,6,3,3
28069,Féélmyfury,tarren-mill,288,warrior,arms,6,3,3
28070,Martøswarr,uldum,288,warrior,arms,6,3,3
28071,Møtomoto,defias-brotherhood,288,warrior,arms,6,3,3
28072,Stompare,tarren-mill,288,warrior,arms,6,3,3
28073,Raïgã,hyjal,288,warrior,arms,6,3,3
28074,Opticsynfel,argent-dawn,288,warrior,arms,6,3,3
28075,Jammy,dentarg,288,warrior,arms,6,3,3
28076,Tbomb,stormscale,288,warrior,arms,6,3,3
28077,Ludjack,tarren-mill,288,warrior,arms,6,3,3
28078,Tankdepalo,sanguino,288,warrior,arms,6,3,3
28079,Hanna,argent-dawn,288,warrior,arms,6,3,3
28080,Gabbz,aggra-português,288,warrior,arms,6,3,3
28081,Ckx,kazzak,288,warrior,arms,6,3,3
28082,Despacitus,burning-legion,288,warrior,arms,6,3,3
28083,Vexxenn,outland,288,warrior,arms,10,4,6
28084,Górut,zuljin,288,warrior,arms,10,3,7
28085,Bolvarson,malganis,288,warrior,arms,12,3,9
28086,Flexay,archimonde,288,warrior,arms,12,3,9
28087,Poluneikos,turalyon,288,warrior,arms,12,3,9
28088,Calmdownbrú,frostmane,288,warrior,arms,12,3,9
28089,Gladiatoor,terenas,288,warrior,arms,12,3,9
28090,Carksn,blackmoore,288,warrior,arms,12,3,9
28091,Анакронокс,howling-fjord,288,warrior,arms,12,3,9
28092,Cirenax,draenor,288,warrior,arms,12,3,9
28093,Blxxwar,blackmoore,288,warrior,arms,12,3,9
28094,Telrion,silvermoon,288,warrior,arms,12,3,9
28095,Smökey,silvermoon,288,warrior,arms,12,3,9
28096,Бэнчпресс,soulflayer,288,warrior,arms,12,3,9
28097,Ruioz,draenor,288,warrior,arms,12,3,9
28098,Шпингалетыч,howling-fjord,288,warrior,arms,12,3,9
28099,Wingüi,dun-modr,288,warrior,arms,12,3,9
28100,Koorkhan,outland,288,warrior,arms,12,3,9
28101,Mercûry,stormscale,288,warrior,arms,12,3,9
28102,Азизос,gordunni,288,warrior,arms,12,3,9
28103,Romic,guldan,288,warrior,arms,12,3,9
28104,Warzaph,ravencrest,288,warrior,arms,12,3,9
28105,Sorryforwhat,stormscale,288,warrior,arms,12,3,9
28106,Тирхо,gordunni,288,warrior,arms,12,3,9
28107,Iarsonn,drakthul,288,warrior,arms,12,3,9
28108,Jonukas,argent-dawn,288,warrior,arms,12,3,9
28109,Vrokoda,quelthalas,288,warrior,arms,12,3,9
28110,Qdex,kazzak,288,warrior,arms,12,3,9
28111,Ravedeath,tarren-mill,288,warrior,arms,12,3,9
28112,Zhodd,zuljin,288,warrior,arms,12,3,9
28113,Awewar,crushridge,288,warrior,arms,12,3,9
28114,Грруд,galakrond,288,warrior,arms,12,3,9
28115,Garganelli,tarren-mill,288,warrior,arms,12,3,9
28116,Raithwall,stormreaver,288,warrior,arms,12,3,9
28117,Aiwar,tarren-mill,288,warrior,arms,12,3,9
28118,Grodor,alakir,288,warrior,arms,12,3,9
28119,Melliug,ysondre,288,warrior,arms,12,3,9
28120,Maxxiwumms,amanthul,288,warrior,arms,12,3,9
28121,Abrash,ysondre,288,warrior,arms,12,3,9
28122,Wanzzeur,hyjal,288,warrior,arms,17,3,14
28123,Luckysop,chants-éternels,288,warrior,arms,18,3,15
28124,Olagkhan,minahonda,287,warrior,arms,6,3,3
28125,Sheriff,dragonblight,287,warrior,arms,6,3,3
28126,Smeshh,burning-legion,287,warrior,arms,6,3,3
28127,Lapyy,drakthul,287,warrior,arms,6,3,3
28128,Mercaderx,stormscale,287,warrior,arms,6,3,3
28129,Bashion,ghostlands,287,warrior,arms,6,3,3
28130,Crasher,dentarg,287,warrior,arms,6,3,3
28131,Freakzy,blackhand,287,warrior,arms,12,3,9
28132,Heavenheart,bronzebeard,286,warrior,arms,6,3,3
28133,Рф,thermaplugg,271,warrior,arms,11,3,8
28134,Evèllon,blackmoore,271,warrior,arms,11,3,8
28135,Gwagonbrabus,twisting-nether,271,warrior,arms,17,3,14
28136,Kanyequest,bloodhoof,266,warrior,arms,15,5,10
28137,Jvpx,silvermoon,256,warrior,arms,10,3,7
28138,Fion,kult-der-verdammten,255,warrior,arms,8,4,4
28139,Angrethar,tarren-mill,255,warrior,arms,8,4,4
28140,Greeneroi,khaz-modan,255,warrior,arms,11,3,8
28141,Ânaxi,silvermoon,255,warrior,arms,11,3,8
28142,Ahlda,hyjal,240,warrior,arms,15,3,12
28143,Keffboi,draenor,239,warrior,arms,5,3,2
28144,Inselmo,grim-batol,239,warrior,arms,5,3,2
28145,Sarma,trollbane,239,warrior,arms,5,3,2
28146,Армсег,soulflayer,239,warrior,arms,5,3,2
28147,Renji,proudmoore,239,warrior,arms,5,3,2
28148,Bubidiblumxq,twisting-nether,239,warrior,arms,9,4,5
28149,Mölntuss,emeriss,239,warrior,arms,11,3,8
28150,Tstrike,silvermoon,234,warrior,arms,9,4,5
28151,Enÿo,stormscale,234,warrior,arms,23,6,17
28152,Waf,hakkar,223,warrior,arms,8,3,5
28153,Шрекинатор,soulflayer,208,warrior,arms,7,3,4
28154,Miotyz,ahnqiraj,192,warrior,arms,6,2,4
28155,Lakes,eredar,192,warrior,arms,6,2,4
28156,Ивантуз,gordunni,192,warrior,arms,6,2,4
28157,Гудмунт,borean-tundra,192,warrior,arms,6,2,4
28158,Zaoclap,blackhand,192,warrior,arms,6,2,4
28159,Экзекутэр,soulflayer,192,warrior,arms,6,2,4
28160,Хедтакер,gordunni,192,warrior,arms,6,2,4
28161,Arthayl,eredar,192,warrior,arms,6,2,4
28162,Unehuitsept,eredar,192,warrior,arms,6,2,4
28163,Ladoz,ragnaros,192,warrior,arms,6,2,4
28164,Míngxuan,tarren-mill,192,warrior,arms,6,2,4
28165,Mifuune,argent-dawn,192,warrior,arms,6,2,4
28166,Bigestdamugr,stormscale,192,warrior,arms,6,2,4
28167,Zugpump,tarren-mill,192,warrior,arms,6,2,4
28168,Abibe,aggra-português,192,warrior,arms,6,2,4
28169,Tekà,tarren-mill,192,warrior,arms,6,2,4
28170,Nînes,tarren-mill,192,warrior,arms,6,2,4
28171,Moolong,nozdormu,192,warrior,arms,6,2,4
28172,Wilæm,argent-dawn,192,warrior,arms,6,2,4
28173,Blizo,tarren-mill,192,warrior,arms,6,2,4
28174,Rhaegon,laughing-skull,192,warrior,arms,6,2,4
28175,Kante,frostmane,192,warrior,arms,6,2,4
28176,Milant,antonidas,192,warrior,arms,6,2,4
28177,Fastnfuryous,antonidas,192,warrior,arms,6,2,4
28178,Unhingéd,stormscale,192,warrior,arms,6,2,4
28179,Algazarra,aggra-português,192,warrior,arms,6,2,4
28180,Scheroh,aegwynn,192,warrior,arms,6,2,4
28181,Ptp,argent-dawn,192,warrior,arms,6,2,4
28182,Bicepss,blackhand,192,warrior,arms,6,2,4
28183,Repó,twisting-nether,192,warrior,arms,6,2,4
28184,Zerxees,tarren-mill,192,warrior,arms,6,2,4
28185,Кереешка,howling-fjord,192,warrior,arms,6,2,4
28186,Shimy,pozzo-delleternità,192,warrior,arms,6,2,4
28187,Dutteh,tarren-mill,192,warrior,arms,6,2,4
28188,Hundar,archimonde,192,warrior,arms,6,2,4
28189,Krîspie,archimonde,192,warrior,arms,6,2,4
28190,Эгнораш,soulflayer,192,warrior,arms,6,2,4
28191,Ciuez,tarren-mill,192,warrior,arms,6,2,4
28192,Redencounter,stormscale,192,warrior,arms,6,2,4
28193,Burkek,hyjal,192,warrior,arms,6,2,4
28194,Eleborn,tarren-mill,192,warrior,arms,6,2,4
28195,Broley,blackhand,192,warrior,arms,6,2,4
28196,Sibali,stormreaver,192,warrior,arms,6,2,4
28197,Хэлвид,soulflayer,192,warrior,arms,6,2,4
28198,Blademir,aegwynn,192,warrior,arms,6,2,4
28199,Linberg,ysondre,192,warrior,arms,6,2,4
28200,Kaerz,ysondre,192,warrior,arms,6,2,4
28201,Meìlie,outland,192,warrior,arms,6,2,4
28202,Cjak,pozzo-delleternità,192,warrior,arms,6,2,4
28203,Ryonâgai,aegwynn,192,warrior,arms,6,2,4
28204,Pvpstyle,bloodscalp,192,warrior,arms,6,2,4
28205,Gretathunb,twisting-nether,192,warrior,arms,6,2,4
28206,Yoz,uldaman,192,warrior,arms,6,2,4
28207,Katypärry,outland,192,warrior,arms,6,2,4
28208,Luffydono,stormscale,192,warrior,arms,6,2,4
28209,Jäky,ragnaros,192,warrior,arms,6,2,4
28210,Nocton,blackhand,192,warrior,arms,6,2,4
28211,Eyolf,thunderhorn,192,warrior,arms,6,2,4
28212,Ericmontana,draenor,192,warrior,arms,6,2,4
28213,Shádówfáxí,outland,192,warrior,arms,6,2,4
28214,Rochful,frostwolf,192,warrior,arms,6,2,4
28215,Garthro,antonidas,192,warrior,arms,6,2,4
28216,Elinyar,aegwynn,192,warrior,arms,6,2,4
28217,Rastaboo,ravencrest,192,warrior,arms,6,2,4
28218,Svepscumata,twisting-nether,192,warrior,arms,6,2,4
28219,Бормормуш,gordunni,192,warrior,arms,6,2,4
28220,Dariman,aegwynn,192,warrior,arms,6,2,4
28221,Äsgeïr,archimonde,192,warrior,arms,6,2,4
28222,Irherklek,stormscale,192,warrior,arms,6,2,4
28223,Galenthor,ravencrest,192,warrior,arms,6,2,4
28224,Salsetti,nemesis,192,warrior,arms,6,2,4
28225,Aléxsandra,ravencrest,192,warrior,arms,6,2,4
28226,Acour,elune,192,warrior,arms,6,2,4
28227,Falaliss,elune,192,warrior,arms,6,2,4
28228,Bazsika,ragnaros,192,warrior,arms,6,2,4
28229,Siberianstag,ravencrest,192,warrior,arms,6,2,4
28230,Андервульф,booty-bay,192,warrior,arms,6,2,4
28231,Syrebral,archimonde,192,warrior,arms,6,2,4
28232,Seghrim,drakthul,192,warrior,arms,6,2,4
28233,Rutch,hyjal,192,warrior,arms,6,2,4
28234,Highoverlord,aggra-português,192,warrior,arms,6,2,4
28235,Барнаул,gordunni,192,warrior,arms,6,2,4
28236,Woghard,drakthul,192,warrior,arms,6,2,4
28237,Gkavlaki,ravencrest,192,warrior,arms,6,2,4
28238,Fugrim,draenor,192,warrior,arms,6,2,4
28239,Robthebruce,ravencrest,192,warrior,arms,6,2,4
28240,Iordmatesp,drakthul,192,warrior,arms,6,2,4
28241,Spaiché,azshara,192,warrior,arms,6,2,4
28242,Darlith,azshara,192,warrior,arms,6,2,4
28243,Phalekxox,twisting-nether,192,warrior,arms,6,2,4
28244,Havkon,twisting-nether,192,warrior,arms,6,2,4
28245,Груббоб,booty-bay,192,warrior,arms,6,2,4
28246,Razoo,stormscale,192,warrior,arms,6,2,4
28247,Чухануспрайм,howling-fjord,192,warrior,arms,6,2,4
28248,Athënã,archimonde,192,warrior,arms,6,2,4
28249,Bulduzer,kazzak,192,warrior,arms,6,2,4
28250,Sepuko,stormscale,192,warrior,arms,6,2,4
28251,Warrlee,ravencrest,192,warrior,arms,6,2,4
28252,Stepmomgodx,kazzak,192,warrior,arms,6,2,4
28253,Кичисан,howling-fjord,192,warrior,arms,6,2,4
28254,Мэднас,howling-fjord,192,warrior,arms,6,2,4
28255,Sinkiss,archimonde,192,warrior,arms,6,2,4
28256,Ratafya,hyjal,192,warrior,arms,6,2,4
28257,ßandit,ravencrest,192,warrior,arms,6,2,4
28258,Bulbasaur,twisting-nether,192,warrior,arms,6,2,4
28259,Рагаксес,blackscar,192,warrior,arms,6,2,4
28260,Ratnìk,stormscale,192,warrior,arms,6,2,4
28261,Wärlør,ravencrest,192,warrior,arms,6,2,4
28262,Kíllguard,kazzak,192,warrior,arms,6,2,4
28263,Hitmanler,frostmane,192,warrior,arms,6,2,4
28264,Totenkrieger,draenor,192,warrior,arms,6,2,4
28265,Thebigtosco,ravencrest,192,warrior,arms,6,2,4
28266,Touthi,archimonde,192,warrior,arms,6,2,4
28267,Grimilax,hellscream,192,warrior,arms,6,2,4
28268,Brutalizator,talnivarr,192,warrior,arms,6,2,4
28269,Xilthy,stormscale,192,warrior,arms,6,2,4
28270,Audelia,sunstrider,192,warrior,arms,6,2,4
28271,Kladers,ravencrest,192,warrior,arms,6,2,4
28272,Weezing,argent-dawn,192,warrior,arms,6,2,4
28273,Darkbehemoth,kazzak,192,warrior,arms,6,2,4
28274,Frézzér,blackrock,192,warrior,arms,6,2,4
28275,Rayguerrero,blackrock,192,warrior,arms,6,2,4
28276,Dabr,stormscale,192,warrior,arms,6,2,4
28277,Astost,silvermoon,192,warrior,arms,6,2,4
28278,Chloade,burning-legion,192,warrior,arms,6,2,4
28279,Snissel,guldan,192,warrior,arms,6,2,4
28280,Tigron,burning-legion,192,warrior,arms,6,2,4
28281,Byedriver,kazzak,192,warrior,arms,6,2,4
28282,Bonkors,bronzebeard,192,warrior,arms,6,2,4
28283,Vaaýzx,blackrock,192,warrior,arms,6,2,4
28284,Artheim,silvermoon,192,warrior,arms,6,2,4
28285,Kharabik,silvermoon,192,warrior,arms,6,2,4
28286,Spacemachine,kazzak,192,warrior,arms,6,2,4
28287,Raggnnar,blackrock,192,warrior,arms,6,2,4
28288,Kehnan,blackrock,192,warrior,arms,6,2,4
28289,Очепенец,soulflayer,192,warrior,arms,6,2,4
28290,Longy,mazrigos,192,warrior,arms,6,2,4
28291,Därlara,amanthul,192,warrior,arms,6,2,4
28292,Artemiox,silvermoon,192,warrior,arms,6,2,4
28293,Kerando,tirion,192,warrior,arms,6,2,4
28294,Lildiabeto,darkspear,192,warrior,arms,6,2,4
28295,Darkwa,azjolnerub,192,warrior,arms,6,2,4
28296,Vlader,dun-modr,192,warrior,arms,6,2,4
28297,Gaarrossh,kazzak,192,warrior,arms,6,2,4
28298,Apolyptica,blackmoore,192,warrior,arms,6,2,4
28299,Discoklaus,blackmoore,192,warrior,arms,6,2,4
28300,Yatõ,blackmoore,192,warrior,arms,6,2,4
28301,Æyra,durotan,192,warrior,arms,6,2,4
28302,Cyrø,blackmoore,192,warrior,arms,6,2,4
28303,Amphie,silvermoon,192,warrior,arms,6,2,4
28304,Creezê,blackmoore,192,warrior,arms,6,2,4
28305,Frcwar,kazzak,192,warrior,arms,6,2,4
28306,Kurosawa,uldum,192,warrior,arms,6,2,4
28307,Critwar,silvermoon,192,warrior,arms,6,2,4
28308,Sadex,blackmoore,192,warrior,arms,6,2,4
28309,Enzylolz,sanguino,192,warrior,arms,6,2,4
28310,Vearpayne,silvermoon,192,warrior,arms,6,2,4
28311,Trohr,blackmoore,192,warrior,arms,6,2,4
28312,Guryn,sanguino,192,warrior,arms,6,2,4
28313,Maeselance,dun-modr,192,warrior,arms,6,2,4
28314,Faláfel,zuljin,192,warrior,arms,6,2,4
28315,Røcksteady,festung-der-stürme,192,warrior,arms,6,2,4
28316,Lâppön,blackmoore,192,warrior,arms,6,2,4
28317,Eriqua,archimonde,192,warrior,arms,8,2,6
28318,Lzdmfckmeazy,blackmoore,192,warrior,arms,12,2,10
28319,Erololi,sanguino,192,warrior,arms,12,2,10
28320,Otzi,sargeras,192,warrior,arms,12,2,10
28321,Gorzan,dragonmaw,192,warrior,arms,12,2,10
28322,Radge,hyjal,192,warrior,arms,12,2,10
28323,Rukkeg,silvermoon,192,warrior,arms,12,2,10
28324,Péridotruite,hyjal,192,warrior,arms,12,2,10
28325,Battousai,sanguino,192,warrior,arms,12,2,10
28326,Утонаган,fordragon,192,warrior,arms,12,2,10
28327,Solidier,archimonde,192,warrior,arms,12,2,10
28328,Furybringer,silvermoon,192,warrior,arms,12,2,10
28329,Takatoa,argent-dawn,192,warrior,arms,12,2,10
28330,Gramash,grim-batol,192,warrior,arms,12,2,10
28331,Actoni,sylvanas,192,warrior,arms,12,2,10
28332,Younes,ravencrest,192,warrior,arms,12,2,10
28333,Bhallts,twisting-nether,192,warrior,arms,12,2,10
28334,Tyranoth,defias-brotherhood,192,warrior,arms,12,2,10
28335,Maxeyn,kazzak,192,warrior,arms,18,2,16
28336,Razzimak,eredar,191,warrior,arms,4,3,1
28337,Oxascand,kazzak,175,warrior,arms,11,2,9
28338,Номер,eversong,160,warrior,arms,10,2,8
28339,Deadwily,twisting-nether,159,warrior,arms,5,2,3
28340,Kibb,sylvanas,159,warrior,arms,5,2,3
28341,Khilax,ragnaros,159,warrior,arms,5,2,3
28342,Bloodpyre,nemesis,159,warrior,arms,11,2,9
28343,Amystad,ahnqiraj,144,warrior,arms,9,2,7
28344,Gondyr,quelthalas,144,warrior,arms,15,2,13
28345,Nobelisarius,norgannon,138,warrior,arms,11,5,6
28346,Lilsib,outland,138,warrior,arms,7,3,4
28347,Hasira,xavius,128,warrior,arms,4,2,2
28348,Dreadoran,voljin,112,warrior,arms,7,2,5
28349,Estarotte,ravencrest,112,warrior,arms,7,2,5
28350,Rdeniro,blackmoore,96,warrior,arms,3,2,1
28351,Nekwar,ravencrest,96,warrior,arms,3,2,1
28352,Kyraxe,silvermoon,96,warrior,arms,3,2,1
28353,Lasttfallen,hyjal,96,warrior,arms,3,2,1
28354,Kylian,aegwynn,96,warrior,arms,6,1,5
28355,Ayasaki,argent-dawn,96,warrior,arms,6,1,5
28356,Brutannya,argent-dawn,96,warrior,arms,6,1,5
28357,Belmont,doomhammer,96,warrior,arms,6,1,5
28358,Abukrd,turalyon,96,warrior,arms,6,1,5
28359,Crook,doomhammer,96,warrior,arms,6,1,5
28360,Blackmoor,argent-dawn,96,warrior,arms,6,1,5
28361,Rikkavikki,argent-dawn,96,warrior,arms,6,1,5
28362,Naiph,blackmoore,96,warrior,arms,6,1,5
28363,Geroldius,silvermoon,96,warrior,arms,6,1,5
28364,Taroom,turalyon,96,warrior,arms,6,1,5
28365,Üzzy,dun-modr,96,warrior,arms,6,1,5
28366,Lithanør,silvermoon,96,warrior,arms,6,1,5
28367,Stillpetao,dun-modr,96,warrior,arms,6,1,5
28368,Axelitee,draenor,96,warrior,arms,6,1,5
28369,Ugbruk,blackhand,96,warrior,arms,6,1,5
28370,Rohc,kazzak,96,warrior,arms,6,1,5
28371,Warfield,draenor,96,warrior,arms,6,1,5
28372,Murämasä,hyjal,96,warrior,arms,6,1,5
28373,Leapling,blackmoore,96,warrior,arms,6,1,5
28374,Kamelskum,draenor,96,warrior,arms,6,1,5
28375,Durrüti,sanguino,96,warrior,arms,6,1,5
28376,Ifir,hyjal,96,warrior,arms,6,1,5
28377,Molsah,draenor,96,warrior,arms,6,1,5
28378,Pwndrizle,blackmoore,96,warrior,arms,6,1,5
28379,Craftorar,defias-brotherhood,96,warrior,arms,6,1,5
28380,Magmos,terenas,96,warrior,arms,6,1,5
28381,Juanvaco,tarren-mill,96,warrior,arms,6,1,5
28382,Armyne,kazzak,96,warrior,arms,6,1,5
28383,Marax,spinebreaker,96,warrior,arms,6,1,5
28384,Darkmain,outland,96,warrior,arms,6,1,5
28385,Beduin,twilights-hammer,96,warrior,arms,6,1,5
28386,Dundulinka,outland,96,warrior,arms,6,1,5
28387,Santorro,drakthul,96,warrior,arms,6,1,5
28388,Lilsweép,draenor,96,warrior,arms,6,1,5
28389,Meistarinn,draenor,96,warrior,arms,6,1,5
28390,Galatan,kazzak,96,warrior,arms,6,1,5
28391,Recklessness,drakthul,96,warrior,arms,6,1,5
28392,Wigman,shattered-hand,96,warrior,arms,6,1,5
28393,Claymøre,khaz-modan,96,warrior,arms,6,1,5
28394,Feltias,drakthul,96,warrior,arms,6,1,5
28395,Davidass,drakthul,96,warrior,arms,6,1,5
28396,Gorroth,chamber-of-aspects,96,warrior,arms,6,1,5
28397,Osopeligroso,outland,96,warrior,arms,6,1,5
28398,Gnomeð,blackrock,96,warrior,arms,6,1,5
28399,Midvînter,silvermoon,96,warrior,arms,6,1,5
28400,Romppu,shattered-hand,96,warrior,arms,6,1,5
28401,Catrine,drakthul,96,warrior,arms,6,1,5
28402,Zeover,ragnaros,96,warrior,arms,6,1,5
28403,Yngvar,darksorrow,96,warrior,arms,6,1,5
28404,Xail,rexxar,96,warrior,arms,6,1,5
28405,Deathsnarl,ragnaros,96,warrior,arms,6,1,5
28406,Luntee,ragnaros,96,warrior,arms,6,1,5
28407,Moowar,defias-brotherhood,96,warrior,arms,6,1,5
28408,Acudam,stormscale,96,warrior,arms,6,1,5
28409,Monsterborn,bloodhoof,96,warrior,arms,6,1,5
28410,Leryswarro,sanguino,96,warrior,arms,6,1,5
28411,Zetorc,burning-legion,96,warrior,arms,6,1,5
28412,Executê,kazzak,96,warrior,arms,6,1,5
28413,Bravestar,ungoro,96,warrior,arms,6,1,5
28414,Molløtov,sargeras,96,warrior,arms,6,1,5
28415,Redjaw,twisting-nether,96,warrior,arms,6,1,5
28416,Oksimbillah,blackrock,96,warrior,arms,6,1,5
28417,Letha,twisting-nether,96,warrior,arms,6,1,5
28418,Ordovis,silvermoon,96,warrior,arms,6,1,5
28419,Арленхейтлав,gordunni,96,warrior,arms,6,1,5
28420,Шапканауши,eversong,96,warrior,arms,6,1,5
28421,Рсдрпб,eversong,96,warrior,arms,6,1,5
28422,Dracos,mannoroth,96,warrior,arms,6,1,5
28423,Pyrul,antonidas,96,warrior,arms,6,1,5
28424,Слоз,gordunni,96,warrior,arms,6,1,5
28425,Winedru,bronzebeard,96,warrior,arms,6,1,5
28426,Humanboi,ravencrest,96,warrior,arms,6,1,5
28427,Талейлан,gordunni,96,warrior,arms,6,1,5
28428,Sarkan,ravencrest,96,warrior,arms,6,1,5
28429,Karyoroo,eredar,96,warrior,arms,6,1,5
28430,Soley,neptulon,96,warrior,arms,6,1,5
28431,Tidùs,nethersturm,96,warrior,arms,6,1,5
28432,Greenbeanx,antonidas,96,warrior,arms,6,1,5
28433,Stretch,thrall,96,warrior,arms,6,1,5
28434,Bloodpath,stormrage,96,warrior,arms,6,1,5
28435,Azjolnerub,kazzak,96,warrior,arms,6,1,5
28436,Æxcoast,ravencrest,96,warrior,arms,6,1,5
28437,Ivailowar,ravencrest,96,warrior,arms,6,1,5
28438,Scootter,ravencrest,96,warrior,arms,6,1,5
28439,Sebastian,ravencrest,96,warrior,arms,6,1,5
28440,Tomhankz,ravencrest,96,warrior,arms,6,1,5
28441,Spritekoppen,ravencrest,96,warrior,arms,6,1,5
28442,Elsinner,ravencrest,96,warrior,arms,6,1,5
28443,Pinkblast,sylvanas,96,warrior,arms,6,1,5
28444,Màndø,archimonde,96,warrior,arms,7,1,6
28445,Tàuruss,blackhand,96,warrior,arms,7,1,6
28446,Moshpít,antonidas,96,warrior,arms,12,1,11
28447,Отпустите,howling-fjord,96,warrior,arms,12,1,11
28448,Babæ,ravencrest,96,warrior,arms,12,1,11
28449,Blufurys,nemesis,96,warrior,arms,14,1,13
28450,Sangarane,archimonde,95,warrior,arms,3,2,1
28451,Gìlgamesh,dun-modr,84,warrior,arms,19,4,15
28452,Koboone,tarren-mill,79,warrior,arms,5,1,4
28453,Rimmedpigeon,alakir,64,warrior,arms,4,1,3
28454,Rinos,silvermoon,63,warrior,arms,8,2,6
28455,Garaha,argent-dawn,48,warrior,arms,3,1,2
28456,Elloo,tarren-mill,48,warrior,arms,3,1,2
28457,Данилатитич,howling-fjord,48,warrior,arms,3,1,2
28458,Матумбо,gordunni,48,warrior,arms,3,1,2
28459,Warriar,sylvanas,42,warrior,arms,11,3,8
28460,Myshu,ravencrest,42,warrior,arms,8,2,6
28461,Артен,ashenvale,42,warrior,arms,10,2,8
28462,Glut,drakthul,42,warrior,arms,12,2,10
28463,Reyon,argent-dawn,41,warrior,arms,6,2,4
28464,Eijnar,kazzak,31,warrior,arms,2,1,1
28465,Гангстарэпер,gordunni,31,warrior,arms,2,1,1
28466,Clówny,garrosh,31,warrior,arms,8,1,7
28467,Ugrlak,drakthul,16,warrior,arms,7,1,6
28468,Sublexgg,blackrock,1868,warrior,protection,43,24,19
28469,Swagenknecht,blackrock,1840,warrior,protection,66,31,35
28470,Narrative,kazzak,1091,warrior,protection,54,20,34
28471,Blaying,ravencrest,958,warrior,protection,18,10,8
28472,Tríbún,kult-der-verdammten,854,warrior,protection,18,9,9
28473,Ferran,sanguino,570,warrior,protection,18,6,12
28474,Flinn,die-nachtwache,376,warrior,protection,18,4,14
28475,Флоуби,razuvious,287,warrior,protection,6,3,3
28476,Денеур,gordunni,192,warrior,protection,6,2,4
