,name,realm,rating,cls,spec,play,win,lose
0,Rahbekius,kazzak,1519,deathknight,blood,225,103,122
1,Эваер,blackscar,1506,deathknight,blood,60,29,31
2,Hoggster,kazzak,1416,deathknight,blood,75,28,47
3,Maylined,antonidas,1316,deathknight,blood,36,16,20
4,Horrorda,defias-brotherhood,1265,deathknight,blood,44,24,20
5,Nîghtmáre,ravencrest,1180,deathknight,blood,35,20,15
6,Ducados,forscherliga,952,deathknight,blood,24,12,12
7,Minoporc,archimonde,916,deathknight,blood,39,14,25
8,Wickedgray,outland,672,deathknight,blood,12,7,5
9,Schiva,eredar,607,deathknight,blood,23,7,16
10,Smalldk,silvermoon,574,deathknight,blood,18,6,12
11,Оосака,gordunni,573,deathknight,blood,24,6,18
12,Downtoclown,argent-dawn,480,deathknight,blood,12,5,7
13,Bloodzin,frostwhisper,480,deathknight,blood,12,5,7
14,Helixnc,silvermoon,480,deathknight,blood,12,5,7
15,Schwuischädl,eredar,479,deathknight,blood,12,5,7
16,Zdan,sylvanas,476,deathknight,blood,12,5,7
17,Akamechân,frostmourne,382,deathknight,blood,6,4,2
18,Hellcrosser,blackrock,381,deathknight,blood,12,4,8
19,Airok,proudmoore,381,deathknight,blood,12,4,8
20,Pinkish,argent-dawn,379,deathknight,blood,12,4,8
21,Барагган,thermaplugg,288,deathknight,blood,6,3,3
22,Кмамехочу,howling-fjord,288,deathknight,blood,18,3,15
23,Oxcidium,archimonde,287,deathknight,blood,6,3,3
24,Pechugona,zuljin,287,deathknight,blood,24,3,21
25,Dromadeus,sylvanas,286,deathknight,blood,12,3,9
26,Calculated,spinebreaker,192,deathknight,blood,6,2,4
27,Rakia,defias-brotherhood,191,deathknight,blood,12,2,10
28,Fixmybones,frostmane,96,deathknight,blood,6,1,5
29,Maradk,drakthul,96,deathknight,blood,6,1,5
30,Нишимба,soulflayer,2121,deathknight,unholy,90,46,44
31,Страхолит,soulflayer,2107,deathknight,unholy,179,89,90
32,Хайвейтухэлл,soulflayer,2098,deathknight,unholy,96,48,48
33,Conqueròr,tarren-mill,2083,deathknight,unholy,94,46,48
34,Кромгона,soulflayer,2023,deathknight,unholy,136,83,53
35,Bíllÿ,kazzak,2003,deathknight,unholy,104,56,48
36,Storhøf,sanguino,1982,deathknight,unholy,108,61,47
37,Bedstemoor,ravencrest,1982,deathknight,unholy,120,63,57
38,Elite,xavius,1977,deathknight,unholy,74,39,35
39,Leónid,kazzak,1962,deathknight,unholy,72,36,36
40,Enzy,drakthul,1948,deathknight,unholy,42,26,16
41,Hotcherryx,dun-modr,1946,deathknight,unholy,192,97,95
42,Дайтоолгоун,gordunni,1937,deathknight,unholy,113,56,57
43,Leomordf,doomhammer,1919,deathknight,unholy,244,136,108
44,Murky,kazzak,1918,deathknight,unholy,262,129,133
45,Bøby,kul-tiras,1917,deathknight,unholy,60,31,29
46,Shadowdeathj,kazzak,1913,deathknight,unholy,54,27,27
47,Vakü,burning-legion,1907,deathknight,unholy,558,275,283
48,Worlviuz,argent-dawn,1905,deathknight,unholy,141,70,71
49,Шайбовёрт,gordunni,1884,deathknight,unholy,130,66,64
50,Валькейн,blackscar,1883,deathknight,unholy,60,32,28
51,Fxckingmad,ravencrest,1883,deathknight,unholy,72,37,35
52,Yazga,blackmoore,1883,deathknight,unholy,65,32,33
53,Akaliz,die-aldor,1876,deathknight,unholy,66,35,31
54,Ipanic,argent-dawn,1875,deathknight,unholy,228,120,108
55,Eyyoo,blackmoore,1875,deathknight,unholy,70,35,35
56,Necrølyte,sylvanas,1874,deathknight,unholy,120,64,56
57,Bóby,ravencrest,1873,deathknight,unholy,297,140,157
58,Narali,argent-dawn,1859,deathknight,unholy,72,34,38
59,Likewise,twisting-nether,1853,deathknight,unholy,48,20,28
60,Vallenhal,twisting-nether,1850,deathknight,unholy,48,23,25
61,Azüla,ysondre,1848,deathknight,unholy,66,30,36
62,Fabricius,blackrock,1847,deathknight,unholy,66,36,30
63,Меланндрис,gordunni,1845,deathknight,unholy,60,44,16
64,Лордпафос,blackscar,1844,deathknight,unholy,66,37,29
65,Øtherànóther,stormscale,1843,deathknight,unholy,54,30,24
66,Ezlyy,ravencrest,1843,deathknight,unholy,114,60,54
67,Кромгон,soulflayer,1843,deathknight,unholy,61,30,31
68,Amnésyx,ysondre,1842,deathknight,unholy,64,32,32
69,Frege,tarren-mill,1839,deathknight,unholy,84,43,41
70,Nómòre,ravencrest,1839,deathknight,unholy,60,30,30
71,Mockingbirdo,sanguino,1836,deathknight,unholy,36,24,12
72,Fennro,ysondre,1836,deathknight,unholy,300,147,153
73,Аронас,blackscar,1833,deathknight,unholy,83,42,41
74,Lilshiet,stormreaver,1831,deathknight,unholy,66,30,36
75,Namzera,draenor,1827,deathknight,unholy,114,70,44
76,Undeadcell,ravencrest,1826,deathknight,unholy,60,34,26
77,Quizon,tarren-mill,1826,deathknight,unholy,84,39,45
78,Oj,darkspear,1825,deathknight,unholy,211,112,99
79,Zokko,blackrock,1820,deathknight,unholy,59,31,28
80,Cealdris,blackmoore,1819,deathknight,unholy,30,20,10
81,Обледенение,gordunni,1819,deathknight,unholy,36,19,17
82,Bigdickdk,ragnaros,1819,deathknight,unholy,58,27,31
83,Bephomet,onyxia,1819,deathknight,unholy,111,50,61
84,Lutcher,hellfire,1818,deathknight,unholy,36,20,16
85,Rankor,grim-batol,1816,deathknight,unholy,66,36,30
86,Necrofear,grim-batol,1816,deathknight,unholy,126,62,64
87,Змейняша,soulflayer,1814,deathknight,unholy,121,62,59
88,Aifam,twisting-nether,1813,deathknight,unholy,116,59,57
89,Andreàs,silvermoon,1813,deathknight,unholy,60,30,30
90,Брексиен,gordunni,1813,deathknight,unholy,54,20,34
91,Aryash,silvermoon,1812,deathknight,unholy,66,31,35
92,Amyntasz,twisting-nether,1812,deathknight,unholy,54,23,31
93,Sélyne,dalaran,1811,deathknight,unholy,60,27,33
94,Unhóly,tarren-mill,1810,deathknight,unholy,127,72,55
95,Аоепупс,gordunni,1809,deathknight,unholy,57,28,29
96,Allmawt,argent-dawn,1808,deathknight,unholy,89,51,38
97,Oscman,silvermoon,1805,deathknight,unholy,123,65,58
98,Køley,draenor,1804,deathknight,unholy,53,30,23
99,Annabolik,ravencrest,1804,deathknight,unholy,36,19,17
100,Icegrin,silvermoon,1803,deathknight,unholy,150,81,69
101,Butthurtx,stormscale,1802,deathknight,unholy,46,27,19
102,Бургер,soulflayer,1802,deathknight,unholy,78,33,45
103,Exoflake,kazzak,1801,deathknight,unholy,64,36,28
104,Inflex,silvermoon,1800,deathknight,unholy,102,51,51
105,Grepetta,argent-dawn,1800,deathknight,unholy,243,121,122
106,Sanlex,twisting-nether,1800,deathknight,unholy,139,67,72
107,Mirídiuss,silvermoon,1798,deathknight,unholy,58,31,27
108,Ðavy,silvermoon,1793,deathknight,unholy,60,29,31
109,Verminosis,stormscale,1791,deathknight,unholy,78,31,47
110,Jesûsx,ravencrest,1787,deathknight,unholy,130,69,61
111,Дайтоолгоун,deathguard,1783,deathknight,unholy,69,38,31
112,Дэхон,gordunni,1777,deathknight,unholy,85,45,40
113,Argonat,silvermoon,1775,deathknight,unholy,132,72,60
114,Péterpain,antonidas,1771,deathknight,unholy,102,49,53
115,Shanariel,khaz-modan,1761,deathknight,unholy,114,65,49
116,Crenshawx,twisting-nether,1761,deathknight,unholy,165,81,84
117,Deathgrab,twisting-nether,1758,deathknight,unholy,74,40,34
118,Фростинг,gordunni,1757,deathknight,unholy,42,23,19
119,Apacstanya,ragnaros,1757,deathknight,unholy,60,25,35
120,Zektal,thrall,1753,deathknight,unholy,66,32,34
121,Darkknights,archimonde,1749,deathknight,unholy,85,48,37
122,Ampdk,ravencrest,1748,deathknight,unholy,48,28,20
123,Sendurd,ragnaros,1747,deathknight,unholy,66,27,39
124,Happsor,eredar,1746,deathknight,unholy,77,35,42
125,Elyth,kazzak,1740,deathknight,unholy,58,33,25
126,Сантамо,soulflayer,1738,deathknight,unholy,110,59,51
127,Кромгак,soulflayer,1738,deathknight,unholy,68,35,33
128,Sakiko,thrall,1736,deathknight,unholy,42,23,19
129,Неондк,eversong,1734,deathknight,unholy,134,65,69
130,Slade,blackrock,1734,deathknight,unholy,60,23,37
131,Zerachy,blackmoore,1733,deathknight,unholy,30,19,11
132,Вовчан,howling-fjord,1733,deathknight,unholy,92,42,50
133,Deathmonsta,auchindoun,1731,deathknight,unholy,84,39,45
134,Râke,teldrassil,1729,deathknight,unholy,54,25,29
135,Motvinden,stormscale,1724,deathknight,unholy,100,54,46
136,Рыжаяпедаль,soulflayer,1723,deathknight,unholy,42,27,15
137,Darkertimes,ragnaros,1723,deathknight,unholy,189,92,97
138,Skulm,twisting-nether,1722,deathknight,unholy,48,20,28
139,Inâste,thrall,1719,deathknight,unholy,48,26,22
140,Вирко,eversong,1719,deathknight,unholy,184,96,88
141,Ghostreign,tarren-mill,1719,deathknight,unholy,68,33,35
142,Кулькулегал,ashenvale,1717,deathknight,unholy,66,34,32
143,Лордэскорт,gordunni,1717,deathknight,unholy,114,52,62
144,Nazgül,drakthul,1716,deathknight,unholy,122,68,54
145,Itreachesout,ravencrest,1716,deathknight,unholy,137,67,70
146,Тхиро,gordunni,1716,deathknight,unholy,95,38,57
147,Koranderx,argent-dawn,1713,deathknight,unholy,30,18,12
148,Alti,blackmoore,1705,deathknight,unholy,118,65,53
149,Triffdich,blackrock,1704,deathknight,unholy,120,62,58
150,Wôrgenator,kazzak,1704,deathknight,unholy,48,18,30
151,Alessia,alonsus,1701,deathknight,unholy,36,21,15
152,Ràiven,blackmoore,1701,deathknight,unholy,65,31,34
153,Évìl,stormscale,1700,deathknight,unholy,45,24,21
154,Sprangers,ravencrest,1699,deathknight,unholy,36,18,18
155,Enzÿ,drakthul,1698,deathknight,unholy,54,29,25
156,Raziee,twisting-nether,1698,deathknight,unholy,96,50,46
157,Альдафьод,howling-fjord,1696,deathknight,unholy,30,19,11
158,Эриданс,gordunni,1696,deathknight,unholy,142,79,63
159,Èvíl,stormscale,1695,deathknight,unholy,42,23,19
160,Fraeya,sunstrider,1695,deathknight,unholy,213,107,106
161,Doozz,draenor,1692,deathknight,unholy,87,34,53
162,Vainajala,die-aldor,1691,deathknight,unholy,77,46,31
163,Arizon,drakthul,1691,deathknight,unholy,98,40,58
164,Necrotic,blackrock,1690,deathknight,unholy,53,30,23
165,Deathlog,silvermoon,1690,deathknight,unholy,138,71,67
166,Impey,kazzak,1689,deathknight,unholy,30,18,12
167,Reidemorte,minahonda,1689,deathknight,unholy,140,81,59
168,Моровой,blackscar,1685,deathknight,unholy,70,35,35
169,Ronsôn,terrordar,1685,deathknight,unholy,54,27,27
170,Gladiadk,ysondre,1684,deathknight,unholy,53,21,32
171,Ûñhølýðéåthj,tarren-mill,1683,deathknight,unholy,59,28,31
172,Mammacitaa,argent-dawn,1682,deathknight,unholy,47,28,19
173,ßankoedno,stormscale,1681,deathknight,unholy,120,62,58
174,Аркёт,howling-fjord,1681,deathknight,unholy,84,42,42
175,Sang,deathwing,1680,deathknight,unholy,44,24,20
176,Stely,alonsus,1678,deathknight,unholy,36,21,15
177,Wombo,dentarg,1677,deathknight,unholy,57,30,27
178,Lovroo,silvermoon,1677,deathknight,unholy,93,43,50
179,Sanuky,blackrock,1677,deathknight,unholy,42,18,24
180,Nurekindk,argent-dawn,1676,deathknight,unholy,125,65,60
181,Vatø,tarren-mill,1676,deathknight,unholy,60,27,33
182,Sangíus,blackmoore,1673,deathknight,unholy,353,171,182
183,Femilista,dun-modr,1671,deathknight,unholy,42,23,19
184,Faznik,twisting-nether,1671,deathknight,unholy,124,61,63
185,Адэлина,soulflayer,1669,deathknight,unholy,36,22,14
186,Nèrfx,ragnaros,1669,deathknight,unholy,78,37,41
187,Senkingodx,ravencrest,1668,deathknight,unholy,60,20,40
188,Zugzugdecay,kazzak,1665,deathknight,unholy,42,23,19
189,Synthwave,tarren-mill,1665,deathknight,unholy,99,46,53
190,Олинф,deathguard,1664,deathknight,unholy,62,26,36
191,Blazeberg,blackrock,1662,deathknight,unholy,58,33,25
192,Geraltbg,twisting-nether,1661,deathknight,unholy,42,18,24
193,Dräpârn,sylvanas,1660,deathknight,unholy,93,50,43
194,Økah,outland,1659,deathknight,unholy,54,25,29
195,Zdi,tarren-mill,1657,deathknight,unholy,47,23,24
196,Thezftw,kazzak,1656,deathknight,unholy,71,30,41
197,Средозавр,howling-fjord,1655,deathknight,unholy,48,31,17
198,Heyä,ysondre,1655,deathknight,unholy,54,25,29
199,Dasvidania,ragnaros,1651,deathknight,unholy,30,18,12
200,Тыпидо,howling-fjord,1650,deathknight,unholy,72,41,31
201,Reann,argent-dawn,1649,deathknight,unholy,55,31,24
202,Кидер,blackscar,1647,deathknight,unholy,53,29,24
203,Äyrenn,draenor,1645,deathknight,unholy,61,35,26
204,Mávé,tarren-mill,1645,deathknight,unholy,64,31,33
205,Leanâdle,hyjal,1644,deathknight,unholy,134,66,68
206,Смердонос,grom,1642,deathknight,unholy,209,116,93
207,Джонаджеймсн,soulflayer,1642,deathknight,unholy,42,21,21
208,Ayra,nethersturm,1641,deathknight,unholy,35,24,11
209,Creatar,kazzak,1639,deathknight,unholy,53,31,22
210,Sugarcakedk,blackrock,1638,deathknight,unholy,89,44,45
211,Çruél,silvermoon,1638,deathknight,unholy,48,21,27
212,Garrinchá,stormscale,1636,deathknight,unholy,48,21,27
213,Jiodythyy,archimonde,1634,deathknight,unholy,60,27,33
214,Дрогдош,howling-fjord,1633,deathknight,unholy,48,29,19
215,Акамахи,ashenvale,1631,deathknight,unholy,42,23,19
216,Гронташ,howling-fjord,1631,deathknight,unholy,71,36,35
217,Uvros,bloodhoof,1630,deathknight,unholy,48,23,25
218,Лапочки,gordunni,1628,deathknight,unholy,84,49,35
219,Khalifamia,alonsus,1628,deathknight,unholy,54,26,28
220,Zariia,twisting-nether,1627,deathknight,unholy,126,72,54
221,Herumor,nerzhul,1627,deathknight,unholy,60,32,28
222,Yusehz,kazzak,1627,deathknight,unholy,51,25,26
223,Dejkå,silvermoon,1627,deathknight,unholy,66,30,36
224,Deadlyorca,tarren-mill,1625,deathknight,unholy,42,18,24
225,Castlevanía,ravencrest,1623,deathknight,unholy,115,58,57
226,Сгеатог,gordunni,1623,deathknight,unholy,36,17,19
227,Smallbaboon,stormreaver,1623,deathknight,unholy,42,17,25
228,Ghoulish,outland,1622,deathknight,unholy,187,92,95
229,Apacsom,ragnaros,1621,deathknight,unholy,30,17,13
230,Quetza,twisting-nether,1621,deathknight,unholy,36,17,19
231,Кокосоус,gordunni,1618,deathknight,unholy,36,18,18
232,Xenfos,tarren-mill,1618,deathknight,unholy,54,23,31
233,Baltersa,blackhand,1618,deathknight,unholy,60,25,35
234,Rottenpete,grim-batol,1617,deathknight,unholy,36,20,16
235,Pandahapci,ragnaros,1617,deathknight,unholy,54,23,31
236,Qtxi,nozdormu,1614,deathknight,unholy,183,98,85
237,Линфео,galakrond,1614,deathknight,unholy,54,22,32
238,Jollíe,tarren-mill,1613,deathknight,unholy,53,33,20
239,Aeneriah,tarren-mill,1613,deathknight,unholy,91,50,41
240,Lurkkiss,ravencrest,1613,deathknight,unholy,48,22,26
241,Pellizquitas,sanguino,1612,deathknight,unholy,30,17,13
242,Dk,tarren-mill,1612,deathknight,unholy,48,20,28
243,Инлакеш,howling-fjord,1611,deathknight,unholy,57,25,32
244,Stinglelz,chogall,1610,deathknight,unholy,30,19,11
245,Bokrak,norgannon,1610,deathknight,unholy,123,73,50
246,Deathvid,ravencrest,1610,deathknight,unholy,78,43,35
247,Lichbørn,ragnaros,1610,deathknight,unholy,102,50,52
248,Giandam,draenor,1610,deathknight,unholy,48,19,29
249,Анзорини,gordunni,1609,deathknight,unholy,48,19,29
250,Garasu,eredar,1609,deathknight,unholy,54,21,33
251,Halez,antonidas,1607,deathknight,unholy,186,96,90
252,Sxyd,silvermoon,1607,deathknight,unholy,66,27,39
253,Вондум,howling-fjord,1606,deathknight,unholy,42,18,24
254,Orktra,stormscale,1604,deathknight,unholy,42,22,20
255,Шуршаня,blackscar,1604,deathknight,unholy,54,22,32
256,Sølîta,archimonde,1603,deathknight,unholy,89,47,42
257,Krisigaped,blackhand,1603,deathknight,unholy,36,17,19
258,Маххес,howling-fjord,1601,deathknight,unholy,101,48,53
259,Aceléss,drakthul,1600,deathknight,unholy,42,20,22
260,Nasxsy,blackmoore,1599,deathknight,unholy,36,18,18
261,Branchë,stormscale,1599,deathknight,unholy,111,55,56
262,Maxto,outland,1596,deathknight,unholy,36,19,17
263,Deathcaller,zuljin,1594,deathknight,unholy,65,32,33
264,Zoree,draenor,1588,deathknight,unholy,119,64,55
265,Yagoora,silvermoon,1588,deathknight,unholy,74,29,45
266,Kwc,kazzak,1586,deathknight,unholy,117,54,63
267,Ахелекус,blackscar,1584,deathknight,unholy,36,21,15
268,Raizhen,ragnaros,1582,deathknight,unholy,36,17,19
269,Bredox,ravencrest,1582,deathknight,unholy,63,27,36
270,Linuzbunny,zenedar,1580,deathknight,unholy,30,18,12
271,Skórm,burning-legion,1580,deathknight,unholy,36,17,19
272,Vexxed,magtheridon,1576,deathknight,unholy,99,55,44
273,Spøøk,defias-brotherhood,1575,deathknight,unholy,48,22,26
274,Слендер,howling-fjord,1572,deathknight,unholy,119,57,62
275,Judin,kazzak,1570,deathknight,unholy,36,19,17
276,Ктунец,blackscar,1570,deathknight,unholy,36,19,17
277,Ahilus,bladefist,1570,deathknight,unholy,67,33,34
278,Prekliatylad,burning-blade,1570,deathknight,unholy,60,26,34
279,Gødofredo,dun-modr,1568,deathknight,unholy,96,55,41
280,Megdeath,silvermoon,1568,deathknight,unholy,108,54,54
281,Jäätynyt,zenedar,1568,deathknight,unholy,350,170,180
282,Söttguetsi,blackrock,1566,deathknight,unholy,41,23,18
283,Lockhead,stormscale,1566,deathknight,unholy,126,66,60
284,Nysaia,blackmoore,1564,deathknight,unholy,60,27,33
285,Körthazz,hyjal,1563,deathknight,unholy,55,27,28
286,Хорссэ,soulflayer,1562,deathknight,unholy,37,22,15
287,Винерас,soulflayer,1562,deathknight,unholy,66,31,35
288,Oweiowei,blackrock,1558,deathknight,unholy,30,18,12
289,Ghaloob,draenor,1557,deathknight,unholy,54,24,30
290,Gushik,twisting-nether,1555,deathknight,unholy,52,30,22
291,Хассандра,galakrond,1554,deathknight,unholy,117,58,59
292,Smörj,aggramar,1554,deathknight,unholy,88,38,50
293,Feministi,stormreaver,1552,deathknight,unholy,108,51,57
294,Aleejha,draenor,1551,deathknight,unholy,70,39,31
295,Капустас,gordunni,1551,deathknight,unholy,90,45,45
296,Yamisukehiro,drakthul,1551,deathknight,unholy,60,28,32
297,Utyr,ragnaros,1550,deathknight,unholy,60,31,29
298,Emphendk,twisting-nether,1550,deathknight,unholy,120,55,65
299,Рамкар,howling-fjord,1550,deathknight,unholy,38,17,21
300,Hellguy,draenor,1548,deathknight,unholy,263,124,139
301,Gargalon,drakthul,1547,deathknight,unholy,72,37,35
302,Turboface,kazzak,1546,deathknight,unholy,60,34,26
303,Apoikos,argent-dawn,1546,deathknight,unholy,36,19,17
304,Abomination,emeriss,1546,deathknight,unholy,49,20,29
305,Misazabanshi,blackrock,1543,deathknight,unholy,42,26,16
306,Сванхильда,grom,1543,deathknight,unholy,124,61,63
307,Элекна,deepholm,1541,deathknight,unholy,48,24,24
308,Juliean,blackmoore,1540,deathknight,unholy,42,20,22
309,Ganessha,sanguino,1538,deathknight,unholy,49,29,20
310,Abcdk,sargeras,1535,deathknight,unholy,56,31,25
311,Metalmanethé,tarren-mill,1534,deathknight,unholy,242,120,122
312,Segrim,drakthul,1533,deathknight,unholy,95,52,43
313,Вурдулакх,gordunni,1533,deathknight,unholy,114,56,58
314,Pawcio,argent-dawn,1527,deathknight,unholy,135,74,61
315,Dzemoo,drakthul,1527,deathknight,unholy,59,31,28
316,Алсидис,gordunni,1527,deathknight,unholy,72,29,43
317,Руин,blackscar,1526,deathknight,unholy,48,26,22
318,Huekun,draenor,1524,deathknight,unholy,29,18,11
319,Арцевус,gordunni,1524,deathknight,unholy,115,59,56
320,Полонит,gordunni,1523,deathknight,unholy,76,38,38
321,Nauser,kazzak,1522,deathknight,unholy,53,28,25
322,Dörfl,antonidas,1521,deathknight,unholy,87,42,45
323,Олинфия,soulflayer,1521,deathknight,unholy,36,16,20
324,Panorboy,tarren-mill,1521,deathknight,unholy,36,16,20
325,Gripbroblem,nemesis,1521,deathknight,unholy,42,16,26
326,Woddey,blackrock,1520,deathknight,unholy,72,39,33
327,Yousaindk,blackrock,1519,deathknight,unholy,60,29,31
328,Deadroses,tarren-mill,1517,deathknight,unholy,78,49,29
329,Gharzhul,xavius,1517,deathknight,unholy,32,18,14
330,Goreshovel,stormscale,1517,deathknight,unholy,72,39,33
331,Торедх,howling-fjord,1516,deathknight,unholy,66,27,39
332,Athanatøs,archimonde,1514,deathknight,unholy,98,43,55
333,Greymarker,kirin-tor,1513,deathknight,unholy,66,37,29
334,Cleverb,silvermoon,1512,deathknight,unholy,33,18,15
335,Cayliadk,tarren-mill,1512,deathknight,unholy,86,46,40
336,Ехтрим,howling-fjord,1512,deathknight,unholy,65,30,35
337,Raust,xavius,1512,deathknight,unholy,74,33,41
338,Manego,eredar,1511,deathknight,unholy,30,18,12
339,Дерайв,gordunni,1511,deathknight,unholy,114,55,59
340,Катаринья,howling-fjord,1511,deathknight,unholy,53,24,29
341,Grendul,blackmoore,1510,deathknight,unholy,60,26,34
342,Anathela,dalaran,1508,deathknight,unholy,85,40,45
343,Трибунальщик,gordunni,1508,deathknight,unholy,60,27,33
344,Apoikia,argent-dawn,1507,deathknight,unholy,42,19,23
345,Руариди,gordunni,1504,deathknight,unholy,36,18,18
346,Salezians,drakthul,1503,deathknight,unholy,107,59,48
347,Numnuts,alakir,1502,deathknight,unholy,36,21,15
348,Lavonobatas,kazzak,1502,deathknight,unholy,54,27,27
349,Deathcam,emerald-dream,1502,deathknight,unholy,95,45,50
350,Derfitt,sanguino,1502,deathknight,unholy,96,45,51
351,Ezlar,silvermoon,1501,deathknight,unholy,49,29,20
352,Unchaindk,outland,1500,deathknight,unholy,136,68,68
353,Bertonilo,burning-legion,1500,deathknight,unholy,84,39,45
354,Dklékata,archimonde,1499,deathknight,unholy,43,20,23
355,Veçh,turalyon,1497,deathknight,unholy,58,25,33
356,Nødder,ragnaros,1496,deathknight,unholy,60,32,28
357,Anaralien,ravencrest,1494,deathknight,unholy,107,50,57
358,Babsyknight,wildhammer,1494,deathknight,unholy,114,52,62
359,Промештейн,gordunni,1493,deathknight,unholy,93,44,49
360,Apolyio,outland,1493,deathknight,unholy,53,21,32
361,Recoil,blackrock,1490,deathknight,unholy,26,17,9
362,Gegham,ravencrest,1490,deathknight,unholy,46,26,20
363,Rizzlerdk,blackhand,1489,deathknight,unholy,114,49,65
364,Axram,ravencrest,1487,deathknight,unholy,60,30,30
365,Goùlag,culte-de-la-rive-noire,1487,deathknight,unholy,87,34,53
366,Kérmít,tarren-mill,1486,deathknight,unholy,100,58,42
367,Кадавров,gordunni,1486,deathknight,unholy,140,76,64
368,Majlus,outland,1486,deathknight,unholy,50,24,26
369,Dharniman,sylvanas,1485,deathknight,unholy,46,21,25
370,Riceeater,kazzak,1483,deathknight,unholy,59,29,30
371,Агереро,howling-fjord,1482,deathknight,unholy,71,37,34
372,Blízna,kazzak,1481,deathknight,unholy,122,58,64
373,Erodevil,kazzak,1481,deathknight,unholy,54,22,32
374,Nellath,kazzak,1481,deathknight,unholy,42,16,26
375,Zff,hyjal,1480,deathknight,unholy,42,25,17
376,Teljujad,sanguino,1480,deathknight,unholy,98,49,49
377,Брюшина,gordunni,1480,deathknight,unholy,42,19,23
378,Calina,frostwolf,1480,deathknight,unholy,72,26,46
379,Ullefuz,silvermoon,1479,deathknight,unholy,42,25,17
380,Лекъса,gordunni,1477,deathknight,unholy,217,109,108
381,Polimeh,draenor,1473,deathknight,unholy,78,42,36
382,Yandeäth,chants-éternels,1470,deathknight,unholy,209,102,107
383,Nommad,archimonde,1469,deathknight,unholy,137,62,75
384,Ультерис,deathguard,1468,deathknight,unholy,24,17,7
385,Sorostew,twisting-nether,1467,deathknight,unholy,42,23,19
386,Arxelas,sylvanas,1467,deathknight,unholy,115,60,55
387,Frags,arathor,1467,deathknight,unholy,66,31,35
388,Moko,defias-brotherhood,1467,deathknight,unholy,54,25,29
389,Bloodraynee,twisting-nether,1467,deathknight,unholy,48,19,29
390,Протосеня,soulflayer,1465,deathknight,unholy,78,35,43
391,Manovar,archimonde,1462,deathknight,unholy,137,65,72
392,Bärdk,forscherliga,1461,deathknight,unholy,95,47,48
393,Шифычдк,howling-fjord,1460,deathknight,unholy,60,27,33
394,Hawkthuglife,dun-modr,1459,deathknight,unholy,90,42,48
395,Nospets,kazzak,1459,deathknight,unholy,54,25,29
396,Fýhr,silvermoon,1458,deathknight,unholy,54,29,25
397,Gethunts,drakthul,1457,deathknight,unholy,42,25,17
398,Deusmort,ravencrest,1457,deathknight,unholy,66,26,40
399,Thecurator,ragnaros,1456,deathknight,unholy,72,32,40
400,Барагган,thermaplugg,1455,deathknight,unholy,96,47,49
401,Hordak,stormscale,1455,deathknight,unholy,45,16,29
402,Ceranto,frostwolf,1453,deathknight,unholy,77,46,31
403,Моорта,soulflayer,1453,deathknight,unholy,182,94,88
404,Kebabpizza,argent-dawn,1452,deathknight,unholy,85,42,43
405,Tölp,ravencrest,1452,deathknight,unholy,95,46,49
406,Skèltòn,rexxar,1451,deathknight,unholy,73,47,26
407,Форнителли,howling-fjord,1451,deathknight,unholy,54,19,35
408,Ohsevèn,ravencrest,1450,deathknight,unholy,65,36,29
409,Sathmayla,silvermoon,1448,deathknight,unholy,53,32,21
410,Arkaris,blackmoore,1447,deathknight,unholy,32,21,11
411,Шинратенсеи,howling-fjord,1447,deathknight,unholy,50,29,21
412,Demrior,hellfire,1447,deathknight,unholy,66,27,39
413,Ilius,kelthuzad,1445,deathknight,unholy,99,50,49
414,Dekayo,blackrock,1445,deathknight,unholy,38,19,19
415,Ithis,zuljin,1445,deathknight,unholy,126,60,66
416,Борнтудай,borean-tundra,1445,deathknight,unholy,48,17,31
417,Quantumshift,ravencrest,1444,deathknight,unholy,36,23,13
418,Дкшрёдингера,gordunni,1444,deathknight,unholy,30,16,14
419,Unholy,ragnaros,1444,deathknight,unholy,38,20,18
420,Sîck,bladefist,1444,deathknight,unholy,78,29,49
421,Рэндрей,gordunni,1443,deathknight,unholy,39,21,18
422,Сенкрул,gordunni,1440,deathknight,unholy,72,48,24
423,Logoz,dun-modr,1440,deathknight,unholy,30,17,13
424,Exoduss,dunemaul,1439,deathknight,unholy,78,38,40
425,Notsyndra,nemesis,1437,deathknight,unholy,49,25,24
426,Mîîkkaa,blackhand,1435,deathknight,unholy,42,15,27
427,Дедхо,soulflayer,1434,deathknight,unholy,62,28,34
428,Chrispbacøn,ragnaros,1433,deathknight,unholy,40,19,21
429,Кристер,lich-king,1433,deathknight,unholy,36,16,20
430,Спавни,blackscar,1432,deathknight,unholy,153,71,82
431,Таможникс,soulflayer,1431,deathknight,unholy,29,18,11
432,Reezeer,stormscale,1431,deathknight,unholy,35,17,18
433,Grubbins,kul-tiras,1427,deathknight,unholy,55,29,26
434,Apatheia,stormscale,1426,deathknight,unholy,28,16,12
435,Zandruq,twisting-nether,1426,deathknight,unholy,88,47,41
436,Gøretterog,ysondre,1425,deathknight,unholy,24,15,9
437,Shabiri,twisting-nether,1425,deathknight,unholy,97,52,45
438,Шейзо,soulflayer,1424,deathknight,unholy,39,22,17
439,Анихиме,howling-fjord,1424,deathknight,unholy,75,37,38
440,Zeghor,ragnaros,1424,deathknight,unholy,78,32,46
441,Ardros,eredar,1422,deathknight,unholy,84,38,46
442,Späwn,ysondre,1422,deathknight,unholy,64,24,40
443,Астартэс,deathguard,1421,deathknight,unholy,30,19,11
444,Discochoppa,blackmoore,1421,deathknight,unholy,36,15,21
445,Tenzøftw,archimonde,1420,deathknight,unholy,30,15,15
446,Ðiesel,stormscale,1420,deathknight,unholy,111,45,66
447,Maradk,drakthul,1419,deathknight,unholy,166,82,84
448,Анкара,ashenvale,1419,deathknight,unholy,83,41,42
449,Ínví,aegwynn,1418,deathknight,unholy,96,47,49
450,Wallenschøld,kazzak,1418,deathknight,unholy,36,15,21
451,Аирфрост,howling-fjord,1416,deathknight,unholy,54,25,29
452,Epoch,azjolnerub,1416,deathknight,unholy,103,47,56
453,Arxelas,stormscale,1416,deathknight,unholy,72,30,42
454,Pavkata,outland,1415,deathknight,unholy,154,74,80
455,Mìa,kragjin,1415,deathknight,unholy,73,33,40
456,Exanex,ragnaros,1413,deathknight,unholy,24,15,9
457,Cheethdoom,ragnaros,1413,deathknight,unholy,30,15,15
458,Sorcc,burning-legion,1413,deathknight,unholy,76,36,40
459,Десхоб,soulflayer,1413,deathknight,unholy,163,66,97
460,Empiu,blackhand,1409,deathknight,unholy,36,23,13
461,Terren,ravencrest,1409,deathknight,unholy,52,29,23
462,Xirra,tarren-mill,1409,deathknight,unholy,67,33,34
463,Hêalz,ungoro,1408,deathknight,unholy,66,34,32
464,Assgripper,hyjal,1406,deathknight,unholy,42,26,16
465,Вирзерагна,howling-fjord,1406,deathknight,unholy,48,29,19
466,Negzul,blackmoore,1406,deathknight,unholy,73,39,34
467,Walkeni,defias-brotherhood,1405,deathknight,unholy,78,35,43
468,Estoico,ragnaros,1404,deathknight,unholy,66,32,34
469,Кланки,soulflayer,1404,deathknight,unholy,76,34,42
470,Ðaserka,blackrock,1403,deathknight,unholy,23,15,8
471,Deathlïght,nemesis,1399,deathknight,unholy,77,41,36
472,Fosswire,stormscale,1399,deathknight,unholy,36,18,18
473,Sonofalích,aerie-peak,1397,deathknight,unholy,43,24,19
474,Draforce,quelthalas,1396,deathknight,unholy,63,35,28
475,Judythegreat,silvermoon,1396,deathknight,unholy,53,23,30
476,Xado,frostwolf,1395,deathknight,unholy,96,51,45
477,Ecoya,blackrock,1395,deathknight,unholy,35,16,19
478,Lorvetis,malorne,1395,deathknight,unholy,42,19,23
479,Frostmommy,argent-dawn,1394,deathknight,unholy,87,37,50
480,Skøurge,silvermoon,1392,deathknight,unholy,186,93,93
481,Dzwiadke,burning-legion,1392,deathknight,unholy,122,56,66
482,Zegaan,kazzak,1391,deathknight,unholy,90,43,47
483,Blorin,sylvanas,1391,deathknight,unholy,91,41,50
484,Unholycard,argent-dawn,1389,deathknight,unholy,72,37,35
485,Reapocalypse,blackhand,1389,deathknight,unholy,244,118,126
486,Darhma,archimonde,1389,deathknight,unholy,56,19,37
487,Gaurk,aggra-português,1382,deathknight,unholy,42,24,18
488,Jalapeñofan,tarren-mill,1382,deathknight,unholy,75,36,39
489,Мурмадонище,soulflayer,1380,deathknight,unholy,32,21,11
490,Анфалагон,gordunni,1380,deathknight,unholy,102,49,53
491,Сивкабурка,fordragon,1380,deathknight,unholy,42,16,26
492,Fixmybones,frostmane,1378,deathknight,unholy,54,22,32
493,Дядьдим,soulflayer,1377,deathknight,unholy,39,18,21
494,Flawstmourne,kazzak,1374,deathknight,unholy,35,15,20
495,Нарилуне,blackscar,1373,deathknight,unholy,394,194,200
496,Мёрдерфэйсх,soulflayer,1373,deathknight,unholy,132,63,69
497,Bloodbane,burning-blade,1371,deathknight,unholy,66,29,37
498,Ziuziu,twisting-nether,1371,deathknight,unholy,48,15,33
499,Dkbladet,ravencrest,1370,deathknight,unholy,81,41,40
500,Roaredrick,draenor,1370,deathknight,unholy,93,44,49
501,Tyvra,blackhand,1369,deathknight,unholy,47,17,30
502,Nilodk,nemesis,1367,deathknight,unholy,332,170,162
503,Oßitø,ravencrest,1365,deathknight,unholy,31,17,14
504,Metalist,ravencrest,1362,deathknight,unholy,78,37,41
505,Sveinnhran,kazzak,1361,deathknight,unholy,194,95,99
506,Bloodkatana,drakthul,1359,deathknight,unholy,60,24,36
507,Arthrex,twisting-nether,1358,deathknight,unholy,36,21,15
508,Veyrøn,kazzak,1358,deathknight,unholy,54,29,25
509,Ridire,saurfang,1358,deathknight,unholy,53,27,26
510,Fishtruction,tarren-mill,1357,deathknight,unholy,210,111,99
511,Morinosei,twisting-nether,1351,deathknight,unholy,89,48,41
512,Nekote,silvermoon,1350,deathknight,unholy,33,17,16
513,Dunklerlord,malfurion,1348,deathknight,unholy,36,17,19
514,Gûuts,archimonde,1347,deathknight,unholy,253,129,124
515,Xênôrr,archimonde,1347,deathknight,unholy,30,15,15
516,Petardodupy,burning-legion,1344,deathknight,unholy,44,20,24
517,Хейткрю,howling-fjord,1342,deathknight,unholy,48,21,27
518,Zóur,rajaxx,1338,deathknight,unholy,60,31,29
519,Томиганн,grom,1336,deathknight,unholy,48,23,25
520,Züg,draenor,1336,deathknight,unholy,120,56,64
521,Aesthaetik,draenor,1332,deathknight,unholy,28,16,12
522,Scotty,ravencrest,1330,deathknight,unholy,30,14,16
523,Jöndas,drakthul,1329,deathknight,unholy,48,25,23
524,Evelys,kazzak,1329,deathknight,unholy,34,17,17
525,Тумм,howling-fjord,1329,deathknight,unholy,30,14,16
526,Fizzdk,pozzo-delleternità,1329,deathknight,unholy,54,24,30
527,Kalantii,draenor,1326,deathknight,unholy,36,19,17
528,Gengàr,tarren-mill,1325,deathknight,unholy,24,14,10
529,Fentanil,elune,1325,deathknight,unholy,229,116,113
530,Зибак,soulflayer,1322,deathknight,unholy,51,24,27
531,Teflonphobos,stormreaver,1320,deathknight,unholy,18,14,4
532,Dunkàn,silvermoon,1318,deathknight,unholy,48,32,16
533,Darkhallow,thrall,1318,deathknight,unholy,142,76,66
534,Zarad,scarshield-legion,1318,deathknight,unholy,30,15,15
535,Prænklý,blackrock,1316,deathknight,unholy,60,28,32
536,Detrah,argent-dawn,1315,deathknight,unholy,52,27,25
537,Ahlat,blackmoore,1306,deathknight,unholy,89,53,36
538,Алкеокол,soulflayer,1301,deathknight,unholy,33,15,18
539,Defeated,thrall,1301,deathknight,unholy,81,36,45
540,Akelæ,draenor,1300,deathknight,unholy,70,35,35
541,Persefal,nemesis,1300,deathknight,unholy,48,18,30
542,Mojodango,outland,1299,deathknight,unholy,26,15,11
543,Fluffínator,kazzak,1298,deathknight,unholy,88,45,43
544,Крикед,soulflayer,1297,deathknight,unholy,102,55,47
545,Роземайер,ashenvale,1297,deathknight,unholy,60,29,31
546,Msvine,kazzak,1294,deathknight,unholy,72,39,33
547,Táli,tarren-mill,1294,deathknight,unholy,33,14,19
548,Asakim,tarren-mill,1291,deathknight,unholy,29,14,15
549,Альмон,howling-fjord,1290,deathknight,unholy,42,19,23
550,Ничер,thermaplugg,1289,deathknight,unholy,24,14,10
551,Jihm,silvermoon,1286,deathknight,unholy,141,72,69
552,Бреч,gordunni,1285,deathknight,unholy,42,14,28
553,Xawias,ulduar,1283,deathknight,unholy,26,15,11
554,Sictir,stormscale,1280,deathknight,unholy,236,113,123
555,Endlesspain,burning-legion,1280,deathknight,unholy,58,24,34
556,Âlîce,culte-de-la-rive-noire,1277,deathknight,unholy,36,19,17
557,Galayn,burning-legion,1277,deathknight,unholy,33,14,19
558,Kratagon,thrall,1276,deathknight,unholy,72,25,47
559,Zracul,nordrassil,1272,deathknight,unholy,85,41,44
560,Джайвана,soulflayer,1270,deathknight,unholy,227,114,113
561,Reportmeplz,ragnaros,1270,deathknight,unholy,48,22,26
562,Necrozy,aggra-português,1269,deathknight,unholy,84,43,41
563,Necrocancerr,twisting-nether,1269,deathknight,unholy,116,55,61
564,Lobotomia,burning-blade,1266,deathknight,unholy,49,25,24
565,Kaletorn,ragnaros,1265,deathknight,unholy,84,41,43
566,Undtot,azshara,1264,deathknight,unholy,36,16,20
567,Pjthedk,lightbringer,1263,deathknight,unholy,42,21,21
568,Drenodur,amanthul,1261,deathknight,unholy,24,14,10
569,Superere,hyjal,1261,deathknight,unholy,36,17,19
570,Mamanica,sanguino,1261,deathknight,unholy,30,14,16
571,Heyabigail,wildhammer,1258,deathknight,unholy,72,29,43
572,Fineral,argent-dawn,1256,deathknight,unholy,48,21,27
573,Tesasd,silvermoon,1255,deathknight,unholy,58,26,32
574,Sarkasm,malganis,1248,deathknight,unholy,66,31,35
575,Chocopeanut,ravencrest,1246,deathknight,unholy,25,15,10
576,Taylorswiftz,tarren-mill,1246,deathknight,unholy,30,13,17
577,Ластофас,gordunni,1242,deathknight,unholy,30,13,17
578,Elíta,draenor,1242,deathknight,unholy,36,15,21
579,Schweezlord,tarren-mill,1241,deathknight,unholy,24,13,11
580,Патриаррх,gordunni,1240,deathknight,unholy,47,25,22
581,Flinsen,blackmoore,1239,deathknight,unholy,86,47,39
582,Kéréos,hyjal,1238,deathknight,unholy,24,13,11
583,Turkknight,outland,1236,deathknight,unholy,30,13,17
584,Obstwald,blackrock,1235,deathknight,unholy,49,26,23
585,Zelbørk,medivh,1235,deathknight,unholy,42,21,21
586,Khorag,lordaeron,1235,deathknight,unholy,30,13,17
587,Rimewraith,argent-dawn,1232,deathknight,unholy,32,15,17
588,Funds,kazzak,1230,deathknight,unholy,30,13,17
589,Дэбон,howling-fjord,1229,deathknight,unholy,138,63,75
590,Аданаэль,howling-fjord,1228,deathknight,unholy,47,21,26
591,Крус,blackscar,1227,deathknight,unholy,89,39,50
592,Serelis,argent-dawn,1226,deathknight,unholy,36,13,23
593,Younix,silvermoon,1221,deathknight,unholy,48,16,32
594,Варделон,gordunni,1219,deathknight,unholy,18,13,5
595,Halohuntress,outland,1219,deathknight,unholy,42,18,24
596,Zpartan,ragnaros,1216,deathknight,unholy,48,17,31
597,Tanenoss,kazzak,1213,deathknight,unholy,54,21,33
598,Gothenburger,darksorrow,1212,deathknight,unholy,48,24,24
599,Razzvy,darkspear,1209,deathknight,unholy,69,30,39
600,Thedx,blades-edge,1208,deathknight,unholy,52,20,32
601,Деркхаус,soulflayer,1206,deathknight,unholy,24,15,9
602,Tyranus,quelthalas,1203,deathknight,unholy,156,69,87
603,Sigarå,twisting-nether,1191,deathknight,unholy,36,16,20
604,Mayaya,malganis,1190,deathknight,unholy,28,14,14
605,Bitdead,doomhammer,1184,deathknight,unholy,30,15,15
606,Darkqüeen,sanguino,1180,deathknight,unholy,30,14,16
607,Homoforsluts,silvermoon,1178,deathknight,unholy,24,15,9
608,Abnormus,tarren-mill,1175,deathknight,unholy,45,19,26
609,Tarfu,kazzak,1168,deathknight,unholy,42,20,22
610,Ezreo,neptulon,1167,deathknight,unholy,31,14,17
611,Eltorro,ravencrest,1165,deathknight,unholy,42,14,28
612,Микелон,gordunni,1164,deathknight,unholy,22,13,9
613,Dezzi,azuremyst,1160,deathknight,unholy,62,31,31
614,Дэдушка,gordunni,1159,deathknight,unholy,23,13,10
615,Radan,stormscale,1152,deathknight,unholy,24,12,12
616,Fyrkadk,aegwynn,1151,deathknight,unholy,24,12,12
617,Qmy,outland,1151,deathknight,unholy,46,17,29
618,Tharassian,chamber-of-aspects,1150,deathknight,unholy,24,12,12
619,Dklol,dun-morogh,1150,deathknight,unholy,36,14,22
620,Numnutz,alakir,1149,deathknight,unholy,25,13,12
621,Usbdock,stormscale,1149,deathknight,unholy,24,12,12
622,Auru,tarren-mill,1149,deathknight,unholy,63,31,32
623,Larrydk,tarren-mill,1147,deathknight,unholy,24,12,12
624,Mawdrym,twisting-nether,1146,deathknight,unholy,24,12,12
625,Micaiah,dun-modr,1146,deathknight,unholy,30,12,18
626,Клиссанг,razuvious,1146,deathknight,unholy,42,12,30
627,Slawtér,arathor,1145,deathknight,unholy,24,12,12
628,Trialist,dun-modr,1143,deathknight,unholy,24,12,12
629,Roykoopa,hyjal,1143,deathknight,unholy,42,19,23
630,Rûnâr,proudmoore,1141,deathknight,unholy,21,13,8
631,Mãshi,hyjal,1140,deathknight,unholy,59,26,33
632,Leipä,scarshield-legion,1140,deathknight,unholy,30,12,18
633,Grezak,defias-brotherhood,1139,deathknight,unholy,24,12,12
634,Scareanger,argent-dawn,1139,deathknight,unholy,29,14,15
635,Nestia,emerald-dream,1139,deathknight,unholy,49,22,27
636,Gùra,sanguino,1139,deathknight,unholy,36,13,23
637,Sevatar,zuljin,1137,deathknight,unholy,18,12,6
638,Kailara,draenor,1133,deathknight,unholy,29,12,17
639,Niex,destromath,1133,deathknight,unholy,30,12,18
640,Jowân,blackmoore,1131,deathknight,unholy,24,13,11
641,Dêku,aegwynn,1130,deathknight,unholy,79,44,35
642,Lilyxtulle,tarren-mill,1128,deathknight,unholy,131,64,67
643,Asakurai,grim-batol,1126,deathknight,unholy,42,22,20
644,Feekus,deathwing,1123,deathknight,unholy,18,12,6
645,Mellowqt,aegwynn,1120,deathknight,unholy,53,25,28
646,Kazay,madmortem,1119,deathknight,unholy,24,12,12
647,Артушадк,soulflayer,1118,deathknight,unholy,60,31,29
648,Híruzen,blackrock,1115,deathknight,unholy,30,15,15
649,Zdan,sylvanas,1114,deathknight,unholy,30,15,15
650,Ârtjom,aegwynn,1106,deathknight,unholy,28,12,16
651,Saromón,ravencrest,1101,deathknight,unholy,30,18,12
652,Zathron,blackmoore,1087,deathknight,unholy,35,15,20
653,Gowther,blackmoore,1086,deathknight,unholy,66,37,29
654,Skeggjold,drakthul,1083,deathknight,unholy,24,12,12
655,Narrua,die-aldor,1082,deathknight,unholy,47,17,30
656,Orochimaruo,stormscale,1080,deathknight,unholy,36,15,21
657,Diatriss,argent-dawn,1078,deathknight,unholy,63,27,36
658,Highmelli,ambossar,1070,deathknight,unholy,78,27,51
659,Ennigmá,stormscale,1066,deathknight,unholy,24,13,11
660,Flytomoon,argent-dawn,1062,deathknight,unholy,23,13,10
661,Фиджибро,soulflayer,1060,deathknight,unholy,44,17,27
662,Grisig,twisting-nether,1057,deathknight,unholy,30,18,12
663,Bigblackgrip,hyjal,1056,deathknight,unholy,24,11,13
664,Fuzzyofc,draenor,1054,deathknight,unholy,24,11,13
665,Synchronic,stormscale,1053,deathknight,unholy,24,11,13
666,Regniér,frostwolf,1050,deathknight,unholy,18,11,7
667,Некронн,grom,1050,deathknight,unholy,23,13,10
668,Mefhesto,tarren-mill,1049,deathknight,unholy,30,11,19
669,Pamplemouse,burning-blade,1046,deathknight,unholy,85,40,45
670,Нуурргл,howling-fjord,1046,deathknight,unholy,48,19,29
671,Shakour,argent-dawn,1044,deathknight,unholy,18,11,7
672,Rammsteïn,ravencrest,1042,deathknight,unholy,33,12,21
673,Ilovegouàng,khaz-modan,1041,deathknight,unholy,36,15,21
674,Eibon,drakthul,1037,deathknight,unholy,18,11,7
675,Порнпанда,gordunni,1037,deathknight,unholy,24,11,13
676,Волграл,howling-fjord,1036,deathknight,unholy,18,11,7
677,Jixcore,draenor,1034,deathknight,unholy,36,11,25
678,Охъламон,soulflayer,1030,deathknight,unholy,100,43,57
679,Beinlausi,dalaran,1026,deathknight,unholy,21,12,9
680,Мокраявода,soulflayer,1026,deathknight,unholy,94,49,45
681,Kixx,bloodfeather,1026,deathknight,unholy,88,37,51
682,Larvalîs,blackmoore,1025,deathknight,unholy,48,24,24
683,Karalun,nagrand,1024,deathknight,unholy,66,32,34
684,Taylorswiift,tarren-mill,1023,deathknight,unholy,17,11,6
685,Icyplague,ravencrest,1018,deathknight,unholy,20,12,8
686,Малп,gordunni,1018,deathknight,unholy,42,24,18
687,Assasínator,tarren-mill,1017,deathknight,unholy,205,105,100
688,Kaldhan,nemesis,1017,deathknight,unholy,30,13,17
689,Scorbion,kilrogg,1015,deathknight,unholy,24,11,13
690,Рэкставр,soulflayer,1014,deathknight,unholy,64,33,31
691,Takåtry,archimonde,1004,deathknight,unholy,30,14,16
692,Kisenth,doomhammer,1000,deathknight,unholy,48,28,20
693,Tyrannus,earthen-ring,1000,deathknight,unholy,23,13,10
694,Braastad,sylvanas,989,deathknight,unholy,66,35,31
695,Hqxdd,twisting-nether,982,deathknight,unholy,87,37,50
696,Gathalion,the-maelstrom,980,deathknight,unholy,48,28,20
697,Ashlëy,kaelthas,978,deathknight,unholy,156,74,82
698,Квашонка,howling-fjord,972,deathknight,unholy,84,28,56
699,Kaliro,sylvanas,960,deathknight,unholy,18,10,8
700,Бешенсство,soulflayer,960,deathknight,unholy,18,10,8
701,Julezer,malganis,960,deathknight,unholy,24,10,14
702,Кромгондк,soulflayer,960,deathknight,unholy,24,10,14
703,Spom,elune,960,deathknight,unholy,30,10,20
704,Feelmyfuri,mazrigos,959,deathknight,unholy,18,10,8
705,Olriklol,dentarg,959,deathknight,unholy,18,10,8
706,Silvergreed,kazzak,959,deathknight,unholy,24,10,14
707,Скизм,howling-fjord,959,deathknight,unholy,24,10,14
708,Drogba,burning-blade,958,deathknight,unholy,18,10,8
709,Bølvar,zuljin,958,deathknight,unholy,18,10,8
710,Rimda,twisting-nether,958,deathknight,unholy,18,10,8
711,Fpsrvg,minahonda,956,deathknight,unholy,53,23,30
712,Restodrowd,tarren-mill,955,deathknight,unholy,57,29,28
713,Syncros,blackrock,955,deathknight,unholy,24,10,14
714,Puppétmastér,kazzak,954,deathknight,unholy,24,10,14
715,Bämbämpewpew,ravencrest,954,deathknight,unholy,24,10,14
716,Nickolass,skullcrusher,953,deathknight,unholy,48,22,26
717,Azrìal,agamaggan,951,deathknight,unholy,24,10,14
718,Aguroh,khaz-modan,937,deathknight,unholy,36,16,20
719,Dreamgirl,sylvanas,931,deathknight,unholy,24,14,10
720,Gravetitan,shattrath,931,deathknight,unholy,85,33,52
721,Jess,blackhand,926,deathknight,unholy,65,33,32
722,Rognvald,les-sentinelles,921,deathknight,unholy,47,23,24
723,Valeriania,burning-legion,919,deathknight,unholy,21,11,10
724,Thyrandre,khaz-modan,905,deathknight,unholy,56,20,36
725,Rayliegh,silvermoon,891,deathknight,unholy,17,10,7
726,Лордэнергон,gordunni,888,deathknight,unholy,16,10,6
727,Unzul,twisting-nether,869,deathknight,unholy,18,10,8
728,Orcborg,zuljin,868,deathknight,unholy,25,10,15
729,Gáïà,blackmoore,864,deathknight,unholy,12,9,3
730,Deathcaller,dun-modr,864,deathknight,unholy,12,9,3
731,Diabeticus,the-maelstrom,864,deathknight,unholy,18,9,9
732,Fringles,twisting-nether,864,deathknight,unholy,18,9,9
733,Charlytango,archimonde,864,deathknight,unholy,18,9,9
734,Catloaf,silvermoon,864,deathknight,unholy,24,9,15
735,Mateusz,lightbringer,863,deathknight,unholy,12,9,3
736,Darknemesis,nemesis,863,deathknight,unholy,18,9,9
737,Styxdk,blackhand,863,deathknight,unholy,18,9,9
738,Elliipirelli,doomhammer,863,deathknight,unholy,18,9,9
739,Ecormcpz,eredar,863,deathknight,unholy,24,9,15
740,Frostplague,aegwynn,863,deathknight,unholy,24,9,15
741,Oxxöw,draenor,863,deathknight,unholy,24,9,15
742,Råyzen,draenor,863,deathknight,unholy,24,9,15
743,Dimania,the-maelstrom,863,deathknight,unholy,30,9,21
744,Plagueherald,ravencrest,862,deathknight,unholy,18,9,9
745,Vrez,argent-dawn,862,deathknight,unholy,24,9,15
746,Alroc,blackrock,862,deathknight,unholy,30,9,21
747,Izanagii,exodar,861,deathknight,unholy,18,9,9
748,Valanaari,argent-dawn,861,deathknight,unholy,24,9,15
749,Тзинч,soulflayer,859,deathknight,unholy,18,9,9
750,Dzahnecro,archimonde,858,deathknight,unholy,18,9,9
751,Booneuh,kazzak,858,deathknight,unholy,24,9,15
752,Кмамехочу,howling-fjord,857,deathknight,unholy,12,9,3
753,Grubyr,burning-legion,857,deathknight,unholy,24,9,15
754,Джагат,gordunni,856,deathknight,unholy,30,12,18
755,Dalenn,kazzak,856,deathknight,unholy,24,9,15
756,Marcianorock,dalaran,850,deathknight,unholy,18,9,9
757,Deathcleave,burning-legion,845,deathknight,unholy,23,9,14
758,Lastdragon,dun-modr,840,deathknight,unholy,42,16,26
759,Oldu,haomarush,836,deathknight,unholy,63,28,35
760,Жекабыкует,borean-tundra,836,deathknight,unholy,38,14,24
761,Fidaii,sylvanas,833,deathknight,unholy,18,9,9
762,Civilredevil,ravencrest,830,deathknight,unholy,23,9,14
763,Cryistyx,draenor,828,deathknight,unholy,14,10,4
764,Zot,twisting-nether,814,deathknight,unholy,18,10,8
765,Flúrrý,ravencrest,799,deathknight,unholy,17,9,8
766,Angalor,argent-dawn,798,deathknight,unholy,17,9,8
767,Шмуркич,gordunni,798,deathknight,unholy,23,10,13
768,Alielib,eredar,794,deathknight,unholy,70,22,48
769,Марактус,gordunni,768,deathknight,unholy,12,8,4
770,Wórzzag,arygos,768,deathknight,unholy,12,8,4
771,Psychopathz,tarren-mill,768,deathknight,unholy,12,8,4
772,Barnëylord,argent-dawn,768,deathknight,unholy,12,8,4
773,Ravencraft,azjolnerub,768,deathknight,unholy,12,8,4
774,Aladonreith,zenedar,768,deathknight,unholy,12,8,4
775,Critycal,draenor,768,deathknight,unholy,12,8,4
776,Preddktwo,twisting-nether,768,deathknight,unholy,12,8,4
777,Шадоудез,gordunni,768,deathknight,unholy,12,8,4
778,Fatøumatata,archimonde,768,deathknight,unholy,18,8,10
779,Glower,burning-blade,768,deathknight,unholy,18,8,10
780,Xisaark,blackrock,768,deathknight,unholy,18,8,10
781,Zatrina,blackrock,768,deathknight,unholy,24,8,16
782,Dariusgrip,kazzak,768,deathknight,unholy,24,8,16
783,Мионеелол,goldrinn,768,deathknight,unholy,24,8,16
784,Dreshtarg,draenor,768,deathknight,unholy,24,8,16
785,Quazy,draenor,768,deathknight,unholy,30,8,22
786,Amelia,ambossar,767,deathknight,unholy,12,8,4
787,Deathpaladin,blackmoore,767,deathknight,unholy,12,8,4
788,Bonethugg,burning-legion,767,deathknight,unholy,18,8,10
789,Thanatus,aggra-português,767,deathknight,unholy,18,8,10
790,Apocalypse,ravencrest,767,deathknight,unholy,18,8,10
791,Goblinslayer,zuljin,767,deathknight,unholy,18,8,10
792,Shewoman,stormreaver,767,deathknight,unholy,18,8,10
793,Blácklíght,silvermoon,767,deathknight,unholy,18,8,10
794,Kàrásu,eredar,767,deathknight,unholy,18,8,10
795,Cyliandra,silvermoon,767,deathknight,unholy,27,9,18
796,Nuadar,outland,767,deathknight,unholy,24,8,16
797,Kaeyz,blackmoore,767,deathknight,unholy,24,8,16
798,Payat,aegwynn,766,deathknight,unholy,12,8,4
799,Auggee,ravencrest,766,deathknight,unholy,18,8,10
800,Krinoe,dalaran,766,deathknight,unholy,18,8,10
801,Zombienatíon,silvermoon,766,deathknight,unholy,24,8,16
802,Juicyjayho,stormscale,765,deathknight,unholy,24,8,16
803,Appdeath,azjolnerub,764,deathknight,unholy,12,8,4
804,Trigárdon,antonidas,764,deathknight,unholy,58,28,30
805,Darkeron,dun-modr,764,deathknight,unholy,18,8,10
806,Zanretxd,outland,764,deathknight,unholy,20,8,12
807,Mjölnir,sanguino,764,deathknight,unholy,24,8,16
808,Жупело,gordunni,762,deathknight,unholy,12,8,4
809,Latindvergur,sylvanas,762,deathknight,unholy,18,8,10
810,Olm,guldan,761,deathknight,unholy,12,8,4
811,Kazagoth,draenor,761,deathknight,unholy,18,8,10
812,Badbrian,draenor,760,deathknight,unholy,12,8,4
813,Unsuspected,kazzak,758,deathknight,unholy,24,8,16
814,Homunculas,twisting-nether,750,deathknight,unholy,17,8,9
815,Bhishma,blades-edge,749,deathknight,unholy,12,8,4
816,Ricardiob,argent-dawn,748,deathknight,unholy,16,9,7
817,Morssal,outland,748,deathknight,unholy,17,8,9
818,Kahp,tarren-mill,738,deathknight,unholy,21,9,12
819,Aldramil,gorgonnash,726,deathknight,unholy,24,9,15
820,Holîx,kazzak,714,deathknight,unholy,21,9,12
821,Deathuss,silvermoon,702,deathknight,unholy,22,8,14
822,Karisteur,azuremyst,672,deathknight,unholy,12,7,5
823,Moonpoxdk,nerathor,672,deathknight,unholy,12,7,5
824,Cervä,kazzak,672,deathknight,unholy,12,7,5
825,Gosuhat,kazzak,672,deathknight,unholy,12,7,5
826,Wolfyy,antonidas,672,deathknight,unholy,12,7,5
827,Vorrén,tarren-mill,672,deathknight,unholy,12,7,5
828,Vaalur,dalaran,672,deathknight,unholy,12,7,5
829,Диджейфрау,deathguard,672,deathknight,unholy,12,7,5
830,Hyperflexz,blackrock,672,deathknight,unholy,14,7,7
831,Wttdmg,kazzak,672,deathknight,unholy,18,7,11
832,Soulchaos,ravencrest,672,deathknight,unholy,18,7,11
833,Sythuss,argent-dawn,672,deathknight,unholy,18,7,11
834,Чумазная,howling-fjord,672,deathknight,unholy,18,7,11
835,Никнейм,gordunni,672,deathknight,unholy,18,7,11
836,Unholykebab,defias-brotherhood,672,deathknight,unholy,18,7,11
837,Darkarthás,aegwynn,672,deathknight,unholy,18,7,11
838,Gadres,aegwynn,672,deathknight,unholy,18,7,11
839,Keet,turalyon,672,deathknight,unholy,21,8,13
840,Падшийрыцарь,gordunni,671,deathknight,unholy,12,7,5
841,Lùrtzz,frostwolf,671,deathknight,unholy,12,7,5
842,Theamine,silvermoon,671,deathknight,unholy,12,7,5
843,Smightydk,kazzak,671,deathknight,unholy,12,7,5
844,Моргаррок,soulflayer,671,deathknight,unholy,12,7,5
845,Cmonbruvv,outland,671,deathknight,unholy,12,7,5
846,Дезентирия,soulflayer,671,deathknight,unholy,15,7,8
847,Корольбич,soulflayer,671,deathknight,unholy,18,7,11
848,Lìlïth,kazzak,671,deathknight,unholy,18,7,11
849,Creepzor,tarren-mill,671,deathknight,unholy,18,7,11
850,Mcrune,ravencrest,671,deathknight,unholy,18,7,11
851,Shiryú,ravencrest,671,deathknight,unholy,24,7,17
852,Ráisy,outland,671,deathknight,unholy,24,7,17
853,Crudelias,aegwynn,670,deathknight,unholy,12,7,5
854,Думсдэйи,gordunni,670,deathknight,unholy,12,7,5
855,Дуонза,blackscar,670,deathknight,unholy,12,7,5
856,Планус,booty-bay,670,deathknight,unholy,12,7,5
857,Amencore,kazzak,670,deathknight,unholy,14,7,7
858,Kranker,thrall,670,deathknight,unholy,18,7,11
859,Sulf,burning-legion,670,deathknight,unholy,18,7,11
860,Deathclapp,twisting-nether,670,deathknight,unholy,18,7,11
861,Akuji,dragonmaw,669,deathknight,unholy,12,7,5
862,Gothral,doomhammer,665,deathknight,unholy,12,7,5
863,Redzone,ravencrest,639,deathknight,unholy,23,7,16
864,Ogomegee,ravencrest,638,deathknight,unholy,16,7,9
865,Arthursq,stormscale,627,deathknight,unholy,82,30,52
866,Cremefresh,ragnaros,624,deathknight,unholy,15,7,8
867,Дкмонт,deathguard,623,deathknight,unholy,17,7,10
868,Moartèa,blackhand,622,deathknight,unholy,23,7,16
869,Kazagul,blackrock,620,deathknight,unholy,21,7,14
870,Ashgôrath,defias-brotherhood,607,deathknight,unholy,20,7,13
871,Vargass,darksorrow,598,deathknight,unholy,14,7,7
872,Uqrdk,twisting-nether,576,deathknight,unholy,12,6,6
873,Mêlian,blackmoore,576,deathknight,unholy,12,6,6
874,Kurían,burning-legion,576,deathknight,unholy,12,6,6
875,Ymirzo,outland,576,deathknight,unholy,12,6,6
876,Babs,sylvanas,576,deathknight,unholy,12,6,6
877,Duriel,stormscale,576,deathknight,unholy,12,6,6
878,Tombkeeper,silvermoon,576,deathknight,unholy,12,6,6
879,Merekx,emerald-dream,576,deathknight,unholy,12,6,6
880,Huxleeyys,draenor,576,deathknight,unholy,12,6,6
881,Swordkill,drakthul,576,deathknight,unholy,12,6,6
882,Янатащи,gordunni,576,deathknight,unholy,12,6,6
883,Petergrippin,dragonblight,576,deathknight,unholy,12,6,6
884,Myeltior,kazzak,576,deathknight,unholy,12,6,6
885,Фалькра,soulflayer,576,deathknight,unholy,12,6,6
886,Lemain,drakthul,576,deathknight,unholy,12,6,6
887,Gigadk,ragnaros,576,deathknight,unholy,12,6,6
888,Kyusuke,blackhand,576,deathknight,unholy,12,6,6
889,Ketnissq,blackrock,576,deathknight,unholy,12,6,6
890,Nephalêm,thrall,576,deathknight,unholy,12,6,6
891,Sfintter,uldum,576,deathknight,unholy,12,6,6
892,Dextroyersx,sanguino,576,deathknight,unholy,12,6,6
893,Venexia,kazzak,576,deathknight,unholy,12,6,6
894,Critgødx,draenor,576,deathknight,unholy,13,6,7
895,Pestikus,thrall,576,deathknight,unholy,18,6,12
896,Elisaron,silvermoon,576,deathknight,unholy,18,6,12
897,Bubbledeath,tarren-mill,576,deathknight,unholy,18,6,12
898,Deathboost,archimonde,576,deathknight,unholy,18,6,12
899,Armanelo,stormscale,576,deathknight,unholy,18,6,12
900,Itokawa,tarren-mill,576,deathknight,unholy,18,6,12
901,Exult,twisting-nether,576,deathknight,unholy,18,6,12
902,Tyranuse,kazzak,576,deathknight,unholy,24,6,18
903,Nefertitï,kazzak,576,deathknight,unholy,30,6,24
904,Pangen,ravencrest,576,deathknight,unholy,36,6,30
905,Havi,thunderhorn,575,deathknight,unholy,12,6,6
906,Archdemonio,wildhammer,575,deathknight,unholy,12,6,6
907,Arrakìs,nemesis,575,deathknight,unholy,12,6,6
908,Oldiseas,grim-batol,575,deathknight,unholy,12,6,6
909,Squeeze,drakthul,575,deathknight,unholy,12,6,6
910,Zegò,silvermoon,575,deathknight,unholy,12,6,6
911,Mosscraciun,kazzak,575,deathknight,unholy,12,6,6
912,Feugen,hyjal,575,deathknight,unholy,12,6,6
913,Zúrg,stormscale,575,deathknight,unholy,12,6,6
914,Deathmaiden,outland,575,deathknight,unholy,12,6,6
915,Dekatos,twisting-nether,575,deathknight,unholy,12,6,6
916,Namfuuh,blackrock,575,deathknight,unholy,24,6,18
917,Luciferyan,twisting-nether,574,deathknight,unholy,12,6,6
918,Nephenty,der-rat-von-dalaran,574,deathknight,unholy,12,6,6
919,Fortinateur,dalaran,573,deathknight,unholy,12,6,6
920,Cervanteso,uldum,571,deathknight,unholy,12,6,6
921,Kirkster,terokkar,570,deathknight,unholy,18,6,12
922,Hailandher,nemesis,565,deathknight,unholy,12,6,6
923,Lifetakergr,sylvanas,544,deathknight,unholy,16,6,10
924,Keltòr,antonidas,539,deathknight,unholy,17,6,11
925,Laobeef,twisting-nether,527,deathknight,unholy,11,6,5
926,Даркслэш,howling-fjord,522,deathknight,unholy,23,8,15
927,Deadpòól,twisting-nether,521,deathknight,unholy,33,7,26
928,Nirna,argent-dawn,514,deathknight,unholy,39,6,33
929,Vrark,forscherliga,512,deathknight,unholy,10,6,4
930,Seal,lightnings-blade,511,deathknight,unholy,26,9,17
931,Necrotickiss,frostwolf,480,deathknight,unholy,6,5,1
932,Roids,twisting-nether,480,deathknight,unholy,6,5,1
933,Sarconis,quelthalas,480,deathknight,unholy,6,5,1
934,Dromor,echsenkessel,480,deathknight,unholy,6,5,1
935,Náthrakh,argent-dawn,480,deathknight,unholy,6,5,1
936,Roundoné,kazzak,480,deathknight,unholy,6,5,1
937,Phrek,outland,480,deathknight,unholy,12,5,7
938,Boreghar,drakthul,480,deathknight,unholy,12,5,7
939,Gigacow,outland,480,deathknight,unholy,12,5,7
940,Шэйп,fordragon,480,deathknight,unholy,12,5,7
941,Deathkanta,antonidas,480,deathknight,unholy,12,5,7
942,Gorruk,malorne,480,deathknight,unholy,12,5,7
943,Тидог,ashenvale,480,deathknight,unholy,12,5,7
944,Dêeath,madmortem,480,deathknight,unholy,12,5,7
945,Миракл,howling-fjord,480,deathknight,unholy,12,5,7
946,Емтвоюкиску,soulflayer,480,deathknight,unholy,12,5,7
947,Cipisza,drakthul,480,deathknight,unholy,12,5,7
948,Morgianà,argent-dawn,480,deathknight,unholy,12,5,7
949,Clérora,argent-dawn,480,deathknight,unholy,12,5,7
950,Unholybezerk,darkspear,480,deathknight,unholy,12,5,7
951,Kaenor,sporeggar,480,deathknight,unholy,12,5,7
952,Frostich,ragnaros,480,deathknight,unholy,12,5,7
953,Luciferon,zenedar,480,deathknight,unholy,12,5,7
954,Stipemiocic,nemesis,480,deathknight,unholy,12,5,7
955,Zyknight,silvermoon,480,deathknight,unholy,12,5,7
956,Sipsip,tarren-mill,480,deathknight,unholy,12,5,7
957,Zhugzug,ragnaros,480,deathknight,unholy,12,5,7
958,Хенстор,gordunni,480,deathknight,unholy,12,5,7
959,Gripshiftr,kazzak,480,deathknight,unholy,12,5,7
960,Christldeath,blackrock,480,deathknight,unholy,12,5,7
961,Cbalife,ragnaros,480,deathknight,unholy,12,5,7
962,Rêxaks,dun-modr,480,deathknight,unholy,12,5,7
963,Painrune,nordrassil,480,deathknight,unholy,12,5,7
964,Kelebglin,silvermoon,480,deathknight,unholy,12,5,7
965,Skylerblack,kazzak,480,deathknight,unholy,12,5,7
966,Leyir,shendralar,480,deathknight,unholy,13,5,8
967,Shining,blackrock,480,deathknight,unholy,21,6,15
968,Xad,blackrock,480,deathknight,unholy,18,5,13
969,Necroslap,blackhand,480,deathknight,unholy,18,5,13
970,Тоши,fordragon,480,deathknight,unholy,18,5,13
971,Frostbone,ravencrest,480,deathknight,unholy,18,5,13
972,Helixsdk,outland,480,deathknight,unholy,20,5,15
973,Maxïmus,argent-dawn,480,deathknight,unholy,24,5,19
974,Rafuki,stormscale,479,deathknight,unholy,12,6,6
975,Mennal,the-maelstrom,479,deathknight,unholy,12,5,7
976,Crostrike,kazzak,479,deathknight,unholy,12,5,7
977,Мордаворот,gordunni,479,deathknight,unholy,12,5,7
978,Еххел,soulflayer,479,deathknight,unholy,12,5,7
979,Kraken,aerie-peak,479,deathknight,unholy,18,5,13
980,Jonyo,silvermoon,479,deathknight,unholy,24,5,19
981,Hacknorris,aegwynn,478,deathknight,unholy,12,5,7
982,Mailasse,dalaran,476,deathknight,unholy,10,6,4
983,Jarhèad,grim-batol,476,deathknight,unholy,22,7,15
984,Kavour,tarren-mill,447,deathknight,unholy,8,6,2
985,Calhoun,teldrassil,447,deathknight,unholy,11,5,6
986,Shadowgohst,dun-morogh,440,deathknight,unholy,14,6,8
987,Eli,dalaran,431,deathknight,unholy,11,5,6
988,Yggrauthr,argent-dawn,384,deathknight,unholy,6,4,2
989,Mangemicro,archimonde,384,deathknight,unholy,6,4,2
990,Redduck,silvermoon,384,deathknight,unholy,6,4,2
991,Kalhyst,archimonde,384,deathknight,unholy,6,4,2
992,Neph,sanguino,384,deathknight,unholy,6,4,2
993,Dragamanca,shendralar,384,deathknight,unholy,6,4,2
994,Енваки,gordunni,384,deathknight,unholy,6,4,2
995,Zyôs,blackmoore,384,deathknight,unholy,6,4,2
996,Helmich,frostmane,384,deathknight,unholy,6,4,2
997,Радиосмерти,gordunni,384,deathknight,unholy,6,4,2
998,Runeblade,shattered-hand,384,deathknight,unholy,6,4,2
999,Cówboylayla,stormscale,384,deathknight,unholy,6,4,2
1000,Tigros,burning-legion,384,deathknight,unholy,6,4,2
1001,Rabbijacob,ysondre,384,deathknight,unholy,6,4,2
1002,Buldog,laughing-skull,384,deathknight,unholy,6,4,2
1003,Budgetarthas,arthas,384,deathknight,unholy,6,4,2
1004,Shlongripper,silvermoon,384,deathknight,unholy,6,4,2
1005,Soulrender,kirin-tor,384,deathknight,unholy,6,4,2
1006,Copium,hyjal,384,deathknight,unholy,6,4,2
1007,Deathfrqst,ysondre,384,deathknight,unholy,6,4,2
1008,Stepknìght,draenor,384,deathknight,unholy,6,4,2
1009,Lichkunt,stormscale,384,deathknight,unholy,6,4,2
1010,Yerssinia,sylvanas,384,deathknight,unholy,6,4,2
1011,Kãzan,archimonde,384,deathknight,unholy,6,4,2
1012,Zd,ghostlands,384,deathknight,unholy,6,4,2
1013,Servein,stormscale,384,deathknight,unholy,12,4,8
1014,Derimathras,stormscale,384,deathknight,unholy,12,4,8
1015,Skypowerxx,darkspear,384,deathknight,unholy,12,4,8
1016,Dreadmind,blackrock,384,deathknight,unholy,12,4,8
1017,Volkovitch,archimonde,384,deathknight,unholy,12,4,8
1018,Брейвз,gordunni,384,deathknight,unholy,12,4,8
1019,Rouskkoff,hyjal,384,deathknight,unholy,12,4,8
1020,Виндрукс,soulflayer,384,deathknight,unholy,12,4,8
1021,Trashdk,blackrock,384,deathknight,unholy,12,4,8
1022,Nathriel,stormscale,384,deathknight,unholy,12,4,8
1023,Kachie,stormscale,384,deathknight,unholy,12,4,8
1024,Razdig,dun-modr,384,deathknight,unholy,12,4,8
1025,Vezthel,stormscale,384,deathknight,unholy,12,4,8
1026,Fatuglyrat,kazzak,384,deathknight,unholy,12,4,8
1027,Wlcrealworld,ravencrest,384,deathknight,unholy,12,4,8
1028,Puzikovatr,tarren-mill,384,deathknight,unholy,12,4,8
1029,Amesz,tarren-mill,384,deathknight,unholy,12,4,8
1030,Лордтемар,howling-fjord,384,deathknight,unholy,12,4,8
1031,Cervâ,twisting-nether,384,deathknight,unholy,12,4,8
1032,Mustakäsi,ravencrest,384,deathknight,unholy,12,4,8
1033,Sekkah,tarren-mill,384,deathknight,unholy,12,4,8
1034,Thoir,ahnqiraj,384,deathknight,unholy,12,4,8
1035,Колхозник,howling-fjord,384,deathknight,unholy,12,4,8
1036,Szayestra,draenor,384,deathknight,unholy,12,4,8
1037,Хлопайпопой,howling-fjord,384,deathknight,unholy,12,4,8
1038,Superpotatoh,silvermoon,384,deathknight,unholy,12,4,8
1039,Pängei,frostwolf,384,deathknight,unholy,12,4,8
1040,Freakabiceps,draenor,384,deathknight,unholy,18,4,14
1041,Blòópy,silvermoon,384,deathknight,unholy,18,4,14
1042,Brurf,ysondre,384,deathknight,unholy,18,4,14
1043,Pottifar,tarren-mill,384,deathknight,unholy,18,4,14
1044,Rades,sanguino,384,deathknight,unholy,18,4,14
1045,Madseason,burning-legion,384,deathknight,unholy,18,4,14
1046,Luzifear,bloodscalp,384,deathknight,unholy,18,4,14
1047,Dizin,ravencrest,384,deathknight,unholy,19,4,15
1048,Bargane,twilights-hammer,383,deathknight,unholy,6,4,2
1049,Zoombie,draenor,383,deathknight,unholy,6,4,2
1050,Flippmo,argent-dawn,383,deathknight,unholy,9,5,4
1051,Хворной,howling-fjord,383,deathknight,unholy,12,4,8
1052,Aczheron,argent-dawn,383,deathknight,unholy,12,4,8
1053,Украшение,galakrond,383,deathknight,unholy,12,4,8
1054,Darkangelina,aggra-português,378,deathknight,unholy,12,4,8
1055,Варрлнишнс,soulflayer,367,deathknight,unholy,11,4,7
1056,Millknight,norgannon,341,deathknight,unholy,15,6,9
1057,Väkü,silvermoon,336,deathknight,unholy,9,5,4
1058,Ikarack,twisting-nether,319,deathknight,unholy,8,4,4
1059,Randomdkxd,ravencrest,304,deathknight,unholy,13,4,9
1060,Saryn,burning-steppes,304,deathknight,unholy,13,4,9
1061,Darkeolos,twisting-nether,303,deathknight,unholy,7,4,3
1062,Amentet,anetheron,288,deathknight,unholy,10,5,5
1063,Krozzytwo,draenor,288,deathknight,unholy,6,3,3
1064,Fredriksend,argent-dawn,288,deathknight,unholy,6,3,3
1065,Spliddy,ravencrest,288,deathknight,unholy,6,3,3
1066,Knoxhult,kazzak,288,deathknight,unholy,6,3,3
1067,Masakryczny,burning-legion,288,deathknight,unholy,6,3,3
1068,Døddrukken,ragnaros,288,deathknight,unholy,6,3,3
1069,Dëmise,ravencrest,288,deathknight,unholy,6,3,3
1070,Uridk,sanguino,288,deathknight,unholy,6,3,3
1071,Darkrolexx,blackhand,288,deathknight,unholy,6,3,3
1072,Kalenis,nemesis,288,deathknight,unholy,6,3,3
1073,Smalldk,silvermoon,288,deathknight,unholy,6,3,3
1074,Soseiuchi,sargeras,288,deathknight,unholy,6,3,3
1075,Joyt,argent-dawn,288,deathknight,unholy,6,3,3
1076,Galgalí,blackmoore,288,deathknight,unholy,6,3,3
1077,Gbdk,xavius,288,deathknight,unholy,6,3,3
1078,Hasbullagødx,blackrock,288,deathknight,unholy,6,3,3
1079,Krookidk,archimonde,288,deathknight,unholy,6,3,3
1080,Unholyspîrît,outland,288,deathknight,unholy,6,3,3
1081,Rävjakt,twisting-nether,288,deathknight,unholy,6,3,3
1082,Dktyro,ravencrest,288,deathknight,unholy,6,3,3
1083,Løz,kazzak,288,deathknight,unholy,6,3,3
1084,Hurubur,ravencrest,288,deathknight,unholy,6,3,3
1085,Zêlëph,archimonde,288,deathknight,unholy,6,3,3
1086,Zathy,twisting-nether,288,deathknight,unholy,6,3,3
1087,Небишоп,howling-fjord,288,deathknight,unholy,6,3,3
1088,Heresjohny,stormrage,288,deathknight,unholy,6,3,3
1089,Wpízdu,aegwynn,288,deathknight,unholy,6,3,3
1090,Vip,argent-dawn,288,deathknight,unholy,6,3,3
1091,Salzalara,draenor,288,deathknight,unholy,6,3,3
1092,Dakyforfun,ravencrest,288,deathknight,unholy,6,3,3
1093,Тряпьё,galakrond,288,deathknight,unholy,6,3,3
1094,Grippyb,tarren-mill,288,deathknight,unholy,6,3,3
1095,Mocca,aegwynn,288,deathknight,unholy,6,3,3
1096,Sonervous,hyjal,288,deathknight,unholy,6,3,3
1097,Cyphîllyth,auchindoun,288,deathknight,unholy,6,3,3
1098,Bigbaboon,stormreaver,288,deathknight,unholy,6,3,3
1099,Израф,soulflayer,288,deathknight,unholy,6,3,3
1100,Cortessá,rexxar,288,deathknight,unholy,6,3,3
1101,Jénga,ghostlands,288,deathknight,unholy,6,3,3
1102,Zfeuda,azshara,288,deathknight,unholy,6,3,3
1103,Карвалан,eversong,288,deathknight,unholy,6,3,3
1104,Nmedk,grim-batol,288,deathknight,unholy,15,4,11
1105,Ecatholicus,silvermoon,288,deathknight,unholy,12,3,9
1106,Drraugrinn,tarren-mill,288,deathknight,unholy,12,3,9
1107,Ipanicfart,argent-dawn,288,deathknight,unholy,12,3,9
1108,Plaguebones,ravencrest,288,deathknight,unholy,12,3,9
1109,Морталес,azuregos,288,deathknight,unholy,12,3,9
1110,Whiskine,aggramar,288,deathknight,unholy,12,3,9
1111,Worldwiynd,ravencrest,288,deathknight,unholy,12,3,9
1112,Эвессом,goldrinn,288,deathknight,unholy,12,3,9
1113,Mizrael,burning-blade,288,deathknight,unholy,12,3,9
1114,Infamousmobb,archimonde,288,deathknight,unholy,12,3,9
1115,Zixcommixx,hyjal,288,deathknight,unholy,12,3,9
1116,Lewro,drakthul,288,deathknight,unholy,12,3,9
1117,Benetleilax,bronzebeard,288,deathknight,unholy,12,3,9
1118,Hexenköníg,frostmourne,288,deathknight,unholy,12,3,9
1119,Alakiah,khaz-modan,288,deathknight,unholy,12,3,9
1120,Dagë,twisting-nether,288,deathknight,unholy,12,3,9
1121,Adlian,twisting-nether,288,deathknight,unholy,12,3,9
1122,Gongroosh,blackrock,288,deathknight,unholy,12,3,9
1123,Smurm,stormscale,288,deathknight,unholy,12,3,9
1124,Demonium,twisting-nether,288,deathknight,unholy,12,3,9
1125,Chains,sanguino,288,deathknight,unholy,12,3,9
1126,Lair,shendralar,288,deathknight,unholy,12,3,9
1127,Naerys,ysondre,287,deathknight,unholy,6,3,3
1128,Atakan,nemesis,287,deathknight,unholy,6,3,3
1129,Ideath,executus,287,deathknight,unholy,6,3,3
1130,Euphorius,azuremyst,287,deathknight,unholy,6,3,3
1131,Ahin,antonidas,287,deathknight,unholy,6,3,3
1132,Каскадёрка,howling-fjord,287,deathknight,unholy,12,3,9
1133,Mámmôn,malygos,287,deathknight,unholy,13,3,10
1134,Abyad,dalaran,285,deathknight,unholy,12,3,9
1135,Hateem,sylvanas,255,deathknight,unholy,11,3,8
1136,Miruvar,tarren-mill,240,deathknight,unholy,9,3,6
1137,Difestia,silvermoon,239,deathknight,unholy,5,3,2
1138,Gogeta,zirkel-des-cenarius,239,deathknight,unholy,5,3,2
1139,Fearax,terenas,239,deathknight,unholy,5,3,2
1140,Charai,blackhand,234,deathknight,unholy,14,4,10
1141,Erector,norgannon,232,deathknight,unholy,11,5,6
1142,Xerone,turalyon,223,deathknight,unholy,8,3,5
1143,Nexium,outland,192,deathknight,unholy,4,3,1
1144,Varogo,drakthul,192,deathknight,unholy,6,2,4
1145,Urukaye,silvermoon,192,deathknight,unholy,6,2,4
1146,Fdkgotbuffed,tarren-mill,192,deathknight,unholy,6,2,4
1147,Dilbil,tarren-mill,192,deathknight,unholy,6,2,4
1148,Njor,twisting-nether,192,deathknight,unholy,6,2,4
1149,Doubledead,the-maelstrom,192,deathknight,unholy,6,2,4
1150,Barnalord,dentarg,192,deathknight,unholy,6,2,4
1151,Mangalitsa,twisting-nether,192,deathknight,unholy,6,2,4
1152,Norux,alonsus,192,deathknight,unholy,6,2,4
1153,Hemopathy,tarren-mill,192,deathknight,unholy,6,2,4
1154,Гнилец,soulflayer,192,deathknight,unholy,6,2,4
1155,Eigrin,argent-dawn,192,deathknight,unholy,6,2,4
1156,Draghonis,argent-dawn,192,deathknight,unholy,6,2,4
1157,Binknight,argent-dawn,192,deathknight,unholy,6,2,4
1158,Lén,malygos,192,deathknight,unholy,6,2,4
1159,Iziqroi,archimonde,192,deathknight,unholy,6,2,4
1160,Mustapha,kazzak,192,deathknight,unholy,6,2,4
1161,Имбазомбарь,howling-fjord,192,deathknight,unholy,6,2,4
1162,Postura,kazzak,192,deathknight,unholy,6,2,4
1163,Woltorme,archimonde,192,deathknight,unholy,6,2,4
1164,Аэрит,howling-fjord,192,deathknight,unholy,6,2,4
1165,Kaysto,blackrock,192,deathknight,unholy,6,2,4
1166,Letudra,outland,192,deathknight,unholy,6,2,4
1167,Oxcidium,archimonde,192,deathknight,unholy,6,2,4
1168,Unholyysteel,silvermoon,192,deathknight,unholy,6,2,4
1169,Engelinä,ysondre,192,deathknight,unholy,6,2,4
1170,Mcdreamy,grim-batol,192,deathknight,unholy,6,2,4
1171,Буризан,blackscar,192,deathknight,unholy,6,2,4
1172,Kromas,silvermoon,192,deathknight,unholy,6,2,4
1173,Горосов,gordunni,192,deathknight,unholy,6,2,4
1174,Nihilistyx,blackrock,192,deathknight,unholy,6,2,4
1175,Zehahaha,defias-brotherhood,192,deathknight,unholy,6,2,4
1176,Dk,earthen-ring,192,deathknight,unholy,6,2,4
1177,Firebladesa,ravencrest,192,deathknight,unholy,6,2,4
1178,Haeydez,draenor,192,deathknight,unholy,6,2,4
1179,Shackles,ravencrest,192,deathknight,unholy,6,2,4
1180,Bårêlýgød,blackmoore,192,deathknight,unholy,6,2,4
1181,Kacpèr,burning-legion,192,deathknight,unholy,6,2,4
1182,Rektsohard,ravencrest,192,deathknight,unholy,6,2,4
1183,Thryndiel,ravencrest,192,deathknight,unholy,6,2,4
1184,Homelándér,blackmoore,192,deathknight,unholy,6,2,4
1185,Feldøøm,nemesis,192,deathknight,unholy,6,2,4
1186,Hoggster,kazzak,192,deathknight,unholy,6,2,4
1187,Alameda,nathrezim,192,deathknight,unholy,6,2,4
1188,Clipe,sanguino,192,deathknight,unholy,6,2,4
1189,Ghary,blackhand,192,deathknight,unholy,6,2,4
1190,Lastprophet,drakthul,192,deathknight,unholy,6,2,4
1191,Valkion,nemesis,192,deathknight,unholy,6,2,4
1192,Goochtickler,kazzak,192,deathknight,unholy,6,2,4
1193,Elendren,blackrock,192,deathknight,unholy,6,2,4
1194,Lithics,blades-edge,192,deathknight,unholy,6,2,4
1195,Vahllas,blackhand,192,deathknight,unholy,6,2,4
1196,Kane,destromath,192,deathknight,unholy,7,2,5
1197,ßambøøzle,draenor,192,deathknight,unholy,13,3,10
1198,Majkântês,drakthul,192,deathknight,unholy,12,2,10
1199,Sénta,tarren-mill,192,deathknight,unholy,12,2,10
1200,Goldins,doomhammer,192,deathknight,unholy,12,2,10
1201,Demonicaltar,dalaran,192,deathknight,unholy,12,2,10
1202,Lumerix,drakthul,192,deathknight,unholy,12,2,10
1203,Carnificis,nefarian,192,deathknight,unholy,12,2,10
1204,Vîrus,kazzak,192,deathknight,unholy,12,2,10
1205,Arthaslegend,magtheridon,192,deathknight,unholy,12,2,10
1206,Azrail,alonsus,192,deathknight,unholy,12,2,10
1207,Гадиния,soulflayer,191,deathknight,unholy,4,3,1
1208,Whitedead,destromath,191,deathknight,unholy,6,2,4
1209,Àragørn,blackrock,191,deathknight,unholy,6,2,4
1210,Narancha,haomarush,191,deathknight,unholy,6,2,4
1211,Ândi,alleria,190,deathknight,unholy,12,2,10
1212,Strigoih,argent-dawn,190,deathknight,unholy,12,2,10
1213,Mupak,drakthul,159,deathknight,unholy,5,2,3
1214,Hokdk,voljin,159,deathknight,unholy,17,2,15
1215,Dødsmanna,twisting-nether,144,deathknight,unholy,9,2,7
1216,Jodure,silvermoon,138,deathknight,unholy,17,3,14
1217,Sämäël,outland,137,deathknight,unholy,8,3,5
1218,Auto,hyjal,128,deathknight,unholy,4,2,2
1219,Inmau,sanguino,96,deathknight,unholy,3,2,1
1220,Lothqgar,burning-legion,96,deathknight,unholy,3,2,1
1221,Deathdayben,kazzak,96,deathknight,unholy,6,1,5
1222,Unholygunnds,ravencrest,96,deathknight,unholy,6,1,5
1223,Гачимучий,soulflayer,96,deathknight,unholy,6,1,5
1224,Itrailblazer,turalyon,96,deathknight,unholy,6,1,5
1225,Имерсий,gordunni,96,deathknight,unholy,6,1,5
1226,Rongos,norgannon,96,deathknight,unholy,6,1,5
1227,Erezar,burning-legion,96,deathknight,unholy,6,1,5
1228,Antexdk,drakthul,96,deathknight,unholy,6,1,5
1229,Gdubet,kazzak,96,deathknight,unholy,6,1,5
1230,Инфлюминс,soulflayer,96,deathknight,unholy,6,1,5
1231,Lieven,tarren-mill,96,deathknight,unholy,6,1,5
1232,Úñçháíñéd,kazzak,96,deathknight,unholy,6,1,5
1233,Madsgrip,tarren-mill,96,deathknight,unholy,6,1,5
1234,Grimgôr,kazzak,96,deathknight,unholy,6,1,5
1235,Wavemaker,kazzak,96,deathknight,unholy,6,1,5
1236,Axemastery,draenor,96,deathknight,unholy,6,1,5
1237,Tsoupunisher,ravencrest,96,deathknight,unholy,6,1,5
1238,Dextèr,stormreaver,96,deathknight,unholy,6,1,5
1239,Drfatnuts,kazzak,96,deathknight,unholy,6,1,5
1240,Asarth,silvermoon,96,deathknight,unholy,6,1,5
1241,Shadowevil,silvermoon,96,deathknight,unholy,6,1,5
1242,Bytedk,aggra-português,96,deathknight,unholy,6,1,5
1243,Brotén,grim-batol,96,deathknight,unholy,6,1,5
1244,Sìrmooalot,twisting-nether,96,deathknight,unholy,6,1,5
1245,Eívór,garrosh,96,deathknight,unholy,6,1,5
1246,Муунрок,howling-fjord,96,deathknight,unholy,6,1,5
1247,Cameltôe,frostwolf,96,deathknight,unholy,6,1,5
1248,Beliall,draenor,96,deathknight,unholy,6,1,5
1249,Routasydän,outland,96,deathknight,unholy,6,1,5
1250,Veleran,blackrock,96,deathknight,unholy,6,1,5
1251,Искрос,gordunni,96,deathknight,unholy,6,1,5
1252,Zagoôo,outland,96,deathknight,unholy,6,1,5
1253,Ôcb,marécage-de-zangar,96,deathknight,unholy,6,1,5
1254,Джеттар,howling-fjord,96,deathknight,unholy,6,1,5
1255,Cowsoup,stormscale,96,deathknight,unholy,6,1,5
1256,Natanio,area-52,96,deathknight,unholy,6,1,5
1257,Abusedk,archimonde,96,deathknight,unholy,6,1,5
1258,Yagashi,stormscale,96,deathknight,unholy,6,1,5
1259,Orrengo,blackrock,96,deathknight,unholy,6,1,5
1260,Dumbclass,wildhammer,96,deathknight,unholy,6,1,5
1261,Armax,stormscale,96,deathknight,unholy,6,1,5
1262,Melicia,anubarak,96,deathknight,unholy,6,1,5
1263,Nyzak,stormscale,96,deathknight,unholy,6,1,5
1264,Verssatus,archimonde,96,deathknight,unholy,6,1,5
1265,Skrati,das-syndikat,96,deathknight,unholy,6,1,5
1266,Диманекротик,blackscar,96,deathknight,unholy,6,1,5
1267,Gruzzaghkull,azuremyst,96,deathknight,unholy,6,1,5
1268,Кернесса,blackscar,96,deathknight,unholy,6,1,5
1269,Коилкоилкоил,blackscar,96,deathknight,unholy,6,1,5
1270,Gosting,kirin-tor,96,deathknight,unholy,12,1,11
1271,Fenixflexin,ravencrest,96,deathknight,unholy,12,1,11
1272,Plaguecloud,kazzak,96,deathknight,unholy,12,1,11
1273,Brasith,outland,96,deathknight,unholy,12,1,11
1274,Depleterus,blackrock,96,deathknight,unholy,12,1,11
1275,Darkarnø,chants-éternels,96,deathknight,unholy,12,1,11
1276,Peiie,ravencrest,96,deathknight,unholy,12,1,11
1277,Buzknight,twisting-nether,96,deathknight,unholy,12,1,11
1278,Bestiaccia,nemesis,95,deathknight,unholy,6,1,5
1279,Beurkbeurk,la-croisade-écarlate,95,deathknight,unholy,12,1,11
1280,Necromedes,kazzak,64,deathknight,unholy,4,1,3
1281,Errøar,aegwynn,31,deathknight,unholy,2,1,1
1282,Шарабум,howling-fjord,16,deathknight,unholy,7,1,6
1283,Никнейм,gordunni,2123,deathknight,frost,102,55,47
1284,Имерсий,gordunni,2104,deathknight,frost,72,43,29
1285,Fdkgotbuffed,tarren-mill,2071,deathknight,frost,78,39,39
1286,Nellion,kazzak,2060,deathknight,frost,84,38,46
1287,Garrinchá,stormscale,2040,deathknight,frost,60,36,24
1288,Anotherdkx,ravencrest,2002,deathknight,frost,66,39,27
1289,Igetmount,draenor,1993,deathknight,frost,48,27,21
1290,Murbastic,draenor,1981,deathknight,frost,251,127,124
1291,Viuff,kazzak,1894,deathknight,frost,42,23,19
1292,Diogenisis,arthas,1834,deathknight,frost,94,43,51
1293,Jeanice,blackhand,1833,deathknight,frost,42,23,19
1294,Малтель,howling-fjord,1828,deathknight,frost,54,28,26
1295,Эриданс,gordunni,1806,deathknight,frost,48,32,16
1296,Картафилиус,soulflayer,1804,deathknight,frost,66,28,38
1297,Дарргг,ashenvale,1750,deathknight,frost,144,72,72
1298,Duriel,stormscale,1736,deathknight,frost,168,90,78
1299,Ayro,aegwynn,1732,deathknight,frost,66,34,32
1300,Kisyhrâ,aegwynn,1728,deathknight,frost,36,21,15
1301,Mikagoddess,argent-dawn,1723,deathknight,frost,118,61,57
1302,Arrèsted,aegwynn,1696,deathknight,frost,45,20,25
1303,Moreau,eredar,1682,deathknight,frost,93,47,46
1304,Sonnedeath,tarren-mill,1676,deathknight,frost,34,21,13
1305,Rêxaks,dun-modr,1661,deathknight,frost,60,28,32
1306,Zektal,thrall,1652,deathknight,frost,48,19,29
1307,Xolaani,outland,1632,deathknight,frost,72,32,40
1308,Ниффер,deathguard,1627,deathknight,frost,34,18,16
1309,Geunieve,ysondre,1621,deathknight,frost,60,23,37
1310,Espatula,ravencrest,1619,deathknight,frost,48,23,25
1311,Frace,tyrande,1619,deathknight,frost,84,38,46
1312,Cyliandra,silvermoon,1615,deathknight,frost,48,27,21
1313,Banishabomb,ragnaros,1615,deathknight,frost,78,39,39
1314,Vidofnir,argent-dawn,1611,deathknight,frost,56,31,25
1315,Raylenx,uldaman,1609,deathknight,frost,75,39,36
1316,Arxelas,stormscale,1607,deathknight,frost,68,42,26
1317,Diatriss,argent-dawn,1600,deathknight,frost,121,70,51
1318,Deucàlyqt,nemesis,1589,deathknight,frost,64,28,36
1319,Selena,blackmoore,1587,deathknight,frost,30,17,13
1320,Arxelas,sylvanas,1580,deathknight,frost,172,89,83
1321,Chakko,ravencrest,1579,deathknight,frost,57,26,31
1322,Клиссанг,razuvious,1572,deathknight,frost,30,19,11
1323,Dexterlul,blackmoore,1564,deathknight,frost,42,19,23
1324,Винкис,gordunni,1561,deathknight,frost,106,56,50
1325,Hatriox,outland,1551,deathknight,frost,153,84,69
1326,Maryø,drakthul,1543,deathknight,frost,42,18,24
1327,Deucalyqt,nemesis,1538,deathknight,frost,66,31,35
1328,Wrathlich,tyrande,1534,deathknight,frost,41,21,20
1329,Лордтемар,howling-fjord,1530,deathknight,frost,54,25,29
1330,Dripgrip,ravencrest,1529,deathknight,frost,77,36,41
1331,Tenzøftw,archimonde,1527,deathknight,frost,31,17,14
1332,Frostlux,archimonde,1524,deathknight,frost,539,257,282
1333,Kailara,draenor,1519,deathknight,frost,78,40,38
1334,Fallenjaina,kazzak,1513,deathknight,frost,203,101,102
1335,Gauloupin,lightnings-blade,1509,deathknight,frost,57,28,29
1336,Маклайкнайт,gordunni,1508,deathknight,frost,152,76,76
1337,Wildsword,sylvanas,1507,deathknight,frost,57,32,25
1338,Brawlerbabe,stormscale,1502,deathknight,frost,126,56,70
1339,Darlyn,grim-batol,1501,deathknight,frost,36,24,12
1340,Leónid,kazzak,1486,deathknight,frost,33,17,16
1341,Геннош,howling-fjord,1486,deathknight,frost,60,30,30
1342,Obliterate,frostmourne,1469,deathknight,frost,52,28,24
1343,Murky,kazzak,1467,deathknight,frost,36,16,20
1344,Катаринья,howling-fjord,1461,deathknight,frost,69,33,36
1345,Gorobijec,drakthul,1460,deathknight,frost,173,78,95
1346,Desolatiøn,ravencrest,1441,deathknight,frost,48,24,24
1347,Madseason,burning-legion,1441,deathknight,frost,42,20,22
1348,Akril,tarren-mill,1429,deathknight,frost,90,43,47
1349,Dktroll,blackmoore,1428,deathknight,frost,151,67,84
1350,Кулькулегал,ashenvale,1424,deathknight,frost,24,15,9
1351,Regniér,frostwolf,1423,deathknight,frost,206,97,109
1352,Neitoperho,frostmane,1422,deathknight,frost,36,15,21
1353,Frege,tarren-mill,1420,deathknight,frost,30,15,15
1354,Асаала,soulflayer,1419,deathknight,frost,27,19,8
1355,Kooklynn,aggra-português,1418,deathknight,frost,48,25,23
1356,Prokszii,turalyon,1416,deathknight,frost,35,21,14
1357,Abadonn,archimonde,1412,deathknight,frost,36,15,21
1358,Lylíth,archimonde,1411,deathknight,frost,60,31,29
1359,Frostymel,ravencrest,1411,deathknight,frost,54,21,33
1360,Drkok,blackmoore,1409,deathknight,frost,30,16,14
1361,Furleyc,argent-dawn,1405,deathknight,frost,60,34,26
1362,Jumbogrip,tarren-mill,1405,deathknight,frost,37,19,18
1363,Arthaslegend,magtheridon,1403,deathknight,frost,66,27,39
1364,Stevensdk,darkspear,1399,deathknight,frost,42,19,23
1365,Angalor,argent-dawn,1399,deathknight,frost,44,18,26
1366,Blácked,draenor,1397,deathknight,frost,36,18,18
1367,Düksito,dun-modr,1392,deathknight,frost,63,32,31
1368,Skorice,dalaran,1389,deathknight,frost,48,19,29
1369,Mocca,aegwynn,1385,deathknight,frost,58,25,33
1370,Scørn,thrall,1383,deathknight,frost,84,39,45
1371,Флаттершайдк,booty-bay,1383,deathknight,frost,37,16,21
1372,Reapocalypse,blackhand,1376,deathknight,frost,36,16,20
1373,Фростмаран,soulflayer,1373,deathknight,frost,96,45,51
1374,Mcrune,ravencrest,1364,deathknight,frost,44,22,22
1375,Cdp,ragnaros,1361,deathknight,frost,42,26,16
1376,Keronaterol,blackhand,1361,deathknight,frost,78,43,35
1377,Orcborg,zuljin,1360,deathknight,frost,54,30,24
1378,Ðeucaly,nemesis,1357,deathknight,frost,66,30,36
1379,Arthasuk,dun-modr,1356,deathknight,frost,153,84,69
1380,Reezeer,stormscale,1351,deathknight,frost,30,15,15
1381,Neorteriona,argent-dawn,1328,deathknight,frost,34,17,17
1382,Superere,hyjal,1326,deathknight,frost,150,80,70
1383,Comehere,norgannon,1321,deathknight,frost,30,19,11
1384,Tofin,dunemaul,1320,deathknight,frost,38,18,20
1385,Wintersons,tarren-mill,1317,deathknight,frost,36,17,19
1386,Buldog,laughing-skull,1309,deathknight,frost,58,25,33
1387,Zoree,draenor,1307,deathknight,frost,42,15,27
1388,Wlcrealworld,ravencrest,1303,deathknight,frost,54,24,30
1389,Sinabre,eitrigg,1302,deathknight,frost,30,14,16
1390,Deucalygodx,nemesis,1301,deathknight,frost,60,22,38
1391,Deathknight,spinebreaker,1300,deathknight,frost,50,22,28
1392,Âlîce,culte-de-la-rive-noire,1297,deathknight,frost,54,26,28
1393,Kãra,ysondre,1288,deathknight,frost,85,42,43
1394,Кроуфрост,gordunni,1285,deathknight,frost,60,29,31
1395,Dzengiskhan,draenor,1285,deathknight,frost,66,27,39
1396,Ubiystvo,kazzak,1284,deathknight,frost,60,31,29
1397,Soulrender,kirin-tor,1283,deathknight,frost,36,15,21
1398,Unchaindk,outland,1282,deathknight,frost,60,31,29
1399,Barathéøn,les-sentinelles,1282,deathknight,frost,53,19,34
1400,Касуляпвнз,gordunni,1271,deathknight,frost,51,26,25
1401,Ihatelife,frostwolf,1271,deathknight,frost,102,49,53
1402,Spøøk,defias-brotherhood,1268,deathknight,frost,217,104,113
1403,Sukadino,ragnaros,1264,deathknight,frost,60,31,29
1404,Døuffy,hyjal,1248,deathknight,frost,149,72,77
1405,Elendren,blackrock,1247,deathknight,frost,24,13,11
1406,Düks,dun-modr,1238,deathknight,frost,87,39,48
1407,Leonis,arthas,1237,deathknight,frost,35,13,22
1408,Hî,malganis,1234,deathknight,frost,67,35,32
1409,Iaccidens,stormscale,1232,deathknight,frost,99,45,54
1410,Krasny,hyjal,1231,deathknight,frost,108,59,49
1411,Dükss,dun-modr,1230,deathknight,frost,42,22,20
1412,Morgouse,kazzak,1225,deathknight,frost,107,49,58
1413,Satyriasis,twisting-nether,1224,deathknight,frost,28,16,12
1414,Frostmommy,argent-dawn,1214,deathknight,frost,41,16,25
1415,Moosbirne,blackhand,1213,deathknight,frost,36,15,21
1416,Belía,blackmoore,1204,deathknight,frost,56,26,30
1417,Monkeydclaus,arathor,1202,deathknight,frost,60,31,29
1418,Êbøla,sanguino,1202,deathknight,frost,66,28,38
1419,Exodiuss,dalaran,1195,deathknight,frost,40,20,20
1420,Fixmybones,frostmane,1183,deathknight,frost,54,27,27
1421,Gageth,shadowsong,1180,deathknight,frost,45,15,30
1422,Twardobaba,burning-legion,1176,deathknight,frost,56,25,31
1423,Cayliadk,tarren-mill,1174,deathknight,frost,167,76,91
1424,Môrgøth,nemesis,1171,deathknight,frost,54,20,34
1425,Bari,the-venture-co,1166,deathknight,frost,36,15,21
1426,Zandruq,twisting-nether,1162,deathknight,frost,58,24,34
1427,Clàymax,kazzak,1161,deathknight,frost,45,17,28
1428,Селес,ashenvale,1151,deathknight,frost,24,12,12
1429,Aceléss,drakthul,1150,deathknight,frost,18,12,6
1430,Ziuziu,twisting-nether,1149,deathknight,frost,34,16,18
1431,Разлажение,gordunni,1147,deathknight,frost,66,33,33
1432,Leyc,argent-dawn,1146,deathknight,frost,24,12,12
1433,Nôsferatú,amanthul,1145,deathknight,frost,78,39,39
1434,Rektsohard,ravencrest,1144,deathknight,frost,20,12,8
1435,Darkchas,silvermoon,1144,deathknight,frost,24,12,12
1436,Erbugul,uldum,1143,deathknight,frost,30,12,18
1437,Zerodude,silvermoon,1142,deathknight,frost,60,30,30
1438,Azrador,frostwolf,1140,deathknight,frost,54,21,33
1439,Grendul,blackmoore,1139,deathknight,frost,24,12,12
1440,Sipsip,tarren-mill,1139,deathknight,frost,24,12,12
1441,Thenrys,culte-de-la-rive-noire,1139,deathknight,frost,80,32,48
1442,Polimeh,draenor,1132,deathknight,frost,66,38,28
1443,Zuggandk,tarren-mill,1132,deathknight,frost,24,13,11
1444,Mattesøs,drakthul,1130,deathknight,frost,36,13,23
1445,Wardrickxdd,ravencrest,1128,deathknight,frost,24,12,12
1446,Nîghtmáre,ravencrest,1117,deathknight,frost,23,12,11
1447,Dkruffos,draenor,1114,deathknight,frost,60,24,36
1448,Dämäger,proudmoore,1113,deathknight,frost,77,36,41
1449,Alastoras,nemesis,1108,deathknight,frost,37,19,18
1450,Akantras,blackmoore,1106,deathknight,frost,59,28,31
1451,Collinná,aegwynn,1104,deathknight,frost,36,13,23
1452,Posinkautta,silvermoon,1103,deathknight,frost,18,13,5
1453,Woddey,blackrock,1101,deathknight,frost,60,29,31
1454,Archa,shendralar,1097,deathknight,frost,48,20,28
1455,Nelahh,the-maelstrom,1093,deathknight,frost,30,15,15
1456,Abnormus,tarren-mill,1089,deathknight,frost,107,53,54
1457,Regys,argent-dawn,1080,deathknight,frost,28,12,16
1458,Zioan,jaedenar,1079,deathknight,frost,62,33,29
1459,Angôs,sanguino,1075,deathknight,frost,36,18,18
1460,Вафельнаяфея,blackscar,1073,deathknight,frost,43,17,26
1461,Порция,greymane,1058,deathknight,frost,54,32,22
1462,Khelthalas,teldrassil,1053,deathknight,frost,25,18,7
1463,Unaxito,sanguino,1052,deathknight,frost,24,11,13
1464,Merdraut,alakir,1037,deathknight,frost,18,11,7
1465,Папичдк,gordunni,1031,deathknight,frost,23,13,10
1466,Ivik,the-maelstrom,1024,deathknight,frost,62,35,27
1467,Krylow,draenor,1020,deathknight,frost,42,17,25
1468,Deathcardos,die-aldor,1013,deathknight,frost,30,11,19
1469,Quantumshift,ravencrest,1004,deathknight,frost,17,11,6
1470,Sooran,blackhand,994,deathknight,frost,24,16,8
1471,Gravehammer,sylvanas,991,deathknight,frost,18,11,7
1472,Nathriel,stormscale,985,deathknight,frost,23,11,12
1473,Dakyforfun,ravencrest,960,deathknight,frost,12,10,2
1474,Flúrrý,kazzak,960,deathknight,frost,24,10,14
1475,Re,stormrage,959,deathknight,frost,18,10,8
1476,Adär,kazzak,958,deathknight,frost,18,10,8
1477,Kerastrell,doomhammer,957,deathknight,frost,24,10,14
1478,Nifllheimr,outland,954,deathknight,frost,18,10,8
1479,Dursall,thrall,951,deathknight,frost,154,75,79
1480,Scorbion,kilrogg,947,deathknight,frost,33,16,17
1481,Zaouros,silvermoon,946,deathknight,frost,36,10,26
1482,Grumpykathi,blackmoore,945,deathknight,frost,18,10,8
1483,Íbossit,doomhammer,940,deathknight,frost,18,10,8
1484,Mauryr,drakthul,900,deathknight,frost,72,26,46
1485,Нифер,deathguard,894,deathknight,frost,20,10,10
1486,Карвалан,eversong,884,deathknight,frost,36,18,18
1487,Kixx,bloodfeather,873,deathknight,frost,53,13,40
1488,Assasínator,tarren-mill,872,deathknight,frost,49,24,25
1489,Fareast,nerathor,865,deathknight,frost,78,36,42
1490,Mellion,ragnaros,864,deathknight,frost,12,9,3
1491,Løz,kazzak,864,deathknight,frost,18,9,9
1492,ßambøøzle,draenor,864,deathknight,frost,18,9,9
1493,Ñogg,kazzak,864,deathknight,frost,24,9,15
1494,Asphyxias,alleria,863,deathknight,frost,18,9,9
1495,Nymfo,tirion,862,deathknight,frost,12,9,3
1496,Zhigan,ravencrest,862,deathknight,frost,18,9,9
1497,Gringly,tarren-mill,862,deathknight,frost,18,9,9
1498,Vîrus,kazzak,859,deathknight,frost,18,9,9
1499,Triddion,sylvanas,857,deathknight,frost,18,9,9
1500,Rogerwaterz,twisting-nether,855,deathknight,frost,12,9,3
1501,Deadkilla,stormreaver,851,deathknight,frost,18,9,9
1502,Dànté,eitrigg,848,deathknight,frost,18,10,8
1503,Peachvajz,turalyon,845,deathknight,frost,87,43,44
1504,Guillemet,turalyon,830,deathknight,frost,16,10,6
1505,Elbaqwan,the-shatar,827,deathknight,frost,30,13,17
1506,Craftmaker,eonar,816,deathknight,frost,44,19,25
1507,Sunwrath,magtheridon,816,deathknight,frost,24,9,15
1508,Leahthebad,sylvanas,803,deathknight,frost,26,10,16
1509,Tenzøjr,archimonde,768,deathknight,frost,12,8,4
1510,Salaahadin,darkspear,768,deathknight,frost,18,8,10
1511,Eynoway,blackmoore,768,deathknight,frost,18,8,10
1512,Deathvarg,argent-dawn,768,deathknight,frost,18,8,10
1513,Khagra,ravencrest,767,deathknight,frost,18,8,10
1514,Jollíe,tarren-mill,767,deathknight,frost,24,8,16
1515,Истинна,grom,766,deathknight,frost,18,8,10
1516,Zombíe,laughing-skull,765,deathknight,frost,12,8,4
1517,Дрогдош,howling-fjord,765,deathknight,frost,24,8,16
1518,Арнорос,lich-king,764,deathknight,frost,12,8,4
1519,Fullbusterr,hyjal,761,deathknight,frost,12,8,4
1520,Aegwynnêr,blackmoore,760,deathknight,frost,19,9,10
1521,Zerdon,frostmane,756,deathknight,frost,13,8,5
1522,Afadk,kazzak,752,deathknight,frost,72,27,45
1523,Darklich,blackmoore,745,deathknight,frost,18,8,10
1524,Lichfils,chogall,745,deathknight,frost,27,8,19
1525,Odaijini,archimonde,719,deathknight,frost,17,8,9
1526,Inaëlys,medivh,713,deathknight,frost,15,9,6
1527,Импостик,blackscar,672,deathknight,frost,12,7,5
1528,Gorefiend,kazzak,672,deathknight,frost,12,7,5
1529,Mâxî,hyjal,672,deathknight,frost,12,7,5
1530,Veneera,emeriss,672,deathknight,frost,12,7,5
1531,Primø,malganis,671,deathknight,frost,16,8,8
1532,Halohuntress,outland,671,deathknight,frost,18,7,11
1533,Vampire,ahnqiraj,671,deathknight,frost,18,7,11
1534,Holîx,kazzak,671,deathknight,frost,30,7,23
1535,Karthor,teldrassil,670,deathknight,frost,12,7,5
1536,Blurek,lordaeron,670,deathknight,frost,12,7,5
1537,Uthn,outland,670,deathknight,frost,24,7,17
1538,Меланндрис,gordunni,669,deathknight,frost,15,8,7
1539,Annecanos,ravencrest,668,deathknight,frost,12,7,5
1540,Menacê,ravencrest,662,deathknight,frost,18,7,11
1541,Aczheron,argent-dawn,660,deathknight,frost,24,7,17
1542,Antîlâ,antonidas,658,deathknight,frost,12,7,5
1543,Dreadnight,sanguino,639,deathknight,frost,14,8,6
1544,Narali,argent-dawn,576,deathknight,frost,12,6,6
1545,Flúrry,ravencrest,576,deathknight,frost,12,6,6
1546,Sødax,sanguino,576,deathknight,frost,12,6,6
1547,Doping,eredar,576,deathknight,frost,12,6,6
1548,Volestral,emeriss,576,deathknight,frost,12,6,6
1549,Планус,booty-bay,576,deathknight,frost,12,6,6
1550,Liija,blackrock,576,deathknight,frost,12,6,6
1551,Rubbann,ravencrest,576,deathknight,frost,12,6,6
1552,Pandahapci,ragnaros,576,deathknight,frost,12,6,6
1553,Silvergreed,kazzak,576,deathknight,frost,12,6,6
1554,Orangatang,dalaran,576,deathknight,frost,12,6,6
1555,Xeliora,ragnaros,576,deathknight,frost,15,7,8
1556,Qus,twisting-nether,576,deathknight,frost,18,6,12
1557,Oj,darkspear,576,deathknight,frost,18,6,12
1558,Worlviuz,argent-dawn,576,deathknight,frost,18,6,12
1559,Deathmike,steamwheedle-cartel,576,deathknight,frost,18,6,12
1560,Parayysite,eredar,576,deathknight,frost,18,6,12
1561,Rompå,ravencrest,576,deathknight,frost,18,6,12
1562,Gotendk,draenor,575,deathknight,frost,12,6,6
1563,Fatbutdead,malganis,575,deathknight,frost,12,6,6
1564,Tugarinzmey,tarren-mill,575,deathknight,frost,18,6,12
1565,Ahnuk,aggra-português,574,deathknight,frost,12,6,6
1566,Trogkhar,blackrock,574,deathknight,frost,12,6,6
1567,Фламмивир,gordunni,572,deathknight,frost,12,6,6
1568,Izanagii,exodar,572,deathknight,frost,12,6,6
1569,Tyranuse,kazzak,527,deathknight,frost,17,6,11
1570,Фэйлстрайк,azuregos,510,deathknight,frost,14,6,8
1571,Grimmoth,argent-dawn,480,deathknight,frost,6,5,1
1572,Deckbulle,blackhand,480,deathknight,frost,6,5,1
1573,Goring,confrérie-du-thorium,480,deathknight,frost,6,5,1
1574,Thebangman,ravencrest,480,deathknight,frost,9,6,3
1575,Дэвайна,gordunni,480,deathknight,frost,12,5,7
1576,Ларкусдк,howling-fjord,480,deathknight,frost,12,5,7
1577,Hemopathy,tarren-mill,480,deathknight,frost,12,5,7
1578,Руин,blackscar,480,deathknight,frost,12,5,7
1579,Feelmyfuri,mazrigos,480,deathknight,frost,12,5,7
1580,Khnïshou,silvermoon,480,deathknight,frost,12,5,7
1581,Ûñhølýðéåthj,tarren-mill,480,deathknight,frost,12,5,7
1582,Nommad,archimonde,480,deathknight,frost,12,5,7
1583,Goochtickler,kazzak,480,deathknight,frost,12,5,7
1584,Urzza,ysondre,480,deathknight,frost,12,5,7
1585,Justaniceguy,silvermoon,480,deathknight,frost,12,5,7
1586,Runepride,argent-dawn,480,deathknight,frost,12,5,7
1587,Pestilerous,draenor,480,deathknight,frost,18,5,13
1588,Hellcrosser,blackrock,479,deathknight,frost,12,5,7
1589,Jowân,blackmoore,479,deathknight,frost,12,5,7
1590,Sindó,blackrock,479,deathknight,frost,12,5,7
1591,Xtream,blackmoore,479,deathknight,frost,12,5,7
1592,Смердонос,grom,479,deathknight,frost,12,5,7
1593,Ostridz,grim-batol,479,deathknight,frost,12,5,7
1594,Talge,sylvanas,479,deathknight,frost,12,5,7
1595,Deadpòól,twisting-nether,479,deathknight,frost,18,5,13
1596,Merà,antonidas,479,deathknight,frost,18,5,13
1597,Bigspider,aggramar,479,deathknight,frost,24,5,19
1598,Copium,hyjal,477,deathknight,frost,12,5,7
1599,Fishtruction,tarren-mill,476,deathknight,frost,12,5,7
1600,Kejpo,drakthul,473,deathknight,frost,12,5,7
1601,Predatormkdd,ravencrest,429,deathknight,frost,11,5,6
1602,Dunkàn,silvermoon,384,deathknight,frost,6,4,2
1603,Gozuryu,kazzak,384,deathknight,frost,6,4,2
1604,Smardacus,silvermoon,384,deathknight,frost,6,4,2
1605,Lemmegetuuh,chogall,384,deathknight,frost,6,4,2
1606,Wuurzaag,twisting-nether,384,deathknight,frost,6,4,2
1607,Oldiseas,grim-batol,384,deathknight,frost,6,4,2
1608,Wpízdu,aegwynn,384,deathknight,frost,6,4,2
1609,Indrette,archimonde,384,deathknight,frost,6,4,2
1610,Letumnex,tarren-mill,384,deathknight,frost,6,4,2
1611,Namzera,draenor,384,deathknight,frost,6,4,2
1612,Reann,argent-dawn,384,deathknight,frost,6,4,2
1613,Enzy,drakthul,384,deathknight,frost,6,4,2
1614,Necrølyte,sylvanas,384,deathknight,frost,6,4,2
1615,Вирко,eversong,384,deathknight,frost,9,5,4
1616,Дедвбане,gordunni,384,deathknight,frost,8,4,4
1617,Anasûrimbor,tarren-mill,384,deathknight,frost,12,4,8
1618,Maxmo,twilights-hammer,384,deathknight,frost,12,4,8
1619,Apraxia,ravencrest,384,deathknight,frost,12,4,8
1620,Джайвана,soulflayer,384,deathknight,frost,12,4,8
1621,Æew,kazzak,384,deathknight,frost,12,4,8
1622,Doodcraft,tarren-mill,384,deathknight,frost,12,4,8
1623,Xenake,kazzak,384,deathknight,frost,12,4,8
1624,Pawnzqtie,stormscale,384,deathknight,frost,12,4,8
1625,Leahthemad,sylvanas,384,deathknight,frost,12,4,8
1626,Raihor,outland,384,deathknight,frost,14,4,10
1627,Кокосоус,gordunni,384,deathknight,frost,17,4,13
1628,Hordak,stormscale,384,deathknight,frost,18,4,14
1629,Dextroyersx,sanguino,384,deathknight,frost,18,4,14
1630,Beherith,sunstrider,383,deathknight,frost,6,4,2
1631,Tÿnak,der-mithrilorden,383,deathknight,frost,9,4,5
1632,Breeze,xavius,383,deathknight,frost,12,4,8
1633,Eckodk,aggra-português,383,deathknight,frost,12,4,8
1634,Гадиния,soulflayer,383,deathknight,frost,12,4,8
1635,Arond,arygos,383,deathknight,frost,12,4,8
1636,Kivo,marécage-de-zangar,383,deathknight,frost,12,4,8
1637,Бранс,gordunni,383,deathknight,frost,12,4,8
1638,Belâam,archimonde,383,deathknight,frost,24,4,20
1639,Mahfel,twisting-nether,382,deathknight,frost,6,4,2
1640,Группер,gordunni,382,deathknight,frost,6,4,2
1641,Дневнои,howling-fjord,382,deathknight,frost,12,4,8
1642,Dødsgud,khaz-modan,382,deathknight,frost,12,4,8
1643,Dekagramcz,drakthul,382,deathknight,frost,12,4,8
1644,Vicoperian,stormscale,382,deathknight,frost,12,4,8
1645,Poaka,outland,380,deathknight,frost,12,4,8
1646,Iikarus,eredar,376,deathknight,frost,18,4,14
1647,Душанерзула,howling-fjord,330,deathknight,frost,18,6,12
1648,Vín,silvermoon,319,deathknight,frost,10,4,6
1649,Cptneverdie,stormscale,288,deathknight,frost,6,3,3
1650,Vaanor,draenor,288,deathknight,frost,6,3,3
1651,Neptunium,archimonde,288,deathknight,frost,6,3,3
1652,Necrozy,aggra-português,288,deathknight,frost,6,3,3
1653,Persefal,nemesis,288,deathknight,frost,6,3,3
1654,Moohammood,argent-dawn,288,deathknight,frost,6,3,3
1655,Ogomegee,ravencrest,288,deathknight,frost,6,3,3
1656,Шэйп,fordragon,288,deathknight,frost,6,3,3
1657,Xanthic,ravencrest,288,deathknight,frost,6,3,3
1658,Darxiera,drakthul,288,deathknight,frost,6,3,3
1659,Whippy,ravencrest,288,deathknight,frost,6,3,3
1660,Микелон,gordunni,288,deathknight,frost,6,3,3
1661,Dêeath,madmortem,288,deathknight,frost,6,3,3
1662,Джеттар,howling-fjord,288,deathknight,frost,6,3,3
1663,Keridíin,twisting-nether,288,deathknight,frost,6,3,3
1664,Cyphîllyth,auchindoun,288,deathknight,frost,6,3,3
1665,Трибунальщик,gordunni,288,deathknight,frost,6,3,3
1666,Modelo,twisting-nether,288,deathknight,frost,6,3,3
1667,Madsgrip,tarren-mill,288,deathknight,frost,6,3,3
1668,Fallén,stormrage,288,deathknight,frost,6,3,3
1669,Tómér,outland,288,deathknight,frost,6,3,3
1670,Merdenhall,argent-dawn,288,deathknight,frost,6,3,3
1671,Petardodupy,burning-legion,288,deathknight,frost,6,3,3
1672,Loorda,kazzak,288,deathknight,frost,6,3,3
1673,Jjayker,kazzak,288,deathknight,frost,6,3,3
1674,Shicheria,blackrock,288,deathknight,frost,6,3,3
1675,Moko,defias-brotherhood,288,deathknight,frost,6,3,3
1676,Гурий,ashenvale,288,deathknight,frost,6,3,3
1677,Hellcrusher,kazzak,288,deathknight,frost,6,3,3
1678,Nasxsy,blackmoore,288,deathknight,frost,6,3,3
1679,Myzouth,silvermoon,288,deathknight,frost,6,3,3
1680,Husarz,kazzak,288,deathknight,frost,6,3,3
1681,Lair,shendralar,288,deathknight,frost,6,3,3
1682,Vexxed,magtheridon,288,deathknight,frost,6,3,3
1683,Nazgül,drakthul,288,deathknight,frost,6,3,3
1684,Kèén,kazzak,288,deathknight,frost,6,3,3
1685,Desulól,tarren-mill,288,deathknight,frost,9,4,5
1686,Nexxel,blackhand,288,deathknight,frost,11,3,8
1687,Râke,teldrassil,288,deathknight,frost,12,3,9
1688,Milchimhaus,dun-morogh,288,deathknight,frost,12,3,9
1689,Prekliatylad,burning-blade,288,deathknight,frost,12,3,9
1690,Thedk,voljin,288,deathknight,frost,12,3,9
1691,Тенелла,gordunni,288,deathknight,frost,12,3,9
1692,Obstwald,blackrock,288,deathknight,frost,12,3,9
1693,Discochoppa,blackmoore,288,deathknight,frost,12,3,9
1694,Powerlifting,los-errantes,288,deathknight,frost,12,3,9
1695,Ezlar,silvermoon,288,deathknight,frost,12,3,9
1696,Thilior,silvermoon,288,deathknight,frost,12,3,9
1697,Chifuyu,azjolnerub,288,deathknight,frost,12,3,9
1698,Emielf,silvermoon,288,deathknight,frost,12,3,9
1699,Balekouille,eldrethalas,287,deathknight,frost,6,3,3
1700,Rakhash,antonidas,287,deathknight,frost,6,3,3
1701,Sawishere,sanguino,287,deathknight,frost,12,3,9
1702,Eisentorte,nerathor,287,deathknight,frost,20,3,17
1703,Whitedead,destromath,286,deathknight,frost,6,3,3
1704,Housemeyster,antonidas,286,deathknight,frost,12,3,9
1705,Tiunping,silvermoon,286,deathknight,frost,12,3,9
1706,Venthyrgwa,kazzak,284,deathknight,frost,7,5,2
1707,Rubyblood,aggra-português,271,deathknight,frost,11,3,8
1708,ßæst,archimonde,208,deathknight,frost,7,3,4
1709,Dimania,the-maelstrom,192,deathknight,frost,4,3,1
1710,Ratge,hyjal,192,deathknight,frost,6,2,4
1711,Bàbarus,dun-morogh,192,deathknight,frost,6,2,4
1712,Ikarack,twisting-nether,192,deathknight,frost,6,2,4
1713,Køley,draenor,192,deathknight,frost,6,2,4
1714,Ullefuz,silvermoon,192,deathknight,frost,6,2,4
1715,Leomordf,doomhammer,192,deathknight,frost,6,2,4
1716,Unholz,kazzak,192,deathknight,frost,6,2,4
1717,Likell,argent-dawn,192,deathknight,frost,6,2,4
1718,Doozz,draenor,192,deathknight,frost,6,2,4
1719,Archdemonio,wildhammer,192,deathknight,frost,6,2,4
1720,Babsyknight,wildhammer,192,deathknight,frost,6,2,4
1721,Darkarthás,aegwynn,192,deathknight,frost,6,2,4
1722,Nergål,sanguino,192,deathknight,frost,6,2,4
1723,Scárebear,outland,192,deathknight,frost,6,2,4
1724,Pandahapcii,ragnaros,192,deathknight,frost,6,2,4
1725,Nèrfx,ragnaros,192,deathknight,frost,6,2,4
1726,Tyró,ravencrest,192,deathknight,frost,6,2,4
1727,Аирфрост,howling-fjord,192,deathknight,frost,6,2,4
1728,Ilaenu,ravencrest,192,deathknight,frost,6,2,4
1729,Lemonhazebg,stormscale,192,deathknight,frost,6,2,4
1730,Fentanil,elune,192,deathknight,frost,6,2,4
1731,Ilovegouàng,khaz-modan,192,deathknight,frost,6,2,4
1732,Эвессом,goldrinn,192,deathknight,frost,6,2,4
1733,Bedstemoor,ravencrest,192,deathknight,frost,6,2,4
1734,Сивкабурка,fordragon,192,deathknight,frost,6,2,4
1735,Mennal,the-maelstrom,192,deathknight,frost,6,2,4
1736,Ghaloob,draenor,192,deathknight,frost,6,2,4
1737,Doubledead,the-maelstrom,192,deathknight,frost,6,2,4
1738,Abomination,emeriss,192,deathknight,frost,6,2,4
1739,Notstacy,dragonblight,192,deathknight,frost,6,2,4
1740,Dreadmind,blackrock,192,deathknight,frost,6,2,4
1741,Necrossis,stormscale,192,deathknight,frost,6,2,4
1742,Vaffe,tarren-mill,192,deathknight,frost,6,2,4
1743,Toffy,anetheron,192,deathknight,frost,6,2,4
1744,Darksoulk,frostmane,192,deathknight,frost,6,2,4
1745,Kane,destromath,192,deathknight,frost,6,2,4
1746,Royalcrown,stormscale,192,deathknight,frost,6,2,4
1747,Ваатерло,soulflayer,192,deathknight,frost,6,2,4
1748,Seasonfive,arathor,192,deathknight,frost,6,2,4
1749,Капустас,gordunni,192,deathknight,frost,6,2,4
1750,Deadlygnome,silvermoon,192,deathknight,frost,12,2,10
1751,Lillekas,outland,192,deathknight,frost,12,2,10
1752,Adreak,defias-brotherhood,192,deathknight,frost,12,2,10
1753,Narrua,die-aldor,192,deathknight,frost,12,2,10
1754,Dklékata,archimonde,192,deathknight,frost,12,2,10
1755,Бахлыщ,soulflayer,192,deathknight,frost,12,2,10
1756,Freeks,die-aldor,192,deathknight,frost,12,2,10
1757,Tüsa,exodar,192,deathknight,frost,18,2,16
1758,Moograine,anachronos,191,deathknight,frost,6,2,4
1759,Lithirion,ysondre,191,deathknight,frost,6,2,4
1760,Ренкус,grom,191,deathknight,frost,6,2,4
1761,Arthursq,stormscale,190,deathknight,frost,12,2,10
1762,Брейвз,gordunni,159,deathknight,frost,5,2,3
1763,Endlesspain,burning-legion,138,deathknight,frost,8,3,5
1764,Tzunâ,blackmoore,138,deathknight,frost,21,3,18
1765,Gigadk,ragnaros,96,deathknight,frost,6,1,5
1766,Dïkcite,archimonde,96,deathknight,frost,6,1,5
1767,Gotbaked,outland,96,deathknight,frost,6,1,5
1768,Pavkata,outland,96,deathknight,frost,6,1,5
1769,Rudysek,dunemaul,96,deathknight,frost,6,1,5
1770,Буризан,blackscar,96,deathknight,frost,6,1,5
1771,Thirtyfour,aegwynn,96,deathknight,frost,6,1,5
1772,Armanelo,stormscale,96,deathknight,frost,6,1,5
1773,Thryndiel,ravencrest,96,deathknight,frost,6,1,5
1774,Syncros,blackrock,96,deathknight,frost,6,1,5
1775,Hydross,archimonde,96,deathknight,frost,6,1,5
1776,Thínkk,ysondre,96,deathknight,frost,6,1,5
1777,Brurf,ysondre,96,deathknight,frost,6,1,5
1778,Reyu,ambossar,96,deathknight,frost,6,1,5
1779,Veçh,turalyon,96,deathknight,frost,6,1,5
1780,Dreodis,der-mithrilorden,96,deathknight,frost,6,1,5
1781,Cleverb,silvermoon,96,deathknight,frost,6,1,5
1782,Mizrael,burning-blade,96,deathknight,frost,6,1,5
1783,Jenkk,drakthul,96,deathknight,frost,6,1,5
1784,Urukaye,silvermoon,96,deathknight,frost,6,1,5
1785,Sokkara,silvermoon,96,deathknight,frost,6,1,5
1786,Thyrandre,khaz-modan,96,deathknight,frost,6,1,5
1787,Feddk,stormscale,96,deathknight,frost,6,1,5
1788,Umadßroh,sanguino,96,deathknight,frost,6,1,5
1789,Дкшрёдингера,gordunni,96,deathknight,frost,6,1,5
1790,Slimez,magtheridon,96,deathknight,frost,6,1,5
1791,Kaeyz,blackmoore,96,deathknight,frost,6,1,5
1792,Ischozâr,blackmoore,96,deathknight,frost,6,1,5
1793,Кунимэнгус,soulflayer,96,deathknight,frost,9,1,8
1794,Shaturi,antonidas,96,deathknight,frost,12,1,11
1795,Burebistà,eonar,96,deathknight,frost,12,1,11
1796,Nirna,argent-dawn,96,deathknight,frost,18,1,17
1797,Deadorcy,kazzak,95,deathknight,frost,3,2,1
1798,Infamousmobb,archimonde,79,deathknight,frost,5,1,4
1799,Assølid,arathor,42,deathknight,frost,11,2,9
1800,Greiz,aggramar,16,deathknight,frost,7,1,6
1801,Norgan,die-aldor,2339,demonhunter,havoc,153,85,68
1802,Íllìðåñgøðx,twisting-nether,2337,demonhunter,havoc,136,72,64
1803,Elswavé,kazzak,2290,demonhunter,havoc,156,91,65
1804,Glìmpsêgøðx,twisting-nether,2288,demonhunter,havoc,131,71,60
1805,Itsdampbaby,kazzak,2211,demonhunter,havoc,115,62,53
1806,Guësswho,twisting-nether,2201,demonhunter,havoc,105,54,51
1807,Norgàn,die-aldor,2178,demonhunter,havoc,81,44,37
1808,Zslebaans,dun-modr,2173,demonhunter,havoc,266,134,132
1809,Ðesz,sanguino,2153,demonhunter,havoc,95,52,43
1810,Betterevoker,outland,2134,demonhunter,havoc,198,112,86
1811,Wibez,twisting-nether,2131,demonhunter,havoc,120,74,46
1812,Enysia,twisting-nether,2127,demonhunter,havoc,122,62,60
1813,Badtime,malganis,2126,demonhunter,havoc,218,117,101
1814,Zuklio,ysondre,2125,demonhunter,havoc,146,74,72
1815,Hellwynne,archimonde,2117,demonhunter,havoc,134,78,56
1816,Melan,sanguino,2116,demonhunter,havoc,108,54,54
1817,Évø,silvermoon,2114,demonhunter,havoc,107,54,53
1818,Лфгхиро,soulflayer,2101,demonhunter,havoc,65,37,28
1819,Razzagall,elune,2101,demonhunter,havoc,54,30,24
1820,Boostbydh,archimonde,2101,demonhunter,havoc,219,115,104
1821,Paschli,tarren-mill,2100,demonhunter,havoc,228,122,106
1822,Konydh,outland,2067,demonhunter,havoc,59,39,20
1823,Heatx,ysondre,2043,demonhunter,havoc,180,98,82
1824,Satånist,outland,2033,demonhunter,havoc,268,145,123
1825,Battlebruh,ghostlands,2032,demonhunter,havoc,83,39,44
1826,Demonalpha,stormscale,2018,demonhunter,havoc,61,34,27
1827,Nèvér,silvermoon,2014,demonhunter,havoc,143,74,69
1828,Bxdh,outland,2004,demonhunter,havoc,93,46,47
1829,Illíllìllî,twisting-nether,1998,demonhunter,havoc,60,33,27
1830,Smydi,blackmoore,1991,demonhunter,havoc,112,82,30
1831,Ææçëñ,ravencrest,1990,demonhunter,havoc,82,46,36
1832,Læsy,antonidas,1990,demonhunter,havoc,151,77,74
1833,Ewynadh,die-aldor,1990,demonhunter,havoc,84,42,42
1834,Veon,ravencrest,1988,demonhunter,havoc,281,136,145
1835,Истребитель,blackscar,1978,demonhunter,havoc,288,160,128
1836,Tórstenstøck,ravencrest,1975,demonhunter,havoc,65,46,19
1837,Aiean,ravencrest,1974,demonhunter,havoc,264,132,132
1838,Anabbele,kazzak,1968,demonhunter,havoc,96,52,44
1839,Gilletteabdi,argent-dawn,1966,demonhunter,havoc,115,58,57
1840,Ohseri,defias-brotherhood,1963,demonhunter,havoc,180,87,93
1841,Depure,blackrock,1955,demonhunter,havoc,96,45,51
1842,Мортрэд,gordunni,1950,demonhunter,havoc,66,39,27
1843,Pipeandy,kazzak,1946,demonhunter,havoc,95,52,43
1844,Майотх,gordunni,1943,demonhunter,havoc,211,109,102
1845,Yúki,blackrock,1939,demonhunter,havoc,66,32,34
1846,Scubaman,tarren-mill,1936,demonhunter,havoc,84,44,40
1847,Battlebruuh,ghostlands,1935,demonhunter,havoc,66,27,39
1848,Iryut,onyxia,1932,demonhunter,havoc,84,45,39
1849,Delanoss,blackmoore,1922,demonhunter,havoc,133,72,61
1850,Майвэйх,soulflayer,1922,demonhunter,havoc,124,62,62
1851,Cydh,auchindoun,1917,demonhunter,havoc,90,45,45
1852,Wibergdh,kazzak,1915,demonhunter,havoc,54,30,24
1853,Damatche,outland,1910,demonhunter,havoc,136,68,68
1854,Brawndow,draenor,1908,demonhunter,havoc,164,83,81
1855,Carritoscrm,outland,1906,demonhunter,havoc,36,20,16
1856,Dripcatchér,ravencrest,1904,demonhunter,havoc,48,29,19
1857,Gíftig,ravencrest,1900,demonhunter,havoc,95,50,45
1858,Avye,tichondrius,1892,demonhunter,havoc,66,34,32
1859,Rvnx,archimonde,1890,demonhunter,havoc,281,154,127
1860,Yarrøck,silvermoon,1890,demonhunter,havoc,84,46,38
1861,Хэллшок,eversong,1890,demonhunter,havoc,96,49,47
1862,Моигваза,soulflayer,1890,demonhunter,havoc,59,30,29
1863,Ïfï,archimonde,1887,demonhunter,havoc,171,90,81
1864,Perojeina,draenor,1885,demonhunter,havoc,41,22,19
1865,Skywålker,stormscale,1882,demonhunter,havoc,81,41,40
1866,Schrewneil,twisting-nether,1882,demonhunter,havoc,72,30,42
1867,Ïîï,archimonde,1880,demonhunter,havoc,85,38,47
1868,Nøbodyx,tarren-mill,1879,demonhunter,havoc,72,36,36
1869,Walkmyshoes,twisting-nether,1877,demonhunter,havoc,102,51,51
1870,Boxssabanned,archimonde,1875,demonhunter,havoc,137,67,70
1871,Elipireli,doomhammer,1874,demonhunter,havoc,54,27,27
1872,Mazöku,ravencrest,1873,demonhunter,havoc,86,51,35
1873,Lassudan,stormreaver,1873,demonhunter,havoc,53,28,25
1874,Donkeydh,tarren-mill,1868,demonhunter,havoc,54,36,18
1875,Anerana,malganis,1868,demonhunter,havoc,102,48,54
1876,Oldforwow,outland,1865,demonhunter,havoc,174,91,83
1877,Зарах,gordunni,1862,demonhunter,havoc,54,33,21
1878,Pulsefuzzy,burning-legion,1861,demonhunter,havoc,59,34,25
1879,Jincksdh,kazzak,1861,demonhunter,havoc,61,29,32
1880,Brolafsen,ravencrest,1859,demonhunter,havoc,66,32,34
1881,Cuddlypeanut,argent-dawn,1859,demonhunter,havoc,207,96,111
1882,Apfelbaum,die-aldor,1857,demonhunter,havoc,60,40,20
1883,Carboen,tarren-mill,1856,demonhunter,havoc,96,52,44
1884,Kebabidin,kazzak,1856,demonhunter,havoc,66,30,36
1885,Itadora,antonidas,1854,demonhunter,havoc,77,40,37
1886,Mädchen,blackhand,1854,demonhunter,havoc,48,23,25
1887,Wàýztøpgx,ravencrest,1854,demonhunter,havoc,65,27,38
1888,Демонблэйдс,gordunni,1853,demonhunter,havoc,66,36,30
1889,Dasein,tarren-mill,1852,demonhunter,havoc,54,29,25
1890,Natosyywaor,dun-modr,1850,demonhunter,havoc,41,21,20
1891,Notlars,chamber-of-aspects,1847,demonhunter,havoc,65,37,28
1892,Mips,ghostlands,1847,demonhunter,havoc,60,30,30
1893,Аркантт,soulflayer,1847,demonhunter,havoc,183,88,95
1894,Flyingwhale,terokkar,1846,demonhunter,havoc,75,43,32
1895,Çøððøøððøøðð,blackmoore,1846,demonhunter,havoc,222,113,109
1896,Grimjow,arthas,1843,demonhunter,havoc,73,34,39
1897,Клопобойка,gordunni,1842,demonhunter,havoc,69,37,32
1898,Bloodwatcher,twisting-nether,1842,demonhunter,havoc,54,27,27
1899,Neunelfturbo,ravencrest,1839,demonhunter,havoc,48,32,16
1900,Çrymemøre,dun-modr,1839,demonhunter,havoc,120,63,57
1901,Rxor,eredar,1838,demonhunter,havoc,120,66,54
1902,Màuul,ravencrest,1838,demonhunter,havoc,201,99,102
1903,Fotmdehatwo,blackrock,1837,demonhunter,havoc,61,32,29
1904,Ilovelilith,zuljin,1837,demonhunter,havoc,129,67,62
1905,Xarôth,eredar,1837,demonhunter,havoc,66,32,34
1906,Скинр,soulflayer,1836,demonhunter,havoc,78,47,31
1907,Smoothbraiin,ravencrest,1836,demonhunter,havoc,137,76,61
1908,Illislan,darksorrow,1836,demonhunter,havoc,251,126,125
1909,Whøo,stormscale,1835,demonhunter,havoc,26,24,2
1910,Minifranger,archimonde,1835,demonhunter,havoc,87,47,40
1911,Ðoksy,archimonde,1835,demonhunter,havoc,60,31,29
1912,Zkrdh,kazzak,1835,demonhunter,havoc,65,33,32
1913,Mavorz,blackhand,1834,demonhunter,havoc,42,25,17
1914,Нэйтиси,soulflayer,1834,demonhunter,havoc,68,36,32
1915,Mittÿ,tarren-mill,1833,demonhunter,havoc,77,36,41
1916,Evilidan,hyjal,1833,demonhunter,havoc,48,22,26
1917,Dânÿ,elune,1831,demonhunter,havoc,66,35,31
1918,Zeroques,frostmane,1831,demonhunter,havoc,66,33,33
1919,Сасун,galakrond,1831,demonhunter,havoc,69,32,37
1920,Supay,rexxar,1830,demonhunter,havoc,58,31,27
1921,Shattre,silvermoon,1830,demonhunter,havoc,41,20,21
1922,Mür,nordrassil,1830,demonhunter,havoc,59,26,33
1923,Charteryo,eredar,1829,demonhunter,havoc,60,35,25
1924,Bogren,sylvanas,1829,demonhunter,havoc,48,25,23
1925,Sofun,stormscale,1829,demonhunter,havoc,228,110,118
1926,Yamehd,stormreaver,1827,demonhunter,havoc,42,26,16
1927,Pogdh,silvermoon,1827,demonhunter,havoc,81,46,35
1928,Sayph,hyjal,1826,demonhunter,havoc,54,30,24
1929,Chxpo,twisting-nether,1826,demonhunter,havoc,89,47,42
1930,Leýara,blackmoore,1825,demonhunter,havoc,56,35,21
1931,Camtoe,ravencrest,1825,demonhunter,havoc,216,121,95
1932,Сибу,soulflayer,1825,demonhunter,havoc,48,21,27
1933,Imslapping,draenor,1824,demonhunter,havoc,96,57,39
1934,Mürh,nordrassil,1824,demonhunter,havoc,54,25,29
1935,Дантеллиан,gordunni,1823,demonhunter,havoc,135,77,58
1936,Cuirnoir,ravencrest,1823,demonhunter,havoc,54,30,24
1937,Malignantx,ragnaros,1823,demonhunter,havoc,56,31,25
1938,Barneeéy,tarren-mill,1823,demonhunter,havoc,113,62,51
1939,Bojestvena,twisting-nether,1823,demonhunter,havoc,180,89,91
1940,Dizbi,argent-dawn,1822,demonhunter,havoc,63,43,20
1941,Zireáel,stormscale,1822,demonhunter,havoc,56,33,23
1942,Hopéless,aggra-português,1821,demonhunter,havoc,42,23,19
1943,Khétí,tarren-mill,1821,demonhunter,havoc,101,53,48
1944,Uldren,defias-brotherhood,1821,demonhunter,havoc,200,102,98
1945,Элизар,howling-fjord,1821,demonhunter,havoc,120,61,59
1946,Dadøw,dun-modr,1820,demonhunter,havoc,72,34,38
1947,Onof,hyjal,1820,demonhunter,havoc,96,43,53
1948,Empúsa,stormscale,1819,demonhunter,havoc,72,39,33
1949,Razex,kazzak,1819,demonhunter,havoc,111,59,52
1950,Stickidan,malganis,1819,demonhunter,havoc,72,36,36
1951,Krm,dun-modr,1818,demonhunter,havoc,38,23,15
1952,Amnésysx,ysondre,1818,demonhunter,havoc,72,35,37
1953,Luwayne,blackmoore,1818,demonhunter,havoc,47,21,26
1954,Dreamslash,tarren-mill,1817,demonhunter,havoc,52,29,23
1955,Zhadrom,ragnaros,1817,demonhunter,havoc,72,31,41
1956,Perna,ghostlands,1814,demonhunter,havoc,74,34,40
1957,Faufilé,garona,1813,demonhunter,havoc,163,85,78
1958,Unseenshadow,ragnaros,1813,demonhunter,havoc,60,25,35
1959,Írony,draenor,1812,demonhunter,havoc,50,25,25
1960,Yukiz,ravencrest,1812,demonhunter,havoc,48,24,24
1961,Найтшифт,blackscar,1811,demonhunter,havoc,46,29,17
1962,Vexanic,chamber-of-aspects,1811,demonhunter,havoc,93,49,44
1963,Eyasluna,twisting-nether,1811,demonhunter,havoc,66,30,36
1964,Djratatouill,kazzak,1810,demonhunter,havoc,42,27,15
1965,Хменчик,soulflayer,1809,demonhunter,havoc,97,47,50
1966,Mandariâ,blackmoore,1808,demonhunter,havoc,60,32,28
1967,Jumpmeister,ragnaros,1806,demonhunter,havoc,42,25,17
1968,Rabæ,blackhand,1806,demonhunter,havoc,102,54,48
1969,Gøat,nemesis,1804,demonhunter,havoc,96,55,41
1970,Турбосвинья,gordunni,1804,demonhunter,havoc,210,115,95
1971,Jawohunt,rexxar,1803,demonhunter,havoc,108,49,59
1972,Stràt,ysondre,1803,demonhunter,havoc,72,31,41
1973,Shtahuntna,tarren-mill,1802,demonhunter,havoc,210,124,86
1974,Мэйзиквин,howling-fjord,1802,demonhunter,havoc,123,66,57
1975,Phesxdh,sylvanas,1801,demonhunter,havoc,122,77,45
1976,Kindablind,aggramar,1801,demonhunter,havoc,95,46,49
1977,Barbarinjo,silvermoon,1800,demonhunter,havoc,36,22,14
1978,Jimfromsales,argent-dawn,1800,demonhunter,havoc,36,19,17
1979,Kardyö,archimonde,1800,demonhunter,havoc,108,50,58
1980,Jco,kazzak,1800,demonhunter,havoc,50,23,27
1981,Миелион,gordunni,1800,demonhunter,havoc,65,29,36
1982,Badtimes,malganis,1799,demonhunter,havoc,243,120,123
1983,Icekissl,hyjal,1797,demonhunter,havoc,40,20,20
1984,Mongoose,drakthul,1796,demonhunter,havoc,154,78,76
1985,Камуи,gordunni,1796,demonhunter,havoc,90,45,45
1986,Finwe,outland,1795,demonhunter,havoc,51,31,20
1987,Дэн,blackscar,1792,demonhunter,havoc,72,37,35
1988,Гвинович,blackscar,1792,demonhunter,havoc,130,66,64
1989,Fiveyearques,sylvanas,1792,demonhunter,havoc,111,51,60
1990,Dpsspec,draenor,1792,demonhunter,havoc,60,27,33
1991,Hunee,kazzak,1790,demonhunter,havoc,69,43,26
1992,Funkiller,stormscale,1790,demonhunter,havoc,64,34,30
1993,Mazeeken,kazzak,1790,demonhunter,havoc,75,38,37
1994,Zedxx,kazzak,1787,demonhunter,havoc,105,54,51
1995,Kostiq,kazzak,1787,demonhunter,havoc,59,30,29
1996,Ted,frostwolf,1785,demonhunter,havoc,66,31,35
1997,Amatèrasú,kazzak,1784,demonhunter,havoc,58,29,29
1998,Найтбладия,gordunni,1783,demonhunter,havoc,66,38,28
1999,Anubias,ravencrest,1777,demonhunter,havoc,72,34,38
2000,Temac,magtheridon,1776,demonhunter,havoc,60,32,28
2001,Врежимеэтти,soulflayer,1776,demonhunter,havoc,70,37,33
2002,Gnarpump,emeriss,1776,demonhunter,havoc,42,21,21
2003,Cláw,ravencrest,1774,demonhunter,havoc,102,50,52
2004,Demonmatheo,stormscale,1771,demonhunter,havoc,54,31,23
2005,Автокикер,soulflayer,1771,demonhunter,havoc,60,34,26
2006,Possomhd,kazzak,1767,demonhunter,havoc,149,84,65
2007,Daemonax,ragnaros,1767,demonhunter,havoc,60,29,31
2008,Exoqt,blackhand,1766,demonhunter,havoc,66,34,32
2009,Edh,dalaran,1765,demonhunter,havoc,101,54,47
2010,Сосочков,soulflayer,1763,demonhunter,havoc,193,100,93
2011,Ðemøñsåy,blackrock,1763,demonhunter,havoc,174,87,87
2012,Бабкамопед,howling-fjord,1760,demonhunter,havoc,45,26,19
2013,Lelaniae,blackhand,1759,demonhunter,havoc,48,20,28
2014,Rïmðh,haomarush,1758,demonhunter,havoc,41,22,19
2015,Nørðìç,nordrassil,1756,demonhunter,havoc,36,21,15
2016,Haldin,kazzak,1755,demonhunter,havoc,83,44,39
2017,Wyna,aggra-português,1755,demonhunter,havoc,160,80,80
2018,Bokajr,ragnaros,1754,demonhunter,havoc,48,28,20
2019,Shanaplow,hyjal,1754,demonhunter,havoc,72,33,39
2020,Mønkeyx,kazzak,1753,demonhunter,havoc,38,25,13
2021,Airelidari,tyrande,1753,demonhunter,havoc,203,101,102
2022,Dhgoddess,kazzak,1752,demonhunter,havoc,42,21,21
2023,Eurobeat,dun-modr,1751,demonhunter,havoc,120,67,53
2024,Primolover,outland,1751,demonhunter,havoc,66,33,33
2025,Eréthrus,ravencrest,1751,demonhunter,havoc,61,28,33
2026,Calloww,kazzak,1750,demonhunter,havoc,37,19,18
2027,Sailen,blackmoore,1748,demonhunter,havoc,59,28,31
2028,Felom,garona,1746,demonhunter,havoc,78,43,35
2029,Ehrin,lightbringer,1746,demonhunter,havoc,100,49,51
2030,Xotourlife,stormscale,1744,demonhunter,havoc,36,22,14
2031,Batik,blackmoore,1744,demonhunter,havoc,178,88,90
2032,Lagseven,ravencrest,1744,demonhunter,havoc,63,31,32
2033,Merelini,twisting-nether,1743,demonhunter,havoc,40,22,18
2034,Billyhassan,kazzak,1742,demonhunter,havoc,48,31,17
2035,Brunhity,twisting-nether,1739,demonhunter,havoc,47,21,26
2036,Mojothejojo,ravencrest,1738,demonhunter,havoc,79,42,37
2037,Zerinitý,outland,1737,demonhunter,havoc,54,29,25
2038,Viced,kazzak,1737,demonhunter,havoc,54,24,30
2039,Jeannedäsh,archimonde,1736,demonhunter,havoc,48,24,24
2040,Susanoø,eredar,1735,demonhunter,havoc,213,116,97
2041,Фавлав,ashenvale,1734,demonhunter,havoc,56,29,27
2042,Belákor,twisting-nether,1734,demonhunter,havoc,235,120,115
2043,Shadyblady,nemesis,1731,demonhunter,havoc,142,72,70
2044,Йактон,soulflayer,1731,demonhunter,havoc,42,20,22
2045,Xenits,kazzak,1730,demonhunter,havoc,75,38,37
2046,Ewlyna,stormscale,1730,demonhunter,havoc,48,22,26
2047,Elsynn,dalaran,1729,demonhunter,havoc,96,47,49
2048,Donipwnz,blackrock,1729,demonhunter,havoc,89,38,51
2049,Weez,kilrogg,1727,demonhunter,havoc,162,80,82
2050,Азместь,howling-fjord,1727,demonhunter,havoc,42,20,22
2051,Trashcarlitô,eredar,1726,demonhunter,havoc,56,30,26
2052,Badreal,sylvanas,1726,demonhunter,havoc,54,25,29
2053,Shadowjambo,twisting-nether,1725,demonhunter,havoc,81,45,36
2054,Alundil,ravencrest,1725,demonhunter,havoc,60,32,28
2055,Kinstak,sanguino,1725,demonhunter,havoc,54,27,27
2056,Balberith,twisting-nether,1724,demonhunter,havoc,87,47,40
2057,Luunz,argent-dawn,1724,demonhunter,havoc,119,58,61
2058,Çôæ,twisting-nether,1723,demonhunter,havoc,163,81,82
2059,Immørtaldh,tarren-mill,1723,demonhunter,havoc,48,23,25
2060,Nagatobimaru,tarren-mill,1721,demonhunter,havoc,48,26,22
2061,Felpsita,kazzak,1721,demonhunter,havoc,60,30,30
2062,Simshady,stormscale,1720,demonhunter,havoc,54,34,20
2063,Felski,outland,1720,demonhunter,havoc,61,29,32
2064,Enjøybrah,nemesis,1718,demonhunter,havoc,55,34,21
2065,Âspen,archimonde,1717,demonhunter,havoc,84,52,32
2066,Cheetòs,blackmoore,1717,demonhunter,havoc,57,33,24
2067,Periphere,eredar,1715,demonhunter,havoc,42,22,20
2068,Maevê,frostmourne,1712,demonhunter,havoc,37,19,18
2069,Культсмерти,howling-fjord,1712,demonhunter,havoc,78,31,47
2070,Kezumå,tarren-mill,1710,demonhunter,havoc,84,42,42
2071,Alythes,stormscale,1709,demonhunter,havoc,115,62,53
2072,Лизарин,gordunni,1708,demonhunter,havoc,101,46,55
2073,Bestro,tarren-mill,1706,demonhunter,havoc,62,31,31
2074,Zy,ahnqiraj,1705,demonhunter,havoc,35,20,15
2075,Jolyh,nemesis,1704,demonhunter,havoc,53,34,19
2076,Chàk,marécage-de-zangar,1704,demonhunter,havoc,126,54,72
2077,Neralith,ravencrest,1703,demonhunter,havoc,119,62,57
2078,Авилолз,gordunni,1702,demonhunter,havoc,48,25,23
2079,Enfy,twisting-nether,1701,demonhunter,havoc,71,35,36
2080,Dantert,zuljin,1699,demonhunter,havoc,36,21,15
2081,Киттигоплей,soulflayer,1699,demonhunter,havoc,90,46,44
2082,Tanjero,stormscale,1696,demonhunter,havoc,53,36,17
2083,Anzz,kazzak,1695,demonhunter,havoc,48,25,23
2084,Purpleturtle,blackrock,1695,demonhunter,havoc,48,25,23
2085,Máédhros,ravencrest,1695,demonhunter,havoc,46,21,25
2086,Yousaindh,blackrock,1694,demonhunter,havoc,66,29,37
2087,Malabala,grim-batol,1693,demonhunter,havoc,29,19,10
2088,Indral,argent-dawn,1693,demonhunter,havoc,77,43,34
2089,Márcin,burning-legion,1693,demonhunter,havoc,64,31,33
2090,Tyssra,argent-dawn,1692,demonhunter,havoc,335,161,174
2091,Yerla,burning-legion,1691,demonhunter,havoc,42,20,22
2092,Shabalda,dun-morogh,1690,demonhunter,havoc,58,29,29
2093,Mâdzylîa,archimonde,1688,demonhunter,havoc,41,19,22
2094,Dxæn,archimonde,1687,demonhunter,havoc,41,24,17
2095,Spheria,outland,1687,demonhunter,havoc,135,65,70
2096,Mêgumi,kirin-tor,1686,demonhunter,havoc,178,94,84
2097,Deehâ,eredar,1686,demonhunter,havoc,48,25,23
2098,Demobob,tarren-mill,1686,demonhunter,havoc,48,23,25
2099,Valarauk,ravencrest,1685,demonhunter,havoc,192,112,80
2100,Demonkata,twisting-nether,1684,demonhunter,havoc,80,46,34
2101,Slutkitten,ravencrest,1684,demonhunter,havoc,48,21,27
2102,Burchulica,sylvanas,1683,demonhunter,havoc,42,24,18
2103,Soizis,drakthul,1682,demonhunter,havoc,42,23,19
2104,Emurid,les-sentinelles,1682,demonhunter,havoc,54,26,28
2105,Míàkhãlîfâýð,stormscale,1682,demonhunter,havoc,62,26,36
2106,Инферналка,howling-fjord,1681,demonhunter,havoc,42,27,15
2107,Ячмо,gordunni,1681,demonhunter,havoc,29,18,11
2108,Demonichanta,azjolnerub,1681,demonhunter,havoc,196,101,95
2109,Aethinos,sylvanas,1678,demonhunter,havoc,42,27,15
2110,Asmonsmash,twisting-nether,1678,demonhunter,havoc,56,27,29
2111,Eyecandy,scarshield-legion,1677,demonhunter,havoc,67,34,33
2112,Депрессивдед,gordunni,1677,demonhunter,havoc,48,24,24
2113,Kïallz,hyjal,1676,demonhunter,havoc,337,175,162
2114,Ryänåir,ravencrest,1675,demonhunter,havoc,78,45,33
2115,Hcsgötze,dalaran,1674,demonhunter,havoc,64,39,25
2116,Ráiku,ravencrest,1674,demonhunter,havoc,48,22,26
2117,Шахдан,howling-fjord,1673,demonhunter,havoc,76,43,33
2118,Twopumpchump,twisting-nether,1673,demonhunter,havoc,98,48,50
2119,Demoncyka,twisting-nether,1673,demonhunter,havoc,60,22,38
2120,Hialdoo,sylvanas,1672,demonhunter,havoc,66,29,37
2121,Neverdance,ravencrest,1669,demonhunter,havoc,48,22,26
2122,Fruchtzwerg,tarren-mill,1667,demonhunter,havoc,60,33,27
2123,Smâshêd,stormscale,1666,demonhunter,havoc,75,43,32
2124,Bestboytoy,ravencrest,1666,demonhunter,havoc,41,22,19
2125,Wojtall,silvermoon,1666,demonhunter,havoc,236,122,114
2126,Âyro,ravencrest,1665,demonhunter,havoc,54,33,21
2127,Thingawoop,tarren-mill,1664,demonhunter,havoc,67,33,34
2128,Ranked,drakthul,1664,demonhunter,havoc,129,55,74
2129,Gwoodza,archimonde,1664,demonhunter,havoc,48,20,28
2130,Lasaka,stormscale,1663,demonhunter,havoc,99,61,38
2131,Brodor,alakir,1663,demonhunter,havoc,42,22,20
2132,Nyalah,eredar,1662,demonhunter,havoc,48,24,24
2133,Nepthýs,blackhand,1662,demonhunter,havoc,57,25,32
2134,Nillrogthedh,stormscale,1661,demonhunter,havoc,132,81,51
2135,Koiskdh,tarren-mill,1661,demonhunter,havoc,52,28,24
2136,Солфдх,fordragon,1661,demonhunter,havoc,42,19,23
2137,Nisirae,argent-dawn,1659,demonhunter,havoc,138,80,58
2138,Havocer,burning-legion,1659,demonhunter,havoc,78,44,34
2139,Lilydrop,varimathras,1659,demonhunter,havoc,51,20,31
2140,Kékw,stormscale,1658,demonhunter,havoc,123,74,49
2141,Уполномочен,howling-fjord,1658,demonhunter,havoc,42,23,19
2142,Barny,skullcrusher,1658,demonhunter,havoc,102,51,51
2143,Anayihh,dun-modr,1658,demonhunter,havoc,48,22,26
2144,Nøvillain,blackrock,1657,demonhunter,havoc,102,59,43
2145,Nyalaah,eredar,1657,demonhunter,havoc,42,23,19
2146,Кейтпрнстарс,howling-fjord,1657,demonhunter,havoc,100,53,47
2147,Ðêmønìnsìðê,blackmoore,1656,demonhunter,havoc,30,19,11
2148,Èfiie,culte-de-la-rive-noire,1656,demonhunter,havoc,53,24,29
2149,Солевыеглефы,gordunni,1655,demonhunter,havoc,30,22,8
2150,Tamtheone,silvermoon,1652,demonhunter,havoc,102,55,47
2151,Broglaive,sylvanas,1652,demonhunter,havoc,42,21,21
2152,Slaanaesh,kazzak,1652,demonhunter,havoc,68,27,41
2153,Oniramqt,aegwynn,1651,demonhunter,havoc,48,22,26
2154,Xalgalor,silvermoon,1650,demonhunter,havoc,48,29,19
2155,Ethína,kazzak,1649,demonhunter,havoc,48,23,25
2156,Speedførce,antonidas,1647,demonhunter,havoc,126,59,67
2157,Gigasloth,outland,1646,demonhunter,havoc,30,23,7
2158,Амбату,howling-fjord,1646,demonhunter,havoc,56,38,18
2159,Lhya,tarren-mill,1645,demonhunter,havoc,60,32,28
2160,Lilfly,twisting-nether,1645,demonhunter,havoc,36,19,17
2161,Aofaye,aegwynn,1645,demonhunter,havoc,77,29,48
2162,Ekaõs,les-sentinelles,1644,demonhunter,havoc,53,28,25
2163,Rylqt,blackmoore,1644,demonhunter,havoc,67,33,34
2164,Benihimee,twisting-nether,1644,demonhunter,havoc,72,35,37
2165,Kâsúxôxô,ravencrest,1643,demonhunter,havoc,34,19,15
2166,Broilerx,balnazzar,1643,demonhunter,havoc,48,22,26
2167,Killia,lothar,1642,demonhunter,havoc,42,24,18
2168,Azaleia,archimonde,1642,demonhunter,havoc,142,74,68
2169,Felen,zuljin,1642,demonhunter,havoc,136,64,72
2170,Davidastt,drakthul,1641,demonhunter,havoc,65,30,35
2171,Razrsolo,tarren-mill,1640,demonhunter,havoc,53,30,23
2172,Loucee,blackhand,1639,demonhunter,havoc,90,47,43
2173,Ðârksìðê,stormscale,1638,demonhunter,havoc,30,20,10
2174,Bizl,arygos,1638,demonhunter,havoc,30,19,11
2175,Ðisgraze,argent-dawn,1637,demonhunter,havoc,156,82,74
2176,Zayláh,ravencrest,1637,demonhunter,havoc,93,46,47
2177,Picpouc,archimonde,1637,demonhunter,havoc,54,24,30
2178,Prepared,kaelthas,1637,demonhunter,havoc,45,20,25
2179,Rezer,stormscale,1637,demonhunter,havoc,66,29,37
2180,Destinado,aggra-português,1636,demonhunter,havoc,48,28,20
2181,Róxor,twisting-nether,1636,demonhunter,havoc,48,21,27
2182,Batx,ravencrest,1636,demonhunter,havoc,48,20,28
2183,Øctågøñ,blackrock,1635,demonhunter,havoc,98,50,48
2184,ßerdína,tarren-mill,1635,demonhunter,havoc,81,41,40
2185,Xekaul,tarren-mill,1635,demonhunter,havoc,258,124,134
2186,Riptos,blackhand,1635,demonhunter,havoc,46,22,24
2187,Azraethx,ravencrest,1633,demonhunter,havoc,60,35,25
2188,Djdeathsweep,blackrock,1633,demonhunter,havoc,36,19,17
2189,Смутсайбот,howling-fjord,1633,demonhunter,havoc,48,22,26
2190,Lanadelbae,teldrassil,1631,demonhunter,havoc,115,58,57
2191,Azmodían,silvermoon,1631,demonhunter,havoc,59,28,31
2192,Blæm,archimonde,1630,demonhunter,havoc,48,25,23
2193,Velysaría,guldan,1630,demonhunter,havoc,97,50,47
2194,Fullsënd,ragnaros,1630,demonhunter,havoc,146,71,75
2195,Shadoss,ravencrest,1629,demonhunter,havoc,78,41,37
2196,Molntuss,ravencrest,1629,demonhunter,havoc,80,36,44
2197,Великаямыша,blackscar,1628,demonhunter,havoc,56,33,23
2198,Reckqt,eredar,1628,demonhunter,havoc,30,17,13
2199,Mentalìst,blackmoore,1628,demonhunter,havoc,93,50,43
2200,Юзлескласс,gordunni,1627,demonhunter,havoc,36,20,16
2201,Felbannedguy,twisting-nether,1627,demonhunter,havoc,42,23,19
2202,Dinastye,archimonde,1627,demonhunter,havoc,168,90,78
2203,Tdh,sanguino,1627,demonhunter,havoc,36,19,17
2204,Оригамушка,gordunni,1627,demonhunter,havoc,48,23,25
2205,Крикадский,howling-fjord,1626,demonhunter,havoc,90,54,36
2206,Xetalar,burning-legion,1626,demonhunter,havoc,144,84,60
2207,Omegapump,ravencrest,1626,demonhunter,havoc,36,19,17
2208,Unkqt,dalaran,1625,demonhunter,havoc,36,20,16
2209,Jumboo,tarren-mill,1625,demonhunter,havoc,53,29,24
2210,Nolitara,exodar,1625,demonhunter,havoc,86,44,42
2211,Stazó,drakthul,1625,demonhunter,havoc,145,71,74
2212,Nuxzhell,tarren-mill,1625,demonhunter,havoc,246,119,127
2213,Sonreye,kazzak,1625,demonhunter,havoc,41,18,23
2214,Brainlessdmg,ragnaros,1624,demonhunter,havoc,24,17,7
2215,Lindzor,frostmane,1624,demonhunter,havoc,47,32,15
2216,Zahadius,silvermoon,1624,demonhunter,havoc,47,30,17
2217,Drmanaburn,ravencrest,1624,demonhunter,havoc,30,17,13
2218,Quazr,outland,1624,demonhunter,havoc,205,116,89
2219,Onecho,ragnaros,1623,demonhunter,havoc,30,18,12
2220,Despèradø,archimonde,1623,demonhunter,havoc,140,74,66
2221,Koomaliha,outland,1623,demonhunter,havoc,85,42,43
2222,Бельторо,soulflayer,1622,demonhunter,havoc,123,68,55
2223,Cptncucumber,blackmoore,1622,demonhunter,havoc,108,54,54
2224,Garoteromani,draenor,1621,demonhunter,havoc,96,57,39
2225,Kolísenn,drakthul,1621,demonhunter,havoc,58,31,27
2226,Ilidrax,hyjal,1621,demonhunter,havoc,48,23,25
2227,Calcïum,archimonde,1621,demonhunter,havoc,68,28,40
2228,Nowhereturun,stormscale,1619,demonhunter,havoc,36,20,16
2229,Dragontwist,sylvanas,1619,demonhunter,havoc,42,22,20
2230,Alcóhon,ravencrest,1619,demonhunter,havoc,41,21,20
2231,Ferihokurva,outland,1619,demonhunter,havoc,48,22,26
2232,Nerronaxd,silvermoon,1618,demonhunter,havoc,96,47,49
2233,Fazero,silvermoon,1618,demonhunter,havoc,84,40,44
2234,Пибзянка,howling-fjord,1616,demonhunter,havoc,36,20,16
2235,Ботология,gordunni,1616,demonhunter,havoc,78,37,41
2236,Aroxos,draenor,1616,demonhunter,havoc,64,29,35
2237,Maytherel,blackhand,1616,demonhunter,havoc,126,52,74
2238,Crappyftw,ravencrest,1615,demonhunter,havoc,370,193,177
2239,Xenca,ravencrest,1614,demonhunter,havoc,113,66,47
2240,Фэсс,soulflayer,1613,demonhunter,havoc,65,35,30
2241,Zakaji,blackmoore,1613,demonhunter,havoc,38,20,18
2242,Demonmancer,ravencrest,1613,demonhunter,havoc,258,133,125
2243,Felwinter,ravencrest,1613,demonhunter,havoc,168,80,88
2244,Chïbrøne,archimonde,1613,demonhunter,havoc,48,17,31
2245,Venatica,twisting-nether,1612,demonhunter,havoc,108,62,46
2246,Evil,uldum,1612,demonhunter,havoc,137,72,65
2247,Tachala,khaz-modan,1612,demonhunter,havoc,39,20,19
2248,Kéftëmé,ravencrest,1612,demonhunter,havoc,84,43,41
2249,Thedudex,dunemaul,1612,demonhunter,havoc,44,21,23
2250,Sekørm,ragnaros,1612,demonhunter,havoc,48,21,27
2251,Sepdy,draenor,1611,demonhunter,havoc,92,48,44
2252,Netherim,twisting-nether,1611,demonhunter,havoc,122,52,70
2253,Азелира,gordunni,1610,demonhunter,havoc,84,47,37
2254,Gündüzgezen,silvermoon,1610,demonhunter,havoc,59,30,29
2255,Дайкиаомине,soulflayer,1609,demonhunter,havoc,36,19,17
2256,Enthia,antonidas,1607,demonhunter,havoc,119,65,54
2257,Râindra,twisting-nether,1607,demonhunter,havoc,168,87,81
2258,Jórúnn,twisting-nether,1607,demonhunter,havoc,48,22,26
2259,Kayzel,argent-dawn,1606,demonhunter,havoc,183,93,90
2260,Майкелелекек,gordunni,1606,demonhunter,havoc,36,17,19
2261,Kins,dun-modr,1606,demonhunter,havoc,66,29,37
2262,Firebringer,silvermoon,1605,demonhunter,havoc,36,21,15
2263,Höllymedx,blackmoore,1605,demonhunter,havoc,30,17,13
2264,Ifeeldirty,draenor,1605,demonhunter,havoc,37,20,17
2265,ßerdíná,tarren-mill,1605,demonhunter,havoc,60,31,29
2266,Sturmovik,ravencrest,1604,demonhunter,havoc,30,19,11
2267,Èstefany,stormscale,1604,demonhunter,havoc,90,49,41
2268,Zevsa,ravencrest,1604,demonhunter,havoc,48,25,23
2269,Nixzon,thrall,1604,demonhunter,havoc,78,31,47
2270,Trashclass,draenor,1603,demonhunter,havoc,34,18,16
2271,Kekburagól,kazzak,1602,demonhunter,havoc,39,21,18
2272,Wintalker,nemesis,1602,demonhunter,havoc,60,31,29
2273,Krmâ,blackrock,1602,demonhunter,havoc,48,20,28
2274,Zoyle,blackrock,1602,demonhunter,havoc,54,22,32
2275,Alithy,kazzak,1600,demonhunter,havoc,132,79,53
2276,Ícéìnmývèins,stormscale,1600,demonhunter,havoc,45,20,25
2277,Кельдарк,soulflayer,1598,demonhunter,havoc,192,97,95
2278,Ignasei,archimonde,1598,demonhunter,havoc,69,31,38
2279,Cappaowx,ravencrest,1597,demonhunter,havoc,30,21,9
2280,Ðêmønìç,area-52,1597,demonhunter,havoc,42,25,17
2281,Рейз,howling-fjord,1597,demonhunter,havoc,138,67,71
2282,Illidarisi,auchindoun,1597,demonhunter,havoc,66,32,34
2283,Illidankxx,sylvanas,1596,demonhunter,havoc,61,36,25
2284,Antidevil,kazzak,1596,demonhunter,havoc,129,73,56
2285,Мэртольятти,soulflayer,1596,demonhunter,havoc,67,34,33
2286,Zamassu,kazzak,1596,demonhunter,havoc,42,21,21
2287,Glayvie,kazzak,1593,demonhunter,havoc,69,32,37
2288,Sebyk,doomhammer,1592,demonhunter,havoc,60,35,25
2289,Dominik,the-maelstrom,1592,demonhunter,havoc,132,75,57
2290,Турботашш,soulflayer,1592,demonhunter,havoc,35,17,18
2291,Bhairav,silvermoon,1591,demonhunter,havoc,36,21,15
2292,Gonextbg,tarren-mill,1590,demonhunter,havoc,120,66,54
2293,Shaihulud,sanguino,1590,demonhunter,havoc,217,115,102
2294,Akkita,ravencrest,1590,demonhunter,havoc,120,63,57
2295,Alareey,antonidas,1590,demonhunter,havoc,141,68,73
2296,Boozlike,tarren-mill,1588,demonhunter,havoc,78,42,36
2297,Lghdtv,ravencrest,1587,demonhunter,havoc,78,40,38
2298,Coolpizzaguy,twisting-nether,1587,demonhunter,havoc,42,19,23
2299,Schejtan,blackmoore,1586,demonhunter,havoc,48,30,18
2300,Släshes,kazzak,1584,demonhunter,havoc,46,21,25
2301,Pibzya,ravencrest,1583,demonhunter,havoc,45,22,23
2302,Kividari,dun-modr,1583,demonhunter,havoc,44,21,23
2303,Трукейт,gordunni,1582,demonhunter,havoc,56,33,23
2304,Junkai,echsenkessel,1581,demonhunter,havoc,54,30,24
2305,Guáca,draenor,1579,demonhunter,havoc,51,26,25
2306,Ydrael,terokkar,1578,demonhunter,havoc,54,29,25
2307,Gïzmó,tarren-mill,1578,demonhunter,havoc,60,30,30
2308,Мишаметапамп,grom,1578,demonhunter,havoc,38,19,19
2309,Ryuwar,dun-modr,1577,demonhunter,havoc,83,44,39
2310,Геммула,howling-fjord,1575,demonhunter,havoc,144,70,74
2311,Shylaría,blackhand,1573,demonhunter,havoc,42,20,22
2312,Muyoni,eredar,1573,demonhunter,havoc,42,18,24
2313,Хингарский,deathguard,1571,demonhunter,havoc,44,25,19
2314,Urukguy,silvermoon,1569,demonhunter,havoc,30,20,10
2315,Ноубрейндыха,gordunni,1569,demonhunter,havoc,263,135,128
2316,Przemson,mazrigos,1568,demonhunter,havoc,71,35,36
2317,Драксх,gordunni,1566,demonhunter,havoc,54,26,28
2318,Dhqoo,blackrock,1565,demonhunter,havoc,42,18,24
2319,Exact,throkferoth,1564,demonhunter,havoc,71,38,33
2320,Solarae,silvermoon,1564,demonhunter,havoc,127,67,60
2321,Цезарий,gordunni,1563,demonhunter,havoc,162,83,79
2322,Winxclub,ravencrest,1562,demonhunter,havoc,95,54,41
2323,Crylater,twisting-nether,1561,demonhunter,havoc,30,20,10
2324,Phudi,tarren-mill,1561,demonhunter,havoc,139,71,68
2325,Jaquees,stormscale,1561,demonhunter,havoc,36,18,18
2326,Vorbis,twisting-nether,1561,demonhunter,havoc,108,53,55
2327,Akaria,blackrock,1559,demonhunter,havoc,82,53,29
2328,Onebuttonxd,ravencrest,1559,demonhunter,havoc,48,29,19
2329,Imsickleavme,draenor,1557,demonhunter,havoc,82,42,40
2330,Deathe,kilrogg,1556,demonhunter,havoc,54,24,30
2331,Синнэрлити,soulflayer,1555,demonhunter,havoc,42,18,24
2332,Shivarræ,stormreaver,1554,demonhunter,havoc,30,17,13
2333,Zintu,draenor,1554,demonhunter,havoc,108,53,55
2334,Thkingragnar,sanguino,1553,demonhunter,havoc,36,23,13
2335,Dhzor,twisting-nether,1552,demonhunter,havoc,64,32,32
2336,Shylea,ravencrest,1551,demonhunter,havoc,126,66,60
2337,Этмер,soulflayer,1550,demonhunter,havoc,48,27,21
2338,Fellespont,hellscream,1550,demonhunter,havoc,87,39,48
2339,Demøniac,ravencrest,1549,demonhunter,havoc,90,51,39
2340,Самадиэль,soulflayer,1549,demonhunter,havoc,59,30,29
2341,Safedaddy,silvermoon,1548,demonhunter,havoc,33,18,15
2342,Terrminator,darksorrow,1547,demonhunter,havoc,29,19,10
2343,Ashcan,tarren-mill,1547,demonhunter,havoc,70,37,33
2344,Гивюрхартми,gordunni,1547,demonhunter,havoc,42,17,25
2345,Däshgødx,stormscale,1543,demonhunter,havoc,54,31,23
2346,Usaïnbolts,archimonde,1543,demonhunter,havoc,36,17,19
2347,Telarris,twisting-nether,1542,demonhunter,havoc,195,110,85
2348,Snibsxdh,silvermoon,1542,demonhunter,havoc,42,19,23
2349,Testôdh,blackrock,1542,demonhunter,havoc,48,17,31
2350,Kïng,frostmane,1541,demonhunter,havoc,30,20,10
2351,Бананчикус,gordunni,1541,demonhunter,havoc,54,23,31
2352,Khray,archimonde,1540,demonhunter,havoc,36,18,18
2353,Чанпэн,soulflayer,1539,demonhunter,havoc,128,68,60
2354,Шэдоуштормх,soulflayer,1538,demonhunter,havoc,78,48,30
2355,Duffin,doomhammer,1538,demonhunter,havoc,138,69,69
2356,Thorno,argent-dawn,1538,demonhunter,havoc,48,17,31
2357,Hallando,draenor,1537,demonhunter,havoc,232,122,110
2358,Opmuch,eonar,1537,demonhunter,havoc,58,29,29
2359,Omegasyx,dun-modr,1537,demonhunter,havoc,40,19,21
2360,Roaf,twisting-nether,1536,demonhunter,havoc,99,48,51
2361,Flys,doomhammer,1534,demonhunter,havoc,32,19,13
2362,Méruème,hyjal,1534,demonhunter,havoc,43,22,21
2363,Ambudh,kazzak,1533,demonhunter,havoc,30,16,14
2364,Глефавочко,gordunni,1533,demonhunter,havoc,36,16,20
2365,Bichmicher,earthen-ring,1533,demonhunter,havoc,54,19,35
2366,Thorair,ravenholdt,1532,demonhunter,havoc,72,33,39
2367,Nuitrayer,hyjal,1531,demonhunter,havoc,56,37,19
2368,Felthunder,twisting-nether,1530,demonhunter,havoc,30,16,14
2369,Padalecki,blackmoore,1530,demonhunter,havoc,30,16,14
2370,Цэрри,soulflayer,1525,demonhunter,havoc,66,34,32
2371,Ruíko,dun-morogh,1525,demonhunter,havoc,72,37,35
2372,Geauxinue,archimonde,1525,demonhunter,havoc,36,16,20
2373,Крикетчсв,soulflayer,1524,demonhunter,havoc,42,23,19
2374,Glímpse,ravencrest,1524,demonhunter,havoc,66,32,34
2375,Геннитиро,deathguard,1523,demonhunter,havoc,34,20,14
2376,Snitchezz,blackmoore,1523,demonhunter,havoc,102,55,47
2377,Yeedhlol,blackmoore,1523,demonhunter,havoc,30,16,14
2378,Вскрыша,soulflayer,1522,demonhunter,havoc,30,16,14
2379,Shyuk,sanguino,1521,demonhunter,havoc,24,16,8
2380,Szexypopsi,ragnaros,1521,demonhunter,havoc,65,35,30
2381,Shiefwiggum,aegwynn,1521,demonhunter,havoc,42,22,20
2382,Гневлуны,lich-king,1521,demonhunter,havoc,66,31,35
2383,Ashiharademo,twilights-hammer,1520,demonhunter,havoc,78,42,36
2384,Ranzerg,tarren-mill,1519,demonhunter,havoc,24,17,7
2385,Drphillidan,tarren-mill,1518,demonhunter,havoc,38,17,21
2386,Doomcake,emeriss,1516,demonhunter,havoc,30,17,13
2387,Jesana,argent-dawn,1515,demonhunter,havoc,126,67,59
2388,Azzïnoth,sargeras,1515,demonhunter,havoc,36,17,19
2389,Mephîsto,sylvanas,1514,demonhunter,havoc,78,41,37
2390,Мужичок,soulflayer,1514,demonhunter,havoc,131,68,63
2391,Sokal,dun-modr,1514,demonhunter,havoc,62,30,32
2392,Эльгастон,howling-fjord,1514,demonhunter,havoc,54,26,28
2393,Аитерия,gordunni,1513,demonhunter,havoc,24,18,6
2394,Vênedri,eredar,1511,demonhunter,havoc,45,26,19
2395,Cynmatic,kargath,1511,demonhunter,havoc,48,23,25
2396,Blacklidan,blackrock,1509,demonhunter,havoc,40,17,23
2397,Øhka,outland,1509,demonhunter,havoc,60,24,36
2398,Faytundh,kult-der-verdammten,1508,demonhunter,havoc,36,16,20
2399,Geashy,blackmoore,1507,demonhunter,havoc,52,31,21
2400,Nanana,doomhammer,1507,demonhunter,havoc,72,37,35
2401,Ceyye,blackrock,1507,demonhunter,havoc,54,26,28
2402,Mâlefiz,blackmoore,1507,demonhunter,havoc,48,22,26
2403,Pinkberry,outland,1506,demonhunter,havoc,30,16,14
2404,Theaisbae,twisting-nether,1506,demonhunter,havoc,54,25,29
2405,Сложныйдх,howling-fjord,1505,demonhunter,havoc,48,29,19
2406,Talamacus,outland,1505,demonhunter,havoc,36,21,15
2407,Дрэгонборн,howling-fjord,1504,demonhunter,havoc,60,29,31
2408,Brawngodx,draenor,1503,demonhunter,havoc,25,17,8
2409,Штормдоттэр,howling-fjord,1503,demonhunter,havoc,36,19,17
2410,Sidekiq,silvermoon,1503,demonhunter,havoc,52,26,26
2411,Kanabiz,outland,1502,demonhunter,havoc,246,127,119
2412,Incanator,tarren-mill,1502,demonhunter,havoc,83,40,43
2413,Lòsâng,sanguino,1501,demonhunter,havoc,99,42,57
2414,Мужна,grom,1500,demonhunter,havoc,40,22,18
2415,Apokalypsra,blackmoore,1500,demonhunter,havoc,73,37,36
2416,Íllìðåñgøðx,antonidas,1500,demonhunter,havoc,118,57,61
2417,Bippsy,zuljin,1499,demonhunter,havoc,44,28,16
2418,Mikezilla,drakthul,1498,demonhunter,havoc,48,24,24
2419,Arnokia,kazzak,1498,demonhunter,havoc,114,56,58
2420,Insaneomg,blackmoore,1497,demonhunter,havoc,40,16,24
2421,Hauntedseoul,grim-batol,1496,demonhunter,havoc,90,54,36
2422,Sonnefel,tarren-mill,1495,demonhunter,havoc,65,32,33
2423,Gullveîg,archimonde,1494,demonhunter,havoc,42,25,17
2424,Persio,sanguino,1493,demonhunter,havoc,95,48,47
2425,Kalr,silvermoon,1492,demonhunter,havoc,35,22,13
2426,Aenirá,tarren-mill,1492,demonhunter,havoc,77,37,40
2427,Draxie,turalyon,1492,demonhunter,havoc,70,33,37
2428,Hornyhexy,stormscale,1489,demonhunter,havoc,72,35,37
2429,Échô,tarren-mill,1489,demonhunter,havoc,40,18,22
2430,Headlessdh,ragnaros,1488,demonhunter,havoc,42,23,19
2431,Métakagoule,ysondre,1488,demonhunter,havoc,87,43,44
2432,Kolrex,ragnaros,1488,demonhunter,havoc,59,29,30
2433,Läderjoel,ravencrest,1488,demonhunter,havoc,71,34,37
2434,Cantseêyou,blackmoore,1487,demonhunter,havoc,78,42,36
2435,Ziltush,archimonde,1487,demonhunter,havoc,137,69,68
2436,Sweetpety,tarren-mill,1486,demonhunter,havoc,105,53,52
2437,Împd,ravencrest,1485,demonhunter,havoc,96,47,49
2438,Zumei,stormreaver,1484,demonhunter,havoc,56,31,25
2439,Покахонта,soulflayer,1484,demonhunter,havoc,100,54,46
2440,Myztiko,hellscream,1484,demonhunter,havoc,170,87,83
2441,Dhsheesh,draenor,1484,demonhunter,havoc,42,21,21
2442,Эинхерия,soulflayer,1484,demonhunter,havoc,57,25,32
2443,Pvpabuser,ravencrest,1483,demonhunter,havoc,47,27,20
2444,Smoochygodx,antonidas,1483,demonhunter,havoc,96,54,42
2445,Onlytwokeys,dun-modr,1483,demonhunter,havoc,96,48,48
2446,Cumbayá,draenor,1482,demonhunter,havoc,30,17,13
2447,Oonn,outland,1482,demonhunter,havoc,45,21,24
2448,Monkeypox,twisting-nether,1481,demonhunter,havoc,94,47,47
2449,Misli,stormscale,1480,demonhunter,havoc,54,29,25
2450,Grimberg,tarren-mill,1480,demonhunter,havoc,108,57,51
2451,Emerelle,die-aldor,1479,demonhunter,havoc,126,60,66
2452,Кирсена,gordunni,1479,demonhunter,havoc,41,19,22
2453,Tenawees,blackmoore,1478,demonhunter,havoc,48,27,21
2454,Fumbiidhx,thrall,1478,demonhunter,havoc,48,25,23
2455,Oggidanbuu,tarren-mill,1478,demonhunter,havoc,49,22,27
2456,Olddemon,ravencrest,1477,demonhunter,havoc,59,40,19
2457,Æä,draenor,1477,demonhunter,havoc,54,26,28
2458,Lastactiondh,dun-morogh,1475,demonhunter,havoc,30,21,9
2459,Iphanaa,frostmane,1475,demonhunter,havoc,91,44,47
2460,Баттлрэп,soulflayer,1473,demonhunter,havoc,74,36,38
2461,Thehûnt,outland,1472,demonhunter,havoc,101,55,46
2462,Tylleröwittu,grim-batol,1471,demonhunter,havoc,30,16,14
2463,Parmesano,tyrande,1470,demonhunter,havoc,48,31,17
2464,Treehunter,ravencrest,1470,demonhunter,havoc,30,16,14
2465,Valkorion,chamber-of-aspects,1470,demonhunter,havoc,39,20,19
2466,Ардатйякши,borean-tundra,1470,demonhunter,havoc,98,39,59
2467,Zitx,ravencrest,1467,demonhunter,havoc,138,71,67
2468,Szopóvadász,ragnaros,1466,demonhunter,havoc,36,17,19
2469,Frevee,outland,1464,demonhunter,havoc,113,63,50
2470,Убийца,soulflayer,1463,demonhunter,havoc,53,29,24
2471,Рэгес,howling-fjord,1463,demonhunter,havoc,30,16,14
2472,Saisahan,archimonde,1462,demonhunter,havoc,41,23,18
2473,Kéøn,ravencrest,1462,demonhunter,havoc,30,16,14
2474,Baball,kazzak,1460,demonhunter,havoc,93,50,43
2475,Wirsing,azshara,1460,demonhunter,havoc,54,22,32
2476,Kvye,archimonde,1459,demonhunter,havoc,30,16,14
2477,Blîndmaster,ravencrest,1459,demonhunter,havoc,130,65,65
2478,Feluron,silvermoon,1457,demonhunter,havoc,30,24,6
2479,Syonis,archimonde,1457,demonhunter,havoc,25,17,8
2480,Actuallytrol,argent-dawn,1457,demonhunter,havoc,59,27,32
2481,Фумиан,soulflayer,1457,demonhunter,havoc,64,28,36
2482,Yugsiturath,drakthul,1456,demonhunter,havoc,66,33,33
2483,Vexblade,silvermoon,1454,demonhunter,havoc,78,48,30
2484,Toonsdh,kazzak,1453,demonhunter,havoc,79,46,33
2485,Шалдарон,howling-fjord,1453,demonhunter,havoc,34,18,16
2486,Trinchensdh,blackhand,1453,demonhunter,havoc,48,23,25
2487,Ayö,draenor,1452,demonhunter,havoc,121,66,55
2488,Morskivuk,draenor,1451,demonhunter,havoc,38,22,16
2489,Ülquiorrä,kazzak,1450,demonhunter,havoc,53,34,19
2490,Аянамирейко,blackscar,1450,demonhunter,havoc,60,36,24
2491,Dibo,blackmoore,1448,demonhunter,havoc,99,48,51
2492,Хорбелий,deathguard,1446,demonhunter,havoc,84,42,42
2493,Guccibaby,silvermoon,1445,demonhunter,havoc,72,33,39
2494,Knùbbz,ravencrest,1444,demonhunter,havoc,63,29,34
2495,Tursal,dun-morogh,1442,demonhunter,havoc,39,22,17
2496,Níghtwing,wildhammer,1441,demonhunter,havoc,47,25,22
2497,Дашажмимету,blackscar,1439,demonhunter,havoc,32,16,16
2498,Chotzbrocke,blackhand,1438,demonhunter,havoc,24,15,9
2499,Blizdliksk,outland,1437,demonhunter,havoc,42,22,20
2500,Onlyfangodx,antonidas,1436,demonhunter,havoc,30,15,15
2501,Sturmimon,arthas,1436,demonhunter,havoc,36,15,21
2502,Netrisha,ravencrest,1436,demonhunter,havoc,72,28,44
2503,Джастх,howling-fjord,1435,demonhunter,havoc,24,15,9
2504,Carablue,hyjal,1435,demonhunter,havoc,30,15,15
2505,Erzàuwu,silvermoon,1435,demonhunter,havoc,36,15,21
2506,Maskinegoðx,tarren-mill,1433,demonhunter,havoc,30,15,15
2507,Shõ,twisting-nether,1433,demonhunter,havoc,42,15,27
2508,Sabe,ravencrest,1432,demonhunter,havoc,29,20,9
2509,Ashrena,ysondre,1431,demonhunter,havoc,48,32,16
2510,Остроухйй,blackscar,1430,demonhunter,havoc,66,30,36
2511,Nvampire,draenor,1429,demonhunter,havoc,24,17,7
2512,Øbsessiøn,kazzak,1429,demonhunter,havoc,107,53,54
2513,Bhaz,tichondrius,1428,demonhunter,havoc,30,16,14
2514,Ûro,dun-modr,1428,demonhunter,havoc,42,15,27
2515,Ultîma,hyjal,1427,demonhunter,havoc,36,15,21
2516,Brisingamen,outland,1426,demonhunter,havoc,60,29,31
2517,Муими,soulflayer,1426,demonhunter,havoc,36,15,21
2518,Kîrîto,nethersturm,1426,demonhunter,havoc,47,16,31
2519,Afuwarrior,doomhammer,1425,demonhunter,havoc,57,31,26
2520,Древиал,gordunni,1424,demonhunter,havoc,50,27,23
2521,Deponiajkm,dun-modr,1424,demonhunter,havoc,30,15,15
2522,Malakbel,nemesis,1424,demonhunter,havoc,193,95,98
2523,Slaanesh,xavius,1423,demonhunter,havoc,23,16,7
2524,Baileeh,blackmoore,1423,demonhunter,havoc,30,19,11
2525,Adapterinput,auchindoun,1423,demonhunter,havoc,114,62,52
2526,Philona,die-aldor,1423,demonhunter,havoc,158,83,75
2527,Culywurly,silvermoon,1423,demonhunter,havoc,60,28,32
2528,Nyxxeria,drakthul,1423,demonhunter,havoc,39,16,23
2529,Тарапынька,gordunni,1422,demonhunter,havoc,128,72,56
2530,Obitum,burning-legion,1422,demonhunter,havoc,101,56,45
2531,Lawus,blackhand,1422,demonhunter,havoc,30,15,15
2532,Enhtailo,draenor,1421,demonhunter,havoc,24,15,9
2533,Azaeel,blackhand,1421,demonhunter,havoc,30,15,15
2534,Tayo,dun-modr,1421,demonhunter,havoc,71,35,36
2535,Cheethless,ragnaros,1420,demonhunter,havoc,54,29,25
2536,Келадор,soulflayer,1420,demonhunter,havoc,95,44,51
2537,Ibeem,dentarg,1419,demonhunter,havoc,57,37,20
2538,Иллиферрат,blackscar,1419,demonhunter,havoc,104,53,51
2539,Эллий,blackscar,1419,demonhunter,havoc,36,15,21
2540,Aphulucky,kazzak,1418,demonhunter,havoc,48,21,27
2541,Biü,tarren-mill,1418,demonhunter,havoc,42,16,26
2542,Ihløøx,minahonda,1416,demonhunter,havoc,60,30,30
2543,Jazhz,dalaran,1415,demonhunter,havoc,36,17,19
2544,Alury,blackrock,1414,demonhunter,havoc,78,41,37
2545,Felcaller,sylvanas,1414,demonhunter,havoc,65,34,31
2546,Sarrabulho,magtheridon,1414,demonhunter,havoc,48,25,23
2547,Demogen,sylvanas,1413,demonhunter,havoc,78,44,34
2548,Havocnslash,ragnaros,1411,demonhunter,havoc,42,23,19
2549,Illiada,spinebreaker,1411,demonhunter,havoc,30,15,15
2550,Itàchì,kazzak,1410,demonhunter,havoc,24,15,9
2551,Knmdemon,draenor,1407,demonhunter,havoc,30,15,15
2552,Luzifer,ambossar,1406,demonhunter,havoc,147,77,70
2553,Kanéki,sylvanas,1405,demonhunter,havoc,29,22,7
2554,Demonade,ravencrest,1404,demonhunter,havoc,42,21,21
2555,Choclatballs,stormscale,1404,demonhunter,havoc,125,59,66
2556,Saleny,blackrock,1404,demonhunter,havoc,36,15,21
2557,Garretos,senjin,1403,demonhunter,havoc,31,22,9
2558,Cayssaelle,argent-dawn,1403,demonhunter,havoc,30,15,15
2559,Кейсимег,soulflayer,1402,demonhunter,havoc,50,25,25
2560,Vaynahi,grim-batol,1401,demonhunter,havoc,72,36,36
2561,Albunico,draenor,1400,demonhunter,havoc,141,73,68
2562,Дикаяособа,howling-fjord,1400,demonhunter,havoc,63,32,31
2563,Mareen,pozzo-delleternità,1400,demonhunter,havoc,42,21,21
2564,Tapio,burning-legion,1400,demonhunter,havoc,42,16,26
2565,Деструкцыя,howling-fjord,1399,demonhunter,havoc,45,24,21
2566,Тириола,howling-fjord,1398,demonhunter,havoc,36,20,16
2567,Åelita,burning-legion,1398,demonhunter,havoc,34,17,17
2568,Экселия,howling-fjord,1397,demonhunter,havoc,60,32,28
2569,Razziyel,ragnaros,1396,demonhunter,havoc,41,21,20
2570,Дартарин,gordunni,1395,demonhunter,havoc,62,34,28
2571,Aååááååââåâå,arygos,1394,demonhunter,havoc,24,15,9
2572,Jedbrazander,ragnaros,1394,demonhunter,havoc,30,15,15
2573,Ämi,blackmoore,1394,demonhunter,havoc,112,55,57
2574,Immune,aegwynn,1394,demonhunter,havoc,36,17,19
2575,Бичерезх,soulflayer,1393,demonhunter,havoc,48,27,21
2576,Харольд,deepholm,1392,demonhunter,havoc,76,38,38
2577,Demonsqueezy,nemesis,1389,demonhunter,havoc,34,21,13
2578,Thugrøse,blackrock,1389,demonhunter,havoc,126,63,63
2579,Skyborn,tarren-mill,1386,demonhunter,havoc,27,16,11
2580,Коньх,goldrinn,1386,demonhunter,havoc,71,31,40
2581,Tyhaxx,ravencrest,1384,demonhunter,havoc,54,24,30
2582,Hatemrankone,outland,1383,demonhunter,havoc,51,23,28
2583,Toddsnuggles,thrall,1382,demonhunter,havoc,42,25,17
2584,Cptxo,tarren-mill,1382,demonhunter,havoc,35,16,19
2585,Äzräël,dun-modr,1382,demonhunter,havoc,54,22,32
2586,Darrkdemon,kazzak,1381,demonhunter,havoc,258,125,133
2587,Ziplar,tarren-mill,1379,demonhunter,havoc,60,30,30
2588,Imlegalblind,ragnaros,1378,demonhunter,havoc,85,37,48
2589,Keanujeeves,dentarg,1376,demonhunter,havoc,60,33,27
2590,Daemonai,neptulon,1376,demonhunter,havoc,66,35,31
2591,Дэйнни,blackscar,1374,demonhunter,havoc,48,21,27
2592,Adalya,stormrage,1373,demonhunter,havoc,82,35,47
2593,Даблкорк,soulflayer,1372,demonhunter,havoc,119,68,51
2594,Sayee,drakthul,1371,demonhunter,havoc,30,19,11
2595,Pówèr,ravencrest,1371,demonhunter,havoc,54,29,25
2596,Tkr,zuljin,1371,demonhunter,havoc,108,56,52
2597,Flaybalbooll,ragnaros,1371,demonhunter,havoc,191,97,94
2598,Anstict,kazzak,1371,demonhunter,havoc,48,22,26
2599,Bloodconte,darksorrow,1369,demonhunter,havoc,28,17,11
2600,Error,ravencrest,1369,demonhunter,havoc,34,16,18
2601,Súrinox,blackrock,1367,demonhunter,havoc,83,48,35
2602,Icelucard,argent-dawn,1367,demonhunter,havoc,75,38,37
2603,Seyran,silvermoon,1367,demonhunter,havoc,30,15,15
2604,Dbolmami,twisting-nether,1366,demonhunter,havoc,22,15,7
2605,Sakumi,azshara,1366,demonhunter,havoc,169,75,94
2606,Poutanaola,twisting-nether,1365,demonhunter,havoc,30,15,15
2607,Shirra,shadowsong,1364,demonhunter,havoc,32,15,17
2608,Ikari,neptulon,1363,demonhunter,havoc,47,28,19
2609,Алькирена,howling-fjord,1363,demonhunter,havoc,30,16,14
2610,Nezruslfive,dun-modr,1361,demonhunter,havoc,36,18,18
2611,Dyamo,sylvanas,1361,demonhunter,havoc,425,206,219
2612,Adraelia,archimonde,1360,demonhunter,havoc,51,29,22
2613,Флеркенкот,galakrond,1360,demonhunter,havoc,220,124,96
2614,Easywaay,kazzak,1358,demonhunter,havoc,79,40,39
2615,Stellarvore,nemesis,1358,demonhunter,havoc,90,39,51
2616,Wrakdh,archimonde,1355,demonhunter,havoc,56,34,22
2617,Coniras,dun-morogh,1355,demonhunter,havoc,36,15,21
2618,Byakugaan,drakthul,1353,demonhunter,havoc,48,29,19
2619,Impatìence,tarren-mill,1351,demonhunter,havoc,36,15,21
2620,Kamaz,twisting-nether,1350,demonhunter,havoc,45,22,23
2621,Агрочика,borean-tundra,1349,demonhunter,havoc,36,16,20
2622,Natazia,eredar,1345,demonhunter,havoc,84,45,39
2623,Thalamis,kazzak,1345,demonhunter,havoc,75,33,42
2624,Flowen,stormreaver,1343,demonhunter,havoc,54,25,29
2625,Ларэгар,azuregos,1343,demonhunter,havoc,70,28,42
2626,Moonbeàm,kazzak,1343,demonhunter,havoc,48,18,30
2627,Varedisa,kazzak,1342,demonhunter,havoc,59,27,32
2628,Illídana,azjolnerub,1340,demonhunter,havoc,62,32,30
2629,Itheos,kazzak,1339,demonhunter,havoc,178,88,90
2630,Rehagen,ysondre,1339,demonhunter,havoc,36,14,22
2631,Baddxd,ragnaros,1338,demonhunter,havoc,26,15,11
2632,Нейроуз,howling-fjord,1338,demonhunter,havoc,154,82,72
2633,Сильверган,soulflayer,1337,demonhunter,havoc,192,100,92
2634,Dhogge,emerald-dream,1337,demonhunter,havoc,36,14,22
2635,Miscóde,twisting-nether,1336,demonhunter,havoc,30,14,16
2636,Aryuna,frostwolf,1335,demonhunter,havoc,36,21,15
2637,Balsza,burning-legion,1335,demonhunter,havoc,54,26,28
2638,Kainenn,silvermoon,1335,demonhunter,havoc,60,26,34
2639,Hawoc,chamber-of-aspects,1334,demonhunter,havoc,42,26,16
2640,Sadzari,burning-legion,1333,demonhunter,havoc,24,14,10
2641,Freylis,burning-legion,1332,demonhunter,havoc,26,14,12
2642,Orochimaruu,kargath,1332,demonhunter,havoc,63,22,41
2643,Irenzy,twisting-nether,1331,demonhunter,havoc,30,14,16
2644,Beerseewälk,ragnaros,1331,demonhunter,havoc,76,34,42
2645,Notcrashy,eredar,1329,demonhunter,havoc,35,22,13
2646,Checakore,argent-dawn,1329,demonhunter,havoc,66,34,32
2647,Ðraudræm,ravencrest,1329,demonhunter,havoc,83,39,44
2648,Иланари,gordunni,1328,demonhunter,havoc,23,16,7
2649,Maryjane,nordrassil,1328,demonhunter,havoc,60,39,21
2650,Шмальнуть,gordunni,1327,demonhunter,havoc,57,25,32
2651,Kiirtach,dun-modr,1326,demonhunter,havoc,21,15,6
2652,Naïtipa,arathi,1326,demonhunter,havoc,36,14,22
2653,Adroenz,twisting-nether,1325,demonhunter,havoc,48,22,26
2654,Dirtydoggy,dun-modr,1324,demonhunter,havoc,30,14,16
2655,Егордемон,soulflayer,1323,demonhunter,havoc,46,25,21
2656,Iaml,ravencrest,1323,demonhunter,havoc,67,32,35
2657,Aedilles,ravencrest,1322,demonhunter,havoc,24,14,10
2658,Destructs,sylvanas,1321,demonhunter,havoc,67,33,34
2659,Kâtsulol,ysondre,1321,demonhunter,havoc,30,14,16
2660,Tharysan,sanguino,1320,demonhunter,havoc,48,31,17
2661,Séphrióth,frostwolf,1320,demonhunter,havoc,30,14,16
2662,Bohchín,zuljin,1319,demonhunter,havoc,24,14,10
2663,Demonpun,the-venture-co,1318,demonhunter,havoc,40,22,18
2664,Valendriel,archimonde,1318,demonhunter,havoc,54,29,25
2665,Ragnirok,deathwing,1318,demonhunter,havoc,138,66,72
2666,Felleaf,ragnaros,1318,demonhunter,havoc,58,24,34
2667,Watchmepoop,stormscale,1315,demonhunter,havoc,24,15,9
2668,Yäkku,drakthul,1315,demonhunter,havoc,66,26,40
2669,Seedor,archimonde,1314,demonhunter,havoc,68,32,36
2670,Yvrig,eredar,1313,demonhunter,havoc,24,14,10
2671,Бропинг,soulflayer,1313,demonhunter,havoc,123,66,57
2672,Obey,exodar,1312,demonhunter,havoc,47,22,25
2673,Délyria,blackhand,1311,demonhunter,havoc,54,32,22
2674,Jayhan,chamber-of-aspects,1311,demonhunter,havoc,68,37,31
2675,Bestdemon,tarren-mill,1311,demonhunter,havoc,39,20,19
2676,Demozzer,ravencrest,1310,demonhunter,havoc,61,34,27
2677,Ilyerias,twisting-nether,1310,demonhunter,havoc,78,32,46
2678,Мицлейн,gordunni,1309,demonhunter,havoc,57,21,36
2679,Ricmorphis,grim-batol,1309,demonhunter,havoc,41,14,27
2680,Sinninse,blackmoore,1308,demonhunter,havoc,30,18,12
2681,Zephyrê,blackrock,1308,demonhunter,havoc,96,47,49
2682,Slowcuzclick,stormscale,1307,demonhunter,havoc,85,44,41
2683,Luckertwo,tarren-mill,1307,demonhunter,havoc,109,55,54
2684,Дисофи,soulflayer,1307,demonhunter,havoc,64,29,35
2685,Thëos,argent-dawn,1305,demonhunter,havoc,91,46,45
2686,Breezzdh,twisting-nether,1305,demonhunter,havoc,29,14,15
2687,Lexim,khaz-modan,1303,demonhunter,havoc,66,36,30
2688,Каралас,soulflayer,1301,demonhunter,havoc,36,21,15
2689,Demonguard,draenor,1299,demonhunter,havoc,64,35,29
2690,Bläckdëvïl,uldum,1298,demonhunter,havoc,49,30,19
2691,Demonicrage,burning-legion,1297,demonhunter,havoc,26,15,11
2692,Bicskas,ragnaros,1296,demonhunter,havoc,45,19,26
2693,Muharaar,ravencrest,1295,demonhunter,havoc,22,15,7
2694,Ávto,stormscale,1294,demonhunter,havoc,59,37,22
2695,Сумърак,grom,1294,demonhunter,havoc,84,40,44
2696,Soca,ysondre,1294,demonhunter,havoc,66,29,37
2697,Demonk,nemesis,1290,demonhunter,havoc,75,40,35
2698,Coltender,drakthul,1290,demonhunter,havoc,73,34,39
2699,Chaosfist,blackrock,1288,demonhunter,havoc,48,21,27
2700,Féileacán,kazzak,1286,demonhunter,havoc,48,20,28
2701,Momochi,silvermoon,1285,demonhunter,havoc,24,14,10
2702,Wauway,ragnaros,1285,demonhunter,havoc,44,21,23
2703,Тонниданза,howling-fjord,1284,demonhunter,havoc,220,110,110
2704,Billidan,eredar,1282,demonhunter,havoc,54,25,29
2705,Ozeey,draenor,1280,demonhunter,havoc,29,14,15
2706,Symbul,blackrock,1279,demonhunter,havoc,42,19,23
2707,Cassitä,chogall,1278,demonhunter,havoc,48,24,24
2708,Полетела,gordunni,1278,demonhunter,havoc,30,15,15
2709,Antrixa,ravencrest,1278,demonhunter,havoc,29,14,15
2710,Khalestya,shendralar,1278,demonhunter,havoc,90,39,51
2711,Kaizzy,twisting-nether,1276,demonhunter,havoc,119,62,57
2712,Juha,bronze-dragonflight,1274,demonhunter,havoc,45,28,17
2713,Manga,aegwynn,1274,demonhunter,havoc,60,25,35
2714,Gwx,draenor,1274,demonhunter,havoc,54,20,34
2715,Pleskdh,malganis,1272,demonhunter,havoc,54,23,31
2716,Louloulou,aegwynn,1271,demonhunter,havoc,123,65,58
2717,Illidanio,xavius,1271,demonhunter,havoc,30,14,16
2718,Konoth,kirin-tor,1268,demonhunter,havoc,42,23,19
2719,Scotcheggs,argent-dawn,1267,demonhunter,havoc,38,16,22
2720,Minutte,twisting-nether,1265,demonhunter,havoc,48,27,21
2721,Gamaö,khaz-modan,1265,demonhunter,havoc,41,16,25
2722,Sua,outland,1264,demonhunter,havoc,85,42,43
2723,Gurvan,kazzak,1263,demonhunter,havoc,71,35,36
2724,Никкэс,gordunni,1263,demonhunter,havoc,30,14,16
2725,Æroa,antonidas,1262,demonhunter,havoc,35,19,16
2726,Schonevrouw,aszune,1261,demonhunter,havoc,48,29,19
2727,Khamzath,blackhand,1261,demonhunter,havoc,48,27,21
2728,Ðarckjojo,hyjal,1260,demonhunter,havoc,41,18,23
2729,Hirbs,silvermoon,1257,demonhunter,havoc,78,35,43
2730,Chapzi,ragnaros,1256,demonhunter,havoc,51,26,25
2731,Жемчужинка,eversong,1256,demonhunter,havoc,35,16,19
2732,Lùcîfer,hellfire,1255,demonhunter,havoc,77,38,39
2733,Nasghul,drakthul,1255,demonhunter,havoc,54,23,31
2734,Száraz,ragnaros,1254,demonhunter,havoc,42,14,28
2735,Hellboii,kilrogg,1253,demonhunter,havoc,63,39,24
2736,Lozakum,draenor,1252,demonhunter,havoc,114,55,59
2737,Schahmiran,kargath,1252,demonhunter,havoc,30,14,16
2738,Jahannam,ysondre,1251,demonhunter,havoc,66,31,35
2739,Anödyth,kirin-tor,1251,demonhunter,havoc,45,20,25
2740,Norac,silvermoon,1248,demonhunter,havoc,41,16,25
2741,Necorinex,silvermoon,1247,demonhunter,havoc,18,13,5
2742,Rùkîbazùkï,ravencrest,1247,demonhunter,havoc,18,13,5
2743,Abuelodosaka,dun-modr,1247,demonhunter,havoc,24,13,11
2744,Nstea,cthun,1247,demonhunter,havoc,24,13,11
2745,Нереалочка,blackscar,1247,demonhunter,havoc,24,13,11
2746,Fróstdh,ravencrest,1247,demonhunter,havoc,30,13,17
2747,Тэлэсык,gordunni,1247,demonhunter,havoc,36,15,21
2748,Embruixada,sanguino,1246,demonhunter,havoc,58,34,24
2749,Zernoid,kazzak,1246,demonhunter,havoc,24,13,11
2750,Weback,ravencrest,1246,demonhunter,havoc,30,13,17
2751,Saehila,kirin-tor,1246,demonhunter,havoc,53,21,32
2752,Illidrax,outland,1245,demonhunter,havoc,36,13,23
2753,Jotaros,ravencrest,1245,demonhunter,havoc,36,13,23
2754,Dedemøn,ysondre,1243,demonhunter,havoc,24,13,11
2755,Kimberleh,doomhammer,1243,demonhunter,havoc,24,13,11
2756,Asmedios,twisting-nether,1243,demonhunter,havoc,416,211,205
2757,Demonpegasus,draenor,1243,demonhunter,havoc,30,13,17
2758,Allosa,argent-dawn,1243,demonhunter,havoc,30,13,17
2759,Håssan,ravencrest,1242,demonhunter,havoc,24,13,11
2760,Meleidar,kazzak,1242,demonhunter,havoc,30,13,17
2761,Порядокх,soulflayer,1240,demonhunter,havoc,24,14,10
2762,Mooty,drekthar,1240,demonhunter,havoc,24,13,11
2763,Nidorino,aegwynn,1240,demonhunter,havoc,30,13,17
2764,Блъя,gordunni,1240,demonhunter,havoc,30,13,17
2765,Kãzïn,archimonde,1240,demonhunter,havoc,30,13,17
2766,Кавайтити,howling-fjord,1239,demonhunter,havoc,24,13,11
2767,Waviel,burning-legion,1239,demonhunter,havoc,29,14,15
2768,Zejza,ragnaros,1238,demonhunter,havoc,43,19,24
2769,Jugøbænned,blackrock,1236,demonhunter,havoc,18,13,5
2770,Xellnaga,twisting-nether,1236,demonhunter,havoc,38,18,20
2771,Полутемный,howling-fjord,1235,demonhunter,havoc,24,13,11
2772,Nekkëtsu,archimonde,1235,demonhunter,havoc,24,13,11
2773,Maltok,ysondre,1235,demonhunter,havoc,49,25,24
2774,Demonjay,stormscale,1233,demonhunter,havoc,28,14,14
2775,Эридали,gordunni,1233,demonhunter,havoc,90,42,48
2776,Goatcorpse,blackmoore,1233,demonhunter,havoc,30,14,16
2777,Titanslayyer,azjolnerub,1233,demonhunter,havoc,30,13,17
2778,Даргсайд,gordunni,1230,demonhunter,havoc,77,34,43
2779,Lydaro,malganis,1229,demonhunter,havoc,18,13,5
2780,Djaris,ghostlands,1228,demonhunter,havoc,18,13,5
2781,Isp,kazzak,1227,demonhunter,havoc,36,14,22
2782,Mojois,ravenholdt,1225,demonhunter,havoc,81,46,35
2783,Даудаев,gordunni,1225,demonhunter,havoc,36,19,17
2784,Sindweller,arathi,1225,demonhunter,havoc,36,14,22
2785,Shreddern,ragnaros,1224,demonhunter,havoc,31,14,17
2786,Zyasea,blackmoore,1223,demonhunter,havoc,60,21,39
2787,Кайриель,gordunni,1222,demonhunter,havoc,24,13,11
2788,Dârhma,archimonde,1221,demonhunter,havoc,29,18,11
2789,Лолбичьпро,blackscar,1221,demonhunter,havoc,30,16,14
2790,Овецловец,deathguard,1220,demonhunter,havoc,24,13,11
2791,Реалистик,deathweaver,1219,demonhunter,havoc,79,33,46
2792,Giace,drakthul,1219,demonhunter,havoc,60,25,35
2793,Нксин,howling-fjord,1218,demonhunter,havoc,30,14,16
2794,Dmgchris,sylvanas,1218,demonhunter,havoc,36,13,23
2795,Quakes,pozzo-delleternità,1217,demonhunter,havoc,36,19,17
2796,Осхимс,deathguard,1215,demonhunter,havoc,36,21,15
2797,Fruttidimare,frostwolf,1214,demonhunter,havoc,93,41,52
2798,Betråyêr,draenor,1213,demonhunter,havoc,38,15,23
2799,Heàvic,outland,1210,demonhunter,havoc,57,32,25
2800,Kladius,skullcrusher,1210,demonhunter,havoc,27,15,12
2801,Medievils,silvermoon,1209,demonhunter,havoc,60,22,38
2802,Jyzu,festung-der-stürme,1209,demonhunter,havoc,36,13,23
2803,Chancelvie,outland,1208,demonhunter,havoc,34,14,20
2804,Bessus,aggra-português,1207,demonhunter,havoc,48,24,24
2805,Ìllídán,ravencrest,1205,demonhunter,havoc,80,41,39
2806,Demonzeus,sylvanas,1203,demonhunter,havoc,56,30,26
2807,Trekxx,ragnaros,1203,demonhunter,havoc,36,16,20
2808,Bøøgý,silvermoon,1202,demonhunter,havoc,54,24,30
2809,Isila,alakir,1202,demonhunter,havoc,89,33,56
2810,Самуройд,gordunni,1199,demonhunter,havoc,42,18,24
2811,Camilysu,perenolde,1199,demonhunter,havoc,35,13,22
2812,Vozol,stormscale,1195,demonhunter,havoc,30,20,10
2813,Shytan,tarren-mill,1195,demonhunter,havoc,33,14,19
2814,Hellarious,ragnaros,1195,demonhunter,havoc,72,30,42
2815,Demonronin,the-maelstrom,1194,demonhunter,havoc,74,38,36
2816,Nanocsika,twisting-nether,1194,demonhunter,havoc,131,63,68
2817,Дитяхаоса,howling-fjord,1194,demonhunter,havoc,60,24,36
2818,Dämokröte,ambossar,1192,demonhunter,havoc,36,21,15
2819,Stringsz,ragnaros,1190,demonhunter,havoc,70,43,27
2820,Kélida,dun-modr,1190,demonhunter,havoc,33,13,20
2821,Danedemlia,magtheridon,1189,demonhunter,havoc,55,25,30
2822,Aûrelian,kragjin,1189,demonhunter,havoc,33,15,18
2823,Marmotaa,ragnaros,1188,demonhunter,havoc,67,31,36
2824,Leloine,trollbane,1185,demonhunter,havoc,51,30,21
2825,Hawek,madmortem,1184,demonhunter,havoc,58,33,25
2826,Claere,blackhand,1184,demonhunter,havoc,87,45,42
2827,Dämonbumm,blackmoore,1183,demonhunter,havoc,22,13,9
2828,Demonligos,draenor,1183,demonhunter,havoc,72,36,36
2829,Artexxen,kazzak,1182,demonhunter,havoc,42,14,28
2830,Uthinare,silvermoon,1179,demonhunter,havoc,32,14,18
2831,Tokoloshë,ragnaros,1177,demonhunter,havoc,54,27,27
2832,Øutsider,blackmoore,1174,demonhunter,havoc,78,34,44
2833,Munja,hyjal,1173,demonhunter,havoc,208,106,102
2834,Эндимэн,soulflayer,1172,demonhunter,havoc,44,24,20
2835,Моуровани,eversong,1172,demonhunter,havoc,30,16,14
2836,Самфор,soulflayer,1172,demonhunter,havoc,84,41,43
2837,Änyä,ravencrest,1171,demonhunter,havoc,28,13,15
2838,Гневныймомон,soulflayer,1168,demonhunter,havoc,76,38,38
2839,Kiriall,blackmoore,1166,demonhunter,havoc,78,36,42
2840,Oxydh,ravencrest,1165,demonhunter,havoc,28,13,15
2841,Люцифэйль,gordunni,1165,demonhunter,havoc,50,23,27
2842,Shizá,burning-legion,1165,demonhunter,havoc,86,39,47
2843,Lagordin,aggramar,1161,demonhunter,havoc,18,14,4
2844,Athoribos,silvermoon,1160,demonhunter,havoc,60,32,28
2845,Letidyr,ravencrest,1158,demonhunter,havoc,54,17,37
2846,Zayl,defias-brotherhood,1157,demonhunter,havoc,38,13,25
2847,Wréckful,ravencrest,1155,demonhunter,havoc,48,17,31
2848,Itsukix,stormscale,1153,demonhunter,havoc,36,21,15
2849,Folygale,outland,1152,demonhunter,havoc,18,12,6
2850,Sarissa,dun-modr,1152,demonhunter,havoc,30,16,14
2851,Аоешный,howling-fjord,1152,demonhunter,havoc,24,12,12
2852,Makri,outland,1151,demonhunter,havoc,52,26,26
2853,Vaiprix,ragnaros,1151,demonhunter,havoc,24,12,12
2854,Hagana,tirion,1151,demonhunter,havoc,24,12,12
2855,Ricedh,blackhand,1151,demonhunter,havoc,24,12,12
2856,Onlyw,ravencrest,1150,demonhunter,havoc,17,13,4
2857,Azzinoth,outland,1150,demonhunter,havoc,57,20,37
2858,Kerog,blackmoore,1149,demonhunter,havoc,18,12,6
2859,Seleverkauft,antonidas,1149,demonhunter,havoc,18,12,6
2860,Spankoproof,kazzak,1149,demonhunter,havoc,18,12,6
2861,Bigboychaos,twisting-nether,1149,demonhunter,havoc,36,19,17
2862,Teoma,hyjal,1149,demonhunter,havoc,146,77,69
2863,Bignugs,ravencrest,1149,demonhunter,havoc,30,12,18
2864,Schøck,blackhand,1148,demonhunter,havoc,18,12,6
2865,Maøu,hyjal,1147,demonhunter,havoc,24,12,12
2866,Хирако,booty-bay,1147,demonhunter,havoc,24,12,12
2867,Mèlfurion,hyjal,1147,demonhunter,havoc,97,42,55
2868,Exceltor,sanguino,1147,demonhunter,havoc,36,12,24
2869,Cielis,outland,1146,demonhunter,havoc,24,12,12
2870,Satanmanna,twisting-nether,1145,demonhunter,havoc,30,12,18
2871,Джигурдинец,gordunni,1144,demonhunter,havoc,30,17,13
2872,Allalina,draenor,1144,demonhunter,havoc,60,33,27
2873,Themen,ragnaros,1143,demonhunter,havoc,18,12,6
2874,Viridisignis,silvermoon,1143,demonhunter,havoc,80,43,37
2875,Téthis,uldaman,1143,demonhunter,havoc,78,34,44
2876,Xellidan,dun-modr,1142,demonhunter,havoc,30,14,16
2877,Ræko,sanguino,1142,demonhunter,havoc,30,12,18
2878,Anandria,blutkessel,1140,demonhunter,havoc,71,42,29
2879,Azn,twisting-nether,1140,demonhunter,havoc,24,12,12
2880,Yuka,earthen-ring,1140,demonhunter,havoc,42,20,22
2881,Azkerash,draenor,1140,demonhunter,havoc,54,20,34
2882,Сангвиннус,howling-fjord,1139,demonhunter,havoc,23,13,10
2883,Lilithxz,blackmoore,1139,demonhunter,havoc,24,12,12
2884,Fotmfgt,eredar,1139,demonhunter,havoc,24,12,12
2885,Dreggath,doomhammer,1139,demonhunter,havoc,59,29,30
2886,Тушино,lich-king,1135,demonhunter,havoc,18,12,6
2887,Гарражж,howling-fjord,1135,demonhunter,havoc,24,12,12
2888,Basiliskus,argent-dawn,1134,demonhunter,havoc,30,12,18
2889,Pichkachu,sylvanas,1129,demonhunter,havoc,24,12,12
2890,Gurthalak,alakir,1129,demonhunter,havoc,35,14,21
2891,Giboo,emerald-dream,1127,demonhunter,havoc,18,12,6
2892,Liisza,blackhand,1124,demonhunter,havoc,18,12,6
2893,Picotea,argent-dawn,1124,demonhunter,havoc,18,12,6
2894,Vio,jaedenar,1124,demonhunter,havoc,60,36,24
2895,Арат,ashenvale,1122,demonhunter,havoc,18,12,6
2896,Jnfd,outland,1118,demonhunter,havoc,32,13,19
2897,Sharhan,sylvanas,1118,demonhunter,havoc,42,16,26
2898,Vaenil,hyjal,1118,demonhunter,havoc,41,14,27
2899,Aloii,kazzak,1116,demonhunter,havoc,30,13,17
2900,Youjosenki,magtheridon,1111,demonhunter,havoc,23,15,8
2901,Zulthealbino,tarren-mill,1110,demonhunter,havoc,20,13,7
2902,Zengor,twilights-hammer,1109,demonhunter,havoc,28,14,14
2903,Мотек,howling-fjord,1109,demonhunter,havoc,120,57,63
2904,Tatsukiyuzu,hyjal,1107,demonhunter,havoc,48,32,16
2905,Roostidh,shattered-hand,1103,demonhunter,havoc,54,30,24
2906,Metadel,outland,1103,demonhunter,havoc,163,86,77
2907,Shadowkick,archimonde,1103,demonhunter,havoc,204,102,102
2908,Нохелет,deepholm,1102,demonhunter,havoc,181,94,87
2909,Mcsmackface,hellfire,1102,demonhunter,havoc,54,19,35
2910,Scarebearz,outland,1100,demonhunter,havoc,66,34,32
2911,Айвэнгос,thermaplugg,1097,demonhunter,havoc,61,35,26
2912,Twistyy,drakthul,1097,demonhunter,havoc,72,41,31
2913,Glavesong,burning-legion,1096,demonhunter,havoc,21,13,8
2914,Darkustos,blackrock,1096,demonhunter,havoc,26,14,12
2915,Biànca,outland,1096,demonhunter,havoc,34,13,21
2916,Petefile,kazzak,1094,demonhunter,havoc,24,13,11
2917,Зографос,fordragon,1094,demonhunter,havoc,25,13,12
2918,Аллилания,fordragon,1092,demonhunter,havoc,50,32,18
2919,Kebiz,ragnaros,1090,demonhunter,havoc,23,12,11
2920,Eranduur,draenor,1088,demonhunter,havoc,24,13,11
2921,Âkazza,archimonde,1086,demonhunter,havoc,26,12,14
2922,Marsterkush,malygos,1086,demonhunter,havoc,36,16,20
2923,Fikyx,draenor,1086,demonhunter,havoc,50,20,30
2924,Илизарнный,gordunni,1085,demonhunter,havoc,30,13,17
2925,Azazelkw,ragnaros,1084,demonhunter,havoc,66,34,32
2926,Thegamesucks,ravencrest,1084,demonhunter,havoc,214,104,110
2927,Дронкрылатый,soulflayer,1084,demonhunter,havoc,36,15,21
2928,Дэрзлорд,fordragon,1082,demonhunter,havoc,23,12,11
2929,Iaozh,culte-de-la-rive-noire,1082,demonhunter,havoc,30,12,18
2930,Stonebanker,turalyon,1079,demonhunter,havoc,23,14,9
2931,Typhoonxq,tarren-mill,1078,demonhunter,havoc,41,21,20
2932,Lögan,uldum,1078,demonhunter,havoc,36,16,20
2933,Sgravo,nemesis,1077,demonhunter,havoc,18,12,6
2934,Dadicek,drakthul,1069,demonhunter,havoc,18,12,6
2935,Asporos,pozzo-delleternità,1067,demonhunter,havoc,31,12,19
2936,Scurenzio,outland,1065,demonhunter,havoc,42,24,18
2937,Sombessat,tarren-mill,1064,demonhunter,havoc,24,12,12
2938,Venøøm,eldrethalas,1064,demonhunter,havoc,108,49,59
2939,Gabquist,argent-dawn,1063,demonhunter,havoc,47,25,22
2940,Yousif,stormscale,1062,demonhunter,havoc,61,29,32
2941,Noctilucent,executus,1061,demonhunter,havoc,90,49,41
2942,Стрепа,grom,1061,demonhunter,havoc,29,15,14
2943,Grazilo,outland,1061,demonhunter,havoc,32,13,19
2944,Aamonath,tarren-mill,1060,demonhunter,havoc,36,20,16
2945,Makkivar,terenas,1060,demonhunter,havoc,36,15,21
2946,Prismio,ysondre,1059,demonhunter,havoc,21,12,9
2947,Alkann,chogall,1057,demonhunter,havoc,29,15,14
2948,Happykx,draenor,1056,demonhunter,havoc,12,11,1
2949,Диджейвжух,gordunni,1056,demonhunter,havoc,18,11,7
2950,Ayyo,agamaggan,1056,demonhunter,havoc,24,11,13
2951,Véin,stormscale,1056,demonhunter,havoc,30,11,19
2952,Dhlee,ravencrest,1055,demonhunter,havoc,18,11,7
2953,Kakashî,darksorrow,1055,demonhunter,havoc,18,11,7
2954,Draqula,ravencrest,1055,demonhunter,havoc,24,11,13
2955,Onizukadh,archimonde,1055,demonhunter,havoc,24,11,13
2956,Newgens,kazzak,1055,demonhunter,havoc,24,11,13
2957,Suitcåséguy,ravencrest,1055,demonhunter,havoc,30,11,19
2958,Skippydemon,nozdormu,1055,demonhunter,havoc,30,11,19
2959,Кайренсс,howling-fjord,1055,demonhunter,havoc,30,11,19
2960,Ohshietwadap,twisting-nether,1055,demonhunter,havoc,30,11,19
2961,Шизванаденс,gordunni,1054,demonhunter,havoc,18,11,7
2962,Mcfitty,stormscale,1054,demonhunter,havoc,18,11,7
2963,Deocleo,draenor,1054,demonhunter,havoc,21,12,9
2964,Mårcxb,blackhand,1054,demonhunter,havoc,24,11,13
2965,Përry,archimonde,1054,demonhunter,havoc,24,11,13
2966,Verybigdps,aegwynn,1054,demonhunter,havoc,24,11,13
2967,Lyzzra,blackmoore,1054,demonhunter,havoc,24,11,13
2968,Сочняга,gordunni,1054,demonhunter,havoc,30,11,19
2969,Спииртт,blackscar,1054,demonhunter,havoc,36,11,25
2970,Turbomenak,drakthul,1053,demonhunter,havoc,18,11,7
2971,Fredoo,sylvanas,1053,demonhunter,havoc,20,11,9
2972,Бистлайк,soulflayer,1053,demonhunter,havoc,24,11,13
2973,Darktérror,silvermoon,1053,demonhunter,havoc,30,11,19
2974,Никельдон,howling-fjord,1052,demonhunter,havoc,54,33,21
2975,Шавермье,gordunni,1052,demonhunter,havoc,36,11,25
2976,Bud,lightnings-blade,1051,demonhunter,havoc,18,11,7
2977,Demonbean,stormscale,1051,demonhunter,havoc,22,12,10
2978,Jyrpä,stormscale,1051,demonhunter,havoc,29,12,17
2979,Squan,blackmoore,1050,demonhunter,havoc,20,12,8
2980,Vìdhar,tarren-mill,1049,demonhunter,havoc,24,11,13
2981,Zamp,deathwing,1049,demonhunter,havoc,30,11,19
2982,Posterboy,tarren-mill,1048,demonhunter,havoc,18,11,7
2983,Clexa,thrall,1047,demonhunter,havoc,24,11,13
2984,Blisdon,argent-dawn,1046,demonhunter,havoc,60,27,33
2985,Aminféryadi,twisting-nether,1046,demonhunter,havoc,30,11,19
2986,Dèathless,pozzo-delleternità,1044,demonhunter,havoc,42,15,27
2987,Calthmon,shattrath,1043,demonhunter,havoc,24,11,13
2988,Badgyalriri,hyjal,1042,demonhunter,havoc,24,11,13
2989,Yiùna,hyjal,1039,demonhunter,havoc,36,16,20
2990,Estarloco,blackmoore,1038,demonhunter,havoc,36,19,17
2991,Kaitlyyn,norgannon,1038,demonhunter,havoc,30,11,19
2992,Sintoraz,amanthul,1035,demonhunter,havoc,50,30,20
2993,Haýuken,kazzak,1035,demonhunter,havoc,24,13,11
2994,Lightkick,archimonde,1034,demonhunter,havoc,36,23,13
2995,Vaterdenke,defias-brotherhood,1032,demonhunter,havoc,18,11,7
2996,Électrâs,archimonde,1032,demonhunter,havoc,50,21,29
2997,Cirino,defias-brotherhood,1027,demonhunter,havoc,30,13,17
2998,Ascanius,nemesis,1026,demonhunter,havoc,59,31,28
2999,Aggerpain,draenor,1026,demonhunter,havoc,68,24,44
3000,Aruzar,twisting-nether,1025,demonhunter,havoc,30,11,19
3001,Cobayashi,der-mithrilorden,1023,demonhunter,havoc,38,21,17
3002,Gigipletosu,ravencrest,1018,demonhunter,havoc,30,11,19
3003,Sorowas,tichondrius,1015,demonhunter,havoc,30,17,13
3004,Увиден,eversong,1015,demonhunter,havoc,92,44,48
3005,Shirakava,quelthalas,1014,demonhunter,havoc,76,29,47
3006,Milkeyes,ravencrest,1011,demonhunter,havoc,66,32,34
3007,Nelairia,tarren-mill,1010,demonhunter,havoc,24,12,12
3008,Aelita,twisting-nether,1006,demonhunter,havoc,96,53,43
3009,Demontripo,silvermoon,1005,demonhunter,havoc,81,43,38
3010,Solrosfrön,stormscale,1005,demonhunter,havoc,23,11,12
3011,Delfee,twisting-nether,1005,demonhunter,havoc,54,25,29
3012,Нотреди,howling-fjord,1004,demonhunter,havoc,30,17,13
3013,Demonhyan,chants-éternels,1003,demonhunter,havoc,61,30,31
3014,Pismanik,drakthul,1002,demonhunter,havoc,24,15,9
3015,Ilidas,frostwolf,999,demonhunter,havoc,24,11,13
3016,Vaco,la-croisade-écarlate,996,demonhunter,havoc,30,13,17
3017,Nehmarath,doomhammer,995,demonhunter,havoc,36,11,25
3018,Гарнаш,howling-fjord,993,demonhunter,havoc,60,30,30
3019,Hunterston,twisting-nether,992,demonhunter,havoc,68,38,30
3020,Siscia,outland,991,demonhunter,havoc,54,28,26
3021,Zlett,draenor,990,demonhunter,havoc,22,11,11
3022,Ànavar,twisting-nether,990,demonhunter,havoc,35,15,20
3023,Piloudh,dalaran,989,demonhunter,havoc,22,11,11
3024,Demonzeus,archimonde,985,demonhunter,havoc,25,12,13
3025,Straizo,malganis,984,demonhunter,havoc,26,11,15
3026,Silan,kiljaeden,972,demonhunter,havoc,29,16,13
3027,Ladj,blackmoore,969,demonhunter,havoc,24,12,12
3028,Огнод,gordunni,968,demonhunter,havoc,42,21,21
3029,Êvê,blackmoore,962,demonhunter,havoc,22,12,10
3030,Johncoffèy,ragnaros,960,demonhunter,havoc,12,10,2
3031,Дианист,gordunni,960,demonhunter,havoc,16,11,5
3032,Reckqqt,eredar,960,demonhunter,havoc,18,10,8
3033,Izzidan,magtheridon,960,demonhunter,havoc,18,10,8
3034,Antrix,ravencrest,960,demonhunter,havoc,18,10,8
3035,Keýrañe,ragnaros,960,demonhunter,havoc,18,10,8
3036,Narkiza,tarren-mill,960,demonhunter,havoc,18,10,8
3037,Анхардх,gordunni,960,demonhunter,havoc,18,10,8
3038,Ragefighterr,ragnaros,960,demonhunter,havoc,36,16,20
3039,Krvckhead,hyjal,960,demonhunter,havoc,24,10,14
3040,Iíïììïiíïìïï,alakir,960,demonhunter,havoc,24,10,14
3041,Íamprepared,tarren-mill,960,demonhunter,havoc,30,10,20
3042,Fishmicksh,twisting-nether,959,demonhunter,havoc,12,10,2
3043,Völkswagen,dun-modr,959,demonhunter,havoc,18,10,8
3044,Lucianloco,dun-morogh,959,demonhunter,havoc,18,10,8
3045,Гранкрю,blackscar,959,demonhunter,havoc,18,10,8
3046,Soysoyum,draenor,959,demonhunter,havoc,18,10,8
3047,Qqski,kazzak,959,demonhunter,havoc,18,10,8
3048,Катякрылышки,gordunni,959,demonhunter,havoc,18,10,8
3049,Vayshi,turalyon,959,demonhunter,havoc,24,10,14
3050,Demonicat,twisting-nether,959,demonhunter,havoc,24,10,14
3051,Mollamaija,defias-brotherhood,959,demonhunter,havoc,24,10,14
3052,Yumhip,dun-modr,959,demonhunter,havoc,24,10,14
3053,Táti,blackrock,959,demonhunter,havoc,24,10,14
3054,Darnke,silvermoon,959,demonhunter,havoc,30,10,20
3055,Gandzsä,ragnaros,959,demonhunter,havoc,30,10,20
3056,Sephiris,argent-dawn,958,demonhunter,havoc,19,11,8
3057,Elenôy,malganis,958,demonhunter,havoc,18,10,8
3058,Demonetized,blackrock,958,demonhunter,havoc,24,10,14
3059,Дэйзиджонсон,soulflayer,958,demonhunter,havoc,24,10,14
3060,Охотникн,howling-fjord,958,demonhunter,havoc,24,10,14
3061,Critlerman,blackmoore,957,demonhunter,havoc,16,11,5
3062,Skarvy,bronze-dragonflight,957,demonhunter,havoc,18,10,8
3063,Kenzaii,aegwynn,957,demonhunter,havoc,24,10,14
3064,Sèptember,draenor,957,demonhunter,havoc,30,10,20
3065,Bobdh,twisting-nether,957,demonhunter,havoc,35,10,25
3066,Nightglaives,twisting-nether,956,demonhunter,havoc,12,10,2
3067,Drilloz,ravencrest,956,demonhunter,havoc,18,10,8
3068,Такетомии,gordunni,956,demonhunter,havoc,24,10,14
3069,Версомния,gordunni,956,demonhunter,havoc,24,10,14
3070,Morphiyy,tarren-mill,955,demonhunter,havoc,18,10,8
3071,Shadowweaver,earthen-ring,955,demonhunter,havoc,18,10,8
3072,Morvash,nemesis,954,demonhunter,havoc,18,10,8
3073,Noitradh,zuljin,954,demonhunter,havoc,21,11,10
3074,Anklàr,blackrock,954,demonhunter,havoc,24,10,14
3075,Карнавалыч,gordunni,954,demonhunter,havoc,96,35,61
3076,Argnils,tarren-mill,953,demonhunter,havoc,12,10,2
3077,Nuriia,arthas,953,demonhunter,havoc,54,30,24
3078,Эфемерид,howling-fjord,953,demonhunter,havoc,18,10,8
3079,Ravier,baelgun,953,demonhunter,havoc,75,39,36
3080,Greedsmoke,kazzak,952,demonhunter,havoc,18,10,8
3081,Цейн,azuregos,952,demonhunter,havoc,39,15,24
3082,Илайора,galakrond,952,demonhunter,havoc,30,10,20
3083,Pijvijie,shattrath,951,demonhunter,havoc,30,10,20
3084,Годиксгёрл,gordunni,950,demonhunter,havoc,12,10,2
3085,Иллидал,greymane,949,demonhunter,havoc,18,10,8
3086,Alandrisz,argent-dawn,949,demonhunter,havoc,30,10,20
3087,Mamazboy,lightnings-blade,946,demonhunter,havoc,18,10,8
3088,Максаналл,soulflayer,944,demonhunter,havoc,18,10,8
3089,Hannipham,silvermoon,944,demonhunter,havoc,21,11,10
3090,Thorskinius,ravencrest,944,demonhunter,havoc,32,11,21
3091,Jemoer,twisting-nether,942,demonhunter,havoc,25,15,10
3092,Талона,fordragon,942,demonhunter,havoc,18,10,8
3093,Nylaria,dethecus,940,demonhunter,havoc,18,10,8
3094,Shishiro,alakir,937,demonhunter,havoc,24,10,14
3095,Rockymarcia,archimonde,930,demonhunter,havoc,18,11,7
3096,Winnztlol,chamber-of-aspects,927,demonhunter,havoc,36,17,19
3097,Devilmonkey,ambossar,927,demonhunter,havoc,54,16,38
3098,Zermut,culte-de-la-rive-noire,925,demonhunter,havoc,17,10,7
3099,Byah,kazzak,924,demonhunter,havoc,115,48,67
3100,Flamme,amanthul,923,demonhunter,havoc,30,16,14
3101,Maßik,terokkar,922,demonhunter,havoc,21,11,10
3102,Sinthetyx,quelthalas,917,demonhunter,havoc,36,19,17
3103,Noire,zuljin,917,demonhunter,havoc,29,10,19
3104,Фирулия,goldrinn,914,demonhunter,havoc,108,52,56
3105,Andij,frostwolf,913,demonhunter,havoc,29,11,18
3106,Taliaa,drakthul,911,demonhunter,havoc,21,10,11
3107,Аллидариан,howling-fjord,910,demonhunter,havoc,23,10,13
3108,Skylinex,dentarg,909,demonhunter,havoc,66,33,33
3109,Манапарда,howling-fjord,909,demonhunter,havoc,35,10,25
3110,Sìnbad,khaz-modan,908,demonhunter,havoc,24,14,10
3111,Hicgidik,outland,905,demonhunter,havoc,24,11,13
3112,Ataddcay,outland,901,demonhunter,havoc,45,16,29
3113,Ejder,anubarak,900,demonhunter,havoc,66,26,40
3114,Maurî,tarren-mill,895,demonhunter,havoc,26,10,16
3115,Kroepoeks,mazrigos,894,demonhunter,havoc,30,16,14
3116,Jamule,dun-morogh,889,demonhunter,havoc,36,15,21
3117,Braserol,archimonde,881,demonhunter,havoc,38,12,26
3118,Amionisiken,amanthul,873,demonhunter,havoc,25,10,15
3119,Legionek,burning-blade,866,demonhunter,havoc,20,11,9
3120,Lorcanmar,draenor,866,demonhunter,havoc,63,26,37
3121,Paiz,grim-batol,864,demonhunter,havoc,12,9,3
3122,Illidiangød,sanguino,864,demonhunter,havoc,12,9,3
3123,Лфгнехиро,soulflayer,864,demonhunter,havoc,12,9,3
3124,Fizzpep,eredar,864,demonhunter,havoc,12,9,3
3125,Ittas,archimonde,864,demonhunter,havoc,18,9,9
3126,Sghemon,pozzo-delleternità,864,demonhunter,havoc,18,9,9
3127,Realtrance,sanguino,864,demonhunter,havoc,18,9,9
3128,Toschadh,blackmoore,864,demonhunter,havoc,18,9,9
3129,Saene,ravencrest,864,demonhunter,havoc,18,9,9
3130,Raïley,archimonde,864,demonhunter,havoc,18,9,9
3131,Notapistol,outland,864,demonhunter,havoc,18,9,9
3132,Эридари,blackscar,864,demonhunter,havoc,18,9,9
3133,Zophý,ragnaros,864,demonhunter,havoc,18,9,9
3134,Thulânn,twisting-nether,864,demonhunter,havoc,18,9,9
3135,Chosabreka,zuljin,864,demonhunter,havoc,18,9,9
3136,Albdh,kazzak,864,demonhunter,havoc,24,9,15
3137,Djaskmazi,archimonde,864,demonhunter,havoc,24,9,15
3138,Fuseton,kazzak,864,demonhunter,havoc,24,9,15
3139,Sunestaa,kazzak,863,demonhunter,havoc,12,9,3
3140,Drunkendemon,frostwolf,863,demonhunter,havoc,12,9,3
3141,Lennöx,silvermoon,863,demonhunter,havoc,13,9,4
3142,Ììîîííììîîíí,tarren-mill,863,demonhunter,havoc,18,9,9
3143,Сихая,howling-fjord,863,demonhunter,havoc,18,9,9
3144,Neomicha,blackmoore,863,demonhunter,havoc,18,9,9
3145,Illidaia,ravencrest,863,demonhunter,havoc,18,9,9
3146,Sutures,ravencrest,863,demonhunter,havoc,18,9,9
3147,Õmen,ravencrest,863,demonhunter,havoc,18,9,9
3148,Lodjay,hyjal,863,demonhunter,havoc,18,9,9
3149,Asylèm,draenor,863,demonhunter,havoc,18,9,9
3150,Minadng,silvermoon,863,demonhunter,havoc,18,9,9
3151,Watermelonqt,tarren-mill,863,demonhunter,havoc,18,9,9
3152,Integer,tarren-mill,863,demonhunter,havoc,18,9,9
3153,Кррюкс,gordunni,863,demonhunter,havoc,18,9,9
3154,Finstergraf,blackmoore,863,demonhunter,havoc,36,17,19
3155,Djdhh,draenor,863,demonhunter,havoc,20,9,11
3156,Hialdoo,bladefist,863,demonhunter,havoc,24,9,15
3157,Ðanizâ,aegwynn,863,demonhunter,havoc,24,9,15
3158,Slizer,draenor,863,demonhunter,havoc,24,9,15
3159,Zappikdh,silvermoon,862,demonhunter,havoc,18,9,9
3160,Ðhgøðx,outland,862,demonhunter,havoc,18,9,9
3161,Illidián,chamber-of-aspects,862,demonhunter,havoc,24,9,15
3162,Demonstorpix,drakthul,862,demonhunter,havoc,24,9,15
3163,Aeshalla,blackmoore,862,demonhunter,havoc,24,9,15
3164,Tzklkn,sylvanas,861,demonhunter,havoc,12,9,3
3165,Selénhe,silvermoon,861,demonhunter,havoc,18,9,9
3166,Selcan,archimonde,861,demonhunter,havoc,18,9,9
3167,Тэниан,gordunni,861,demonhunter,havoc,24,9,15
3168,Sinorack,sargeras,860,demonhunter,havoc,18,9,9
3169,Wrathill,draenor,860,demonhunter,havoc,24,9,15
3170,Doobregeesy,burning-legion,859,demonhunter,havoc,21,10,11
3171,Deadskill,alexstrasza,858,demonhunter,havoc,54,21,33
3172,Keiti,drakthul,856,demonhunter,havoc,36,9,27
3173,Bhuta,aerie-peak,855,demonhunter,havoc,18,9,9
3174,Chrititia,blackmoore,852,demonhunter,havoc,24,9,15
3175,Butcherr,ulduar,851,demonhunter,havoc,30,11,19
3176,Dutchmadman,aerie-peak,848,demonhunter,havoc,79,37,42
3177,Dântés,silvermoon,845,demonhunter,havoc,30,9,21
3178,Besnik,stormscale,844,demonhunter,havoc,30,9,21
3179,Heemaglobin,ravencrest,843,demonhunter,havoc,42,18,24
3180,Winchesterxx,sanguino,842,demonhunter,havoc,24,9,15
3181,Subelsiu,alakir,840,demonhunter,havoc,63,26,37
3182,Fckmlf,outland,839,demonhunter,havoc,21,12,9
3183,Backflipgødx,uldaman,832,demonhunter,havoc,22,9,13
3184,Majînßûü,ravencrest,831,demonhunter,havoc,17,9,8
3185,Devendora,antonidas,831,demonhunter,havoc,18,9,9
3186,Toio,nemesis,831,demonhunter,havoc,24,9,15
3187,Дантавул,gordunni,825,demonhunter,havoc,24,9,15
3188,Daimon,pozzo-delleternità,813,demonhunter,havoc,21,10,11
3189,Alfazar,pozzo-delleternità,801,demonhunter,havoc,74,23,51
3190,Kundans,antonidas,799,demonhunter,havoc,18,10,8
3191,Illidaniellé,tarren-mill,799,demonhunter,havoc,17,9,8
3192,Blutox,antonidas,797,demonhunter,havoc,25,11,14
3193,Deadhuntor,daggerspine,795,demonhunter,havoc,17,9,8
3194,Dombra,kult-der-verdammten,788,demonhunter,havoc,11,9,2
3195,Demonakis,twisting-nether,784,demonhunter,havoc,19,9,10
3196,Кусьзакиску,soulflayer,781,demonhunter,havoc,22,9,13
3197,Wèx,tarren-mill,768,demonhunter,havoc,12,8,4
3198,Qweqweasd,outland,768,demonhunter,havoc,12,8,4
3199,Smallnik,tarren-mill,768,demonhunter,havoc,12,8,4
3200,Gixota,silvermoon,768,demonhunter,havoc,12,8,4
3201,Синтвеив,soulflayer,768,demonhunter,havoc,12,8,4
3202,Judditdhx,draenor,768,demonhunter,havoc,12,8,4
3203,Snubbeldemon,outland,768,demonhunter,havoc,12,8,4
3204,Dhamp,kazzak,768,demonhunter,havoc,12,8,4
3205,Viodemon,blackrock,768,demonhunter,havoc,12,8,4
3206,Eysndh,blackrock,768,demonhunter,havoc,12,8,4
3207,Traumadh,tarren-mill,768,demonhunter,havoc,12,8,4
3208,Sweåfy,outland,768,demonhunter,havoc,12,8,4
3209,Mesini,darksorrow,768,demonhunter,havoc,12,8,4
3210,Desdh,blackmoore,768,demonhunter,havoc,18,8,10
3211,Praisethelrd,blackrock,768,demonhunter,havoc,18,8,10
3212,Mvqdh,stormscale,768,demonhunter,havoc,18,8,10
3213,Thestrength,twisting-nether,768,demonhunter,havoc,18,8,10
3214,Nthday,draenor,768,demonhunter,havoc,18,8,10
3215,Lolliance,talnivarr,768,demonhunter,havoc,18,8,10
3216,Рензокукеен,gordunni,768,demonhunter,havoc,18,8,10
3217,Stinkymonkey,pozzo-delleternità,768,demonhunter,havoc,18,8,10
3218,Вирбль,gordunni,768,demonhunter,havoc,18,8,10
3219,Ozu,blackrock,768,demonhunter,havoc,18,8,10
3220,Demoan,outland,768,demonhunter,havoc,24,8,16
3221,Rõb,magtheridon,768,demonhunter,havoc,24,8,16
3222,Lilor,aegwynn,767,demonhunter,havoc,12,8,4
3223,Эска,razuvious,767,demonhunter,havoc,12,8,4
3224,Крикетгодх,howling-fjord,767,demonhunter,havoc,12,8,4
3225,Ninetzqp,tarren-mill,767,demonhunter,havoc,12,8,4
3226,Felsbane,argent-dawn,767,demonhunter,havoc,15,9,6
3227,Yorxdh,eredar,767,demonhunter,havoc,15,9,6
3228,Zmasteez,ahnqiraj,767,demonhunter,havoc,18,8,10
3229,Tòd,silvermoon,767,demonhunter,havoc,18,8,10
3230,Lifel,nemesis,767,demonhunter,havoc,18,8,10
3231,Kithan,zuljin,767,demonhunter,havoc,18,8,10
3232,Bamßi,ragnaros,767,demonhunter,havoc,18,8,10
3233,Lilitlovesme,blackmoore,767,demonhunter,havoc,18,8,10
3234,Paindemon,outland,767,demonhunter,havoc,18,8,10
3235,Kouloukas,ragnaros,767,demonhunter,havoc,18,8,10
3236,Shax,hellscream,767,demonhunter,havoc,18,8,10
3237,Calendith,arathor,767,demonhunter,havoc,21,9,12
3238,Salamihexler,dun-morogh,767,demonhunter,havoc,23,8,15
3239,Luceafaru,draenor,767,demonhunter,havoc,24,8,16
3240,Mëy,thrall,767,demonhunter,havoc,30,8,22
3241,Skrelarent,argent-dawn,766,demonhunter,havoc,12,8,4
3242,Мейьибейьи,howling-fjord,766,demonhunter,havoc,18,8,10
3243,Nestrae,drakthul,766,demonhunter,havoc,18,8,10
3244,Varthag,antonidas,766,demonhunter,havoc,18,8,10
3245,Deathblades,twisting-nether,766,demonhunter,havoc,18,8,10
3246,Neiden,deathwing,766,demonhunter,havoc,24,8,16
3247,Akäly,hyjal,765,demonhunter,havoc,19,9,10
3248,Mihaliana,argent-dawn,765,demonhunter,havoc,18,8,10
3249,Gruusha,kazzak,765,demonhunter,havoc,18,8,10
3250,Vvdh,ravencrest,765,demonhunter,havoc,22,9,13
3251,Aelzeran,stormscale,765,demonhunter,havoc,24,8,16
3252,Noxxi,gorgonnash,764,demonhunter,havoc,18,8,10
3253,Ironjòe,eredar,764,demonhunter,havoc,18,8,10
3254,Hupon,drakthul,764,demonhunter,havoc,18,8,10
3255,Saìras,blackhand,763,demonhunter,havoc,18,8,10
3256,Попкасиська,eversong,763,demonhunter,havoc,47,19,28
3257,Covidian,kilrogg,762,demonhunter,havoc,12,8,4
3258,Velgetox,blackrock,762,demonhunter,havoc,18,8,10
3259,Daweeo,the-maelstrom,762,demonhunter,havoc,18,8,10
3260,Unsainted,blackhand,762,demonhunter,havoc,18,8,10
3261,Darksink,kazzak,762,demonhunter,havoc,18,8,10
3262,Amaterasù,alleria,761,demonhunter,havoc,18,8,10
3263,Lovzuu,draenor,759,demonhunter,havoc,12,8,4
3264,Shnshon,kazzak,759,demonhunter,havoc,12,8,4
3265,Цион,soulflayer,757,demonhunter,havoc,18,8,10
3266,Meliòdas,draenor,757,demonhunter,havoc,25,8,17
3267,Lailat,alexstrasza,752,demonhunter,havoc,16,9,7
3268,Quavanity,sylvanas,735,demonhunter,havoc,17,8,9
3269,Heiltgalen,grim-batol,734,demonhunter,havoc,14,9,5
3270,Zealdancer,veknilash,734,demonhunter,havoc,17,8,9
3271,Gushìñgwøuñð,blackmoore,719,demonhunter,havoc,11,8,3
3272,Bezdna,stormrage,718,demonhunter,havoc,15,8,7
3273,Judderzz,bronze-dragonflight,717,demonhunter,havoc,18,8,10
3274,Makiu,archimonde,717,demonhunter,havoc,21,8,13
3275,Amylia,perenolde,711,demonhunter,havoc,21,10,11
3276,Liondam,pozzo-delleternità,696,demonhunter,havoc,24,8,16
3277,Yeyote,dun-modr,695,demonhunter,havoc,15,10,5
3278,Stixxs,archimonde,691,demonhunter,havoc,14,8,6
3279,Maddificator,silvermoon,686,demonhunter,havoc,14,8,6
3280,Магнисс,fordragon,685,demonhunter,havoc,14,8,6
3281,Itzrazor,ravencrest,683,demonhunter,havoc,25,8,17
3282,Prouser,turalyon,678,demonhunter,havoc,27,9,18
3283,Herzbann,madmortem,676,demonhunter,havoc,19,8,11
3284,Hanuta,alleria,672,demonhunter,havoc,12,7,5
3285,Дезлее,gordunni,672,demonhunter,havoc,12,7,5
3286,Ðevl,blackmoore,672,demonhunter,havoc,12,7,5
3287,Eydipha,blackmoore,672,demonhunter,havoc,12,7,5
3288,Verrottung,blackhand,672,demonhunter,havoc,12,7,5
3289,Esadeáth,ravencrest,672,demonhunter,havoc,12,7,5
3290,Karpandero,stormreaver,672,demonhunter,havoc,12,7,5
3291,Illyriel,antonidas,672,demonhunter,havoc,12,7,5
3292,Hextechz,stormscale,672,demonhunter,havoc,12,7,5
3293,Heimnar,frostmane,672,demonhunter,havoc,12,7,5
3294,Damnituther,kazzak,672,demonhunter,havoc,12,7,5
3295,Lemiisa,burning-blade,672,demonhunter,havoc,12,7,5
3296,Zmemroo,magtheridon,672,demonhunter,havoc,12,7,5
3297,Lirigizel,hellscream,672,demonhunter,havoc,12,7,5
3298,Crispychick,stormscale,672,demonhunter,havoc,12,7,5
3299,Glevenuschii,blackmoore,672,demonhunter,havoc,12,7,5
3300,Deadmaus,stormscale,672,demonhunter,havoc,12,7,5
3301,Ronstoppable,ravencrest,672,demonhunter,havoc,12,7,5
3302,Pepenger,kazzak,672,demonhunter,havoc,12,7,5
3303,Kalachiquezz,kazzak,672,demonhunter,havoc,12,7,5
3304,Alied,burning-blade,672,demonhunter,havoc,12,7,5
3305,Teinzy,stormscale,672,demonhunter,havoc,12,7,5
3306,Darkshadow,turalyon,672,demonhunter,havoc,12,7,5
3307,Itsfinee,outland,672,demonhunter,havoc,12,7,5
3308,Atrikagodx,kazzak,672,demonhunter,havoc,12,7,5
3309,Gorinda,twisting-nether,672,demonhunter,havoc,12,7,5
3310,Stonedaf,ravencrest,672,demonhunter,havoc,12,7,5
3311,Evul,blackmoore,672,demonhunter,havoc,12,7,5
3312,Chaosknight,outland,672,demonhunter,havoc,12,7,5
3313,Styxdh,blackhand,672,demonhunter,havoc,12,7,5
3314,Dêyza,archimonde,672,demonhunter,havoc,12,7,5
3315,Exoduss,ravencrest,672,demonhunter,havoc,12,7,5
3316,Caronte,los-errantes,672,demonhunter,havoc,12,7,5
3317,Satti,sargeras,672,demonhunter,havoc,18,7,11
3318,Ayimprepared,ragnaros,672,demonhunter,havoc,18,7,11
3319,Chrístíe,sanguino,672,demonhunter,havoc,18,7,11
3320,Demondulle,kazzak,672,demonhunter,havoc,18,7,11
3321,Grazax,lightnings-blade,672,demonhunter,havoc,18,7,11
3322,Charleyzard,argent-dawn,672,demonhunter,havoc,18,7,11
3323,Daekon,ahnqiraj,672,demonhunter,havoc,18,7,11
3324,Kruthor,taerar,672,demonhunter,havoc,18,7,11
3325,Крикетх,soulflayer,672,demonhunter,havoc,18,7,11
3326,Veryfunhaha,ravencrest,672,demonhunter,havoc,18,7,11
3327,Opsidaisi,tarren-mill,672,demonhunter,havoc,18,7,11
3328,Badess,malfurion,672,demonhunter,havoc,18,7,11
3329,Pelko,sanguino,672,demonhunter,havoc,18,7,11
3330,Reachfight,lothar,672,demonhunter,havoc,18,7,11
3331,Neonishh,twisting-nether,672,demonhunter,havoc,18,7,11
3332,Келидаррия,soulflayer,672,demonhunter,havoc,18,7,11
3333,Hatabaa,argent-dawn,672,demonhunter,havoc,18,7,11
3334,Wrathia,rexxar,672,demonhunter,havoc,18,7,11
3335,Êlva,alleria,672,demonhunter,havoc,18,7,11
3336,Størmrage,sanguino,672,demonhunter,havoc,18,7,11
3337,Abigorien,blackmoore,672,demonhunter,havoc,18,7,11
3338,Rybn,eredar,672,demonhunter,havoc,24,7,17
3339,Iamayaqt,nemesis,672,demonhunter,havoc,24,7,17
3340,Jokas,archimonde,672,demonhunter,havoc,24,7,17
3341,Illidorie,twisting-nether,672,demonhunter,havoc,24,7,17
3342,Paîmon,hyjal,672,demonhunter,havoc,24,7,17
3343,Inflection,ravencrest,672,demonhunter,havoc,24,7,17
3344,Vaimustus,outland,672,demonhunter,havoc,30,7,23
3345,Рагнос,goldrinn,672,demonhunter,havoc,30,7,23
3346,Karakas,drakthul,671,demonhunter,havoc,12,7,5
3347,Nerfy,silvermoon,671,demonhunter,havoc,12,7,5
3348,Randydhunt,draenor,671,demonhunter,havoc,12,7,5
3349,Deqthstrïke,ysondre,671,demonhunter,havoc,12,7,5
3350,Ddvh,drakthul,671,demonhunter,havoc,12,7,5
3351,Elfmonger,ravencrest,671,demonhunter,havoc,12,7,5
3352,Demonjagge,tarren-mill,671,demonhunter,havoc,12,7,5
3353,Meji,ravencrest,671,demonhunter,havoc,12,7,5
3354,Marcellaa,ravencrest,671,demonhunter,havoc,12,7,5
3355,Youngboost,blackrock,671,demonhunter,havoc,12,7,5
3356,Nxmpys,sanguino,671,demonhunter,havoc,12,7,5
3357,Mirajen,dun-modr,671,demonhunter,havoc,12,7,5
3358,Funclass,blackrock,671,demonhunter,havoc,12,7,5
3359,Corelly,ragnaros,671,demonhunter,havoc,18,7,11
3360,Moojdh,malganis,671,demonhunter,havoc,18,7,11
3361,Rebelion,dun-modr,671,demonhunter,havoc,18,7,11
3362,Norebb,sanguino,671,demonhunter,havoc,18,7,11
3363,Abrahêll,dun-modr,671,demonhunter,havoc,18,7,11
3364,Wårbÿ,ravencrest,671,demonhunter,havoc,18,7,11
3365,Gearuzaki,ghostlands,671,demonhunter,havoc,18,7,11
3366,Abendro,twisting-nether,671,demonhunter,havoc,18,7,11
3367,Løkil,blackrock,671,demonhunter,havoc,18,7,11
3368,Lîllîv,wrathbringer,671,demonhunter,havoc,18,7,11
3369,Милинайт,eversong,670,demonhunter,havoc,12,7,5
3370,Leäf,drakthul,670,demonhunter,havoc,12,7,5
3371,Nikkidesaint,twisting-nether,670,demonhunter,havoc,12,7,5
3372,Xtrmhunter,ysondre,670,demonhunter,havoc,18,7,11
3373,Hyunkél,kirin-tor,670,demonhunter,havoc,18,7,11
3374,Felni,lightbringer,669,demonhunter,havoc,12,7,5
3375,Nmeule,turalyon,669,demonhunter,havoc,12,7,5
3376,Zahif,kazzak,669,demonhunter,havoc,18,7,11
3377,Diabloman,stormscale,669,demonhunter,havoc,18,7,11
3378,Kumoko,burning-legion,669,demonhunter,havoc,21,8,13
3379,Necrotyle,twisting-nether,669,demonhunter,havoc,21,8,13
3380,Valen,die-aldor,669,demonhunter,havoc,24,7,17
3381,Katheros,garrosh,667,demonhunter,havoc,12,7,5
3382,Дядяэл,fordragon,667,demonhunter,havoc,24,7,17
3383,Plec,alakir,667,demonhunter,havoc,24,7,17
3384,Farlopon,dun-modr,667,demonhunter,havoc,36,7,29
3385,Mormefiél,twisting-nether,666,demonhunter,havoc,12,7,5
3386,Fugma,defias-brotherhood,666,demonhunter,havoc,12,7,5
3387,Glaiverush,alakir,666,demonhunter,havoc,12,7,5
3388,Seeshark,thrall,665,demonhunter,havoc,16,8,8
3389,Starlightkid,kazzak,665,demonhunter,havoc,18,7,11
3390,Rúpél,thrall,664,demonhunter,havoc,24,7,17
3391,Selvagg,archimonde,662,demonhunter,havoc,24,7,17
3392,Solian,ravencrest,661,demonhunter,havoc,12,7,5
3393,Takeshy,alleria,658,demonhunter,havoc,18,7,11
3394,Vengeful,alonsus,655,demonhunter,havoc,11,7,4
3395,Ёмайл,soulflayer,655,demonhunter,havoc,18,7,11
3396,Anishara,die-nachtwache,653,demonhunter,havoc,19,8,11
3397,Летучий,howling-fjord,638,demonhunter,havoc,14,8,6
3398,Emmunka,drakthul,638,demonhunter,havoc,17,7,10
3399,Lexxdh,blackmoore,637,demonhunter,havoc,14,8,6
3400,Snelle,outland,624,demonhunter,havoc,15,7,8
3401,Harha,stormscale,623,demonhunter,havoc,11,7,4
3402,Подкрадунзай,soulflayer,621,demonhunter,havoc,12,9,3
3403,Makhabunda,terokkar,618,demonhunter,havoc,28,8,20
3404,Hyperflex,blackrock,608,demonhunter,havoc,16,7,9
3405,Inolia,argent-dawn,608,demonhunter,havoc,16,7,9
3406,Phalekxox,ravencrest,607,demonhunter,havoc,11,7,4
3407,Солстрэйл,gordunni,607,demonhunter,havoc,17,7,10
3408,Innostigma,dalaran,607,demonhunter,havoc,20,7,13
3409,Predatrix,khaz-modan,606,demonhunter,havoc,14,7,7
3410,Calainis,twisting-nether,606,demonhunter,havoc,14,7,7
3411,Линдорм,deathguard,603,demonhunter,havoc,14,7,7
3412,Nahlendris,darkmoon-faire,596,demonhunter,havoc,16,7,9
3413,Firstwolf,twisting-nether,576,demonhunter,havoc,6,6,0
3414,Fôns,sanguino,576,demonhunter,havoc,6,6,0
3415,Ratho,ragnaros,576,demonhunter,havoc,6,6,0
3416,Mímð,ravencrest,576,demonhunter,havoc,6,6,0
3417,Alasune,twisting-nether,576,demonhunter,havoc,6,6,0
3418,Like,shattrath,576,demonhunter,havoc,14,7,7
3419,Friidaadh,lightbringer,576,demonhunter,havoc,12,6,6
3420,Malethrienna,argent-dawn,576,demonhunter,havoc,12,6,6
3421,Noovedh,ravencrest,576,demonhunter,havoc,12,6,6
3422,Velvetrain,ravencrest,576,demonhunter,havoc,12,6,6
3423,Peacedopice,drakthul,576,demonhunter,havoc,12,6,6
3424,Demonzøku,ravencrest,576,demonhunter,havoc,12,6,6
3425,Sandem,blackrock,576,demonhunter,havoc,12,6,6
3426,Gangstaboy,nemesis,576,demonhunter,havoc,12,6,6
3427,Kazeha,tarren-mill,576,demonhunter,havoc,12,6,6
3428,Mendøøza,hyjal,576,demonhunter,havoc,12,6,6
3429,Zelidh,korgall,576,demonhunter,havoc,12,6,6
3430,Ferrero,guldan,576,demonhunter,havoc,12,6,6
3431,Kyuzo,sanguino,576,demonhunter,havoc,12,6,6
3432,Rhinozerg,kazzak,576,demonhunter,havoc,12,6,6
3433,Alrashidi,ravencrest,576,demonhunter,havoc,12,6,6
3434,Lòsêr,ravencrest,576,demonhunter,havoc,12,6,6
3435,Mythnimue,tarren-mill,576,demonhunter,havoc,12,6,6
3436,Bayerd,burning-legion,576,demonhunter,havoc,12,6,6
3437,Нулевыйчел,gordunni,576,demonhunter,havoc,12,6,6
3438,Adírael,cthun,576,demonhunter,havoc,12,6,6
3439,Анавеллка,howling-fjord,576,demonhunter,havoc,12,6,6
3440,Swearix,twisting-nether,576,demonhunter,havoc,12,6,6
3441,Lanaël,kaelthas,576,demonhunter,havoc,12,6,6
3442,Pyleá,malganis,576,demonhunter,havoc,12,6,6
3443,Spiriteru,archimonde,576,demonhunter,havoc,12,6,6
3444,Jaace,silvermoon,576,demonhunter,havoc,12,6,6
3445,Ailisdmgbotx,drakthul,576,demonhunter,havoc,12,6,6
3446,Lurtéx,kazzak,576,demonhunter,havoc,12,6,6
3447,Länika,drakthul,576,demonhunter,havoc,12,6,6
3448,Yarudh,blackrock,576,demonhunter,havoc,12,6,6
3449,Вафлистикус,ashenvale,576,demonhunter,havoc,12,6,6
3450,Tëvnic,kazzak,576,demonhunter,havoc,12,6,6
3451,Calicó,draenor,576,demonhunter,havoc,12,6,6
3452,Rasmekul,defias-brotherhood,576,demonhunter,havoc,12,6,6
3453,Xyrs,draenor,576,demonhunter,havoc,12,6,6
3454,Shotraklul,zuljin,576,demonhunter,havoc,12,6,6
3455,Miyxcu,aegwynn,576,demonhunter,havoc,12,6,6
3456,Qtt,arthas,576,demonhunter,havoc,12,6,6
3457,Tetedechaise,archimonde,576,demonhunter,havoc,12,6,6
3458,Soulmortal,draenor,576,demonhunter,havoc,12,6,6
3459,Avadåra,stormscale,576,demonhunter,havoc,12,6,6
3460,Stickihunt,malganis,576,demonhunter,havoc,12,6,6
3461,Mortyb,kazzak,576,demonhunter,havoc,12,6,6
3462,Брилаброви,soulflayer,576,demonhunter,havoc,12,6,6
3463,Lezzo,tarren-mill,576,demonhunter,havoc,12,6,6
3464,Hatemaker,burning-legion,576,demonhunter,havoc,15,7,8
3465,Shreeð,blackmoore,576,demonhunter,havoc,16,7,9
3466,Mettdaemon,ravencrest,576,demonhunter,havoc,18,6,12
3467,Inasyndre,argent-dawn,576,demonhunter,havoc,18,6,12
3468,Dèsdemøna,nemesis,576,demonhunter,havoc,18,6,12
3469,Axxad,kazzak,576,demonhunter,havoc,18,6,12
3470,Chíwas,outland,576,demonhunter,havoc,18,6,12
3471,Pinx,archimonde,576,demonhunter,havoc,18,6,12
3472,Riñ,twisting-nether,576,demonhunter,havoc,18,6,12
3473,Nøøßønline,hyjal,576,demonhunter,havoc,18,6,12
3474,Bämbøué,hyjal,576,demonhunter,havoc,18,6,12
3475,Blueformeld,draenor,576,demonhunter,havoc,18,6,12
3476,Shyoxdh,twisting-nether,576,demonhunter,havoc,18,6,12
3477,Blish,blackhand,576,demonhunter,havoc,18,6,12
3478,Alandiel,twisting-nether,576,demonhunter,havoc,18,6,12
3479,Zaÿn,antonidas,576,demonhunter,havoc,18,6,12
3480,Songur,blackhand,576,demonhunter,havoc,18,6,12
3481,Pèpsì,kazzak,576,demonhunter,havoc,24,6,18
3482,Стараятварь,thermaplugg,576,demonhunter,havoc,24,6,18
3483,Redgi,tarren-mill,576,demonhunter,havoc,24,6,18
3484,Shizuuli,outland,576,demonhunter,havoc,30,6,24
3485,Devilord,sanguino,575,demonhunter,havoc,12,6,6
3486,Saftad,outland,575,demonhunter,havoc,12,6,6
3487,Nameerr,ragnaros,575,demonhunter,havoc,12,6,6
3488,Spicysteve,tarren-mill,575,demonhunter,havoc,12,6,6
3489,Extraxtreme,ravencrest,575,demonhunter,havoc,12,6,6
3490,Instinctivee,sylvanas,575,demonhunter,havoc,12,6,6
3491,Kramixx,thrall,575,demonhunter,havoc,12,6,6
3492,Lailâh,blackmoore,575,demonhunter,havoc,12,6,6
3493,Nerudas,blackhand,575,demonhunter,havoc,12,6,6
3494,Davdavdh,tarren-mill,575,demonhunter,havoc,12,6,6
3495,Jimlast,eredar,575,demonhunter,havoc,12,6,6
3496,Nassou,hyjal,575,demonhunter,havoc,12,6,6
3497,Valshatt,sanguino,575,demonhunter,havoc,12,6,6
3498,Arløw,archimonde,575,demonhunter,havoc,16,7,9
3499,Brolycoly,stormscale,575,demonhunter,havoc,16,6,10
3500,Нокаруру,gordunni,575,demonhunter,havoc,18,6,12
3501,Зедю,howling-fjord,575,demonhunter,havoc,18,6,12
3502,Joezus,draenor,575,demonhunter,havoc,18,6,12
3503,Kaylaz,eredar,575,demonhunter,havoc,18,6,12
3504,Candylicks,kazzak,575,demonhunter,havoc,18,6,12
3505,Julmia,dragonblight,575,demonhunter,havoc,24,6,18
3506,Sangita,tarren-mill,574,demonhunter,havoc,12,6,6
3507,Mdåll,chogall,574,demonhunter,havoc,12,6,6
3508,Ôlowain,blackmoore,574,demonhunter,havoc,18,6,12
3509,Talwen,guldan,573,demonhunter,havoc,12,6,6
3510,Klave,argent-dawn,573,demonhunter,havoc,18,6,12
3511,Elindoria,dalaran,572,demonhunter,havoc,12,6,6
3512,Kaletoq,ragnaros,572,demonhunter,havoc,16,6,10
3513,Arxaxe,sanguino,571,demonhunter,havoc,12,6,6
3514,Hamssterek,magtheridon,571,demonhunter,havoc,18,6,12
3515,Caria,twisting-nether,570,demonhunter,havoc,12,6,6
3516,Bahmut,argent-dawn,569,demonhunter,havoc,12,6,6
3517,Ysanix,drakthul,568,demonhunter,havoc,12,6,6
3518,Dàrkinette,archimonde,566,demonhunter,havoc,12,6,6
3519,Glerog,ragnaros,558,demonhunter,havoc,10,7,3
3520,Kranta,blackmoore,544,demonhunter,havoc,16,8,8
3521,Tzigonline,silvermoon,542,demonhunter,havoc,17,6,11
3522,Foxylama,stormscale,528,demonhunter,havoc,15,7,8
3523,Panejo,drakthul,528,demonhunter,havoc,15,6,9
3524,Хисаго,gordunni,522,demonhunter,havoc,15,7,8
3525,Beraxulus,aegwynn,522,demonhunter,havoc,16,7,9
3526,Алистреель,gordunni,521,demonhunter,havoc,13,7,6
3527,Gnjurac,outland,511,demonhunter,havoc,14,6,8
3528,Asperity,antonidas,511,demonhunter,havoc,18,6,12
3529,Cmi,tarren-mill,511,demonhunter,havoc,22,6,16
3530,Неффкодх,howling-fjord,496,demonhunter,havoc,13,6,7
3531,Illidancz,thunderhorn,488,demonhunter,havoc,13,6,7
3532,Lesamaritain,ysondre,480,demonhunter,havoc,6,5,1
3533,Эрнерион,soulflayer,480,demonhunter,havoc,6,5,1
3534,Nanába,draenor,480,demonhunter,havoc,6,5,1
3535,Avavidh,blackmoore,480,demonhunter,havoc,6,5,1
3536,Guziel,kazzak,480,demonhunter,havoc,6,5,1
3537,Ismelldemons,silvermoon,480,demonhunter,havoc,6,5,1
3538,Bruxdh,colinas-pardas,480,demonhunter,havoc,6,5,1
3539,Demongodxx,twisting-nether,480,demonhunter,havoc,6,5,1
3540,Mouga,hyjal,480,demonhunter,havoc,6,5,1
3541,Monion,defias-brotherhood,480,demonhunter,havoc,6,5,1
3542,Нсэнс,soulflayer,480,demonhunter,havoc,6,5,1
3543,Marrie,area-52,480,demonhunter,havoc,6,5,1
3544,Morrion,blackmoore,480,demonhunter,havoc,6,5,1
3545,Miscodedh,ravencrest,480,demonhunter,havoc,9,6,3
3546,Подэхилла,galakrond,480,demonhunter,havoc,10,6,4
3547,Superchocowo,sanguino,480,demonhunter,havoc,12,5,7
3548,Revérse,stormscale,480,demonhunter,havoc,12,5,7
3549,Tatoos,bronze-dragonflight,480,demonhunter,havoc,12,5,7
3550,Dzikalocha,burning-legion,480,demonhunter,havoc,12,5,7
3551,Tomkis,ravencrest,480,demonhunter,havoc,12,5,7
3552,Ukumeqt,kazzak,480,demonhunter,havoc,12,5,7
3553,Atlizzdh,twisting-nether,480,demonhunter,havoc,12,5,7
3554,Tozpak,sylvanas,480,demonhunter,havoc,12,5,7
3555,Huntoverkill,hyjal,480,demonhunter,havoc,12,5,7
3556,Thelyan,ravencrest,480,demonhunter,havoc,12,5,7
3557,Tastyblades,blackmoore,480,demonhunter,havoc,12,5,7
3558,Ourius,blackmoore,480,demonhunter,havoc,12,5,7
3559,Thrina,blackmoore,480,demonhunter,havoc,12,5,7
3560,Spitface,aegwynn,480,demonhunter,havoc,12,5,7
3561,Eibemme,alleria,480,demonhunter,havoc,12,5,7
3562,Диртхамен,blackscar,480,demonhunter,havoc,12,5,7
3563,Zunada,ragnaros,480,demonhunter,havoc,12,5,7
3564,Takad,twisting-nether,480,demonhunter,havoc,12,5,7
3565,Caøtix,blackrock,480,demonhunter,havoc,12,5,7
3566,Khenetai,silvermoon,480,demonhunter,havoc,12,5,7
3567,Actarüs,hyjal,480,demonhunter,havoc,12,5,7
3568,Lyanadh,blackhand,480,demonhunter,havoc,12,5,7
3569,Zumbly,silvermoon,480,demonhunter,havoc,12,5,7
3570,Nagh,archimonde,480,demonhunter,havoc,12,5,7
3571,Kukulkanx,tarren-mill,480,demonhunter,havoc,12,5,7
3572,Véspé,naxxramas,480,demonhunter,havoc,12,5,7
3573,Blind,kazzak,480,demonhunter,havoc,12,5,7
3574,Dhaosh,nemesis,480,demonhunter,havoc,12,5,7
3575,Пупчански,howling-fjord,480,demonhunter,havoc,12,5,7
3576,Atômik,drakthul,480,demonhunter,havoc,12,5,7
3577,Darrkmoff,sylvanas,480,demonhunter,havoc,12,5,7
3578,Алекзей,gordunni,480,demonhunter,havoc,12,5,7
3579,Максимлолпро,howling-fjord,480,demonhunter,havoc,12,5,7
3580,Trickstero,ragnaros,480,demonhunter,havoc,12,5,7
3581,Hakakuri,ravencrest,480,demonhunter,havoc,12,5,7
3582,Topg,bladefist,480,demonhunter,havoc,12,5,7
3583,Glìmpsêgøðx,antonidas,480,demonhunter,havoc,12,5,7
3584,Tthic,shadowsong,480,demonhunter,havoc,12,5,7
3585,Demondusk,silvermoon,480,demonhunter,havoc,12,5,7
3586,Natzú,ravencrest,480,demonhunter,havoc,12,5,7
3587,Шликшлик,blackscar,480,demonhunter,havoc,12,5,7
3588,Malzehar,tarren-mill,480,demonhunter,havoc,12,5,7
3589,Giftìg,ravencrest,480,demonhunter,havoc,12,5,7
3590,Freddh,blackrock,480,demonhunter,havoc,12,5,7
3591,Филеровщик,deathguard,480,demonhunter,havoc,12,5,7
3592,Noether,blackrock,480,demonhunter,havoc,12,5,7
3593,Дракомуфлон,gordunni,480,demonhunter,havoc,12,5,7
3594,Ferndejar,draenor,480,demonhunter,havoc,12,5,7
3595,Korrupt,draenor,480,demonhunter,havoc,12,5,7
3596,Блэйэмих,gordunni,480,demonhunter,havoc,12,5,7
3597,Kiwicrash,tarren-mill,480,demonhunter,havoc,15,6,9
3598,Shyynedh,grim-batol,480,demonhunter,havoc,15,6,9
3599,Dübler,gorgonnash,480,demonhunter,havoc,18,5,13
3600,Natarásh,blackmoore,480,demonhunter,havoc,18,5,13
3601,Разагеш,gordunni,480,demonhunter,havoc,18,5,13
3602,Crushidemon,draenor,480,demonhunter,havoc,18,5,13
3603,Wajoglaive,blackhand,480,demonhunter,havoc,18,5,13
3604,Gagfordaddy,ravencrest,480,demonhunter,havoc,18,5,13
3605,Lovesong,the-shatar,480,demonhunter,havoc,18,5,13
3606,Aelina,area-52,480,demonhunter,havoc,18,5,13
3607,Talyrîs,aegwynn,480,demonhunter,havoc,18,5,13
3608,Dharuel,cthun,480,demonhunter,havoc,18,5,13
3609,Zimmerdin,blackmoore,480,demonhunter,havoc,18,5,13
3610,Каталейна,howling-fjord,480,demonhunter,havoc,24,5,19
3611,Dontrunaway,tarren-mill,479,demonhunter,havoc,6,5,1
3612,Кевалат,gordunni,479,demonhunter,havoc,6,5,1
3613,Sholon,kiljaeden,479,demonhunter,havoc,6,5,1
3614,Ridweng,ravenholdt,479,demonhunter,havoc,7,5,2
3615,Cindras,turalyon,479,demonhunter,havoc,12,5,7
3616,Макай,deathguard,479,demonhunter,havoc,12,5,7
3617,Jonasdh,antonidas,479,demonhunter,havoc,12,5,7
3618,Shekny,sanguino,479,demonhunter,havoc,12,5,7
3619,Mandemz,nagrand,479,demonhunter,havoc,12,5,7
3620,Dedaronnes,hyjal,479,demonhunter,havoc,12,5,7
3621,Gryphory,ravencrest,479,demonhunter,havoc,12,5,7
3622,Merilidan,blackrock,479,demonhunter,havoc,12,5,7
3623,Demontevz,outland,479,demonhunter,havoc,12,5,7
3624,Approxis,archimonde,479,demonhunter,havoc,12,5,7
3625,Rtz,malfurion,479,demonhunter,havoc,12,5,7
3626,Bluespe,twisting-nether,479,demonhunter,havoc,12,5,7
3627,Chàuvequipeu,dalaran,479,demonhunter,havoc,12,5,7
3628,Demonwithin,nerathor,479,demonhunter,havoc,18,5,13
3629,Thilanea,emeriss,478,demonhunter,havoc,12,5,7
3630,Deasdh,tarren-mill,478,demonhunter,havoc,12,5,7
3631,Скудайвер,gordunni,478,demonhunter,havoc,12,5,7
3632,Karxarias,silvermoon,478,demonhunter,havoc,12,5,7
3633,Greyfel,blackhand,478,demonhunter,havoc,20,7,13
3634,Samurase,kazzak,477,demonhunter,havoc,12,5,7
3635,Kairidemon,eredar,477,demonhunter,havoc,12,5,7
3636,Гёнке,gordunni,477,demonhunter,havoc,22,6,16
3637,Гачирабыня,lich-king,477,demonhunter,havoc,30,5,25
3638,Vincbengt,tarren-mill,476,demonhunter,havoc,12,5,7
3639,Sorgnarol,dalaran,475,demonhunter,havoc,12,5,7
3640,Cometofloki,outland,475,demonhunter,havoc,12,5,7
3641,Hellforce,nemesis,474,demonhunter,havoc,12,5,7
3642,Illikan,stormscale,474,demonhunter,havoc,12,5,7
3643,Etraidor,turalyon,473,demonhunter,havoc,12,5,7
3644,Кислотна,borean-tundra,471,demonhunter,havoc,13,5,8
3645,Cameclc,hyjal,448,demonhunter,havoc,16,5,11
3646,Shaundead,drakthul,447,demonhunter,havoc,11,5,6
3647,Илнари,soulflayer,447,demonhunter,havoc,11,5,6
3648,Shironeko,ysondre,447,demonhunter,havoc,11,5,6
3649,Иллианэль,howling-fjord,432,demonhunter,havoc,9,5,4
3650,Акамамба,gordunni,431,demonhunter,havoc,11,5,6
3651,Buttslapper,silvermoon,426,demonhunter,havoc,20,6,14
3652,Bertori,dun-modr,416,demonhunter,havoc,10,5,5
3653,Jïsoo,blackhand,416,demonhunter,havoc,16,5,11
3654,Çhïñêséðëmøñ,draenor,384,demonhunter,havoc,6,4,2
3655,Niellarsc,ravencrest,384,demonhunter,havoc,6,4,2
3656,Spacedance,silvermoon,384,demonhunter,havoc,6,4,2
3657,Nelathas,twisting-nether,384,demonhunter,havoc,6,4,2
3658,Diagonol,ragnaros,384,demonhunter,havoc,6,4,2
3659,Puppygf,ravencrest,384,demonhunter,havoc,6,4,2
3660,Милифесена,gordunni,384,demonhunter,havoc,6,4,2
3661,Rageglaive,ragnaros,384,demonhunter,havoc,6,4,2
3662,Mýg,ravencrest,384,demonhunter,havoc,6,4,2
3663,Mäxo,frostwolf,384,demonhunter,havoc,6,4,2
3664,Lemondehunta,twisting-nether,384,demonhunter,havoc,6,4,2
3665,Adexi,twisting-nether,384,demonhunter,havoc,6,4,2
3666,Dimonhunta,tarren-mill,384,demonhunter,havoc,6,4,2
3667,Tzs,blackrock,384,demonhunter,havoc,6,4,2
3668,Талисзора,gordunni,384,demonhunter,havoc,6,4,2
3669,Nxtpls,silvermoon,384,demonhunter,havoc,6,4,2
3670,Onkwang,twisting-nether,384,demonhunter,havoc,6,4,2
3671,Kriszidan,arathor,384,demonhunter,havoc,6,4,2
3672,Fiduci,archimonde,384,demonhunter,havoc,6,4,2
3673,Apsodemon,twisting-nether,384,demonhunter,havoc,6,4,2
3674,Soulstacker,outland,384,demonhunter,havoc,6,4,2
3675,Khrtdh,silvermoon,384,demonhunter,havoc,6,4,2
3676,Atti,the-maelstrom,384,demonhunter,havoc,6,4,2
3677,Vidagín,blackmoore,384,demonhunter,havoc,6,4,2
3678,Akaniiaa,blackmoore,384,demonhunter,havoc,6,4,2
3679,Iken,ragnaros,384,demonhunter,havoc,6,4,2
3680,Klerikerin,blackmoore,384,demonhunter,havoc,6,4,2
3681,Bartoshek,auchindoun,384,demonhunter,havoc,6,4,2
3682,Liladan,sylvanas,384,demonhunter,havoc,6,4,2
3683,Falanar,ysondre,384,demonhunter,havoc,6,4,2
3684,Morthorr,grim-batol,384,demonhunter,havoc,6,4,2
3685,Ðéstrøz,draenor,384,demonhunter,havoc,6,4,2
3686,Demoncalle,the-maelstrom,384,demonhunter,havoc,6,4,2
3687,Docos,genjuros,384,demonhunter,havoc,6,4,2
3688,Dakydh,ravencrest,384,demonhunter,havoc,6,4,2
3689,Sickdoci,kazzak,384,demonhunter,havoc,6,4,2
3690,Exerzaria,twisting-nether,384,demonhunter,havoc,6,4,2
3691,Timitär,mazrigos,384,demonhunter,havoc,6,4,2
3692,Lëtho,colinas-pardas,384,demonhunter,havoc,6,4,2
3693,Shinsen,archimonde,384,demonhunter,havoc,6,4,2
3694,Деирдевил,blackscar,384,demonhunter,havoc,6,4,2
3695,Blankdh,outland,384,demonhunter,havoc,6,4,2
3696,Varonx,drakthul,384,demonhunter,havoc,6,4,2
3697,Garra,chants-éternels,384,demonhunter,havoc,6,4,2
3698,Manybuttons,tarren-mill,384,demonhunter,havoc,6,4,2
3699,Anwenox,argent-dawn,384,demonhunter,havoc,6,4,2
3700,Shïca,sanguino,384,demonhunter,havoc,6,4,2
3701,Avnanof,draenor,384,demonhunter,havoc,6,4,2
3702,Gotwings,sunstrider,384,demonhunter,havoc,6,4,2
3703,Bosskuw,kazzak,384,demonhunter,havoc,6,4,2
3704,Maupau,ravencrest,384,demonhunter,havoc,6,4,2
3705,Wuzzabi,darksorrow,384,demonhunter,havoc,6,4,2
3706,Valdrake,burning-legion,384,demonhunter,havoc,6,4,2
3707,Jennyßright,sargeras,384,demonhunter,havoc,6,4,2
3708,Memedhbtw,outland,384,demonhunter,havoc,6,4,2
3709,Imprøve,ravencrest,384,demonhunter,havoc,9,5,4
3710,Darmash,ambossar,384,demonhunter,havoc,9,5,4
3711,Freakerzoid,kazzak,384,demonhunter,havoc,11,4,7
3712,Cutforshred,zenedar,384,demonhunter,havoc,12,4,8
3713,Illidarios,blackhand,384,demonhunter,havoc,12,4,8
3714,Gorilla,korgall,384,demonhunter,havoc,12,4,8
3715,Saikamango,blackhand,384,demonhunter,havoc,12,4,8
3716,Rivy,magtheridon,384,demonhunter,havoc,12,4,8
3717,Arkta,kazzak,384,demonhunter,havoc,12,4,8
3718,Bratti,kazzak,384,demonhunter,havoc,12,4,8
3719,Rúllio,rexxar,384,demonhunter,havoc,12,4,8
3720,Хреньещёта,booty-bay,384,demonhunter,havoc,12,4,8
3721,Mempaan,magtheridon,384,demonhunter,havoc,12,4,8
3722,Leylas,nagrand,384,demonhunter,havoc,12,4,8
3723,Лупидолх,soulflayer,384,demonhunter,havoc,12,4,8
3724,Becknárn,sylvanas,384,demonhunter,havoc,12,4,8
3725,Ascindra,kazzak,384,demonhunter,havoc,12,4,8
3726,Артёмблэйдх,blackscar,384,demonhunter,havoc,12,4,8
3727,Jabuzi,drakthul,384,demonhunter,havoc,12,4,8
3728,Akkixy,die-aldor,384,demonhunter,havoc,12,4,8
3729,Betterdk,twilights-hammer,384,demonhunter,havoc,12,4,8
3730,Exodlia,silvermoon,384,demonhunter,havoc,12,4,8
3731,Братилидана,gordunni,384,demonhunter,havoc,12,4,8
3732,Xendrina,blackrock,384,demonhunter,havoc,12,4,8
3733,Fbh,stormscale,384,demonhunter,havoc,12,4,8
3734,Lenuna,frostmourne,384,demonhunter,havoc,12,4,8
3735,Mouz,thrall,384,demonhunter,havoc,12,4,8
3736,Алмантиус,gordunni,384,demonhunter,havoc,12,4,8
3737,Хокану,gordunni,384,demonhunter,havoc,12,4,8
3738,Одзангейра,blackscar,384,demonhunter,havoc,12,4,8
3739,Graffyre,eonar,384,demonhunter,havoc,12,4,8
3740,Папичгодх,borean-tundra,384,demonhunter,havoc,12,4,8
3741,Voicechat,tarren-mill,384,demonhunter,havoc,12,4,8
3742,Pokálen,drakthul,384,demonhunter,havoc,12,4,8
3743,Demondik,aggramar,384,demonhunter,havoc,12,4,8
3744,Ninjantiz,antonidas,384,demonhunter,havoc,12,4,8
3745,Floridaboy,ravencrest,384,demonhunter,havoc,12,4,8
3746,Koger,twisting-nether,384,demonhunter,havoc,12,4,8
3747,Frostidh,ysondre,384,demonhunter,havoc,12,4,8
3748,Drædløcks,ysondre,384,demonhunter,havoc,12,4,8
3749,Alleyezønme,outland,384,demonhunter,havoc,12,4,8
3750,Hatred,argent-dawn,384,demonhunter,havoc,12,4,8
3751,Deadrawdh,aegwynn,384,demonhunter,havoc,12,4,8
3752,Mamio,chogall,384,demonhunter,havoc,12,4,8
3753,Maeltus,hyjal,384,demonhunter,havoc,12,4,8
3754,Deathbydeaf,terenas,384,demonhunter,havoc,12,4,8
3755,Nephylon,draenor,384,demonhunter,havoc,12,4,8
3756,Blüëräin,draenor,384,demonhunter,havoc,12,4,8
3757,Innocuouss,twisting-nether,384,demonhunter,havoc,12,4,8
3758,Ågøny,outland,384,demonhunter,havoc,12,4,8
3759,Dannyp,ravencrest,384,demonhunter,havoc,12,4,8
3760,Ázârìûs,draenor,384,demonhunter,havoc,12,4,8
3761,Stormshred,stormscale,384,demonhunter,havoc,13,4,9
3762,Asukakazama,twisting-nether,384,demonhunter,havoc,15,4,11
3763,Skajlan,burning-legion,384,demonhunter,havoc,18,4,14
3764,Gouteça,la-croisade-écarlate,384,demonhunter,havoc,18,4,14
3765,Sazukè,blackmoore,384,demonhunter,havoc,18,4,14
3766,Ekhlipz,ysondre,384,demonhunter,havoc,18,4,14
3767,Dìus,blackmoore,384,demonhunter,havoc,18,4,14
3768,Linea,jaedenar,384,demonhunter,havoc,18,4,14
3769,Poliex,khaz-modan,383,demonhunter,havoc,6,4,2
3770,Tiucciah,kirin-tor,383,demonhunter,havoc,6,4,2
3771,Némesîs,cthun,383,demonhunter,havoc,6,4,2
3772,Rouzi,defias-brotherhood,383,demonhunter,havoc,6,4,2
3773,Yocolo,sinstralis,383,demonhunter,havoc,6,4,2
3774,Zaeros,archimonde,383,demonhunter,havoc,6,4,2
3775,Vengatoria,cthun,383,demonhunter,havoc,12,4,8
3776,Elenastar,kazzak,383,demonhunter,havoc,12,4,8
3777,Thelanora,zirkel-des-cenarius,383,demonhunter,havoc,12,4,8
3778,Сязекть,goldrinn,383,demonhunter,havoc,12,4,8
3779,Chaordic,turalyon,383,demonhunter,havoc,12,4,8
3780,Шоеррей,gordunni,383,demonhunter,havoc,12,4,8
3781,Lillinète,archimonde,383,demonhunter,havoc,18,4,14
3782,Demoncancer,kazzak,382,demonhunter,havoc,6,4,2
3783,Nazzan,destromath,382,demonhunter,havoc,6,4,2
3784,Rijsel,dalaran,382,demonhunter,havoc,6,4,2
3785,Séleister,khaz-modan,382,demonhunter,havoc,12,4,8
3786,Deathniresa,argent-dawn,379,demonhunter,havoc,12,4,8
3787,Åáäàáåàáäàáå,dun-modr,377,demonhunter,havoc,15,6,9
3788,Elldarion,blackhand,367,demonhunter,havoc,11,4,7
3789,Deamo,stormscale,367,demonhunter,havoc,11,4,7
3790,Блэйденрифтс,soulflayer,351,demonhunter,havoc,11,4,7
3791,Fläsktorped,stormscale,335,demonhunter,havoc,11,4,7
3792,Zavoc,the-maelstrom,319,demonhunter,havoc,8,4,4
3793,Felwaifu,tarren-mill,319,demonhunter,havoc,8,4,4
3794,Squarty,wrathbringer,316,demonhunter,havoc,8,4,4
3795,Froog,frostmane,288,demonhunter,havoc,6,3,3
3796,Imvnrcvr,dalaran,288,demonhunter,havoc,6,3,3
3797,Joeybadass,aegwynn,288,demonhunter,havoc,6,3,3
3798,Nightfly,twisting-nether,288,demonhunter,havoc,6,3,3
3799,Fantabolous,ragnaros,288,demonhunter,havoc,6,3,3
3800,Yelans,twisting-nether,288,demonhunter,havoc,6,3,3
3801,Qualron,twisting-nether,288,demonhunter,havoc,6,3,3
3802,Aoeshu,wildhammer,288,demonhunter,havoc,6,3,3
3803,Indominus,pozzo-delleternità,288,demonhunter,havoc,6,3,3
3804,Extitan,twisting-nether,288,demonhunter,havoc,6,3,3
3805,Kyart,nemesis,288,demonhunter,havoc,6,3,3
3806,Чубрик,howling-fjord,288,demonhunter,havoc,6,3,3
3807,Zsídakabra,ragnaros,288,demonhunter,havoc,6,3,3
3808,Uranoth,nemesis,288,demonhunter,havoc,6,3,3
3809,Cursedblade,archimonde,288,demonhunter,havoc,6,3,3
3810,Батявздане,soulflayer,288,demonhunter,havoc,6,3,3
3811,Резако,soulflayer,288,demonhunter,havoc,6,3,3
3812,Андрюхадх,soulflayer,288,demonhunter,havoc,6,3,3
3813,Bunzi,sylvanas,288,demonhunter,havoc,6,3,3
3814,Шрэдэр,thermaplugg,288,demonhunter,havoc,6,3,3
3815,Lonedh,sylvanas,288,demonhunter,havoc,6,3,3
3816,Ксен,howling-fjord,288,demonhunter,havoc,6,3,3
3817,Норилайнн,gordunni,288,demonhunter,havoc,6,3,3
3818,Тиктокденсер,gordunni,288,demonhunter,havoc,6,3,3
3819,Ашерис,deathguard,288,demonhunter,havoc,6,3,3
3820,Akhyra,ysondre,288,demonhunter,havoc,6,3,3
3821,Mephilax,stormscale,288,demonhunter,havoc,6,3,3
3822,Coca,stormreaver,288,demonhunter,havoc,6,3,3
3823,Marilu,nathrezim,288,demonhunter,havoc,6,3,3
3824,Vtoriavgust,silvermoon,288,demonhunter,havoc,6,3,3
3825,Morow,die-ewige-wacht,288,demonhunter,havoc,6,3,3
3826,Divia,anubarak,288,demonhunter,havoc,6,3,3
3827,Kritflake,blackrock,288,demonhunter,havoc,6,3,3
3828,Älger,archimonde,288,demonhunter,havoc,6,3,3
3829,Youngfelrush,blackrock,288,demonhunter,havoc,6,3,3
3830,Ailis,drakthul,288,demonhunter,havoc,6,3,3
3831,Cienlowczyni,silvermoon,288,demonhunter,havoc,6,3,3
3832,Killaden,ravenholdt,288,demonhunter,havoc,6,3,3
3833,Schwitte,tichondrius,288,demonhunter,havoc,6,3,3
3834,Xocotl,blackmoore,288,demonhunter,havoc,6,3,3
3835,Crueldo,silvermoon,288,demonhunter,havoc,6,3,3
3836,Vqqxx,stormreaver,288,demonhunter,havoc,6,3,3
3837,Hyonzyyesh,silvermoon,288,demonhunter,havoc,6,3,3
3838,Fredhy,tarren-mill,288,demonhunter,havoc,6,3,3
3839,Jörgböhme,blackhand,288,demonhunter,havoc,6,3,3
3840,Neony,blackmoore,288,demonhunter,havoc,6,3,3
3841,Damenhunter,malganis,288,demonhunter,havoc,6,3,3
3842,Xénôns,archimonde,288,demonhunter,havoc,6,3,3
3843,Dadagodx,kazzak,288,demonhunter,havoc,6,3,3
3844,Tåkotsubo,archimonde,288,demonhunter,havoc,6,3,3
3845,Aaryaa,archimonde,288,demonhunter,havoc,6,3,3
3846,Factcox,magtheridon,288,demonhunter,havoc,6,3,3
3847,Demonsushi,tarren-mill,288,demonhunter,havoc,6,3,3
3848,Leïaprincess,hyjal,288,demonhunter,havoc,6,3,3
3849,Hellboi,dun-modr,288,demonhunter,havoc,6,3,3
3850,Jellyjoker,malganis,288,demonhunter,havoc,6,3,3
3851,Cánoo,blackhand,288,demonhunter,havoc,6,3,3
3852,Luciferio,quelthalas,288,demonhunter,havoc,6,3,3
3853,Vlexsuave,stormscale,288,demonhunter,havoc,6,3,3
3854,Dàrknight,azjolnerub,288,demonhunter,havoc,6,3,3
3855,Shaadraz,stormscale,288,demonhunter,havoc,6,3,3
3856,Ortä,sanguino,288,demonhunter,havoc,6,3,3
3857,Hárald,sanguino,288,demonhunter,havoc,6,3,3
3858,Grifht,zuljin,288,demonhunter,havoc,6,3,3
3859,Mephedroni,kazzak,288,demonhunter,havoc,6,3,3
3860,Catchmebaby,sanguino,288,demonhunter,havoc,6,3,3
3861,Nneverx,bladefist,288,demonhunter,havoc,6,3,3
3862,Cnbâckbb,archimonde,288,demonhunter,havoc,6,3,3
3863,Sionar,kazzak,288,demonhunter,havoc,6,3,3
3864,Demonyz,hyjal,288,demonhunter,havoc,6,3,3
3865,Ravae,burning-legion,288,demonhunter,havoc,6,3,3
3866,Rehaell,burning-legion,288,demonhunter,havoc,6,3,3
3867,Sfguild,kazzak,288,demonhunter,havoc,6,3,3
3868,Makwah,kazzak,288,demonhunter,havoc,6,3,3
3869,Naargof,outland,288,demonhunter,havoc,6,3,3
3870,Crasyface,kazzak,288,demonhunter,havoc,6,3,3
3871,Deschacke,eredar,288,demonhunter,havoc,6,3,3
3872,Ostosbigego,ravencrest,288,demonhunter,havoc,6,3,3
3873,Meserani,eredar,288,demonhunter,havoc,6,3,3
3874,Kyoukaii,kazzak,288,demonhunter,havoc,6,3,3
3875,Hogidan,hellscream,288,demonhunter,havoc,6,3,3
3876,Âstræa,antonidas,288,demonhunter,havoc,6,3,3
3877,Cydonia,medivh,288,demonhunter,havoc,6,3,3
3878,Blizó,tarren-mill,288,demonhunter,havoc,6,3,3
3879,Lundí,tarren-mill,288,demonhunter,havoc,6,3,3
3880,Tígél,argent-dawn,288,demonhunter,havoc,6,3,3
3881,Richielou,outland,288,demonhunter,havoc,6,3,3
3882,Terboven,outland,288,demonhunter,havoc,6,3,3
3883,Tire,draenor,288,demonhunter,havoc,6,3,3
3884,Na,conseil-des-ombres,288,demonhunter,havoc,6,3,3
3885,Myuøu,hyjal,288,demonhunter,havoc,6,3,3
3886,Bossmac,mugthol,288,demonhunter,havoc,6,3,3
3887,Shinnu,antonidas,288,demonhunter,havoc,6,3,3
3888,Rustedchurl,draenor,288,demonhunter,havoc,6,3,3
3889,Archadric,ravencrest,288,demonhunter,havoc,6,3,3
3890,Annaboliik,ravencrest,288,demonhunter,havoc,6,3,3
3891,Kätarïnas,confrérie-du-thorium,288,demonhunter,havoc,6,3,3
3892,Ravael,archimonde,288,demonhunter,havoc,6,3,3
3893,Nephthyis,draenor,288,demonhunter,havoc,6,3,3
3894,Filthyape,ravencrest,288,demonhunter,havoc,6,3,3
3895,Alfaa,outland,288,demonhunter,havoc,6,3,3
3896,Wildest,blackmoore,288,demonhunter,havoc,9,4,5
3897,Aethilios,silvermoon,288,demonhunter,havoc,11,3,8
3898,Ðèvìllìà,ragnaros,288,demonhunter,havoc,12,3,9
3899,Metaman,archimonde,288,demonhunter,havoc,12,3,9
3900,Valø,malganis,288,demonhunter,havoc,12,3,9
3901,Neiìf,blackhand,288,demonhunter,havoc,12,3,9
3902,Bosque,ragnaros,288,demonhunter,havoc,12,3,9
3903,Artwar,stormscale,288,demonhunter,havoc,12,3,9
3904,Silandara,grim-batol,288,demonhunter,havoc,12,3,9
3905,Blacklance,ravencrest,288,demonhunter,havoc,12,3,9
3906,Fullinaretta,archimonde,288,demonhunter,havoc,12,3,9
3907,Vulcaan,ravencrest,288,demonhunter,havoc,12,3,9
3908,Gpk,argent-dawn,288,demonhunter,havoc,12,3,9
3909,Bernhoftdh,ravencrest,288,demonhunter,havoc,12,3,9
3910,Tødø,nemesis,288,demonhunter,havoc,12,3,9
3911,Sazzox,blackrock,288,demonhunter,havoc,12,3,9
3912,Ambodh,thrall,288,demonhunter,havoc,12,3,9
3913,Donstyle,anachronos,288,demonhunter,havoc,12,3,9
3914,Nightwalk,blackmoore,288,demonhunter,havoc,12,3,9
3915,Cptgmiasbria,eredar,288,demonhunter,havoc,12,3,9
3916,Naturalis,die-todeskrallen,288,demonhunter,havoc,12,3,9
3917,Domiinator,sylvanas,288,demonhunter,havoc,12,3,9
3918,Râny,blackmoore,288,demonhunter,havoc,12,3,9
3919,Fleshes,draenor,288,demonhunter,havoc,12,3,9
3920,Vänöx,dun-modr,288,demonhunter,havoc,12,3,9
3921,Välhöll,kirin-tor,288,demonhunter,havoc,12,3,9
3922,Milanto,antonidas,288,demonhunter,havoc,12,3,9
3923,Tuffêli,turalyon,288,demonhunter,havoc,12,3,9
3924,Wheelchairdh,twisting-nether,288,demonhunter,havoc,12,3,9
3925,Vrekur,sanguino,288,demonhunter,havoc,12,3,9
3926,Tenaebris,silvermoon,288,demonhunter,havoc,12,3,9
3927,Ïvø,sargeras,288,demonhunter,havoc,12,3,9
3928,Арвулфик,eversong,288,demonhunter,havoc,12,3,9
3929,Rurt,sanguino,288,demonhunter,havoc,12,3,9
3930,Laurana,argent-dawn,288,demonhunter,havoc,12,3,9
3931,Corvox,argent-dawn,288,demonhunter,havoc,12,3,9
3932,Феяужаса,soulflayer,288,demonhunter,havoc,12,3,9
3933,Mordaer,twisting-nether,288,demonhunter,havoc,12,3,9
3934,Гелиосса,soulflayer,288,demonhunter,havoc,12,3,9
3935,Rapp,nemesis,288,demonhunter,havoc,12,3,9
3936,Bengleng,draenor,288,demonhunter,havoc,12,3,9
3937,Хемах,howling-fjord,288,demonhunter,havoc,12,3,9
3938,Vandazza,argent-dawn,288,demonhunter,havoc,12,3,9
3939,Deathsnote,marécage-de-zangar,288,demonhunter,havoc,12,3,9
3940,Lamello,nemesis,288,demonhunter,havoc,12,3,9
3941,Néèdgirly,malfurion,288,demonhunter,havoc,15,3,12
3942,Lasthija,dun-modr,288,demonhunter,havoc,18,3,15
3943,Devildust,ravencrest,288,demonhunter,havoc,18,3,15
3944,Jimdh,quelthalas,288,demonhunter,havoc,18,3,15
3945,Menutzdh,tarren-mill,287,demonhunter,havoc,6,3,3
3946,Saturnein,stormscale,287,demonhunter,havoc,6,3,3
3947,Elfitoloco,sanguino,287,demonhunter,havoc,6,3,3
3948,Dethlyn,twisting-nether,287,demonhunter,havoc,6,3,3
3949,Dimonanta,grim-batol,287,demonhunter,havoc,6,3,3
3950,Gêliôs,kazzak,271,demonhunter,havoc,11,3,8
3951,Dexterzx,stormscale,240,demonhunter,havoc,9,3,6
3952,Nithraim,kazzak,240,demonhunter,havoc,9,3,6
3953,Xaro,quelthalas,239,demonhunter,havoc,5,3,2
3954,Itskarmax,outland,239,demonhunter,havoc,5,3,2
3955,Herax,drakthul,239,demonhunter,havoc,5,3,2
3956,Ponn,blackmoore,239,demonhunter,havoc,5,3,2
3957,Джерегумо,howling-fjord,234,demonhunter,havoc,10,4,6
3958,Ñítøryù,ravencrest,234,demonhunter,havoc,10,4,6
3959,Munamasa,archimonde,234,demonhunter,havoc,11,4,7
3960,Лэймрисх,gordunni,223,demonhunter,havoc,14,3,11
3961,Demoqt,ragnaros,192,demonhunter,havoc,4,3,1
3962,Erenyeagerr,kazzak,192,demonhunter,havoc,4,3,1
3963,Kiô,drakthul,192,demonhunter,havoc,9,3,6
3964,Brolafsen,ragnaros,192,demonhunter,havoc,6,2,4
3965,Маскитол,soulflayer,192,demonhunter,havoc,6,2,4
3966,Razzàl,sinstralis,192,demonhunter,havoc,6,2,4
3967,Lixxersmeta,stormscale,192,demonhunter,havoc,6,2,4
3968,Roxxis,mazrigos,192,demonhunter,havoc,6,2,4
3969,Lexdh,blackrock,192,demonhunter,havoc,6,2,4
3970,Cøldlean,ravencrest,192,demonhunter,havoc,6,2,4
3971,Sñüîîâ,kazzak,192,demonhunter,havoc,6,2,4
3972,Schakalèn,ragnaros,192,demonhunter,havoc,6,2,4
3973,Ybou,archimonde,192,demonhunter,havoc,6,2,4
3974,Kibiri,rajaxx,192,demonhunter,havoc,6,2,4
3975,Heidihauge,silvermoon,192,demonhunter,havoc,6,2,4
3976,Barocs,antonidas,192,demonhunter,havoc,6,2,4
3977,Draecis,twisting-nether,192,demonhunter,havoc,6,2,4
3978,Люблюмеф,gordunni,192,demonhunter,havoc,6,2,4
3979,Ellatriel,blackrock,192,demonhunter,havoc,6,2,4
3980,Mythisa,blackrock,192,demonhunter,havoc,6,2,4
3981,Scarath,eredar,192,demonhunter,havoc,6,2,4
3982,Khrum,rajaxx,192,demonhunter,havoc,6,2,4
3983,Alervius,blackrock,192,demonhunter,havoc,6,2,4
3984,Bananabritta,aegwynn,192,demonhunter,havoc,6,2,4
3985,Omegahunterx,ravencrest,192,demonhunter,havoc,6,2,4
3986,Dayo,archimonde,192,demonhunter,havoc,6,2,4
3987,Martøsdh,uldum,192,demonhunter,havoc,6,2,4
3988,Drahîna,khaz-modan,192,demonhunter,havoc,6,2,4
3989,Лилэйв,gordunni,192,demonhunter,havoc,6,2,4
3990,Деорру,gordunni,192,demonhunter,havoc,6,2,4
3991,Nörsedh,sanguino,192,demonhunter,havoc,6,2,4
3992,Hykoolique,arakarahm,192,demonhunter,havoc,6,2,4
3993,Yataganac,draenor,192,demonhunter,havoc,6,2,4
3994,Sârgan,khaz-modan,192,demonhunter,havoc,6,2,4
3995,Kakovicz,gorgonnash,192,demonhunter,havoc,6,2,4
3996,Haveadad,outland,192,demonhunter,havoc,6,2,4
3997,Datejust,archimonde,192,demonhunter,havoc,6,2,4
3998,Anekk,kazzak,192,demonhunter,havoc,6,2,4
3999,Gendó,twisting-nether,192,demonhunter,havoc,6,2,4
4000,Chaeeri,twisting-nether,192,demonhunter,havoc,6,2,4
4001,Haragazu,blackrock,192,demonhunter,havoc,6,2,4
4002,Draneka,argent-dawn,192,demonhunter,havoc,6,2,4
4003,Czl,silvermoon,192,demonhunter,havoc,6,2,4
4004,Янгфрукт,howling-fjord,192,demonhunter,havoc,6,2,4
4005,Zenô,antonidas,192,demonhunter,havoc,6,2,4
4006,Opvoksterxx,sylvanas,192,demonhunter,havoc,6,2,4
4007,Siio,antonidas,192,demonhunter,havoc,6,2,4
4008,Neimfel,outland,192,demonhunter,havoc,6,2,4
4009,Fèll,silvermoon,192,demonhunter,havoc,6,2,4
4010,Disconecting,outland,192,demonhunter,havoc,6,2,4
4011,Chlorel,arthas,192,demonhunter,havoc,6,2,4
4012,Demontoolz,outland,192,demonhunter,havoc,6,2,4
4013,Tacodhx,ravencrest,192,demonhunter,havoc,6,2,4
4014,Sephy,argent-dawn,192,demonhunter,havoc,6,2,4
4015,Kaelisi,argent-dawn,192,demonhunter,havoc,6,2,4
4016,Lucziane,blackmoore,192,demonhunter,havoc,6,2,4
4017,Alcadejas,pozzo-delleternità,192,demonhunter,havoc,6,2,4
4018,Andariell,sylvanas,192,demonhunter,havoc,6,2,4
4019,Nairra,blackmoore,192,demonhunter,havoc,6,2,4
4020,Emkogødx,outland,192,demonhunter,havoc,6,2,4
4021,Кеиичи,howling-fjord,192,demonhunter,havoc,6,2,4
4022,Mayzhi,hyjal,192,demonhunter,havoc,6,2,4
4023,Qúkn,tarren-mill,192,demonhunter,havoc,6,2,4
4024,Harrah,archimonde,192,demonhunter,havoc,6,2,4
4025,Аврорамур,howling-fjord,192,demonhunter,havoc,6,2,4
4026,Shockzzyydh,ravencrest,192,demonhunter,havoc,6,2,4
4027,Cíondra,aegwynn,192,demonhunter,havoc,6,2,4
4028,Тэнсу,borean-tundra,192,demonhunter,havoc,6,2,4
4029,Zxcjklcasdlk,sylvanas,192,demonhunter,havoc,6,2,4
4030,Riveén,blackhand,192,demonhunter,havoc,6,2,4
4031,Tabsen,sanguino,192,demonhunter,havoc,6,2,4
4032,Беатриз,soulflayer,192,demonhunter,havoc,6,2,4
4033,Grinchdemon,nagrand,192,demonhunter,havoc,6,2,4
4034,Kibikari,nemesis,192,demonhunter,havoc,6,2,4
4035,Остинджейн,soulflayer,192,demonhunter,havoc,6,2,4
4036,Wolfex,hellfire,192,demonhunter,havoc,6,2,4
4037,Stifeur,archimonde,192,demonhunter,havoc,6,2,4
4038,Linkôs,aegwynn,192,demonhunter,havoc,6,2,4
4039,Khinn,tyrande,192,demonhunter,havoc,6,2,4
4040,Dionyz,magtheridon,192,demonhunter,havoc,6,2,4
4041,Gnaget,the-maelstrom,192,demonhunter,havoc,6,2,4
4042,Dhslayer,magtheridon,192,demonhunter,havoc,6,2,4
4043,Мэлифсб,blackscar,192,demonhunter,havoc,6,2,4
4044,Palaurx,kazzak,192,demonhunter,havoc,6,2,4
4045,Neulgød,zuljin,192,demonhunter,havoc,6,2,4
4046,Pablino,darksorrow,192,demonhunter,havoc,6,2,4
4047,Aerkex,kazzak,192,demonhunter,havoc,6,2,4
4048,Thefightergz,terokkar,192,demonhunter,havoc,6,2,4
4049,Ragnarak,amanthul,192,demonhunter,havoc,6,2,4
4050,Mîlîm,silvermoon,192,demonhunter,havoc,6,2,4
4051,Топдекдх,howling-fjord,192,demonhunter,havoc,6,2,4
4052,Saphira,laughing-skull,192,demonhunter,havoc,6,2,4
4053,Kryshan,burning-legion,192,demonhunter,havoc,6,2,4
4054,Холегдх,gordunni,192,demonhunter,havoc,6,2,4
4055,Aggrodíte,antonidas,192,demonhunter,havoc,6,2,4
4056,Дабллди,soulflayer,192,demonhunter,havoc,6,2,4
4057,Артесдх,gordunni,192,demonhunter,havoc,6,2,4
4058,Sälexz,ysondre,192,demonhunter,havoc,6,2,4
4059,Zarkhyl,malygos,192,demonhunter,havoc,6,2,4
4060,Williamgrant,alonsus,192,demonhunter,havoc,6,2,4
4061,Tvé,ravencrest,192,demonhunter,havoc,6,2,4
4062,Generaaloo,ragnaros,192,demonhunter,havoc,6,2,4
4063,Шоксенсацияя,howling-fjord,192,demonhunter,havoc,6,2,4
4064,Juicyglaives,ragnaros,192,demonhunter,havoc,6,2,4
4065,Флайрин,blackscar,192,demonhunter,havoc,6,2,4
4066,Dikcitx,archimonde,192,demonhunter,havoc,6,2,4
4067,Fellout,burning-legion,192,demonhunter,havoc,6,2,4
4068,Hicke,burning-legion,192,demonhunter,havoc,6,2,4
4069,Лорберн,soulflayer,192,demonhunter,havoc,6,2,4
4070,Ôdhyn,hyjal,192,demonhunter,havoc,6,2,4
4071,Malkyor,ysondre,192,demonhunter,havoc,6,2,4
4072,Hârambe,stormscale,192,demonhunter,havoc,12,3,9
4073,Врадость,soulflayer,192,demonhunter,havoc,8,2,6
4074,Zaydra,the-maelstrom,192,demonhunter,havoc,12,2,10
4075,Thenangel,alleria,192,demonhunter,havoc,12,2,10
4076,Qweasda,stormscale,192,demonhunter,havoc,12,2,10
4077,Парагони,gordunni,192,demonhunter,havoc,12,2,10
4078,Esseline,outland,192,demonhunter,havoc,12,2,10
4079,Spideymon,ragnaros,192,demonhunter,havoc,12,2,10
4080,Kandres,ragnaros,192,demonhunter,havoc,12,2,10
4081,Aygael,archimonde,192,demonhunter,havoc,12,2,10
4082,Enygamy,frostmane,192,demonhunter,havoc,12,2,10
4083,Язамясо,gordunni,192,demonhunter,havoc,12,2,10
4084,Ayido,xavius,192,demonhunter,havoc,12,2,10
4085,Abalim,nemesis,192,demonhunter,havoc,12,2,10
4086,Sajr,twisting-nether,192,demonhunter,havoc,12,2,10
4087,Asperatus,dalaran,192,demonhunter,havoc,12,2,10
4088,Deehoh,twisting-nether,192,demonhunter,havoc,12,2,10
4089,Tbomb,ragnaros,192,demonhunter,havoc,12,2,10
4090,Aytèè,eredar,192,demonhunter,havoc,12,2,10
4091,Dhogus,twisting-nether,192,demonhunter,havoc,12,2,10
4092,Zynês,draenor,192,demonhunter,havoc,12,2,10
4093,Axyo,doomhammer,192,demonhunter,havoc,12,2,10
4094,Tôx,dalaran,192,demonhunter,havoc,12,2,10
4095,Wruzna,shattered-halls,192,demonhunter,havoc,12,2,10
4096,Aloera,blackmoore,192,demonhunter,havoc,12,2,10
4097,Teletubby,blackrock,192,demonhunter,havoc,12,2,10
4098,Synistera,trollbane,192,demonhunter,havoc,12,2,10
4099,Drâparn,sylvanas,192,demonhunter,havoc,12,2,10
4100,Themogar,earthen-ring,192,demonhunter,havoc,12,2,10
4101,Fullmutter,twisting-nether,191,demonhunter,havoc,6,2,4
4102,Anarcky,ravencrest,191,demonhunter,havoc,7,2,5
4103,Manjirosano,blackmoore,191,demonhunter,havoc,12,2,10
4104,Noorrd,hyjal,191,demonhunter,havoc,12,2,10
4105,Lilarii,argent-dawn,191,demonhunter,havoc,12,2,10
4106,Kurox,drakthul,191,demonhunter,havoc,18,2,16
4107,Onorera,tarren-mill,160,demonhunter,havoc,10,2,8
4108,Galafel,outland,159,demonhunter,havoc,5,2,3
4109,Mezo,outland,144,demonhunter,havoc,3,3,0
4110,Gucknicht,blackrock,144,demonhunter,havoc,9,2,7
4111,Razerøø,ysondre,138,demonhunter,havoc,9,3,6
4112,Kantklipper,ragnaros,138,demonhunter,havoc,10,3,7
4113,Джэкмэн,soulflayer,138,demonhunter,havoc,23,4,19
4114,Мегапташка,howling-fjord,128,demonhunter,havoc,4,2,2
4115,Drstn,blackmoore,128,demonhunter,havoc,4,2,2
4116,Luferite,burning-blade,127,demonhunter,havoc,8,2,6
4117,Indagatrix,bladefist,112,demonhunter,havoc,7,2,5
4118,Amatèrasu,burning-legion,110,demonhunter,havoc,13,2,11
4119,Âyoôrts,archimonde,96,demonhunter,havoc,3,2,1
4120,Kassin,dun-modr,96,demonhunter,havoc,6,1,5
4121,Zyfu,antonidas,96,demonhunter,havoc,6,1,5
4122,Teladar,outland,96,demonhunter,havoc,6,1,5
4123,Ilovesabrina,dun-modr,96,demonhunter,havoc,6,1,5
4124,Bchj,ysondre,96,demonhunter,havoc,6,1,5
4125,Ellare,burning-blade,96,demonhunter,havoc,6,1,5
4126,Akron,magtheridon,96,demonhunter,havoc,6,1,5
4127,Bröwnye,dun-modr,96,demonhunter,havoc,6,1,5
4128,Syldrae,hyjal,96,demonhunter,havoc,6,1,5
4129,Vrazjababa,dragonmaw,96,demonhunter,havoc,6,1,5
4130,Maikko,los-errantes,96,demonhunter,havoc,6,1,5
4131,Hørnyßæ,drakthul,96,demonhunter,havoc,6,1,5
4132,Reikuel,nemesis,96,demonhunter,havoc,6,1,5
4133,Vg,blackhand,96,demonhunter,havoc,6,1,5
4134,Cruptiq,kazzak,96,demonhunter,havoc,6,1,5
4135,Demongorgon,arathor,96,demonhunter,havoc,6,1,5
4136,Oob,ysondre,96,demonhunter,havoc,6,1,5
4137,Shaelby,archimonde,96,demonhunter,havoc,6,1,5
4138,Permachill,blackmoore,96,demonhunter,havoc,6,1,5
4139,Rëdencounter,ravencrest,96,demonhunter,havoc,6,1,5
4140,Stàmàzza,nemesis,96,demonhunter,havoc,6,1,5
4141,Аззазэль,howling-fjord,96,demonhunter,havoc,6,1,5
4142,ßaßayaga,blackhand,96,demonhunter,havoc,6,1,5
4143,Burritodh,tarren-mill,96,demonhunter,havoc,6,1,5
4144,Satela,azjolnerub,96,demonhunter,havoc,6,1,5
4145,Zoer,kazzak,96,demonhunter,havoc,6,1,5
4146,Bïquette,ysondre,96,demonhunter,havoc,6,1,5
4147,Спокоивич,soulflayer,96,demonhunter,havoc,6,1,5
4148,Malvax,tarren-mill,96,demonhunter,havoc,6,1,5
4149,Teimotevey,silvermoon,96,demonhunter,havoc,6,1,5
4150,Jiínx,kazzak,96,demonhunter,havoc,6,1,5
4151,Ryuhayabusa,stormscale,96,demonhunter,havoc,6,1,5
4152,Louú,blackmoore,96,demonhunter,havoc,6,1,5
4153,Fantamazing,ragnaros,96,demonhunter,havoc,6,1,5
4154,Esthá,argent-dawn,96,demonhunter,havoc,6,1,5
4155,Blíndgódx,ravencrest,96,demonhunter,havoc,6,1,5
4156,Dhgoddess,ravencrest,96,demonhunter,havoc,6,1,5
4157,Styggve,ragnaros,96,demonhunter,havoc,6,1,5
4158,Tenx,auchindoun,96,demonhunter,havoc,6,1,5
4159,Найлинель,fordragon,96,demonhunter,havoc,6,1,5
4160,Evlos,hyjal,96,demonhunter,havoc,6,1,5
4161,Dýlän,argent-dawn,96,demonhunter,havoc,6,1,5
4162,Stormma,kazzak,96,demonhunter,havoc,6,1,5
4163,Anänke,twisting-nether,96,demonhunter,havoc,6,1,5
4164,Яестьдима,howling-fjord,96,demonhunter,havoc,6,1,5
4165,Shonal,defias-brotherhood,96,demonhunter,havoc,6,1,5
4166,Zarafel,hyjal,96,demonhunter,havoc,6,1,5
4167,Mlecznygolem,silvermoon,96,demonhunter,havoc,6,1,5
4168,Ghetzlel,draenor,96,demonhunter,havoc,6,1,5
4169,Чесденьгамии,soulflayer,96,demonhunter,havoc,6,1,5
4170,Unk,outland,96,demonhunter,havoc,6,1,5
4171,Bootyspread,twisting-nether,96,demonhunter,havoc,6,1,5
4172,Wìxx,blackrock,96,demonhunter,havoc,6,1,5
4173,Bradzdh,outland,96,demonhunter,havoc,6,1,5
4174,Niqel,blackrock,96,demonhunter,havoc,6,1,5
4175,Áarón,der-mithrilorden,96,demonhunter,havoc,6,1,5
4176,Kuñkkïsh,twisting-nether,96,demonhunter,havoc,6,1,5
4177,Azazël,turalyon,96,demonhunter,havoc,6,1,5
4178,Laethas,twisting-nether,96,demonhunter,havoc,6,1,5
4179,Nairu,doomhammer,96,demonhunter,havoc,6,1,5
4180,Sgit,doomhammer,96,demonhunter,havoc,6,1,5
4181,Annee,eredar,96,demonhunter,havoc,6,1,5
4182,Bitex,archimonde,96,demonhunter,havoc,6,1,5
4183,Eliyz,dalaran,96,demonhunter,havoc,6,1,5
4184,Camotheck,stormscale,96,demonhunter,havoc,6,1,5
4185,Pkdaemon,draenor,96,demonhunter,havoc,6,1,5
4186,Blulake,silvermoon,96,demonhunter,havoc,6,1,5
4187,Flasqo,eredar,96,demonhunter,havoc,6,1,5
4188,Äzot,burning-legion,96,demonhunter,havoc,6,1,5
4189,Askari,lothar,96,demonhunter,havoc,6,1,5
4190,Croüp,draenor,96,demonhunter,havoc,6,1,5
4191,Соларт,howling-fjord,96,demonhunter,havoc,6,1,5
4192,Tricki,kelthuzad,96,demonhunter,havoc,6,1,5
4193,Неверластх,gordunni,96,demonhunter,havoc,6,1,5
4194,Распилил,gordunni,96,demonhunter,havoc,6,1,5
4195,Ганстапутин,howling-fjord,96,demonhunter,havoc,6,1,5
4196,Булёхинс,howling-fjord,96,demonhunter,havoc,6,1,5
4197,Nvm,wrathbringer,96,demonhunter,havoc,6,1,5
4198,Ripgodx,bronzebeard,96,demonhunter,havoc,6,1,5
4199,Galuna,deathwing,96,demonhunter,havoc,7,1,6
4200,Kryux,blackrock,96,demonhunter,havoc,9,1,8
4201,Бонятяф,gordunni,96,demonhunter,havoc,12,1,11
4202,Babyyéah,sunstrider,96,demonhunter,havoc,12,1,11
4203,Seaburn,bronzebeard,96,demonhunter,havoc,12,1,11
4204,Jásírá,shattrath,96,demonhunter,havoc,12,1,11
4205,Jeandh,nerzhul,96,demonhunter,havoc,12,1,11
4206,Ecthelionn,outland,96,demonhunter,havoc,12,1,11
4207,Shinarei,silvermoon,95,demonhunter,havoc,6,1,5
4208,Caluxe,blackmoore,79,demonhunter,havoc,5,1,4
4209,Гадх,gordunni,42,demonhunter,havoc,8,2,6
4210,Impulz,archimonde,42,demonhunter,havoc,9,2,7
4211,Neednerf,draenor,31,demonhunter,havoc,2,1,1
4212,Sinjinzoo,blackrock,31,demonhunter,havoc,2,1,1
4213,Frozensoules,turalyon,31,demonhunter,havoc,8,1,7
4214,Plagues,quelthalas,30,demonhunter,havoc,14,5,9
4215,Sìena,ravencrest,16,demonhunter,havoc,1,1,0
4216,Vengeancezin,frostwhisper,1910,demonhunter,vengeance,192,97,95
4217,Strqt,archimonde,1509,demonhunter,vengeance,54,29,25
4218,Jedidiah,aggra-português,1496,demonhunter,vengeance,110,49,61
4219,Zarín,outland,1394,demonhunter,vengeance,78,41,37
4220,Paindemon,outland,1315,demonhunter,vengeance,72,42,30
4221,Enithy,twisting-nether,934,demonhunter,vengeance,18,10,8
4222,Kubusz,ravencrest,889,demonhunter,vengeance,36,16,20
4223,Сумърак,grom,739,demonhunter,vengeance,29,8,21
4224,Kekburagól,kazzak,575,demonhunter,vengeance,12,6,6
4225,Arussil,pozzo-delleternità,572,demonhunter,vengeance,18,6,12
4226,Demonlucy,colinas-pardas,287,demonhunter,vengeance,12,3,9
4227,Геммула,howling-fjord,192,demonhunter,vengeance,6,2,4
4228,Camtoe,ravencrest,192,demonhunter,vengeance,6,2,4
4229,Askari,lothar,192,demonhunter,vengeance,6,2,4
4230,Nephthyis,draenor,192,demonhunter,vengeance,6,2,4
4231,Myztiko,hellscream,96,demonhunter,vengeance,6,1,5
4232,Xenits,kazzak,96,demonhunter,vengeance,6,1,5
4233,Øß,moonglade,96,demonhunter,vengeance,6,1,5
4234,Zarafel,hyjal,95,demonhunter,vengeance,12,1,11
4235,Hibibi,kazzak,2257,druid,restoration,113,66,47
4236,Pegasu,kelthuzad,2182,druid,restoration,114,66,48
4237,Vanostboom,kazzak,2181,druid,restoration,88,50,38
4238,Iloveher,ravencrest,2180,druid,restoration,160,89,71
4239,Miouzy,archimonde,2156,druid,restoration,66,36,30
4240,Kev,elune,2134,druid,restoration,209,113,96
4241,Vinniehacker,archimonde,2129,druid,restoration,71,42,29
4242,Årt,ravencrest,2106,druid,restoration,186,100,86
4243,Niksidruid,grim-batol,2105,druid,restoration,58,37,21
4244,Unohanâ,archimonde,2103,druid,restoration,108,65,43
4245,Håbibi,kazzak,2100,druid,restoration,65,35,30
4246,Nesedondon,stormscale,2086,druid,restoration,72,50,22
4247,Trèes,outland,2085,druid,restoration,264,144,120
4248,Surfingbirdx,ragnaros,2058,druid,restoration,54,28,26
4249,Drjmy,silvermoon,2053,druid,restoration,71,54,17
4250,Dendariottvx,sunstrider,2042,druid,restoration,73,44,29
4251,Rives,sylvanas,2030,druid,restoration,102,60,42
4252,Acondris,kazzak,2025,druid,restoration,222,113,109
4253,Bambambimbim,draenor,2023,druid,restoration,84,44,40
4254,Thotz,kazzak,2020,druid,restoration,221,113,108
4255,Galadronìa,aegwynn,2018,druid,restoration,77,42,35
4256,Friedbrocolí,tarren-mill,2009,druid,restoration,86,43,43
4257,Yoogy,ravencrest,1995,druid,restoration,60,37,23
4258,Jaytiz,ravencrest,1975,druid,restoration,65,33,32
4259,Dokixo,kazzak,1968,druid,restoration,47,29,18
4260,Bloomitize,ravencrest,1967,druid,restoration,78,43,35
4261,Tjxaxa,ravencrest,1966,druid,restoration,78,38,40
4262,Lunamimi,argent-dawn,1962,druid,restoration,368,190,178
4263,Thysabtw,archimonde,1954,druid,restoration,99,58,41
4264,Shinöbü,sanguino,1954,druid,restoration,87,49,38
4265,Ovérheal,ravencrest,1953,druid,restoration,94,52,42
4266,Sintiq,silvermoon,1949,druid,restoration,65,37,28
4267,Mentallyill,ravencrest,1949,druid,restoration,204,106,98
4268,Theatrex,ravencrest,1945,druid,restoration,165,100,65
4269,Sheippi,stormreaver,1945,druid,restoration,54,31,23
4270,Angrykejton,silvermoon,1940,druid,restoration,276,138,138
4271,Hånukkah,outland,1929,druid,restoration,64,30,34
4272,Threesixnìne,dun-morogh,1928,druid,restoration,246,134,112
4273,Skrrlock,ravencrest,1923,druid,restoration,108,53,55
4274,Kyomã,burning-legion,1915,druid,restoration,102,49,53
4275,Syví,outland,1912,druid,restoration,59,29,30
4276,Andr,voljin,1907,druid,restoration,102,49,53
4277,Joksica,draenor,1903,druid,restoration,65,32,33
4278,Afky,stormreaver,1901,druid,restoration,156,77,79
4279,Maxpojke,ravencrest,1899,druid,restoration,148,92,56
4280,Cplazi,kazzak,1890,druid,restoration,48,30,18
4281,Amaré,burning-legion,1873,druid,restoration,54,28,26
4282,Panigale,dun-modr,1872,druid,restoration,55,24,31
4283,Ralaa,guldan,1865,druid,restoration,54,29,25
4284,Arthéas,archimonde,1865,druid,restoration,174,89,85
4285,Naffelle,ysondre,1862,druid,restoration,71,34,37
4286,Druidrak,eredar,1855,druid,restoration,66,32,34
4287,Chas,ravencrest,1852,druid,restoration,51,31,20
4288,Leyô,archimonde,1852,druid,restoration,60,31,29
4289,Traffix,outland,1852,druid,restoration,51,26,25
4290,Alolexx,archimonde,1851,druid,restoration,45,27,18
4291,Lalalime,arthas,1851,druid,restoration,64,31,33
4292,Skrood,kazzak,1847,druid,restoration,60,31,29
4293,Druidello,stormscale,1845,druid,restoration,52,24,28
4294,Køngx,blackhand,1840,druid,restoration,131,68,63
4295,Åä,ravencrest,1837,druid,restoration,32,20,12
4296,Thebiggest,ravencrest,1836,druid,restoration,42,25,17
4297,Myndrá,varimathras,1835,druid,restoration,66,34,32
4298,Ammare,burning-legion,1834,druid,restoration,72,39,33
4299,Matteps,outland,1833,druid,restoration,59,28,31
4300,Nantou,stormscale,1833,druid,restoration,59,28,31
4301,Chacopic,archimonde,1831,druid,restoration,168,88,80
4302,Jmdr,silvermoon,1830,druid,restoration,71,31,40
4303,Asøri,antonidas,1829,druid,restoration,48,21,27
4304,Kìttÿ,dun-modr,1828,druid,restoration,66,41,25
4305,Spamclone,draenor,1828,druid,restoration,57,30,27
4306,Kanyevotèrx,ravencrest,1828,druid,restoration,54,25,29
4307,Jìnró,ravencrest,1825,druid,restoration,135,66,69
4308,Sprøut,drakthul,1825,druid,restoration,59,27,32
4309,Gummysnake,aszune,1823,druid,restoration,42,25,17
4310,Helløkittyßß,dun-modr,1823,druid,restoration,151,86,65
4311,Treliuz,twilights-hammer,1823,druid,restoration,346,190,156
4312,Zydrux,outland,1822,druid,restoration,48,36,12
4313,Olaphy,elune,1821,druid,restoration,257,133,124
4314,Thugzie,kazzak,1821,druid,restoration,194,92,102
4315,Yesco,malganis,1821,druid,restoration,63,27,36
4316,Doodlez,blackrock,1820,druid,restoration,60,27,33
4317,Baawz,blackmoore,1820,druid,restoration,60,25,35
4318,Aesha,los-errantes,1819,druid,restoration,54,26,28
4319,Promethezine,tarren-mill,1818,druid,restoration,236,122,114
4320,Metagrass,stormscale,1818,druid,restoration,129,59,70
4321,Skadooshee,kazzak,1816,druid,restoration,36,19,17
4322,Xvmon,draenor,1815,druid,restoration,99,45,54
4323,Велаине,gordunni,1813,druid,restoration,240,140,100
4324,Nediena,twisting-nether,1812,druid,restoration,48,20,28
4325,Troc,karazhan,1811,druid,restoration,50,25,25
4326,Sorryblya,ravencrest,1809,druid,restoration,60,26,34
4327,Rhonir,twisting-nether,1807,druid,restoration,71,33,38
4328,Muraglia,pozzo-delleternità,1806,druid,restoration,30,19,11
4329,Bellatrx,darksorrow,1806,druid,restoration,56,33,23
4330,Uñsullied,kazzak,1806,druid,restoration,57,31,26
4331,Morkius,ravencrest,1806,druid,restoration,36,19,17
4332,Eedaza,argent-dawn,1805,druid,restoration,134,75,59
4333,Мафио,blackscar,1805,druid,restoration,48,25,23
4334,Дикаякиара,blackscar,1804,druid,restoration,307,151,156
4335,Riplilpeep,grim-batol,1803,druid,restoration,54,28,26
4336,Gaeldeth,silvermoon,1802,druid,restoration,105,63,42
4337,Wraithshape,stormscale,1800,druid,restoration,60,32,28
4338,Hadok,azjolnerub,1798,druid,restoration,167,76,91
4339,Reins,silvermoon,1795,druid,restoration,106,56,50
4340,Кенкертайм,gordunni,1794,druid,restoration,84,43,41
4341,Tedel,kazzak,1791,druid,restoration,53,33,20
4342,Asklepion,twisting-nether,1785,druid,restoration,42,19,23
4343,Orayin,ravencrest,1784,druid,restoration,166,102,64
4344,Traickovic,antonidas,1779,druid,restoration,48,24,24
4345,Lexopewpew,ravencrest,1779,druid,restoration,47,22,25
4346,Афклалка,gordunni,1778,druid,restoration,42,22,20
4347,Druu,stormscale,1778,druid,restoration,60,28,32
4348,Panørax,archimonde,1774,druid,restoration,41,21,20
4349,Tj,frostmane,1773,druid,restoration,52,22,30
4350,Clone,aegwynn,1770,druid,restoration,138,73,65
4351,Amaree,burning-legion,1770,druid,restoration,66,29,37
4352,Heçtôr,silvermoon,1767,druid,restoration,60,27,33
4353,Ltmx,ravencrest,1764,druid,restoration,59,25,34
4354,Bëstwôrld,archimonde,1763,druid,restoration,76,39,37
4355,Nastycat,magtheridon,1763,druid,restoration,221,105,116
4356,Gøðførm,silvermoon,1758,druid,restoration,118,63,55
4357,Wéédmâñ,ravencrest,1756,druid,restoration,45,30,15
4358,Slayced,blackrock,1756,druid,restoration,71,34,37
4359,Píshi,silvermoon,1754,druid,restoration,42,23,19
4360,Asaj,argent-dawn,1754,druid,restoration,207,112,95
4361,Maedic,outland,1753,druid,restoration,125,60,65
4362,Hizzy,burning-legion,1751,druid,restoration,243,119,124
4363,Loleh,ragnaros,1751,druid,restoration,59,27,32
4364,Lamatoes,ravencrest,1750,druid,restoration,59,24,35
4365,Qjkuug,twisting-nether,1749,druid,restoration,154,91,63
4366,Mòzat,stormscale,1749,druid,restoration,54,28,26
4367,Migami,nemesis,1748,druid,restoration,65,27,38
4368,Solowlevel,ravencrest,1748,druid,restoration,60,24,36
4369,Zonsy,twisting-nether,1747,druid,restoration,48,27,21
4370,Weezíng,ysondre,1747,druid,restoration,73,40,33
4371,Джелони,soulflayer,1745,druid,restoration,47,23,24
4372,Badashellm,ravencrest,1744,druid,restoration,66,37,29
4373,Hyggefinger,ravencrest,1741,druid,restoration,54,26,28
4374,Улдрэйн,deathguard,1739,druid,restoration,66,38,28
4375,Naraia,aegwynn,1739,druid,restoration,125,66,59
4376,Drøødis,archimonde,1730,druid,restoration,54,31,23
4377,Nasduck,ravencrest,1726,druid,restoration,184,99,85
4378,Lúh,kazzak,1724,druid,restoration,24,19,5
4379,Крашдру,gordunni,1724,druid,restoration,64,38,26
4380,Филавтия,gordunni,1724,druid,restoration,60,32,28
4381,Notsikaan,blackhand,1723,druid,restoration,71,27,44
4382,Druidella,stormscale,1716,druid,restoration,30,18,12
4383,Ûnsullied,kazzak,1716,druid,restoration,54,25,29
4384,Fatøumatä,archimonde,1712,druid,restoration,60,32,28
4385,Evílz,kazzak,1710,druid,restoration,36,21,15
4386,Muraebbasta,pozzo-delleternità,1709,druid,restoration,42,18,24
4387,Luhmanish,thunderhorn,1707,druid,restoration,143,74,69
4388,Wraithmoon,stormscale,1705,druid,restoration,36,18,18
4389,Lifelover,outland,1704,druid,restoration,54,25,29
4390,Kittyperry,tarren-mill,1703,druid,restoration,68,34,34
4391,Ninadobrev,ragnaros,1697,druid,restoration,57,26,31
4392,Treeførm,ravencrest,1694,druid,restoration,36,25,11
4393,Josedudu,twisting-nether,1692,druid,restoration,75,37,38
4394,Moondra,outland,1688,druid,restoration,95,39,56
4395,Erika,vashj,1684,druid,restoration,72,38,34
4396,Hólo,blackrock,1682,druid,restoration,102,47,55
4397,Vijaja,aegwynn,1681,druid,restoration,30,19,11
4398,Kokanine,ravencrest,1681,druid,restoration,45,23,22
4399,Néøu,archimonde,1681,druid,restoration,48,23,25
4400,Praetorian,sylvanas,1680,druid,restoration,315,155,160
4401,Synapes,outland,1680,druid,restoration,60,28,32
4402,Traick,antonidas,1679,druid,restoration,41,18,23
4403,Moonbee,burning-blade,1677,druid,restoration,155,82,73
4404,Akumei,ravencrest,1676,druid,restoration,47,24,23
4405,Bjoernbrudn,ravencrest,1674,druid,restoration,48,24,24
4406,Fryén,archimonde,1671,druid,restoration,75,33,42
4407,Naruhot,archimonde,1670,druid,restoration,49,27,22
4408,Skailzdruid,hyjal,1669,druid,restoration,200,124,76
4409,Lunglung,blutkessel,1664,druid,restoration,114,60,54
4410,Tooclosex,outland,1663,druid,restoration,95,54,41
4411,Elayria,blackmoore,1663,druid,restoration,36,19,17
4412,Wernøs,archimonde,1661,druid,restoration,51,26,25
4413,Rozi,draenor,1660,druid,restoration,48,27,21
4414,Demerit,aegwynn,1657,druid,restoration,32,18,14
4415,Sélia,sylvanas,1657,druid,restoration,116,57,59
4416,Bâneth,destromath,1656,druid,restoration,60,33,27
4417,Catgirlx,ravencrest,1652,druid,restoration,42,26,16
4418,Øhshift,drakthul,1651,druid,restoration,47,25,22
4419,Shufflebot,sylvanas,1650,druid,restoration,36,22,14
4420,Fantastix,silvermoon,1649,druid,restoration,36,20,16
4421,Чухх,howling-fjord,1649,druid,restoration,73,39,34
4422,Nozome,draenor,1648,druid,restoration,45,22,23
4423,Flåppers,stormscale,1645,druid,restoration,48,20,28
4424,Pogoth,turalyon,1641,druid,restoration,72,38,34
4425,Diolives,stormscale,1640,druid,restoration,303,159,144
4426,Uknowwhaddup,silvermoon,1639,druid,restoration,48,19,29
4427,Ooktharg,turalyon,1637,druid,restoration,42,22,20
4428,Абраг,soulflayer,1637,druid,restoration,72,36,36
4429,Trèes,draenor,1636,druid,restoration,46,22,24
4430,Zudwa,twisting-nether,1635,druid,restoration,44,27,17
4431,Adjaara,ravencrest,1635,druid,restoration,115,68,47
4432,Pardus,ambossar,1635,druid,restoration,50,27,23
4433,Kroghelf,tarren-mill,1634,druid,restoration,42,21,21
4434,Bellhooks,blackrock,1633,druid,restoration,30,18,12
4435,Rawri,blackmoore,1633,druid,restoration,48,26,22
4436,Mafiasnipe,ravencrest,1630,druid,restoration,24,17,7
4437,Cæsífer,area-52,1630,druid,restoration,71,37,34
4438,Plsbuffdruid,ravencrest,1630,druid,restoration,40,19,21
4439,Crownydrood,hyjal,1628,druid,restoration,42,25,17
4440,Asga,stormscale,1628,druid,restoration,30,17,13
4441,Estariol,auchindoun,1628,druid,restoration,36,17,19
4442,Peterpain,grim-batol,1626,druid,restoration,30,17,13
4443,Andromedda,twisting-nether,1626,druid,restoration,198,105,93
4444,Trollisha,mannoroth,1626,druid,restoration,705,345,360
4445,Ёу,soulflayer,1624,druid,restoration,161,85,76
4446,Tropjeune,dalaran,1623,druid,restoration,36,17,19
4447,Davorian,frostmane,1622,druid,restoration,63,35,28
4448,Hotsnthots,elune,1622,druid,restoration,48,24,24
4449,Jamuhlee,kult-der-verdammten,1622,druid,restoration,43,18,25
4450,Chaboom,hyjal,1622,druid,restoration,60,25,35
4451,Миледистайпи,gordunni,1619,druid,restoration,32,18,14
4452,Frances,auchindoun,1618,druid,restoration,63,36,27
4453,Bjútiful,silvermoon,1618,druid,restoration,41,23,18
4454,Eyvimel,ravencrest,1618,druid,restoration,404,212,192
4455,Elu,eredar,1617,druid,restoration,48,28,20
4456,Haszard,outland,1617,druid,restoration,134,68,66
4457,Nancey,auchindoun,1617,druid,restoration,149,75,74
4458,Друлихаз,gordunni,1617,druid,restoration,54,20,34
4459,Wømbat,ravencrest,1616,druid,restoration,36,17,19
4460,Goldrax,outland,1615,druid,restoration,24,17,7
4461,Bigdaddyshay,twisting-nether,1615,druid,restoration,42,24,18
4462,Tåylor,laughing-skull,1615,druid,restoration,41,21,20
4463,Sangré,suramar,1615,druid,restoration,108,52,56
4464,Драменбейз,gordunni,1615,druid,restoration,42,20,22
4465,Dûdûrînâ,blackrock,1614,druid,restoration,66,42,24
4466,Skillfall,ravencrest,1614,druid,restoration,48,21,27
4467,Nímbs,tarren-mill,1612,druid,restoration,35,20,15
4468,Zhosy,shattrath,1612,druid,restoration,61,22,39
4469,Zevana,tarren-mill,1611,druid,restoration,30,18,12
4470,Funnyjoker,outland,1611,druid,restoration,142,66,76
4471,Skipperd,blackmoore,1610,druid,restoration,42,17,25
4472,Kaamirach,blackmoore,1609,druid,restoration,157,97,60
4473,Xalio,ravencrest,1609,druid,restoration,161,90,71
4474,Xoriauz,archimonde,1609,druid,restoration,78,37,41
4475,Slaugh,zuljin,1608,druid,restoration,48,20,28
4476,Опапенелопа,blackscar,1607,druid,restoration,39,27,12
4477,Monatamis,kazzak,1607,druid,restoration,36,21,15
4478,Kheazar,blackmoore,1606,druid,restoration,115,69,46
4479,Bigmeandruid,twisting-nether,1606,druid,restoration,30,17,13
4480,Чекхмеаскохз,gordunni,1604,druid,restoration,36,21,15
4481,Builtdiffy,kazzak,1604,druid,restoration,249,126,123
4482,Bîrke,blackrock,1604,druid,restoration,36,17,19
4483,Diriculous,kazzak,1603,druid,restoration,60,20,40
4484,Soguu,thrall,1601,druid,restoration,30,17,13
4485,Watchmebear,stormscale,1601,druid,restoration,42,23,19
4486,Ðarckness,kazzak,1600,druid,restoration,24,17,7
4487,Swifte,argent-dawn,1600,druid,restoration,48,27,21
4488,Tamburoo,tarren-mill,1600,druid,restoration,225,110,115
4489,Akmón,tarren-mill,1600,druid,restoration,58,20,38
4490,Dïsä,ravencrest,1599,druid,restoration,30,17,13
4491,Mònsterz,archimonde,1599,druid,restoration,160,86,74
4492,Mortalnight,sinstralis,1598,druid,restoration,412,205,207
4493,Heavysmoker,emeriss,1597,druid,restoration,162,75,87
4494,Ittei,korgall,1596,druid,restoration,120,63,57
4495,Рамзес,gordunni,1595,druid,restoration,54,31,23
4496,Rhapsodý,twisting-nether,1591,druid,restoration,36,19,17
4497,Folzenqt,archimonde,1590,druid,restoration,68,27,41
4498,Bêvêrly,ravencrest,1586,druid,restoration,70,37,33
4499,Miyá,sylvanas,1580,druid,restoration,30,17,13
4500,Naridruidx,eredar,1578,druid,restoration,42,26,16
4501,Shiftway,stormscale,1573,druid,restoration,42,23,19
4502,Pega,archimonde,1572,druid,restoration,84,39,45
4503,Scorlok,eredar,1567,druid,restoration,68,42,26
4504,Eaglefox,aszune,1565,druid,restoration,71,37,34
4505,Stratocaster,blackmoore,1563,druid,restoration,30,19,11
4506,Pawful,malganis,1562,druid,restoration,266,141,125
4507,Kundz,dalaran,1558,druid,restoration,160,88,72
4508,Zaelitwo,archimonde,1557,druid,restoration,30,21,9
4509,Naturez,sylvanas,1557,druid,restoration,32,20,12
4510,Уэсериктх,blackscar,1557,druid,restoration,45,26,19
4511,Crïn,ravencrest,1553,druid,restoration,36,17,19
4512,Druncha,sunstrider,1553,druid,restoration,189,74,115
4513,Néllä,archimonde,1552,druid,restoration,36,25,11
4514,Tunling,ravencrest,1549,druid,restoration,66,44,22
4515,Брэвно,gordunni,1549,druid,restoration,273,145,128
4516,Arogane,outland,1548,druid,restoration,96,51,45
4517,Bearform,blackhand,1548,druid,restoration,48,23,25
4518,Legyna,ravencrest,1547,druid,restoration,65,40,25
4519,Çãm,magtheridon,1547,druid,restoration,42,25,17
4520,Khunahype,thrall,1546,druid,restoration,88,48,40
4521,Reinulfen,blackmoore,1545,druid,restoration,166,89,77
4522,Deluron,malganis,1545,druid,restoration,119,63,56
4523,Probablyahoe,ravencrest,1544,druid,restoration,36,17,19
4524,Swisz,bronzebeard,1542,druid,restoration,78,41,37
4525,Bammedrudu,archimonde,1541,druid,restoration,42,25,17
4526,Ssonty,drakthul,1541,druid,restoration,54,23,31
4527,Phelessa,silvermoon,1539,druid,restoration,54,23,31
4528,Нубстримсс,gordunni,1538,druid,restoration,82,38,44
4529,Tôrmêñtêd,outland,1535,druid,restoration,105,65,40
4530,Roshaga,blackrock,1535,druid,restoration,51,25,26
4531,Buffbloom,auchindoun,1534,druid,restoration,141,72,69
4532,Dârkacêû,blackmoore,1534,druid,restoration,44,21,23
4533,Директорх,blackscar,1534,druid,restoration,47,22,25
4534,Eviscreator,stormscale,1529,druid,restoration,45,27,18
4535,Fabsl,archimonde,1529,druid,restoration,42,18,24
4536,Kætachy,archimonde,1529,druid,restoration,42,16,26
4537,Cheçhy,aegwynn,1527,druid,restoration,54,26,28
4538,Hasselhoof,eredar,1526,druid,restoration,63,26,37
4539,Homek,eredar,1525,druid,restoration,108,58,50
4540,Делоникс,soulflayer,1525,druid,restoration,36,16,20
4541,Lyvuni,blackmoore,1524,druid,restoration,60,36,24
4542,Høtbøt,ysera,1523,druid,restoration,33,19,14
4543,Melonmanx,outland,1523,druid,restoration,30,17,13
4544,Floka,archimonde,1523,druid,restoration,60,32,28
4545,Ына,gordunni,1523,druid,restoration,114,60,54
4546,Mw,dun-modr,1520,druid,restoration,71,33,38
4547,Hatecrew,twisting-nether,1517,druid,restoration,59,33,26
4548,Stonesight,argent-dawn,1516,druid,restoration,30,20,10
4549,Dwaokut,ravencrest,1514,druid,restoration,47,24,23
4550,Utopiah,ravencrest,1513,druid,restoration,80,45,35
4551,Latêralus,silvermoon,1513,druid,restoration,67,26,41
4552,Сладуляя,gordunni,1512,druid,restoration,53,23,30
4553,Tînkerbèll,blackmoore,1511,druid,restoration,41,22,19
4554,Azchuk,blackmoore,1509,druid,restoration,53,22,31
4555,Jìnro,stormscale,1508,druid,restoration,24,16,8
4556,Друрашка,soulflayer,1508,druid,restoration,81,43,38
4557,Devióus,twilights-hammer,1508,druid,restoration,246,125,121
4558,Jcpenney,xavius,1508,druid,restoration,223,109,114
4559,Bloomies,tarren-mill,1507,druid,restoration,100,59,41
4560,Yseraheal,drakthul,1507,druid,restoration,42,17,25
4561,Ystalgia,sylvanas,1507,druid,restoration,42,16,26
4562,Cyclonebroo,blackmoore,1504,druid,restoration,34,20,14
4563,Feelstreeman,twisting-nether,1504,druid,restoration,77,42,35
4564,Lÿter,dun-modr,1502,druid,restoration,60,27,33
4565,Greenlips,ravencrest,1502,druid,restoration,60,23,37
4566,Zaerox,ambossar,1501,druid,restoration,90,45,45
4567,Kittý,terokkar,1500,druid,restoration,162,82,80
4568,Elwenyss,outland,1498,druid,restoration,65,30,35
4569,Блицклик,gordunni,1498,druid,restoration,82,36,46
4570,Аренатренер,gordunni,1498,druid,restoration,90,39,51
4571,Eeivi,argent-dawn,1497,druid,restoration,195,104,91
4572,Нагетсмяу,howling-fjord,1496,druid,restoration,24,16,8
4573,Trayndaras,drakthul,1495,druid,restoration,35,23,12
4574,Kicki,outland,1494,druid,restoration,66,34,32
4575,Маккаланн,soulflayer,1493,druid,restoration,48,30,18
4576,Setztes,tarren-mill,1493,druid,restoration,151,79,72
4577,Rougetreize,khaz-modan,1490,druid,restoration,30,16,14
4578,Jtepdru,ravencrest,1490,druid,restoration,132,67,65
4579,Peerpope,draenor,1488,druid,restoration,238,131,107
4580,Atôtheex,kazzak,1488,druid,restoration,43,21,22
4581,Guccicken,garona,1487,druid,restoration,173,92,81
4582,Cptfalcony,outland,1486,druid,restoration,60,34,26
4583,Mnine,twisting-nether,1485,druid,restoration,42,23,19
4584,Фапдрим,howling-fjord,1480,druid,restoration,246,123,123
4585,Noosh,thrall,1480,druid,restoration,42,20,22
4586,Xoat,marécage-de-zangar,1479,druid,restoration,36,23,13
4587,Атмос,deathguard,1478,druid,restoration,198,109,89
4588,Phala,outland,1478,druid,restoration,48,20,28
4589,Supremecat,kazzak,1477,druid,restoration,66,38,28
4590,Pureballs,twisting-nether,1477,druid,restoration,165,93,72
4591,Nyxxz,shattered-hand,1477,druid,restoration,36,19,17
4592,Xôárqt,aegwynn,1477,druid,restoration,72,33,39
4593,Maqer,argent-dawn,1476,druid,restoration,56,31,25
4594,Kaher,ravencrest,1475,druid,restoration,48,24,24
4595,Delviri,stormreaver,1474,druid,restoration,104,54,50
4596,Asanaria,ravencrest,1474,druid,restoration,95,43,52
4597,Nasgra,malganis,1473,druid,restoration,41,17,24
4598,Halyconwings,outland,1470,druid,restoration,57,29,28
4599,Islandbôy,blackrock,1470,druid,restoration,42,16,26
4600,Hashtagone,ysondre,1468,druid,restoration,47,23,24
4601,Trúdl,das-konsortium,1466,druid,restoration,24,18,6
4602,Feyzoude,ysondre,1461,druid,restoration,40,24,16
4603,Drbse,silvermoon,1461,druid,restoration,56,28,28
4604,Цукерище,gordunni,1459,druid,restoration,40,25,15
4605,Cliftshifter,outland,1458,druid,restoration,36,25,11
4606,Styleexd,ragnaros,1458,druid,restoration,69,39,30
4607,Маминапуська,soulflayer,1458,druid,restoration,57,32,25
4608,Spliçe,draenor,1458,druid,restoration,42,21,21
4609,Arlandia,drakthul,1458,druid,restoration,42,17,25
4610,Bakicadr,sylvanas,1454,druid,restoration,27,17,10
4611,Ööh,outland,1453,druid,restoration,48,25,23
4612,Warami,eredar,1453,druid,restoration,54,24,30
4613,Ивантяй,gordunni,1452,druid,restoration,137,71,66
4614,Euskal,chogall,1451,druid,restoration,42,18,24
4615,Deltalol,blackmoore,1450,druid,restoration,48,25,23
4616,Dafapa,twilights-hammer,1447,druid,restoration,42,21,21
4617,Vashiko,tarren-mill,1446,druid,restoration,83,41,42
4618,Bearliheals,draenor,1445,druid,restoration,75,45,30
4619,Brorsnor,ravencrest,1445,druid,restoration,86,38,48
4620,Xyruden,kazzak,1441,druid,restoration,171,69,102
4621,Eldi,uldum,1438,druid,restoration,30,15,15
4622,Trõn,draenor,1436,druid,restoration,155,92,63
4623,Síggíe,eredar,1436,druid,restoration,30,17,13
4624,Shredzz,ravencrest,1436,druid,restoration,36,15,21
4625,Dartdogg,sanguino,1436,druid,restoration,65,22,43
4626,Блумха,howling-fjord,1435,druid,restoration,66,34,32
4627,Solàryx,hyjal,1434,druid,restoration,72,38,34
4628,Shiftycents,ravencrest,1433,druid,restoration,24,15,9
4629,Scra,anubarak,1433,druid,restoration,107,55,52
4630,Ráw,dun-modr,1433,druid,restoration,96,44,52
4631,Kukisanban,stormscale,1432,druid,restoration,314,168,146
4632,Bägira,sylvanas,1431,druid,restoration,255,135,120
4633,Bulldócer,sanguino,1431,druid,restoration,36,15,21
4634,Doodougie,silvermoon,1430,druid,restoration,36,15,21
4635,Pumplt,thrall,1429,druid,restoration,54,31,23
4636,Òniz,hyjal,1428,druid,restoration,46,30,16
4637,Maethar,stormrage,1428,druid,restoration,111,67,44
4638,Lindorel,khaz-modan,1428,druid,restoration,30,15,15
4639,Analmonstret,shattered-hand,1427,druid,restoration,35,17,18
4640,Друлёнышь,eversong,1426,druid,restoration,173,90,83
4641,Вексиус,gordunni,1425,druid,restoration,54,26,28
4642,Weisslogia,aegwynn,1424,druid,restoration,30,15,15
4643,Febricyla,blackmoore,1424,druid,restoration,48,23,25
4644,Filyina,blackrock,1424,druid,restoration,105,46,59
4645,Wenciorek,kazzak,1423,druid,restoration,135,67,68
4646,Georn,sylvanas,1423,druid,restoration,36,15,21
4647,Jnzymiau,blackrock,1422,druid,restoration,58,31,27
4648,Senoka,shattrath,1419,druid,restoration,191,101,90
4649,Shiftyshaft,tarren-mill,1419,druid,restoration,116,56,60
4650,Tokifong,kazzak,1419,druid,restoration,36,15,21
4651,Twerkdabooty,azjolnerub,1416,druid,restoration,30,15,15
4652,Yunalaa,blackmoore,1415,druid,restoration,44,25,19
4653,Drineh,ravencrest,1415,druid,restoration,42,19,23
4654,Ráay,blackrock,1414,druid,restoration,66,34,32
4655,Друидсимба,howling-fjord,1413,druid,restoration,170,92,78
4656,Rawillinen,kazzak,1413,druid,restoration,36,18,18
4657,Кингкиса,gordunni,1412,druid,restoration,36,15,21
4658,Kajiun,silvermoon,1411,druid,restoration,48,28,20
4659,Antheiaa,frostmane,1411,druid,restoration,72,32,40
4660,Theeix,silvermoon,1410,druid,restoration,66,33,33
4661,Mortagua,kazzak,1410,druid,restoration,36,15,21
4662,Jugaia,frostmourne,1409,druid,restoration,41,19,22
4663,Ilyethea,earthen-ring,1408,druid,restoration,447,237,210
4664,Lukass,drakthul,1408,druid,restoration,188,96,92
4665,Thanom,auchindoun,1406,druid,restoration,246,124,122
4666,Plàntz,tarren-mill,1406,druid,restoration,79,39,40
4667,Drukae,stormscale,1406,druid,restoration,54,23,31
4668,Làhen,ravencrest,1404,druid,restoration,225,109,116
4669,Wooshy,kazzak,1403,druid,restoration,52,25,27
4670,Rytmusdudu,ragnaros,1403,druid,restoration,42,19,23
4671,Béccàbtw,draenor,1402,druid,restoration,30,16,14
4672,Suprot,aggramar,1402,druid,restoration,106,52,54
4673,Røxhot,archimonde,1401,druid,restoration,66,41,25
4674,Hellofresh,silvermoon,1399,druid,restoration,54,21,33
4675,Qri,ahnqiraj,1398,druid,restoration,36,22,14
4676,Feinberg,stormscale,1397,druid,restoration,101,44,57
4677,Phebzdrood,archimonde,1396,druid,restoration,45,27,18
4678,Mindru,sylvanas,1396,druid,restoration,51,24,27
4679,Wagoneis,grim-batol,1395,druid,restoration,58,28,30
4680,Cesn,vashj,1395,druid,restoration,42,15,27
4681,Sandirion,silvermoon,1394,druid,restoration,524,258,266
4682,Papjin,blackhand,1392,druid,restoration,36,23,13
4683,Shufflê,blackmoore,1392,druid,restoration,125,57,68
4684,Champaa,aggra-português,1392,druid,restoration,46,16,30
4685,Bloompuf,draenor,1391,druid,restoration,124,54,70
4686,Zyndril,silvermoon,1390,druid,restoration,38,17,21
4687,Leafceld,aggra-português,1388,druid,restoration,54,22,32
4688,Катяблум,gordunni,1387,druid,restoration,84,36,48
4689,Jikuni,ravencrest,1386,druid,restoration,42,20,22
4690,Clovér,outland,1384,druid,restoration,77,35,42
4691,Lestty,the-maelstrom,1383,druid,restoration,58,32,26
4692,Gandraste,neptulon,1379,druid,restoration,24,19,5
4693,Азя,blackscar,1379,druid,restoration,54,22,32
4694,Scaleo,stormreaver,1377,druid,restoration,78,46,32
4695,Kramit,ravencrest,1376,druid,restoration,48,25,23
4696,Blacksage,dragonmaw,1376,druid,restoration,107,50,57
4697,Fth,dethecus,1375,druid,restoration,24,16,8
4698,Spacedout,taerar,1375,druid,restoration,61,33,28
4699,Kooglaash,kazzak,1372,druid,restoration,103,49,54
4700,Hideme,tarren-mill,1371,druid,restoration,78,34,44
4701,Badbloom,ravencrest,1370,druid,restoration,46,22,24
4702,Erebear,ravencrest,1369,druid,restoration,59,34,25
4703,Akasuky,thrall,1369,druid,restoration,42,22,20
4704,Saintbiose,dalaran,1368,druid,restoration,24,17,7
4705,Sgtdrood,archimonde,1367,druid,restoration,36,17,19
4706,Мекс,gordunni,1366,druid,restoration,23,15,8
4707,Будклим,blackscar,1366,druid,restoration,24,15,9
4708,Balanc,ragnaros,1366,druid,restoration,42,22,20
4709,Avimoo,tarren-mill,1364,druid,restoration,41,22,19
4710,Hotsexpress,aegwynn,1360,druid,restoration,42,16,26
4711,Badbeliø,hyjal,1360,druid,restoration,82,31,51
4712,Cörelly,ravencrest,1358,druid,restoration,187,108,79
4713,Bronox,ragnaros,1358,druid,restoration,71,34,37
4714,Zwierzyniec,jaedenar,1357,druid,restoration,60,27,33
4715,Xontpos,stormscale,1356,druid,restoration,24,15,9
4716,Sertris,kazzak,1352,druid,restoration,58,23,35
4717,Ravenfang,dun-modr,1351,druid,restoration,54,34,20
4718,Nayokô,grim-batol,1351,druid,restoration,66,33,33
4719,Царапкатян,gordunni,1351,druid,restoration,212,101,111
4720,Althei,argent-dawn,1349,druid,restoration,45,22,23
4721,Biomat,norgannon,1348,druid,restoration,33,16,17
4722,Kormakurr,silvermoon,1347,druid,restoration,45,24,21
4723,Wwvwwvwwvwvw,burning-legion,1347,druid,restoration,75,27,48
4724,Ipossible,kazzak,1347,druid,restoration,48,16,32
4725,Hotsandpot,outland,1346,druid,restoration,36,15,21
4726,Duharbrahud,outland,1345,druid,restoration,54,22,32
4727,Feralgodx,quelthalas,1344,druid,restoration,27,16,11
4728,Zaeli,archimonde,1344,druid,restoration,24,14,10
4729,Stiffýz,archimonde,1343,druid,restoration,24,14,10
4730,Lindémann,blackhand,1343,druid,restoration,36,19,17
4731,Acxaryl,ravencrest,1343,druid,restoration,30,14,16
4732,Stevedru,ravencrest,1342,druid,restoration,24,14,10
4733,Brømberry,blackrock,1342,druid,restoration,155,75,80
4734,Рефикс,gordunni,1340,druid,restoration,109,68,41
4735,Rabacki,blackmoore,1339,druid,restoration,102,48,54
4736,Bibeed,blackmoore,1339,druid,restoration,36,14,22
4737,Woohoo,ravencrest,1338,druid,restoration,24,14,10
4738,Cylantus,eredar,1337,druid,restoration,18,15,3
4739,Idect,silvermoon,1337,druid,restoration,130,68,62
4740,Ванечка,razuvious,1337,druid,restoration,36,14,22
4741,Malacella,marécage-de-zangar,1335,druid,restoration,36,14,22
4742,Shifthappénz,draenor,1334,druid,restoration,60,28,32
4743,Morfer,grim-batol,1333,druid,restoration,145,77,68
4744,Likh,das-konsortium,1332,druid,restoration,24,14,10
4745,Yenwe,kazzak,1332,druid,restoration,185,96,89
4746,Вакидзами,gordunni,1331,druid,restoration,48,28,20
4747,Emodruid,sunstrider,1330,druid,restoration,24,14,10
4748,Ekaterina,dun-morogh,1330,druid,restoration,75,42,33
4749,Roshava,stormscale,1329,druid,restoration,46,27,19
4750,Autoritär,gilneas,1326,druid,restoration,106,58,48
4751,Hidras,tarren-mill,1326,druid,restoration,48,21,27
4752,Minipilsen,outland,1325,druid,restoration,36,16,20
4753,Milkmepls,balnazzar,1324,druid,restoration,24,14,10
4754,Knzm,dun-modr,1323,druid,restoration,120,62,58
4755,Teengirl,blackmoore,1323,druid,restoration,30,14,16
4756,Blomberg,burning-legion,1321,druid,restoration,18,14,4
4757,Panpanqcul,archimonde,1321,druid,restoration,23,17,6
4758,Microw,ghostlands,1321,druid,restoration,111,59,52
4759,Buckxxz,nazjatar,1320,druid,restoration,30,17,13
4760,Exïlla,archimonde,1320,druid,restoration,30,15,15
4761,Koemarkt,sunstrider,1319,druid,restoration,46,29,17
4762,Endoplazmik,silvermoon,1319,druid,restoration,61,36,25
4763,Seherbaz,ravencrest,1319,druid,restoration,30,14,16
4764,Крайсонг,soulflayer,1316,druid,restoration,42,21,21
4765,Didi,frostwhisper,1316,druid,restoration,86,39,47
4766,Manuka,argent-dawn,1315,druid,restoration,88,48,40
4767,Bigßoi,stormscale,1315,druid,restoration,108,54,54
4768,Groundpovx,blackmoore,1315,druid,restoration,30,14,16
4769,Snuffurious,ragnaros,1314,druid,restoration,24,14,10
4770,Elysea,antonidas,1313,druid,restoration,66,31,35
4771,Dortalon,outland,1313,druid,restoration,72,30,42
4772,Kattbjörnen,ragnaros,1312,druid,restoration,207,110,97
4773,Лэвиш,blackscar,1310,druid,restoration,24,14,10
4774,Forzendl,twisting-nether,1310,druid,restoration,42,22,20
4775,Mangy,xavius,1309,druid,restoration,78,39,39
4776,Иггдрассиль,blackscar,1309,druid,restoration,30,15,15
4777,Nuwell,arathor,1309,druid,restoration,132,62,70
4778,Maghh,ravencrest,1307,druid,restoration,34,19,15
4779,Closér,stormscale,1307,druid,restoration,54,27,27
4780,Disclaimed,twisting-nether,1307,druid,restoration,36,15,21
4781,Cultivatedz,twisting-nether,1306,druid,restoration,54,24,30
4782,Basilethe,hyjal,1304,druid,restoration,30,17,13
4783,Тырубльдуде,gordunni,1302,druid,restoration,51,26,25
4784,Boomayé,archimonde,1301,druid,restoration,56,34,22
4785,Nelffie,kazzak,1300,druid,restoration,138,74,64
4786,Budspencebär,draenor,1300,druid,restoration,30,16,14
4787,Benzimaax,ragnaros,1299,druid,restoration,42,21,21
4788,Hanibalector,silvermoon,1298,druid,restoration,45,24,21
4789,Vioboomie,blackrock,1298,druid,restoration,33,17,16
4790,Ekologiskxx,outland,1296,druid,restoration,85,40,45
4791,Wannabanhere,outland,1295,druid,restoration,41,16,25
4792,Atsumåsterx,archimonde,1294,druid,restoration,46,19,27
4793,Beesoup,blackrock,1291,druid,restoration,21,15,6
4794,Phatbushy,silvermoon,1291,druid,restoration,35,16,19
4795,Karodoom,twisting-nether,1290,druid,restoration,42,26,16
4796,Flum,darksorrow,1289,druid,restoration,149,77,72
4797,Brosephiné,stormscale,1289,druid,restoration,30,14,16
4798,Varrdru,kazzak,1288,druid,restoration,91,42,49
4799,Khalec,silvermoon,1287,druid,restoration,40,24,16
4800,Bennydruid,kazzak,1286,druid,restoration,112,46,66
4801,Хуссипусси,galakrond,1285,druid,restoration,29,14,15
4802,Parkydru,draenor,1284,druid,restoration,24,15,9
4803,Kattig,grim-batol,1284,druid,restoration,44,21,23
4804,Seikoo,defias-brotherhood,1284,druid,restoration,91,41,50
4805,Yeats,blackmoore,1283,druid,restoration,48,20,28
4806,Paawz,stormscale,1281,druid,restoration,65,33,32
4807,Glaskål,draenor,1281,druid,restoration,101,42,59
4808,Кнесис,howling-fjord,1278,druid,restoration,55,31,24
4809,Leliaen,sylvanas,1278,druid,restoration,75,39,36
4810,Diastra,silvermoon,1278,druid,restoration,255,128,127
4811,Cubalitis,tarren-mill,1276,druid,restoration,39,24,15
4812,Mv,gorgonnash,1276,druid,restoration,52,27,25
4813,Zaratras,arathor,1276,druid,restoration,79,39,40
4814,Nøbødy,silvermoon,1276,druid,restoration,29,14,15
4815,Exoar,ravencrest,1275,druid,restoration,59,27,32
4816,Grololotte,dalaran,1274,druid,restoration,183,97,86
4817,Rrayed,kazzak,1274,druid,restoration,94,47,47
4818,Tanariel,ravencrest,1273,druid,restoration,48,24,24
4819,Урька,blackscar,1273,druid,restoration,71,32,39
4820,Thornat,chamber-of-aspects,1270,druid,restoration,59,32,27
4821,Arulol,aegwynn,1270,druid,restoration,54,25,29
4822,Wazam,kazzak,1269,druid,restoration,152,77,75
4823,ßløøm,outland,1268,druid,restoration,44,27,17
4824,Madshad,draenor,1268,druid,restoration,48,19,29
4825,Julss,archimonde,1267,druid,restoration,114,58,56
4826,Mchots,ragnaros,1267,druid,restoration,95,42,53
4827,Walexx,kazzak,1266,druid,restoration,44,25,19
4828,Delmond,sylvanas,1266,druid,restoration,185,93,92
4829,Nalreaa,kazzak,1265,druid,restoration,48,27,21
4830,Lalon,blackrock,1265,druid,restoration,48,24,24
4831,Noxlunaire,ravencrest,1265,druid,restoration,58,25,33
4832,Elainx,thrall,1264,druid,restoration,30,16,14
4833,Hotto,antonidas,1263,druid,restoration,18,15,3
4834,Cemiink,drakthul,1263,druid,restoration,42,29,13
4835,Дюссельдорф,blackscar,1263,druid,restoration,30,19,11
4836,Shelby,tirion,1263,druid,restoration,81,41,40
4837,Обейрин,gordunni,1261,druid,restoration,78,40,38
4838,Cuxorb,rexxar,1259,druid,restoration,48,21,27
4839,Delarion,nemesis,1258,druid,restoration,36,21,15
4840,Krizak,eredar,1258,druid,restoration,107,61,46
4841,Orten,dun-modr,1258,druid,restoration,48,25,23
4842,Ponytheone,burning-legion,1258,druid,restoration,36,14,22
4843,Chinoiserie,aszune,1255,druid,restoration,209,108,101
4844,Zadrood,rashgarroth,1254,druid,restoration,33,16,17
4845,Närthex,kazzak,1253,druid,restoration,24,14,10
4846,Solstrale,ravencrest,1252,druid,restoration,67,29,38
4847,Bloomer,stormreaver,1251,druid,restoration,42,21,21
4848,Випера,gordunni,1249,druid,restoration,36,19,17
4849,Nizkul,dun-modr,1249,druid,restoration,80,37,43
4850,Deltsur,stormscale,1247,druid,restoration,35,17,18
4851,Кэлиборн,gordunni,1246,druid,restoration,53,26,27
4852,Xomeboci,draenor,1246,druid,restoration,42,14,28
4853,Bunzor,sylvanas,1245,druid,restoration,18,13,5
4854,Eko,auchindoun,1245,druid,restoration,117,58,59
4855,Hotlotta,aegwynn,1244,druid,restoration,24,13,11
4856,Naphé,ysondre,1243,druid,restoration,18,13,5
4857,Crep,krasus,1243,druid,restoration,30,21,9
4858,Erdnuckèl,antonidas,1242,druid,restoration,27,18,9
4859,Robutt,runetotem,1242,druid,restoration,40,25,15
4860,Gnaro,ragnaros,1242,druid,restoration,76,40,36
4861,Plantpuzzl,silvermoon,1242,druid,restoration,42,13,29
4862,Shaelx,nethersturm,1241,druid,restoration,30,13,17
4863,Göli,argent-dawn,1240,druid,restoration,32,16,16
4864,Siuo,ravencrest,1240,druid,restoration,30,13,17
4865,Amoreah,silvermoon,1239,druid,restoration,103,45,58
4866,Ironveins,ravencrest,1238,druid,restoration,42,28,14
4867,Malbo,archimonde,1238,druid,restoration,24,13,11
4868,Коляскальяс,howling-fjord,1238,druid,restoration,112,43,69
4869,Juicy,stormreaver,1237,druid,restoration,42,26,16
4870,Irondruid,silvermoon,1236,druid,restoration,105,58,47
4871,Artichte,archimonde,1236,druid,restoration,24,13,11
4872,Ghaara,outland,1231,druid,restoration,49,28,21
4873,Layzz,archimonde,1231,druid,restoration,29,13,16
4874,Корнерит,gordunni,1229,druid,restoration,82,43,39
4875,Ningannel,argent-dawn,1227,druid,restoration,65,26,39
4876,Razmus,lightbringer,1226,druid,restoration,24,13,11
4877,Vickepicke,stormreaver,1226,druid,restoration,30,16,14
4878,Acwi,dun-morogh,1226,druid,restoration,72,36,36
4879,Ninø,gorgonnash,1226,druid,restoration,51,25,26
4880,Канимэ,howling-fjord,1226,druid,restoration,30,13,17
4881,Weregoon,blackmoore,1225,druid,restoration,191,91,100
4882,Jyggz,azshara,1224,druid,restoration,33,19,14
4883,Mitnik,stormscale,1223,druid,restoration,128,73,55
4884,Fettpumpad,karazhan,1221,druid,restoration,103,59,44
4885,Harei,archimonde,1221,druid,restoration,24,13,11
4886,Memento,kazzak,1220,druid,restoration,24,13,11
4887,Азазиона,gordunni,1220,druid,restoration,30,13,17
4888,Mochiløxz,tarren-mill,1219,druid,restoration,66,35,31
4889,Liquis,outland,1219,druid,restoration,127,63,64
4890,Siako,sanguino,1218,druid,restoration,71,32,39
4891,Arear,frostmane,1216,druid,restoration,85,40,45
4892,Silvyan,silvermoon,1216,druid,restoration,39,17,22
4893,Ischumekcid,anubarak,1215,druid,restoration,24,13,11
4894,Bonsai,terrordar,1215,druid,restoration,43,21,22
4895,Tommix,ravencrest,1214,druid,restoration,26,14,12
4896,Киберужас,gordunni,1214,druid,restoration,173,90,83
4897,Ceapamatii,sylvanas,1213,druid,restoration,54,30,24
4898,Дуггизавр,howling-fjord,1213,druid,restoration,29,13,16
4899,Deretus,blackmoore,1213,druid,restoration,34,13,21
4900,Lépaw,twisting-nether,1212,druid,restoration,95,46,49
4901,Tsurío,thrall,1211,druid,restoration,108,60,48
4902,Ýanux,aegwynn,1210,druid,restoration,22,14,8
4903,Dreaddot,archimonde,1210,druid,restoration,24,13,11
4904,Séyla,blackrock,1209,druid,restoration,24,13,11
4905,Zelíx,bronzebeard,1208,druid,restoration,71,41,30
4906,Cazzette,grim-batol,1208,druid,restoration,46,26,20
4907,Aebí,dalaran,1208,druid,restoration,24,13,11
4908,Shapeshafter,twisting-nether,1207,druid,restoration,114,56,58
4909,Vícvega,ravencrest,1206,druid,restoration,52,28,24
4910,Midnightstry,alakir,1206,druid,restoration,304,158,146
4911,Bearinator,aggramar,1205,druid,restoration,116,63,53
4912,Maxekaxe,sylvanas,1205,druid,restoration,47,22,25
4913,Menolao,dun-morogh,1203,druid,restoration,62,36,26
4914,Farodiin,blackmoore,1203,druid,restoration,138,73,65
4915,Эверих,soulflayer,1203,druid,restoration,71,34,37
4916,Багетлюбви,howling-fjord,1203,druid,restoration,39,18,21
4917,Callìa,sylvanas,1203,druid,restoration,71,32,39
4918,Bonza,agamaggan,1202,druid,restoration,84,39,45
4919,Schwertlilie,aegwynn,1202,druid,restoration,29,13,16
4920,Дилайт,blackscar,1201,druid,restoration,30,13,17
4921,Saberrtooth,twisting-nether,1201,druid,restoration,66,25,41
4922,Namenloser,azshara,1200,druid,restoration,72,39,33
4923,Goodzychoo,silvermoon,1199,druid,restoration,36,17,19
4924,Wtfck,outland,1199,druid,restoration,90,42,48
4925,Weiden,twisting-nether,1199,druid,restoration,42,19,23
4926,Telaroxx,die-nachtwache,1199,druid,restoration,36,13,23
4927,Basajáun,dun-modr,1198,druid,restoration,60,21,39
4928,Karlsn,ravencrest,1197,druid,restoration,25,14,11
4929,Arazorwyn,ravencrest,1196,druid,restoration,77,45,32
4930,Shadraw,arakarahm,1195,druid,restoration,30,13,17
4931,Amakary,blackrock,1193,druid,restoration,42,19,23
4932,Стенлимур,eversong,1191,druid,restoration,54,27,27
4933,Yazari,nathrezim,1188,druid,restoration,36,14,22
4934,Chable,hyjal,1187,druid,restoration,60,31,29
4935,Wiyah,hyjal,1186,druid,restoration,30,14,16
4936,Rakúsh,thrall,1184,druid,restoration,37,21,16
4937,Jiujiteiro,tarren-mill,1184,druid,restoration,47,26,21
4938,Baldurix,blackrock,1184,druid,restoration,32,15,17
4939,Collîî,aegwynn,1183,druid,restoration,44,25,19
4940,Thieane,blackhand,1183,druid,restoration,24,13,11
4941,Kryptonîte,twisting-nether,1183,druid,restoration,28,13,15
4942,Inkeyes,outland,1182,druid,restoration,107,45,62
4943,Shenandoah,hyjal,1181,druid,restoration,42,25,17
4944,Vanlise,ravencrest,1181,druid,restoration,90,42,48
4945,Nissemand,ravencrest,1180,druid,restoration,54,28,26
4946,Papanik,tarren-mill,1179,druid,restoration,54,30,24
4947,Soratess,azshara,1179,druid,restoration,45,19,26
4948,Exane,ragnaros,1178,druid,restoration,30,18,12
4949,Mutato,draenor,1178,druid,restoration,216,118,98
4950,Amberleaff,auchindoun,1178,druid,restoration,31,16,15
4951,Luneriá,blackmoore,1176,druid,restoration,42,15,27
4952,Thaldrenaar,argent-dawn,1175,druid,restoration,38,15,23
4953,Hílarío,sanguino,1174,druid,restoration,38,13,25
4954,Restopesto,silvermoon,1173,druid,restoration,38,22,16
4955,Ubbeleg,kazzak,1172,druid,restoration,42,22,20
4956,Tsuteymanga,veknilash,1172,druid,restoration,66,33,33
4957,Digestivebis,defias-brotherhood,1170,druid,restoration,91,55,36
4958,Shinymoomoo,tarren-mill,1169,druid,restoration,27,14,13
4959,Mayurí,kazzak,1166,druid,restoration,30,18,12
4960,Xdrus,argent-dawn,1166,druid,restoration,50,26,24
4961,Вертуос,soulflayer,1166,druid,restoration,51,23,28
4962,Halleyz,hyjal,1163,druid,restoration,135,70,65
4963,Bynxx,antonidas,1163,druid,restoration,118,57,61
4964,Eô,antonidas,1163,druid,restoration,30,14,16
4965,Madschinken,malganis,1162,druid,restoration,71,28,43
4966,Mchøt,ravencrest,1162,druid,restoration,62,23,39
4967,Fricky,burning-blade,1161,druid,restoration,24,16,8
4968,Forzend,twisting-nether,1161,druid,restoration,20,13,7
4969,Дудумейстер,howling-fjord,1160,druid,restoration,144,60,84
4970,Lethius,silvermoon,1158,druid,restoration,33,15,18
4971,Makelsi,tarren-mill,1158,druid,restoration,36,15,21
4972,Ушастикэ,gordunni,1157,druid,restoration,32,27,5
4973,Бульбион,gordunni,1157,druid,restoration,133,68,65
4974,Røsary,stormscale,1156,druid,restoration,81,43,38
4975,Walenok,thrall,1155,druid,restoration,185,90,95
4976,Cäsïo,khaz-modan,1154,druid,restoration,54,32,22
4977,Corias,blackmoore,1154,druid,restoration,42,14,28
4978,Pikkusuhnu,twisting-nether,1152,druid,restoration,30,12,18
4979,Ÿdrassia,archimonde,1152,druid,restoration,44,17,27
4980,Lfsecondreju,ravencrest,1151,druid,restoration,18,12,6
4981,Dyloxe,silvermoon,1151,druid,restoration,24,12,12
4982,Zekmvp,silvermoon,1151,druid,restoration,24,12,12
4983,Ковамедведь,borean-tundra,1151,druid,restoration,65,27,38
4984,Hotop,draenor,1151,druid,restoration,30,12,18
4985,Древнина,gordunni,1150,druid,restoration,96,51,45
4986,Rozt,ravencrest,1150,druid,restoration,24,12,12
4987,Dreathqt,twisting-nether,1150,druid,restoration,24,12,12
4988,Sâty,draenor,1150,druid,restoration,36,14,22
4989,Пупсики,gordunni,1149,druid,restoration,68,29,39
4990,Burattino,draenor,1147,druid,restoration,12,12,0
4991,Olympïee,archimonde,1147,druid,restoration,24,12,12
4992,Zuuhhl,ravencrest,1146,druid,restoration,18,12,6
4993,Eluñeãdore,silvermoon,1146,druid,restoration,41,26,15
4994,Mcneil,wrathbringer,1146,druid,restoration,36,20,16
4995,Elmáestró,aegwynn,1146,druid,restoration,24,12,12
4996,Hordzee,blackmoore,1146,druid,restoration,58,25,33
4997,Фатуомуэрте,razuvious,1146,druid,restoration,30,12,18
4998,Saimdude,blackrock,1145,druid,restoration,48,25,23
4999,Elainia,emerald-dream,1144,druid,restoration,24,12,12
5000,Mikshak,drakthul,1144,druid,restoration,24,12,12
5001,Trànsformer,nemesis,1142,druid,restoration,30,12,18
5002,Möllemäck,sylvanas,1141,druid,restoration,18,12,6
5003,Rockyfella,alexstrasza,1141,druid,restoration,24,12,12
5004,Lynysae,blackmoore,1141,druid,restoration,29,13,16
5005,Ajwen,tarren-mill,1141,druid,restoration,30,12,18
5006,Clownrad,tarren-mill,1141,druid,restoration,30,12,18
5007,Stuu,nathrezim,1140,druid,restoration,24,12,12
5008,Adiycrazy,outland,1138,druid,restoration,54,22,32
5009,Hót,ravencrest,1138,druid,restoration,42,14,28
5010,Obamos,stormscale,1136,druid,restoration,18,12,6
5011,Golddy,hyjal,1136,druid,restoration,80,38,42
5012,Lucael,blackmoore,1135,druid,restoration,66,24,42
5013,Lisovamavka,draenor,1134,druid,restoration,64,32,32
5014,Moundîr,archimonde,1134,druid,restoration,54,21,33
5015,Lïs,the-maelstrom,1133,druid,restoration,49,29,20
5016,Druidorie,ravencrest,1133,druid,restoration,24,12,12
5017,Curoahojas,silvermoon,1132,druid,restoration,130,56,74
5018,Racadruid,antonidas,1132,druid,restoration,48,17,31
5019,Bioházard,blackrock,1130,druid,restoration,36,20,16
5020,Neri,shattered-hand,1130,druid,restoration,24,12,12
5021,Spacenoub,archimonde,1130,druid,restoration,24,12,12
5022,Thunderzeus,mazrigos,1129,druid,restoration,40,20,20
5023,Druiddingo,lightnings-blade,1127,druid,restoration,24,12,12
5024,Sariel,saurfang,1127,druid,restoration,129,56,73
5025,Druibe,burning-legion,1127,druid,restoration,56,23,33
5026,Simplydrood,archimonde,1127,druid,restoration,30,12,18
5027,Dadud,twisting-nether,1126,druid,restoration,30,18,12
5028,Kbåkå,ravencrest,1125,druid,restoration,42,19,23
5029,Lil,elune,1124,druid,restoration,36,12,24
5030,Лаегмерил,gordunni,1120,druid,restoration,40,23,17
5031,Vranz,draenor,1120,druid,restoration,67,32,35
5032,Raysa,archimonde,1119,druid,restoration,69,35,34
5033,Domsz,dalaran,1119,druid,restoration,75,37,38
5034,Moonshîne,arygos,1117,druid,restoration,94,54,40
5035,Kikinho,argent-dawn,1117,druid,restoration,24,12,12
5036,Maryjuanita,silvermoon,1116,druid,restoration,146,64,82
5037,Heidepaa,tichondrius,1115,druid,restoration,30,13,17
5038,Celendiil,argent-dawn,1115,druid,restoration,103,30,73
5039,Lïlja,tarren-mill,1113,druid,restoration,24,15,9
5040,Ndnd,drakthul,1112,druid,restoration,82,42,40
5041,Herbiko,turalyon,1111,druid,restoration,182,93,89
5042,Mayhh,ragnaros,1111,druid,restoration,90,41,49
5043,Legharta,ravencrest,1111,druid,restoration,84,31,53
5044,Uvøgin,ragnaros,1109,druid,restoration,18,12,6
5045,Ðelnôs,destromath,1109,druid,restoration,42,15,27
5046,Blazor,eredar,1108,druid,restoration,52,24,28
5047,Arfedan,kazzak,1106,druid,restoration,66,35,31
5048,Klerosa,moonglade,1105,druid,restoration,56,24,32
5049,Berdix,ragnaros,1103,druid,restoration,25,14,11
5050,Thaibarian,shattered-hand,1102,druid,restoration,48,26,22
5051,Zirkuszwei,aegwynn,1102,druid,restoration,29,14,15
5052,Mikeisbike,ragnaros,1101,druid,restoration,21,13,8
5053,Vertymbras,hyjal,1101,druid,restoration,44,25,19
5054,Ankhenature,outland,1100,druid,restoration,71,40,31
5055,Shadowmeld,stormreaver,1100,druid,restoration,32,13,19
5056,Catkayn,stormscale,1100,druid,restoration,36,12,24
5057,Räysa,archimonde,1098,druid,restoration,214,105,109
5058,Solutionx,aegwynn,1096,druid,restoration,33,13,20
5059,Ccmydcv,archimonde,1095,druid,restoration,25,13,12
5060,Snowrk,hyjal,1093,druid,restoration,54,31,23
5061,Tharandrél,argent-dawn,1092,druid,restoration,72,20,52
5062,Relxc,outland,1091,druid,restoration,18,13,5
5063,Spikill,uldaman,1091,druid,restoration,24,16,8
5064,Тианна,razuvious,1091,druid,restoration,48,24,24
5065,Zillo,stormscale,1091,druid,restoration,80,34,46
5066,Ayehotx,ragnaros,1090,druid,restoration,35,15,20
5067,Hotouck,hyjal,1089,druid,restoration,38,22,16
5068,Mayte,ragnaros,1088,druid,restoration,23,14,9
5069,Ganoförd,zuljin,1087,druid,restoration,19,13,6
5070,Taatz,stormscale,1087,druid,restoration,85,33,52
5071,Relache,twisting-nether,1086,druid,restoration,48,26,22
5072,Alexstraza,arthas,1085,druid,restoration,49,23,26
5073,Сваткумбрат,eversong,1084,druid,restoration,108,40,68
5074,Jamburapro,sylvanas,1082,druid,restoration,130,69,61
5075,Ghostbustér,emeriss,1081,druid,restoration,61,36,25
5076,Niknoom,azjolnerub,1081,druid,restoration,110,63,47
5077,Bazilika,argent-dawn,1080,druid,restoration,137,74,63
5078,Georn,bladefist,1079,druid,restoration,17,12,5
5079,Vurgyl,hyjal,1079,druid,restoration,54,33,21
5080,Theridrax,twisting-nether,1078,druid,restoration,38,18,20
5081,Wyngx,blackrock,1076,druid,restoration,60,34,26
5082,Zarlaac,ravencrest,1075,druid,restoration,66,27,39
5083,Drúídárn,talnivarr,1074,druid,restoration,54,26,28
5084,Bloomly,tarren-mill,1073,druid,restoration,36,18,18
5085,Jagerdog,archimonde,1072,druid,restoration,13,12,1
5086,Кишкинахир,razuvious,1072,druid,restoration,42,22,20
5087,Алунар,lich-king,1070,druid,restoration,84,39,45
5088,Petitchät,archimonde,1069,druid,restoration,46,23,23
5089,Инский,howling-fjord,1069,druid,restoration,49,24,25
5090,Mirana,drakthul,1067,druid,restoration,39,21,18
5091,Аматэррасу,blackscar,1067,druid,restoration,36,18,18
5092,Betelgues,kazzak,1066,druid,restoration,132,70,62
5093,Elanrya,argent-dawn,1066,druid,restoration,53,15,38
5094,Gyvunas,silvermoon,1065,druid,restoration,43,25,18
5095,Djungelgrabb,twisting-nether,1064,druid,restoration,48,22,26
5096,Dreäms,ravencrest,1063,druid,restoration,152,83,69
5097,Shadowcat,archimonde,1063,druid,restoration,25,12,13
5098,Secondage,blackmoore,1057,druid,restoration,56,24,32
5099,Shylanna,ragnaros,1057,druid,restoration,28,12,16
5100,Kókushibò,archimonde,1056,druid,restoration,12,11,1
5101,Justforgames,ravencrest,1056,druid,restoration,12,11,1
5102,Degentiuso,alakir,1056,druid,restoration,30,21,9
5103,Kobrá,ravencrest,1056,druid,restoration,18,11,7
5104,Bananadru,stormscale,1056,druid,restoration,18,11,7
5105,Isitbleedin,silvermoon,1056,druid,restoration,18,11,7
5106,Noramun,alexstrasza,1056,druid,restoration,18,11,7
5107,Лабирошка,blackscar,1056,druid,restoration,24,11,13
5108,Хлайси,gordunni,1056,druid,restoration,24,11,13
5109,Taurvid,outland,1056,druid,restoration,24,11,13
5110,Bigbones,frostwolf,1056,druid,restoration,72,24,48
5111,Happypeanut,blackmoore,1055,druid,restoration,18,11,7
5112,Fotmrerollér,darksorrow,1055,druid,restoration,63,34,29
5113,Chocofrijj,tarren-mill,1055,druid,restoration,24,11,13
5114,Арбузир,howling-fjord,1055,druid,restoration,54,21,33
5115,Ðezo,stormscale,1055,druid,restoration,30,11,19
5116,Slimp,the-maelstrom,1055,druid,restoration,30,11,19
5117,Oschlandor,blackmoore,1054,druid,restoration,12,11,1
5118,Светдру,blackscar,1054,druid,restoration,24,11,13
5119,Solern,ravencrest,1054,druid,restoration,24,11,13
5120,Elviiradruid,tarren-mill,1053,druid,restoration,24,11,13
5121,Lemicus,twisting-nether,1053,druid,restoration,30,11,19
5122,Jackyblue,silvermoon,1053,druid,restoration,30,11,19
5123,Noskillx,auchindoun,1052,druid,restoration,12,11,1
5124,Тчаёк,gordunni,1052,druid,restoration,21,13,8
5125,Benjosef,blackmoore,1051,druid,restoration,62,31,31
5126,Muminoses,burning-legion,1051,druid,restoration,30,11,19
5127,Fondü,outland,1050,druid,restoration,18,11,7
5128,Druidenbeton,antonidas,1050,druid,restoration,24,13,11
5129,Larlye,dun-modr,1050,druid,restoration,24,11,13
5130,Exilia,kragjin,1050,druid,restoration,24,11,13
5131,Spidete,sanguino,1049,druid,restoration,78,41,37
5132,Uuni,sylvanas,1049,druid,restoration,30,11,19
5133,Влажныйдру,soulflayer,1048,druid,restoration,24,11,13
5134,Cigamt,kazzak,1047,druid,restoration,18,12,6
5135,Felfran,ravencrest,1047,druid,restoration,36,13,23
5136,Kirïllx,silvermoon,1046,druid,restoration,89,47,42
5137,Trolléverte,archimonde,1046,druid,restoration,69,34,35
5138,Sodamncute,ravencrest,1046,druid,restoration,24,11,13
5139,Jehtrotull,nemesis,1046,druid,restoration,40,17,23
5140,Pzyhlol,anetheron,1045,druid,restoration,18,11,7
5141,Soný,aegwynn,1043,druid,restoration,24,11,13
5142,Greengolly,argent-dawn,1042,druid,restoration,30,11,19
5143,Luarbak,kazzak,1041,druid,restoration,18,11,7
5144,Hypnosoad,outland,1041,druid,restoration,160,72,88
5145,Xenva,blackmoore,1041,druid,restoration,54,24,30
5146,Malleria,blackmoore,1041,druid,restoration,30,13,17
5147,Spoco,defias-brotherhood,1040,druid,restoration,102,56,46
5148,Ранок,fordragon,1040,druid,restoration,24,11,13
5149,Жолудь,gordunni,1040,druid,restoration,66,28,38
5150,Dfjguidfg,baelgun,1040,druid,restoration,36,13,23
5151,Дремлин,deathguard,1038,druid,restoration,212,99,113
5152,Kezbaniye,silvermoon,1035,druid,restoration,18,11,7
5153,Lutzmiller,eredar,1035,druid,restoration,236,112,124
5154,Growiêlle,ravencrest,1034,druid,restoration,30,17,13
5155,Pakù,archimonde,1033,druid,restoration,12,11,1
5156,Vextron,burning-legion,1030,druid,restoration,26,13,13
5157,Xadidruîd,blackrock,1030,druid,restoration,42,11,31
5158,Mendozä,stormscale,1029,druid,restoration,82,38,44
5159,Hopê,burning-legion,1028,druid,restoration,108,61,47
5160,Corrupthz,outland,1028,druid,restoration,24,11,13
5161,Storpboom,drakthul,1028,druid,restoration,31,13,18
5162,Chéchédroïd,marécage-de-zangar,1027,druid,restoration,64,30,34
5163,Klørfem,draenor,1027,druid,restoration,36,13,23
5164,Davincidru,tarren-mill,1026,druid,restoration,68,32,36
5165,Ella,kult-der-verdammten,1024,druid,restoration,24,15,9
5166,Raysien,doomhammer,1021,druid,restoration,24,13,11
5167,Shanikya,argent-dawn,1021,druid,restoration,44,20,24
5168,Elrroir,dun-modr,1021,druid,restoration,34,12,22
5169,Zyska,outland,1020,druid,restoration,223,103,120
5170,Baroona,kazzak,1019,druid,restoration,24,14,10
5171,Tângo,eredar,1019,druid,restoration,31,15,16
5172,Malandrin,khazgoroth,1019,druid,restoration,55,25,30
5173,Jagu,blackrock,1018,druid,restoration,30,16,14
5174,Santamonica,blackrock,1018,druid,restoration,36,13,23
5175,Эмканегодяйк,galakrond,1016,druid,restoration,95,50,45
5176,Омгдру,gordunni,1016,druid,restoration,117,53,64
5177,Sfarcolacul,tarren-mill,1013,druid,restoration,90,50,40
5178,Фераст,azuregos,1013,druid,restoration,24,11,13
5179,Zêrg,ysondre,1012,druid,restoration,24,11,13
5180,Komiker,ravencrest,1011,druid,restoration,47,29,18
5181,Dobbmaster,aegwynn,1011,druid,restoration,244,121,123
5182,Dirtyhacks,blackmoore,1010,druid,restoration,36,17,19
5183,Флиперкэт,howling-fjord,1010,druid,restoration,36,12,24
5184,Дендринис,gordunni,1009,druid,restoration,30,19,11
5185,Ukri,ravencrest,1008,druid,restoration,22,11,11
5186,Lightboxx,ravencrest,1005,druid,restoration,30,19,11
5187,Akuda,blackrock,1004,druid,restoration,21,11,10
5188,Фэйблуд,blackscar,1004,druid,restoration,138,72,66
5189,Artracos,thrall,1003,druid,restoration,35,11,24
5190,Feedbark,stormscale,1002,druid,restoration,23,13,10
5191,Spiralout,nemesis,1000,druid,restoration,298,144,154
5192,Spankproof,kazzak,999,druid,restoration,20,12,8
5193,Iprex,outland,997,druid,restoration,54,31,23
5194,Kasjuz,tarren-mill,997,druid,restoration,24,12,12
5195,Pudseytree,doomhammer,996,druid,restoration,74,38,36
5196,Cárnagè,stormscale,996,druid,restoration,92,40,52
5197,Дела,eversong,994,druid,restoration,36,21,15
5198,Jimpä,outland,991,druid,restoration,22,11,11
5199,Sorahe,arthas,989,druid,restoration,20,12,8
5200,Nokodo,silvermoon,988,druid,restoration,39,19,20
5201,Sooamazing,korgall,987,druid,restoration,27,15,12
5202,Moonfan,darkmoon-faire,986,druid,restoration,48,17,31
5203,Aolynk,twisting-nether,986,druid,restoration,35,12,23
5204,Yespapa,kazzak,985,druid,restoration,273,140,133
5205,Inspiredrood,archimonde,984,druid,restoration,107,58,49
5206,Nezruslfour,dun-modr,983,druid,restoration,18,12,6
5207,Draneis,les-sentinelles,983,druid,restoration,68,40,28
5208,Weremyst,outland,982,druid,restoration,32,11,21
5209,Featherball,tarren-mill,981,druid,restoration,42,25,17
5210,Ellismera,argent-dawn,978,druid,restoration,36,17,19
5211,Liloè,onyxia,975,druid,restoration,48,24,24
5212,Arydan,quelthalas,974,druid,restoration,28,11,17
5213,Nali,arthas,972,druid,restoration,19,12,7
5214,Sinthorasia,blackrock,972,druid,restoration,28,12,16
5215,Ванилане,ashenvale,971,druid,restoration,66,27,39
5216,Torawara,ragnaros,969,druid,restoration,17,11,6
5217,Zerschmatzen,aegwynn,965,druid,restoration,75,23,52
5218,Shaorma,ravencrest,964,druid,restoration,18,13,5
5219,Jimmorris,eredar,964,druid,restoration,24,11,13
5220,Greyhøund,archimonde,964,druid,restoration,37,14,23
5221,Дазашо,soulflayer,964,druid,restoration,93,35,58
5222,Jambonmaster,archimonde,963,druid,restoration,30,15,15
5223,Wegian,sylvanas,962,druid,restoration,63,36,27
5224,Прожималодру,deathguard,962,druid,restoration,66,27,39
5225,Wolfeiy,ravenholdt,961,druid,restoration,145,77,68
5226,Bntyx,dun-modr,960,druid,restoration,18,10,8
5227,Foxyfeet,outland,960,druid,restoration,18,10,8
5228,Caldino,tarren-mill,960,druid,restoration,23,11,12
5229,Eviency,outland,960,druid,restoration,24,10,14
5230,Crìmz,aszune,960,druid,restoration,36,10,26
5231,Worstdruid,sanguino,959,druid,restoration,12,10,2
5232,Treedog,ravencrest,959,druid,restoration,18,10,8
5233,Snedden,silvermoon,959,druid,restoration,30,15,15
5234,Tjann,darksorrow,959,druid,restoration,24,10,14
5235,Kasugia,aegwynn,959,druid,restoration,24,10,14
5236,Zmira,outland,959,druid,restoration,30,10,20
5237,Bäckey,silvermoon,958,druid,restoration,12,10,2
5238,Rînaa,ravencrest,958,druid,restoration,18,10,8
5239,Iqfrags,silvermoon,957,druid,restoration,21,14,7
5240,Prayx,dalaran,957,druid,restoration,30,10,20
5241,Plúx,antonidas,956,druid,restoration,26,10,16
5242,Элеарсия,gordunni,956,druid,restoration,42,15,27
5243,Steuerung,twisting-nether,956,druid,restoration,30,10,20
5244,Indann,kazzak,955,druid,restoration,24,10,14
5245,Whiplazh,archimonde,954,druid,restoration,18,10,8
5246,Taèzoth,terokkar,954,druid,restoration,18,10,8
5247,Moonfetamine,silvermoon,954,druid,restoration,30,10,20
5248,Килаф,gordunni,952,druid,restoration,18,10,8
5249,Энчантерес,gordunni,952,druid,restoration,30,10,20
5250,Johndru,kazzak,948,druid,restoration,71,26,45
5251,Wrak,eonar,947,druid,restoration,18,10,8
5252,Triplej,twisting-nether,946,druid,restoration,52,26,26
5253,Thélon,antonidas,945,druid,restoration,69,35,34
5254,Shaize,dalaran,943,druid,restoration,24,10,14
5255,Muju,stormscale,942,druid,restoration,66,30,36
5256,Talyfox,outland,941,druid,restoration,33,11,22
5257,Svass,ragnaros,940,druid,restoration,18,10,8
5258,Erinark,aegwynn,940,druid,restoration,42,10,32
5259,Buffspencer,ragnaros,936,druid,restoration,107,56,51
5260,Nimèl,argent-dawn,936,druid,restoration,42,18,24
5261,Fubarmeep,outland,932,druid,restoration,42,22,20
5262,Borne,aggra-português,930,druid,restoration,24,10,14
5263,Krollix,dun-morogh,929,druid,restoration,47,25,22
5264,Trikill,hyjal,929,druid,restoration,49,20,29
5265,Loumpa,hyjal,928,druid,restoration,24,14,10
5266,Maldrýn,stormscale,927,druid,restoration,17,10,7
5267,Gribix,kazzak,927,druid,restoration,18,10,8
5268,Ellinaki,neptulon,927,druid,restoration,84,42,42
5269,Sinestah,ravencrest,926,druid,restoration,79,35,44
5270,Bigborst,ravencrest,924,druid,restoration,20,11,9
5271,Missfar,doomhammer,923,druid,restoration,42,16,26
5272,Djclonex,archimonde,922,druid,restoration,36,16,20
5273,Мирафлоресс,booty-bay,921,druid,restoration,88,39,49
5274,Kaod,outland,918,druid,restoration,33,17,16
5275,Kkriss,stormscale,918,druid,restoration,22,11,11
5276,Avadakodavra,ravencrest,912,druid,restoration,50,14,36
5277,Yellow,sylvanas,911,druid,restoration,21,10,11
5278,Yam,thrall,911,druid,restoration,29,10,19
5279,Бехеровка,grom,910,druid,restoration,58,24,34
5280,Woodrla,sylvanas,908,druid,restoration,54,30,24
5281,Kárél,drakthul,906,druid,restoration,24,12,12
5282,Shokazu,blackmoore,906,druid,restoration,88,41,47
5283,Blolzz,silvermoon,904,druid,restoration,30,14,16
5284,Akifumi,archimonde,903,druid,restoration,35,11,24
5285,Celéry,silvermoon,896,druid,restoration,16,10,6
5286,Lorucka,die-nachtwache,894,druid,restoration,20,10,10
5287,Barbesco,zuljin,892,druid,restoration,70,34,36
5288,Arianator,culte-de-la-rive-noire,890,druid,restoration,41,21,20
5289,Борзойрог,soulflayer,890,druid,restoration,54,23,31
5290,Raylla,dun-modr,888,druid,restoration,24,11,13
5291,Naturberserk,tarren-mill,887,druid,restoration,27,12,15
5292,Feanthur,drakthul,886,druid,restoration,148,72,76
5293,ßlackßåmßå,zuljin,886,druid,restoration,29,13,16
5294,Nachtelf,lightbringer,881,druid,restoration,96,36,60
5295,Arthoriana,thrall,878,druid,restoration,47,10,37
5296,Do,alakir,876,druid,restoration,30,10,20
5297,Khalynn,eredar,875,druid,restoration,80,28,52
5298,Lyarx,ragnaros,873,druid,restoration,42,20,22
5299,Bunnykiss,kazzak,873,druid,restoration,24,10,14
5300,Merakir,dun-modr,870,druid,restoration,72,25,47
5301,Spaartaa,blackhand,870,druid,restoration,36,10,26
5302,Argbjörn,sylvanas,868,druid,restoration,57,23,34
5303,Dokus,grim-batol,866,druid,restoration,30,11,19
5304,Healbrah,burning-blade,865,druid,restoration,54,10,44
5305,Koshai,twisting-nether,864,druid,restoration,18,9,9
5306,Lxstcentury,stormscale,864,druid,restoration,18,9,9
5307,Иксвовски,gordunni,864,druid,restoration,18,9,9
5308,Kawèlz,archimonde,864,druid,restoration,18,9,9
5309,Viggez,outland,864,druid,restoration,18,9,9
5310,Ponardo,outland,864,druid,restoration,19,9,10
5311,Лабирон,soulflayer,864,druid,restoration,24,9,15
5312,Tarshish,outland,863,druid,restoration,12,9,3
5313,Vacaleiteira,aggra-português,863,druid,restoration,18,9,9
5314,Madmanul,draenor,863,druid,restoration,18,9,9
5315,Místergreen,ravencrest,863,druid,restoration,18,9,9
5316,Jtsoigne,ysondre,863,druid,restoration,40,19,21
5317,Clonecity,ravencrest,863,druid,restoration,24,9,15
5318,Drèamer,ravencrest,863,druid,restoration,24,9,15
5319,Drrood,stormscale,862,druid,restoration,12,9,3
5320,Yandris,argent-dawn,862,druid,restoration,18,9,9
5321,Csmedruid,blackrock,862,druid,restoration,18,9,9
5322,Pavelot,runetotem,862,druid,restoration,22,9,13
5323,Jugai,archimonde,861,druid,restoration,18,9,9
5324,Smucka,ragnaros,861,druid,restoration,24,9,15
5325,Fknmad,burning-blade,860,druid,restoration,12,9,3
5326,Thardruid,stormscale,860,druid,restoration,18,9,9
5327,Macanbre,tarren-mill,860,druid,restoration,66,31,35
5328,Helguard,silvermoon,860,druid,restoration,24,9,15
5329,Suunto,blackrock,859,druid,restoration,18,9,9
5330,Caturday,terrordar,859,druid,restoration,30,13,17
5331,Synoe,la-croisade-écarlate,855,druid,restoration,18,9,9
5332,Ihone,frostmane,855,druid,restoration,24,9,15
5333,Nutzlos,azshara,855,druid,restoration,144,50,94
5334,Aivy,boulderfist,854,druid,restoration,37,17,20
5335,Happyhoter,blackrock,854,druid,restoration,24,9,15
5336,Ballosh,hyjal,854,druid,restoration,24,9,15
5337,Fajia,frostmane,854,druid,restoration,30,9,21
5338,Nious,kazzak,853,druid,restoration,24,9,15
5339,Lunatrixs,dun-modr,852,druid,restoration,18,9,9
5340,Инуараши,ashenvale,851,druid,restoration,38,14,24
5341,Baineaordur,krasus,850,druid,restoration,18,9,9
5342,Driiptoohard,turalyon,849,druid,restoration,99,43,56
5343,Simouch,archimonde,848,druid,restoration,124,57,67
5344,Kattman,tarren-mill,848,druid,restoration,24,9,15
5345,Relay,ragnaros,847,druid,restoration,24,12,12
5346,Котанет,gordunni,847,druid,restoration,36,12,24
5347,Jendiiss,drakthul,843,druid,restoration,22,11,11
5348,Chujogrzmot,kazzak,843,druid,restoration,23,9,14
5349,Seabath,kirin-tor,841,druid,restoration,24,9,15
5350,Houwalia,archimonde,840,druid,restoration,48,22,26
5351,Kaydjan,elune,839,druid,restoration,18,10,8
5352,Альбигоиц,thermaplugg,837,druid,restoration,24,9,15
5353,Clearwipe,thunderhorn,835,druid,restoration,24,9,15
5354,Robeala,twisting-nether,832,druid,restoration,42,17,25
5355,Rááy,blackrock,831,druid,restoration,17,9,8
5356,Maylika,hyjal,831,druid,restoration,52,13,39
5357,Ånåphorå,archimonde,830,druid,restoration,17,9,8
5358,Braxxiloa,nazjatar,830,druid,restoration,18,9,9
5359,Theguyandbea,draenor,830,druid,restoration,53,17,36
5360,Omegaheals,scarshield-legion,826,druid,restoration,30,13,17
5361,Nube,alonsus,826,druid,restoration,66,25,41
5362,Catbear,kazzak,824,druid,restoration,61,28,33
5363,Ruap,blackmoore,822,druid,restoration,20,10,10
5364,Oyoyo,kaelthas,819,druid,restoration,20,10,10
5365,Metaboss,ravencrest,817,druid,restoration,71,24,47
5366,Karvapersé,argent-dawn,816,druid,restoration,24,10,14
5367,Shakshun,draenor,813,druid,restoration,30,11,19
5368,Ruhlide,anetheron,810,druid,restoration,23,9,14
5369,Droodfist,khaz-modan,805,druid,restoration,54,24,30
5370,Purple,draenor,803,druid,restoration,18,9,9
5371,Kiadorn,stormreaver,799,druid,restoration,22,9,13
5372,Buitonix,khaz-modan,798,druid,restoration,135,60,75
5373,Moontriix,kazzak,798,druid,restoration,22,9,13
5374,Trytargetme,outland,796,druid,restoration,17,9,8
5375,Sacmycløne,draenor,786,druid,restoration,35,10,25
5376,Gladyon,ravencrest,785,druid,restoration,24,9,15
5377,Bidodici,nemesis,783,druid,restoration,135,57,78
5378,Buufu,kazzak,780,druid,restoration,19,9,10
5379,Çhuucky,khaz-modan,780,druid,restoration,71,18,53
5380,Ratskrone,alleria,778,druid,restoration,148,66,82
5381,Stinka,ravencrest,768,druid,restoration,12,8,4
5382,Ecological,outland,768,druid,restoration,12,8,4
5383,Målukah,archimonde,768,druid,restoration,12,8,4
5384,Catdoge,thrall,768,druid,restoration,12,8,4
5385,Justdmg,ravencrest,768,druid,restoration,12,8,4
5386,Dablol,draenor,768,druid,restoration,12,8,4
5387,Nohos,blackrock,768,druid,restoration,18,8,10
5388,Xanxiety,outland,768,druid,restoration,18,8,10
5389,Ксенона,gordunni,768,druid,restoration,18,8,10
5390,Jin,the-venture-co,768,druid,restoration,18,8,10
5391,Lyricx,kazzak,768,druid,restoration,18,8,10
5392,Flensí,stormscale,768,druid,restoration,18,8,10
5393,Huebbi,blackmoore,768,druid,restoration,18,8,10
5394,Renewer,argent-dawn,768,druid,restoration,21,9,12
5395,Neverfall,aegwynn,768,druid,restoration,24,10,14
5396,Trol,malganis,768,druid,restoration,24,9,15
5397,Skilloxus,gilneas,768,druid,restoration,105,35,70
5398,Ajaÿ,sylvanas,768,druid,restoration,24,8,16
5399,Lyalis,kazzak,768,druid,restoration,30,8,22
5400,Taylrswftmnd,twisting-nether,767,druid,restoration,12,8,4
5401,Alexialol,silvermoon,767,druid,restoration,12,8,4
5402,Piggo,tarren-mill,767,druid,restoration,12,8,4
5403,Liunara,nemesis,767,druid,restoration,18,8,10
5404,Brindefolie,archimonde,767,druid,restoration,18,8,10
5405,Quasarx,ravencrest,767,druid,restoration,18,8,10
5406,Fanboij,kazzak,767,druid,restoration,18,8,10
5407,Lavague,hyjal,767,druid,restoration,18,8,10
5408,Dêrbombär,guldan,767,druid,restoration,24,8,16
5409,Tehira,antonidas,767,druid,restoration,30,8,22
5410,Seekx,silvermoon,766,druid,restoration,12,8,4
5411,Ghxsty,silvermoon,766,druid,restoration,18,8,10
5412,Uncleruccus,outland,766,druid,restoration,24,8,16
5413,Berkalicious,frostmane,765,druid,restoration,16,9,7
5414,Razudru,nerathor,765,druid,restoration,15,8,7
5415,Crydotcom,aegwynn,765,druid,restoration,18,8,10
5416,Biebear,sylvanas,765,druid,restoration,24,8,16
5417,Wísh,stormscale,764,druid,restoration,18,8,10
5418,Jahmandudu,ragnaros,764,druid,restoration,24,8,16
5419,Reiss,tarren-mill,764,druid,restoration,24,8,16
5420,Димитруа,howling-fjord,761,druid,restoration,18,8,10
5421,Aliani,trollbane,761,druid,restoration,24,8,16
5422,Lyndruid,sylvanas,760,druid,restoration,96,33,63
5423,Друоид,howling-fjord,759,druid,restoration,24,8,16
5424,Kkthanks,twisting-nether,757,druid,restoration,12,8,4
5425,Semiflora,silvermoon,757,druid,restoration,24,8,16
5426,Karmacowboy,ravencrest,756,druid,restoration,24,8,16
5427,Mandy,spinebreaker,755,druid,restoration,18,8,10
5428,Zalherbata,burning-legion,755,druid,restoration,24,8,16
5429,Nargaí,kargath,753,druid,restoration,18,8,10
5430,Narawenn,ysondre,753,druid,restoration,18,8,10
5431,Hootymactoot,magtheridon,752,druid,restoration,12,8,4
5432,Karochi,kazzak,751,druid,restoration,12,8,4
5433,Malfis,the-maelstrom,748,druid,restoration,18,8,10
5434,Wildblu,nemesis,748,druid,restoration,24,8,16
5435,Bug,eredar,747,druid,restoration,12,8,4
5436,Foyboy,ravencrest,747,druid,restoration,62,13,49
5437,Mirreska,silvermoon,743,druid,restoration,64,17,47
5438,Frostfox,ghostlands,741,druid,restoration,22,9,13
5439,Haveacoffee,stormscale,739,druid,restoration,54,17,37
5440,Skraks,ysondre,739,druid,restoration,30,8,22
5441,Kirkey,terokkar,736,druid,restoration,82,37,45
5442,Krayzz,tarren-mill,736,druid,restoration,28,8,20
5443,Ivysun,auchindoun,734,druid,restoration,20,9,11
5444,Devdude,blackrock,734,druid,restoration,22,8,14
5445,Saxondale,aszune,729,druid,restoration,18,8,10
5446,Allod,stormscale,728,druid,restoration,209,100,109
5447,Лордсенка,eversong,721,druid,restoration,18,8,10
5448,Catman,eredar,717,druid,restoration,15,9,6
5449,Barkingdog,tarren-mill,717,druid,restoration,21,9,12
5450,Jakeparkki,sylvanas,714,druid,restoration,26,9,17
5451,Тремакулан,gordunni,711,druid,restoration,18,9,9
5452,Rbosse,aszune,702,druid,restoration,14,8,6
5453,Avemonthemus,silvermoon,701,druid,restoration,23,9,14
5454,Sylocin,earthen-ring,699,druid,restoration,16,8,8
5455,Itswoland,emeriss,687,druid,restoration,11,8,3
5456,Найтед,gordunni,678,druid,restoration,17,10,7
5457,Fòggie,silvermoon,675,druid,restoration,28,9,19
5458,Магараганага,azuregos,675,druid,restoration,25,8,17
5459,Pissbomb,ravencrest,672,druid,restoration,12,7,5
5460,Ekexd,grim-batol,672,druid,restoration,12,7,5
5461,Boomkïn,draenor,672,druid,restoration,12,7,5
5462,Jakeffsake,stormscale,672,druid,restoration,12,7,5
5463,Icecöld,silvermoon,672,druid,restoration,12,7,5
5464,Innos,azshara,672,druid,restoration,12,7,5
5465,Pll,defias-brotherhood,672,druid,restoration,12,7,5
5466,Riddlerdruid,aegwynn,672,druid,restoration,12,7,5
5467,Maiverdr,ravencrest,672,druid,restoration,12,7,5
5468,Kll,defias-brotherhood,672,druid,restoration,12,7,5
5469,Luuxiå,archimonde,672,druid,restoration,12,7,5
5470,Антиблэк,soulflayer,672,druid,restoration,12,7,5
5471,Druidomedio,pozzo-delleternità,672,druid,restoration,12,7,5
5472,Bll,defias-brotherhood,672,druid,restoration,12,7,5
5473,Buckxxz,aegwynn,672,druid,restoration,12,7,5
5474,Krewèlla,emerald-dream,672,druid,restoration,12,7,5
5475,Skysrex,outland,672,druid,restoration,12,7,5
5476,Zarune,sanguino,672,druid,restoration,12,7,5
5477,Zhényá,ravencrest,672,druid,restoration,16,8,8
5478,Tommiz,silvermoon,672,druid,restoration,18,7,11
5479,Smightydr,silvermoon,672,druid,restoration,18,7,11
5480,Holybarkzqt,aegwynn,672,druid,restoration,18,7,11
5481,Juhudy,kazzak,672,druid,restoration,18,7,11
5482,Djalexdruid,kazzak,672,druid,restoration,18,7,11
5483,Buzzlîghtyea,outland,672,druid,restoration,18,7,11
5484,Darkyblood,archimonde,672,druid,restoration,18,7,11
5485,Epicskin,kazzak,672,druid,restoration,18,7,11
5486,Juhato,outland,672,druid,restoration,18,7,11
5487,Eduthecat,dun-modr,672,druid,restoration,18,7,11
5488,Stormendru,kazzak,672,druid,restoration,24,7,17
5489,Стомпбр,gordunni,672,druid,restoration,24,7,17
5490,Thyana,blackrock,671,druid,restoration,12,7,5
5491,Norkenis,neptulon,671,druid,restoration,12,7,5
5492,Lycann,burning-blade,671,druid,restoration,12,7,5
5493,Kladdkaka,earthen-ring,671,druid,restoration,12,7,5
5494,Тое,soulflayer,671,druid,restoration,12,7,5
5495,Pomdöner,echsenkessel,671,druid,restoration,12,7,5
5496,Zatarmix,sylvanas,671,druid,restoration,12,7,5
5497,Darktigrou,archimonde,671,druid,restoration,12,7,5
5498,Мамамышь,gordunni,671,druid,restoration,12,7,5
5499,Hristiana,outland,671,druid,restoration,12,7,5
5500,Гимодера,gordunni,671,druid,restoration,12,7,5
5501,Badballance,outland,671,druid,restoration,12,7,5
5502,Zkasnoname,archimonde,671,druid,restoration,18,7,11
5503,Scuta,sylvanas,671,druid,restoration,18,7,11
5504,Sandh,uldum,671,druid,restoration,18,7,11
5505,Glückstaler,die-aldor,671,druid,restoration,18,7,11
5506,Dridoxx,archimonde,671,druid,restoration,18,7,11
5507,Rosskemp,tarren-mill,671,druid,restoration,18,7,11
5508,Wizår,outland,671,druid,restoration,18,7,11
5509,Bayerant,burning-legion,671,druid,restoration,24,7,17
5510,Шеданна,gordunni,671,druid,restoration,24,7,17
5511,Behemothe,dalaran,670,druid,restoration,12,7,5
5512,Azumera,silvermoon,670,druid,restoration,12,7,5
5513,Sarkophag,blackrock,670,druid,restoration,12,7,5
5514,Corroboree,archimonde,670,druid,restoration,12,7,5
5515,Blòódý,ravencrest,670,druid,restoration,12,7,5
5516,Cerius,drakthul,670,druid,restoration,12,7,5
5517,Bubadruid,silvermoon,670,druid,restoration,12,7,5
5518,Elysiá,twisting-nether,670,druid,restoration,18,7,11
5519,Driftmaster,defias-brotherhood,670,druid,restoration,18,7,11
5520,Proxis,the-maelstrom,670,druid,restoration,18,7,11
5521,Imissclone,outland,670,druid,restoration,18,7,11
5522,Muffinjump,outland,670,druid,restoration,18,7,11
5523,Gotyoufam,tarren-mill,670,druid,restoration,21,8,13
5524,Naicy,khaz-modan,670,druid,restoration,30,7,23
5525,Xavoths,outland,669,druid,restoration,18,7,11
5526,Azenoir,ravencrest,669,druid,restoration,18,7,11
5527,Derie,nazjatar,669,druid,restoration,18,7,11
5528,Whiskers,emerald-dream,669,druid,restoration,24,8,16
5529,Gailiûga,kazzak,669,druid,restoration,25,8,17
5530,Druidbox,ravencrest,668,druid,restoration,12,7,5
5531,Ultrassick,kazzak,668,druid,restoration,12,7,5
5532,Coínlíp,drakthul,668,druid,restoration,24,7,17
5533,Shäylä,sinstralis,667,druid,restoration,12,7,5
5534,Thaeldres,argent-dawn,667,druid,restoration,18,7,11
5535,Croassant,archimonde,665,druid,restoration,12,7,5
5536,Bepanten,azshara,665,druid,restoration,18,7,11
5537,Syre,pozzo-delleternità,664,druid,restoration,12,7,5
5538,Druiddamage,the-maelstrom,660,druid,restoration,18,7,11
5539,Rukashi,die-aldor,659,druid,restoration,12,7,5
5540,Raktav,kazzak,659,druid,restoration,12,7,5
5541,Сутулоерыгло,howling-fjord,658,druid,restoration,20,7,13
5542,Бацна,gordunni,656,druid,restoration,24,7,17
5543,Foaqi,aegwynn,639,druid,restoration,16,7,9
5544,Juggmusicxd,hyjal,639,druid,restoration,20,8,12
5545,Lyvaley,dun-modr,629,druid,restoration,28,7,21
5546,Унаген,howling-fjord,624,druid,restoration,15,8,7
5547,Kùrámágødx,ravencrest,624,druid,restoration,17,7,10
5548,Нюхнимедведя,blackscar,623,druid,restoration,11,7,4
5549,Fatdroodz,draenor,622,druid,restoration,30,8,22
5550,Амильфийка,blackscar,617,druid,restoration,15,8,7
5551,ßïgßúll,twisting-nether,614,druid,restoration,19,8,11
5552,Chainbrake,sylvanas,611,druid,restoration,21,10,11
5553,Thespanker,aggramar,608,druid,restoration,10,7,3
5554,Yamsha,dalaran,607,druid,restoration,16,7,9
5555,Метафрея,gordunni,605,druid,restoration,11,7,4
5556,Horkz,frostmourne,605,druid,restoration,17,7,10
5557,Ilovealex,blackmoore,604,druid,restoration,8,7,1
5558,Kerataas,lightnings-blade,603,druid,restoration,17,7,10
5559,Allagís,kul-tiras,594,druid,restoration,13,8,5
5560,Medreas,argent-dawn,594,druid,restoration,16,7,9
5561,Draxedin,kazzak,576,druid,restoration,6,6,0
5562,Abercrombx,thrall,576,druid,restoration,6,6,0
5563,Felisin,ravencrest,576,druid,restoration,12,6,6
5564,Kyssope,chants-éternels,576,druid,restoration,12,6,6
5565,Outformpoly,ravencrest,576,druid,restoration,12,6,6
5566,Biggttgothgf,doomhammer,576,druid,restoration,12,6,6
5567,Ðès,ravencrest,576,druid,restoration,12,6,6
5568,Tashani,blackhand,576,druid,restoration,12,6,6
5569,Bilmo,ragnaros,576,druid,restoration,12,6,6
5570,Jhiun,ragnaros,576,druid,restoration,12,6,6
5571,Bøømerswågxx,twisting-nether,576,druid,restoration,12,6,6
5572,Freddyßear,draenor,576,druid,restoration,12,6,6
5573,Lolimadudu,silvermoon,576,druid,restoration,12,6,6
5574,Zaelithree,archimonde,576,druid,restoration,12,6,6
5575,Thorns,blackrock,576,druid,restoration,12,6,6
5576,Pogidruid,ragnaros,576,druid,restoration,12,6,6
5577,Ravnac,aegwynn,576,druid,restoration,12,6,6
5578,Vindruva,ravencrest,576,druid,restoration,12,6,6
5579,Piñaclo,archimonde,576,druid,restoration,12,6,6
5580,Sálty,aegwynn,576,druid,restoration,12,6,6
5581,Sakkosækk,ravencrest,576,druid,restoration,12,6,6
5582,Theforest,stormscale,576,druid,restoration,12,6,6
5583,Mccarthy,archimonde,576,druid,restoration,12,6,6
5584,Telpha,onyxia,576,druid,restoration,12,6,6
5585,Vacuumcleanr,ravencrest,576,druid,restoration,12,6,6
5586,Poporseven,archimonde,576,druid,restoration,12,6,6
5587,Jincksdru,ravencrest,576,druid,restoration,12,6,6
5588,Noramun,blackmoore,576,druid,restoration,12,6,6
5589,Milkyheals,burning-blade,576,druid,restoration,12,6,6
5590,Cyriaan,eredar,576,druid,restoration,12,6,6
5591,Shumamakan,nemesis,576,druid,restoration,12,6,6
5592,Ferraribob,ravencrest,576,druid,restoration,12,6,6
5593,Nivcat,kazzak,576,druid,restoration,12,6,6
5594,Worsteux,blackrock,576,druid,restoration,14,6,8
5595,Âurum,silvermoon,576,druid,restoration,14,6,8
5596,Ãmba,blackrock,576,druid,restoration,15,6,9
5597,Джунали,howling-fjord,576,druid,restoration,18,6,12
5598,Neverpanic,stormscale,576,druid,restoration,18,6,12
5599,Critdruid,kazzak,576,druid,restoration,18,6,12
5600,Suevlaki,ragnaros,576,druid,restoration,18,6,12
5601,Tjillevippen,tarren-mill,576,druid,restoration,18,6,12
5602,Animaldoh,kazzak,576,druid,restoration,18,6,12
5603,Pölkky,argent-dawn,576,druid,restoration,18,6,12
5604,Nellro,blackrock,576,druid,restoration,18,6,12
5605,Doktordudu,drakthul,576,druid,restoration,18,6,12
5606,Deazydrood,blackrock,576,druid,restoration,18,6,12
5607,Jìkkz,aegwynn,576,druid,restoration,24,6,18
5608,Helkondr,thrall,576,druid,restoration,24,6,18
5609,Meall,blackmoore,575,druid,restoration,6,6,0
5610,Karakarrtaal,silvermoon,575,druid,restoration,6,6,0
5611,Lucidor,frostmane,575,druid,restoration,12,6,6
5612,Mistgone,hyjal,575,druid,restoration,12,6,6
5613,Lanmìe,malganis,575,druid,restoration,12,6,6
5614,Geeorge,stormscale,575,druid,restoration,12,6,6
5615,Iamsocute,silvermoon,575,druid,restoration,12,6,6
5616,Аммазония,gordunni,575,druid,restoration,12,6,6
5617,Garbloom,silvermoon,575,druid,restoration,12,6,6
5618,Thiudaish,tarren-mill,575,druid,restoration,12,6,6
5619,Wykked,outland,575,druid,restoration,12,6,6
5620,Scarrymonsta,outland,575,druid,restoration,12,6,6
5621,Afret,kazzak,575,druid,restoration,12,6,6
5622,Jinxaran,culte-de-la-rive-noire,575,druid,restoration,12,6,6
5623,Chicobullz,ysondre,575,druid,restoration,12,6,6
5624,Берды,gordunni,575,druid,restoration,12,6,6
5625,Марголав,gordunni,575,druid,restoration,12,6,6
5626,Chintawaz,archimonde,575,druid,restoration,16,7,9
5627,Docdruid,outland,575,druid,restoration,19,7,12
5628,Drbark,blackmoore,575,druid,restoration,18,6,12
5629,Ipiridian,kargath,575,druid,restoration,18,6,12
5630,Avilary,tarren-mill,575,druid,restoration,18,6,12
5631,Enggetsu,drakthul,575,druid,restoration,18,6,12
5632,Séifér,auchindoun,575,druid,restoration,18,6,12
5633,Sartipus,draenor,575,druid,restoration,18,6,12
5634,Pouletqt,archimonde,575,druid,restoration,18,6,12
5635,Урголяфа,gordunni,575,druid,restoration,18,6,12
5636,Storfjåset,stormscale,575,druid,restoration,18,6,12
5637,Mascraxx,earthen-ring,575,druid,restoration,18,6,12
5638,Dorange,stormscale,575,druid,restoration,18,6,12
5639,Fiq,silvermoon,575,druid,restoration,18,6,12
5640,Paskixoxo,ravencrest,574,druid,restoration,12,6,6
5641,Оксинаген,ashenvale,574,druid,restoration,12,6,6
5642,Eriaeda,stormscale,574,druid,restoration,12,6,6
5643,Sveoris,malganis,574,druid,restoration,12,6,6
5644,Tsihsel,ravencrest,574,druid,restoration,12,6,6
5645,Spritzer,tarren-mill,574,druid,restoration,12,6,6
5646,Silverdice,thrall,574,druid,restoration,12,6,6
5647,Ruberg,kazzak,574,druid,restoration,12,6,6
5648,Rìften,stormscale,574,druid,restoration,18,6,12
5649,Зервес,gordunni,574,druid,restoration,24,6,18
5650,Goatmeal,draenor,574,druid,restoration,24,6,18
5651,Oaky,alonsus,573,druid,restoration,12,6,6
5652,Visurat,tarren-mill,573,druid,restoration,12,6,6
5653,Shifts,aggramar,573,druid,restoration,18,6,12
5654,Ragdru,twisting-nether,573,druid,restoration,24,6,18
5655,Shadówglen,defias-brotherhood,573,druid,restoration,30,6,24
5656,Gargasina,colinas-pardas,571,druid,restoration,16,9,7
5657,Nøboorst,ravencrest,571,druid,restoration,12,6,6
5658,Arenus,argent-dawn,571,druid,restoration,18,6,12
5659,Bearshift,aggra-português,571,druid,restoration,18,6,12
5660,Pussn,twisting-nether,570,druid,restoration,18,6,12
5661,Kelerun,blackhand,570,druid,restoration,24,6,18
5662,Эгерме24FA33,howling-fjord,569,druid,restoration,12,6,6
5663,Socialphobia,draenor,569,druid,restoration,24,6,18
5664,Essya,earthen-ring,569,druid,restoration,31,7,24
5665,Olekh,nemesis,568,druid,restoration,12,6,6
5666,Roséa,ravencrest,568,druid,restoration,18,6,12
5667,Walkao,tarren-mill,566,druid,restoration,12,6,6
5668,Panacée,dalaran,565,druid,restoration,12,6,6
5669,Wellsie,blackmoore,565,druid,restoration,18,6,12
5670,Rakhajan,twisting-nether,553,druid,restoration,35,6,29
5671,Vlookup,tarren-mill,543,druid,restoration,17,6,11
5672,Márron,blackhand,542,druid,restoration,16,7,9
5673,Siahra,khaz-modan,534,druid,restoration,48,6,42
5674,Quorn,pozzo-delleternità,527,druid,restoration,13,7,6
5675,Deliveru,outland,527,druid,restoration,17,6,11
5676,Orgazmo,archimonde,526,druid,restoration,17,6,11
5677,Noodledru,tarren-mill,526,druid,restoration,21,6,15
5678,Laserlars,blackrock,522,druid,restoration,13,7,6
5679,Zagrem,antonidas,522,druid,restoration,16,7,9
5680,Dablolo,ravencrest,521,druid,restoration,12,7,5
5681,Shawtyx,argent-dawn,521,druid,restoration,20,7,13
5682,Auspicer,moonglade,519,druid,restoration,16,7,9
5683,Fuzzy,the-venture-co,511,druid,restoration,11,6,5
5684,Sethdr,hyjal,511,druid,restoration,20,6,14
5685,Bartoluca,twisting-nether,488,druid,restoration,40,7,33
5686,Miskydruid,kazzak,480,druid,restoration,6,5,1
5687,Bobthebull,ragnaros,480,druid,restoration,6,5,1
5688,Celetik,archimonde,480,druid,restoration,6,5,1
5689,Druidtar,burning-steppes,480,druid,restoration,6,5,1
5690,Quadpulse,ravencrest,480,druid,restoration,6,5,1
5691,Мегабамбук,soulflayer,480,druid,restoration,6,5,1
5692,Mykk,ravencrest,480,druid,restoration,6,5,1
5693,Demncow,twisting-nether,480,druid,restoration,12,5,7
5694,Devastras,ravencrest,480,druid,restoration,12,5,7
5695,Хекзкор,ashenvale,480,druid,restoration,12,5,7
5696,Skirr,kelthuzad,480,druid,restoration,12,5,7
5697,Ppr,stormscale,480,druid,restoration,12,5,7
5698,Tokamon,blackrock,480,druid,restoration,12,5,7
5699,Димадубощит,blackscar,480,druid,restoration,12,5,7
5700,Horstyolo,blackrock,480,druid,restoration,12,5,7
5701,Búse,twisting-nether,480,druid,restoration,12,5,7
5702,Kvalitet,outland,480,druid,restoration,12,5,7
5703,Daisyx,eredar,480,druid,restoration,12,5,7
5704,Trashgamex,eredar,480,druid,restoration,12,5,7
5705,Alásea,kazzak,480,druid,restoration,12,5,7
5706,Asude,outland,480,druid,restoration,12,5,7
5707,Bloomitizé,ravencrest,480,druid,restoration,12,5,7
5708,Pøwêr,blackrock,480,druid,restoration,12,5,7
5709,Billydruida,sanguino,480,druid,restoration,12,5,7
5710,Crysís,sanguino,480,druid,restoration,12,5,7
5711,Napsta,sylvanas,480,druid,restoration,12,5,7
5712,Marmotini,the-maelstrom,480,druid,restoration,12,5,7
5713,Hótty,antonidas,480,druid,restoration,12,5,7
5714,Músclébéach,silvermoon,480,druid,restoration,12,5,7
5715,Druidicchi,stormscale,480,druid,restoration,12,5,7
5716,Chæmp,blackmoore,480,druid,restoration,12,5,7
5717,Vaacku,stormreaver,480,druid,restoration,12,5,7
5718,Cheddar,tyrande,480,druid,restoration,12,5,7
5719,Holybarkz,aegwynn,480,druid,restoration,12,5,7
5720,Pyctograhm,eldrethalas,480,druid,restoration,12,5,7
5721,Nythielle,argent-dawn,480,druid,restoration,12,5,7
5722,Oøom,stormscale,480,druid,restoration,12,5,7
5723,Pomjo,archimonde,480,druid,restoration,12,5,7
5724,Nightmoon,hellscream,480,druid,restoration,12,5,7
5725,Druni,blackrock,480,druid,restoration,12,5,7
5726,Thatzdmg,blackmoore,480,druid,restoration,12,5,7
5727,Jenovas,argent-dawn,480,druid,restoration,12,5,7
5728,Solonely,argent-dawn,480,druid,restoration,12,5,7
5729,Higuys,the-maelstrom,480,druid,restoration,12,5,7
5730,Sùmmêrz,outland,480,druid,restoration,12,5,7
5731,Jebaitor,tarren-mill,480,druid,restoration,12,5,7
5732,Neshalry,blackhand,480,druid,restoration,13,5,8
5733,Øxxy,ravencrest,480,druid,restoration,18,5,13
5734,Локотьдрева,gordunni,480,druid,restoration,18,5,13
5735,Erelieva,silvermoon,480,druid,restoration,18,5,13
5736,Sneedlewøødz,exodar,480,druid,restoration,18,5,13
5737,Subu,drakthul,480,druid,restoration,18,5,13
5738,Åzjôl,magtheridon,480,druid,restoration,18,5,13
5739,Bigbaddream,stormscale,480,druid,restoration,18,5,13
5740,Restaidpvs,wildhammer,480,druid,restoration,18,5,13
5741,Patrík,twisting-nether,480,druid,restoration,18,5,13
5742,Клиптыч,soulflayer,479,druid,restoration,6,5,1
5743,Ashiothie,argent-dawn,479,druid,restoration,6,5,1
5744,Rocknrollà,doomhammer,479,druid,restoration,6,5,1
5745,Epidruid,stormrage,479,druid,restoration,12,5,7
5746,Enzymex,burning-blade,479,druid,restoration,12,5,7
5747,Delphina,dun-modr,479,druid,restoration,12,5,7
5748,Salagkoydi,sylvanas,479,druid,restoration,12,5,7
5749,Inspira,teldrassil,479,druid,restoration,12,5,7
5750,Alfrëd,quelthalas,479,druid,restoration,12,5,7
5751,Xaeerow,archimonde,479,druid,restoration,12,5,7
5752,Greenthûmbs,sylvanas,479,druid,restoration,12,5,7
5753,Shadowdury,frostwolf,479,druid,restoration,12,5,7
5754,Sieur,archimonde,479,druid,restoration,12,5,7
5755,Bhorumir,colinas-pardas,479,druid,restoration,12,5,7
5756,Quiksx,blackrock,479,druid,restoration,13,5,8
5757,Drix,frostwolf,479,druid,restoration,15,5,10
5758,Swo,emeriss,479,druid,restoration,18,5,13
5759,Hâyâbusa,antonidas,479,druid,restoration,18,5,13
5760,Jemyd,aegwynn,479,druid,restoration,24,5,19
5761,Tightaníc,sylvanas,478,druid,restoration,12,5,7
5762,Kroshka,sylvanas,478,druid,restoration,12,5,7
5763,Шмыгадру,eversong,478,druid,restoration,12,5,7
5764,Lùmy,arygos,478,druid,restoration,12,5,7
5765,Yodox,kazzak,477,druid,restoration,6,5,1
5766,Xtrakul,bloodfeather,477,druid,restoration,6,5,1
5767,Kodobursto,stormscale,477,druid,restoration,12,5,7
5768,Шмору,deathguard,477,druid,restoration,12,5,7
5769,Wybsalt,dragonblight,477,druid,restoration,18,5,13
5770,Sýrês,malganis,475,druid,restoration,12,5,7
5771,Томография,howling-fjord,475,druid,restoration,12,5,7
5772,Prowlinger,silvermoon,473,druid,restoration,12,5,7
5773,Alatie,sylvanas,473,druid,restoration,12,5,7
5774,Voodoodrood,draenor,473,druid,restoration,30,5,25
5775,Iamtheone,ragnaros,463,druid,restoration,17,5,12
5776,Druidicmorr,sylvanas,447,druid,restoration,10,5,5
5777,Flandersdru,ravencrest,447,druid,restoration,11,5,6
5778,Dhomaris,emerald-dream,447,druid,restoration,17,5,12
5779,Happyhippo,arathor,447,druid,restoration,17,5,12
5780,Luaavin,madmortem,446,druid,restoration,10,5,5
5781,Ambracer,silvermoon,444,druid,restoration,8,6,2
5782,Исмалат,howling-fjord,429,druid,restoration,11,5,6
5783,Pfandmalle,blackrock,426,druid,restoration,14,6,8
5784,Smradzblech,drakthul,425,druid,restoration,16,6,10
5785,Kotkacy,silvermoon,416,druid,restoration,10,5,5
5786,Qjkuug,ravencrest,416,druid,restoration,10,5,5
5787,Meridus,thrall,400,druid,restoration,13,5,8
5788,Heathen,defias-brotherhood,384,druid,restoration,6,4,2
5789,Asgá,stormscale,384,druid,restoration,6,4,2
5790,Shegal,uldum,384,druid,restoration,6,4,2
5791,Kapidrooqt,suramar,384,druid,restoration,6,4,2
5792,Сокдобрый,gordunni,384,druid,restoration,6,4,2
5793,Notmyfriend,sylvanas,384,druid,restoration,6,4,2
5794,Bombiix,sanguino,384,druid,restoration,6,4,2
5795,Tlxrdlx,archimonde,384,druid,restoration,6,4,2
5796,Lerralol,eredar,384,druid,restoration,6,4,2
5797,Jacksonh,blackmoore,384,druid,restoration,6,4,2
5798,Hamilina,thunderhorn,384,druid,restoration,6,4,2
5799,Fangornn,outland,384,druid,restoration,6,4,2
5800,Tormentedlol,outland,384,druid,restoration,6,4,2
5801,Xandersito,sanguino,384,druid,restoration,6,4,2
5802,Neuroz,ravencrest,384,druid,restoration,6,4,2
5803,Mentaldead,tarren-mill,384,druid,restoration,6,4,2
5804,Zeroclones,the-maelstrom,384,druid,restoration,6,4,2
5805,Феразинария,gordunni,384,druid,restoration,6,4,2
5806,Jellyxdd,silvermoon,384,druid,restoration,6,4,2
5807,Claptastic,magtheridon,384,druid,restoration,6,4,2
5808,Sensisdruid,blackmoore,384,druid,restoration,6,4,2
5809,Cykablyaster,defias-brotherhood,384,druid,restoration,6,4,2
5810,Esmerito,tarren-mill,384,druid,restoration,6,4,2
5811,Bearmeister,kazzak,384,druid,restoration,6,4,2
5812,Béstfriend,uldum,384,druid,restoration,6,4,2
5813,Ктотоизкчр,gordunni,384,druid,restoration,6,4,2
5814,Zuzam,bladefist,384,druid,restoration,6,4,2
5815,Koala,temple-noir,384,druid,restoration,6,4,2
5816,Greenberry,eonar,384,druid,restoration,6,4,2
5817,Zuldram,uldaman,384,druid,restoration,6,4,2
5818,Cyclonebot,kazzak,384,druid,restoration,6,4,2
5819,Jimmyjam,archimonde,384,druid,restoration,6,4,2
5820,Bekkjin,todeswache,384,druid,restoration,6,4,2
5821,Àrkange,hyjal,384,druid,restoration,6,4,2
5822,Lhûne,twisting-nether,384,druid,restoration,6,4,2
5823,Балаклаваа,soulflayer,384,druid,restoration,6,4,2
5824,Mancy,silvermoon,384,druid,restoration,6,4,2
5825,Híraad,blackmoore,384,druid,restoration,6,4,2
5826,Maltøx,archimonde,384,druid,restoration,6,4,2
5827,Druidka,grim-batol,384,druid,restoration,6,4,2
5828,Гвенивар,soulflayer,384,druid,restoration,6,4,2
5829,Daleen,silvermoon,384,druid,restoration,12,4,8
5830,Cumulisama,sylvanas,384,druid,restoration,12,4,8
5831,Jöggel,perenolde,384,druid,restoration,12,4,8
5832,Hotundwech,blackrock,384,druid,restoration,12,4,8
5833,Irrlycht,blackrock,384,druid,restoration,12,4,8
5834,Crazydos,tarren-mill,384,druid,restoration,12,4,8
5835,Dëlins,outland,384,druid,restoration,12,4,8
5836,Àlec,silvermoon,384,druid,restoration,12,4,8
5837,Biglet,tarren-mill,384,druid,restoration,12,4,8
5838,Hyggef,ravencrest,384,druid,restoration,12,4,8
5839,Farmmygold,dun-modr,384,druid,restoration,12,4,8
5840,Koniny,drakthul,384,druid,restoration,12,4,8
5841,Noggerglatze,blackrock,384,druid,restoration,12,4,8
5842,Curtainscall,kazzak,384,druid,restoration,12,4,8
5843,Pròxy,hyjal,384,druid,restoration,12,4,8
5844,Громозилка,soulflayer,384,druid,restoration,12,4,8
5845,Sqoopy,tarren-mill,384,druid,restoration,12,4,8
5846,Estrogenlord,auchindoun,384,druid,restoration,12,4,8
5847,Celtimi,antonidas,384,druid,restoration,12,4,8
5848,Сулинея,blackscar,384,druid,restoration,12,4,8
5849,Holdmabeer,blackmoore,384,druid,restoration,12,4,8
5850,Toffyfee,anetheron,384,druid,restoration,12,4,8
5851,Kobra,twilights-hammer,384,druid,restoration,12,4,8
5852,Ravenfel,argent-dawn,384,druid,restoration,12,4,8
5853,Baraforet,archimonde,384,druid,restoration,12,4,8
5854,Hûibûh,eredar,384,druid,restoration,12,4,8
5855,Wakefields,dun-modr,384,druid,restoration,12,4,8
5856,Найадра,gordunni,384,druid,restoration,12,4,8
5857,Meowu,twisting-nether,384,druid,restoration,12,4,8
5858,Shapeshiptur,argent-dawn,384,druid,restoration,12,4,8
5859,Swiftlife,blackrock,384,druid,restoration,12,4,8
5860,Murlwywy,blackmoore,384,druid,restoration,12,4,8
5861,Farashh,archimonde,384,druid,restoration,12,4,8
5862,Zivela,blackrock,384,druid,restoration,12,4,8
5863,Litany,drakthul,384,druid,restoration,13,4,9
5864,Hrz,kazzak,384,druid,restoration,18,4,14
5865,Nezara,kazzak,384,druid,restoration,18,4,14
5866,Tacobender,tarren-mill,384,druid,restoration,18,4,14
5867,Frequentist,ragnaros,384,druid,restoration,18,4,14
5868,Yøungreidzz,blackrock,384,druid,restoration,24,4,20
5869,Lathlas,defias-brotherhood,383,druid,restoration,6,4,2
5870,Cmfg,blackrock,383,druid,restoration,6,4,2
5871,Santoniq,dun-morogh,383,druid,restoration,6,4,2
5872,Blackfür,sylvanas,383,druid,restoration,6,4,2
5873,Бабазарулем,fordragon,383,druid,restoration,6,4,2
5874,Jabbah,defias-brotherhood,383,druid,restoration,6,4,2
5875,Xidenn,quelthalas,383,druid,restoration,12,4,8
5876,Høpè,die-silberne-hand,383,druid,restoration,12,4,8
5877,Замакибо,howling-fjord,383,druid,restoration,12,4,8
5878,Druidguy,ghostlands,383,druid,restoration,12,4,8
5879,Opla,nethersturm,383,druid,restoration,12,4,8
5880,Noxndruid,blackhand,383,druid,restoration,12,4,8
5881,Mimisiek,burning-legion,383,druid,restoration,12,4,8
5882,Сигстейнхохо,blackscar,383,druid,restoration,12,4,8
5883,Kuivea,the-maelstrom,383,druid,restoration,12,4,8
5884,Arns,kazzak,383,druid,restoration,12,4,8
5885,Semenisback,archimonde,383,druid,restoration,12,4,8
5886,Itê,dun-morogh,383,druid,restoration,18,4,14
5887,Leeonore,burning-legion,383,druid,restoration,18,4,14
5888,Tyraloll,ghostlands,383,druid,restoration,18,4,14
5889,Шикалат,howling-fjord,383,druid,restoration,24,4,20
5890,Xele,destromath,382,druid,restoration,6,4,2
5891,Mongetout,ravencrest,382,druid,restoration,6,4,2
5892,Pega,nazjatar,382,druid,restoration,12,4,8
5893,Amalou,ravencrest,381,druid,restoration,12,4,8
5894,Nàrina,der-abyssische-rat,381,druid,restoration,12,4,8
5895,Dolob,ragnaros,381,druid,restoration,18,4,14
5896,Thaurus,durotan,380,druid,restoration,12,4,8
5897,Фигоначи,soulflayer,379,druid,restoration,12,4,8
5898,Tranquillo,outland,379,druid,restoration,12,4,8
5899,Nøkki,draenor,367,druid,restoration,21,8,13
5900,Jincksdru,anachronos,367,druid,restoration,11,4,7
5901,Demerit,defias-brotherhood,351,druid,restoration,11,4,7
5902,Biegel,ysera,351,druid,restoration,11,4,7
5903,Fapmasterx,eredar,351,druid,restoration,23,4,19
5904,Lyhene,outland,339,druid,restoration,32,8,24
5905,Mymoms,stormscale,336,druid,restoration,15,4,11
5906,Wuppii,blackmoore,329,druid,restoration,10,6,4
5907,Swarmah,draenor,329,druid,restoration,18,5,13
5908,Hubek,silvermoon,328,druid,restoration,8,6,2
5909,Hairytree,outland,318,druid,restoration,14,4,10
5910,Jirenthegrey,antonidas,318,druid,restoration,14,4,10
5911,Mímír,frostmane,317,druid,restoration,10,4,6
5912,Elsnorro,sylvanas,313,druid,restoration,19,5,14
5913,Rëckiah,ysondre,304,druid,restoration,13,4,9
5914,Pipima,kazzak,288,druid,restoration,6,3,3
5915,Furbyz,kazzak,288,druid,restoration,6,3,3
5916,Ullainho,stormscale,288,druid,restoration,6,3,3
5917,Maníx,tarren-mill,288,druid,restoration,6,3,3
5918,Koprogatos,twilights-hammer,288,druid,restoration,6,3,3
5919,Preda,thunderhorn,288,druid,restoration,6,3,3
5920,Nobrainopain,aegwynn,288,druid,restoration,6,3,3
5921,Noobr,ravencrest,288,druid,restoration,6,3,3
5922,Дробовик,soulflayer,288,druid,restoration,6,3,3
5923,Hð,blackmoore,288,druid,restoration,6,3,3
5924,Friyiee,stormscale,288,druid,restoration,6,3,3
5925,Lèafy,silvermoon,288,druid,restoration,6,3,3
5926,Ripmacmiller,grim-batol,288,druid,restoration,6,3,3
5927,Milknosugar,tarren-mill,288,druid,restoration,6,3,3
5928,Owldschool,blackmoore,288,druid,restoration,6,3,3
5929,Mealann,drakthul,288,druid,restoration,6,3,3
5930,Ærõxy,aegwynn,288,druid,restoration,6,3,3
5931,Skrewu,silvermoon,288,druid,restoration,6,3,3
5932,Atomanna,blackmoore,288,druid,restoration,6,3,3
5933,Фонш,soulflayer,288,druid,restoration,6,3,3
5934,Jonnaxø,ravencrest,288,druid,restoration,6,3,3
5935,Whitemaine,aggramar,288,druid,restoration,6,3,3
5936,Ipsdray,ysondre,288,druid,restoration,6,3,3
5937,Мехнакиске,howling-fjord,288,druid,restoration,6,3,3
5938,Whisk,ravencrest,288,druid,restoration,6,3,3
5939,Spielmann,ravencrest,288,druid,restoration,6,3,3
5940,Darkömwz,ysondre,288,druid,restoration,6,3,3
5941,Fallken,burning-blade,288,druid,restoration,6,3,3
5942,Dopadruid,ravencrest,288,druid,restoration,6,3,3
5943,Gehrkehotter,silvermoon,288,druid,restoration,6,3,3
5944,Танганэку,howling-fjord,288,druid,restoration,6,3,3
5945,Астраджет,gordunni,288,druid,restoration,6,3,3
5946,Whelpss,archimonde,288,druid,restoration,6,3,3
5947,Сайнтификх,gordunni,288,druid,restoration,6,3,3
5948,Sportzdruid,argent-dawn,288,druid,restoration,6,3,3
5949,Qb,blackrock,288,druid,restoration,6,3,3
5950,Myxa,arthas,288,druid,restoration,6,3,3
5951,Vestor,ravencrest,288,druid,restoration,6,3,3
5952,Nubsi,aegwynn,288,druid,restoration,6,3,3
5953,Moonbloom,defias-brotherhood,288,druid,restoration,6,3,3
5954,Wurzeldor,ravencrest,288,druid,restoration,6,3,3
5955,Thecousins,ravencrest,288,druid,restoration,6,3,3
5956,Ghøstavdruid,ravencrest,288,druid,restoration,6,3,3
5957,Eftersmak,ravencrest,288,druid,restoration,6,3,3
5958,Sygko,kazzak,288,druid,restoration,6,3,3
5959,Skuhlxz,thrall,288,druid,restoration,6,3,3
5960,Drozzie,twisting-nether,288,druid,restoration,6,3,3
5961,Zaethul,draenor,288,druid,restoration,6,3,3
5962,Faustîno,dun-modr,288,druid,restoration,6,3,3
5963,Ðrøøði,dun-modr,288,druid,restoration,6,3,3
5964,Shyni,outland,288,druid,restoration,6,3,3
5965,Bigorkey,blackrock,288,druid,restoration,6,3,3
5966,Bêlion,dun-modr,288,druid,restoration,6,3,3
5967,Djdishwasher,kazzak,288,druid,restoration,6,3,3
5968,Snowlight,der-rat-von-dalaran,288,druid,restoration,6,3,3
5969,Healingwoods,outland,288,druid,restoration,6,3,3
5970,Зурсага,deathguard,288,druid,restoration,6,3,3
5971,Vellusdruid,burning-legion,288,druid,restoration,6,3,3
5972,Magiskeforme,draenor,288,druid,restoration,6,3,3
5973,Peaches,aerie-peak,288,druid,restoration,6,3,3
5974,Ríkku,sargeras,288,druid,restoration,6,3,3
5975,Jéssíé,silvermoon,288,druid,restoration,6,3,3
5976,Qwopeiqpwoid,kazzak,288,druid,restoration,6,3,3
5977,Houkka,doomhammer,288,druid,restoration,6,3,3
5978,Lolaven,turalyon,288,druid,restoration,6,3,3
5979,Myos,conseil-des-ombres,288,druid,restoration,6,3,3
5980,Droodyàz,hyjal,288,druid,restoration,6,3,3
5981,Shìinx,hyjal,288,druid,restoration,6,3,3
5982,Cøwgirl,draenor,288,druid,restoration,6,3,3
5983,Rumbus,sanguino,288,druid,restoration,7,3,4
5984,Piñaclonada,archimonde,288,druid,restoration,9,3,6
5985,Ilarilén,blackmoore,288,druid,restoration,10,3,7
5986,Draawun,burning-legion,288,druid,restoration,11,3,8
5987,Smarticle,aegwynn,288,druid,restoration,11,3,8
5988,Shredz,destromath,288,druid,restoration,12,3,9
5989,Sharlla,burning-legion,288,druid,restoration,12,3,9
5990,Taugenîchts,blackmoore,288,druid,restoration,12,3,9
5991,Toacon,destromath,288,druid,restoration,12,3,9
5992,Takar,dalaran,288,druid,restoration,12,3,9
5993,Ezils,silvermoon,288,druid,restoration,12,3,9
5994,Navra,ravencrest,288,druid,restoration,12,3,9
5995,Lukøu,blackrock,288,druid,restoration,12,3,9
5996,Teah,darkmoon-faire,288,druid,restoration,12,3,9
5997,Trolthelhas,chogall,288,druid,restoration,12,3,9
5998,Кекичан,howling-fjord,288,druid,restoration,12,3,9
5999,Fejgi,stormreaver,288,druid,restoration,12,3,9
6000,Amstaffio,blackhand,288,druid,restoration,12,3,9
6001,Elxa,silvermoon,288,druid,restoration,12,3,9
6002,Xbrokeaf,eredar,288,druid,restoration,12,3,9
6003,Harrasmoes,ravencrest,288,druid,restoration,12,3,9
6004,Jàgër,archimonde,288,druid,restoration,12,3,9
6005,Nebrahl,silvermoon,288,druid,restoration,12,3,9
6006,Shiotake,hyjal,288,druid,restoration,12,3,9
6007,Megustatu,ravencrest,288,druid,restoration,12,3,9
6008,Chapawee,eredar,288,druid,restoration,12,3,9
6009,Imoen,hyjal,288,druid,restoration,12,3,9
6010,Restodruidx,ravencrest,288,druid,restoration,12,3,9
6011,Januzo,kazzak,288,druid,restoration,12,3,9
6012,Furía,anubarak,288,druid,restoration,12,3,9
6013,Храмульчик,blackscar,288,druid,restoration,12,3,9
6014,Coffeebean,twisting-nether,288,druid,restoration,12,3,9
6015,Emeskay,ravencrest,288,druid,restoration,12,3,9
6016,Xanánioma,ravencrest,288,druid,restoration,12,3,9
6017,Eladhria,arakarahm,288,druid,restoration,12,3,9
6018,Awienx,kazzak,288,druid,restoration,12,3,9
6019,Untouchablè,outland,288,druid,restoration,12,3,9
6020,Ajày,sylvanas,288,druid,restoration,12,3,9
6021,Raila,pozzo-delleternità,288,druid,restoration,12,3,9
6022,Sojiz,outland,288,druid,restoration,12,3,9
6023,Nostigon,azshara,288,druid,restoration,12,3,9
6024,Amazed,wildhammer,288,druid,restoration,12,3,9
6025,Marryat,argent-dawn,288,druid,restoration,12,3,9
6026,Areidhel,pozzo-delleternità,288,druid,restoration,12,3,9
6027,Doup,alakir,288,druid,restoration,12,3,9
6028,Trntydr,senjin,288,druid,restoration,12,3,9
6029,Jàgêr,archimonde,288,druid,restoration,12,3,9
6030,Nyha,garrosh,288,druid,restoration,18,3,15
6031,Boomdruud,tarren-mill,288,druid,restoration,18,3,15
6032,Денчикбратиш,soulflayer,288,druid,restoration,18,3,15
6033,Hurutuk,ysondre,288,druid,restoration,18,3,15
6034,Квазарм,gordunni,288,druid,restoration,18,3,15
6035,Rakuy,thrall,288,druid,restoration,18,3,15
6036,Taskingoman,twisting-nether,287,druid,restoration,6,3,3
6037,Wildsoul,hyjal,287,druid,restoration,6,3,3
6038,Kuhlheit,der-rat-von-dalaran,287,druid,restoration,6,3,3
6039,Kuokkanen,azuremyst,287,druid,restoration,6,3,3
6040,Youngjin,ravencrest,287,druid,restoration,6,3,3
6041,Grimmie,frostmane,287,druid,restoration,6,3,3
6042,Smittly,bloodhoof,287,druid,restoration,6,3,3
6043,Huayhey,the-maelstrom,287,druid,restoration,6,3,3
6044,Boompjeh,chamber-of-aspects,287,druid,restoration,6,3,3
6045,Lundx,ravencrest,287,druid,restoration,6,3,3
6046,Tombenuit,tarren-mill,287,druid,restoration,6,3,3
6047,Aègon,ravencrest,287,druid,restoration,6,3,3
6048,Kufcuf,eredar,287,druid,restoration,6,3,3
6049,Xulian,exodar,287,druid,restoration,12,3,9
6050,Лёшациклонх,deathguard,287,druid,restoration,12,3,9
6051,Reckóning,draenor,287,druid,restoration,12,3,9
6052,Barki,silvermoon,287,druid,restoration,12,3,9
6053,Papalegba,kilrogg,287,druid,restoration,12,3,9
6054,Rumjin,burning-blade,287,druid,restoration,17,4,13
6055,Paniel,amanthul,286,druid,restoration,6,3,3
6056,Kebanos,ravencrest,286,druid,restoration,6,3,3
6057,Corrosion,outland,286,druid,restoration,12,3,9
6058,Elônea,antonidas,285,druid,restoration,12,3,9
6059,Адаладиус,howling-fjord,285,druid,restoration,42,3,39
6060,Duduque,twisting-nether,255,druid,restoration,11,3,8
6061,Bunga,quelthalas,255,druid,restoration,11,3,8
6062,Kaliyuga,dalaran,255,druid,restoration,11,3,8
6063,Yopi,stormscale,240,druid,restoration,15,3,12
6064,Акетчи,howling-fjord,239,druid,restoration,5,3,2
6065,Amélor,ragnaros,239,druid,restoration,5,3,2
6066,Потнаякиса,grom,239,druid,restoration,5,3,2
6067,Izhusky,ravencrest,234,druid,restoration,8,4,4
6068,Lxz,blackhand,234,druid,restoration,8,4,4
6069,Beerplusbeer,kazzak,234,druid,restoration,23,6,17
6070,Bigdambitex,draenor,234,druid,restoration,16,4,12
6071,Chelsealeart,frostmane,192,druid,restoration,9,3,6
6072,Sekunden,ravencrest,192,druid,restoration,6,2,4
6073,Clonesy,outland,192,druid,restoration,6,2,4
6074,Jamley,tarren-mill,192,druid,restoration,6,2,4
6075,Skavenlol,zuljin,192,druid,restoration,6,2,4
6076,Ðon,nemesis,192,druid,restoration,6,2,4
6077,Mooji,darksorrow,192,druid,restoration,6,2,4
6078,Gaiaa,kilrogg,192,druid,restoration,6,2,4
6079,Hydrochronic,ravencrest,192,druid,restoration,6,2,4
6080,Drøda,aegwynn,192,druid,restoration,6,2,4
6081,Trusten,nemesis,192,druid,restoration,6,2,4
6082,Heejåe,archimonde,192,druid,restoration,6,2,4
6083,Vandalís,garrosh,192,druid,restoration,6,2,4
6084,Restoboi,stormscale,192,druid,restoration,6,2,4
6085,Baldhir,nemesis,192,druid,restoration,6,2,4
6086,Tàazz,sargeras,192,druid,restoration,6,2,4
6087,Griminal,norgannon,192,druid,restoration,6,2,4
6088,Zhiwé,ravencrest,192,druid,restoration,6,2,4
6089,Vulcäin,ysondre,192,druid,restoration,6,2,4
6090,Hotseîdank,blackrock,192,druid,restoration,6,2,4
6091,Rtxy,hyjal,192,druid,restoration,6,2,4
6092,Zenkillers,outland,192,druid,restoration,6,2,4
6093,Nelfurion,twisting-nether,192,druid,restoration,6,2,4
6094,Пикаббука,gordunni,192,druid,restoration,6,2,4
6095,Fanso,burning-legion,192,druid,restoration,6,2,4
6096,Xerrean,ravencrest,192,druid,restoration,6,2,4
6097,Droodu,dun-modr,192,druid,restoration,6,2,4
6098,Sajlol,doomhammer,192,druid,restoration,6,2,4
6099,Kremhelt,outland,192,druid,restoration,6,2,4
6100,Pinkpanda,arthas,192,druid,restoration,6,2,4
6101,Wörstplayêr,archimonde,192,druid,restoration,6,2,4
6102,Midrialis,sinstralis,192,druid,restoration,6,2,4
6103,Lootmann,die-silberne-hand,192,druid,restoration,6,2,4
6104,Slimsneeky,outland,192,druid,restoration,6,2,4
6105,Адорабэль,deathguard,192,druid,restoration,6,2,4
6106,Mjáy,tarren-mill,192,druid,restoration,6,2,4
6107,Шокоокулист,gordunni,192,druid,restoration,6,2,4
6108,Harryjane,antonidas,192,druid,restoration,6,2,4
6109,Palavanus,stormscale,192,druid,restoration,6,2,4
6110,Chrisdruid,argent-dawn,192,druid,restoration,6,2,4
6111,Атитока,goldrinn,192,druid,restoration,6,2,4
6112,Disney,ragnaros,192,druid,restoration,6,2,4
6113,Jasof,sylvanas,192,druid,restoration,6,2,4
6114,Cpt,xavius,192,druid,restoration,6,2,4
6115,Ymöthep,archimonde,192,druid,restoration,6,2,4
6116,Conn,ravencrest,192,druid,restoration,6,2,4
6117,Nooz,thrall,192,druid,restoration,6,2,4
6118,Jimboza,stormscale,192,druid,restoration,6,2,4
6119,Smokahontas,kilrogg,192,druid,restoration,6,2,4
6120,Sickomodê,blackmoore,192,druid,restoration,6,2,4
6121,Morphael,ravencrest,192,druid,restoration,6,2,4
6122,Moodee,kazzak,192,druid,restoration,6,2,4
6123,Kkona,silvermoon,192,druid,restoration,6,2,4
6124,Rédbullz,silvermoon,192,druid,restoration,6,2,4
6125,Northstarx,kazzak,192,druid,restoration,6,2,4
6126,Trollingt,draenor,192,druid,restoration,6,2,4
6127,Príimé,kazzak,192,druid,restoration,6,2,4
6128,Revølter,kazzak,192,druid,restoration,6,2,4
6129,Benjiee,kazzak,192,druid,restoration,6,2,4
6130,Speegle,kazzak,192,druid,restoration,6,2,4
6131,Heligakatten,twisting-nether,192,druid,restoration,10,3,7
6132,Gonco,blackrock,192,druid,restoration,8,2,6
6133,Baracüda,draenor,192,druid,restoration,16,3,13
6134,Shaggí,draenor,192,druid,restoration,11,2,9
6135,Qocotte,archimonde,192,druid,restoration,12,2,10
6136,Testomake,kazzak,192,druid,restoration,12,2,10
6137,Piper,culte-de-la-rive-noire,192,druid,restoration,12,2,10
6138,Màf,silvermoon,192,druid,restoration,12,2,10
6139,Álou,dalaran,192,druid,restoration,12,2,10
6140,Lyj,dalaran,192,druid,restoration,12,2,10
6141,Skorpo,blackrock,192,druid,restoration,12,2,10
6142,Helpthebear,twisting-nether,192,druid,restoration,12,2,10
6143,Jacksonella,dun-morogh,192,druid,restoration,12,2,10
6144,Салона,deathguard,192,druid,restoration,12,2,10
6145,Wahahoo,la-croisade-écarlate,192,druid,restoration,12,2,10
6146,Drâcâ,antonidas,192,druid,restoration,12,2,10
6147,Nakkikastike,magtheridon,192,druid,restoration,12,2,10
6148,Vertabrain,twilights-hammer,192,druid,restoration,12,2,10
6149,Keløkss,silvermoon,192,druid,restoration,12,2,10
6150,Kizanimagus,magtheridon,192,druid,restoration,12,2,10
6151,Amaaja,blackmoore,192,druid,restoration,12,2,10
6152,Blâckrök,blackhand,192,druid,restoration,12,2,10
6153,Anníe,tarren-mill,192,druid,restoration,12,2,10
6154,Darkstalker,arygos,192,druid,restoration,12,2,10
6155,Imperador,tyrande,192,druid,restoration,12,2,10
6156,Quentalius,argent-dawn,192,druid,restoration,12,2,10
6157,Maceyx,ravencrest,192,druid,restoration,12,2,10
6158,Tayswiftmend,defias-brotherhood,192,druid,restoration,12,2,10
6159,Fâucon,eitrigg,192,druid,restoration,12,2,10
6160,Bigstop,kazzak,192,druid,restoration,17,2,15
6161,Arminíus,die-silberne-hand,192,druid,restoration,18,2,16
6162,Quza,lightbringer,192,druid,restoration,18,2,16
6163,Охломон,gordunni,192,druid,restoration,24,2,22
6164,Dudu,sinstralis,191,druid,restoration,6,2,4
6165,Bingó,blutkessel,191,druid,restoration,6,2,4
6166,Siyoo,thrall,191,druid,restoration,6,2,4
6167,Dahelire,shendralar,191,druid,restoration,6,2,4
6168,Зулгасилич,howling-fjord,191,druid,restoration,6,2,4
6169,Snifa,the-venture-co,191,druid,restoration,7,2,5
6170,Westbeast,doomhammer,191,druid,restoration,12,2,10
6171,Mômmôm,aggra-português,191,druid,restoration,12,2,10
6172,Эхосна,howling-fjord,191,druid,restoration,12,2,10
6173,Amindenes,ragnaros,191,druid,restoration,18,2,16
6174,Charlierunkl,gorgonnash,190,druid,restoration,18,2,16
6175,Marynlord,dalaran,175,druid,restoration,11,2,9
6176,Wolig,tarren-mill,159,druid,restoration,5,2,3
6177,Stkk,dun-modr,159,druid,restoration,5,2,3
6178,Zayrok,throkferoth,159,druid,restoration,8,3,5
6179,Сугрик,deathweaver,143,druid,restoration,15,2,13
6180,Starcrash,amanthul,138,druid,restoration,6,3,3
6181,Shipmaster,ravencrest,138,druid,restoration,8,3,5
6182,Zzblaah,archimonde,138,druid,restoration,10,3,7
6183,Chauntee,draenor,138,druid,restoration,15,3,12
6184,Prettysavage,blackhand,138,druid,restoration,19,3,16
6185,Lynaee,cthun,128,druid,restoration,4,2,2
6186,Ihatewhales,ravencrest,128,druid,restoration,4,2,2
6187,Thaiboimbyy,veknilash,127,druid,restoration,4,2,2
6188,Razorleaf,turalyon,127,druid,restoration,8,2,6
6189,Xneji,sylvanas,111,druid,restoration,13,2,11
6190,Drblackus,draenor,96,druid,restoration,3,2,1
6191,Trä,earthen-ring,96,druid,restoration,3,2,1
6192,Пасторизсша,soulflayer,96,druid,restoration,6,1,5
6193,Fedelmae,nagrand,96,druid,restoration,6,1,5
6194,Bøøstèdtréè,ravencrest,96,druid,restoration,6,1,5
6195,Nikta,trollbane,96,druid,restoration,6,1,5
6196,Phatzoo,stormscale,96,druid,restoration,6,1,5
6197,Tilikum,stormscale,96,druid,restoration,6,1,5
6198,Blark,sylvanas,96,druid,restoration,6,1,5
6199,Hefdgaharald,antonidas,96,druid,restoration,6,1,5
6200,Sucukk,antonidas,96,druid,restoration,6,1,5
6201,Naturaven,sylvanas,96,druid,restoration,6,1,5
6202,Ilikecaipi,eredar,96,druid,restoration,6,1,5
6203,Tshungubuäch,eredar,96,druid,restoration,6,1,5
6204,Blanoz,ravencrest,96,druid,restoration,6,1,5
6205,Zoura,ysondre,96,druid,restoration,6,1,5
6206,Pølïna,ysondre,96,druid,restoration,6,1,5
6207,Vicedxo,kazzak,96,druid,restoration,6,1,5
6208,Effi,aggramar,96,druid,restoration,6,1,5
6209,Gámóra,argent-dawn,96,druid,restoration,6,1,5
6210,Søfiaa,argent-dawn,96,druid,restoration,6,1,5
6211,Nanuu,sylvanas,96,druid,restoration,6,1,5
6212,Sylindra,argent-dawn,96,druid,restoration,6,1,5
6213,Druvian,argent-dawn,96,druid,restoration,6,1,5
6214,Мунпраид,gordunni,96,druid,restoration,6,1,5
6215,Druiruu,tarren-mill,96,druid,restoration,6,1,5
6216,Druidguden,tarren-mill,96,druid,restoration,6,1,5
6217,Heala,malganis,96,druid,restoration,6,1,5
6218,Элнут,gordunni,96,druid,restoration,6,1,5
6219,Secô,sylvanas,96,druid,restoration,6,1,5
6220,Släshes,stormreaver,96,druid,restoration,6,1,5
6221,Злодзейка,gordunni,96,druid,restoration,6,1,5
6222,Feroxe,kazzak,96,druid,restoration,6,1,5
6223,Deezforms,kazzak,96,druid,restoration,6,1,5
6224,Винш,grom,96,druid,restoration,6,1,5
6225,Nermax,kazzak,96,druid,restoration,6,1,5
6226,Sonyk,drakthul,96,druid,restoration,6,1,5
6227,Hecaloth,drakthul,96,druid,restoration,6,1,5
6228,Tranduiil,drakthul,96,druid,restoration,6,1,5
6229,Linkin,azshara,96,druid,restoration,6,1,5
6230,Жарищка,soulflayer,96,druid,restoration,6,1,5
6231,Sodapop,aszune,96,druid,restoration,6,1,5
6232,Madmoss,twisting-nether,96,druid,restoration,6,1,5
6233,Nwal,thunderhorn,96,druid,restoration,6,1,5
6234,Haginator,twisting-nether,96,druid,restoration,6,1,5
6235,Kisyqt,aegwynn,96,druid,restoration,6,1,5
6236,Meisterd,aegwynn,96,druid,restoration,6,1,5
6237,Utuabzu,grim-batol,96,druid,restoration,6,1,5
6238,Aspegic,grim-batol,96,druid,restoration,6,1,5
6239,Nøunøurss,dalaran,96,druid,restoration,6,1,5
6240,Anahots,silvermoon,96,druid,restoration,6,1,5
6241,Murma,dalaran,96,druid,restoration,6,1,5
6242,Bgwell,archimonde,96,druid,restoration,6,1,5
6243,Wildsoûl,kazzak,96,druid,restoration,6,1,5
6244,Nuggetspøwa,dalaran,96,druid,restoration,6,1,5
6245,Durlehardu,archimonde,96,druid,restoration,6,1,5
6246,Ka,the-maelstrom,96,druid,restoration,6,1,5
6247,Maiuna,blackhand,96,druid,restoration,6,1,5
6248,Blodemoon,ragnaros,96,druid,restoration,6,1,5
6249,Kerydwen,silvermoon,96,druid,restoration,6,1,5
6250,Droodae,hyjal,96,druid,restoration,6,1,5
6251,Taicoo,outland,96,druid,restoration,6,1,5
6252,Chapuk,kazzak,96,druid,restoration,6,1,5
6253,Thebartender,khaz-modan,96,druid,restoration,6,1,5
6254,Pesza,bloodscalp,96,druid,restoration,6,1,5
6255,Сейтил,deathguard,96,druid,restoration,6,1,5
6256,Cevto,drakthul,96,druid,restoration,6,1,5
6257,Enfy,lightbringer,96,druid,restoration,6,1,5
6258,Zulk,draenor,96,druid,restoration,6,1,5
6259,Jooblob,guldan,96,druid,restoration,6,1,5
6260,Kweelor,der-abyssische-rat,96,druid,restoration,6,1,5
6261,Bignunu,silvermoon,96,druid,restoration,6,1,5
6262,Vaizier,defias-brotherhood,96,druid,restoration,6,1,5
6263,Seekíng,blackmoore,96,druid,restoration,6,1,5
6264,Psitol,silvermoon,96,druid,restoration,6,1,5
6265,Dmai,burning-legion,96,druid,restoration,6,1,5
6266,Malurith,silvermoon,96,druid,restoration,6,1,5
6267,Winstonka,doomhammer,96,druid,restoration,6,1,5
6268,Bartige,blackmoore,96,druid,restoration,6,1,5
6269,Cowárd,blackmoore,96,druid,restoration,6,1,5
6270,Nyooxix,blackmoore,96,druid,restoration,6,1,5
6271,Oltoker,korgall,96,druid,restoration,6,1,5
6272,Xkirtach,dun-modr,96,druid,restoration,6,1,5
6273,Elo,dun-morogh,96,druid,restoration,6,1,5
6274,Gintoni,dun-modr,96,druid,restoration,6,1,5
6275,Sozu,magtheridon,96,druid,restoration,6,1,5
6276,Thaïs,blackmoore,96,druid,restoration,6,1,5
6277,Horadruid,silvermoon,96,druid,restoration,6,1,5
6278,Qdrood,quelthalas,96,druid,restoration,6,1,5
6279,Kruwkamilka,burning-legion,96,druid,restoration,6,1,5
6280,Ymgrawl,zuljin,96,druid,restoration,6,1,5
6281,Symba,uldum,96,druid,restoration,6,1,5
6282,Faladriel,zirkel-des-cenarius,96,druid,restoration,7,1,6
6283,Napukka,silvermoon,96,druid,restoration,12,1,11
6284,Püpply,antonidas,96,druid,restoration,12,1,11
6285,Tafs,stormscale,96,druid,restoration,12,1,11
6286,Aisak,burning-legion,96,druid,restoration,12,1,11
6287,Athenex,azshara,96,druid,restoration,12,1,11
6288,Mariss25076F,chogall,96,druid,restoration,12,1,11
6289,Anniko,garona,96,druid,restoration,12,1,11
6290,Xilmai,darksorrow,96,druid,restoration,12,1,11
6291,Blietmachine,ravencrest,96,druid,restoration,12,1,11
6292,Ra,stormscale,96,druid,restoration,12,1,11
6293,Griimmjjow,kazzak,96,druid,restoration,12,1,11
6294,Meowmeowmeow,stormscale,96,druid,restoration,12,1,11
6295,Nevthren,aggra-português,96,druid,restoration,12,1,11
6296,Feminhacked,outland,96,druid,restoration,12,1,11
6297,Kli,los-errantes,96,druid,restoration,12,1,11
6298,Avalora,the-maelstrom,96,druid,restoration,12,1,11
6299,Чупакамра,gordunni,96,druid,restoration,12,1,11
6300,Natur,gorgonnash,96,druid,restoration,12,1,11
6301,Келиса,blackscar,96,druid,restoration,12,1,11
6302,Лапунька,gordunni,96,druid,restoration,12,1,11
6303,Raveous,tarren-mill,96,druid,restoration,18,1,17
6304,Lübka,amanthul,95,druid,restoration,12,1,11
6305,Acidbrate,aegwynn,90,druid,restoration,12,3,9
6306,Watchmymoon,blackrock,84,druid,restoration,20,4,16
6307,Pobrica,stormscale,79,druid,restoration,5,1,4
6308,Sealife,destromath,79,druid,restoration,5,1,4
6309,Druidenee,hyjal,63,druid,restoration,2,2,0
6310,Rasserdruid,runetotem,63,druid,restoration,2,2,0
6311,Shunos,ragnaros,48,druid,restoration,9,1,8
6312,Restouz,twisting-nether,42,druid,restoration,6,2,4
6313,Quizdarude,draenor,42,druid,restoration,10,3,7
6314,Therøn,dun-modr,42,druid,restoration,11,3,8
6315,Growlithe,hellfire,42,druid,restoration,8,2,6
6316,Eceria,the-maelstrom,42,druid,restoration,9,2,7
6317,Feráx,doomhammer,42,druid,restoration,9,2,7
6318,Ультраафина,gordunni,42,druid,restoration,9,2,7
6319,Amadi,grim-batol,42,druid,restoration,9,2,7
6320,Аллишана,howling-fjord,42,druid,restoration,10,2,8
6321,Noxann,archimonde,42,druid,restoration,10,2,8
6322,Onacor,stormrage,42,druid,restoration,10,2,8
6323,Nytaleas,naxxramas,42,druid,restoration,10,2,8
6324,Uniquz,sylvanas,42,druid,restoration,11,2,9
6325,Vanarea,argent-dawn,42,druid,restoration,14,2,12
6326,Druiden,the-maelstrom,31,druid,restoration,2,1,1
6327,Девочкамиши,soulflayer,31,druid,restoration,2,1,1
6328,Bulleyo,ysondre,1595,druid,guardian,107,58,49
6329,Djemdruid,argent-dawn,1585,druid,guardian,42,18,24
6330,Windythemilf,stormscale,1240,druid,guardian,195,98,97
6331,Сверххищникк,soulflayer,1163,druid,guardian,50,20,30
6332,Rbgbear,blackhand,1156,druid,guardian,36,15,21
6333,Rapatera,argent-dawn,1115,druid,guardian,24,12,12
6334,Reshifted,sunstrider,1090,druid,guardian,39,14,25
6335,Durlehardu,archimonde,1053,druid,guardian,41,19,22
6336,Микайо,goldrinn,986,druid,guardian,41,17,24
6337,Avior,eonar,975,druid,guardian,106,46,60
6338,Laracroft,the-maelstrom,953,druid,guardian,22,11,11
6339,Bigdomas,sylvanas,833,druid,guardian,34,14,20
6340,Renaissancee,silvermoon,823,druid,guardian,32,10,22
6341,Avisa,blackhand,786,druid,guardian,78,30,48
6342,Ноорру,gordunni,715,druid,guardian,11,8,3
6343,Ксидронис,eversong,687,druid,guardian,22,8,14
6344,Lioky,dun-modr,670,druid,guardian,12,7,5
6345,Critter,kargath,661,druid,guardian,24,7,17
6346,Wildsoûl,kazzak,575,druid,guardian,24,6,18
6347,Crazydudu,tarren-mill,550,druid,guardian,27,8,19
6348,Win,hellscream,496,druid,guardian,23,7,16
6349,Slotheron,ravencrest,480,druid,guardian,12,5,7
6350,Tigerbear,argent-dawn,384,druid,guardian,12,4,8
6351,Horizonline,terokkar,350,druid,guardian,11,4,7
6352,Фэк,eversong,288,druid,guardian,6,3,3
6353,Icxigo,silvermoon,288,druid,guardian,6,3,3
6354,Гохгерункянк,soulflayer,287,druid,guardian,6,3,3
6355,Pumpick,doomhammer,285,druid,guardian,13,3,10
6356,Kaynine,lightnings-blade,192,druid,guardian,6,2,4
6357,Sároman,ravencrest,192,druid,guardian,6,2,4
6358,Astralcore,stormscale,192,druid,guardian,6,2,4
6359,Джирас,gordunni,192,druid,guardian,6,2,4
6360,Druidyy,exodar,192,druid,guardian,6,2,4
6361,Kárrde,balnazzar,192,druid,guardian,6,2,4
6362,Zinister,hyjal,192,druid,guardian,6,2,4
6363,Nwal,thunderhorn,192,druid,guardian,12,2,10
6364,Fynvola,anubarak,192,druid,guardian,12,2,10
6365,Beteralsjij,frostwhisper,192,druid,guardian,12,2,10
6366,Silver,terokkar,192,druid,guardian,12,2,10
6367,Sheâ,nemesis,191,druid,guardian,6,2,4
6368,Pure,kul-tiras,190,druid,guardian,15,3,12
6369,Plandros,draenor,96,druid,guardian,6,1,5
6370,Anthlas,outland,96,druid,guardian,6,1,5
6371,Leondir,quelthalas,96,druid,guardian,6,1,5
6372,Almightydudu,draenor,96,druid,guardian,6,1,5
6373,Oõ,aggra-português,96,druid,guardian,6,1,5
6374,Жекакотик,eversong,96,druid,guardian,6,1,5
6375,Brutaldamage,ravencrest,2271,druid,feral,119,63,56
6376,Ktx,aegwynn,2238,druid,feral,84,50,34
6377,Verycringe,ravencrest,2237,druid,feral,144,75,69
6378,Twinklex,ravencrest,2186,druid,feral,185,91,94
6379,Lïved,nemesis,2184,druid,feral,114,71,43
6380,Xercas,outland,2166,druid,feral,65,39,26
6381,Degmond,silvermoon,2147,druid,feral,108,61,47
6382,Mabkferal,ravencrest,2146,druid,feral,133,67,66
6383,Elîas,kazzak,2141,druid,feral,77,45,32
6384,Desenlace,ravencrest,2127,druid,feral,149,82,67
6385,Tael,elune,2119,druid,feral,120,60,60
6386,Houmrx,ravencrest,2113,druid,feral,173,89,84
6387,Bloodyredlyx,ysera,2112,druid,feral,90,46,44
6388,Öøöøöøöøöøöø,anachronos,2110,druid,feral,72,47,25
6389,Ромкабикстар,gordunni,2107,druid,feral,78,40,38
6390,Cataferal,ravencrest,2075,druid,feral,108,57,51
6391,Yone,blackmoore,2071,druid,feral,78,44,34
6392,Nìm,outland,2057,druid,feral,124,60,64
6393,Crøwnd,twisting-nether,2056,druid,feral,54,34,20
6394,Dashfull,ravencrest,2049,druid,feral,227,122,105
6395,Desenlace,silvermoon,2047,druid,feral,156,77,79
6396,Tomyn,burning-legion,2033,druid,feral,72,43,29
6397,Zøte,ravencrest,2026,druid,feral,96,47,49
6398,Uebiwe,silvermoon,2022,druid,feral,84,48,36
6399,Rubbershark,ravencrest,2020,druid,feral,154,99,55
6400,Rapatera,argent-dawn,2019,druid,feral,54,30,24
6401,Jakamx,ravencrest,2017,druid,feral,342,172,170
6402,Mmlprox,burning-legion,2012,druid,feral,121,59,62
6403,Vulko,lightbringer,2009,druid,feral,108,52,56
6404,Taladruide,archimonde,2002,druid,feral,102,50,52
6405,Lxve,tarren-mill,1999,druid,feral,66,34,32
6406,Purgatxry,ravencrest,1989,druid,feral,443,224,219
6407,Råñkønêbëår,ravencrest,1982,druid,feral,60,36,24
6408,Gurranq,argent-dawn,1964,druid,feral,60,32,28
6409,Trøüpäx,outland,1955,druid,feral,123,61,62
6410,Iminz,ravencrest,1950,druid,feral,233,111,122
6411,Djgírlßøssqt,argent-dawn,1941,druid,feral,126,62,64
6412,Трэвисдог,gordunni,1936,druid,feral,59,31,28
6413,Mutaattori,sylvanas,1931,druid,feral,61,29,32
6414,Kaldorei,nemesis,1929,druid,feral,56,33,23
6415,Mortality,proudmoore,1925,druid,feral,77,39,38
6416,Cløwnferalx,argent-dawn,1921,druid,feral,54,25,29
6417,Cåssidy,archimonde,1911,druid,feral,72,32,40
6418,Kàraba,archimonde,1909,druid,feral,94,47,47
6419,Noxxìe,draenor,1904,druid,feral,56,29,27
6420,Ðevilwhite,nemesis,1902,druid,feral,36,20,16
6421,Nîîght,ravencrest,1895,druid,feral,54,26,28
6422,Норланда,gordunni,1884,druid,feral,60,32,28
6423,Опакот,howling-fjord,1879,druid,feral,68,30,38
6424,Garbagemonky,amanthul,1878,druid,feral,130,83,47
6425,Trauller,outland,1872,druid,feral,72,30,42
6426,Symbiosa,silvermoon,1870,druid,feral,30,20,10
6427,Elfsu,ravencrest,1863,druid,feral,77,44,33
6428,Obeseferal,outland,1859,druid,feral,66,31,35
6429,Bigangrycatx,ravencrest,1859,druid,feral,68,31,37
6430,Boostedbear,ragnaros,1848,druid,feral,65,30,35
6431,Нимир,soulflayer,1844,druid,feral,72,34,38
6432,Bigcrazycatx,ravencrest,1844,druid,feral,72,33,39
6433,Kattenvoer,stormscale,1842,druid,feral,36,27,9
6434,Alexmeow,ravencrest,1841,druid,feral,56,34,22
6435,Calaftayou,ravencrest,1841,druid,feral,72,33,39
6436,Ethryl,ravencrest,1837,druid,feral,90,45,45
6437,Skatch,sylvanas,1836,druid,feral,54,28,26
6438,Yesbody,tarren-mill,1836,druid,feral,48,24,24
6439,Jhiun,ragnaros,1833,druid,feral,126,68,58
6440,Mysticalmoon,ravencrest,1832,druid,feral,72,32,40
6441,Khunahype,thrall,1829,druid,feral,42,31,11
6442,Февти,gordunni,1828,druid,feral,59,34,25
6443,Блюгилли,ashenvale,1826,druid,feral,86,40,46
6444,Kaÿn,tarren-mill,1825,druid,feral,54,24,30
6445,Jåkeferalta,outland,1824,druid,feral,81,42,39
6446,Drbeef,sanguino,1823,druid,feral,45,28,17
6447,Zelaron,twisting-nether,1823,druid,feral,42,22,20
6448,Léxiny,blackrock,1822,druid,feral,29,20,9
6449,Фейкхехе,gordunni,1822,druid,feral,48,27,21
6450,Reward,ragnaros,1819,druid,feral,64,30,34
6451,Rheasilvià,silvermoon,1818,druid,feral,54,31,23
6452,Fyrkax,aegwynn,1818,druid,feral,48,26,22
6453,Блиденг,gordunni,1818,druid,feral,81,43,38
6454,Kroñm,dun-modr,1818,druid,feral,60,25,35
6455,Cocaqt,nemesis,1815,druid,feral,58,35,23
6456,Fendrïl,varimathras,1814,druid,feral,90,55,35
6457,Nøfåmïly,silvermoon,1814,druid,feral,160,83,77
6458,Лардиан,gordunni,1813,druid,feral,42,25,17
6459,Nainket,ravencrest,1813,druid,feral,48,22,26
6460,Moonkniight,ravencrest,1810,druid,feral,30,22,8
6461,Dureka,tarren-mill,1810,druid,feral,60,38,22
6462,Nfxdruid,argent-dawn,1810,druid,feral,90,54,36
6463,Muckì,alleria,1808,druid,feral,48,24,24
6464,Minaervea,antonidas,1808,druid,feral,102,47,55
6465,Bleêds,dun-modr,1807,druid,feral,30,19,11
6466,Coineagan,frostmourne,1807,druid,feral,46,20,26
6467,Caprïsun,archimonde,1804,druid,feral,42,24,18
6468,Tilikum,stormscale,1804,druid,feral,311,156,155
6469,Mykk,ravencrest,1802,druid,feral,54,33,21
6470,Ratsimulator,tarren-mill,1802,druid,feral,54,32,22
6471,Skytek,silvermoon,1802,druid,feral,84,41,43
6472,Мелталиора,soulflayer,1800,druid,feral,59,30,29
6473,Annksunamún,ysondre,1798,druid,feral,225,124,101
6474,Nzmdruid,burning-legion,1795,druid,feral,48,25,23
6475,Alessathrina,argent-dawn,1783,druid,feral,192,93,99
6476,Dzandel,silvermoon,1781,druid,feral,494,246,248
6477,Ålleyézoffme,ravencrest,1780,druid,feral,77,43,34
6478,Catkovic,kult-der-verdammten,1777,druid,feral,47,24,23
6479,Отхода,gordunni,1770,druid,feral,40,22,18
6480,Klaerke,tarren-mill,1769,druid,feral,75,32,43
6481,Noé,aegwynn,1766,druid,feral,183,112,71
6482,Jarethy,dun-modr,1766,druid,feral,117,55,62
6483,Каергорн,soulflayer,1766,druid,feral,54,19,35
6484,Селфика,gordunni,1757,druid,feral,66,21,45
6485,Yaddas,draenor,1754,druid,feral,60,27,33
6486,Sleepykitty,argent-dawn,1750,druid,feral,143,75,68
6487,Fürfur,ravencrest,1749,druid,feral,48,29,19
6488,Kikihoux,ravencrest,1747,druid,feral,41,22,19
6489,Moldrokk,ravencrest,1739,druid,feral,52,31,21
6490,Feralwilder,turalyon,1736,druid,feral,165,75,90
6491,Babynaty,ravencrest,1735,druid,feral,102,48,54
6492,Pilaf,emerald-dream,1734,druid,feral,133,63,70
6493,Шев,blackscar,1733,druid,feral,48,23,25
6494,Apuasaatana,stormreaver,1731,druid,feral,36,20,16
6495,Jabbari,outland,1729,druid,feral,186,96,90
6496,Jukeboks,silvermoon,1726,druid,feral,55,25,30
6497,Verbxp,kazzak,1725,druid,feral,65,35,30
6498,Buffshred,ravencrest,1721,druid,feral,24,18,6
6499,Themartyr,tarren-mill,1721,druid,feral,30,18,12
6500,Zechey,stormreaver,1721,druid,feral,30,18,12
6501,Shiftydruid,thunderhorn,1718,druid,feral,206,99,107
6502,Zaibastus,doomhammer,1718,druid,feral,72,30,42
6503,Opresse,archimonde,1717,druid,feral,66,28,38
6504,Melsson,stormreaver,1714,druid,feral,48,22,26
6505,Pänthërä,ravencrest,1711,druid,feral,36,18,18
6506,Итильтириэль,gordunni,1705,druid,feral,92,41,51
6507,Worgenshiftr,kazzak,1697,druid,feral,48,21,27
6508,Kouda,draenor,1696,druid,feral,74,34,40
6509,Ottur,argent-dawn,1695,druid,feral,30,18,12
6510,Blvckðvitchz,ravencrest,1692,druid,feral,36,18,18
6511,Tangela,stormreaver,1689,druid,feral,48,29,19
6512,Fückøff,ravencrest,1689,druid,feral,65,33,32
6513,Natakis,blades-edge,1688,druid,feral,48,25,23
6514,Doopdroo,tarren-mill,1687,druid,feral,48,20,28
6515,Scaleo,stormreaver,1686,druid,feral,42,26,16
6516,Facerippin,proudmoore,1683,druid,feral,40,21,19
6517,Freyanah,argent-dawn,1682,druid,feral,111,49,62
6518,ßgøðx,argent-dawn,1681,druid,feral,79,45,34
6519,Arfgtdispo,hyjal,1680,druid,feral,48,23,25
6520,Hässelhoof,ragnaros,1680,druid,feral,114,48,66
6521,Jellytardx,outland,1675,druid,feral,75,41,34
6522,Paranoia,outland,1675,druid,feral,94,46,48
6523,Zifr,dalaran,1675,druid,feral,66,22,44
6524,Thørkang,dun-modr,1674,druid,feral,59,36,23
6525,Crazydos,tarren-mill,1671,druid,feral,57,27,30
6526,Phenova,sargeras,1671,druid,feral,99,41,58
6527,Adastroeolo,sanguino,1669,druid,feral,87,49,38
6528,Aedui,tarren-mill,1668,druid,feral,38,20,18
6529,Ðrüid,ravencrest,1668,druid,feral,72,34,38
6530,Jgltrainer,archimonde,1666,druid,feral,53,31,22
6531,Nøkki,draenor,1666,druid,feral,62,34,28
6532,Silksharp,ravencrest,1663,druid,feral,60,31,29
6533,Bernfried,silvermoon,1662,druid,feral,64,28,36
6534,Triluxa,blackmoore,1659,druid,feral,54,28,26
6535,Adabsurdum,kazzak,1659,druid,feral,124,55,69
6536,Blakkowl,drakthul,1653,druid,feral,36,21,15
6537,Bigpapad,ravencrest,1651,druid,feral,42,21,21
6538,Indann,kazzak,1651,druid,feral,48,19,29
6539,Nasukka,grim-batol,1648,druid,feral,103,54,49
6540,Moskaros,turalyon,1646,druid,feral,90,41,49
6541,Ckelf,ravencrest,1646,druid,feral,42,18,24
6542,Nouin,twisting-nether,1643,druid,feral,154,74,80
6543,Simdruid,stormscale,1641,druid,feral,36,19,17
6544,Bulan,ghostlands,1638,druid,feral,66,41,25
6545,Goodtrip,archimonde,1636,druid,feral,110,53,57
6546,Phïl,ravencrest,1635,druid,feral,90,48,42
6547,Emph,ravencrest,1631,druid,feral,48,28,20
6548,Ñøpe,ravencrest,1630,druid,feral,30,17,13
6549,Fzx,aegwynn,1629,druid,feral,30,17,13
6550,Ddru,ravencrest,1629,druid,feral,36,20,16
6551,Avanah,silvermoon,1626,druid,feral,72,35,37
6552,Rami,sylvanas,1624,druid,feral,114,56,58
6553,Паинтер,blackscar,1624,druid,feral,59,27,32
6554,Котосапенс,howling-fjord,1623,druid,feral,42,23,19
6555,Грязныекогти,gordunni,1622,druid,feral,65,39,26
6556,Goldrax,outland,1621,druid,feral,48,22,26
6557,Neyok,blackrock,1619,druid,feral,50,26,24
6558,Злодзейка,gordunni,1619,druid,feral,105,53,52
6559,Skypinho,blackhand,1616,druid,feral,48,22,26
6560,Djmeowxd,blackrock,1616,druid,feral,69,30,39
6561,Soofyan,kazzak,1615,druid,feral,54,22,32
6562,Rayjinn,dun-modr,1613,druid,feral,36,17,19
6563,Narunis,tarren-mill,1612,druid,feral,90,43,47
6564,Unoseeme,outland,1610,druid,feral,95,42,53
6565,Heyiamdan,tarren-mill,1609,druid,feral,158,88,70
6566,Hugepepega,ravencrest,1608,druid,feral,48,27,21
6567,Banzeye,nordrassil,1607,druid,feral,68,35,33
6568,Feytique,aegwynn,1607,druid,feral,53,27,26
6569,Тётявискас,howling-fjord,1606,druid,feral,42,26,16
6570,Pitchou,karazhan,1606,druid,feral,70,35,35
6571,Crisspurolss,ysondre,1605,druid,feral,73,38,35
6572,Реалаг,howling-fjord,1604,druid,feral,47,20,27
6573,Evilshade,ravencrest,1604,druid,feral,115,47,68
6574,Акиша,deepholm,1602,druid,feral,44,21,23
6575,Køgér,kazzak,1601,druid,feral,30,17,13
6576,Zarc,stormreaver,1601,druid,feral,37,20,17
6577,Chronoqtxd,ravencrest,1601,druid,feral,52,24,28
6578,Tani,kazzak,1600,druid,feral,63,34,29
6579,Ajwen,tarren-mill,1593,druid,feral,30,20,10
6580,Frighton,ravencrest,1591,druid,feral,72,30,42
6581,Drunosio,magtheridon,1588,druid,feral,78,36,42
6582,Vëgâñgøðx,ragnaros,1582,druid,feral,170,90,80
6583,Fluffygoon,tarren-mill,1581,druid,feral,86,41,45
6584,Leylå,ravencrest,1578,druid,feral,42,19,23
6585,Wucherwurzel,eredar,1576,druid,feral,107,47,60
6586,Nédith,archimonde,1576,druid,feral,42,18,24
6587,Sartipus,draenor,1575,druid,feral,48,24,24
6588,Raznos,ravencrest,1572,druid,feral,83,48,35
6589,Asçdruid,kazzak,1572,druid,feral,56,24,32
6590,Eranor,archimonde,1569,druid,feral,152,79,73
6591,Yongala,archimonde,1565,druid,feral,66,35,31
6592,Stopwatching,outland,1565,druid,feral,42,18,24
6593,Fangornn,outland,1560,druid,feral,89,40,49
6594,Sadskia,sanguino,1559,druid,feral,42,20,22
6595,Риама,blackscar,1558,druid,feral,78,38,40
6596,Jasperqt,silvermoon,1556,druid,feral,30,18,12
6597,Drylle,argent-dawn,1555,druid,feral,93,50,43
6598,Cubswansón,outland,1550,druid,feral,79,43,36
6599,Zhosy,shattrath,1550,druid,feral,41,17,24
6600,Texoria,twisting-nether,1549,druid,feral,126,63,63
6601,Chiwsy,outland,1548,druid,feral,83,42,41
6602,Féral,hyjal,1548,druid,feral,101,48,53
6603,Vlcák,drakthul,1547,druid,feral,202,104,98
6604,Smuktøs,twisting-nether,1546,druid,feral,47,28,19
6605,Lunamimi,argent-dawn,1544,druid,feral,84,55,29
6606,Køda,blackrock,1544,druid,feral,44,19,25
6607,Gediminas,argent-dawn,1543,druid,feral,82,29,53
6608,Bigdaddytate,kazzak,1542,druid,feral,59,38,21
6609,Мунпраид,gordunni,1541,druid,feral,78,39,39
6610,Sekunden,ravencrest,1540,druid,feral,72,37,35
6611,Retzerbil,ravencrest,1535,druid,feral,28,17,11
6612,Kärmä,eldrethalas,1535,druid,feral,113,58,55
6613,Baerminatør,blackrock,1535,druid,feral,72,35,37
6614,Shyngodx,archimonde,1533,druid,feral,41,17,24
6615,Сириль,soulflayer,1531,druid,feral,53,29,24
6616,Maccín,draenor,1530,druid,feral,52,18,34
6617,Epicplays,sylvanas,1526,druid,feral,84,49,35
6618,Lenyl,dun-modr,1526,druid,feral,36,16,20
6619,Одряя,soulflayer,1525,druid,feral,90,51,39
6620,Оудин,blackscar,1521,druid,feral,47,23,24
6621,Razoremperor,tarren-mill,1519,druid,feral,138,64,74
6622,Житмедветь,booty-bay,1518,druid,feral,52,27,25
6623,Rbgbot,ragnaros,1517,druid,feral,54,30,24
6624,Extracssion,ysondre,1515,druid,feral,89,40,49
6625,Unreally,drakthul,1512,druid,feral,30,18,12
6626,Zurllyn,ravencrest,1511,druid,feral,42,18,24
6627,Druidry,ragnaros,1506,druid,feral,54,30,24
6628,Даркедес,gordunni,1506,druid,feral,30,16,14
6629,Jerrybeans,ravencrest,1504,druid,feral,120,57,63
6630,Panthéra,ravencrest,1502,druid,feral,220,110,110
6631,Взп,gordunni,1502,druid,feral,36,18,18
6632,Зонкс,gordunni,1501,druid,feral,92,47,45
6633,Unlit,draenor,1499,druid,feral,54,27,27
6634,Броодяга,razuvious,1497,druid,feral,41,18,23
6635,Kabraxis,silvermoon,1494,druid,feral,54,25,29
6636,Chirnaruk,ravencrest,1492,druid,feral,72,38,34
6637,Арбузег,gordunni,1491,druid,feral,64,31,33
6638,Hkwoaf,chants-éternels,1487,druid,feral,47,18,29
6639,Rollozuu,blackrock,1483,druid,feral,96,46,50
6640,Crow,saurfang,1482,druid,feral,62,34,28
6641,Clipsy,twilights-hammer,1480,druid,feral,291,144,147
6642,Màz,blackmoore,1480,druid,feral,140,64,76
6643,Byet,kazzak,1478,druid,feral,42,17,25
6644,Элисандра,gordunni,1470,druid,feral,48,31,17
6645,Oleander,zuljin,1465,druid,feral,133,66,67
6646,Hushorde,twisting-nether,1464,druid,feral,47,23,24
6647,Zaethul,draenor,1460,druid,feral,30,20,10
6648,Муумуумуу,howling-fjord,1457,druid,feral,150,69,81
6649,Arlina,magtheridon,1454,druid,feral,57,26,31
6650,Ripgødx,outland,1453,druid,feral,146,79,67
6651,Christàlyst,garona,1452,druid,feral,45,23,22
6652,Bomoth,kazzak,1451,druid,feral,36,16,20
6653,Biffsteak,blackhand,1450,druid,feral,186,95,91
6654,Larryburns,nathrezim,1450,druid,feral,116,57,59
6655,Deehe,thrall,1447,druid,feral,36,18,18
6656,Smellykitten,ravencrest,1445,druid,feral,36,18,18
6657,Kimpine,kirin-tor,1444,druid,feral,73,41,32
6658,Vargall,silvermoon,1441,druid,feral,29,19,10
6659,Docmedlove,aegwynn,1437,druid,feral,36,15,21
6660,Chromaticx,argent-dawn,1436,druid,feral,56,32,24
6661,Dubakoo,outland,1435,druid,feral,85,46,39
6662,Hydorn,cthun,1435,druid,feral,50,24,26
6663,Crinji,ravencrest,1433,druid,feral,24,15,9
6664,Boomzter,frostmane,1433,druid,feral,75,36,39
6665,Микайо,goldrinn,1432,druid,feral,167,79,88
6666,Margueriti,the-maelstrom,1429,druid,feral,85,38,47
6667,Беконайзер,howling-fjord,1427,druid,feral,40,20,20
6668,Tazdino,destromath,1427,druid,feral,48,15,33
6669,Arilíaxo,amanthul,1426,druid,feral,18,15,3
6670,Бобасик,fordragon,1425,druid,feral,90,43,47
6671,Lugtedyr,draenor,1423,druid,feral,59,29,30
6672,Алексина,fordragon,1422,druid,feral,166,90,76
6673,Mervend,tarren-mill,1420,druid,feral,41,15,26
6674,Ephixa,burning-legion,1419,druid,feral,47,23,24
6675,Bagheera,archimonde,1419,druid,feral,95,45,50
6676,Фекаллис,soulflayer,1417,druid,feral,30,15,15
6677,Alcik,silvermoon,1417,druid,feral,54,15,39
6678,Nå,outland,1413,druid,feral,146,70,76
6679,Муунфаер,gordunni,1410,druid,feral,97,44,53
6680,Mônchô,sanguino,1408,druid,feral,100,61,39
6681,Thaelyy,drakthul,1407,druid,feral,66,27,39
6682,Kodobursto,stormscale,1406,druid,feral,85,50,35
6683,Эскоф,gordunni,1406,druid,feral,74,39,35
6684,Degentiuso,alakir,1405,druid,feral,96,53,43
6685,Furmagic,tarren-mill,1405,druid,feral,30,15,15
6686,Enjoik,drakthul,1404,druid,feral,131,65,66
6687,Snapzy,sylvanas,1401,druid,feral,42,27,15
6688,Luigina,blackmoore,1400,druid,feral,30,15,15
6689,Phesxd,sylvanas,1400,druid,feral,54,26,28
6690,Koumma,archimonde,1395,druid,feral,91,47,44
6691,Picatso,blackrock,1395,druid,feral,30,15,15
6692,Seyyid,archimonde,1394,druid,feral,36,18,18
6693,Sabertoon,argent-dawn,1393,druid,feral,165,73,92
6694,Neshalry,blackhand,1392,druid,feral,36,16,20
6695,Elitarian,argent-dawn,1391,druid,feral,163,81,82
6696,Котфилин,gordunni,1389,druid,feral,78,44,34
6697,Ponshü,hyjal,1389,druid,feral,45,24,21
6698,Sløthy,uldum,1386,druid,feral,46,24,22
6699,Legitx,dentarg,1385,druid,feral,43,17,26
6700,Drudonja,silvermoon,1384,druid,feral,102,53,49
6701,Tsopúnisher,twisting-nether,1383,druid,feral,46,20,26
6702,Carlitto,blackmoore,1382,druid,feral,33,23,10
6703,Crtx,blackhand,1381,druid,feral,102,60,42
6704,Liqoú,tarren-mill,1380,druid,feral,54,31,23
6705,Donoz,ravencrest,1378,druid,feral,42,26,16
6706,Zhényá,ravencrest,1377,druid,feral,36,17,19
6707,Ferøsse,hyjal,1374,druid,feral,42,21,21
6708,Pipima,kazzak,1374,druid,feral,48,20,28
6709,Cörelly,ravencrest,1368,druid,feral,96,48,48
6710,Акетчи,howling-fjord,1366,druid,feral,42,24,18
6711,Blintschiki,echsenkessel,1363,druid,feral,71,32,39
6712,Друличч,blackscar,1361,druid,feral,61,29,32
6713,Диаболус,gordunni,1359,druid,feral,62,32,30
6714,Rottweiler,doomhammer,1357,druid,feral,102,46,56
6715,Dadzeus,khaz-modan,1354,druid,feral,50,28,22
6716,Äcajou,hyjal,1354,druid,feral,70,39,31
6717,Manoestouro,draenor,1353,druid,feral,48,19,29
6718,ßußßo,ravencrest,1352,druid,feral,30,24,6
6719,Druidicmorr,sylvanas,1351,druid,feral,68,30,38
6720,Sÿlph,sylvanas,1348,druid,feral,102,51,51
6721,Grimgoor,burning-legion,1347,druid,feral,94,52,42
6722,Snapeshifter,blackhand,1343,druid,feral,36,19,17
6723,Bignik,tarren-mill,1343,druid,feral,30,14,16
6724,Chepochem,stormscale,1341,druid,feral,38,16,22
6725,Ефомитстерша,gordunni,1339,druid,feral,36,17,19
6726,Тёмныйзверь,borean-tundra,1339,druid,feral,54,20,34
6727,Snøwden,twisting-nether,1337,druid,feral,48,27,21
6728,Фейк,howling-fjord,1337,druid,feral,36,14,22
6729,Хэрес,gordunni,1336,druid,feral,24,14,10
6730,Vancis,ravencrest,1335,druid,feral,69,35,34
6731,Cheddar,tyrande,1332,druid,feral,46,22,24
6732,Криашин,goldrinn,1331,druid,feral,63,28,35
6733,Dijem,wildhammer,1329,druid,feral,66,39,27
6734,Mooncarnatio,burning-legion,1329,druid,feral,42,14,28
6735,Starliner,ravencrest,1326,druid,feral,36,14,22
6736,Шэйпшифт,fordragon,1326,druid,feral,42,16,26
6737,Quikahn,outland,1323,druid,feral,30,14,16
6738,Vanhelsíng,dun-modr,1322,druid,feral,22,15,7
6739,Turkus,draenor,1322,druid,feral,72,31,41
6740,Basedgôd,alakir,1321,druid,feral,24,14,10
6741,Chouan,marécage-de-zangar,1320,druid,feral,188,96,92
6742,Drupal,argent-dawn,1319,druid,feral,36,19,17
6743,Migajde,stormscale,1317,druid,feral,83,49,34
6744,Lukeyferalxo,argent-dawn,1317,druid,feral,162,75,87
6745,Балаклаваа,soulflayer,1316,druid,feral,29,18,11
6746,Erelae,twisting-nether,1316,druid,feral,33,16,17
6747,Hottad,tarren-mill,1313,druid,feral,132,72,60
6748,Медверх,gordunni,1313,druid,feral,54,24,30
6749,Enock,hyjal,1312,druid,feral,24,14,10
6750,Лякокля,soulflayer,1312,druid,feral,78,42,36
6751,Majokz,ravencrest,1307,druid,feral,44,23,21
6752,Regelè,sylvanas,1305,druid,feral,86,45,41
6753,Henessi,ragnaros,1302,druid,feral,30,14,16
6754,Droodae,hyjal,1301,druid,feral,53,27,26
6755,Nalaa,festung-der-stürme,1301,druid,feral,130,59,71
6756,Paws,dun-modr,1300,druid,feral,66,33,33
6757,Maylon,darksorrow,1294,druid,feral,48,23,25
6758,Liya,ravencrest,1292,druid,feral,48,15,33
6759,Kirmelastas,kazzak,1289,druid,feral,56,29,27
6760,Chinoiserie,aszune,1287,druid,feral,48,26,22
6761,Malfurryon,drakthul,1285,druid,feral,30,16,14
6762,Naetsch,blackrock,1285,druid,feral,47,20,27
6763,Carakal,outland,1284,druid,feral,53,24,29
6764,Weydjin,garona,1278,druid,feral,30,16,14
6765,Malfyurion,ragnaros,1276,druid,feral,114,57,57
6766,Ghettoven,kazzak,1275,druid,feral,66,30,36
6767,Stelthee,silvermoon,1274,druid,feral,60,27,33
6768,Symbiosîs,stormscale,1273,druid,feral,41,17,24
6769,Laguna,ravencrest,1271,druid,feral,41,14,27
6770,Jxst,tarren-mill,1270,druid,feral,48,19,29
6771,Йванныч,gordunni,1268,druid,feral,55,27,28
6772,Owling,antonidas,1262,druid,feral,78,46,32
6773,Jaxtn,tarren-mill,1259,druid,feral,46,24,22
6774,Koffee,archimonde,1259,druid,feral,48,23,25
6775,Беркамп,howling-fjord,1257,druid,feral,111,45,66
6776,Shinshìva,twisting-nether,1255,druid,feral,205,104,101
6777,Pepeja,doomhammer,1253,druid,feral,24,15,9
6778,Dougi,argent-dawn,1252,druid,feral,60,28,32
6779,Trusten,nemesis,1249,druid,feral,84,46,38
6780,Ведмедив,blackscar,1249,druid,feral,84,36,48
6781,Taigarus,aerie-peak,1246,druid,feral,72,34,38
6782,Benyameow,ravencrest,1245,druid,feral,18,13,5
6783,Loyoq,elune,1244,druid,feral,24,13,11
6784,Weedgras,eredar,1244,druid,feral,30,13,17
6785,Tussenfryd,draenor,1243,druid,feral,150,69,81
6786,Shifthappens,dun-modr,1242,druid,feral,24,13,11
6787,Tîma,blackmoore,1241,druid,feral,206,101,105
6788,Salseo,uldum,1239,druid,feral,33,14,19
6789,Развалустоев,blackscar,1237,druid,feral,24,13,11
6790,Cleandc,blackhand,1234,druid,feral,34,20,14
6791,Кеорл,gordunni,1234,druid,feral,102,43,59
6792,Soléda,thrall,1233,druid,feral,129,60,69
6793,Webla,blackmoore,1231,druid,feral,29,15,14
6794,Deviantdruid,tarren-mill,1231,druid,feral,39,20,19
6795,Bâbusch,blackmoore,1230,druid,feral,24,13,11
6796,Катяблум,gordunni,1230,druid,feral,30,13,17
6797,Shifabull,kazzak,1229,druid,feral,35,17,18
6798,Andros,arathor,1229,druid,feral,42,15,27
6799,Shaggery,stormscale,1227,druid,feral,93,39,54
6800,Ildrin,ragnaros,1226,druid,feral,30,19,11
6801,Whísperclaw,ravencrest,1226,druid,feral,41,21,20
6802,Dirtyfantasy,alakir,1225,druid,feral,54,31,23
6803,Yøløswag,naxxramas,1224,druid,feral,95,56,39
6804,Moonglade,deathwing,1220,druid,feral,33,14,19
6805,Jdogger,tarren-mill,1219,druid,feral,24,13,11
6806,Garfield,uldum,1218,druid,feral,41,21,20
6807,Ganjeez,kazzak,1218,druid,feral,30,13,17
6808,Tyldormeow,tarren-mill,1216,druid,feral,167,74,93
6809,Azmerloth,antonidas,1214,druid,feral,36,13,23
6810,Defløwer,aegwynn,1213,druid,feral,36,18,18
6811,Tàlented,aggra-português,1213,druid,feral,29,13,16
6812,Смизм,gordunni,1209,druid,feral,38,19,19
6813,Dudeimgodly,ravencrest,1205,druid,feral,42,13,29
6814,Kintax,drakthul,1201,druid,feral,81,44,37
6815,Bigscarycatx,ravencrest,1199,druid,feral,21,13,8
6816,Storslev,stormscale,1199,druid,feral,137,55,82
6817,Azenoir,ravencrest,1199,druid,feral,39,14,25
6818,Liionheart,khaz-modan,1198,druid,feral,60,29,31
6819,Devonshira,ravencrest,1198,druid,feral,36,14,22
6820,Богарт,soulflayer,1193,druid,feral,24,14,10
6821,Zeyne,ravencrest,1193,druid,feral,24,14,10
6822,Lorcàn,argent-dawn,1189,druid,feral,52,22,30
6823,Twyty,khaz-modan,1186,druid,feral,167,79,88
6824,Herten,tarren-mill,1185,druid,feral,30,13,17
6825,Snootxt,blackmoore,1185,druid,feral,54,23,31
6826,Millenia,darkmoon-faire,1183,druid,feral,127,64,63
6827,Nevercloneqt,argent-dawn,1181,druid,feral,29,13,16
6828,Gonco,blackrock,1173,druid,feral,70,30,40
6829,Naturalie,silvermoon,1172,druid,feral,60,19,41
6830,Tl,archimonde,1170,druid,feral,61,28,33
6831,Álex,anachronos,1169,druid,feral,36,16,20
6832,Kittasek,drakthul,1167,druid,feral,36,23,13
6833,Ivìs,nemesis,1160,druid,feral,90,38,52
6834,Nightfáll,tarren-mill,1157,druid,feral,36,13,23
6835,Howtonio,archimonde,1151,druid,feral,18,12,6
6836,Katzovic,kult-der-verdammten,1151,druid,feral,18,12,6
6837,Zbear,kazzak,1151,druid,feral,36,16,20
6838,Sùmmèrz,ravencrest,1150,druid,feral,24,12,12
6839,Fallken,burning-blade,1149,druid,feral,24,12,12
6840,Treeflogger,ravencrest,1149,druid,feral,96,42,54
6841,Arnwaald,kaelthas,1147,druid,feral,42,21,21
6842,Frs,bladefist,1147,druid,feral,30,12,18
6843,Trevorkki,korgall,1147,druid,feral,31,12,19
6844,Tibozx,stormscale,1146,druid,feral,36,21,15
6845,Mímír,frostmane,1145,druid,feral,24,12,12
6846,Ra,stormscale,1145,druid,feral,24,12,12
6847,Calîmerô,blackrock,1142,druid,feral,18,12,6
6848,Veryfast,blackhand,1142,druid,feral,24,12,12
6849,Jinxaran,culte-de-la-rive-noire,1135,druid,feral,36,12,24
6850,Tranduiil,drakthul,1131,druid,feral,96,56,40
6851,Käissi,blackmoore,1127,druid,feral,60,27,33
6852,Larkos,grim-batol,1126,druid,feral,30,15,15
6853,Кыцко,soulflayer,1124,druid,feral,24,12,12
6854,Naheliaqt,outland,1121,druid,feral,24,12,12
6855,Swagmode,draenor,1119,druid,feral,49,30,19
6856,Lemmí,frostwolf,1113,druid,feral,30,13,17
6857,Malvakten,kazzak,1112,druid,feral,25,13,12
6858,Jaghut,burning-legion,1109,druid,feral,18,12,6
6859,Kynji,twisting-nether,1109,druid,feral,66,28,38
6860,Bæghira,draenor,1106,druid,feral,88,49,39
6861,Moonpuff,kazzak,1103,druid,feral,45,22,23
6862,Papan,sylvanas,1100,druid,feral,66,34,32
6863,Mudpie,stormscale,1100,druid,feral,55,23,32
6864,Zivertgodx,argent-dawn,1093,druid,feral,48,23,25
6865,Nicos,elune,1091,druid,feral,29,13,16
6866,Tyranderawr,ravencrest,1090,druid,feral,33,13,20
6867,Vidlna,outland,1089,druid,feral,60,26,34
6868,Jamaican,outland,1089,druid,feral,48,20,28
6869,Shymä,hyjal,1088,druid,feral,91,35,56
6870,Йонарк,gordunni,1087,druid,feral,41,20,21
6871,Teacherr,quelthalas,1087,druid,feral,81,28,53
6872,Greengünter,blackmoore,1086,druid,feral,22,12,10
6873,Скагуар,blackscar,1084,druid,feral,68,25,43
6874,Rootznloots,draenor,1082,druid,feral,48,26,22
6875,Derzis,eonar,1081,druid,feral,66,32,34
6876,Feraligator,sanguino,1081,druid,feral,180,84,96
6877,Denadu,turalyon,1080,druid,feral,48,12,36
6878,Taatz,stormscale,1079,druid,feral,30,20,10
6879,Elenwyth,argent-dawn,1079,druid,feral,111,47,64
6880,Exortas,kazzak,1078,druid,feral,67,27,40
6881,Blacknight,aggramar,1073,druid,feral,39,13,26
6882,Blazor,eredar,1072,druid,feral,58,29,29
6883,Kageioshi,kazzak,1070,druid,feral,56,28,28
6884,Мукару,howling-fjord,1069,druid,feral,24,13,11
6885,Progodd,silvermoon,1064,druid,feral,72,35,37
6886,Асония,deathguard,1056,druid,feral,24,11,13
6887,Vahid,antonidas,1055,druid,feral,12,11,1
6888,Yhavi,kazzak,1055,druid,feral,26,12,14
6889,Notsad,dun-modr,1055,druid,feral,24,11,13
6890,Weyztwo,hyjal,1055,druid,feral,24,11,13
6891,Salviaf,silvermoon,1055,druid,feral,94,43,51
6892,Belsebub,ravencrest,1055,druid,feral,30,11,19
6893,Ashtral,kazzak,1054,druid,feral,24,11,13
6894,Starasta,magtheridon,1054,druid,feral,24,11,13
6895,Runeclaws,twisting-nether,1053,druid,feral,18,11,7
6896,Chexdruid,silvermoon,1053,druid,feral,27,12,15
6897,Togara,kazzak,1050,druid,feral,24,11,13
6898,Muffinjump,outland,1049,druid,feral,65,28,37
6899,Healníx,blackrock,1046,druid,feral,20,11,9
6900,Maethar,stormrage,1046,druid,feral,24,11,13
6901,Weedum,kazzak,1046,druid,feral,24,11,13
6902,Tsajj,stormreaver,1045,druid,feral,57,31,26
6903,Nightdruidcz,turalyon,1044,druid,feral,24,11,13
6904,Eprophet,stormscale,1041,druid,feral,36,11,25
6905,Zaltaruk,sanguino,1040,druid,feral,98,45,53
6906,Battleray,twisting-nether,1040,druid,feral,57,25,32
6907,Zokix,doomhammer,1040,druid,feral,30,12,18
6908,Mîyukí,ravencrest,1034,druid,feral,36,15,21
6909,Kermit,die-aldor,1032,druid,feral,81,32,49
6910,Élmunia,ravencrest,1030,druid,feral,36,19,17
6911,Tastyrawr,blackhand,1029,druid,feral,24,11,13
6912,Eternas,elune,1027,druid,feral,82,37,45
6913,Hetalia,culte-de-la-rive-noire,1025,druid,feral,24,13,11
6914,Morfâns,ragnaros,1024,druid,feral,49,23,26
6915,Amoonaa,kazzak,1020,druid,feral,54,28,26
6916,Cjparker,archimonde,1020,druid,feral,26,12,14
6917,Hönör,ysondre,1016,druid,feral,183,87,96
6918,Арвелл,gordunni,1014,druid,feral,24,11,13
6919,Boombassador,stormscale,1012,druid,feral,36,20,16
6920,Phanterus,chamber-of-aspects,1012,druid,feral,24,11,13
6921,Carldroid,sylvanas,1009,druid,feral,28,13,15
6922,Tatabomba,archimonde,1008,druid,feral,60,30,30
6923,Брэмблс,soulflayer,1008,druid,feral,35,15,20
6924,Kyoshî,blackmoore,1007,druid,feral,136,64,72
6925,Mpounia,twilights-hammer,1006,druid,feral,89,45,44
6926,Ripndip,eredar,1006,druid,feral,94,45,49
6927,Smittly,bloodhoof,1005,druid,feral,58,23,35
6928,Chlambak,archimonde,1004,druid,feral,24,14,10
6929,Канвус,gordunni,1003,druid,feral,28,11,17
6930,Savvy,arthas,1003,druid,feral,30,11,19
6931,Фаллендэл,gordunni,1001,druid,feral,30,17,13
6932,Clawdiá,silvermoon,995,druid,feral,60,28,32
6933,Terror,agamaggan,983,druid,feral,36,12,24
6934,Спэкк,gordunni,983,druid,feral,48,15,33
6935,Rakuy,thrall,981,druid,feral,27,11,16
6936,Arntooth,burning-legion,978,druid,feral,42,17,25
6937,Janjalism,silvermoon,973,druid,feral,63,34,29
6938,Descendance,ysondre,968,druid,feral,85,42,43
6939,Klatro,terokkar,965,druid,feral,24,13,11
6940,Tjxaxa,ravencrest,960,druid,feral,12,10,2
6941,Ryseqt,nemesis,960,druid,feral,12,10,2
6942,Shylovez,aegwynn,960,druid,feral,18,10,8
6943,Møonknight,ravencrest,960,druid,feral,18,10,8
6944,Nîghtz,ravencrest,960,druid,feral,18,10,8
6945,Cyborgz,archimonde,960,druid,feral,18,10,8
6946,Flufie,alexstrasza,960,druid,feral,18,10,8
6947,Druiidou,dalaran,960,druid,feral,30,10,20
6948,Goodtrip,hyjal,959,druid,feral,18,10,8
6949,Suggly,ysondre,959,druid,feral,18,10,8
6950,Жекакотик,eversong,959,druid,feral,42,21,21
6951,Beerista,tarren-mill,959,druid,feral,24,11,13
6952,Hahafun,ravencrest,959,druid,feral,24,10,14
6953,Luphrekfurry,ysondre,959,druid,feral,24,10,14
6954,Dipz,frostwolf,958,druid,feral,18,10,8
6955,Cyph,shadowsong,958,druid,feral,18,10,8
6956,Nîchtsnutz,blackmoore,958,druid,feral,18,10,8
6957,Lenzork,thrall,958,druid,feral,24,10,14
6958,Carridwyn,argent-dawn,958,druid,feral,24,10,14
6959,Phandris,argent-dawn,957,druid,feral,91,48,43
6960,Zjukov,ragnaros,955,druid,feral,24,10,14
6961,Corrupthz,outland,955,druid,feral,24,10,14
6962,Pointlez,frostmane,954,druid,feral,24,10,14
6963,Thecòntról,ravencrest,953,druid,feral,18,10,8
6964,Шонгу,soulflayer,953,druid,feral,24,10,14
6965,Ивантяй,gordunni,949,druid,feral,18,10,8
6966,Друлевой,greymane,948,druid,feral,24,12,12
6967,Lutis,magtheridon,947,druid,feral,72,28,44
6968,Ультраафина,gordunni,946,druid,feral,24,10,14
6969,Inuah,veknilash,946,druid,feral,34,12,22
6970,Collnaris,ravencrest,944,druid,feral,18,10,8
6971,Реептилоид,soulflayer,942,druid,feral,24,10,14
6972,Wuzzington,outland,940,druid,feral,24,10,14
6973,Zhabka,silvermoon,939,druid,feral,45,24,21
6974,Hadesx,blackhand,933,druid,feral,48,23,25
6975,Stéely,ravencrest,933,druid,feral,30,14,16
6976,Sorron,blades-edge,926,druid,feral,36,19,17
6977,Маветт,blackscar,925,druid,feral,63,29,34
6978,Mordpaw,stormscale,925,druid,feral,26,11,15
6979,Trikill,hyjal,922,druid,feral,31,10,21
6980,Mistic,twisting-nether,918,druid,feral,25,12,13
6981,Teddîursa,kazzak,915,druid,feral,34,10,24
6982,Blacksagex,dragonmaw,910,druid,feral,17,10,7
6983,Gató,kazzak,899,druid,feral,32,11,21
6984,Lohki,eredar,895,druid,feral,21,12,9
6985,Леминвинкс,eversong,889,druid,feral,24,13,11
6986,Джирас,gordunni,883,druid,feral,38,14,24
6987,Verbat,cthun,878,druid,feral,42,21,21
6988,Mommonga,onyxia,874,druid,feral,38,14,24
6989,Nkoyi,argent-dawn,872,druid,feral,30,10,20
6990,Béar,arathor,871,druid,feral,64,22,42
6991,Maräanhatähr,silvermoon,869,druid,feral,36,10,26
6992,Maaghera,silvermoon,867,druid,feral,92,40,52
6993,Wex,darksorrow,864,druid,feral,12,9,3
6994,Urfi,tyrande,864,druid,feral,12,9,3
6995,Fuzzylol,haomarush,864,druid,feral,18,9,9
6996,Paramore,outland,864,druid,feral,18,9,9
6997,Cocomojo,outland,864,druid,feral,18,9,9
6998,Furrykruger,the-maelstrom,864,druid,feral,18,9,9
6999,Aleatório,grim-batol,864,druid,feral,18,9,9
7000,Rysejr,nemesis,864,druid,feral,18,9,9
7001,Fyrka,aegwynn,864,druid,feral,18,9,9
7002,Roska,archimonde,864,druid,feral,18,9,9
7003,Sixmonthbann,ravencrest,864,druid,feral,18,9,9
7004,Pitý,kaelthas,864,druid,feral,24,9,15
7005,Bikiniwochen,antonidas,863,druid,feral,18,9,9
7006,Xilmai,darksorrow,863,druid,feral,18,9,9
7007,Mònókox,eredar,863,druid,feral,18,9,9
7008,Rbg,dun-modr,863,druid,feral,22,10,12
7009,Aendy,tarren-mill,863,druid,feral,23,10,13
7010,Àzà,dun-modr,863,druid,feral,21,9,12
7011,Пиггипоп,soulflayer,863,druid,feral,24,9,15
7012,Sethread,ragnaros,863,druid,feral,24,9,15
7013,Олежасутра,howling-fjord,863,druid,feral,30,9,21
7014,Aggoth,drakthul,862,druid,feral,12,9,3
7015,Мунфайр,galakrond,862,druid,feral,18,9,9
7016,Dilleydank,ravencrest,862,druid,feral,18,9,9
7017,Кецян,gordunni,862,druid,feral,19,9,10
7018,Эверблуми,howling-fjord,862,druid,feral,30,9,21
7019,Exïlla,archimonde,861,druid,feral,18,9,9
7020,Буйныйкот,gordunni,861,druid,feral,24,9,15
7021,Bäkø,dun-modr,861,druid,feral,27,10,17
7022,Caèlas,outland,859,druid,feral,18,9,9
7023,Minaye,hyjal,859,druid,feral,18,9,9
7024,Nalreaa,kazzak,859,druid,feral,18,9,9
7025,Golddy,hyjal,859,druid,feral,19,9,10
7026,Cøcøpøpsmøke,archimonde,859,druid,feral,30,12,18
7027,Hadespool,sanguino,859,druid,feral,24,9,15
7028,Бруан,gordunni,859,druid,feral,24,9,15
7029,Плагиат,grom,858,druid,feral,36,10,26
7030,Wathen,argent-dawn,857,druid,feral,34,12,22
7031,Toaa,antonidas,857,druid,feral,30,9,21
7032,Астраджет,gordunni,856,druid,feral,12,9,3
7033,Aniprimal,auchindoun,854,druid,feral,18,9,9
7034,Noyake,ragnaros,854,druid,feral,24,9,15
7035,Wainl,hyjal,854,druid,feral,30,9,21
7036,Bgam,ravencrest,853,druid,feral,12,9,3
7037,Isaye,archimonde,850,druid,feral,88,31,57
7038,Plingan,argent-dawn,847,druid,feral,17,9,8
7039,Rellena,khaz-modan,847,druid,feral,27,12,15
7040,Frökensuss,stormscale,844,druid,feral,27,12,15
7041,Ziovris,silvermoon,839,druid,feral,33,9,24
7042,Miukïna,archimonde,837,druid,feral,12,9,3
7043,Kîñg,tarren-mill,836,druid,feral,76,33,43
7044,Рефикс,gordunni,827,druid,feral,17,9,8
7045,Théó,grim-batol,818,druid,feral,41,18,23
7046,Snupy,outland,815,druid,feral,17,9,8
7047,Зенза,howling-fjord,815,druid,feral,27,9,18
7048,Saltow,archimonde,797,druid,feral,52,14,38
7049,Domänia,onyxia,779,druid,feral,25,9,16
7050,Snkxo,perenolde,768,druid,feral,12,8,4
7051,Kgn,blackmoore,768,druid,feral,12,8,4
7052,Mikor,aegwynn,768,druid,feral,12,8,4
7053,Hakuchey,aegwynn,768,druid,feral,12,8,4
7054,Kattenover,stormscale,768,druid,feral,12,8,4
7055,Garoh,dalaran,768,druid,feral,18,8,10
7056,Апвель,gordunni,768,druid,feral,18,8,10
7057,Sølaria,kazzak,768,druid,feral,18,8,10
7058,Älênkâ,drakthul,768,druid,feral,30,8,22
7059,Svxstarz,archimonde,768,druid,feral,30,8,22
7060,Kørnuto,nemesis,767,druid,feral,12,8,4
7061,Firrothe,die-aldor,767,druid,feral,15,9,6
7062,Jeezuschrist,archimonde,767,druid,feral,18,8,10
7063,Стэлларпауэр,gordunni,767,druid,feral,18,8,10
7064,Seysso,silvermoon,767,druid,feral,18,8,10
7065,Mimir,la-croisade-écarlate,767,druid,feral,18,8,10
7066,Pneuma,xavius,767,druid,feral,24,8,16
7067,Laek,chogall,767,druid,feral,24,8,16
7068,Acéré,archimonde,767,druid,feral,24,8,16
7069,Psychodeliya,ragnaros,767,druid,feral,36,8,28
7070,Kutjing,dun-modr,766,druid,feral,12,8,4
7071,Hecky,xavius,766,druid,feral,12,8,4
7072,Thielyy,blackmoore,766,druid,feral,18,8,10
7073,Annksunamun,ysondre,766,druid,feral,24,8,16
7074,Dracaan,boulderfist,765,druid,feral,12,8,4
7075,Krvopito,tarren-mill,765,druid,feral,12,8,4
7076,Koshde,blackrock,765,druid,feral,18,8,10
7077,Chunkeykill,alonsus,765,druid,feral,18,8,10
7078,Plankface,ravencrest,765,druid,feral,18,8,10
7079,Шадараф,howling-fjord,765,druid,feral,21,9,12
7080,Vorag,dalaran,765,druid,feral,24,8,16
7081,Oblivark,draenor,764,druid,feral,18,8,10
7082,Bâlou,nathrezim,764,druid,feral,18,8,10
7083,Lukass,drakthul,764,druid,feral,18,8,10
7084,Djsnigel,stormscale,764,druid,feral,24,8,16
7085,Levila,defias-brotherhood,763,druid,feral,12,8,4
7086,Shuffey,frostmane,763,druid,feral,12,8,4
7087,Dash,the-maelstrom,763,druid,feral,18,8,10
7088,Düldül,kargath,762,druid,feral,85,33,52
7089,Holditorsken,grim-batol,761,druid,feral,18,8,10
7090,Razorleaf,turalyon,761,druid,feral,24,8,16
7091,Tombenuit,tarren-mill,757,druid,feral,18,8,10
7092,Druidou,kaelthas,756,druid,feral,30,8,22
7093,Jupter,burning-blade,755,druid,feral,18,8,10
7094,Khai,argent-dawn,748,druid,feral,24,8,16
7095,Neischa,das-konsortium,746,druid,feral,18,8,10
7096,Âltashamane,elune,733,druid,feral,17,8,9
7097,Ytzù,archimonde,719,druid,feral,11,8,3
7098,Aègon,ravencrest,719,druid,feral,15,8,7
7099,Cyriaan,eredar,719,druid,feral,17,8,9
7100,Greenfingerz,azjolnerub,712,druid,feral,30,8,22
7101,Zaibiendormi,kirin-tor,706,druid,feral,25,8,17
7102,Euskal,chogall,703,druid,feral,14,8,6
7103,Asarune,hyjal,703,druid,feral,20,9,11
7104,Xarxius,sanguino,699,druid,feral,32,8,24
7105,Necorine,silvermoon,672,druid,feral,12,7,5
7106,Lolhaha,ravencrest,672,druid,feral,12,7,5
7107,Симбиозный,howling-fjord,672,druid,feral,12,7,5
7108,Диздру,howling-fjord,672,druid,feral,12,7,5
7109,Cruelbunny,nemesis,672,druid,feral,12,7,5
7110,Jincksdruid,anachronos,672,druid,feral,12,7,5
7111,Snkyferalmov,aegwynn,672,druid,feral,12,7,5
7112,Goretterog,archimonde,672,druid,feral,12,7,5
7113,Fíja,blackmoore,672,druid,feral,12,7,5
7114,Zoobidu,garona,672,druid,feral,12,7,5
7115,Tanmax,blackmoore,672,druid,feral,12,7,5
7116,Moderntalkin,aegwynn,672,druid,feral,23,10,13
7117,Luveena,kazzak,672,druid,feral,18,7,11
7118,Oni,kelthuzad,672,druid,feral,18,7,11
7119,Flawkin,kazzak,672,druid,feral,18,7,11
7120,Coldkíng,twisting-nether,672,druid,feral,18,7,11
7121,Bearmeister,kazzak,672,druid,feral,18,7,11
7122,Samian,turalyon,672,druid,feral,18,7,11
7123,Saabeq,hyjal,672,druid,feral,18,7,11
7124,Колайна,gordunni,672,druid,feral,18,7,11
7125,Marshy,kazzak,672,druid,feral,20,7,13
7126,Liptonbite,blackhand,672,druid,feral,24,7,17
7127,Zulucat,aegwynn,672,druid,feral,24,7,17
7128,Sôalôgel,blackrock,671,druid,feral,12,7,5
7129,Druikraut,silvermoon,671,druid,feral,12,7,5
7130,Déme,twisting-nether,671,druid,feral,12,7,5
7131,Мехнакиске,howling-fjord,671,druid,feral,16,7,9
7132,Sheradel,argent-dawn,671,druid,feral,18,7,11
7133,Eltroncazo,sanguino,671,druid,feral,18,7,11
7134,Miracoplixx,blackrock,671,druid,feral,18,7,11
7135,Toron,dalaran,671,druid,feral,18,7,11
7136,Speedlebee,malganis,671,druid,feral,18,7,11
7137,Bærbell,blackrock,671,druid,feral,18,7,11
7138,Lazerbinks,blackmoore,671,druid,feral,24,7,17
7139,Axiu,kazzak,671,druid,feral,24,7,17
7140,Noobbiiee,silvermoon,670,druid,feral,12,7,5
7141,Biorythm,draenor,670,druid,feral,12,7,5
7142,Toredorxy,blackrock,669,druid,feral,12,7,5
7143,Radime,khaz-modan,669,druid,feral,12,7,5
7144,Iloveadriana,kiljaeden,669,druid,feral,18,7,11
7145,Терамин,howling-fjord,669,druid,feral,18,7,11
7146,Stoormrage,deathwing,668,druid,feral,12,7,5
7147,Itzferal,durotan,668,druid,feral,15,7,8
7148,Грэкхэк,soulflayer,666,druid,feral,15,8,7
7149,Tricklou,tarren-mill,666,druid,feral,18,7,11
7150,Sherkàn,dalaran,661,druid,feral,18,7,11
7151,Zulazain,bladefist,659,druid,feral,86,31,55
7152,Blejkv,defias-brotherhood,658,druid,feral,18,7,11
7153,Ôpium,eldrethalas,658,druid,feral,24,7,17
7154,Kovlian,argent-dawn,655,druid,feral,17,7,10
7155,Эвгедент,deathguard,646,druid,feral,30,7,23
7156,Drujdjel,die-todeskrallen,641,druid,feral,17,7,10
7157,Dooferdudu,azshara,640,druid,feral,21,7,14
7158,Nspirit,ravencrest,639,druid,feral,17,7,10
7159,Sìa,frostmane,639,druid,feral,23,7,16
7160,Juraci,forscherliga,623,druid,feral,11,7,4
7161,Лорирэнд,gordunni,623,druid,feral,23,7,16
7162,Shalys,archimonde,622,druid,feral,11,7,4
7163,Хённим,howling-fjord,607,druid,feral,11,7,4
7164,Àyóorts,archimonde,607,druid,feral,14,7,7
7165,Halabanaha,silvermoon,606,druid,feral,11,7,4
7166,Hadoukan,ravencrest,576,druid,feral,6,6,0
7167,Darkcon,silvermoon,576,druid,feral,6,6,0
7168,Hàlunkè,eredar,576,druid,feral,12,6,6
7169,Эриэс,gordunni,576,druid,feral,12,6,6
7170,Kittý,terokkar,576,druid,feral,12,6,6
7171,Biggestnick,ravencrest,576,druid,feral,12,6,6
7172,Amandial,silvermoon,576,druid,feral,12,6,6
7173,Druiderex,outland,576,druid,feral,12,6,6
7174,Seekx,silvermoon,576,druid,feral,12,6,6
7175,Madeath,stormscale,576,druid,feral,12,6,6
7176,Forrest,bronze-dragonflight,576,druid,feral,12,6,6
7177,Borja,malganis,576,druid,feral,12,6,6
7178,Dragonferal,tarren-mill,576,druid,feral,12,6,6
7179,Aslanah,hyjal,576,druid,feral,12,6,6
7180,Rimpularaisa,grim-batol,576,druid,feral,12,6,6
7181,Arlandia,drakthul,576,druid,feral,12,6,6
7182,Сиэн,ashenvale,576,druid,feral,12,6,6
7183,Snkyexpress,aegwynn,576,druid,feral,12,6,6
7184,Migalo,outland,576,druid,feral,12,6,6
7185,Ataxyhehe,sylvanas,576,druid,feral,12,6,6
7186,Asoli,aegwynn,576,druid,feral,12,6,6
7187,Мцк,deathguard,576,druid,feral,12,6,6
7188,Imbadxx,kazzak,576,druid,feral,12,6,6
7189,Mikecat,aegwynn,576,druid,feral,12,6,6
7190,Шйшка,gordunni,576,druid,feral,12,6,6
7191,Tonycatmeow,ravencrest,576,druid,feral,12,6,6
7192,Baccthana,auchindoun,576,druid,feral,12,6,6
7193,Sumecx,aegwynn,576,druid,feral,12,6,6
7194,Imsothorny,genjuros,576,druid,feral,18,6,12
7195,Bilis,nazjatar,576,druid,feral,18,6,12
7196,Хокан,deepholm,576,druid,feral,18,6,12
7197,Hasted,kazzak,576,druid,feral,18,6,12
7198,Niknikola,silvermoon,576,druid,feral,18,6,12
7199,Svass,ragnaros,576,druid,feral,18,6,12
7200,Radauronny,malganis,576,druid,feral,18,6,12
7201,Fur,antonidas,576,druid,feral,23,6,17
7202,Трясишатай,gordunni,576,druid,feral,24,6,18
7203,Teknó,ragnaros,575,druid,feral,6,6,0
7204,Леромейкен,fordragon,575,druid,feral,12,6,6
7205,Broccoliform,eredar,575,druid,feral,12,6,6
7206,Leidbulle,blackrock,575,druid,feral,12,6,6
7207,Psixx,blackhand,575,druid,feral,12,6,6
7208,Xurta,kazzak,575,druid,feral,12,6,6
7209,Lakaport,dun-modr,575,druid,feral,12,6,6
7210,Chrîslol,twisting-nether,575,druid,feral,18,6,12
7211,Скайтибрайдх,gordunni,575,druid,feral,24,6,18
7212,Docdruid,outland,575,druid,feral,24,6,18
7213,Мендея,gordunni,574,druid,feral,12,6,6
7214,Kratzbeiß,blackmoore,574,druid,feral,24,6,18
7215,Almightydudu,draenor,573,druid,feral,18,6,12
7216,Alimona,the-venture-co,573,druid,feral,30,6,24
7217,Taco,eredar,573,druid,feral,33,6,27
7218,Harryharrt,veknilash,572,druid,feral,12,6,6
7219,Avior,eonar,571,druid,feral,12,6,6
7220,Грегориан,galakrond,571,druid,feral,12,6,6
7221,Annajak,bloodfeather,570,druid,feral,12,6,6
7222,Элинна,ashenvale,570,druid,feral,18,6,12
7223,Горртек,howling-fjord,569,druid,feral,18,6,12
7224,Sìíta,dun-modr,568,druid,feral,24,6,18
7225,Glanis,malorne,558,druid,feral,17,6,11
7226,Whiterun,pozzo-delleternità,555,druid,feral,19,7,12
7227,Spangle,stormscale,554,druid,feral,21,7,14
7228,Agè,stormscale,544,druid,feral,16,6,10
7229,Shapeshifts,kul-tiras,543,druid,feral,11,6,5
7230,Неваляка,gordunni,542,druid,feral,11,6,5
7231,Диджейкошка,howling-fjord,527,druid,feral,11,6,5
7232,Nuashoa,argent-dawn,521,druid,feral,16,7,9
7233,Lionquokk,azjolnerub,512,druid,feral,10,6,4
7234,Amuini,draenor,511,druid,feral,14,6,8
7235,Ryselol,nemesis,480,druid,feral,6,5,1
7236,Slaaya,ravencrest,480,druid,feral,6,5,1
7237,Shanikya,argent-dawn,480,druid,feral,6,5,1
7238,Drach,ravencrest,480,druid,feral,6,5,1
7239,Vârima,ravencrest,480,druid,feral,6,5,1
7240,Synzuu,turalyon,480,druid,feral,10,6,4
7241,Xunjeral,blackhand,480,druid,feral,12,7,5
7242,Einsfünfkcat,madmortem,480,druid,feral,12,5,7
7243,Sketz,stormscale,480,druid,feral,12,5,7
7244,Iproxy,dalaran,480,druid,feral,12,5,7
7245,Rímeru,blackmoore,480,druid,feral,12,5,7
7246,Deßradator,stormscale,480,druid,feral,12,5,7
7247,Siire,ravencrest,480,druid,feral,12,5,7
7248,Loryaayroll,stormscale,480,druid,feral,12,5,7
7249,Hrabioid,burning-legion,480,druid,feral,12,5,7
7250,Redlung,outland,480,druid,feral,12,5,7
7251,Rapzr,argent-dawn,480,druid,feral,12,5,7
7252,Жеводанский,gordunni,480,druid,feral,12,5,7
7253,Bloomly,tarren-mill,480,druid,feral,12,5,7
7254,Hipølita,zuljin,480,druid,feral,12,5,7
7255,Flum,darksorrow,480,druid,feral,12,5,7
7256,Guiltyas,turalyon,480,druid,feral,12,5,7
7257,Оссава,blackscar,480,druid,feral,12,5,7
7258,Hardbasior,burning-legion,480,druid,feral,12,5,7
7259,Pronkson,tarren-mill,480,druid,feral,12,5,7
7260,West,drakthul,480,druid,feral,12,5,7
7261,Vãrima,ravencrest,480,druid,feral,12,5,7
7262,Erenalby,draenor,480,druid,feral,12,5,7
7263,Animålz,archimonde,480,druid,feral,12,5,7
7264,Epidruid,stormrage,480,druid,feral,12,5,7
7265,Falbâlas,hyjal,480,druid,feral,12,5,7
7266,Mooqt,alexstrasza,480,druid,feral,12,5,7
7267,Kardashìan,ravencrest,480,druid,feral,13,5,8
7268,Nariah,silvermoon,480,druid,feral,15,5,10
7269,Mérias,archimonde,480,druid,feral,18,5,13
7270,Линнер,lich-king,480,druid,feral,18,5,13
7271,Enylasi,hyjal,480,druid,feral,18,5,13
7272,Outtanowhere,drakthul,480,druid,feral,18,5,13
7273,Nefertiti,baelgun,480,druid,feral,18,5,13
7274,Derrezzed,stormscale,480,druid,feral,18,5,13
7275,Yamkar,blackrock,480,druid,feral,18,5,13
7276,Tskilli,draenor,480,druid,feral,18,5,13
7277,Yiradur,stormscale,480,druid,feral,18,5,13
7278,Wølveríne,frostmane,480,druid,feral,18,5,13
7279,Pethebär,tarren-mill,480,druid,feral,18,5,13
7280,Cdsxr,outland,480,druid,feral,24,5,19
7281,Morsee,hellfire,479,druid,feral,12,5,7
7282,Poskehh,outland,479,druid,feral,12,5,7
7283,Shifts,the-maelstrom,479,druid,feral,12,5,7
7284,Astlanes,ysondre,479,druid,feral,12,5,7
7285,Telpha,onyxia,479,druid,feral,12,5,7
7286,Mambalol,sanguino,479,druid,feral,12,5,7
7287,Dorcelvision,archimonde,479,druid,feral,12,5,7
7288,Менстряк,howling-fjord,479,druid,feral,18,5,13
7289,Фэк,eversong,479,druid,feral,18,5,13
7290,Plandros,draenor,479,druid,feral,24,5,19
7291,Yorashi,blackhand,478,druid,feral,6,5,1
7292,Эндердру,gordunni,478,druid,feral,12,5,7
7293,Jooriell,defias-brotherhood,477,druid,feral,6,5,1
7294,Cattastrophe,bronzebeard,477,druid,feral,12,5,7
7295,Mitomen,ragnaros,476,druid,feral,12,5,7
7296,Skylarr,alexstrasza,475,druid,feral,12,5,7
7297,Bumsbert,teldrassil,472,druid,feral,18,9,9
7298,Cosiris,elune,469,druid,feral,18,5,13
7299,Varø,aegwynn,463,druid,feral,11,5,6
7300,Jamera,stormscale,463,druid,feral,17,5,12
7301,Nuada,skullcrusher,462,druid,feral,11,5,6
7302,Nefariz,dun-modr,448,druid,feral,10,5,5
7303,Apetino,dun-modr,447,druid,feral,11,5,6
7304,Infêrno,twisting-nether,446,druid,feral,22,5,17
7305,Овналь,gordunni,431,druid,feral,11,5,6
7306,Sároman,ravencrest,431,druid,feral,11,5,6
7307,Гимодера,gordunni,431,druid,feral,11,5,6
7308,Zynmeow,lordaeron,416,druid,feral,19,6,13
7309,Бабакошка,gordunni,415,druid,feral,11,5,6
7310,Nipply,ravencrest,415,druid,feral,15,6,9
7311,Svarre,outland,413,druid,feral,10,5,5
7312,Staness,khaz-modan,413,druid,feral,32,5,27
7313,Furiol,darksorrow,384,druid,feral,6,4,2
7314,Коксвейн,ashenvale,384,druid,feral,6,4,2
7315,Gyome,sargeras,384,druid,feral,6,4,2
7316,Крофтт,goldrinn,384,druid,feral,6,4,2
7317,Шабашиоргия,soulflayer,384,druid,feral,6,4,2
7318,Faveyo,die-nachtwache,384,druid,feral,6,4,2
7319,Chpochm,stormscale,384,druid,feral,6,4,2
7320,Nøwørnever,ulduar,384,druid,feral,6,4,2
7321,Idraly,kirin-tor,384,druid,feral,6,4,2
7322,Noxxzar,stormscale,384,druid,feral,6,4,2
7323,Ryáanz,ravencrest,384,druid,feral,6,4,2
7324,Takamizy,ysondre,384,druid,feral,6,4,2
7325,Kkriss,stormscale,384,druid,feral,6,4,2
7326,Ábomínatíon,draenor,384,druid,feral,6,4,2
7327,Osaviciosa,shendralar,384,druid,feral,6,4,2
7328,Tróllinger,blackrock,384,druid,feral,6,4,2
7329,Improved,hyjal,384,druid,feral,6,4,2
7330,Aliyxo,aegwynn,384,druid,feral,6,4,2
7331,Knatch,outland,384,druid,feral,6,4,2
7332,Dystaleon,blackrock,384,druid,feral,6,4,2
7333,Currare,aegwynn,384,druid,feral,6,4,2
7334,Pegert,aegwynn,384,druid,feral,6,4,2
7335,Kowtuerz,silvermoon,384,druid,feral,6,4,2
7336,Akifumi,archimonde,384,druid,feral,6,4,2
7337,Righttwix,blackrock,384,druid,feral,6,4,2
7338,Dèxò,blackmoore,384,druid,feral,17,7,10
7339,Goatmeal,draenor,384,druid,feral,12,4,8
7340,Helltoothz,ragnaros,384,druid,feral,12,4,8
7341,Tropicqt,ravencrest,384,druid,feral,12,4,8
7342,Giaya,turalyon,384,druid,feral,12,4,8
7343,Ociroza,outland,384,druid,feral,12,4,8
7344,Shiotake,hyjal,384,druid,feral,12,4,8
7345,Deranion,drakthul,384,druid,feral,12,4,8
7346,ßlackßåmßå,zuljin,384,druid,feral,12,4,8
7347,Турбокалясик,gordunni,384,druid,feral,12,4,8
7348,Tenader,draenor,384,druid,feral,12,4,8
7349,Рэво,gordunni,384,druid,feral,12,4,8
7350,Derni,burning-legion,384,druid,feral,12,4,8
7351,Vitaex,blackrock,384,druid,feral,12,4,8
7352,Milkniatrump,tarren-mill,384,druid,feral,12,4,8
7353,Noxxll,gorgonnash,384,druid,feral,12,4,8
7354,Valkeryu,hyjal,384,druid,feral,12,4,8
7355,Skinnyleg,baelgun,384,druid,feral,12,4,8
7356,Ялория,azuregos,384,druid,feral,12,4,8
7357,Éxy,kazzak,384,druid,feral,12,4,8
7358,Nibbl,doomhammer,384,druid,feral,12,4,8
7359,Risibisi,blackmoore,384,druid,feral,12,4,8
7360,Фдру,eversong,384,druid,feral,12,4,8
7361,Алендор,deathguard,384,druid,feral,12,4,8
7362,Gruffeline,marécage-de-zangar,384,druid,feral,12,4,8
7363,Mbk,kazzak,384,druid,feral,12,4,8
7364,Lupa,drakthul,384,druid,feral,18,4,14
7365,Bullhoezerx,silvermoon,384,druid,feral,18,4,14
7366,Nidaalee,thrall,383,druid,feral,6,4,2
7367,Bearshift,aggra-português,383,druid,feral,6,4,2
7368,Tsukuyómi,ragnaros,383,druid,feral,6,4,2
7369,Afta,ysondre,383,druid,feral,6,4,2
7370,Hartzig,blackmoore,383,druid,feral,6,4,2
7371,Asterya,dun-modr,383,druid,feral,10,5,5
7372,Murraywolf,dun-modr,383,druid,feral,12,4,8
7373,Loafy,the-maelstrom,383,druid,feral,12,4,8
7374,Whizkazz,ravencrest,383,druid,feral,12,4,8
7375,Fòggie,silvermoon,383,druid,feral,12,4,8
7376,Tettsu,silvermoon,383,druid,feral,12,4,8
7377,Sheiheda,kazzak,383,druid,feral,18,4,14
7378,Vanarea,argent-dawn,383,druid,feral,18,4,14
7379,Altramuz,uldum,382,druid,feral,6,4,2
7380,Fiagard,antonidas,382,druid,feral,6,4,2
7381,Jamaicanherb,bronzebeard,382,druid,feral,12,4,8
7382,Hasdruida,zuljin,382,druid,feral,14,4,10
7383,Viølin,silvermoon,381,druid,feral,12,4,8
7384,Yopi,stormscale,351,druid,feral,11,4,7
7385,Nèxtløls,twisting-nether,336,druid,feral,9,5,4
7386,Fyralion,silvermoon,335,druid,feral,9,4,5
7387,Krekigaadzre,draenor,335,druid,feral,9,4,5
7388,Dawodz,archimonde,330,druid,feral,8,5,3
7389,Wintx,ragnaros,329,druid,feral,24,7,17
7390,Rixdudu,silvermoon,319,druid,feral,5,4,1
7391,Lybell,antonidas,319,druid,feral,8,4,4
7392,Амахасла,deathweaver,288,druid,feral,6,3,3
7393,Beckett,aszune,288,druid,feral,6,3,3
7394,Fraptal,dalaran,288,druid,feral,6,3,3
7395,Melondru,dun-modr,288,druid,feral,6,3,3
7396,Ferpylul,ragnaros,288,druid,feral,6,3,3
7397,Syniixmeow,ravencrest,288,druid,feral,6,3,3
7398,Жексоул,gordunni,288,druid,feral,6,3,3
7399,Millya,sargeras,288,druid,feral,6,3,3
7400,Xercàs,outland,288,druid,feral,6,3,3
7401,Kømo,draenor,288,druid,feral,6,3,3
7402,Kúùsh,frostwolf,288,druid,feral,6,3,3
7403,Wildthing,blackmoore,288,druid,feral,6,3,3
7404,Quentalius,argent-dawn,288,druid,feral,6,3,3
7405,Madgazfanboi,ravencrest,288,druid,feral,6,3,3
7406,Ðeathwatch,ravencrest,288,druid,feral,6,3,3
7407,Oddform,silvermoon,288,druid,feral,6,3,3
7408,Gargnda,tarren-mill,288,druid,feral,6,3,3
7409,Kørn,drakthul,288,druid,feral,6,3,3
7410,Кошикк,azuregos,288,druid,feral,6,3,3
7411,Павлорион,gordunni,288,druid,feral,6,3,3
7412,Fearthecat,defias-brotherhood,288,druid,feral,6,3,3
7413,Lyrasanna,argent-dawn,288,druid,feral,6,3,3
7414,Мивинчик,ashenvale,288,druid,feral,6,3,3
7415,Sylvy,dun-modr,288,druid,feral,6,3,3
7416,Zusaria,azshara,288,druid,feral,6,3,3
7417,Urgrull,baelgun,288,druid,feral,6,3,3
7418,Lunanikuya,ravencrest,288,druid,feral,6,3,3
7419,Hundavidsad,quelthalas,288,druid,feral,6,3,3
7420,Mäffu,silvermoon,288,druid,feral,6,3,3
7421,Ацкийдру,gordunni,288,druid,feral,6,3,3
7422,Cacatus,tarren-mill,288,druid,feral,6,3,3
7423,Reservebär,blackhand,288,druid,feral,6,3,3
7424,Snky,perenolde,288,druid,feral,6,3,3
7425,Payday,darksorrow,288,druid,feral,6,3,3
7426,Alkurosa,sylvanas,288,druid,feral,6,3,3
7427,Shirí,hyjal,288,druid,feral,6,3,3
7428,Miruush,malganis,288,druid,feral,6,3,3
7429,Liony,aegwynn,288,druid,feral,6,3,3
7430,Yepnesse,khaz-modan,288,druid,feral,6,3,3
7431,Theonlydruid,frostmane,288,druid,feral,6,3,3
7432,Druidicchi,stormscale,288,druid,feral,6,3,3
7433,Dianabigby,silvermoon,288,druid,feral,6,3,3
7434,Feign,blackmoore,288,druid,feral,6,3,3
7435,Muffler,ragnaros,288,druid,feral,6,3,3
7436,Ysomnia,tirion,288,druid,feral,6,3,3
7437,Zantill,chamber-of-aspects,288,druid,feral,7,3,4
7438,Shingeki,alonsus,288,druid,feral,8,3,5
7439,Bénjî,khazgoroth,288,druid,feral,12,3,9
7440,Catbear,kazzak,288,druid,feral,12,3,9
7441,Оленяпеченя,gordunni,288,druid,feral,12,3,9
7442,Azyol,argent-dawn,288,druid,feral,12,3,9
7443,Murzzilka,kazzak,288,druid,feral,12,3,9
7444,Ripern,silvermoon,288,druid,feral,12,3,9
7445,Ferdax,outland,288,druid,feral,12,3,9
7446,Elocat,blackmoore,288,druid,feral,12,3,9
7447,Myex,exodar,288,druid,feral,12,3,9
7448,Phòènìx,twisting-nether,288,druid,feral,12,3,9
7449,Ashamane,outland,288,druid,feral,12,3,9
7450,Лорья,azuregos,288,druid,feral,12,3,9
7451,Skywíng,stormscale,288,druid,feral,12,3,9
7452,Шокшо,soulflayer,288,druid,feral,12,3,9
7453,Kittyclâw,perenolde,288,druid,feral,12,3,9
7454,Diow,elune,288,druid,feral,12,3,9
7455,Drocos,genjuros,288,druid,feral,12,3,9
7456,Zink,sanguino,288,druid,feral,12,3,9
7457,Senoka,shattrath,288,druid,feral,12,3,9
7458,Knææl,argent-dawn,288,druid,feral,18,3,15
7459,Frincessa,burning-legion,288,druid,feral,18,3,15
7460,Tallbutshort,stormscale,288,druid,feral,18,3,15
7461,Cemendur,bronzebeard,287,druid,feral,6,3,3
7462,Giosis,stormscale,287,druid,feral,6,3,3
7463,Growshax,nerzhul,287,druid,feral,6,3,3
7464,Huginmuninn,outland,287,druid,feral,6,3,3
7465,Vicendius,drakthul,287,druid,feral,12,3,9
7466,Kyth,forscherliga,287,druid,feral,12,3,9
7467,Vólotyr,ravencrest,287,druid,feral,12,3,9
7468,Poxu,eredar,287,druid,feral,18,3,15
7469,Papírzsepi,ragnaros,287,druid,feral,18,3,15
7470,Bakar,ghostlands,286,druid,feral,6,3,3
7471,Puuhalí,stormreaver,286,druid,feral,6,3,3
7472,Zottelmahne,blackrock,286,druid,feral,6,3,3
7473,Dildor,ysondre,286,druid,feral,6,3,3
7474,Mãui,blackhand,286,druid,feral,15,4,11
7475,Bearmantlé,outland,256,druid,feral,10,3,7
7476,Creadora,ravencrest,255,druid,feral,11,3,8
7477,Muryo,der-rat-von-dalaran,255,druid,feral,11,3,8
7478,Bartax,culte-de-la-rive-noire,240,druid,feral,9,3,6
7479,Persefal,garona,239,druid,feral,5,3,2
7480,Diktus,outland,234,druid,feral,8,4,4
7481,Anyône,dun-morogh,229,druid,feral,16,4,12
7482,Tommyferal,outland,192,druid,feral,4,3,1
7483,Mapitom,stormscale,192,druid,feral,4,3,1
7484,Bïscøte,archimonde,192,druid,feral,6,2,4
7485,Rabatout,eitrigg,192,druid,feral,6,2,4
7486,Seekíng,blackmoore,192,druid,feral,6,2,4
7487,Zouzouille,ravencrest,192,druid,feral,6,2,4
7488,Rabacki,blackmoore,192,druid,feral,6,2,4
7489,Spale,twisting-nether,192,druid,feral,6,2,4
7490,Likë,frostwolf,192,druid,feral,6,2,4
7491,Catwild,blackmoore,192,druid,feral,6,2,4
7492,Growlithe,hellfire,192,druid,feral,6,2,4
7493,Leafceld,aggra-português,192,druid,feral,6,2,4
7494,Tøpkittyg,twisting-nether,192,druid,feral,6,2,4
7495,Jokiri,argent-dawn,192,druid,feral,6,2,4
7496,Lyvaley,dun-modr,192,druid,feral,6,2,4
7497,Getsomefunny,archimonde,192,druid,feral,6,2,4
7498,Kig,ragnaros,192,druid,feral,6,2,4
7499,Shyasiandru,area-52,192,druid,feral,6,2,4
7500,Pitsas,silvermoon,192,druid,feral,6,2,4
7501,Savagehèals,ravencrest,192,druid,feral,6,2,4
7502,Bóssít,doomhammer,192,druid,feral,6,2,4
7503,Shiningztar,twisting-nether,192,druid,feral,6,2,4
7504,Citrus,sargeras,192,druid,feral,6,2,4
7505,Sàngha,frostwolf,192,druid,feral,6,2,4
7506,Атиса,gordunni,192,druid,feral,6,2,4
7507,Snuggums,argent-dawn,192,druid,feral,6,2,4
7508,Mcservietsky,chogall,192,druid,feral,6,2,4
7509,Kisskossa,stormscale,192,druid,feral,6,2,4
7510,Glyn,earthen-ring,192,druid,feral,6,2,4
7511,Filiduttkatt,ravencrest,192,druid,feral,6,2,4
7512,Nidra,silvermoon,192,druid,feral,6,2,4
7513,Yeats,blackmoore,192,druid,feral,6,2,4
7514,Nelfboyuk,tarren-mill,192,druid,feral,6,2,4
7515,Womzas,blackhand,192,druid,feral,6,2,4
7516,Glenn,alakir,192,druid,feral,6,2,4
7517,Вендьета,blackscar,192,druid,feral,6,2,4
7518,Erundrood,ysondre,192,druid,feral,6,2,4
7519,Zyron,sanguino,192,druid,feral,6,2,4
7520,Druipa,sylvanas,192,druid,feral,6,2,4
7521,Mjáy,tarren-mill,192,druid,feral,6,2,4
7522,Melcow,eredar,192,druid,feral,6,2,4
7523,Papjin,blackhand,192,druid,feral,6,2,4
7524,Вохако,howling-fjord,192,druid,feral,6,2,4
7525,Treepoloski,stormscale,192,druid,feral,6,2,4
7526,Leylajr,ravencrest,192,druid,feral,6,2,4
7527,Kiizal,twisting-nether,192,druid,feral,6,2,4
7528,Narawenn,ysondre,192,druid,feral,6,2,4
7529,Túskér,stormscale,192,druid,feral,6,2,4
7530,Агнотар,soulflayer,192,druid,feral,6,2,4
7531,Lilkâzzam,blackrock,192,druid,feral,6,2,4
7532,Bigbear,stormrage,192,druid,feral,6,2,4
7533,Casiu,blackmoore,192,druid,feral,6,2,4
7534,Voyerka,drakthul,192,druid,feral,6,2,4
7535,Indräkah,dun-modr,192,druid,feral,6,2,4
7536,Сверххищникк,soulflayer,192,druid,feral,6,2,4
7537,Cemiink,drakthul,192,druid,feral,6,2,4
7538,Friidaf,lightbringer,192,druid,feral,6,2,4
7539,Aryitu,blackrock,192,druid,feral,6,2,4
7540,Swagdemonxd,outland,192,druid,feral,6,2,4
7541,Dwaokut,ravencrest,192,druid,feral,6,2,4
7542,Szondykhan,ragnaros,192,druid,feral,6,2,4
7543,Druiddamage,the-maelstrom,192,druid,feral,6,2,4
7544,Chikiz,ghostlands,192,druid,feral,6,2,4
7545,Redyogurt,outland,192,druid,feral,6,2,4
7546,Smat,thunderhorn,192,druid,feral,6,2,4
7547,Variolus,dun-modr,192,druid,feral,6,2,4
7548,Feralsaber,ghostlands,192,druid,feral,6,2,4
7549,Comodruid,nemesis,192,druid,feral,6,2,4
7550,Кентухен,gordunni,192,druid,feral,6,2,4
7551,Santamonica,blackrock,192,druid,feral,6,2,4
7552,Snûx,antonidas,192,druid,feral,6,2,4
7553,Nicodruid,ravencrest,192,druid,feral,6,2,4
7554,Zibark,nemesis,192,druid,feral,6,2,4
7555,Beginníng,outland,192,druid,feral,6,2,4
7556,Pöttli,blackhand,192,druid,feral,6,2,4
7557,Routasydän,shattered-hand,192,druid,feral,6,2,4
7558,Sandirion,silvermoon,192,druid,feral,6,2,4
7559,Ringthaw,silvermoon,192,druid,feral,6,2,4
7560,Impertinent,outland,192,druid,feral,6,2,4
7561,Jimmyxdd,kazzak,192,druid,feral,6,2,4
7562,Lechaource,silvermoon,192,druid,feral,6,2,4
7563,Píshi,silvermoon,192,druid,feral,6,2,4
7564,Metamø,blackrock,192,druid,feral,6,2,4
7565,Frunze,sylvanas,192,druid,feral,9,2,7
7566,Spidete,sanguino,192,druid,feral,9,2,7
7567,Aaune,argent-dawn,192,druid,feral,12,2,10
7568,Nicotex,draenor,192,druid,feral,12,2,10
7569,Adawehi,ravencrest,192,druid,feral,12,2,10
7570,Naturexbot,silvermoon,192,druid,feral,12,2,10
7571,Erelieva,silvermoon,192,druid,feral,12,2,10
7572,Kuw,archimonde,192,druid,feral,12,2,10
7573,Amoveo,argent-dawn,192,druid,feral,12,2,10
7574,Yoshia,shadowsong,192,druid,feral,12,2,10
7575,Твойбарсик,gordunni,192,druid,feral,12,2,10
7576,Rasgath,kazzak,192,druid,feral,12,2,10
7577,Ellaria,burning-legion,192,druid,feral,12,2,10
7578,Astøriøn,elune,192,druid,feral,12,2,10
7579,Steakotaur,chamber-of-aspects,192,druid,feral,12,2,10
7580,Affines,the-maelstrom,192,druid,feral,12,2,10
7581,Trànsformer,nemesis,192,druid,feral,12,2,10
7582,Инфернох,gordunni,192,druid,feral,12,2,10
7583,Speegle,kazzak,192,druid,feral,12,2,10
7584,Feralzeus,sylvanas,192,druid,feral,12,2,10
7585,Teám,tarren-mill,192,druid,feral,18,2,16
7586,Tigerroll,kazzak,192,druid,feral,18,2,16
7587,Gachal,kazzak,192,druid,feral,18,2,16
7588,Sellsarya,blackmoore,191,druid,feral,6,2,4
7589,Muju,stormscale,191,druid,feral,6,2,4
7590,Jompemanfish,stormscale,191,druid,feral,6,2,4
7591,Nayato,draenor,191,druid,feral,12,2,10
7592,Loriann,twisting-nether,191,druid,feral,18,2,16
7593,Meuhtéki,hyjal,190,druid,feral,13,3,10
7594,Avisa,blackhand,190,druid,feral,12,2,10
7595,Shadøwdruid,silvermoon,190,druid,feral,18,2,16
7596,Wolfly,ravencrest,179,druid,feral,21,7,14
7597,Ilyethea,earthen-ring,175,druid,feral,11,2,9
7598,Hiloqtdruid,blackmoore,159,druid,feral,5,2,3
7599,Korkskruven,draenor,159,druid,feral,5,2,3
7600,Совулька,howling-fjord,159,druid,feral,5,2,3
7601,Bearfôrceône,blackrock,159,druid,feral,11,2,9
7602,Grawlex,silvermoon,159,druid,feral,11,2,9
7603,Найадра,gordunni,144,druid,feral,9,2,7
7604,Несессари,howling-fjord,144,druid,feral,15,2,13
7605,Azaría,aegwynn,128,druid,feral,4,2,2
7606,Baniaucygana,draenor,127,druid,feral,4,2,2
7607,Wurnas,silvermoon,121,druid,feral,15,3,12
7608,Epikeks,blackmoore,96,druid,feral,4,2,2
7609,Skyreapa,burning-legion,96,druid,feral,9,2,7
7610,Råbi,ravencrest,96,druid,feral,9,2,7
7611,Xenrakh,blackhand,96,druid,feral,6,1,5
7612,Hccl,blackhand,96,druid,feral,6,1,5
7613,Hecone,los-errantes,96,druid,feral,6,1,5
7614,Tartáros,blackrock,96,druid,feral,6,1,5
7615,Абапер,galakrond,96,druid,feral,6,1,5
7616,Markuslanz,blackrock,96,druid,feral,6,1,5
7617,Yarrp,stormscale,96,druid,feral,6,1,5
7618,Kattig,grim-batol,96,druid,feral,6,1,5
7619,Herbstkind,frostmourne,96,druid,feral,6,1,5
7620,Dawgydawg,emerald-dream,96,druid,feral,6,1,5
7621,Ragnai,emerald-dream,96,druid,feral,6,1,5
7622,Legyna,ravencrest,96,druid,feral,6,1,5
7623,Snorlaxza,ravencrest,96,druid,feral,6,1,5
7624,Saliencias,kazzak,96,druid,feral,6,1,5
7625,Seraxi,der-mithrilorden,96,druid,feral,6,1,5
7626,Солнцеедка,gordunni,96,druid,feral,6,1,5
7627,Cegorach,xavius,96,druid,feral,6,1,5
7628,Rszn,ravencrest,96,druid,feral,6,1,5
7629,Бьеорн,gordunni,96,druid,feral,6,1,5
7630,Папакамбэк,grom,96,druid,feral,6,1,5
7631,Sodniss,aggra-português,96,druid,feral,6,1,5
7632,Catgirlx,ravencrest,96,druid,feral,6,1,5
7633,Hârâohshît,blackmoore,96,druid,feral,6,1,5
7634,Спудич,eversong,96,druid,feral,6,1,5
7635,Albinoape,doomhammer,96,druid,feral,6,1,5
7636,Awán,aegwynn,96,druid,feral,6,1,5
7637,Ayatola,conseil-des-ombres,96,druid,feral,6,1,5
7638,Zðe,la-croisade-écarlate,96,druid,feral,6,1,5
7639,Laaide,blackmoore,96,druid,feral,6,1,5
7640,Venomjr,bloodhoof,96,druid,feral,6,1,5
7641,Hyza,bronzebeard,96,druid,feral,6,1,5
7642,Taurendruid,the-maelstrom,96,druid,feral,6,1,5
7643,Horkz,frostmourne,96,druid,feral,6,1,5
7644,Thaneo,blackmoore,96,druid,feral,6,1,5
7645,Spoco,defias-brotherhood,96,druid,feral,6,1,5
7646,Пивч,soulflayer,96,druid,feral,6,1,5
7647,Vaalya,hyjal,96,druid,feral,6,1,5
7648,Aahboom,draenor,96,druid,feral,6,1,5
7649,Nytaleas,naxxramas,96,druid,feral,6,1,5
7650,Hefdgaharald,antonidas,96,druid,feral,6,1,5
7651,Benfufu,kazzak,96,druid,feral,6,1,5
7652,Арбузир,howling-fjord,96,druid,feral,6,1,5
7653,Fabulous,genjuros,96,druid,feral,6,1,5
7654,Tshungubuäch,eredar,96,druid,feral,6,1,5
7655,Feyzode,ysondre,96,druid,feral,6,1,5
7656,Tael,argent-dawn,96,druid,feral,6,1,5
7657,Majesty,nagrand,96,druid,feral,6,1,5
7658,Zinister,hyjal,96,druid,feral,6,1,5
7659,Haragmancs,arathor,96,druid,feral,6,1,5
7660,Ãnimal,argent-dawn,96,druid,feral,6,1,5
7661,Bolhás,defias-brotherhood,96,druid,feral,6,1,5
7662,Jellybra,tarren-mill,96,druid,feral,6,1,5
7663,Strand,ragnaros,96,druid,feral,6,1,5
7664,Nidrien,doomhammer,96,druid,feral,6,1,5
7665,Théodên,dalaran,96,druid,feral,6,1,5
7666,Gurudru,tarren-mill,96,druid,feral,6,1,5
7667,Plàntz,tarren-mill,96,druid,feral,6,1,5
7668,Stjärna,kult-der-verdammten,96,druid,feral,6,1,5
7669,Sabresheep,twisting-nether,96,druid,feral,6,1,5
7670,Heav,kiljaeden,96,druid,feral,6,1,5
7671,Мурталор,soulflayer,96,druid,feral,6,1,5
7672,Cesty,silvermoon,96,druid,feral,6,1,5
7673,Veyronn,burning-legion,96,druid,feral,12,1,11
7674,Mássive,darkmoon-faire,96,druid,feral,12,1,11
7675,Sempai,hyjal,96,druid,feral,12,1,11
7676,Yabooni,ravencrest,96,druid,feral,12,1,11
7677,Mäywen,ravencrest,96,druid,feral,12,1,11
7678,Nakkikastike,magtheridon,96,druid,feral,12,1,11
7679,Treébeárd,draenor,96,druid,feral,12,1,11
7680,Raferalston,nathrezim,96,druid,feral,12,1,11
7681,Farnae,kirin-tor,96,druid,feral,12,1,11
7682,Bidodici,nemesis,95,druid,feral,6,1,5
7683,Allîyâ,archimonde,79,druid,feral,5,1,4
7684,Forigiver,draenor,64,druid,feral,4,1,3
7685,Прокси,gordunni,64,druid,feral,4,1,3
7686,Tamakie,blackmoore,64,druid,feral,4,1,3
7687,Lycal,chogall,63,druid,feral,2,2,0
7688,Cus,tarren-mill,48,druid,feral,3,1,2
7689,Wadles,draenor,48,druid,feral,3,1,2
7690,Maroxd,stormscale,2391,druid,balance,114,78,36
7691,Kaabeedo,ravencrest,2389,druid,balance,114,70,44
7692,Merceý,ravencrest,2323,druid,balance,97,65,32
7693,Immuz,kazzak,2316,druid,balance,166,93,73
7694,Skivesnulle,kazzak,2275,druid,balance,291,152,139
7695,Fuséton,tarren-mill,2269,druid,balance,305,180,125
7696,Wriong,ravencrest,2250,druid,balance,141,87,54
7697,Ackiz,ravencrest,2225,druid,balance,87,53,34
7698,Bd,stormscale,2225,druid,balance,83,49,34
7699,Zødzin,kazzak,2217,druid,balance,126,70,56
7700,Vabore,twisting-nether,2203,druid,balance,108,57,51
7701,Batboomie,zuljin,2198,druid,balance,280,156,124
7702,Thelire,silvermoon,2188,druid,balance,310,164,146
7703,Isatá,ravencrest,2179,druid,balance,72,46,26
7704,Norgand,die-aldor,2173,druid,balance,42,33,9
7705,Flanagân,hyjal,2171,druid,balance,60,36,24
7706,Ööh,outland,2158,druid,balance,138,77,61
7707,Shayia,aegwynn,2156,druid,balance,143,78,65
7708,Shåmss,kazzak,2151,druid,balance,54,35,19
7709,Deép,nazjatar,2149,druid,balance,96,50,46
7710,Dezarden,die-aldor,2147,druid,balance,99,61,38
7711,Sleepyhallow,blackmoore,2143,druid,balance,106,61,45
7712,Стомпбр,gordunni,2141,druid,balance,144,89,55
7713,Eôxxd,blackrock,2135,druid,balance,95,63,32
7714,Agagagagagag,ravencrest,2129,druid,balance,108,59,49
7715,Wwboomy,kazzak,2129,druid,balance,132,65,67
7716,Muhammadali,ravencrest,2126,druid,balance,72,42,30
7717,Mopboomkin,twisting-nether,2122,druid,balance,78,45,33
7718,Jwrld,stormscale,2121,druid,balance,66,35,31
7719,Yore,tichondrius,2120,druid,balance,102,72,30
7720,Rexonadudu,kazzak,2120,druid,balance,165,98,67
7721,Bumkin,bloodhoof,2120,druid,balance,72,41,31
7722,Kirexz,blackrock,2118,druid,balance,83,55,28
7723,Newaccount,kazzak,2117,druid,balance,156,95,61
7724,Feelstreeman,twisting-nether,2115,druid,balance,54,33,21
7725,Rek,sanguino,2114,druid,balance,87,50,37
7726,Эё,howling-fjord,2113,druid,balance,118,78,40
7727,Ursulaboomer,blackrock,2113,druid,balance,96,55,41
7728,Positivîty,stormscale,2111,druid,balance,168,99,69
7729,Winkler,kazzak,2109,druid,balance,50,38,12
7730,Broccoliboy,sylvanas,2107,druid,balance,144,76,68
7731,Handsoff,stormscale,2104,druid,balance,210,112,98
7732,Pikatwo,tyrande,2103,druid,balance,54,41,13
7733,Бубаджек,howling-fjord,2102,druid,balance,48,31,17
7734,Catchmê,archimonde,2099,druid,balance,86,50,36
7735,Mephîs,ravencrest,2081,druid,balance,82,52,30
7736,Tmeister,kazzak,2081,druid,balance,114,65,49
7737,Eviscreator,stormscale,2076,druid,balance,120,76,44
7738,Crippaa,tarren-mill,2071,druid,balance,121,74,47
7739,Bambye,stormscale,2067,druid,balance,158,102,56
7740,Limme,ravencrest,2066,druid,balance,122,81,41
7741,Gonyogonyo,blackmoore,2061,druid,balance,66,38,28
7742,Výragosa,der-rat-von-dalaran,2059,druid,balance,128,73,55
7743,Antahka,archimonde,2057,druid,balance,60,34,26
7744,Oskol,tarren-mill,2057,druid,balance,70,37,33
7745,Shivany,twisting-nether,2052,druid,balance,130,66,64
7746,Méáckós,aegwynn,2050,druid,balance,164,82,82
7747,Celtimi,antonidas,2049,druid,balance,66,49,17
7748,Владисзади,gordunni,2046,druid,balance,125,68,57
7749,Bulla,culte-de-la-rive-noire,2045,druid,balance,213,122,91
7750,Rootzxx,ravencrest,2043,druid,balance,126,72,54
7751,Lifeseed,ravencrest,2040,druid,balance,89,51,38
7752,Nutsnack,tarren-mill,2039,druid,balance,78,38,40
7753,Gulmi,outland,2032,druid,balance,123,71,52
7754,Starsy,frostmane,2032,druid,balance,89,42,47
7755,Høtpøket,ravencrest,2028,druid,balance,54,36,18
7756,Didiee,kazzak,2025,druid,balance,150,85,65
7757,Sadgeconvoke,draenor,2021,druid,balance,316,183,133
7758,Win,hellscream,2018,druid,balance,108,61,47
7759,Рейзакх,howling-fjord,2017,druid,balance,150,80,70
7760,Shakso,stormscale,2016,druid,balance,90,54,36
7761,Saufeb,stormscale,2016,druid,balance,113,65,48
7762,Flanagàn,hyjal,2016,druid,balance,82,41,41
7763,Cmfg,blackrock,2015,druid,balance,104,65,39
7764,Dincks,draenor,2015,druid,balance,89,54,35
7765,Blanoz,ravencrest,2012,druid,balance,84,42,42
7766,Iloveher,ravencrest,2011,druid,balance,48,34,14
7767,Secrägodx,ragnaros,2011,druid,balance,90,54,36
7768,Moodý,aegwynn,2009,druid,balance,76,51,25
7769,Qtkitty,outland,2009,druid,balance,356,195,161
7770,Ôwlnur,kult-der-verdammten,2008,druid,balance,91,50,41
7771,Akinimod,ravencrest,2000,druid,balance,120,69,51
7772,Ganqb,ravencrest,1995,druid,balance,483,264,219
7773,Zaoow,stormscale,1994,druid,balance,114,71,43
7774,Klimakleber,ravencrest,1991,druid,balance,158,78,80
7775,Kruwkamilka,burning-legion,1988,druid,balance,182,100,82
7776,Bittebads,stormscale,1987,druid,balance,54,35,19
7777,Detü,blackrock,1979,druid,balance,89,56,33
7778,Okøë,marécage-de-zangar,1978,druid,balance,54,34,20
7779,Øsbura,silvermoon,1978,druid,balance,72,43,29
7780,Lilpumpz,outland,1978,druid,balance,89,45,44
7781,Disvikz,outland,1971,druid,balance,72,41,31
7782,Rbgkári,draenor,1967,druid,balance,87,56,31
7783,Slaugh,zuljin,1966,druid,balance,101,55,46
7784,Turtleform,blackrock,1961,druid,balance,138,64,74
7785,ßa,blackmoore,1960,druid,balance,59,38,21
7786,Uglyrasputin,blackmoore,1960,druid,balance,156,94,62
7787,Wizzlafa,ravencrest,1960,druid,balance,82,48,34
7788,Wrathgodx,aegwynn,1958,druid,balance,54,33,21
7789,Pvekek,stormscale,1953,druid,balance,74,48,26
7790,Aggroasian,tarren-mill,1952,druid,balance,263,144,119
7791,Даирлин,gordunni,1952,druid,balance,154,77,77
7792,Transmangodx,tarren-mill,1950,druid,balance,78,48,30
7793,Zuterlø,ragnaros,1950,druid,balance,72,38,34
7794,Imperiusx,ravencrest,1944,druid,balance,251,139,112
7795,Néllÿ,elune,1942,druid,balance,108,54,54
7796,Kënzo,ravencrest,1941,druid,balance,121,79,42
7797,Crnkie,sylvanas,1937,druid,balance,66,42,24
7798,Cassiddyy,draenor,1937,druid,balance,78,45,33
7799,Sentería,sylvanas,1937,druid,balance,90,42,48
7800,Tuttu,kazzak,1936,druid,balance,90,50,40
7801,Травкер,howling-fjord,1936,druid,balance,353,179,174
7802,Anpassad,outland,1935,druid,balance,64,37,27
7803,Ciucciotutto,nemesis,1934,druid,balance,66,46,20
7804,Grässoppa,tarren-mill,1933,druid,balance,59,33,26
7805,Muufasa,blackmoore,1931,druid,balance,260,134,126
7806,Siuo,ravencrest,1930,druid,balance,77,43,34
7807,Credenz,frostmane,1929,druid,balance,102,61,41
7808,Laker,stormscale,1929,druid,balance,145,79,66
7809,Maijs,ravencrest,1929,druid,balance,72,35,37
7810,Gambós,kazzak,1927,druid,balance,59,30,29
7811,Kayllie,silvermoon,1926,druid,balance,72,45,27
7812,Veonski,argent-dawn,1925,druid,balance,105,57,48
7813,Björnskift,tarren-mill,1924,druid,balance,66,40,26
7814,Ezeke,eredar,1922,druid,balance,178,91,87
7815,Mooskie,draenor,1921,druid,balance,54,37,17
7816,Fredhqt,tarren-mill,1918,druid,balance,59,37,22
7817,Ледруд,gordunni,1918,druid,balance,74,37,37
7818,Dudukid,nemesis,1915,druid,balance,178,92,86
7819,Hammd,kazzak,1914,druid,balance,161,89,72
7820,Bompfer,blackmoore,1914,druid,balance,60,33,27
7821,Narq,sylvanas,1911,druid,balance,84,51,33
7822,Найттир,gordunni,1910,druid,balance,69,39,30
7823,Flæppy,blackmoore,1910,druid,balance,208,105,103
7824,Millions,tarren-mill,1909,druid,balance,129,82,47
7825,Cioaralba,sylvanas,1909,druid,balance,81,50,31
7826,Вбг,soulflayer,1908,druid,balance,166,90,76
7827,Greenful,drakthul,1907,druid,balance,90,51,39
7828,Trntydr,senjin,1906,druid,balance,41,30,11
7829,Sleepystacy,argent-dawn,1904,druid,balance,60,40,20
7830,Karvajyrä,stormreaver,1904,druid,balance,296,161,135
7831,Afret,kazzak,1902,druid,balance,371,191,180
7832,Kjøttberit,moonglade,1901,druid,balance,42,32,10
7833,Hotflora,aegwynn,1898,druid,balance,36,22,14
7834,Carnivals,twisting-nether,1897,druid,balance,138,74,64
7835,Interaktio,ravencrest,1896,druid,balance,34,24,10
7836,Captaïn,twisting-nether,1896,druid,balance,78,50,28
7837,Æøøm,blackmoore,1896,druid,balance,200,112,88
7838,Zendda,hyjal,1896,druid,balance,61,30,31
7839,Malex,auchindoun,1895,druid,balance,54,32,22
7840,Knùbz,ravencrest,1895,druid,balance,77,40,37
7841,Calê,blackrock,1894,druid,balance,177,104,73
7842,Рябчиик,blackscar,1894,druid,balance,215,119,96
7843,Хальтенис,gordunni,1893,druid,balance,106,57,49
7844,Votionex,tarren-mill,1891,druid,balance,64,38,26
7845,Hunkex,frostmane,1891,druid,balance,93,51,42
7846,Connorz,blackmoore,1890,druid,balance,81,50,31
7847,Hppsr,eredar,1889,druid,balance,72,38,34
7848,Melby,tarren-mill,1888,druid,balance,54,29,25
7849,Punxybear,ravencrest,1887,druid,balance,289,149,140
7850,Boomky,blackmoore,1887,druid,balance,57,29,28
7851,Kenzia,stormrage,1886,druid,balance,72,43,29
7852,Senfkai,kelthuzad,1885,druid,balance,42,35,7
7853,Peaches,aerie-peak,1885,druid,balance,71,48,23
7854,Kankstery,stormscale,1882,druid,balance,65,44,21
7855,Shivany,outland,1880,druid,balance,106,63,43
7856,Blopstar,stormscale,1879,druid,balance,54,34,20
7857,Bmybmybmybmy,outland,1875,druid,balance,30,24,6
7858,Ghostpaws,ravencrest,1874,druid,balance,130,67,63
7859,Øncê,durotan,1871,druid,balance,54,29,25
7860,Tobid,blackrock,1869,druid,balance,48,36,12
7861,Restaidpvs,wildhammer,1868,druid,balance,66,34,32
7862,Hyperbêast,blackrock,1866,druid,balance,41,31,10
7863,Xerlog,thrall,1866,druid,balance,60,39,21
7864,Boomjutzu,kazzak,1866,druid,balance,42,25,17
7865,Rudabaebey,draenor,1863,druid,balance,42,28,14
7866,Låsèrpêwpéw,tarren-mill,1861,druid,balance,96,60,36
7867,Shàal,ysondre,1859,druid,balance,134,73,61
7868,ßoomin,tarren-mill,1859,druid,balance,48,25,23
7869,Trytargetme,outland,1858,druid,balance,72,43,29
7870,Starbro,grim-batol,1856,druid,balance,48,27,21
7871,Emmdru,silvermoon,1854,druid,balance,101,63,38
7872,Starfallkey,dun-modr,1854,druid,balance,111,67,44
7873,Howgh,destromath,1854,druid,balance,192,100,92
7874,Bearpawzz,kazzak,1852,druid,balance,70,41,29
7875,Juicypus,ragnaros,1851,druid,balance,54,32,22
7876,Mdrgtwo,ravencrest,1850,druid,balance,53,36,17
7877,Näela,archimonde,1850,druid,balance,54,27,27
7878,Løsër,ravencrest,1849,druid,balance,44,26,18
7879,Øhmygød,stormscale,1849,druid,balance,66,35,31
7880,Миртлэкшн,gordunni,1848,druid,balance,83,45,38
7881,Tzeeni,stormscale,1847,druid,balance,35,28,7
7882,Mesmerizing,ravencrest,1847,druid,balance,78,43,35
7883,Sænxx,blackrock,1846,druid,balance,42,30,12
7884,Друлякич,gordunni,1846,druid,balance,49,30,19
7885,Nuvemone,stormscale,1846,druid,balance,114,64,50
7886,Snøø,frostwolf,1845,druid,balance,90,51,39
7887,Xora,kazzak,1845,druid,balance,197,106,91
7888,Арадия,gordunni,1843,druid,balance,66,35,31
7889,Gipi,ravencrest,1843,druid,balance,60,31,29
7890,Füllxtrap,hyjal,1841,druid,balance,24,20,4
7891,Ovérheal,ravencrest,1840,druid,balance,51,37,14
7892,Drooshy,ravencrest,1840,druid,balance,51,34,17
7893,Fiskmåsn,twisting-nether,1840,druid,balance,185,103,82
7894,Hrz,kazzak,1839,druid,balance,79,50,29
7895,Memphiswhx,drakthul,1839,druid,balance,96,50,46
7896,Rlwlwlwlwr,twisting-nether,1838,druid,balance,48,33,15
7897,Pluginbaby,stormscale,1838,druid,balance,64,41,23
7898,Ravneskrig,ravencrest,1838,druid,balance,62,38,24
7899,Айрокси,blackscar,1838,druid,balance,48,28,20
7900,Skirr,kelthuzad,1838,druid,balance,42,23,19
7901,Anéry,ravencrest,1837,druid,balance,29,20,9
7902,Tjillevippen,tarren-mill,1836,druid,balance,36,23,13
7903,Nassii,antonidas,1836,druid,balance,162,99,63
7904,Connydor,stormscale,1836,druid,balance,48,29,19
7905,Metamoo,tarren-mill,1835,druid,balance,47,36,11
7906,Atrosity,ravencrest,1835,druid,balance,66,40,26
7907,Nyndrà,archimonde,1835,druid,balance,165,81,84
7908,Vregord,twisting-nether,1834,druid,balance,48,32,16
7909,Mochiløxz,tarren-mill,1834,druid,balance,149,89,60
7910,Sylvy,dun-modr,1834,druid,balance,142,79,63
7911,Tommyruin,the-venture-co,1834,druid,balance,105,57,48
7912,Jøkèr,outland,1833,druid,balance,53,30,23
7913,Кирукхэ,gordunni,1832,druid,balance,36,28,8
7914,Brovis,sylvanas,1832,druid,balance,45,32,13
7915,Bigpûmp,elune,1832,druid,balance,48,30,18
7916,Kÿara,khaz-modan,1832,druid,balance,48,28,20
7917,Tárzáñ,ravencrest,1831,druid,balance,60,37,23
7918,Embrangle,silvermoon,1830,druid,balance,48,30,18
7919,Kabôôm,stormscale,1830,druid,balance,48,28,20
7920,Taurendruid,the-maelstrom,1830,druid,balance,150,84,66
7921,Lóvebeam,ravencrest,1829,druid,balance,42,26,16
7922,Tummus,blackrock,1829,druid,balance,60,32,28
7923,Bastodonte,skullcrusher,1828,druid,balance,190,97,93
7924,Rlwlwlwrtwo,twisting-nether,1828,druid,balance,54,27,27
7925,Triskelion,burning-legion,1827,druid,balance,82,47,35
7926,Eloahdruid,blackhand,1826,druid,balance,63,36,27
7927,Rngmåchinéx,ravencrest,1825,druid,balance,127,83,44
7928,Зетзул,grom,1825,druid,balance,290,155,135
7929,Dizay,xavius,1823,druid,balance,60,40,20
7930,Melyssea,argent-dawn,1823,druid,balance,59,35,24
7931,Qtrly,ravencrest,1823,druid,balance,56,30,26
7932,Faxotium,argent-dawn,1822,druid,balance,30,21,9
7933,Djemdruid,argent-dawn,1822,druid,balance,42,27,15
7934,Kaalil,argent-dawn,1822,druid,balance,72,40,32
7935,Hyac,the-maelstrom,1819,druid,balance,42,29,13
7936,Alxzdru,auchindoun,1819,druid,balance,135,83,52
7937,Izhusky,ravencrest,1819,druid,balance,85,46,39
7938,Sylindra,argent-dawn,1818,druid,balance,106,66,40
7939,Zâe,archimonde,1818,druid,balance,36,21,15
7940,Gurru,xavius,1818,druid,balance,155,78,77
7941,Sunshinex,silvermoon,1818,druid,balance,96,47,49
7942,Quadpulse,ravencrest,1817,druid,balance,42,23,19
7943,Nerem,blackrock,1817,druid,balance,84,44,40
7944,Bákhar,ravencrest,1817,druid,balance,148,71,77
7945,Lunahu,argent-dawn,1816,druid,balance,72,42,30
7946,Kokslina,sylvanas,1816,druid,balance,59,28,31
7947,Astrobazooka,stormreaver,1815,druid,balance,77,48,29
7948,Treesus,blackrock,1815,druid,balance,36,22,14
7949,Neirdá,hyjal,1815,druid,balance,191,104,87
7950,Brucebruce,stormscale,1814,druid,balance,36,21,15
7951,Tallu,das-konsortium,1813,druid,balance,66,41,25
7952,Flanders,blackrock,1811,druid,balance,36,25,11
7953,Bashmac,mugthol,1811,druid,balance,72,49,23
7954,Randomnup,sanguino,1811,druid,balance,48,28,20
7955,Balanc,ragnaros,1811,druid,balance,164,92,72
7956,Яммаккаасии,grom,1811,druid,balance,60,30,30
7957,Owlbum,grim-batol,1810,druid,balance,48,31,17
7958,Veganvapex,draenor,1810,druid,balance,79,48,31
7959,Sartipus,draenor,1810,druid,balance,78,47,31
7960,Artistdubose,kazzak,1809,druid,balance,42,27,15
7961,Superchïcken,archimonde,1809,druid,balance,36,23,13
7962,Núri,lordaeron,1809,druid,balance,80,46,34
7963,Imaginarý,ravencrest,1809,druid,balance,47,26,21
7964,Ccoco,aegwynn,1809,druid,balance,96,49,47
7965,Ferawri,draenor,1808,druid,balance,42,24,18
7966,Scaleo,stormreaver,1808,druid,balance,90,48,42
7967,Citróne,blackrock,1807,druid,balance,24,19,5
7968,Icek,outland,1806,druid,balance,54,33,21
7969,Xalio,ravencrest,1806,druid,balance,65,39,26
7970,Elunælle,les-sentinelles,1806,druid,balance,126,72,54
7971,Gehrkehotter,silvermoon,1805,druid,balance,90,58,32
7972,Otpboomie,dun-modr,1805,druid,balance,37,23,14
7973,Shamerika,tarren-mill,1805,druid,balance,83,50,33
7974,Meowcry,outland,1805,druid,balance,78,45,33
7975,Solariah,garona,1804,druid,balance,143,84,59
7976,Cøntrol,argent-dawn,1804,druid,balance,60,34,26
7977,Starcowx,ragnaros,1804,druid,balance,69,38,31
7978,Ruetinjeri,blackmoore,1804,druid,balance,73,38,35
7979,Rnkx,sanguino,1803,druid,balance,57,33,24
7980,Wrldx,twisting-nether,1802,druid,balance,106,61,45
7981,Justyo,archimonde,1801,druid,balance,69,45,24
7982,Jettad,ravencrest,1801,druid,balance,40,25,15
7983,Geîl,blackrock,1801,druid,balance,42,24,18
7984,Daÿdream,ravencrest,1800,druid,balance,60,39,21
7985,Eselhirte,blackhand,1800,druid,balance,45,27,18
7986,Совёнушек,howling-fjord,1799,druid,balance,59,34,25
7987,Онличикен,gordunni,1797,druid,balance,150,78,72
7988,Abyssaldepth,ravencrest,1796,druid,balance,96,65,31
7989,Legitx,dentarg,1794,druid,balance,85,46,39
7990,Crunchtime,ragnaros,1792,druid,balance,127,68,59
7991,Klappskaft,outland,1791,druid,balance,35,20,15
7992,Moonhusky,blackrock,1789,druid,balance,60,36,24
7993,Ventrìx,alleria,1787,druid,balance,84,43,41
7994,Laserchicken,malganis,1787,druid,balance,267,129,138
7995,Kylaaz,die-ewige-wacht,1786,druid,balance,111,70,41
7996,Krathar,kazzak,1786,druid,balance,47,22,25
7997,Longhornjohn,ragnaros,1784,druid,balance,58,33,25
7998,Trekkertt,zuljin,1784,druid,balance,53,28,25
7999,Crywingz,antonidas,1783,druid,balance,136,68,68
8000,Kivimon,dun-modr,1781,druid,balance,48,31,17
8001,Morlán,blackmoore,1777,druid,balance,30,19,11
8002,Darktigrou,archimonde,1775,druid,balance,30,21,9
8003,Подпивасникх,gordunni,1775,druid,balance,42,28,14
8004,Gigacooker,ravencrest,1774,druid,balance,42,30,12
8005,Zkrd,kazzak,1774,druid,balance,61,33,28
8006,Rivella,blackrock,1774,druid,balance,57,30,27
8007,Dràkàn,dethecus,1772,druid,balance,48,26,22
8008,Лёхалепеха,gordunni,1770,druid,balance,72,44,28
8009,Zerozerosex,archimonde,1770,druid,balance,66,34,32
8010,Stepgødx,twisting-nether,1769,druid,balance,69,30,39
8011,Лсдспайсы,soulflayer,1767,druid,balance,69,44,25
8012,Gallokiriko,zuljin,1767,druid,balance,78,39,39
8013,Skarbowka,burning-legion,1766,druid,balance,24,20,4
8014,Shiftowl,tarren-mill,1766,druid,balance,36,25,11
8015,Mirynn,elune,1766,druid,balance,127,64,63
8016,Mqs,stormscale,1765,druid,balance,122,72,50
8017,Asinistar,ravencrest,1764,druid,balance,56,32,24
8018,Bbl,rexxar,1763,druid,balance,30,20,10
8019,Thcpositiv,aegwynn,1763,druid,balance,128,63,65
8020,Мунстрайк,borean-tundra,1761,druid,balance,103,59,44
8021,Сосисосочка,gordunni,1761,druid,balance,66,32,34
8022,Durkdriven,kazzak,1759,druid,balance,63,37,26
8023,Kotaryzi,kazzak,1758,druid,balance,24,19,5
8024,Större,twisting-nether,1758,druid,balance,56,41,15
8025,Yinx,darksorrow,1758,druid,balance,66,38,28
8026,Escaa,stormscale,1757,druid,balance,36,21,15
8027,Eddiethepunk,ravencrest,1757,druid,balance,237,134,103
8028,Euphørie,twisting-nether,1757,druid,balance,211,117,94
8029,Taylorshîft,burning-legion,1757,druid,balance,60,31,29
8030,Jenovas,argent-dawn,1756,druid,balance,87,45,42
8031,Shyngodx,archimonde,1755,druid,balance,96,58,38
8032,Dyroxs,twisting-nether,1755,druid,balance,184,91,93
8033,Amazed,wildhammer,1753,druid,balance,54,34,20
8034,Broflovskii,tarren-mill,1752,druid,balance,60,27,33
8035,Shroomdoom,ravencrest,1751,druid,balance,47,23,24
8036,Gudñ,tarren-mill,1750,druid,balance,65,38,27
8037,Stb,outland,1750,druid,balance,48,28,20
8038,Hornykarenn,bladefist,1749,druid,balance,36,25,11
8039,Pneuma,xavius,1749,druid,balance,117,67,50
8040,Hilom,grim-batol,1748,druid,balance,47,29,18
8041,Даена,razuvious,1747,druid,balance,48,34,14
8042,Ånaðeårmas,outland,1746,druid,balance,77,47,30
8043,Babynaty,ravencrest,1745,druid,balance,188,91,97
8044,Págánxø,kazzak,1743,druid,balance,53,34,19
8045,Угощаюх,howling-fjord,1743,druid,balance,47,30,17
8046,Мариантус,greymane,1742,druid,balance,42,22,20
8047,Frenkoz,outland,1741,druid,balance,90,53,37
8048,Brîvaëlle,silvermoon,1740,druid,balance,30,24,6
8049,Deepak,nemesis,1740,druid,balance,60,35,25
8050,Ashleyx,antonidas,1738,druid,balance,36,30,6
8051,Empi,sanguino,1738,druid,balance,54,34,20
8052,Meowmf,silvermoon,1738,druid,balance,78,48,30
8053,Kribie,aegwynn,1738,druid,balance,66,40,26
8054,Jaiyen,ravencrest,1736,druid,balance,65,45,20
8055,Fuzzylol,haomarush,1736,druid,balance,41,24,17
8056,Leqt,ravencrest,1736,druid,balance,90,52,38
8057,Frapucino,ravencrest,1735,druid,balance,39,28,11
8058,Fantomasik,drakthul,1734,druid,balance,230,117,113
8059,Bigbaddream,stormscale,1733,druid,balance,60,34,26
8060,Isuckdruid,aegwynn,1733,druid,balance,100,56,44
8061,Мягкийвисп,howling-fjord,1729,druid,balance,72,41,31
8062,Трэйкотик,blackscar,1728,druid,balance,71,41,30
8063,Ахисса,gordunni,1727,druid,balance,78,37,41
8064,Tâliah,silvermoon,1726,druid,balance,54,35,19
8065,Aleza,tarren-mill,1726,druid,balance,51,30,21
8066,Rekked,alleria,1726,druid,balance,60,32,28
8067,Pultsarí,tarren-mill,1725,druid,balance,39,24,15
8068,Duckiethotx,twisting-nether,1725,druid,balance,36,21,15
8069,Yarinai,blackmoore,1725,druid,balance,78,44,34
8070,Pouletqt,archimonde,1723,druid,balance,42,21,21
8071,Píøøx,tarren-mill,1722,druid,balance,84,53,31
8072,Oommis,outland,1722,druid,balance,48,28,20
8073,Blood,frostwolf,1722,druid,balance,66,36,30
8074,Pwnylol,teldrassil,1721,druid,balance,70,46,24
8075,Smøkewéed,ravencrest,1719,druid,balance,24,18,6
8076,Xyzy,burning-legion,1719,druid,balance,96,48,48
8077,Hugeragê,stormreaver,1719,druid,balance,71,33,38
8078,Kalgarm,burning-legion,1719,druid,balance,66,29,37
8079,Juicew,stormscale,1717,druid,balance,24,18,6
8080,Adizero,blackrock,1716,druid,balance,37,24,13
8081,Shakeme,zuljin,1716,druid,balance,48,25,23
8082,Khålêd,kazzak,1714,druid,balance,52,38,14
8083,Orangeterror,stormscale,1714,druid,balance,48,30,18
8084,Хрофт,blackscar,1714,druid,balance,54,26,28
8085,Yapyapyapyap,eredar,1713,druid,balance,42,25,17
8086,Kabuul,dun-modr,1712,druid,balance,119,74,45
8087,Sifferx,stormscale,1712,druid,balance,53,28,25
8088,Batmòn,stormscale,1712,druid,balance,93,48,45
8089,Владибой,gordunni,1712,druid,balance,36,18,18
8090,Illmíndofboo,twisting-nether,1711,druid,balance,59,37,22
8091,Madhatterr,kazzak,1710,druid,balance,96,63,33
8092,Scars,outland,1710,druid,balance,30,18,12
8093,Bîjaqt,blackmoore,1710,druid,balance,30,18,12
8094,Mirâculixx,dethecus,1709,druid,balance,30,19,11
8095,Kørra,dun-modr,1707,druid,balance,73,42,31
8096,Moonfirecow,thrall,1706,druid,balance,54,32,22
8097,Slahnesh,aegwynn,1706,druid,balance,48,26,22
8098,Linkin,azshara,1704,druid,balance,102,53,49
8099,Naturez,sylvanas,1704,druid,balance,74,37,37
8100,Mikhaili,stormreaver,1703,druid,balance,30,18,12
8101,Leywä,drekthar,1703,druid,balance,47,28,19
8102,Каралесер,gordunni,1703,druid,balance,205,111,94
8103,Nerfmemaybe,blackmoore,1702,druid,balance,29,20,9
8104,Yuhor,outland,1702,druid,balance,202,107,95
8105,Небесныйхант,soulflayer,1702,druid,balance,123,63,60
8106,Elissian,silvermoon,1701,druid,balance,223,117,106
8107,Neufcinqq,archimonde,1700,druid,balance,39,26,13
8108,Symbiosa,silvermoon,1699,druid,balance,99,63,36
8109,Thardruid,stormscale,1699,druid,balance,72,42,30
8110,Колтрэйнх,fordragon,1699,druid,balance,54,29,25
8111,Htxo,kazzak,1698,druid,balance,30,18,12
8112,Shaakm,nerathor,1697,druid,balance,66,40,26
8113,Cryspie,hyjal,1697,druid,balance,42,23,19
8114,Raykk,culte-de-la-rive-noire,1696,druid,balance,30,18,12
8115,Rexadria,blackrock,1695,druid,balance,24,18,6
8116,Eñzo,stormscale,1695,druid,balance,30,21,9
8117,Esrín,the-maelstrom,1695,druid,balance,104,56,48
8118,Bubadruid,silvermoon,1694,druid,balance,65,47,18
8119,Sinalûlz,outland,1694,druid,balance,30,18,12
8120,Taveirasurge,kazzak,1693,druid,balance,42,28,14
8121,Nastyclones,kazzak,1691,druid,balance,36,21,15
8122,Chäz,sanguino,1690,druid,balance,56,42,14
8123,Nzmdruid,burning-legion,1689,druid,balance,36,21,15
8124,Hymìr,silvermoon,1689,druid,balance,71,37,34
8125,Néxct,stormscale,1688,druid,balance,36,22,14
8126,Bobobobobobo,blackrock,1687,druid,balance,101,60,41
8127,Msb,the-maelstrom,1687,druid,balance,36,18,18
8128,Gnoobr,ravencrest,1686,druid,balance,24,18,6
8129,Ykg,twisting-nether,1686,druid,balance,51,32,19
8130,Nergi,darksorrow,1686,druid,balance,53,31,22
8131,Cyriaan,eredar,1686,druid,balance,101,55,46
8132,Güccïmane,twisting-nether,1685,druid,balance,72,53,19
8133,Teebeidl,tarren-mill,1685,druid,balance,78,46,32
8134,Panpanqcul,archimonde,1685,druid,balance,99,57,42
8135,Добродейтель,soulflayer,1683,druid,balance,132,82,50
8136,Cowgurl,stormscale,1682,druid,balance,48,27,21
8137,Haanook,ravencrest,1682,druid,balance,136,74,62
8138,Mäismz,hyjal,1680,druid,balance,54,37,17
8139,Sleepz,blackrock,1679,druid,balance,24,18,6
8140,Npml,tarren-mill,1678,druid,balance,53,30,23
8141,Kaïnak,dalaran,1677,druid,balance,54,29,25
8142,Zeptune,tarren-mill,1677,druid,balance,126,59,67
8143,Highonfire,grim-batol,1676,druid,balance,60,41,19
8144,Ïndrä,arathi,1676,druid,balance,35,22,13
8145,Dotclass,outland,1675,druid,balance,44,25,19
8146,Iamobito,blackmoore,1674,druid,balance,36,22,14
8147,Wildrice,blackhand,1674,druid,balance,65,37,28
8148,Totemdrood,blackmoore,1673,druid,balance,30,20,10
8149,Cptnclone,blackmoore,1669,druid,balance,72,38,34
8150,Andreud,dunemaul,1669,druid,balance,77,37,40
8151,Воому,soulflayer,1668,druid,balance,30,22,8
8152,Drcaøs,sanguino,1668,druid,balance,84,47,37
8153,Maladorf,draenor,1667,druid,balance,30,21,9
8154,Pyaw,kazzak,1666,druid,balance,78,44,34
8155,Мэдикейт,soulflayer,1665,druid,balance,84,48,36
8156,Suomenlorgok,stormreaver,1664,druid,balance,36,23,13
8157,Fapmasterx,eredar,1664,druid,balance,36,23,13
8158,Settembre,ragnaros,1664,druid,balance,69,40,29
8159,Dreathqt,twisting-nether,1664,druid,balance,84,37,47
8160,Suprachybre,arathi,1662,druid,balance,48,31,17
8161,Sanaponic,burning-legion,1660,druid,balance,40,26,14
8162,Shapeshift,sanguino,1659,druid,balance,62,34,28
8163,Suevlaki,ragnaros,1658,druid,balance,108,68,40
8164,Møømøø,tarren-mill,1658,druid,balance,30,18,12
8165,Nönö,tarren-mill,1657,druid,balance,36,21,15
8166,Bàrathrum,blackrock,1657,druid,balance,48,27,21
8167,Jamzydruid,kazzak,1657,druid,balance,72,37,35
8168,Кектахан,soulflayer,1656,druid,balance,30,20,10
8169,Bøllemís,silvermoon,1655,druid,balance,30,19,11
8170,Hotsincee,stormscale,1654,druid,balance,157,85,72
8171,Superdr,ragnaros,1653,druid,balance,28,21,7
8172,Svend,kazzak,1653,druid,balance,59,36,23
8173,Shreedex,blackmoore,1651,druid,balance,66,41,25
8174,Chøpzjr,blackrock,1651,druid,balance,48,27,21
8175,Сибирячечка,greymane,1651,druid,balance,116,61,55
8176,Pewpewdruid,blackmoore,1650,druid,balance,144,79,65
8177,Opathecool,bladefist,1649,druid,balance,35,25,10
8178,Trinket,frostmane,1648,druid,balance,42,30,12
8179,Troc,karazhan,1648,druid,balance,30,21,9
8180,Beanery,aegwynn,1648,druid,balance,36,24,12
8181,Macron,terokkar,1648,druid,balance,64,35,29
8182,Kabòöóm,outland,1647,druid,balance,42,25,17
8183,Cantdonothig,ravencrest,1646,druid,balance,245,130,115
8184,Ampdru,ravencrest,1644,druid,balance,23,18,5
8185,Hyunâ,dalaran,1644,druid,balance,48,30,18
8186,Twitchmoney,archimonde,1643,druid,balance,32,24,8
8187,Øffroadz,blackmoore,1643,druid,balance,30,20,10
8188,Holziger,azshara,1643,druid,balance,51,32,19
8189,Kittenmitten,ragnaros,1643,druid,balance,130,76,54
8190,Spaceshift,magtheridon,1643,druid,balance,132,77,55
8191,Мэдикейт,gordunni,1643,druid,balance,72,39,33
8192,Ibuyicecream,outland,1642,druid,balance,89,55,34
8193,Milantu,antonidas,1642,druid,balance,30,18,12
8194,Pradasurge,ravencrest,1642,druid,balance,149,81,68
8195,Ploho,blackmoore,1642,druid,balance,39,19,20
8196,Laødinay,hyjal,1641,druid,balance,54,30,24
8197,Фигарофигаро,gordunni,1641,druid,balance,66,35,31
8198,Xoap,kazzak,1640,druid,balance,30,21,9
8199,Loethen,argent-dawn,1640,druid,balance,76,51,25
8200,Gstahr,taerar,1640,druid,balance,82,47,35
8201,Cønvokê,tarren-mill,1640,druid,balance,64,34,30
8202,Хотдиллер,howling-fjord,1639,druid,balance,30,20,10
8203,Cupoftea,drakthul,1639,druid,balance,95,58,37
8204,Zapx,hyjal,1639,druid,balance,90,50,40
8205,Drutro,hellfire,1639,druid,balance,54,27,27
8206,Meganfoxdq,sanguino,1638,druid,balance,82,53,29
8207,ßoom,antonidas,1638,druid,balance,65,34,31
8208,Ymagyne,frostmane,1638,druid,balance,44,23,21
8209,Shiftcaster,ravencrest,1638,druid,balance,48,22,26
8210,Obrys,tarren-mill,1637,druid,balance,42,21,21
8211,Gotnaga,silvermoon,1636,druid,balance,30,20,10
8212,Grafíx,blackrock,1636,druid,balance,30,18,12
8213,Derfaï,kaelthas,1636,druid,balance,41,21,20
8214,Balencìága,sanguino,1635,druid,balance,47,30,17
8215,Gretathnberg,ravencrest,1635,druid,balance,38,20,18
8216,Ðevilwhite,nemesis,1635,druid,balance,50,20,30
8217,Deví,twilights-hammer,1634,druid,balance,48,30,18
8218,Gentle,tarren-mill,1634,druid,balance,38,22,16
8219,Bobcup,tarren-mill,1634,druid,balance,97,55,42
8220,Naturalbeef,argent-dawn,1634,druid,balance,40,22,18
8221,Naicy,khaz-modan,1633,druid,balance,42,24,18
8222,Frodds,grim-batol,1632,druid,balance,75,53,22
8223,Óffstér,kazzak,1632,druid,balance,72,22,50
8224,Knuffle,eredar,1631,druid,balance,82,52,30
8225,Rystafarian,kazzak,1631,druid,balance,38,22,16
8226,Valgo,twisting-nether,1631,druid,balance,36,20,16
8227,Bøøstèdtréè,ravencrest,1631,druid,balance,132,69,63
8228,Moffwastaken,kazzak,1631,druid,balance,219,111,108
8229,Masakrelol,sanguino,1631,druid,balance,36,18,18
8230,Felysae,kazzak,1630,druid,balance,24,17,7
8231,Klßa,grim-batol,1630,druid,balance,30,21,9
8232,Myllymatti,frostwhisper,1630,druid,balance,36,21,15
8233,Squirtdogx,drakthul,1630,druid,balance,30,17,13
8234,Feralenjoyer,drakthul,1630,druid,balance,30,17,13
8235,Жизэ,galakrond,1629,druid,balance,62,39,23
8236,Боблерсс,gordunni,1629,druid,balance,36,21,15
8237,Porzi,eredar,1628,druid,balance,84,51,33
8238,Saqartvelo,tarren-mill,1628,druid,balance,60,34,26
8239,Izzual,tarren-mill,1628,druid,balance,36,20,16
8240,Èøèøèøèøè,stormscale,1627,druid,balance,18,17,1
8241,Сансплэш,lich-king,1627,druid,balance,30,24,6
8242,Ðréws,ravencrest,1627,druid,balance,30,19,11
8243,Pikamoo,kazzak,1627,druid,balance,35,20,15
8244,Зенза,howling-fjord,1627,druid,balance,60,33,27
8245,Møønhorn,nemesis,1627,druid,balance,137,75,62
8246,Vulkayn,ysondre,1627,druid,balance,42,22,20
8247,Jaycutler,archimonde,1627,druid,balance,72,36,36
8248,Séxycàt,ravencrest,1626,druid,balance,141,78,63
8249,Иггдрасиль,gordunni,1625,druid,balance,103,61,42
8250,Amøveo,draenor,1625,druid,balance,48,25,23
8251,Dakotaboomer,ravencrest,1624,druid,balance,30,17,13
8252,Kkona,silvermoon,1624,druid,balance,77,41,36
8253,Ipsdray,ysondre,1623,druid,balance,48,31,17
8254,Deßradator,stormscale,1623,druid,balance,42,25,17
8255,Çhîñêséðrüîð,kazzak,1623,druid,balance,36,21,15
8256,Hirmo,ragnaros,1623,druid,balance,52,30,22
8257,Grisdrood,ragnaros,1623,druid,balance,54,31,23
8258,Kittyexpress,arygos,1623,druid,balance,48,25,23
8259,Elatadru,silvermoon,1623,druid,balance,42,21,21
8260,Rassia,blackrock,1622,druid,balance,60,39,21
8261,Храш,gordunni,1622,druid,balance,29,18,11
8262,Yosimoo,draenor,1622,druid,balance,72,43,29
8263,Baboss,chogall,1622,druid,balance,60,31,29
8264,Слоич,howling-fjord,1622,druid,balance,158,76,82
8265,Merfje,karazhan,1622,druid,balance,36,17,19
8266,Valijan,blackrock,1622,druid,balance,40,18,22
8267,Светдру,blackscar,1621,druid,balance,24,17,7
8268,Nizkul,dun-modr,1621,druid,balance,67,36,31
8269,Malvakten,kazzak,1621,druid,balance,194,94,100
8270,Cyclønegodxd,dentarg,1620,druid,balance,57,40,17
8271,Thundruid,archimonde,1620,druid,balance,30,18,12
8272,Kåmen,ravenholdt,1620,druid,balance,91,53,38
8273,Rasgath,kazzak,1620,druid,balance,285,157,128
8274,Moonzysunzy,sylvanas,1620,druid,balance,36,17,19
8275,Landesverrat,kazzak,1619,druid,balance,24,21,3
8276,Rosskemp,tarren-mill,1619,druid,balance,24,17,7
8277,Døttore,garona,1619,druid,balance,122,63,59
8278,Whisker,outland,1618,druid,balance,24,17,7
8279,Youngdinozzo,dalaran,1618,druid,balance,35,23,12
8280,Xora,aegwynn,1618,druid,balance,38,23,15
8281,Takemanstwix,ragnaros,1618,druid,balance,42,25,17
8282,Damigjat,sylvanas,1618,druid,balance,215,123,92
8283,Xenuss,kazzak,1618,druid,balance,42,23,19
8284,Thielyy,blackmoore,1618,druid,balance,89,48,41
8285,Pøpp,archimonde,1618,druid,balance,41,22,19
8286,Mendorin,stormrage,1618,druid,balance,69,36,33
8287,Аласторвов,deathweaver,1618,druid,balance,118,57,61
8288,Ícekiss,hyjal,1617,druid,balance,30,24,6
8289,Zì,stormscale,1617,druid,balance,54,31,23
8290,Ryuzu,aegwynn,1616,druid,balance,79,45,34
8291,Fabuboomy,blackrock,1616,druid,balance,30,17,13
8292,Alessàsavage,nemesis,1616,druid,balance,36,18,18
8293,Pumpingurass,twisting-nether,1615,druid,balance,24,17,7
8294,Xirbtihs,stormscale,1615,druid,balance,50,32,18
8295,Djsnigel,stormscale,1615,druid,balance,35,22,13
8296,Âlhajillo,dun-modr,1615,druid,balance,30,17,13
8297,Klørfem,draenor,1614,druid,balance,36,21,15
8298,Happybear,outland,1613,druid,balance,63,46,17
8299,Hollymedx,blackmoore,1613,druid,balance,98,57,41
8300,Horadruid,silvermoon,1613,druid,balance,268,147,121
8301,Gòrgoth,pozzo-delleternità,1613,druid,balance,42,23,19
8302,Pawel,defias-brotherhood,1613,druid,balance,125,67,58
8303,Exilara,twisting-nether,1612,druid,balance,61,38,23
8304,Kubzii,archimonde,1612,druid,balance,90,48,42
8305,Teaser,dun-modr,1612,druid,balance,66,35,31
8306,Бонони,booty-bay,1612,druid,balance,102,51,51
8307,Rá,outland,1611,druid,balance,32,22,10
8308,Pëchy,aggra-português,1611,druid,balance,66,39,27
8309,Mianmar,silvermoon,1610,druid,balance,149,92,57
8310,Åkømo,aegwynn,1610,druid,balance,36,21,15
8311,Deadmeøw,outland,1609,druid,balance,34,21,13
8312,Vitaex,blackrock,1608,druid,balance,33,23,10
8313,Boomykush,twisting-nether,1608,druid,balance,74,42,32
8314,Kl,archimonde,1608,druid,balance,114,53,61
8315,Doncy,ragnaros,1607,druid,balance,54,24,30
8316,Sqoopy,tarren-mill,1606,druid,balance,36,27,9
8317,Alethorn,twisting-nether,1606,druid,balance,43,30,13
8318,Ryng,nagrand,1606,druid,balance,60,41,19
8319,Ахаххаха,howling-fjord,1606,druid,balance,42,26,16
8320,Lillevän,tarren-mill,1606,druid,balance,30,18,12
8321,Noou,aegwynn,1606,druid,balance,46,25,21
8322,Scamlafsen,ragnaros,1606,druid,balance,42,22,20
8323,Dharli,stormscale,1606,druid,balance,60,27,33
8324,Neverpanic,stormscale,1605,druid,balance,30,21,9
8325,Hillarious,blackmoore,1605,druid,balance,111,65,46
8326,Auches,argent-dawn,1605,druid,balance,42,22,20
8327,Isylia,twisting-nether,1605,druid,balance,72,36,36
8328,Owenwilson,twisting-nether,1604,druid,balance,36,22,14
8329,Rode,magtheridon,1604,druid,balance,129,75,54
8330,Grisdrood,draenor,1604,druid,balance,221,111,110
8331,Duis,twilights-hammer,1603,druid,balance,80,44,36
8332,Winarchikxxl,tarren-mill,1603,druid,balance,217,115,102
8333,Alamâ,madmortem,1603,druid,balance,48,21,27
8334,Pròtodrù,twisting-nether,1602,druid,balance,30,18,12
8335,Dematos,forscherliga,1602,druid,balance,114,68,46
8336,Cptsponksa,tarren-mill,1602,druid,balance,106,60,46
8337,Arecsne,turalyon,1602,druid,balance,85,45,40
8338,Nomilkforyou,steamwheedle-cartel,1601,druid,balance,63,39,24
8339,Niul,aegwynn,1601,druid,balance,146,83,63
8340,Aenrolz,hyjal,1600,druid,balance,30,21,9
8341,Goom,rexxar,1600,druid,balance,214,124,90
8342,Deepqt,kargath,1600,druid,balance,66,36,30
8343,Mopferal,twisting-nether,1599,druid,balance,36,28,8
8344,Стампид,blackscar,1599,druid,balance,127,76,51
8345,Featherfeet,kazzak,1599,druid,balance,48,22,26
8346,Bigtouch,draenor,1597,druid,balance,54,31,23
8347,Siajin,frostwolf,1597,druid,balance,30,17,13
8348,Saltymoo,tarren-mill,1597,druid,balance,53,30,23
8349,Pitbull,archimonde,1597,druid,balance,72,38,34
8350,Zonsy,twisting-nether,1597,druid,balance,60,28,32
8351,Wísh,stormscale,1596,druid,balance,36,23,13
8352,Phobidru,thrall,1595,druid,balance,30,19,11
8353,Stinkyicky,sylvanas,1594,druid,balance,60,38,22
8354,Malaprljavca,kazzak,1594,druid,balance,67,40,27
8355,Hashishi,grim-batol,1594,druid,balance,72,40,32
8356,Zømßie,outland,1594,druid,balance,102,56,46
8357,Malfurien,magtheridon,1593,druid,balance,30,17,13
8358,Àspro,hyjal,1591,druid,balance,42,21,21
8359,Rwq,outland,1590,druid,balance,57,30,27
8360,Муниня,gordunni,1589,druid,balance,78,45,33
8361,Ôp,aegwynn,1589,druid,balance,65,31,34
8362,Truffleßuttr,kazzak,1587,druid,balance,30,17,13
8363,Xä,bloodscalp,1587,druid,balance,159,86,73
8364,Veyronn,burning-legion,1586,druid,balance,48,25,23
8365,Magnusson,shadowsong,1585,druid,balance,90,59,31
8366,Convokeboost,archimonde,1581,druid,balance,235,136,99
8367,Monkeynight,ambossar,1581,druid,balance,41,22,19
8368,Vaacku,stormreaver,1581,druid,balance,64,34,30
8369,Hotdóts,outland,1580,druid,balance,30,20,10
8370,Zevis,outland,1580,druid,balance,126,65,61
8371,Borderliner,blackrock,1576,druid,balance,48,29,19
8372,Goüsta,archimonde,1576,druid,balance,60,35,25
8373,Ittei,korgall,1575,druid,balance,36,22,14
8374,Amoveo,argent-dawn,1574,druid,balance,56,31,25
8375,Mjáy,tarren-mill,1574,druid,balance,36,19,17
8376,Brainjuice,blackrock,1574,druid,balance,36,19,17
8377,Redlung,outland,1573,druid,balance,30,18,12
8378,Nevermeldx,blackrock,1573,druid,balance,29,17,12
8379,Merawr,ravencrest,1573,druid,balance,129,66,63
8380,Nctmé,tarren-mill,1573,druid,balance,35,17,18
8381,Aègon,ravencrest,1572,druid,balance,89,53,36
8382,Kolt,rajaxx,1571,druid,balance,86,47,39
8383,Wildanomaly,argent-dawn,1571,druid,balance,94,51,43
8384,Diggear,doomhammer,1570,druid,balance,30,21,9
8385,Halouest,archimonde,1570,druid,balance,77,42,35
8386,Bôoze,nathrezim,1569,druid,balance,36,19,17
8387,Notmyfriend,sylvanas,1568,druid,balance,47,32,15
8388,Azurai,blackmoore,1567,druid,balance,72,38,34
8389,Kalthazar,twisting-nether,1567,druid,balance,36,19,17
8390,Topfrag,outland,1566,druid,balance,42,22,20
8391,Gibsx,blackmoore,1564,druid,balance,30,21,9
8392,Elodìa,antonidas,1561,druid,balance,30,21,9
8393,Synexi,sylvanas,1560,druid,balance,36,21,15
8394,Maelkan,sanguino,1560,druid,balance,132,68,64
8395,Hotlife,ravencrest,1559,druid,balance,55,29,26
8396,Starcrash,amanthul,1559,druid,balance,60,28,32
8397,Ðelix,ysera,1558,druid,balance,62,37,25
8398,Insølitø,sanguino,1558,druid,balance,99,57,42
8399,Newdudu,draenor,1557,druid,balance,53,30,23
8400,Sequisha,tarren-mill,1555,druid,balance,30,17,13
8401,Hackamore,archimonde,1555,druid,balance,115,61,54
8402,Rédbull,outland,1554,druid,balance,148,81,67
8403,Inkibek,burning-blade,1553,druid,balance,102,64,38
8404,Урркке,soulflayer,1552,druid,balance,48,29,19
8405,Legyna,ravencrest,1552,druid,balance,39,20,19
8406,Rivenx,ravencrest,1551,druid,balance,53,32,21
8407,Obsessíon,kazzak,1551,druid,balance,48,24,24
8408,Баттнэйкед,gordunni,1551,druid,balance,83,41,42
8409,Nixhot,blackmoore,1550,druid,balance,30,17,13
8410,Wildmistake,argent-dawn,1550,druid,balance,35,17,18
8411,Uptoyou,defias-brotherhood,1549,druid,balance,77,45,32
8412,Potatodru,ragnaros,1549,druid,balance,30,17,13
8413,Бамболони,gordunni,1548,druid,balance,92,56,36
8414,Muhz,nathrezim,1548,druid,balance,70,39,31
8415,Moonwatcher,blackrock,1548,druid,balance,188,103,85
8416,Грибомания,soulflayer,1548,druid,balance,35,18,17
8417,Majokz,ravencrest,1547,druid,balance,74,37,37
8418,Threesixnìne,dun-morogh,1547,druid,balance,65,25,40
8419,Brokul,kazzak,1546,druid,balance,54,29,25
8420,Кыцко,soulflayer,1546,druid,balance,63,32,31
8421,Wykked,outland,1545,druid,balance,42,18,24
8422,Angelinax,silvermoon,1544,druid,balance,35,19,16
8423,Frikolina,outland,1543,druid,balance,98,49,49
8424,Krosanx,outland,1542,druid,balance,30,17,13
8425,Moler,hyjal,1541,druid,balance,67,43,24
8426,Maaw,tarren-mill,1541,druid,balance,48,27,21
8427,Gretl,blackrock,1541,druid,balance,60,30,30
8428,Zhof,ravencrest,1540,druid,balance,130,63,67
8429,Algír,argent-dawn,1539,druid,balance,107,53,54
8430,Chadru,magtheridon,1538,druid,balance,68,36,32
8431,Lazerbinks,blackmoore,1536,druid,balance,29,18,11
8432,Jazzme,aegwynn,1535,druid,balance,24,16,8
8433,Elfsu,ravencrest,1534,druid,balance,54,36,18
8434,Buurzalbai,drakthul,1534,druid,balance,66,34,32
8435,Druidflight,ravencrest,1534,druid,balance,48,24,24
8436,Gorthunx,kazzak,1533,druid,balance,40,26,14
8437,Køßÿ,ysondre,1533,druid,balance,30,19,11
8438,Хастла,galakrond,1532,druid,balance,30,18,12
8439,Suitti,ravencrest,1532,druid,balance,29,17,12
8440,Грандал,howling-fjord,1532,druid,balance,66,30,36
8441,Thaeris,outland,1531,druid,balance,28,17,11
8442,Mindruid,kazzak,1531,druid,balance,30,18,12
8443,Chavinelf,twisting-nether,1530,druid,balance,30,16,14
8444,Анестезий,soulflayer,1529,druid,balance,66,48,18
8445,Catten,sylvanas,1529,druid,balance,30,17,13
8446,Whiskers,emerald-dream,1529,druid,balance,84,44,40
8447,Heiden,terokkar,1528,druid,balance,24,16,8
8448,Ljóskan,kazzak,1528,druid,balance,36,16,20
8449,Brandyballix,twisting-nether,1526,druid,balance,116,58,58
8450,Migami,nemesis,1526,druid,balance,36,18,18
8451,Crazzimus,tarren-mill,1525,druid,balance,36,21,15
8452,Utiniutini,thrall,1525,druid,balance,33,19,14
8453,Leathy,eredar,1524,druid,balance,60,35,25
8454,Silvix,blackrock,1524,druid,balance,54,28,26
8455,Lisbethqt,nemesis,1523,druid,balance,24,16,8
8456,Chillerin,draenor,1523,druid,balance,54,31,23
8457,Healol,sanguino,1523,druid,balance,75,42,33
8458,Seboom,outland,1522,druid,balance,123,69,54
8459,Crackfat,stormscale,1521,druid,balance,52,34,18
8460,Bagginston,nazjatar,1521,druid,balance,38,20,18
8461,Sofiadrood,stormreaver,1520,druid,balance,24,16,8
8462,Chansnax,thrall,1519,druid,balance,58,32,26
8463,Exca,stormscale,1519,druid,balance,54,28,26
8464,Gløbal,antonidas,1518,druid,balance,33,19,14
8465,Lyø,draenor,1518,druid,balance,112,64,48
8466,Endoplazmik,silvermoon,1518,druid,balance,96,50,46
8467,Milkywáys,draenor,1518,druid,balance,142,70,72
8468,Nøny,gorgonnash,1517,druid,balance,69,40,29
8469,Rilak,nordrassil,1517,druid,balance,112,61,51
8470,Ylmh,archimonde,1516,druid,balance,24,16,8
8471,Elrroir,dun-modr,1516,druid,balance,42,24,18
8472,Feralspîrît,outland,1516,druid,balance,30,17,13
8473,Telbo,ravencrest,1516,druid,balance,89,48,41
8474,Likwidator,stormscale,1514,druid,balance,116,66,50
8475,Schannine,archimonde,1513,druid,balance,41,20,21
8476,Jerie,silvermoon,1512,druid,balance,24,16,8
8477,Czarnykocur,burning-legion,1512,druid,balance,108,62,46
8478,Lèafy,silvermoon,1511,druid,balance,43,26,17
8479,Shedzokey,tarren-mill,1511,druid,balance,66,39,27
8480,Opla,nethersturm,1510,druid,balance,40,27,13
8481,Metzarqq,stormscale,1510,druid,balance,24,16,8
8482,Saabeq,hyjal,1509,druid,balance,50,28,22
8483,Ðrpressure,blackrock,1508,druid,balance,120,72,48
8484,Abercrombx,thrall,1508,druid,balance,44,26,18
8485,Calambius,blackhand,1508,druid,balance,66,31,35
8486,Ashkaxx,ragnaros,1507,druid,balance,64,35,29
8487,Rhaf,argent-dawn,1507,druid,balance,150,82,68
8488,Pórts,kazzak,1507,druid,balance,42,20,22
8489,Druidka,grim-batol,1507,druid,balance,42,20,22
8490,Andjuga,doomhammer,1506,druid,balance,130,62,68
8491,Fransman,sylvanas,1505,druid,balance,53,25,28
8492,Gurudru,tarren-mill,1505,druid,balance,108,47,61
8493,Ayamiss,outland,1504,druid,balance,30,16,14
8494,Whythis,archimonde,1504,druid,balance,146,74,72
8495,Lasertipu,tarren-mill,1503,druid,balance,53,28,25
8496,Blackfür,sylvanas,1501,druid,balance,116,57,59
8497,Sagezza,draenor,1500,druid,balance,180,91,89
8498,Xqzmybleedz,onyxia,1499,druid,balance,38,24,14
8499,Skadruid,blackmoore,1499,druid,balance,60,30,30
8500,Trylune,blackmoore,1498,druid,balance,30,17,13
8501,Ezkatka,ravencrest,1497,druid,balance,24,16,8
8502,Nømat,defias-brotherhood,1497,druid,balance,149,86,63
8503,Karodoom,twisting-nether,1497,druid,balance,125,68,57
8504,Quorn,pozzo-delleternità,1497,druid,balance,70,34,36
8505,Sweetner,outland,1495,druid,balance,58,35,23
8506,Гнетея,howling-fjord,1494,druid,balance,59,33,26
8507,Surps,ravencrest,1494,druid,balance,30,16,14
8508,Carismatic,blackmoore,1494,druid,balance,224,116,108
8509,Slaughtér,stormscale,1491,druid,balance,30,22,8
8510,Dámøn,stormscale,1491,druid,balance,30,16,14
8511,Syremark,silvermoon,1491,druid,balance,48,21,27
8512,Woodzey,sylvanas,1489,druid,balance,36,18,18
8513,Kittyperry,blackmoore,1489,druid,balance,41,20,21
8514,Drutiful,outland,1486,druid,balance,54,24,30
8515,Sodapop,aszune,1485,druid,balance,114,64,50
8516,Smuktøs,twisting-nether,1484,druid,balance,63,43,20
8517,Strinx,ragnaros,1484,druid,balance,96,60,36
8518,Jejoueferal,chogall,1484,druid,balance,138,72,66
8519,Arkatt,outland,1482,druid,balance,36,24,12
8520,Seudoz,silvermoon,1482,druid,balance,48,29,19
8521,Pyqmi,stormscale,1479,druid,balance,36,23,13
8522,Yiradur,stormscale,1479,druid,balance,90,47,43
8523,Rât,blackmoore,1478,druid,balance,54,36,18
8524,Bëndover,uldaman,1478,druid,balance,36,23,13
8525,Demonbalance,silvermoon,1478,druid,balance,64,39,25
8526,Hållkäften,twisting-nether,1478,druid,balance,60,29,31
8527,Dingeren,stormscale,1473,druid,balance,30,19,11
8528,Epidemic,argent-dawn,1473,druid,balance,49,26,23
8529,Báco,dun-modr,1473,druid,balance,36,17,19
8530,Kbdd,outland,1472,druid,balance,36,16,20
8531,Boomalot,auchindoun,1471,druid,balance,54,31,23
8532,Prinzfarming,mugthol,1469,druid,balance,57,29,28
8533,Aetheris,varimathras,1469,druid,balance,62,29,33
8534,Mønrøe,ravencrest,1467,druid,balance,29,17,12
8535,Ddggss,ragnaros,1466,druid,balance,37,21,16
8536,Ziele,the-maelstrom,1465,druid,balance,40,23,17
8537,Bashfui,draenor,1465,druid,balance,132,69,63
8538,Pfandmalle,blackrock,1464,druid,balance,36,24,12
8539,Lashketchum,aszune,1463,druid,balance,42,27,15
8540,Sefinana,malganis,1463,druid,balance,132,60,72
8541,Wallaar,ragnaros,1463,druid,balance,36,16,20
8542,Vaizier,defias-brotherhood,1462,druid,balance,119,60,59
8543,Restouz,twisting-nether,1462,druid,balance,129,65,64
8544,Kroaxs,draenor,1461,druid,balance,157,87,70
8545,Meatwallet,defias-brotherhood,1460,druid,balance,47,27,20
8546,Skywíng,stormscale,1460,druid,balance,48,23,25
8547,Magiskeforme,draenor,1459,druid,balance,32,22,10
8548,Entas,kazzak,1459,druid,balance,36,24,12
8549,Asterism,stormscale,1459,druid,balance,129,71,58
8550,Kamzik,drakthul,1459,druid,balance,36,19,17
8551,Primdâhl,ravencrest,1459,druid,balance,60,31,29
8552,Fiomy,blackhand,1458,druid,balance,47,36,11
8553,Beefsteaxs,thrall,1458,druid,balance,30,22,8
8554,Teddyxbear,nefarian,1458,druid,balance,30,18,12
8555,Tawaraki,outland,1458,druid,balance,215,114,101
8556,Viverion,ravencrest,1458,druid,balance,92,47,45
8557,Almrudi,blackrock,1456,druid,balance,42,20,22
8558,Dabudi,kazzak,1455,druid,balance,57,32,25
8559,Мантоя,gordunni,1455,druid,balance,174,93,81
8560,Ånåphorå,archimonde,1454,druid,balance,33,16,17
8561,Кулунхе,soulflayer,1453,druid,balance,78,50,28
8562,Kuhgucci,blackmoore,1451,druid,balance,30,16,14
8563,Gúccî,blackrock,1450,druid,balance,30,22,8
8564,Fillet,aggra-português,1448,druid,balance,44,33,11
8565,Aik,gorgonnash,1448,druid,balance,60,30,30
8566,Mahist,archimonde,1447,druid,balance,54,31,23
8567,Кортанус,gordunni,1447,druid,balance,39,21,18
8568,Ciaolol,ragnaros,1443,druid,balance,30,19,11
8569,Eärendir,ravencrest,1442,druid,balance,223,111,112
8570,Dudana,argent-dawn,1441,druid,balance,48,29,19
8571,Duridlol,nemesis,1439,druid,balance,18,15,3
8572,Dudmæster,blackmoore,1439,druid,balance,33,18,15
8573,Lappe,stormreaver,1439,druid,balance,30,15,15
8574,Lacÿn,twisting-nether,1438,druid,balance,18,15,3
8575,Jatto,magtheridon,1438,druid,balance,36,20,16
8576,Vamix,aegwynn,1437,druid,balance,18,15,3
8577,Ferraridudux,ravencrest,1437,druid,balance,18,15,3
8578,Chángé,draenor,1437,druid,balance,36,23,13
8579,Shuffey,frostmane,1437,druid,balance,45,24,21
8580,Редмун,soulflayer,1436,druid,balance,104,55,49
8581,Néøu,archimonde,1434,druid,balance,24,15,9
8582,Duskdawn,xavius,1434,druid,balance,60,30,30
8583,Kørn,drakthul,1433,druid,balance,61,28,33
8584,Restromide,ravencrest,1432,druid,balance,30,15,15
8585,Mogi,pozzo-delleternità,1432,druid,balance,75,35,40
8586,Óðinn,stormscale,1431,druid,balance,18,15,3
8587,Tøyz,stormscale,1431,druid,balance,18,15,3
8588,Juvencus,twisting-nether,1431,druid,balance,24,15,9
8589,Chouwa,korgall,1431,druid,balance,65,38,27
8590,Drøøkîé,antonidas,1430,druid,balance,144,83,61
8591,Tonutc,sanguino,1430,druid,balance,51,25,26
8592,Elilith,auchindoun,1429,druid,balance,18,15,3
8593,Ibnform,archimonde,1429,druid,balance,18,15,3
8594,Jöggel,perenolde,1429,druid,balance,42,25,17
8595,Lxz,blackhand,1429,druid,balance,52,23,29
8596,Kazuid,argent-dawn,1428,druid,balance,38,24,14
8597,Vëgâñgøðx,ragnaros,1428,druid,balance,24,15,9
8598,Fouser,shattered-hand,1428,druid,balance,36,17,19
8599,Крейзикет,eversong,1427,druid,balance,24,15,9
8600,Keynn,kazzak,1427,druid,balance,72,33,39
8601,Fluffeh,doomhammer,1426,druid,balance,36,22,14
8602,Littleneo,ambossar,1426,druid,balance,53,25,28
8603,Dypas,chogall,1425,druid,balance,36,20,16
8604,Däkk,draenor,1425,druid,balance,72,32,40
8605,Smashella,pozzo-delleternità,1423,druid,balance,36,25,11
8606,Anabola,frostwhisper,1423,druid,balance,24,15,9
8607,Inghlo,blackmoore,1423,druid,balance,53,29,24
8608,Mørshac,blackrock,1422,druid,balance,24,15,9
8609,Wize,pozzo-delleternità,1422,druid,balance,56,27,29
8610,Bearcosby,burning-legion,1421,druid,balance,29,16,13
8611,Dantet,the-maelstrom,1421,druid,balance,30,15,15
8612,Petiteorange,archimonde,1420,druid,balance,24,16,8
8613,Малисеннта,gordunni,1420,druid,balance,42,21,21
8614,Reed,sylvanas,1420,druid,balance,30,15,15
8615,Applestrudle,blackrock,1420,druid,balance,54,24,30
8616,Екфта,gordunni,1419,druid,balance,36,18,18
8617,Kanataka,stormscale,1418,druid,balance,54,32,22
8618,Guthíx,silvermoon,1418,druid,balance,66,29,37
8619,Wazam,kazzak,1417,druid,balance,50,34,16
8620,Лардиан,gordunni,1417,druid,balance,30,15,15
8621,Lyøñ,dun-modr,1417,druid,balance,35,16,19
8622,Levéltetü,ragnaros,1416,druid,balance,24,15,9
8623,Storpboom,drakthul,1416,druid,balance,108,62,46
8624,Этъя,borean-tundra,1416,druid,balance,42,19,23
8625,Carebearlol,frostmane,1416,druid,balance,42,17,25
8626,Hauntie,kazzak,1413,druid,balance,42,24,18
8627,Hypam,archimonde,1413,druid,balance,42,19,23
8628,Chispiwini,cthun,1412,druid,balance,55,28,27
8629,Flippy,blackmoore,1412,druid,balance,110,54,56
8630,Traplordgen,outland,1411,druid,balance,24,15,9
8631,Layle,argent-dawn,1411,druid,balance,36,15,21
8632,Fruitdealer,antonidas,1410,druid,balance,42,23,19
8633,Anahots,silvermoon,1410,druid,balance,141,69,72
8634,Chúcky,twisting-nether,1409,druid,balance,91,50,41
8635,Paulskinbak,tarren-mill,1409,druid,balance,36,18,18
8636,Albás,kazzak,1407,druid,balance,18,15,3
8637,Izzi,arathor,1405,druid,balance,56,31,25
8638,Krtt,tarren-mill,1405,druid,balance,163,78,85
8639,Rbgbear,blackhand,1403,druid,balance,59,32,27
8640,Rrayed,kazzak,1402,druid,balance,64,42,22
8641,Hisoca,tarren-mill,1402,druid,balance,108,60,48
8642,Itadorikun,silvermoon,1401,druid,balance,71,41,30
8643,Elonax,eredar,1400,druid,balance,44,28,16
8644,Çãm,magtheridon,1399,druid,balance,24,16,8
8645,Kielorn,stormscale,1399,druid,balance,30,16,14
8646,Xyiz,ravencrest,1399,druid,balance,80,42,38
8647,Матумбо,razuvious,1399,druid,balance,302,149,153
8648,Fleq,antonidas,1397,druid,balance,65,34,31
8649,Ilovedruid,forscherliga,1397,druid,balance,52,27,25
8650,Ramgis,sanguino,1397,druid,balance,36,17,19
8651,Weisslogia,aegwynn,1397,druid,balance,71,33,38
8652,Druidboss,tarren-mill,1396,druid,balance,90,50,40
8653,Nujus,kazzak,1394,druid,balance,30,15,15
8654,Puppen,alakir,1392,druid,balance,24,15,9
8655,Kénshin,blackhand,1392,druid,balance,30,15,15
8656,Fluffykin,defias-brotherhood,1391,druid,balance,36,21,15
8657,Кашаган,howling-fjord,1391,druid,balance,69,39,30
8658,Anhoq,silvermoon,1391,druid,balance,64,33,31
8659,Жибка,howling-fjord,1391,druid,balance,44,21,23
8660,Шубаиздуба,howling-fjord,1390,druid,balance,72,38,34
8661,Buhuu,blackmoore,1390,druid,balance,98,50,48
8662,Natoro,outland,1389,druid,balance,36,19,17
8663,Pantheraa,twisting-nether,1388,druid,balance,55,35,20
8664,Cowárd,blackmoore,1388,druid,balance,38,18,20
8665,Couleaf,stormscale,1387,druid,balance,31,22,9
8666,Zhyra,arathor,1387,druid,balance,36,19,17
8667,Icetep,sargeras,1386,druid,balance,60,30,30
8668,Arrakiz,sanguino,1385,druid,balance,59,41,18
8669,Джоннчек,gordunni,1385,druid,balance,46,29,17
8670,Catsgomeow,outland,1382,druid,balance,54,27,27
8671,Drazefin,twisting-nether,1382,druid,balance,42,15,27
8672,Мурдермашин,deathguard,1381,druid,balance,36,15,21
8673,Convoke,burning-legion,1380,druid,balance,42,18,24
8674,Brujo,azjolnerub,1379,druid,balance,36,15,21
8675,Salseo,uldum,1377,druid,balance,72,46,26
8676,Boomzter,frostmane,1376,druid,balance,42,20,22
8677,Rexiehunty,aszune,1376,druid,balance,59,28,31
8678,Karolg,tyrande,1376,druid,balance,69,30,39
8679,Данилсахарок,soulflayer,1376,druid,balance,47,20,27
8680,Farmerone,tarren-mill,1373,druid,balance,96,54,42
8681,Тёмныйзверь,borean-tundra,1373,druid,balance,84,43,41
8682,Aliandrel,teldrassil,1372,druid,balance,42,27,15
8683,Megaball,sylvanas,1372,druid,balance,72,44,28
8684,Jarko,ysondre,1372,druid,balance,104,46,58
8685,Оудин,blackscar,1371,druid,balance,36,21,15
8686,Neova,dun-modr,1371,druid,balance,57,29,28
8687,Pø,blackrock,1371,druid,balance,59,26,33
8688,Owlcápown,ravencrest,1370,druid,balance,30,15,15
8689,Mayhh,ragnaros,1369,druid,balance,143,79,64
8690,Patchlølx,blackmoore,1367,druid,balance,51,31,20
8691,Chrîslol,twisting-nether,1366,druid,balance,103,49,54
8692,Arreton,silvermoon,1365,druid,balance,22,15,7
8693,Shìrò,kelthuzad,1365,druid,balance,48,24,24
8694,Альмазар,lich-king,1364,druid,balance,76,40,36
8695,Jaile,burning-legion,1363,druid,balance,28,18,10
8696,Heanra,frostmane,1363,druid,balance,35,22,13
8697,Ðiàblos,nemesis,1363,druid,balance,72,41,31
8698,Yungle,stormscale,1363,druid,balance,48,20,28
8699,Druiddamage,the-maelstrom,1362,druid,balance,224,117,107
8700,Ketama,sylvanas,1362,druid,balance,60,30,30
8701,Irishdemón,ravencrest,1360,druid,balance,90,47,43
8702,Vulyr,outland,1359,druid,balance,107,57,50
8703,Aryitu,blackrock,1357,druid,balance,62,33,29
8704,Catmøm,blackmoore,1357,druid,balance,94,47,47
8705,Амахасла,deathweaver,1356,druid,balance,67,38,29
8706,Kermit,die-aldor,1356,druid,balance,90,42,48
8707,Nyetoo,dun-modr,1355,druid,balance,85,38,47
8708,Ennelle,silvermoon,1353,druid,balance,38,23,15
8709,Endoth,blackrock,1352,druid,balance,38,20,18
8710,Mercmydude,ravencrest,1351,druid,balance,93,44,49
8711,Zhroomx,blackmoore,1351,druid,balance,44,20,24
8712,Xclonedotcom,aegwynn,1348,druid,balance,42,27,15
8713,Druidere,outland,1348,druid,balance,66,32,34
8714,Freakyo,blackrock,1347,druid,balance,29,15,14
8715,Bum,ravencrest,1344,druid,balance,18,14,4
8716,Divref,tarren-mill,1343,druid,balance,18,14,4
8717,Corrupthz,outland,1343,druid,balance,27,16,11
8718,Broxisqt,blackrock,1343,druid,balance,24,14,10
8719,Wenciorek,kazzak,1343,druid,balance,36,17,19
8720,Suppencaster,frostwolf,1342,druid,balance,18,14,4
8721,Heav,kiljaeden,1342,druid,balance,29,19,10
8722,Pôpcorn,ragnaros,1342,druid,balance,54,33,21
8723,Kissachtak,blackrock,1341,druid,balance,18,14,4
8724,Kuraina,the-maelstrom,1341,druid,balance,18,14,4
8725,Ноунэймбич,blackscar,1341,druid,balance,24,14,10
8726,Huxleyys,draenor,1339,druid,balance,24,14,10
8727,Santoniq,dun-morogh,1339,druid,balance,162,79,83
8728,Shiffe,argent-dawn,1338,druid,balance,24,14,10
8729,Doublesunday,thrall,1338,druid,balance,27,15,12
8730,Kittyboomy,burning-blade,1338,druid,balance,69,33,36
8731,Rifthy,nemesis,1337,druid,balance,24,14,10
8732,Insanexp,antonidas,1336,druid,balance,19,14,5
8733,Nuqa,thrall,1336,druid,balance,21,15,6
8734,Bazikk,kazzak,1336,druid,balance,58,41,17
8735,Illebra,defias-brotherhood,1336,druid,balance,24,14,10
8736,Chrevarraige,saurfang,1334,druid,balance,192,99,93
8737,Tigerroll,kazzak,1334,druid,balance,30,14,16
8738,Beamgødx,thrall,1333,druid,balance,22,15,7
8739,Забурсчу,howling-fjord,1333,druid,balance,30,20,10
8740,Wizår,outland,1332,druid,balance,18,14,4
8741,When,kirin-tor,1332,druid,balance,55,27,28
8742,Strix,dun-modr,1332,druid,balance,36,14,22
8743,Soward,la-croisade-écarlate,1331,druid,balance,38,17,21
8744,Deetaa,eredar,1330,druid,balance,24,14,10
8745,Barbielolz,archimonde,1330,druid,balance,24,14,10
8746,Stìck,archimonde,1330,druid,balance,65,34,31
8747,Stêvé,silvermoon,1329,druid,balance,74,43,31
8748,Kunya,tarren-mill,1329,druid,balance,116,55,61
8749,Mirikastiko,korgall,1328,druid,balance,24,14,10
8750,Ralffoosa,auchindoun,1328,druid,balance,24,14,10
8751,Древогрут,howling-fjord,1325,druid,balance,18,14,4
8752,Birb,archimonde,1325,druid,balance,29,17,12
8753,Kâllîsto,eredar,1325,druid,balance,30,14,16
8754,Cráck,nagrand,1324,druid,balance,28,15,13
8755,Fruntimmern,sylvanas,1323,druid,balance,24,14,10
8756,Экстазиус,borean-tundra,1321,druid,balance,42,14,28
8757,Shag,archimonde,1319,druid,balance,36,17,19
8758,Lucidx,blackrock,1319,druid,balance,54,20,34
8759,Rinjindin,eredar,1318,druid,balance,48,25,23
8760,Кекичшрекич,soulflayer,1318,druid,balance,54,25,29
8761,Wildthing,blackmoore,1316,druid,balance,44,25,19
8762,Srkameltouss,sanguino,1315,druid,balance,18,14,4
8763,Pavesino,nemesis,1315,druid,balance,24,15,9
8764,Kimba,onyxia,1315,druid,balance,66,36,30
8765,Bløødax,hyjal,1315,druid,balance,136,64,72
8766,Fejgi,stormreaver,1314,druid,balance,48,29,19
8767,Fäcker,blackhand,1313,druid,balance,48,27,21
8768,Hideinbushh,ravencrest,1309,druid,balance,20,15,5
8769,Усыильвиры,soulflayer,1309,druid,balance,30,14,16
8770,Zzblaah,archimonde,1309,druid,balance,42,15,27
8771,Yomosh,eredar,1308,druid,balance,39,19,20
8772,Губкобоб,galakrond,1307,druid,balance,34,16,18
8773,Buffmeplz,medivh,1304,druid,balance,24,15,9
8774,Solarian,ravencrest,1304,druid,balance,42,26,16
8775,Toondog,doomhammer,1303,druid,balance,24,14,10
8776,Cieniuu,burning-legion,1302,druid,balance,24,16,8
8777,Шадарлогот,gordunni,1300,druid,balance,90,52,38
8778,Æîîs,blackrock,1300,druid,balance,104,53,51
8779,Sazo,elune,1300,druid,balance,28,14,14
8780,Transformerr,silvermoon,1300,druid,balance,54,25,29
8781,Fantaclause,tarren-mill,1298,druid,balance,194,95,99
8782,Snedden,silvermoon,1298,druid,balance,31,14,17
8783,Zeifana,khaz-modan,1297,druid,balance,30,18,12
8784,Oiseth,tarren-mill,1297,druid,balance,78,36,42
8785,Callmev,hyjal,1294,druid,balance,18,14,4
8786,Tubi,darksorrow,1292,druid,balance,30,16,14
8787,Aastal,uldaman,1292,druid,balance,37,15,22
8788,Lindémann,blackhand,1291,druid,balance,44,30,14
8789,Ðãddy,ravencrest,1291,druid,balance,38,24,14
8790,Forestrun,sylvanas,1287,druid,balance,48,30,18
8791,Nakkikastike,magtheridon,1287,druid,balance,36,19,17
8792,Quiksx,blackrock,1286,druid,balance,43,20,23
8793,Ralokian,drakthul,1285,druid,balance,53,34,19
8794,Zindaya,blades-edge,1284,druid,balance,32,16,16
8795,Shaize,dalaran,1283,druid,balance,26,17,9
8796,Scottparker,sylvanas,1282,druid,balance,36,24,12
8797,Fhi,antonidas,1281,druid,balance,42,23,19
8798,Hadoukan,ravencrest,1281,druid,balance,41,22,19
8799,Trydru,blackmoore,1281,druid,balance,90,46,44
8800,Forigiver,draenor,1280,druid,balance,24,14,10
8801,Myex,exodar,1280,druid,balance,30,14,16
8802,Smøuler,sanguino,1279,druid,balance,27,15,12
8803,Jeesman,sylvanas,1279,druid,balance,74,41,33
8804,Ххансолл,gordunni,1279,druid,balance,131,69,62
8805,Астраджет,gordunni,1279,druid,balance,30,15,15
8806,Seysso,silvermoon,1279,druid,balance,90,39,51
8807,Voorhess,blackmoore,1278,druid,balance,36,14,22
8808,Àlec,silvermoon,1276,druid,balance,132,72,60
8809,Droodfarm,hyjal,1275,druid,balance,70,37,33
8810,Disclaimed,twisting-nether,1274,druid,balance,26,15,11
8811,Meezy,ragnaros,1273,druid,balance,30,15,15
8812,Antiseptik,ysondre,1273,druid,balance,36,17,19
8813,Rektjin,stormscale,1273,druid,balance,42,17,25
8814,Slaskêt,tarren-mill,1272,druid,balance,22,14,8
8815,Revølter,kazzak,1272,druid,balance,32,15,17
8816,Wtcseven,eredar,1272,druid,balance,36,16,20
8817,Delmond,sylvanas,1272,druid,balance,50,21,29
8818,Àsúnâ,eredar,1272,druid,balance,42,15,27
8819,Chugs,draenor,1271,druid,balance,30,16,14
8820,Doomkin,tichondrius,1271,druid,balance,36,17,19
8821,Hardí,tarren-mill,1268,druid,balance,60,28,32
8822,Atbõs,stormscale,1267,druid,balance,29,16,13
8823,Duhdudu,thrall,1266,druid,balance,30,20,10
8824,Melyo,blackmoore,1265,druid,balance,36,21,15
8825,Caltvalai,ravencrest,1265,druid,balance,28,14,14
8826,Ohndankalan,kazzak,1265,druid,balance,48,20,28
8827,Tytankon,silvermoon,1264,druid,balance,73,32,41
8828,Petju,darksorrow,1262,druid,balance,48,21,27
8829,Toffyfee,anetheron,1260,druid,balance,38,25,13
8830,Bambøué,khaz-modan,1260,druid,balance,24,14,10
8831,Succee,stormscale,1259,druid,balance,90,47,43
8832,Achre,thunderhorn,1259,druid,balance,30,14,16
8833,Hushorde,twisting-nether,1259,druid,balance,48,17,31
8834,Bearhúg,kazzak,1258,druid,balance,35,15,20
8835,Braokhull,stormscale,1256,druid,balance,54,28,26
8836,Ваандри,gordunni,1255,druid,balance,24,16,8
8837,Rullader,draenor,1255,druid,balance,36,23,13
8838,Нэйроуз,howling-fjord,1254,druid,balance,95,49,46
8839,Medreas,argent-dawn,1253,druid,balance,71,46,25
8840,Whísperclaw,ravencrest,1253,druid,balance,60,31,29
8841,Demizeub,archimonde,1252,druid,balance,72,30,42
8842,Mascraxx,earthen-ring,1249,druid,balance,73,38,35
8843,Zuldram,uldaman,1249,druid,balance,29,14,15
8844,Киллиманжаро,howling-fjord,1249,druid,balance,116,55,61
8845,Tygra,blackrock,1248,druid,balance,18,13,5
8846,Slurmms,sylvanas,1248,druid,balance,126,75,51
8847,Iupa,silvermoon,1248,druid,balance,59,33,26
8848,Luphrekmeow,ravencrest,1247,druid,balance,18,13,5
8849,Lílpèëpgødx,archimonde,1247,druid,balance,18,13,5
8850,Jeaylqt,archimonde,1247,druid,balance,21,14,7
8851,Replicusowl,doomhammer,1247,druid,balance,24,13,11
8852,Rozi,draenor,1247,druid,balance,24,13,11
8853,Whêylon,ragnaros,1247,druid,balance,24,13,11
8854,Mariss25076F,chogall,1246,druid,balance,30,18,12
8855,Mazalot,kazzak,1246,druid,balance,25,14,11
8856,Beutow,archimonde,1246,druid,balance,30,13,17
8857,Xkirtach,dun-modr,1245,druid,balance,24,13,11
8858,Djràkèâlòt,ravencrest,1244,druid,balance,18,13,5
8859,Eranor,archimonde,1243,druid,balance,18,13,5
8860,Ateli,kazzak,1243,druid,balance,21,14,7
8861,Smittly,bloodhoof,1243,druid,balance,36,17,19
8862,Velnens,shattered-halls,1243,druid,balance,66,30,36
8863,Guccicken,garona,1242,druid,balance,18,13,5
8864,Clonorrhea,tarren-mill,1242,druid,balance,24,13,11
8865,Máedhros,ravencrest,1241,druid,balance,18,13,5
8866,Mahwi,das-konsortium,1241,druid,balance,18,13,5
8867,Vrill,kazzak,1241,druid,balance,99,51,48
8868,Füsselviech,frostwolf,1239,druid,balance,18,13,5
8869,Kikïnøu,garona,1239,druid,balance,24,13,11
8870,Fangornn,outland,1239,druid,balance,30,13,17
8871,Lunarveil,draenor,1236,druid,balance,24,13,11
8872,Morphael,ravencrest,1233,druid,balance,24,13,11
8873,Makelsi,tarren-mill,1233,druid,balance,29,14,15
8874,Amici,eredar,1232,druid,balance,24,13,11
8875,Мунмунмун,gordunni,1229,druid,balance,43,19,24
8876,Psycloniac,ravencrest,1228,druid,balance,24,13,11
8877,Oxox,defias-brotherhood,1227,druid,balance,24,14,10
8878,Ðoxi,draenor,1226,druid,balance,120,58,62
8879,Maurana,sylvanas,1225,druid,balance,30,13,17
8880,Sheâ,nemesis,1221,druid,balance,126,63,63
8881,Bulma,dun-modr,1220,druid,balance,36,15,21
8882,Rayðii,archimonde,1219,druid,balance,44,24,20
8883,Dancingrain,ravencrest,1219,druid,balance,30,13,17
8884,Certton,arakarahm,1218,druid,balance,75,36,39
8885,Artío,the-maelstrom,1215,druid,balance,69,32,37
8886,Balzàc,ravencrest,1213,druid,balance,42,23,19
8887,Weregoon,blackmoore,1213,druid,balance,57,21,36
8888,Avior,eonar,1213,druid,balance,53,18,35
8889,Vasilona,sanguino,1211,druid,balance,24,13,11
8890,Мяурицао,howling-fjord,1210,druid,balance,98,54,44
8891,Challi,nordrassil,1210,druid,balance,24,13,11
8892,Cagaboliches,sanguino,1208,druid,balance,30,14,16
8893,Zerofrenzy,hyjal,1207,druid,balance,142,60,82
8894,Trollskee,draenor,1205,druid,balance,36,16,20
8895,Астралъх,gordunni,1205,druid,balance,36,15,21
8896,Eliaster,ysondre,1204,druid,balance,30,18,12
8897,Coogee,malganis,1201,druid,balance,44,20,24
8898,Gardenstate,silvermoon,1200,druid,balance,42,26,16
8899,Altix,blackmoore,1200,druid,balance,48,26,22
8900,Søfiaa,argent-dawn,1199,druid,balance,131,74,57
8901,Wolfhealer,blackmoore,1198,druid,balance,42,24,18
8902,Malammore,burning-legion,1195,druid,balance,77,49,28
8903,Shåmssz,kazzak,1194,druid,balance,20,15,5
8904,Sarkophag,blackrock,1193,druid,balance,36,13,23
8905,Trollisha,mannoroth,1191,druid,balance,32,17,15
8906,Suranaelle,argent-dawn,1190,druid,balance,38,19,19
8907,Exactt,blackrock,1189,druid,balance,43,17,26
8908,Dêesse,archimonde,1188,druid,balance,42,20,22
8909,Uglydruid,drakthul,1187,druid,balance,110,57,53
8910,Ærîs,garona,1185,druid,balance,58,24,34
8911,Drrestospec,tarren-mill,1182,druid,balance,34,22,12
8912,Laylie,aegwynn,1182,druid,balance,29,13,16
8913,Blesya,ravencrest,1182,druid,balance,39,15,24
8914,Ohpfo,outland,1181,druid,balance,17,13,4
8915,Chulainn,sylvanas,1181,druid,balance,24,18,6
8916,Deadmorph,ysondre,1178,druid,balance,27,14,13
8917,Mööñ,hyjal,1177,druid,balance,22,14,8
8918,Doggerz,aggra-português,1177,druid,balance,72,36,36
8919,Farodiin,blackmoore,1177,druid,balance,48,18,30
8920,Larbre,dalaran,1176,druid,balance,43,29,14
8921,Fey,stormrage,1174,druid,balance,35,13,22
8922,Попестовали,gordunni,1172,druid,balance,33,19,14
8923,Trickpotato,terrordar,1172,druid,balance,42,24,18
8924,Лякокля,soulflayer,1172,druid,balance,42,22,20
8925,Mehgyver,ravencrest,1172,druid,balance,26,13,13
8926,Maelinou,archimonde,1168,druid,balance,36,19,17
8927,ßalmain,nethersturm,1163,druid,balance,36,20,16
8928,Máilo,aegwynn,1158,druid,balance,60,23,37
8929,Toxida,antonidas,1157,druid,balance,71,35,36
8930,Haginator,twisting-nether,1157,druid,balance,102,48,54
8931,Northstar,sylvanas,1156,druid,balance,18,13,5
8932,Dremdra,draenor,1156,druid,balance,48,19,29
8933,Gnotten,thunderhorn,1154,druid,balance,23,13,10
8934,Conn,ravencrest,1153,druid,balance,27,16,11
8935,Clonecity,ravencrest,1152,druid,balance,12,12,0
8936,Afky,stormreaver,1152,druid,balance,18,12,6
8937,Lêviàthäñ,blackhand,1152,druid,balance,24,12,12
8938,Minado,outland,1151,druid,balance,12,12,0
8939,Boomdruud,tarren-mill,1151,druid,balance,18,12,6
8940,Renzay,ysondre,1151,druid,balance,18,12,6
8941,Lodikum,defias-brotherhood,1151,druid,balance,18,12,6
8942,Куколдос,eversong,1151,druid,balance,18,12,6
8943,Vârima,ravencrest,1151,druid,balance,18,12,6
8944,Bigfeeder,ravencrest,1151,druid,balance,20,12,8
8945,Øwlkin,ravencrest,1151,druid,balance,24,12,12
8946,Lazermonster,tarren-mill,1151,druid,balance,24,12,12
8947,Fabutwo,blackrock,1151,druid,balance,24,12,12
8948,Friidaf,lightbringer,1151,druid,balance,24,12,12
8949,Bigbrrd,outland,1150,druid,balance,18,12,6
8950,Deblin,ragnaros,1148,druid,balance,41,23,18
8951,Drdudu,dun-morogh,1148,druid,balance,32,15,17
8952,Putitimoriri,pozzo-delleternità,1147,druid,balance,30,21,9
8953,Leafsandstuf,ragnaros,1147,druid,balance,18,12,6
8954,Limmiited,ravencrest,1147,druid,balance,60,28,32
8955,Iamramen,blackmoore,1147,druid,balance,82,35,47
8956,Rabbalala,twisting-nether,1147,druid,balance,30,12,18
8957,Cowxoxo,twisting-nether,1147,druid,balance,30,12,18
8958,Nexirøs,hyjal,1146,druid,balance,12,12,0
8959,Mnqn,ravencrest,1146,druid,balance,18,12,6
8960,Merq,ravencrest,1146,druid,balance,18,12,6
8961,Lunel,arathor,1146,druid,balance,24,12,12
8962,Hïrøshïmå,malganis,1146,druid,balance,24,12,12
8963,Ashär,kirin-tor,1146,druid,balance,75,33,42
8964,Tjoepert,azjolnerub,1146,druid,balance,96,41,55
8965,Meretrizx,kazzak,1145,druid,balance,24,12,12
8966,Aestûs,outland,1145,druid,balance,24,12,12
8967,Doruido,rashgarroth,1145,druid,balance,30,12,18
8968,Sháko,dun-modr,1144,druid,balance,38,17,21
8969,Mythiaran,argent-dawn,1144,druid,balance,30,12,18
8970,Meuhtéki,hyjal,1143,druid,balance,18,12,6
8971,Wartôn,blackhand,1143,druid,balance,46,24,22
8972,Criaø,blackrock,1143,druid,balance,24,12,12
8973,Hefdgaharald,antonidas,1141,druid,balance,24,12,12
8974,Requinymph,ravencrest,1141,druid,balance,24,12,12
8975,Loriann,twisting-nether,1141,druid,balance,75,36,39
8976,Ibêx,blackmoore,1139,druid,balance,18,12,6
8977,Blueedood,twisting-nether,1139,druid,balance,24,12,12
8978,Shiotake,hyjal,1139,druid,balance,24,12,12
8979,Schneéeule,blackrock,1138,druid,balance,30,12,18
8980,Zoxen,nefarian,1138,druid,balance,30,12,18
8981,Bztémor,archimonde,1137,druid,balance,24,12,12
8982,Сейтил,deathguard,1137,druid,balance,73,31,42
8983,Gluqt,outland,1135,druid,balance,54,21,33
8984,Putzé,blackrock,1134,druid,balance,35,16,19
8985,Kizilbuka,ragnaros,1133,druid,balance,30,21,9
8986,Мутаборец,howling-fjord,1133,druid,balance,56,33,23
8987,Blark,sylvanas,1133,druid,balance,30,12,18
8988,Quoting,ravencrest,1132,druid,balance,29,12,17
8989,Lonedrood,blackrock,1130,druid,balance,24,12,12
8990,Bluebanana,bronzebeard,1128,druid,balance,48,20,28
8991,Eyune,tarren-mill,1127,druid,balance,39,19,20
8992,Youngjin,ravencrest,1126,druid,balance,18,12,6
8993,Pretender,arathi,1123,druid,balance,40,13,27
8994,Tankis,dalaran,1118,druid,balance,62,36,26
8995,Fâucon,eitrigg,1115,druid,balance,22,13,9
8996,Bénjî,khazgoroth,1114,druid,balance,60,26,34
8997,Taskingoman,twisting-nether,1113,druid,balance,24,12,12
8998,Happysw,thrall,1113,druid,balance,74,28,46
8999,Дайтеполено,howling-fjord,1112,druid,balance,70,30,40
9000,Jabah,silvermoon,1111,druid,balance,18,12,6
9001,Morlas,kazzak,1111,druid,balance,50,22,28
9002,Laiquaril,ravencrest,1111,druid,balance,31,12,19
9003,Gallorath,draenor,1110,druid,balance,28,12,16
9004,Two,silvermoon,1106,druid,balance,67,34,33
9005,Hightotem,hakkar,1104,druid,balance,29,16,13
9006,Ooxx,rashgarroth,1104,druid,balance,29,12,17
9007,Roroa,ravencrest,1102,druid,balance,21,12,9
9008,Aionx,ravencrest,1101,druid,balance,23,12,11
9009,Phatbushy,silvermoon,1096,druid,balance,27,12,15
9010,Krausz,burning-legion,1094,druid,balance,24,17,7
9011,Ruberg,kazzak,1091,druid,balance,21,12,9
9012,Животноеыы,howling-fjord,1089,druid,balance,29,12,17
9013,Бруан,gordunni,1088,druid,balance,47,23,24
9014,Исмалат,howling-fjord,1088,druid,balance,51,24,27
9015,Orchard,silvermoon,1080,druid,balance,24,13,11
9016,Kotomer,defias-brotherhood,1077,druid,balance,129,54,75
9017,Darisom,alexstrasza,1076,druid,balance,219,117,102
9018,Semiflora,silvermoon,1073,druid,balance,30,13,17
9019,Dobradoonga,exodar,1072,druid,balance,21,13,8
9020,Whøðìspélmé,twisting-nether,1071,druid,balance,13,12,1
9021,Negríno,cthun,1067,druid,balance,27,18,9
9022,Buckshee,doomhammer,1066,druid,balance,47,25,22
9023,Cubir,turalyon,1065,druid,balance,23,12,11
9024,Wherismygold,ravencrest,1064,druid,balance,22,12,10
9025,Bjærky,silvermoon,1063,druid,balance,20,12,8
9026,Exiztenz,deathwing,1062,druid,balance,36,18,18
9027,Astralarius,argent-dawn,1061,druid,balance,38,12,26
9028,Ellüna,ravencrest,1060,druid,balance,30,14,16
9029,Потерявшийся,howling-fjord,1059,druid,balance,38,15,23
9030,Amalou,ravencrest,1058,druid,balance,78,38,40
9031,Colibrix,ravencrest,1057,druid,balance,56,20,36
9032,Terrays,the-maelstrom,1056,druid,balance,18,15,3
9033,Zyndril,silvermoon,1056,druid,balance,18,11,7
9034,Cutiepain,kazzak,1055,druid,balance,12,11,1
9035,Drmoe,blackmoore,1055,druid,balance,15,12,3
9036,Maedic,outland,1055,druid,balance,18,11,7
9037,Narkiza,blackhand,1055,druid,balance,18,11,7
9038,Píps,ravencrest,1055,druid,balance,18,11,7
9039,Crittler,forscherliga,1055,druid,balance,18,11,7
9040,Buckmysallz,archimonde,1055,druid,balance,18,11,7
9041,Fatfingerx,blackrock,1055,druid,balance,18,11,7
9042,Speegle,kazzak,1054,druid,balance,18,11,7
9043,Flukeyz,draenor,1054,druid,balance,18,11,7
9044,Felicìty,draenor,1054,druid,balance,18,11,7
9045,Curzex,blackmoore,1054,druid,balance,18,11,7
9046,Oomhammer,darkspear,1054,druid,balance,18,11,7
9047,Zwierzyniec,jaedenar,1053,druid,balance,18,11,7
9048,Lechaource,silvermoon,1053,druid,balance,18,11,7
9049,Нортикус,soulflayer,1053,druid,balance,24,11,13
9050,Jamley,tarren-mill,1053,druid,balance,24,11,13
9051,Varunys,blackrock,1052,druid,balance,18,11,7
9052,Dèxò,blackmoore,1051,druid,balance,24,11,13
9053,Rèchy,blackrock,1051,druid,balance,24,11,13
9054,Gajani,stormscale,1050,druid,balance,18,11,7
9055,Taylorshift,argent-dawn,1050,druid,balance,18,11,7
9056,Bigpopp,kazzak,1050,druid,balance,18,11,7
9057,Aimwaré,ravencrest,1050,druid,balance,24,11,13
9058,Drugnag,blackmoore,1049,druid,balance,18,11,7
9059,Wonderbear,blackrock,1049,druid,balance,18,11,7
9060,Orazien,ravencrest,1049,druid,balance,18,11,7
9061,Soguu,thrall,1049,druid,balance,18,11,7
9062,Wrathofstar,azjolnerub,1048,druid,balance,18,11,7
9063,Skyphi,silvermoon,1048,druid,balance,18,11,7
9064,Tongá,draenor,1048,druid,balance,24,11,13
9065,Tulleku,azjolnerub,1047,druid,balance,21,12,9
9066,Nefariz,dun-modr,1047,druid,balance,24,11,13
9067,Alterejuv,ravencrest,1047,druid,balance,30,11,19
9068,Hengst,laughing-skull,1046,druid,balance,24,11,13
9069,Tílac,eredar,1045,druid,balance,18,11,7
9070,Feraligator,sanguino,1045,druid,balance,105,45,60
9071,Покекек,lich-king,1045,druid,balance,33,14,19
9072,Tchoubouléru,throkferoth,1045,druid,balance,36,13,23
9073,Rorugo,sanguino,1044,druid,balance,18,11,7
9074,Wainl,hyjal,1044,druid,balance,24,11,13
9075,Naone,silvermoon,1044,druid,balance,36,14,22
9076,Høtbøx,aegwynn,1044,druid,balance,33,11,22
9077,Jirenthegrey,antonidas,1043,druid,balance,18,11,7
9078,Bigdx,blackrock,1042,druid,balance,24,11,13
9079,Adoodo,argent-dawn,1041,druid,balance,29,16,13
9080,Ðelnôs,destromath,1041,druid,balance,24,11,13
9081,Elmunia,ravencrest,1041,druid,balance,35,16,19
9082,Kizerx,garona,1039,druid,balance,36,18,18
9083,Månljuset,outland,1035,druid,balance,18,11,7
9084,Hárty,tarren-mill,1035,druid,balance,24,11,13
9085,Sabresheep,twisting-nether,1034,druid,balance,30,11,19
9086,Athenã,blackmoore,1034,druid,balance,35,12,23
9087,Xaeia,aegwynn,1033,druid,balance,18,11,7
9088,Anerol,arthas,1031,druid,balance,36,19,17
9089,Diepauline,aegwynn,1030,druid,balance,42,22,20
9090,Nolak,frostwolf,1030,druid,balance,30,11,19
9091,Dudukush,eredar,1029,druid,balance,43,19,24
9092,Ronî,arthas,1028,druid,balance,30,11,19
9093,Théodên,dalaran,1027,druid,balance,182,91,91
9094,Вёкс,howling-fjord,1023,druid,balance,14,12,2
9095,Hardruid,sanguino,1021,druid,balance,20,12,8
9096,Fx,mazrigos,1018,druid,balance,17,11,6
9097,Makoes,tarren-mill,1018,druid,balance,20,12,8
9098,Nightingalee,stormscale,1018,druid,balance,30,12,18
9099,Ambracer,silvermoon,1016,druid,balance,29,12,17
9100,Bullmarkets,kazzak,1013,druid,balance,24,12,12
9101,Yolobolo,ragnaros,1007,druid,balance,17,11,6
9102,Frenkiej,pozzo-delleternità,1007,druid,balance,24,11,13
9103,Yugene,dun-modr,991,druid,balance,20,11,9
9104,Sløthy,uldum,990,druid,balance,16,11,5
9105,Starcat,defias-brotherhood,988,druid,balance,20,11,9
9106,Druice,tyrande,987,druid,balance,17,11,6
9107,Skvll,silvermoon,987,druid,balance,26,11,15
9108,Venh,forscherliga,982,druid,balance,14,11,3
9109,Bulvai,medivh,979,druid,balance,14,11,3
9110,Melábufes,dun-modr,976,druid,balance,19,11,8
9111,Notsikaan,blackhand,975,druid,balance,25,11,14
9112,Toxicclones,tarren-mill,960,druid,balance,12,10,2
9113,Smokahontas,kilrogg,960,druid,balance,12,10,2
9114,Boomco,stormscale,960,druid,balance,12,10,2
9115,Nàaz,stormscale,960,druid,balance,12,10,2
9116,Vizir,stormscale,960,druid,balance,12,10,2
9117,Moonleaf,burning-steppes,960,druid,balance,12,10,2
9118,Nätsügødxqt,archimonde,960,druid,balance,12,10,2
9119,Rofyx,twisting-nether,960,druid,balance,18,10,8
9120,Shayîa,nozdormu,960,druid,balance,18,10,8
9121,Blackdrd,archimonde,960,druid,balance,18,10,8
9122,Djfukface,ravencrest,960,druid,balance,18,10,8
9123,Амераки,blackscar,960,druid,balance,18,10,8
9124,Shapees,sylvanas,960,druid,balance,18,10,8
9125,Eroxx,blackrock,960,druid,balance,24,10,14
9126,Feralisser,ravencrest,959,druid,balance,12,10,2
9127,Luphrekfurry,ysondre,959,druid,balance,18,10,8
9128,Stalkdro,elune,959,druid,balance,18,10,8
9129,Còwgummi,blackhand,959,druid,balance,18,10,8
9130,Tiktokstar,blackrock,959,druid,balance,18,10,8
9131,Sün,kazzak,959,druid,balance,18,10,8
9132,Littlecok,blackmoore,959,druid,balance,18,10,8
9133,Häggrä,dalaran,959,druid,balance,18,10,8
9134,Ultrapoulet,archimonde,959,druid,balance,18,10,8
9135,Slâkkxz,kazzak,959,druid,balance,18,10,8
9136,Zarune,sanguino,959,druid,balance,18,10,8
9137,Bignunu,silvermoon,959,druid,balance,18,10,8
9138,Focusboomy,archimonde,959,druid,balance,18,10,8
9139,Thepuma,dun-modr,958,druid,balance,12,10,2
9140,Éatshiftndie,tarren-mill,958,druid,balance,18,10,8
9141,Clone,aegwynn,958,druid,balance,18,10,8
9142,Pèps,dalaran,958,druid,balance,18,10,8
9143,Bears,outland,958,druid,balance,18,10,8
9144,Nelíno,twisting-nether,958,druid,balance,18,10,8
9145,Élán,sylvanas,958,druid,balance,24,10,14
9146,Verenai,bloodfeather,957,druid,balance,12,10,2
9147,Джасэл,howling-fjord,957,druid,balance,12,10,2
9148,Coldleans,kazzak,957,druid,balance,12,10,2
9149,Kahar,eredar,957,druid,balance,18,10,8
9150,Gbq,ravencrest,957,druid,balance,18,10,8
9151,Raízun,blackmoore,957,druid,balance,18,10,8
9152,Jokodo,silvermoon,956,druid,balance,18,10,8
9153,Ajgreed,grim-batol,956,druid,balance,18,10,8
9154,Prytek,turalyon,955,druid,balance,18,10,8
9155,Sajlol,doomhammer,955,druid,balance,18,10,8
9156,Feral,mazrigos,955,druid,balance,18,10,8
9157,Katharo,kult-der-verdammten,955,druid,balance,42,12,30
9158,Медведяра,howling-fjord,954,druid,balance,84,38,46
9159,Enolcyc,frostmane,954,druid,balance,24,10,14
9160,Zac,quelthalas,953,druid,balance,18,10,8
9161,Bolskigg,stormreaver,953,druid,balance,24,10,14
9162,Degentiuso,alakir,952,druid,balance,18,10,8
9163,Kaspurr,ravencrest,951,druid,balance,12,10,2
9164,Mlyzioz,ahnqiraj,951,druid,balance,22,11,11
9165,Hypnosoad,outland,951,druid,balance,24,10,14
9166,Yeahbuddeh,draenor,951,druid,balance,28,11,17
9167,Видди,soulflayer,947,druid,balance,24,10,14
9168,Бсуза,soulflayer,947,druid,balance,30,10,20
9169,Yepnesse,khaz-modan,946,druid,balance,18,10,8
9170,Phanos,twisting-nether,945,druid,balance,24,10,14
9171,Bearhugzz,outland,942,druid,balance,287,141,146
9172,Metamorfurio,arthas,939,druid,balance,24,11,13
9173,Nëko,chamber-of-aspects,936,druid,balance,35,10,25
9174,Mâéviss,ysondre,936,druid,balance,36,10,26
9175,Resthunor,draenor,935,druid,balance,18,10,8
9176,Máximus,blades-edge,934,druid,balance,60,20,40
9177,Shainá,dun-modr,930,druid,balance,24,10,14
9178,Yaendra,dun-modr,926,druid,balance,33,14,19
9179,Calistane,silvermoon,926,druid,balance,69,24,45
9180,Numberonebs,silvermoon,925,druid,balance,17,10,7
9181,Veijari,deathwing,925,druid,balance,22,11,11
9182,Saxondale,aszune,918,druid,balance,30,14,16
9183,Cöyote,hyjal,916,druid,balance,54,28,26
9184,Суггуторр,howling-fjord,909,druid,balance,87,42,45
9185,Mushröøms,nemesis,904,druid,balance,27,13,14
9186,Darkillaa,anetheron,902,druid,balance,23,10,13
9187,Древнина,gordunni,901,druid,balance,21,10,11
9188,Flume,chromaggus,896,druid,balance,24,10,14
9189,Durtidikdave,kazzak,895,druid,balance,23,10,13
9190,Dao,aegwynn,893,druid,balance,20,10,10
9191,Smexim,dalaran,876,druid,balance,49,26,23
9192,Aggibääm,blackhand,868,druid,balance,24,12,12
9193,Yshára,darkmoon-faire,864,druid,balance,12,9,3
9194,Flopparider,ravencrest,864,druid,balance,12,9,3
9195,Elandreth,twisting-nether,864,druid,balance,12,9,3
9196,Ròb,magtheridon,864,druid,balance,12,9,3
9197,Bakkú,ravencrest,864,druid,balance,12,9,3
9198,Eftermalm,silvermoon,864,druid,balance,12,9,3
9199,Betobalance,blackmoore,864,druid,balance,12,9,3
9200,Shandala,ragnaros,864,druid,balance,12,9,3
9201,Claynoe,blackmoore,864,druid,balance,15,10,5
9202,Yseraheal,drakthul,864,druid,balance,18,9,9
9203,Svp,ravencrest,864,druid,balance,18,9,9
9204,Tronchetto,nemesis,864,druid,balance,24,9,15
9205,Cioban,ravencrest,864,druid,balance,24,9,15
9206,Jengá,nagrand,863,druid,balance,12,9,3
9207,Lakersinfive,argent-dawn,863,druid,balance,12,9,3
9208,Sakkrethd,hyjal,863,druid,balance,12,9,3
9209,Aolynk,twisting-nether,863,druid,balance,12,9,3
9210,Borticow,sanguino,863,druid,balance,12,9,3
9211,Pezuñera,sanguino,863,druid,balance,12,9,3
9212,Forthis,frostmane,863,druid,balance,18,9,9
9213,Hunterkiller,azjolnerub,863,druid,balance,18,9,9
9214,Lockied,eredar,863,druid,balance,18,9,9
9215,Nymå,outland,863,druid,balance,18,9,9
9216,Damagebot,tarren-mill,863,druid,balance,18,9,9
9217,Кеорл,gordunni,863,druid,balance,18,9,9
9218,Wîzzp,magtheridon,863,druid,balance,18,9,9
9219,Croquetoro,sanguino,863,druid,balance,18,9,9
9220,Moonpoxdru,nerathor,863,druid,balance,18,9,9
9221,Malolepszy,burning-legion,863,druid,balance,24,9,15
9222,Redyogurt,outland,863,druid,balance,24,9,15
9223,Mokujiin,burning-blade,863,druid,balance,24,9,15
9224,Bxxmkin,draenor,862,druid,balance,12,9,3
9225,Hiquien,silvermoon,862,druid,balance,12,9,3
9226,Téddý,tarren-mill,862,druid,balance,18,9,9
9227,Karuck,ravencrest,862,druid,balance,18,9,9
9228,Metaboss,ravencrest,862,druid,balance,18,9,9
9229,Ábomínatíon,draenor,862,druid,balance,18,9,9
9230,Angharradh,arthas,862,druid,balance,18,9,9
9231,Jabbah,defias-brotherhood,862,druid,balance,18,9,9
9232,Qocotte,archimonde,862,druid,balance,18,9,9
9233,Oxe,malganis,861,druid,balance,12,9,3
9234,Noctilus,steamwheedle-cartel,861,druid,balance,18,9,9
9235,Quza,lightbringer,861,druid,balance,18,9,9
9236,Schneelol,outland,861,druid,balance,18,9,9
9237,Wombati,blackrock,861,druid,balance,24,9,15
9238,Drocos,genjuros,860,druid,balance,18,9,9
9239,Spoco,defias-brotherhood,860,druid,balance,18,9,9
9240,Rumjin,burning-blade,859,druid,balance,18,9,9
9241,Хоточник,gordunni,859,druid,balance,24,9,15
9242,Corias,blackmoore,859,druid,balance,36,9,27
9243,Pelagius,ravencrest,858,druid,balance,12,9,3
9244,Дайдорогу,blackscar,857,druid,balance,18,9,9
9245,Grizzlyhills,silvermoon,856,druid,balance,12,9,3
9246,Lunably,silvermoon,855,druid,balance,18,9,9
9247,Freshener,antonidas,854,druid,balance,20,10,10
9248,Erbaiolo,pozzo-delleternità,852,druid,balance,12,9,3
9249,Lootmann,die-silberne-hand,850,druid,balance,18,9,9
9250,Shenzform,ysondre,848,druid,balance,19,11,8
9251,Kucsmagoomba,ragnaros,846,druid,balance,117,52,65
9252,Tombenuit,tarren-mill,843,druid,balance,18,9,9
9253,Rockymarci,dalaran,840,druid,balance,12,9,3
9254,Sethdr,hyjal,840,druid,balance,23,11,12
9255,Tarâkings,outland,832,druid,balance,18,9,9
9256,Сомеваск,deathweaver,830,druid,balance,23,9,14
9257,Eikthyrson,alleria,829,druid,balance,16,10,6
9258,Ribuu,dun-morogh,826,druid,balance,18,9,9
9259,Пушистаялапа,blackscar,824,druid,balance,16,10,6
9260,Split,rexxar,817,druid,balance,20,10,10
9261,Yungtrappy,stormscale,815,druid,balance,15,10,5
9262,Tôrmêñtêd,outland,815,druid,balance,17,9,8
9263,Ishaqu,bladefist,815,druid,balance,23,9,14
9264,Nuggetspøwa,dalaran,814,druid,balance,17,9,8
9265,Burren,auchindoun,810,druid,balance,25,9,16
9266,Ashirae,drakthul,798,druid,balance,14,9,5
9267,Fréki,ravenholdt,791,druid,balance,20,9,11
9268,Rungohar,stormscale,791,druid,balance,34,9,25
9269,Kakaiy,shadowsong,784,druid,balance,96,43,53
9270,Tritit,marécage-de-zangar,768,druid,balance,12,8,4
9271,Treeswinger,twisting-nether,768,druid,balance,12,8,4
9272,Positivity,stormscale,768,druid,balance,12,8,4
9273,Khiree,archimonde,768,druid,balance,12,8,4
9274,Jometatile,hyjal,768,druid,balance,12,8,4
9275,Jónahfalcon,draenor,768,druid,balance,12,8,4
9276,Soofiaa,ravencrest,768,druid,balance,12,8,4
9277,Yiriy,baelgun,768,druid,balance,12,8,4
9278,Ðíør,ravencrest,768,druid,balance,12,8,4
9279,Ethiqd,aegwynn,768,druid,balance,12,8,4
9280,Barneycatz,tarren-mill,768,druid,balance,12,8,4
9281,Meillaeth,sylvanas,768,druid,balance,12,8,4
9282,Cryspie,garona,768,druid,balance,12,8,4
9283,Клыкояр,goldrinn,768,druid,balance,12,8,4
9284,Mîrxy,outland,768,druid,balance,12,8,4
9285,Moksy,outland,768,druid,balance,12,8,4
9286,Kissaey,emeriss,768,druid,balance,12,8,4
9287,Gsix,blackrock,768,druid,balance,12,8,4
9288,Pjuske,silvermoon,768,druid,balance,12,8,4
9289,Admeliora,ravencrest,768,druid,balance,12,8,4
9290,Everdreamx,arathor,768,druid,balance,12,8,4
9291,Emochicken,silvermoon,768,druid,balance,15,9,6
9292,Epicplays,sylvanas,768,druid,balance,18,8,10
9293,Superpoulet,archimonde,768,druid,balance,18,8,10
9294,Réhagen,archimonde,768,druid,balance,18,8,10
9295,Boompjeh,chamber-of-aspects,768,druid,balance,18,8,10
9296,Commonsense,kazzak,768,druid,balance,18,8,10
9297,Xtremeterror,blackmoore,767,druid,balance,12,8,4
9298,Sebikboomie,ravencrest,767,druid,balance,12,8,4
9299,Cîalîs,blackmoore,767,druid,balance,12,8,4
9300,Salvagã,outland,767,druid,balance,12,8,4
9301,Rengár,blackrock,767,druid,balance,12,8,4
9302,Seasexsune,antonidas,767,druid,balance,12,8,4
9303,Dëåd,zenedar,767,druid,balance,12,8,4
9304,Kheleñ,blackrock,767,druid,balance,14,8,6
9305,Bogahcan,twisting-nether,767,druid,balance,18,8,10
9306,Snoxy,wrathbringer,767,druid,balance,18,8,10
9307,Phanÿ,garona,767,druid,balance,18,8,10
9308,Царапкатян,gordunni,767,druid,balance,18,8,10
9309,Ilovehannah,laughing-skull,767,druid,balance,18,8,10
9310,Bigsmoké,die-aldor,767,druid,balance,18,8,10
9311,Asrais,dun-modr,767,druid,balance,18,8,10
9312,Hugepepega,ravencrest,767,druid,balance,18,8,10
9313,Eýesburn,silvermoon,767,druid,balance,18,8,10
9314,Arydan,quelthalas,767,druid,balance,18,8,10
9315,Isotopîa,antonidas,767,druid,balance,18,8,10
9316,Loswochos,blackmoore,767,druid,balance,18,8,10
9317,Schebäb,blackhand,767,druid,balance,24,8,16
9318,Irithel,ravencrest,766,druid,balance,12,8,4
9319,Stormspirit,hellscream,766,druid,balance,12,8,4
9320,Humanoidpt,aggra-português,766,druid,balance,12,8,4
9321,Doctóras,twisting-nether,766,druid,balance,12,8,4
9322,Benzinoid,silvermoon,766,druid,balance,12,8,4
9323,Vandalís,garrosh,766,druid,balance,12,8,4
9324,Freefang,dun-modr,766,druid,balance,12,8,4
9325,Коктявзер,deathweaver,766,druid,balance,18,8,10
9326,Obois,archimonde,766,druid,balance,18,8,10
9327,Kheluna,the-maelstrom,766,druid,balance,18,8,10
9328,Lendron,malygos,766,druid,balance,23,8,15
9329,Polimorphism,tarren-mill,766,druid,balance,24,8,16
9330,Pansarbamse,outland,766,druid,balance,25,8,17
9331,Darthiud,outland,765,druid,balance,12,8,4
9332,Wiligun,archimonde,765,druid,balance,12,8,4
9333,Machie,argent-dawn,765,druid,balance,18,8,10
9334,Arenshimoon,kazzak,765,druid,balance,18,8,10
9335,Zaratras,arathor,765,druid,balance,18,8,10
9336,Raszcal,blackhand,765,druid,balance,18,8,10
9337,Droodu,dun-modr,765,druid,balance,30,8,22
9338,Cirwen,silvermoon,764,druid,balance,12,8,4
9339,Mongobongo,onyxia,764,druid,balance,12,8,4
9340,Fiberpäls,magtheridon,764,druid,balance,18,8,10
9341,Teldrastion,silvermoon,764,druid,balance,30,8,22
9342,Dwaokut,ravencrest,763,druid,balance,12,8,4
9343,Cobradrood,culte-de-la-rive-noire,763,druid,balance,18,8,10
9344,Карантини,howling-fjord,763,druid,balance,21,9,12
9345,Anchoring,argent-dawn,763,druid,balance,22,9,13
9346,Vigôuróuz,blackmoore,762,druid,balance,12,8,4
9347,Moonsama,twisting-nether,762,druid,balance,24,8,16
9348,Sároman,ravencrest,761,druid,balance,24,8,16
9349,Lothadriel,sylvanas,760,druid,balance,18,8,10
9350,Celebras,chogall,756,druid,balance,12,8,4
9351,Drudd,hellscream,751,druid,balance,23,8,15
9352,Swolecat,ravencrest,749,druid,balance,23,8,15
9353,Fakers,the-maelstrom,747,druid,balance,12,8,4
9354,Ратататата,blackscar,734,druid,balance,14,9,5
9355,Litany,drakthul,731,druid,balance,17,8,9
9356,Vaea,hyjal,731,druid,balance,26,9,17
9357,Treepoloski,stormscale,719,druid,balance,15,9,6
9358,Maw,hellfire,717,druid,balance,11,8,3
9359,Cörelly,ravencrest,715,druid,balance,15,9,6
9360,Humizon,silvermoon,714,druid,balance,21,9,12
9361,Elpresidénté,blackmoore,713,druid,balance,12,9,3
9362,Rain,kazzak,703,druid,balance,11,8,3
9363,Rønièl,tarren-mill,702,druid,balance,11,8,3
9364,Papalegba,kilrogg,700,druid,balance,14,8,6
9365,Lörex,ravencrest,687,druid,balance,13,8,5
9366,Хфикс,gordunni,683,druid,balance,13,8,5
9367,Imcasting,doomhammer,672,druid,balance,12,7,5
9368,Glúingél,tarren-mill,672,druid,balance,12,7,5
9369,Mommymìlkers,archimonde,672,druid,balance,12,7,5
9370,Qyoon,argent-dawn,672,druid,balance,12,7,5
9371,Cotangens,tarren-mill,672,druid,balance,12,7,5
9372,Noggelicious,ragnaros,672,druid,balance,12,7,5
9373,Wafflecat,outland,672,druid,balance,12,7,5
9374,Sitruu,zenedar,672,druid,balance,12,7,5
9375,Ìluan,ravencrest,672,druid,balance,12,7,5
9376,Трусырвущая,gordunni,672,druid,balance,12,7,5
9377,Trønchetto,nemesis,672,druid,balance,12,7,5
9378,Sweedrood,hyjal,672,druid,balance,12,7,5
9379,Harrydòtter,eredar,672,druid,balance,12,7,5
9380,Deeizm,ravencrest,672,druid,balance,12,7,5
9381,Underrated,darksorrow,672,druid,balance,12,7,5
9382,Därgon,archimonde,672,druid,balance,12,7,5
9383,Аррерон,howling-fjord,672,druid,balance,12,7,5
9384,Формен,howling-fjord,672,druid,balance,12,7,5
9385,Sasosins,ravencrest,672,druid,balance,12,7,5
9386,Kosadoodoo,sylvanas,672,druid,balance,12,7,5
9387,Noobr,ravencrest,672,druid,balance,12,7,5
9388,Emeskay,ravencrest,672,druid,balance,12,7,5
9389,Surlax,defias-brotherhood,672,druid,balance,12,7,5
9390,Twerkdabooty,azjolnerub,672,druid,balance,12,7,5
9391,Delarion,nemesis,672,druid,balance,12,7,5
9392,Thornat,chamber-of-aspects,672,druid,balance,12,7,5
9393,Locite,blackrock,672,druid,balance,12,7,5
9394,Hajlol,sylvanas,672,druid,balance,12,7,5
9395,Tease,blackrock,672,druid,balance,12,7,5
9396,Adelsten,tarren-mill,672,druid,balance,15,8,7
9397,Pansaa,stormscale,672,druid,balance,15,8,7
9398,Nyenna,twilights-hammer,672,druid,balance,16,8,8
9399,Avimoo,tarren-mill,672,druid,balance,18,7,11
9400,Ravenfang,dun-modr,672,druid,balance,18,7,11
9401,Lilim,culte-de-la-rive-noire,672,druid,balance,18,7,11
9402,Quellwell,outland,672,druid,balance,18,7,11
9403,Lifty,dun-modr,672,druid,balance,18,7,11
9404,Solgarna,saurfang,672,druid,balance,18,7,11
9405,Murenito,nemesis,672,druid,balance,24,7,17
9406,Shreddít,tarren-mill,672,druid,balance,24,7,17
9407,Shehida,silvermoon,671,druid,balance,12,7,5
9408,Лидир,blackscar,671,druid,balance,12,7,5
9409,Maruuk,argent-dawn,671,druid,balance,12,7,5
9410,Rikayn,tarren-mill,671,druid,balance,12,7,5
9411,Halfback,blackhand,671,druid,balance,12,7,5
9412,Найадра,gordunni,671,druid,balance,12,7,5
9413,Yabooni,ravencrest,671,druid,balance,12,7,5
9414,Asura,nozdormu,671,druid,balance,12,7,5
9415,Alexuwu,draenor,671,druid,balance,12,7,5
9416,Pogoth,turalyon,671,druid,balance,12,7,5
9417,Vrillox,blackmoore,671,druid,balance,15,8,7
9418,Fesenjon,blackhand,671,druid,balance,18,7,11
9419,Thunderzeus,mazrigos,671,druid,balance,18,7,11
9420,Kivu,blackrock,671,druid,balance,18,7,11
9421,Picatso,blackrock,671,druid,balance,18,7,11
9422,Yunød,silvermoon,671,druid,balance,18,7,11
9423,Legevakten,grim-batol,671,druid,balance,18,7,11
9424,Felfran,ravencrest,671,druid,balance,18,7,11
9425,Phala,outland,671,druid,balance,18,7,11
9426,Justycare,ragnaros,671,druid,balance,18,7,11
9427,Knindza,tarren-mill,670,druid,balance,12,7,5
9428,Släshes,stormreaver,670,druid,balance,12,7,5
9429,Klatu,doomhammer,670,druid,balance,24,7,17
9430,Jevcoh,area-52,668,druid,balance,12,7,5
9431,Thyanya,blackmoore,668,druid,balance,18,7,11
9432,Jokizy,burning-legion,667,druid,balance,18,7,11
9433,Mondino,blackrock,667,druid,balance,24,7,17
9434,Thrynitie,les-sentinelles,663,druid,balance,12,7,5
9435,Bönüs,cthun,661,druid,balance,12,7,5
9436,Nightshape,kragjin,661,druid,balance,18,7,11
9437,Qra,area-52,660,druid,balance,12,7,5
9438,Kawaíï,frostwolf,659,druid,balance,26,10,16
9439,Ketash,ragnaros,657,druid,balance,12,7,5
9440,Iskaarjx,archimonde,654,druid,balance,17,7,10
9441,Yawawe,blackmoore,638,druid,balance,17,7,10
9442,Abadar,tarren-mill,638,druid,balance,20,8,12
9443,Nille,tarren-mill,617,druid,balance,14,8,6
9444,Blazek,sylvanas,617,druid,balance,14,8,6
9445,Kidawi,frostwolf,617,druid,balance,16,8,8
9446,Kamatea,eredar,607,druid,balance,11,7,4
9447,Bubidiblumdr,twisting-nether,605,druid,balance,16,7,9
9448,Músclébéach,silvermoon,605,druid,balance,22,7,15
9449,Rtfz,ravencrest,591,druid,balance,13,7,6
9450,Ухухуня,gordunni,576,druid,balance,6,6,0
9451,Dreamdoll,ravencrest,576,druid,balance,6,6,0
9452,Zamans,silvermoon,576,druid,balance,6,6,0
9453,Флаффер,soulflayer,576,druid,balance,6,6,0
9454,Qpoof,sylvanas,576,druid,balance,6,6,0
9455,Risuoksa,tarren-mill,576,druid,balance,6,6,0
9456,Mentaldead,tarren-mill,576,druid,balance,12,6,6
9457,Vedee,tarren-mill,576,druid,balance,12,6,6
9458,Maníx,tarren-mill,576,druid,balance,12,6,6
9459,Vongihkuhher,blackmoore,576,druid,balance,12,6,6
9460,Dyuuna,hyjal,576,druid,balance,12,6,6
9461,Ipossible,kazzak,576,druid,balance,12,6,6
9462,Diolives,stormscale,576,druid,balance,12,6,6
9463,Kamenká,aegwynn,576,druid,balance,12,6,6
9464,Degnosaur,outland,576,druid,balance,12,6,6
9465,Lèthal,arakarahm,576,druid,balance,12,6,6
9466,Tonie,stormscale,576,druid,balance,12,6,6
9467,Thefudge,silvermoon,576,druid,balance,12,6,6
9468,Sajah,outland,576,druid,balance,12,6,6
9469,Talressian,argent-dawn,576,druid,balance,12,6,6
9470,Лунныйфилин,deathguard,576,druid,balance,12,6,6
9471,Wrx,sylvanas,576,druid,balance,12,6,6
9472,Ghostdoggie,stormscale,576,druid,balance,12,6,6
9473,Knozylg,kazzak,576,druid,balance,12,6,6
9474,Valoruk,ravencrest,576,druid,balance,12,6,6
9475,Naturexbot,silvermoon,576,druid,balance,12,6,6
9476,Pælter,draenor,576,druid,balance,12,6,6
9477,Димитруа,howling-fjord,576,druid,balance,12,6,6
9478,Nancey,auchindoun,576,druid,balance,12,6,6
9479,Bildukas,ravencrest,576,druid,balance,12,6,6
9480,Teryx,blackmoore,576,druid,balance,12,6,6
9481,Quinten,ulduar,576,druid,balance,12,6,6
9482,Pataleaqtp,sanguino,576,druid,balance,12,6,6
9483,Póllen,magtheridon,576,druid,balance,12,6,6
9484,Emidrem,ravencrest,576,druid,balance,12,6,6
9485,Seraxi,der-mithrilorden,576,druid,balance,12,6,6
9486,Fèéli,twisting-nether,576,druid,balance,12,6,6
9487,Orious,dun-modr,576,druid,balance,12,6,6
9488,Bane,dun-modr,576,druid,balance,12,6,6
9489,Islandbôy,blackrock,576,druid,balance,12,6,6
9490,Мунпраид,gordunni,576,druid,balance,12,6,6
9491,Amrul,hyjal,576,druid,balance,12,6,6
9492,Salvaga,outland,576,druid,balance,12,6,6
9493,Lushe,kazzak,576,druid,balance,12,6,6
9494,Fishanchips,archimonde,576,druid,balance,12,6,6
9495,Зулкхаку,soulflayer,576,druid,balance,12,6,6
9496,Yalojr,blackmoore,576,druid,balance,12,6,6
9497,Inbml,silvermoon,576,druid,balance,12,6,6
9498,Shoca,die-ewige-wacht,576,druid,balance,12,6,6
9499,Axrae,ravencrest,576,druid,balance,18,6,12
9500,Disney,ragnaros,576,druid,balance,18,6,12
9501,Doncaino,amanthul,576,druid,balance,18,6,12
9502,Aureliusx,drakthul,576,druid,balance,18,6,12
9503,Smedoge,outland,576,druid,balance,18,6,12
9504,Mugwa,blackmoore,575,druid,balance,6,6,0
9505,Sojiz,outland,575,druid,balance,12,6,6
9506,Òniz,hyjal,575,druid,balance,12,6,6
9507,Graffyrre,eonar,575,druid,balance,12,6,6
9508,Kleinii,blackrock,575,druid,balance,12,6,6
9509,Helguard,silvermoon,575,druid,balance,12,6,6
9510,Лицеторг,howling-fjord,575,druid,balance,12,6,6
9511,Tekal,vashj,575,druid,balance,12,6,6
9512,Grinnox,outland,575,druid,balance,12,6,6
9513,Gruvkatt,stormscale,575,druid,balance,12,6,6
9514,Praythysun,khaz-modan,575,druid,balance,12,6,6
9515,Maniek,defias-brotherhood,575,druid,balance,12,6,6
9516,Dinamitko,silvermoon,575,druid,balance,12,6,6
9517,Raxona,blackmoore,575,druid,balance,12,6,6
9518,Flagvan,ravencrest,575,druid,balance,13,6,7
9519,Barkskin,grim-batol,575,druid,balance,15,6,9
9520,Robinchwän,archimonde,575,druid,balance,18,6,12
9521,Thruf,nemesis,575,druid,balance,18,6,12
9522,Аматэррасу,blackscar,575,druid,balance,18,6,12
9523,Дарзамат,blackscar,575,druid,balance,18,6,12
9524,Aimïn,sanguino,575,druid,balance,18,6,12
9525,Wardruíd,outland,575,druid,balance,24,6,18
9526,Lucianis,drakthul,575,druid,balance,24,6,18
9527,Lúthiëñ,silvermoon,575,druid,balance,24,6,18
9528,Kimiza,hyjal,575,druid,balance,25,6,19
9529,Тиликум,goldrinn,574,druid,balance,12,6,6
9530,Raciness,grim-batol,574,druid,balance,12,6,6
9531,Momaa,neptulon,574,druid,balance,12,6,6
9532,Apodruid,tarren-mill,574,druid,balance,12,6,6
9533,Derie,nazjatar,574,druid,balance,12,6,6
9534,Tyreek,eredar,574,druid,balance,16,7,9
9535,Жекакотик,eversong,574,druid,balance,24,6,18
9536,Bareforms,medivh,573,druid,balance,12,6,6
9537,Kittasek,drakthul,572,druid,balance,12,6,6
9538,Tarantinonon,kazzak,572,druid,balance,18,6,12
9539,Keltaris,dun-modr,565,druid,balance,12,6,6
9540,Delfin,aerie-peak,563,druid,balance,21,7,14
9541,Thaiboimbyy,veknilash,558,druid,balance,29,10,19
9542,Duwaz,blackmoore,543,druid,balance,14,7,7
9543,Ancientix,burning-legion,543,druid,balance,17,6,11
9544,Blamer,thrall,527,druid,balance,17,6,11
9545,Fotmrerollér,darksorrow,510,druid,balance,8,6,2
9546,Фэк,eversong,509,druid,balance,10,6,4
9547,Bigdambitex,draenor,480,druid,balance,6,5,1
9548,Ferdiboo,draenor,480,druid,balance,6,5,1
9549,Smøkyyd,eredar,480,druid,balance,6,5,1
9550,Corkiri,tarren-mill,480,druid,balance,6,5,1
9551,Éxy,kazzak,480,druid,balance,6,5,1
9552,Murdok,suramar,480,druid,balance,6,5,1
9553,Boomytunes,silvermoon,480,druid,balance,6,5,1
9554,Tshungubuäch,eredar,480,druid,balance,6,5,1
9555,Huayhey,the-maelstrom,480,druid,balance,6,5,1
9556,Hashtagone,ysondre,480,druid,balance,6,5,1
9557,Stkk,sanguino,480,druid,balance,6,5,1
9558,Cowieowie,draenor,480,druid,balance,6,5,1
9559,Bighike,drakthul,480,druid,balance,6,5,1
9560,Ashidx,ragnaros,480,druid,balance,6,5,1
9561,Catsareevil,silvermoon,480,druid,balance,6,5,1
9562,Smølboi,ravencrest,480,druid,balance,6,5,1
9563,Ñêkø,ravencrest,480,druid,balance,6,5,1
9564,Svartvit,sylvanas,480,druid,balance,6,5,1
9565,Brittmagi,sylvanas,480,druid,balance,6,5,1
9566,Liften,blackhand,480,druid,balance,6,5,1
9567,Хлайси,gordunni,480,druid,balance,6,5,1
9568,Опущеныйкелх,gordunni,480,druid,balance,6,5,1
9569,Clawlessqtx,outland,480,druid,balance,6,5,1
9570,Corkiy,tarren-mill,480,druid,balance,6,5,1
9571,Азраешль,gordunni,480,druid,balance,6,5,1
9572,Papacarlo,ravencrest,480,druid,balance,6,5,1
9573,Brbrøyk,tarren-mill,480,druid,balance,6,5,1
9574,Myxo,aggra-português,480,druid,balance,6,5,1
9575,Xhifty,ravencrest,480,druid,balance,6,5,1
9576,Nyrrh,blackmoore,480,druid,balance,6,5,1
9577,Sonjin,burning-legion,480,druid,balance,6,5,1
9578,Pinkpanda,arthas,480,druid,balance,6,5,1
9579,Ïmåkêïtråïñ,ravencrest,480,druid,balance,6,5,1
9580,Whaazzform,tarren-mill,480,druid,balance,6,5,1
9581,Tåylor,laughing-skull,480,druid,balance,6,5,1
9582,Zulrája,outland,480,druid,balance,6,5,1
9583,Súçúkbøømíe,aegwynn,480,druid,balance,6,5,1
9584,Daisyx,eredar,480,druid,balance,9,6,3
9585,Ischumekcid,anubarak,480,druid,balance,9,6,3
9586,Dabär,mannoroth,480,druid,balance,10,6,4
9587,Brunogösta,aerie-peak,480,druid,balance,12,5,7
9588,Ассайоу,gordunni,480,druid,balance,12,5,7
9589,Shawkz,kazzak,480,druid,balance,12,5,7
9590,Yadon,the-maelstrom,480,druid,balance,12,5,7
9591,Naturina,shattered-hand,480,druid,balance,12,5,7
9592,Bafere,twisting-nether,480,druid,balance,12,5,7
9593,Hairydøtter,aegwynn,480,druid,balance,12,5,7
9594,Lifecycle,nemesis,480,druid,balance,12,5,7
9595,Fofosdru,kazzak,480,druid,balance,12,5,7
9596,Doup,alakir,480,druid,balance,12,5,7
9597,Theridrax,twisting-nether,480,druid,balance,12,5,7
9598,Tomixdd,stormrage,480,druid,balance,12,5,7
9599,Yööi,nemesis,480,druid,balance,12,5,7
9600,Лолэтохег,soulflayer,480,druid,balance,12,5,7
9601,Balanced,blackhand,480,druid,balance,12,5,7
9602,Shreddies,the-maelstrom,480,druid,balance,12,5,7
9603,Liiandri,khaz-modan,480,druid,balance,12,5,7
9604,Feraline,stormrage,480,druid,balance,12,5,7
9605,Флексим,soulflayer,480,druid,balance,12,5,7
9606,Variolus,dun-modr,480,druid,balance,12,5,7
9607,Robsondruid,twisting-nether,480,druid,balance,12,5,7
9608,Zomgcow,twisting-nether,480,druid,balance,12,5,7
9609,Димадубощит,blackscar,480,druid,balance,12,5,7
9610,Zebår,runetotem,480,druid,balance,12,5,7
9611,Yabbah,blackrock,480,druid,balance,12,5,7
9612,Goated,stormscale,480,druid,balance,12,5,7
9613,Nyooxix,blackmoore,480,druid,balance,12,5,7
9614,Angrykejton,silvermoon,480,druid,balance,12,5,7
9615,Kovalawa,archimonde,480,druid,balance,12,5,7
9616,Quisp,ravencrest,480,druid,balance,12,5,7
9617,Caddan,argent-dawn,480,druid,balance,12,5,7
9618,Quin,frostwolf,480,druid,balance,12,5,7
9619,Acwi,dun-morogh,480,druid,balance,12,5,7
9620,Xërxës,outland,480,druid,balance,12,5,7
9621,Elayria,blackmoore,480,druid,balance,12,5,7
9622,Grîsh,burning-legion,480,druid,balance,12,5,7
9623,Polymorphler,theradras,480,druid,balance,12,5,7
9624,Mîraculix,dun-morogh,480,druid,balance,12,5,7
9625,Zephris,grim-batol,480,druid,balance,12,5,7
9626,Elrandir,tarren-mill,480,druid,balance,12,5,7
9627,Elekträ,ravencrest,480,druid,balance,15,6,9
9628,Qïx,outland,480,druid,balance,15,6,9
9629,Vodibull,aegwynn,480,druid,balance,15,6,9
9630,Lemonjohn,outland,480,druid,balance,14,5,9
9631,Miyá,sylvanas,480,druid,balance,18,5,13
9632,Zeromario,draenor,480,druid,balance,18,5,13
9633,Mazzawii,kazzak,480,druid,balance,18,5,13
9634,Surgeshift,ravencrest,480,druid,balance,18,5,13
9635,Teog,stormreaver,480,druid,balance,18,5,13
9636,Aloraysoda,doomhammer,480,druid,balance,30,5,25
9637,Faedria,outland,479,druid,balance,6,5,1
9638,Zinnform,ragnaros,479,druid,balance,12,5,7
9639,Biologie,onyxia,479,druid,balance,12,5,7
9640,Larsia,nordrassil,479,druid,balance,12,5,7
9641,Sinmanos,eredar,479,druid,balance,12,5,7
9642,Betol,das-konsortium,479,druid,balance,12,5,7
9643,Fallingmoon,ravencrest,479,druid,balance,18,5,13
9644,Тахикамару,blackscar,479,druid,balance,18,5,13
9645,Вилдвестганс,howling-fjord,478,druid,balance,12,5,7
9646,Lysende,arathor,478,druid,balance,12,5,7
9647,Чепенкос,gordunni,478,druid,balance,12,5,7
9648,Druza,draenor,478,druid,balance,12,5,7
9649,Барли,grom,478,druid,balance,16,6,10
9650,Druvian,argent-dawn,478,druid,balance,24,5,19
9651,Zenkay,naxxramas,476,druid,balance,16,6,10
9652,Stanjr,archimonde,476,druid,balance,18,5,13
9653,Закарпаття,galakrond,475,druid,balance,10,6,4
9654,Krakus,twisting-nether,473,druid,balance,12,5,7
9655,Spellmáster,ravencrest,473,druid,balance,12,5,7
9656,Drix,frostwolf,463,druid,balance,17,5,12
9657,Chouan,marécage-de-zangar,457,druid,balance,21,7,14
9658,Karyaga,tarren-mill,431,druid,balance,14,6,8
9659,Pine,aggramar,415,druid,balance,8,5,3
9660,Foxîo,frostmane,415,druid,balance,8,5,3
9661,Ragingmilker,tarren-mill,415,druid,balance,8,5,3
9662,Tomyn,burning-legion,384,druid,balance,6,4,2
9663,Womzas,blackhand,384,druid,balance,6,4,2
9664,Fzx,aegwynn,384,druid,balance,6,4,2
9665,Freedonnad,alleria,384,druid,balance,6,4,2
9666,Daluria,malganis,384,druid,balance,6,4,2
9667,Sunisan,stormscale,384,druid,balance,6,4,2
9668,Hefnerd,grim-batol,384,druid,balance,6,4,2
9669,Kkriss,stormscale,384,druid,balance,6,4,2
9670,Cpt,xavius,384,druid,balance,6,4,2
9671,Lucidz,kazzak,384,druid,balance,6,4,2
9672,Mylanqx,ragnaros,384,druid,balance,6,4,2
9673,Freshpussyz,ravencrest,384,druid,balance,6,4,2
9674,Tharae,blackmoore,384,druid,balance,6,4,2
9675,Kasugia,aegwynn,384,druid,balance,6,4,2
9676,Sapheà,burning-legion,384,druid,balance,6,4,2
9677,Geizagobble,twisting-nether,384,druid,balance,6,4,2
9678,Bigbitez,kazzak,384,druid,balance,6,4,2
9679,Dermegon,outland,384,druid,balance,6,4,2
9680,Vertabrain,twilights-hammer,384,druid,balance,6,4,2
9681,Petypeet,drakthul,384,druid,balance,6,4,2
9682,Loasamdi,tarren-mill,384,druid,balance,6,4,2
9683,Weremyst,outland,384,druid,balance,6,4,2
9684,Dmgtràsh,dun-modr,384,druid,balance,6,4,2
9685,Noodledru,tarren-mill,384,druid,balance,6,4,2
9686,Djbéámgódx,ravencrest,384,druid,balance,6,4,2
9687,Haarbál,tarren-mill,384,druid,balance,6,4,2
9688,Aelins,twisting-nether,384,druid,balance,6,4,2
9689,Hyoyoe,stormreaver,384,druid,balance,6,4,2
9690,Xvmon,draenor,384,druid,balance,6,4,2
9691,Feign,blackmoore,384,druid,balance,6,4,2
9692,Mâlcøm,archimonde,384,druid,balance,6,4,2
9693,Bearygrylls,sylvanas,384,druid,balance,6,4,2
9694,Lolaven,turalyon,384,druid,balance,6,4,2
9695,Nizrã,archimonde,384,druid,balance,6,4,2
9696,Jwifgodx,archimonde,384,druid,balance,6,4,2
9697,Ponardo,outland,384,druid,balance,6,4,2
9698,Rugsul,kazzak,384,druid,balance,6,4,2
9699,Shapeit,blackrock,384,druid,balance,6,4,2
9700,Zootxd,ravencrest,384,druid,balance,6,4,2
9701,Shiftmeow,tarren-mill,384,druid,balance,6,4,2
9702,Jp,eredar,384,druid,balance,6,4,2
9703,Fordragos,ravencrest,384,druid,balance,6,4,2
9704,Cmzdruidxdd,ravencrest,384,druid,balance,6,4,2
9705,Dikc,twisting-nether,384,druid,balance,6,4,2
9706,Lunor,kazzak,384,druid,balance,6,4,2
9707,Kattbjörnen,ragnaros,384,druid,balance,6,4,2
9708,Ekologiskxx,outland,384,druid,balance,6,4,2
9709,Wotahn,antonidas,384,druid,balance,6,4,2
9710,Rawr,dun-morogh,384,druid,balance,6,4,2
9711,Druikraut,silvermoon,384,druid,balance,6,4,2
9712,Amellian,silvermoon,384,druid,balance,6,4,2
9713,Stoptheclone,nordrassil,384,druid,balance,6,4,2
9714,Buikstuk,kilrogg,384,druid,balance,6,4,2
9715,Skavenlol,zuljin,384,druid,balance,6,4,2
9716,Drufar,outland,384,druid,balance,6,4,2
9717,Izzyb,draenor,384,druid,balance,6,4,2
9718,Spatchy,silvermoon,384,druid,balance,6,4,2
9719,Inspira,teldrassil,384,druid,balance,6,4,2
9720,Treebearded,agamaggan,384,druid,balance,6,4,2
9721,Euphoríax,ravencrest,384,druid,balance,10,5,5
9722,Фамай,howling-fjord,384,druid,balance,8,4,4
9723,Astralbody,auchindoun,384,druid,balance,12,4,8
9724,Roxshifter,tarren-mill,384,druid,balance,12,4,8
9725,Bellatrx,darksorrow,384,druid,balance,12,4,8
9726,Ralenia,ravencrest,384,druid,balance,12,4,8
9727,Феразинария,gordunni,384,druid,balance,12,4,8
9728,Tmhaikyu,blackhand,384,druid,balance,12,4,8
9729,Koffee,archimonde,384,druid,balance,12,4,8
9730,Leyarin,argent-dawn,384,druid,balance,12,4,8
9731,Lorucka,die-nachtwache,384,druid,balance,12,4,8
9732,Piiti,burning-legion,384,druid,balance,12,4,8
9733,Pathetik,archimonde,384,druid,balance,12,4,8
9734,Sixtyinches,burning-blade,384,druid,balance,12,4,8
9735,Màlàkaii,hyjal,384,druid,balance,12,4,8
9736,Kiggstar,blackmoore,384,druid,balance,12,4,8
9737,Elainx,thrall,384,druid,balance,12,4,8
9738,Woopi,blackrock,384,druid,balance,12,4,8
9739,Alanpapi,sanguino,384,druid,balance,12,4,8
9740,Ibroninad,ragnaros,384,druid,balance,12,4,8
9741,Ninoboyswag,stormscale,384,druid,balance,12,4,8
9742,Gwendalyr,silvermoon,384,druid,balance,12,4,8
9743,Druidytrudy,blackrock,384,druid,balance,12,4,8
9744,Manimalia,kazzak,384,druid,balance,12,4,8
9745,Yee,twisting-nether,384,druid,balance,12,4,8
9746,Allîyâ,archimonde,384,druid,balance,12,4,8
9747,Fortuma,eredar,384,druid,balance,12,4,8
9748,Boomlex,defias-brotherhood,384,druid,balance,12,4,8
9749,Rastamona,draenor,384,druid,balance,12,4,8
9750,Mauzicek,drakthul,384,druid,balance,12,4,8
9751,Telära,argent-dawn,384,druid,balance,12,4,8
9752,Amhro,ragnaros,384,druid,balance,12,4,8
9753,Tønychopper,sanguino,384,druid,balance,12,4,8
9754,Мукару,howling-fjord,384,druid,balance,12,4,8
9755,Astracat,korgall,384,druid,balance,12,4,8
9756,Kasiopee,hyjal,384,druid,balance,12,4,8
9757,Zeldaa,antonidas,384,druid,balance,14,4,10
9758,Мехнакиске,howling-fjord,384,druid,balance,14,4,10
9759,Ednaqt,grim-batol,384,druid,balance,18,4,14
9760,Храмульчик,blackscar,383,druid,balance,6,4,2
9761,Elm,trollbane,383,druid,balance,6,4,2
9762,Котангис,eversong,383,druid,balance,6,4,2
9763,Herten,tarren-mill,383,druid,balance,6,4,2
9764,Mongwau,blackrock,383,druid,balance,6,4,2
9765,Hecaloth,drakthul,383,druid,balance,6,4,2
9766,Fluke,thrall,383,druid,balance,11,4,7
9767,Summertearz,thrall,383,druid,balance,12,4,8
9768,Ondope,blackmoore,383,druid,balance,12,4,8
9769,Moonpouk,archimonde,383,druid,balance,12,4,8
9770,Blablábla,silvermoon,383,druid,balance,12,4,8
9771,Rústy,baelgun,383,druid,balance,12,4,8
9772,Sodniss,aggra-português,383,druid,balance,14,4,10
9773,Катафей,deathguard,382,druid,balance,6,4,2
9774,Wuki,conseil-des-ombres,379,druid,balance,12,4,8
9775,Billybobb,dentarg,377,druid,balance,19,8,11
9776,Neincat,sylvanas,367,druid,balance,11,4,7
9777,Ráw,dun-modr,367,druid,balance,11,4,7
9778,Gôdzîllâ,silvermoon,352,druid,balance,10,4,6
9779,Blakemonster,khaz-modan,351,druid,balance,8,5,3
9780,Zybri,ragnaros,351,druid,balance,11,4,7
9781,Nightshaðe,argent-dawn,351,druid,balance,11,4,7
9782,Oaeb,stormscale,351,druid,balance,11,4,7
9783,Soný,aegwynn,336,druid,balance,9,5,4
9784,Blownaway,outland,336,druid,balance,9,4,5
9785,Sketit,grim-batol,335,druid,balance,11,4,7
9786,Hilliax,sanguino,330,druid,balance,13,5,8
9787,Martinesämst,outland,320,druid,balance,10,4,6
9788,Holyconvoke,stormscale,319,druid,balance,5,4,1
9789,Eclipße,silvermoon,319,druid,balance,5,4,1
9790,Olula,blackmoore,319,druid,balance,8,4,4
9791,Ahylles,antonidas,288,druid,balance,6,3,3
9792,Flower,aggramar,288,druid,balance,6,3,3
9793,Catgirlx,ravencrest,288,druid,balance,6,3,3
9794,Framoin,archimonde,288,druid,balance,6,3,3
9795,Сэнтэс,soulflayer,288,druid,balance,6,3,3
9796,Irfrayl,antonidas,288,druid,balance,6,3,3
9797,Sucukk,antonidas,288,druid,balance,6,3,3
9798,Jubbs,laughing-skull,288,druid,balance,6,3,3
9799,Junglelist,antonidas,288,druid,balance,6,3,3
9800,Zagrem,antonidas,288,druid,balance,6,3,3
9801,Lærken,the-maelstrom,288,druid,balance,6,3,3
9802,Блэкфорест,gordunni,288,druid,balance,6,3,3
9803,Fayn,aggra-português,288,druid,balance,6,3,3
9804,Garudas,eldrethalas,288,druid,balance,6,3,3
9805,Erelieva,silvermoon,288,druid,balance,6,3,3
9806,Yezzir,defias-brotherhood,288,druid,balance,6,3,3
9807,Ciwone,blackrock,288,druid,balance,6,3,3
9808,Блинчек,gordunni,288,druid,balance,6,3,3
9809,Faqbàdi,twisting-nether,288,druid,balance,6,3,3
9810,Baubles,ghostlands,288,druid,balance,6,3,3
9811,Måckïngsx,the-maelstrom,288,druid,balance,6,3,3
9812,Bäckey,silvermoon,288,druid,balance,6,3,3
9813,Treksta,draenor,288,druid,balance,6,3,3
9814,Tribemeister,twisting-nether,288,druid,balance,6,3,3
9815,Уэсериктх,blackscar,288,druid,balance,6,3,3
9816,Fishe,twisting-nether,288,druid,balance,6,3,3
9817,Rêdx,archimonde,288,druid,balance,6,3,3
9818,Heejåe,archimonde,288,druid,balance,6,3,3
9819,Shermi,eredar,288,druid,balance,6,3,3
9820,Sweqt,argent-dawn,288,druid,balance,6,3,3
9821,Quinteness,silvermoon,288,druid,balance,6,3,3
9822,Yeats,blackmoore,288,druid,balance,6,3,3
9823,Heldil,chants-éternels,288,druid,balance,6,3,3
9824,Hð,blackmoore,288,druid,balance,6,3,3
9825,Gnarrdrood,eredar,288,druid,balance,6,3,3
9826,Blietmachine,ravencrest,288,druid,balance,6,3,3
9827,Hordepwnr,sylvanas,288,druid,balance,6,3,3
9828,Sparkex,ravencrest,288,druid,balance,6,3,3
9829,Seey,thrall,288,druid,balance,6,3,3
9830,Testopöllö,ravencrest,288,druid,balance,6,3,3
9831,Ullainho,stormscale,288,druid,balance,6,3,3
9832,Barbulloup,hyjal,288,druid,balance,6,3,3
9833,Cyclonejk,blackrock,288,druid,balance,6,3,3
9834,Исканет,gordunni,288,druid,balance,6,3,3
9835,Veilath,tarren-mill,288,druid,balance,6,3,3
9836,Phike,blackrock,288,druid,balance,6,3,3
9837,Garbagemonky,amanthul,288,druid,balance,6,3,3
9838,Motry,tarren-mill,288,druid,balance,6,3,3
9839,Jungleghost,sylvanas,288,druid,balance,6,3,3
9840,Hippycraft,the-maelstrom,288,druid,balance,6,3,3
9841,Вооми,gordunni,288,druid,balance,6,3,3
9842,Worsteux,blackrock,288,druid,balance,6,3,3
9843,Drester,blackrock,288,druid,balance,6,3,3
9844,Bámbí,sylvanas,288,druid,balance,6,3,3
9845,Nóque,ravencrest,288,druid,balance,6,3,3
9846,Jazeera,ragnaros,288,druid,balance,6,3,3
9847,Llcooljay,ravencrest,288,druid,balance,6,3,3
9848,Urilmæ,blackmoore,288,druid,balance,6,3,3
9849,Stiffýz,archimonde,288,druid,balance,6,3,3
9850,Mogwaî,arygos,288,druid,balance,6,3,3
9851,Катяблум,gordunni,288,druid,balance,6,3,3
9852,Tsikarde,ravencrest,288,druid,balance,6,3,3
9853,Maldrýn,stormscale,288,druid,balance,6,3,3
9854,Jac,blackhand,288,druid,balance,6,3,3
9855,Блиденг,gordunni,288,druid,balance,6,3,3
9856,Durlehardu,archimonde,288,druid,balance,6,3,3
9857,Vodkavodkaa,tarren-mill,288,druid,balance,6,3,3
9858,Vyzir,stormscale,288,druid,balance,6,3,3
9859,Mikeisbike,ragnaros,288,druid,balance,6,3,3
9860,Зонкс,gordunni,288,druid,balance,6,3,3
9861,Vícvega,ravencrest,288,druid,balance,6,3,3
9862,Ilus,outland,288,druid,balance,6,3,3
9863,Eysnd,blackrock,288,druid,balance,6,3,3
9864,Àyóorts,archimonde,288,druid,balance,6,3,3
9865,Auden,arathor,288,druid,balance,6,3,3
9866,Amakary,blackrock,288,druid,balance,6,3,3
9867,Alillaeth,ravencrest,288,druid,balance,6,3,3
9868,Nareeik,tarren-mill,288,druid,balance,6,3,3
9869,Løgbjørnen,tarren-mill,288,druid,balance,6,3,3
9870,Cursedmee,blackrock,288,druid,balance,6,3,3
9871,Svantte,stormreaver,288,druid,balance,6,3,3
9872,Druidat,kazzak,288,druid,balance,6,3,3
9873,Dabulla,kazzak,288,druid,balance,6,3,3
9874,Wasïro,zuljin,288,druid,balance,6,3,3
9875,Kooglaash,kazzak,288,druid,balance,6,3,3
9876,Leslra,agamaggan,288,druid,balance,6,3,3
9877,Byjiblznuk,kazzak,288,druid,balance,6,3,3
9878,Rbg,dun-modr,288,druid,balance,6,3,3
9879,Kvngthegoat,kazzak,288,druid,balance,6,3,3
9880,Cáptnmorgan,blackmoore,288,druid,balance,6,3,3
9881,Djclonebot,kazzak,288,druid,balance,6,3,3
9882,Furíouz,darksorrow,288,druid,balance,9,4,5
9883,Bootydrooty,thrall,288,druid,balance,9,3,6
9884,Baracüda,draenor,288,druid,balance,12,3,9
9885,Astarhot,cthun,288,druid,balance,12,3,9
9886,Loverace,dun-modr,288,druid,balance,12,3,9
9887,Akkamory,terokkar,288,druid,balance,12,3,9
9888,Kidow,wrathbringer,288,druid,balance,12,3,9
9889,Сэднхорни,howling-fjord,288,druid,balance,12,3,9
9890,Tayswiftmend,defias-brotherhood,288,druid,balance,12,3,9
9891,Groncowski,blackmoore,288,druid,balance,12,3,9
9892,Zuwyldxd,blackrock,288,druid,balance,12,3,9
9893,Astralcaller,kazzak,288,druid,balance,12,3,9
9894,Thaneo,blackmoore,288,druid,balance,12,3,9
9895,Segundø,archimonde,288,druid,balance,12,3,9
9896,Сейдр,grom,288,druid,balance,18,3,15
9897,Dasgrandeur,kazzak,287,druid,balance,6,3,3
9898,Bigcappa,ahnqiraj,287,druid,balance,6,3,3
9899,Walkao,tarren-mill,287,druid,balance,6,3,3
9900,Millworgen,norgannon,286,druid,balance,12,3,9
9901,Jhiun,ragnaros,256,druid,balance,4,4,0
9902,Calligenia,antonidas,256,druid,balance,16,3,13
9903,Bóssít,doomhammer,255,druid,balance,11,3,8
9904,Drulius,tarren-mill,240,druid,balance,9,4,5
9905,Sinyi,arathor,239,druid,balance,11,3,8
9906,Qoatazinha,malganis,192,druid,balance,4,3,1
9907,Baccon,ravencrest,192,druid,balance,6,2,4
9908,Foxglove,ravencrest,192,druid,balance,6,2,4
9909,Natzuri,lothar,192,druid,balance,6,2,4
9910,Twodaysordie,ravencrest,192,druid,balance,6,2,4
9911,Zolduran,archimonde,192,druid,balance,6,2,4
9912,Halfaway,ravencrest,192,druid,balance,6,2,4
9913,Trueforms,ravencrest,192,druid,balance,6,2,4
9914,Rootbeamftw,ravencrest,192,druid,balance,6,2,4
9915,Bidochonne,ravencrest,192,druid,balance,6,2,4
9916,Ultimoos,aggra-português,192,druid,balance,6,2,4
9917,Hotributionx,ravencrest,192,druid,balance,6,2,4
9918,Dresten,burning-blade,192,druid,balance,6,2,4
9919,Borne,aggra-português,192,druid,balance,6,2,4
9920,Killxhard,ravencrest,192,druid,balance,6,2,4
9921,Hâyâbusa,antonidas,192,druid,balance,6,2,4
9922,Varìx,ysondre,192,druid,balance,6,2,4
9923,Faetish,hyjal,192,druid,balance,6,2,4
9924,Tallbutshort,stormscale,192,druid,balance,6,2,4
9925,Chickenrice,blackhand,192,druid,balance,6,2,4
9926,Chupapoya,pozzo-delleternità,192,druid,balance,6,2,4
9927,Galgaan,burning-legion,192,druid,balance,6,2,4
9928,Violess,burning-legion,192,druid,balance,6,2,4
9929,Jaffacakeqt,draenor,192,druid,balance,6,2,4
9930,Jimmyxdd,kazzak,192,druid,balance,6,2,4
9931,Tranduiil,drakthul,192,druid,balance,6,2,4
9932,Lïlara,elune,192,druid,balance,6,2,4
9933,Jordnötssmör,draenor,192,druid,balance,6,2,4
9934,Werevolf,drakthul,192,druid,balance,6,2,4
9935,Harrasmoes,ravencrest,192,druid,balance,6,2,4
9936,Jflow,draenor,192,druid,balance,6,2,4
9937,Meatus,ragnaros,192,druid,balance,6,2,4
9938,Lyj,dalaran,192,druid,balance,6,2,4
9939,Chzycow,twisting-nether,192,druid,balance,6,2,4
9940,Maxreflect,pozzo-delleternità,192,druid,balance,6,2,4
9941,Erkerkerk,twisting-nether,192,druid,balance,6,2,4
9942,Filderah,doomhammer,192,druid,balance,6,2,4
9943,Roidcat,twisting-nether,192,druid,balance,6,2,4
9944,Akiíra,twisting-nether,192,druid,balance,6,2,4
9945,Уличныйиисус,azuregos,192,druid,balance,6,2,4
9946,Chickenboss,sanguino,192,druid,balance,6,2,4
9947,Снэйк,borean-tundra,192,druid,balance,6,2,4
9948,Имбахилка,lich-king,192,druid,balance,6,2,4
9949,Spidete,sanguino,192,druid,balance,6,2,4
9950,Feraflux,dragonblight,192,druid,balance,6,2,4
9951,Pawnamera,norgannon,192,druid,balance,6,2,4
9952,Nilatsfloda,quelthalas,192,druid,balance,6,2,4
9953,Versality,lightnings-blade,192,druid,balance,6,2,4
9954,Mmhcharal,voljin,192,druid,balance,6,2,4
9955,Blacksage,dragonmaw,192,druid,balance,6,2,4
9956,Дробовик,soulflayer,192,druid,balance,6,2,4
9957,Катали,soulflayer,192,druid,balance,6,2,4
9958,Старселлер,gordunni,192,druid,balance,6,2,4
9959,Kwenden,arygos,192,druid,balance,6,2,4
9960,Друнуар,gordunni,192,druid,balance,6,2,4
9961,Энокей,gordunni,192,druid,balance,6,2,4
9962,Natuh,outland,192,druid,balance,6,2,4
9963,Tamburoo,tarren-mill,192,druid,balance,6,2,4
9964,Luveena,kazzak,192,druid,balance,6,2,4
9965,Druidbox,ravencrest,192,druid,balance,6,2,4
9966,Maxiturbogay,stormscale,192,druid,balance,6,2,4
9967,Фераладзе,gordunni,192,druid,balance,6,2,4
9968,Leliaen,sylvanas,192,druid,balance,6,2,4
9969,Deezforms,kazzak,192,druid,balance,6,2,4
9970,Луноэльф,gordunni,192,druid,balance,6,2,4
9971,Маалир,gordunni,192,druid,balance,6,2,4
9972,Biggestbirdx,stormscale,192,druid,balance,6,2,4
9973,Héryse,hyjal,192,druid,balance,6,2,4
9974,Wheyproteín,dun-modr,192,druid,balance,6,2,4
9975,Kotkacy,silvermoon,192,druid,balance,6,2,4
9976,Tadoson,blackmoore,192,druid,balance,6,2,4
9977,Fromeden,silvermoon,192,druid,balance,6,2,4
9978,Csmedruid,blackrock,192,druid,balance,6,2,4
9979,Skrewu,silvermoon,192,druid,balance,6,2,4
9980,Canezmvp,blackrock,192,druid,balance,6,2,4
9981,Deadlydudu,magtheridon,192,druid,balance,6,2,4
9982,Brømberry,blackrock,192,druid,balance,6,2,4
9983,Auntypat,defias-brotherhood,192,druid,balance,6,2,4
9984,Avanishri,defias-brotherhood,192,druid,balance,6,2,4
9985,Epidruid,stormrage,192,druid,balance,6,2,4
9986,Trowbsi,blackmoore,192,druid,balance,6,2,4
9987,Sorkoxd,silvermoon,192,druid,balance,6,2,4
9988,Kaamirach,blackmoore,192,druid,balance,6,2,4
9989,Fanboij,kazzak,192,druid,balance,6,2,4
9990,Saliencias,kazzak,192,druid,balance,6,2,4
9991,Energäde,twisting-nether,192,druid,balance,7,2,5
9992,Gurranq,argent-dawn,192,druid,balance,11,3,8
9993,Aceeu,dalaran,192,druid,balance,9,2,7
9994,Lelyssa,burning-legion,192,druid,balance,12,2,10
9995,Onmyass,dragonblight,192,druid,balance,12,2,10
9996,Shapeshiptur,argent-dawn,192,druid,balance,12,2,10
9997,Darksthero,draenor,192,druid,balance,12,2,10
9998,Hävefunny,archimonde,192,druid,balance,12,2,10
9999,Leekroom,forscherliga,192,druid,balance,12,2,10
10000,Trækvinden,ravencrest,192,druid,balance,12,2,10
10001,Kramit,ravencrest,192,druid,balance,12,2,10
10002,Querasidru,ravencrest,192,druid,balance,12,2,10
10003,Broasted,stormscale,192,druid,balance,12,2,10
10004,Plankface,ravencrest,192,druid,balance,19,3,16
10005,Sumbahe,blackrock,191,druid,balance,6,2,4
10006,Catbear,kazzak,191,druid,balance,6,2,4
10007,Myrddil,kult-der-verdammten,191,druid,balance,12,2,10
10008,Silvacustos,teldrassil,191,druid,balance,12,2,10
10009,Arrock,malfurion,191,druid,balance,12,2,10
10010,Vendeqt,aegwynn,159,druid,balance,5,2,3
10011,Fabsl,archimonde,159,druid,balance,5,2,3
10012,Иосси,soulflayer,138,druid,balance,9,5,4
10013,Покусаютебя,gordunni,138,druid,balance,10,3,7
10014,Tekilaz,sanguino,128,druid,balance,4,2,2
10015,Xaahl,archimonde,128,druid,balance,4,2,2
10016,Ligoz,silvermoon,96,druid,balance,3,2,1
10017,Nayemi,blackmoore,96,druid,balance,6,1,5
10018,Skinnyleg,baelgun,96,druid,balance,6,1,5
10019,Lemónde,outland,96,druid,balance,6,1,5
10020,Cattdamon,outland,96,druid,balance,6,1,5
10021,Dreathie,kazzak,96,druid,balance,6,1,5
10022,Wolfverine,dentarg,96,druid,balance,6,1,5
10023,Môõn,tarren-mill,96,druid,balance,6,1,5
10024,Ashiothie,argent-dawn,96,druid,balance,6,1,5
10025,Leronox,blackmoore,96,druid,balance,6,1,5
10026,Shalysae,silvermoon,96,druid,balance,6,1,5
10027,Beginníng,outland,96,druid,balance,6,1,5
10028,Anahita,emerald-dream,96,druid,balance,6,1,5
10029,Ösdru,tarren-mill,96,druid,balance,6,1,5
10030,Summër,los-errantes,96,druid,balance,6,1,5
10031,Kaira,kazzak,96,druid,balance,6,1,5
10032,Pudseytree,doomhammer,96,druid,balance,6,1,5
10033,Ãnimal,argent-dawn,96,druid,balance,6,1,5
10034,Scarykejton,draenor,96,druid,balance,6,1,5
10035,Apojeanne,hyjal,96,druid,balance,6,1,5
10036,Sorath,aggramar,96,druid,balance,6,1,5
10037,Tigerbalm,ravenholdt,96,druid,balance,6,1,5
10038,Blazor,eredar,96,druid,balance,6,1,5
10039,Dramweida,eredar,96,druid,balance,6,1,5
10040,Ayven,kazzak,96,druid,balance,6,1,5
10041,Lilkâzzam,blackrock,96,druid,balance,6,1,5
10042,Brownny,dun-modr,96,druid,balance,6,1,5
10043,Panigale,dun-modr,96,druid,balance,6,1,5
10044,Devióus,twilights-hammer,96,druid,balance,6,1,5
10045,Tykè,outland,96,druid,balance,6,1,5
10046,Druidlaba,drakthul,96,druid,balance,6,1,5
10047,Whelpss,archimonde,96,druid,balance,6,1,5
10048,Samuelito,ravencrest,96,druid,balance,6,1,5
10049,Ayanakamurà,archimonde,96,druid,balance,6,1,5
10050,Nermax,kazzak,96,druid,balance,6,1,5
10051,Liegremmah,blackmoore,96,druid,balance,6,1,5
10052,Druiduis,minahonda,96,druid,balance,6,1,5
10053,Tortugo,dun-modr,96,druid,balance,6,1,5
10054,Tàazz,sargeras,96,druid,balance,6,1,5
10055,Droodzerqt,archimonde,96,druid,balance,6,1,5
10056,Enia,azjolnerub,96,druid,balance,6,1,5
10057,Fakeztwo,eredar,96,druid,balance,6,1,5
10058,Арбузир,howling-fjord,96,druid,balance,6,1,5
10059,Reyk,sunstrider,96,druid,balance,6,1,5
10060,Druidja,sylvanas,96,druid,balance,6,1,5
10061,Сверххищникк,soulflayer,96,druid,balance,6,1,5
10062,Маминапуська,soulflayer,96,druid,balance,6,1,5
10063,Hotseîdank,blackrock,96,druid,balance,6,1,5
10064,Spielmann,ravencrest,96,druid,balance,6,1,5
10065,Razah,ravencrest,96,druid,balance,6,1,5
10066,Herekitykity,frostmane,96,druid,balance,6,1,5
10067,Ghxsty,silvermoon,96,druid,balance,6,1,5
10068,Garudax,blackrock,96,druid,balance,6,1,5
10069,Beatball,aegwynn,96,druid,balance,6,1,5
10070,Xwerzz,stormscale,96,druid,balance,6,1,5
10071,Eredhion,stormscale,96,druid,balance,6,1,5
10072,Blolzz,silvermoon,96,druid,balance,6,1,5
10073,Хенет,blackscar,96,druid,balance,6,1,5
10074,Arún,nazjatar,96,druid,balance,6,1,5
10075,Fullcyclone,stormscale,96,druid,balance,6,1,5
10076,Ra,stormscale,96,druid,balance,6,1,5
10077,Nubsi,aegwynn,96,druid,balance,6,1,5
10078,Frequentist,ragnaros,96,druid,balance,6,1,5
10079,Котябра,gordunni,96,druid,balance,6,1,5
10080,Siahra,khaz-modan,96,druid,balance,6,1,5
10081,Jamaicanherb,bronzebeard,96,druid,balance,6,1,5
10082,Zaerox,ambossar,96,druid,balance,6,1,5
10083,Stjärna,kult-der-verdammten,96,druid,balance,6,1,5
10084,Пасторизсша,soulflayer,96,druid,balance,6,1,5
10085,Stuntgirlcat,pozzo-delleternità,96,druid,balance,6,1,5
10086,Ewena,ragnaros,96,druid,balance,6,1,5
10087,Tarendil,argent-dawn,96,druid,balance,12,1,11
10088,Вэдэшечка,howling-fjord,96,druid,balance,12,1,11
10089,Grynoth,silvermoon,96,druid,balance,12,1,11
10090,Noiir,malfurion,96,druid,balance,12,1,11
10091,Maßka,terokkar,96,druid,balance,12,1,11
10092,Kocovali,frostmane,95,druid,balance,6,1,5
10093,Gawsworth,aerie-peak,95,druid,balance,6,1,5
10094,Mirelawe,stormscale,79,druid,balance,5,1,4
10095,Mûcke,kazzak,79,druid,balance,5,1,4
10096,Revoidý,blackmoore,79,druid,balance,5,1,4
10097,Qb,blackrock,79,druid,balance,5,1,4
10098,Kodobursto,stormscale,79,druid,balance,6,1,5
10099,Ушастикэ,gordunni,64,druid,balance,4,1,3
10100,Soofyan,kazzak,48,druid,balance,3,1,2
10101,Exïlla,archimonde,48,druid,balance,3,1,2
10102,Møønlight,scarshield-legion,48,druid,balance,3,1,2
10103,Mortagua,kazzak,48,druid,balance,3,1,2
10104,Madschinken,malganis,42,druid,balance,8,2,6
10105,Melonjuicer,argent-dawn,42,druid,balance,9,2,7
10106,Tiemyrôpe,outland,31,druid,balance,2,1,1
10107,Shapeshifts,kul-tiras,31,druid,balance,2,1,1
10108,Nalreaa,kazzak,31,druid,balance,8,1,7
10109,Báttlx,blackrock,16,druid,balance,7,1,6
10110,Kankethyr,korgall,2241,evoker,preservation,107,64,43
10111,Гачитварь,galakrond,2194,evoker,preservation,251,130,121
10112,Nesedon,stormscale,2170,evoker,preservation,239,127,112
10113,Bodytypezero,terenas,2169,evoker,preservation,110,62,48
10114,Бедныйгрузин,howling-fjord,2146,evoker,preservation,72,43,29
10115,Zychodrac,draenor,2145,evoker,preservation,148,74,74
10116,Néthy,argent-dawn,2131,evoker,preservation,108,60,48
10117,Sukkmymadnes,draenor,2120,evoker,preservation,79,39,40
10118,Сансетшторм,gordunni,2119,evoker,preservation,88,47,41
10119,Kronata,sanguino,2112,evoker,preservation,102,45,57
10120,Dn,shattered-hand,2111,evoker,preservation,89,46,43
10121,Dragonsweat,hyjal,2088,evoker,preservation,120,66,54
10122,Haxyia,outland,2083,evoker,preservation,120,63,57
10123,Najikí,tarren-mill,2069,evoker,preservation,107,61,46
10124,Ramfurry,kazzak,2045,evoker,preservation,201,107,94
10125,Nerfevøker,ragnaros,2022,evoker,preservation,100,51,49
10126,Humòngóus,kazzak,2008,evoker,preservation,54,29,25
10127,Sinéstrà,antonidas,2005,evoker,preservation,216,111,105
10128,Gardennewt,ravencrest,2001,evoker,preservation,78,39,39
10129,Drogon,shendralar,1992,evoker,preservation,84,48,36
10130,Xays,ravencrest,1987,evoker,preservation,100,50,50
10131,Theories,blackhand,1977,evoker,preservation,110,54,56
10132,Puzikloh,ravencrest,1973,evoker,preservation,42,23,19
10133,Ноубадиаттак,soulflayer,1963,evoker,preservation,102,49,53
10134,Smellybreath,ravencrest,1961,evoker,preservation,48,27,21
10135,Шафлэнжоер,fordragon,1958,evoker,preservation,30,22,8
10136,Rvrsl,outland,1954,evoker,preservation,108,55,53
10137,Podonok,ravencrest,1932,evoker,preservation,84,45,39
10138,Dizablise,burning-legion,1931,evoker,preservation,77,40,37
10139,Seafolk,stormscale,1927,evoker,preservation,217,119,98
10140,Onelastdance,ravencrest,1922,evoker,preservation,71,61,10
10141,Jamesdéan,twisting-nether,1921,evoker,preservation,108,68,40
10142,Dragondaddy,eredar,1917,evoker,preservation,114,63,51
10143,Nahfr,terenas,1905,evoker,preservation,132,75,57
10144,Drookun,outland,1905,evoker,preservation,75,39,36
10145,Dracthal,blackmoore,1903,evoker,preservation,54,29,25
10146,Waifuwu,blackhand,1900,evoker,preservation,175,85,90
10147,Адоннис,gordunni,1891,evoker,preservation,72,43,29
10148,Huxleysroar,draenor,1888,evoker,preservation,54,26,28
10149,Ðåñîq,kazzak,1888,evoker,preservation,89,38,51
10150,Phnx,blackrock,1886,evoker,preservation,246,125,121
10151,Myxiwinxy,archimonde,1885,evoker,preservation,36,23,13
10152,Theories,aegwynn,1880,evoker,preservation,53,29,24
10153,Amadeusx,ravencrest,1879,evoker,preservation,96,47,49
10154,Matrixslave,tarren-mill,1875,evoker,preservation,81,46,35
10155,Vokedrak,eredar,1875,evoker,preservation,66,32,34
10156,Plogi,twisting-nether,1869,evoker,preservation,54,32,22
10157,Nakavoker,arygos,1859,evoker,preservation,115,56,59
10158,Ipho,twisting-nether,1856,evoker,preservation,100,45,55
10159,Titnoute,archimonde,1856,evoker,preservation,60,25,35
10160,Bodytypefour,stormscale,1854,evoker,preservation,66,28,38
10161,Béatér,aegwynn,1852,evoker,preservation,102,58,44
10162,Ltmdrgn,ravencrest,1851,evoker,preservation,42,26,16
10163,Ripgódx,bronzebeard,1851,evoker,preservation,354,182,172
10164,Zimbello,nemesis,1849,evoker,preservation,54,34,20
10165,Myshagini,ravencrest,1846,evoker,preservation,45,27,18
10166,Æzorahai,area-52,1845,evoker,preservation,72,33,39
10167,Bümber,stormscale,1835,evoker,preservation,129,64,65
10168,Yulinex,argent-dawn,1833,evoker,preservation,160,92,68
10169,Cellv,kazzak,1829,evoker,preservation,156,88,68
10170,Jakelóng,ravencrest,1818,evoker,preservation,52,25,27
10171,Justyowxs,archimonde,1817,evoker,preservation,85,49,36
10172,Smâûg,silvermoon,1812,evoker,preservation,48,27,21
10173,Mixn,argent-dawn,1812,evoker,preservation,93,41,52
10174,Gneltharion,draenor,1811,evoker,preservation,68,31,37
10175,Infidus,ravencrest,1810,evoker,preservation,145,82,63
10176,Puffthemagic,archimonde,1810,evoker,preservation,60,28,32
10177,Dragonmeta,kazzak,1808,evoker,preservation,36,19,17
10178,Dreamwalk,archimonde,1806,evoker,preservation,24,19,5
10179,Wakûwakû,kazzak,1805,evoker,preservation,135,72,63
10180,Evokis,tarren-mill,1804,evoker,preservation,71,40,31
10181,Трейш,soulflayer,1804,evoker,preservation,90,42,48
10182,Hornyxj,draenor,1804,evoker,preservation,78,33,45
10183,Keñwøød,ysondre,1803,evoker,preservation,60,33,27
10184,Cptdrakon,twisting-nether,1802,evoker,preservation,77,43,34
10185,Lerrastrasza,zirkel-des-cenarius,1802,evoker,preservation,48,24,24
10186,Sính,ravencrest,1801,evoker,preservation,53,28,25
10187,Alusiedrake,ravencrest,1800,evoker,preservation,295,163,132
10188,Talim,terrordar,1800,evoker,preservation,78,37,41
10189,Phyrrax,silvermoon,1798,evoker,preservation,54,33,21
10190,Elcocodrilo,tarren-mill,1790,evoker,preservation,36,21,15
10191,Лабирон,blackscar,1789,evoker,preservation,54,24,30
10192,Swainsupp,archimonde,1776,evoker,preservation,42,19,23
10193,Yayaxoxoxoxo,hyjal,1775,evoker,preservation,54,25,29
10194,Lazey,stormscale,1769,evoker,preservation,94,50,44
10195,Ezinice,hyjal,1767,evoker,preservation,88,45,43
10196,Антошадф,gordunni,1760,evoker,preservation,54,29,25
10197,Froststraza,chamber-of-aspects,1758,evoker,preservation,60,27,33
10198,Kalevra,eredar,1757,evoker,preservation,123,66,57
10199,Healevoker,aegwynn,1755,evoker,preservation,177,85,92
10200,Хронолиса,blackscar,1752,evoker,preservation,258,133,125
10201,Camdaddy,magtheridon,1749,evoker,preservation,171,88,83
10202,Asyncgosa,ravencrest,1749,evoker,preservation,60,25,35
10203,Elleavo,tarren-mill,1742,evoker,preservation,48,23,25
10204,Baiyuekui,blackmoore,1740,evoker,preservation,375,183,192
10205,Drakela,frostwhisper,1732,evoker,preservation,42,22,20
10206,Themasktw,kazzak,1728,evoker,preservation,64,29,35
10207,Evocy,ravencrest,1725,evoker,preservation,66,35,31
10208,Däkuookami,twisting-nether,1716,evoker,preservation,24,18,6
10209,Bugdul,twisting-nether,1713,evoker,preservation,74,46,28
10210,Даэдра,gordunni,1712,evoker,preservation,186,94,92
10211,Ранкондракон,lich-king,1712,evoker,preservation,95,42,53
10212,Maxthecar,draenor,1710,evoker,preservation,136,87,49
10213,Branados,argent-dawn,1707,evoker,preservation,36,22,14
10214,Novvae,hyjal,1704,evoker,preservation,60,32,28
10215,Carrotz,doomhammer,1703,evoker,preservation,60,28,32
10216,Jaje,nerathor,1701,evoker,preservation,46,24,22
10217,Pcerainer,stormscale,1699,evoker,preservation,53,26,27
10218,Nyghtx,sanguino,1698,evoker,preservation,100,45,55
10219,Kaipha,ravencrest,1697,evoker,preservation,71,38,33
10220,Lurkî,blackhand,1690,evoker,preservation,179,82,97
10221,Аскми,blackscar,1690,evoker,preservation,96,43,53
10222,Tombeelee,kazzak,1687,evoker,preservation,36,21,15
10223,Nivoker,kazzak,1687,evoker,preservation,51,24,27
10224,Evoxter,twisting-nether,1686,evoker,preservation,36,26,10
10225,Flouzzx,blackmoore,1685,evoker,preservation,48,24,24
10226,Ms,ravencrest,1683,evoker,preservation,46,24,22
10227,Reska,archimonde,1678,evoker,preservation,54,25,29
10228,Mìnos,drakthul,1677,evoker,preservation,36,18,18
10229,Brynesuge,ragnaros,1676,evoker,preservation,63,32,31
10230,Setraxia,argent-dawn,1673,evoker,preservation,130,81,49
10231,Jkdrage,stormscale,1670,evoker,preservation,36,19,17
10232,Häröpallo,stormscale,1669,evoker,preservation,75,44,31
10233,Malboroasted,archimonde,1665,evoker,preservation,48,25,23
10234,Mixoö,throkferoth,1664,evoker,preservation,78,39,39
10235,Эндемический,soulflayer,1664,evoker,preservation,79,39,40
10236,Драконсила,gordunni,1663,evoker,preservation,41,21,20
10237,Thèrèse,hyjal,1658,evoker,preservation,42,20,22
10238,Ambuy,kazzak,1656,evoker,preservation,35,21,14
10239,Sebek,archimonde,1653,evoker,preservation,33,19,14
10240,Gardenewt,ravencrest,1647,evoker,preservation,42,21,21
10241,Devidra,defias-brotherhood,1645,evoker,preservation,111,47,64
10242,Wernøker,archimonde,1643,evoker,preservation,54,23,31
10243,Roth,stormreaver,1641,evoker,preservation,220,110,110
10244,Valtion,stormscale,1634,evoker,preservation,42,23,19
10245,Evodorie,ravencrest,1634,evoker,preservation,44,21,23
10246,Sanktcs,blackhand,1633,evoker,preservation,48,23,25
10247,Rüllatorsven,stormscale,1631,evoker,preservation,36,21,15
10248,Тирэсплюс,soulflayer,1630,evoker,preservation,30,17,13
10249,Kackaloch,tarren-mill,1625,evoker,preservation,69,37,32
10250,Dwagonzuv,the-maelstrom,1624,evoker,preservation,60,36,24
10251,Aeste,dun-modr,1624,evoker,preservation,42,23,19
10252,Detdragetid,zenedar,1622,evoker,preservation,102,40,62
10253,Methamfetami,kazzak,1619,evoker,preservation,72,40,32
10254,Âspên,archimonde,1618,evoker,preservation,105,50,55
10255,Bòrís,kazzak,1617,evoker,preservation,18,17,1
10256,Chasxstrasza,ravencrest,1616,evoker,preservation,54,20,34
10257,Omac,sylvanas,1615,evoker,preservation,42,22,20
10258,Akaos,silvermoon,1613,evoker,preservation,38,20,18
10259,Blueaizu,draenor,1612,evoker,preservation,137,78,59
10260,Bònéz,blackmoore,1612,evoker,preservation,107,50,57
10261,Fartinhaler,ravencrest,1611,evoker,preservation,56,34,22
10262,Dârys,kazzak,1611,evoker,preservation,46,20,26
10263,Adriia,draenor,1610,evoker,preservation,24,17,7
10264,Drakeadorie,twisting-nether,1610,evoker,preservation,30,20,10
10265,Rgedrake,blackrock,1605,evoker,preservation,114,67,47
10266,Hjucen,twisting-nether,1603,evoker,preservation,90,49,41
10267,Ятромантис,gordunni,1603,evoker,preservation,625,318,307
10268,Потныйдракон,soulflayer,1603,evoker,preservation,42,20,22
10269,Пидрактир,soulflayer,1602,evoker,preservation,54,26,28
10270,Castytopg,blackrock,1602,evoker,preservation,36,17,19
10271,Akly,nemesis,1600,evoker,preservation,60,37,23
10272,Bråckie,draenor,1600,evoker,preservation,84,49,35
10273,Malowux,outland,1600,evoker,preservation,36,19,17
10274,Dragonello,stormscale,1600,evoker,preservation,36,17,19
10275,Draskathyr,sylvanas,1594,evoker,preservation,47,29,18
10276,Crocodeal,ysondre,1593,evoker,preservation,48,26,22
10277,Ксенондрейк,gordunni,1591,evoker,preservation,36,17,19
10278,Dragnthsnuts,sylvanas,1590,evoker,preservation,50,26,24
10279,Ystarblaze,tarren-mill,1590,evoker,preservation,57,26,31
10280,Штеци,howling-fjord,1582,evoker,preservation,462,224,238
10281,Odensbest,silvermoon,1580,evoker,preservation,79,48,31
10282,Dragarius,tarren-mill,1580,evoker,preservation,48,19,29
10283,Gracyn,ravencrest,1570,evoker,preservation,30,20,10
10284,Nahkiainen,darksorrow,1569,evoker,preservation,42,19,23
10285,Rawrus,blackrock,1567,evoker,preservation,53,24,29
10286,Flowerscale,tarren-mill,1567,evoker,preservation,51,19,32
10287,Scarydragôn,draenor,1565,evoker,preservation,140,79,61
10288,Alamostrasza,doomhammer,1564,evoker,preservation,48,22,26
10289,Kuramir,twisting-nether,1560,evoker,preservation,54,27,27
10290,Websensation,twisting-nether,1559,evoker,preservation,90,35,55
10291,Shroudflight,draenor,1558,evoker,preservation,125,52,73
10292,Eidachsal,antonidas,1558,evoker,preservation,66,24,42
10293,Lytër,sanguino,1555,evoker,preservation,141,75,66
10294,Vydrag,der-rat-von-dalaran,1553,evoker,preservation,35,17,18
10295,Fearawr,malganis,1552,evoker,preservation,63,22,41
10296,Didii,frostwhisper,1548,evoker,preservation,183,88,95
10297,Zenvoker,silvermoon,1543,evoker,preservation,119,60,59
10298,Valkroth,argent-dawn,1541,evoker,preservation,149,67,82
10299,Antiflexx,ragnaros,1537,evoker,preservation,66,30,36
10300,Нежныйболт,howling-fjord,1536,evoker,preservation,134,68,66
10301,Sürion,grim-batol,1535,evoker,preservation,72,39,33
10302,Sedricae,twisting-nether,1534,evoker,preservation,137,70,67
10303,Kirivoker,dun-modr,1526,evoker,preservation,65,31,34
10304,Kharduk,outland,1525,evoker,preservation,40,19,21
10305,Vimoker,trollbane,1523,evoker,preservation,102,49,53
10306,Sinistrea,conseil-des-ombres,1512,evoker,preservation,117,65,52
10307,Bubbleblower,stormscale,1510,evoker,preservation,30,21,9
10308,Дарконикс,gordunni,1508,evoker,preservation,98,44,54
10309,Torae,burning-legion,1502,evoker,preservation,66,31,35
10310,Nexxà,archimonde,1501,evoker,preservation,63,45,18
10311,Navilism,kazzak,1501,evoker,preservation,429,228,201
10312,Jayrexx,doomhammer,1500,evoker,preservation,73,51,22
10313,Skypov,sylvanas,1498,evoker,preservation,41,24,17
10314,Pflanz,nozdormu,1494,evoker,preservation,36,24,12
10315,Indragon,blackmoore,1492,evoker,preservation,78,37,41
10316,Tenibris,die-nachtwache,1491,evoker,preservation,143,67,76
10317,Tobbebakar,silvermoon,1490,evoker,preservation,48,22,26
10318,Динамика,borean-tundra,1488,evoker,preservation,115,61,54
10319,Fiiery,deathwing,1488,evoker,preservation,82,42,40
10320,Lytër,dun-modr,1488,evoker,preservation,63,28,35
10321,Polzeig,dentarg,1487,evoker,preservation,45,19,26
10322,Superflyy,kazzak,1486,evoker,preservation,172,83,89
10323,Obbwoke,ravencrest,1486,evoker,preservation,120,53,67
10324,Ацидракон,blackscar,1481,evoker,preservation,83,35,48
10325,Sakade,archimonde,1480,evoker,preservation,40,18,22
10326,Sárkány,ravencrest,1478,evoker,preservation,36,17,19
10327,Gg,wildhammer,1477,evoker,preservation,59,37,22
10328,Srache,frostwolf,1477,evoker,preservation,36,16,20
10329,Ámenó,stormscale,1476,evoker,preservation,48,25,23
10330,Lazurius,ravencrest,1472,evoker,preservation,101,43,58
10331,Eagleflow,aszune,1469,evoker,preservation,85,41,44
10332,Nekrosdrake,tarren-mill,1469,evoker,preservation,83,39,44
10333,Drageye,tarren-mill,1467,evoker,preservation,115,64,51
10334,Luderx,outland,1467,evoker,preservation,90,49,41
10335,Dragoncya,archimonde,1466,evoker,preservation,102,50,52
10336,Oldwhiteman,guldan,1465,evoker,preservation,52,25,27
10337,Viodragon,blackrock,1462,evoker,preservation,45,19,26
10338,Samidr,ravencrest,1460,evoker,preservation,41,16,25
10339,Бадикабаер,thermaplugg,1457,evoker,preservation,200,104,96
10340,Beefwing,xavius,1454,evoker,preservation,48,21,27
10341,Féféledragon,archimonde,1452,evoker,preservation,62,24,38
10342,Fubukinoryuu,frostwolf,1451,evoker,preservation,112,61,51
10343,Madelynxoxo,draenor,1450,evoker,preservation,30,25,5
10344,Bigaluga,blackmoore,1446,evoker,preservation,54,22,32
10345,Condrage,grim-batol,1445,evoker,preservation,42,22,20
10346,Nanthira,darksorrow,1445,evoker,preservation,110,53,57
10347,Etier,aegwynn,1444,evoker,preservation,48,25,23
10348,Detixbae,blackrock,1443,evoker,preservation,41,16,25
10349,Dazaar,kazzak,1442,evoker,preservation,54,34,20
10350,Шкуроносец,gordunni,1442,evoker,preservation,36,20,16
10351,Omnipøtens,silvermoon,1441,evoker,preservation,42,27,15
10352,Evizard,nagrand,1438,evoker,preservation,89,49,40
10353,Drachenlilie,aegwynn,1436,evoker,preservation,30,16,14
10354,Nutson,blackrock,1436,evoker,preservation,30,15,15
10355,Conwoker,ravencrest,1435,evoker,preservation,30,15,15
10356,Wingard,twisting-nether,1431,evoker,preservation,29,17,12
10357,Tarecgosa,sanguino,1431,evoker,preservation,245,118,127
10358,Iblvicanfly,stormscale,1429,evoker,preservation,31,17,14
10359,Dokkàmxk,archimonde,1429,evoker,preservation,36,15,21
10360,Natashtrasza,tarren-mill,1427,evoker,preservation,72,26,46
10361,Scalo,kazzak,1423,evoker,preservation,131,67,64
10362,Dedx,sylvanas,1423,evoker,preservation,39,19,20
10363,Cokayn,eonar,1422,evoker,preservation,51,23,28
10364,Sârmikas,blackhand,1420,evoker,preservation,30,15,15
10365,Cheryl,aggra-português,1420,evoker,preservation,31,15,16
10366,Viseriøn,kazzak,1420,evoker,preservation,48,16,32
10367,Орехдракона,gordunni,1418,evoker,preservation,30,16,14
10368,Yeatsa,blackmoore,1417,evoker,preservation,24,15,9
10369,Th,stormscale,1415,evoker,preservation,48,32,16
10370,Djrabtah,sargeras,1414,evoker,preservation,82,43,39
10371,Chronowalker,ragnaros,1413,evoker,preservation,30,15,15
10372,Вексалис,gordunni,1411,evoker,preservation,30,15,15
10373,Lichbõrne,outland,1411,evoker,preservation,42,18,24
10374,Thyrke,aegwynn,1407,evoker,preservation,94,52,42
10375,Spiragon,ysondre,1406,evoker,preservation,154,76,78
10376,Kuubski,ravencrest,1405,evoker,preservation,26,17,9
10377,Aêro,malganis,1403,evoker,preservation,50,22,28
10378,Draelaynex,eredar,1403,evoker,preservation,36,15,21
10379,Dragondznutz,defias-brotherhood,1401,evoker,preservation,65,31,34
10380,Емари,howling-fjord,1397,evoker,preservation,43,30,13
10381,Evoketing,tarren-mill,1396,evoker,preservation,24,15,9
10382,Мефодийевок,howling-fjord,1394,evoker,preservation,60,23,37
10383,Drackarys,tarren-mill,1393,evoker,preservation,60,31,29
10384,Donns,frostmane,1391,evoker,preservation,58,36,22
10385,Cragheart,ravencrest,1391,evoker,preservation,60,28,32
10386,Nagimurr,kazzak,1390,evoker,preservation,99,57,42
10387,Dracanus,bronze-dragonflight,1390,evoker,preservation,54,28,26
10388,Nadoney,hyjal,1389,evoker,preservation,67,42,25
10389,Dragio,blackrock,1387,evoker,preservation,48,25,23
10390,Ammendorn,blackrock,1384,evoker,preservation,46,27,19
10391,Azorgaron,outland,1383,evoker,preservation,60,26,34
10392,Asraestrasz,silvermoon,1380,evoker,preservation,38,24,14
10393,Jamiewing,ravencrest,1380,evoker,preservation,42,25,17
10394,Krayvoker,tarren-mill,1372,evoker,preservation,35,15,20
10395,Dothemath,blackmoore,1371,evoker,preservation,48,22,26
10396,Badrig,silvermoon,1369,evoker,preservation,144,70,74
10397,Filtendragon,stormscale,1362,evoker,preservation,43,21,22
10398,Buqxrawrr,antonidas,1358,evoker,preservation,32,18,14
10399,Matysniak,burning-legion,1355,evoker,preservation,51,24,27
10400,Scalie,ravencrest,1353,evoker,preservation,54,31,23
10401,Darigo,ravencrest,1353,evoker,preservation,30,16,14
10402,Sarapakara,burning-blade,1351,evoker,preservation,36,18,18
10403,Маркзук,gordunni,1350,evoker,preservation,112,53,59
10404,Liliwood,ravencrest,1349,evoker,preservation,82,38,44
10405,Evokazoran,dentarg,1349,evoker,preservation,78,27,51
10406,Cinquanteuro,hyjal,1347,evoker,preservation,101,45,56
10407,Choubalo,archimonde,1346,evoker,preservation,66,35,31
10408,Rescuegirl,blackrock,1345,evoker,preservation,99,50,49
10409,Varkoth,nemesis,1345,evoker,preservation,84,41,43
10410,Sissilisko,sylvanas,1344,evoker,preservation,41,25,16
10411,Kitoed,aegwynn,1344,evoker,preservation,78,35,43
10412,Dragonsimp,archimonde,1340,evoker,preservation,28,17,11
10413,Drarent,hyjal,1340,evoker,preservation,54,24,30
10414,Profdrake,zuluhed,1337,evoker,preservation,24,14,10
10415,Shosho,uldaman,1337,evoker,preservation,30,15,15
10416,Rhaenîra,twisting-nether,1333,evoker,preservation,36,20,16
10417,Ashmoo,archimonde,1333,evoker,preservation,30,14,16
10418,Icemushu,twisting-nether,1331,evoker,preservation,24,14,10
10419,Draevil,emerald-dream,1330,evoker,preservation,42,22,20
10420,Loveheart,die-aldor,1330,evoker,preservation,94,41,53
10421,Drakkujjer,twisting-nether,1329,evoker,preservation,24,15,9
10422,Pelington,silvermoon,1329,evoker,preservation,59,27,32
10423,Aphelïon,dun-modr,1327,evoker,preservation,173,84,89
10424,Gissthebuzzy,dun-modr,1326,evoker,preservation,42,24,18
10425,Saga,aegwynn,1325,evoker,preservation,154,77,77
10426,Drdrag,blackmoore,1324,evoker,preservation,24,18,6
10427,Fetzi,blackhand,1324,evoker,preservation,126,63,63
10428,Smrdimipytel,drakthul,1323,evoker,preservation,40,15,25
10429,Uroegevoker,twisting-nether,1316,evoker,preservation,68,36,32
10430,Ladrieth,hyjal,1316,evoker,preservation,71,34,37
10431,Desnø,frostwolf,1315,evoker,preservation,37,21,16
10432,Голденджо,gordunni,1315,evoker,preservation,59,21,38
10433,Dägon,drakthul,1312,evoker,preservation,72,36,36
10434,Crunktusk,twisting-nether,1310,evoker,preservation,72,27,45
10435,Thellon,frostwolf,1308,evoker,preservation,97,49,48
10436,Бунтз,howling-fjord,1306,evoker,preservation,29,14,15
10437,Xerragon,ravencrest,1306,evoker,preservation,60,20,40
10438,Fredgobrr,tarren-mill,1305,evoker,preservation,102,62,40
10439,Cenca,blackmoore,1304,evoker,preservation,210,101,109
10440,Ludracy,antonidas,1301,evoker,preservation,102,54,48
10441,Asinitaris,ravencrest,1300,evoker,preservation,77,42,35
10442,Drashiku,zuljin,1299,evoker,preservation,84,30,54
10443,Nonolildrake,ysondre,1297,evoker,preservation,82,46,36
10444,Vahamut,argent-dawn,1297,evoker,preservation,42,22,20
10445,Scarlexo,ravencrest,1297,evoker,preservation,47,22,25
10446,Sorextrazy,twisting-nether,1296,evoker,preservation,70,29,41
10447,Breall,tarren-mill,1292,evoker,preservation,388,185,203
10448,Orocimaaru,pozzo-delleternità,1289,evoker,preservation,30,16,14
10449,Flygfjås,stormscale,1288,evoker,preservation,57,28,29
10450,Discodidling,silvermoon,1287,evoker,preservation,63,32,31
10451,Pindaar,zenedar,1283,evoker,preservation,42,17,25
10452,Malfø,exodar,1282,evoker,preservation,115,58,57
10453,Cothikos,ysondre,1282,evoker,preservation,34,15,19
10454,Xiomarita,frostmane,1280,evoker,preservation,60,29,31
10455,Draxaer,outland,1278,evoker,preservation,116,60,56
10456,Blamdrake,blackhand,1275,evoker,preservation,36,14,22
10457,Lynastrasza,silvermoon,1274,evoker,preservation,147,78,69
10458,Drogøn,khaz-modan,1274,evoker,preservation,42,21,21
10459,Hyggëê,sanguino,1273,evoker,preservation,51,22,29
10460,Stormwing,twilights-hammer,1272,evoker,preservation,29,19,10
10461,Beharot,silvermoon,1272,evoker,preservation,96,33,63
10462,Jimmytrivet,archimonde,1271,evoker,preservation,63,30,33
10463,Vaermithor,tarren-mill,1270,evoker,preservation,59,33,26
10464,Vyron,amanthul,1270,evoker,preservation,46,19,27
10465,Iphonetwo,ravencrest,1267,evoker,preservation,29,20,9
10466,Thundermifln,nemesis,1266,evoker,preservation,48,26,22
10467,Dragonerr,kiljaeden,1264,evoker,preservation,47,25,22
10468,Howtodragon,twisting-nether,1262,evoker,preservation,48,26,22
10469,Mortlalune,conseil-des-ombres,1260,evoker,preservation,154,78,76
10470,Folevo,stormreaver,1255,evoker,preservation,295,144,151
10471,Mugeki,burning-legion,1255,evoker,preservation,59,28,31
10472,Drgnokn,silvermoon,1252,evoker,preservation,80,48,32
10473,Nagoli,silvermoon,1250,evoker,preservation,55,26,29
10474,Dinotron,uldaman,1249,evoker,preservation,54,27,27
10475,Lynt,burning-blade,1248,evoker,preservation,66,34,32
10476,Sondosa,twisting-nether,1248,evoker,preservation,30,15,15
10477,Aebivoker,dalaran,1245,evoker,preservation,30,18,12
10478,Kda,die-nachtwache,1245,evoker,preservation,30,13,17
10479,Nazalath,eonar,1245,evoker,preservation,42,18,24
10480,Патриотика,howling-fjord,1244,evoker,preservation,95,45,50
10481,Dargenpont,turalyon,1244,evoker,preservation,30,13,17
10482,Schwañ,twisting-nether,1243,evoker,preservation,24,13,11
10483,Crottedezen,archimonde,1243,evoker,preservation,30,13,17
10484,Apaçi,ravencrest,1243,evoker,preservation,51,19,32
10485,Ithijin,blackmoore,1241,evoker,preservation,59,27,32
10486,Dragawn,grim-batol,1240,evoker,preservation,121,68,53
10487,Kymura,archimonde,1239,evoker,preservation,30,13,17
10488,Voraxos,silvermoon,1238,evoker,preservation,18,13,5
10489,Vyore,silvermoon,1238,evoker,preservation,24,13,11
10490,Тектрис,howling-fjord,1238,evoker,preservation,126,58,68
10491,Kampe,nemesis,1237,evoker,preservation,36,17,19
10492,Airwaves,hyjal,1233,evoker,preservation,24,14,10
10493,Draagon,burning-legion,1232,evoker,preservation,36,15,21
10494,Drackheal,kaelthas,1229,evoker,preservation,59,31,28
10495,Elenaevoker,stormscale,1229,evoker,preservation,161,82,79
10496,Beenus,doomhammer,1228,evoker,preservation,36,24,12
10497,Lagadta,antonidas,1228,evoker,preservation,36,22,14
10498,Драгоблуд,soulflayer,1227,evoker,preservation,54,25,29
10499,Âbs,archimonde,1227,evoker,preservation,99,41,58
10500,Smokitor,kazzak,1223,evoker,preservation,48,24,24
10501,Pokemongame,draenor,1222,evoker,preservation,22,14,8
10502,Douevnfly,ravencrest,1220,evoker,preservation,44,26,18
10503,Stjáuni,ravencrest,1219,evoker,preservation,58,29,29
10504,Мвпгуччи,blackscar,1219,evoker,preservation,36,13,23
10505,Verithian,kazzak,1218,evoker,preservation,42,22,20
10506,Drakdilla,tarren-mill,1216,evoker,preservation,24,13,11
10507,Shnptyr,ragnaros,1215,evoker,preservation,42,22,20
10508,Lojinevo,twisting-nether,1215,evoker,preservation,95,43,52
10509,Kekvoker,antonidas,1213,evoker,preservation,72,35,37
10510,Ruinastrasza,silvermoon,1212,evoker,preservation,24,13,11
10511,Wrcdragon,drakthul,1212,evoker,preservation,136,60,76
10512,Varaug,veklor,1211,evoker,preservation,40,25,15
10513,Groovyy,hyjal,1211,evoker,preservation,60,36,24
10514,Awaboo,draenor,1210,evoker,preservation,24,13,11
10515,Slimygecko,ravencrest,1210,evoker,preservation,41,22,19
10516,Flyingaway,tarren-mill,1209,evoker,preservation,42,19,23
10517,Мэриджэин,soulflayer,1205,evoker,preservation,41,18,23
10518,Geckonen,stormreaver,1204,evoker,preservation,179,90,89
10519,Theocean,turalyon,1204,evoker,preservation,259,120,139
10520,Whitelizzard,tarren-mill,1199,evoker,preservation,60,29,31
10521,Dragonspaff,argent-dawn,1199,evoker,preservation,30,14,16
10522,Erhvoker,veknilash,1199,evoker,preservation,111,47,64
10523,Corneflex,chogall,1196,evoker,preservation,27,13,14
10524,Yeetsera,thrall,1195,evoker,preservation,58,25,33
10525,Zethreus,silvermoon,1192,evoker,preservation,64,34,30
10526,Bestofriendo,eredar,1191,evoker,preservation,72,36,36
10527,Dolphdrago,outland,1190,evoker,preservation,28,15,13
10528,Sibvoker,kazzak,1188,evoker,preservation,108,52,56
10529,Sitdownnow,blackrock,1188,evoker,preservation,56,19,37
10530,Salamanderx,stormscale,1186,evoker,preservation,22,14,8
10531,Uztfuzt,blackmoore,1185,evoker,preservation,44,29,15
10532,Raøug,blackmoore,1182,evoker,preservation,54,18,36
10533,Drakatha,kazzak,1181,evoker,preservation,57,33,24
10534,Xdxd,burning-blade,1180,evoker,preservation,27,13,14
10535,Muccavok,stormrage,1179,evoker,preservation,64,34,30
10536,Belkavoker,zirkel-des-cenarius,1177,evoker,preservation,42,14,28
10537,Kujira,draenor,1171,evoker,preservation,27,16,11
10538,Dayandnight,quelthalas,1170,evoker,preservation,60,28,32
10539,Aphi,frostwolf,1170,evoker,preservation,57,26,31
10540,Glouglouti,drekthar,1168,evoker,preservation,60,27,33
10541,Saucy,sanguino,1166,evoker,preservation,43,26,17
10542,Anso,sanguino,1164,evoker,preservation,53,26,27
10543,Уконэ,blackscar,1159,evoker,preservation,49,22,27
10544,Dracobelli,drakthul,1157,evoker,preservation,30,14,16
10545,Amaterãsu,kazzak,1154,evoker,preservation,77,37,40
10546,Jmy,bloodhoof,1152,evoker,preservation,18,12,6
10547,Dracum,kazzak,1152,evoker,preservation,24,12,12
10548,Odiin,dun-modr,1151,evoker,preservation,21,13,8
10549,Hehehihihaha,ravencrest,1151,evoker,preservation,24,12,12
10550,Mistrßroducr,stormreaver,1151,evoker,preservation,24,12,12
10551,Siìre,thrall,1150,evoker,preservation,12,12,0
10552,Mysaldo,sylvanas,1150,evoker,preservation,18,12,6
10553,Coarraze,eldrethalas,1148,evoker,preservation,18,12,6
10554,Veryspikes,twisting-nether,1148,evoker,preservation,30,12,18
10555,Reptak,stormscale,1146,evoker,preservation,24,12,12
10556,Uwudyret,tarren-mill,1145,evoker,preservation,30,12,18
10557,Панераи,gordunni,1145,evoker,preservation,39,12,27
10558,Cryuu,burning-legion,1144,evoker,preservation,30,12,18
10559,Sinusiitiis,destromath,1142,evoker,preservation,18,12,6
10560,Tsukiko,archimonde,1140,evoker,preservation,43,16,27
10561,Ryujíin,kazzak,1139,evoker,preservation,23,12,11
10562,Nisiris,doomhammer,1139,evoker,preservation,58,29,29
10563,Yorfyr,ravencrest,1139,evoker,preservation,37,16,21
10564,Dragonbrx,antonidas,1138,evoker,preservation,18,12,6
10565,Emberturd,blackmoore,1138,evoker,preservation,24,12,12
10566,Nikoo,runetotem,1138,evoker,preservation,36,13,23
10567,Jurrassic,defias-brotherhood,1133,evoker,preservation,69,38,31
10568,Steeken,haomarush,1130,evoker,preservation,54,26,28
10569,Xorago,guldan,1127,evoker,preservation,42,18,24
10570,Adnoc,tarren-mill,1124,evoker,preservation,19,13,6
10571,Djolero,silvermoon,1124,evoker,preservation,60,28,32
10572,Siderion,drakthul,1122,evoker,preservation,24,14,10
10573,Retyss,twisting-nether,1115,evoker,preservation,348,176,172
10574,Nynnaydoth,drakthul,1112,evoker,preservation,80,39,41
10575,Drachenglas,antonidas,1112,evoker,preservation,30,13,17
10576,Sudrac,antonidas,1110,evoker,preservation,24,12,12
10577,Tennin,thrall,1108,evoker,preservation,51,28,23
10578,Huusdrache,outland,1107,evoker,preservation,34,14,20
10579,Пероник,gordunni,1107,evoker,preservation,52,18,34
10580,Dangai,draenor,1103,evoker,preservation,23,12,11
10581,Hems,bronzebeard,1101,evoker,preservation,70,36,34
10582,Tusibi,hyjal,1100,evoker,preservation,47,32,15
10583,Алекстраса,blackscar,1097,evoker,preservation,30,16,14
10584,Dmn,defias-brotherhood,1097,evoker,preservation,54,24,30
10585,Saphirá,hyjal,1094,evoker,preservation,28,13,15
10586,Xidalulz,sylvanas,1093,evoker,preservation,12,12,0
10587,Deathwinng,twisting-nether,1090,evoker,preservation,66,26,40
10588,Asgá,kazzak,1087,evoker,preservation,23,12,11
10589,Dragonflye,kazzak,1084,evoker,preservation,29,12,17
10590,Khaela,archimonde,1083,evoker,preservation,99,47,52
10591,Калесгоз,howling-fjord,1083,evoker,preservation,42,19,23
10592,Dractarys,arathi,1080,evoker,preservation,78,41,37
10593,Gilgakek,darksorrow,1078,evoker,preservation,74,31,43
10594,Drakeish,kazzak,1077,evoker,preservation,29,13,16
10595,Bambusák,draenor,1077,evoker,preservation,94,38,56
10596,Schenlong,kelthuzad,1074,evoker,preservation,54,26,28
10597,Blackli,kazzak,1074,evoker,preservation,33,14,19
10598,Dreiwyn,kazzak,1072,evoker,preservation,30,20,10
10599,Pikiscalez,bronzebeard,1072,evoker,preservation,24,12,12
10600,Kyrathir,hyjal,1069,evoker,preservation,30,12,18
10601,Эбиб,gordunni,1066,evoker,preservation,66,34,32
10602,Wingzy,chogall,1059,evoker,preservation,201,93,108
10603,Lizardofoz,argent-dawn,1058,evoker,preservation,30,18,12
10604,Haawwt,eredar,1058,evoker,preservation,24,12,12
10605,Targzæ,hyjal,1057,evoker,preservation,24,12,12
10606,Øoøoøoøo,outland,1056,evoker,preservation,12,11,1
10607,Вискписк,soulflayer,1056,evoker,preservation,12,11,1
10608,Berlyvoke,stormscale,1056,evoker,preservation,18,11,7
10609,Kremost,sylvanas,1056,evoker,preservation,30,11,19
10610,Шадофдрагон,deathweaver,1055,evoker,preservation,42,28,14
10611,Lacer,minahonda,1055,evoker,preservation,30,11,19
10612,Adrienne,steamwheedle-cartel,1054,evoker,preservation,30,13,17
10613,Àtòmìc,malorne,1053,evoker,preservation,24,11,13
10614,Bombrush,ragnaros,1052,evoker,preservation,27,15,12
10615,Parodize,thrall,1051,evoker,preservation,24,11,13
10616,Kurger,twisting-nether,1048,evoker,preservation,59,20,39
10617,Дрэгтир,lich-king,1047,evoker,preservation,43,22,21
10618,Horiz,kazzak,1047,evoker,preservation,30,11,19
10619,Zeigrem,antonidas,1044,evoker,preservation,12,11,1
10620,Elaijaz,turalyon,1040,evoker,preservation,18,14,4
10621,Predatax,drakthul,1039,evoker,preservation,142,71,71
10622,Morlie,argent-dawn,1036,evoker,preservation,76,36,40
10623,Kharalambos,stormscale,1036,evoker,preservation,36,13,23
10624,Thedrake,aegwynn,1034,evoker,preservation,47,28,19
10625,Antistrasza,argent-dawn,1033,evoker,preservation,48,22,26
10626,Spirow,archimonde,1032,evoker,preservation,30,17,13
10627,Iceslinger,stormscale,1031,evoker,preservation,89,41,48
10628,Leblon,stormreaver,1031,evoker,preservation,30,12,18
10629,Chrisú,thrall,1029,evoker,preservation,30,12,18
10630,Guntoker,tarren-mill,1029,evoker,preservation,60,21,39
10631,Ohcaralho,outland,1028,evoker,preservation,50,19,31
10632,Athyrstria,blackmoore,1028,evoker,preservation,65,18,47
10633,Zathîel,argent-dawn,1026,evoker,preservation,149,64,85
10634,Drazor,blackhand,1021,evoker,preservation,23,11,12
10635,Snällaldo,bladefist,1020,evoker,preservation,16,12,4
10636,Aezthaza,outland,1018,evoker,preservation,26,12,14
10637,Offering,ravencrest,1015,evoker,preservation,30,11,19
10638,Dragonna,argent-dawn,1013,evoker,preservation,99,43,56
10639,Гопоп,gordunni,1011,evoker,preservation,31,14,17
10640,Singe,nemesis,1010,evoker,preservation,120,42,78
10641,Dreamiee,kazzak,1008,evoker,preservation,54,20,34
10642,Quoz,ragnaros,1006,evoker,preservation,23,11,12
10643,Nurant,blackmoore,1006,evoker,preservation,29,12,17
10644,Dragonban,tarren-mill,1005,evoker,preservation,40,11,29
10645,Chronicryder,draenor,1004,evoker,preservation,21,11,10
10646,Pigioto,silvermoon,1002,evoker,preservation,210,104,106
10647,Archont,eredar,999,evoker,preservation,42,12,30
10648,Draknr,alakir,998,evoker,preservation,36,11,25
10649,Kalerinozi,blackhand,997,evoker,preservation,44,11,33
10650,Tf,doomhammer,988,evoker,preservation,40,15,25
10651,Jhoanna,grim-batol,987,evoker,preservation,48,25,23
10652,Palindre,argent-dawn,987,evoker,preservation,29,14,15
10653,Viseron,zuljin,987,evoker,preservation,105,38,67
10654,Deadfyre,dun-modr,986,evoker,preservation,30,15,15
10655,Blackwing,twilights-hammer,986,evoker,preservation,28,11,17
10656,Hios,twisting-nether,984,evoker,preservation,60,33,27
10657,Kraaznus,ravencrest,984,evoker,preservation,20,11,9
10658,Gantsu,blackhand,980,evoker,preservation,18,11,7
10659,Zaverion,nathrezim,977,evoker,preservation,30,13,17
10660,Абьюз,galakrond,970,evoker,preservation,271,140,131
10661,Kàzuée,outland,969,evoker,preservation,42,14,28
10662,Мйлкйвей,deathguard,968,evoker,preservation,40,25,15
10663,Reddeaddrago,silvermoon,966,evoker,preservation,44,24,20
10664,Алифсе,howling-fjord,965,evoker,preservation,84,23,61
10665,Drazikz,archimonde,962,evoker,preservation,76,41,35
10666,Drakares,la-croisade-écarlate,962,evoker,preservation,54,19,35
10667,Silverwingg,tarren-mill,960,evoker,preservation,18,10,8
10668,Konzaa,argent-dawn,960,evoker,preservation,18,10,8
10669,Ecovoker,outland,960,evoker,preservation,18,10,8
10670,Yavak,blackmoore,960,evoker,preservation,18,10,8
10671,Mauül,ravencrest,959,evoker,preservation,12,10,2
10672,Argnir,archimonde,959,evoker,preservation,24,10,14
10673,Síire,ravencrest,958,evoker,preservation,12,10,2
10674,Mithrandir,marécage-de-zangar,957,evoker,preservation,24,10,14
10675,Druggz,burning-blade,955,evoker,preservation,12,10,2
10676,Baszz,aegwynn,955,evoker,preservation,24,10,14
10677,Kleftra,stormscale,954,evoker,preservation,18,10,8
10678,Skrix,khadgar,953,evoker,preservation,18,10,8
10679,Dontiá,draenor,953,evoker,preservation,81,37,44
10680,Goalkeeper,ravencrest,952,evoker,preservation,18,10,8
10681,Hool,silvermoon,951,evoker,preservation,149,71,78
10682,Bobonakia,sylvanas,950,evoker,preservation,24,10,14
10683,Slashlowe,archimonde,948,evoker,preservation,40,18,22
10684,Jamesdouglas,eredar,946,evoker,preservation,30,19,11
10685,Scaleyfurry,azshara,941,evoker,preservation,21,12,9
10686,ßëkûsåùrús,ragnaros,941,evoker,preservation,23,10,13
10687,Altairion,dalaran,939,evoker,preservation,30,18,12
10688,Lînkôs,aegwynn,938,evoker,preservation,71,35,36
10689,Dracwyn,shattrath,938,evoker,preservation,25,11,14
10690,Ewings,archimonde,938,evoker,preservation,30,10,20
10691,Винтер,azuregos,935,evoker,preservation,19,11,8
10692,Vozzat,stormscale,934,evoker,preservation,24,11,13
10693,Blazeros,sylvanas,933,evoker,preservation,42,21,21
10694,Draklorn,moonglade,933,evoker,preservation,75,36,39
10695,Dracnass,silvermoon,930,evoker,preservation,18,10,8
10696,Тирдде,deathweaver,914,evoker,preservation,102,48,54
10697,Zaraten,hyjal,909,evoker,preservation,27,14,13
10698,Vores,norgannon,908,evoker,preservation,59,26,33
10699,Kamings,outland,907,evoker,preservation,32,17,15
10700,Domynevoc,hyjal,902,evoker,preservation,55,26,29
10701,Cárried,twilights-hammer,902,evoker,preservation,33,11,22
10702,Canitabravar,cthun,898,evoker,preservation,60,30,30
10703,Drakutyr,defias-brotherhood,896,evoker,preservation,20,11,9
10704,Morsan,tichondrius,896,evoker,preservation,48,23,25
10705,Лесанор,gordunni,894,evoker,preservation,16,10,6
10706,Marasz,silvermoon,893,evoker,preservation,42,22,20
10707,Rafale,the-maelstrom,892,evoker,preservation,139,69,70
10708,Eosin,blackrock,890,evoker,preservation,23,10,13
10709,Drakars,kazzak,886,evoker,preservation,62,27,35
10710,Doriangray,drakthul,884,evoker,preservation,20,11,9
10711,Drachi,ambossar,880,evoker,preservation,78,35,43
10712,Drâcarys,destromath,879,evoker,preservation,25,13,12
10713,Mergwahlbark,hyjal,878,evoker,preservation,29,10,19
10714,Dioni,sylvanas,873,evoker,preservation,39,15,24
10715,Thymian,ambossar,871,evoker,preservation,149,68,81
10716,Minikuja,culte-de-la-rive-noire,867,evoker,preservation,56,22,34
10717,Escamosa,exodar,866,evoker,preservation,48,10,38
10718,Antifightx,kazzak,864,evoker,preservation,12,9,3
10719,Flystowardsu,argent-dawn,864,evoker,preservation,12,9,3
10720,Dekaralol,ravencrest,864,evoker,preservation,12,9,3
10721,Rullatorsvên,sylvanas,864,evoker,preservation,18,9,9
10722,Moondraka,outland,864,evoker,preservation,18,9,9
10723,Drgigapump,blackmoore,864,evoker,preservation,18,9,9
10724,Laurenzos,tarren-mill,864,evoker,preservation,18,9,9
10725,Мишанячешуя,gordunni,863,evoker,preservation,12,9,3
10726,Wjörm,outland,863,evoker,preservation,18,9,9
10727,Dracronix,the-maelstrom,863,evoker,preservation,18,9,9
10728,Cupcâke,dalaran,863,evoker,preservation,18,9,9
10729,Nassuada,dalaran,863,evoker,preservation,18,9,9
10730,Anlong,alakir,863,evoker,preservation,23,10,13
10731,Myntara,tarren-mill,863,evoker,preservation,24,9,15
10732,Teneja,malganis,863,evoker,preservation,24,9,15
10733,Exxa,tarren-mill,863,evoker,preservation,24,9,15
10734,Zezus,outland,862,evoker,preservation,12,9,3
10735,Zygumy,hyjal,862,evoker,preservation,18,9,9
10736,Навидх,howling-fjord,862,evoker,preservation,24,9,15
10737,Mistvoke,kazzak,860,evoker,preservation,18,9,9
10738,Lithnxv,bladefist,859,evoker,preservation,18,9,9
10739,Evok,deathwing,858,evoker,preservation,24,10,14
10740,Drakmool,ysondre,858,evoker,preservation,30,12,18
10741,Setoc,blackrock,857,evoker,preservation,19,9,10
10742,Nedflanderss,silvermoon,856,evoker,preservation,18,9,9
10743,Azurewings,argent-dawn,851,evoker,preservation,65,23,42
10744,Zymotîx,stormscale,850,evoker,preservation,30,9,21
10745,Javåscript,outland,849,evoker,preservation,18,9,9
10746,Damssx,medivh,847,evoker,preservation,33,13,20
10747,Drâkarys,khaz-modan,845,evoker,preservation,57,21,36
10748,Yadormi,sylvanas,843,evoker,preservation,60,28,32
10749,Sumo,burning-legion,841,evoker,preservation,36,16,20
10750,Avizz,tarren-mill,837,evoker,preservation,23,12,11
10751,Zerario,blackhand,827,evoker,preservation,23,9,14
10752,Viseriðn,archimonde,827,evoker,preservation,24,9,15
10753,Mendes,kazzak,827,evoker,preservation,84,26,58
10754,Voryax,kirin-tor,825,evoker,preservation,30,9,21
10755,Верметор,soulflayer,820,evoker,preservation,96,32,64
10756,Miumyuki,drakthul,815,evoker,preservation,54,21,33
10757,Aayala,dalaran,806,evoker,preservation,21,9,12
10758,Xanthisa,malganis,800,evoker,preservation,34,13,21
10759,Quetzalcoâtl,burning-blade,795,evoker,preservation,24,10,14
10760,Nochance,dentarg,795,evoker,preservation,127,45,82
10761,Dratheon,dun-modr,794,evoker,preservation,32,10,22
10762,Cheapdragon,tarren-mill,791,evoker,preservation,45,18,27
10763,Эфирид,blackscar,779,evoker,preservation,59,22,37
10764,Kanketopg,kazzak,768,evoker,preservation,12,8,4
10765,Nst,zuljin,768,evoker,preservation,12,8,4
10766,Dragondn,alleria,768,evoker,preservation,12,8,4
10767,Nhoru,stormscale,768,evoker,preservation,12,8,4
10768,Swooshz,ragnaros,768,evoker,preservation,12,8,4
10769,Zemar,dalaran,768,evoker,preservation,12,8,4
10770,Naicover,kazzak,768,evoker,preservation,12,8,4
10771,Myshavion,hyjal,768,evoker,preservation,12,8,4
10772,Zendaë,archimonde,768,evoker,preservation,12,8,4
10773,Dragonkim,draenor,768,evoker,preservation,18,8,10
10774,Visage,kul-tiras,768,evoker,preservation,18,8,10
10775,Ringil,tarren-mill,768,evoker,preservation,18,8,10
10776,Korialstraz,aegwynn,767,evoker,preservation,12,8,4
10777,Krazuntus,argent-dawn,767,evoker,preservation,12,8,4
10778,Meteo,the-maelstrom,767,evoker,preservation,15,9,6
10779,Sysstrasza,archimonde,767,evoker,preservation,18,8,10
10780,Shenronblue,bloodscalp,767,evoker,preservation,24,8,16
10781,Mirajhti,blackrock,767,evoker,preservation,30,8,22
10782,Dragonsito,cthun,765,evoker,preservation,18,8,10
10783,Nêóô,blackrock,765,evoker,preservation,18,8,10
10784,Daracthyr,arathor,765,evoker,preservation,18,8,10
10785,Mfdragon,grim-batol,765,evoker,preservation,24,8,16
10786,Уполнамоченн,soulflayer,764,evoker,preservation,12,8,4
10787,Mikevoker,aegwynn,763,evoker,preservation,12,8,4
10788,Iscale,twisting-nether,763,evoker,preservation,24,8,16
10789,Drakhtyr,draenor,762,evoker,preservation,12,8,4
10790,Arecibo,tarren-mill,762,evoker,preservation,12,8,4
10791,Dracanis,shendralar,761,evoker,preservation,27,12,15
10792,Aevon,blackrock,758,evoker,preservation,48,11,37
10793,Sarodari,blackhand,757,evoker,preservation,18,8,10
10794,Dragonrocker,silvermoon,757,evoker,preservation,24,8,16
10795,Cyclops,zuljin,756,evoker,preservation,24,8,16
10796,Maverickx,nemesis,753,evoker,preservation,18,8,10
10797,Lunariëlle,les-sentinelles,749,evoker,preservation,12,8,4
10798,Inspecto,turalyon,737,evoker,preservation,18,8,10
10799,Touge,varimathras,721,evoker,preservation,24,8,16
10800,Ryujinx,blackhand,719,evoker,preservation,17,8,9
10801,Ptipangoevok,dalaran,713,evoker,preservation,22,9,13
10802,Kuzzan,blackhand,707,evoker,preservation,18,9,9
10803,Baléryon,archimonde,705,evoker,preservation,11,8,3
10804,Nicholbolas,nordrassil,690,evoker,preservation,11,8,3
10805,Sunfyres,frostmane,679,evoker,preservation,28,8,20
10806,Escaaboy,stormscale,672,evoker,preservation,12,7,5
10807,Ricidevo,nerathor,672,evoker,preservation,12,7,5
10808,Blazelt,blackrock,672,evoker,preservation,12,7,5
10809,Fûrý,twisting-nether,672,evoker,preservation,12,7,5
10810,Stormnn,kazzak,672,evoker,preservation,12,7,5
10811,Zarikus,argent-dawn,672,evoker,preservation,12,7,5
10812,Evyzz,blackmoore,672,evoker,preservation,12,7,5
10813,Beetk,tarren-mill,672,evoker,preservation,12,7,5
10814,Flyhacker,blackrock,672,evoker,preservation,12,7,5
10815,Løcøtømmy,blackrock,672,evoker,preservation,12,7,5
10816,Óceiros,silvermoon,672,evoker,preservation,18,7,11
10817,Tojodormi,argent-dawn,672,evoker,preservation,18,7,11
10818,Spacebreath,ravencrest,672,evoker,preservation,18,7,11
10819,Iwaavoker,archimonde,672,evoker,preservation,18,7,11
10820,Sulführer,sanguino,672,evoker,preservation,18,7,11
10821,Deadwing,eonar,672,evoker,preservation,18,7,11
10822,Dárnast,draenor,671,evoker,preservation,12,7,5
10823,Draaxy,twisting-nether,671,evoker,preservation,15,8,7
10824,Fusanabide,kazzak,671,evoker,preservation,14,7,7
10825,Гневиан,eversong,671,evoker,preservation,18,7,11
10826,Dagruel,exodar,671,evoker,preservation,18,7,11
10827,Karristrasza,silvermoon,671,evoker,preservation,18,7,11
10828,Evoris,frostmane,671,evoker,preservation,18,7,11
10829,Dodgens,auchindoun,671,evoker,preservation,18,7,11
10830,Therzer,drakthul,670,evoker,preservation,12,7,5
10831,Coaxoch,thunderhorn,670,evoker,preservation,12,7,5
10832,Spïzz,dun-modr,670,evoker,preservation,12,7,5
10833,Esalisko,kazzak,670,evoker,preservation,12,7,5
10834,Liroo,hyjal,670,evoker,preservation,12,7,5
10835,Myszostrasza,burning-legion,670,evoker,preservation,12,7,5
10836,Hakuzah,terokkar,670,evoker,preservation,18,7,11
10837,Malfestio,zuljin,669,evoker,preservation,12,7,5
10838,Ìzànamì,hyjal,669,evoker,preservation,12,7,5
10839,Avemonetemus,silvermoon,669,evoker,preservation,18,7,11
10840,Lapaneri,sylvanas,669,evoker,preservation,24,7,17
10841,Vatiras,magtheridon,669,evoker,preservation,24,7,17
10842,Wywill,eitrigg,668,evoker,preservation,12,7,5
10843,Entombevoker,twisting-nether,668,evoker,preservation,12,7,5
10844,Prikkedøden,grim-batol,668,evoker,preservation,18,7,11
10845,Панкрок,thermaplugg,668,evoker,preservation,21,7,14
10846,Hornbeam,tarren-mill,666,evoker,preservation,18,7,11
10847,Acnologîa,ysondre,665,evoker,preservation,12,7,5
10848,Gihzmo,tarren-mill,664,evoker,preservation,12,7,5
10849,Büsselberg,blackmoore,658,evoker,preservation,18,7,11
10850,Awfultrash,archimonde,655,evoker,preservation,23,7,16
10851,Charezard,draenor,638,evoker,preservation,17,7,10
10852,Myndragosa,varimathras,624,evoker,preservation,15,8,7
10853,Judragon,kazzak,618,evoker,preservation,20,8,12
10854,Blyatcuka,kazzak,617,evoker,preservation,17,8,9
10855,Quewl,blackmoore,606,evoker,preservation,11,7,4
10856,Voltyrh,antonidas,589,evoker,preservation,19,7,12
10857,Iandret,destromath,576,evoker,preservation,12,6,6
10858,Psheetae,kazzak,576,evoker,preservation,12,6,6
10859,Oceirós,draenor,576,evoker,preservation,12,6,6
10860,Lasissi,dragonblight,576,evoker,preservation,12,6,6
10861,Snipy,burning-legion,576,evoker,preservation,12,6,6
10862,Bluesaphir,ravencrest,576,evoker,preservation,12,6,6
10863,Cutegirlx,blackrock,576,evoker,preservation,12,6,6
10864,Louiekin,outland,576,evoker,preservation,12,6,6
10865,Drakarroar,ragnaros,576,evoker,preservation,12,6,6
10866,Rømmegrøt,tarren-mill,576,evoker,preservation,12,6,6
10867,Dizatwo,silvermoon,576,evoker,preservation,12,6,6
10868,Talynn,sylvanas,576,evoker,preservation,12,6,6
10869,Jacko,nemesis,576,evoker,preservation,12,6,6
10870,Rmplol,twisting-nether,576,evoker,preservation,12,6,6
10871,Djsnake,twisting-nether,576,evoker,preservation,12,6,6
10872,Darkevokoul,conseil-des-ombres,576,evoker,preservation,12,6,6
10873,Kocaina,ravencrest,576,evoker,preservation,12,6,6
10874,Kapevok,sanguino,576,evoker,preservation,12,6,6
10875,Luu,the-maelstrom,576,evoker,preservation,12,6,6
10876,Nèthy,argent-dawn,576,evoker,preservation,12,6,6
10877,Kajer,nemesis,576,evoker,preservation,12,6,6
10878,Yesdaddyowo,draenor,576,evoker,preservation,12,6,6
10879,Ragnai,sunstrider,576,evoker,preservation,12,6,6
10880,Holyvoker,aegwynn,576,evoker,preservation,12,6,6
10881,Sindragonk,ravencrest,576,evoker,preservation,12,6,6
10882,Mesarin,eredar,576,evoker,preservation,12,6,6
10883,Trainsaw,kazzak,576,evoker,preservation,12,6,6
10884,Alphabét,ravencrest,576,evoker,preservation,18,6,12
10885,Enzetrius,argent-dawn,576,evoker,preservation,18,6,12
10886,Lolprevoker,outland,576,evoker,preservation,18,6,12
10887,Discodraken,stormscale,576,evoker,preservation,18,6,12
10888,Дэзвинк,gordunni,576,evoker,preservation,24,6,18
10889,Lìssàndra,argent-dawn,576,evoker,preservation,24,6,18
10890,Pasqvoker,ravencrest,575,evoker,preservation,12,6,6
10891,Nevara,ragnaros,575,evoker,preservation,12,6,6
10892,Drakeó,kazzak,575,evoker,preservation,12,6,6
10893,Raegos,ravencrest,575,evoker,preservation,12,6,6
10894,Dragonlet,twisting-nether,575,evoker,preservation,12,6,6
10895,Pe,dalaran,575,evoker,preservation,12,6,6
10896,Drachenbeton,blackhand,575,evoker,preservation,12,6,6
10897,Сулистраза,blackscar,575,evoker,preservation,12,6,6
10898,Draccaris,silvermoon,575,evoker,preservation,12,6,6
10899,Nexevo,blackmoore,575,evoker,preservation,18,6,12
10900,Boonvoker,the-maelstrom,575,evoker,preservation,24,6,18
10901,Kutdraak,laughing-skull,574,evoker,preservation,12,6,6
10902,Tarystrasza,blackrock,574,evoker,preservation,12,6,6
10903,Drakpojke,stormscale,574,evoker,preservation,12,6,6
10904,Etherwood,bronze-dragonflight,573,evoker,preservation,12,6,6
10905,Dracarysfire,kazzak,573,evoker,preservation,12,6,6
10906,Skytrace,silvermoon,573,evoker,preservation,18,6,12
10907,Kaiser,trollbane,573,evoker,preservation,18,6,12
10908,Blainedragon,arathor,573,evoker,preservation,18,6,12
10909,Synpho,ahnqiraj,571,evoker,preservation,12,6,6
10910,Aevnon,sylvanas,569,evoker,preservation,12,6,6
10911,Synhtol,ragnaros,564,evoker,preservation,18,6,12
10912,Evÿ,turalyon,560,evoker,preservation,18,6,12
10913,Балрогхаоса,gordunni,539,evoker,preservation,14,7,7
10914,Ahyllesevok,antonidas,527,evoker,preservation,15,7,8
10915,Rasalhague,uldum,522,evoker,preservation,15,6,9
10916,Dracarysx,grim-batol,520,evoker,preservation,15,7,8
10917,Drakthur,terenas,519,evoker,preservation,27,7,20
10918,Drakinas,outland,511,evoker,preservation,11,6,5
10919,Tyuz,antonidas,509,evoker,preservation,14,6,8
10920,Draktoros,kazzak,504,evoker,preservation,30,11,19
10921,Diggidydract,silvermoon,480,evoker,preservation,6,5,1
10922,Baddragonn,nemesis,480,evoker,preservation,6,5,1
10923,Stêwpit,blackhand,480,evoker,preservation,6,5,1
10924,Pyrestra,argent-dawn,480,evoker,preservation,6,5,1
10925,Ralfferion,auchindoun,480,evoker,preservation,6,5,1
10926,Arfedar,kazzak,480,evoker,preservation,6,5,1
10927,Jàcè,antonidas,480,evoker,preservation,6,5,1
10928,Dåseskjuul,kazzak,480,evoker,preservation,6,5,1
10929,Jmyzard,tarren-mill,480,evoker,preservation,10,6,4
10930,Runewing,turalyon,480,evoker,preservation,12,5,7
10931,Nemrák,blackmoore,480,evoker,preservation,12,5,7
10932,Silversnakex,ravencrest,480,evoker,preservation,12,5,7
10933,Candicewho,twisting-nether,480,evoker,preservation,12,5,7
10934,Драгонкокс,gordunni,480,evoker,preservation,12,5,7
10935,Mimic,scarshield-legion,480,evoker,preservation,12,5,7
10936,Belzevoker,blackrock,480,evoker,preservation,12,5,7
10937,Bigreddragon,outland,480,evoker,preservation,12,5,7
10938,Rímmer,kazzak,480,evoker,preservation,12,5,7
10939,Poporaight,archimonde,480,evoker,preservation,12,5,7
10940,Dzin,burning-legion,480,evoker,preservation,12,5,7
10941,Alanikus,silvermoon,480,evoker,preservation,12,5,7
10942,Drdrayk,balnazzar,480,evoker,preservation,12,5,7
10943,Fnom,hyjal,480,evoker,preservation,12,5,7
10944,Evokoloko,outland,480,evoker,preservation,12,5,7
10945,Vizdraken,tarren-mill,480,evoker,preservation,12,5,7
10946,Twocats,twisting-nether,480,evoker,preservation,12,5,7
10947,Lootharon,blackhand,480,evoker,preservation,12,5,7
10948,Deathwingx,sylvanas,480,evoker,preservation,12,5,7
10949,Flatterhipy,blackrock,480,evoker,preservation,12,5,7
10950,Emeraldcomun,twisting-nether,480,evoker,preservation,12,5,7
10951,Soupmah,silvermoon,480,evoker,preservation,12,5,7
10952,Favera,taerar,480,evoker,preservation,12,5,7
10953,Feddra,twisting-nether,480,evoker,preservation,12,5,7
10954,Драмуся,gordunni,480,evoker,preservation,12,5,7
10955,Катяламизил,howling-fjord,480,evoker,preservation,12,5,7
10956,Toplevel,eredar,480,evoker,preservation,12,5,7
10957,Xyphoo,kazzak,480,evoker,preservation,18,5,13
10958,Invinite,blackrock,480,evoker,preservation,18,5,13
10959,Draakoñ,outland,480,evoker,preservation,18,5,13
10960,Theflight,ravencrest,480,evoker,preservation,18,5,13
10961,Dragóndééz,draenor,480,evoker,preservation,18,5,13
10962,Miraas,burning-blade,480,evoker,preservation,18,5,13
10963,Rise,tarren-mill,480,evoker,preservation,24,5,19
10964,Uxiono,dun-modr,480,evoker,preservation,24,5,19
10965,Ophois,malygos,479,evoker,preservation,6,5,1
10966,Dragondisnut,sylvanas,479,evoker,preservation,12,5,7
10967,Scaleflux,argent-dawn,479,evoker,preservation,12,5,7
10968,Dudebrö,arathor,479,evoker,preservation,12,5,7
10969,Chunlooi,baelgun,479,evoker,preservation,12,5,7
10970,Naloqa,frostwolf,479,evoker,preservation,12,5,7
10971,Cinnamoon,defias-brotherhood,479,evoker,preservation,12,5,7
10972,Darksaider,draenor,479,evoker,preservation,12,5,7
10973,Shosk,chamber-of-aspects,479,evoker,preservation,12,5,7
10974,Luftwaffel,blackmoore,479,evoker,preservation,12,5,7
10975,Puffdaddyxd,twisting-nether,479,evoker,preservation,12,5,7
10976,Chizy,aegwynn,479,evoker,preservation,18,5,13
10977,Kärlethos,dun-modr,478,evoker,preservation,12,5,7
10978,Widow,chromaggus,478,evoker,preservation,12,5,7
10979,Bbuszek,outland,478,evoker,preservation,18,5,13
10980,Fodom,medivh,477,evoker,preservation,12,5,7
10981,Cazé,archimonde,477,evoker,preservation,12,5,7
10982,Vereeza,draenor,477,evoker,preservation,15,6,9
10983,Zahaak,doomhammer,477,evoker,preservation,18,5,13
10984,Dragorasi,frostwolf,476,evoker,preservation,24,5,19
10985,Гарил,grom,475,evoker,preservation,12,5,7
10986,Gladdrake,doomhammer,474,evoker,preservation,18,5,13
10987,Fricandela,sanguino,472,evoker,preservation,18,5,13
10988,Valasthor,argent-dawn,469,evoker,preservation,18,5,13
10989,Incarnevoke,ravencrest,463,evoker,preservation,11,5,6
10990,Thyriån,kazzak,447,evoker,preservation,11,5,6
10991,Missnorway,blackmoore,447,evoker,preservation,11,5,6
10992,Яссон,howling-fjord,447,evoker,preservation,14,6,8
10993,Kássadaín,the-maelstrom,447,evoker,preservation,16,5,11
10994,Jcloud,shattered-hand,432,evoker,preservation,15,5,10
10995,Grajade,dun-modr,422,evoker,preservation,15,6,9
10996,Alrakis,kragjin,415,evoker,preservation,16,5,11
10997,Дрейкорг,howling-fjord,384,evoker,preservation,6,4,2
10998,Drakelussac,silvermoon,384,evoker,preservation,6,4,2
10999,Variandre,ravencrest,384,evoker,preservation,6,4,2
11000,Zaffira,kazzak,384,evoker,preservation,6,4,2
11001,Momodragon,draenor,384,evoker,preservation,6,4,2
11002,Killmeifucan,twisting-nether,384,evoker,preservation,6,4,2
11003,Krakadayle,archimonde,384,evoker,preservation,6,4,2
11004,Ahnë,archimonde,384,evoker,preservation,6,4,2
11005,Roastedpig,kazzak,384,evoker,preservation,6,4,2
11006,Snàx,aggra-português,384,evoker,preservation,6,4,2
11007,Aymoreth,argent-dawn,384,evoker,preservation,6,4,2
11008,Grumes,blackmoore,384,evoker,preservation,6,4,2
11009,Bindrasz,ahnqiraj,384,evoker,preservation,6,4,2
11010,Seboker,nemesis,384,evoker,preservation,6,4,2
11011,Killafoolz,kazzak,384,evoker,preservation,12,4,8
11012,Evokker,antonidas,384,evoker,preservation,12,4,8
11013,Yaraxes,outland,384,evoker,preservation,12,4,8
11014,Tokvoker,tarren-mill,384,evoker,preservation,12,4,8
11015,Драксинед,howling-fjord,384,evoker,preservation,12,4,8
11016,Azdaja,blackmoore,384,evoker,preservation,12,4,8
11017,Галактиг,thermaplugg,384,evoker,preservation,12,4,8
11018,Feradely,thrall,384,evoker,preservation,12,4,8
11019,Toílet,blackmoore,384,evoker,preservation,12,4,8
11020,Zelenobelata,neptulon,384,evoker,preservation,12,4,8
11021,Ninhursag,hyjal,384,evoker,preservation,12,4,8
11022,Feyrbrand,ysera,384,evoker,preservation,12,4,8
11023,Arniye,ravencrest,384,evoker,preservation,12,4,8
11024,Woke,the-venture-co,384,evoker,preservation,12,4,8
11025,Multytür,antonidas,384,evoker,preservation,18,4,14
11026,Lohis,grim-batol,384,evoker,preservation,18,4,14
11027,Dractharion,blackrock,384,evoker,preservation,18,4,14
11028,Fogwing,ravencrest,384,evoker,preservation,18,4,14
11029,Belzilian,dalaran,384,evoker,preservation,18,4,14
11030,Nicnacx,stormscale,383,evoker,preservation,6,4,2
11031,Кефтыме,soulflayer,383,evoker,preservation,6,4,2
11032,Timeshifter,stormscale,383,evoker,preservation,6,4,2
11033,Thenotelmat,twisting-nether,383,evoker,preservation,6,4,2
11034,Сантанико,grom,383,evoker,preservation,12,4,8
11035,Cxsmetic,antonidas,383,evoker,preservation,12,4,8
11036,Ignisaureus,silvermoon,383,evoker,preservation,12,4,8
11037,Pureshot,archimonde,383,evoker,preservation,12,4,8
11038,Flawxy,blackmoore,383,evoker,preservation,12,4,8
11039,Renistra,argent-dawn,383,evoker,preservation,12,4,8
11040,Yaldthion,dun-modr,383,evoker,preservation,18,4,14
11041,Steadyop,doomhammer,382,evoker,preservation,6,4,2
11042,Dolceprada,stormscale,381,evoker,preservation,12,4,8
11043,Dragonboss,doomhammer,380,evoker,preservation,12,4,8
11044,Мизурион,gordunni,379,evoker,preservation,12,4,8
11045,Ekko,nethersturm,379,evoker,preservation,13,4,9
11046,Sinastral,sanguino,350,evoker,preservation,11,4,7
11047,Lycêrâ,antonidas,330,evoker,preservation,9,6,3
11048,Zarog,frostwolf,303,evoker,preservation,7,4,3
11049,Soø,kazzak,288,evoker,preservation,6,3,3
11050,Zordrach,quelthalas,288,evoker,preservation,6,3,3
11051,Flâneur,ysondre,288,evoker,preservation,6,3,3
11052,Botomforgold,ravencrest,288,evoker,preservation,6,3,3
11053,Colacorta,zuljin,288,evoker,preservation,6,3,3
11054,Ramilbest,ravencrest,288,evoker,preservation,6,3,3
11055,Noogon,outland,288,evoker,preservation,6,3,3
11056,Jackarlys,outland,288,evoker,preservation,6,3,3
11057,Alldru,outland,288,evoker,preservation,6,3,3
11058,Моралдракон,soulflayer,288,evoker,preservation,6,3,3
11059,Meezyevo,ragnaros,288,evoker,preservation,6,3,3
11060,Konstraz,kazzak,288,evoker,preservation,6,3,3
11061,Rippo,tarren-mill,288,evoker,preservation,6,3,3
11062,Знамядрак,soulflayer,288,evoker,preservation,6,3,3
11063,Nezruslfarm,cthun,288,evoker,preservation,6,3,3
11064,Espâgnøl,hyjal,288,evoker,preservation,6,3,3
11065,Alicendre,hyjal,288,evoker,preservation,6,3,3
11066,Jpeo,blackhand,288,evoker,preservation,6,3,3
11067,Eurydíke,blackhand,288,evoker,preservation,6,3,3
11068,Shôrty,ravencrest,288,evoker,preservation,6,3,3
11069,Saphiraa,lightnings-blade,288,evoker,preservation,6,3,3
11070,Spudvoker,silvermoon,288,evoker,preservation,6,3,3
11071,Dokkamok,hyjal,288,evoker,preservation,6,3,3
11072,Психея,soulflayer,288,evoker,preservation,6,3,3
11073,Zanarian,defias-brotherhood,288,evoker,preservation,6,3,3
11074,Azwel,khaz-modan,288,evoker,preservation,6,3,3
11075,Ivokerz,tarren-mill,288,evoker,preservation,6,3,3
11076,Meyowuo,doomhammer,288,evoker,preservation,6,3,3
11077,Niffdra,twisting-nether,288,evoker,preservation,6,3,3
11078,Gloris,aegwynn,288,evoker,preservation,6,3,3
11079,Keizal,twisting-nether,288,evoker,preservation,6,3,3
11080,Jmý,tarren-mill,288,evoker,preservation,6,3,3
11081,Släshés,ravencrest,288,evoker,preservation,6,3,3
11082,Morkek,dun-modr,288,evoker,preservation,6,3,3
11083,Kanketo,ravencrest,288,evoker,preservation,6,3,3
11084,Ceroxs,aegwynn,288,evoker,preservation,6,3,3
11085,Asrwea,draenor,288,evoker,preservation,6,3,3
11086,Pruttburk,draenor,288,evoker,preservation,6,3,3
11087,Distinkd,draenor,288,evoker,preservation,6,3,3
11088,Evokimag,grim-batol,288,evoker,preservation,6,3,3
11089,Notadvanced,draenor,288,evoker,preservation,6,3,3
11090,Cauter,draenor,288,evoker,preservation,6,3,3
11091,Scottpula,tarren-mill,288,evoker,preservation,6,3,3
11092,Renalia,blackrock,288,evoker,preservation,6,3,3
11093,Speckjarrow,blackrock,288,evoker,preservation,6,3,3
11094,Tactician,stormreaver,288,evoker,preservation,6,3,3
11095,Cadwalader,blades-edge,288,evoker,preservation,12,3,9
11096,Elderruan,shattered-hand,288,evoker,preservation,12,3,9
11097,Khaliy,blackrock,288,evoker,preservation,12,3,9
11098,Edgybeb,archimonde,288,evoker,preservation,12,3,9
11099,Siigge,draenor,288,evoker,preservation,12,3,9
11100,Reelona,silvermoon,288,evoker,preservation,12,3,9
11101,Effrt,ravencrest,288,evoker,preservation,12,3,9
11102,Monftroglou,archimonde,288,evoker,preservation,12,3,9
11103,Taktcik,archimonde,288,evoker,preservation,12,3,9
11104,Dreamdoll,tarren-mill,288,evoker,preservation,12,3,9
11105,Fumfum,twisting-nether,288,evoker,preservation,12,3,9
11106,Боевойхомякд,howling-fjord,288,evoker,preservation,12,3,9
11107,Chrisussy,argent-dawn,288,evoker,preservation,12,3,9
11108,Bemil,twisting-nether,288,evoker,preservation,12,3,9
11109,Terrorwings,twisting-nether,288,evoker,preservation,12,3,9
11110,Moltenazo,dun-modr,288,evoker,preservation,13,3,10
11111,Милеис,soulflayer,287,evoker,preservation,6,3,3
11112,Elexatra,hyjal,287,evoker,preservation,12,3,9
11113,Iashiak,silvermoon,286,evoker,preservation,6,3,3
11114,Flymetothemo,twisting-nether,286,evoker,preservation,12,3,9
11115,Лунет,lich-king,286,evoker,preservation,12,3,9
11116,Valystrá,die-aldor,285,evoker,preservation,24,3,21
11117,Quarsilly,frostwolf,271,evoker,preservation,11,3,8
11118,Trellie,die-aldor,255,evoker,preservation,11,3,8
11119,Smoochbumble,argent-dawn,240,evoker,preservation,9,3,6
11120,Agnî,sanguino,240,evoker,preservation,9,3,6
11121,Nêrifiel,hyjal,239,evoker,preservation,5,3,2
11122,Provôker,tarren-mill,223,evoker,preservation,8,3,5
11123,Baranzion,twisting-nether,207,evoker,preservation,8,3,5
11124,Nordomu,silvermoon,192,evoker,preservation,6,2,4
11125,Shëitan,sinstralis,192,evoker,preservation,6,2,4
11126,Sénkú,silvermoon,192,evoker,preservation,6,2,4
11127,Crazylucifer,kazzak,192,evoker,preservation,6,2,4
11128,Burndaddy,dun-modr,192,evoker,preservation,6,2,4
11129,Sloeez,kazzak,192,evoker,preservation,6,2,4
11130,Asunarion,silvermoon,192,evoker,preservation,6,2,4
11131,Змийх,gordunni,192,evoker,preservation,6,2,4
11132,Alariath,mannoroth,192,evoker,preservation,6,2,4
11133,Youzfull,blackrock,192,evoker,preservation,6,2,4
11134,Sheràqt,blackrock,192,evoker,preservation,6,2,4
11135,Shinad,ravencrest,192,evoker,preservation,6,2,4
11136,Язычник,thermaplugg,192,evoker,preservation,6,2,4
11137,Tamargon,frostwhisper,192,evoker,preservation,6,2,4
11138,Campus,blackrock,192,evoker,preservation,6,2,4
11139,Dno,archimonde,192,evoker,preservation,6,2,4
11140,Eymo,archimonde,192,evoker,preservation,6,2,4
11141,Flipflapflop,twisting-nether,192,evoker,preservation,6,2,4
11142,Whatisthis,archimonde,192,evoker,preservation,6,2,4
11143,Freesckretx,archimonde,192,evoker,preservation,6,2,4
11144,Puzzles,ravencrest,192,evoker,preservation,6,2,4
11145,Solutionevok,aegwynn,192,evoker,preservation,6,2,4
11146,Glurakk,aegwynn,192,evoker,preservation,6,2,4
11147,Hound,lordaeron,192,evoker,preservation,6,2,4
11148,Høt,nemesis,192,evoker,preservation,6,2,4
11149,Azurog,blackmoore,192,evoker,preservation,6,2,4
11150,Zendervish,draenor,192,evoker,preservation,6,2,4
11151,Drunkvoker,stormscale,192,evoker,preservation,6,2,4
11152,Cousinbetty,defias-brotherhood,192,evoker,preservation,6,2,4
11153,Garussy,draenor,192,evoker,preservation,6,2,4
11154,Dragonlol,stormscale,192,evoker,preservation,6,2,4
11155,Maudragosa,blackmoore,192,evoker,preservation,6,2,4
11156,Glurak,stormscale,192,evoker,preservation,6,2,4
11157,Voldermort,ravencrest,192,evoker,preservation,6,2,4
11158,Rngmåchinè,ravencrest,192,evoker,preservation,6,2,4
11159,Mistime,twisting-nether,192,evoker,preservation,6,2,4
11160,Dragonzo,arathor,192,evoker,preservation,6,2,4
11161,Vermithors,ravencrest,192,evoker,preservation,6,2,4
11162,Adriia,ravencrest,192,evoker,preservation,6,2,4
11163,Arbîter,eredar,192,evoker,preservation,6,2,4
11164,Jaratitz,dun-modr,192,evoker,preservation,6,2,4
11165,Иванза,howling-fjord,192,evoker,preservation,6,2,4
11166,Soondeleted,eredar,192,evoker,preservation,6,2,4
11167,Pico,madmortem,192,evoker,preservation,12,2,10
11168,Rhäegal,kaelthas,192,evoker,preservation,12,2,10
11169,Lazorkröte,blackrock,192,evoker,preservation,12,2,10
11170,Teyvoker,blackmoore,192,evoker,preservation,12,2,10
11171,Flametender,silvermoon,192,evoker,preservation,12,2,10
11172,Dráthír,blackrock,192,evoker,preservation,12,2,10
11173,Margouillax,archimonde,192,evoker,preservation,12,2,10
11174,Lììn,hyjal,192,evoker,preservation,12,2,10
11175,Dragonsphera,sylvanas,192,evoker,preservation,12,2,10
11176,Suicidel,silvermoon,192,evoker,preservation,12,2,10
11177,Macdrac,area-52,192,evoker,preservation,18,2,16
11178,Dracipsouk,drakthul,192,evoker,preservation,18,2,16
11179,Morpheuzx,tarren-mill,191,evoker,preservation,6,2,4
11180,Drackial,zuljin,191,evoker,preservation,6,2,4
11181,Ясосалочка,howling-fjord,191,evoker,preservation,6,2,4
11182,Yuyux,sanguino,191,evoker,preservation,6,2,4
11183,Адалдракулий,howling-fjord,191,evoker,preservation,6,2,4
11184,Azza,uldum,191,evoker,preservation,12,2,10
11185,Flameclaw,argent-dawn,191,evoker,preservation,12,2,10
11186,Viorias,argent-dawn,191,evoker,preservation,27,2,25
11187,Eldrax,emerald-dream,159,evoker,preservation,5,2,3
11188,Cirøvoke,ravencrest,159,evoker,preservation,5,2,3
11189,Kynirà,magtheridon,159,evoker,preservation,5,2,3
11190,Taynia,stormscale,144,evoker,preservation,9,2,7
11191,Stinka,blackmoore,138,evoker,preservation,9,5,4
11192,Asharys,argent-dawn,138,evoker,preservation,17,4,13
11193,Primepewpew,ragnaros,138,evoker,preservation,15,3,12
11194,Zzaazaa,argent-dawn,137,evoker,preservation,10,3,7
11195,Marcelproust,burning-legion,127,evoker,preservation,4,2,2
11196,Dewi,anachronos,96,evoker,preservation,6,1,5
11197,Rhaenaya,tarren-mill,96,evoker,preservation,6,1,5
11198,Beec,tarren-mill,96,evoker,preservation,6,1,5
11199,Rickastley,ragnaros,96,evoker,preservation,6,1,5
11200,Kedel,tarren-mill,96,evoker,preservation,6,1,5
11201,Drakenballen,ragnaros,96,evoker,preservation,6,1,5
11202,Lumberdrake,stormscale,96,evoker,preservation,6,1,5
11203,Tetrís,blackhand,96,evoker,preservation,6,1,5
11204,Drgn,blackhand,96,evoker,preservation,6,1,5
11205,Tokidormi,nemesis,96,evoker,preservation,6,1,5
11206,Pavelito,ysondre,96,evoker,preservation,6,1,5
11207,Mobidra,twisting-nether,96,evoker,preservation,6,1,5
11208,Азивокер,howling-fjord,96,evoker,preservation,6,1,5
11209,Mulqahdiiv,archimonde,96,evoker,preservation,6,1,5
11210,Batmanjasii,eredar,96,evoker,preservation,6,1,5
11211,Ch,ghostlands,96,evoker,preservation,6,1,5
11212,Louzard,draenor,96,evoker,preservation,6,1,5
11213,Hizzo,burning-legion,96,evoker,preservation,6,1,5
11214,Huangzhang,burning-legion,96,evoker,preservation,6,1,5
11215,Yaboismok,burning-legion,96,evoker,preservation,6,1,5
11216,Drachenlord,alakir,96,evoker,preservation,6,1,5
11217,Foldoudoune,archimonde,96,evoker,preservation,6,1,5
11218,Larrykoopa,hyjal,96,evoker,preservation,6,1,5
11219,Смехокрыл,deathguard,96,evoker,preservation,6,1,5
11220,Xqa,hyjal,96,evoker,preservation,6,1,5
11221,Oogabuga,outland,96,evoker,preservation,6,1,5
11222,Brystrasza,quelthalas,96,evoker,preservation,6,1,5
11223,Awienz,kazzak,96,evoker,preservation,6,1,5
11224,Gwindora,azjolnerub,96,evoker,preservation,6,1,5
11225,Dragonpro,kazzak,96,evoker,preservation,6,1,5
11226,Madbreath,cthun,96,evoker,preservation,6,1,5
11227,Tályn,twisting-nether,96,evoker,preservation,6,1,5
11228,Charovoker,blackmoore,96,evoker,preservation,6,1,5
11229,Kaezmasterx,blackrock,96,evoker,preservation,6,1,5
11230,Chocodragon,blackmoore,96,evoker,preservation,6,1,5
11231,Breathpitt,blackrock,96,evoker,preservation,6,1,5
11232,Ceerdrogo,twisting-nether,96,evoker,preservation,9,1,8
11233,Tatsuki,arthas,96,evoker,preservation,12,1,11
11234,Frreeyya,silvermoon,96,evoker,preservation,12,1,11
11235,Baddragonxxl,sylvanas,96,evoker,preservation,12,1,11
11236,Vullgred,sylvanas,96,evoker,preservation,12,1,11
11237,Sopollina,draenor,96,evoker,preservation,12,1,11
11238,Vänesiä,sylvanas,96,evoker,preservation,12,1,11
11239,Heidrun,ravenholdt,95,evoker,preservation,6,1,5
11240,Kelisthrasa,antonidas,95,evoker,preservation,6,1,5
11241,Fluffykoi,silvermoon,95,evoker,preservation,12,1,11
11242,Imend,stormscale,79,evoker,preservation,5,1,4
11243,Aarón,der-mithrilorden,79,evoker,preservation,5,1,4
11244,Blokie,silvermoon,79,evoker,preservation,5,1,4
11245,Sentos,blackmoore,64,evoker,preservation,10,1,9
11246,Draginy,blackrock,63,evoker,preservation,2,2,0
11247,Dopëshow,drakthul,48,evoker,preservation,3,1,2
11248,Faijer,blackmoore,42,evoker,preservation,10,3,7
11249,Nickydragonx,stormscale,42,evoker,preservation,10,3,7
11250,Flyvern,kazzak,42,evoker,preservation,8,2,6
11251,Ятутглавный,howling-fjord,16,evoker,preservation,1,1,0
11252,Кеннокс,soulflayer,2177,evoker,devastation,86,49,37
11253,Hehehihihaha,ravencrest,2176,evoker,devastation,84,44,40
11254,Animenorgam,alakir,2126,evoker,devastation,254,151,103
11255,Rexzstrasza,eredar,2114,evoker,devastation,78,49,29
11256,Sârmikas,blackhand,2113,evoker,devastation,120,67,53
11257,Kàido,ravencrest,2110,evoker,devastation,360,185,175
11258,Ryujíin,kazzak,2045,evoker,devastation,89,59,30
11259,Drakenyasha,tarren-mill,2045,evoker,devastation,207,103,104
11260,Heõ,twisting-nether,2034,evoker,devastation,207,102,105
11261,Babodrake,blackhand,2019,evoker,devastation,55,27,28
11262,Нерфсрочно,gordunni,1990,evoker,devastation,228,114,114
11263,Meust,blackrock,1960,evoker,devastation,48,33,15
11264,Claxy,ragnaros,1952,evoker,devastation,72,38,34
11265,Diznutz,kazzak,1949,evoker,devastation,90,45,45
11266,Wexvoker,darksorrow,1936,evoker,devastation,109,59,50
11267,Darkssoul,outland,1932,evoker,devastation,96,52,44
11268,Twodeep,blackrock,1930,evoker,devastation,123,64,59
11269,Myxker,burning-legion,1922,evoker,devastation,77,36,41
11270,Dracohfeu,archimonde,1913,evoker,devastation,82,44,38
11271,Evodraxx,hyjal,1911,evoker,devastation,72,32,40
11272,Brokz,twisting-nether,1906,evoker,devastation,110,56,54
11273,Ízma,ravencrest,1894,evoker,devastation,192,99,93
11274,Oontäälihis,ravencrest,1889,evoker,devastation,157,84,73
11275,Edvoker,twisting-nether,1875,evoker,devastation,120,62,58
11276,Lesgrossman,ravencrest,1870,evoker,devastation,42,26,16
11277,Ipanicsoar,tarren-mill,1869,evoker,devastation,128,64,64
11278,Nigesaurus,burning-legion,1862,evoker,devastation,39,21,18
11279,Enzetrius,argent-dawn,1861,evoker,devastation,36,22,14
11280,Atoll,scarshield-legion,1858,evoker,devastation,55,29,26
11281,Lizardbøi,blackhand,1855,evoker,devastation,72,37,35
11282,Silvior,outland,1854,evoker,devastation,60,29,31
11283,Frozendragon,twisting-nether,1849,evoker,devastation,45,32,13
11284,Xzvoker,kazzak,1848,evoker,devastation,134,67,67
11285,Balthinar,argent-dawn,1846,evoker,devastation,66,31,35
11286,Calygosa,antonidas,1843,evoker,devastation,36,23,13
11287,Advancedboy,archimonde,1839,evoker,devastation,69,32,37
11288,Sagrax,silvermoon,1835,evoker,devastation,68,40,28
11289,Mizamiza,blackrock,1832,evoker,devastation,142,75,67
11290,Korvi,ravencrest,1830,evoker,devastation,44,25,19
11291,Azorgaron,outland,1827,evoker,devastation,36,23,13
11292,Ryuu,mazrigos,1823,evoker,devastation,41,22,19
11293,Irvethius,argent-dawn,1822,evoker,devastation,203,103,100
11294,Tremmérz,outland,1821,evoker,devastation,66,34,32
11295,Bigmacfrite,ysondre,1821,evoker,devastation,88,45,43
11296,Дракшотик,soulflayer,1817,evoker,devastation,30,19,11
11297,Jamzyevoker,emerald-dream,1816,evoker,devastation,49,26,23
11298,Ryuujin,outland,1815,evoker,devastation,66,30,36
11299,Amadeusx,ravencrest,1810,evoker,devastation,55,30,25
11300,Valdrakon,doomhammer,1807,evoker,devastation,66,39,27
11301,Zmej,twisting-nether,1807,evoker,devastation,60,27,33
11302,Дарратель,gordunni,1806,evoker,devastation,195,106,89
11303,Wuiflyta,dun-modr,1805,evoker,devastation,65,29,36
11304,Kamehaméha,outland,1803,evoker,devastation,48,26,22
11305,Lidldragon,argent-dawn,1801,evoker,devastation,32,23,9
11306,Hëroinhenry,tarren-mill,1794,evoker,devastation,48,33,15
11307,Драгонтьма,gordunni,1793,evoker,devastation,77,38,39
11308,Avë,kazzak,1790,evoker,devastation,77,39,38
11309,Shaze,zuljin,1788,evoker,devastation,59,39,20
11310,Rahzk,twisting-nether,1788,evoker,devastation,48,28,20
11311,Eldunaries,argent-dawn,1788,evoker,devastation,105,53,52
11312,Sloeez,kazzak,1782,evoker,devastation,48,24,24
11313,Evøkergøðx,outland,1779,evoker,devastation,97,51,46
11314,Apacstrasza,ragnaros,1776,evoker,devastation,116,57,59
11315,Nazyr,blackhand,1765,evoker,devastation,60,32,28
11316,Sawk,archimonde,1762,evoker,devastation,102,63,39
11317,Obbwoke,ravencrest,1760,evoker,devastation,84,44,40
11318,Дреадди,soulflayer,1756,evoker,devastation,76,40,36
11319,Верестраз,howling-fjord,1746,evoker,devastation,72,34,38
11320,Jeannedebruj,ravencrest,1725,evoker,devastation,165,81,84
11321,Keñwøød,ysondre,1717,evoker,devastation,41,19,22
11322,Kymaíra,hyjal,1716,evoker,devastation,48,22,26
11323,Archdragon,argent-dawn,1715,evoker,devastation,103,59,44
11324,Tetsú,tarren-mill,1714,evoker,devastation,90,53,37
11325,Melodio,outland,1713,evoker,devastation,60,37,23
11326,Kôlaghan,archimonde,1713,evoker,devastation,35,20,15
11327,Zendaÿa,silvermoon,1713,evoker,devastation,60,29,31
11328,Famouszorc,sanguino,1704,evoker,devastation,168,96,72
11329,Rokki,blackrock,1701,evoker,devastation,82,45,37
11330,Ларенил,gordunni,1701,evoker,devastation,66,28,38
11331,Sintharion,ravencrest,1699,evoker,devastation,93,47,46
11332,Mørningstãr,ragnaros,1698,evoker,devastation,36,22,14
11333,Cybraxq,kazzak,1692,evoker,devastation,30,18,12
11334,Хетсв,gordunni,1691,evoker,devastation,96,55,41
11335,Hollowbreath,sanguino,1685,evoker,devastation,209,101,108
11336,Duvahkahr,ragnaros,1683,evoker,devastation,57,28,29
11337,Jamiewing,ravencrest,1679,evoker,devastation,159,81,78
11338,Lurkî,blackhand,1678,evoker,devastation,48,21,27
11339,Sadlylate,dentarg,1677,evoker,devastation,66,34,32
11340,Скорукх,gordunni,1671,evoker,devastation,54,34,20
11341,Amnevoker,dalaran,1671,evoker,devastation,30,18,12
11342,Cinnannoe,tarren-mill,1670,evoker,devastation,151,85,66
11343,Varagon,rexxar,1665,evoker,devastation,53,32,21
11344,Гневиан,eversong,1660,evoker,devastation,160,81,79
11345,Аксиомх,soulflayer,1658,evoker,devastation,42,20,22
11346,Фиамниэль,gordunni,1655,evoker,devastation,48,22,26
11347,Yuhabahha,kazzak,1653,evoker,devastation,166,87,79
11348,Flâneur,ysondre,1652,evoker,devastation,53,25,28
11349,Fyndassil,blackrock,1652,evoker,devastation,59,21,38
11350,Dispelgodx,eredar,1647,evoker,devastation,42,20,22
11351,Hanoostrasz,tarren-mill,1646,evoker,devastation,129,70,59
11352,Dracoli,eredar,1646,evoker,devastation,91,48,43
11353,Sürion,grim-batol,1642,evoker,devastation,72,39,33
11354,Ясъелинеры,gordunni,1640,evoker,devastation,54,31,23
11355,Tezkaz,blackmoore,1639,evoker,devastation,283,145,138
11356,Draxxys,blackmoore,1637,evoker,devastation,66,33,33
11357,Dragonide,draenor,1636,evoker,devastation,35,20,15
11358,Serulyon,draenor,1636,evoker,devastation,84,43,41
11359,Ruinastrasza,silvermoon,1636,evoker,devastation,187,93,94
11360,Voklath,kazzak,1636,evoker,devastation,61,30,31
11361,Hyperan,twisting-nether,1635,evoker,devastation,82,40,42
11362,Rzektwo,eredar,1634,evoker,devastation,54,24,30
11363,Aegón,uldum,1633,evoker,devastation,84,38,46
11364,Niddhøgg,ragnaros,1632,evoker,devastation,36,21,15
11365,Stefanosxios,bloodfeather,1631,evoker,devastation,125,69,56
11366,Papayoyo,draenor,1630,evoker,devastation,156,75,81
11367,Merkels,blackmoore,1629,evoker,devastation,323,162,161
11368,Crueh,outland,1628,evoker,devastation,36,17,19
11369,Saintly,kult-der-verdammten,1627,evoker,devastation,66,33,33
11370,Meust,destromath,1627,evoker,devastation,42,20,22
11371,Deathdream,stormscale,1627,evoker,devastation,36,17,19
11372,Eskavoker,kazzak,1623,evoker,devastation,36,22,14
11373,Грринч,deathweaver,1619,evoker,devastation,94,49,45
11374,Саммеракс,gordunni,1619,evoker,devastation,60,25,35
11375,Aesstrass,hyjal,1618,evoker,devastation,47,27,20
11376,Mazaw,burning-legion,1613,evoker,devastation,72,41,31
11377,Batsquatch,argent-dawn,1612,evoker,devastation,36,23,13
11378,Drazam,blackrock,1612,evoker,devastation,94,55,39
11379,Zapaflap,silvermoon,1612,evoker,devastation,119,65,54
11380,Homeoffice,zenedar,1611,evoker,devastation,60,29,31
11381,Släshés,ravencrest,1610,evoker,devastation,54,23,31
11382,Леерустан,howling-fjord,1609,evoker,devastation,44,26,18
11383,Denegos,sylvanas,1606,evoker,devastation,66,40,26
11384,Drakshoff,khaz-modan,1606,evoker,devastation,265,142,123
11385,Ludwoker,tarren-mill,1605,evoker,devastation,67,44,23
11386,Lizarduck,tarren-mill,1605,evoker,devastation,52,26,26
11387,Пивнаябошка,soulflayer,1603,evoker,devastation,36,19,17
11388,Shumma,frostmane,1603,evoker,devastation,75,34,41
11389,Voldermort,ravencrest,1602,evoker,devastation,77,46,31
11390,Delorraine,burning-legion,1602,evoker,devastation,30,17,13
11391,Мнякуня,howling-fjord,1600,evoker,devastation,46,24,22
11392,Спайрок,gordunni,1600,evoker,devastation,158,78,80
11393,Drakeflaps,lightnings-blade,1599,evoker,devastation,30,18,12
11394,Soleric,drakthul,1599,evoker,devastation,121,57,64
11395,Pêengei,blackrock,1596,evoker,devastation,66,36,30
11396,Углекислот,howling-fjord,1595,evoker,devastation,78,35,43
11397,Krothus,outland,1590,evoker,devastation,124,67,57
11398,Ðø,antonidas,1589,evoker,devastation,35,18,17
11399,Draguzee,draenor,1579,evoker,devastation,36,23,13
11400,Lumberdrake,stormscale,1579,evoker,devastation,40,24,16
11401,Ysterja,darkspear,1577,evoker,devastation,36,27,9
11402,Øxyom,archimonde,1570,evoker,devastation,46,27,19
11403,Ocanada,draenor,1563,evoker,devastation,84,45,39
11404,Инсейнмэн,soulflayer,1562,evoker,devastation,133,69,64
11405,Touchmywings,ravencrest,1560,evoker,devastation,24,17,7
11406,Drôgon,archimonde,1560,evoker,devastation,60,28,32
11407,Аймбадикабтв,howling-fjord,1555,evoker,devastation,72,33,39
11408,Devoxz,tarren-mill,1554,evoker,devastation,54,30,24
11409,Lagerstrasza,stormreaver,1553,evoker,devastation,42,21,21
11410,Ch,ghostlands,1546,evoker,devastation,47,22,25
11411,Dragonandyy,blackrock,1544,evoker,devastation,71,38,33
11412,Kayly,twisting-nether,1540,evoker,devastation,42,29,13
11413,Emmagosa,argent-dawn,1539,evoker,devastation,96,52,44
11414,Øseria,khaz-modan,1538,evoker,devastation,124,73,51
11415,Màlakir,chogall,1537,evoker,devastation,50,24,26
11416,Tiganj,silvermoon,1536,evoker,devastation,48,31,17
11417,Woasid,outland,1536,evoker,devastation,42,26,16
11418,Shimmerscale,blackhand,1533,evoker,devastation,111,60,51
11419,Hömeöffice,sylvanas,1532,evoker,devastation,50,26,24
11420,Merqury,ravencrest,1529,evoker,devastation,24,16,8
11421,Swapxyevo,ravencrest,1525,evoker,devastation,30,16,14
11422,Филлид,gordunni,1525,evoker,devastation,43,19,24
11423,Badrig,silvermoon,1523,evoker,devastation,210,112,98
11424,Ольменго,fordragon,1523,evoker,devastation,44,18,26
11425,Spýröo,kazzak,1522,evoker,devastation,108,67,41
11426,Gämeovêrkïd,archimonde,1522,evoker,devastation,59,35,24
11427,Hyperflexx,blackrock,1521,evoker,devastation,30,16,14
11428,Cûddles,hyjal,1521,evoker,devastation,138,70,68
11429,Bindrasz,ahnqiraj,1520,evoker,devastation,36,16,20
11430,Savaithnir,draenor,1513,evoker,devastation,30,16,14
11431,Gasparievok,sylvanas,1513,evoker,devastation,135,69,66
11432,Lilpooper,bloodhoof,1508,evoker,devastation,61,32,29
11433,Telepathy,ravencrest,1507,evoker,devastation,29,18,11
11434,Lazurius,ravencrest,1507,evoker,devastation,54,26,28
11435,Skywitch,ragnaros,1507,evoker,devastation,60,28,32
11436,Draghad,blackmoore,1506,evoker,devastation,75,37,38
11437,Phanex,bloodhoof,1506,evoker,devastation,66,28,38
11438,Parisinka,silvermoon,1503,evoker,devastation,341,178,163
11439,Ironwing,sanguino,1502,evoker,devastation,456,234,222
11440,Лабриса,galakrond,1501,evoker,devastation,230,113,117
11441,Bakspek,kilrogg,1498,evoker,devastation,24,16,8
11442,Mommystrasza,dentarg,1493,evoker,devastation,92,46,46
11443,Agnî,sanguino,1490,evoker,devastation,82,40,42
11444,Kaynyxia,argent-dawn,1487,evoker,devastation,45,25,20
11445,Deadlyvok,zenedar,1486,evoker,devastation,24,16,8
11446,Bodytypechad,ravencrest,1482,evoker,devastation,60,32,28
11447,Dracyan,taerar,1479,evoker,devastation,42,24,18
11448,Fogwing,ravencrest,1478,evoker,devastation,71,38,33
11449,Arbylegion,outland,1478,evoker,devastation,118,63,55
11450,Piyuli,silvermoon,1475,evoker,devastation,49,27,22
11451,Yol,bladefist,1474,evoker,devastation,66,30,36
11452,Draakoñ,outland,1473,evoker,devastation,42,18,24
11453,Dowaa,tarren-mill,1473,evoker,devastation,48,20,28
11454,Dragorus,stormscale,1472,evoker,devastation,81,41,40
11455,Rowzy,sylvanas,1468,evoker,devastation,148,77,71
11456,Motloh,ravencrest,1468,evoker,devastation,42,20,22
11457,Уфдрактир,howling-fjord,1466,evoker,devastation,48,23,25
11458,Shenronblue,bloodscalp,1465,evoker,devastation,30,16,14
11459,Nuvese,tarren-mill,1460,evoker,devastation,36,16,20
11460,Mölnlycke,twisting-nether,1457,evoker,devastation,53,29,24
11461,Baroqs,antonidas,1456,evoker,devastation,24,18,6
11462,Простокоршун,howling-fjord,1456,evoker,devastation,30,20,10
11463,Nagoli,silvermoon,1456,evoker,devastation,52,27,25
11464,Grillkylling,outland,1454,evoker,devastation,69,38,31
11465,Magmarôs,argent-dawn,1453,evoker,devastation,81,48,33
11466,Кунидракон,gordunni,1453,evoker,devastation,86,40,46
11467,Malfoyer,arathor,1452,evoker,devastation,54,30,24
11468,Ghiscar,dentarg,1451,evoker,devastation,102,50,52
11469,Chuckyy,archimonde,1446,evoker,devastation,48,26,22
11470,Лечулечу,blackscar,1442,evoker,devastation,90,39,51
11471,Judda,stormscale,1438,evoker,devastation,30,15,15
11472,Nerfmeplze,outland,1438,evoker,devastation,30,15,15
11473,Паунфаунд,eversong,1435,evoker,devastation,96,45,51
11474,Норимида,soulflayer,1434,evoker,devastation,67,39,28
11475,Feyrbrand,ysera,1434,evoker,devastation,92,48,44
11476,Dikkondrus,twisting-nether,1434,evoker,devastation,101,50,51
11477,Hellvarg,twisting-nether,1433,evoker,devastation,30,18,12
11478,Ken,la-croisade-écarlate,1433,evoker,devastation,207,104,103
11479,Drunkino,aegwynn,1432,evoker,devastation,60,31,29
11480,Drakea,sanguino,1432,evoker,devastation,98,49,49
11481,Juhadormu,stormreaver,1432,evoker,devastation,30,15,15
11482,Pippomale,nemesis,1430,evoker,devastation,42,22,20
11483,Йормунгандка,soulflayer,1429,evoker,devastation,39,20,19
11484,Caliss,archimonde,1427,evoker,devastation,71,38,33
11485,Evokimag,grim-batol,1425,evoker,devastation,30,15,15
11486,Yoshinora,archimonde,1424,evoker,devastation,36,19,17
11487,Dreek,emerald-dream,1423,evoker,devastation,30,20,10
11488,Tibimbo,blackrock,1418,evoker,devastation,98,51,47
11489,Drackial,zuljin,1418,evoker,devastation,72,32,40
11490,Yála,anetheron,1416,evoker,devastation,232,116,116
11491,Фаламэйн,soulflayer,1412,evoker,devastation,24,15,9
11492,Solandor,kazzak,1411,evoker,devastation,24,15,9
11493,Flügelnix,blackmoore,1401,evoker,devastation,59,28,31
11494,Draconz,stormrage,1399,evoker,devastation,42,21,21
11495,Avizz,tarren-mill,1396,evoker,devastation,39,21,18
11496,Childofdawn,blackmoore,1392,evoker,devastation,60,36,24
11497,Dreamfyrez,dun-modr,1391,evoker,devastation,60,29,31
11498,Юнигоса,soulflayer,1388,evoker,devastation,36,20,16
11499,Xtdrakaris,uldum,1388,evoker,devastation,478,237,241
11500,Loveheart,die-aldor,1386,evoker,devastation,57,29,28
11501,Ouaitamaman,draenor,1386,evoker,devastation,30,15,15
11502,Kuve,stormscale,1386,evoker,devastation,81,39,42
11503,Tályn,twisting-nether,1385,evoker,devastation,48,25,23
11504,Голденджо,gordunni,1382,evoker,devastation,64,31,33
11505,Honz,antonidas,1380,evoker,devastation,49,23,26
11506,Keeqo,silvermoon,1378,evoker,devastation,54,33,21
11507,Cuufizix,silvermoon,1377,evoker,devastation,70,38,32
11508,Nathraakhza,argent-dawn,1375,evoker,devastation,48,26,22
11509,Dratheon,dun-modr,1375,evoker,devastation,39,20,19
11510,Xéíoín,kazzak,1374,evoker,devastation,78,41,37
11511,Vagar,garona,1369,evoker,devastation,42,20,22
11512,Kirinde,draenor,1368,evoker,devastation,30,19,11
11513,Drákon,dalaran,1368,evoker,devastation,111,50,61
11514,Kaìdo,tarren-mill,1365,evoker,devastation,48,21,27
11515,Marvok,bloodfeather,1363,evoker,devastation,54,19,35
11516,Sakade,archimonde,1359,evoker,devastation,66,22,44
11517,Драгтир,blackscar,1355,evoker,devastation,76,45,31
11518,Nazalath,eonar,1354,evoker,devastation,106,51,55
11519,Nurilla,twisting-nether,1352,evoker,devastation,36,17,19
11520,Saragoza,kirin-tor,1350,evoker,devastation,30,15,15
11521,Smegma,norgannon,1348,evoker,devastation,30,15,15
11522,Ferante,ragnaros,1346,evoker,devastation,131,60,71
11523,Hazzèr,blackrock,1345,evoker,devastation,162,82,80
11524,Thyriån,kazzak,1344,evoker,devastation,42,19,23
11525,Juicyjeffe,blackrock,1341,evoker,devastation,18,14,4
11526,Ксдз,soulflayer,1341,evoker,devastation,60,28,32
11527,Thebigsmoke,lightbringer,1337,evoker,devastation,124,67,57
11528,Yaboismok,burning-legion,1336,evoker,devastation,53,23,30
11529,Potéto,rashgarroth,1334,evoker,devastation,72,31,41
11530,Kuhi,twisting-nether,1328,evoker,devastation,42,18,24
11531,Karnâks,silvermoon,1326,evoker,devastation,30,16,14
11532,Hornytail,doomhammer,1323,evoker,devastation,29,15,14
11533,Димадракон,gordunni,1321,evoker,devastation,58,37,21
11534,Zsyntra,blackmoore,1321,evoker,devastation,30,14,16
11535,Eldraegosa,argent-dawn,1320,evoker,devastation,30,14,16
11536,Yantaî,hyjal,1315,evoker,devastation,48,30,18
11537,Tenshà,nemesis,1314,evoker,devastation,71,35,36
11538,Dakir,blackmoore,1312,evoker,devastation,38,26,12
11539,Seryphys,blackhand,1312,evoker,devastation,48,24,24
11540,Favill,blackhand,1312,evoker,devastation,69,30,39
11541,Snoby,onyxia,1309,evoker,devastation,158,70,88
11542,Nochance,dentarg,1305,evoker,devastation,102,51,51
11543,Darktempest,onyxia,1300,evoker,devastation,66,32,34
11544,Draxone,malfurion,1297,evoker,devastation,54,33,21
11545,Yaldthion,dun-modr,1295,evoker,devastation,54,24,30
11546,Thavion,forscherliga,1291,evoker,devastation,30,14,16
11547,Душнот,fordragon,1283,evoker,devastation,65,35,30
11548,Airbourne,sanguino,1280,evoker,devastation,38,18,20
11549,Dragonaked,silvermoon,1279,evoker,devastation,78,38,40
11550,Sharaxis,blackmoore,1276,evoker,devastation,42,23,19
11551,Gharløk,outland,1276,evoker,devastation,80,43,37
11552,Драганайт,gordunni,1274,evoker,devastation,94,58,36
11553,Shmog,stormscale,1272,evoker,devastation,41,15,26
11554,Ayders,khaz-modan,1270,evoker,devastation,156,76,80
11555,Raagnar,kazzak,1266,evoker,devastation,60,29,31
11556,Ppiaxx,dalaran,1263,evoker,devastation,30,15,15
11557,Itisabuse,antonidas,1262,evoker,devastation,36,18,18
11558,Echoker,stormscale,1261,evoker,devastation,31,16,15
11559,Llael,blackhand,1259,evoker,devastation,86,36,50
11560,Коляомон,gordunni,1256,evoker,devastation,71,38,33
11561,Shoggoth,chogall,1256,evoker,devastation,187,89,98
11562,Emayra,argent-dawn,1253,evoker,devastation,23,14,9
11563,Rafale,the-maelstrom,1253,evoker,devastation,42,21,21
11564,Orazur,hyjal,1247,evoker,devastation,18,13,5
11565,Алексатэтсуя,ashenvale,1247,evoker,devastation,36,18,18
11566,Evojøa,tarren-mill,1246,evoker,devastation,24,13,11
11567,Steeken,haomarush,1246,evoker,devastation,129,59,70
11568,Серцедраконн,gordunni,1246,evoker,devastation,81,36,45
11569,Leyca,outland,1245,evoker,devastation,48,19,29
11570,Veo,aggra-português,1244,evoker,devastation,42,20,22
11571,Доракарис,deathweaver,1243,evoker,devastation,42,20,22
11572,Nyedrak,kilrogg,1239,evoker,devastation,18,13,5
11573,Rieper,twisting-nether,1239,evoker,devastation,207,101,106
11574,Snitties,tarren-mill,1234,evoker,devastation,34,14,20
11575,Rufistraz,burning-legion,1231,evoker,devastation,43,18,25
11576,Haltorr,ravencrest,1230,evoker,devastation,36,13,23
11577,Oudwood,onyxia,1229,evoker,devastation,36,13,23
11578,Xendrag,silvermoon,1227,evoker,devastation,96,45,51
11579,Дыханиеочка,howling-fjord,1227,evoker,devastation,30,13,17
11580,Tokzestra,hyjal,1222,evoker,devastation,62,28,34
11581,Minikuja,culte-de-la-rive-noire,1219,evoker,devastation,233,125,108
11582,Шотнутый,soulflayer,1213,evoker,devastation,51,26,25
11583,Dragoncloak,blackrock,1209,evoker,devastation,106,59,47
11584,Evosker,zuljin,1207,evoker,devastation,48,17,31
11585,Isizzu,draenor,1205,evoker,devastation,73,37,36
11586,Zenda,turalyon,1202,evoker,devastation,67,30,37
11587,Razthyr,twisting-nether,1201,evoker,devastation,70,33,37
11588,Xfckd,ragnaros,1199,evoker,devastation,60,28,32
11589,Wingit,frostmane,1187,evoker,devastation,36,21,15
11590,Mesmerìze,khaz-modan,1185,evoker,devastation,30,14,16
11591,Ryújín,blackhand,1183,evoker,devastation,29,13,16
11592,Папиич,soulflayer,1176,evoker,devastation,59,21,38
11593,Firaxis,kazzak,1173,evoker,devastation,60,32,28
11594,Flaminghot,stormreaver,1173,evoker,devastation,257,137,120
11595,Glennett,silvermoon,1172,evoker,devastation,28,13,15
11596,Dopëshow,drakthul,1170,evoker,devastation,36,20,16
11597,Rhel,the-maelstrom,1170,evoker,devastation,30,15,15
11598,Lugarius,gilneas,1164,evoker,devastation,41,23,18
11599,Camilis,archimonde,1159,evoker,devastation,33,14,19
11600,Tazouu,marécage-de-zangar,1158,evoker,devastation,24,15,9
11601,Рептилойдина,howling-fjord,1154,evoker,devastation,78,37,41
11602,Kmzi,twisting-nether,1151,evoker,devastation,24,12,12
11603,Deny,frostmane,1150,evoker,devastation,18,12,6
11604,Darthagos,outland,1145,evoker,devastation,18,12,6
11605,Zaralek,stormscale,1145,evoker,devastation,18,12,6
11606,Imwhite,doomhammer,1144,evoker,devastation,48,22,26
11607,Туймаада,soulflayer,1141,evoker,devastation,18,12,6
11608,Dracsona,twisting-nether,1141,evoker,devastation,24,12,12
11609,Ahiresegyfej,ragnaros,1139,evoker,devastation,72,39,33
11610,Gissthebuzzy,dun-modr,1138,evoker,devastation,24,12,12
11611,Ekko,nethersturm,1136,evoker,devastation,54,30,24
11612,Scathethrel,draenor,1135,evoker,devastation,24,12,12
11613,Wircea,kazzak,1133,evoker,devastation,18,12,6
11614,Ignisaureus,silvermoon,1133,evoker,devastation,30,13,17
11615,Алыйкиви,howling-fjord,1132,evoker,devastation,33,17,16
11616,Lago,gorgonnash,1130,evoker,devastation,66,36,30
11617,Antistrasza,argent-dawn,1125,evoker,devastation,33,15,18
11618,Sleepnot,argent-dawn,1121,evoker,devastation,18,12,6
11619,Dragomakry,blackmoore,1118,evoker,devastation,54,30,24
11620,Lektar,eredar,1118,evoker,devastation,29,13,16
11621,Deathdula,draenor,1117,evoker,devastation,30,14,16
11622,Dranke,silvermoon,1115,evoker,devastation,85,45,40
11623,Clueless,nemesis,1112,evoker,devastation,29,12,17
11624,Jelboen,draenor,1111,evoker,devastation,34,19,15
11625,Iolite,dun-modr,1111,evoker,devastation,78,39,39
11626,Rytoshi,medivh,1111,evoker,devastation,78,28,50
11627,Azzul,teldrassil,1110,evoker,devastation,31,16,15
11628,Evokíng,argent-dawn,1109,evoker,devastation,97,42,55
11629,Iordred,kazzak,1104,evoker,devastation,24,12,12
11630,Theredpepper,outland,1104,evoker,devastation,30,12,18
11631,Abcxqt,hyjal,1097,evoker,devastation,28,13,15
11632,Dàenérys,hyjal,1089,evoker,devastation,48,31,17
11633,Dragis,die-aldor,1088,evoker,devastation,36,17,19
11634,Crygon,outland,1086,evoker,devastation,42,17,25
11635,Fruhans,tarren-mill,1080,evoker,devastation,29,15,14
11636,Padrepì,nemesis,1078,evoker,devastation,18,13,5
11637,Syraxis,shadowsong,1074,evoker,devastation,22,12,10
11638,Draganeel,frostwolf,1073,evoker,devastation,54,17,37
11639,Raktoy,frostwolf,1071,evoker,devastation,70,28,42
11640,Ferdibaba,aegwynn,1071,evoker,devastation,42,13,29
11641,Мизурион,gordunni,1070,evoker,devastation,24,19,5
11642,Akúda,blackhand,1069,evoker,devastation,42,20,22
11643,Sethos,dalaran,1068,evoker,devastation,36,13,23
11644,Дархо,goldrinn,1059,evoker,devastation,36,21,15
11645,Canitabravar,cthun,1057,evoker,devastation,54,27,27
11646,Fabrizios,blackrock,1055,evoker,devastation,24,11,13
11647,Dragônslayer,amanthul,1054,evoker,devastation,24,14,10
11648,Infopaki,stormscale,1054,evoker,devastation,19,11,8
11649,Krazuntus,argent-dawn,1054,evoker,devastation,24,11,13
11650,Beeragos,deathwing,1053,evoker,devastation,18,11,7
11651,Калесгоз,howling-fjord,1053,evoker,devastation,24,11,13
11652,Pêrcevâl,archimonde,1053,evoker,devastation,24,11,13
11653,Dragonlia,blackrock,1052,evoker,devastation,18,11,7
11654,Lecutos,sunstrider,1052,evoker,devastation,18,11,7
11655,Lonte,hyjal,1052,evoker,devastation,18,11,7
11656,Алрад,gordunni,1051,evoker,devastation,21,12,9
11657,Daboc,tarren-mill,1051,evoker,devastation,74,30,44
11658,Kirkgon,terokkar,1047,evoker,devastation,42,15,27
11659,Dovakin,arathi,1043,evoker,devastation,20,12,8
11660,Otr,draenor,1037,evoker,devastation,72,29,43
11661,Гекаш,soulflayer,1034,evoker,devastation,36,11,25
11662,Krithdow,terokkar,1031,evoker,devastation,23,13,10
11663,Elorand,ulduar,1025,evoker,devastation,78,29,49
11664,Bubbleblower,stormscale,1023,evoker,devastation,16,11,5
11665,Rîncêwind,uldum,1018,evoker,devastation,42,25,17
11666,Pedogos,outland,1016,evoker,devastation,75,31,44
11667,Draqthyr,frostmane,1015,evoker,devastation,23,11,12
11668,Arella,mannoroth,1006,evoker,devastation,149,76,73
11669,Drakridarn,kazzak,999,evoker,devastation,29,11,18
11670,Mallor,kirin-tor,990,evoker,devastation,36,14,22
11671,Dragonhero,arygos,986,evoker,devastation,96,52,44
11672,Julerion,draenor,984,evoker,devastation,42,26,16
11673,Ashlàr,earthen-ring,979,evoker,devastation,51,21,30
11674,Deskölorio,shendralar,978,evoker,devastation,22,13,9
11675,Ewoky,ravencrest,976,evoker,devastation,30,12,18
11676,Vucashi,blackhand,974,evoker,devastation,46,18,28
11677,Bläckrow,tarren-mill,960,evoker,devastation,12,10,2
11678,Rhegal,auchindoun,960,evoker,devastation,12,10,2
11679,Billyhassan,stormscale,960,evoker,devastation,12,10,2
11680,Spicylizard,stormscale,960,evoker,devastation,18,10,8
11681,Soondeleted,eredar,960,evoker,devastation,18,10,8
11682,Kiwí,antonidas,960,evoker,devastation,18,10,8
11683,Azustraza,ysondre,960,evoker,devastation,24,10,14
11684,Jinthyr,anachronos,959,evoker,devastation,12,10,2
11685,Lùñe,hyjal,959,evoker,devastation,12,10,2
11686,Terradòr,die-aldor,959,evoker,devastation,18,10,8
11687,Dractaris,khaz-modan,959,evoker,devastation,18,10,8
11688,Hästdrake,the-maelstrom,959,evoker,devastation,30,10,20
11689,Drevo,nemesis,958,evoker,devastation,12,10,2
11690,Волккейн,soulflayer,958,evoker,devastation,18,10,8
11691,Maccen,twisting-nether,955,evoker,devastation,18,10,8
11692,Danaval,blackhand,955,evoker,devastation,18,10,8
11693,Enzospatalo,nemesis,955,evoker,devastation,18,10,8
11694,Grajade,dun-modr,954,evoker,devastation,18,10,8
11695,Batmanjasii,eredar,953,evoker,devastation,18,10,8
11696,Boulior,defias-brotherhood,952,evoker,devastation,24,10,14
11697,Akaitzu,blackmoore,950,evoker,devastation,18,10,8
11698,Lizzardhero,kazzak,948,evoker,devastation,24,10,14
11699,Быковскии,howling-fjord,939,evoker,devastation,60,34,26
11700,Scalo,kazzak,935,evoker,devastation,17,10,7
11701,Dragotar,malygos,932,evoker,devastation,97,50,47
11702,Jkrowlingxox,ravencrest,928,evoker,devastation,36,17,19
11703,Oeos,dragonblight,925,evoker,devastation,54,18,36
11704,Leskano,aegwynn,923,evoker,devastation,30,14,16
11705,Drakkisat,archimonde,918,evoker,devastation,34,17,17
11706,Starblazed,defias-brotherhood,916,evoker,devastation,12,10,2
11707,Dracofeuxd,archimonde,912,evoker,devastation,21,10,11
11708,Azza,uldum,912,evoker,devastation,36,14,22
11709,Stormydude,doomhammer,907,evoker,devastation,24,13,11
11710,Tendoker,ragnaros,888,evoker,devastation,17,10,7
11711,Sleipnyr,garrosh,888,evoker,devastation,60,27,33
11712,Donairian,doomhammer,886,evoker,devastation,63,31,32
11713,Blazinamazin,korgall,884,evoker,devastation,22,10,12
11714,Tenkenfutsu,elune,879,evoker,devastation,100,41,59
11715,Disizmaju,silvermoon,873,evoker,devastation,36,18,18
11716,Lifestrasza,drakthul,868,evoker,devastation,13,10,3
11717,Ralfferion,auchindoun,864,evoker,devastation,18,9,9
11718,Yimvoker,blackrock,864,evoker,devastation,18,9,9
11719,Pinacóladaqt,stormscale,864,evoker,devastation,18,9,9
11720,Рогатыйдебик,gordunni,863,evoker,devastation,18,9,9
11721,Luu,the-maelstrom,863,evoker,devastation,18,9,9
11722,Féféledragon,archimonde,863,evoker,devastation,18,9,9
11723,Setutekh,argent-dawn,863,evoker,devastation,24,9,15
11724,Gle,ragnaros,863,evoker,devastation,30,9,21
11725,Storhorn,silvermoon,863,evoker,devastation,30,9,21
11726,Abehethan,archimonde,862,evoker,devastation,18,9,9
11727,Runednmf,kazzak,862,evoker,devastation,18,9,9
11728,Nanderoza,the-maelstrom,861,evoker,devastation,12,9,3
11729,Bloodspiral,tarren-mill,861,evoker,devastation,18,9,9
11730,Kroqmoo,drekthar,861,evoker,devastation,19,9,10
11731,Shenrøn,garona,861,evoker,devastation,29,11,18
11732,Skabaluga,blackrock,860,evoker,devastation,18,9,9
11733,Copíum,silvermoon,859,evoker,devastation,30,9,21
11734,Dschíses,malganis,858,evoker,devastation,18,9,9
11735,Shyke,draenor,858,evoker,devastation,18,9,9
11736,Karistrasza,sylvanas,854,evoker,devastation,24,9,15
11737,Elitedraach,tarren-mill,847,evoker,devastation,17,9,8
11738,Флардикас,gordunni,842,evoker,devastation,24,9,15
11739,Scalash,drakthul,836,evoker,devastation,54,25,29
11740,Xatures,twisting-nether,832,evoker,devastation,24,14,10
11741,Sivaas,arathi,832,evoker,devastation,60,29,31
11742,Acedragniir,khaz-modan,826,evoker,devastation,24,11,13
11743,Thebabayag,kazzak,823,evoker,devastation,24,10,14
11744,Crynerf,ravencrest,817,evoker,devastation,84,39,45
11745,Tsunamì,ysondre,768,evoker,devastation,12,8,4
11746,Gloombloom,emeriss,768,evoker,devastation,13,8,5
11747,Súnny,archimonde,768,evoker,devastation,15,8,7
11748,Mazakqt,draenor,768,evoker,devastation,18,8,10
11749,Nekrosdrake,tarren-mill,768,evoker,devastation,18,8,10
11750,Garussy,draenor,768,evoker,devastation,18,8,10
11751,Lulvoker,blackrock,768,evoker,devastation,18,8,10
11752,Zp,kazzak,768,evoker,devastation,18,8,10
11753,Drãco,auchindoun,768,evoker,devastation,30,8,22
11754,Fayral,blackmoore,767,evoker,devastation,12,8,4
11755,Balerioon,draenor,767,evoker,devastation,12,8,4
11756,Deathwingx,sylvanas,767,evoker,devastation,18,8,10
11757,Tooltipshow,ragnaros,767,evoker,devastation,18,8,10
11758,Shenlongoat,ravencrest,766,evoker,devastation,12,8,4
11759,Aiakès,marécage-de-zangar,766,evoker,devastation,12,8,4
11760,Flypzz,stormscale,766,evoker,devastation,18,8,10
11761,Flawxy,blackmoore,766,evoker,devastation,18,8,10
11762,Saratharion,argent-dawn,764,evoker,devastation,24,8,16
11763,Firebutt,argent-dawn,763,evoker,devastation,12,8,4
11764,Ogienoddech,silvermoon,762,evoker,devastation,18,8,10
11765,Zerotales,turalyon,755,evoker,devastation,12,8,4
11766,Drakenballen,ragnaros,755,evoker,devastation,15,8,7
11767,Viorias,argent-dawn,751,evoker,devastation,24,8,16
11768,Davioncz,thunderhorn,749,evoker,devastation,12,8,4
11769,Vanima,forscherliga,746,evoker,devastation,12,8,4
11770,Morsan,tichondrius,737,evoker,devastation,19,9,10
11771,Zyevoker,silvermoon,687,evoker,devastation,13,8,5
11772,Schmoker,stormscale,672,evoker,devastation,12,7,5
11773,Arecibo,tarren-mill,672,evoker,devastation,12,7,5
11774,Styxev,blackhand,672,evoker,devastation,12,7,5
11775,Elbozo,kazzak,672,evoker,devastation,12,7,5
11776,Knööz,antonidas,672,evoker,devastation,12,7,5
11777,Zettaflare,nazjatar,672,evoker,devastation,12,7,5
11778,Hodnsak,blackmoore,672,evoker,devastation,12,7,5
11779,Paizz,tarren-mill,672,evoker,devastation,12,7,5
11780,Flythe,silvermoon,672,evoker,devastation,12,7,5
11781,Gonzalo,dun-modr,672,evoker,devastation,12,7,5
11782,Sebek,archimonde,672,evoker,devastation,12,7,5
11783,Jaykvoker,kazzak,672,evoker,devastation,12,7,5
11784,Эбиб,gordunni,672,evoker,devastation,12,7,5
11785,Cascadia,deathwing,672,evoker,devastation,15,8,7
11786,Kda,die-nachtwache,672,evoker,devastation,18,7,11
11787,Zaradreth,grim-batol,672,evoker,devastation,18,7,11
11788,Glurakk,aegwynn,672,evoker,devastation,18,7,11
11789,Ønce,durotan,672,evoker,devastation,18,7,11
11790,Aeryz,burning-legion,672,evoker,devastation,24,7,17
11791,Drexxe,boulderfist,672,evoker,devastation,24,7,17
11792,Evoslaps,norgannon,671,evoker,devastation,12,7,5
11793,Jarhys,draenor,671,evoker,devastation,12,7,5
11794,Dracofion,ravencrest,671,evoker,devastation,12,7,5
11795,Kábutø,antonidas,671,evoker,devastation,12,7,5
11796,Chck,ragnaros,671,evoker,devastation,18,7,11
11797,Stalkhyr,elune,671,evoker,devastation,18,7,11
11798,Mijähh,taerar,671,evoker,devastation,18,7,11
11799,Azzazed,dun-modr,670,evoker,devastation,12,7,5
11800,Ryuniss,argent-dawn,670,evoker,devastation,12,7,5
11801,Wôpz,archimonde,670,evoker,devastation,12,7,5
11802,Bullseiye,silvermoon,670,evoker,devastation,18,7,11
11803,Enemi,twisting-nether,669,evoker,devastation,14,9,5
11804,Nebulai,silvermoon,669,evoker,devastation,19,7,12
11805,Flapant,archimonde,668,evoker,devastation,18,7,11
11806,Kvothe,malygos,668,evoker,devastation,18,7,11
11807,Аверьятор,fordragon,663,evoker,devastation,18,7,11
11808,Chrysaetor,argent-dawn,657,evoker,devastation,12,7,5
11809,Flameclaw,argent-dawn,657,evoker,devastation,12,7,5
11810,Kayizer,archimonde,657,evoker,devastation,12,7,5
11811,Evokah,der-abyssische-rat,655,evoker,devastation,23,7,16
11812,Draknil,ysondre,640,evoker,devastation,16,7,9
11813,Auchedrax,argent-dawn,639,evoker,devastation,14,8,6
11814,Zharas,nemesis,623,evoker,devastation,11,7,4
11815,Zpartadraga,ragnaros,584,evoker,devastation,9,8,1
11816,Dromar,malganis,576,evoker,devastation,6,6,0
11817,Tholanía,baelgun,576,evoker,devastation,6,6,0
11818,Kallistian,argent-dawn,576,evoker,devastation,6,6,0
11819,Henmon,defias-brotherhood,576,evoker,devastation,6,6,0
11820,Selectaa,grim-batol,576,evoker,devastation,12,6,6
11821,Dracalos,silvermoon,576,evoker,devastation,12,6,6
11822,Terrorclaw,ragnaros,576,evoker,devastation,12,6,6
11823,Puffdaddyxd,twisting-nether,576,evoker,devastation,12,6,6
11824,Gorgonn,cthun,576,evoker,devastation,12,6,6
11825,Khimari,xavius,576,evoker,devastation,12,6,6
11826,Xendragon,kazzak,576,evoker,devastation,12,6,6
11827,Charezard,draenor,576,evoker,devastation,12,6,6
11828,Scalewind,twisting-nether,576,evoker,devastation,12,6,6
11829,Mattyastrasz,hyjal,576,evoker,devastation,12,6,6
11830,Naömi,archimonde,576,evoker,devastation,12,6,6
11831,Madeinhæven,ravencrest,576,evoker,devastation,18,6,12
11832,Митокада,soulflayer,576,evoker,devastation,18,6,12
11833,Burnrate,draenor,576,evoker,devastation,20,6,14
11834,Barneyxx,tarren-mill,576,evoker,devastation,24,6,18
11835,Ágarosz,sanguino,575,evoker,devastation,12,6,6
11836,Chunlooi,baelgun,575,evoker,devastation,12,6,6
11837,Hyunastraza,dalaran,575,evoker,devastation,12,6,6
11838,Drdrake,aszune,575,evoker,devastation,12,6,6
11839,Meyowuo,doomhammer,575,evoker,devastation,14,6,8
11840,Uprover,kazzak,575,evoker,devastation,18,6,12
11841,Малесиндра,gordunni,575,evoker,devastation,18,6,12
11842,Temeraire,argent-dawn,575,evoker,devastation,18,6,12
11843,Mazzg,blackmoore,574,evoker,devastation,21,7,14
11844,Morph,talnivarr,574,evoker,devastation,18,6,12
11845,Kharon,garrosh,574,evoker,devastation,24,6,18
11846,Geckonen,stormreaver,573,evoker,devastation,18,6,12
11847,Dragorona,kult-der-verdammten,572,evoker,devastation,12,6,6
11848,Faijer,blackmoore,572,evoker,devastation,12,6,6
11849,Voraxe,draenor,568,evoker,devastation,12,6,6
11850,Эллъис,gordunni,544,evoker,devastation,34,7,27
11851,Molem,defias-brotherhood,543,evoker,devastation,11,6,5
11852,Lilvorki,silvermoon,543,evoker,devastation,17,6,11
11853,Hekatonshire,hyjal,539,evoker,devastation,11,6,5
11854,Rise,tarren-mill,522,evoker,devastation,12,7,5
11855,Somntersu,argent-dawn,511,evoker,devastation,14,7,7
11856,Streetspyro,ravencrest,480,evoker,devastation,6,5,1
11857,Chronougi,ravencrest,480,evoker,devastation,6,5,1
11858,Hösh,elune,480,evoker,devastation,6,5,1
11859,Dragondeezs,silvermoon,480,evoker,devastation,6,5,1
11860,Côlt,twisting-nether,480,evoker,devastation,6,5,1
11861,Zendervish,draenor,480,evoker,devastation,6,5,1
11862,Elvarg,ragnaros,480,evoker,devastation,6,5,1
11863,Tovaro,xavius,480,evoker,devastation,6,5,1
11864,Zinxo,ravencrest,480,evoker,devastation,12,5,7
11865,Shazag,ragnaros,480,evoker,devastation,12,5,7
11866,Ripgódx,bronzebeard,480,evoker,devastation,12,5,7
11867,Dracnass,silvermoon,480,evoker,devastation,12,5,7
11868,Icyevoker,ravencrest,480,evoker,devastation,12,5,7
11869,Wuschwuscha,thrall,480,evoker,devastation,12,5,7
11870,Skulblakas,blackmoore,480,evoker,devastation,12,5,7
11871,Pavelito,ysondre,480,evoker,devastation,12,5,7
11872,Pandagos,archimonde,480,evoker,devastation,12,5,7
11873,Arbîter,eredar,480,evoker,devastation,12,5,7
11874,Nerõ,thrall,480,evoker,devastation,12,5,7
11875,Cooperevoker,blackrock,480,evoker,devastation,12,5,7
11876,Сансетшторм,gordunni,480,evoker,devastation,12,5,7
11877,Spyro,bloodfeather,480,evoker,devastation,12,5,7
11878,Bal,arakarahm,480,evoker,devastation,12,5,7
11879,Syraxxes,sanguino,480,evoker,devastation,12,5,7
11880,Tilwahlzok,pozzo-delleternità,480,evoker,devastation,12,5,7
11881,Gaargaveko,blackmoore,480,evoker,devastation,12,5,7
11882,Niddhog,antonidas,480,evoker,devastation,12,5,7
11883,Predictrash,archimonde,480,evoker,devastation,12,5,7
11884,Rekinn,tarren-mill,480,evoker,devastation,12,5,7
11885,Jetfqds,archimonde,480,evoker,devastation,18,5,13
11886,Magicae,drakthul,479,evoker,devastation,12,5,7
11887,Кайрэс,gordunni,479,evoker,devastation,12,5,7
11888,Vermithors,ravencrest,479,evoker,devastation,12,5,7
11889,Драккалис,eversong,479,evoker,devastation,12,5,7
11890,Mirazare,khadgar,478,evoker,devastation,12,5,7
11891,Штеци,howling-fjord,384,evoker,devastation,6,4,2
11892,Iblvicanfly,stormscale,384,evoker,devastation,6,4,2
11893,Hungryhank,ragnaros,384,evoker,devastation,6,4,2
11894,Theralon,tarren-mill,384,evoker,devastation,6,4,2
11895,Notadvanced,draenor,384,evoker,devastation,6,4,2
11896,Dyrokan,blackhand,384,evoker,devastation,6,4,2
11897,Gulimvoker,aegwynn,384,evoker,devastation,6,4,2
11898,Wurm,shadowsong,384,evoker,devastation,6,4,2
11899,Blamdrake,blackhand,384,evoker,devastation,6,4,2
11900,Skiora,argent-dawn,384,evoker,devastation,6,4,2
11901,Kárás,silvermoon,384,evoker,devastation,6,4,2
11902,Aclysia,outland,384,evoker,devastation,6,4,2
11903,Dèéz,ravencrest,384,evoker,devastation,8,5,3
11904,Дракарус,soulflayer,384,evoker,devastation,12,4,8
11905,Croker,ravencrest,384,evoker,devastation,12,4,8
11906,Hijeon,ravencrest,384,evoker,devastation,12,4,8
11907,Pentraktar,pozzo-delleternità,384,evoker,devastation,12,4,8
11908,Nózdormuwu,argent-dawn,384,evoker,devastation,12,4,8
11909,Draceon,argent-dawn,384,evoker,devastation,12,4,8
11910,Ãbl,silvermoon,384,evoker,devastation,12,4,8
11911,Huangzhang,burning-legion,384,evoker,devastation,12,4,8
11912,Vrèsh,blackrock,384,evoker,devastation,12,4,8
11913,Gazunkle,draenor,384,evoker,devastation,12,4,8
11914,Tigurius,onyxia,384,evoker,devastation,12,4,8
11915,Лавеон,gordunni,384,evoker,devastation,12,4,8
11916,Fueu,draenor,384,evoker,devastation,12,4,8
11917,Spyróò,ravencrest,384,evoker,devastation,12,4,8
11918,Nynnaydoth,drakthul,384,evoker,devastation,12,4,8
11919,Rikji,blackmoore,384,evoker,devastation,12,4,8
11920,Bæxo,blackrock,384,evoker,devastation,18,4,14
11921,Jamesdouglas,eredar,383,evoker,devastation,6,4,2
11922,Bombrush,ragnaros,383,evoker,devastation,9,5,4
11923,Ominobari,silvermoon,383,evoker,devastation,18,4,14
11924,Calonddraig,turalyon,382,evoker,devastation,6,4,2
11925,Sheego,anetheron,382,evoker,devastation,6,4,2
11926,Deimong,khaz-modan,381,evoker,devastation,12,4,8
11927,Quicksmoke,argent-dawn,379,evoker,devastation,21,6,15
11928,Dracsamdi,tarren-mill,367,evoker,devastation,11,4,7
11929,Crispywingz,draenor,366,evoker,devastation,11,4,7
11930,Otøgí,antonidas,351,evoker,devastation,11,4,7
11931,Renalia,blackrock,351,evoker,devastation,14,5,9
11932,Tremola,twisting-nether,320,evoker,devastation,10,4,6
11933,Belkavoker,zirkel-des-cenarius,319,evoker,devastation,5,4,1
11934,Galanix,argent-dawn,288,evoker,devastation,6,3,3
11935,Drachenwut,aegwynn,288,evoker,devastation,6,3,3
11936,Flippmoker,argent-dawn,288,evoker,devastation,6,3,3
11937,Kitoed,aegwynn,288,evoker,devastation,6,3,3
11938,Chàrizàd,archimonde,288,evoker,devastation,6,3,3
11939,Ðragøn,argent-dawn,288,evoker,devastation,6,3,3
11940,Shåmsse,kazzak,288,evoker,devastation,6,3,3
11941,Bestofriendo,eredar,288,evoker,devastation,6,3,3
11942,Alusiedrake,ravencrest,288,evoker,devastation,6,3,3
11943,Whaazzdragon,tarren-mill,288,evoker,devastation,6,3,3
11944,Magalàs,pozzo-delleternità,288,evoker,devastation,6,3,3
11945,Dantex,ravencrest,288,evoker,devastation,6,3,3
11946,Feinerkerl,blackmoore,288,evoker,devastation,6,3,3
11947,Тектрис,howling-fjord,288,evoker,devastation,6,3,3
11948,Эндемический,soulflayer,288,evoker,devastation,6,3,3
11949,Hateroll,ravencrest,288,evoker,devastation,6,3,3
11950,Psheetae,kazzak,288,evoker,devastation,6,3,3
11951,Merrius,der-rat-von-dalaran,288,evoker,devastation,6,3,3
11952,Dalsath,silvermoon,288,evoker,devastation,6,3,3
11953,Норус,howling-fjord,288,evoker,devastation,6,3,3
11954,Darksmouke,forscherliga,288,evoker,devastation,6,3,3
11955,Louzard,draenor,288,evoker,devastation,6,3,3
11956,Гиперзверь,gordunni,288,evoker,devastation,6,3,3
11957,Nørgan,die-aldor,288,evoker,devastation,6,3,3
11958,Навидх,howling-fjord,288,evoker,devastation,6,3,3
11959,Fivebeers,silvermoon,288,evoker,devastation,6,3,3
11960,Dragenlul,tarren-mill,288,evoker,devastation,6,3,3
11961,Ernesti,draenor,288,evoker,devastation,6,3,3
11962,Lizzar,ravencrest,288,evoker,devastation,6,3,3
11963,Kaskala,dun-morogh,288,evoker,devastation,6,3,3
11964,Keltullis,archimonde,288,evoker,devastation,6,3,3
11965,Mollÿ,sanguino,288,evoker,devastation,6,3,3
11966,Azurog,blackmoore,288,evoker,devastation,6,3,3
11967,Jrmdragik,kaelthas,288,evoker,devastation,6,3,3
11968,Purplelizard,twisting-nether,288,evoker,devastation,6,3,3
11969,Rosiash,auchindoun,288,evoker,devastation,6,3,3
11970,Malowux,outland,288,evoker,devastation,6,3,3
11971,Feldrac,ravencrest,288,evoker,devastation,6,3,3
11972,Ughvoker,kazzak,288,evoker,devastation,6,3,3
11973,Lajra,ragnaros,288,evoker,devastation,6,3,3
11974,Drokki,burning-legion,288,evoker,devastation,6,3,3
11975,Adônis,malorne,288,evoker,devastation,6,3,3
11976,Lìshrá,baelgun,288,evoker,devastation,6,3,3
11977,Skùzito,ysondre,288,evoker,devastation,6,3,3
11978,Zephlas,sunstrider,288,evoker,devastation,6,3,3
11979,Twinkillerx,dun-morogh,288,evoker,devastation,12,3,9
11980,Tamargon,frostwhisper,288,evoker,devastation,12,3,9
11981,Raøug,blackmoore,288,evoker,devastation,12,3,9
11982,Valdrakken,anubarak,288,evoker,devastation,12,3,9
11983,Gailliade,archimonde,288,evoker,devastation,12,3,9
11984,Shindragøsa,ysondre,288,evoker,devastation,12,3,9
11985,Dundrion,outland,288,evoker,devastation,12,3,9
11986,Sáróman,ravencrest,288,evoker,devastation,13,3,10
11987,Nybxx,frostmane,288,evoker,devastation,18,3,15
11988,Sliimshady,dalaran,287,evoker,devastation,6,3,3
11989,Дракариса,eversong,287,evoker,devastation,6,3,3
11990,Belianf,silvermoon,287,evoker,devastation,6,3,3
11991,Drakonovic,blackrock,287,evoker,devastation,6,3,3
11992,Dahwi,blackmoore,287,evoker,devastation,6,3,3
11993,Drks,draenor,287,evoker,devastation,12,4,8
11994,Aegonis,archimonde,287,evoker,devastation,12,3,9
11995,Syccs,blackrock,255,evoker,devastation,8,4,4
11996,Argentrenard,twilights-hammer,239,evoker,devastation,5,3,2
11997,Kirien,blackhand,234,evoker,devastation,22,4,18
11998,Färsia,drakthul,223,evoker,devastation,8,3,5
11999,Snàx,aggra-português,192,evoker,devastation,6,2,4
12000,Bittewhyally,grim-batol,192,evoker,devastation,6,2,4
12001,Adamâs,archimonde,192,evoker,devastation,6,2,4
12002,Fullyndra,archimonde,192,evoker,devastation,6,2,4
12003,Ninhursag,hyjal,192,evoker,devastation,6,2,4
12004,Sindras,frostmane,192,evoker,devastation,6,2,4
12005,Oogabuga,outland,192,evoker,devastation,6,2,4
12006,Валказар,gordunni,192,evoker,devastation,6,2,4
12007,Jibobo,the-maelstrom,192,evoker,devastation,6,2,4
12008,Hahahahalolx,twisting-nether,192,evoker,devastation,6,2,4
12009,Gelamk,twisting-nether,192,evoker,devastation,6,2,4
12010,Draaxy,twisting-nether,192,evoker,devastation,6,2,4
12011,Draknr,alakir,192,evoker,devastation,6,2,4
12012,Exitelolx,blackrock,192,evoker,devastation,6,2,4
12013,Drakary,chogall,192,evoker,devastation,6,2,4
12014,Draagon,burning-legion,192,evoker,devastation,6,2,4
12015,Lelemion,arathor,192,evoker,devastation,6,2,4
12016,Ellphi,illidan,192,evoker,devastation,6,2,4
12017,Evøcado,blackmoore,192,evoker,devastation,6,2,4
12018,Chürbis,blackmoore,192,evoker,devastation,6,2,4
12019,Frogzey,kazzak,192,evoker,devastation,6,2,4
12020,Malydra,blackhand,192,evoker,devastation,6,2,4
12021,Shenronn,zuljin,192,evoker,devastation,6,2,4
12022,Twokgbananas,blackhand,192,evoker,devastation,6,2,4
12023,Кмандр,gordunni,192,evoker,devastation,6,2,4
12024,Авидогх,gordunni,192,evoker,devastation,6,2,4
12025,Drevoker,daggerspine,192,evoker,devastation,6,2,4
12026,Grogar,hellfire,192,evoker,devastation,6,2,4
12027,Niluslangbal,stormscale,192,evoker,devastation,6,2,4
12028,Norskairline,kazzak,192,evoker,devastation,6,2,4
12029,Emiltate,ravencrest,192,evoker,devastation,6,2,4
12030,Drgndeznuts,kazzak,192,evoker,devastation,6,2,4
12031,Reddeaddrago,silvermoon,192,evoker,devastation,6,2,4
12032,Vynestria,argent-dawn,192,evoker,devastation,6,2,4
12033,Azzaanan,kirin-tor,192,evoker,devastation,6,2,4
12034,Kandragor,antonidas,192,evoker,devastation,6,2,4
12035,Airplanepeek,draenor,192,evoker,devastation,6,2,4
12036,Майтимаус,goldrinn,192,evoker,devastation,6,2,4
12037,Lubyan,pozzo-delleternità,192,evoker,devastation,18,3,15
12038,Jpeo,blackhand,192,evoker,devastation,12,2,10
12039,Shellfire,twisting-nether,192,evoker,devastation,12,2,10
12040,Невердракон,howling-fjord,192,evoker,devastation,12,2,10
12041,Jacra,twisting-nether,192,evoker,devastation,12,2,10
12042,Дракомант,eversong,192,evoker,devastation,12,2,10
12043,Erenhan,archimonde,192,evoker,devastation,12,2,10
12044,Andragosa,confrérie-du-thorium,192,evoker,devastation,12,2,10
12045,Oldlizard,blackrock,192,evoker,devastation,12,2,10
12046,Czerwonooki,turalyon,192,evoker,devastation,12,2,10
12047,Скозложёп,ashenvale,192,evoker,devastation,12,2,10
12048,Aintnospyro,silvermoon,192,evoker,devastation,12,2,10
12049,Tatsuki,arthas,192,evoker,devastation,18,2,16
12050,Kraakraa,turalyon,191,evoker,devastation,6,2,4
12051,Shenrøn,defias-brotherhood,160,evoker,devastation,10,2,8
12052,Вжухкия,gordunni,159,evoker,devastation,5,2,3
12053,Gypsydrake,tarren-mill,159,evoker,devastation,8,3,5
12054,Kekeri,blackhand,112,evoker,devastation,7,2,5
12055,Tneen,stormscale,96,evoker,devastation,3,2,1
12056,Freaksy,blackmoore,96,evoker,devastation,3,2,1
12057,Archidrake,ravencrest,96,evoker,devastation,6,1,5
12058,Rawrdragon,twisting-nether,96,evoker,devastation,6,1,5
12059,Zørix,hyjal,96,evoker,devastation,6,1,5
12060,Dracarysfire,kazzak,96,evoker,devastation,6,1,5
12061,Devanthar,argent-dawn,96,evoker,devastation,6,1,5
12062,Asharys,argent-dawn,96,evoker,devastation,6,1,5
12063,Craycry,argent-dawn,96,evoker,devastation,6,1,5
12064,Monstrosity,proudmoore,96,evoker,devastation,6,1,5
12065,Vahamut,argent-dawn,96,evoker,devastation,6,1,5
12066,Suba,tarren-mill,96,evoker,devastation,6,1,5
12067,Drakô,festung-der-stürme,96,evoker,devastation,6,1,5
12068,Terrorwings,twisting-nether,96,evoker,devastation,6,1,5
12069,Holdya,archimonde,96,evoker,devastation,6,1,5
12070,Xahal,hyjal,96,evoker,devastation,6,1,5
12071,Piecemaker,malganis,96,evoker,devastation,6,1,5
12072,Erones,burning-blade,96,evoker,devastation,6,1,5
12073,Ronmanarmy,blackrock,96,evoker,devastation,6,1,5
12074,Retyss,twisting-nether,96,evoker,devastation,6,1,5
12075,Skyfire,stormscale,96,evoker,devastation,6,1,5
12076,Тренакса,soulflayer,96,evoker,devastation,6,1,5
12077,Мельхиор,booty-bay,96,evoker,devastation,6,1,5
12078,Zerario,blackhand,96,evoker,devastation,6,1,5
12079,Eosin,blackrock,96,evoker,devastation,6,1,5
12080,Effrt,ravencrest,96,evoker,devastation,12,1,11
12081,Manadrake,silvermoon,96,evoker,devastation,12,1,11
12082,Spioche,burning-legion,96,evoker,devastation,12,1,11
12083,Setur,outland,96,evoker,devastation,12,1,11
12084,Драгоблуд,soulflayer,79,evoker,devastation,5,1,4
12085,Drakoonz,ravencrest,64,evoker,devastation,4,1,3
12086,Xidalulz,sylvanas,63,evoker,devastation,2,2,0
12087,Bulydracguir,kazzak,42,evoker,devastation,7,2,5
12088,Âspên,archimonde,31,evoker,devastation,2,1,1
12089,Abragan,aegwynn,31,evoker,devastation,2,1,1
12090,Chronoalis,nemesis,31,evoker,devastation,2,1,1
12091,Thundermifln,nemesis,16,evoker,devastation,7,1,6
12092,Ceitronox,argent-dawn,2148,hunter,marksmanship,102,52,50
12093,Matasso,burning-legion,1988,hunter,marksmanship,227,115,112
12094,Olyleskotch,ravencrest,1983,hunter,marksmanship,60,31,29
12095,Nennimi,ravencrest,1978,hunter,marksmanship,87,44,43
12096,Yasuohasagi,archimonde,1967,hunter,marksmanship,60,30,30
12097,Stylez,emeriss,1945,hunter,marksmanship,66,35,31
12098,Pjållistani,ravencrest,1942,hunter,marksmanship,206,108,98
12099,Drxta,blackrock,1937,hunter,marksmanship,72,36,36
12100,Yezzu,sylvanas,1936,hunter,marksmanship,68,34,34
12101,Gorethaur,twisting-nether,1935,hunter,marksmanship,57,47,10
12102,Wruck,echsenkessel,1929,hunter,marksmanship,126,71,55
12103,Harrianlar,ravenholdt,1905,hunter,marksmanship,132,59,73
12104,Stavfel,kazzak,1903,hunter,marksmanship,101,50,51
12105,Alêx,outland,1902,hunter,marksmanship,126,61,65
12106,Huprah,ravencrest,1901,hunter,marksmanship,126,63,63
12107,Мартидэн,howling-fjord,1894,hunter,marksmanship,173,83,90
12108,Аккулэйд,blackscar,1859,hunter,marksmanship,72,35,37
12109,Skilachi,stormscale,1848,hunter,marksmanship,84,39,45
12110,Душнила,razuvious,1841,hunter,marksmanship,113,57,56
12111,Aimywinehaus,drakthul,1840,hunter,marksmanship,60,31,29
12112,Арамор,blackscar,1838,hunter,marksmanship,58,33,25
12113,Onlystuns,sylvanas,1831,hunter,marksmanship,89,46,43
12114,Trapsfordays,tarren-mill,1827,hunter,marksmanship,70,41,29
12115,Evacuatur,argent-dawn,1826,hunter,marksmanship,66,33,33
12116,Wildheárt,aegwynn,1824,hunter,marksmanship,66,35,31
12117,Ancalarion,tarren-mill,1824,hunter,marksmanship,54,26,28
12118,Hï,eitrigg,1819,hunter,marksmanship,72,35,37
12119,Cenaa,ragnaros,1816,hunter,marksmanship,25,19,6
12120,Rashoumon,zuljin,1816,hunter,marksmanship,52,35,17
12121,Techpoint,silvermoon,1816,hunter,marksmanship,42,27,15
12122,Crôwley,twisting-nether,1816,hunter,marksmanship,54,30,24
12123,Suchskill,stormreaver,1813,hunter,marksmanship,77,37,40
12124,Xoarqt,aegwynn,1812,hunter,marksmanship,72,32,40
12125,Iceyx,stormscale,1810,hunter,marksmanship,48,21,27
12126,Лесбиянюсь,gordunni,1809,hunter,marksmanship,30,19,11
12127,Lenooby,blades-edge,1805,hunter,marksmanship,114,59,55
12128,Áñmy,ravencrest,1804,hunter,marksmanship,53,28,25
12129,Aimshotx,stormscale,1801,hunter,marksmanship,48,28,20
12130,Mogwai,stormscale,1801,hunter,marksmanship,59,29,30
12131,Spirys,drakthul,1797,hunter,marksmanship,54,25,29
12132,Passalaqua,aegwynn,1795,hunter,marksmanship,78,47,31
12133,Warbringerx,stormscale,1792,hunter,marksmanship,40,20,20
12134,Chindala,zuljin,1780,hunter,marksmanship,49,24,25
12135,Åíøñs,kazzak,1778,hunter,marksmanship,35,19,16
12136,Samuru,auchindoun,1777,hunter,marksmanship,65,28,37
12137,Myice,twisting-nether,1771,hunter,marksmanship,66,36,30
12138,Misstrap,drakthul,1769,hunter,marksmanship,53,35,18
12139,Spoonfingers,ravencrest,1744,hunter,marksmanship,41,21,20
12140,Dis,twilights-hammer,1739,hunter,marksmanship,53,26,27
12141,Murtagh,khaz-modan,1733,hunter,marksmanship,72,37,35
12142,Amistat,kazzak,1732,hunter,marksmanship,115,57,58
12143,Nutshotx,stormscale,1732,hunter,marksmanship,90,39,51
12144,Huntrag,tarren-mill,1729,hunter,marksmanship,247,123,124
12145,Лотариель,howling-fjord,1728,hunter,marksmanship,66,34,32
12146,Cadvan,nagrand,1727,hunter,marksmanship,45,23,22
12147,Trashcarlito,eredar,1725,hunter,marksmanship,36,23,13
12148,Deuterium,stormscale,1723,hunter,marksmanship,42,29,13
12149,Lègolas,sylvanas,1721,hunter,marksmanship,66,28,38
12150,Setyouintrap,ravencrest,1717,hunter,marksmanship,54,31,23
12151,Hallé,frostmane,1714,hunter,marksmanship,78,43,35
12152,Bestregards,ravencrest,1714,hunter,marksmanship,124,56,68
12153,Mógwaí,stormscale,1710,hunter,marksmanship,72,36,36
12154,Strikke,archimonde,1709,hunter,marksmanship,42,18,24
12155,Dragnial,kazzak,1703,hunter,marksmanship,53,26,27
12156,Xanter,blackrock,1698,hunter,marksmanship,68,32,36
12157,Ремонтлицаа,gordunni,1695,hunter,marksmanship,115,66,49
12158,Dexter,ravencrest,1689,hunter,marksmanship,214,104,110
12159,Адвентурер,howling-fjord,1685,hunter,marksmanship,108,60,48
12160,Huntsmart,kazzak,1682,hunter,marksmanship,78,34,44
12161,Lowcaskor,turalyon,1678,hunter,marksmanship,47,26,21
12162,Sindorian,aggra-português,1675,hunter,marksmanship,60,31,29
12163,Nêzz,tarren-mill,1675,hunter,marksmanship,68,31,37
12164,Velrox,blackmoore,1674,hunter,marksmanship,60,30,30
12165,Jabela,eredar,1668,hunter,marksmanship,78,35,43
12166,Johnreapèr,sylvanas,1663,hunter,marksmanship,95,42,53
12167,Maticshorter,blackmoore,1660,hunter,marksmanship,29,18,11
12168,Pandanero,ravencrest,1660,hunter,marksmanship,36,20,16
12169,Podroto,tyrande,1660,hunter,marksmanship,77,30,47
12170,Eldrekou,kazzak,1657,hunter,marksmanship,48,22,26
12171,Speedhack,argent-dawn,1650,hunter,marksmanship,63,35,28
12172,Xqzmytrapz,blackrock,1650,hunter,marksmanship,36,18,18
12173,Klarix,outland,1649,hunter,marksmanship,62,29,33
12174,Pewpewstuff,draenor,1648,hunter,marksmanship,36,20,16
12175,Buffrøgues,ravencrest,1648,hunter,marksmanship,204,100,104
12176,Xzmiq,outland,1646,hunter,marksmanship,32,19,13
12177,Hotshòt,silvermoon,1642,hunter,marksmanship,144,78,66
12178,Rizlay,the-maelstrom,1640,hunter,marksmanship,108,50,58
12179,Triggaz,stormscale,1637,hunter,marksmanship,83,39,44
12180,Zeanoff,ravencrest,1636,hunter,marksmanship,54,35,19
12181,Миссклик,soulflayer,1632,hunter,marksmanship,66,42,24
12182,Srsbsnshunta,kazzak,1632,hunter,marksmanship,43,24,19
12183,Naid,lordaeron,1632,hunter,marksmanship,36,20,16
12184,Самокаратель,gordunni,1630,hunter,marksmanship,42,27,15
12185,Khregan,aerie-peak,1630,hunter,marksmanship,42,18,24
12186,Дарктеххно,howling-fjord,1629,hunter,marksmanship,36,18,18
12187,Амореселф,gordunni,1629,hunter,marksmanship,59,25,34
12188,Metak,auchindoun,1627,hunter,marksmanship,32,22,10
12189,Куфачка,soulflayer,1627,hunter,marksmanship,36,17,19
12190,Evengance,dragonblight,1624,hunter,marksmanship,66,43,23
12191,Nidaliyae,archimonde,1624,hunter,marksmanship,42,20,22
12192,Murkek,drakthul,1623,hunter,marksmanship,48,28,20
12193,Natchell,ysondre,1623,hunter,marksmanship,48,22,26
12194,Mfbloom,blackmoore,1621,hunter,marksmanship,48,23,25
12195,Травок,gordunni,1620,hunter,marksmanship,64,34,30
12196,Nätzz,dun-modr,1618,hunter,marksmanship,67,29,38
12197,Ixxmhunt,blackrock,1616,hunter,marksmanship,54,24,30
12198,Бипбип,galakrond,1615,hunter,marksmanship,35,20,15
12199,Ледо,deathguard,1614,hunter,marksmanship,66,30,36
12200,Jetay,silvermoon,1613,hunter,marksmanship,60,33,27
12201,Играсломана,howling-fjord,1613,hunter,marksmanship,39,21,18
12202,Arung,ravencrest,1610,hunter,marksmanship,48,22,26
12203,Loretta,ragnaros,1609,hunter,marksmanship,47,27,20
12204,Darts,outland,1608,hunter,marksmanship,82,41,41
12205,Sizemattersx,kazzak,1608,hunter,marksmanship,124,59,65
12206,Crétin,archimonde,1605,hunter,marksmanship,38,20,18
12207,Legosoldaten,stormscale,1604,hunter,marksmanship,53,21,32
12208,Streetxpres,nethersturm,1602,hunter,marksmanship,35,19,16
12209,Çryneth,ravencrest,1602,hunter,marksmanship,92,49,43
12210,Rêmøórsêlês,outland,1594,hunter,marksmanship,39,19,20
12211,Gugenot,tarren-mill,1589,hunter,marksmanship,56,33,23
12212,Vangeroth,kazzak,1589,hunter,marksmanship,324,169,155
12213,Gunlaugr,defias-brotherhood,1588,hunter,marksmanship,33,18,15
12214,Desudi,tarren-mill,1588,hunter,marksmanship,59,30,29
12215,Крой,howling-fjord,1588,hunter,marksmanship,83,40,43
12216,Bearmane,tarren-mill,1587,hunter,marksmanship,112,54,58
12217,Recrent,kazzak,1582,hunter,marksmanship,96,53,43
12218,Шотнес,gordunni,1579,hunter,marksmanship,72,33,39
12219,Inayah,outland,1571,hunter,marksmanship,121,65,56
12220,Scheixanter,drakthul,1570,hunter,marksmanship,146,72,74
12221,Kayvaal,kaelthas,1568,hunter,marksmanship,48,26,22
12222,Mönster,ravenholdt,1565,hunter,marksmanship,74,43,31
12223,Lebalaffré,arathi,1562,hunter,marksmanship,77,41,36
12224,Лисатия,gordunni,1562,hunter,marksmanship,48,22,26
12225,Мизэрица,soulflayer,1556,hunter,marksmanship,66,32,34
12226,Ekz,twisting-nether,1554,hunter,marksmanship,46,24,22
12227,Mantinell,hellfire,1553,hunter,marksmanship,36,20,16
12228,Trytoconnect,ravencrest,1546,hunter,marksmanship,60,33,27
12229,Miladinorc,azjolnerub,1540,hunter,marksmanship,54,32,22
12230,Chaussons,kazzak,1539,hunter,marksmanship,114,59,55
12231,Lookmyezzy,ravencrest,1535,hunter,marksmanship,32,17,15
12232,Jup,elune,1535,hunter,marksmanship,55,21,34
12233,Brk,dun-modr,1534,hunter,marksmanship,30,16,14
12234,Elja,laughing-skull,1531,hunter,marksmanship,73,40,33
12235,Kyudo,ravencrest,1531,hunter,marksmanship,124,66,58
12236,Mînérvá,blackhand,1530,hunter,marksmanship,60,38,22
12237,Jamzyhunter,emerald-dream,1530,hunter,marksmanship,42,17,25
12238,Хжв,ashenvale,1528,hunter,marksmanship,112,59,53
12239,Daela,elune,1527,hunter,marksmanship,83,38,45
12240,Hurion,sanguino,1526,hunter,marksmanship,36,17,19
12241,Манаррия,soulflayer,1522,hunter,marksmanship,78,33,45
12242,Kariss,khaz-modan,1521,hunter,marksmanship,143,71,72
12243,Hardscoped,tarren-mill,1521,hunter,marksmanship,64,29,35
12244,Килофвратх,gordunni,1520,hunter,marksmanship,170,81,89
12245,Eenel,twisting-nether,1513,hunter,marksmanship,30,16,14
12246,Eferos,quelthalas,1513,hunter,marksmanship,60,26,34
12247,Minisay,magtheridon,1509,hunter,marksmanship,286,141,145
12248,Crowsza,archimonde,1508,hunter,marksmanship,35,19,16
12249,Cpflex,arthas,1508,hunter,marksmanship,76,32,44
12250,Focushunter,outland,1506,hunter,marksmanship,64,30,34
12251,Хальвеген,gordunni,1500,hunter,marksmanship,258,129,129
12252,Rattentäter,alexstrasza,1498,hunter,marksmanship,54,28,26
12253,Barnabaz,skullcrusher,1497,hunter,marksmanship,42,22,20
12254,Ронингуд,gordunni,1496,hunter,marksmanship,60,32,28
12255,Deatharow,ravencrest,1496,hunter,marksmanship,55,28,27
12256,Xrey,ragnaros,1496,hunter,marksmanship,75,37,38
12257,Длинноемоджо,soulflayer,1493,hunter,marksmanship,371,182,189
12258,Tiidus,burning-legion,1492,hunter,marksmanship,24,16,8
12259,Ravensoulz,stormscale,1492,hunter,marksmanship,30,18,12
12260,Jimbow,blackrock,1486,hunter,marksmanship,34,19,15
12261,Reyst,moonglade,1483,hunter,marksmanship,24,16,8
12262,Vruh,antonidas,1483,hunter,marksmanship,60,31,29
12263,Jeeves,outland,1481,hunter,marksmanship,36,17,19
12264,Zirilan,nemesis,1480,hunter,marksmanship,112,57,55
12265,Meinkoenig,frostwolf,1479,hunter,marksmanship,54,34,20
12266,Swïtchz,hyjal,1479,hunter,marksmanship,117,59,58
12267,Шимэйла,gordunni,1474,hunter,marksmanship,97,51,46
12268,Souljâh,ravencrest,1473,hunter,marksmanship,59,30,29
12269,Афигеннски,ashenvale,1473,hunter,marksmanship,66,31,35
12270,Emnia,argent-dawn,1470,hunter,marksmanship,78,37,41
12271,Yarnvid,twisting-nether,1467,hunter,marksmanship,153,81,72
12272,Mervyl,burning-legion,1467,hunter,marksmanship,42,21,21
12273,Epheso,daggerspine,1467,hunter,marksmanship,36,16,20
12274,Дисконнэктор,soulflayer,1467,hunter,marksmanship,72,27,45
12275,Rèyz,blackhand,1466,hunter,marksmanship,111,58,53
12276,Boomkillshot,zuljin,1463,hunter,marksmanship,173,95,78
12277,Короткиствол,gordunni,1463,hunter,marksmanship,48,21,27
12278,Surtfire,alonsus,1462,hunter,marksmanship,108,54,54
12279,Smekminbåge,tarren-mill,1462,hunter,marksmanship,36,16,20
12280,Soupsoupsòup,blackmoore,1458,hunter,marksmanship,36,19,17
12281,Вееном,gordunni,1458,hunter,marksmanship,111,51,60
12282,Tntabsotrap,silvermoon,1455,hunter,marksmanship,82,44,38
12283,Bøøgy,silvermoon,1455,hunter,marksmanship,176,93,83
12284,Rex,chamber-of-aspects,1454,hunter,marksmanship,39,23,16
12285,Summa,silvermoon,1452,hunter,marksmanship,72,34,38
12286,Скартэкс,howling-fjord,1451,hunter,marksmanship,44,30,14
12287,Dafhel,hyjal,1451,hunter,marksmanship,54,24,30
12288,Sinplify,emeriss,1451,hunter,marksmanship,42,17,25
12289,Bollo,malganis,1449,hunter,marksmanship,61,29,32
12290,Mânhunt,blackhand,1447,hunter,marksmanship,59,33,26
12291,Будкусломаю,grom,1447,hunter,marksmanship,77,35,42
12292,Bapt,blackrock,1447,hunter,marksmanship,42,17,25
12293,Hunsed,sanguino,1445,hunter,marksmanship,42,26,16
12294,Balamut,aegwynn,1445,hunter,marksmanship,83,45,38
12295,Pickaboo,defias-brotherhood,1445,hunter,marksmanship,215,106,109
12296,Carpante,nemesis,1442,hunter,marksmanship,72,34,38
12297,Asthorio,stormscale,1442,hunter,marksmanship,89,39,50
12298,Jurá,perenolde,1441,hunter,marksmanship,83,37,46
12299,Nanns,silvermoon,1439,hunter,marksmanship,59,29,30
12300,Killitoss,blackmoore,1438,hunter,marksmanship,33,16,17
12301,Джоуе,ashenvale,1437,hunter,marksmanship,30,15,15
12302,Luuszapfae,aegwynn,1436,hunter,marksmanship,29,16,13
12303,Keskolica,outland,1436,hunter,marksmanship,60,29,31
12304,Àfpro,hyjal,1436,hunter,marksmanship,70,32,38
12305,Babclaar,culte-de-la-rive-noire,1435,hunter,marksmanship,36,22,14
12306,Nagu,antonidas,1435,hunter,marksmanship,30,15,15
12307,Skillzone,silvermoon,1432,hunter,marksmanship,36,15,21
12308,Jeston,amanthul,1430,hunter,marksmanship,49,23,26
12309,Valkhen,boulderfist,1428,hunter,marksmanship,42,24,18
12310,Роктджана,deathguard,1426,hunter,marksmanship,76,38,38
12311,Mizumo,burning-legion,1425,hunter,marksmanship,133,74,59
12312,Longblow,outland,1424,hunter,marksmanship,48,20,28
12313,Begøne,draenor,1423,hunter,marksmanship,42,28,14
12314,Ønske,azjolnerub,1423,hunter,marksmanship,48,25,23
12315,Ashimaru,sylvanas,1423,hunter,marksmanship,63,31,32
12316,Melriya,ravencrest,1421,hunter,marksmanship,24,15,9
12317,Shootingbob,blackrock,1421,hunter,marksmanship,42,23,19
12318,Shaib,kazzak,1420,hunter,marksmanship,24,15,9
12319,Rikishot,ravencrest,1420,hunter,marksmanship,52,25,27
12320,Everya,ravencrest,1418,hunter,marksmanship,24,15,9
12321,Kravên,anubarak,1417,hunter,marksmanship,63,32,31
12322,Kalima,malfurion,1416,hunter,marksmanship,72,28,44
12323,Doubletap,ysondre,1415,hunter,marksmanship,18,15,3
12324,Firescorpion,onyxia,1414,hunter,marksmanship,30,19,11
12325,Littlerat,kult-der-verdammten,1414,hunter,marksmanship,30,15,15
12326,Aimnfire,anachronos,1411,hunter,marksmanship,73,39,34
12327,Аскентр,gordunni,1411,hunter,marksmanship,67,31,36
12328,Elonyr,sanguino,1411,hunter,marksmanship,196,90,106
12329,Piit,elune,1403,hunter,marksmanship,67,28,39
12330,Abraxan,twisting-nether,1402,hunter,marksmanship,46,31,15
12331,Scatshot,grim-batol,1401,hunter,marksmanship,24,16,8
12332,Еввнух,gordunni,1401,hunter,marksmanship,72,31,41
12333,Kértor,die-aldor,1401,hunter,marksmanship,46,19,27
12334,Hiðe,archimonde,1399,hunter,marksmanship,56,28,28
12335,Laskoo,tarren-mill,1398,hunter,marksmanship,84,45,39
12336,Slmao,tarren-mill,1398,hunter,marksmanship,78,38,40
12337,Darm,sunstrider,1398,hunter,marksmanship,36,15,21
12338,Plzdontrun,sylvanas,1389,hunter,marksmanship,47,24,23
12339,Duckling,argent-dawn,1387,hunter,marksmanship,54,25,29
12340,Sharpeyezz,ravencrest,1387,hunter,marksmanship,71,28,43
12341,Gwalëndil,hyjal,1384,hunter,marksmanship,66,33,33
12342,Mindgap,pozzo-delleternità,1383,hunter,marksmanship,98,46,52
12343,Ensomnia,silvermoon,1382,hunter,marksmanship,24,19,5
12344,Bluelol,ravencrest,1382,hunter,marksmanship,46,16,30
12345,Krypzit,garona,1378,hunter,marksmanship,42,15,27
12346,Lincolne,ravencrest,1375,hunter,marksmanship,41,17,24
12347,Wowkulaka,kazzak,1371,hunter,marksmanship,48,23,25
12348,Lrr,grim-batol,1370,hunter,marksmanship,18,15,3
12349,Zulthos,kazzak,1370,hunter,marksmanship,25,16,9
12350,Samhunt,blackrock,1370,hunter,marksmanship,35,15,20
12351,Doncar,stormscale,1367,hunter,marksmanship,99,44,55
12352,Lobos,ravencrest,1367,hunter,marksmanship,60,25,35
12353,Mmaaee,ravencrest,1365,hunter,marksmanship,58,33,25
12354,Ofortuna,silvermoon,1365,hunter,marksmanship,42,23,19
12355,Absolutnoob,blackrock,1362,hunter,marksmanship,38,21,17
12356,Crar,frostwolf,1360,hunter,marksmanship,88,47,41
12357,Chrishyh,blackrock,1357,hunter,marksmanship,42,20,22
12358,Elyar,eredar,1355,hunter,marksmanship,40,23,17
12359,Llaz,silvermoon,1355,hunter,marksmanship,28,15,13
12360,Szybky,defias-brotherhood,1354,hunter,marksmanship,60,25,35
12361,Curtiss,sanguino,1353,hunter,marksmanship,46,28,18
12362,Wmaximoff,tarren-mill,1351,hunter,marksmanship,80,33,47
12363,Adariana,archimonde,1349,hunter,marksmanship,60,27,33
12364,Stingarrow,stormscale,1345,hunter,marksmanship,60,32,28
12365,Vavabxl,ysondre,1345,hunter,marksmanship,114,52,62
12366,Meskette,ravencrest,1344,hunter,marksmanship,36,18,18
12367,Gromaya,elune,1342,hunter,marksmanship,47,23,24
12368,Xalaar,frostwolf,1339,hunter,marksmanship,62,33,29
12369,Antiork,doomhammer,1339,hunter,marksmanship,66,31,35
12370,Røxxilia,blackmoore,1339,hunter,marksmanship,60,26,34
12371,Enÿo,ysondre,1339,hunter,marksmanship,48,16,32
12372,Snipèr,blackmoore,1336,hunter,marksmanship,26,16,10
12373,Prodanhunts,frostmane,1336,hunter,marksmanship,66,32,34
12374,Jamesie,ravencrest,1335,hunter,marksmanship,24,14,10
12375,Nirn,ravencrest,1335,hunter,marksmanship,30,14,16
12376,Encore,sylvanas,1334,hunter,marksmanship,48,23,25
12377,Rzeezznik,burning-legion,1333,hunter,marksmanship,24,14,10
12378,Moschtix,forscherliga,1333,hunter,marksmanship,48,20,28
12379,Oatmeal,dun-morogh,1331,hunter,marksmanship,113,67,46
12380,Эльк,gordunni,1331,hunter,marksmanship,57,29,28
12381,Cryneth,twisting-nether,1329,hunter,marksmanship,24,14,10
12382,Ëluna,burning-legion,1329,hunter,marksmanship,49,27,22
12383,Noxxen,burning-legion,1328,hunter,marksmanship,31,18,13
12384,Klinksz,ysondre,1328,hunter,marksmanship,31,16,15
12385,Bæst,elune,1327,hunter,marksmanship,31,16,15
12386,Deadfire,hyjal,1325,hunter,marksmanship,42,20,22
12387,Diapositiv,draenor,1325,hunter,marksmanship,30,14,16
12388,Maroxy,ragnaros,1325,hunter,marksmanship,35,14,21
12389,Gilgharsh,rajaxx,1324,hunter,marksmanship,48,21,27
12390,Оленнька,howling-fjord,1322,hunter,marksmanship,72,38,34
12391,Selaesa,chamber-of-aspects,1321,hunter,marksmanship,45,22,23
12392,Amphi,stormscale,1320,hunter,marksmanship,66,36,30
12393,Glad,argent-dawn,1320,hunter,marksmanship,77,32,45
12394,Tupalax,outland,1320,hunter,marksmanship,64,26,38
12395,Donneraàn,blackrock,1319,hunter,marksmanship,60,33,27
12396,Atiyêsh,arthas,1318,hunter,marksmanship,30,15,15
12397,Kokowawaa,kazzak,1317,hunter,marksmanship,66,28,38
12398,Arrown,outland,1316,hunter,marksmanship,35,17,18
12399,Silvyn,pozzo-delleternità,1315,hunter,marksmanship,42,22,20
12400,Setis,uldaman,1315,hunter,marksmanship,42,14,28
12401,Smitheye,argent-dawn,1314,hunter,marksmanship,141,69,72
12402,Zushji,ysondre,1314,hunter,marksmanship,152,69,83
12403,Narawinger,silvermoon,1310,hunter,marksmanship,42,24,18
12404,Arrowdoxx,silvermoon,1310,hunter,marksmanship,117,51,66
12405,Xaotsu,ravencrest,1308,hunter,marksmanship,45,21,24
12406,Lennylynx,garrosh,1308,hunter,marksmanship,30,14,16
12407,Ксидре,eversong,1302,hunter,marksmanship,54,28,26
12408,Silvyina,todeswache,1302,hunter,marksmanship,86,43,43
12409,Огнеборик,howling-fjord,1302,hunter,marksmanship,36,14,22
12410,Ixlxlxlxl,kazzak,1301,hunter,marksmanship,30,21,9
12411,Høward,aegwynn,1300,hunter,marksmanship,36,20,16
12412,Autoturret,eredar,1297,hunter,marksmanship,94,41,53
12413,Deathshots,aggra-português,1297,hunter,marksmanship,66,26,40
12414,Thysalee,hyjal,1296,hunter,marksmanship,38,15,23
12415,Casey,zuluhed,1295,hunter,marksmanship,36,16,20
12416,Pappous,kul-tiras,1294,hunter,marksmanship,65,32,33
12417,Bobleearrow,darkspear,1294,hunter,marksmanship,53,25,28
12418,Jeddaj,stormscale,1289,hunter,marksmanship,36,14,22
12419,Yoúmad,draenor,1288,hunter,marksmanship,28,14,14
12420,Heísenberg,ragnaros,1287,hunter,marksmanship,31,15,16
12421,Pekkoe,khaz-modan,1286,hunter,marksmanship,60,33,27
12422,Elywiél,frostwolf,1286,hunter,marksmanship,35,14,21
12423,Rupeebtw,stormscale,1285,hunter,marksmanship,96,43,53
12424,Rabiate,blackrock,1282,hunter,marksmanship,46,22,24
12425,Fauda,hellscream,1277,hunter,marksmanship,30,15,15
12426,Doomhorg,quelthalas,1276,hunter,marksmanship,60,30,30
12427,Waltuhwhite,teldrassil,1275,hunter,marksmanship,20,14,6
12428,Féliché,elune,1275,hunter,marksmanship,84,36,48
12429,Iòvól,azuremyst,1274,hunter,marksmanship,82,41,41
12430,Дайпострелят,gordunni,1273,hunter,marksmanship,36,15,21
12431,Rmnsbm,blackmoore,1271,hunter,marksmanship,30,14,16
12432,Argahnim,azjolnerub,1271,hunter,marksmanship,60,27,33
12433,Tokkie,burning-blade,1268,hunter,marksmanship,24,14,10
12434,Nightshäde,aggra-português,1264,hunter,marksmanship,40,16,24
12435,Øßlíck,ysondre,1262,hunter,marksmanship,28,14,14
12436,Zelira,boulderfist,1262,hunter,marksmanship,76,33,43
12437,Yanger,burning-legion,1259,hunter,marksmanship,42,18,24
12438,Шамагута,gordunni,1258,hunter,marksmanship,30,14,16
12439,Sàclak,ysondre,1258,hunter,marksmanship,36,16,20
12440,Хантвкроксах,gordunni,1257,hunter,marksmanship,22,14,8
12441,Феорика,grom,1257,hunter,marksmanship,66,33,33
12442,Имбакласс,howling-fjord,1257,hunter,marksmanship,80,37,43
12443,Cutehuntér,ragnaros,1256,hunter,marksmanship,74,31,43
12444,Booms,eonar,1254,hunter,marksmanship,65,31,34
12445,Serihu,cthun,1251,hunter,marksmanship,48,19,29
12446,Mspt,archimonde,1248,hunter,marksmanship,30,13,17
12447,Zendar,blackmoore,1246,hunter,marksmanship,69,33,36
12448,Darilli,wildhammer,1245,hunter,marksmanship,36,14,22
12449,Lísy,hyjal,1244,hunter,marksmanship,24,13,11
12450,Phillon,blackrock,1243,hunter,marksmanship,24,18,6
12451,Iilac,argent-dawn,1242,hunter,marksmanship,184,104,80
12452,Nharul,blackmoore,1242,hunter,marksmanship,30,13,17
12453,Huntatard,silvermoon,1241,hunter,marksmanship,28,16,12
12454,Рбг,blackscar,1241,hunter,marksmanship,30,13,17
12455,Poatan,outland,1240,hunter,marksmanship,164,86,78
12456,Арийская,gordunni,1239,hunter,marksmanship,65,29,36
12457,Imfiné,outland,1239,hunter,marksmanship,30,13,17
12458,Eskubar,burning-legion,1238,hunter,marksmanship,72,36,36
12459,Хантнерюга,gordunni,1236,hunter,marksmanship,24,13,11
12460,Jðsi,dalaran,1236,hunter,marksmanship,60,26,34
12461,Shedzargo,twisting-nether,1234,hunter,marksmanship,24,13,11
12462,Blowplac,moonglade,1234,hunter,marksmanship,64,29,35
12463,Fränko,ravencrest,1234,hunter,marksmanship,36,13,23
12464,Гусецап,gordunni,1233,hunter,marksmanship,30,13,17
12465,Corrupth,outland,1233,hunter,marksmanship,33,14,19
12466,Mainblu,nemesis,1231,hunter,marksmanship,30,14,16
12467,Xesih,twisting-nether,1228,hunter,marksmanship,59,26,33
12468,Sivoh,silvermoon,1227,hunter,marksmanship,50,23,27
12469,Ililivillumi,tarren-mill,1227,hunter,marksmanship,36,16,20
12470,Breier,argent-dawn,1225,hunter,marksmanship,95,49,46
12471,Andtamed,thunderhorn,1225,hunter,marksmanship,54,25,29
12472,Opsi,area-52,1223,hunter,marksmanship,78,35,43
12473,Эннабонни,gordunni,1222,hunter,marksmanship,30,15,15
12474,Travels,tarren-mill,1222,hunter,marksmanship,30,13,17
12475,Одисенс,eversong,1220,hunter,marksmanship,109,55,54
12476,Snaped,malganis,1219,hunter,marksmanship,37,14,23
12477,Zajaczek,burning-legion,1218,hunter,marksmanship,30,13,17
12478,Loca,twilights-hammer,1217,hunter,marksmanship,78,38,40
12479,Курунирка,gordunni,1213,hunter,marksmanship,36,13,23
12480,Elyxa,ysondre,1211,hunter,marksmanship,54,30,24
12481,Coft,sargeras,1209,hunter,marksmanship,24,13,11
12482,Sallina,blutkessel,1209,hunter,marksmanship,24,13,11
12483,Buzzle,sylvanas,1209,hunter,marksmanship,30,16,14
12484,Snipekill,bronze-dragonflight,1208,hunter,marksmanship,24,13,11
12485,Эвилтар,soulflayer,1206,hunter,marksmanship,26,14,12
12486,Vïcødïnë,sinstralis,1205,hunter,marksmanship,48,20,28
12487,Хакаар,grom,1204,hunter,marksmanship,89,46,43
12488,Hawkz,quelthalas,1204,hunter,marksmanship,67,32,35
12489,Redneckjoe,draenor,1204,hunter,marksmanship,58,26,32
12490,Deneja,kilrogg,1201,hunter,marksmanship,30,13,17
12491,Skohal,draenor,1200,hunter,marksmanship,78,36,42
12492,Sinsé,conseil-des-ombres,1198,hunter,marksmanship,28,17,11
12493,Watty,chogall,1195,hunter,marksmanship,88,45,43
12494,Серргио,soulflayer,1191,hunter,marksmanship,18,13,5
12495,Barrex,guldan,1190,hunter,marksmanship,41,16,25
12496,Fetts,silvermoon,1189,hunter,marksmanship,56,29,27
12497,Bigfoot,argent-dawn,1189,hunter,marksmanship,129,56,73
12498,Corrwus,argent-dawn,1181,hunter,marksmanship,42,18,24
12499,Blackas,dun-modr,1179,hunter,marksmanship,78,36,42
12500,Swáy,twisting-nether,1175,hunter,marksmanship,274,133,141
12501,Каизик,soulflayer,1173,hunter,marksmanship,35,14,21
12502,Tránsphobic,kilrogg,1171,hunter,marksmanship,60,29,31
12503,Yunalèsca,eredar,1171,hunter,marksmanship,34,13,21
12504,Анхантэй,lich-king,1170,hunter,marksmanship,166,87,79
12505,Naven,minahonda,1170,hunter,marksmanship,36,15,21
12506,Lillynahh,argent-dawn,1169,hunter,marksmanship,127,59,68
12507,Viséeauto,confrérie-du-thorium,1168,hunter,marksmanship,24,13,11
12508,Celtya,archimonde,1166,hunter,marksmanship,135,69,66
12509,Linneâ,blackmoore,1166,hunter,marksmanship,32,15,17
12510,Áragorn,frostmane,1165,hunter,marksmanship,36,20,16
12511,Lightarròw,nordrassil,1162,hunter,marksmanship,36,13,23
12512,Overhït,hyjal,1157,hunter,marksmanship,137,66,71
12513,Sâetha,dun-modr,1157,hunter,marksmanship,36,14,22
12514,Azaella,tarren-mill,1156,hunter,marksmanship,36,16,20
12515,Металшот,blackscar,1155,hunter,marksmanship,23,13,10
12516,Huntaloko,outland,1155,hunter,marksmanship,29,15,14
12517,Taveon,turalyon,1154,hunter,marksmanship,36,13,23
12518,Jodd,ragnaros,1152,hunter,marksmanship,24,12,12
12519,Bøost,stormscale,1151,hunter,marksmanship,18,12,6
12520,Krothga,blackrock,1151,hunter,marksmanship,48,23,25
12521,Farmerjoee,alakir,1147,hunter,marksmanship,24,13,11
12522,Migro,sylvanas,1145,hunter,marksmanship,24,12,12
12523,Marcher,aggra-português,1145,hunter,marksmanship,30,12,18
12524,Bgkrasavec,stormscale,1142,hunter,marksmanship,75,36,39
12525,Narøs,blackhand,1142,hunter,marksmanship,82,33,49
12526,Белыйатомщик,howling-fjord,1142,hunter,marksmanship,30,12,18
12527,Pínnen,draenor,1140,hunter,marksmanship,24,12,12
12528,Nezekielle,drekthar,1140,hunter,marksmanship,30,12,18
12529,Survivr,frostmane,1139,hunter,marksmanship,24,14,10
12530,Koratoz,blackmoore,1135,hunter,marksmanship,18,12,6
12531,Хапмьюзик,howling-fjord,1133,hunter,marksmanship,96,39,57
12532,Kakadoo,twisting-nether,1131,hunter,marksmanship,36,16,20
12533,Aszasi,azjolnerub,1130,hunter,marksmanship,31,13,18
12534,Touscahunter,kazzak,1129,hunter,marksmanship,270,134,136
12535,Oneeyed,kazzak,1127,hunter,marksmanship,24,12,12
12536,Jägarbröje,kazzak,1126,hunter,marksmanship,30,18,12
12537,Anpaytoo,antonidas,1126,hunter,marksmanship,36,14,22
12538,Sekeh,ragnaros,1126,hunter,marksmanship,42,15,27
12539,Virdirthera,silvermoon,1124,hunter,marksmanship,24,12,12
12540,Hoody,culte-de-la-rive-noire,1123,hunter,marksmanship,30,18,12
12541,Docchr,doomhammer,1123,hunter,marksmanship,36,15,21
12542,Лорбан,gordunni,1122,hunter,marksmanship,38,18,20
12543,Kendow,blackrock,1122,hunter,marksmanship,66,29,37
12544,Blacksyo,elune,1122,hunter,marksmanship,51,16,35
12545,Jozsiur,ragnaros,1121,hunter,marksmanship,24,14,10
12546,Bazrzokh,elune,1121,hunter,marksmanship,24,12,12
12547,Rediction,ravencrest,1121,hunter,marksmanship,55,20,35
12548,Jaggatee,senjin,1119,hunter,marksmanship,34,17,17
12549,Cooroona,stormrage,1119,hunter,marksmanship,24,12,12
12550,Gorá,dethecus,1118,hunter,marksmanship,18,12,6
12551,Zirgoo,outland,1117,hunter,marksmanship,75,30,45
12552,Meläna,ysondre,1117,hunter,marksmanship,36,14,22
12553,Akyra,runetotem,1116,hunter,marksmanship,76,31,45
12554,Réja,norgannon,1112,hunter,marksmanship,37,16,21
12555,Bobihunt,argent-dawn,1108,hunter,marksmanship,30,14,16
12556,Bélier,hyjal,1105,hunter,marksmanship,56,31,25
12557,Hollabackgrl,outland,1105,hunter,marksmanship,42,18,24
12558,Talcaliste,archimonde,1104,hunter,marksmanship,69,30,39
12559,Barbrady,nethersturm,1103,hunter,marksmanship,36,16,20
12560,Naghtel,die-silberne-hand,1101,hunter,marksmanship,54,29,25
12561,Tinlop,ragnaros,1097,hunter,marksmanship,108,48,60
12562,Mendinar,sylvanas,1096,hunter,marksmanship,53,14,39
12563,Naizoo,doomhammer,1090,hunter,marksmanship,24,12,12
12564,Voitelka,terokkar,1090,hunter,marksmanship,73,36,37
12565,Травмаопасен,gordunni,1090,hunter,marksmanship,36,12,24
12566,Vanstro,ragnaros,1086,hunter,marksmanship,26,12,14
12567,Йошумитсу,howling-fjord,1084,hunter,marksmanship,56,29,27
12568,Mántîs,argent-dawn,1084,hunter,marksmanship,73,32,41
12569,Bendit,eredar,1083,hunter,marksmanship,62,31,31
12570,Robìnhood,nemesis,1080,hunter,marksmanship,42,22,20
12571,Shubichou,illidan,1080,hunter,marksmanship,36,16,20
12572,Thelasiel,aerie-peak,1079,hunter,marksmanship,67,33,34
12573,Dentaar,draenor,1078,hunter,marksmanship,125,62,63
12574,Retroxia,stormreaver,1075,hunter,marksmanship,26,12,14
12575,Sisilianno,khaz-modan,1073,hunter,marksmanship,124,55,69
12576,Chassfurax,hyjal,1067,hunter,marksmanship,48,19,29
12577,Thauana,los-errantes,1060,hunter,marksmanship,30,14,16
12578,Aratoxx,blackmoore,1059,hunter,marksmanship,54,28,26
12579,Neldrassil,blackmoore,1058,hunter,marksmanship,89,42,47
12580,Miezuu,ravencrest,1056,hunter,marksmanship,33,14,19
12581,Sùnzí,alakir,1055,hunter,marksmanship,18,11,7
12582,Сандабар,borean-tundra,1055,hunter,marksmanship,41,20,21
12583,Kittykite,thunderhorn,1055,hunter,marksmanship,36,11,25
12584,Kirimbald,blackmoore,1054,hunter,marksmanship,24,11,13
12585,Енвина,gordunni,1054,hunter,marksmanship,29,13,16
12586,Uncø,kazzak,1053,hunter,marksmanship,18,11,7
12587,Bladewing,archimonde,1053,hunter,marksmanship,30,11,19
12588,Artémíss,kazzak,1050,hunter,marksmanship,24,11,13
12589,Kbesagrillo,sanguino,1050,hunter,marksmanship,24,11,13
12590,Nìsalle,argent-dawn,1050,hunter,marksmanship,32,13,19
12591,Слезыотлука,howling-fjord,1048,hunter,marksmanship,18,11,7
12592,Bgxd,tarren-mill,1048,hunter,marksmanship,30,11,19
12593,Pøca,kaelthas,1045,hunter,marksmanship,18,11,7
12594,Aerieshan,ravencrest,1045,hunter,marksmanship,24,11,13
12595,Bulseye,kilrogg,1044,hunter,marksmanship,24,11,13
12596,Omixloua,ragnaros,1044,hunter,marksmanship,53,23,30
12597,Kliantra,wildhammer,1042,hunter,marksmanship,63,29,34
12598,Винтаж,deepholm,1041,hunter,marksmanship,59,26,33
12599,Cêdric,alleria,1041,hunter,marksmanship,28,12,16
12600,Ямакасси,thermaplugg,1038,hunter,marksmanship,96,38,58
12601,Hunterdream,aszune,1037,hunter,marksmanship,25,11,14
12602,Honzu,silvermoon,1030,hunter,marksmanship,24,11,13
12603,Gilgalat,drakthul,1029,hunter,marksmanship,47,20,27
12604,Ispo,frostwolf,1028,hunter,marksmanship,94,45,49
12605,Yrtja,minahonda,1027,hunter,marksmanship,32,18,14
12606,Olnàk,ysondre,1023,hunter,marksmanship,60,32,28
12607,Slicer,arthas,1023,hunter,marksmanship,73,31,42
12608,Vèreesa,azjolnerub,1022,hunter,marksmanship,36,12,24
12609,Triggery,ravencrest,1020,hunter,marksmanship,29,11,18
12610,Fèhn,krasus,1019,hunter,marksmanship,24,14,10
12611,Azsräel,dalaran,1019,hunter,marksmanship,80,33,47
12612,Noobatala,tarren-mill,1018,hunter,marksmanship,36,17,19
12613,Мальберна,eversong,1017,hunter,marksmanship,34,17,17
12614,Hanzolo,uldum,1016,hunter,marksmanship,42,15,27
12615,Crní,tarren-mill,1015,hunter,marksmanship,81,37,44
12616,Isarnexx,dun-modr,1007,hunter,marksmanship,41,21,20
12617,Tungusta,defias-brotherhood,1006,hunter,marksmanship,42,19,23
12618,Nutzz,ragnaros,1006,hunter,marksmanship,41,15,26
12619,Hkizzler,kazzak,1005,hunter,marksmanship,68,27,41
12620,Neosmoke,shadowsong,1004,hunter,marksmanship,93,37,56
12621,Брухлянка,gordunni,1003,hunter,marksmanship,24,12,12
12622,Sazak,draenor,1000,hunter,marksmanship,30,17,13
12623,Ashkabous,kazzak,1000,hunter,marksmanship,36,19,17
12624,Heavenlyx,area-52,998,hunter,marksmanship,42,13,29
12625,Honilsom,thunderhorn,997,hunter,marksmanship,49,14,35
12626,Jaýlah,draenor,991,hunter,marksmanship,54,24,30
12627,Bonquiesha,tarren-mill,991,hunter,marksmanship,25,11,14
12628,Анреал,gordunni,988,hunter,marksmanship,38,16,22
12629,Gorett,kazzak,987,hunter,marksmanship,30,11,19
12630,Tomtus,aggramar,983,hunter,marksmanship,55,27,28
12631,Laara,khaz-modan,983,hunter,marksmanship,131,63,68
12632,Aidsmacka,shattered-hand,982,hunter,marksmanship,20,11,9
12633,Honrø,hyjal,977,hunter,marksmanship,48,21,27
12634,Ártemide,pozzo-delleternità,975,hunter,marksmanship,33,15,18
12635,Väärä,stormscale,964,hunter,marksmanship,27,13,14
12636,Hnut,kazzak,961,hunter,marksmanship,41,16,25
12637,Nyxìa,shattered-halls,960,hunter,marksmanship,18,10,8
12638,Imonér,frostmane,960,hunter,marksmanship,18,10,8
12639,Lonewolfe,ravencrest,960,hunter,marksmanship,218,99,119
12640,Xawai,ragnaros,960,hunter,marksmanship,24,10,14
12641,Bekrepál,outland,960,hunter,marksmanship,24,10,14
12642,Квит,blackscar,960,hunter,marksmanship,24,10,14
12643,Amortên,silvermoon,959,hunter,marksmanship,18,10,8
12644,Velites,aggra-português,959,hunter,marksmanship,18,10,8
12645,Cill,ravencrest,959,hunter,marksmanship,18,10,8
12646,Sazox,blackrock,959,hunter,marksmanship,24,10,14
12647,Bãbas,sargeras,959,hunter,marksmanship,24,10,14
12648,Meetyour,stormscale,959,hunter,marksmanship,24,10,14
12649,Тамирка,deathguard,958,hunter,marksmanship,12,10,2
12650,Metalbaci,sylvanas,958,hunter,marksmanship,18,10,8
12651,Оверман,azuregos,958,hunter,marksmanship,18,10,8
12652,Therakal,culte-de-la-rive-noire,958,hunter,marksmanship,18,10,8
12653,Wìndrunner,malfurion,958,hunter,marksmanship,89,44,45
12654,Snuupz,kazzak,958,hunter,marksmanship,24,10,14
12655,Angelcr,uldum,958,hunter,marksmanship,24,10,14
12656,Birgitta,jaedenar,958,hunter,marksmanship,24,10,14
12657,Yelanna,argent-dawn,957,hunter,marksmanship,18,10,8
12658,Zlejkadlec,burning-blade,957,hunter,marksmanship,24,10,14
12659,Huntazt,draenor,956,hunter,marksmanship,18,10,8
12660,Zrijad,draenor,955,hunter,marksmanship,18,10,8
12661,Johnydep,silvermoon,955,hunter,marksmanship,30,10,20
12662,Фузег,deathguard,953,hunter,marksmanship,18,10,8
12663,Wlndrunner,ravencrest,953,hunter,marksmanship,18,10,8
12664,Kaktus,shattered-hand,951,hunter,marksmanship,18,10,8
12665,Aaryel,outland,948,hunter,marksmanship,18,10,8
12666,Ромажиробас,gordunni,947,hunter,marksmanship,18,10,8
12667,Argato,eredar,947,hunter,marksmanship,18,10,8
12668,Jisila,ravencrest,947,hunter,marksmanship,63,27,36
12669,Quinty,durotan,947,hunter,marksmanship,26,11,15
12670,Freezyshinkn,blackrock,945,hunter,marksmanship,18,11,7
12671,Milandria,antonidas,943,hunter,marksmanship,50,24,26
12672,Djzntrap,outland,939,hunter,marksmanship,24,10,14
12673,Ayshæ,tarren-mill,937,hunter,marksmanship,41,21,20
12674,Agarez,blackrock,936,hunter,marksmanship,42,19,23
12675,Жабра,gordunni,936,hunter,marksmanship,30,10,20
12676,Armoredtiger,grim-batol,935,hunter,marksmanship,72,34,38
12677,Nezuqo,archimonde,932,hunter,marksmanship,30,10,20
12678,Mhood,dun-morogh,931,hunter,marksmanship,56,27,29
12679,Ранбоу,howling-fjord,929,hunter,marksmanship,115,55,60
12680,Sogoru,dun-modr,927,hunter,marksmanship,69,37,32
12681,Euphellius,darkmoon-faire,923,hunter,marksmanship,42,18,24
12682,Madida,ravencrest,916,hunter,marksmanship,29,15,14
12683,Zicko,argent-dawn,909,hunter,marksmanship,53,22,31
12684,Matarmeya,los-errantes,908,hunter,marksmanship,22,11,11
12685,Mimiop,hyjal,907,hunter,marksmanship,60,30,30
12686,Silverinn,turalyon,904,hunter,marksmanship,27,10,17
12687,Амобарбиталх,gordunni,901,hunter,marksmanship,33,11,22
12688,Enfinici,eitrigg,894,hunter,marksmanship,17,10,7
12689,Jibolad,stormreaver,893,hunter,marksmanship,24,11,13
12690,Burondeya,twisting-nether,886,hunter,marksmanship,30,13,17
12691,Adventures,darkmoon-faire,881,hunter,marksmanship,18,10,8
12692,Madtony,aegwynn,879,hunter,marksmanship,26,12,14
12693,Лордорион,gordunni,878,hunter,marksmanship,23,12,11
12694,Luckyshooter,nethersturm,877,hunter,marksmanship,71,32,39
12695,Лордввт,howling-fjord,874,hunter,marksmanship,30,14,16
12696,Aous,burning-legion,873,hunter,marksmanship,30,11,19
12697,Aliyah,blackmoore,867,hunter,marksmanship,66,33,33
12698,Feelmyfurý,tarren-mill,864,hunter,marksmanship,12,9,3
12699,Nyjal,archimonde,864,hunter,marksmanship,12,9,3
12700,Denkstah,tarren-mill,864,hunter,marksmanship,18,9,9
12701,Liquidhunter,quelthalas,864,hunter,marksmanship,18,9,9
12702,Mòzetonq,ravencrest,864,hunter,marksmanship,18,9,9
12703,Krøsh,blackmoore,864,hunter,marksmanship,42,18,24
12704,Medgical,outland,864,hunter,marksmanship,24,9,15
12705,Watchouttah,the-maelstrom,864,hunter,marksmanship,24,9,15
12706,Fìnwë,varimathras,863,hunter,marksmanship,12,9,3
12707,Jayri,ravencrest,863,hunter,marksmanship,18,9,9
12708,Vyana,sylvanas,863,hunter,marksmanship,18,9,9
12709,Thugzilla,auchindoun,863,hunter,marksmanship,18,9,9
12710,Какжеплевать,gordunni,862,hunter,marksmanship,12,9,3
12711,Retropunk,ravencrest,862,hunter,marksmanship,18,9,9
12712,Fantus,sylvanas,862,hunter,marksmanship,18,9,9
12713,Grolmgar,malganis,862,hunter,marksmanship,18,9,9
12714,Chloros,ysondre,862,hunter,marksmanship,18,9,9
12715,Eilyn,quelthalas,862,hunter,marksmanship,18,9,9
12716,Obii,stormscale,862,hunter,marksmanship,18,9,9
12717,Vandathien,stormrage,861,hunter,marksmanship,24,9,15
12718,Theuzikat,ragnaros,861,hunter,marksmanship,24,9,15
12719,Jalcer,draenor,860,hunter,marksmanship,30,9,21
12720,Джимуха,soulflayer,859,hunter,marksmanship,30,15,15
12721,Warkum,zuljin,859,hunter,marksmanship,18,9,9
12722,Enistee,silvermoon,859,hunter,marksmanship,19,9,10
12723,Shieryu,archimonde,859,hunter,marksmanship,24,9,15
12724,Krippie,dun-modr,857,hunter,marksmanship,42,19,23
12725,Gintønic,blackmoore,857,hunter,marksmanship,36,9,27
12726,Grafhunter,antonidas,855,hunter,marksmanship,99,49,50
12727,Крипа,gordunni,855,hunter,marksmanship,22,10,12
12728,Qmbonboni,ravencrest,855,hunter,marksmanship,24,9,15
12729,Helioshin,pozzo-delleternità,855,hunter,marksmanship,30,9,21
12730,Odyzeus,drakthul,854,hunter,marksmanship,24,9,15
12731,Aliriana,doomhammer,853,hunter,marksmanship,18,9,9
12732,Erdna,khaz-modan,853,hunter,marksmanship,42,20,22
12733,Baldazr,shadowsong,853,hunter,marksmanship,24,9,15
12734,Rivery,azjolnerub,852,hunter,marksmanship,18,10,8
12735,Ruppig,nozdormu,851,hunter,marksmanship,24,9,15
12736,Zerkarok,draenor,851,hunter,marksmanship,30,9,21
12737,Talanar,tarren-mill,850,hunter,marksmanship,18,9,9
12738,Фридор,deathguard,850,hunter,marksmanship,24,10,14
12739,Falenwing,blackmoore,842,hunter,marksmanship,22,10,12
12740,Calea,zirkel-des-cenarius,835,hunter,marksmanship,30,13,17
12741,Куфа,blackscar,831,hunter,marksmanship,20,10,10
12742,Faelhorn,archimonde,831,hunter,marksmanship,18,9,9
12743,Кривоватый,galakrond,829,hunter,marksmanship,16,10,6
12744,Digsholes,ravencrest,828,hunter,marksmanship,17,9,8
12745,Hylzen,outland,828,hunter,marksmanship,17,9,8
12746,Annihllation,twilights-hammer,826,hunter,marksmanship,18,9,9
12747,Eldrilaon,arthas,823,hunter,marksmanship,45,20,25
12748,Gyldain,argent-dawn,823,hunter,marksmanship,65,16,49
12749,Rollei,uldum,816,hunter,marksmanship,18,9,9
12750,Kartouche,culte-de-la-rive-noire,816,hunter,marksmanship,56,26,30
12751,Пуллятель,borean-tundra,810,hunter,marksmanship,17,9,8
12752,Hollybuster,perenolde,809,hunter,marksmanship,17,9,8
12753,Zion,kul-tiras,800,hunter,marksmanship,22,9,13
12754,Ímpulsion,stormscale,799,hunter,marksmanship,20,9,11
12755,Tenkai,cthun,791,hunter,marksmanship,65,29,36
12756,Эксп,ashenvale,784,hunter,marksmanship,25,9,16
12757,Neiloh,defias-brotherhood,782,hunter,marksmanship,13,9,4
12758,Hellriderr,silvermoon,779,hunter,marksmanship,42,16,26
12759,Moonzsu,ravencrest,768,hunter,marksmanship,12,8,4
12760,Küredent,archimonde,768,hunter,marksmanship,12,8,4
12761,Luzivar,malganis,768,hunter,marksmanship,12,8,4
12762,Fitzgerald,ragnaros,768,hunter,marksmanship,12,8,4
12763,Смотрюанимэ,gordunni,768,hunter,marksmanship,18,8,10
12764,Carre,twilights-hammer,768,hunter,marksmanship,18,8,10
12765,Wolfud,pozzo-delleternità,768,hunter,marksmanship,18,8,10
12766,Celesticx,chamber-of-aspects,768,hunter,marksmanship,18,8,10
12767,Луврен,deepholm,768,hunter,marksmanship,30,8,22
12768,Sylverain,silvermoon,767,hunter,marksmanship,12,8,4
12769,Elmadre,arthas,767,hunter,marksmanship,12,8,4
12770,Mareyn,argent-dawn,767,hunter,marksmanship,12,8,4
12771,Raegal,sanguino,767,hunter,marksmanship,18,8,10
12772,Рэкрэйван,gordunni,767,hunter,marksmanship,18,8,10
12773,Treyzzor,blackmoore,767,hunter,marksmanship,18,8,10
12774,Donfabio,norgannon,767,hunter,marksmanship,18,8,10
12775,Bicepflex,ragnaros,767,hunter,marksmanship,18,8,10
12776,Иттириса,gordunni,767,hunter,marksmanship,18,8,10
12777,Dasimir,blackrock,767,hunter,marksmanship,18,8,10
12778,Lourse,ysondre,767,hunter,marksmanship,18,8,10
12779,Thallia,todeswache,767,hunter,marksmanship,18,8,10
12780,Jettraichu,aggra-português,767,hunter,marksmanship,18,8,10
12781,Krooghan,outland,767,hunter,marksmanship,18,8,10
12782,Skitari,draenor,767,hunter,marksmanship,18,8,10
12783,Screewu,twisting-nether,767,hunter,marksmanship,21,8,13
12784,Обнимуха,soulflayer,767,hunter,marksmanship,24,8,16
12785,Иоссифсталин,soulflayer,767,hunter,marksmanship,24,8,16
12786,Nelftard,agamaggan,766,hunter,marksmanship,12,8,4
12787,Lani,talnivarr,766,hunter,marksmanship,12,8,4
12788,Shoót,blackmoore,766,hunter,marksmanship,18,8,10
12789,Leílah,kazzak,766,hunter,marksmanship,24,8,16
12790,Makaxx,stormscale,766,hunter,marksmanship,24,8,16
12791,Sylphie,dalaran,766,hunter,marksmanship,24,8,16
12792,Galadris,kirin-tor,765,hunter,marksmanship,18,8,10
12793,Æthelflæd,nathrezim,765,hunter,marksmanship,18,8,10
12794,Ixôn,tarren-mill,765,hunter,marksmanship,24,8,16
12795,Guerrilla,stormscale,765,hunter,marksmanship,24,8,16
12796,Zajebantip,sylvanas,765,hunter,marksmanship,25,8,17
12797,Oneeyedjoe,the-maelstrom,764,hunter,marksmanship,18,8,10
12798,Aourön,archimonde,764,hunter,marksmanship,18,8,10
12799,Muckel,area-52,764,hunter,marksmanship,24,8,16
12800,Juliã,dalaran,763,hunter,marksmanship,12,8,4
12801,Høøli,nethersturm,763,hunter,marksmanship,12,8,4
12802,Rosiee,dun-modr,762,hunter,marksmanship,12,8,4
12803,Shibai,outland,762,hunter,marksmanship,18,8,10
12804,Galintzor,area-52,761,hunter,marksmanship,18,8,10
12805,Hunterhouse,draenor,761,hunter,marksmanship,23,8,15
12806,Wetto,ravencrest,759,hunter,marksmanship,18,8,10
12807,Diosteayuda,dun-modr,755,hunter,marksmanship,12,8,4
12808,Skynner,blackrock,755,hunter,marksmanship,18,8,10
12809,Greel,saurfang,753,hunter,marksmanship,68,27,41
12810,Thrund,burning-legion,751,hunter,marksmanship,12,8,4
12811,Sasi,burning-legion,750,hunter,marksmanship,12,8,4
12812,Спелла,goldrinn,748,hunter,marksmanship,29,8,21
12813,Erestor,hellfire,747,hunter,marksmanship,12,8,4
12814,Ønur,twisting-nether,747,hunter,marksmanship,18,8,10
12815,Thedoors,twisting-nether,746,hunter,marksmanship,30,9,21
12816,Aadarshh,turalyon,741,hunter,marksmanship,24,9,15
12817,Filizvogel,aegwynn,735,hunter,marksmanship,17,8,9
12818,Foxhunt,turalyon,731,hunter,marksmanship,22,8,14
12819,Deathøfrats,ravencrest,719,hunter,marksmanship,11,8,3
12820,Gen,twisting-nether,719,hunter,marksmanship,17,8,9
12821,Эолиана,borean-tundra,715,hunter,marksmanship,15,8,7
12822,Ryhope,silvermoon,714,hunter,marksmanship,11,8,3
12823,Saccä,ysondre,711,hunter,marksmanship,36,9,27
12824,Загзигзаг,soulflayer,710,hunter,marksmanship,21,9,12
12825,Sauer,stormreaver,704,hunter,marksmanship,24,8,16
12826,Grinfall,archimonde,704,hunter,marksmanship,32,9,23
12827,Thieuu,twisting-nether,703,hunter,marksmanship,11,8,3
12828,Фломидзе,gordunni,688,hunter,marksmanship,13,8,5
12829,Dtq,silvermoon,672,hunter,marksmanship,12,7,5
12830,Weilerz,drakthul,672,hunter,marksmanship,12,7,5
12831,Barrybigtoe,tarren-mill,672,hunter,marksmanship,12,7,5
12832,Killershadow,twisting-nether,672,hunter,marksmanship,12,7,5
12833,Vracarx,silvermoon,672,hunter,marksmanship,12,7,5
12834,Merquryh,ravencrest,672,hunter,marksmanship,12,7,5
12835,Hesuss,kazzak,672,hunter,marksmanship,12,7,5
12836,Агелетка,gordunni,672,hunter,marksmanship,12,7,5
12837,Fluttershy,terokkar,672,hunter,marksmanship,12,7,5
12838,Lilsnuss,outland,672,hunter,marksmanship,12,7,5
12839,Costner,darksorrow,672,hunter,marksmanship,12,7,5
12840,Blackbane,ravencrest,672,hunter,marksmanship,12,7,5
12841,Bonjwa,aegwynn,672,hunter,marksmanship,12,7,5
12842,Аабстрактная,gordunni,672,hunter,marksmanship,12,7,5
12843,Monnee,outland,672,hunter,marksmanship,12,7,5
12844,Bigbowyahurd,draenor,672,hunter,marksmanship,12,7,5
12845,Veñom,stormscale,672,hunter,marksmanship,12,7,5
12846,Найтхантишка,gordunni,672,hunter,marksmanship,12,7,5
12847,Riflur,stormscale,672,hunter,marksmanship,12,7,5
12848,Хвоостт,gordunni,672,hunter,marksmanship,12,7,5
12849,Avaren,archimonde,672,hunter,marksmanship,12,7,5
12850,Bawzé,archimonde,672,hunter,marksmanship,12,7,5
12851,Bnji,hyjal,672,hunter,marksmanship,18,7,11
12852,Påtrîckbátém,ravencrest,672,hunter,marksmanship,18,7,11
12853,Mclooving,runetotem,672,hunter,marksmanship,18,7,11
12854,Scartet,blackmoore,672,hunter,marksmanship,18,7,11
12855,Землепух,howling-fjord,672,hunter,marksmanship,18,7,11
12856,Джарвиз,soulflayer,672,hunter,marksmanship,18,7,11
12857,Ahrtemís,destromath,672,hunter,marksmanship,18,7,11
12858,Трольболь,eversong,672,hunter,marksmanship,18,7,11
12859,Онкьяр,gordunni,672,hunter,marksmanship,24,7,17
12860,Griffithstew,blackmoore,672,hunter,marksmanship,24,7,17
12861,Piksî,kazzak,672,hunter,marksmanship,24,7,17
12862,Халикер,soulflayer,671,hunter,marksmanship,12,7,5
12863,Недоношенная,howling-fjord,671,hunter,marksmanship,12,7,5
12864,Ôrïøn,archimonde,671,hunter,marksmanship,12,7,5
12865,Poppson,magtheridon,671,hunter,marksmanship,12,7,5
12866,Partouche,sargeras,671,hunter,marksmanship,12,7,5
12867,Qiruun,draenor,671,hunter,marksmanship,12,7,5
12868,Pargz,auchindoun,671,hunter,marksmanship,12,7,5
12869,Maknamara,tarren-mill,671,hunter,marksmanship,12,7,5
12870,Rísu,argent-dawn,671,hunter,marksmanship,12,7,5
12871,Fixel,pozzo-delleternità,671,hunter,marksmanship,12,7,5
12872,Rydén,pozzo-delleternità,671,hunter,marksmanship,18,7,11
12873,Fanstwo,tarren-mill,671,hunter,marksmanship,18,7,11
12874,Jomerin,thrall,671,hunter,marksmanship,18,7,11
12875,Thengill,draenor,671,hunter,marksmanship,18,7,11
12876,Snaptrap,eredar,671,hunter,marksmanship,18,7,11
12877,Ashrak,frostmourne,671,hunter,marksmanship,18,7,11
12878,Ihateyoumore,ravencrest,671,hunter,marksmanship,18,7,11
12879,Aureboby,hyjal,671,hunter,marksmanship,24,7,17
12880,Faenor,arygos,671,hunter,marksmanship,24,7,17
12881,Sjufemman,ravencrest,671,hunter,marksmanship,24,7,17
12882,Pôts,blackrock,671,hunter,marksmanship,24,7,17
12883,Deathtrapper,bronzebeard,670,hunter,marksmanship,12,7,5
12884,Pewpewshotz,stormscale,670,hunter,marksmanship,12,7,5
12885,Spêctrâ,sylvanas,670,hunter,marksmanship,18,7,11
12886,Yip,twisting-nether,670,hunter,marksmanship,18,7,11
12887,Jiton,grim-batol,670,hunter,marksmanship,18,7,11
12888,Ричардн,howling-fjord,670,hunter,marksmanship,18,7,11
12889,Elektrô,blackmoore,670,hunter,marksmanship,27,7,20
12890,Dahunter,blackmoore,669,hunter,marksmanship,12,7,5
12891,Qqc,burning-legion,669,hunter,marksmanship,12,7,5
12892,Aggyaceshot,silvermoon,669,hunter,marksmanship,18,7,11
12893,Flintenwilly,die-aldor,669,hunter,marksmanship,18,7,11
12894,Kaudza,archimonde,669,hunter,marksmanship,18,7,11
12895,Ядрис,gordunni,668,hunter,marksmanship,12,7,5
12896,Wishmeweed,kazzak,668,hunter,marksmanship,18,7,11
12897,Rayzør,eitrigg,668,hunter,marksmanship,18,7,11
12898,Panfilmaaj,burning-legion,667,hunter,marksmanship,18,7,11
12899,Enerhunt,ysondre,667,hunter,marksmanship,18,7,11
12900,Мокку,howling-fjord,665,hunter,marksmanship,12,7,5
12901,Eilaa,ravencrest,662,hunter,marksmanship,18,7,11
12902,Fernetcola,los-errantes,661,hunter,marksmanship,12,7,5
12903,Banshees,sylvanas,661,hunter,marksmanship,12,7,5
12904,Arkman,malganis,660,hunter,marksmanship,30,7,23
12905,Shokre,silvermoon,657,hunter,marksmanship,12,7,5
12906,Breezhunt,twisting-nether,655,hunter,marksmanship,17,7,10
12907,Есселин,thermaplugg,650,hunter,marksmanship,18,7,11
12908,Lofiv,turalyon,639,hunter,marksmanship,16,7,9
12909,Jocitwitch,ragnaros,624,hunter,marksmanship,15,8,7
12910,Элфй,gordunni,623,hunter,marksmanship,21,7,14
12911,Scark,tarren-mill,621,hunter,marksmanship,11,7,4
12912,Kyliun,frostmane,620,hunter,marksmanship,17,7,10
12913,Zaragattas,aggra-português,618,hunter,marksmanship,23,9,14
12914,Фаффурион,gordunni,617,hunter,marksmanship,19,9,10
12915,Iniduhr,dalaran,617,hunter,marksmanship,21,8,13
12916,Sylasteria,twisting-nether,617,hunter,marksmanship,22,8,14
12917,Weridia,der-rat-von-dalaran,607,hunter,marksmanship,11,7,4
12918,Trachunt,twisting-nether,607,hunter,marksmanship,11,7,4
12919,Chizuna,dun-morogh,606,hunter,marksmanship,14,7,7
12920,Tingly,grim-batol,605,hunter,marksmanship,20,7,13
12921,Саэсантессис,howling-fjord,601,hunter,marksmanship,16,7,9
12922,Biggusdickuz,tarren-mill,590,hunter,marksmanship,11,7,4
12923,Крошкамэг,eversong,582,hunter,marksmanship,13,7,6
12924,Connyrövöga,draenor,576,hunter,marksmanship,6,6,0
12925,Djidawn,ysondre,576,hunter,marksmanship,12,6,6
12926,Hunlin,kazzak,576,hunter,marksmanship,12,6,6
12927,Shína,argent-dawn,576,hunter,marksmanship,12,6,6
12928,Aenina,kazzak,576,hunter,marksmanship,12,6,6
12929,Dugini,ravencrest,576,hunter,marksmanship,12,6,6
12930,Axran,ravencrest,576,hunter,marksmanship,12,6,6
12931,Nelf,shattered-hand,576,hunter,marksmanship,12,6,6
12932,Pantero,kazzak,576,hunter,marksmanship,12,6,6
12933,Инкризшот,gordunni,576,hunter,marksmanship,12,6,6
12934,Bøgs,the-maelstrom,576,hunter,marksmanship,12,6,6
12935,Sketana,silvermoon,576,hunter,marksmanship,12,6,6
12936,Madjia,ravencrest,576,hunter,marksmanship,12,6,6
12937,Vorsia,tarren-mill,576,hunter,marksmanship,12,6,6
12938,Destynarîa,illidan,576,hunter,marksmanship,12,6,6
12939,Stamzer,drakthul,576,hunter,marksmanship,12,6,6
12940,Grandiosity,tarren-mill,576,hunter,marksmanship,12,6,6
12941,Gramyr,ysondre,576,hunter,marksmanship,12,6,6
12942,Greg,defias-brotherhood,576,hunter,marksmanship,12,6,6
12943,Джинксан,blackscar,576,hunter,marksmanship,12,6,6
12944,Crudeconzept,talnivarr,576,hunter,marksmanship,12,6,6
12945,Dolwen,argent-dawn,576,hunter,marksmanship,12,6,6
12946,Freexkite,aegwynn,576,hunter,marksmanship,14,6,8
12947,Antisniper,kazzak,576,hunter,marksmanship,17,6,11
12948,Tomli,nemesis,576,hunter,marksmanship,18,6,12
12949,Oobe,hyjal,576,hunter,marksmanship,18,6,12
12950,Такувами,gordunni,576,hunter,marksmanship,18,6,12
12951,Avaîo,ysondre,576,hunter,marksmanship,18,6,12
12952,Тохадиско,gordunni,575,hunter,marksmanship,6,6,0
12953,Xeragon,frostwolf,575,hunter,marksmanship,12,6,6
12954,Чизано,deathguard,575,hunter,marksmanship,12,6,6
12955,Fugass,ragnaros,575,hunter,marksmanship,12,6,6
12956,Jägarenen,kazzak,575,hunter,marksmanship,12,6,6
12957,Ina,tarren-mill,575,hunter,marksmanship,12,6,6
12958,Eledryn,bronze-dragonflight,575,hunter,marksmanship,12,6,6
12959,Dirtydolores,thrall,575,hunter,marksmanship,12,6,6
12960,Kilölek,ragnaros,575,hunter,marksmanship,12,6,6
12961,Ruger,hyjal,575,hunter,marksmanship,12,6,6
12962,Neuwi,stormreaver,575,hunter,marksmanship,12,6,6
12963,Slayné,silvermoon,575,hunter,marksmanship,12,6,6
12964,Elladiel,blackmoore,575,hunter,marksmanship,12,6,6
12965,Itenik,frostwolf,575,hunter,marksmanship,12,6,6
12966,Domsín,ravencrest,575,hunter,marksmanship,12,6,6
12967,Earlyspring,ragnaros,575,hunter,marksmanship,12,6,6
12968,Muddí,ravencrest,575,hunter,marksmanship,12,6,6
12969,Squidy,archimonde,575,hunter,marksmanship,12,6,6
12970,Tolkienn,archimonde,575,hunter,marksmanship,12,6,6
12971,Evelhunter,kargath,575,hunter,marksmanship,12,6,6
12972,Переферия,galakrond,575,hunter,marksmanship,18,6,12
12973,Bawwykwipkee,ragnaros,575,hunter,marksmanship,18,6,12
12974,Dritzdòurden,dun-modr,575,hunter,marksmanship,18,6,12
12975,Narziel,die-todeskrallen,575,hunter,marksmanship,18,6,12
12976,Elvenian,twisting-nether,575,hunter,marksmanship,18,6,12
12977,Bourrinax,kazzak,575,hunter,marksmanship,18,6,12
12978,Gxx,burning-blade,575,hunter,marksmanship,18,6,12
12979,Longshot,burning-legion,574,hunter,marksmanship,12,6,6
12980,Egy,the-maelstrom,574,hunter,marksmanship,12,6,6
12981,Hunterixx,outland,574,hunter,marksmanship,12,6,6
12982,Løløsifredo,ysondre,574,hunter,marksmanship,12,6,6
12983,Seariko,draenor,574,hunter,marksmanship,18,6,12
12984,Kveyther,silvermoon,572,hunter,marksmanship,12,6,6
12985,Hitscan,ravencrest,572,hunter,marksmanship,12,6,6
12986,Анариэлль,gordunni,572,hunter,marksmanship,12,6,6
12987,Orcgun,mugthol,572,hunter,marksmanship,18,6,12
12988,Cilia,suramar,571,hunter,marksmanship,18,6,12
12989,Selini,bloodfeather,570,hunter,marksmanship,12,6,6
12990,Dødshøt,twisting-nether,569,hunter,marksmanship,18,6,12
12991,Jilkhar,twisting-nether,565,hunter,marksmanship,12,6,6
12992,Mooj,malganis,559,hunter,marksmanship,11,6,5
12993,Rockymarciaa,dalaran,527,hunter,marksmanship,21,6,15
12994,Hantdown,defias-brotherhood,526,hunter,marksmanship,11,6,5
12995,Кисяныч,gordunni,522,hunter,marksmanship,15,7,8
12996,Huntseeker,draenor,511,hunter,marksmanship,14,6,8
12997,Emriye,antonidas,510,hunter,marksmanship,14,6,8
12998,Фэйсконтроль,azuregos,506,hunter,marksmanship,20,6,14
12999,Пушкабомби,soulflayer,497,hunter,marksmanship,20,6,14
13000,Сальверди,gordunni,480,hunter,marksmanship,6,5,1
13001,Deepcleaning,kazzak,480,hunter,marksmanship,6,5,1
13002,Hvaskøduenme,stormscale,480,hunter,marksmanship,6,5,1
13003,Srédder,defias-brotherhood,480,hunter,marksmanship,6,5,1
13004,Hollyz,auchindoun,480,hunter,marksmanship,6,5,1
13005,Eveo,antonidas,480,hunter,marksmanship,6,5,1
13006,Ðarrk,tarren-mill,480,hunter,marksmanship,6,5,1
13007,Hawkinstinct,tarren-mill,480,hunter,marksmanship,6,5,1
13008,Soloist,sylvanas,480,hunter,marksmanship,6,5,1
13009,Akkixz,antonidas,480,hunter,marksmanship,6,5,1
13010,Îløvémêld,kazzak,480,hunter,marksmanship,6,5,1
13011,Toptìérgoðx,drakthul,480,hunter,marksmanship,6,5,1
13012,Ormsliskaren,shattered-hand,480,hunter,marksmanship,6,5,1
13013,Полития,azuregos,480,hunter,marksmanship,9,6,3
13014,Agbaba,twisting-nether,480,hunter,marksmanship,12,5,7
13015,Headshott,agamaggan,480,hunter,marksmanship,12,5,7
13016,Famex,blackmoore,480,hunter,marksmanship,12,5,7
13017,Denaik,ravencrest,480,hunter,marksmanship,12,5,7
13018,Galou,ghostlands,480,hunter,marksmanship,12,5,7
13019,Adhdbad,tarren-mill,480,hunter,marksmanship,12,5,7
13020,Psychlolzxr,burning-legion,480,hunter,marksmanship,12,5,7
13021,Sissnik,thrall,480,hunter,marksmanship,12,5,7
13022,Ghøst,madmortem,480,hunter,marksmanship,12,5,7
13023,Lambtron,tarren-mill,480,hunter,marksmanship,12,5,7
13024,Bloodymarìe,kelthuzad,480,hunter,marksmanship,12,5,7
13025,Уайлен,gordunni,480,hunter,marksmanship,12,5,7
13026,Mazhug,stormreaver,480,hunter,marksmanship,12,5,7
13027,Msir,kazzak,480,hunter,marksmanship,12,5,7
13028,Huntardös,outland,480,hunter,marksmanship,12,5,7
13029,Nawwaf,tarren-mill,480,hunter,marksmanship,12,5,7
13030,Кукито,goldrinn,480,hunter,marksmanship,12,5,7
13031,Кайсго,gordunni,480,hunter,marksmanship,12,5,7
13032,Мафчик,razuvious,480,hunter,marksmanship,12,5,7
13033,Zulthat,thrall,480,hunter,marksmanship,12,5,7
13034,Majuli,stormrage,480,hunter,marksmanship,12,5,7
13035,Deathmarks,blackrock,480,hunter,marksmanship,12,5,7
13036,Sloee,sylvanas,480,hunter,marksmanship,12,5,7
13037,Thúnar,aegwynn,480,hunter,marksmanship,12,5,7
13038,Geete,kazzak,480,hunter,marksmanship,12,5,7
13039,Nothrokh,auchindoun,480,hunter,marksmanship,12,5,7
13040,Trapmanager,kazzak,480,hunter,marksmanship,12,5,7
13041,Tackleberry,ysondre,480,hunter,marksmanship,12,5,7
13042,Ðõt,ravencrest,480,hunter,marksmanship,12,5,7
13043,Kundra,ravencrest,480,hunter,marksmanship,12,5,7
13044,Tavira,zuljin,480,hunter,marksmanship,12,5,7
13045,Куников,booty-bay,480,hunter,marksmanship,12,5,7
13046,Frágile,drakthul,480,hunter,marksmanship,12,5,7
13047,Carrilynn,blackrock,480,hunter,marksmanship,12,5,7
13048,Fylealaes,ravencrest,480,hunter,marksmanship,12,5,7
13049,Ashide,dun-modr,480,hunter,marksmanship,12,5,7
13050,Sodavand,silvermoon,480,hunter,marksmanship,12,5,7
13051,Spitchy,kazzak,480,hunter,marksmanship,12,5,7
13052,Serpos,cthun,480,hunter,marksmanship,12,5,7
13053,Sashobg,aerie-peak,480,hunter,marksmanship,12,5,7
13054,Meghanmarkle,tarren-mill,480,hunter,marksmanship,13,5,8
13055,Draknik,nemesis,480,hunter,marksmanship,16,6,10
13056,Deathchoice,azshara,480,hunter,marksmanship,18,5,13
13057,Elcouche,draenor,480,hunter,marksmanship,18,5,13
13058,Ceres,kaelthas,480,hunter,marksmanship,18,5,13
13059,Тэуреэль,gordunni,480,hunter,marksmanship,18,5,13
13060,Athel,moonglade,480,hunter,marksmanship,18,5,13
13061,Deathwallker,silvermoon,480,hunter,marksmanship,18,5,13
13062,Dramin,defias-brotherhood,480,hunter,marksmanship,18,5,13
13063,Hÿyrøk,ysondre,480,hunter,marksmanship,18,5,13
13064,Outkást,sylvanas,480,hunter,marksmanship,18,5,13
13065,Gukéx,stormscale,480,hunter,marksmanship,18,5,13
13066,Ggproiettili,pozzo-delleternità,480,hunter,marksmanship,18,5,13
13067,Carnificis,sanguino,480,hunter,marksmanship,18,5,13
13068,Noobhuntress,norgannon,480,hunter,marksmanship,18,5,13
13069,Glockzs,auchindoun,480,hunter,marksmanship,18,5,13
13070,Tetiscaza,sanguino,480,hunter,marksmanship,24,5,19
13071,Asâya,blackmoore,479,hunter,marksmanship,6,5,1
13072,Nathah,burning-legion,479,hunter,marksmanship,6,5,1
13073,Xeqter,ravencrest,479,hunter,marksmanship,12,5,7
13074,Typex,defias-brotherhood,479,hunter,marksmanship,12,5,7
13075,Whereismypet,azjolnerub,479,hunter,marksmanship,12,5,7
13076,Ninjaskillss,ravencrest,479,hunter,marksmanship,12,5,7
13077,Zäyk,zuljin,479,hunter,marksmanship,12,5,7
13078,Lunalai,antonidas,479,hunter,marksmanship,12,5,7
13079,Aspéct,ravencrest,479,hunter,marksmanship,12,5,7
13080,Razzét,stormscale,479,hunter,marksmanship,12,5,7
13081,Grimazg,chogall,479,hunter,marksmanship,12,5,7
13082,Bicepz,azjolnerub,479,hunter,marksmanship,12,5,7
13083,Secrety,doomhammer,479,hunter,marksmanship,17,5,12
13084,Зиргус,gordunni,479,hunter,marksmanship,18,5,13
13085,Nígruløl,arthas,479,hunter,marksmanship,18,5,13
13086,Leafstorm,vashj,479,hunter,marksmanship,18,5,13
13087,Hentt,burning-legion,479,hunter,marksmanship,18,5,13
13088,Naregar,draenor,479,hunter,marksmanship,18,5,13
13089,Ðepleter,outland,479,hunter,marksmanship,18,5,13
13090,Fugerlynipps,stormrage,479,hunter,marksmanship,24,5,19
13091,Bæbåk,frostmane,478,hunter,marksmanship,6,5,1
13092,Nightarrows,ravencrest,478,hunter,marksmanship,6,5,1
13093,Thebalrog,korgall,478,hunter,marksmanship,12,5,7
13094,Tiph,argent-dawn,478,hunter,marksmanship,12,5,7
13095,Лукорды,gordunni,478,hunter,marksmanship,12,5,7
13096,Miisakaa,antonidas,477,hunter,marksmanship,12,5,7
13097,Bloodshot,nethersturm,477,hunter,marksmanship,12,5,7
13098,Titanx,sylvanas,477,hunter,marksmanship,12,5,7
13099,Legath,emerald-dream,477,hunter,marksmanship,12,5,7
13100,Pylos,azshara,477,hunter,marksmanship,12,5,7
13101,Ашмадей,eversong,476,hunter,marksmanship,12,5,7
13102,Robros,dentarg,475,hunter,marksmanship,12,5,7
13103,Klittcrit,bloodhoof,475,hunter,marksmanship,12,5,7
13104,Sixty,rajaxx,474,hunter,marksmanship,18,5,13
13105,Karmios,drakthul,473,hunter,marksmanship,12,5,7
13106,Juki,pozzo-delleternità,472,hunter,marksmanship,12,5,7
13107,Banninymph,culte-de-la-rive-noire,467,hunter,marksmanship,18,5,13
13108,Brønkø,azshara,463,hunter,marksmanship,17,5,12
13109,Rdevill,outland,448,hunter,marksmanship,16,5,11
13110,Шэнчи,greymane,447,hunter,marksmanship,11,6,5
13111,Littlenugget,ravencrest,447,hunter,marksmanship,11,5,6
13112,Urith,les-clairvoyants,447,hunter,marksmanship,14,6,8
13113,Snípér,blackhand,447,hunter,marksmanship,20,6,14
13114,Haleth,uldum,447,hunter,marksmanship,17,5,12
13115,Thedanchodak,stormrage,440,hunter,marksmanship,11,5,6
13116,Darkstripe,turalyon,431,hunter,marksmanship,11,5,6
13117,Cais,drakthul,426,hunter,marksmanship,18,6,12
13118,Сашатетива,gordunni,426,hunter,marksmanship,20,6,14
13119,Deadyeyez,doomhammer,423,hunter,marksmanship,15,7,8
13120,Sleepyarrow,chogall,420,hunter,marksmanship,12,6,6
13121,Artaeos,lordaeron,416,hunter,marksmanship,16,5,11
13122,Azmena,silvermoon,415,hunter,marksmanship,11,5,6
13123,Гилара,soulflayer,415,hunter,marksmanship,22,5,17
13124,Gotha,festung-der-stürme,414,hunter,marksmanship,14,5,9
13125,Anjeschka,nemesis,400,hunter,marksmanship,7,5,2
13126,Thain,stormscale,384,hunter,marksmanship,6,4,2
13127,Unßørn,archimonde,384,hunter,marksmanship,6,4,2
13128,Snipinx,draenor,384,hunter,marksmanship,6,4,2
13129,Тумбаюмб,howling-fjord,384,hunter,marksmanship,6,4,2
13130,Comegetme,auchindoun,384,hunter,marksmanship,6,4,2
13131,Burninghunt,ravencrest,384,hunter,marksmanship,6,4,2
13132,Chase,wildhammer,384,hunter,marksmanship,6,4,2
13133,Hntudwn,azshara,384,hunter,marksmanship,6,4,2
13134,Kikilirilivi,ysondre,384,hunter,marksmanship,6,4,2
13135,Nßatrapper,outland,384,hunter,marksmanship,6,4,2
13136,Haranti,dun-modr,384,hunter,marksmanship,6,4,2
13137,Kragán,silvermoon,384,hunter,marksmanship,6,4,2
13138,Smígol,stormreaver,384,hunter,marksmanship,6,4,2
13139,Ðøper,hyjal,384,hunter,marksmanship,6,4,2
13140,Øtemløol,sanguino,384,hunter,marksmanship,6,4,2
13141,Roke,malganis,384,hunter,marksmanship,6,4,2
13142,Huntbegin,burning-legion,384,hunter,marksmanship,6,4,2
13143,Rymous,nemesis,384,hunter,marksmanship,6,4,2
13144,Хантероо,gordunni,384,hunter,marksmanship,6,4,2
13145,Velen,pozzo-delleternità,384,hunter,marksmanship,6,4,2
13146,Skytraped,hyjal,384,hunter,marksmanship,6,4,2
13147,Томбомбадил,howling-fjord,384,hunter,marksmanship,6,4,2
13148,Sovanz,aggra-português,384,hunter,marksmanship,6,4,2
13149,Yoey,tarren-mill,384,hunter,marksmanship,6,4,2
13150,Likandria,blackmoore,384,hunter,marksmanship,6,4,2
13151,Spyte,twisting-nether,384,hunter,marksmanship,6,4,2
13152,Dariusmm,silvermoon,384,hunter,marksmanship,6,4,2
13153,Niffe,stormscale,384,hunter,marksmanship,6,4,2
13154,Zoêva,blackhand,384,hunter,marksmanship,6,4,2
13155,Lennyx,quelthalas,384,hunter,marksmanship,6,4,2
13156,Myoui,silvermoon,384,hunter,marksmanship,6,4,2
13157,Ðæom,outland,384,hunter,marksmanship,6,4,2
13158,Sandchaton,ragnaros,384,hunter,marksmanship,6,4,2
13159,Luzivarus,malganis,384,hunter,marksmanship,6,4,2
13160,Slo,sylvanas,384,hunter,marksmanship,6,4,2
13161,Benbutton,antonidas,384,hunter,marksmanship,6,4,2
13162,Hävenofün,archimonde,384,hunter,marksmanship,6,4,2
13163,Ditbjrapex,chants-éternels,384,hunter,marksmanship,6,4,2
13164,Yuichiro,senjin,384,hunter,marksmanship,6,4,2
13165,Сынсема,blackscar,384,hunter,marksmanship,6,4,2
13166,Джеймсфранко,blackscar,384,hunter,marksmanship,6,4,2
13167,Doloresman,tarren-mill,384,hunter,marksmanship,6,4,2
13168,Intoxd,sylvanas,384,hunter,marksmanship,6,4,2
13169,Gaudio,outland,384,hunter,marksmanship,6,4,2
13170,Idtrapthat,nagrand,384,hunter,marksmanship,6,4,2
13171,Сацыви,gordunni,384,hunter,marksmanship,6,4,2
13172,Bosseleon,blackrock,384,hunter,marksmanship,6,4,2
13173,Vantagepoint,arathor,384,hunter,marksmanship,6,4,2
13174,Yuptae,alonsus,384,hunter,marksmanship,6,4,2
13175,Darllene,kazzak,384,hunter,marksmanship,6,4,2
13176,Nöbody,khaz-modan,384,hunter,marksmanship,6,4,2
13177,Donpromìlló,blackhand,384,hunter,marksmanship,9,5,4
13178,Wîldhunt,burning-legion,384,hunter,marksmanship,11,4,7
13179,Fennecshand,colinas-pardas,384,hunter,marksmanship,12,4,8
13180,Йинги,gordunni,384,hunter,marksmanship,12,4,8
13181,Darkshe,dun-modr,384,hunter,marksmanship,12,4,8
13182,Ozaï,eredar,384,hunter,marksmanship,12,4,8
13183,Querro,azshara,384,hunter,marksmanship,12,4,8
13184,Harmonía,outland,384,hunter,marksmanship,12,4,8
13185,Peonfarmer,argent-dawn,384,hunter,marksmanship,12,4,8
13186,Slinkywinky,eonar,384,hunter,marksmanship,12,4,8
13187,Sjins,draenor,384,hunter,marksmanship,12,4,8
13188,Tartaupommes,hyjal,384,hunter,marksmanship,12,4,8
13189,Dangerousfoe,argent-dawn,384,hunter,marksmanship,12,4,8
13190,Shadowxx,silvermoon,384,hunter,marksmanship,12,4,8
13191,Tonttulul,draenor,384,hunter,marksmanship,12,4,8
13192,Nyri,drakthul,384,hunter,marksmanship,12,4,8
13193,Jondone,silvermoon,384,hunter,marksmanship,12,4,8
13194,Kanlina,ravencrest,384,hunter,marksmanship,12,4,8
13195,Графруру,soulflayer,384,hunter,marksmanship,12,4,8
13196,Becoming,burning-legion,384,hunter,marksmanship,12,4,8
13197,Døømslayer,nemesis,384,hunter,marksmanship,12,4,8
13198,Rapid,sylvanas,384,hunter,marksmanship,12,4,8
13199,Rndhunt,shattrath,384,hunter,marksmanship,12,4,8
13200,Chaoticshot,ravencrest,384,hunter,marksmanship,12,4,8
13201,Mexine,dun-morogh,384,hunter,marksmanship,12,4,8
13202,Jinxpeasant,twisting-nether,384,hunter,marksmanship,12,4,8
13203,Diqtore,aszune,384,hunter,marksmanship,12,4,8
13204,Oròg,hyjal,384,hunter,marksmanship,12,4,8
13205,Mousysnok,ravencrest,384,hunter,marksmanship,12,4,8
13206,Jskey,aggramar,384,hunter,marksmanship,12,4,8
13207,Bugspitz,outland,384,hunter,marksmanship,12,4,8
13208,Marodan,ambossar,384,hunter,marksmanship,12,4,8
13209,Абунай,soulflayer,384,hunter,marksmanship,12,4,8
13210,Sharún,sylvanas,384,hunter,marksmanship,12,4,8
13211,Deeparrow,stormscale,384,hunter,marksmanship,12,4,8
13212,Skyttelaj,stormscale,384,hunter,marksmanship,12,4,8
13213,Aamön,tarren-mill,384,hunter,marksmanship,12,4,8
13214,Vallêria,malganis,384,hunter,marksmanship,12,4,8
13215,Zurzok,blackrock,384,hunter,marksmanship,12,4,8
13216,Tytoyz,khaz-modan,384,hunter,marksmanship,12,4,8
13217,Hashaya,hyjal,384,hunter,marksmanship,12,4,8
13218,Naestra,tarren-mill,384,hunter,marksmanship,12,4,8
13219,Vohnívak,turalyon,384,hunter,marksmanship,12,4,8
13220,Egodennis,frostwolf,384,hunter,marksmanship,12,4,8
13221,Aimedbot,azjolnerub,384,hunter,marksmanship,12,4,8
13222,Свадебная,gordunni,384,hunter,marksmanship,12,4,8
13223,Gødzftw,kazzak,384,hunter,marksmanship,14,4,10
13224,Soppatorsk,shadowsong,384,hunter,marksmanship,18,4,14
13225,Шумогон,gordunni,384,hunter,marksmanship,18,4,14
13226,Kêêpsmile,blackmoore,384,hunter,marksmanship,18,4,14
13227,Ruhen,aegwynn,384,hunter,marksmanship,18,4,14
13228,Маори,deepholm,384,hunter,marksmanship,18,4,14
13229,Haraigoshí,grim-batol,384,hunter,marksmanship,18,4,14
13230,Enablee,lightbringer,384,hunter,marksmanship,24,4,20
13231,Конар,soulflayer,383,hunter,marksmanship,6,4,2
13232,Вевери,blackscar,383,hunter,marksmanship,6,4,2
13233,Køûrø,hyjal,383,hunter,marksmanship,6,4,2
13234,Amiosi,sanguino,383,hunter,marksmanship,10,5,5
13235,Penelopé,darkmoon-faire,383,hunter,marksmanship,12,4,8
13236,Zirriath,mazrigos,383,hunter,marksmanship,12,4,8
13237,Anguerande,khaz-modan,383,hunter,marksmanship,12,4,8
13238,Meletis,stormreaver,383,hunter,marksmanship,12,4,8
13239,Tervel,dun-morogh,383,hunter,marksmanship,12,4,8
13240,Kyéra,kirin-tor,383,hunter,marksmanship,12,4,8
13241,Amsterdamer,sylvanas,383,hunter,marksmanship,12,4,8
13242,Beaupapa,archimonde,383,hunter,marksmanship,14,4,10
13243,Hunntte,ravencrest,383,hunter,marksmanship,14,4,10
13244,Koreic,silvermoon,383,hunter,marksmanship,18,4,14
13245,Musux,uldum,383,hunter,marksmanship,18,4,14
13246,Agnõr,chants-éternels,382,hunter,marksmanship,6,4,2
13247,Bulhumt,draenor,382,hunter,marksmanship,6,4,2
13248,Deadshout,kazzak,382,hunter,marksmanship,6,4,2
13249,Petardas,outland,382,hunter,marksmanship,6,4,2
13250,Nonamenoskil,sylvanas,382,hunter,marksmanship,12,4,8
13251,Costae,aerie-peak,382,hunter,marksmanship,12,4,8
13252,Бурбоньчик,soulflayer,382,hunter,marksmanship,12,4,8
13253,Metapouk,archimonde,382,hunter,marksmanship,12,4,8
13254,Skapig,frostwolf,381,hunter,marksmanship,12,4,8
13255,Pâthfînder,destromath,379,hunter,marksmanship,12,4,8
13256,Lumidii,burning-legion,379,hunter,marksmanship,12,4,8
13257,Ketsh,antonidas,367,hunter,marksmanship,11,4,7
13258,Dhmuntar,ravencrest,367,hunter,marksmanship,11,4,7
13259,Éddiémórphín,kazzak,367,hunter,marksmanship,11,4,7
13260,Jablaka,blackhand,366,hunter,marksmanship,23,4,19
13261,Boehelientje,defias-brotherhood,351,hunter,marksmanship,11,4,7
13262,Naepy,thrall,351,hunter,marksmanship,16,4,12
13263,Rea,archimonde,350,hunter,marksmanship,16,4,12
13264,Shadoox,argent-dawn,335,hunter,marksmanship,11,4,7
13265,Arwenna,argent-dawn,328,hunter,marksmanship,11,6,5
13266,Rakmo,blackmoore,320,hunter,marksmanship,10,4,6
13267,Bloópy,silvermoon,320,hunter,marksmanship,10,4,6
13268,Выпейдождь,gordunni,319,hunter,marksmanship,8,4,4
13269,Трапавграунд,howling-fjord,288,hunter,marksmanship,6,3,3
13270,Magmageul,archimonde,288,hunter,marksmanship,6,3,3
13271,Kaznek,hyjal,288,hunter,marksmanship,6,3,3
13272,Антисерт,ashenvale,288,hunter,marksmanship,6,3,3
13273,Djøgi,archimonde,288,hunter,marksmanship,6,3,3
13274,Mhb,quelthalas,288,hunter,marksmanship,6,3,3
13275,Nerdhark,hyjal,288,hunter,marksmanship,6,3,3
13276,Dreemshoot,stormscale,288,hunter,marksmanship,6,3,3
13277,Eéilin,the-maelstrom,288,hunter,marksmanship,6,3,3
13278,Fize,blackmoore,288,hunter,marksmanship,6,3,3
13279,Andrøk,archimonde,288,hunter,marksmanship,6,3,3
13280,Tardoboy,blackrock,288,hunter,marksmanship,6,3,3
13281,Люблюлюбовь,gordunni,288,hunter,marksmanship,6,3,3
13282,Комомура,soulflayer,288,hunter,marksmanship,6,3,3
13283,ßæro,hyjal,288,hunter,marksmanship,6,3,3
13284,Brûmovitch,archimonde,288,hunter,marksmanship,6,3,3
13285,Phinecone,stormscale,288,hunter,marksmanship,6,3,3
13286,Zøk,stormscale,288,hunter,marksmanship,6,3,3
13287,Lioness,ahnqiraj,288,hunter,marksmanship,6,3,3
13288,Loydzz,hyjal,288,hunter,marksmanship,6,3,3
13289,Mariabanks,aegwynn,288,hunter,marksmanship,6,3,3
13290,Padancete,sanguino,288,hunter,marksmanship,6,3,3
13291,Spítz,outland,288,hunter,marksmanship,6,3,3
13292,Ев,lich-king,288,hunter,marksmanship,6,3,3
13293,Celebor,sanguino,288,hunter,marksmanship,6,3,3
13294,Feyoonxx,blackrock,288,hunter,marksmanship,6,3,3
13295,Spunkybum,nagrand,288,hunter,marksmanship,6,3,3
13296,Atranex,ravencrest,288,hunter,marksmanship,6,3,3
13297,Колякилшот,gordunni,288,hunter,marksmanship,6,3,3
13298,Abaforth,bronze-dragonflight,288,hunter,marksmanship,6,3,3
13299,Яроняютрапу,gordunni,288,hunter,marksmanship,6,3,3
13300,Aimshot,ravencrest,288,hunter,marksmanship,6,3,3
13301,Kahbe,ravencrest,288,hunter,marksmanship,6,3,3
13302,Neescafe,sylvanas,288,hunter,marksmanship,6,3,3
13303,Rakshor,thrall,288,hunter,marksmanship,6,3,3
13304,Velne,ravencrest,288,hunter,marksmanship,6,3,3
13305,Sylariel,die-aldor,288,hunter,marksmanship,6,3,3
13306,Samasukë,grim-batol,288,hunter,marksmanship,6,3,3
13307,Techpøint,silvermoon,288,hunter,marksmanship,6,3,3
13308,Hiddenstalk,outland,288,hunter,marksmanship,6,3,3
13309,Attileus,ragnaros,288,hunter,marksmanship,6,3,3
13310,Хихихихх,gordunni,288,hunter,marksmanship,6,3,3
13311,Kaminôr,antonidas,288,hunter,marksmanship,6,3,3
13312,Каэсс,gordunni,288,hunter,marksmanship,6,3,3
13313,Threeguns,blackrock,288,hunter,marksmanship,6,3,3
13314,Jarhead,arthas,288,hunter,marksmanship,6,3,3
13315,Anthélià,antonidas,288,hunter,marksmanship,6,3,3
13316,Pläpp,stormscale,288,hunter,marksmanship,6,3,3
13317,Ätea,hyjal,288,hunter,marksmanship,6,3,3
13318,Экономист,fordragon,288,hunter,marksmanship,6,3,3
13319,Kfcmanagerx,silvermoon,288,hunter,marksmanship,6,3,3
13320,Dedral,aegwynn,288,hunter,marksmanship,6,3,3
13321,Hreo,twisting-nether,288,hunter,marksmanship,6,3,3
13322,Bocek,silvermoon,288,hunter,marksmanship,6,3,3
13323,Semda,blackmoore,288,hunter,marksmanship,6,3,3
13324,Aliltoxic,silvermoon,288,hunter,marksmanship,6,3,3
13325,Zwockeline,blutkessel,288,hunter,marksmanship,6,3,3
13326,Гунныч,grom,288,hunter,marksmanship,6,3,3
13327,Osie,kazzak,288,hunter,marksmanship,6,3,3
13328,Rykini,twisting-nether,288,hunter,marksmanship,6,3,3
13329,Ozzaty,drekthar,288,hunter,marksmanship,6,3,3
13330,Milhambré,ysondre,288,hunter,marksmanship,6,3,3
13331,Eliune,silvermoon,288,hunter,marksmanship,6,3,3
13332,Storphunt,drakthul,288,hunter,marksmanship,6,3,3
13333,Stripedcani,kelthuzad,288,hunter,marksmanship,6,3,3
13334,Hidalgô,kult-der-verdammten,288,hunter,marksmanship,6,3,3
13335,Zugzlug,tarren-mill,288,hunter,marksmanship,6,3,3
13336,Lithell,kazzak,288,hunter,marksmanship,6,3,3
13337,Burbutsuluki,silvermoon,288,hunter,marksmanship,6,3,3
13338,Ayiu,argent-dawn,288,hunter,marksmanship,6,3,3
13339,Deadluck,kazzak,288,hunter,marksmanship,6,3,3
13340,Elonmask,argent-dawn,288,hunter,marksmanship,6,3,3
13341,Graavi,silvermoon,288,hunter,marksmanship,6,3,3
13342,Ökisek,drakthul,288,hunter,marksmanship,6,3,3
13343,Nightarrowq,tarren-mill,288,hunter,marksmanship,9,4,5
13344,Amdéa,boulderfist,288,hunter,marksmanship,10,4,6
13345,Boen,nordrassil,288,hunter,marksmanship,8,3,5
13346,Нойран,eversong,288,hunter,marksmanship,9,3,6
13347,Астериел,blackscar,288,hunter,marksmanship,12,3,9
13348,Saîtek,chogall,288,hunter,marksmanship,12,3,9
13349,Richidex,zuljin,288,hunter,marksmanship,12,3,9
13350,Jensa,darksorrow,288,hunter,marksmanship,12,3,9
13351,Ghenter,sargeras,288,hunter,marksmanship,12,3,9
13352,Dafragger,blackmoore,288,hunter,marksmanship,12,3,9
13353,Akù,magtheridon,288,hunter,marksmanship,12,3,9
13354,Flucxx,stormscale,288,hunter,marksmanship,12,3,9
13355,Mewithoutyou,ragnaros,288,hunter,marksmanship,12,3,9
13356,Хедшоттер,blackscar,288,hunter,marksmanship,12,3,9
13357,Chassuu,khaz-modan,288,hunter,marksmanship,12,3,9
13358,Sphinx,neptulon,288,hunter,marksmanship,12,3,9
13359,Deahtviper,blackmoore,288,hunter,marksmanship,12,3,9
13360,Naaztko,stormscale,288,hunter,marksmanship,12,3,9
13361,Funkemarie,blackmoore,288,hunter,marksmanship,12,3,9
13362,Скадхи,blackscar,288,hunter,marksmanship,12,3,9
13363,Missdarkness,shattered-hand,288,hunter,marksmanship,12,3,9
13364,Нэвлоск,gordunni,288,hunter,marksmanship,12,3,9
13365,Snipar,chogall,288,hunter,marksmanship,12,3,9
13366,Bâng,zuljin,288,hunter,marksmanship,12,3,9
13367,Bowgamerx,ravencrest,288,hunter,marksmanship,12,3,9
13368,Fatfrumos,twisting-nether,288,hunter,marksmanship,12,3,9
13369,Incompetence,argent-dawn,288,hunter,marksmanship,12,3,9
13370,Бубунн,howling-fjord,288,hunter,marksmanship,12,3,9
13371,Oduross,minahonda,288,hunter,marksmanship,12,3,9
13372,Flyingnipp,arthas,288,hunter,marksmanship,12,3,9
13373,Spakster,blackrock,288,hunter,marksmanship,12,3,9
13374,Thalanel,arthas,288,hunter,marksmanship,12,3,9
13375,Jakis,silvermoon,288,hunter,marksmanship,12,3,9
13376,Rløad,hyjal,288,hunter,marksmanship,12,3,9
13377,Aurah,les-clairvoyants,288,hunter,marksmanship,12,3,9
13378,Soviectk,aggra-português,288,hunter,marksmanship,12,3,9
13379,Zubro,kazzak,288,hunter,marksmanship,12,3,9
13380,Augie,kazzak,288,hunter,marksmanship,12,3,9
13381,Nímren,ambossar,288,hunter,marksmanship,12,3,9
13382,Deify,grim-batol,288,hunter,marksmanship,12,3,9
13383,Lùchiean,kazzak,288,hunter,marksmanship,12,3,9
13384,Foxmis,kazzak,288,hunter,marksmanship,12,3,9
13385,Tsía,ysondre,288,hunter,marksmanship,17,3,14
13386,Shademd,ahnqiraj,288,hunter,marksmanship,18,3,15
13387,Apolix,ragnaros,288,hunter,marksmanship,18,3,15
13388,Lamenob,neptulon,288,hunter,marksmanship,18,3,15
13389,Showdope,drakthul,288,hunter,marksmanship,18,3,15
13390,Sidera,der-rat-von-dalaran,288,hunter,marksmanship,18,3,15
13391,Turkos,krasus,287,hunter,marksmanship,6,3,3
13392,Nycto,norgannon,287,hunter,marksmanship,6,3,3
13393,Оркос,deathweaver,287,hunter,marksmanship,6,3,3
13394,Cronox,sporeggar,287,hunter,marksmanship,6,3,3
13395,Pulica,the-maelstrom,287,hunter,marksmanship,6,3,3
13396,Kolskoot,kilrogg,287,hunter,marksmanship,6,3,3
13397,Kilshot,burning-legion,287,hunter,marksmanship,6,3,3
13398,Btk,sanguino,287,hunter,marksmanship,6,3,3
13399,Cøbrâ,hyjal,287,hunter,marksmanship,10,3,7
13400,Onexshot,draenor,287,hunter,marksmanship,12,3,9
13401,Dwoas,darkspear,287,hunter,marksmanship,12,3,9
13402,Constantín,aegwynn,287,hunter,marksmanship,12,3,9
13403,Zwerglogan,amanthul,287,hunter,marksmanship,18,3,15
13404,Jomoguin,stormscale,286,hunter,marksmanship,6,3,3
13405,Millhunter,norgannon,284,hunter,marksmanship,12,3,9
13406,Najetazruda,drakthul,255,hunter,marksmanship,10,3,7
13407,Jaguarundy,dun-modr,239,hunter,marksmanship,5,3,2
13408,Eazzyy,auchindoun,239,hunter,marksmanship,5,3,2
13409,Олдорк,howling-fjord,239,hunter,marksmanship,12,3,9
13410,Incrediown,tarren-mill,234,hunter,marksmanship,7,4,3
13411,Шикаа,gordunni,223,hunter,marksmanship,8,3,5
13412,Dampfwâlzê,nozdormu,223,hunter,marksmanship,14,3,11
13413,Skarra,zuljin,208,hunter,marksmanship,7,3,4
13414,Zinà,naxxramas,192,hunter,marksmanship,6,2,4
13415,Entaiy,blackmoore,192,hunter,marksmanship,6,2,4
13416,Bobshmurda,defias-brotherhood,192,hunter,marksmanship,6,2,4
13417,Notikâ,aegwynn,192,hunter,marksmanship,6,2,4
13418,Горгудц,gordunni,192,hunter,marksmanship,6,2,4
13419,Хароко,gordunni,192,hunter,marksmanship,6,2,4
13420,Ecthelione,the-venture-co,192,hunter,marksmanship,6,2,4
13421,Гернриета,gordunni,192,hunter,marksmanship,6,2,4
13422,Nnoyk,defias-brotherhood,192,hunter,marksmanship,6,2,4
13423,Bowner,frostmane,192,hunter,marksmanship,6,2,4
13424,Bignug,conseil-des-ombres,192,hunter,marksmanship,6,2,4
13425,Lagich,sylvanas,192,hunter,marksmanship,6,2,4
13426,Sloe,sylvanas,192,hunter,marksmanship,6,2,4
13427,Bärberøusse,illidan,192,hunter,marksmanship,6,2,4
13428,Bellecoq,arathi,192,hunter,marksmanship,6,2,4
13429,Flick,auchindoun,192,hunter,marksmanship,6,2,4
13430,Avp,sylvanas,192,hunter,marksmanship,6,2,4
13431,Bréanni,auchindoun,192,hunter,marksmanship,6,2,4
13432,Traplørdx,sylvanas,192,hunter,marksmanship,6,2,4
13433,Mìrilass,nemesis,192,hunter,marksmanship,6,2,4
13434,Sarblade,bronze-dragonflight,192,hunter,marksmanship,6,2,4
13435,Sebrienne,defias-brotherhood,192,hunter,marksmanship,6,2,4
13436,Anklar,blackrock,192,hunter,marksmanship,6,2,4
13437,Трисциллочка,howling-fjord,192,hunter,marksmanship,6,2,4
13438,Sankari,blackmoore,192,hunter,marksmanship,6,2,4
13439,Darkshàdow,archimonde,192,hunter,marksmanship,6,2,4
13440,Rixxâr,blackrock,192,hunter,marksmanship,6,2,4
13441,Sayn,la-croisade-écarlate,192,hunter,marksmanship,6,2,4
13442,Hapocalypt,pozzo-delleternità,192,hunter,marksmanship,6,2,4
13443,Velvett,blackmoore,192,hunter,marksmanship,6,2,4
13444,Silenta,outland,192,hunter,marksmanship,6,2,4
13445,Keinzira,hyjal,192,hunter,marksmanship,6,2,4
13446,Melloy,drakthul,192,hunter,marksmanship,6,2,4
13447,Rickgrimés,silvermoon,192,hunter,marksmanship,6,2,4
13448,Elvyns,silvermoon,192,hunter,marksmanship,6,2,4
13449,Themehdi,silvermoon,192,hunter,marksmanship,6,2,4
13450,Fenomhunt,silvermoon,192,hunter,marksmanship,6,2,4
13451,Ävírøñskÿ,ravencrest,192,hunter,marksmanship,6,2,4
13452,Ðkð,archimonde,192,hunter,marksmanship,6,2,4
13453,Brizza,talnivarr,192,hunter,marksmanship,6,2,4
13454,Greenstar,twisting-nether,192,hunter,marksmanship,6,2,4
13455,Охотуначал,soulflayer,192,hunter,marksmanship,6,2,4
13456,Фетсол,soulflayer,192,hunter,marksmanship,6,2,4
13457,Зихантер,soulflayer,192,hunter,marksmanship,6,2,4
13458,Mobshot,twisting-nether,192,hunter,marksmanship,6,2,4
13459,Tòràk,twisting-nether,192,hunter,marksmanship,6,2,4
13460,Сактарион,soulflayer,192,hunter,marksmanship,6,2,4
13461,Kodakcrack,draenor,192,hunter,marksmanship,6,2,4
13462,Plilolz,archimonde,192,hunter,marksmanship,6,2,4
13463,Шергала,soulflayer,192,hunter,marksmanship,6,2,4
13464,Othellö,kazzak,192,hunter,marksmanship,6,2,4
13465,Legöläs,tarren-mill,192,hunter,marksmanship,6,2,4
13466,Doknak,gilneas,192,hunter,marksmanship,6,2,4
13467,Vâleriaa,blackrock,192,hunter,marksmanship,6,2,4
13468,Realme,blackrock,192,hunter,marksmanship,6,2,4
13469,Olsenas,silvermoon,192,hunter,marksmanship,6,2,4
13470,Slayman,kazzak,192,hunter,marksmanship,6,2,4
13471,Sinadoreck,sargeras,192,hunter,marksmanship,6,2,4
13472,Olrik,dentarg,192,hunter,marksmanship,6,2,4
13473,Goldnug,karazhan,192,hunter,marksmanship,6,2,4
13474,Dola,archimonde,192,hunter,marksmanship,6,2,4
13475,Miracleh,tarren-mill,192,hunter,marksmanship,6,2,4
13476,Hadto,der-rat-von-dalaran,192,hunter,marksmanship,6,2,4
13477,Arrowlight,archimonde,192,hunter,marksmanship,6,2,4
13478,Sinequanon,mannoroth,192,hunter,marksmanship,6,2,4
13479,Хисдед,howling-fjord,192,hunter,marksmanship,6,2,4
13480,Ricoshet,silvermoon,192,hunter,marksmanship,6,2,4
13481,Nashanael,argent-dawn,192,hunter,marksmanship,6,2,4
13482,Powerofanime,drakthul,192,hunter,marksmanship,6,2,4
13483,Bóssit,skullcrusher,192,hunter,marksmanship,6,2,4
13484,Isokrates,das-syndikat,192,hunter,marksmanship,6,2,4
13485,Tórbjorn,argent-dawn,192,hunter,marksmanship,6,2,4
13486,Beletor,medivh,192,hunter,marksmanship,6,2,4
13487,Phanos,draenor,192,hunter,marksmanship,6,2,4
13488,Nimri,kazzak,192,hunter,marksmanship,6,2,4
13489,Carioca,blackhand,192,hunter,marksmanship,6,2,4
13490,Дианнесса,howling-fjord,192,hunter,marksmanship,6,2,4
13491,Rhyle,hyjal,192,hunter,marksmanship,6,2,4
13492,Garrash,teldrassil,192,hunter,marksmanship,6,2,4
13493,Lilsnipè,outland,192,hunter,marksmanship,6,2,4
13494,Jachtorc,kazzak,192,hunter,marksmanship,6,2,4
13495,Aspergun,ragnaros,192,hunter,marksmanship,6,2,4
13496,Hvnn,stormscale,192,hunter,marksmanship,6,2,4
13497,Zulldek,sanguino,192,hunter,marksmanship,6,2,4
13498,Sylverein,silvermoon,192,hunter,marksmanship,6,2,4
13499,Hexorn,ysondre,192,hunter,marksmanship,6,2,4
13500,Hntard,stormscale,192,hunter,marksmanship,6,2,4
13501,Chenony,ravencrest,192,hunter,marksmanship,6,2,4
13502,Maeba,shendralar,192,hunter,marksmanship,6,2,4
13503,Bláckheart,doomhammer,192,hunter,marksmanship,6,2,4
13504,Kerrveros,ravencrest,192,hunter,marksmanship,6,2,4
13505,Viktorijå,draenor,192,hunter,marksmanship,6,2,4
13506,Boarthrills,ravencrest,192,hunter,marksmanship,6,2,4
13507,Nyght,ravencrest,192,hunter,marksmanship,6,2,4
13508,Meztarinnan,twisting-nether,192,hunter,marksmanship,6,2,4
13509,Denixilith,eredar,192,hunter,marksmanship,6,2,4
13510,Jamais02AEE6,stormscale,192,hunter,marksmanship,6,2,4
13511,Huntbeard,ragnaros,192,hunter,marksmanship,6,2,4
13512,Dãhrn,sanguino,192,hunter,marksmanship,6,2,4
13513,Elfyhunter,outland,192,hunter,marksmanship,6,2,4
13514,Brubeck,terokkar,192,hunter,marksmanship,6,2,4
13515,Eilosh,outland,192,hunter,marksmanship,6,2,4
13516,Arunaky,uldum,192,hunter,marksmanship,6,2,4
13517,Anoroxx,arthas,192,hunter,marksmanship,6,2,4
13518,Grytax,outland,192,hunter,marksmanship,6,2,4
13519,Youardead,arthas,192,hunter,marksmanship,6,2,4
13520,Rafaela,genjuros,192,hunter,marksmanship,6,2,4
13521,Traenuss,azuremyst,192,hunter,marksmanship,6,2,4
13522,Enfaktüs,silvermoon,192,hunter,marksmanship,6,2,4
13523,Mcperra,zuljin,192,hunter,marksmanship,6,2,4
13524,Coxxie,ragnaros,192,hunter,marksmanship,6,2,4
13525,Arnakua,outland,192,hunter,marksmanship,6,2,4
13526,Machini,terokkar,192,hunter,marksmanship,6,2,4
13527,Corrector,outland,192,hunter,marksmanship,6,2,4
13528,Яриона,galakrond,192,hunter,marksmanship,6,2,4
13529,Sïrrys,nemesis,192,hunter,marksmanship,7,2,5
13530,Андреймвп,galakrond,192,hunter,marksmanship,9,2,7
13531,Ghostriders,archimonde,192,hunter,marksmanship,11,2,9
13532,Explicits,stormscale,192,hunter,marksmanship,12,2,10
13533,Spacenøub,archimonde,192,hunter,marksmanship,12,2,10
13534,Застрельщикц,soulflayer,192,hunter,marksmanship,12,2,10
13535,Cazaó,sanguino,192,hunter,marksmanship,12,2,10
13536,Headshota,stormscale,192,hunter,marksmanship,12,2,10
13537,Weedonyhunt,hyjal,192,hunter,marksmanship,12,2,10
13538,Whitehor,ragnaros,192,hunter,marksmanship,12,2,10
13539,Лиасон,howling-fjord,192,hunter,marksmanship,12,2,10
13540,Kenpach,frostmane,192,hunter,marksmanship,12,2,10
13541,Hyod,khaz-modan,192,hunter,marksmanship,12,2,10
13542,Suchykeb,silvermoon,192,hunter,marksmanship,12,2,10
13543,Dmanite,ravencrest,192,hunter,marksmanship,12,2,10
13544,Katharyne,argent-dawn,192,hunter,marksmanship,12,2,10
13545,Коватори,borean-tundra,192,hunter,marksmanship,12,2,10
13546,Elitepeon,blackmoore,192,hunter,marksmanship,12,2,10
13547,Rêxxer,blackmoore,192,hunter,marksmanship,12,2,10
13548,Friskì,draenor,192,hunter,marksmanship,12,2,10
13549,Gingiismydad,outland,192,hunter,marksmanship,12,2,10
13550,Banglor,shattered-hand,192,hunter,marksmanship,12,2,10
13551,Fedya,kazzak,192,hunter,marksmanship,12,2,10
13552,Chaydee,stormscale,192,hunter,marksmanship,18,2,16
13553,Kronzucker,eredar,192,hunter,marksmanship,18,2,16
13554,Гекагека,gordunni,191,hunter,marksmanship,6,2,4
13555,Enanorabioso,minahonda,191,hunter,marksmanship,6,2,4
13556,Downpipe,shattered-hand,191,hunter,marksmanship,6,2,4
13557,Sushimän,kaelthas,191,hunter,marksmanship,6,2,4
13558,Кикто,gordunni,191,hunter,marksmanship,6,2,4
13559,Fakepvper,darksorrow,191,hunter,marksmanship,6,2,4
13560,Rockét,malorne,191,hunter,marksmanship,6,2,4
13561,Stormhoofd,bloodhoof,191,hunter,marksmanship,6,2,4
13562,Fingon,alleria,191,hunter,marksmanship,12,2,10
13563,Chalyto,dun-morogh,191,hunter,marksmanship,12,2,10
13564,Kure,blackrock,191,hunter,marksmanship,12,2,10
13565,Buttsnipe,sylvanas,159,hunter,marksmanship,5,2,3
13566,Doojas,archimonde,159,hunter,marksmanship,5,2,3
13567,Jaguàr,kazzak,159,hunter,marksmanship,5,2,3
13568,Spagooters,argent-dawn,138,hunter,marksmanship,11,3,8
13569,Robingood,alexstrasza,138,hunter,marksmanship,22,5,17
13570,Neremyn,sylvanas,138,hunter,marksmanship,15,3,12
13571,Primator,argent-dawn,128,hunter,marksmanship,4,2,2
13572,Akahr,thrall,96,hunter,marksmanship,3,2,1
13573,Ríffraff,silvermoon,96,hunter,marksmanship,3,2,1
13574,Janoh,dalaran,96,hunter,marksmanship,3,2,1
13575,Tryx,darksorrow,96,hunter,marksmanship,3,2,1
13576,Tyrone,saurfang,96,hunter,marksmanship,9,2,7
13577,Åbomìnatïon,ravencrest,96,hunter,marksmanship,18,3,15
13578,Sângha,frostwolf,96,hunter,marksmanship,6,1,5
13579,Nortroll,draenor,96,hunter,marksmanship,6,1,5
13580,Kongweaver,ragnaros,96,hunter,marksmanship,6,1,5
13581,Gabbriel,ravencrest,96,hunter,marksmanship,6,1,5
13582,Eowale,outland,96,hunter,marksmanship,6,1,5
13583,Drolarin,zuljin,96,hunter,marksmanship,6,1,5
13584,Pestilencio,shendralar,96,hunter,marksmanship,6,1,5
13585,Cowmelk,stormscale,96,hunter,marksmanship,6,1,5
13586,Negz,eredar,96,hunter,marksmanship,6,1,5
13587,Tesourinho,aggra-português,96,hunter,marksmanship,6,1,5
13588,Jagarbladet,ravencrest,96,hunter,marksmanship,6,1,5
13589,Камсшотт,gordunni,96,hunter,marksmanship,6,1,5
13590,Pennymarks,blackhand,96,hunter,marksmanship,6,1,5
13591,Raverave,burning-legion,96,hunter,marksmanship,6,1,5
13592,Mehtäsika,xavius,96,hunter,marksmanship,6,1,5
13593,Akaname,ravencrest,96,hunter,marksmanship,6,1,5
13594,Almêryck,ysondre,96,hunter,marksmanship,6,1,5
13595,Chantalia,ravencrest,96,hunter,marksmanship,6,1,5
13596,Roupinol,aggra-português,96,hunter,marksmanship,6,1,5
13597,Орталиус,deathguard,96,hunter,marksmanship,6,1,5
13598,Левери,gordunni,96,hunter,marksmanship,6,1,5
13599,Wèdra,hyjal,96,hunter,marksmanship,6,1,5
13600,Mästerkill,dun-modr,96,hunter,marksmanship,6,1,5
13601,Elaresas,argent-dawn,96,hunter,marksmanship,6,1,5
13602,Velcy,ravencrest,96,hunter,marksmanship,6,1,5
13603,Fayenia,ravencrest,96,hunter,marksmanship,6,1,5
13604,Frilance,dun-modr,96,hunter,marksmanship,6,1,5
13605,Cendrac,ravencrest,96,hunter,marksmanship,6,1,5
13606,Nethria,antonidas,96,hunter,marksmanship,6,1,5
13607,Cléò,kazzak,96,hunter,marksmanship,6,1,5
13608,Høøl,hyjal,96,hunter,marksmanship,6,1,5
13609,Hanzú,argent-dawn,96,hunter,marksmanship,6,1,5
13610,Tillhunt,kargath,96,hunter,marksmanship,6,1,5
13611,Xaraimz,ravencrest,96,hunter,marksmanship,6,1,5
13612,Galedjïn,conseil-des-ombres,96,hunter,marksmanship,6,1,5
13613,Drágø,blackmoore,96,hunter,marksmanship,6,1,5
13614,Badkirves,kazzak,96,hunter,marksmanship,6,1,5
13615,Crowcifer,argent-dawn,96,hunter,marksmanship,6,1,5
13616,Cxc,dun-modr,96,hunter,marksmanship,6,1,5
13617,Гижуна,howling-fjord,96,hunter,marksmanship,6,1,5
13618,Nalys,argent-dawn,96,hunter,marksmanship,6,1,5
13619,Killzo,sylvanas,96,hunter,marksmanship,6,1,5
13620,Навальница,gordunni,96,hunter,marksmanship,6,1,5
13621,Deadlymayhem,dragonblight,96,hunter,marksmanship,6,1,5
13622,Salie,argent-dawn,96,hunter,marksmanship,6,1,5
13623,Avâlos,dentarg,96,hunter,marksmanship,6,1,5
13624,Statik,deathwing,96,hunter,marksmanship,6,1,5
13625,Hallem,karazhan,96,hunter,marksmanship,6,1,5
13626,Chassour,archimonde,96,hunter,marksmanship,6,1,5
13627,Xurrl,kazzak,96,hunter,marksmanship,6,1,5
13628,Iddqd,outland,96,hunter,marksmanship,6,1,5
13629,Обспн,borean-tundra,96,hunter,marksmanship,6,1,5
13630,Wàterloo,marécage-de-zangar,96,hunter,marksmanship,6,1,5
13631,Санзи,howling-fjord,96,hunter,marksmanship,6,1,5
13632,Ренектон,soulflayer,96,hunter,marksmanship,6,1,5
13633,Teedfredd,tarren-mill,96,hunter,marksmanship,6,1,5
13634,Хантунец,soulflayer,96,hunter,marksmanship,6,1,5
13635,Darthbow,outland,96,hunter,marksmanship,6,1,5
13636,Flechaoscurä,exodar,96,hunter,marksmanship,6,1,5
13637,Mavis,bloodfeather,96,hunter,marksmanship,6,1,5
13638,Feedbackloop,silvermoon,96,hunter,marksmanship,6,1,5
13639,Desow,blackrock,96,hunter,marksmanship,6,1,5
13640,Лсныйпамп,howling-fjord,96,hunter,marksmanship,6,1,5
13641,Frapt,dalaran,96,hunter,marksmanship,6,1,5
13642,Tuljan,ravencrest,96,hunter,marksmanship,6,1,5
13643,Delanoche,exodar,96,hunter,marksmanship,6,1,5
13644,Syx,amanthul,96,hunter,marksmanship,6,1,5
13645,Arkancia,throkferoth,96,hunter,marksmanship,6,1,5
13646,Applix,tarren-mill,96,hunter,marksmanship,6,1,5
13647,Наладдчик,howling-fjord,96,hunter,marksmanship,6,1,5
13648,Wolfmcquade,draenor,96,hunter,marksmanship,6,1,5
13649,Instinctx,agamaggan,96,hunter,marksmanship,6,1,5
13650,Farkrin,silvermoon,96,hunter,marksmanship,6,1,5
13651,Quasar,arakarahm,96,hunter,marksmanship,6,1,5
13652,Leaxs,onyxia,96,hunter,marksmanship,6,1,5
13653,Superfacial,twisting-nether,96,hunter,marksmanship,6,1,5
13654,Kolgrim,temple-noir,96,hunter,marksmanship,6,1,5
13655,Chillø,elune,96,hunter,marksmanship,6,1,5
13656,Pinocion,drakthul,96,hunter,marksmanship,6,1,5
13657,Faccacamoale,twisting-nether,96,hunter,marksmanship,6,1,5
13658,Wantsumsnipe,twisting-nether,96,hunter,marksmanship,6,1,5
13659,Castbuny,drakthul,96,hunter,marksmanship,6,1,5
13660,Avizi,anachronos,96,hunter,marksmanship,6,1,5
13661,Cítyzens,drakthul,96,hunter,marksmanship,6,1,5
13662,Горгонт,blackscar,96,hunter,marksmanship,6,1,5
13663,Chapovito,twisting-nether,96,hunter,marksmanship,6,1,5
13664,Dewshot,silvermoon,96,hunter,marksmanship,6,1,5
13665,Wonderbrax,nemesis,96,hunter,marksmanship,6,1,5
13666,Oneofus,malygos,96,hunter,marksmanship,6,1,5
13667,Toulouki,silvermoon,96,hunter,marksmanship,6,1,5
13668,Kichassequi,khaz-modan,96,hunter,marksmanship,14,2,12
13669,Gorgorotha,ragnaros,96,hunter,marksmanship,12,1,11
13670,Noskillbot,twisting-nether,96,hunter,marksmanship,12,1,11
13671,Artexxia,kazzak,96,hunter,marksmanship,12,1,11
13672,Moskalhunter,terokkar,96,hunter,marksmanship,12,1,11
13673,Götthunter,antonidas,96,hunter,marksmanship,12,1,11
13674,Tiguy,archimonde,96,hunter,marksmanship,12,1,11
13675,Donáldtrúmp,tarren-mill,96,hunter,marksmanship,12,1,11
13676,Râpton,blackmoore,96,hunter,marksmanship,12,1,11
13677,Kratozs,outland,96,hunter,marksmanship,13,1,12
13678,Kælan,grim-batol,96,hunter,marksmanship,18,1,17
13679,Denixxia,bronzebeard,95,hunter,marksmanship,3,2,1
13680,Magahra,thrall,95,hunter,marksmanship,6,1,5
13681,Gohsthunter,dun-morogh,95,hunter,marksmanship,6,1,5
13682,Nogneteen,chamber-of-aspects,95,hunter,marksmanship,12,1,11
13683,Twinshot,anetheron,84,hunter,marksmanship,15,5,10
13684,Gettóbuxa,arathor,79,hunter,marksmanship,5,1,4
13685,Dréws,kazzak,64,hunter,marksmanship,4,1,3
13686,Draugrinnh,tarren-mill,48,hunter,marksmanship,3,1,2
13687,Nimrod,norgannon,48,hunter,marksmanship,3,1,2
13688,Howlinjoe,darkspear,48,hunter,marksmanship,9,1,8
13689,Merveilleux,hyjal,42,hunter,marksmanship,11,3,8
13690,Svinrbglol,arygos,31,hunter,marksmanship,2,1,1
13691,Geruga,thrall,31,hunter,marksmanship,2,1,1
13692,Elgango,blackrock,16,hunter,marksmanship,1,1,0
13693,Дунморг,grom,16,hunter,marksmanship,1,1,0
13694,Tudjuk,arathor,16,hunter,marksmanship,1,1,0
13695,Imortaltroll,kazzak,16,hunter,marksmanship,1,1,0
13696,Skaedi,silvermoon,16,hunter,marksmanship,1,1,0
13697,Bicmex,ravencrest,2304,hunter,survival,86,51,35
13698,Bonquiesha,tarren-mill,2163,hunter,survival,120,69,51
13699,Corossity,blackmoore,2155,hunter,survival,107,71,36
13700,Gíggí,malganis,2155,hunter,survival,72,40,32
13701,Rynex,festung-der-stürme,2134,hunter,survival,78,45,33
13702,Harrianlar,ravenholdt,2128,hunter,survival,166,84,82
13703,Pridz,archimonde,2121,hunter,survival,186,94,92
13704,Nikzeubii,archimonde,2113,hunter,survival,66,39,27
13705,Razoorine,blackrock,2102,hunter,survival,156,87,69
13706,Djheartstrng,argent-dawn,2100,hunter,survival,138,82,56
13707,Götdelen,kult-der-verdammten,2084,hunter,survival,182,97,85
13708,Fíng,tarren-mill,2079,hunter,survival,216,109,107
13709,Uglybaboon,draenor,2064,hunter,survival,305,150,155
13710,Earfalass,twisting-nether,2040,hunter,survival,238,133,105
13711,Macrolaim,outland,2016,hunter,survival,251,122,129
13712,Epicsurvive,ravencrest,2013,hunter,survival,102,52,50
13713,Yeezu,sylvanas,2009,hunter,survival,66,36,30
13714,Marvelmary,ravencrest,2004,hunter,survival,83,38,45
13715,Krakenaspect,kazzak,2002,hunter,survival,50,32,18
13716,Josethepimpo,stormscale,2002,hunter,survival,161,81,80
13717,Jànet,ravencrest,2002,hunter,survival,66,33,33
13718,Mestar,outland,2001,hunter,survival,199,100,99
13719,Belaux,archimonde,1997,hunter,survival,221,108,113
13720,Huntity,kazzak,1995,hunter,survival,101,54,47
13721,Crucfixion,kazzak,1993,hunter,survival,60,35,25
13722,Exquisitor,draenor,1990,hunter,survival,295,156,139
13723,Лесбиянюсь,gordunni,1983,hunter,survival,137,77,60
13724,Booxun,sylvanas,1982,hunter,survival,133,68,65
13725,Dackeldustin,norgannon,1970,hunter,survival,59,50,9
13726,Stormblãze,ravencrest,1969,hunter,survival,155,73,82
13727,Mspt,archimonde,1967,hunter,survival,130,63,67
13728,Gukexa,outland,1965,hunter,survival,66,39,27
13729,Gukéx,stormscale,1965,hunter,survival,72,39,33
13730,Hyderr,aegwynn,1964,hunter,survival,54,34,20
13731,Rayadz,nethersturm,1961,hunter,survival,210,104,106
13732,Dyndns,blackmoore,1959,hunter,survival,90,46,44
13733,Pokefangirlx,grim-batol,1952,hunter,survival,259,140,119
13734,Akronis,outland,1951,hunter,survival,119,58,61
13735,Jackjager,ravencrest,1950,hunter,survival,63,40,23
13736,Yemistar,archimonde,1949,hunter,survival,90,48,42
13737,Jamboss,twisting-nether,1945,hunter,survival,60,29,31
13738,Aboleon,ragnaros,1934,hunter,survival,74,38,36
13739,Cjezka,blackmoore,1931,hunter,survival,123,64,59
13740,Zhulk,los-errantes,1926,hunter,survival,137,68,69
13741,Kfcmanagerx,silvermoon,1923,hunter,survival,58,38,20
13742,Rewgodxq,ravencrest,1903,hunter,survival,161,81,80
13743,Mmkekw,guldan,1902,hunter,survival,48,33,15
13744,Горгонт,blackscar,1897,hunter,survival,132,72,60
13745,Sneakyshøt,nemesis,1894,hunter,survival,263,137,126
13746,Yake,kazzak,1881,hunter,survival,52,23,29
13747,Momohenní,archimonde,1871,hunter,survival,156,86,70
13748,Raelaf,zuljin,1866,hunter,survival,42,23,19
13749,Scypher,ragnaros,1864,hunter,survival,50,33,17
13750,Lágåta,outland,1864,hunter,survival,53,27,26
13751,Ryomen,garona,1862,hunter,survival,189,99,90
13752,Øvade,argent-dawn,1861,hunter,survival,67,41,26
13753,Brkh,ravencrest,1857,hunter,survival,54,30,24
13754,Calesthas,tarren-mill,1856,hunter,survival,96,51,45
13755,Nwnw,tarren-mill,1855,hunter,survival,36,22,14
13756,Svinrbglol,arygos,1854,hunter,survival,54,26,28
13757,Kagrot,silvermoon,1847,hunter,survival,102,49,53
13758,Kyosoku,silvermoon,1845,hunter,survival,57,28,29
13759,Madzynette,archimonde,1842,hunter,survival,67,40,27
13760,Feignfisto,draenor,1840,hunter,survival,33,20,13
13761,Zanpa,archimonde,1840,hunter,survival,82,49,33
13762,Lugnåls,hyjal,1838,hunter,survival,89,46,43
13763,Moustø,archimonde,1836,hunter,survival,47,29,18
13764,Zerberas,blackrock,1835,hunter,survival,60,32,28
13765,Åíøñs,kazzak,1834,hunter,survival,42,26,16
13766,Djshibalxd,argent-dawn,1834,hunter,survival,90,44,46
13767,Квит,blackscar,1832,hunter,survival,30,20,10
13768,Fwaffidack,tarren-mill,1829,hunter,survival,63,36,27
13769,Vunter,malganis,1828,hunter,survival,48,26,22
13770,Dabeszt,draenor,1827,hunter,survival,60,38,22
13771,Avaren,archimonde,1826,hunter,survival,118,61,57
13772,Майен,thermaplugg,1823,hunter,survival,72,32,40
13773,Vènuhá,ravencrest,1822,hunter,survival,66,41,25
13774,Sarrow,ravencrest,1822,hunter,survival,115,64,51
13775,Qwèrts,stormscale,1822,hunter,survival,60,33,27
13776,Skârlock,blackmoore,1819,hunter,survival,89,50,39
13777,Зеленыйиисус,gordunni,1818,hunter,survival,153,84,69
13778,Stuckstepbro,silvermoon,1818,hunter,survival,47,22,25
13779,Mogumogu,blackhand,1817,hunter,survival,66,34,32
13780,Marchik,outland,1813,hunter,survival,52,34,18
13781,Frog,crushridge,1810,hunter,survival,78,46,32
13782,Thugzilla,auchindoun,1810,hunter,survival,71,40,31
13783,Polaqu,burning-legion,1809,hunter,survival,60,37,23
13784,Betarayjinx,kazzak,1806,hunter,survival,63,37,26
13785,Соняпиво,gordunni,1804,hunter,survival,72,41,31
13786,Glosendra,ravencrest,1803,hunter,survival,90,52,38
13787,Ksreport,stormscale,1802,hunter,survival,58,27,31
13788,Zpf,silvermoon,1801,hunter,survival,56,30,26
13789,Minibicmex,aegwynn,1801,hunter,survival,82,43,39
13790,Lagich,stormscale,1799,hunter,survival,34,24,10
13791,Killerkatze,outland,1794,hunter,survival,36,19,17
13792,Clydefrog,outland,1794,hunter,survival,52,24,28
13793,Alexdi,kazzak,1792,hunter,survival,66,30,36
13794,Laayopeh,argent-dawn,1788,hunter,survival,48,29,19
13795,Fatbushpig,stormscale,1786,hunter,survival,30,19,11
13796,Saliressa,ravencrest,1775,hunter,survival,102,50,52
13797,Onlylfg,drakthul,1772,hunter,survival,68,35,33
13798,Dreämhäck,ravencrest,1768,hunter,survival,78,47,31
13799,Sneakyshoot,nemesis,1767,hunter,survival,59,31,28
13800,Ravebae,silvermoon,1766,hunter,survival,150,73,77
13801,Скадхи,blackscar,1761,hunter,survival,156,79,77
13802,Летмимейт,howling-fjord,1759,hunter,survival,96,53,43
13803,Easyclass,hyjal,1756,hunter,survival,78,40,38
13804,Burbutsuluki,silvermoon,1755,hunter,survival,48,24,24
13805,Boops,ragnaros,1754,hunter,survival,96,45,51
13806,Chopitoo,blackmoore,1749,hunter,survival,72,40,32
13807,Obbnfriends,ravencrest,1749,hunter,survival,66,30,36
13808,Clifton,archimonde,1748,hunter,survival,42,27,15
13809,Grulog,kazzak,1747,hunter,survival,66,31,35
13810,Svetlanatrap,stormscale,1746,hunter,survival,48,24,24
13811,Draxil,archimonde,1739,hunter,survival,112,60,52
13812,Pwon,ravencrest,1739,hunter,survival,242,125,117
13813,Hunjo,quelthalas,1739,hunter,survival,90,40,50
13814,Døvah,argent-dawn,1737,hunter,survival,54,30,24
13815,Fablet,draenor,1736,hunter,survival,54,31,23
13816,Monkeytrapz,norgannon,1733,hunter,survival,54,29,25
13817,Subha,quelthalas,1731,hunter,survival,48,31,17
13818,Kalthrog,ragnaros,1731,hunter,survival,66,37,29
13819,Глефард,fordragon,1727,hunter,survival,42,29,13
13820,Ехесу,soulflayer,1720,hunter,survival,36,19,17
13821,Иснсейшн,soulflayer,1718,hunter,survival,53,31,22
13822,Curbý,blackhand,1718,hunter,survival,36,20,16
13823,Тэмплест,howling-fjord,1714,hunter,survival,48,32,16
13824,Yosia,draenor,1714,hunter,survival,126,64,62
13825,Wicmex,archimonde,1713,hunter,survival,33,21,12
13826,Skewdar,hyjal,1712,hunter,survival,60,27,33
13827,Sipsomewater,ravencrest,1707,hunter,survival,36,21,15
13828,Hühneknubbel,blackmoore,1707,hunter,survival,42,24,18
13829,Løvebombing,ravencrest,1706,hunter,survival,30,18,12
13830,Robzyhunter,kazzak,1705,hunter,survival,77,46,31
13831,Леоа,howling-fjord,1703,hunter,survival,54,24,30
13832,Snippy,sanguino,1702,hunter,survival,132,63,69
13833,Bnak,die-ewige-wacht,1700,hunter,survival,24,18,6
13834,Razôr,blackhand,1700,hunter,survival,30,18,12
13835,Киссмайпет,howling-fjord,1700,hunter,survival,60,34,26
13836,Sorozo,aegwynn,1699,hunter,survival,120,62,58
13837,Разплюханка,howling-fjord,1698,hunter,survival,120,62,58
13838,Микихаса,galakrond,1697,hunter,survival,105,56,49
13839,Rubydacherrý,argent-dawn,1696,hunter,survival,30,21,9
13840,Yazqua,deathwing,1696,hunter,survival,70,42,28
13841,Fusko,ysondre,1695,hunter,survival,54,29,25
13842,Búddhìst,ravencrest,1694,hunter,survival,48,22,26
13843,Zøk,stormscale,1689,hunter,survival,125,71,54
13844,Плутяра,blackscar,1684,hunter,survival,66,31,35
13845,Nurki,the-maelstrom,1680,hunter,survival,53,26,27
13846,Eunte,archimonde,1680,hunter,survival,78,38,40
13847,Danissia,argent-dawn,1675,hunter,survival,57,32,25
13848,Slizzle,sporeggar,1675,hunter,survival,78,42,36
13849,Субоота,gordunni,1672,hunter,survival,137,70,67
13850,Arrcher,thrall,1670,hunter,survival,36,26,10
13851,Аркеро,soulflayer,1670,hunter,survival,61,31,30
13852,Knokkelmann,outland,1668,hunter,survival,36,24,12
13853,Kukenisluken,stormscale,1667,hunter,survival,29,18,11
13854,Avizi,anachronos,1667,hunter,survival,84,42,42
13855,Оскорбление,howling-fjord,1667,hunter,survival,84,42,42
13856,Véncsótány,ragnaros,1666,hunter,survival,54,29,25
13857,Axehead,outland,1664,hunter,survival,42,22,20
13858,Liikes,arygos,1664,hunter,survival,48,25,23
13859,Kurkelx,ravencrest,1661,hunter,survival,48,30,18
13860,Sunyjuyono,ravencrest,1659,hunter,survival,54,25,29
13861,Lukez,ravencrest,1656,hunter,survival,48,28,20
13862,Lìmpy,stormreaver,1656,hunter,survival,36,21,15
13863,Zäroury,ravencrest,1653,hunter,survival,64,32,32
13864,Хансбург,howling-fjord,1653,hunter,survival,92,42,50
13865,Бомбетта,grom,1649,hunter,survival,90,43,47
13866,Xiumiune,antonidas,1648,hunter,survival,69,40,29
13867,Urtanis,stormscale,1647,hunter,survival,107,58,49
13868,Бубунн,howling-fjord,1646,hunter,survival,87,50,37
13869,Amilienne,nozdormu,1646,hunter,survival,45,22,23
13870,Чууч,blackscar,1645,hunter,survival,153,72,81
13871,Xamisch,eredar,1644,hunter,survival,34,22,12
13872,Yemmeth,argent-dawn,1644,hunter,survival,216,110,106
13873,Brattamer,twisting-nether,1642,hunter,survival,28,19,9
13874,Wonkeedx,ravencrest,1641,hunter,survival,42,21,21
13875,Halfogre,draenor,1640,hunter,survival,30,20,10
13876,Zulldek,sanguino,1638,hunter,survival,78,42,36
13877,Mewithoutyou,ragnaros,1637,hunter,survival,214,99,115
13878,Xexhel,twisting-nether,1634,hunter,survival,45,26,19
13879,Gedept,blackrock,1633,hunter,survival,80,41,39
13880,Closeenought,ravencrest,1633,hunter,survival,102,51,51
13881,Unsáinted,ravencrest,1632,hunter,survival,227,119,108
13882,Maiverx,ravencrest,1631,hunter,survival,24,17,7
13883,Lxoh,turalyon,1629,hunter,survival,251,125,126
13884,Nienel,archimonde,1629,hunter,survival,125,57,68
13885,Renathir,argent-dawn,1628,hunter,survival,56,31,25
13886,Skyh,outland,1628,hunter,survival,101,48,53
13887,Кулерквест,soulflayer,1627,hunter,survival,85,46,39
13888,Albumx,hyjal,1627,hunter,survival,271,139,132
13889,Marryme,blackhand,1625,hunter,survival,50,32,18
13890,Iceyx,stormscale,1624,hunter,survival,49,22,27
13891,Babûsch,blackmoore,1623,hunter,survival,54,25,29
13892,Shiceloch,blackmoore,1621,hunter,survival,42,20,22
13893,Kajtarn,outland,1621,hunter,survival,60,27,33
13894,Katzila,outland,1620,hunter,survival,41,22,19
13895,Жуткойкрот,lich-king,1620,hunter,survival,78,32,46
13896,Копия,azuregos,1619,hunter,survival,72,30,42
13897,Leviáckerman,ravencrest,1617,hunter,survival,36,17,19
13898,Skytraped,hyjal,1616,hunter,survival,41,25,16
13899,Saejku,archimonde,1616,hunter,survival,75,40,35
13900,Ntwoõ,ravencrest,1615,hunter,survival,65,37,28
13901,Pizzafanatic,blackrock,1614,hunter,survival,49,25,24
13902,Losiané,thrall,1613,hunter,survival,94,48,46
13903,Фломидзе,gordunni,1611,hunter,survival,76,47,29
13904,Defjacks,argent-dawn,1609,hunter,survival,80,40,40
13905,Savageone,frostwhisper,1609,hunter,survival,48,23,25
13906,Ластшот,blackscar,1608,hunter,survival,30,17,13
13907,Ruxhunter,sanguino,1607,hunter,survival,90,50,40
13908,Skydraz,ysondre,1606,hunter,survival,60,33,27
13909,Cira,archimonde,1606,hunter,survival,48,24,24
13910,Gradevine,twisting-nether,1605,hunter,survival,86,52,34
13911,Гудхантер,blackscar,1605,hunter,survival,66,38,28
13912,Rasmi,kazzak,1605,hunter,survival,65,31,34
13913,Mclooving,runetotem,1604,hunter,survival,49,29,20
13914,Turdy,executus,1603,hunter,survival,82,45,37
13915,Жэш,howling-fjord,1602,hunter,survival,42,21,21
13916,Tiffanydoll,hyjal,1601,hunter,survival,54,30,24
13917,Сабакаа,borean-tundra,1600,hunter,survival,78,44,34
13918,Darllene,kazzak,1599,hunter,survival,101,46,55
13919,Dariusmm,silvermoon,1598,hunter,survival,58,32,26
13920,Твояпомощь,gordunni,1596,hunter,survival,24,17,7
13921,Noop,sylvanas,1596,hunter,survival,96,48,48
13922,Regale,archimonde,1595,hunter,survival,66,25,41
13923,Смолильщик,gordunni,1594,hunter,survival,69,36,33
13924,Hûntyhunt,silvermoon,1594,hunter,survival,42,21,21
13925,Calyssae,shattered-halls,1591,hunter,survival,99,58,41
13926,Ódelagga,sylvanas,1591,hunter,survival,123,66,57
13927,Løwg,drekthar,1590,hunter,survival,54,28,26
13928,Aspergun,ragnaros,1590,hunter,survival,46,22,24
13929,Оути,azuregos,1588,hunter,survival,138,76,62
13930,Стингергодх,gordunni,1587,hunter,survival,81,40,41
13931,Sznxøxo,ravencrest,1585,hunter,survival,42,24,18
13932,Xallis,outland,1582,hunter,survival,36,19,17
13933,Xelsera,antonidas,1580,hunter,survival,30,17,13
13934,Kydérr,aegwynn,1580,hunter,survival,42,20,22
13935,Tillhunt,kargath,1573,hunter,survival,87,50,37
13936,Свадебная,gordunni,1572,hunter,survival,148,78,70
13937,Zapzy,ravencrest,1570,hunter,survival,95,49,46
13938,Ilovejwrld,dun-modr,1569,hunter,survival,40,18,22
13939,Nemámponetí,drakthul,1568,hunter,survival,78,42,36
13940,Juniorm,kazzak,1568,hunter,survival,42,22,20
13941,Хантзер,howling-fjord,1568,hunter,survival,86,42,44
13942,Миаур,gordunni,1567,hunter,survival,60,27,33
13943,Suzumebachi,twisting-nether,1562,hunter,survival,54,34,20
13944,Zeer,sylvanas,1562,hunter,survival,159,73,86
13945,Cenesthesia,draenor,1560,hunter,survival,70,39,31
13946,Виралатта,gordunni,1558,hunter,survival,42,23,19
13947,Ázurâ,blackhand,1557,hunter,survival,151,73,78
13948,Doraxa,sanguino,1557,hunter,survival,39,17,22
13949,Bren,shattrath,1554,hunter,survival,73,36,37
13950,Zacxx,ravencrest,1551,hunter,survival,53,37,16
13951,Ðarrk,tarren-mill,1551,hunter,survival,66,35,31
13952,Rettoo,aszune,1550,hunter,survival,42,25,17
13953,Westcøãst,archimonde,1550,hunter,survival,54,32,22
13954,Ðrãke,blackmoore,1550,hunter,survival,54,30,24
13955,Âmalphy,ravencrest,1549,hunter,survival,42,17,25
13956,Танчибосс,soulflayer,1547,hunter,survival,121,60,61
13957,Rizlay,the-maelstrom,1546,hunter,survival,78,37,41
13958,Пистоглазка,howling-fjord,1544,hunter,survival,29,18,11
13959,Neyv,blackmoore,1542,hunter,survival,33,18,15
13960,Shotazz,frostmane,1541,hunter,survival,30,17,13
13961,Ищименявтени,gordunni,1540,hunter,survival,77,40,37
13962,Wikariusz,kazzak,1540,hunter,survival,66,27,39
13963,Capd,kazzak,1538,hunter,survival,71,39,32
13964,Knoxblå,stormscale,1533,hunter,survival,24,16,8
13965,Horxxa,kul-tiras,1531,hunter,survival,84,51,33
13966,Bnak,thrall,1530,hunter,survival,24,16,8
13967,Skzu,archimonde,1529,hunter,survival,30,20,10
13968,Lottemor,tarren-mill,1528,hunter,survival,47,32,15
13969,Garxzhunter,tarren-mill,1528,hunter,survival,30,16,14
13970,Sphexya,ravencrest,1528,hunter,survival,30,16,14
13971,Horku,kazzak,1528,hunter,survival,36,16,20
13972,Errowini,blackmoore,1525,hunter,survival,24,16,8
13973,Глаззалмаз,howling-fjord,1519,hunter,survival,34,21,13
13974,Bittercoast,stormscale,1518,hunter,survival,29,16,13
13975,Outofcontrol,karazhan,1515,hunter,survival,30,17,13
13976,Raztreadör,dun-modr,1514,hunter,survival,299,153,146
13977,Capullospawn,dun-morogh,1513,hunter,survival,36,21,15
13978,Jakis,silvermoon,1513,hunter,survival,35,17,18
13979,Dedral,aegwynn,1509,hunter,survival,30,16,14
13980,Robinbuds,stormscale,1508,hunter,survival,46,25,21
13981,Iòvól,azuremyst,1507,hunter,survival,84,44,40
13982,Jailevaccin,khaz-modan,1505,hunter,survival,121,58,63
13983,Китас,soulflayer,1504,hunter,survival,153,90,63
13984,Næ,kazzak,1504,hunter,survival,103,55,48
13985,Fmatzen,the-maelstrom,1503,hunter,survival,30,16,14
13986,Молеандрис,gordunni,1503,hunter,survival,81,41,40
13987,Clicktrap,runetotem,1503,hunter,survival,38,17,21
13988,Blvckjvckz,ravencrest,1500,hunter,survival,30,16,14
13989,Badboyxoxo,stormscale,1497,hunter,survival,48,35,13
13990,Галятрицепс,eversong,1494,hunter,survival,38,19,19
13991,Clicker,runetotem,1494,hunter,survival,60,28,32
13992,Вандамос,soulflayer,1492,hunter,survival,103,57,46
13993,Sayn,la-croisade-écarlate,1488,hunter,survival,56,30,26
13994,Hakkoti,argent-dawn,1486,hunter,survival,66,33,33
13995,Jeddaj,stormscale,1485,hunter,survival,66,32,34
13996,Huntiika,silvermoon,1484,hunter,survival,76,37,39
13997,Riema,ragnaros,1483,hunter,survival,76,34,42
13998,Andjelaa,kazzak,1482,hunter,survival,36,18,18
13999,Чужойй,howling-fjord,1478,hunter,survival,54,28,26
14000,Deathwallker,silvermoon,1473,hunter,survival,63,42,21
14001,Штынь,gordunni,1471,hunter,survival,36,17,19
14002,Hreo,twisting-nether,1470,hunter,survival,60,30,30
14003,Комомура,soulflayer,1467,hunter,survival,65,34,31
14004,Killitoss,blackmoore,1466,hunter,survival,54,26,28
14005,Óneshóter,madmortem,1465,hunter,survival,36,21,15
14006,Melissax,silvermoon,1464,hunter,survival,40,17,23
14007,Яшатаю,soulflayer,1463,hunter,survival,39,26,13
14008,Jäegr,hyjal,1462,hunter,survival,42,22,20
14009,Vâleriaa,blackrock,1460,hunter,survival,90,43,47
14010,Xhn,stormscale,1460,hunter,survival,48,18,30
14011,Frapt,dalaran,1459,hunter,survival,28,16,12
14012,Boggy,outland,1453,hunter,survival,47,26,21
14013,Psychotik,stormreaver,1451,hunter,survival,166,83,83
14014,Atalnta,ravencrest,1451,hunter,survival,69,28,41
14015,Pentaboule,archimonde,1448,hunter,survival,120,64,56
14016,Nalys,argent-dawn,1447,hunter,survival,70,39,31
14017,Варкраб,blackscar,1446,hunter,survival,36,16,20
14018,Makeawish,antonidas,1444,hunter,survival,64,37,27
14019,Olk,stormscale,1439,hunter,survival,24,15,9
14020,Islide,ravencrest,1438,hunter,survival,36,15,21
14021,Хитвейн,gordunni,1438,hunter,survival,54,22,32
14022,Blackwarz,la-croisade-écarlate,1437,hunter,survival,30,21,9
14023,Блатнайт,blackscar,1436,hunter,survival,25,15,10
14024,Huntsmart,kazzak,1432,hunter,survival,30,15,15
14025,Zinà,naxxramas,1429,hunter,survival,34,19,15
14026,Каморан,grom,1427,hunter,survival,30,16,14
14027,Dorota,auchindoun,1426,hunter,survival,36,19,17
14028,Гаррельд,blackscar,1426,hunter,survival,36,18,18
14029,Kalani,la-croisade-écarlate,1426,hunter,survival,137,65,72
14030,Тэуреэль,gordunni,1426,hunter,survival,66,26,40
14031,Flappypig,stormscale,1424,hunter,survival,24,15,9
14032,Headhunterrz,burning-legion,1424,hunter,survival,48,24,24
14033,Vengefull,draenor,1421,hunter,survival,162,84,78
14034,Shibai,outland,1420,hunter,survival,65,31,34
14035,Crème,blackrock,1419,hunter,survival,83,36,47
14036,Coromant,blackrock,1417,hunter,survival,32,15,17
14037,Torelk,dalaran,1416,hunter,survival,36,17,19
14038,Hoffen,dentarg,1414,hunter,survival,24,18,6
14039,Notikâ,aegwynn,1414,hunter,survival,102,50,52
14040,Artemisïa,archimonde,1414,hunter,survival,42,17,25
14041,Tyrone,saurfang,1410,hunter,survival,42,17,25
14042,Kürze,silvermoon,1409,hunter,survival,58,27,31
14043,Arykes,drakthul,1409,hunter,survival,59,27,32
14044,Шадак,soulflayer,1405,hunter,survival,47,24,23
14045,Taurïel,stormscale,1404,hunter,survival,85,46,39
14046,Крэин,howling-fjord,1403,hunter,survival,54,27,27
14047,Oggi,draenor,1402,hunter,survival,60,29,31
14048,Shoty,zuluhed,1402,hunter,survival,106,50,56
14049,Survsen,kazzak,1399,hunter,survival,78,38,40
14050,Рэдхаант,soulflayer,1397,hunter,survival,56,23,33
14051,Feignindeath,twisting-nether,1396,hunter,survival,38,23,15
14052,Живучийорех,gordunni,1394,hunter,survival,24,15,9
14053,Ballistix,elune,1394,hunter,survival,30,15,15
14054,Sívér,antonidas,1393,hunter,survival,42,16,26
14055,Кфоззи,soulflayer,1391,hunter,survival,30,15,15
14056,Moralisa,eredar,1390,hunter,survival,35,17,18
14057,Itchy,das-syndikat,1387,hunter,survival,57,28,29
14058,Bigbababotan,blackrock,1384,hunter,survival,44,27,17
14059,Eufumo,sanguino,1384,hunter,survival,29,16,13
14060,Wastage,draenor,1383,hunter,survival,54,26,28
14061,Кир,blackscar,1378,hunter,survival,54,31,23
14062,Ajko,blackmoore,1378,hunter,survival,60,33,27
14063,Milééna,ravencrest,1375,hunter,survival,65,27,38
14064,Сильвиина,eversong,1372,hunter,survival,36,17,19
14065,Йинги,gordunni,1371,hunter,survival,77,40,37
14066,Heliandra,dun-modr,1370,hunter,survival,30,17,13
14067,Jónes,dunemaul,1370,hunter,survival,36,16,20
14068,Hunttes,nagrand,1365,hunter,survival,29,15,14
14069,Twitche,ravencrest,1365,hunter,survival,36,15,21
14070,Shootingu,aegwynn,1364,hunter,survival,96,49,47
14071,Ðoñko,hyjal,1363,hunter,survival,156,74,82
14072,Rolky,silvermoon,1360,hunter,survival,30,16,14
14073,Suxino,doomhammer,1360,hunter,survival,94,43,51
14074,Zwerghauer,arthas,1358,hunter,survival,30,17,13
14075,Dîdierraoult,archimonde,1358,hunter,survival,29,15,14
14076,Стивстифлер,razuvious,1357,hunter,survival,60,33,27
14077,Мандалорецц,soulflayer,1356,hunter,survival,92,44,48
14078,Röwene,argent-dawn,1355,hunter,survival,44,24,20
14079,Torrë,sanguino,1355,hunter,survival,55,26,29
14080,Santiägø,archimonde,1353,hunter,survival,54,30,24
14081,Abovival,ragnaros,1349,hunter,survival,30,20,10
14082,Skyyw,tarren-mill,1348,hunter,survival,62,34,28
14083,Zaphody,doomhammer,1346,hunter,survival,63,32,31
14084,Icetrapped,eredar,1341,hunter,survival,30,14,16
14085,Ðévi,ravencrest,1340,hunter,survival,18,14,4
14086,Xaone,blackrock,1340,hunter,survival,18,14,4
14087,Айхана,gordunni,1337,hunter,survival,53,30,23
14088,Snôptas,blackmoore,1337,hunter,survival,32,15,17
14089,Satantrapbot,outland,1337,hunter,survival,30,14,16
14090,Подлыйстарик,gordunni,1336,hunter,survival,49,34,15
14091,Jalcer,draenor,1334,hunter,survival,56,25,31
14092,Janoh,dalaran,1332,hunter,survival,24,14,10
14093,Анариэльсин,soulflayer,1332,hunter,survival,60,27,33
14094,Sasquaczek,burning-legion,1328,hunter,survival,42,24,18
14095,Jamalinho,silvermoon,1322,hunter,survival,60,38,22
14096,Карвинн,soulflayer,1321,hunter,survival,30,14,16
14097,Spitchy,kazzak,1320,hunter,survival,42,23,19
14098,Zehned,ysondre,1316,hunter,survival,57,25,32
14099,Ниалла,thermaplugg,1316,hunter,survival,48,19,29
14100,Slagatronic,ragnaros,1314,hunter,survival,108,57,51
14101,Malgorn,burning-legion,1313,hunter,survival,46,29,17
14102,Занзуолли,howling-fjord,1309,hunter,survival,66,32,34
14103,Gakco,twisting-nether,1308,hunter,survival,36,20,16
14104,Littlhuntard,tarren-mill,1306,hunter,survival,24,14,10
14105,Пятницкий,soulflayer,1304,hunter,survival,33,17,16
14106,Dhmain,frostmane,1304,hunter,survival,45,18,27
14107,Ilørell,archimonde,1303,hunter,survival,36,15,21
14108,Karabeg,twisting-nether,1301,hunter,survival,53,22,31
14109,Kobayashi,arathor,1300,hunter,survival,101,45,56
14110,Thëoden,cthun,1298,hunter,survival,30,16,14
14111,Steezowl,kazzak,1297,hunter,survival,47,20,27
14112,Prodanhunts,frostmane,1296,hunter,survival,30,14,16
14113,Wôôdsy,blackrock,1291,hunter,survival,30,14,16
14114,Sarttrap,aerie-peak,1289,hunter,survival,24,14,10
14115,Cásper,tarren-mill,1288,hunter,survival,54,27,27
14116,Bigmøist,ravencrest,1287,hunter,survival,80,38,42
14117,Kasperle,frostwolf,1281,hunter,survival,24,14,10
14118,Фурболгов,gordunni,1278,hunter,survival,66,30,36
14119,Барабаша,deathguard,1278,hunter,survival,40,15,25
14120,Daweí,draenor,1275,hunter,survival,40,15,25
14121,Trapfish,dalaran,1265,hunter,survival,84,42,42
14122,Nith,ungoro,1263,hunter,survival,42,22,20
14123,Nvukaze,argent-dawn,1262,hunter,survival,33,22,11
14124,Ägris,die-todeskrallen,1255,hunter,survival,90,47,43
14125,Jomoguin,stormscale,1255,hunter,survival,54,27,27
14126,Куджикс,soulflayer,1248,hunter,survival,18,13,5
14127,Zudith,sanguino,1248,hunter,survival,24,14,10
14128,Xxø,ravencrest,1248,hunter,survival,24,13,11
14129,Tortillia,madmortem,1248,hunter,survival,87,38,49
14130,Petshøp,outland,1247,hunter,survival,18,13,5
14131,Kurdo,outland,1247,hunter,survival,24,13,11
14132,Getsniffarn,sylvanas,1247,hunter,survival,42,20,22
14133,Jumong,ragnaros,1246,hunter,survival,24,13,11
14134,Khodii,aegwynn,1245,hunter,survival,18,13,5
14135,Caelas,outland,1245,hunter,survival,36,17,19
14136,Foxyfoxo,guldan,1245,hunter,survival,41,19,22
14137,Vargar,arygos,1245,hunter,survival,30,13,17
14138,Guanchin,silvermoon,1245,hunter,survival,42,16,26
14139,Thalanos,antonidas,1243,hunter,survival,30,13,17
14140,Paxiwtf,eredar,1242,hunter,survival,22,14,8
14141,Oczkuhne,burning-legion,1241,hunter,survival,24,13,11
14142,Morkahs,dalaran,1240,hunter,survival,24,13,11
14143,Bicepspump,dun-morogh,1240,hunter,survival,30,13,17
14144,Lilsnuss,outland,1239,hunter,survival,18,13,5
14145,Wuad,silvermoon,1239,hunter,survival,24,13,11
14146,ßlackjack,thrall,1237,hunter,survival,18,13,5
14147,Junglez,nagrand,1232,hunter,survival,30,16,14
14148,Критпояйцам,howling-fjord,1230,hunter,survival,23,15,8
14149,Huntanova,antonidas,1226,hunter,survival,30,13,17
14150,Mcgloebels,archimonde,1225,hunter,survival,27,14,13
14151,Bowmasterjay,kazzak,1221,hunter,survival,24,13,11
14152,Herubin,doomhammer,1220,hunter,survival,63,29,34
14153,Тике,soulflayer,1215,hunter,survival,38,19,19
14154,Vorsord,zuljin,1209,hunter,survival,30,13,17
14155,Waziralwazar,auchindoun,1207,hunter,survival,28,13,15
14156,Bloodxx,ragnaros,1201,hunter,survival,72,33,39
14157,Sainttcc,thrall,1195,hunter,survival,60,28,32
14158,Согекхей,gordunni,1192,hunter,survival,48,13,35
14159,Kazzaak,kazzak,1188,hunter,survival,72,26,46
14160,Illnysa,silvermoon,1187,hunter,survival,23,13,10
14161,Binhoker,argent-dawn,1173,hunter,survival,18,13,5
14162,Doru,silvermoon,1162,hunter,survival,60,29,31
14163,Ketaminösa,zuljin,1151,hunter,survival,18,12,6
14164,Jäinenool,outland,1151,hunter,survival,24,12,12
14165,Ähäkutti,kazzak,1151,hunter,survival,30,12,18
14166,Erhu,drakthul,1150,hunter,survival,18,12,6
14167,Nkl,archimonde,1150,hunter,survival,24,12,12
14168,Alwaysthug,ravencrest,1150,hunter,survival,30,12,18
14169,Natchell,ysondre,1148,hunter,survival,24,12,12
14170,Nevêrse,archimonde,1147,hunter,survival,24,12,12
14171,Terrorduni,tarren-mill,1147,hunter,survival,30,12,18
14172,Звериныйпапа,gordunni,1146,hunter,survival,24,12,12
14173,Äzul,ysondre,1142,hunter,survival,27,13,14
14174,Мертвыйпсарь,soulflayer,1142,hunter,survival,40,17,23
14175,Såvëâmäzøñíà,stormscale,1142,hunter,survival,30,12,18
14176,Akasa,twilights-hammer,1142,hunter,survival,30,12,18
14177,Kaynor,dalaran,1141,hunter,survival,24,12,12
14178,Gilzog,exodar,1138,hunter,survival,30,12,18
14179,Cabaim,eredar,1137,hunter,survival,18,12,6
14180,Autoturret,eredar,1130,hunter,survival,30,12,18
14181,Floris,outland,1126,hunter,survival,24,12,12
14182,Cämper,aegwynn,1124,hunter,survival,24,12,12
14183,Leemool,ysondre,1123,hunter,survival,30,18,12
14184,Fãdê,ravencrest,1118,hunter,survival,20,13,7
14185,Ashablack,argent-dawn,1118,hunter,survival,119,55,64
14186,Bâng,zuljin,1117,hunter,survival,24,12,12
14187,Inter,hellscream,1117,hunter,survival,32,13,19
14188,Бандерака,goldrinn,1115,hunter,survival,24,12,12
14189,Hännibal,nazjatar,1114,hunter,survival,23,12,11
14190,Absolutnoob,blackrock,1103,hunter,survival,56,28,28
14191,Milandra,the-maelstrom,1101,hunter,survival,42,20,22
14192,Apachy,amanthul,1100,hunter,survival,29,12,17
14193,Sláyer,the-shatar,1099,hunter,survival,58,28,30
14194,Harrak,ysondre,1098,hunter,survival,18,12,6
14195,Aszasi,azjolnerub,1096,hunter,survival,23,12,11
14196,Bairex,magtheridon,1090,hunter,survival,42,23,19
14197,Himba,dentarg,1088,hunter,survival,36,18,18
14198,Spliinter,twisting-nether,1086,hunter,survival,28,17,11
14199,Dragonflayer,sylvanas,1083,hunter,survival,24,13,11
14200,Yinn,kilrogg,1074,hunter,survival,42,15,27
14201,Pôîson,kazzak,1070,hunter,survival,94,39,55
14202,Speedymarieh,argent-dawn,1056,hunter,survival,18,11,7
14203,Djsecousse,hyjal,1056,hunter,survival,18,11,7
14204,Guccyfied,blackrock,1056,hunter,survival,18,11,7
14205,Lutza,sanguino,1056,hunter,survival,24,11,13
14206,Chrønôs,archimonde,1055,hunter,survival,18,11,7
14207,Djtrápálót,dragonmaw,1055,hunter,survival,18,11,7
14208,Ранкон,lich-king,1055,hunter,survival,24,11,13
14209,Síraw,tarren-mill,1055,hunter,survival,30,11,19
14210,Éddiémórphín,kazzak,1053,hunter,survival,24,11,13
14211,Ayshæ,tarren-mill,1053,hunter,survival,66,23,43
14212,Cataleýà,outland,1052,hunter,survival,18,11,7
14213,Kabedon,drakthul,1049,hunter,survival,24,11,13
14214,Pyrep,draenor,1048,hunter,survival,18,11,7
14215,Didzon,ravencrest,1045,hunter,survival,18,11,7
14216,Querro,azshara,1036,hunter,survival,42,11,31
14217,Agarez,blackrock,1026,hunter,survival,36,16,20
14218,Szybky,defias-brotherhood,1017,hunter,survival,18,11,7
14219,Voltár,antonidas,1017,hunter,survival,30,11,19
14220,Roacher,hyjal,1011,hunter,survival,29,11,18
14221,Giobi,draenor,996,hunter,survival,24,13,11
14222,Hotgrillexde,sylvanas,990,hunter,survival,23,11,12
14223,Animàl,argent-dawn,988,hunter,survival,22,11,11
14224,Huntoruu,outland,983,hunter,survival,113,48,65
14225,Änubïs,culte-de-la-rive-noire,973,hunter,survival,28,12,16
14226,Крысюкпифпаф,blackscar,971,hunter,survival,19,11,8
14227,Tayu,throkferoth,960,hunter,survival,12,10,2
14228,Reviam,ravencrest,960,hunter,survival,12,10,2
14229,Аминотоксид,blackscar,960,hunter,survival,12,10,2
14230,Vincex,ravencrest,960,hunter,survival,18,10,8
14231,Мигнитюша,blackscar,960,hunter,survival,18,10,8
14232,Hiddenstalke,argent-dawn,960,hunter,survival,18,10,8
14233,Neddly,draenor,960,hunter,survival,24,10,14
14234,Nayeem,silvermoon,959,hunter,survival,12,10,2
14235,Смертонносна,lich-king,959,hunter,survival,12,10,2
14236,Tomasínos,drakthul,959,hunter,survival,18,10,8
14237,Nttcoopzz,silvermoon,959,hunter,survival,18,10,8
14238,Cadier,argent-dawn,959,hunter,survival,24,10,14
14239,Fiskerr,darksorrow,959,hunter,survival,24,10,14
14240,Mógwaí,stormscale,958,hunter,survival,18,10,8
14241,Менстряк,deathguard,958,hunter,survival,18,10,8
14242,Элфй,gordunni,956,hunter,survival,18,10,8
14243,Starkt,ragnaros,956,hunter,survival,24,10,14
14244,Whyareurunin,silvermoon,953,hunter,survival,30,10,20
14245,Memli,uldaman,950,hunter,survival,18,10,8
14246,Marluxiâ,archimonde,947,hunter,survival,30,11,19
14247,Kinaou,sargeras,944,hunter,survival,18,10,8
14248,Zipzâp,blackrock,936,hunter,survival,18,10,8
14249,Neilime,marécage-de-zangar,936,hunter,survival,74,33,41
14250,Akibane,blackmoore,925,hunter,survival,20,11,9
14251,Pechvogel,blackmoore,910,hunter,survival,17,10,7
14252,Otekkâ,hyjal,894,hunter,survival,23,10,13
14253,Bláckheart,doomhammer,888,hunter,survival,22,10,12
14254,Ирртой,grom,885,hunter,survival,24,10,14
14255,Urrane,archimonde,864,hunter,survival,12,9,3
14256,Crøxx,archimonde,864,hunter,survival,12,9,3
14257,Mahikotwo,arathor,864,hunter,survival,12,9,3
14258,Dribla,blackhand,864,hunter,survival,12,9,3
14259,Mortybeans,ravencrest,864,hunter,survival,18,9,9
14260,Agnêas,silvermoon,864,hunter,survival,18,9,9
14261,Bùddhíst,ravencrest,864,hunter,survival,18,9,9
14262,Xlít,outland,864,hunter,survival,18,9,9
14263,Nooksem,blackrock,864,hunter,survival,18,9,9
14264,Vexxed,thrall,863,hunter,survival,12,9,3
14265,Shøt,stormreaver,863,hunter,survival,12,9,3
14266,Murkek,drakthul,863,hunter,survival,12,9,3
14267,Mileysaures,stormscale,863,hunter,survival,12,9,3
14268,Kayhh,stormscale,863,hunter,survival,12,9,3
14269,Kapitannapas,deathwing,863,hunter,survival,18,9,9
14270,Zion,kul-tiras,863,hunter,survival,18,9,9
14271,Kirax,ravencrest,863,hunter,survival,21,10,11
14272,Ashendan,silvermoon,863,hunter,survival,24,9,15
14273,Тиометра,gordunni,862,hunter,survival,12,9,3
14274,Skumrask,outland,862,hunter,survival,24,9,15
14275,Rollin,khaz-modan,861,hunter,survival,12,9,3
14276,Вилдфлекс,gordunni,861,hunter,survival,12,9,3
14277,Fluffiis,twisting-nether,861,hunter,survival,12,9,3
14278,Tôm,ravencrest,860,hunter,survival,12,9,3
14279,Пивпавнах,gordunni,859,hunter,survival,12,9,3
14280,Raenard,ragnaros,858,hunter,survival,21,10,11
14281,Orcpie,defias-brotherhood,856,hunter,survival,18,9,9
14282,Cliff,kiljaeden,852,hunter,survival,24,9,15
14283,Beaupapa,archimonde,846,hunter,survival,18,9,9
14284,Killdembro,sunstrider,835,hunter,survival,102,31,71
14285,Abeji,malygos,830,hunter,survival,23,9,14
14286,Chillibetv,blackrock,829,hunter,survival,22,10,12
14287,Reenacer,dun-modr,826,hunter,survival,30,10,20
14288,Powerhord,burning-legion,794,hunter,survival,23,9,14
14289,Drolig,blackmoore,793,hunter,survival,17,9,8
14290,Velen,pozzo-delleternità,768,hunter,survival,12,8,4
14291,Techpoint,silvermoon,768,hunter,survival,12,8,4
14292,Jaggy,hyjal,768,hunter,survival,12,8,4
14293,Poggersdaddy,kazzak,768,hunter,survival,12,8,4
14294,Bawzé,archimonde,768,hunter,survival,12,8,4
14295,Djfortnite,ravencrest,768,hunter,survival,12,8,4
14296,Gurrmex,stormscale,768,hunter,survival,12,8,4
14297,Патчхороший,howling-fjord,768,hunter,survival,12,8,4
14298,Maiver,ravencrest,768,hunter,survival,12,8,4
14299,Фираналь,blackscar,768,hunter,survival,18,8,10
14300,Трапавграунд,howling-fjord,768,hunter,survival,18,8,10
14301,Bø,burning-blade,768,hunter,survival,18,8,10
14302,Пьёт,gordunni,768,hunter,survival,18,8,10
14303,Epicsurvive,kazzak,768,hunter,survival,24,8,16
14304,Тиандриса,soulflayer,767,hunter,survival,12,8,4
14305,Øpedro,kirin-tor,767,hunter,survival,12,8,4
14306,Luftikuss,arthas,767,hunter,survival,12,8,4
14307,Nokti,die-ewige-wacht,767,hunter,survival,12,8,4
14308,Double,sylvanas,767,hunter,survival,18,8,10
14309,Zuggander,ravencrest,767,hunter,survival,18,8,10
14310,Arnakua,outland,767,hunter,survival,18,8,10
14311,Abeba,grim-batol,767,hunter,survival,18,8,10
14312,Борькабритва,soulflayer,767,hunter,survival,18,8,10
14313,Вуйчеч,howling-fjord,766,hunter,survival,24,8,16
14314,Harmonía,outland,764,hunter,survival,24,8,16
14315,Eledanu,blackmoore,762,hunter,survival,12,8,4
14316,Риппер,gordunni,762,hunter,survival,24,8,16
14317,Хантероо,gordunni,756,hunter,survival,18,8,10
14318,Thëhunter,tyrande,749,hunter,survival,17,8,9
14319,Hanibale,burning-blade,740,hunter,survival,31,8,23
14320,Оверман,azuregos,735,hunter,survival,26,9,17
14321,Hyparion,kazzak,719,hunter,survival,17,8,9
14322,Ватмано,gordunni,718,hunter,survival,11,8,3
14323,Focüs,les-sentinelles,703,hunter,survival,20,8,12
14324,Reefa,the-maelstrom,702,hunter,survival,11,8,3
14325,Dexx,kazzak,698,hunter,survival,17,9,8
14326,Алекскиллшот,blackscar,672,hunter,survival,12,7,5
14327,Dauria,blackhand,672,hunter,survival,12,7,5
14328,Laptopplayër,ravencrest,672,hunter,survival,12,7,5
14329,Tomorrow,ravencrest,672,hunter,survival,12,7,5
14330,Trappewpew,blackmoore,672,hunter,survival,12,7,5
14331,Amadia,defias-brotherhood,672,hunter,survival,12,7,5
14332,Nulles,ravencrest,672,hunter,survival,12,7,5
14333,Merquryh,ravencrest,672,hunter,survival,12,7,5
14334,Motri,tarren-mill,672,hunter,survival,12,7,5
14335,Buoma,kazzak,672,hunter,survival,12,7,5
14336,Burninghunt,ravencrest,672,hunter,survival,12,7,5
14337,Davidghettô,dalaran,672,hunter,survival,12,7,5
14338,Волкорн,gordunni,672,hunter,survival,12,7,5
14339,Трапгодикс,eversong,672,hunter,survival,12,7,5
14340,Ilovemax,archimonde,672,hunter,survival,12,7,5
14341,Норапина,eversong,672,hunter,survival,33,15,18
14342,Avashah,ravencrest,672,hunter,survival,16,7,9
14343,Niro,argent-dawn,672,hunter,survival,18,7,11
14344,Wórldz,dun-modr,672,hunter,survival,18,7,11
14345,Aspects,blackrock,672,hunter,survival,18,7,11
14346,Mahikosan,outland,672,hunter,survival,18,7,11
14347,Oldlynx,ravencrest,671,hunter,survival,12,7,5
14348,Fyoni,silvermoon,671,hunter,survival,12,7,5
14349,Kissnodig,outland,671,hunter,survival,12,7,5
14350,Flamehand,kazzak,671,hunter,survival,12,7,5
14351,Алестея,gordunni,671,hunter,survival,18,7,11
14352,Shanndu,ravencrest,671,hunter,survival,18,7,11
14353,Madtony,aegwynn,671,hunter,survival,18,7,11
14354,Koblih,draenor,671,hunter,survival,30,7,23
14355,Blackox,zirkel-des-cenarius,670,hunter,survival,12,7,5
14356,Renegansnipe,silvermoon,670,hunter,survival,18,7,11
14357,Panfilmaaj,burning-legion,670,hunter,survival,19,7,12
14358,Karasana,earthen-ring,669,hunter,survival,24,7,17
14359,Санясурв,gordunni,665,hunter,survival,25,12,13
14360,Mahemi,mazrigos,664,hunter,survival,30,7,23
14361,Skyythe,dun-morogh,649,hunter,survival,18,7,11
14362,Bowkeeper,kazzak,642,hunter,survival,24,7,17
14363,Daiking,pozzo-delleternità,639,hunter,survival,22,7,15
14364,Iendx,silvermoon,623,hunter,survival,11,7,4
14365,Beersalma,arathor,623,hunter,survival,11,7,4
14366,Bugspitz,outland,622,hunter,survival,11,7,4
14367,Хищник,gordunni,622,hunter,survival,14,8,6
14368,Onefatalshot,the-maelstrom,617,hunter,survival,14,8,6
14369,Shanè,blackrock,603,hunter,survival,20,7,13
14370,Iloveluna,silvermoon,576,hunter,survival,6,6,0
14371,Gitanìlla,dun-modr,576,hunter,survival,6,6,0
14372,Adefthunt,kazzak,576,hunter,survival,6,6,0
14373,Haileyjones,darkmoon-faire,576,hunter,survival,6,6,0
14374,Ernorx,stormscale,576,hunter,survival,6,6,0
14375,Alissón,aegwynn,576,hunter,survival,6,6,0
14376,Ревирин,gordunni,576,hunter,survival,6,6,0
14377,Uranîa,blackmoore,576,hunter,survival,12,6,6
14378,Alibigjungle,ravencrest,576,hunter,survival,12,6,6
14379,Snoude,silvermoon,576,hunter,survival,12,6,6
14380,Nobuno,dun-modr,576,hunter,survival,12,6,6
14381,Schwabbels,silvermoon,576,hunter,survival,12,6,6
14382,Zøøkëëper,silvermoon,576,hunter,survival,12,6,6
14383,Anupephu,stormscale,576,hunter,survival,12,6,6
14384,Kuzes,ravencrest,576,hunter,survival,12,6,6
14385,Lightxyz,ravencrest,576,hunter,survival,12,6,6
14386,Maddoqx,frostwolf,576,hunter,survival,12,6,6
14387,Nunziatellà,nemesis,576,hunter,survival,12,6,6
14388,Bicmeks,ravencrest,576,hunter,survival,12,6,6
14389,Huntaro,blackmoore,576,hunter,survival,12,6,6
14390,Weraxo,ravencrest,576,hunter,survival,12,6,6
14391,Yezzu,sylvanas,576,hunter,survival,12,6,6
14392,Mouganstine,archimonde,576,hunter,survival,12,6,6
14393,Scarletgirl,draenor,576,hunter,survival,12,6,6
14394,Seandeluxe,defias-brotherhood,576,hunter,survival,12,6,6
14395,Milkyway,jaedenar,576,hunter,survival,12,6,6
14396,Дарктеххно,howling-fjord,576,hunter,survival,12,6,6
14397,Sneakyshot,nemesis,576,hunter,survival,12,6,6
14398,Ямилигодц,soulflayer,576,hunter,survival,12,6,6
14399,Reelgigachad,archimonde,576,hunter,survival,12,6,6
14400,Isøbu,hyjal,576,hunter,survival,12,6,6
14401,Psghunt,argent-dawn,576,hunter,survival,12,6,6
14402,Jamoneame,sanguino,576,hunter,survival,12,6,6
14403,Уроборос,gordunni,576,hunter,survival,12,6,6
14404,Nirn,ravencrest,576,hunter,survival,12,6,6
14405,Crapulegangz,archimonde,576,hunter,survival,12,6,6
14406,Куджикс,gordunni,576,hunter,survival,20,7,13
14407,Lucrecius,magtheridon,575,hunter,survival,12,6,6
14408,Hevl,silvermoon,575,hunter,survival,12,6,6
14409,Pãstèque,ravencrest,575,hunter,survival,12,6,6
14410,Grimazg,chogall,575,hunter,survival,12,6,6
14411,Broomyuk,kilrogg,575,hunter,survival,12,6,6
14412,Йеттеринг,deathweaver,575,hunter,survival,15,7,8
14413,Дондонандон,gordunni,575,hunter,survival,18,6,12
14414,Enistee,silvermoon,575,hunter,survival,18,6,12
14415,Girlfwiend,argent-dawn,575,hunter,survival,18,6,12
14416,Sekkeh,ragnaros,575,hunter,survival,18,6,12
14417,Amjamh,hyjal,575,hunter,survival,18,6,12
14418,Bôbby,kelthuzad,575,hunter,survival,18,6,12
14419,Jwishrankone,outland,574,hunter,survival,12,6,6
14420,Mufassa,sinstralis,574,hunter,survival,12,6,6
14421,Васябицепс,howling-fjord,574,hunter,survival,18,6,12
14422,Vuloshi,twisting-nether,573,hunter,survival,18,6,12
14423,Mâjôô,blackhand,544,hunter,survival,10,6,4
14424,Sumecxh,aegwynn,543,hunter,survival,11,6,5
14425,Боцекабузер,galakrond,543,hunter,survival,11,6,5
14426,Reðrighthånð,throkferoth,528,hunter,survival,9,6,3
14427,Yvenne,uldaman,525,hunter,survival,11,6,5
14428,Aequitaz,blackhand,511,hunter,survival,20,6,14
14429,Хантвкроксах,gordunni,496,hunter,survival,13,6,7
14430,Dheredre,silvermoon,480,hunter,survival,6,5,1
14431,Smellygroin,darksorrow,480,hunter,survival,6,5,1
14432,Deek,ysera,480,hunter,survival,6,5,1
14433,Lísy,hyjal,480,hunter,survival,6,5,1
14434,Musen,draenor,480,hunter,survival,6,5,1
14435,Silverlaine,quelthalas,480,hunter,survival,6,5,1
14436,Alohunt,archimonde,480,hunter,survival,6,5,1
14437,Spirys,drakthul,480,hunter,survival,6,5,1
14438,Glama,archimonde,480,hunter,survival,6,5,1
14439,Zybxd,drakthul,480,hunter,survival,6,5,1
14440,Забзаб,soulflayer,480,hunter,survival,6,5,1
14441,Jelibon,ragnaros,480,hunter,survival,6,5,1
14442,Sebikh,ravencrest,480,hunter,survival,6,5,1
14443,Intensivigel,blackmoore,480,hunter,survival,6,5,1
14444,Vilopez,arthas,480,hunter,survival,6,5,1
14445,Mòzetónq,ravencrest,480,hunter,survival,6,5,1
14446,Oof,lightnings-blade,480,hunter,survival,12,5,7
14447,Мэйвиан,gordunni,480,hunter,survival,12,5,7
14448,Эвилтар,soulflayer,480,hunter,survival,12,5,7
14449,Akyra,runetotem,480,hunter,survival,12,5,7
14450,Acefyre,sylvanas,480,hunter,survival,12,5,7
14451,Аскентр,gordunni,480,hunter,survival,12,5,7
14452,Vypaz,twisting-nether,480,hunter,survival,12,5,7
14453,Baconflips,ravencrest,480,hunter,survival,12,5,7
14454,Solotrap,kazzak,480,hunter,survival,12,5,7
14455,Discoråttan,stormscale,480,hunter,survival,12,5,7
14456,Hunterado,burning-legion,480,hunter,survival,12,5,7
14457,Grusijohn,executus,480,hunter,survival,12,5,7
14458,Gogolehunt,archimonde,480,hunter,survival,12,5,7
14459,Repap,defias-brotherhood,480,hunter,survival,12,5,7
14460,Unferth,the-venture-co,480,hunter,survival,12,5,7
14461,Doloresman,tarren-mill,480,hunter,survival,12,5,7
14462,Cyhi,ravencrest,480,hunter,survival,12,5,7
14463,Moscowmule,tarren-mill,480,hunter,survival,12,5,7
14464,Вкинулматрас,gordunni,480,hunter,survival,12,5,7
14465,Ðîe,ysondre,480,hunter,survival,12,5,7
14466,Mercpet,tarren-mill,480,hunter,survival,12,5,7
14467,Yakayoshi,kazzak,480,hunter,survival,12,5,7
14468,Coopatron,silvermoon,480,hunter,survival,12,5,7
14469,Snarer,argent-dawn,480,hunter,survival,12,5,7
14470,Djzntrap,outland,480,hunter,survival,12,5,7
14471,Ormassey,drakthul,480,hunter,survival,12,5,7
14472,Noneedtotrap,darksorrow,480,hunter,survival,12,5,7
14473,Caìuz,pozzo-delleternità,480,hunter,survival,12,5,7
14474,Beletor,medivh,480,hunter,survival,18,5,13
14475,Ector,silvermoon,480,hunter,survival,18,5,13
14476,Sharpeyezz,ravencrest,480,hunter,survival,18,5,13
14477,Дэнитрехо,soulflayer,480,hunter,survival,24,5,19
14478,Zireal,pozzo-delleternità,479,hunter,survival,6,5,1
14479,Yakx,dun-modr,479,hunter,survival,12,5,7
14480,Daltyr,ravencrest,479,hunter,survival,12,5,7
14481,Cazados,shendralar,479,hunter,survival,16,6,10
14482,Сногивкабину,soulflayer,479,hunter,survival,18,5,13
14483,Marvii,drakthul,479,hunter,survival,18,5,13
14484,Grufflin,bronzebeard,479,hunter,survival,18,5,13
14485,Jabela,eredar,447,hunter,survival,11,5,6
14486,Axiøs,thrall,431,hunter,survival,11,5,6
14487,Jeanpisse,hyjal,431,hunter,survival,11,5,6
14488,Azuren,twisting-nether,430,hunter,survival,11,5,6
14489,Nektard,ravencrest,425,hunter,survival,14,6,8
14490,Speartusk,blackhand,384,hunter,survival,6,4,2
14491,Antisober,ravencrest,384,hunter,survival,6,4,2
14492,Vazaî,ravencrest,384,hunter,survival,6,4,2
14493,Henario,ravencrest,384,hunter,survival,6,4,2
14494,Bubboo,dun-modr,384,hunter,survival,6,4,2
14495,Fyrya,ravencrest,384,hunter,survival,6,4,2
14496,Djurmästaren,ravencrest,384,hunter,survival,6,4,2
14497,Куфа,blackscar,384,hunter,survival,6,4,2
14498,Murotar,dalaran,384,hunter,survival,6,4,2
14499,Nazona,blackmoore,384,hunter,survival,6,4,2
14500,Rokmahr,stormscale,384,hunter,survival,6,4,2
14501,Ледо,deathguard,384,hunter,survival,6,4,2
14502,Giggiwho,malganis,384,hunter,survival,6,4,2
14503,Mooj,malganis,384,hunter,survival,6,4,2
14504,Eyvin,defias-brotherhood,384,hunter,survival,6,4,2
14505,Rynextwo,khaz-modan,384,hunter,survival,6,4,2
14506,Bièretrand,les-clairvoyants,384,hunter,survival,6,4,2
14507,Thresha,ravenholdt,384,hunter,survival,6,4,2
14508,Rheyl,dun-morogh,384,hunter,survival,6,4,2
14509,Tyràél,mugthol,384,hunter,survival,6,4,2
14510,Kàisèr,shendralar,384,hunter,survival,6,4,2
14511,Vádîazmeý,twisting-nether,384,hunter,survival,6,4,2
14512,Shenra,argent-dawn,384,hunter,survival,6,4,2
14513,Blhunt,magtheridon,384,hunter,survival,6,4,2
14514,Cinnè,frostwolf,384,hunter,survival,6,4,2
14515,Dumbfoundead,argent-dawn,384,hunter,survival,6,4,2
14516,Morgard,uldum,384,hunter,survival,6,4,2
14517,Jske,silvermoon,384,hunter,survival,6,4,2
14518,Nyxìa,shattered-halls,384,hunter,survival,6,4,2
14519,Youngbepse,blackrock,384,hunter,survival,6,4,2
14520,Virzion,silvermoon,384,hunter,survival,6,4,2
14521,Djøgi,archimonde,384,hunter,survival,6,4,2
14522,Nomorex,frostwhisper,384,hunter,survival,6,4,2
14523,Trapandstun,aszune,384,hunter,survival,6,4,2
14524,Tibaq,burning-legion,384,hunter,survival,6,4,2
14525,Shubou,silvermoon,384,hunter,survival,6,4,2
14526,Kleiar,dun-modr,384,hunter,survival,9,5,4
14527,Eâgleêyê,frostwolf,384,hunter,survival,12,4,8
14528,Fíwhale,tarren-mill,384,hunter,survival,12,4,8
14529,Хикази,soulflayer,384,hunter,survival,12,4,8
14530,Abgeherjoe,antonidas,384,hunter,survival,12,4,8
14531,Beaststeaks,thrall,384,hunter,survival,12,4,8
14532,Nillaxy,blackmoore,384,hunter,survival,12,4,8
14533,Nåzumaks,stormscale,384,hunter,survival,12,4,8
14534,Illuminate,laughing-skull,384,hunter,survival,12,4,8
14535,Magicnanø,nemesis,384,hunter,survival,12,4,8
14536,Florya,blackhand,384,hunter,survival,12,4,8
14537,Dzago,burning-legion,384,hunter,survival,12,4,8
14538,Helvetiya,sylvanas,384,hunter,survival,12,4,8
14539,Salie,argent-dawn,384,hunter,survival,12,4,8
14540,Headshotxd,ragnaros,384,hunter,survival,12,4,8
14541,Esperion,ragnaros,384,hunter,survival,12,4,8
14542,Wärft,arathi,384,hunter,survival,12,4,8
14543,Voldagor,hyjal,384,hunter,survival,12,4,8
14544,Dettas,silvermoon,384,hunter,survival,12,4,8
14545,Geevhunt,hyjal,384,hunter,survival,12,4,8
14546,Keinzira,hyjal,384,hunter,survival,18,4,14
14547,Døømslayer,nemesis,383,hunter,survival,6,4,2
14548,Platza,ragnaros,383,hunter,survival,12,4,8
14549,Vhaagarr,blackmoore,351,hunter,survival,11,4,7
14550,Ghob,kazzak,330,hunter,survival,8,5,3
14551,Эквинтия,soulflayer,319,hunter,survival,5,4,1
14552,Sùnzí,alakir,319,hunter,survival,6,4,2
14553,Джулибуба,howling-fjord,304,hunter,survival,7,4,3
14554,Velrhegal,tarren-mill,304,hunter,survival,13,4,9
14555,Naramir,ysondre,288,hunter,survival,6,3,3
14556,Psychadelic,chamber-of-aspects,288,hunter,survival,6,3,3
14557,Loading,garrosh,288,hunter,survival,6,3,3
14558,Himatoumi,elune,288,hunter,survival,6,3,3
14559,Fjarla,aegwynn,288,hunter,survival,6,3,3
14560,Neepal,archimonde,288,hunter,survival,6,3,3
14561,Unöhänä,archimonde,288,hunter,survival,6,3,3
14562,Марчик,blackscar,288,hunter,survival,6,3,3
14563,Hépheistos,kelthuzad,288,hunter,survival,6,3,3
14564,Natheldir,silvermoon,288,hunter,survival,6,3,3
14565,Kq,argent-dawn,288,hunter,survival,6,3,3
14566,Assaultrifle,frostmane,288,hunter,survival,6,3,3
14567,Monnezzus,nemesis,288,hunter,survival,6,3,3
14568,Hræsvëlg,archimonde,288,hunter,survival,6,3,3
14569,Zwergjäger,aegwynn,288,hunter,survival,6,3,3
14570,Gormlokar,kazzak,288,hunter,survival,6,3,3
14571,Рэкрэйван,gordunni,288,hunter,survival,6,3,3
14572,Daddytrap,burning-legion,288,hunter,survival,6,3,3
14573,Ремонтлицаа,gordunni,288,hunter,survival,6,3,3
14574,Whis,blackrock,288,hunter,survival,6,3,3
14575,Spakster,blackrock,288,hunter,survival,6,3,3
14576,Likandria,blackmoore,288,hunter,survival,6,3,3
14577,Goblinstyle,kazzak,288,hunter,survival,6,3,3
14578,Veganmuscles,madmortem,288,hunter,survival,6,3,3
14579,Rákthar,blackmoore,288,hunter,survival,6,3,3
14580,Simppeli,sylvanas,288,hunter,survival,6,3,3
14581,Prinzz,blackmoore,288,hunter,survival,6,3,3
14582,Deskö,shendralar,288,hunter,survival,6,3,3
14583,Jayquillen,sylvanas,288,hunter,survival,6,3,3
14584,Arrowknee,outland,288,hunter,survival,6,3,3
14585,Eazzyy,auchindoun,288,hunter,survival,6,3,3
14586,Bubonciêl,archimonde,288,hunter,survival,6,3,3
14587,Åzey,hyjal,288,hunter,survival,6,3,3
14588,Benbutton,antonidas,288,hunter,survival,6,3,3
14589,Jäegarn,ravencrest,288,hunter,survival,6,3,3
14590,Bubby,burning-legion,288,hunter,survival,6,3,3
14591,Aidsmacka,shattered-hand,288,hunter,survival,6,3,3
14592,Crispystix,draenor,288,hunter,survival,6,3,3
14593,Engetsu,drakthul,288,hunter,survival,6,3,3
14594,Bkrbot,dun-modr,288,hunter,survival,6,3,3
14595,Паркх,soulflayer,288,hunter,survival,6,3,3
14596,Oneeyedjoe,the-maelstrom,288,hunter,survival,6,3,3
14597,Faccacamoale,twisting-nether,288,hunter,survival,6,3,3
14598,Friendlyone,quelthalas,288,hunter,survival,6,3,3
14599,Kapowz,kazzak,288,hunter,survival,6,3,3
14600,Grippage,draenor,288,hunter,survival,6,3,3
14601,Нойран,eversong,288,hunter,survival,6,3,3
14602,Sworra,silvermoon,288,hunter,survival,6,3,3
14603,Buekåre,outland,288,hunter,survival,6,3,3
14604,Igyunk,ragnaros,288,hunter,survival,6,3,3
14605,Properchub,ravencrest,288,hunter,survival,6,3,3
14606,Thekev,ravencrest,288,hunter,survival,6,3,3
14607,Suetøløgx,shadowsong,288,hunter,survival,6,3,3
14608,Badwar,twisting-nether,288,hunter,survival,6,3,3
14609,Tràpz,archimonde,288,hunter,survival,6,3,3
14610,Nyyrikkí,ravencrest,288,hunter,survival,6,3,3
14611,Jorhan,ravencrest,288,hunter,survival,6,3,3
14612,Myoui,silvermoon,288,hunter,survival,6,3,3
14613,Bláckthorn,ravencrest,288,hunter,survival,12,3,9
14614,Aleenya,dalaran,288,hunter,survival,12,3,9
14615,Aella,thrall,288,hunter,survival,12,3,9
14616,Caedus,argent-dawn,288,hunter,survival,12,3,9
14617,Астериел,blackscar,288,hunter,survival,12,3,9
14618,Swïtchz,hyjal,288,hunter,survival,12,3,9
14619,Cryts,dun-modr,288,hunter,survival,12,3,9
14620,Wolfína,drakthul,288,hunter,survival,12,3,9
14621,Шмалетар,gordunni,288,hunter,survival,12,3,9
14622,Àfpro,hyjal,288,hunter,survival,12,3,9
14623,Nestór,todeswache,288,hunter,survival,12,3,9
14624,Bigfoot,argent-dawn,288,hunter,survival,12,3,9
14625,Amyst,senjin,288,hunter,survival,12,3,9
14626,Zäphiiro,archimonde,288,hunter,survival,12,3,9
14627,Lezigoulleur,marécage-de-zangar,287,hunter,survival,6,3,3
14628,Charlet,archimonde,287,hunter,survival,6,3,3
14629,Trabucones,sanguino,287,hunter,survival,12,3,9
14630,Arkeye,draenor,271,hunter,survival,11,3,8
14631,Twinkhunter,pozzo-delleternità,256,hunter,survival,10,3,7
14632,Jacobszy,outland,255,hunter,survival,8,4,4
14633,Bowtreat,aggramar,239,hunter,survival,5,3,2
14634,Arrowboss,kazzak,239,hunter,survival,5,3,2
14635,Дочьпескова,gordunni,239,hunter,survival,5,3,2
14636,Sizemattersx,kazzak,239,hunter,survival,11,3,8
14637,Gharzok,blackrock,234,hunter,survival,8,4,4
14638,Himpy,twisting-nether,234,hunter,survival,14,4,10
14639,Одисенс,eversong,233,hunter,survival,13,4,9
14640,Shall,outland,223,hunter,survival,8,3,5
14641,Malover,ravencrest,192,hunter,survival,6,2,4
14642,Hasselunden,ravencrest,192,hunter,survival,6,2,4
14643,Vasco,chogall,192,hunter,survival,6,2,4
14644,Наладдчик,howling-fjord,192,hunter,survival,6,2,4
14645,Abomìnatìon,blackhand,192,hunter,survival,6,2,4
14646,Eromoar,outland,192,hunter,survival,6,2,4
14647,Steffxd,twisting-nether,192,hunter,survival,6,2,4
14648,Bèâr,stormscale,192,hunter,survival,6,2,4
14649,Akhtabot,twisting-nether,192,hunter,survival,6,2,4
14650,Elyar,eredar,192,hunter,survival,6,2,4
14651,Robosexual,ravencrest,192,hunter,survival,6,2,4
14652,Drvix,outland,192,hunter,survival,6,2,4
14653,Rølyn,hyjal,192,hunter,survival,6,2,4
14654,Мусафа,eversong,192,hunter,survival,6,2,4
14655,Нью,soulflayer,192,hunter,survival,6,2,4
14656,Афганыч,soulflayer,192,hunter,survival,6,2,4
14657,Gynax,hyjal,192,hunter,survival,6,2,4
14658,Daarkkhunter,twisting-nether,192,hunter,survival,6,2,4
14659,Yopps,draenor,192,hunter,survival,6,2,4
14660,Jarekk,auchindoun,192,hunter,survival,6,2,4
14661,Evazeonhunt,antonidas,192,hunter,survival,6,2,4
14662,Brindefolìe,archimonde,192,hunter,survival,6,2,4
14663,Орталиус,deathguard,192,hunter,survival,6,2,4
14664,Тандеркейдж,gordunni,192,hunter,survival,6,2,4
14665,Неужто,deathguard,192,hunter,survival,6,2,4
14666,Grundibg,chamber-of-aspects,192,hunter,survival,6,2,4
14667,Xaotsu,ravencrest,192,hunter,survival,6,2,4
14668,Ammò,kazzak,192,hunter,survival,6,2,4
14669,Nýka,sanguino,192,hunter,survival,6,2,4
14670,Valtondre,argent-dawn,192,hunter,survival,6,2,4
14671,Roscke,drakthul,192,hunter,survival,6,2,4
14672,Honeytrap,blackmoore,192,hunter,survival,6,2,4
14673,Twobuttngodx,blackrock,192,hunter,survival,6,2,4
14674,Ilòóll,veknilash,192,hunter,survival,6,2,4
14675,Lithell,kazzak,192,hunter,survival,6,2,4
14676,Gransu,argent-dawn,192,hunter,survival,6,2,4
14677,Draugrinnh,tarren-mill,192,hunter,survival,6,2,4
14678,Aggrobatics,blackmoore,192,hunter,survival,6,2,4
14679,Flexifys,tarren-mill,192,hunter,survival,6,2,4
14680,Adram,burning-legion,192,hunter,survival,6,2,4
14681,Fajitax,lightbringer,192,hunter,survival,6,2,4
14682,Gerzyy,drakthul,192,hunter,survival,6,2,4
14683,Bloodyshot,dun-modr,192,hunter,survival,6,2,4
14684,Sakaryali,silvermoon,192,hunter,survival,6,2,4
14685,Tdapills,sanguino,192,hunter,survival,6,2,4
14686,Nimoria,zuluhed,192,hunter,survival,6,2,4
14687,Réja,norgannon,192,hunter,survival,12,2,10
14688,Zéros,argent-dawn,192,hunter,survival,12,2,10
14689,Haskeer,shattrath,192,hunter,survival,12,2,10
14690,Блоуйоэсс,howling-fjord,192,hunter,survival,12,2,10
14691,Louårn,hyjal,192,hunter,survival,12,2,10
14692,Ecthelione,the-venture-co,192,hunter,survival,12,2,10
14693,Sixty,rajaxx,192,hunter,survival,18,2,16
14694,Bélier,hyjal,191,hunter,survival,6,2,4
14695,Bosnimph,bloodfeather,191,hunter,survival,12,2,10
14696,Thalanos,blackmoore,185,hunter,survival,14,4,10
14697,Bnji,hyjal,159,hunter,survival,11,2,9
14698,Rdwlf,draenor,138,hunter,survival,8,3,5
14699,Donaldtrap,archimonde,128,hunter,survival,4,2,2
14700,Archfiend,stormscale,96,hunter,survival,6,1,5
14701,Draksha,stormscale,96,hunter,survival,6,1,5
14702,Hekyna,ravencrest,96,hunter,survival,6,1,5
14703,Nixerious,alakir,96,hunter,survival,6,1,5
14704,Supcuz,stormscale,96,hunter,survival,6,1,5
14705,Lowfet,neptulon,96,hunter,survival,6,1,5
14706,Oobe,hyjal,96,hunter,survival,6,1,5
14707,Katzchen,burning-legion,96,hunter,survival,6,1,5
14708,Барановируса,soulflayer,96,hunter,survival,6,1,5
14709,Aimywinehaus,drakthul,96,hunter,survival,6,1,5
14710,Multigodx,draenor,96,hunter,survival,6,1,5
14711,Ryztik,garona,96,hunter,survival,6,1,5
14712,Gyurkicz,hyjal,96,hunter,survival,6,1,5
14713,Panzershot,hyjal,96,hunter,survival,6,1,5
14714,Durion,tichondrius,96,hunter,survival,6,1,5
14715,Diabloiv,doomhammer,96,hunter,survival,6,1,5
14716,Leaxs,onyxia,96,hunter,survival,6,1,5
14717,Zynga,sylvanas,96,hunter,survival,6,1,5
14718,Ansâvage,ravencrest,96,hunter,survival,6,1,5
14719,Zárnah,defias-brotherhood,96,hunter,survival,6,1,5
14720,Stirea,alakir,96,hunter,survival,6,1,5
14721,Zuggi,defias-brotherhood,96,hunter,survival,6,1,5
14722,Grollar,ragnaros,96,hunter,survival,6,1,5
14723,Fantus,sylvanas,96,hunter,survival,6,1,5
14724,Куоль,gordunni,96,hunter,survival,6,1,5
14725,Saksa,blackrock,96,hunter,survival,6,1,5
14726,Раелиин,gordunni,96,hunter,survival,6,1,5
14727,Хипстеркотик,gordunni,96,hunter,survival,6,1,5
14728,Серомиг,eversong,96,hunter,survival,6,1,5
14729,Liljan,kult-der-verdammten,96,hunter,survival,6,1,5
14730,Claimi,silvermoon,96,hunter,survival,6,1,5
14731,Escaflôwn,aegwynn,96,hunter,survival,6,1,5
14732,Эннабонни,gordunni,79,hunter,survival,5,1,4
14733,Рангмар,howling-fjord,79,hunter,survival,5,1,4
14734,Kamayail,skullcrusher,64,hunter,survival,4,1,3
14735,Хароко,gordunni,42,hunter,survival,9,3,6
14736,Скримзх,gordunni,41,hunter,survival,6,3,3
14737,Mizumo,burning-legion,16,hunter,survival,1,1,0
14738,Mariabanks,aegwynn,2271,hunter,beastmastery,234,124,110
14739,Куфа,blackscar,2222,hunter,beastmastery,78,43,35
14740,Hypse,kazzak,2172,hunter,beastmastery,292,145,147
14741,Brokeasalwys,ravencrest,2164,hunter,beastmastery,84,46,38
14742,Cbã,ravencrest,2156,hunter,beastmastery,60,32,28
14743,Nelida,ragnaros,2105,hunter,beastmastery,60,32,28
14744,Noorky,kazzak,2093,hunter,beastmastery,78,43,35
14745,Mekerosh,burning-legion,2069,hunter,beastmastery,88,43,45
14746,Fãdê,ravencrest,2053,hunter,beastmastery,114,72,42
14747,Eldrekou,kazzak,2045,hunter,beastmastery,96,53,43
14748,Plugonbaby,hyjal,2035,hunter,beastmastery,77,37,40
14749,Kfcmanagerx,silvermoon,2024,hunter,beastmastery,90,42,48
14750,Truejkee,silvermoon,2014,hunter,beastmastery,137,72,65
14751,Jambomambo,twisting-nether,2008,hunter,beastmastery,90,46,44
14752,Baltímore,stormscale,2006,hunter,beastmastery,77,35,42
14753,Тружка,soulflayer,2000,hunter,beastmastery,96,44,52
14754,Kachaxa,kazzak,1999,hunter,beastmastery,99,46,53
14755,Luzivarus,malganis,1993,hunter,beastmastery,83,40,43
14756,Doghxnter,ravencrest,1989,hunter,beastmastery,60,29,31
14757,Берх,gordunni,1984,hunter,beastmastery,148,72,76
14758,Esperion,ragnaros,1976,hunter,beastmastery,144,68,76
14759,Gernoqz,frostwolf,1973,hunter,beastmastery,107,51,56
14760,Ynv,argent-dawn,1956,hunter,beastmastery,134,69,65
14761,Teals,blackrock,1954,hunter,beastmastery,141,73,68
14762,Expiraa,twisting-nether,1954,hunter,beastmastery,72,35,37
14763,Nivshot,kazzak,1950,hunter,beastmastery,54,31,23
14764,Raawy,blackmoore,1948,hunter,beastmastery,42,31,11
14765,Sipsomewater,ravencrest,1943,hunter,beastmastery,69,36,33
14766,Zyphx,der-rat-von-dalaran,1935,hunter,beastmastery,146,68,78
14767,Баянист,soulflayer,1934,hunter,beastmastery,120,59,61
14768,Luzivar,malganis,1934,hunter,beastmastery,83,38,45
14769,Odeôn,twisting-nether,1921,hunter,beastmastery,65,27,38
14770,Мираклдримз,gordunni,1919,hunter,beastmastery,72,38,34
14771,Babýrage,twisting-nether,1919,hunter,beastmastery,60,31,29
14772,Feevah,frostmane,1916,hunter,beastmastery,278,139,139
14773,Roarmantic,blackrock,1915,hunter,beastmastery,66,31,35
14774,Safnirx,tarren-mill,1908,hunter,beastmastery,72,32,40
14775,Trend,silvermoon,1907,hunter,beastmastery,213,105,108
14776,Aimshots,twisting-nether,1906,hunter,beastmastery,66,36,30
14777,Ataxyz,draenor,1906,hunter,beastmastery,60,30,30
14778,Экономист,fordragon,1905,hunter,beastmastery,60,37,23
14779,Libanais,archimonde,1905,hunter,beastmastery,251,119,132
14780,Онкьяр,gordunni,1901,hunter,beastmastery,98,53,45
14781,Беби,gordunni,1901,hunter,beastmastery,66,31,35
14782,Thing,kazzak,1900,hunter,beastmastery,36,21,15
14783,Izmad,archimonde,1899,hunter,beastmastery,317,178,139
14784,Trapgoddxx,archimonde,1894,hunter,beastmastery,65,44,21
14785,Гринмех,gordunni,1893,hunter,beastmastery,66,35,31
14786,Tagz,ravencrest,1887,hunter,beastmastery,60,29,31
14787,Rndhunt,shattrath,1881,hunter,beastmastery,90,43,47
14788,Snarthelg,tarren-mill,1874,hunter,beastmastery,60,32,28
14789,Priceqtxd,ravencrest,1870,hunter,beastmastery,145,88,57
14790,Евилик,gordunni,1870,hunter,beastmastery,66,31,35
14791,Pussirotta,stormreaver,1869,hunter,beastmastery,60,30,30
14792,Jàsøn,ravencrest,1867,hunter,beastmastery,72,33,39
14793,Sukzess,antonidas,1866,hunter,beastmastery,84,38,46
14794,Phesx,sylvanas,1865,hunter,beastmastery,54,27,27
14795,Биско,gordunni,1865,hunter,beastmastery,144,71,73
14796,Ígrågøßñø,silvermoon,1864,hunter,beastmastery,44,30,14
14797,Breezme,twisting-nether,1864,hunter,beastmastery,72,33,39
14798,Hanuong,ragnaros,1862,hunter,beastmastery,36,20,16
14799,Moscowmule,tarren-mill,1859,hunter,beastmastery,59,29,30
14800,Krampack,dun-modr,1858,hunter,beastmastery,54,31,23
14801,Draxil,archimonde,1855,hunter,beastmastery,60,27,33
14802,Найстити,deathguard,1854,hunter,beastmastery,66,31,35
14803,Raggeh,frostwhisper,1853,hunter,beastmastery,66,35,31
14804,Rákthar,blackmoore,1852,hunter,beastmastery,128,63,65
14805,Nexztwo,blackrock,1852,hunter,beastmastery,69,33,36
14806,Samanou,kazzak,1851,hunter,beastmastery,94,45,49
14807,Chillbroo,twisting-nether,1851,hunter,beastmastery,71,33,38
14808,Âmalphy,ravencrest,1846,hunter,beastmastery,47,23,24
14809,Ryxzn,eredar,1846,hunter,beastmastery,78,36,42
14810,Дианнесса,howling-fjord,1845,hunter,beastmastery,83,40,43
14811,Колякилшот,gordunni,1844,hunter,beastmastery,60,29,31
14812,Kondy,twisting-nether,1843,hunter,beastmastery,43,29,14
14813,Nyzuri,die-aldor,1843,hunter,beastmastery,54,26,28
14814,Мерзкийбот,gordunni,1843,hunter,beastmastery,74,33,41
14815,Miraculous,dalaran,1841,hunter,beastmastery,51,25,26
14816,Scrubbi,destromath,1840,hunter,beastmastery,59,30,29
14817,Wilfyre,twisting-nether,1840,hunter,beastmastery,75,36,39
14818,Каосси,gordunni,1839,hunter,beastmastery,61,31,30
14819,Лесбиянюсь,gordunni,1838,hunter,beastmastery,60,43,17
14820,Imcuteandfun,ravencrest,1838,hunter,beastmastery,135,69,66
14821,Thogel,hyjal,1838,hunter,beastmastery,72,33,39
14822,Irefutabil,stormscale,1838,hunter,beastmastery,72,32,40
14823,Tyranski,ravencrest,1837,hunter,beastmastery,87,49,38
14824,Winiswin,stormscale,1837,hunter,beastmastery,178,84,94
14825,Dheredre,silvermoon,1835,hunter,beastmastery,48,27,21
14826,Miløø,silvermoon,1835,hunter,beastmastery,48,26,22
14827,Manj,blackhand,1835,hunter,beastmastery,65,32,33
14828,Hugø,twisting-nether,1835,hunter,beastmastery,102,43,59
14829,Hlogic,tarren-mill,1834,hunter,beastmastery,108,51,57
14830,Pfizershotx,khaz-modan,1832,hunter,beastmastery,60,29,31
14831,Næmes,hyjal,1830,hunter,beastmastery,66,32,34
14832,Kabaro,rajaxx,1830,hunter,beastmastery,60,27,33
14833,Рагнарианх,gordunni,1829,hunter,beastmastery,105,48,57
14834,Кразайс,ashenvale,1829,hunter,beastmastery,91,39,52
14835,Крайдершот,howling-fjord,1828,hunter,beastmastery,59,30,29
14836,Diktatos,kazzak,1828,hunter,beastmastery,64,31,33
14837,Bilbohunter,draenor,1825,hunter,beastmastery,48,27,21
14838,Горгонт,blackscar,1825,hunter,beastmastery,47,25,22
14839,Saggymilkies,outland,1825,hunter,beastmastery,72,33,39
14840,Mottorhead,kazzak,1823,hunter,beastmastery,45,30,15
14841,Burninghunt,ravencrest,1822,hunter,beastmastery,60,32,28
14842,Wêskêr,tarren-mill,1821,hunter,beastmastery,66,31,35
14843,Куроните,howling-fjord,1820,hunter,beastmastery,48,27,21
14844,Bynen,tarren-mill,1819,hunter,beastmastery,77,33,44
14845,Pryse,hyjal,1818,hunter,beastmastery,48,24,24
14846,Шергала,soulflayer,1818,hunter,beastmastery,298,147,151
14847,Omegakek,madmortem,1817,hunter,beastmastery,85,45,40
14848,Jawox,antonidas,1817,hunter,beastmastery,60,27,33
14849,Wiffed,tarren-mill,1816,hunter,beastmastery,36,24,12
14850,Brokenpetman,defias-brotherhood,1816,hunter,beastmastery,36,22,14
14851,Haltrâdar,archimonde,1816,hunter,beastmastery,69,35,34
14852,Blackszpak,jaedenar,1816,hunter,beastmastery,48,24,24
14853,Играсломана,howling-fjord,1815,hunter,beastmastery,60,39,21
14854,Bíllybobbs,argent-dawn,1815,hunter,beastmastery,36,19,17
14855,Badboybørge,draenor,1815,hunter,beastmastery,42,22,20
14856,Пожилойпупь,soulflayer,1815,hunter,beastmastery,66,32,34
14857,Ooh,doomhammer,1815,hunter,beastmastery,120,56,64
14858,Jabela,eredar,1814,hunter,beastmastery,59,42,17
14859,Dangen,stormreaver,1814,hunter,beastmastery,36,19,17
14860,Cor,ravencrest,1814,hunter,beastmastery,113,54,59
14861,Лордсахарок,gordunni,1814,hunter,beastmastery,90,40,50
14862,Alpharaven,ravencrest,1812,hunter,beastmastery,60,31,29
14863,Twineyes,ravencrest,1812,hunter,beastmastery,154,75,79
14864,Dréws,kazzak,1811,hunter,beastmastery,58,26,32
14865,Shroomynuts,kazzak,1810,hunter,beastmastery,114,68,46
14866,Марчик,blackscar,1810,hunter,beastmastery,42,19,23
14867,Masthuhn,blackmoore,1809,hunter,beastmastery,36,27,9
14868,Jungletime,outland,1809,hunter,beastmastery,48,26,22
14869,Mòzetonq,ravencrest,1809,hunter,beastmastery,42,22,20
14870,Corossity,blackmoore,1808,hunter,beastmastery,30,19,11
14871,Hiddenx,blackmoore,1808,hunter,beastmastery,42,21,21
14872,Sparcùs,stormreaver,1807,hunter,beastmastery,140,79,61
14873,Bøgs,the-maelstrom,1807,hunter,beastmastery,42,22,20
14874,Поппишот,blackscar,1806,hunter,beastmastery,36,19,17
14875,Цитрукс,gordunni,1806,hunter,beastmastery,90,47,43
14876,Huntchonk,kazzak,1806,hunter,beastmastery,53,27,26
14877,Spirys,drakthul,1806,hunter,beastmastery,47,20,27
14878,Dogetrainer,silvermoon,1805,hunter,beastmastery,199,101,98
14879,Hacz,bronzebeard,1804,hunter,beastmastery,138,70,68
14880,Lysanhunt,zuljin,1804,hunter,beastmastery,54,27,27
14881,Jägarnmt,twisting-nether,1804,hunter,beastmastery,89,37,52
14882,Crippa,tarren-mill,1803,hunter,beastmastery,54,28,26
14883,Tillhunt,kargath,1803,hunter,beastmastery,54,26,28
14884,Ayiu,argent-dawn,1802,hunter,beastmastery,53,24,29
14885,Трапгодикс,eversong,1800,hunter,beastmastery,176,95,81
14886,Qtìp,aegwynn,1798,hunter,beastmastery,89,42,47
14887,Sekzpitch,blackmoore,1790,hunter,beastmastery,48,24,24
14888,Пивопьюня,ashenvale,1790,hunter,beastmastery,71,34,37
14889,Smhx,stormscale,1788,hunter,beastmastery,30,21,9
14890,Wodhunterxdd,outland,1788,hunter,beastmastery,53,25,28
14891,Pkz,dun-modr,1787,hunter,beastmastery,99,46,53
14892,Appirc,tarren-mill,1785,hunter,beastmastery,48,24,24
14893,Deathcode,stormscale,1784,hunter,beastmastery,66,27,39
14894,Wîldhunt,burning-legion,1781,hunter,beastmastery,161,76,85
14895,Jamesyy,ravencrest,1776,hunter,beastmastery,60,28,32
14896,Gucçi,kazzak,1773,hunter,beastmastery,73,42,31
14897,Orcji,blackhand,1772,hunter,beastmastery,101,49,52
14898,Chúx,twisting-nether,1771,hunter,beastmastery,96,53,43
14899,Каоссхант,howling-fjord,1770,hunter,beastmastery,53,32,21
14900,Silverwolfa,dun-modr,1770,hunter,beastmastery,81,43,38
14901,Erethrus,ravencrest,1769,hunter,beastmastery,48,19,29
14902,Вождь,howling-fjord,1768,hunter,beastmastery,59,29,30
14903,Fanjah,sylvanas,1767,hunter,beastmastery,63,36,27
14904,Amyndôr,ravencrest,1767,hunter,beastmastery,48,27,21
14905,Guccihuntlol,ravencrest,1766,hunter,beastmastery,68,33,35
14906,Altimor,blackmoore,1765,hunter,beastmastery,35,19,16
14907,Donixx,blackrock,1765,hunter,beastmastery,60,29,31
14908,Dìgítal,twisting-nether,1763,hunter,beastmastery,95,47,48
14909,Fullxtrap,hyjal,1763,hunter,beastmastery,41,19,22
14910,Jamzyhunter,emerald-dream,1762,hunter,beastmastery,48,24,24
14911,Скадхи,blackscar,1762,hunter,beastmastery,88,42,46
14912,Dafhel,hyjal,1762,hunter,beastmastery,95,44,51
14913,Grynu,kazzak,1761,hunter,beastmastery,72,31,41
14914,Nimhunt,dentarg,1759,hunter,beastmastery,65,29,36
14915,Futureman,blackrock,1758,hunter,beastmastery,54,31,23
14916,Ruffixvs,blackrock,1756,hunter,beastmastery,35,19,16
14917,Riflur,stormscale,1756,hunter,beastmastery,84,42,42
14918,Djfury,archimonde,1756,hunter,beastmastery,46,21,25
14919,Порошокк,gordunni,1756,hunter,beastmastery,69,29,40
14920,Vrikenh,tarren-mill,1755,hunter,beastmastery,127,75,52
14921,Nollieflip,stormscale,1754,hunter,beastmastery,114,67,47
14922,Мэлвиса,borean-tundra,1754,hunter,beastmastery,90,50,40
14923,Антошадпс,gordunni,1752,hunter,beastmastery,66,38,28
14924,Kachaxaa,ravencrest,1752,hunter,beastmastery,64,27,37
14925,Father,auchindoun,1750,hunter,beastmastery,107,57,50
14926,Pewpewshotz,stormscale,1750,hunter,beastmastery,229,117,112
14927,Nystaleoss,grim-batol,1750,hunter,beastmastery,267,131,136
14928,Pawzz,kazzak,1750,hunter,beastmastery,60,29,31
14929,Ilovemax,archimonde,1750,hunter,beastmastery,46,20,26
14930,Такувами,gordunni,1747,hunter,beastmastery,108,44,64
14931,Мориартис,ashenvale,1744,hunter,beastmastery,83,43,40
14932,Åsynåmvp,twisting-nether,1742,hunter,beastmastery,65,29,36
14933,Блэкстейдж,howling-fjord,1741,hunter,beastmastery,135,74,61
14934,Carioca,blackhand,1741,hunter,beastmastery,66,30,36
14935,Treaz,sanguino,1739,hunter,beastmastery,66,33,33
14936,Fatmum,magtheridon,1738,hunter,beastmastery,81,43,38
14937,Dhadhar,kazzak,1737,hunter,beastmastery,161,79,82
14938,Hawkeyé,forscherliga,1735,hunter,beastmastery,147,66,81
14939,Fluphy,thrall,1734,hunter,beastmastery,94,51,43
14940,Stingsz,chogall,1733,hunter,beastmastery,64,25,39
14941,Darksmoke,forscherliga,1732,hunter,beastmastery,42,24,18
14942,Lofiel,blackrock,1732,hunter,beastmastery,92,50,42
14943,Nèxz,blackrock,1732,hunter,beastmastery,77,33,44
14944,Parhainkoira,argent-dawn,1728,hunter,beastmastery,78,45,33
14945,Valkrys,die-aldor,1726,hunter,beastmastery,70,35,35
14946,Duppdupp,eredar,1726,hunter,beastmastery,84,38,46
14947,Oldbear,frostmane,1725,hunter,beastmastery,70,38,32
14948,Dohter,kazzak,1725,hunter,beastmastery,43,23,20
14949,Ashily,blackhand,1725,hunter,beastmastery,56,27,29
14950,Sankari,blackmoore,1724,hunter,beastmastery,48,26,22
14951,Idtrapthat,nagrand,1723,hunter,beastmastery,84,41,43
14952,Lsa,kazzak,1722,hunter,beastmastery,59,28,31
14953,Misstrap,nemesis,1722,hunter,beastmastery,60,28,32
14954,Mtrider,twisting-nether,1721,hunter,beastmastery,105,50,55
14955,Easyclass,hyjal,1718,hunter,beastmastery,159,92,67
14956,Дэнвин,deathweaver,1718,hunter,beastmastery,219,110,109
14957,Ericspet,stormscale,1717,hunter,beastmastery,48,32,16
14958,Painaldeepz,stormscale,1717,hunter,beastmastery,48,26,22
14959,Piranhaa,archimonde,1717,hunter,beastmastery,39,18,21
14960,Laserkamel,aegwynn,1716,hunter,beastmastery,24,18,6
14961,Vajraw,blackrock,1716,hunter,beastmastery,190,95,95
14962,Peazý,ravencrest,1715,hunter,beastmastery,48,27,21
14963,Дашатрирубля,soulflayer,1715,hunter,beastmastery,42,21,21
14964,Фираналь,blackscar,1715,hunter,beastmastery,93,46,47
14965,Spider,zuljin,1710,hunter,beastmastery,42,25,17
14966,Noversia,aegwynn,1710,hunter,beastmastery,123,59,64
14967,Jägarntwo,stormscale,1710,hunter,beastmastery,51,20,31
14968,Petshopgirl,ravencrest,1709,hunter,beastmastery,30,18,12
14969,Mogwai,stormscale,1709,hunter,beastmastery,42,18,24
14970,Jêsslíne,ravencrest,1706,hunter,beastmastery,48,24,24
14971,Bicmax,archimonde,1705,hunter,beastmastery,45,20,25
14972,Ansâvage,ravencrest,1705,hunter,beastmastery,84,37,47
14973,Impxgodx,outland,1704,hunter,beastmastery,51,24,27
14974,Lobo,kazzak,1704,hunter,beastmastery,66,28,38
14975,Dmanite,ravencrest,1703,hunter,beastmastery,96,53,43
14976,Saiko,kazzak,1703,hunter,beastmastery,42,18,24
14977,Unßørn,archimonde,1702,hunter,beastmastery,96,38,58
14978,Vilopez,arthas,1701,hunter,beastmastery,24,20,4
14979,Kafkules,outland,1700,hunter,beastmastery,137,78,59
14980,Shinkichi,archimonde,1699,hunter,beastmastery,30,18,12
14981,Elamondria,outland,1699,hunter,beastmastery,72,42,30
14982,Sznxøxo,ravencrest,1699,hunter,beastmastery,54,29,25
14983,Hacx,ravencrest,1697,hunter,beastmastery,57,25,32
14984,Rakeesh,hyjal,1696,hunter,beastmastery,36,18,18
14985,Гигапупсх,howling-fjord,1695,hunter,beastmastery,149,85,64
14986,Merquryh,ravencrest,1693,hunter,beastmastery,48,27,21
14987,Kamar,archimonde,1692,hunter,beastmastery,66,43,23
14988,Naraxis,blackrock,1692,hunter,beastmastery,54,27,27
14989,Fize,blackmoore,1692,hunter,beastmastery,77,36,41
14990,Séyena,outland,1692,hunter,beastmastery,54,22,32
14991,Krix,ragnaros,1691,hunter,beastmastery,54,34,20
14992,Пихпахах,gordunni,1691,hunter,beastmastery,82,43,39
14993,Pëâcêßß,outland,1688,hunter,beastmastery,36,21,15
14994,Адыгах,blackscar,1688,hunter,beastmastery,61,35,26
14995,Balthazzarxx,ravencrest,1686,hunter,beastmastery,68,36,32
14996,Вееном,gordunni,1685,hunter,beastmastery,48,24,24
14997,Thogelle,hyjal,1684,hunter,beastmastery,84,41,43
14998,Ðxlz,archimonde,1683,hunter,beastmastery,71,35,36
14999,Letsrock,outland,1682,hunter,beastmastery,33,20,13
15000,Deathvain,tarren-mill,1682,hunter,beastmastery,42,18,24
15001,Liquidhunter,quelthalas,1681,hunter,beastmastery,42,25,17
15002,Poupoune,uldum,1680,hunter,beastmastery,48,24,24
15003,Забзаб,soulflayer,1680,hunter,beastmastery,63,31,32
15004,Nestór,todeswache,1678,hunter,beastmastery,47,28,19
15005,Sïmc,archimonde,1678,hunter,beastmastery,108,58,50
15006,Erilis,twisting-nether,1676,hunter,beastmastery,37,22,15
15007,Kestlér,twisting-nether,1675,hunter,beastmastery,84,35,49
15008,Galileo,sanguino,1674,hunter,beastmastery,62,29,33
15009,Murtagh,khaz-modan,1673,hunter,beastmastery,48,26,22
15010,Raindra,twisting-nether,1672,hunter,beastmastery,42,20,22
15011,Irefutabilâ,outland,1670,hunter,beastmastery,138,63,75
15012,Techpøint,silvermoon,1669,hunter,beastmastery,35,18,17
15013,Zubro,kazzak,1666,hunter,beastmastery,60,31,29
15014,Triggaz,stormscale,1665,hunter,beastmastery,216,109,107
15015,Yarrgi,kazzak,1663,hunter,beastmastery,84,46,38
15016,Zanpa,archimonde,1663,hunter,beastmastery,122,56,66
15017,Chrysantes,forscherliga,1660,hunter,beastmastery,38,19,19
15018,Ysina,arathi,1660,hunter,beastmastery,42,20,22
15019,Trenesta,tarren-mill,1659,hunter,beastmastery,34,18,16
15020,Eazzyy,auchindoun,1659,hunter,beastmastery,115,56,59
15021,Tháyn,tarren-mill,1658,hunter,beastmastery,41,25,16
15022,Dogwatcher,outland,1658,hunter,beastmastery,48,23,25
15023,Pérnix,tarren-mill,1657,hunter,beastmastery,30,18,12
15024,Anklar,blackrock,1657,hunter,beastmastery,53,24,29
15025,Dragosvis,arathor,1656,hunter,beastmastery,36,23,13
15026,Хантунец,soulflayer,1654,hunter,beastmastery,48,27,21
15027,Cnby,stormscale,1652,hunter,beastmastery,43,26,17
15028,Meghanmarkle,tarren-mill,1650,hunter,beastmastery,52,26,26
15029,Ðéadsøulz,stormscale,1648,hunter,beastmastery,135,71,64
15030,Стэпси,gordunni,1648,hunter,beastmastery,36,18,18
15031,Røzy,twisting-nether,1647,hunter,beastmastery,48,35,13
15032,Каэлланис,soulflayer,1647,hunter,beastmastery,53,24,29
15033,Oldcocknbals,silvermoon,1645,hunter,beastmastery,100,54,46
15034,Nîøssx,blackrock,1644,hunter,beastmastery,53,28,25
15035,Nkdchef,outland,1642,hunter,beastmastery,54,29,25
15036,Astari,outland,1641,hunter,beastmastery,48,21,27
15037,Смертонносна,lich-king,1641,hunter,beastmastery,71,30,41
15038,Rynx,hellfire,1640,hunter,beastmastery,60,28,32
15039,Askaway,sylvanas,1639,hunter,beastmastery,42,31,11
15040,Povish,twisting-nether,1639,hunter,beastmastery,49,25,24
15041,Gaeln,outland,1639,hunter,beastmastery,204,93,111
15042,Kerólus,blackhand,1639,hunter,beastmastery,48,18,30
15043,Teestylee,stormscale,1638,hunter,beastmastery,42,21,21
15044,Traplørdx,sylvanas,1638,hunter,beastmastery,48,21,27
15045,Drøøðqt,blackrock,1637,hunter,beastmastery,60,31,29
15046,Ætå,blackmoore,1637,hunter,beastmastery,47,22,25
15047,Coltan,nemesis,1636,hunter,beastmastery,60,22,38
15048,Akaris,archimonde,1635,hunter,beastmastery,78,35,43
15049,Yolofant,blackhand,1634,hunter,beastmastery,36,22,14
15050,Wlâd,archimonde,1634,hunter,beastmastery,35,21,14
15051,Hultasy,outland,1634,hunter,beastmastery,134,67,67
15052,Жажждущий,gordunni,1633,hunter,beastmastery,79,43,36
15053,Paimen,darksorrow,1633,hunter,beastmastery,102,55,47
15054,Bebiyo,sanguino,1631,hunter,beastmastery,94,45,49
15055,Horhyndan,ragnaros,1631,hunter,beastmastery,51,24,27
15056,Bluefluclue,draenor,1630,hunter,beastmastery,110,46,64
15057,Nickyhunt,stormscale,1629,hunter,beastmastery,71,37,34
15058,Ðesøtø,frostwolf,1628,hunter,beastmastery,66,33,33
15059,Drewsx,ravencrest,1627,hunter,beastmastery,36,22,14
15060,Xenvantoss,silvermoon,1627,hunter,beastmastery,30,17,13
15061,Ðrtrapx,blackmoore,1627,hunter,beastmastery,50,27,23
15062,Hypsenn,kazzak,1627,hunter,beastmastery,36,17,19
15063,Trapzila,aggra-português,1626,hunter,beastmastery,90,50,40
15064,Eggcowmeow,azjolnerub,1626,hunter,beastmastery,42,22,20
15065,Xenvantos,stormscale,1626,hunter,beastmastery,42,21,21
15066,Klausmanne,blackrock,1626,hunter,beastmastery,218,101,117
15067,Порошокк,howling-fjord,1625,hunter,beastmastery,30,17,13
15068,Fåded,ravencrest,1625,hunter,beastmastery,65,31,34
15069,Gibiswag,outland,1625,hunter,beastmastery,36,17,19
15070,Uglybaboon,draenor,1625,hunter,beastmastery,42,17,25
15071,Mirmona,stormscale,1624,hunter,beastmastery,40,19,21
15072,Lambo,laughing-skull,1624,hunter,beastmastery,36,17,19
15073,Sayn,la-croisade-écarlate,1624,hunter,beastmastery,59,24,35
15074,Sicktrapbtw,hyjal,1624,hunter,beastmastery,42,17,25
15075,Solò,eredar,1623,hunter,beastmastery,30,17,13
15076,Fiftyóne,festung-der-stürme,1622,hunter,beastmastery,96,53,43
15077,Bebar,kazzak,1622,hunter,beastmastery,120,62,58
15078,Infléx,silvermoon,1622,hunter,beastmastery,77,39,38
15079,Podroto,tyrande,1622,hunter,beastmastery,47,22,25
15080,Gigamesh,sporeggar,1621,hunter,beastmastery,90,52,38
15081,Piky,nemesis,1620,hunter,beastmastery,36,20,16
15082,Índigo,kazzak,1620,hunter,beastmastery,56,30,26
15083,Flappypig,stormscale,1620,hunter,beastmastery,50,22,28
15084,Jèrsèy,draenor,1619,hunter,beastmastery,42,22,20
15085,Vezeka,ravencrest,1618,hunter,beastmastery,42,26,16
15086,Zuxz,blackmoore,1618,hunter,beastmastery,79,38,41
15087,Vinsanity,dunemaul,1618,hunter,beastmastery,42,17,25
15088,Neïç,antonidas,1618,hunter,beastmastery,65,25,40
15089,Djøgi,archimonde,1617,hunter,beastmastery,42,22,20
15090,Bobon,stormscale,1617,hunter,beastmastery,54,26,28
15091,Notdilly,varimathras,1617,hunter,beastmastery,48,20,28
15092,Quasar,ravencrest,1616,hunter,beastmastery,42,17,25
15093,Ганидони,soulflayer,1616,hunter,beastmastery,59,23,36
15094,Ефрейя,gordunni,1615,hunter,beastmastery,30,17,13
15095,Sentriks,tarren-mill,1615,hunter,beastmastery,36,17,19
15096,Tobbè,silvermoon,1615,hunter,beastmastery,36,17,19
15097,Lufreak,ravencrest,1614,hunter,beastmastery,30,23,7
15098,Eltrapo,ravencrest,1613,hunter,beastmastery,24,17,7
15099,Missmytraps,ravencrest,1613,hunter,beastmastery,39,20,19
15100,Wrongtarget,auchindoun,1613,hunter,beastmastery,54,24,30
15101,Aroeris,ravencrest,1611,hunter,beastmastery,57,32,25
15102,Lowfet,neptulon,1611,hunter,beastmastery,156,85,71
15103,Spinella,antonidas,1611,hunter,beastmastery,102,50,52
15104,Ixix,blackhand,1611,hunter,beastmastery,54,26,28
15105,Pekaxôxô,sanguino,1609,hunter,beastmastery,48,34,14
15106,Denkstah,tarren-mill,1609,hunter,beastmastery,51,21,30
15107,Nordafrøst,antonidas,1609,hunter,beastmastery,66,27,39
15108,Feralhound,exodar,1608,hunter,beastmastery,252,129,123
15109,Eaglexx,twisting-nether,1608,hunter,beastmastery,78,39,39
15110,Hîldegard,todeswache,1608,hunter,beastmastery,59,27,32
15111,Downey,azshara,1608,hunter,beastmastery,54,19,35
15112,Símpíng,tarren-mill,1607,hunter,beastmastery,24,17,7
15113,Jinxpeasant,twisting-nether,1607,hunter,beastmastery,30,20,10
15114,Nukenfoobs,draenor,1607,hunter,beastmastery,36,23,13
15115,Axran,ravencrest,1607,hunter,beastmastery,52,23,29
15116,Ingvi,antonidas,1606,hunter,beastmastery,131,60,71
15117,Jomerin,thrall,1606,hunter,beastmastery,48,20,28
15118,Зуланария,howling-fjord,1605,hunter,beastmastery,41,26,15
15119,Homesz,blackmoore,1605,hunter,beastmastery,36,22,14
15120,Smegmagol,baelgun,1605,hunter,beastmastery,41,20,21
15121,Lolez,dun-modr,1605,hunter,beastmastery,42,17,25
15122,Taoshii,die-aldor,1604,hunter,beastmastery,66,36,30
15123,Céah,blackrock,1604,hunter,beastmastery,54,28,26
15124,Эвилтар,soulflayer,1604,hunter,beastmastery,78,40,38
15125,Wèndy,blackrock,1604,hunter,beastmastery,82,41,41
15126,Ariabeast,archimonde,1604,hunter,beastmastery,42,20,22
15127,Xiioo,ravencrest,1604,hunter,beastmastery,83,37,46
15128,Chasseurcool,argent-dawn,1603,hunter,beastmastery,50,28,22
15129,Bànsundara,hyjal,1603,hunter,beastmastery,97,53,44
15130,Cubro,sanguino,1603,hunter,beastmastery,77,42,35
15131,Asery,blackmoore,1603,hunter,beastmastery,42,20,22
15132,Pluttbug,xavius,1602,hunter,beastmastery,32,19,13
15133,Bigdog,eredar,1602,hunter,beastmastery,77,33,44
15134,Sjins,draenor,1601,hunter,beastmastery,35,20,15
15135,Hunterlolz,tarren-mill,1601,hunter,beastmastery,54,29,25
15136,Nottberozz,silvermoon,1601,hunter,beastmastery,146,72,74
15137,Douglas,die-silberne-hand,1601,hunter,beastmastery,36,17,19
15138,Stickey,antonidas,1600,hunter,beastmastery,66,34,32
15139,Trapyx,malganis,1600,hunter,beastmastery,327,165,162
15140,Chasxc,kazzak,1599,hunter,beastmastery,60,31,29
15141,Spidak,stormscale,1597,hunter,beastmastery,42,23,19
15142,Snaipergirl,twisting-nether,1597,hunter,beastmastery,66,30,36
15143,Оути,azuregos,1595,hunter,beastmastery,69,37,32
15144,Morìtz,ravencrest,1592,hunter,beastmastery,36,20,16
15145,Mânhunt,blackhand,1592,hunter,beastmastery,373,181,192
15146,Memehunter,aegwynn,1591,hunter,beastmastery,66,41,25
15147,Eagletalon,twisting-nether,1590,hunter,beastmastery,57,27,30
15148,Bøøya,aegwynn,1590,hunter,beastmastery,85,39,46
15149,Зоотян,gordunni,1589,hunter,beastmastery,111,55,56
15150,Earlygrey,ravencrest,1588,hunter,beastmastery,105,50,55
15151,Keinzira,hyjal,1588,hunter,beastmastery,48,22,26
15152,Xxiioo,ravencrest,1583,hunter,beastmastery,85,49,36
15153,Иоссифсталин,soulflayer,1583,hunter,beastmastery,36,17,19
15154,Survabuse,silvermoon,1581,hunter,beastmastery,33,20,13
15155,Búddhá,stormscale,1581,hunter,beastmastery,186,88,98
15156,Diapositiv,draenor,1580,hunter,beastmastery,60,33,27
15157,Тиблэк,soulflayer,1579,hunter,beastmastery,101,51,50
15158,Knocked,quelthalas,1579,hunter,beastmastery,54,20,34
15159,Idetylem,burning-legion,1574,hunter,beastmastery,48,29,19
15160,Reptile,outland,1574,hunter,beastmastery,88,49,39
15161,Lëgølåslõrdx,blackrock,1574,hunter,beastmastery,68,32,36
15162,Jeeso,baelgun,1574,hunter,beastmastery,130,61,69
15163,Отерон,gordunni,1573,hunter,beastmastery,158,85,73
15164,Йокуя,blackscar,1572,hunter,beastmastery,24,18,6
15165,Akïratqz,sanguino,1572,hunter,beastmastery,30,18,12
15166,Janko,ravencrest,1572,hunter,beastmastery,284,142,142
15167,Леао,howling-fjord,1571,hunter,beastmastery,45,30,15
15168,Мунлэс,lich-king,1569,hunter,beastmastery,69,30,39
15169,Pandanero,ravencrest,1568,hunter,beastmastery,36,18,18
15170,Dragomirka,kazzak,1568,hunter,beastmastery,62,29,33
15171,Комомура,soulflayer,1568,hunter,beastmastery,53,24,29
15172,Sallya,kazzak,1567,hunter,beastmastery,42,22,20
15173,Сотк,howling-fjord,1567,hunter,beastmastery,42,19,23
15174,Dispairge,antonidas,1566,hunter,beastmastery,42,18,24
15175,Sagethunt,blackrock,1565,hunter,beastmastery,41,17,24
15176,Arcaniz,ravencrest,1564,hunter,beastmastery,42,22,20
15177,Tigerups,burning-legion,1563,hunter,beastmastery,58,29,29
15178,Келен,blackscar,1560,hunter,beastmastery,30,19,11
15179,Saymqt,blackrock,1560,hunter,beastmastery,63,29,34
15180,Charleramsey,outland,1558,hunter,beastmastery,60,30,30
15181,Brisbya,khaz-modan,1557,hunter,beastmastery,47,28,19
15182,Nolove,burning-legion,1557,hunter,beastmastery,137,67,70
15183,Жокра,greymane,1557,hunter,beastmastery,42,19,23
15184,Zendra,sylvanas,1555,hunter,beastmastery,59,36,23
15185,Shkorvi,drakthul,1555,hunter,beastmastery,36,17,19
15186,Søuïlløn,archimonde,1553,hunter,beastmastery,48,30,18
15187,Альриен,gordunni,1553,hunter,beastmastery,30,17,13
15188,Medûse,stormscale,1551,hunter,beastmastery,42,26,16
15189,Gunde,kazzak,1551,hunter,beastmastery,102,52,50
15190,Nallepuuoh,outland,1549,hunter,beastmastery,123,62,61
15191,Sharún,sylvanas,1548,hunter,beastmastery,56,27,29
15192,Gedzer,silvermoon,1547,hunter,beastmastery,40,19,21
15193,Æblesaft,stormscale,1547,hunter,beastmastery,76,34,42
15194,Calutis,blackmoore,1546,hunter,beastmastery,48,28,20
15195,Пулявзубах,gordunni,1544,hunter,beastmastery,110,58,52
15196,Grusijohn,executus,1543,hunter,beastmastery,72,35,37
15197,Tiendat,kazzak,1540,hunter,beastmastery,30,17,13
15198,Антисерт,ashenvale,1538,hunter,beastmastery,70,33,37
15199,Солевойй,gordunni,1537,hunter,beastmastery,42,20,22
15200,Bortian,argent-dawn,1536,hunter,beastmastery,73,41,32
15201,Snipertjuh,silvermoon,1536,hunter,beastmastery,103,51,52
15202,Arcø,dun-modr,1535,hunter,beastmastery,30,16,14
15203,Wolfster,kazzak,1534,hunter,beastmastery,42,19,23
15204,Corrupth,outland,1533,hunter,beastmastery,36,18,18
15205,Encore,sylvanas,1532,hunter,beastmastery,140,75,65
15206,Sonìc,kazzak,1531,hunter,beastmastery,44,25,19
15207,Ledrox,ravencrest,1531,hunter,beastmastery,78,38,40
15208,Djbombastic,archimonde,1528,hunter,beastmastery,48,31,17
15209,Tayaa,draenor,1528,hunter,beastmastery,91,47,44
15210,Аллони,booty-bay,1528,hunter,beastmastery,165,80,85
15211,Xraay,stormscale,1527,hunter,beastmastery,42,22,20
15212,Córelly,outland,1527,hunter,beastmastery,119,57,62
15213,Lascazador,dun-modr,1526,hunter,beastmastery,74,32,42
15214,Orcoro,ysondre,1525,hunter,beastmastery,268,131,137
15215,Vaelyste,doomhammer,1524,hunter,beastmastery,59,31,28
15216,Zugmypole,stormscale,1524,hunter,beastmastery,48,25,23
15217,Blupo,stormscale,1524,hunter,beastmastery,127,62,65
15218,Инкризшот,gordunni,1524,hunter,beastmastery,36,17,19
15219,Sarrow,ravencrest,1523,hunter,beastmastery,77,41,36
15220,Chenony,ravencrest,1523,hunter,beastmastery,78,36,42
15221,Atrisi,tarren-mill,1522,hunter,beastmastery,24,16,8
15222,Оуаоа,blackscar,1522,hunter,beastmastery,24,16,8
15223,Камшотовна,blackscar,1521,hunter,beastmastery,139,79,60
15224,Pewmasters,stormscale,1519,hunter,beastmastery,31,18,13
15225,Dregor,nemesis,1519,hunter,beastmastery,30,16,14
15226,Palaur,kazzak,1519,hunter,beastmastery,94,50,44
15227,Valldes,argent-dawn,1518,hunter,beastmastery,69,31,38
15228,Wøden,ysondre,1517,hunter,beastmastery,78,34,44
15229,Moistmán,kazzak,1514,hunter,beastmastery,176,85,91
15230,Draugrinnh,tarren-mill,1511,hunter,beastmastery,66,29,37
15231,Маунтдроп,gordunni,1509,hunter,beastmastery,130,70,60
15232,Кежма,howling-fjord,1507,hunter,beastmastery,42,26,16
15233,Gnouminøu,archimonde,1507,hunter,beastmastery,145,76,69
15234,Avatarofwoe,blackmoore,1507,hunter,beastmastery,48,20,28
15235,Жмыххунтер,howling-fjord,1504,hunter,beastmastery,60,26,34
15236,Icetrapped,eredar,1502,hunter,beastmastery,41,25,16
15237,Leriath,shadowsong,1502,hunter,beastmastery,89,52,37
15238,Palav,outland,1502,hunter,beastmastery,30,16,14
15239,Badkirves,kazzak,1502,hunter,beastmastery,84,41,43
15240,Druckwelle,frostwolf,1502,hunter,beastmastery,62,25,37
15241,Kravchenko,draenor,1501,hunter,beastmastery,41,23,18
15242,Gumm,gorgonnash,1496,hunter,beastmastery,30,17,13
15243,Funkalation,ravencrest,1495,hunter,beastmastery,36,20,16
15244,Ryuwen,dun-modr,1495,hunter,beastmastery,83,39,44
15245,Rdom,stormreaver,1493,hunter,beastmastery,96,49,47
15246,Øô,dun-morogh,1492,hunter,beastmastery,83,41,42
15247,Фдкд,howling-fjord,1492,hunter,beastmastery,72,33,39
15248,Amigoss,argent-dawn,1490,hunter,beastmastery,36,20,16
15249,Thinkerer,silvermoon,1490,hunter,beastmastery,38,17,21
15250,Solot,silvermoon,1490,hunter,beastmastery,54,24,30
15251,Laoriane,hyjal,1489,hunter,beastmastery,51,28,23
15252,Трэйсх,howling-fjord,1487,hunter,beastmastery,36,17,19
15253,Жэш,howling-fjord,1486,hunter,beastmastery,63,43,20
15254,Ahlgood,stormscale,1484,hunter,beastmastery,30,16,14
15255,Dramin,defias-brotherhood,1482,hunter,beastmastery,209,114,95
15256,Domnite,ravencrest,1482,hunter,beastmastery,139,74,65
15257,Anjeschka,nemesis,1481,hunter,beastmastery,58,35,23
15258,Raxedo,blackrock,1481,hunter,beastmastery,30,16,14
15259,Rhee,the-maelstrom,1481,hunter,beastmastery,96,44,52
15260,Лёт,azuregos,1478,hunter,beastmastery,50,31,19
15261,Almogrote,sanguino,1478,hunter,beastmastery,54,25,29
15262,Engetsu,drakthul,1476,hunter,beastmastery,90,43,47
15263,Lobos,ravencrest,1475,hunter,beastmastery,104,53,51
15264,Tràxes,quelthalas,1473,hunter,beastmastery,50,21,29
15265,Johnblønn,stormscale,1472,hunter,beastmastery,33,16,17
15266,Wingclip,ravencrest,1472,hunter,beastmastery,40,17,23
15267,Bastianapa,twisting-nether,1471,hunter,beastmastery,66,31,35
15268,Aenina,kazzak,1466,hunter,beastmastery,30,19,11
15269,Coldmonster,tarren-mill,1466,hunter,beastmastery,163,88,75
15270,Råhl,zuljin,1466,hunter,beastmastery,41,17,24
15271,Jas,kargath,1465,hunter,beastmastery,90,48,42
15272,Baileé,onyxia,1464,hunter,beastmastery,50,30,20
15273,Куоль,gordunni,1463,hunter,beastmastery,47,21,26
15274,Budhunter,alakir,1462,hunter,beastmastery,72,39,33
15275,Mytown,hyjal,1462,hunter,beastmastery,126,64,62
15276,Huntma,kazzak,1462,hunter,beastmastery,73,36,37
15277,Anca,aegwynn,1462,hunter,beastmastery,107,52,55
15278,Делар,howling-fjord,1461,hunter,beastmastery,42,17,25
15279,Ххун,gordunni,1460,hunter,beastmastery,46,24,22
15280,Ayyubi,blackrock,1460,hunter,beastmastery,71,36,35
15281,Чапуршилов,lich-king,1460,hunter,beastmastery,148,75,73
15282,Zäyk,zuljin,1459,hunter,beastmastery,37,21,16
15283,Ázurâ,blackhand,1458,hunter,beastmastery,75,39,36
15284,Johnwick,aerie-peak,1457,hunter,beastmastery,42,24,18
15285,Mufdii,sylvanas,1457,hunter,beastmastery,34,16,18
15286,Dzikabestia,burning-legion,1455,hunter,beastmastery,30,18,12
15287,Sylariel,die-aldor,1455,hunter,beastmastery,40,20,20
15288,Снюсинка,gordunni,1455,hunter,beastmastery,47,23,24
15289,Ivanthebeast,twisting-nether,1454,hunter,beastmastery,51,30,21
15290,Metalmaison,archimonde,1452,hunter,beastmastery,88,40,48
15291,Acmé,kazzak,1451,hunter,beastmastery,54,22,32
15292,Shawnrai,drakthul,1449,hunter,beastmastery,44,24,20
15293,Dirtydolores,thrall,1448,hunter,beastmastery,35,20,15
15294,Толяарканшот,razuvious,1448,hunter,beastmastery,36,20,16
15295,Сенджогахара,greymane,1447,hunter,beastmastery,37,17,20
15296,Slmao,tarren-mill,1447,hunter,beastmastery,91,39,52
15297,Raymear,kazzak,1446,hunter,beastmastery,48,27,21
15298,Metrolog,twisting-nether,1446,hunter,beastmastery,99,48,51
15299,Assbúrgers,silvermoon,1446,hunter,beastmastery,70,33,37
15300,Shieryu,archimonde,1446,hunter,beastmastery,48,19,29
15301,Yoggys,outland,1445,hunter,beastmastery,54,27,27
15302,Toxical,ragnaros,1444,hunter,beastmastery,24,17,7
15303,Gramzy,blackmoore,1443,hunter,beastmastery,41,18,23
15304,Watchouttah,the-maelstrom,1439,hunter,beastmastery,24,15,9
15305,Kásúxôxô,ravencrest,1439,hunter,beastmastery,30,15,15
15306,Ghost,tarren-mill,1439,hunter,beastmastery,30,15,15
15307,Earnzie,outland,1438,hunter,beastmastery,60,25,35
15308,Ilovekatsu,archimonde,1437,hunter,beastmastery,24,15,9
15309,Waalth,ragnaros,1437,hunter,beastmastery,76,37,39
15310,Yryyh,silvermoon,1436,hunter,beastmastery,54,20,34
15311,Clockwerk,durotan,1435,hunter,beastmastery,28,16,12
15312,Mágaz,draenor,1435,hunter,beastmastery,48,26,22
15313,Drigs,blackrock,1434,hunter,beastmastery,62,31,31
15314,Pancakesgo,twilights-hammer,1434,hunter,beastmastery,71,33,38
15315,Kissnodig,outland,1433,hunter,beastmastery,39,26,13
15316,Spizglub,defias-brotherhood,1433,hunter,beastmastery,59,28,31
15317,Crynomore,tarren-mill,1432,hunter,beastmastery,53,34,19
15318,Джаствэл,howling-fjord,1432,hunter,beastmastery,30,15,15
15319,Duïvell,grim-batol,1432,hunter,beastmastery,36,15,21
15320,Tukene,kazzak,1432,hunter,beastmastery,45,17,28
15321,Noréaga,suramar,1431,hunter,beastmastery,36,20,16
15322,Shoranon,stormscale,1431,hunter,beastmastery,30,15,15
15323,Jaxteller,archimonde,1431,hunter,beastmastery,30,15,15
15324,Strélka,blackrock,1431,hunter,beastmastery,36,16,20
15325,Fotmrerollér,aegwynn,1430,hunter,beastmastery,30,15,15
15326,Акройя,gordunni,1430,hunter,beastmastery,72,33,39
15327,Khatia,blackrock,1429,hunter,beastmastery,36,18,18
15328,Dzikapumpa,burning-legion,1429,hunter,beastmastery,39,18,21
15329,Наспидахх,blackscar,1427,hunter,beastmastery,24,15,9
15330,Eufumo,sanguino,1427,hunter,beastmastery,88,48,40
15331,Gondoo,tarren-mill,1427,hunter,beastmastery,30,15,15
15332,Grabbin,silvermoon,1425,hunter,beastmastery,34,16,18
15333,Гульнарамвд,gordunni,1422,hunter,beastmastery,36,15,21
15334,Ubietza,aegwynn,1421,hunter,beastmastery,54,23,31
15335,Трапча,soulflayer,1420,hunter,beastmastery,24,15,9
15336,Kethos,draenor,1420,hunter,beastmastery,54,28,26
15337,Mariehunt,blackmoore,1420,hunter,beastmastery,108,52,56
15338,Siegbald,ragnaros,1419,hunter,beastmastery,30,15,15
15339,Land,darkspear,1419,hunter,beastmastery,30,15,15
15340,Vypaz,twisting-nether,1419,hunter,beastmastery,54,26,28
15341,Sníper,aggra-português,1419,hunter,beastmastery,109,51,58
15342,Drivenscope,twisting-nether,1418,hunter,beastmastery,34,16,18
15343,Andjelaa,kazzak,1417,hunter,beastmastery,38,19,19
15344,Oife,auchindoun,1416,hunter,beastmastery,47,27,20
15345,Neíth,the-maelstrom,1415,hunter,beastmastery,69,31,38
15346,Jarekk,auchindoun,1414,hunter,beastmastery,53,28,25
15347,Xeld,outland,1414,hunter,beastmastery,30,15,15
15348,Эмомото,howling-fjord,1414,hunter,beastmastery,30,15,15
15349,Edùens,ysondre,1413,hunter,beastmastery,45,25,20
15350,Kalt,twisting-nether,1412,hunter,beastmastery,54,30,24
15351,Velocity,nagrand,1411,hunter,beastmastery,41,19,22
15352,Cosmol,kazzak,1409,hunter,beastmastery,47,24,23
15353,Стреладемона,gordunni,1407,hunter,beastmastery,69,40,29
15354,Hruon,sporeggar,1407,hunter,beastmastery,36,17,19
15355,Hammertime,sanguino,1406,hunter,beastmastery,71,36,35
15356,Flunkytim,blackmoore,1405,hunter,beastmastery,102,56,46
15357,Фетсол,soulflayer,1405,hunter,beastmastery,48,26,22
15358,Juha,the-maelstrom,1405,hunter,beastmastery,40,18,22
15359,Elsasehunter,zuljin,1402,hunter,beastmastery,132,60,72
15360,Váal,dun-modr,1401,hunter,beastmastery,63,36,27
15361,Neescafe,sylvanas,1401,hunter,beastmastery,45,25,20
15362,Xüscha,ysera,1401,hunter,beastmastery,78,33,45
15363,Geete,kazzak,1400,hunter,beastmastery,30,17,13
15364,Phinecone,stormscale,1399,hunter,beastmastery,42,18,24
15365,Thyala,twisting-nether,1398,hunter,beastmastery,33,16,17
15366,Дипшот,deathguard,1397,hunter,beastmastery,44,23,21
15367,Дафирия,deathguard,1395,hunter,beastmastery,58,31,27
15368,Luluxfire,burning-legion,1394,hunter,beastmastery,30,15,15
15369,Mââl,archimonde,1394,hunter,beastmastery,36,16,20
15370,Бубунн,howling-fjord,1394,hunter,beastmastery,96,42,54
15371,Metsänmies,defias-brotherhood,1393,hunter,beastmastery,46,27,19
15372,Xystîco,thrall,1393,hunter,beastmastery,54,26,28
15373,Шионо,howling-fjord,1391,hunter,beastmastery,56,29,27
15374,Беспокойный,soulflayer,1390,hunter,beastmastery,36,15,21
15375,Афигеннски,ashenvale,1387,hunter,beastmastery,54,25,29
15376,Adram,burning-legion,1386,hunter,beastmastery,29,16,13
15377,Berkobaggins,twisting-nether,1386,hunter,beastmastery,58,26,32
15378,Vimd,archimonde,1384,hunter,beastmastery,42,18,24
15379,Grrizzly,kazzak,1382,hunter,beastmastery,43,23,20
15380,Chagaure,hyjal,1382,hunter,beastmastery,36,17,19
15381,Viktorijå,draenor,1380,hunter,beastmastery,36,20,16
15382,Туруханец,gordunni,1380,hunter,beastmastery,108,59,49
15383,Beardmastery,auchindoun,1380,hunter,beastmastery,36,16,20
15384,Bambamgalke,antonidas,1378,hunter,beastmastery,72,34,38
15385,Amitar,tarren-mill,1377,hunter,beastmastery,48,28,20
15386,Талигар,razuvious,1377,hunter,beastmastery,78,33,45
15387,Хлопс,howling-fjord,1376,hunter,beastmastery,36,16,20
15388,Loógosh,blackmoore,1375,hunter,beastmastery,66,32,34
15389,Esgar,blackrock,1374,hunter,beastmastery,74,34,40
15390,Texaco,dun-modr,1374,hunter,beastmastery,55,25,30
15391,Nyght,ravencrest,1373,hunter,beastmastery,86,41,45
15392,Boulaax,ysondre,1372,hunter,beastmastery,118,66,52
15393,Lokiis,hyjal,1372,hunter,beastmastery,84,44,40
15394,Гиладар,borean-tundra,1372,hunter,beastmastery,41,18,23
15395,Фузег,deathguard,1370,hunter,beastmastery,128,65,63
15396,Glorfindhel,archimonde,1370,hunter,beastmastery,36,18,18
15397,Pumbuboo,deathwing,1370,hunter,beastmastery,42,18,24
15398,Wondersnipes,stormrage,1369,hunter,beastmastery,33,15,18
15399,Jaky,illidan,1368,hunter,beastmastery,179,104,75
15400,Анариэльсин,soulflayer,1368,hunter,beastmastery,36,15,21
15401,Честнный,howling-fjord,1366,hunter,beastmastery,141,64,77
15402,Beletor,medivh,1365,hunter,beastmastery,30,15,15
15403,Focuslhunt,archimonde,1363,hunter,beastmastery,30,18,12
15404,Zantorious,ravencrest,1363,hunter,beastmastery,63,37,26
15405,Saromán,ravencrest,1362,hunter,beastmastery,42,23,19
15406,Dêstiny,dun-modr,1360,hunter,beastmastery,30,17,13
15407,Traktorr,stormscale,1360,hunter,beastmastery,90,43,47
15408,Desow,blackrock,1359,hunter,beastmastery,48,27,21
15409,Dotkor,laughing-skull,1359,hunter,beastmastery,72,38,34
15410,Zúzú,hyjal,1358,hunter,beastmastery,54,32,22
15411,Pixxeel,khaz-modan,1356,hunter,beastmastery,30,15,15
15412,Nycrom,ravencrest,1354,hunter,beastmastery,32,15,17
15413,Киборка,howling-fjord,1352,hunter,beastmastery,30,15,15
15414,Asâya,blackmoore,1348,hunter,beastmastery,60,31,29
15415,Sebastien,frostmane,1347,hunter,beastmastery,33,17,16
15416,Artemisas,draenor,1346,hunter,beastmastery,48,16,32
15417,Zelarun,ragnaros,1345,hunter,beastmastery,42,24,18
15418,Felorya,kazzak,1345,hunter,beastmastery,46,25,21
15419,Glizzygobblr,kazzak,1345,hunter,beastmastery,28,15,13
15420,Porch,dragonmaw,1345,hunter,beastmastery,31,16,15
15421,Tåxi,silvermoon,1345,hunter,beastmastery,160,78,82
15422,Шэйдуокер,gordunni,1344,hunter,beastmastery,277,134,143
15423,Nerdhark,hyjal,1343,hunter,beastmastery,45,22,23
15424,Straybullet,kazzak,1343,hunter,beastmastery,119,56,63
15425,Yezzu,sylvanas,1343,hunter,beastmastery,30,14,16
15426,Ðoxz,blackrock,1342,hunter,beastmastery,24,14,10
15427,Чизано,deathguard,1342,hunter,beastmastery,53,25,28
15428,Hogar,frostwolf,1341,hunter,beastmastery,26,16,10
15429,Сатарр,gordunni,1341,hunter,beastmastery,154,74,80
15430,Äyumi,chogall,1341,hunter,beastmastery,42,18,24
15431,Karuso,ravencrest,1340,hunter,beastmastery,30,14,16
15432,Meskette,ravencrest,1340,hunter,beastmastery,70,30,40
15433,Gostry,archimonde,1339,hunter,beastmastery,24,14,10
15434,Joshalama,quelthalas,1339,hunter,beastmastery,35,19,16
15435,Unrealy,grim-batol,1339,hunter,beastmastery,182,95,87
15436,Clickbile,twisting-nether,1338,hunter,beastmastery,24,14,10
15437,Poatan,outland,1338,hunter,beastmastery,96,54,42
15438,Zisqa,alleria,1337,hunter,beastmastery,28,15,13
15439,Notikâ,aegwynn,1336,hunter,beastmastery,48,20,28
15440,Pammycakes,bronze-dragonflight,1335,hunter,beastmastery,194,96,98
15441,Raythe,argent-dawn,1335,hunter,beastmastery,30,14,16
15442,Simpyani,silvermoon,1333,hunter,beastmastery,24,14,10
15443,Заксель,soulflayer,1333,hunter,beastmastery,30,14,16
15444,Heoden,nemesis,1332,hunter,beastmastery,24,14,10
15445,Santiino,silvermoon,1332,hunter,beastmastery,30,14,16
15446,Lustor,ravencrest,1332,hunter,beastmastery,83,34,49
15447,Lòò,aegwynn,1330,hunter,beastmastery,24,14,10
15448,Trapwann,argent-dawn,1329,hunter,beastmastery,24,14,10
15449,Watntietjes,burning-blade,1329,hunter,beastmastery,48,22,26
15450,Афонадзе,gordunni,1329,hunter,beastmastery,90,41,49
15451,Feignindeath,twisting-nether,1328,hunter,beastmastery,60,35,25
15452,Mînérvá,blackhand,1327,hunter,beastmastery,36,20,16
15453,Settisetä,defias-brotherhood,1323,hunter,beastmastery,24,14,10
15454,Sélenaé,hyjal,1323,hunter,beastmastery,52,21,31
15455,Kiingsane,archimonde,1323,hunter,beastmastery,43,17,26
15456,Lis,gorgonnash,1323,hunter,beastmastery,36,14,22
15457,Drestan,drakthul,1322,hunter,beastmastery,60,26,34
15458,Luniel,gilneas,1321,hunter,beastmastery,24,14,10
15459,Travels,tarren-mill,1320,hunter,beastmastery,165,82,83
15460,Ríckybobby,kazzak,1319,hunter,beastmastery,43,22,21
15461,Zinco,ravencrest,1318,hunter,beastmastery,36,14,22
15462,Ловихимеру,soulflayer,1316,hunter,beastmastery,24,14,10
15463,Джантига,howling-fjord,1315,hunter,beastmastery,30,16,14
15464,Øßlíck,ysondre,1314,hunter,beastmastery,30,14,16
15465,Meredo,burning-legion,1313,hunter,beastmastery,64,33,31
15466,Dùmbo,khaz-modan,1313,hunter,beastmastery,96,46,50
15467,Bogüen,sanguino,1313,hunter,beastmastery,30,14,16
15468,Muspigen,tarren-mill,1313,hunter,beastmastery,83,38,45
15469,Ханзолес,gordunni,1312,hunter,beastmastery,24,14,10
15470,Люблюлюбовь,gordunni,1310,hunter,beastmastery,42,27,15
15471,Platzpatron,eredar,1310,hunter,beastmastery,69,30,39
15472,Nårgai,kargath,1305,hunter,beastmastery,30,18,12
15473,Showerhead,silvermoon,1305,hunter,beastmastery,32,14,18
15474,Proccter,silvermoon,1303,hunter,beastmastery,26,14,12
15475,Michaelvm,ravencrest,1302,hunter,beastmastery,36,20,16
15476,Devøurer,blackmoore,1301,hunter,beastmastery,24,14,10
15477,Penthesîlea,aegwynn,1301,hunter,beastmastery,50,24,26
15478,Halessia,ravencrest,1300,hunter,beastmastery,117,57,60
15479,Koopo,stormreaver,1299,hunter,beastmastery,51,28,23
15480,Whatifany,tarren-mill,1299,hunter,beastmastery,90,36,54
15481,Magarosh,eredar,1298,hunter,beastmastery,30,14,16
15482,Footsy,twisting-nether,1298,hunter,beastmastery,30,14,16
15483,Blastarrow,the-maelstrom,1293,hunter,beastmastery,72,30,42
15484,Hantro,argent-dawn,1292,hunter,beastmastery,36,20,16
15485,Bøwjøb,arthas,1292,hunter,beastmastery,42,23,19
15486,Sixty,rajaxx,1291,hunter,beastmastery,42,22,20
15487,Bågeniburen,draenor,1290,hunter,beastmastery,32,16,16
15488,Belorgrim,kirin-tor,1289,hunter,beastmastery,36,18,18
15489,Crippler,arthas,1288,hunter,beastmastery,22,15,7
15490,Zerisi,silvermoon,1288,hunter,beastmastery,35,21,14
15491,Salvia,chromaggus,1288,hunter,beastmastery,96,51,45
15492,Дзэнмашина,booty-bay,1285,hunter,beastmastery,80,40,40
15493,Yoüllsuffer,twisting-nether,1285,hunter,beastmastery,36,15,21
15494,Maknamara,tarren-mill,1284,hunter,beastmastery,60,31,29
15495,Fahin,draenor,1284,hunter,beastmastery,68,32,36
15496,Ynfik,sinstralis,1283,hunter,beastmastery,81,40,41
15497,Кулинарк,howling-fjord,1282,hunter,beastmastery,60,29,31
15498,Cobra,magtheridon,1282,hunter,beastmastery,71,30,41
15499,Bravestarr,blades-edge,1280,hunter,beastmastery,66,32,34
15500,Fenstad,dalaran,1279,hunter,beastmastery,52,25,27
15501,Rushgarroth,ravencrest,1271,hunter,beastmastery,96,44,52
15502,Безос,soulflayer,1270,hunter,beastmastery,44,23,21
15503,Asousa,stormscale,1269,hunter,beastmastery,66,32,34
15504,Яроняютрапу,gordunni,1268,hunter,beastmastery,34,21,13
15505,Rxr,kazzak,1264,hunter,beastmastery,54,17,37
15506,Бирмингем,ashenvale,1262,hunter,beastmastery,36,17,19
15507,Pennymarks,blackhand,1261,hunter,beastmastery,32,14,18
15508,Necromercy,burning-legion,1260,hunter,beastmastery,32,16,16
15509,Cêleste,kaelthas,1257,hunter,beastmastery,70,33,37
15510,Waidø,blackhand,1256,hunter,beastmastery,24,14,10
15511,Linchpin,dentarg,1255,hunter,beastmastery,62,28,34
15512,Aneji,hyjal,1254,hunter,beastmastery,38,19,19
15513,Swâân,sanguino,1254,hunter,beastmastery,33,16,17
15514,Mehtäsika,xavius,1254,hunter,beastmastery,45,21,24
15515,Pareia,blackrock,1248,hunter,beastmastery,18,13,5
15516,Oliene,twisting-nether,1248,hunter,beastmastery,58,27,31
15517,Ðowz,ysondre,1248,hunter,beastmastery,30,13,17
15518,Rïm,haomarush,1247,hunter,beastmastery,24,13,11
15519,Elmez,outland,1247,hunter,beastmastery,24,13,11
15520,Pagman,thrall,1247,hunter,beastmastery,30,13,17
15521,Космодиск,gordunni,1246,hunter,beastmastery,18,13,5
15522,Ivanoé,archimonde,1246,hunter,beastmastery,30,13,17
15523,Shenely,kazzak,1245,hunter,beastmastery,24,13,11
15524,Lothram,les-sentinelles,1245,hunter,beastmastery,24,13,11
15525,Лвндскейп,gordunni,1245,hunter,beastmastery,30,13,17
15526,Ommadawn,dun-modr,1244,hunter,beastmastery,72,33,39
15527,Brawnshunt,stormscale,1244,hunter,beastmastery,30,13,17
15528,Дуссита,gordunni,1244,hunter,beastmastery,36,13,23
15529,Dogthebounty,tarren-mill,1243,hunter,beastmastery,26,15,11
15530,Zäroury,ravencrest,1242,hunter,beastmastery,24,13,11
15531,Skytraped,hyjal,1242,hunter,beastmastery,24,13,11
15532,Ägris,die-todeskrallen,1242,hunter,beastmastery,150,72,78
15533,Bêastî,blackrock,1242,hunter,beastmastery,30,13,17
15534,Хастла,greymane,1240,hunter,beastmastery,30,13,17
15535,Blazeityolo,outland,1240,hunter,beastmastery,36,13,23
15536,Zusale,azshara,1238,hunter,beastmastery,24,13,11
15537,Verathelon,drakthul,1238,hunter,beastmastery,57,27,30
15538,Halgen,medivh,1237,hunter,beastmastery,88,37,51
15539,Freebïrd,shattered-hand,1236,hunter,beastmastery,24,13,11
15540,Benbutton,antonidas,1234,hunter,beastmastery,58,27,31
15541,Jyenety,stormscale,1233,hunter,beastmastery,36,18,18
15542,Bufosh,twisting-nether,1232,hunter,beastmastery,86,43,43
15543,Heiltfürzwei,ungoro,1232,hunter,beastmastery,35,15,20
15544,Брзенк,gordunni,1232,hunter,beastmastery,64,23,41
15545,Shaznak,argent-dawn,1231,hunter,beastmastery,36,17,19
15546,Skidzo,alakir,1231,hunter,beastmastery,32,15,17
15547,Оксанчек,howling-fjord,1229,hunter,beastmastery,29,13,16
15548,Latschodives,malorne,1229,hunter,beastmastery,33,13,20
15549,Bibsy,tarren-mill,1228,hunter,beastmastery,24,13,11
15550,Lusifa,antonidas,1228,hunter,beastmastery,87,46,41
15551,Qmbonboni,ravencrest,1226,hunter,beastmastery,55,32,23
15552,Toralfmoralf,aegwynn,1225,hunter,beastmastery,24,13,11
15553,Davíncí,tarren-mill,1224,hunter,beastmastery,77,41,36
15554,Neeske,sylvanas,1224,hunter,beastmastery,30,13,17
15555,Annisaqt,kazzak,1222,hunter,beastmastery,47,25,22
15556,Vexhh,outland,1221,hunter,beastmastery,24,13,11
15557,Ridlas,silvermoon,1221,hunter,beastmastery,60,28,32
15558,Ililivillumi,tarren-mill,1219,hunter,beastmastery,43,24,19
15559,Pewpewcus,ravencrest,1219,hunter,beastmastery,43,24,19
15560,Балласкиндер,gordunni,1219,hunter,beastmastery,66,36,30
15561,Kyliun,frostmane,1219,hunter,beastmastery,53,24,29
15562,Robal,burning-legion,1219,hunter,beastmastery,42,19,23
15563,Stogie,auchindoun,1217,hunter,beastmastery,24,13,11
15564,Spineshot,thrall,1217,hunter,beastmastery,60,24,36
15565,Bigfoot,argent-dawn,1215,hunter,beastmastery,98,44,54
15566,Гримкааг,eversong,1214,hunter,beastmastery,55,27,28
15567,Тофуитер,howling-fjord,1214,hunter,beastmastery,57,25,32
15568,Kiwala,burning-legion,1212,hunter,beastmastery,48,22,26
15569,Câonimâ,twisting-nether,1212,hunter,beastmastery,30,13,17
15570,Snipingdog,stormscale,1209,hunter,beastmastery,36,18,18
15571,Heylie,senjin,1206,hunter,beastmastery,47,16,31
15572,Papithagore,hyjal,1203,hunter,beastmastery,29,13,16
15573,Ниамх,blackscar,1203,hunter,beastmastery,47,21,26
15574,Diac,dalaran,1201,hunter,beastmastery,18,13,5
15575,Sithrom,blackmoore,1201,hunter,beastmastery,28,13,15
15576,Анютикус,gordunni,1199,hunter,beastmastery,60,34,26
15577,Фитьфитий,howling-fjord,1197,hunter,beastmastery,47,22,25
15578,Slojork,thrall,1190,hunter,beastmastery,92,40,52
15579,Johntoffee,eredar,1190,hunter,beastmastery,35,14,21
15580,Ashjen,aszune,1188,hunter,beastmastery,29,18,11
15581,Kaletorw,ragnaros,1187,hunter,beastmastery,36,20,16
15582,Eddy,the-maelstrom,1187,hunter,beastmastery,36,20,16
15583,Быщь,gordunni,1186,hunter,beastmastery,29,14,15
15584,Loyalman,blackmoore,1180,hunter,beastmastery,24,15,9
15585,Винченцо,blackscar,1180,hunter,beastmastery,27,13,14
15586,Cicatrice,kazzak,1180,hunter,beastmastery,28,13,15
15587,Harpin,azuremyst,1179,hunter,beastmastery,65,32,33
15588,Haleth,uldum,1177,hunter,beastmastery,29,13,16
15589,Fizè,blackmoore,1175,hunter,beastmastery,23,13,10
15590,Амобарбиталх,gordunni,1173,hunter,beastmastery,39,20,19
15591,Gbureczka,burning-legion,1171,hunter,beastmastery,32,13,19
15592,Skullstah,ravencrest,1169,hunter,beastmastery,24,13,11
15593,Straikkeri,draenor,1169,hunter,beastmastery,41,18,23
15594,Sàclak,ysondre,1166,hunter,beastmastery,31,17,14
15595,Spycke,dalaran,1163,hunter,beastmastery,33,22,11
15596,Cabuløsø,aggra-português,1162,hunter,beastmastery,24,13,11
15597,Cinan,twisting-nether,1161,hunter,beastmastery,119,60,59
15598,Ønur,twisting-nether,1159,hunter,beastmastery,72,37,35
15599,Cityhunter,archimonde,1156,hunter,beastmastery,64,30,34
15600,Eluun,saurfang,1156,hunter,beastmastery,30,13,17
15601,Velites,aggra-português,1155,hunter,beastmastery,27,15,12
15602,Rafizox,kazzak,1152,hunter,beastmastery,18,12,6
15603,Lajnus,frostmane,1152,hunter,beastmastery,24,12,12
15604,Basìcs,nemesis,1152,hunter,beastmastery,60,27,33
15605,Hizzenstein,blackhand,1151,hunter,beastmastery,24,12,12
15606,Jeskö,tarren-mill,1151,hunter,beastmastery,24,12,12
15607,Mercoßenz,kazzak,1151,hunter,beastmastery,24,12,12
15608,Blazinghunt,kazzak,1150,hunter,beastmastery,18,12,6
15609,Fendros,kazzak,1150,hunter,beastmastery,18,12,6
15610,Kayluh,sylvanas,1150,hunter,beastmastery,18,12,6
15611,Digimørtal,kazzak,1150,hunter,beastmastery,18,12,6
15612,Wicmex,archimonde,1150,hunter,beastmastery,18,12,6
15613,Leza,kult-der-verdammten,1150,hunter,beastmastery,24,12,12
15614,Bujie,ragnaros,1150,hunter,beastmastery,30,12,18
15615,Амореселф,gordunni,1150,hunter,beastmastery,30,12,18
15616,Outkást,sylvanas,1150,hunter,beastmastery,30,12,18
15617,Næ,kazzak,1150,hunter,beastmastery,30,12,18
15618,Crowsza,archimonde,1150,hunter,beastmastery,34,13,21
15619,Mâjôô,blackhand,1149,hunter,beastmastery,22,13,9
15620,Noxin,blackrock,1149,hunter,beastmastery,24,12,12
15621,Hõth,kazzak,1149,hunter,beastmastery,30,12,18
15622,Мэдраэль,deathguard,1148,hunter,beastmastery,39,18,21
15623,Garfie,tarren-mill,1147,hunter,beastmastery,22,13,9
15624,Amdonesia,ravencrest,1147,hunter,beastmastery,54,18,36
15625,Yoorizz,outland,1147,hunter,beastmastery,36,12,24
15626,Подлыйстарик,gordunni,1146,hunter,beastmastery,24,12,12
15627,Gorgorm,ravencrest,1146,hunter,beastmastery,36,12,24
15628,Eöe,ragnaros,1145,hunter,beastmastery,24,12,12
15629,Лсныйпамп,howling-fjord,1145,hunter,beastmastery,24,12,12
15630,Weiaw,blackmoore,1144,hunter,beastmastery,24,12,12
15631,Yeign,eredar,1144,hunter,beastmastery,24,12,12
15632,Hunterbeck,ravencrest,1144,hunter,beastmastery,78,32,46
15633,Lunaunii,argent-dawn,1142,hunter,beastmastery,18,12,6
15634,Nissa,blackrock,1142,hunter,beastmastery,24,12,12
15635,Синглшот,blackscar,1141,hunter,beastmastery,24,12,12
15636,Xéraphine,mannoroth,1141,hunter,beastmastery,30,12,18
15637,Hlynsson,tarren-mill,1140,hunter,beastmastery,18,12,6
15638,Retroxia,stormreaver,1139,hunter,beastmastery,24,12,12
15639,Mordhunterx,draenor,1138,hunter,beastmastery,24,12,12
15640,Tedohunter,ragnaros,1138,hunter,beastmastery,42,19,23
15641,Zpy,blackmoore,1137,hunter,beastmastery,18,12,6
15642,Crossjob,kazzak,1136,hunter,beastmastery,24,12,12
15643,Бвонсамдик,howling-fjord,1135,hunter,beastmastery,24,12,12
15644,Abovival,ragnaros,1134,hunter,beastmastery,24,12,12
15645,Tempestes,tarren-mill,1133,hunter,beastmastery,83,41,42
15646,Tomli,nemesis,1133,hunter,beastmastery,27,13,14
15647,Armanny,sylvanas,1132,hunter,beastmastery,36,12,24
15648,Olamay,blackmoore,1131,hunter,beastmastery,62,31,31
15649,Ázèrøñå,ravencrest,1129,hunter,beastmastery,27,16,11
15650,Oròme,pozzo-delleternità,1129,hunter,beastmastery,72,36,36
15651,Pigoen,sporeggar,1128,hunter,beastmastery,89,40,49
15652,Tremby,kazzak,1124,hunter,beastmastery,27,13,14
15653,Deunan,shattered-hand,1122,hunter,beastmastery,24,12,12
15654,Paînfull,kazzak,1115,hunter,beastmastery,29,12,17
15655,Huntiio,khaz-modan,1113,hunter,beastmastery,60,25,35
15656,Cäri,colinas-pardas,1109,hunter,beastmastery,36,16,20
15657,Jollis,argent-dawn,1108,hunter,beastmastery,33,13,20
15658,Øutkast,silvermoon,1105,hunter,beastmastery,29,18,11
15659,Ládysháyà,blackrock,1104,hunter,beastmastery,84,42,42
15660,Куфачка,soulflayer,1103,hunter,beastmastery,17,12,5
15661,Nerfjuice,silvermoon,1102,hunter,beastmastery,39,21,18
15662,Sâranjágo,argent-dawn,1102,hunter,beastmastery,61,29,32
15663,Savori,kazzak,1100,hunter,beastmastery,37,21,16
15664,Cyclontrapgg,antonidas,1100,hunter,beastmastery,23,13,10
15665,Paraskámu,twisting-nether,1099,hunter,beastmastery,23,12,11
15666,Atraxi,aegwynn,1096,hunter,beastmastery,64,28,36
15667,Tsoutsoukoss,silvermoon,1095,hunter,beastmastery,109,52,57
15668,Goonii,bronzebeard,1094,hunter,beastmastery,24,12,12
15669,Janjal,silvermoon,1094,hunter,beastmastery,129,57,72
15670,Karstarkk,sanguino,1092,hunter,beastmastery,65,28,37
15671,Ertestuing,tarren-mill,1090,hunter,beastmastery,30,14,16
15672,Ezelina,lightnings-blade,1086,hunter,beastmastery,54,27,27
15673,Brometheus,sylvanas,1083,hunter,beastmastery,41,15,26
15674,Soulshoot,khaz-modan,1078,hunter,beastmastery,88,44,44
15675,Pawder,silvermoon,1077,hunter,beastmastery,42,15,27
15676,Musraah,zuljin,1076,hunter,beastmastery,21,13,8
15677,Nieki,eitrigg,1070,hunter,beastmastery,80,30,50
15678,Spiritshot,baelgun,1066,hunter,beastmastery,34,14,20
15679,Venkox,archimonde,1062,hunter,beastmastery,79,42,37
15680,Cruelsummer,kul-tiras,1061,hunter,beastmastery,60,22,38
15681,Deblaze,aegwynn,1056,hunter,beastmastery,18,11,7
15682,Irükandji,chants-éternels,1056,hunter,beastmastery,18,11,7
15683,Trapgodxx,archimonde,1056,hunter,beastmastery,24,11,13
15684,Vargar,arygos,1056,hunter,beastmastery,24,11,13
15685,Jaxxoo,outland,1055,hunter,beastmastery,18,11,7
15686,Pjållistani,ravencrest,1055,hunter,beastmastery,30,11,19
15687,Reyko,stormscale,1055,hunter,beastmastery,30,11,19
15688,Bazouf,outland,1054,hunter,beastmastery,18,11,7
15689,Дэскрайт,soulflayer,1054,hunter,beastmastery,18,11,7
15690,Notx,ravencrest,1054,hunter,beastmastery,18,11,7
15691,Daveq,drakthul,1054,hunter,beastmastery,24,11,13
15692,Зимняясказка,soulflayer,1053,hunter,beastmastery,29,11,18
15693,Jakis,silvermoon,1052,hunter,beastmastery,18,11,7
15694,Gobliniehoóo,azuremyst,1051,hunter,beastmastery,16,12,4
15695,Arrechus,khaz-modan,1051,hunter,beastmastery,116,54,62
15696,Greg,defias-brotherhood,1051,hunter,beastmastery,24,11,13
15697,Darllene,kazzak,1051,hunter,beastmastery,30,11,19
15698,Pilogbueferd,silvermoon,1050,hunter,beastmastery,18,11,7
15699,Румлис,gordunni,1048,hunter,beastmastery,33,16,17
15700,Коблазнх,howling-fjord,1048,hunter,beastmastery,24,11,13
15701,Sourxete,silvermoon,1048,hunter,beastmastery,24,11,13
15702,Githo,argent-dawn,1047,hunter,beastmastery,21,12,9
15703,Sillychilly,frostwolf,1045,hunter,beastmastery,30,11,19
15704,Shinibon,blackmoore,1044,hunter,beastmastery,36,11,25
15705,Бедствиие,galakrond,1044,hunter,beastmastery,36,11,25
15706,Nidromel,stormscale,1043,hunter,beastmastery,113,52,61
15707,Ayaille,marécage-de-zangar,1043,hunter,beastmastery,40,14,26
15708,Yukina,frostmourne,1038,hunter,beastmastery,28,13,15
15709,Arnatti,tyrande,1036,hunter,beastmastery,28,16,12
15710,Pumukle,madmortem,1035,hunter,beastmastery,34,15,19
15711,Luckyhunty,dalaran,1034,hunter,beastmastery,53,21,32
15712,Айлиси,soulflayer,1031,hunter,beastmastery,43,11,32
15713,Nesthor,sinstralis,1026,hunter,beastmastery,30,11,19
15714,Ремонтлицаа,gordunni,1022,hunter,beastmastery,23,11,12
15715,Ветиринарша,gordunni,1020,hunter,beastmastery,30,11,19
15716,Leemool,ysondre,1017,hunter,beastmastery,24,12,12
15717,Grollar,ragnaros,1014,hunter,beastmastery,80,42,38
15718,Faze,hellfire,1013,hunter,beastmastery,60,30,30
15719,Schnezzler,nerathor,1011,hunter,beastmastery,100,48,52
15720,Bouboule,elune,1010,hunter,beastmastery,48,29,19
15721,Arakton,drakthul,1008,hunter,beastmastery,46,23,23
15722,Weisswinter,drakthul,1004,hunter,beastmastery,24,12,12
15723,Jimmý,sylvanas,1004,hunter,beastmastery,26,11,15
15724,Magrha,khaz-modan,1003,hunter,beastmastery,23,11,12
15725,Фэннон,gordunni,1002,hunter,beastmastery,27,13,14
15726,Lissudarlin,stormreaver,1000,hunter,beastmastery,211,110,101
15727,Shpider,burning-blade,1000,hunter,beastmastery,52,22,30
15728,Feigur,sanguino,999,hunter,beastmastery,47,24,23
15729,Kagan,nemesis,998,hunter,beastmastery,29,17,12
15730,Bigbababotan,blackrock,996,hunter,beastmastery,27,12,15
15731,Sinux,lordaeron,995,hunter,beastmastery,17,11,6
15732,Kure,blackrock,993,hunter,beastmastery,91,43,48
15733,Grandiosity,tarren-mill,992,hunter,beastmastery,17,11,6
15734,Хантвкроксах,gordunni,991,hunter,beastmastery,26,12,14
15735,Enanorabioso,minahonda,991,hunter,beastmastery,30,12,18
15736,Frencharena,the-venture-co,990,hunter,beastmastery,29,11,18
15737,Ulyash,ysondre,990,hunter,beastmastery,42,14,28
15738,Neuromancien,archimonde,990,hunter,beastmastery,35,11,24
15739,Rubyblack,archimonde,984,hunter,beastmastery,48,24,24
15740,Floppybobby,burning-blade,980,hunter,beastmastery,29,12,17
15741,Вагар,blackscar,974,hunter,beastmastery,18,12,6
15742,Kikijojo,ravencrest,971,hunter,beastmastery,30,16,14
15743,Traenuss,azuremyst,968,hunter,beastmastery,48,19,29
15744,Llamp,draenor,964,hunter,beastmastery,60,29,31
15745,Dariatate,eredar,963,hunter,beastmastery,40,17,23
15746,Торая,gordunni,960,hunter,beastmastery,12,10,2
15747,Missmytrap,archimonde,960,hunter,beastmastery,12,10,2
15748,Dathrixjr,ravencrest,960,hunter,beastmastery,12,10,2
15749,Narolaf,doomhammer,960,hunter,beastmastery,15,11,4
15750,Kásúxøxø,ravencrest,960,hunter,beastmastery,16,11,5
15751,Akhtabot,twisting-nether,960,hunter,beastmastery,18,10,8
15752,Hasáblover,ragnaros,960,hunter,beastmastery,18,10,8
15753,Spergmeister,argent-dawn,960,hunter,beastmastery,18,10,8
15754,Dealtqt,ysondre,960,hunter,beastmastery,18,10,8
15755,Хантнерюга,gordunni,960,hunter,beastmastery,18,10,8
15756,Filaliel,outland,960,hunter,beastmastery,18,10,8
15757,Hahahxd,ragnaros,960,hunter,beastmastery,18,10,8
15758,Vhalín,magtheridon,960,hunter,beastmastery,24,10,14
15759,Jägarn,stormscale,960,hunter,beastmastery,24,10,14
15760,Zeanort,nordrassil,960,hunter,beastmastery,24,10,14
15761,Jackjager,ravencrest,960,hunter,beastmastery,24,10,14
15762,Hollyz,auchindoun,960,hunter,beastmastery,24,10,14
15763,Gitanìlla,dun-modr,960,hunter,beastmastery,30,10,20
15764,Bubby,burning-legion,960,hunter,beastmastery,34,11,23
15765,Mckanê,ysondre,959,hunter,beastmastery,18,10,8
15766,Rashoumon,zuljin,959,hunter,beastmastery,18,10,8
15767,Dragh,blackrock,959,hunter,beastmastery,18,10,8
15768,Bempl,onyxia,959,hunter,beastmastery,24,10,14
15769,Appollo,magtheridon,959,hunter,beastmastery,24,10,14
15770,Ausgefuchst,forscherliga,959,hunter,beastmastery,24,10,14
15771,Brmwall,twisting-nether,959,hunter,beastmastery,24,10,14
15772,Svolatch,blackrock,959,hunter,beastmastery,30,10,20
15773,Alée,twisting-nether,959,hunter,beastmastery,30,10,20
15774,Rikitikii,burning-legion,958,hunter,beastmastery,15,11,4
15775,Wüst,tarren-mill,958,hunter,beastmastery,18,10,8
15776,Soblazed,twisting-nether,958,hunter,beastmastery,18,10,8
15777,Shikar,sanguino,958,hunter,beastmastery,18,10,8
15778,Blainehunts,arathor,958,hunter,beastmastery,36,11,25
15779,Vescar,argent-dawn,958,hunter,beastmastery,36,10,26
15780,Choukzt,archimonde,957,hunter,beastmastery,18,10,8
15781,Therasin,ravenholdt,957,hunter,beastmastery,18,10,8
15782,Nandrohunt,dalaran,957,hunter,beastmastery,24,10,14
15783,Skipee,ravencrest,956,hunter,beastmastery,18,10,8
15784,Vassiliadis,bronze-dragonflight,956,hunter,beastmastery,30,10,20
15785,Blutack,stormscale,956,hunter,beastmastery,30,10,20
15786,Pufyrella,kilrogg,955,hunter,beastmastery,18,10,8
15787,Ahsóka,frostwhisper,955,hunter,beastmastery,18,10,8
15788,Hílfíger,kazzak,955,hunter,beastmastery,30,10,20
15789,Badhunt,stormscale,954,hunter,beastmastery,30,10,20
15790,Herpray,blackmoore,953,hunter,beastmastery,18,10,8
15791,Shantala,frostwolf,953,hunter,beastmastery,24,10,14
15792,Soen,zuljin,953,hunter,beastmastery,24,10,14
15793,Karên,blackmoore,952,hunter,beastmastery,24,10,14
15794,Ecalter,dun-modr,951,hunter,beastmastery,18,10,8
15795,Darkdexou,defias-brotherhood,951,hunter,beastmastery,18,10,8
15796,Marleyson,uldum,951,hunter,beastmastery,24,10,14
15797,Lioness,ahnqiraj,951,hunter,beastmastery,24,10,14
15798,Misfîre,tarren-mill,950,hunter,beastmastery,18,10,8
15799,Zappikhunter,silvermoon,950,hunter,beastmastery,24,10,14
15800,Woöky,dalaran,948,hunter,beastmastery,26,16,10
15801,Crittix,kiljaeden,948,hunter,beastmastery,24,10,14
15802,Zarlena,tarren-mill,947,hunter,beastmastery,43,19,24
15803,Bakatumbah,draenor,946,hunter,beastmastery,18,10,8
15804,Cernunnos,auchindoun,944,hunter,beastmastery,19,10,9
15805,Lemeric,blackmoore,942,hunter,beastmastery,19,10,9
15806,Deadlysnîpe,antonidas,941,hunter,beastmastery,16,11,5
15807,Грознострел,gordunni,939,hunter,beastmastery,32,17,15
15808,Jaguarundy,dun-modr,939,hunter,beastmastery,24,10,14
15809,Guanchin,silvermoon,938,hunter,beastmastery,30,10,20
15810,Dioxis,silvermoon,932,hunter,beastmastery,118,57,61
15811,Lore,hyjal,922,hunter,beastmastery,17,10,7
15812,Nixxay,antonidas,920,hunter,beastmastery,42,22,20
15813,Xyrone,bladefist,920,hunter,beastmastery,36,15,21
15814,Goliathoz,blackmoore,917,hunter,beastmastery,35,19,16
15815,Stjordal,chamber-of-aspects,917,hunter,beastmastery,63,30,33
15816,Баззи,grom,916,hunter,beastmastery,30,16,14
15817,Kronzucker,eredar,914,hunter,beastmastery,36,16,20
15818,Graltar,tarren-mill,911,hunter,beastmastery,23,10,13
15819,Allcollapse,outland,910,hunter,beastmastery,21,11,10
15820,Rachelgg,ravencrest,910,hunter,beastmastery,22,10,12
15821,Zorana,twisting-nether,910,hunter,beastmastery,23,10,13
15822,Mankkis,stormscale,909,hunter,beastmastery,48,14,34
15823,Vystrelil,drakthul,906,hunter,beastmastery,109,56,53
15824,Happyrme,thrall,906,hunter,beastmastery,30,14,16
15825,Bjarnhild,die-aldor,906,hunter,beastmastery,24,11,13
15826,Delazi,proudmoore,905,hunter,beastmastery,30,11,19
15827,Beeng,ravencrest,896,hunter,beastmastery,22,10,12
15828,Zoomiesuwu,antonidas,895,hunter,beastmastery,17,10,7
15829,Draknik,nemesis,895,hunter,beastmastery,39,10,29
15830,Jagarbladet,ravencrest,894,hunter,beastmastery,16,10,6
15831,Teacee,twisting-nether,894,hunter,beastmastery,29,13,16
15832,Kënshiro,kazzak,893,hunter,beastmastery,20,10,10
15833,Bornum,khaz-modan,892,hunter,beastmastery,31,10,21
15834,Utopia,korgall,890,hunter,beastmastery,36,12,24
15835,Catmother,grim-batol,886,hunter,beastmastery,20,12,8
15836,Зоопсихолог,gordunni,886,hunter,beastmastery,36,18,18
15837,Lakys,cthun,886,hunter,beastmastery,28,10,18
15838,Akrepkral,kargath,881,hunter,beastmastery,55,26,29
15839,Wodlenprince,draenor,874,hunter,beastmastery,66,14,52
15840,Onlyforfun,ravencrest,864,hunter,beastmastery,12,9,3
15841,Lilpancake,kazzak,864,hunter,beastmastery,12,9,3
15842,Grapemint,blackrock,864,hunter,beastmastery,12,9,3
15843,Тирин,ashenvale,864,hunter,beastmastery,12,9,3
15844,Kapowz,kazzak,864,hunter,beastmastery,12,9,3
15845,Hispanøxd,sanguino,864,hunter,beastmastery,12,9,3
15846,Eenel,twisting-nether,864,hunter,beastmastery,12,9,3
15847,Dwgkia,ravencrest,864,hunter,beastmastery,18,9,9
15848,Tauriêl,blutkessel,864,hunter,beastmastery,18,9,9
15849,Cryptomars,twisting-nether,864,hunter,beastmastery,18,9,9
15850,Negz,eredar,864,hunter,beastmastery,18,9,9
15851,Timec,outland,864,hunter,beastmastery,18,9,9
15852,Lísy,hyjal,864,hunter,beastmastery,18,9,9
15853,Weoneshot,ravencrest,864,hunter,beastmastery,18,9,9
15854,Petitsui,zuljin,864,hunter,beastmastery,18,9,9
15855,Dawil,ragnaros,864,hunter,beastmastery,18,9,9
15856,Chipok,outland,864,hunter,beastmastery,29,11,18
15857,Valhnir,sanguino,864,hunter,beastmastery,24,9,15
15858,Zyrøra,ravencrest,864,hunter,beastmastery,24,9,15
15859,Coôkie,ysondre,864,hunter,beastmastery,24,9,15
15860,Леоа,howling-fjord,864,hunter,beastmastery,27,10,17
15861,Elfyhunter,outland,864,hunter,beastmastery,30,9,21
15862,Skeng,xavius,863,hunter,beastmastery,12,9,3
15863,Srvol,dun-modr,863,hunter,beastmastery,12,9,3
15864,Jahunter,aggra-português,863,hunter,beastmastery,18,9,9
15865,Reshka,dunemaul,863,hunter,beastmastery,18,9,9
15866,Лиор,howling-fjord,863,hunter,beastmastery,18,9,9
15867,Aliltoxic,silvermoon,863,hunter,beastmastery,18,9,9
15868,Fléxyz,sylvanas,863,hunter,beastmastery,18,9,9
15869,Holdmypurse,kazzak,863,hunter,beastmastery,18,9,9
15870,Кишмякхант,howling-fjord,863,hunter,beastmastery,18,9,9
15871,Pavxar,draenor,863,hunter,beastmastery,18,9,9
15872,Nillaxy,blackmoore,863,hunter,beastmastery,18,9,9
15873,Lightcheese,twisting-nether,863,hunter,beastmastery,18,9,9
15874,Wolfyx,cthun,863,hunter,beastmastery,18,9,9
15875,Lännennopein,outland,863,hunter,beastmastery,23,11,12
15876,Nettie,arathor,863,hunter,beastmastery,24,9,15
15877,Krâven,ysondre,863,hunter,beastmastery,36,9,27
15878,Massimox,draenor,862,hunter,beastmastery,12,9,3
15879,Ecthelione,the-venture-co,862,hunter,beastmastery,18,9,9
15880,Vyrê,ghostlands,862,hunter,beastmastery,18,9,9
15881,Leáa,eredar,862,hunter,beastmastery,18,9,9
15882,Arrowman,burning-legion,862,hunter,beastmastery,18,9,9
15883,Aamön,tarren-mill,862,hunter,beastmastery,24,9,15
15884,Buc,burning-legion,862,hunter,beastmastery,28,9,19
15885,Hävenofün,archimonde,862,hunter,beastmastery,30,9,21
15886,Tsivoula,twisting-nether,861,hunter,beastmastery,12,9,3
15887,Xalh,hyjal,861,hunter,beastmastery,18,9,9
15888,Measpy,blackrock,860,hunter,beastmastery,18,9,9
15889,Скелус,soulflayer,859,hunter,beastmastery,18,9,9
15890,Zalacko,ragnaros,859,hunter,beastmastery,18,9,9
15891,Герциг,gordunni,859,hunter,beastmastery,18,9,9
15892,Sylverein,silvermoon,859,hunter,beastmastery,25,9,16
15893,Sokyokuh,burning-legion,858,hunter,beastmastery,18,9,9
15894,Darilli,wildhammer,858,hunter,beastmastery,19,9,10
15895,Tunhaa,arthas,858,hunter,beastmastery,28,11,17
15896,Mindgap,pozzo-delleternità,858,hunter,beastmastery,24,9,15
15897,Тысячиимен,gordunni,857,hunter,beastmastery,18,9,9
15898,Бруксиан,fordragon,857,hunter,beastmastery,19,9,10
15899,Sika,nozdormu,857,hunter,beastmastery,24,9,15
15900,Сяову,gordunni,852,hunter,beastmastery,97,37,60
15901,Towu,archimonde,849,hunter,beastmastery,24,9,15
15902,Zinnady,outland,846,hunter,beastmastery,12,9,3
15903,Greenstar,twisting-nether,846,hunter,beastmastery,27,10,17
15904,Гоу,fordragon,843,hunter,beastmastery,30,9,21
15905,Olddèath,archimonde,837,hunter,beastmastery,24,9,15
15906,Zimmoo,tarren-mill,833,hunter,beastmastery,18,9,9
15907,Venõm,pozzo-delleternità,832,hunter,beastmastery,21,11,10
15908,Гримнар,borean-tundra,831,hunter,beastmastery,17,9,8
15909,Jexxa,draenor,831,hunter,beastmastery,31,9,22
15910,Enty,blackrock,830,hunter,beastmastery,14,10,4
15911,Deathmarks,blackrock,830,hunter,beastmastery,29,9,20
15912,Marlaska,exodar,829,hunter,beastmastery,57,27,30
15913,Аквилеон,gordunni,829,hunter,beastmastery,23,9,14
15914,Võnbødefeld,frostmourne,827,hunter,beastmastery,17,9,8
15915,Poine,sylvanas,826,hunter,beastmastery,24,11,13
15916,Oramar,archimonde,824,hunter,beastmastery,24,9,15
15917,Angeedau,kazzak,815,hunter,beastmastery,17,9,8
15918,Anoroxx,arthas,815,hunter,beastmastery,17,9,8
15919,Шаурмэ,gordunni,815,hunter,beastmastery,21,9,12
15920,Belgorin,alexstrasza,813,hunter,beastmastery,66,30,36
15921,Insanepvper,argent-dawn,812,hunter,beastmastery,21,9,12
15922,Kreiden,twisting-nether,810,hunter,beastmastery,34,11,23
15923,Legosoldaten,stormscale,800,hunter,beastmastery,16,9,7
15924,Colth,hyjal,799,hunter,beastmastery,29,9,20
15925,Slaghunter,argent-dawn,798,hunter,beastmastery,17,9,8
15926,Bnji,hyjal,797,hunter,beastmastery,22,9,13
15927,Maglór,senjin,796,hunter,beastmastery,25,10,15
15928,Melèxè,ysondre,795,hunter,beastmastery,29,9,20
15929,Grokis,blackhand,782,hunter,beastmastery,67,28,39
15930,Hecken,nemesis,768,hunter,beastmastery,12,8,4
15931,Ebobuss,tarren-mill,768,hunter,beastmastery,12,8,4
15932,Thebigboom,outland,768,hunter,beastmastery,12,8,4
15933,Poggelicious,terenas,768,hunter,beastmastery,12,8,4
15934,Mettämies,twisting-nether,768,hunter,beastmastery,12,8,4
15935,Sejkxi,malganis,768,hunter,beastmastery,12,8,4
15936,Suffrebobbs,ravencrest,768,hunter,beastmastery,12,8,4
15937,Deadshøt,thrall,768,hunter,beastmastery,12,8,4
15938,Híldir,draenor,768,hunter,beastmastery,12,8,4
15939,Bonobo,dentarg,768,hunter,beastmastery,18,8,10
15940,Baïonnettex,archimonde,768,hunter,beastmastery,18,8,10
15941,Krâýnn,aegwynn,768,hunter,beastmastery,18,8,10
15942,Páiz,tarren-mill,768,hunter,beastmastery,18,8,10
15943,Ishotharambe,doomhammer,768,hunter,beastmastery,18,8,10
15944,Utoast,ravencrest,768,hunter,beastmastery,18,8,10
15945,Vasco,chogall,768,hunter,beastmastery,18,8,10
15946,Leonidazar,draenor,768,hunter,beastmastery,18,8,10
15947,Psymòn,ravencrest,768,hunter,beastmastery,18,8,10
15948,Рафлекс,eversong,768,hunter,beastmastery,18,8,10
15949,Freakyhoe,twisting-nether,768,hunter,beastmastery,18,8,10
15950,Krakenaspect,kazzak,768,hunter,beastmastery,18,8,10
15951,Кертион,howling-fjord,768,hunter,beastmastery,18,8,10
15952,Pewpewstuff,draenor,768,hunter,beastmastery,18,8,10
15953,Stuckstepbro,silvermoon,768,hunter,beastmastery,24,8,16
15954,Джулибуба,howling-fjord,768,hunter,beastmastery,24,8,16
15955,Craná,blackrock,768,hunter,beastmastery,24,8,16
15956,Mogumogu,blackhand,768,hunter,beastmastery,24,8,16
15957,Wayland,dalaran,768,hunter,beastmastery,24,8,16
15958,Fridion,argent-dawn,768,hunter,beastmastery,24,8,16
15959,Deepcleaning,kazzak,768,hunter,beastmastery,30,8,22
15960,Hyunkies,ysondre,768,hunter,beastmastery,30,8,22
15961,Huntyadaun,blackrock,767,hunter,beastmastery,12,8,4
15962,Callmepapi,kazzak,767,hunter,beastmastery,12,8,4
15963,Kuljaa,ravencrest,767,hunter,beastmastery,12,8,4
15964,Awoe,blackrock,767,hunter,beastmastery,12,8,4
15965,Loydzz,hyjal,767,hunter,beastmastery,12,8,4
15966,Macabremoon,silvermoon,767,hunter,beastmastery,12,8,4
15967,Арнесс,deepholm,767,hunter,beastmastery,15,9,6
15968,Jónes,dunemaul,767,hunter,beastmastery,18,8,10
15969,Blàdê,blackrock,767,hunter,beastmastery,18,8,10
15970,Môrkh,sanguino,767,hunter,beastmastery,18,8,10
15971,Deathwallker,silvermoon,767,hunter,beastmastery,18,8,10
15972,Yayoo,cthun,767,hunter,beastmastery,24,8,16
15973,Гунныч,grom,767,hunter,beastmastery,24,8,16
15974,Шурикцаревич,galakrond,767,hunter,beastmastery,24,8,16
15975,Loridana,tichondrius,767,hunter,beastmastery,24,8,16
15976,Prodanhunts,frostmane,767,hunter,beastmastery,24,8,16
15977,Имбакласс,howling-fjord,766,hunter,beastmastery,12,8,4
15978,Sørha,chogall,766,hunter,beastmastery,12,8,4
15979,Druvnik,zenedar,766,hunter,beastmastery,18,8,10
15980,Miracleh,tarren-mill,766,hunter,beastmastery,18,8,10
15981,Rdwlf,draenor,766,hunter,beastmastery,18,8,10
15982,Birdseye,thrall,766,hunter,beastmastery,18,8,10
15983,Msâka,blackrock,766,hunter,beastmastery,24,8,16
15984,Aluara,burning-legion,766,hunter,beastmastery,24,8,16
15985,Rickh,ravencrest,765,hunter,beastmastery,12,8,4
15986,Fivebabe,tarren-mill,765,hunter,beastmastery,12,8,4
15987,Лузановка,gordunni,765,hunter,beastmastery,18,8,10
15988,Cxc,dun-modr,765,hunter,beastmastery,18,8,10
15989,Marsian,lordaeron,765,hunter,beastmastery,19,8,11
15990,Mykris,aegwynn,765,hunter,beastmastery,86,34,52
15991,Джэромо,gordunni,765,hunter,beastmastery,24,8,16
15992,Attiladagun,hellfire,765,hunter,beastmastery,24,8,16
15993,Castbuny,drakthul,765,hunter,beastmastery,24,8,16
15994,Tracrium,hyjal,764,hunter,beastmastery,30,8,22
15995,Фаталлити,grom,763,hunter,beastmastery,12,8,4
15996,Killzo,sylvanas,763,hunter,beastmastery,18,8,10
15997,Laerya,les-clairvoyants,763,hunter,beastmastery,18,8,10
15998,Eilnu,zuljin,763,hunter,beastmastery,35,8,27
15999,Plong,argent-dawn,761,hunter,beastmastery,12,8,4
16000,Boompuf,draenor,761,hunter,beastmastery,24,8,16
16001,Orgasmatronn,stormscale,760,hunter,beastmastery,24,8,16
16002,Vachekiki,archimonde,759,hunter,beastmastery,12,8,4
16003,Auau,the-maelstrom,759,hunter,beastmastery,18,8,10
16004,Bliss,senjin,756,hunter,beastmastery,12,8,4
16005,Dravara,blackmoore,755,hunter,beastmastery,24,8,16
16006,Sushimän,kaelthas,751,hunter,beastmastery,12,8,4
16007,Lynx,garona,750,hunter,beastmastery,50,12,38
16008,Begehunter,sylvanas,740,hunter,beastmastery,18,8,10
16009,Remiss,sanguino,738,hunter,beastmastery,22,10,12
16010,Kakopaikths,sylvanas,733,hunter,beastmastery,23,8,15
16011,Адула,eversong,729,hunter,beastmastery,35,12,23
16012,Пушкабомби,soulflayer,719,hunter,beastmastery,88,34,54
16013,Oogyboogy,draenor,718,hunter,beastmastery,23,8,15
16014,Drogostorm,steamwheedle-cartel,717,hunter,beastmastery,17,8,9
16015,Kürze,silvermoon,712,hunter,beastmastery,22,10,12
16016,Бей,gordunni,703,hunter,beastmastery,14,8,6
16017,Zevlove,kazzak,703,hunter,beastmastery,20,8,12
16018,Feyoonx,blackrock,703,hunter,beastmastery,23,9,14
16019,Bláckheart,doomhammer,702,hunter,beastmastery,26,8,18
16020,Kruk,blackhand,698,hunter,beastmastery,16,8,8
16021,Huntbeard,aegwynn,695,hunter,beastmastery,22,8,14
16022,Attileus,ragnaros,687,hunter,beastmastery,17,8,9
16023,Elledrin,argent-dawn,680,hunter,beastmastery,21,11,10
16024,Marcsman,blackrock,672,hunter,beastmastery,12,7,5
16025,Lultrap,nemesis,672,hunter,beastmastery,12,7,5
16026,Razuye,nerathor,672,hunter,beastmastery,12,7,5
16027,Unreachable,dethecus,672,hunter,beastmastery,12,7,5
16028,Bulletride,stormscale,672,hunter,beastmastery,12,7,5
16029,Connyrøvøga,stormscale,672,hunter,beastmastery,12,7,5
16030,Белатраиса,gordunni,672,hunter,beastmastery,12,7,5
16031,Найтсол,greymane,672,hunter,beastmastery,12,7,5
16032,Forthehordee,chamber-of-aspects,672,hunter,beastmastery,12,7,5
16033,Lambikas,argent-dawn,672,hunter,beastmastery,12,7,5
16034,Dåo,doomhammer,672,hunter,beastmastery,12,7,5
16035,Potatobeast,twisting-nether,672,hunter,beastmastery,12,7,5
16036,Knokkelmann,outland,672,hunter,beastmastery,12,7,5
16037,Виралатта,gordunni,672,hunter,beastmastery,12,7,5
16038,Ravis,aegwynn,672,hunter,beastmastery,12,7,5
16039,Kioception,blackrock,672,hunter,beastmastery,12,7,5
16040,Midist,stormscale,672,hunter,beastmastery,12,7,5
16041,Onof,archimonde,672,hunter,beastmastery,12,7,5
16042,Belaux,archimonde,672,hunter,beastmastery,12,7,5
16043,Hunttes,nagrand,672,hunter,beastmastery,12,7,5
16044,Сашказнаток,azuregos,672,hunter,beastmastery,12,7,5
16045,Berenger,twisting-nether,672,hunter,beastmastery,12,7,5
16046,Mspt,archimonde,672,hunter,beastmastery,12,7,5
16047,Ufecläimbe,eredar,672,hunter,beastmastery,12,7,5
16048,Загзигзаг,soulflayer,672,hunter,beastmastery,12,7,5
16049,Whiskeylover,outland,672,hunter,beastmastery,12,7,5
16050,Sazox,blackrock,672,hunter,beastmastery,12,7,5
16051,Stamzer,drakthul,672,hunter,beastmastery,12,7,5
16052,Nightvarn,burning-blade,672,hunter,beastmastery,12,7,5
16053,Slougshot,archimonde,672,hunter,beastmastery,12,7,5
16054,Zamx,outland,672,hunter,beastmastery,12,7,5
16055,Exzö,outland,672,hunter,beastmastery,12,7,5
16056,Slejpy,drakthul,672,hunter,beastmastery,12,7,5
16057,Cajakekw,madmortem,672,hunter,beastmastery,12,7,5
16058,Haxaids,sylvanas,672,hunter,beastmastery,12,7,5
16059,Ahotnik,aegwynn,672,hunter,beastmastery,12,7,5
16060,Flugsmälla,kazzak,672,hunter,beastmastery,12,7,5
16061,Kissay,blackmoore,672,hunter,beastmastery,12,7,5
16062,Hølinkasbabe,blackmoore,672,hunter,beastmastery,12,7,5
16063,Beorind,frostwolf,672,hunter,beastmastery,12,7,5
16064,Gødcømplêx,ravencrest,672,hunter,beastmastery,12,7,5
16065,Isaîas,uldum,672,hunter,beastmastery,12,7,5
16066,Hiddenxsabo,blackmoore,672,hunter,beastmastery,12,7,5
16067,Alexdi,kazzak,672,hunter,beastmastery,12,7,5
16068,Fôx,frostmane,672,hunter,beastmastery,12,7,5
16069,Ulfrîc,exodar,672,hunter,beastmastery,12,7,5
16070,Eisenhørn,archimonde,672,hunter,beastmastery,12,7,5
16071,Expoh,blackmoore,672,hunter,beastmastery,13,7,6
16072,Blmlooter,stormreaver,672,hunter,beastmastery,15,8,7
16073,Frods,dun-modr,672,hunter,beastmastery,16,8,8
16074,Fyô,outland,672,hunter,beastmastery,15,7,8
16075,Hask,pozzo-delleternità,672,hunter,beastmastery,15,7,8
16076,Bigramy,sanguino,672,hunter,beastmastery,18,7,11
16077,Mårcxb,antonidas,672,hunter,beastmastery,18,7,11
16078,Hunterstein,archimonde,672,hunter,beastmastery,18,7,11
16079,Chïefhunt,twisting-nether,672,hunter,beastmastery,18,7,11
16080,Graavi,silvermoon,672,hunter,beastmastery,18,7,11
16081,Бранцо,howling-fjord,672,hunter,beastmastery,18,7,11
16082,Boybiron,silvermoon,672,hunter,beastmastery,18,7,11
16083,Дьярэ,gordunni,672,hunter,beastmastery,18,7,11
16084,Düivell,grim-batol,672,hunter,beastmastery,18,7,11
16085,Дэментед,soulflayer,672,hunter,beastmastery,18,7,11
16086,Pilpetra,tarren-mill,672,hunter,beastmastery,18,7,11
16087,Lurigalinda,twisting-nether,672,hunter,beastmastery,18,7,11
16088,Géeked,ravencrest,672,hunter,beastmastery,18,7,11
16089,Sauce,alonsus,672,hunter,beastmastery,18,7,11
16090,Ромкола,gordunni,672,hunter,beastmastery,18,7,11
16091,Тандеркейдж,gordunni,672,hunter,beastmastery,18,7,11
16092,Zublime,dragonblight,672,hunter,beastmastery,18,7,11
16093,Rachelzane,blackrock,672,hunter,beastmastery,18,7,11
16094,Uselessx,kazzak,672,hunter,beastmastery,24,7,17
16095,Setyouintrap,ravencrest,672,hunter,beastmastery,24,7,17
16096,Ridbàck,archimonde,672,hunter,beastmastery,24,7,17
16097,Летмимейт,howling-fjord,672,hunter,beastmastery,26,7,19
16098,Akkonas,antonidas,671,hunter,beastmastery,12,7,5
16099,Døømslayer,nemesis,671,hunter,beastmastery,12,7,5
16100,Jaydogg,lightbringer,671,hunter,beastmastery,12,7,5
16101,Aýsun,kazzak,671,hunter,beastmastery,12,7,5
16102,Nakepw,stormscale,671,hunter,beastmastery,12,7,5
16103,Nith,ungoro,671,hunter,beastmastery,12,7,5
16104,Ashryqt,ravencrest,671,hunter,beastmastery,12,7,5
16105,Mazekhin,khaz-modan,671,hunter,beastmastery,12,7,5
16106,Бэталол,gordunni,671,hunter,beastmastery,12,7,5
16107,Beaststeaks,thrall,671,hunter,beastmastery,12,7,5
16108,Doubleoseven,frostmane,671,hunter,beastmastery,12,7,5
16109,Strade,argent-dawn,671,hunter,beastmastery,12,7,5
16110,Noaim,blackrock,671,hunter,beastmastery,12,7,5
16111,Orian,argent-dawn,671,hunter,beastmastery,18,7,11
16112,Блудитролль,soulflayer,671,hunter,beastmastery,18,7,11
16113,Nîco,nathrezim,671,hunter,beastmastery,18,7,11
16114,Rifle,dun-morogh,671,hunter,beastmastery,18,7,11
16115,Aguerex,alleria,671,hunter,beastmastery,18,7,11
16116,Dràcula,tarren-mill,671,hunter,beastmastery,18,7,11
16117,Løløsifredo,ysondre,671,hunter,beastmastery,24,7,17
16118,Tstigaard,argent-dawn,671,hunter,beastmastery,24,7,17
16119,Hugart,sylvanas,670,hunter,beastmastery,12,7,5
16120,Hoppelchen,blackmoore,670,hunter,beastmastery,12,7,5
16121,Epheso,daggerspine,670,hunter,beastmastery,12,7,5
16122,Хантмантхант,howling-fjord,670,hunter,beastmastery,12,7,5
16123,Oneshotkill,laughing-skull,670,hunter,beastmastery,12,7,5
16124,Kirky,terokkar,670,hunter,beastmastery,12,7,5
16125,Paradisiaco,sanguino,670,hunter,beastmastery,24,7,17
16126,Bobmàrley,frostwolf,670,hunter,beastmastery,24,7,17
16127,Gladiátor,kult-der-verdammten,669,hunter,beastmastery,12,7,5
16128,Sackboy,thrall,669,hunter,beastmastery,18,7,11
16129,Qled,sylvanas,669,hunter,beastmastery,18,7,11
16130,Darkhunt,ysondre,669,hunter,beastmastery,18,7,11
16131,Casey,zuluhed,669,hunter,beastmastery,18,7,11
16132,Nelerias,defias-brotherhood,669,hunter,beastmastery,24,7,17
16133,Trollhunt,bloodscalp,668,hunter,beastmastery,18,7,11
16134,Asharial,twisting-nether,668,hunter,beastmastery,21,8,13
16135,Okumo,the-maelstrom,667,hunter,beastmastery,18,7,11
16136,Bourrinax,kazzak,667,hunter,beastmastery,24,7,17
16137,Rollei,uldum,666,hunter,beastmastery,12,7,5
16138,Doômzi,ysondre,666,hunter,beastmastery,12,7,5
16139,Chillarn,tarren-mill,666,hunter,beastmastery,23,7,16
16140,Aroldo,kazzak,665,hunter,beastmastery,12,7,5
16141,Саэсантессис,howling-fjord,665,hunter,beastmastery,18,7,11
16142,Electrastar,illidan,664,hunter,beastmastery,12,7,5
16143,Winfar,draenor,664,hunter,beastmastery,24,7,17
16144,Барбарисовна,ashenvale,655,hunter,beastmastery,17,7,10
16145,Akù,magtheridon,653,hunter,beastmastery,23,7,16
16146,Toosmall,stormscale,638,hunter,beastmastery,16,7,9
16147,Pennyflame,blackmoore,623,hunter,beastmastery,17,7,10
16148,Grufflin,bronzebeard,620,hunter,beastmastery,17,7,10
16149,Stukrotka,hellfire,617,hunter,beastmastery,15,7,8
16150,Zwergnàse,thrall,616,hunter,beastmastery,23,7,16
16151,Rezgor,stormscale,606,hunter,beastmastery,11,7,4
16152,Хантетский,howling-fjord,604,hunter,beastmastery,14,7,7
16153,Ôrly,outland,587,hunter,beastmastery,20,7,13
16154,Luke,chromaggus,576,hunter,beastmastery,6,6,0
16155,Келентори,gordunni,576,hunter,beastmastery,12,6,6
16156,Мишечкатоп,gordunni,576,hunter,beastmastery,12,6,6
16157,Ráptør,silvermoon,576,hunter,beastmastery,12,6,6
16158,Zajebantip,sylvanas,576,hunter,beastmastery,12,6,6
16159,Iuyiuy,dalaran,576,hunter,beastmastery,12,6,6
16160,Стёпкахант,gordunni,576,hunter,beastmastery,12,6,6
16161,Syveera,twisting-nether,576,hunter,beastmastery,12,6,6
16162,Komesz,ragnaros,576,hunter,beastmastery,12,6,6
16163,Niedzwiedzor,silvermoon,576,hunter,beastmastery,12,6,6
16164,Xðxðxðxðxðxð,sylvanas,576,hunter,beastmastery,12,6,6
16165,Burbutsuluki,silvermoon,576,hunter,beastmastery,12,6,6
16166,Dunkelmut,arthas,576,hunter,beastmastery,12,6,6
16167,Nomadest,silvermoon,576,hunter,beastmastery,12,6,6
16168,Double,sylvanas,576,hunter,beastmastery,12,6,6
16169,Kurtanâ,blackmoore,576,hunter,beastmastery,12,6,6
16170,Boen,nordrassil,576,hunter,beastmastery,12,6,6
16171,Gréènthumbs,ragnaros,576,hunter,beastmastery,12,6,6
16172,Венкара,gordunni,576,hunter,beastmastery,12,6,6
16173,Dtq,silvermoon,576,hunter,beastmastery,12,6,6
16174,Razoorine,blackrock,576,hunter,beastmastery,12,6,6
16175,Массовик,blackscar,576,hunter,beastmastery,12,6,6
16176,Efficíent,auchindoun,576,hunter,beastmastery,12,6,6
16177,Dorkos,sanguino,576,hunter,beastmastery,12,6,6
16178,Magicnanø,nemesis,576,hunter,beastmastery,12,6,6
16179,Logales,dragonblight,576,hunter,beastmastery,12,6,6
16180,Skarra,zuljin,576,hunter,beastmastery,12,6,6
16181,Raegal,sanguino,576,hunter,beastmastery,12,6,6
16182,Cítyzens,drakthul,576,hunter,beastmastery,12,6,6
16183,Metalbaci,sylvanas,576,hunter,beastmastery,12,6,6
16184,Wödën,argent-dawn,576,hunter,beastmastery,12,6,6
16185,Vu,shattered-hand,576,hunter,beastmastery,12,6,6
16186,Gîsh,burning-legion,576,hunter,beastmastery,12,6,6
16187,Arkelion,argent-dawn,576,hunter,beastmastery,12,6,6
16188,Хаурос,soulflayer,576,hunter,beastmastery,12,6,6
16189,Zæuz,outland,576,hunter,beastmastery,12,6,6
16190,Fogknows,ravencrest,576,hunter,beastmastery,12,6,6
16191,Kartantrax,culte-de-la-rive-noire,576,hunter,beastmastery,12,6,6
16192,Flecheoeil,hyjal,576,hunter,beastmastery,12,6,6
16193,Showdope,drakthul,576,hunter,beastmastery,12,6,6
16194,Autopilot,aegwynn,576,hunter,beastmastery,12,6,6
16195,Toptìérgoðx,drakthul,576,hunter,beastmastery,12,6,6
16196,Guidomista,drakthul,576,hunter,beastmastery,12,6,6
16197,Максиммужик,soulflayer,576,hunter,beastmastery,12,6,6
16198,Lökout,twilights-hammer,576,hunter,beastmastery,12,6,6
16199,Vepzen,haomarush,576,hunter,beastmastery,12,6,6
16200,Therakal,culte-de-la-rive-noire,576,hunter,beastmastery,12,6,6
16201,Darkstripe,turalyon,576,hunter,beastmastery,12,6,6
16202,Batcool,tarren-mill,576,hunter,beastmastery,12,6,6
16203,Bråndy,draenor,576,hunter,beastmastery,12,6,6
16204,Poke,aggra-português,576,hunter,beastmastery,12,6,6
16205,Haraigoshí,grim-batol,576,hunter,beastmastery,12,6,6
16206,Flytomars,ravencrest,576,hunter,beastmastery,12,6,6
16207,Nagu,antonidas,576,hunter,beastmastery,12,6,6
16208,Zêrøtwø,draenor,576,hunter,beastmastery,12,6,6
16209,Шмыгахант,gordunni,576,hunter,beastmastery,12,6,6
16210,Зихантер,soulflayer,576,hunter,beastmastery,12,6,6
16211,Ptithoms,hyjal,576,hunter,beastmastery,12,6,6
16212,Зеленыйиисус,gordunni,576,hunter,beastmastery,12,6,6
16213,Джарвиз,soulflayer,576,hunter,beastmastery,12,6,6
16214,Steìn,ysondre,576,hunter,beastmastery,12,6,6
16215,Дайсё,soulflayer,576,hunter,beastmastery,12,6,6
16216,Astair,hyjal,576,hunter,beastmastery,12,6,6
16217,Kaballa,ahnqiraj,576,hunter,beastmastery,12,6,6
16218,Healscare,dalaran,576,hunter,beastmastery,16,7,9
16219,Huntarbeît,eredar,576,hunter,beastmastery,18,6,12
16220,Suisiide,antonidas,576,hunter,beastmastery,18,6,12
16221,Xiaoly,kaelthas,576,hunter,beastmastery,18,6,12
16222,Disyö,kazzak,576,hunter,beastmastery,18,6,12
16223,Свадебная,gordunni,576,hunter,beastmastery,18,6,12
16224,Кронн,howling-fjord,576,hunter,beastmastery,18,6,12
16225,Azrhu,ravencrest,576,hunter,beastmastery,18,6,12
16226,Матанал,gordunni,576,hunter,beastmastery,18,6,12
16227,Realme,blackrock,576,hunter,beastmastery,18,6,12
16228,Wetto,ravencrest,576,hunter,beastmastery,18,6,12
16229,Exwifey,ravencrest,576,hunter,beastmastery,18,6,12
16230,Ângell,kirin-tor,576,hunter,beastmastery,18,6,12
16231,Jwah,tarren-mill,576,hunter,beastmastery,18,6,12
16232,Сексишмекс,soulflayer,576,hunter,beastmastery,24,6,18
16233,Mævis,ravencrest,576,hunter,beastmastery,24,6,18
16234,Rheyl,dun-morogh,576,hunter,beastmastery,30,6,24
16235,Труласек,blackscar,575,hunter,beastmastery,12,6,6
16236,Deôrro,twisting-nether,575,hunter,beastmastery,12,6,6
16237,Petfeelya,antonidas,575,hunter,beastmastery,12,6,6
16238,Kairrux,twisting-nether,575,hunter,beastmastery,12,6,6
16239,Robingood,alexstrasza,575,hunter,beastmastery,12,6,6
16240,Абунай,soulflayer,575,hunter,beastmastery,12,6,6
16241,Nosfuratu,stormscale,575,hunter,beastmastery,12,6,6
16242,Blacksyo,elune,575,hunter,beastmastery,12,6,6
16243,Ghanik,draenor,575,hunter,beastmastery,12,6,6
16244,Truedetectiv,aggramar,575,hunter,beastmastery,12,6,6
16245,Gløbi,malfurion,575,hunter,beastmastery,12,6,6
16246,Splodge,kazzak,575,hunter,beastmastery,12,6,6
16247,Haggy,die-nachtwache,575,hunter,beastmastery,12,6,6
16248,Eyetto,dun-modr,575,hunter,beastmastery,12,6,6
16249,Furian,der-rat-von-dalaran,575,hunter,beastmastery,12,6,6
16250,Hunterizi,silvermoon,575,hunter,beastmastery,12,6,6
16251,Bolgroth,balnazzar,575,hunter,beastmastery,12,6,6
16252,Puska,gilneas,575,hunter,beastmastery,12,6,6
16253,Krasavcik,shattrath,575,hunter,beastmastery,12,6,6
16254,Iddqd,outland,575,hunter,beastmastery,12,6,6
16255,Hitray,stormscale,575,hunter,beastmastery,18,6,12
16256,Täpy,arathor,575,hunter,beastmastery,18,6,12
16257,Ápêx,ravencrest,575,hunter,beastmastery,18,6,12
16258,Quasar,arakarahm,575,hunter,beastmastery,24,6,18
16259,Ketator,archimonde,574,hunter,beastmastery,12,6,6
16260,Erenjaeger,onyxia,574,hunter,beastmastery,12,6,6
16261,Kannon,twisting-nether,574,hunter,beastmastery,18,6,12
16262,Mizumi,frostmane,574,hunter,beastmastery,18,6,12
16263,Örrn,ragnaros,574,hunter,beastmastery,18,6,12
16264,Penelopé,darkmoon-faire,573,hunter,beastmastery,12,6,6
16265,Ranrôk,rexxar,573,hunter,beastmastery,12,6,6
16266,Cliff,kiljaeden,572,hunter,beastmastery,30,6,24
16267,Шейхант,gordunni,571,hunter,beastmastery,12,6,6
16268,Glarco,eldrethalas,571,hunter,beastmastery,12,6,6
16269,Jsâ,blackmoore,571,hunter,beastmastery,12,6,6
16270,Ñava,dalaran,570,hunter,beastmastery,12,6,6
16271,Corrwus,argent-dawn,570,hunter,beastmastery,18,6,12
16272,Олькахант,galakrond,568,hunter,beastmastery,12,6,6
16273,Zahgrug,aerie-peak,568,hunter,beastmastery,12,6,6
16274,Bloodxx,ragnaros,568,hunter,beastmastery,18,6,12
16275,Barzti,thrall,566,hunter,beastmastery,18,8,10
16276,Marudô,aegwynn,559,hunter,beastmastery,17,6,11
16277,Бэрими,gordunni,543,hunter,beastmastery,11,6,5
16278,Dreemshoot,stormscale,542,hunter,beastmastery,11,6,5
16279,Åånei,twisting-nether,528,hunter,beastmastery,15,6,9
16280,Kukenisluken,stormscale,527,hunter,beastmastery,11,6,5
16281,Dybhalsma,outland,527,hunter,beastmastery,11,6,5
16282,Archfiend,stormscale,527,hunter,beastmastery,11,6,5
16283,Braatski,stormscale,526,hunter,beastmastery,18,7,11
16284,Kareltje,stormscale,521,hunter,beastmastery,13,7,6
16285,Raxxic,eredar,512,hunter,beastmastery,10,6,4
16286,Buzzle,sylvanas,512,hunter,beastmastery,22,6,16
16287,Sacroz,frostwhisper,510,hunter,beastmastery,20,6,14
16288,Nefroo,defias-brotherhood,505,hunter,beastmastery,11,6,5
16289,Dogliz,stormscale,480,hunter,beastmastery,6,5,1
16290,Gabbriel,ravencrest,480,hunter,beastmastery,6,5,1
16291,Smokerofweed,kazzak,480,hunter,beastmastery,6,5,1
16292,Sunyjuyono,ravencrest,480,hunter,beastmastery,6,5,1
16293,Hidethegun,draenor,480,hunter,beastmastery,6,5,1
16294,Connyrövöga,draenor,480,hunter,beastmastery,6,5,1
16295,Huntourd,eredar,480,hunter,beastmastery,6,5,1
16296,Jinxbomber,draenor,480,hunter,beastmastery,6,5,1
16297,Wellocérapt,confrérie-du-thorium,480,hunter,beastmastery,6,5,1
16298,Ветрослав,thermaplugg,480,hunter,beastmastery,6,5,1
16299,Мунмейстер,blackscar,480,hunter,beastmastery,6,5,1
16300,Tøkÿöghøül,ravencrest,480,hunter,beastmastery,7,5,2
16301,Круперок,howling-fjord,480,hunter,beastmastery,12,5,7
16302,Jins,illidan,480,hunter,beastmastery,12,5,7
16303,Келкузд,howling-fjord,480,hunter,beastmastery,12,5,7
16304,Вуйчеч,howling-fjord,480,hunter,beastmastery,12,5,7
16305,Speartusk,blackhand,480,hunter,beastmastery,12,5,7
16306,Eredark,zuljin,480,hunter,beastmastery,12,5,7
16307,Bubbahubba,ragnaros,480,hunter,beastmastery,12,5,7
16308,Makaxx,stormscale,480,hunter,beastmastery,12,5,7
16309,Hiff,burning-legion,480,hunter,beastmastery,12,5,7
16310,Bloodpanter,ragnaros,480,hunter,beastmastery,12,5,7
16311,Waneìs,stormscale,480,hunter,beastmastery,12,5,7
16312,Naposin,ragnaros,480,hunter,beastmastery,12,5,7
16313,Crasharrow,stormscale,480,hunter,beastmastery,12,5,7
16314,Stónéyyx,azjolnerub,480,hunter,beastmastery,12,5,7
16315,Tizzlbang,ragnaros,480,hunter,beastmastery,12,5,7
16316,Smecher,ravencrest,480,hunter,beastmastery,12,5,7
16317,Trapyoubro,blackrock,480,hunter,beastmastery,12,5,7
16318,Yamadorî,blackrock,480,hunter,beastmastery,12,5,7
16319,Notley,thrall,480,hunter,beastmastery,12,5,7
16320,Китас,soulflayer,480,hunter,beastmastery,12,5,7
16321,Feelmyfurý,tarren-mill,480,hunter,beastmastery,12,5,7
16322,Elvenian,twisting-nether,480,hunter,beastmastery,12,5,7
16323,Dyve,antonidas,480,hunter,beastmastery,12,5,7
16324,Palomo,argent-dawn,480,hunter,beastmastery,12,5,7
16325,Bloodymarìe,kelthuzad,480,hunter,beastmastery,12,5,7
16326,Sxmphxny,argent-dawn,480,hunter,beastmastery,12,5,7
16327,Khort,twisting-nether,480,hunter,beastmastery,12,5,7
16328,Jimbowjones,antonidas,480,hunter,beastmastery,12,5,7
16329,Kanzlerkohl,frostwolf,480,hunter,beastmastery,12,5,7
16330,Seviaz,draenor,480,hunter,beastmastery,12,5,7
16331,Yésdave,stormscale,480,hunter,beastmastery,12,5,7
16332,Mdmalol,malganis,480,hunter,beastmastery,12,5,7
16333,Квит,blackscar,480,hunter,beastmastery,12,5,7
16334,Quoicoubèh,hyjal,480,hunter,beastmastery,12,5,7
16335,Orosko,archimonde,480,hunter,beastmastery,12,5,7
16336,Джеймсфранко,blackscar,480,hunter,beastmastery,12,5,7
16337,Trendsetterx,pozzo-delleternità,480,hunter,beastmastery,12,5,7
16338,Juniorm,kazzak,480,hunter,beastmastery,12,5,7
16339,Kaaj,nemesis,480,hunter,beastmastery,12,5,7
16340,Sbegodx,hyjal,480,hunter,beastmastery,12,5,7
16341,Темпеест,gordunni,480,hunter,beastmastery,12,5,7
16342,Kongharald,ravencrest,480,hunter,beastmastery,12,5,7
16343,Bojestemrudy,outland,480,hunter,beastmastery,12,5,7
16344,Maxtozer,silvermoon,480,hunter,beastmastery,12,5,7
16345,Стрелывалеры,gordunni,480,hunter,beastmastery,12,5,7
16346,Elðer,dentarg,480,hunter,beastmastery,16,6,10
16347,Lepap,arygos,480,hunter,beastmastery,17,5,12
16348,Hêndricks,eredar,480,hunter,beastmastery,18,5,13
16349,Chrishyh,blackrock,480,hunter,beastmastery,18,5,13
16350,Begøne,draenor,480,hunter,beastmastery,18,5,13
16351,Artexxia,kazzak,479,hunter,beastmastery,6,5,1
16352,Jana,ragnaros,479,hunter,beastmastery,12,5,7
16353,Swïtchz,hyjal,479,hunter,beastmastery,12,5,7
16354,Djzntrap,outland,479,hunter,beastmastery,12,5,7
16355,Droubidi,garona,479,hunter,beastmastery,12,5,7
16356,Arhyah,medivh,479,hunter,beastmastery,12,5,7
16357,Ninjaskillss,ravencrest,479,hunter,beastmastery,12,5,7
16358,Latira,eonar,479,hunter,beastmastery,12,5,7
16359,Ivanrockstar,draenor,479,hunter,beastmastery,12,5,7
16360,Zercore,echsenkessel,479,hunter,beastmastery,12,5,7
16361,Енвина,gordunni,479,hunter,beastmastery,12,5,7
16362,Goethe,ravencrest,479,hunter,beastmastery,15,6,9
16363,Nelthara,burning-blade,479,hunter,beastmastery,18,5,13
16364,Arielowy,doomhammer,479,hunter,beastmastery,18,5,13
16365,Talmïr,archimonde,479,hunter,beastmastery,18,5,13
16366,Добрыйклыкач,gordunni,478,hunter,beastmastery,12,5,7
16367,Kepâssa,ysondre,478,hunter,beastmastery,12,5,7
16368,Oldrocker,sylvanas,478,hunter,beastmastery,18,5,13
16369,Бодрыйсэм,soulflayer,477,hunter,beastmastery,12,5,7
16370,Ghostaim,kazzak,475,hunter,beastmastery,10,6,4
16371,Ahilleaa,aegwynn,472,hunter,beastmastery,12,5,7
16372,Ferax,alleria,472,hunter,beastmastery,12,5,7
16373,Aryaae,les-clairvoyants,472,hunter,beastmastery,13,5,8
16374,Ruhen,aegwynn,463,hunter,beastmastery,11,5,6
16375,Tiguy,archimonde,462,hunter,beastmastery,23,5,18
16376,Momohenní,archimonde,448,hunter,beastmastery,10,5,5
16377,Kabedon,drakthul,448,hunter,beastmastery,16,5,11
16378,Bellecoq,arathi,447,hunter,beastmastery,11,5,6
16379,Artemmis,tarren-mill,447,hunter,beastmastery,11,5,6
16380,Anesa,lightbringer,446,hunter,beastmastery,15,6,9
16381,Lovecjelenu,drakthul,431,hunter,beastmastery,11,5,6
16382,Såvëâmäzøñíà,stormscale,431,hunter,beastmastery,11,5,6
16383,Axg,burning-legion,429,hunter,beastmastery,15,6,9
16384,Truxp,tarren-mill,416,hunter,beastmastery,10,5,5
16385,Valamié,stormscale,415,hunter,beastmastery,8,5,3
16386,Topbow,talnivarr,415,hunter,beastmastery,10,5,5
16387,Darkshe,dun-modr,415,hunter,beastmastery,14,5,9
16388,Elíonora,kazzak,400,hunter,beastmastery,7,5,2
16389,Mórz,magtheridon,384,hunter,beastmastery,6,4,2
16390,Xiviora,archimonde,384,hunter,beastmastery,6,4,2
16391,Khregan,aerie-peak,384,hunter,beastmastery,6,4,2
16392,Mestar,outland,384,hunter,beastmastery,6,4,2
16393,Mothmanx,kazzak,384,hunter,beastmastery,6,4,2
16394,Патапум,deathguard,384,hunter,beastmastery,6,4,2
16395,Napa,kazzak,384,hunter,beastmastery,6,4,2
16396,Garratha,burning-legion,384,hunter,beastmastery,6,4,2
16397,Áñmy,ravencrest,384,hunter,beastmastery,6,4,2
16398,Psychotik,dalaran,384,hunter,beastmastery,6,4,2
16399,Bãldur,ravencrest,384,hunter,beastmastery,6,4,2
16400,Разплюханка,howling-fjord,384,hunter,beastmastery,6,4,2
16401,Arellia,blackmoore,384,hunter,beastmastery,6,4,2
16402,Schwabbels,silvermoon,384,hunter,beastmastery,6,4,2
16403,Wristflex,kazzak,384,hunter,beastmastery,6,4,2
16404,Ксила,blackscar,384,hunter,beastmastery,6,4,2
16405,Tidydarts,balnazzar,384,hunter,beastmastery,6,4,2
16406,Zanéy,ravencrest,384,hunter,beastmastery,6,4,2
16407,Galduhr,silvermoon,384,hunter,beastmastery,6,4,2
16408,Cfueb,doomhammer,384,hunter,beastmastery,6,4,2
16409,Zigi,grim-batol,384,hunter,beastmastery,6,4,2
16410,Wolder,burning-legion,384,hunter,beastmastery,6,4,2
16411,Вихтриэль,gordunni,384,hunter,beastmastery,6,4,2
16412,Nomorepain,outland,384,hunter,beastmastery,6,4,2
16413,Sindaro,kazzak,384,hunter,beastmastery,6,4,2
16414,Missmytraps,stormscale,384,hunter,beastmastery,6,4,2
16415,Hetzenauer,nathrezim,384,hunter,beastmastery,6,4,2
16416,Vïcødïnë,sinstralis,384,hunter,beastmastery,6,4,2
16417,Marksmaniak,ysondre,384,hunter,beastmastery,6,4,2
16418,Djurmästaren,ravencrest,384,hunter,beastmastery,6,4,2
16419,Stingarrow,stormscale,384,hunter,beastmastery,6,4,2
16420,Nulldmgmaker,malganis,384,hunter,beastmastery,6,4,2
16421,Béarrockx,alleria,384,hunter,beastmastery,6,4,2
16422,Xndr,sanguino,384,hunter,beastmastery,6,4,2
16423,Апельсинчес,howling-fjord,384,hunter,beastmastery,6,4,2
16424,Fajitax,lightbringer,384,hunter,beastmastery,6,4,2
16425,Oobe,hyjal,384,hunter,beastmastery,6,4,2
16426,Thursty,twisting-nether,384,hunter,beastmastery,6,4,2
16427,Dafragger,blackmoore,384,hunter,beastmastery,6,4,2
16428,Tiratats,sylvanas,384,hunter,beastmastery,6,4,2
16429,Ghõst,frostmane,384,hunter,beastmastery,6,4,2
16430,Нью,soulflayer,384,hunter,beastmastery,6,4,2
16431,Robbingyou,tarren-mill,384,hunter,beastmastery,6,4,2
16432,Azzazeal,drakthul,384,hunter,beastmastery,6,4,2
16433,Kurobi,kazzak,384,hunter,beastmastery,6,4,2
16434,Zbyrkana,neptulon,384,hunter,beastmastery,6,4,2
16435,Sín,kirin-tor,384,hunter,beastmastery,6,4,2
16436,Chindaliña,zuljin,384,hunter,beastmastery,6,4,2
16437,Dorkis,sanguino,384,hunter,beastmastery,6,4,2
16438,Трисциллочка,howling-fjord,384,hunter,beastmastery,6,4,2
16439,Riema,ragnaros,384,hunter,beastmastery,6,4,2
16440,Kàisèr,shendralar,384,hunter,beastmastery,6,4,2
16441,Кейдлер,gordunni,384,hunter,beastmastery,6,4,2
16442,Varkiza,sylvanas,384,hunter,beastmastery,6,4,2
16443,Матопопа,gordunni,384,hunter,beastmastery,6,4,2
16444,Няшуличка,gordunni,384,hunter,beastmastery,6,4,2
16445,Кайсго,gordunni,384,hunter,beastmastery,6,4,2
16446,Machinedream,sylvanas,384,hunter,beastmastery,6,4,2
16447,Jablaka,blackhand,384,hunter,beastmastery,6,4,2
16448,Illaice,antonidas,384,hunter,beastmastery,6,4,2
16449,Zyprix,blackrock,384,hunter,beastmastery,6,4,2
16450,Thromkhar,sanguino,384,hunter,beastmastery,6,4,2
16451,Silenthunter,blackrock,384,hunter,beastmastery,6,4,2
16452,Ntguilty,blackrock,384,hunter,beastmastery,6,4,2
16453,Celebor,sanguino,384,hunter,beastmastery,6,4,2
16454,Nocturr,ragnaros,384,hunter,beastmastery,6,4,2
16455,Murkek,drakthul,384,hunter,beastmastery,6,4,2
16456,Quasarx,draenor,384,hunter,beastmastery,9,5,4
16457,Valomeere,tarren-mill,384,hunter,beastmastery,12,4,8
16458,Xavers,outland,384,hunter,beastmastery,12,4,8
16459,Nßatrapper,outland,384,hunter,beastmastery,12,4,8
16460,Elionora,kazzak,384,hunter,beastmastery,12,4,8
16461,Brønkø,azshara,384,hunter,beastmastery,12,4,8
16462,Zakert,zuljin,384,hunter,beastmastery,12,4,8
16463,Catman,stormreaver,384,hunter,beastmastery,12,4,8
16464,Вейзу,ashenvale,384,hunter,beastmastery,12,4,8
16465,Sylphie,dalaran,384,hunter,beastmastery,12,4,8
16466,Дэлмор,greymane,384,hunter,beastmastery,12,4,8
16467,Кустурица,azuregos,384,hunter,beastmastery,12,4,8
16468,Lexayah,twisting-nether,384,hunter,beastmastery,12,4,8
16469,Sharpeneye,ragnaros,384,hunter,beastmastery,12,4,8
16470,Marzenielas,silvermoon,384,hunter,beastmastery,12,4,8
16471,Серцебиение,soulflayer,384,hunter,beastmastery,12,4,8
16472,Sîriell,arthas,384,hunter,beastmastery,12,4,8
16473,Mobshot,twisting-nether,384,hunter,beastmastery,12,4,8
16474,Гернриета,gordunni,384,hunter,beastmastery,12,4,8
16475,Pergola,spinebreaker,384,hunter,beastmastery,12,4,8
16476,Zippyzen,twisting-nether,384,hunter,beastmastery,12,4,8
16477,Monnee,outland,384,hunter,beastmastery,12,4,8
16478,Malromero,outland,384,hunter,beastmastery,12,4,8
16479,Tusibi,dalaran,384,hunter,beastmastery,12,4,8
16480,Øï,outland,384,hunter,beastmastery,12,4,8
16481,Horxxa,kul-tiras,384,hunter,beastmastery,12,4,8
16482,Thérón,ravencrest,384,hunter,beastmastery,12,4,8
16483,Aléxy,sanguino,384,hunter,beastmastery,12,4,8
16484,Neocb,ravencrest,384,hunter,beastmastery,12,4,8
16485,Tøixøna,tyrande,384,hunter,beastmastery,12,4,8
16486,Killstreak,magtheridon,384,hunter,beastmastery,12,4,8
16487,Sjufemman,ravencrest,384,hunter,beastmastery,12,4,8
16488,Zynga,sylvanas,384,hunter,beastmastery,12,4,8
16489,Thekev,ravencrest,384,hunter,beastmastery,12,4,8
16490,Teddybeardo,stormscale,384,hunter,beastmastery,12,4,8
16491,Penehuntos,eredar,384,hunter,beastmastery,12,4,8
16492,Khyleanqt,dun-modr,384,hunter,beastmastery,12,4,8
16493,Focùs,eredar,384,hunter,beastmastery,12,4,8
16494,Staynador,turalyon,384,hunter,beastmastery,12,4,8
16495,Navarro,nemesis,384,hunter,beastmastery,12,4,8
16496,Rockshredder,ravencrest,384,hunter,beastmastery,12,4,8
16497,Охотницагодх,borean-tundra,384,hunter,beastmastery,12,4,8
16498,Dissectiøn,hyjal,384,hunter,beastmastery,12,4,8
16499,Donbonz,blackmoore,384,hunter,beastmastery,12,4,8
16500,Mógwaí,stormscale,384,hunter,beastmastery,12,4,8
16501,Дланьгоспода,soulflayer,384,hunter,beastmastery,13,4,9
16502,Mélovéa,sinstralis,384,hunter,beastmastery,18,4,14
16503,Swargano,archimonde,384,hunter,beastmastery,18,4,14
16504,Хедшоттер,blackscar,384,hunter,beastmastery,18,4,14
16505,Tervueren,burning-blade,384,hunter,beastmastery,18,4,14
16506,Bemtistaru,draenor,384,hunter,beastmastery,18,4,14
16507,Kayvaal,kaelthas,384,hunter,beastmastery,18,4,14
16508,Resonate,stormreaver,383,hunter,beastmastery,6,4,2
16509,Whyareurunin,silvermoon,383,hunter,beastmastery,6,4,2
16510,Xscaper,twilights-hammer,383,hunter,beastmastery,6,4,2
16511,Jelezenchuk,outland,383,hunter,beastmastery,6,4,2
16512,Bessa,skullcrusher,383,hunter,beastmastery,12,4,8
16513,Doguago,draenor,383,hunter,beastmastery,12,4,8
16514,Huntseeker,draenor,383,hunter,beastmastery,12,4,8
16515,Lalluna,malganis,383,hunter,beastmastery,12,4,8
16516,Machini,terokkar,383,hunter,beastmastery,17,4,13
16517,Mugiwaras,eldrethalas,383,hunter,beastmastery,18,4,14
16518,Hentt,burning-legion,382,hunter,beastmastery,12,4,8
16519,Neuwi,stormreaver,382,hunter,beastmastery,12,4,8
16520,Beerox,ysondre,382,hunter,beastmastery,12,4,8
16521,Яугеныч,blackscar,381,hunter,beastmastery,12,4,8
16522,Sanite,dun-morogh,381,hunter,beastmastery,12,4,8
16523,Jolox,blackrock,379,hunter,beastmastery,12,4,8
16524,Thelasiel,aerie-peak,379,hunter,beastmastery,14,4,10
16525,Pîpî,blackrock,368,hunter,beastmastery,11,6,5
16526,Zakos,kirin-tor,351,hunter,beastmastery,17,4,13
16527,Jaszczomp,magtheridon,350,hunter,beastmastery,16,4,12
16528,Harpers,kazzak,336,hunter,beastmastery,15,4,11
16529,Dorollo,khaz-modan,332,hunter,beastmastery,11,4,7
16530,Itzcritch,tarren-mill,330,hunter,beastmastery,14,5,9
16531,Skyh,outland,330,hunter,beastmastery,16,5,11
16532,Ozunâ,blackmoore,318,hunter,beastmastery,24,8,16
16533,Greinktar,archimonde,317,hunter,beastmastery,10,4,6
16534,Nastynutshot,stormscale,288,hunter,beastmastery,6,3,3
16535,Taurïel,stormscale,288,hunter,beastmastery,6,3,3
16536,Ileira,blackmoore,288,hunter,beastmastery,6,3,3
16537,Renamexyz,blackmoore,288,hunter,beastmastery,6,3,3
16538,Kondirox,twisting-nether,288,hunter,beastmastery,6,3,3
16539,Shimzz,twisting-nether,288,hunter,beastmastery,6,3,3
16540,Lofiel,aegwynn,288,hunter,beastmastery,6,3,3
16541,Козладой,gordunni,288,hunter,beastmastery,6,3,3
16542,Saîtek,chogall,288,hunter,beastmastery,6,3,3
16543,Fangzahn,aegwynn,288,hunter,beastmastery,6,3,3
16544,Sarnak,thrall,288,hunter,beastmastery,6,3,3
16545,Akahr,thrall,288,hunter,beastmastery,6,3,3
16546,Papisbae,stormscale,288,hunter,beastmastery,6,3,3
16547,Arsola,sylvanas,288,hunter,beastmastery,6,3,3
16548,Prurt,pozzo-delleternità,288,hunter,beastmastery,6,3,3
16549,Shedzargo,twisting-nether,288,hunter,beastmastery,6,3,3
16550,Боураш,gordunni,288,hunter,beastmastery,6,3,3
16551,Varøsch,thrall,288,hunter,beastmastery,6,3,3
16552,Стингергодх,gordunni,288,hunter,beastmastery,6,3,3
16553,Kanwfulldmg,stormscale,288,hunter,beastmastery,6,3,3
16554,Djtrapyasis,blackmoore,288,hunter,beastmastery,6,3,3
16555,Kronkh,nemesis,288,hunter,beastmastery,6,3,3
16556,Lioneli,sylvanas,288,hunter,beastmastery,6,3,3
16557,Sebikh,ravencrest,288,hunter,beastmastery,6,3,3
16558,Bârli,amanthul,288,hunter,beastmastery,6,3,3
16559,Ekz,twisting-nether,288,hunter,beastmastery,6,3,3
16560,Zoophobiaqt,silvermoon,288,hunter,beastmastery,6,3,3
16561,Nizzoz,blackmoore,288,hunter,beastmastery,6,3,3
16562,Kyudoka,sylvanas,288,hunter,beastmastery,6,3,3
16563,Микихаса,galakrond,288,hunter,beastmastery,6,3,3
16564,Кискавтесте,gordunni,288,hunter,beastmastery,6,3,3
16565,Ванхогер,gordunni,288,hunter,beastmastery,6,3,3
16566,Живучийорех,gordunni,288,hunter,beastmastery,6,3,3
16567,Daela,elune,288,hunter,beastmastery,6,3,3
16568,Salemenos,silvermoon,288,hunter,beastmastery,6,3,3
16569,Люциферо,goldrinn,288,hunter,beastmastery,6,3,3
16570,Whitehor,ragnaros,288,hunter,beastmastery,6,3,3
16571,Anhur,blackmoore,288,hunter,beastmastery,6,3,3
16572,Styxht,blackhand,288,hunter,beastmastery,6,3,3
16573,Keyshu,die-aldor,288,hunter,beastmastery,6,3,3
16574,Enthur,sylvanas,288,hunter,beastmastery,6,3,3
16575,Hattorisama,ghostlands,288,hunter,beastmastery,6,3,3
16576,Колтрэйнборз,blackscar,288,hunter,beastmastery,6,3,3
16577,Hallem,karazhan,288,hunter,beastmastery,6,3,3
16578,Nervetøxin,ravencrest,288,hunter,beastmastery,6,3,3
16579,Humanoidorc,the-maelstrom,288,hunter,beastmastery,6,3,3
16580,Mooj,malganis,288,hunter,beastmastery,6,3,3
16581,Hinorist,ravencrest,288,hunter,beastmastery,6,3,3
16582,Анастазис,soulflayer,288,hunter,beastmastery,6,3,3
16583,Kragán,silvermoon,288,hunter,beastmastery,6,3,3
16584,Артекриогг,soulflayer,288,hunter,beastmastery,6,3,3
16585,Aimshot,ravencrest,288,hunter,beastmastery,6,3,3
16586,Abonah,khaz-modan,288,hunter,beastmastery,6,3,3
16587,Imonér,frostmane,288,hunter,beastmastery,6,3,3
16588,Yümekø,khaz-modan,288,hunter,beastmastery,6,3,3
16589,Crmov,silvermoon,288,hunter,beastmastery,6,3,3
16590,Szrek,frostmane,288,hunter,beastmastery,6,3,3
16591,Slett,twisting-nether,288,hunter,beastmastery,6,3,3
16592,Пиворк,soulflayer,288,hunter,beastmastery,6,3,3
16593,Elbatale,sylvanas,288,hunter,beastmastery,6,3,3
16594,Трапавграунд,howling-fjord,288,hunter,beastmastery,6,3,3
16595,Скукота,grom,288,hunter,beastmastery,6,3,3
16596,Sakaryali,silvermoon,288,hunter,beastmastery,6,3,3
16597,Доррети,howling-fjord,288,hunter,beastmastery,6,3,3
16598,Katana,stormreaver,288,hunter,beastmastery,6,3,3
16599,Наладдчик,howling-fjord,288,hunter,beastmastery,6,3,3
16600,Шеннокс,howling-fjord,288,hunter,beastmastery,6,3,3
16601,Scräppÿ,kazzak,288,hunter,beastmastery,6,3,3
16602,Aldra,kelthuzad,288,hunter,beastmastery,6,3,3
16603,Рофшор,gordunni,288,hunter,beastmastery,6,3,3
16604,Lookmyezzy,ravencrest,288,hunter,beastmastery,6,3,3
16605,Nihau,ravencrest,288,hunter,beastmastery,6,3,3
16606,Демела,gordunni,288,hunter,beastmastery,6,3,3
16607,Будкусломаю,grom,288,hunter,beastmastery,6,3,3
16608,Оркос,deathweaver,288,hunter,beastmastery,6,3,3
16609,Yssup,frostmane,288,hunter,beastmastery,6,3,3
16610,Natchell,ysondre,288,hunter,beastmastery,6,3,3
16611,Haeero,archimonde,288,hunter,beastmastery,6,3,3
16612,Japuog,kazzak,288,hunter,beastmastery,6,3,3
16613,Darkdrais,archimonde,288,hunter,beastmastery,6,3,3
16614,Nathah,burning-legion,288,hunter,beastmastery,6,3,3
16615,Eveo,antonidas,288,hunter,beastmastery,6,3,3
16616,Shtooko,conseil-des-ombres,288,hunter,beastmastery,6,3,3
16617,Kxx,kazzak,288,hunter,beastmastery,6,3,3
16618,Katzchen,burning-legion,288,hunter,beastmastery,6,3,3
16619,Megagloc,shadowsong,288,hunter,beastmastery,6,3,3
16620,Bòw,antonidas,288,hunter,beastmastery,6,3,3
16621,Zdravkomamic,kazzak,288,hunter,beastmastery,6,3,3
16622,Weedonyhunt,hyjal,288,hunter,beastmastery,6,3,3
16623,Bâng,zuljin,288,hunter,beastmastery,6,3,3
16624,Bugspitz,outland,288,hunter,beastmastery,6,3,3
16625,Taemper,azshara,288,hunter,beastmastery,6,3,3
16626,Popofles,outland,288,hunter,beastmastery,6,3,3
16627,Chasseeur,archimonde,288,hunter,beastmastery,6,3,3
16628,Sugutor,malfurion,288,hunter,beastmastery,6,3,3
16629,Hugechode,kazzak,288,hunter,beastmastery,6,3,3
16630,Jimpage,eredar,288,hunter,beastmastery,6,3,3
16631,Tukezz,outland,288,hunter,beastmastery,6,3,3
16632,Visas,burning-legion,288,hunter,beastmastery,6,3,3
16633,Ipad,cthun,288,hunter,beastmastery,6,3,3
16634,Lowpital,hyjal,288,hunter,beastmastery,6,3,3
16635,Ritmkesh,draenor,288,hunter,beastmastery,6,3,3
16636,Birdwatcher,kazzak,288,hunter,beastmastery,6,3,3
16637,Zamale,arakarahm,288,hunter,beastmastery,6,3,3
16638,Skrag,outland,288,hunter,beastmastery,6,3,3
16639,Yoey,tarren-mill,288,hunter,beastmastery,6,3,3
16640,Chrønôs,archimonde,288,hunter,beastmastery,6,3,3
16641,Anthorio,cthun,288,hunter,beastmastery,6,3,3
16642,Barrybigtoe,tarren-mill,288,hunter,beastmastery,6,3,3
16643,Heedbónger,tarren-mill,288,hunter,beastmastery,6,3,3
16644,Stillflowi,draenor,288,hunter,beastmastery,6,3,3
16645,Ragingdragon,turalyon,288,hunter,beastmastery,6,3,3
16646,Natashä,area-52,288,hunter,beastmastery,6,3,3
16647,Iliíilíiílíl,outland,288,hunter,beastmastery,6,3,3
16648,Innaria,argent-dawn,288,hunter,beastmastery,6,3,3
16649,Nestereo,zirkel-des-cenarius,288,hunter,beastmastery,6,3,3
16650,Hexorn,ysondre,288,hunter,beastmastery,6,3,3
16651,Artze,outland,288,hunter,beastmastery,6,3,3
16652,Klèo,frostwhisper,288,hunter,beastmastery,6,3,3
16653,Blazeblue,hyjal,288,hunter,beastmastery,6,3,3
16654,Svinrbglol,arygos,288,hunter,beastmastery,6,3,3
16655,Lûnelle,argent-dawn,288,hunter,beastmastery,6,3,3
16656,Darthbow,outland,288,hunter,beastmastery,6,3,3
16657,Beefchops,draenor,288,hunter,beastmastery,6,3,3
16658,Huntness,kazzak,288,hunter,beastmastery,6,3,3
16659,Ðøømsðay,sanguino,288,hunter,beastmastery,6,3,3
16660,Anayhh,dun-modr,288,hunter,beastmastery,6,3,3
16661,Valtondre,argent-dawn,288,hunter,beastmastery,6,3,3
16662,Fedya,kazzak,288,hunter,beastmastery,6,3,3
16663,Heavenknøws,dun-modr,288,hunter,beastmastery,9,4,5
16664,Antisniper,kazzak,288,hunter,beastmastery,9,4,5
16665,Хантероо,gordunni,288,hunter,beastmastery,8,3,5
16666,Gzà,kazzak,288,hunter,beastmastery,12,3,9
16667,Demónhunter,frostmane,288,hunter,beastmastery,12,3,9
16668,Perkxd,stormscale,288,hunter,beastmastery,12,3,9
16669,Headhunterzz,dun-modr,288,hunter,beastmastery,12,3,9
16670,Ayaz,ravencrest,288,hunter,beastmastery,12,3,9
16671,Ímpulsion,stormscale,288,hunter,beastmastery,12,3,9
16672,Squidy,archimonde,288,hunter,beastmastery,12,3,9
16673,Goosebite,ravencrest,288,hunter,beastmastery,12,3,9
16674,Jamesbownd,ravencrest,288,hunter,beastmastery,12,3,9
16675,Hante,ravencrest,288,hunter,beastmastery,12,3,9
16676,Xoarqt,aegwynn,288,hunter,beastmastery,12,3,9
16677,Krëmpai,frostmane,288,hunter,beastmastery,12,3,9
16678,Götthunter,antonidas,288,hunter,beastmastery,12,3,9
16679,Nerøz,ravencrest,288,hunter,beastmastery,12,3,9
16680,Spakster,blackrock,288,hunter,beastmastery,12,3,9
16681,Zárnah,defias-brotherhood,288,hunter,beastmastery,12,3,9
16682,Sabnak,burning-blade,288,hunter,beastmastery,12,3,9
16683,Liikes,arygos,288,hunter,beastmastery,12,3,9
16684,Drherbs,bloodhoof,288,hunter,beastmastery,12,3,9
16685,Rrushi,argent-dawn,288,hunter,beastmastery,12,3,9
16686,Lagich,sylvanas,288,hunter,beastmastery,12,3,9
16687,Shalinda,azshara,288,hunter,beastmastery,12,3,9
16688,Andraz,burning-legion,288,hunter,beastmastery,12,3,9
16689,Mark,runetotem,288,hunter,beastmastery,12,3,9
16690,Riik,ragnaros,288,hunter,beastmastery,12,3,9
16691,Drakess,daggerspine,288,hunter,beastmastery,12,3,9
16692,Kalá,defias-brotherhood,288,hunter,beastmastery,12,3,9
16693,Phillon,blackrock,288,hunter,beastmastery,12,3,9
16694,Frikandelli,outland,288,hunter,beastmastery,12,3,9
16695,Jellyfat,silvermoon,288,hunter,beastmastery,12,3,9
16696,Marusmaskin,kazzak,288,hunter,beastmastery,12,3,9
16697,Хансбург,howling-fjord,288,hunter,beastmastery,12,3,9
16698,Huntardxx,outland,288,hunter,beastmastery,12,3,9
16699,Narziel,die-todeskrallen,288,hunter,beastmastery,12,3,9
16700,Drennak,kult-der-verdammten,288,hunter,beastmastery,12,3,9
16701,Mârked,argent-dawn,288,hunter,beastmastery,12,3,9
16702,Дварфмэн,gordunni,288,hunter,beastmastery,13,3,10
16703,Tràpz,archimonde,288,hunter,beastmastery,14,3,11
16704,Ohwagga,pozzo-delleternità,287,hunter,beastmastery,6,3,3
16705,Zhazha,chamber-of-aspects,287,hunter,beastmastery,6,3,3
16706,Топотелло,ashenvale,287,hunter,beastmastery,6,3,3
16707,Voraxh,draenor,287,hunter,beastmastery,12,3,9
16708,Asca,eldrethalas,287,hunter,beastmastery,12,3,9
16709,Jazminluv,blackrock,287,hunter,beastmastery,12,3,9
16710,Anghron,minahonda,287,hunter,beastmastery,12,3,9
16711,Oatmeal,dun-morogh,287,hunter,beastmastery,12,3,9
16712,Промахнулся,gordunni,287,hunter,beastmastery,12,3,9
16713,Snehvit,bloodhoof,285,hunter,beastmastery,18,3,15
16714,Trapgodz,ragnaros,271,hunter,beastmastery,11,3,8
16715,Lightrandom,kazzak,269,hunter,beastmastery,11,3,8
16716,Ватмано,gordunni,255,hunter,beastmastery,8,4,4
16717,Huntercheese,ravencrest,255,hunter,beastmastery,11,3,8
16718,Sarblade,bronze-dragonflight,255,hunter,beastmastery,11,3,8
16719,Shoothim,destromath,254,hunter,beastmastery,8,4,4
16720,Кулерквест,soulflayer,240,hunter,beastmastery,9,3,6
16721,Huntinger,twisting-nether,234,hunter,beastmastery,10,5,5
16722,Слышумертвых,gordunni,234,hunter,beastmastery,15,5,10
16723,Snakepit,archimonde,234,hunter,beastmastery,17,4,13
16724,Shagora,dalaran,223,hunter,beastmastery,8,3,5
16725,Sarbacanes,hyjal,192,hunter,beastmastery,6,2,4
16726,Waveshoot,hyjal,192,hunter,beastmastery,6,2,4
16727,Zetaph,argent-dawn,192,hunter,beastmastery,6,2,4
16728,Bodytypedog,ragnaros,192,hunter,beastmastery,6,2,4
16729,Privelle,argent-dawn,192,hunter,beastmastery,6,2,4
16730,Nerfit,argent-dawn,192,hunter,beastmastery,6,2,4
16731,Kirinó,ragnaros,192,hunter,beastmastery,6,2,4
16732,Jezaja,draenor,192,hunter,beastmastery,6,2,4
16733,Holytrapqt,aegwynn,192,hunter,beastmastery,6,2,4
16734,Pets,aegwynn,192,hunter,beastmastery,6,2,4
16735,Phantoprowl,stormscale,192,hunter,beastmastery,6,2,4
16736,Wülfhart,argent-dawn,192,hunter,beastmastery,6,2,4
16737,Korrekt,stormscale,192,hunter,beastmastery,6,2,4
16738,Hvaskøduenme,stormscale,192,hunter,beastmastery,6,2,4
16739,Mufassa,sinstralis,192,hunter,beastmastery,6,2,4
16740,Хароко,gordunni,192,hunter,beastmastery,6,2,4
16741,Фломидзе,gordunni,192,hunter,beastmastery,6,2,4
16742,Шимэйла,gordunni,192,hunter,beastmastery,6,2,4
16743,Twirlylock,emerald-dream,192,hunter,beastmastery,6,2,4
16744,Wolfmarko,ragnaros,192,hunter,beastmastery,6,2,4
16745,Talanar,tarren-mill,192,hunter,beastmastery,6,2,4
16746,Patrouifort,ysondre,192,hunter,beastmastery,6,2,4
16747,Dentaar,draenor,192,hunter,beastmastery,6,2,4
16748,Retropunk,ravencrest,192,hunter,beastmastery,6,2,4
16749,Álfié,ravencrest,192,hunter,beastmastery,6,2,4
16750,Avâlos,dentarg,192,hunter,beastmastery,6,2,4
16751,Progh,ragnaros,192,hunter,beastmastery,6,2,4
16752,Риперквин,gordunni,192,hunter,beastmastery,6,2,4
16753,Sylasteria,twisting-nether,192,hunter,beastmastery,6,2,4
16754,Willzz,ravencrest,192,hunter,beastmastery,6,2,4
16755,Não,onyxia,192,hunter,beastmastery,6,2,4
16756,Abraxan,twisting-nether,192,hunter,beastmastery,6,2,4
16757,Gheezana,blackhand,192,hunter,beastmastery,6,2,4
16758,Axams,archimonde,192,hunter,beastmastery,6,2,4
16759,Starkt,ragnaros,192,hunter,beastmastery,6,2,4
16760,Atylla,ravencrest,192,hunter,beastmastery,6,2,4
16761,Luuszapfae,aegwynn,192,hunter,beastmastery,6,2,4
16762,Wodhunterjr,ravencrest,192,hunter,beastmastery,6,2,4
16763,Хихихихх,gordunni,192,hunter,beastmastery,6,2,4
16764,Silencxz,aegwynn,192,hunter,beastmastery,6,2,4
16765,Aliyaan,twisting-nether,192,hunter,beastmastery,6,2,4
16766,Samodiva,twisting-nether,192,hunter,beastmastery,6,2,4
16767,Ataxyjr,ravencrest,192,hunter,beastmastery,6,2,4
16768,Díkembe,aegwynn,192,hunter,beastmastery,6,2,4
16769,Вентрана,gordunni,192,hunter,beastmastery,6,2,4
16770,Ядрис,gordunni,192,hunter,beastmastery,6,2,4
16771,Bernhardoder,blackhand,192,hunter,beastmastery,6,2,4
16772,Wolfariana,chamber-of-aspects,192,hunter,beastmastery,6,2,4
16773,Sotu,stormscale,192,hunter,beastmastery,6,2,4
16774,Фэйсконтроль,azuregos,192,hunter,beastmastery,6,2,4
16775,Dis,twilights-hammer,192,hunter,beastmastery,6,2,4
16776,Кукито,goldrinn,192,hunter,beastmastery,6,2,4
16777,Спелла,goldrinn,192,hunter,beastmastery,6,2,4
16778,Jarran,karazhan,192,hunter,beastmastery,6,2,4
16779,Marryme,blackhand,192,hunter,beastmastery,6,2,4
16780,Longblow,outland,192,hunter,beastmastery,6,2,4
16781,Samasukë,grim-batol,192,hunter,beastmastery,6,2,4
16782,Kabá,eredar,192,hunter,beastmastery,6,2,4
16783,Генрах,soulflayer,192,hunter,beastmastery,6,2,4
16784,Dogstrust,stormscale,192,hunter,beastmastery,6,2,4
16785,Legolex,burning-blade,192,hunter,beastmastery,6,2,4
16786,Ancalarion,tarren-mill,192,hunter,beastmastery,6,2,4
16787,Vör,drakthul,192,hunter,beastmastery,6,2,4
16788,Ренектон,soulflayer,192,hunter,beastmastery,6,2,4
16789,Bethenny,draenor,192,hunter,beastmastery,6,2,4
16790,Arykes,drakthul,192,hunter,beastmastery,6,2,4
16791,Lágåta,outland,192,hunter,beastmastery,6,2,4
16792,Варсор,soulflayer,192,hunter,beastmastery,6,2,4
16793,Vorthrax,drakthul,192,hunter,beastmastery,6,2,4
16794,Lifeiscool,drakthul,192,hunter,beastmastery,6,2,4
16795,Bówyóurfácé,outland,192,hunter,beastmastery,6,2,4
16796,Shademd,ahnqiraj,192,hunter,beastmastery,6,2,4
16797,Jayyke,frostmane,192,hunter,beastmastery,6,2,4
16798,Nómarak,drakthul,192,hunter,beastmastery,6,2,4
16799,Elionora,grim-batol,192,hunter,beastmastery,6,2,4
16800,Foleck,aegwynn,192,hunter,beastmastery,6,2,4
16801,Xeragon,frostwolf,192,hunter,beastmastery,6,2,4
16802,Brummel,frostwolf,192,hunter,beastmastery,6,2,4
16803,Mecamoot,drekthar,192,hunter,beastmastery,6,2,4
16804,Gukéx,stormscale,192,hunter,beastmastery,6,2,4
16805,Snakepit,stormscale,192,hunter,beastmastery,6,2,4
16806,Avp,sylvanas,192,hunter,beastmastery,6,2,4
16807,Diabloiv,doomhammer,192,hunter,beastmastery,6,2,4
16808,Scatterinc,antonidas,192,hunter,beastmastery,6,2,4
16809,Nikzeubii,archimonde,192,hunter,beastmastery,6,2,4
16810,Травок,gordunni,192,hunter,beastmastery,6,2,4
16811,Níne,sylvanas,192,hunter,beastmastery,6,2,4
16812,Bradunov,sylvanas,192,hunter,beastmastery,6,2,4
16813,Aughtism,turalyon,192,hunter,beastmastery,6,2,4
16814,Azahunt,kazzak,192,hunter,beastmastery,6,2,4
16815,Elastaplast,thunderhorn,192,hunter,beastmastery,6,2,4
16816,Sarganno,archimonde,192,hunter,beastmastery,6,2,4
16817,Yakayoshi,kazzak,192,hunter,beastmastery,6,2,4
16818,Bæbåk,frostmane,192,hunter,beastmastery,6,2,4
16819,Comegetme,auchindoun,192,hunter,beastmastery,6,2,4
16820,Sloter,stormscale,192,hunter,beastmastery,6,2,4
16821,Dola,archimonde,192,hunter,beastmastery,6,2,4
16822,Stronkbeast,kazzak,192,hunter,beastmastery,6,2,4
16823,Thecorruptor,skullcrusher,192,hunter,beastmastery,6,2,4
16824,Reiign,burning-legion,192,hunter,beastmastery,6,2,4
16825,Dragoki,blackmoore,192,hunter,beastmastery,6,2,4
16826,Scycs,nazjatar,192,hunter,beastmastery,6,2,4
16827,Deskö,shendralar,192,hunter,beastmastery,6,2,4
16828,Wildwingsebb,nazjatar,192,hunter,beastmastery,6,2,4
16829,As,kazzak,192,hunter,beastmastery,6,2,4
16830,Phyllobates,blackrock,192,hunter,beastmastery,6,2,4
16831,Nythilia,blackrock,192,hunter,beastmastery,6,2,4
16832,Fofoulinaki,silvermoon,192,hunter,beastmastery,6,2,4
16833,Gandro,blackmoore,192,hunter,beastmastery,6,2,4
16834,Gunmeister,bronzebeard,192,hunter,beastmastery,6,2,4
16835,Crostaws,terokkar,192,hunter,beastmastery,6,2,4
16836,Màdnéss,blackmoore,192,hunter,beastmastery,6,2,4
16837,Dahunter,blackmoore,192,hunter,beastmastery,6,2,4
16838,Droz,blackmoore,192,hunter,beastmastery,6,2,4
16839,Myoui,silvermoon,192,hunter,beastmastery,6,2,4
16840,Feedbackloop,silvermoon,192,hunter,beastmastery,6,2,4
16841,Igotwatuneed,kazzak,192,hunter,beastmastery,6,2,4
16842,Skalgor,thrall,192,hunter,beastmastery,6,2,4
16843,Mâgnesium,blackmoore,192,hunter,beastmastery,6,2,4
16844,Cøkø,sanguino,192,hunter,beastmastery,6,2,4
16845,Doraxa,sanguino,192,hunter,beastmastery,6,2,4
16846,Lersey,blackmoore,192,hunter,beastmastery,6,2,4
16847,Maeba,shendralar,192,hunter,beastmastery,6,2,4
16848,Miesmuschel,guldan,192,hunter,beastmastery,6,2,4
16849,Naid,lordaeron,192,hunter,beastmastery,6,2,4
16850,Annababygirl,silvermoon,192,hunter,beastmastery,6,2,4
16851,Curtiss,sanguino,192,hunter,beastmastery,6,2,4
16852,Raztreadör,dun-modr,192,hunter,beastmastery,6,2,4
16853,Zulldek,sanguino,192,hunter,beastmastery,6,2,4
16854,Жабра,gordunni,192,hunter,beastmastery,11,3,8
16855,Куджикс,soulflayer,192,hunter,beastmastery,19,4,15
16856,Elja,laughing-skull,192,hunter,beastmastery,12,2,10
16857,Calesthas,tarren-mill,192,hunter,beastmastery,12,2,10
16858,Rabyan,zuljin,192,hunter,beastmastery,12,2,10
16859,Korneatza,twisting-nether,192,hunter,beastmastery,12,2,10
16860,Ziday,sargeras,192,hunter,beastmastery,12,2,10
16861,Swallowbaby,lothar,192,hunter,beastmastery,12,2,10
16862,Tyronjr,tarren-mill,192,hunter,beastmastery,12,2,10
16863,Willýs,ysondre,192,hunter,beastmastery,12,2,10
16864,Jeddaj,stormscale,192,hunter,beastmastery,12,2,10
16865,Pôîson,kazzak,192,hunter,beastmastery,12,2,10
16866,Bloodking,madmortem,192,hunter,beastmastery,12,2,10
16867,Biorson,silvermoon,192,hunter,beastmastery,12,2,10
16868,Dorakor,ysondre,192,hunter,beastmastery,12,2,10
16869,Schräubchen,antonidas,192,hunter,beastmastery,12,2,10
16870,Waraëlle,dalaran,192,hunter,beastmastery,12,2,10
16871,Фомкалол,howling-fjord,192,hunter,beastmastery,12,2,10
16872,Psailaa,azjolnerub,192,hunter,beastmastery,12,2,10
16873,Slayman,kazzak,192,hunter,beastmastery,18,2,16
16874,Charlet,archimonde,191,hunter,beastmastery,6,2,4
16875,Сливочкии,goldrinn,191,hunter,beastmastery,6,2,4
16876,Traknard,confrérie-du-thorium,191,hunter,beastmastery,6,2,4
16877,Uab,dun-morogh,191,hunter,beastmastery,12,2,10
16878,Kizscamander,magtheridon,191,hunter,beastmastery,12,2,10
16879,Masarusan,eredar,175,hunter,beastmastery,11,2,9
16880,Eilosh,outland,160,hunter,beastmastery,10,2,8
16881,Ripulianneli,stormscale,159,hunter,beastmastery,6,3,3
16882,Rakmo,blackmoore,159,hunter,beastmastery,5,2,3
16883,Guna,aggra-português,159,hunter,beastmastery,5,2,3
16884,Dolwen,argent-dawn,159,hunter,beastmastery,5,2,3
16885,Phinox,sanguino,159,hunter,beastmastery,11,2,9
16886,Cadier,argent-dawn,144,hunter,beastmastery,3,3,0
16887,Hakaîí,aegwynn,138,hunter,beastmastery,10,4,6
16888,Tanteaab,blackmoore,138,hunter,beastmastery,11,4,7
16889,Enîgmatîke,archimonde,138,hunter,beastmastery,9,3,6
16890,Deathøfrats,ravencrest,128,hunter,beastmastery,4,2,2
16891,Elnazar,archimonde,128,hunter,beastmastery,4,2,2
16892,Иттириса,gordunni,128,hunter,beastmastery,4,2,2
16893,Тауриэлль,soulflayer,126,hunter,beastmastery,21,7,14
16894,Liscie,silvermoon,105,hunter,beastmastery,16,4,12
16895,Anun,magtheridon,96,hunter,beastmastery,6,1,5
16896,Furiouslao,eredar,96,hunter,beastmastery,6,1,5
16897,Gurkans,aggramar,96,hunter,beastmastery,6,1,5
16898,Jakuken,dun-modr,96,hunter,beastmastery,6,1,5
16899,Hÿyrøk,ysondre,96,hunter,beastmastery,6,1,5
16900,Rem,zuljin,96,hunter,beastmastery,6,1,5
16901,Táráh,proudmoore,96,hunter,beastmastery,6,1,5
16902,Дочьпескова,gordunni,96,hunter,beastmastery,6,1,5
16903,Золларис,deathguard,96,hunter,beastmastery,6,1,5
16904,Rîsas,draenor,96,hunter,beastmastery,6,1,5
16905,Буреклык,gordunni,96,hunter,beastmastery,6,1,5
16906,Nätzz,dun-modr,96,hunter,beastmastery,6,1,5
16907,Opasan,nordrassil,96,hunter,beastmastery,6,1,5
16908,Akkixz,antonidas,96,hunter,beastmastery,6,1,5
16909,Zogzøg,draenor,96,hunter,beastmastery,6,1,5
16910,Platano,hyjal,96,hunter,beastmastery,6,1,5
16911,Buoma,kazzak,96,hunter,beastmastery,6,1,5
16912,Zulô,rexxar,96,hunter,beastmastery,6,1,5
16913,Baldazr,shadowsong,96,hunter,beastmastery,6,1,5
16914,Steez,hyjal,96,hunter,beastmastery,6,1,5
16915,Derhùnethàl,hyjal,96,hunter,beastmastery,6,1,5
16916,Furheious,archimonde,96,hunter,beastmastery,6,1,5
16917,Billythree,argent-dawn,96,hunter,beastmastery,6,1,5
16918,Bobletty,tarren-mill,96,hunter,beastmastery,6,1,5
16919,Hairyplottér,kazzak,96,hunter,beastmastery,6,1,5
16920,Wórldz,dun-modr,96,hunter,beastmastery,6,1,5
16921,Imahuntard,frostmane,96,hunter,beastmastery,6,1,5
16922,Zergst,nathrezim,96,hunter,beastmastery,6,1,5
16923,Fakepvper,darksorrow,96,hunter,beastmastery,6,1,5
16924,Odenssbest,silvermoon,96,hunter,beastmastery,6,1,5
16925,Teedfredd,tarren-mill,96,hunter,beastmastery,6,1,5
16926,Valiriz,blackmoore,96,hunter,beastmastery,6,1,5
16927,Jâyranger,ravencrest,96,hunter,beastmastery,6,1,5
16928,Bensoussan,archimonde,96,hunter,beastmastery,6,1,5
16929,Nomorex,frostwhisper,96,hunter,beastmastery,6,1,5
16930,Fizí,stormscale,96,hunter,beastmastery,6,1,5
16931,Syjinny,kazzak,96,hunter,beastmastery,6,1,5
16932,Zugzlug,tarren-mill,96,hunter,beastmastery,6,1,5
16933,Sokrám,sanguino,96,hunter,beastmastery,6,1,5
16934,Foxhunt,turalyon,96,hunter,beastmastery,6,1,5
16935,Weafster,outland,96,hunter,beastmastery,6,1,5
16936,Nicoh,elune,96,hunter,beastmastery,6,1,5
16937,Chambiann,tarren-mill,96,hunter,beastmastery,6,1,5
16938,Betarayjinx,kazzak,96,hunter,beastmastery,6,1,5
16939,Hashaya,hyjal,96,hunter,beastmastery,6,1,5
16940,Rayana,garrosh,96,hunter,beastmastery,6,1,5
16941,Ventaric,pozzo-delleternità,96,hunter,beastmastery,6,1,5
16942,Shadowmiz,shattered-hand,96,hunter,beastmastery,6,1,5
16943,Bloodfallen,onyxia,96,hunter,beastmastery,6,1,5
16944,Oou,auchindoun,96,hunter,beastmastery,6,1,5
16945,Øô,blackrock,96,hunter,beastmastery,6,1,5
16946,Clownchef,blackhand,96,hunter,beastmastery,6,1,5
16947,Anhyzer,nemesis,96,hunter,beastmastery,6,1,5
16948,Justchill,ravencrest,96,hunter,beastmastery,6,1,5
16949,Drolarin,zuljin,96,hunter,beastmastery,6,1,5
16950,Сочнаятурель,howling-fjord,96,hunter,beastmastery,6,1,5
16951,Hechozar,kazzak,96,hunter,beastmastery,6,1,5
16952,Ichbringbier,blackrock,96,hunter,beastmastery,6,1,5
16953,Zurzok,blackrock,96,hunter,beastmastery,6,1,5
16954,Женистайл,howling-fjord,96,hunter,beastmastery,6,1,5
16955,Exorbitant,blackrock,96,hunter,beastmastery,6,1,5
16956,Пиппиракон,soulflayer,96,hunter,beastmastery,6,1,5
16957,Beastmaster,ragnaros,96,hunter,beastmastery,6,1,5
16958,Jozsiur,ragnaros,96,hunter,beastmastery,6,1,5
16959,Traptard,blackrock,96,hunter,beastmastery,6,1,5
16960,Jägerjokke,blackrock,96,hunter,beastmastery,6,1,5
16961,Grigur,dalaran,96,hunter,beastmastery,6,1,5
16962,Hntudwn,azshara,96,hunter,beastmastery,6,1,5
16963,Травмаопасен,gordunni,96,hunter,beastmastery,6,1,5
16964,Dasmusdrückn,antonidas,96,hunter,beastmastery,6,1,5
16965,Darkray,dalaran,96,hunter,beastmastery,6,1,5
16966,Runescimmy,twisting-nether,96,hunter,beastmastery,6,1,5
16967,Trollohunt,twisting-nether,96,hunter,beastmastery,6,1,5
16968,Noxll,gorgonnash,96,hunter,beastmastery,6,1,5
16969,Achiles,die-todeskrallen,96,hunter,beastmastery,6,1,5
16970,Левери,gordunni,96,hunter,beastmastery,6,1,5
16971,Bobtroll,twisting-nether,96,hunter,beastmastery,6,1,5
16972,Эннабонни,gordunni,96,hunter,beastmastery,6,1,5
16973,Arthass,die-aldor,96,hunter,beastmastery,12,1,11
16974,Jamaro,dun-modr,96,hunter,beastmastery,12,1,11
16975,Schmaikell,blackmoore,96,hunter,beastmastery,12,1,11
16976,Tsyapka,tarren-mill,96,hunter,beastmastery,12,1,11
16977,Thóorin,ravencrest,96,hunter,beastmastery,12,1,11
16978,Лиасон,howling-fjord,96,hunter,beastmastery,12,1,11
16979,Johnnygnus,drakthul,96,hunter,beastmastery,12,1,11
16980,Сыньйорита,howling-fjord,96,hunter,beastmastery,12,1,11
16981,Døgtamer,twisting-nether,96,hunter,beastmastery,12,1,11
16982,Críted,blackmoore,96,hunter,beastmastery,12,1,11
16983,Vandathien,stormrage,96,hunter,beastmastery,12,1,11
16984,Milandria,antonidas,96,hunter,beastmastery,18,1,17
16985,Халфен,eversong,79,hunter,beastmastery,5,1,4
16986,Franzfuchs,blackmoore,79,hunter,beastmastery,5,1,4
16987,Quiarà,elune,64,hunter,beastmastery,4,1,3
16988,Bmilfhunter,blackhand,64,hunter,beastmastery,4,1,3
16989,Yahamenistos,ysondre,64,hunter,beastmastery,4,1,3
16990,Youngjinh,ravencrest,64,hunter,beastmastery,4,1,3
16991,Acuatropatas,sanguino,64,hunter,beastmastery,4,1,3
16992,Illnysa,silvermoon,48,hunter,beastmastery,3,1,2
16993,Графруру,soulflayer,48,hunter,beastmastery,3,1,2
16994,Voldtzeig,dentarg,42,hunter,beastmastery,13,4,9
16995,Рэттс,soulflayer,31,hunter,beastmastery,2,1,1
16996,Martuk,aegwynn,31,hunter,beastmastery,2,1,1
16997,Котюнечка,gordunni,31,hunter,beastmastery,2,1,1
16998,Melloy,drakthul,31,hunter,beastmastery,2,1,1
16999,Soulflyer,draenor,16,hunter,beastmastery,1,1,0
17000,Random,sylvanas,16,hunter,beastmastery,1,1,0
17001,Gwaan,outland,9,hunter,beastmastery,6,2,4
17002,Aleç,ravencrest,1971,mage,arcane,66,33,33
17003,Cubis,archimonde,1952,mage,arcane,66,34,32
17004,Boogeymanx,ravencrest,1940,mage,arcane,71,42,29
17005,Aleteia,stormscale,1917,mage,arcane,76,38,38
17006,Magegôd,outland,1910,mage,arcane,75,39,36
17007,Макотшельник,gordunni,1881,mage,arcane,30,23,7
17008,Choll,stormscale,1866,mage,arcane,30,20,10
17009,Wàneís,ravencrest,1843,mage,arcane,78,38,40
17010,Castorcato,kazzak,1841,mage,arcane,60,34,26
17011,Фоулли,howling-fjord,1829,mage,arcane,66,31,35
17012,Obbcontrol,ravencrest,1820,mage,arcane,84,45,39
17013,Tokerlol,stormscale,1811,mage,arcane,221,122,99
17014,Belthesad,twisting-nether,1806,mage,arcane,62,42,20
17015,Lemaroxd,draenor,1801,mage,arcane,59,33,26
17016,Ephreaym,stormscale,1787,mage,arcane,83,39,44
17017,Bebenm,archimonde,1762,mage,arcane,105,47,58
17018,Wracrz,argent-dawn,1761,mage,arcane,96,55,41
17019,Папущенный,soulflayer,1749,mage,arcane,91,48,43
17020,Нефростмаг,gordunni,1743,mage,arcane,192,96,96
17021,Ecovation,tarren-mill,1731,mage,arcane,121,68,53
17022,Frostseeker,tarren-mill,1731,mage,arcane,54,30,24
17023,Derett,stormscale,1725,mage,arcane,48,22,26
17024,Raíku,ravencrest,1723,mage,arcane,30,18,12
17025,Непутевыймаг,gordunni,1715,mage,arcane,24,23,1
17026,Waterhagx,tarren-mill,1712,mage,arcane,29,20,9
17027,Mercem,stormscale,1711,mage,arcane,30,21,9
17028,Persi,dentarg,1702,mage,arcane,192,97,95
17029,Sallesauruus,outland,1700,mage,arcane,107,54,53
17030,Shirrunn,the-maelstrom,1687,mage,arcane,38,19,19
17031,Burstology,kazzak,1683,mage,arcane,167,87,80
17032,Dardíe,ravencrest,1681,mage,arcane,54,31,23
17033,Shiranize,aegwynn,1676,mage,arcane,70,35,35
17034,Fearbeäch,ravencrest,1666,mage,arcane,52,25,27
17035,Dárdie,ravencrest,1662,mage,arcane,40,21,19
17036,Radagulf,outland,1659,mage,arcane,127,63,64
17037,Astrryy,burning-legion,1650,mage,arcane,41,19,22
17038,Covran,stormscale,1650,mage,arcane,65,29,36
17039,Uknowhowwedu,blackrock,1649,mage,arcane,36,22,14
17040,Magijoana,silvermoon,1629,mage,arcane,32,18,14
17041,Nvpk,blackrock,1628,mage,arcane,48,24,24
17042,Alustrasz,skullcrusher,1627,mage,arcane,111,60,51
17043,Проблембойх,gordunni,1627,mage,arcane,36,17,19
17044,Sérc,ravencrest,1626,mage,arcane,30,17,13
17045,Barbeuqx,garona,1623,mage,arcane,108,59,49
17046,Медивера,gordunni,1622,mage,arcane,24,17,7
17047,Orkamor,sylvanas,1622,mage,arcane,42,17,25
17048,Сизаам,howling-fjord,1608,mage,arcane,41,21,20
17049,Absie,tarren-mill,1603,mage,arcane,72,47,25
17050,Бигдикмаг,soulflayer,1590,mage,arcane,35,17,18
17051,Antaos,drakthul,1553,mage,arcane,66,41,25
17052,Димаскунфу,howling-fjord,1534,mage,arcane,52,21,31
17053,Манкай,fordragon,1520,mage,arcane,248,131,117
17054,Poochmage,archimonde,1516,mage,arcane,66,31,35
17055,Nelg,silvermoon,1506,mage,arcane,60,35,25
17056,Ekron,sanguino,1496,mage,arcane,385,195,190
17057,Råståfåri,uldum,1490,mage,arcane,107,60,47
17058,Nakamura,outland,1486,mage,arcane,344,171,173
17059,Samirra,stormscale,1485,mage,arcane,60,32,28
17060,Vxvfrowstxvx,jaedenar,1471,mage,arcane,30,17,13
17061,Magikere,tarren-mill,1456,mage,arcane,125,76,49
17062,Akâri,silvermoon,1450,mage,arcane,71,44,27
17063,Portal,scarshield-legion,1446,mage,arcane,48,27,21
17064,Шттрвблнкт,soulflayer,1443,mage,arcane,103,48,55
17065,Ímnotback,outland,1440,mage,arcane,52,24,28
17066,Tiqma,sylvanas,1434,mage,arcane,36,15,21
17067,Ogarcanefist,outland,1424,mage,arcane,69,35,34
17068,Leanboy,dun-modr,1418,mage,arcane,30,16,14
17069,Раканчик,gordunni,1406,mage,arcane,86,42,44
17070,Sukalamink,alonsus,1405,mage,arcane,48,22,26
17071,Lusionator,defias-brotherhood,1394,mage,arcane,54,31,23
17072,Másterdukè,silvermoon,1387,mage,arcane,48,19,29
17073,Sapien,sanguino,1373,mage,arcane,64,27,37
17074,Barspin,lightnings-blade,1368,mage,arcane,102,54,48
17075,Elor,eredar,1361,mage,arcane,39,20,19
17076,Azuredragon,tarren-mill,1361,mage,arcane,61,30,31
17077,Ðøæø,twisting-nether,1346,mage,arcane,93,46,47
17078,Tnhigh,blackrock,1343,mage,arcane,57,31,26
17079,Рбгпотаскуха,gordunni,1337,mage,arcane,18,14,4
17080,Trucy,eredar,1332,mage,arcane,162,76,86
17081,Diper,burning-legion,1328,mage,arcane,36,15,21
17082,Fadi,anachronos,1325,mage,arcane,30,14,16
17083,Aloxigozal,shendralar,1320,mage,arcane,18,14,4
17084,Jhawkwizard,draenor,1314,mage,arcane,274,138,136
17085,Krykz,sanguino,1308,mage,arcane,54,22,32
17086,Hâplo,burning-legion,1307,mage,arcane,30,18,12
17087,Arkeus,turalyon,1305,mage,arcane,41,26,15
17088,Paradigma,sylvanas,1305,mage,arcane,30,14,16
17089,Faxchungus,argent-dawn,1304,mage,arcane,24,16,8
17090,Весиал,deathguard,1304,mage,arcane,77,42,35
17091,Даанрен,galakrond,1301,mage,arcane,36,14,22
17092,Манаманна,gordunni,1300,mage,arcane,382,192,190
17093,Валбериса,deepholm,1298,mage,arcane,60,39,21
17094,Wolftemper,ravencrest,1296,mage,arcane,42,19,23
17095,Nefrendel,kazzak,1292,mage,arcane,86,42,44
17096,Mäalaka,archimonde,1289,mage,arcane,42,16,26
17097,Pradapimp,ravencrest,1286,mage,arcane,32,15,17
17098,Nimdáá,stormscale,1286,mage,arcane,54,24,30
17099,Venchimage,silvermoon,1284,mage,arcane,62,26,36
17100,Nïo,ravencrest,1283,mage,arcane,104,44,60
17101,Estelliên,burning-legion,1273,mage,arcane,27,14,13
17102,Sadrã,kazzak,1247,mage,arcane,69,30,39
17103,Яшабурстх,blackscar,1246,mage,arcane,30,13,17
17104,Нормалмап,soulflayer,1243,mage,arcane,54,21,33
17105,Meolchum,outland,1237,mage,arcane,45,22,23
17106,Nécrømage,confrérie-du-thorium,1235,mage,arcane,18,13,5
17107,Léa,rashgarroth,1235,mage,arcane,48,21,27
17108,Scaleeth,kazzak,1233,mage,arcane,30,13,17
17109,Moxine,la-croisade-écarlate,1230,mage,arcane,59,26,33
17110,Rezre,stormscale,1212,mage,arcane,60,31,29
17111,Kazeen,silvermoon,1211,mage,arcane,82,45,37
17112,Noarcane,twisting-nether,1209,mage,arcane,93,54,39
17113,Tokyodes,twisting-nether,1206,mage,arcane,85,37,48
17114,Канеллис,howling-fjord,1197,mage,arcane,37,14,23
17115,Hruon,ravenholdt,1195,mage,arcane,30,14,16
17116,Bananflickan,kazzak,1189,mage,arcane,96,53,43
17117,Ozdewish,hyjal,1183,mage,arcane,118,55,63
17118,Xiaomofashi,quelthalas,1166,mage,arcane,120,58,62
17119,Scaless,stormscale,1157,mage,arcane,52,19,33
17120,Demizboub,archimonde,1154,mage,arcane,168,85,83
17121,Knúbbz,ravencrest,1147,mage,arcane,36,12,24
17122,Sszz,ravencrest,1145,mage,arcane,145,76,69
17123,Vaelwin,argent-dawn,1145,mage,arcane,42,21,21
17124,Minglul,archimonde,1142,mage,arcane,18,12,6
17125,Айсъмэджик,azuregos,1128,mage,arcane,36,14,22
17126,Gorn,ravencrest,1123,mage,arcane,36,21,15
17127,Kobrass,spinebreaker,1111,mage,arcane,36,12,24
17128,Hardways,archimonde,1109,mage,arcane,153,67,86
17129,Burnqq,twisting-nether,1101,mage,arcane,77,37,40
17130,Säga,the-venture-co,1101,mage,arcane,70,29,41
17131,Romethito,dun-modr,1089,mage,arcane,41,15,26
17132,Sulteaxion,garrosh,1085,mage,arcane,24,12,12
17133,Nelfchewer,ravencrest,1068,mage,arcane,23,12,11
17134,Fôôxy,aegwynn,1059,mage,arcane,36,16,20
17135,Angryalways,stormscale,1054,mage,arcane,18,11,7
17136,Bullegong,archimonde,1052,mage,arcane,24,11,13
17137,Soulraider,tarren-mill,1050,mage,arcane,24,11,13
17138,Roulettefar,kazzak,1038,mage,arcane,24,11,13
17139,Plor,exodar,1019,mage,arcane,26,13,13
17140,Iwannakissu,gorgonnash,1009,mage,arcane,41,21,20
17141,Roughfked,silvermoon,1002,mage,arcane,53,31,22
17142,Mylord,bronze-dragonflight,993,mage,arcane,53,21,32
17143,Дантрий,gordunni,985,mage,arcane,30,16,14
17144,Кронни,razuvious,979,mage,arcane,23,11,12
17145,Banjó,twilights-hammer,959,mage,arcane,12,10,2
17146,Arcticfury,ravencrest,959,mage,arcane,18,10,8
17147,Magiwan,silvermoon,959,mage,arcane,30,10,20
17148,Иссэя,borean-tundra,954,mage,arcane,37,21,16
17149,Чобон,soulflayer,952,mage,arcane,30,10,20
17150,Дырявка,galakrond,949,mage,arcane,30,10,20
17151,Zezt,tarren-mill,939,mage,arcane,30,10,20
17152,Malshash,outland,937,mage,arcane,18,10,8
17153,Syltris,drakthul,930,mage,arcane,48,19,29
17154,Frostdeath,medivh,906,mage,arcane,24,10,14
17155,Mannenye,stormscale,899,mage,arcane,30,11,19
17156,Исусина,borean-tundra,877,mage,arcane,23,11,12
17157,Вадимодесса,soulflayer,877,mage,arcane,61,28,33
17158,Puni,emerald-dream,864,mage,arcane,12,9,3
17159,Fuhry,tarren-mill,864,mage,arcane,12,9,3
17160,Uknowhowwedu,aegwynn,864,mage,arcane,12,9,3
17161,Techies,archimonde,863,mage,arcane,12,9,3
17162,Letsa,stormscale,863,mage,arcane,12,9,3
17163,Gnarrly,tarren-mill,863,mage,arcane,15,9,6
17164,Arcann,ravencrest,863,mage,arcane,18,9,9
17165,Superduck,ragnaros,863,mage,arcane,24,9,15
17166,Сморгонец,gordunni,856,mage,arcane,26,11,15
17167,Kaevelin,argent-dawn,852,mage,arcane,24,9,15
17168,Beardmorph,auchindoun,842,mage,arcane,23,9,14
17169,Merlïne,les-clairvoyants,838,mage,arcane,72,31,41
17170,Modjahead,tarren-mill,822,mage,arcane,29,9,20
17171,Mageé,argent-dawn,807,mage,arcane,23,9,14
17172,Neséri,blackmoore,800,mage,arcane,22,9,13
17173,Zimbabweborc,burning-legion,768,mage,arcane,12,8,4
17174,Sÿmera,dun-modr,768,mage,arcane,18,8,10
17175,Jayhó,outland,767,mage,arcane,12,8,4
17176,Aristarco,outland,767,mage,arcane,18,8,10
17177,Zehnvonzehn,antonidas,767,mage,arcane,18,8,10
17178,Aeghis,darkspear,765,mage,arcane,18,8,10
17179,Angélique,ragnaros,763,mage,arcane,24,8,16
17180,Diaflash,silvermoon,752,mage,arcane,41,15,26
17181,Sticlachivas,stormscale,730,mage,arcane,23,8,15
17182,Freshforces,ragnaros,703,mage,arcane,22,8,14
17183,Nelluc,turalyon,702,mage,arcane,14,8,6
17184,Pyroden,stormscale,700,mage,arcane,20,8,12
17185,Doryy,silvermoon,672,mage,arcane,12,7,5
17186,Jengele,argent-dawn,672,mage,arcane,12,7,5
17187,Wanrltw,ragnaros,672,mage,arcane,12,7,5
17188,Млдбоярин,gordunni,672,mage,arcane,12,7,5
17189,Pizwiz,kazzak,672,mage,arcane,16,8,8
17190,Adetin,tarren-mill,671,mage,arcane,12,7,5
17191,Nötmârtònxø,ragnaros,671,mage,arcane,12,7,5
17192,Thorstäin,ragnaros,670,mage,arcane,18,7,11
17193,Itzlucky,twisting-nether,670,mage,arcane,18,7,11
17194,Зухвала,howling-fjord,655,mage,arcane,29,8,21
17195,Brugg,antonidas,651,mage,arcane,18,7,11
17196,Nergl,darksorrow,623,mage,arcane,27,7,20
17197,Pyllymake,kazzak,576,mage,arcane,12,6,6
17198,Æones,kult-der-verdammten,576,mage,arcane,18,6,12
17199,Shõrty,thrall,575,mage,arcane,12,6,6
17200,Apc,sylvanas,575,mage,arcane,12,6,6
17201,Tarovan,defias-brotherhood,575,mage,arcane,12,6,6
17202,Aod,chogall,575,mage,arcane,12,6,6
17203,Spicymash,chogall,575,mage,arcane,12,6,6
17204,Карраско,soulflayer,575,mage,arcane,12,6,6
17205,ßjwercke,stormscale,575,mage,arcane,18,6,12
17206,Окости,howling-fjord,574,mage,arcane,12,6,6
17207,Sarjeta,grim-batol,572,mage,arcane,18,6,12
17208,Corlys,defias-brotherhood,569,mage,arcane,12,6,6
17209,Leil,die-todeskrallen,569,mage,arcane,24,6,18
17210,Sparrowixx,turalyon,537,mage,arcane,14,7,7
17211,Seraf,argent-dawn,496,mage,arcane,13,6,7
17212,Vaerén,malganis,495,mage,arcane,13,6,7
17213,Tamtheone,frostwhisper,480,mage,arcane,6,5,1
17214,Rmnzr,blackrock,480,mage,arcane,6,5,1
17215,Rayniß,blackmoore,480,mage,arcane,6,5,1
17216,Aletheía,stormscale,480,mage,arcane,6,5,1
17217,Auchenax,argent-dawn,480,mage,arcane,12,5,7
17218,Alarak,drakthul,480,mage,arcane,12,5,7
17219,Jînexo,shattrath,480,mage,arcane,12,5,7
17220,Magevnr,hyjal,480,mage,arcane,12,5,7
17221,Pwntt,terenas,480,mage,arcane,12,5,7
17222,Médivh,archimonde,480,mage,arcane,12,5,7
17223,Barryscótt,stormscale,480,mage,arcane,12,5,7
17224,Ледянойкекс,gordunni,480,mage,arcane,18,5,13
17225,Mðj,kazzak,480,mage,arcane,18,5,13
17226,Ewina,twisting-nether,479,mage,arcane,6,5,1
17227,Skankengine,twisting-nether,479,mage,arcane,6,5,1
17228,Insømnium,stormscale,479,mage,arcane,12,5,7
17229,Mortlol,chamber-of-aspects,479,mage,arcane,12,5,7
17230,Winterblues,frostmourne,479,mage,arcane,12,5,7
17231,Gripe,defias-brotherhood,478,mage,arcane,6,5,1
17232,Odor,haomarush,475,mage,arcane,12,5,7
17233,Bogher,pozzo-delleternità,472,mage,arcane,12,5,7
17234,Mysticbeard,argent-dawn,384,mage,arcane,6,4,2
17235,Yunox,stormscale,384,mage,arcane,6,4,2
17236,Apollohouse,ravencrest,384,mage,arcane,6,4,2
17237,Rizzlybear,outland,384,mage,arcane,6,4,2
17238,Мглавечная,azuregos,384,mage,arcane,6,4,2
17239,Hexmath,tarren-mill,384,mage,arcane,6,4,2
17240,Cysbb,arathi,384,mage,arcane,12,4,8
17241,Boogeyone,drakthul,384,mage,arcane,12,4,8
17242,Uní,emerald-dream,384,mage,arcane,12,4,8
17243,Isralysa,ravencrest,384,mage,arcane,12,4,8
17244,Zoot,ravencrest,384,mage,arcane,12,4,8
17245,Mupana,nagrand,384,mage,arcane,12,4,8
17246,Uskomaaginen,ravencrest,384,mage,arcane,12,4,8
17247,Mikaelà,blackmoore,383,mage,arcane,6,4,2
17248,Reiggo,silvermoon,383,mage,arcane,6,4,2
17249,Némmesis,zuljin,378,mage,arcane,12,4,8
17250,Bigshape,frostwolf,351,mage,arcane,11,4,7
17251,Roxolani,defias-brotherhood,303,mage,arcane,14,4,10
17252,Æskalatîøn,blackmoore,288,mage,arcane,6,3,3
17253,Dcolon,tarren-mill,288,mage,arcane,6,3,3
17254,Bmbiscuit,ravencrest,288,mage,arcane,6,3,3
17255,Khadgia,argent-dawn,288,mage,arcane,6,3,3
17256,Колдрагос,gordunni,288,mage,arcane,6,3,3
17257,Mylanq,ragnaros,288,mage,arcane,6,3,3
17258,Onlymage,outland,288,mage,arcane,6,3,3
17259,Inaruy,hyjal,288,mage,arcane,6,3,3
17260,Purrpl,twisting-nether,288,mage,arcane,6,3,3
17261,Choise,stormscale,288,mage,arcane,6,3,3
17262,Hachiro,onyxia,288,mage,arcane,6,3,3
17263,Radiantfury,outland,288,mage,arcane,6,3,3
17264,Euklid,ravencrest,288,mage,arcane,6,3,3
17265,Kyrn,zuljin,288,mage,arcane,6,3,3
17266,Euphorie,twisting-nether,288,mage,arcane,6,3,3
17267,Seyece,silvermoon,288,mage,arcane,6,3,3
17268,Ignyx,ragnaros,288,mage,arcane,6,3,3
17269,Astroknight,silvermoon,288,mage,arcane,6,3,3
17270,Khoshgele,draenor,288,mage,arcane,6,3,3
17271,Deadtedd,twisting-nether,288,mage,arcane,6,3,3
17272,Ovrpwrdxd,kazzak,288,mage,arcane,6,3,3
17273,Gagaj,ravencrest,288,mage,arcane,6,3,3
17274,Brokenlegman,defias-brotherhood,288,mage,arcane,6,3,3
17275,Мактай,gordunni,288,mage,arcane,6,3,3
17276,Serctheone,ravencrest,288,mage,arcane,9,4,5
17277,Dareah,blackmoore,288,mage,arcane,12,3,9
17278,Kudakto,ravencrest,288,mage,arcane,12,3,9
17279,Magitis,blackhand,288,mage,arcane,12,3,9
17280,Хблэйз,howling-fjord,288,mage,arcane,12,3,9
17281,Chimará,eredar,288,mage,arcane,18,3,15
17282,Магборода,soulflayer,287,mage,arcane,6,3,3
17283,Frökenfrost,stormscale,287,mage,arcane,6,3,3
17284,Burnem,kult-der-verdammten,287,mage,arcane,6,3,3
17285,Arcadua,sanguino,287,mage,arcane,6,3,3
17286,Kasus,sporeggar,286,mage,arcane,6,3,3
17287,Ivoc,drakthul,254,mage,arcane,11,3,8
17288,Naween,hyjal,239,mage,arcane,5,3,2
17289,Kairøs,dragonblight,223,mage,arcane,16,3,13
17290,Teeclis,twisting-nether,192,mage,arcane,6,2,4
17291,Kold,stormscale,192,mage,arcane,6,2,4
17292,Schøkø,eredar,192,mage,arcane,6,2,4
17293,Линклер,fordragon,192,mage,arcane,6,2,4
17294,Baravar,blackrock,192,mage,arcane,6,2,4
17295,Génociidz,archimonde,192,mage,arcane,6,2,4
17296,Sheeptowin,thrall,192,mage,arcane,6,2,4
17297,Versachi,neptulon,192,mage,arcane,6,2,4
17298,Quaile,malygos,192,mage,arcane,6,2,4
17299,Magepress,silvermoon,192,mage,arcane,6,2,4
17300,Phyzed,archimonde,192,mage,arcane,6,2,4
17301,Mejtschazor,twisting-nether,192,mage,arcane,6,2,4
17302,Леракобольд,gordunni,192,mage,arcane,6,2,4
17303,Kuhwar,echsenkessel,192,mage,arcane,6,2,4
17304,Ryûblast,archimonde,192,mage,arcane,6,2,4
17305,Rommelo,ravencrest,192,mage,arcane,6,2,4
17306,Миднаит,gordunni,192,mage,arcane,6,2,4
17307,Галадриелька,gordunni,192,mage,arcane,6,2,4
17308,Nerzzhul,burning-legion,192,mage,arcane,6,2,4
17309,Arimila,sylvanas,192,mage,arcane,6,2,4
17310,Kjh,twisting-nether,192,mage,arcane,6,2,4
17311,Drinte,blackmoore,192,mage,arcane,6,2,4
17312,Imbatto,quelthalas,192,mage,arcane,6,2,4
17313,Зерагуд,eversong,192,mage,arcane,6,2,4
17314,Noxkin,stormscale,192,mage,arcane,6,2,4
17315,Ãshs,archimonde,192,mage,arcane,6,2,4
17316,Shockólot,outland,192,mage,arcane,6,2,4
17317,Azoru,twisting-nether,192,mage,arcane,6,2,4
17318,Naomypayton,tarren-mill,192,mage,arcane,6,2,4
17319,Kbd,outland,192,mage,arcane,6,2,4
17320,Smlx,outland,192,mage,arcane,12,2,10
17321,Magse,kirin-tor,191,mage,arcane,6,2,4
17322,Roslinda,outland,191,mage,arcane,6,2,4
17323,Icx,tarren-mill,191,mage,arcane,6,2,4
17324,Veveroiu,defias-brotherhood,191,mage,arcane,6,2,4
17325,Anderl,kirin-tor,191,mage,arcane,12,2,10
17326,Jamzymage,emerald-dream,96,mage,arcane,3,2,1
17327,Sidildur,ravencrest,96,mage,arcane,6,1,5
17328,Саназэр,soulflayer,96,mage,arcane,6,1,5
17329,Autramage,emerald-dream,96,mage,arcane,6,1,5
17330,Kalokoh,tarren-mill,96,mage,arcane,6,1,5
17331,Криаркана,howling-fjord,96,mage,arcane,6,1,5
17332,Sorrow,outland,96,mage,arcane,6,1,5
17333,Souldemon,burning-legion,96,mage,arcane,6,1,5
17334,Thelastmage,outland,96,mage,arcane,6,1,5
17335,Døomey,ravencrest,96,mage,arcane,6,1,5
17336,Animaze,argent-dawn,96,mage,arcane,6,1,5
17337,Мерац,howling-fjord,96,mage,arcane,6,1,5
17338,Старкскрим,gordunni,96,mage,arcane,6,1,5
17339,Lumberth,sanguino,96,mage,arcane,6,1,5
17340,Moosemæn,stormscale,96,mage,arcane,6,1,5
17341,Azakadabra,ysondre,96,mage,arcane,6,1,5
17342,Wushii,aggra-português,96,mage,arcane,6,1,5
17343,Firehasse,draenor,96,mage,arcane,6,1,5
17344,Yungbambix,twisting-nether,96,mage,arcane,6,1,5
17345,Zerøsílgødx,antonidas,96,mage,arcane,6,1,5
17346,Nohbrain,blackmoore,96,mage,arcane,6,1,5
17347,Шпексх,soulflayer,96,mage,arcane,6,1,5
17348,Hólmess,silvermoon,96,mage,arcane,6,1,5
17349,Buttet,blackmoore,96,mage,arcane,12,1,11
17350,Patricstewrd,draenor,96,mage,arcane,12,1,11
17351,Varini,twisting-nether,96,mage,arcane,12,1,11
17352,Magicpowers,silvermoon,96,mage,arcane,12,1,11
17353,Манднесс,azuregos,79,mage,arcane,11,1,10
17354,Vinlimar,drakthul,64,mage,arcane,4,1,3
17355,Stümpy,ravencrest,64,mage,arcane,5,1,4
17356,Thegoodoctor,kazzak,2186,mage,fire,268,142,126
17357,Hatsu,kazzak,2138,mage,fire,90,47,43
17358,Файрус,soulflayer,2133,mage,fire,104,58,46
17359,Håtsu,ravencrest,2123,mage,fire,143,73,70
17360,Slôw,kazzak,2119,mage,fire,65,42,23
17361,Jíncks,draenor,2104,mage,fire,71,41,30
17362,Диссоциация,greymane,2093,mage,fire,83,49,34
17363,Gelußaßa,ravencrest,2076,mage,fire,77,42,35
17364,Шипми,gordunni,2041,mage,fire,132,72,60
17365,Dazz,ravencrest,2033,mage,fire,210,109,101
17366,Ráìkù,ravencrest,2021,mage,fire,60,32,28
17367,Яшабурстх,blackscar,1986,mage,fire,119,63,56
17368,Urkela,sylvanas,1980,mage,fire,138,79,59
17369,Реордиан,gordunni,1975,mage,fire,86,38,48
17370,Twizzkek,silvermoon,1945,mage,fire,142,67,75
17371,Tommy,laughing-skull,1928,mage,fire,60,34,26
17372,Rizzlybear,outland,1918,mage,fire,75,35,40
17373,Laynerz,kazzak,1917,mage,fire,27,21,6
17374,Ygø,hyjal,1911,mage,fire,228,115,113
17375,Рофкастер,gordunni,1910,mage,fire,154,73,81
17376,Milkenjoyer,ravencrest,1906,mage,fire,47,30,17
17377,Síckmode,khadgar,1903,mage,fire,96,57,39
17378,Mssilvy,sylvanas,1901,mage,fire,216,118,98
17379,Барсуктри,deathguard,1899,mage,fire,60,35,25
17380,Прауз,soulflayer,1899,mage,fire,79,42,37
17381,Isenhour,frostmane,1885,mage,fire,222,115,107
17382,Uknowhowwedu,aegwynn,1879,mage,fire,36,20,16
17383,Altraftw,archimonde,1871,mage,fire,77,52,25
17384,Smlx,outland,1868,mage,fire,78,42,36
17385,Cornfloax,ravencrest,1866,mage,fire,54,33,21
17386,Nilitar,kazzak,1865,mage,fire,54,31,23
17387,Uniquenoodle,alakir,1857,mage,fire,72,34,38
17388,Excuséme,ravencrest,1851,mage,fire,51,27,24
17389,Frøstqt,ravencrest,1851,mage,fire,65,30,35
17390,Dardie,ravencrest,1849,mage,fire,48,30,18
17391,Hazewrld,ravencrest,1848,mage,fire,132,62,70
17392,Lotharie,aegwynn,1847,mage,fire,36,23,13
17393,Tiáno,drakthul,1845,mage,fire,72,36,36
17394,Spelltastíc,blackmoore,1844,mage,fire,54,34,20
17395,Belled,silvermoon,1836,mage,fire,95,64,31
17396,Wàneís,ravencrest,1831,mage,fire,40,25,15
17397,Archíques,kazzak,1831,mage,fire,46,24,22
17398,Zzpf,silvermoon,1831,mage,fire,72,37,35
17399,Wizzárd,ravencrest,1830,mage,fire,48,23,25
17400,Cörnflekz,stormscale,1829,mage,fire,50,30,20
17401,Твейзи,blackscar,1823,mage,fire,40,24,16
17402,Evohz,stormscale,1822,mage,fire,66,33,33
17403,Nøw,kazzak,1816,mage,fire,48,29,19
17404,Hiryú,kazzak,1815,mage,fire,30,20,10
17405,Elmaestró,aegwynn,1815,mage,fire,48,30,18
17406,Bigkent,stormscale,1814,mage,fire,62,27,35
17407,Djflashz,archimonde,1813,mage,fire,52,27,25
17408,Fuego,sylvanas,1811,mage,fire,163,89,74
17409,Jirt,stormscale,1809,mage,fire,59,35,24
17410,Cienaños,outland,1807,mage,fire,102,59,43
17411,Divey,draenor,1805,mage,fire,304,166,138
17412,Spelltastìc,blackmoore,1795,mage,fire,48,27,21
17413,Medivqt,ragnaros,1792,mage,fire,42,33,9
17414,Акиххабара,gordunni,1786,mage,fire,42,31,11
17415,Goomba,tarren-mill,1786,mage,fire,71,29,42
17416,Dxdxdxdxdx,drakthul,1783,mage,fire,60,35,25
17417,Hey,khazgoroth,1783,mage,fire,77,44,33
17418,Ввнд,galakrond,1782,mage,fire,36,21,15
17419,Nøw,ravencrest,1779,mage,fire,69,35,34
17420,Reyown,archimonde,1777,mage,fire,54,40,14
17421,Ширм,blackscar,1774,mage,fire,42,22,20
17422,Ðevlqt,blackmoore,1771,mage,fire,48,30,18
17423,Nihilvm,dalaran,1767,mage,fire,58,28,30
17424,Wenant,ravencrest,1765,mage,fire,66,32,34
17425,Sanjoop,tarren-mill,1756,mage,fire,48,25,23
17426,Choll,stormscale,1754,mage,fire,90,47,43
17427,Arcticfury,ravencrest,1753,mage,fire,36,22,14
17428,Hooksclay,archimonde,1753,mage,fire,60,33,27
17429,Ókamí,ravencrest,1752,mage,fire,133,67,66
17430,Magnobi,sanguino,1750,mage,fire,36,23,13
17431,Frozentwink,kul-tiras,1749,mage,fire,58,29,29
17432,Saiyangodx,twisting-nether,1744,mage,fire,72,37,35
17433,Dizzy,ahnqiraj,1743,mage,fire,131,61,70
17434,Titarie,ravencrest,1742,mage,fire,42,22,20
17435,Magão,frostmane,1738,mage,fire,72,41,31
17436,Гекомория,fordragon,1736,mage,fire,65,26,39
17437,Авгурей,howling-fjord,1735,mage,fire,130,65,65
17438,Nocturnes,sylvanas,1734,mage,fire,67,28,39
17439,Достижений,soulflayer,1733,mage,fire,66,30,36
17440,Asterixus,sylvanas,1728,mage,fire,72,44,28
17441,Cesi,silvermoon,1728,mage,fire,60,26,34
17442,Libre,stormscale,1723,mage,fire,225,119,106
17443,Obbcontrol,ravencrest,1723,mage,fire,162,85,77
17444,Siérra,outland,1708,mage,fire,119,70,49
17445,Rekzaop,ravencrest,1700,mage,fire,28,19,9
17446,Magethings,kazzak,1700,mage,fire,120,66,54
17447,Underscore,outland,1698,mage,fire,73,38,35
17448,Skrex,blackrock,1694,mage,fire,323,171,152
17449,Isildurone,ragnaros,1693,mage,fire,50,28,22
17450,Auchenax,argent-dawn,1686,mage,fire,40,25,15
17451,Jumpfanqt,stormscale,1685,mage,fire,30,23,7
17452,Naps,argent-dawn,1685,mage,fire,104,61,43
17453,Nùts,archimonde,1681,mage,fire,66,30,36
17454,Вовзон,howling-fjord,1677,mage,fire,71,39,32
17455,Aryasa,silvermoon,1676,mage,fire,30,18,12
17456,Фоулли,howling-fjord,1675,mage,fire,48,24,24
17457,Macheat,kazzak,1668,mage,fire,78,42,36
17458,Sheepmeepbip,ravencrest,1664,mage,fire,112,52,60
17459,Аквамэрис,gordunni,1658,mage,fire,36,21,15
17460,Pisini,tarren-mill,1656,mage,fire,48,22,26
17461,Gaárá,stormscale,1655,mage,fire,300,153,147
17462,Møøk,magtheridon,1654,mage,fire,30,19,11
17463,Skylezy,blackrock,1654,mage,fire,35,18,17
17464,Defrozen,twisting-nether,1653,mage,fire,54,31,23
17465,Гнилоглазка,howling-fjord,1651,mage,fire,119,68,51
17466,Consquens,aszune,1648,mage,fire,42,25,17
17467,Symera,dun-modr,1646,mage,fire,48,28,20
17468,Quentin,grim-batol,1646,mage,fire,80,42,38
17469,Elldiamage,draenor,1639,mage,fire,41,23,18
17470,Magenerfed,archimonde,1637,mage,fire,42,21,21
17471,Lemaroxd,draenor,1633,mage,fire,39,22,17
17472,Fuhrem,blackrock,1630,mage,fire,36,23,13
17473,Ayken,burning-legion,1628,mage,fire,42,26,16
17474,Råståfåri,uldum,1627,mage,fire,87,47,40
17475,Ênizt,archimonde,1626,mage,fire,58,34,24
17476,Roxxis,kazzak,1625,mage,fire,30,17,13
17477,Radiantfury,outland,1623,mage,fire,88,41,47
17478,Âcryz,blackrock,1622,mage,fire,59,27,32
17479,Игрдлпдров,gordunni,1621,mage,fire,163,91,72
17480,Oseri,defias-brotherhood,1621,mage,fire,42,20,22
17481,Evovar,silvermoon,1621,mage,fire,40,18,22
17482,Witak,ysondre,1620,mage,fire,130,65,65
17483,Aimaniac,stormscale,1618,mage,fire,199,112,87
17484,Lilblinks,silvermoon,1616,mage,fire,126,67,59
17485,Itrius,tarren-mill,1616,mage,fire,71,33,38
17486,Hólmess,silvermoon,1609,mage,fire,97,46,51
17487,Enandia,darksorrow,1608,mage,fire,92,48,44
17488,Pyrobomb,sylvanas,1608,mage,fire,66,33,33
17489,Insaneex,aegwynn,1607,mage,fire,36,20,16
17490,Whats,korgall,1602,mage,fire,112,61,51
17491,Triplesevenx,silvermoon,1602,mage,fire,180,96,84
17492,Dantiqa,ravencrest,1602,mage,fire,370,188,182
17493,Айслэнц,howling-fjord,1602,mage,fire,42,21,21
17494,Wheí,ravencrest,1601,mage,fire,30,17,13
17495,Twoeightybpm,draenor,1601,mage,fire,40,22,18
17496,Htwhy,kazzak,1601,mage,fire,165,85,80
17497,Zimbabweborc,burning-legion,1600,mage,fire,36,25,11
17498,Doonii,ragnaros,1596,mage,fire,47,20,27
17499,Миднаит,gordunni,1588,mage,fire,54,33,21
17500,Säroumäne,archimonde,1584,mage,fire,49,25,24
17501,Texmexguden,tarren-mill,1583,mage,fire,60,31,29
17502,Shahnoza,thrall,1580,mage,fire,30,17,13
17503,Czd,outland,1580,mage,fire,83,31,52
17504,Мосгормаг,gordunni,1579,mage,fire,35,21,14
17505,Wenndrid,draenor,1579,mage,fire,206,115,91
17506,Firedeáth,kazzak,1577,mage,fire,76,42,34
17507,Tomia,burning-legion,1576,mage,fire,66,36,30
17508,Zíru,outland,1572,mage,fire,63,32,31
17509,Stoychav,outland,1572,mage,fire,96,48,48
17510,Vulcanô,sanguino,1561,mage,fire,72,33,39
17511,Двинск,soulflayer,1558,mage,fire,66,28,38
17512,Калихор,gordunni,1557,mage,fire,36,21,15
17513,Hardtimes,blackhand,1556,mage,fire,74,38,36
17514,Колдрагос,gordunni,1553,mage,fire,80,41,39
17515,Пыроженное,deathguard,1553,mage,fire,36,17,19
17516,Whócárés,dragonmaw,1546,mage,fire,30,17,13
17517,Terlon,ragnaros,1544,mage,fire,90,50,40
17518,Babidi,nemesis,1544,mage,fire,42,23,19
17519,Kjh,twisting-nether,1540,mage,fire,26,17,9
17520,Utarii,deathwing,1538,mage,fire,66,35,31
17521,Gagaj,ravencrest,1534,mage,fire,42,20,22
17522,Твейдей,blackscar,1533,mage,fire,30,16,14
17523,Calientay,ragnaros,1533,mage,fire,54,27,27
17524,Бингчилинг,howling-fjord,1532,mage,fire,42,21,21
17525,Camiina,shattered-hand,1526,mage,fire,143,76,67
17526,Prácticemàge,archimonde,1524,mage,fire,24,16,8
17527,Cheerió,aggramar,1523,mage,fire,209,108,101
17528,Аквамелис,gordunni,1522,mage,fire,84,36,48
17529,Mëgu,silvermoon,1520,mage,fire,373,197,176
17530,Тачитачи,gordunni,1518,mage,fire,47,28,19
17531,Hexmath,tarren-mill,1518,mage,fire,53,30,23
17532,Aronnax,ravencrest,1518,mage,fire,46,21,25
17533,Flypz,stormscale,1516,mage,fire,54,35,19
17534,Hil,blackrock,1516,mage,fire,30,19,11
17535,Экзорсус,goldrinn,1513,mage,fire,154,77,77
17536,Эстерленс,gordunni,1507,mage,fire,70,44,26
17537,Emoden,silvermoon,1506,mage,fire,36,17,19
17538,Petar,tarren-mill,1490,mage,fire,127,62,65
17539,Аластормаг,deathweaver,1488,mage,fire,123,64,59
17540,Aikamie,draenor,1480,mage,fire,93,49,44
17541,Insanewizard,kazzak,1480,mage,fire,59,30,29
17542,Thughunterqt,silvermoon,1474,mage,fire,177,89,88
17543,Ghalanz,ravencrest,1474,mage,fire,141,70,71
17544,Мозифорест,gordunni,1474,mage,fire,78,37,41
17545,Mikefires,blackrock,1473,mage,fire,34,21,13
17546,Robowhoore,silvermoon,1469,mage,fire,42,24,18
17547,Soxlol,sylvanas,1463,mage,fire,29,16,13
17548,Einsmagus,blackrock,1460,mage,fire,30,16,14
17549,Kickyaa,twisting-nether,1460,mage,fire,43,22,21
17550,Caesarclown,silvermoon,1457,mage,fire,216,121,95
17551,Anthrex,drakthul,1456,mage,fire,66,27,39
17552,Imtrynasheep,kazzak,1455,mage,fire,30,18,12
17553,Razrkh,ragnaros,1448,mage,fire,72,39,33
17554,Eddiee,outland,1444,mage,fire,30,17,13
17555,Carinuz,blackmoore,1444,mage,fire,67,29,38
17556,Дрраго,greymane,1443,mage,fire,125,64,61
17557,Tûttifrutti,ravencrest,1442,mage,fire,84,41,43
17558,Secretagent,aegwynn,1439,mage,fire,66,37,29
17559,Mäalaka,archimonde,1439,mage,fire,54,29,25
17560,Intz,twisting-nether,1438,mage,fire,57,24,33
17561,Zazatorica,tarren-mill,1433,mage,fire,120,64,56
17562,Barbeuqx,garona,1432,mage,fire,47,24,23
17563,Mieria,argent-dawn,1432,mage,fire,48,24,24
17564,Kappotjeplif,ravencrest,1431,mage,fire,120,64,56
17565,Yshax,malganis,1430,mage,fire,85,35,50
17566,Gnomag,argent-dawn,1429,mage,fire,113,56,57
17567,Lokilus,dalaran,1428,mage,fire,72,40,32
17568,Neird,sinstralis,1428,mage,fire,72,38,34
17569,Plætinum,ravencrest,1427,mage,fire,110,55,55
17570,Fireblood,runetotem,1426,mage,fire,36,15,21
17571,Baxeraa,draenor,1425,mage,fire,73,41,32
17572,Shizzy,onyxia,1423,mage,fire,57,30,27
17573,Bònk,sylvanas,1423,mage,fire,36,17,19
17574,Chucknoir,draenor,1420,mage,fire,30,16,14
17575,Rayniß,blackmoore,1419,mage,fire,72,34,38
17576,Yatsune,defias-brotherhood,1418,mage,fire,48,33,15
17577,Смилер,gordunni,1416,mage,fire,36,18,18
17578,Morphis,talnivarr,1414,mage,fire,30,16,14
17579,Pluggis,the-maelstrom,1409,mage,fire,30,15,15
17580,Rockyballboa,silvermoon,1403,mage,fire,44,24,20
17581,Kyrn,zuljin,1403,mage,fire,63,32,31
17582,Mejtschazor,twisting-nether,1400,mage,fire,29,16,13
17583,Zéngã,kazzak,1399,mage,fire,61,31,30
17584,Abêj,malygos,1393,mage,fire,32,16,16
17585,Apócalyptic,tarren-mill,1393,mage,fire,147,73,74
17586,Liendri,aegwynn,1392,mage,fire,36,17,19
17587,Ледянойкекс,gordunni,1390,mage,fire,52,26,26
17588,Fortian,boulderfist,1384,mage,fire,24,15,9
17589,Akâri,silvermoon,1380,mage,fire,30,15,15
17590,Calegos,twisting-nether,1378,mage,fire,48,25,23
17591,Линклер,fordragon,1374,mage,fire,24,15,9
17592,Noviina,argent-dawn,1372,mage,fire,56,30,26
17593,Frøzzen,blackrock,1370,mage,fire,29,15,14
17594,Mons,the-venture-co,1369,mage,fire,136,66,70
17595,Atixx,aegwynn,1369,mage,fire,48,20,28
17596,Glïder,archimonde,1366,mage,fire,47,22,25
17597,Spellsteal,antonidas,1366,mage,fire,126,54,72
17598,Elesios,blackmoore,1365,mage,fire,78,34,44
17599,Zensheep,silvermoon,1364,mage,fire,30,15,15
17600,Rilac,nordrassil,1364,mage,fire,48,22,26
17601,Töframaður,draenor,1362,mage,fire,78,43,35
17602,Sadrã,kazzak,1362,mage,fire,48,20,28
17603,Maguscarlsen,ravencrest,1355,mage,fire,30,16,14
17604,Frostytutes,ragnaros,1351,mage,fire,120,62,58
17605,Tiltedpapi,ravencrest,1348,mage,fire,47,20,27
17606,Immortanjoe,thrall,1345,mage,fire,84,44,40
17607,Bobbasor,defias-brotherhood,1345,mage,fire,68,33,35
17608,Шуткам,gordunni,1343,mage,fire,18,14,4
17609,Freeyourmind,kazzak,1341,mage,fire,50,23,27
17610,Zestrax,kazzak,1339,mage,fire,42,29,13
17611,Feuererdnuss,blackhand,1338,mage,fire,42,24,18
17612,Нереварин,soulflayer,1338,mage,fire,27,15,12
17613,Estelliên,burning-legion,1338,mage,fire,36,15,21
17614,Stylaaz,twisting-nether,1337,mage,fire,59,31,28
17615,Reqwyz,ragnaros,1337,mage,fire,32,16,16
17616,Fenrirson,drakthul,1336,mage,fire,144,77,67
17617,Rictue,silvermoon,1335,mage,fire,43,24,19
17618,Sylvîe,tarren-mill,1335,mage,fire,65,31,34
17619,Magmarro,burning-legion,1334,mage,fire,107,54,53
17620,Steveishigh,tarren-mill,1332,mage,fire,25,14,11
17621,Jessaniel,chogall,1330,mage,fire,24,14,10
17622,Climatrix,twisting-nether,1328,mage,fire,18,14,4
17623,Sukalamink,alonsus,1328,mage,fire,42,22,20
17624,Wwjd,darksorrow,1326,mage,fire,25,15,10
17625,Rewq,twisting-nether,1326,mage,fire,24,14,10
17626,Jaídy,aegwynn,1326,mage,fire,52,25,27
17627,Wankel,blackmoore,1325,mage,fire,60,28,32
17628,Magicalmig,draenor,1323,mage,fire,126,75,51
17629,Manvo,bloodscalp,1323,mage,fire,126,65,61
17630,Darríck,argent-dawn,1323,mage,fire,41,16,25
17631,Рифтиг,howling-fjord,1322,mage,fire,95,43,52
17632,Momomagic,silvermoon,1318,mage,fire,64,31,33
17633,Wizmec,silvermoon,1317,mage,fire,171,83,88
17634,Cinoox,blackrock,1316,mage,fire,84,46,38
17635,Versachi,neptulon,1315,mage,fire,30,15,15
17636,Sonofdragon,frostwolf,1314,mage,fire,36,19,17
17637,Quiwi,dun-modr,1313,mage,fire,45,30,15
17638,Darkice,sanguino,1308,mage,fire,48,22,26
17639,Skarxaa,sanguino,1307,mage,fire,80,36,44
17640,Exitelol,blackrock,1305,mage,fire,24,14,10
17641,Aulny,kaelthas,1304,mage,fire,70,30,40
17642,Fiveboyjr,tarren-mill,1302,mage,fire,54,29,25
17643,Быкуня,gordunni,1298,mage,fire,60,33,27
17644,Pumped,haomarush,1298,mage,fire,29,14,15
17645,Bloodycast,archimonde,1298,mage,fire,52,19,33
17646,Nohbrain,blackmoore,1297,mage,fire,75,36,39
17647,Ziscine,tarren-mill,1297,mage,fire,51,23,28
17648,Greey,blackhand,1293,mage,fire,38,21,17
17649,Fingolfin,amanthul,1293,mage,fire,316,152,164
17650,Аваон,deathguard,1289,mage,fire,136,67,69
17651,Дэлос,gordunni,1288,mage,fire,23,14,9
17652,Hahahehe,aegwynn,1288,mage,fire,45,24,21
17653,Magicuze,argent-dawn,1287,mage,fire,60,25,35
17654,Bclaudiu,terokkar,1285,mage,fire,50,22,28
17655,Maggresive,sylvanas,1284,mage,fire,36,16,20
17656,Деозар,eversong,1272,mage,fire,216,103,113
17657,Нетлель,soulflayer,1270,mage,fire,36,16,20
17658,Ihatemages,stormreaver,1270,mage,fire,66,27,39
17659,Mauvé,blades-edge,1266,mage,fire,65,33,32
17660,Cyrîll,malygos,1263,mage,fire,133,75,58
17661,Kuríbo,gorgonnash,1262,mage,fire,33,19,14
17662,Varenca,blackrock,1256,mage,fire,75,35,40
17663,Фрозитв,blackscar,1247,mage,fire,18,13,5
17664,Yanir,die-arguswacht,1245,mage,fire,24,13,11
17665,Larmp,outland,1245,mage,fire,24,13,11
17666,Haxyo,twisting-nether,1244,mage,fire,18,13,5
17667,Johnnydeepp,archimonde,1244,mage,fire,18,13,5
17668,Kurtcobain,draenor,1242,mage,fire,18,13,5
17669,Romethito,dun-modr,1240,mage,fire,42,27,15
17670,Zivac,kazzak,1240,mage,fire,24,13,11
17671,Sekulicgoga,draenor,1235,mage,fire,24,17,7
17672,Grandbasile,hyjal,1235,mage,fire,42,13,29
17673,Pandathis,frostwolf,1233,mage,fire,18,13,5
17674,Elcølgaø,sanguino,1233,mage,fire,30,13,17
17675,Вселениум,razuvious,1232,mage,fire,63,32,31
17676,Tokerlol,stormscale,1231,mage,fire,27,13,14
17677,Faunas,kazzak,1230,mage,fire,46,27,19
17678,Warwizz,sanguino,1226,mage,fire,24,13,11
17679,Silatara,twisting-nether,1223,mage,fire,24,13,11
17680,Ryzea,ravencrest,1223,mage,fire,53,23,30
17681,Pewwpewwpeww,doomhammer,1221,mage,fire,83,37,46
17682,Ràyden,khaz-modan,1219,mage,fire,36,18,18
17683,Durdi,silvermoon,1217,mage,fire,30,17,13
17684,Røvso,ragnaros,1216,mage,fire,36,13,23
17685,Searchy,blackhand,1213,mage,fire,152,79,73
17686,Critzeklein,antonidas,1213,mage,fire,60,24,36
17687,Nuvx,ravencrest,1212,mage,fire,72,39,33
17688,Dobbite,archimonde,1207,mage,fire,48,31,17
17689,Джеззабэль,ashenvale,1204,mage,fire,24,15,9
17690,Айсбоунт,eversong,1203,mage,fire,51,20,31
17691,Wîtchcurse,dentarg,1197,mage,fire,36,15,21
17692,Anshara,stormscale,1193,mage,fire,66,39,27
17693,Bonto,tarren-mill,1182,mage,fire,52,23,29
17694,Athenå,dalaran,1176,mage,fire,48,21,27
17695,Blitzo,madmortem,1174,mage,fire,53,29,24
17696,Critr,sylvanas,1167,mage,fire,134,68,66
17697,Darkoftw,ysondre,1166,mage,fire,25,13,12
17698,Dóncójones,blackrock,1166,mage,fire,95,42,53
17699,Gerdâ,chants-éternels,1154,mage,fire,72,38,34
17700,Drunkpunk,kazzak,1152,mage,fire,60,35,25
17701,Moojob,kazzak,1151,mage,fire,24,12,12
17702,Kaki,stormscale,1150,mage,fire,36,19,17
17703,Córgi,ravencrest,1149,mage,fire,24,12,12
17704,Azulêera,archimonde,1149,mage,fire,24,12,12
17705,Wizarð,archimonde,1149,mage,fire,29,13,16
17706,Самза,howling-fjord,1145,mage,fire,48,27,21
17707,Slashkiiss,archimonde,1145,mage,fire,77,39,38
17708,Demensida,ravencrest,1145,mage,fire,28,13,15
17709,Büyübaba,twisting-nether,1145,mage,fire,30,12,18
17710,Avakadaver,draenor,1143,mage,fire,24,12,12
17711,Revanov,outland,1142,mage,fire,18,12,6
17712,Themagicguy,silvermoon,1140,mage,fire,24,12,12
17713,Skitsó,shadowsong,1139,mage,fire,48,29,19
17714,Fäust,drakthul,1136,mage,fire,52,16,36
17715,Isiah,kaelthas,1132,mage,fire,62,27,35
17716,Мерджреквест,howling-fjord,1128,mage,fire,24,12,12
17717,Асидочка,soulflayer,1118,mage,fire,86,41,45
17718,Lybazinga,frostmane,1118,mage,fire,37,16,21
17719,Дмблдр,soulflayer,1116,mage,fire,33,14,19
17720,Blasic,stormscale,1105,mage,fire,30,12,18
17721,Rapidfrost,drakthul,1104,mage,fire,34,21,13
17722,Worstlove,blackrock,1099,mage,fire,44,23,21
17723,Nezousta,sinstralis,1094,mage,fire,24,12,12
17724,Скиллао,gordunni,1086,mage,fire,29,13,16
17725,Fritmckhaine,archimonde,1084,mage,fire,66,35,31
17726,Leontus,outland,1072,mage,fire,18,12,6
17727,Gorleg,draenor,1072,mage,fire,47,17,30
17728,Бабайбайкала,gordunni,1071,mage,fire,29,12,17
17729,Newtwo,ravencrest,1070,mage,fire,25,12,13
17730,Wushii,aggra-português,1060,mage,fire,25,12,13
17731,Shadowmag,burning-legion,1058,mage,fire,48,19,29
17732,Ilikesheep,blackmoore,1056,mage,fire,18,11,7
17733,Uknowhowwedu,blackrock,1056,mage,fire,24,11,13
17734,Mowns,ravencrest,1056,mage,fire,24,11,13
17735,Sleepingfate,stormscale,1055,mage,fire,18,11,7
17736,Mohammedjiba,ragnaros,1055,mage,fire,18,11,7
17737,Sérum,drakthul,1055,mage,fire,18,11,7
17738,Covran,stormscale,1055,mage,fire,24,11,13
17739,Anisovsky,archimonde,1055,mage,fire,24,11,13
17740,Мизерун,deathguard,1053,mage,fire,79,33,46
17741,Laetitiah,archimonde,1042,mage,fire,26,11,15
17742,Mikaelà,blackmoore,1040,mage,fire,18,11,7
17743,Larah,les-clairvoyants,1038,mage,fire,18,11,7
17744,Rèsí,dun-morogh,1037,mage,fire,30,12,18
17745,Dyx,nemesis,1036,mage,fire,89,42,47
17746,Vantimere,twisting-nether,1036,mage,fire,30,11,19
17747,Rmforever,archimonde,1029,mage,fire,42,21,21
17748,Pablø,blackrock,1024,mage,fire,34,17,17
17749,Icx,tarren-mill,1021,mage,fire,108,56,52
17750,Freezeballs,blackmoore,1017,mage,fire,37,12,25
17751,Хээйлии,goldrinn,1001,mage,fire,30,15,15
17752,Devilpain,zuluhed,1001,mage,fire,24,11,13
17753,Комонщик,howling-fjord,993,mage,fire,30,11,19
17754,Netrinkuet,outland,991,mage,fire,17,11,6
17755,Зубарол,gordunni,984,mage,fire,49,24,25
17756,Plazem,argent-dawn,971,mage,fire,54,20,34
17757,Sukmikok,twisting-nether,960,mage,fire,12,10,2
17758,Фюртэ,howling-fjord,960,mage,fire,12,10,2
17759,Plexyoo,thrall,960,mage,fire,24,10,14
17760,Drè,daggerspine,959,mage,fire,18,10,8
17761,Витуз,gordunni,959,mage,fire,18,10,8
17762,Gandelfmaly,burning-legion,959,mage,fire,18,10,8
17763,Pepsimaxlord,silvermoon,959,mage,fire,18,10,8
17764,Magijoana,silvermoon,959,mage,fire,36,10,26
17765,Ахиригиз,gordunni,958,mage,fire,18,10,8
17766,Rambau,archimonde,958,mage,fire,18,10,8
17767,Charizard,emerald-dream,956,mage,fire,15,11,4
17768,Arcann,ravencrest,956,mage,fire,18,10,8
17769,Shìnra,ravencrest,955,mage,fire,24,10,14
17770,Gàtsby,outland,955,mage,fire,24,10,14
17771,Arandartis,kazzak,954,mage,fire,18,10,8
17772,Tóadette,die-aldor,953,mage,fire,28,11,17
17773,Firen,thrall,952,mage,fire,24,13,11
17774,Çana,thrall,952,mage,fire,30,10,20
17775,Shealá,blackhand,951,mage,fire,24,10,14
17776,Mohrgan,malorne,950,mage,fire,24,10,14
17777,Firewitch,blackhand,950,mage,fire,24,10,14
17778,Cräzÿfrøst,archimonde,949,mage,fire,24,10,14
17779,Khalkazzar,darkspear,943,mage,fire,30,10,20
17780,Santoz,blackrock,938,mage,fire,100,52,48
17781,Кельтаз,soulflayer,932,mage,fire,30,15,15
17782,Häddës,archimonde,925,mage,fire,24,14,10
17783,Pyro,daggerspine,924,mage,fire,60,32,28
17784,Freezandrun,tarren-mill,918,mage,fire,47,21,26
17785,Netherstorm,chogall,896,mage,fire,66,30,36
17786,Nåzmyz,outland,891,mage,fire,23,10,13
17787,Plessx,sylvanas,888,mage,fire,21,11,10
17788,Texhex,ahnqiraj,877,mage,fire,36,10,26
17789,Warpx,aegwynn,872,mage,fire,24,10,14
17790,Sagregas,silvermoon,866,mage,fire,83,36,47
17791,Dyen,hyjal,864,mage,fire,12,9,3
17792,Magerocks,ragnaros,864,mage,fire,12,9,3
17793,Grumpié,ravencrest,864,mage,fire,12,9,3
17794,Turbomedusa,draenor,864,mage,fire,12,9,3
17795,Lisanalgaib,kilrogg,864,mage,fire,18,9,9
17796,Spacehoe,stormscale,864,mage,fire,18,9,9
17797,Magiwan,silvermoon,864,mage,fire,24,9,15
17798,Tagrine,kaelthas,863,mage,fire,12,9,3
17799,Smíte,kazzak,863,mage,fire,12,9,3
17800,Diffa,tarren-mill,863,mage,fire,18,9,9
17801,Sakuranosuke,twisting-nether,863,mage,fire,18,9,9
17802,Vixis,dalaran,863,mage,fire,18,9,9
17803,Satyrnaar,tarren-mill,863,mage,fire,18,9,9
17804,Rhodghar,ravencrest,862,mage,fire,18,9,9
17805,Weedup,zuljin,862,mage,fire,18,9,9
17806,Poporciné,archimonde,862,mage,fire,18,9,9
17807,Интровертка,blackscar,862,mage,fire,22,10,12
17808,Феновар,goldrinn,862,mage,fire,24,9,15
17809,Hokuspokicus,ravencrest,862,mage,fire,24,9,15
17810,Abocajarro,dun-modr,861,mage,fire,18,9,9
17811,Backped,kazzak,860,mage,fire,34,10,24
17812,Чоуза,gordunni,858,mage,fire,24,9,15
17813,Pwntt,terenas,858,mage,fire,24,9,15
17814,Mirobol,hyjal,856,mage,fire,24,9,15
17815,Spader,argent-dawn,851,mage,fire,18,9,9
17816,Bigbazzabean,silvermoon,849,mage,fire,42,17,25
17817,Sippebób,laughing-skull,830,mage,fire,16,10,6
17818,Nagano,deathwing,827,mage,fire,23,9,14
17819,Abruaa,tarren-mill,799,mage,fire,11,9,2
17820,Wëylin,chogall,797,mage,fire,16,9,7
17821,Løxyy,ysondre,793,mage,fire,36,12,24
17822,Aurelius,kargath,783,mage,fire,13,9,4
17823,Takayaki,terokkar,783,mage,fire,19,9,10
17824,Занерзулаа,soulflayer,782,mage,fire,23,9,14
17825,Sèrum,drakthul,777,mage,fire,23,10,13
17826,Matsuratkø,nemesis,768,mage,fire,12,8,4
17827,Apollohouse,ravencrest,768,mage,fire,12,8,4
17828,Nilitarrgh,outland,768,mage,fire,12,8,4
17829,Mlodysimba,burning-legion,768,mage,fire,12,8,4
17830,Funkyfriday,twisting-nether,768,mage,fire,12,8,4
17831,Yésdávé,stormscale,768,mage,fire,12,8,4
17832,Stockfísh,ravencrest,768,mage,fire,12,8,4
17833,Spellonfire,ravencrest,768,mage,fire,12,8,4
17834,Marøjuniõr,draenor,768,mage,fire,12,8,4
17835,Lestrangé,azjolnerub,768,mage,fire,12,8,4
17836,Sölø,stormscale,768,mage,fire,12,8,4
17837,Dcolon,tarren-mill,768,mage,fire,12,8,4
17838,Nuj,blackrock,768,mage,fire,12,8,4
17839,Harrisøn,dun-modr,768,mage,fire,12,8,4
17840,Stümpy,ravencrest,768,mage,fire,12,8,4
17841,Seshlad,stormscale,768,mage,fire,12,8,4
17842,Fakeklepter,sylvanas,768,mage,fire,12,8,4
17843,Zelimeth,outland,768,mage,fire,18,8,10
17844,Octtmiss,twisting-nether,768,mage,fire,18,8,10
17845,Незерёб,soulflayer,768,mage,fire,18,8,10
17846,Zoot,ravencrest,768,mage,fire,24,8,16
17847,Airo,drakthul,768,mage,fire,24,8,16
17848,Mðj,kazzak,768,mage,fire,24,8,16
17849,Azakadabra,ysondre,767,mage,fire,12,8,4
17850,Benjibop,ravencrest,767,mage,fire,12,8,4
17851,Neférú,thrall,767,mage,fire,12,8,4
17852,Kbd,outland,767,mage,fire,18,8,10
17853,Testzerodeux,archimonde,767,mage,fire,18,8,10
17854,Alyraza,chamber-of-aspects,767,mage,fire,18,8,10
17855,Эммилиарда,gordunni,767,mage,fire,18,8,10
17856,Алаурс,howling-fjord,767,mage,fire,18,8,10
17857,Dynamica,ravencrest,767,mage,fire,18,8,10
17858,Elreas,blackmoore,767,mage,fire,18,8,10
17859,Dauwen,silvermoon,767,mage,fire,18,8,10
17860,Codeincassie,blackhand,767,mage,fire,18,8,10
17861,Магмагистр,blackscar,767,mage,fire,24,8,16
17862,Takiix,antonidas,766,mage,fire,12,8,4
17863,Solarian,nemesis,764,mage,fire,18,8,10
17864,Estwald,arathor,763,mage,fire,18,8,10
17865,Iamslow,sylvanas,762,mage,fire,12,8,4
17866,Linyah,arathor,762,mage,fire,18,8,10
17867,Вельдрик,soulflayer,762,mage,fire,24,8,16
17868,Majinbo,doomhammer,760,mage,fire,18,8,10
17869,Arcadua,sanguino,758,mage,fire,12,8,4
17870,Veveroiu,defias-brotherhood,752,mage,fire,24,9,15
17871,Mimicassa,defias-brotherhood,751,mage,fire,26,14,12
17872,Фиеран,grom,747,mage,fire,26,10,16
17873,Rasputina,blackrock,744,mage,fire,35,12,23
17874,Kalyypso,arygos,735,mage,fire,16,9,7
17875,Magicspark,madmortem,735,mage,fire,77,35,42
17876,Mitchmage,ravencrest,732,mage,fire,17,8,9
17877,Tragíc,blackmoore,719,mage,fire,17,8,9
17878,Lanadorei,stormscale,711,mage,fire,21,8,13
17879,Тудысюдым,eversong,684,mage,fire,19,8,11
17880,Pàntera,blackmoore,683,mage,fire,31,8,23
17881,Gnðmeonfire,sylvanas,672,mage,fire,12,7,5
17882,Исендэя,gordunni,672,mage,fire,12,7,5
17883,Draquengar,tyrande,672,mage,fire,12,7,5
17884,Randommagexd,ravencrest,672,mage,fire,12,7,5
17885,Кодимагх,gordunni,672,mage,fire,12,7,5
17886,Equálity,blackrock,672,mage,fire,12,7,5
17887,Iconic,eredar,672,mage,fire,12,7,5
17888,Greaterkick,blackrock,672,mage,fire,12,7,5
17889,Melíssa,silvermoon,672,mage,fire,12,7,5
17890,Pïeck,archimonde,672,mage,fire,12,7,5
17891,Consulalgeri,archimonde,672,mage,fire,18,7,11
17892,Анзот,howling-fjord,672,mage,fire,18,7,11
17893,Mangiafuoco,nemesis,672,mage,fire,18,7,11
17894,Anaxtra,guldan,672,mage,fire,18,7,11
17895,Akrapovic,drakthul,672,mage,fire,18,7,11
17896,Azîlko,frostwolf,671,mage,fire,12,7,5
17897,Uwutehe,ravencrest,671,mage,fire,12,7,5
17898,Wizkidcutt,tarren-mill,671,mage,fire,12,7,5
17899,Spellfaker,drakthul,671,mage,fire,12,7,5
17900,Barspin,lightnings-blade,671,mage,fire,12,7,5
17901,Zaci,argent-dawn,671,mage,fire,12,7,5
17902,Sokardes,the-maelstrom,671,mage,fire,16,8,8
17903,Karima,drekthar,671,mage,fire,16,8,8
17904,Anagramix,silvermoon,671,mage,fire,15,7,8
17905,Camelshaver,tarren-mill,671,mage,fire,18,7,11
17906,Mìsaki,hellscream,671,mage,fire,18,7,11
17907,Ustafrr,argent-dawn,670,mage,fire,13,7,6
17908,Spispi,burning-legion,670,mage,fire,21,8,13
17909,Awart,burning-legion,670,mage,fire,24,7,17
17910,Жгумпель,howling-fjord,670,mage,fire,24,7,17
17911,Vanah,the-maelstrom,669,mage,fire,12,7,5
17912,Mogettemagic,ysondre,669,mage,fire,27,8,19
17913,Kyani,mannoroth,667,mage,fire,24,7,17
17914,Kaktuzze,antonidas,664,mage,fire,18,7,11
17915,Smî,aegwynn,659,mage,fire,12,7,5
17916,Elypøde,ysondre,657,mage,fire,12,7,5
17917,Magikere,tarren-mill,639,mage,fire,17,7,10
17918,Vulcanx,stormscale,638,mage,fire,17,7,10
17919,Cleophe,burning-legion,637,mage,fire,16,8,8
17920,Luxxurious,xavius,623,mage,fire,9,7,2
17921,Bezelgeuse,pozzo-delleternità,623,mage,fire,17,7,10
17922,Qusx,malganis,607,mage,fire,11,7,4
17923,Serctheone,ravencrest,607,mage,fire,14,7,7
17924,Chrismage,argent-dawn,606,mage,fire,20,7,13
17925,Apcg,sylvanas,576,mage,fire,6,6,0
17926,Lyrath,ghostlands,576,mage,fire,6,6,0
17927,Canceled,kazzak,576,mage,fire,12,6,6
17928,Derchong,kazzak,576,mage,fire,12,6,6
17929,Macey,ravencrest,576,mage,fire,12,6,6
17930,Olzaa,outland,576,mage,fire,12,6,6
17931,Pradapimp,ravencrest,576,mage,fire,12,6,6
17932,Icepiece,tarren-mill,576,mage,fire,12,6,6
17933,Nihilum,dalaran,576,mage,fire,12,6,6
17934,Feath,ravencrest,576,mage,fire,12,6,6
17935,Skylez,blackrock,576,mage,fire,12,6,6
17936,Qwibbly,kazzak,576,mage,fire,18,6,12
17937,Nötmârtònxø,ragnaros,576,mage,fire,18,6,12
17938,Relik,sylvanas,576,mage,fire,18,6,12
17939,Ofeu,archimonde,576,mage,fire,18,6,12
17940,Wormhole,kazzak,576,mage,fire,18,6,12
17941,Zymage,silvermoon,575,mage,fire,12,6,6
17942,Arckaen,elune,575,mage,fire,12,6,6
17943,Arhi,silvermoon,575,mage,fire,12,6,6
17944,Akhali,chamber-of-aspects,575,mage,fire,12,6,6
17945,Vurtnez,kazzak,575,mage,fire,12,6,6
17946,Gavra,ravencrest,575,mage,fire,12,6,6
17947,Kitchimage,ravencrest,575,mage,fire,12,6,6
17948,Saturator,burning-legion,575,mage,fire,18,6,12
17949,Zuckerzimt,ravencrest,575,mage,fire,18,6,12
17950,Lupuus,anubarak,575,mage,fire,24,6,18
17951,Explosìve,arthas,574,mage,fire,12,6,6
17952,Zeddic,burning-legion,574,mage,fire,12,6,6
17953,Shâykó,sylvanas,573,mage,fire,12,6,6
17954,Поймайбелку,booty-bay,572,mage,fire,12,6,6
17955,Melimar,khaz-modan,572,mage,fire,12,6,6
17956,Труупоед,borean-tundra,571,mage,fire,12,6,6
17957,Laviathan,die-aldor,568,mage,fire,12,6,6
17958,Hidrax,outland,543,mage,fire,16,6,10
17959,Nâmiz,blackrock,528,mage,fire,9,6,3
17960,Мэдраша,gordunni,527,mage,fire,23,6,17
17961,Zeklo,frostmane,521,mage,fire,20,7,13
17962,Dárdie,ravencrest,512,mage,fire,10,6,4
17963,Yoku,nethersturm,480,mage,fire,6,5,1
17964,Helloimgone,blackmoore,480,mage,fire,6,5,1
17965,Jél,stormscale,480,mage,fire,6,5,1
17966,Palpfiction,silvermoon,480,mage,fire,6,5,1
17967,Magicflame,draenor,480,mage,fire,6,5,1
17968,Bzzr,tarren-mill,480,mage,fire,6,5,1
17969,Mmrlancer,blackmoore,480,mage,fire,6,5,1
17970,Рамблз,gordunni,480,mage,fire,6,5,1
17971,Ицка,fordragon,480,mage,fire,6,5,1
17972,Проблембойх,gordunni,480,mage,fire,12,5,7
17973,Røysi,ravencrest,480,mage,fire,12,5,7
17974,Schøkø,eredar,480,mage,fire,12,5,7
17975,Teeclis,twisting-nether,480,mage,fire,12,5,7
17976,Moleester,twisting-nether,480,mage,fire,12,5,7
17977,Máximus,ravencrest,480,mage,fire,12,5,7
17978,Gadeplan,sylvanas,480,mage,fire,12,5,7
17979,Firever,sanguino,480,mage,fire,12,5,7
17980,Brokenlegman,defias-brotherhood,480,mage,fire,12,5,7
17981,Sheepwithmeh,blackrock,480,mage,fire,12,5,7
17982,Gêrky,drakthul,480,mage,fire,12,5,7
17983,Arcandor,tarren-mill,480,mage,fire,12,5,7
17984,Cleancc,blackhand,480,mage,fire,12,5,7
17985,Magechonk,kazzak,480,mage,fire,12,5,7
17986,Runbabyrun,hyjal,480,mage,fire,12,5,7
17987,Shifteurprõ,hyjal,480,mage,fire,12,5,7
17988,Shíróyama,ravencrest,480,mage,fire,12,5,7
17989,Tessai,sargeras,480,mage,fire,12,5,7
17990,Dmme,dun-morogh,480,mage,fire,18,5,13
17991,Валбериса,deepholm,479,mage,fire,6,5,1
17992,Neoreactor,ravencrest,479,mage,fire,12,5,7
17993,Megancox,blackmoore,479,mage,fire,12,5,7
17994,Tratuf,hyjal,479,mage,fire,12,5,7
17995,Beardmorph,auchindoun,479,mage,fire,18,5,13
17996,Iceorb,azshara,479,mage,fire,24,5,19
17997,Oneal,the-maelstrom,478,mage,fire,12,5,7
17998,Illiaria,antonidas,478,mage,fire,18,5,13
17999,Exorifrigo,dun-modr,477,mage,fire,22,5,17
18000,Eldiablo,dun-modr,476,mage,fire,12,5,7
18001,Draenaya,forscherliga,473,mage,fire,21,6,15
18002,Nabucor,culte-de-la-rive-noire,468,mage,fire,25,6,19
18003,Mínêrvâ,blackrock,431,mage,fire,11,5,6
18004,Buuszek,outland,430,mage,fire,11,5,6
18005,Сморгонец,gordunni,412,mage,fire,14,5,9
18006,Shyasianmage,area-52,384,mage,fire,6,4,2
18007,Naween,hyjal,384,mage,fire,6,4,2
18008,Botbotamba,hyjal,384,mage,fire,6,4,2
18009,Drewna,silvermoon,384,mage,fire,6,4,2
18010,Cardioexpert,ravencrest,384,mage,fire,6,4,2
18011,Khronic,darksorrow,384,mage,fire,6,4,2
18012,Bergillos,sanguino,384,mage,fire,6,4,2
18013,Rotøk,burning-legion,384,mage,fire,6,4,2
18014,Келлазар,gordunni,384,mage,fire,6,4,2
18015,Taylorswîft,ragnaros,384,mage,fire,6,4,2
18016,Файрусх,deathguard,384,mage,fire,6,4,2
18017,Gidsor,silvermoon,384,mage,fire,6,4,2
18018,Saryotheone,silvermoon,384,mage,fire,6,4,2
18019,Kkohp,ravencrest,384,mage,fire,6,4,2
18020,Farmassist,stormscale,384,mage,fire,6,4,2
18021,Xsro,blackrock,384,mage,fire,6,4,2
18022,Fkndog,ravencrest,384,mage,fire,6,4,2
18023,Curran,ravencrest,384,mage,fire,6,4,2
18024,Pavlé,draenor,384,mage,fire,6,4,2
18025,Dubbleblast,draenor,384,mage,fire,6,4,2
18026,Blinker,frostwhisper,384,mage,fire,6,4,2
18027,Нефростмаг,gordunni,384,mage,fire,6,4,2
18028,Praison,defias-brotherhood,384,mage,fire,6,4,2
18029,Monfisback,archimonde,384,mage,fire,6,4,2
18030,Zyreanx,blackrock,384,mage,fire,6,4,2
18031,Wopi,sylvanas,384,mage,fire,6,4,2
18032,Gennésïs,darksorrow,384,mage,fire,6,4,2
18033,Katzron,twisting-nether,384,mage,fire,6,4,2
18034,Dibzz,sanguino,384,mage,fire,6,4,2
18035,Kold,stormscale,384,mage,fire,6,4,2
18036,Whìtewalker,pozzo-delleternità,384,mage,fire,6,4,2
18037,Doryy,silvermoon,384,mage,fire,6,4,2
18038,Мактай,gordunni,384,mage,fire,6,4,2
18039,Mnday,ravencrest,384,mage,fire,6,4,2
18040,Нехай,ashenvale,384,mage,fire,6,4,2
18041,Halfanapple,the-maelstrom,384,mage,fire,6,4,2
18042,Ovrpwrdxd,kazzak,384,mage,fire,6,4,2
18043,Yenneferr,magtheridon,384,mage,fire,6,4,2
18044,Гандолъер,soulflayer,384,mage,fire,6,4,2
18045,Dwang,nemesis,384,mage,fire,6,4,2
18046,Cyser,kazzak,384,mage,fire,6,4,2
18047,Waterhagx,tarren-mill,384,mage,fire,6,4,2
18048,Partypower,twisting-nether,384,mage,fire,12,4,8
18049,Rooven,aegwynn,384,mage,fire,12,4,8
18050,Feuern,antonidas,384,mage,fire,12,4,8
18051,Genviedgiclé,arathi,384,mage,fire,12,4,8
18052,Popbg,outland,384,mage,fire,12,4,8
18053,Sam,outland,384,mage,fire,12,4,8
18054,Diji,the-maelstrom,384,mage,fire,12,4,8
18055,Аркагос,gordunni,384,mage,fire,12,4,8
18056,Дантрий,gordunni,384,mage,fire,12,4,8
18057,Раканчик,gordunni,384,mage,fire,12,4,8
18058,Викликс,borean-tundra,384,mage,fire,12,4,8
18059,Kazeen,silvermoon,384,mage,fire,12,4,8
18060,Гелиадо,soulflayer,384,mage,fire,12,4,8
18061,Aarcheon,kazzak,384,mage,fire,12,4,8
18062,Деорро,gordunni,384,mage,fire,12,4,8
18063,Michellee,ravencrest,384,mage,fire,12,4,8
18064,Bhalïn,dun-modr,384,mage,fire,18,4,14
18065,Lusionator,defias-brotherhood,384,mage,fire,18,4,14
18066,Anghim,tarren-mill,383,mage,fire,6,4,2
18067,Birdlort,draenor,383,mage,fire,6,4,2
18068,Ildrøv,stormscale,383,mage,fire,12,4,8
18069,Unhedged,eredar,383,mage,fire,12,4,8
18070,Мэджиксул,grom,383,mage,fire,12,4,8
18071,Chimará,eredar,367,mage,fire,17,4,13
18072,Lusifera,outland,336,mage,fire,9,4,5
18073,Niivel,ysondre,336,mage,fire,15,4,11
18074,Blazenaa,drakthul,333,mage,fire,15,4,11
18075,Tigerblod,tarren-mill,330,mage,fire,10,5,5
18076,Мегумин,galakrond,318,mage,fire,15,4,11
18077,Kinetiq,kazzak,288,mage,fire,6,3,3
18078,Xlarb,kazzak,288,mage,fire,6,3,3
18079,Procahontas,ravencrest,288,mage,fire,6,3,3
18080,Salvadordalí,ravencrest,288,mage,fire,6,3,3
18081,Abovè,outland,288,mage,fire,6,3,3
18082,Driana,dragonmaw,288,mage,fire,6,3,3
18083,Shermî,blackrock,288,mage,fire,6,3,3
18084,Kàtsu,tarren-mill,288,mage,fire,6,3,3
18085,Sonybonanza,kazzak,288,mage,fire,6,3,3
18086,Adetin,tarren-mill,288,mage,fire,6,3,3
18087,Волшпробуда,gordunni,288,mage,fire,6,3,3
18088,Shinigamí,blackrock,288,mage,fire,6,3,3
18089,Balderk,sanguino,288,mage,fire,6,3,3
18090,Fuchso,area-52,288,mage,fire,6,3,3
18091,Zerøsílgødx,antonidas,288,mage,fire,6,3,3
18092,Pævl,drakthul,288,mage,fire,6,3,3
18093,Maveya,blackmoore,288,mage,fire,6,3,3
18094,Bamz,malganis,288,mage,fire,6,3,3
18095,Tildetbfa,antonidas,288,mage,fire,6,3,3
18096,Cryptik,blackmoore,288,mage,fire,6,3,3
18097,Dampgame,twisting-nether,288,mage,fire,6,3,3
18098,Êgôn,perenolde,288,mage,fire,6,3,3
18099,Макотшельник,gordunni,288,mage,fire,6,3,3
18100,Nïo,ravencrest,288,mage,fire,6,3,3
18101,Namemage,stormscale,288,mage,fire,6,3,3
18102,Onlymage,ravencrest,288,mage,fire,6,3,3
18103,Sendro,twisting-nether,288,mage,fire,6,3,3
18104,Blästz,hyjal,288,mage,fire,6,3,3
18105,Alearis,die-aldor,288,mage,fire,6,3,3
18106,Bebenm,archimonde,288,mage,fire,6,3,3
18107,Mylanq,ragnaros,288,mage,fire,6,3,3
18108,Modrone,ragnaros,288,mage,fire,6,3,3
18109,Quincy,frostwolf,288,mage,fire,6,3,3
18110,Noxkin,stormscale,288,mage,fire,6,3,3
18111,Capphaow,ravencrest,288,mage,fire,6,3,3
18112,Trowbe,blackmoore,288,mage,fire,6,3,3
18113,Fleurdelacur,ravencrest,288,mage,fire,6,3,3
18114,Nàtcho,tichondrius,288,mage,fire,6,3,3
18115,Narexa,silvermoon,288,mage,fire,6,3,3
18116,Meign,eredar,288,mage,fire,6,3,3
18117,Мэджу,gordunni,288,mage,fire,6,3,3
18118,Ãzi,ravencrest,288,mage,fire,6,3,3
18119,Coachrmp,ravencrest,288,mage,fire,6,3,3
18120,Elor,eredar,288,mage,fire,6,3,3
18121,Couñterspell,eredar,288,mage,fire,6,3,3
18122,Kryptass,aegwynn,288,mage,fire,6,3,3
18123,Trxkxx,ragnaros,288,mage,fire,6,3,3
18124,Dardíe,ravencrest,288,mage,fire,6,3,3
18125,Даатхедра,booty-bay,288,mage,fire,6,3,3
18126,Frøstdream,dun-modr,288,mage,fire,6,3,3
18127,Ørka,stormscale,288,mage,fire,6,3,3
18128,Botstyle,ravencrest,288,mage,fire,6,3,3
18129,Zøe,aggra-português,288,mage,fire,6,3,3
18130,Mága,grim-batol,288,mage,fire,6,3,3
18131,Lëyra,ysondre,288,mage,fire,6,3,3
18132,Сизаам,howling-fjord,288,mage,fire,6,3,3
18133,Alterwhite,archimonde,288,mage,fire,6,3,3
18134,Росвенд,gordunni,288,mage,fire,6,3,3
18135,Néiloth,frostmane,288,mage,fire,6,3,3
18136,Matroze,sylvanas,288,mage,fire,6,3,3
18137,Ice,sargeras,288,mage,fire,9,4,5
18138,Хблэйз,howling-fjord,288,mage,fire,9,4,5
18139,Lovësosa,hyjal,288,mage,fire,10,4,6
18140,Колтрэйн,blackscar,288,mage,fire,9,3,6
18141,Aylan,kazzak,288,mage,fire,12,3,9
18142,Frökenfrost,stormscale,288,mage,fire,12,3,9
18143,Rasaku,argent-dawn,288,mage,fire,12,3,9
18144,Waan,sylvanas,288,mage,fire,12,3,9
18145,Tombkiller,kult-der-verdammten,288,mage,fire,12,3,9
18146,Oblív,ravencrest,288,mage,fire,12,3,9
18147,Tsubas,blackmoore,288,mage,fire,12,3,9
18148,Saivedija,blackmoore,288,mage,fire,12,3,9
18149,Овеча,gordunni,288,mage,fire,12,3,9
18150,Milton,dunemaul,288,mage,fire,12,3,9
18151,Trenpapi,twisting-nether,288,mage,fire,12,3,9
18152,Hargun,the-maelstrom,288,mage,fire,12,3,9
18153,Roey,defias-brotherhood,288,mage,fire,12,3,9
18154,Räikü,ravencrest,287,mage,fire,12,4,8
18155,Ceanna,argent-dawn,287,mage,fire,12,3,9
18156,Kyrox,ysondre,287,mage,fire,12,3,9
18157,Regenn,kazzak,286,mage,fire,6,3,3
18158,Венлич,gordunni,271,mage,fire,9,4,5
18159,Incenia,ravencrest,271,mage,fire,17,3,14
18160,Khalix,blackmoore,239,mage,fire,5,3,2
18161,Goukakyu,ravencrest,239,mage,fire,5,3,2
18162,Mercem,stormscale,239,mage,fire,5,3,2
18163,Worstwòrld,draenor,208,mage,fire,7,3,4
18164,Jokiss,draenor,192,mage,fire,6,2,4
18165,Decedé,dun-modr,192,mage,fire,6,2,4
18166,Mohovik,wildhammer,192,mage,fire,6,2,4
18167,Zisseron,frostmane,192,mage,fire,6,2,4
18168,Бигдикмаг,soulflayer,192,mage,fire,6,2,4
18169,Solitaria,tarren-mill,192,mage,fire,6,2,4
18170,Sickßlink,outland,192,mage,fire,6,2,4
18171,Gregoss,elune,192,mage,fire,6,2,4
18172,Cortis,outland,192,mage,fire,6,2,4
18173,Dnt,twilights-hammer,192,mage,fire,6,2,4
18174,Antaos,drakthul,192,mage,fire,6,2,4
18175,Kairøs,dragonblight,192,mage,fire,6,2,4
18176,Frígíd,outland,192,mage,fire,6,2,4
18177,Ikefire,draenor,192,mage,fire,6,2,4
18178,Xatures,tarren-mill,192,mage,fire,6,2,4
18179,Roberx,sanguino,192,mage,fire,6,2,4
18180,Skankengine,twisting-nether,192,mage,fire,6,2,4
18181,Rõdokunohi,darksorrow,192,mage,fire,6,2,4
18182,Frostvirgin,twisting-nether,192,mage,fire,6,2,4
18183,Zerobelow,silvermoon,192,mage,fire,6,2,4
18184,Eksl,draenor,192,mage,fire,6,2,4
18185,Alberdoor,blackmoore,192,mage,fire,6,2,4
18186,Xkod,draenor,192,mage,fire,6,2,4
18187,Alarak,drakthul,192,mage,fire,6,2,4
18188,Atzin,sanguino,192,mage,fire,6,2,4
18189,Ôbsury,hyjal,192,mage,fire,6,2,4
18190,Shinegami,hyjal,192,mage,fire,6,2,4
18191,Milminmage,ravencrest,192,mage,fire,6,2,4
18192,Oizar,hyjal,192,mage,fire,6,2,4
18193,Пиньон,borean-tundra,192,mage,fire,6,2,4
18194,Malshash,outland,192,mage,fire,6,2,4
18195,Hopewell,aszune,192,mage,fire,6,2,4
18196,ßigzok,kazzak,192,mage,fire,6,2,4
18197,Apc,sylvanas,192,mage,fire,6,2,4
18198,Stepdaddyy,kazzak,192,mage,fire,6,2,4
18199,Дэката,grom,192,mage,fire,6,2,4
18200,Grìmmjow,tarren-mill,192,mage,fire,6,2,4
18201,Elynaé,draenor,192,mage,fire,6,2,4
18202,Watchmeclic,archimonde,192,mage,fire,6,2,4
18203,Fleqs,antonidas,192,mage,fire,6,2,4
18204,Transformo,draenor,192,mage,fire,6,2,4
18205,Alorin,dun-modr,192,mage,fire,6,2,4
18206,Kilféfroid,ysondre,192,mage,fire,6,2,4
18207,Димаскунфу,howling-fjord,192,mage,fire,6,2,4
18208,Juicedup,blackrock,192,mage,fire,6,2,4
18209,Letitsnow,ravencrest,192,mage,fire,6,2,4
18210,Гнег,gordunni,192,mage,fire,6,2,4
18211,Mirajânê,blackmoore,192,mage,fire,6,2,4
18212,Quínt,blackhand,192,mage,fire,6,2,4
18213,Zeusmon,ragnaros,192,mage,fire,6,2,4
18214,Szarbán,ragnaros,192,mage,fire,6,2,4
18215,Lìx,ravencrest,192,mage,fire,6,2,4
18216,Magenox,blackrock,192,mage,fire,6,2,4
18217,Puracz,defias-brotherhood,192,mage,fire,6,2,4
18218,Компромис,howling-fjord,192,mage,fire,6,2,4
18219,Кеото,gordunni,192,mage,fire,6,2,4
18220,Symbiano,twisting-nether,192,mage,fire,12,2,10
18221,Явернулси,soulflayer,192,mage,fire,12,2,10
18222,Firelight,argent-dawn,192,mage,fire,12,2,10
18223,Mesvef,archimonde,192,mage,fire,12,2,10
18224,Buzzgnom,malfurion,192,mage,fire,12,2,10
18225,Çatàclysmík,kazzak,192,mage,fire,12,2,10
18226,Kirripirri,doomhammer,191,mage,fire,12,2,10
18227,Shockólot,outland,159,mage,fire,5,2,3
18228,Tahiti,twisting-nether,159,mage,fire,5,2,3
18229,Xhal,hyjal,138,mage,fire,9,3,6
18230,Rukiax,blackrock,128,mage,fire,4,2,2
18231,Ayoubz,outland,128,mage,fire,4,2,2
18232,Burstology,kazzak,128,mage,fire,4,2,2
18233,Akadran,blackmoore,96,mage,fire,6,1,5
18234,Wumz,blackrock,96,mage,fire,6,1,5
18235,Alaster,culte-de-la-rive-noire,96,mage,fire,6,1,5
18236,Фантомланс,howling-fjord,96,mage,fire,6,1,5
18237,Камаёри,howling-fjord,96,mage,fire,6,1,5
18238,Ckrax,sanguino,96,mage,fire,6,1,5
18239,Infamage,draenor,96,mage,fire,6,1,5
18240,Варриморыч,soulflayer,96,mage,fire,6,1,5
18241,Phenoxi,sylvanas,96,mage,fire,6,1,5
18242,Warfio,garona,96,mage,fire,6,1,5
18243,Arcanik,archimonde,96,mage,fire,6,1,5
18244,Мелми,howling-fjord,96,mage,fire,6,1,5
18245,Muzbi,turalyon,96,mage,fire,6,1,5
18246,Jipa,tarren-mill,96,mage,fire,6,1,5
18247,Halbattar,garona,96,mage,fire,6,1,5
18248,Dingin,bronze-dragonflight,96,mage,fire,6,1,5
18249,Nodnarb,dragonblight,96,mage,fire,6,1,5
18250,Cavadrex,arathor,96,mage,fire,6,1,5
18251,Nerzzhul,burning-legion,96,mage,fire,6,1,5
18252,Satheril,argent-dawn,96,mage,fire,6,1,5
18253,Prinskoekie,twisting-nether,96,mage,fire,6,1,5
18254,Leonora,blackhand,96,mage,fire,6,1,5
18255,Zalfax,sinstralis,96,mage,fire,6,1,5
18256,Símple,sylvanas,96,mage,fire,6,1,5
18257,Bekkmzi,drakthul,96,mage,fire,6,1,5
18258,Tsungy,twisting-nether,96,mage,fire,6,1,5
18259,Пламяорды,soulflayer,96,mage,fire,6,1,5
18260,Westx,blackmoore,96,mage,fire,6,1,5
18261,Slïnks,stormscale,96,mage,fire,6,1,5
18262,Caststuffatu,sylvanas,96,mage,fire,6,1,5
18263,Polÿmorph,stormscale,96,mage,fire,6,1,5
18264,Zakardo,kazzak,96,mage,fire,6,1,5
18265,Amalou,stormscale,96,mage,fire,6,1,5
18266,Goodopeners,outland,96,mage,fire,6,1,5
18267,Martixx,stormscale,96,mage,fire,6,1,5
18268,Pyroden,stormscale,96,mage,fire,6,1,5
18269,Zagori,sylvanas,96,mage,fire,6,1,5
18270,Zïa,kazzak,96,mage,fire,6,1,5
18271,Megart,stormscale,96,mage,fire,6,1,5
18272,Maybeblood,kazzak,96,mage,fire,6,1,5
18273,Mexxî,thrall,96,mage,fire,6,1,5
18274,Дизордерх,gordunni,96,mage,fire,6,1,5
18275,Radagulf,outland,96,mage,fire,6,1,5
18276,Одз,grom,96,mage,fire,6,1,5
18277,Slashlife,wrathbringer,96,mage,fire,6,1,5
18278,Lovesosa,malorne,96,mage,fire,9,1,8
18279,Tarryxa,kazzak,96,mage,fire,12,1,11
18280,Kenny,nerzhul,96,mage,fire,12,1,11
18281,Mallphass,dalaran,96,mage,fire,12,1,11
18282,Syltris,drakthul,96,mage,fire,18,1,17
18283,Pyrias,sylvanas,95,mage,fire,6,1,5
18284,Shâdozy,blackmoore,89,mage,fire,6,3,3
18285,Alkhazzar,defias-brotherhood,64,mage,fire,4,1,3
18286,Hecht,burning-legion,64,mage,fire,4,1,3
18287,Preí,archimonde,42,mage,fire,12,3,9
18288,Озобочений,greymane,31,mage,fire,2,1,1
18289,Ðøæø,twisting-nether,16,mage,fire,1,1,0
18290,Partypower,twisting-nether,2294,mage,frost,201,105,96
18291,Chikounet,archimonde,2188,mage,frost,150,78,72
18292,Tommy,laughing-skull,2144,mage,frost,88,45,43
18293,Ðeejkñ,archimonde,2139,mage,frost,72,45,27
18294,Avizura,kazzak,2134,mage,frost,60,35,25
18295,Laynerz,kazzak,2132,mage,frost,67,38,29
18296,Kilstine,outland,2126,mage,frost,78,39,39
18297,Dastion,ravencrest,2105,mage,frost,91,45,46
18298,Макотшельник,gordunni,2091,mage,frost,85,54,31
18299,Медивера,gordunni,2076,mage,frost,95,50,45
18300,Søz,agamaggan,2059,mage,frost,161,79,82
18301,Fakér,ravencrest,2058,mage,frost,184,88,96
18302,Watchmeclic,archimonde,2053,mage,frost,96,46,50
18303,Serctheone,ravencrest,2043,mage,frost,190,94,96
18304,Sóz,ravencrest,2033,mage,frost,109,51,58
18305,Philoû,archimonde,2019,mage,frost,77,36,41
18306,Ticklefinger,agamaggan,2004,mage,frost,59,40,19
18307,Arnoldkelly,tarren-mill,1998,mage,frost,55,32,23
18308,Барсуктри,deathguard,1984,mage,frost,60,30,30
18309,Ràiku,ravencrest,1983,mage,frost,60,30,30
18310,Evovar,silvermoon,1981,mage,frost,119,59,60
18311,Kalamaras,quelthalas,1972,mage,frost,62,30,32
18312,Яшабурстх,blackscar,1971,mage,frost,83,45,38
18313,Oscarwizyo,ravencrest,1968,mage,frost,77,36,41
18314,Voerk,twisting-nether,1955,mage,frost,88,46,42
18315,Gavno,ravencrest,1955,mage,frost,54,26,28
18316,Naynn,archimonde,1948,mage,frost,86,44,42
18317,Øscarwizyo,ravencrest,1940,mage,frost,78,38,40
18318,Efes,dun-modr,1934,mage,frost,58,32,26
18319,Akyrâz,blackrock,1930,mage,frost,130,58,72
18320,Sìckofme,aegwynn,1929,mage,frost,42,29,13
18321,Setyouoncs,ravencrest,1927,mage,frost,84,42,42
18322,Abovè,outland,1918,mage,frost,54,23,31
18323,Sukmikok,twisting-nether,1911,mage,frost,190,94,96
18324,Nilitar,kazzak,1910,mage,frost,60,24,36
18325,Watchmeclick,archimonde,1909,mage,frost,36,20,16
18326,Oseri,defias-brotherhood,1897,mage,frost,155,73,82
18327,Santriss,defias-brotherhood,1883,mage,frost,72,36,36
18328,Zimbabweborc,burning-legion,1875,mage,frost,100,62,38
18329,Kurtkiels,draenor,1872,mage,frost,60,29,31
18330,Ввнд,galakrond,1869,mage,frost,60,27,33
18331,Praison,defias-brotherhood,1863,mage,frost,54,32,22
18332,Zhodusqt,ragnaros,1859,mage,frost,54,27,27
18333,Bebenm,archimonde,1857,mage,frost,42,28,14
18334,Henqo,burning-legion,1856,mage,frost,64,30,34
18335,Cleophe,burning-legion,1853,mage,frost,81,44,37
18336,Emoden,silvermoon,1850,mage,frost,302,158,144
18337,Môv,tarren-mill,1849,mage,frost,54,26,28
18338,Arkhaen,archimonde,1848,mage,frost,71,36,35
18339,Незерёб,soulflayer,1844,mage,frost,114,56,58
18340,Mlodysimba,burning-legion,1843,mage,frost,64,34,30
18341,Drfeeldgoodd,mazrigos,1843,mage,frost,84,38,46
18342,Auchenax,argent-dawn,1839,mage,frost,167,84,83
18343,Aìnz,hyjal,1837,mage,frost,60,27,33
18344,Silverlining,ravencrest,1830,mage,frost,169,88,81
18345,Missl,draenor,1830,mage,frost,62,29,33
18346,Exone,sylvanas,1828,mage,frost,66,32,34
18347,Lyndsey,dalaran,1826,mage,frost,65,31,34
18348,Laurents,silvermoon,1825,mage,frost,128,86,42
18349,Rosady,ragnaros,1824,mage,frost,113,57,56
18350,Soz,agamaggan,1823,mage,frost,42,23,19
18351,Èverix,ravencrest,1823,mage,frost,106,47,59
18352,Goneforever,draenor,1820,mage,frost,42,27,15
18353,Мэдвэйз,gordunni,1819,mage,frost,48,31,17
18354,Søbert,hyjal,1818,mage,frost,36,22,14
18355,Алаурс,howling-fjord,1814,mage,frost,60,31,29
18356,Stîckî,malganis,1814,mage,frost,69,31,38
18357,Pryt,ragnaros,1813,mage,frost,137,78,59
18358,Crylz,kazzak,1813,mage,frost,59,28,31
18359,Djdankzter,outland,1812,mage,frost,42,19,23
18360,Máximus,ravencrest,1809,mage,frost,53,27,26
18361,Ëloenn,dalaran,1807,mage,frost,47,21,26
18362,Reflexz,thrall,1805,mage,frost,42,25,17
18363,Xmoo,blackrock,1805,mage,frost,48,24,24
18364,Novaco,ravencrest,1805,mage,frost,59,29,30
18365,Mßs,outland,1804,mage,frost,48,24,24
18366,Baconlance,stormscale,1803,mage,frost,42,23,19
18367,Tellysia,blackmoore,1802,mage,frost,47,26,21
18368,Símple,sylvanas,1802,mage,frost,60,27,33
18369,Kiirin,drakthul,1801,mage,frost,57,34,23
18370,Lidely,kazzak,1800,mage,frost,30,19,11
18371,Zøe,aggra-português,1800,mage,frost,54,34,20
18372,Kyomachix,ahnqiraj,1799,mage,frost,54,31,23
18373,Whócárés,dragonmaw,1798,mage,frost,45,32,13
18374,Stickiburn,malganis,1797,mage,frost,87,42,45
18375,Knometsj,ravencrest,1796,mage,frost,48,26,22
18376,Løwskìll,outland,1795,mage,frost,95,53,42
18377,Einsmagus,blackrock,1793,mage,frost,60,31,29
18378,Shíróyama,ravencrest,1785,mage,frost,210,114,96
18379,Mgtowforlife,ravencrest,1785,mage,frost,194,97,97
18380,Onnÿy,dun-modr,1781,mage,frost,80,37,43
18381,Dodgezdream,kazzak,1779,mage,frost,40,32,8
18382,Chazs,kazzak,1778,mage,frost,72,36,36
18383,Rekzaop,ravencrest,1778,mage,frost,108,48,60
18384,Polÿmorph,stormscale,1774,mage,frost,65,33,32
18385,Medara,darkspear,1768,mage,frost,72,38,34
18386,Ovrpwrdxd,kazzak,1763,mage,frost,24,20,4
18387,Wmp,ravencrest,1763,mage,frost,42,23,19
18388,Wracrz,argent-dawn,1762,mage,frost,72,38,34
18389,Sorrow,outland,1762,mage,frost,84,39,45
18390,Shakéx,outland,1758,mage,frost,51,26,25
18391,Zoot,ravencrest,1758,mage,frost,84,37,47
18392,Sâkuya,blackrock,1756,mage,frost,122,60,62
18393,Äntigood,outland,1755,mage,frost,161,85,76
18394,Gossipgirlz,outland,1754,mage,frost,262,130,132
18395,Sunehx,blackrock,1753,mage,frost,54,30,24
18396,Колинас,soulflayer,1748,mage,frost,101,50,51
18397,Nightfee,eredar,1745,mage,frost,42,21,21
18398,Esscheppert,blackrock,1743,mage,frost,96,46,50
18399,Jirø,cthun,1738,mage,frost,130,65,65
18400,Mumage,blackrock,1735,mage,frost,60,32,28
18401,Jocelynn,aggramar,1735,mage,frost,65,27,38
18402,Rambau,archimonde,1731,mage,frost,227,112,115
18403,Soloqtarget,archimonde,1730,mage,frost,110,55,55
18404,Darkoftw,ysondre,1729,mage,frost,125,58,67
18405,Neymar,aszune,1725,mage,frost,35,24,11
18406,Blackfirez,ravencrest,1725,mage,frost,30,18,12
18407,Гелиадо,soulflayer,1724,mage,frost,42,19,23
18408,Sylbris,outland,1722,mage,frost,131,62,69
18409,Калихор,gordunni,1719,mage,frost,42,28,14
18410,Mexxî,thrall,1719,mage,frost,72,37,35
18411,Nozarashí,hyjal,1719,mage,frost,103,51,52
18412,Sìsia,ragnaros,1717,mage,frost,30,18,12
18413,Tánu,quelthalas,1717,mage,frost,66,32,34
18414,Fireblood,runetotem,1716,mage,frost,60,28,32
18415,Whïm,ysondre,1714,mage,frost,89,35,54
18416,Аресуперпрес,gordunni,1712,mage,frost,46,21,25
18417,Lorothar,blackhand,1712,mage,frost,60,24,36
18418,Raíner,eredar,1708,mage,frost,78,44,34
18419,Lo,kilrogg,1707,mage,frost,102,50,52
18420,Shalien,tarren-mill,1704,mage,frost,65,35,30
18421,Marybaguette,archimonde,1702,mage,frost,54,25,29
18422,Axhole,darksorrow,1700,mage,frost,48,23,25
18423,Tfmchamp,ravencrest,1698,mage,frost,33,22,11
18424,Ishimura,eredar,1697,mage,frost,54,31,23
18425,Ãshs,archimonde,1696,mage,frost,50,21,29
18426,Леракобольд,gordunni,1695,mage,frost,41,20,21
18427,Slobbery,aggramar,1694,mage,frost,54,29,25
18428,Bombswag,bloodhoof,1693,mage,frost,137,66,71
18429,Melíssa,silvermoon,1692,mage,frost,36,25,11
18430,Chíefsheep,thrall,1692,mage,frost,48,26,22
18431,Dènzx,ravencrest,1690,mage,frost,24,18,6
18432,Alearis,die-aldor,1690,mage,frost,72,38,34
18433,Jaimey,blackhand,1690,mage,frost,161,75,86
18434,Frostgodxqt,ravencrest,1689,mage,frost,105,58,47
18435,Ironhood,nemesis,1685,mage,frost,42,24,18
18436,Swizzy,arathor,1685,mage,frost,64,35,29
18437,Jenggot,ravencrest,1681,mage,frost,35,18,17
18438,Vilain,tarren-mill,1678,mage,frost,35,18,17
18439,Xirrasho,argent-dawn,1677,mage,frost,42,22,20
18440,Tiqma,sylvanas,1673,mage,frost,42,23,19
18441,Саваннхмаег,blackscar,1665,mage,frost,57,34,23
18442,Tdv,draenor,1664,mage,frost,45,23,22
18443,Buffenhance,ravencrest,1664,mage,frost,59,23,36
18444,Ephixis,ravencrest,1664,mage,frost,60,23,37
18445,Lïppoutou,archimonde,1663,mage,frost,35,18,17
18446,Мэтаскрим,soulflayer,1662,mage,frost,84,34,50
18447,Bigacombusta,tarren-mill,1661,mage,frost,72,33,39
18448,Quinella,ravencrest,1660,mage,frost,137,73,64
18449,Reðemption,dun-modr,1659,mage,frost,35,23,12
18450,Rankonedeep,kazzak,1659,mage,frost,57,34,23
18451,Vilenciaga,kazzak,1659,mage,frost,66,35,31
18452,Dsmoke,ravencrest,1657,mage,frost,57,27,30
18453,Snowsánji,blackmoore,1656,mage,frost,41,21,20
18454,Gensorèd,darksorrow,1655,mage,frost,74,36,38
18455,Trowbe,blackmoore,1654,mage,frost,48,26,22
18456,Гекомория,fordragon,1654,mage,frost,74,39,35
18457,Манакса,gordunni,1654,mage,frost,54,24,30
18458,Bigkent,stormscale,1653,mage,frost,48,22,26
18459,Nebbur,dun-modr,1650,mage,frost,54,25,29
18460,Thinamerican,defias-brotherhood,1649,mage,frost,30,20,10
18461,Tagrine,kaelthas,1648,mage,frost,102,49,53
18462,Hógwarts,aegwynn,1646,mage,frost,78,42,36
18463,Johnnydeepp,archimonde,1646,mage,frost,36,18,18
18464,Pharohe,stormscale,1646,mage,frost,57,26,31
18465,Келлазар,gordunni,1645,mage,frost,72,34,38
18466,Bestial,alexstrasza,1645,mage,frost,106,50,56
18467,Rukiax,blackrock,1645,mage,frost,54,18,36
18468,Djflashz,archimonde,1644,mage,frost,42,18,24
18469,Firebaw,tarren-mill,1643,mage,frost,36,25,11
18470,Dostoïevskix,hyjal,1640,mage,frost,30,19,11
18471,Emesarry,scarshield-legion,1636,mage,frost,29,18,11
18472,Highrollerqt,tarren-mill,1636,mage,frost,48,28,20
18473,Ahdetärjag,silvermoon,1636,mage,frost,47,26,21
18474,Nickg,ravencrest,1636,mage,frost,42,21,21
18475,Magerocks,ragnaros,1635,mage,frost,36,20,16
18476,Sondremage,outland,1635,mage,frost,134,60,74
18477,Pezi,outland,1634,mage,frost,50,31,19
18478,Demensida,ravencrest,1634,mage,frost,190,100,90
18479,Xall,silvermoon,1632,mage,frost,48,29,19
18480,Scorchira,outland,1631,mage,frost,30,18,12
18481,Манахк,gordunni,1631,mage,frost,42,19,23
18482,Asiman,eredar,1631,mage,frost,51,22,29
18483,Райоми,fordragon,1630,mage,frost,172,88,84
18484,Thesiôu,ravencrest,1629,mage,frost,36,20,16
18485,Buddi,burning-blade,1629,mage,frost,287,148,139
18486,Xep,ragnaros,1629,mage,frost,48,23,25
18487,Bumbumdead,sylvanas,1628,mage,frost,36,20,16
18488,Girldalf,silvermoon,1627,mage,frost,219,110,109
18489,Unsaìntly,kult-der-verdammten,1625,mage,frost,37,17,20
18490,Glowie,stormreaver,1623,mage,frost,36,20,16
18491,Xenant,ravencrest,1623,mage,frost,42,18,24
18492,Kaeser,ravencrest,1622,mage,frost,101,52,49
18493,Jonku,tarren-mill,1619,mage,frost,47,24,23
18494,Layzzy,kazzak,1619,mage,frost,162,76,86
18495,Emerlyn,ragnaros,1618,mage,frost,30,17,13
18496,Sykz,hyjal,1617,mage,frost,65,35,30
18497,Digi,ravencrest,1617,mage,frost,57,22,35
18498,Anaxtra,guldan,1616,mage,frost,147,70,77
18499,Mlogic,tarren-mill,1615,mage,frost,30,17,13
18500,Covran,stormscale,1614,mage,frost,30,17,13
18501,Samath,conseil-des-ombres,1614,mage,frost,42,19,23
18502,Apeex,chamber-of-aspects,1612,mage,frost,96,48,48
18503,Манаксаа,gordunni,1612,mage,frost,45,21,24
18504,Xæll,silvermoon,1611,mage,frost,114,61,53
18505,Sheepthrillz,blackmoore,1609,mage,frost,41,24,17
18506,Mupana,nagrand,1607,mage,frost,150,76,74
18507,Espressno,ravencrest,1606,mage,frost,30,19,11
18508,Tills,kargath,1606,mage,frost,42,20,22
18509,Ðazzftw,archimonde,1605,mage,frost,24,17,7
18510,Dubstep,blackrock,1605,mage,frost,48,23,25
18511,Манахк,blackscar,1605,mage,frost,53,21,32
18512,Jamzymage,emerald-dream,1604,mage,frost,30,17,13
18513,Copyright,deathwing,1604,mage,frost,36,17,19
18514,Helminsterr,archimonde,1603,mage,frost,48,25,23
18515,Noxkin,stormscale,1603,mage,frost,36,17,19
18516,Magethings,kazzak,1603,mage,frost,54,25,29
18517,Фирдаркнесс,howling-fjord,1602,mage,frost,36,19,17
18518,Bzzr,tarren-mill,1601,mage,frost,54,35,19
18519,Réd,earthen-ring,1601,mage,frost,77,36,41
18520,Icefix,dun-modr,1599,mage,frost,119,67,52
18521,Absoluteswag,tarren-mill,1598,mage,frost,39,22,17
18522,Takayaki,terokkar,1598,mage,frost,72,38,34
18523,Mecharience,rexxar,1597,mage,frost,33,18,15
18524,Iroya,festung-der-stürme,1597,mage,frost,179,90,89
18525,Вольняша,azuregos,1591,mage,frost,112,49,63
18526,Sersei,garona,1590,mage,frost,36,17,19
18527,Knúbbz,ravencrest,1588,mage,frost,36,18,18
18528,Okayhehexd,dun-morogh,1586,mage,frost,90,51,39
18529,Leafløver,ravencrest,1586,mage,frost,59,30,29
18530,Blasty,guldan,1585,mage,frost,75,32,43
18531,Joulz,ravencrest,1583,mage,frost,200,94,106
18532,Ёкай,soulflayer,1582,mage,frost,199,111,88
18533,Ôbsury,hyjal,1581,mage,frost,106,56,50
18534,Гамаюнх,deathguard,1581,mage,frost,48,23,25
18535,Boomboomciao,nemesis,1578,mage,frost,102,49,53
18536,Óuíja,outland,1576,mage,frost,45,28,17
18537,Nimdáá,stormscale,1575,mage,frost,204,113,91
18538,Мибринк,soulflayer,1575,mage,frost,72,32,40
18539,Аквамелис,gordunni,1573,mage,frost,42,19,23
18540,Iverson,kazzak,1571,mage,frost,69,29,40
18541,Dubbleblast,draenor,1570,mage,frost,48,25,23
18542,Petepan,argent-dawn,1570,mage,frost,109,53,56
18543,Ингилейф,howling-fjord,1570,mage,frost,46,18,28
18544,Datpolytho,twisting-nether,1567,mage,frost,54,36,18
18545,Левелнес,howling-fjord,1567,mage,frost,74,32,42
18546,Ceillech,blackrock,1564,mage,frost,76,38,38
18547,Sheepmaster,aegwynn,1563,mage,frost,36,19,17
18548,Smashdown,blackrock,1562,mage,frost,36,19,17
18549,Hbarftw,ravencrest,1562,mage,frost,59,30,29
18550,Itzlucky,twisting-nether,1561,mage,frost,166,82,84
18551,Vyuca,argent-dawn,1559,mage,frost,52,28,24
18552,Karstnstenzl,blackrock,1559,mage,frost,42,22,20
18553,Chareyla,argent-dawn,1558,mage,frost,83,42,41
18554,Afterimage,zuljin,1556,mage,frost,122,57,65
18555,Gaduz,kazzak,1556,mage,frost,72,31,41
18556,Rihnou,blackmoore,1551,mage,frost,89,40,49
18557,Mxrrz,kazzak,1547,mage,frost,211,111,100
18558,Icydeadsheep,draenor,1547,mage,frost,72,28,44
18559,Ghalanz,ravencrest,1545,mage,frost,60,29,31
18560,Homellander,silvermoon,1543,mage,frost,323,168,155
18561,Бингчилинг,howling-fjord,1543,mage,frost,64,30,34
18562,Старкскрим,gordunni,1542,mage,frost,100,48,52
18563,Озобочений,greymane,1541,mage,frost,73,34,39
18564,Koreanbbq,outland,1541,mage,frost,42,18,24
18565,Necizbored,tarren-mill,1539,mage,frost,48,30,18
18566,Sakuranosuke,twisting-nether,1534,mage,frost,36,20,16
18567,Newintown,blackmoore,1533,mage,frost,56,30,26
18568,Elcritadoré,ragnaros,1533,mage,frost,45,22,23
18569,Walian,burning-blade,1532,mage,frost,42,24,18
18570,Arimila,sylvanas,1532,mage,frost,156,75,81
18571,Alluryeine,draenor,1531,mage,frost,59,34,25
18572,Миднаит,gordunni,1531,mage,frost,105,47,58
18573,Фоулли,howling-fjord,1528,mage,frost,34,17,17
18574,Kèj,kazzak,1528,mage,frost,39,19,20
18575,Widmage,silvermoon,1526,mage,frost,134,62,72
18576,Fullpolly,twisting-nether,1525,mage,frost,36,23,13
18577,Lilblinks,silvermoon,1525,mage,frost,30,18,12
18578,Excuses,chamber-of-aspects,1525,mage,frost,290,143,147
18579,Evilmagíc,tarren-mill,1523,mage,frost,30,16,14
18580,Вендайса,soulflayer,1522,mage,frost,256,146,110
18581,Tjq,ravencrest,1522,mage,frost,111,55,56
18582,Beaun,tarren-mill,1521,mage,frost,87,46,41
18583,Manafuzz,outland,1521,mage,frost,36,17,19
18584,Qùb,eldrethalas,1519,mage,frost,42,23,19
18585,Лакифриз,gordunni,1518,mage,frost,36,22,14
18586,Únna,sanguino,1517,mage,frost,81,45,36
18587,Larmp,outland,1517,mage,frost,42,16,26
18588,Ney,drakthul,1516,mage,frost,24,16,8
18589,Фемна,soulflayer,1515,mage,frost,119,65,54
18590,Sekulicgoga,draenor,1515,mage,frost,309,168,141
18591,Mystikj,arathor,1514,mage,frost,36,16,20
18592,Ckrax,sanguino,1512,mage,frost,24,16,8
18593,Rexør,frostwolf,1505,mage,frost,54,31,23
18594,Denaleidi,stormscale,1505,mage,frost,54,30,24
18595,Snakebit,kazzak,1505,mage,frost,73,37,36
18596,Wýr,archimonde,1504,mage,frost,60,26,34
18597,Isralysa,ravencrest,1502,mage,frost,251,131,120
18598,Dzikk,silvermoon,1502,mage,frost,66,34,32
18599,Kaì,twisting-nether,1499,mage,frost,90,51,39
18600,Skretx,archimonde,1497,mage,frost,24,17,7
18601,Shainax,dun-modr,1497,mage,frost,94,49,45
18602,Spellcast,ravencrest,1496,mage,frost,33,18,15
18603,Aeternitaz,outland,1492,mage,frost,53,28,25
18604,Senedai,stormscale,1491,mage,frost,30,16,14
18605,Averus,outland,1490,mage,frost,36,21,15
18606,Мозифрост,gordunni,1490,mage,frost,62,23,39
18607,Сосулькина,gordunni,1488,mage,frost,95,50,45
18608,Phélenia,sargeras,1488,mage,frost,90,44,46
18609,Surlancealot,outland,1488,mage,frost,53,23,30
18610,Borko,rashgarroth,1486,mage,frost,36,19,17
18611,Icekíss,hyjal,1486,mage,frost,70,33,37
18612,Plætinum,ravencrest,1485,mage,frost,192,97,95
18613,Свдпро,deathguard,1485,mage,frost,58,28,30
18614,Корадо,gordunni,1483,mage,frost,120,54,66
18615,Datakrigern,tarren-mill,1480,mage,frost,41,22,19
18616,Saucise,hyjal,1480,mage,frost,54,28,26
18617,Tromie,archimonde,1479,mage,frost,191,96,95
18618,Scaleeth,kazzak,1479,mage,frost,40,18,22
18619,Тачмахал,soulflayer,1478,mage,frost,60,31,29
18620,Qqpwn,ragnaros,1477,mage,frost,65,32,33
18621,Realone,ragnaros,1477,mage,frost,59,25,34
18622,Zaruna,arathor,1476,mage,frost,63,33,30
18623,Octtmiss,twisting-nether,1476,mage,frost,33,17,16
18624,Spamblink,archimonde,1474,mage,frost,63,18,45
18625,Rodatudo,ravencrest,1472,mage,frost,82,37,45
18626,Sciren,nagrand,1471,mage,frost,31,16,15
18627,Джейнанис,gordunni,1471,mage,frost,64,33,31
18628,Vannq,silvermoon,1468,mage,frost,66,26,40
18629,Tôke,kaelthas,1467,mage,frost,66,38,28
18630,Ðíø,twisting-nether,1467,mage,frost,34,18,16
18631,Kelthuzed,twisting-nether,1466,mage,frost,33,18,15
18632,Fïttan,stormscale,1464,mage,frost,44,20,24
18633,Néiloth,frostmane,1463,mage,frost,35,16,19
18634,Nàtcho,tichondrius,1462,mage,frost,36,20,16
18635,Hernêise,silvermoon,1462,mage,frost,167,87,80
18636,Frostique,kazzak,1460,mage,frost,97,54,43
18637,Trais,blackrock,1458,mage,frost,33,22,11
18638,Tainted,eredar,1458,mage,frost,36,18,18
18639,Lolmageop,aegwynn,1457,mage,frost,35,16,19
18640,Hambones,outland,1456,mage,frost,38,16,22
18641,Оай,gordunni,1456,mage,frost,54,22,32
18642,Bebarz,darksorrow,1455,mage,frost,106,57,49
18643,Råståfåri,uldum,1455,mage,frost,60,25,35
18644,Метох,soulflayer,1454,mage,frost,168,78,90
18645,Lesoleil,archimonde,1453,mage,frost,30,19,11
18646,Ia,kirin-tor,1452,mage,frost,46,25,21
18647,Дарнивил,gordunni,1452,mage,frost,167,85,82
18648,Airo,drakthul,1451,mage,frost,36,22,14
18649,Sangumage,silvermoon,1451,mage,frost,54,25,29
18650,Azkarr,stormscale,1450,mage,frost,59,33,26
18651,Dllarky,drakthul,1448,mage,frost,48,24,24
18652,Khivax,twisting-nether,1448,mage,frost,66,27,39
18653,Woorm,sylvanas,1446,mage,frost,76,44,32
18654,Afklow,pozzo-delleternità,1442,mage,frost,39,21,18
18655,Maquiwizz,aggra-português,1442,mage,frost,48,24,24
18656,Eldariel,ravencrest,1442,mage,frost,83,39,44
18657,Comodus,ragnaros,1437,mage,frost,112,52,60
18658,Shnitz,stormscale,1436,mage,frost,24,15,9
18659,Novalia,wrathbringer,1435,mage,frost,84,46,38
18660,Astaden,die-aldor,1435,mage,frost,39,21,18
18661,Hayaka,sanguino,1435,mage,frost,59,30,29
18662,Charliezard,argent-dawn,1435,mage,frost,36,15,21
18663,Нереварин,soulflayer,1435,mage,frost,42,15,27
18664,Hazzá,ravencrest,1433,mage,frost,24,15,9
18665,Maege,ragnaros,1432,mage,frost,32,17,15
18666,Quadekun,tarren-mill,1432,mage,frost,30,15,15
18667,Stillfrostin,blackrock,1430,mage,frost,60,38,22
18668,Аваон,deathguard,1429,mage,frost,81,39,42
18669,Фростидзе,gordunni,1427,mage,frost,60,27,33
18670,Пиньон,borean-tundra,1425,mage,frost,36,21,15
18671,Azakadabra,ysondre,1425,mage,frost,55,31,24
18672,Jezí,ghostlands,1425,mage,frost,36,15,21
18673,Моритакаа,gordunni,1424,mage,frost,60,33,27
18674,Гатмир,gordunni,1423,mage,frost,231,115,116
18675,Gêrky,drakthul,1422,mage,frost,108,53,55
18676,Koreanbbq,kazzak,1422,mage,frost,65,31,34
18677,Borêta,blackrock,1421,mage,frost,120,55,65
18678,Jedite,die-todeskrallen,1420,mage,frost,218,114,104
18679,Tærrëñshíll,tarren-mill,1420,mage,frost,36,15,21
18680,Naylz,archimonde,1419,mage,frost,30,15,15
18681,Iceiceice,stormscale,1418,mage,frost,54,30,24
18682,Hellionblast,ragnaros,1416,mage,frost,30,15,15
18683,Учительйода,ashenvale,1413,mage,frost,36,23,13
18684,Hexmath,tarren-mill,1413,mage,frost,30,15,15
18685,Nutsa,silvermoon,1412,mage,frost,24,15,9
18686,Messatsux,tarren-mill,1411,mage,frost,30,15,15
18687,Нонекс,soulflayer,1411,mage,frost,71,33,38
18688,Zionw,frostwolf,1410,mage,frost,121,60,61
18689,Xyfys,azshara,1409,mage,frost,24,15,9
18690,Pipihu,silvermoon,1409,mage,frost,54,27,27
18691,Elcølgaø,sanguino,1406,mage,frost,90,39,51
18692,Firehasse,draenor,1400,mage,frost,104,57,47
18693,Sixx,aegwynn,1400,mage,frost,41,19,22
18694,Shagee,stormscale,1399,mage,frost,30,16,14
18695,Kippercarry,outland,1398,mage,frost,30,15,15
18696,Wormhole,kazzak,1398,mage,frost,30,15,15
18697,Pluribusunum,outland,1398,mage,frost,38,17,21
18698,Frèézê,frostwolf,1398,mage,frost,36,16,20
18699,Tàylerdarden,nemesis,1396,mage,frost,65,29,36
18700,Elynaé,draenor,1395,mage,frost,70,33,37
18701,Apócalyptic,tarren-mill,1392,mage,frost,76,44,32
18702,Nightplays,sylvanas,1391,mage,frost,36,22,14
18703,Shüri,kazzak,1391,mage,frost,72,41,31
18704,Ymirë,khaz-modan,1391,mage,frost,45,20,25
18705,Shunii,ravencrest,1390,mage,frost,29,15,14
18706,Гунмаказ,soulflayer,1384,mage,frost,28,20,8
18707,Velâska,malganis,1383,mage,frost,81,47,34
18708,Синийлед,galakrond,1382,mage,frost,144,69,75
18709,Derbomber,guldan,1382,mage,frost,41,16,25
18710,Lukewizard,twisting-nether,1381,mage,frost,56,32,24
18711,Iulie,kazzak,1381,mage,frost,174,87,87
18712,Zice,antonidas,1380,mage,frost,34,18,16
18713,Psika,kazzak,1377,mage,frost,79,37,42
18714,Bolesnimage,draenor,1376,mage,frost,47,28,19
18715,Texita,sylvanas,1376,mage,frost,29,17,12
18716,Eclyftw,blackmoore,1374,mage,frost,36,16,20
18717,Find,archimonde,1373,mage,frost,86,36,50
18718,Lsdt,stormscale,1372,mage,frost,42,16,26
18719,Oizar,hyjal,1371,mage,frost,48,25,23
18720,Цепнойпёс,goldrinn,1371,mage,frost,34,17,17
18721,Daneliam,outland,1369,mage,frost,55,28,27
18722,Mohovik,wildhammer,1368,mage,frost,30,15,15
18723,Heathrow,ravencrest,1367,mage,frost,48,28,20
18724,Анзот,howling-fjord,1366,mage,frost,40,23,17
18725,Орижн,howling-fjord,1366,mage,frost,53,29,24
18726,Smöked,tarren-mill,1366,mage,frost,294,150,144
18727,Alicánte,silvermoon,1365,mage,frost,66,29,37
18728,Iceorb,azshara,1364,mage,frost,114,52,62
18729,Arlunea,blackmoore,1364,mage,frost,50,20,30
18730,Cheerió,aggramar,1360,mage,frost,254,118,136
18731,Dabka,argent-dawn,1359,mage,frost,193,95,98
18732,Däpper,ragnaros,1357,mage,frost,42,16,26
18733,Енотмаг,gordunni,1356,mage,frost,42,20,22
18734,Фиджарь,soulflayer,1352,mage,frost,129,66,63
18735,Fistersfrizz,aegwynn,1348,mage,frost,36,20,16
18736,Sylênna,kazzak,1347,mage,frost,60,30,30
18737,Corpusqq,eredar,1347,mage,frost,54,26,28
18738,Morphees,twisting-nether,1345,mage,frost,36,22,14
18739,Confine,twisting-nether,1345,mage,frost,70,34,36
18740,Manvo,bloodscalp,1345,mage,frost,60,23,37
18741,Jíncks,anachronos,1344,mage,frost,24,14,10
18742,Preí,archimonde,1344,mage,frost,37,15,22
18743,Seikatsu,sylvanas,1343,mage,frost,30,14,16
18744,Dastion,sylvanas,1343,mage,frost,30,14,16
18745,Abolf,twisting-nether,1342,mage,frost,36,20,16
18746,Obbcontrol,ravencrest,1342,mage,frost,30,14,16
18747,Lzd,ravencrest,1340,mage,frost,24,14,10
18748,Dmmeforcam,archimonde,1340,mage,frost,26,15,11
18749,Lovësosa,hyjal,1340,mage,frost,47,25,22
18750,Jokiss,draenor,1339,mage,frost,114,57,57
18751,Immobilizer,eredar,1339,mage,frost,78,39,39
18752,Caesarclown,silvermoon,1339,mage,frost,131,65,66
18753,Деорро,gordunni,1338,mage,frost,30,14,16
18754,Grandbasile,hyjal,1338,mage,frost,30,14,16
18755,Mollymorph,ragnaros,1338,mage,frost,42,14,28
18756,Cinoox,blackrock,1337,mage,frost,34,15,19
18757,Pruneau,hyjal,1336,mage,frost,53,28,25
18758,Animaze,argent-dawn,1335,mage,frost,155,88,67
18759,Tirenia,bloodfeather,1335,mage,frost,41,15,26
18760,Fractox,ysondre,1334,mage,frost,118,61,57
18761,Illius,kelthuzad,1334,mage,frost,37,18,19
18762,Spelltastíc,blackmoore,1333,mage,frost,24,14,10
18763,Imbatto,quelthalas,1332,mage,frost,42,20,22
18764,Destruct,doomhammer,1331,mage,frost,66,38,28
18765,Shinzel,hyjal,1331,mage,frost,64,26,38
18766,Кройзис,howling-fjord,1328,mage,frost,80,46,34
18767,Игрдлпдров,gordunni,1327,mage,frost,72,34,38
18768,Pronyma,outland,1327,mage,frost,30,14,16
18769,Dïabolike,archimonde,1326,mage,frost,36,22,14
18770,Phenoxi,sylvanas,1325,mage,frost,24,14,10
18771,Laenadria,argent-dawn,1325,mage,frost,71,28,43
18772,Tìnder,tarren-mill,1324,mage,frost,78,40,38
18773,Discomorph,the-maelstrom,1322,mage,frost,24,14,10
18774,Tarkún,dun-modr,1321,mage,frost,66,39,27
18775,Sused,outland,1321,mage,frost,30,16,14
18776,Маушко,soulflayer,1321,mage,frost,77,40,37
18777,Katarapower,silvermoon,1321,mage,frost,243,117,126
18778,Nïo,ravencrest,1318,mage,frost,36,19,17
18779,Mdog,stormreaver,1317,mage,frost,68,35,33
18780,Zagori,sylvanas,1316,mage,frost,61,30,31
18781,Кварийм,howling-fjord,1316,mage,frost,80,36,44
18782,Лутиум,howling-fjord,1313,mage,frost,181,100,81
18783,Левченкопро,soulflayer,1313,mage,frost,151,78,73
18784,Hetaxata,kazzak,1313,mage,frost,32,16,16
18785,Iceym,ravencrest,1313,mage,frost,41,17,24
18786,Bænoß,ravencrest,1312,mage,frost,30,16,14
18787,Crackheads,hyjal,1312,mage,frost,66,30,36
18788,Seyece,silvermoon,1311,mage,frost,41,22,19
18789,Umaguma,elune,1310,mage,frost,47,20,27
18790,Iggilaus,blackhand,1308,mage,frost,333,166,167
18791,Sandalf,lightnings-blade,1307,mage,frost,30,14,16
18792,Ímnotback,outland,1306,mage,frost,277,139,138
18793,Quilava,ghostlands,1305,mage,frost,37,19,18
18794,Vrajitöru,doomhammer,1304,mage,frost,26,16,10
18795,Mogettemagic,ysondre,1304,mage,frost,30,15,15
18796,Alktraz,outland,1302,mage,frost,78,34,44
18797,Викликс,borean-tundra,1301,mage,frost,40,22,18
18798,Ryydee,silvermoon,1301,mage,frost,146,76,70
18799,Magitron,wildhammer,1301,mage,frost,35,18,17
18800,Iceterror,ravencrest,1300,mage,frost,24,15,9
18801,Quail,anubarak,1300,mage,frost,136,64,72
18802,Oiklo,eitrigg,1300,mage,frost,55,24,31
18803,Nups,ravencrest,1300,mage,frost,84,35,49
18804,Máurus,antonidas,1299,mage,frost,54,21,33
18805,Psychosiss,kazzak,1298,mage,frost,49,27,22
18806,Kaaguraa,ravencrest,1298,mage,frost,181,94,87
18807,Lìx,ravencrest,1295,mage,frost,23,14,9
18808,Магсимум,ashenvale,1292,mage,frost,35,18,17
18809,Winterblues,frostmourne,1291,mage,frost,36,20,16
18810,Seelengott,onyxia,1290,mage,frost,209,106,103
18811,Kundry,tarren-mill,1289,mage,frost,42,16,26
18812,Frostjävel,grim-batol,1288,mage,frost,46,24,22
18813,Zoubaz,archimonde,1286,mage,frost,31,16,15
18814,Voldemort,bronzebeard,1284,mage,frost,51,24,27
18815,Funakin,blackrock,1284,mage,frost,48,18,30
18816,Akúmã,stormscale,1278,mage,frost,203,100,103
18817,Xhal,hyjal,1277,mage,frost,36,18,18
18818,Jackin,burning-legion,1277,mage,frost,66,31,35
18819,Гаразлик,howling-fjord,1277,mage,frost,168,77,91
18820,Justleblanc,dalaran,1277,mage,frost,46,18,28
18821,Flakeh,outland,1276,mage,frost,83,40,43
18822,Mfnz,stormreaver,1275,mage,frost,35,15,20
18823,Asteria,twisting-nether,1274,mage,frost,142,67,75
18824,Kleini,die-aldor,1273,mage,frost,23,15,8
18825,Nevaehine,ravencrest,1272,mage,frost,156,79,77
18826,Silvariy,stormscale,1272,mage,frost,142,71,71
18827,Teuboku,ysondre,1271,mage,frost,43,27,16
18828,Tradez,norgannon,1271,mage,frost,42,17,25
18829,Jaghahah,tarren-mill,1266,mage,frost,90,52,38
18830,Lenycz,burning-blade,1266,mage,frost,36,19,17
18831,Alkhazzar,defias-brotherhood,1265,mage,frost,214,97,117
18832,Nightnovae,ravencrest,1265,mage,frost,42,17,25
18833,Tacto,ravencrest,1264,mage,frost,160,84,76
18834,Nandie,stormreaver,1263,mage,frost,32,18,14
18835,Zwölfte,outland,1262,mage,frost,100,57,43
18836,Braxxorz,chamber-of-aspects,1261,mage,frost,36,24,12
18837,Sikaia,twisting-nether,1261,mage,frost,45,21,24
18838,Дырявка,galakrond,1261,mage,frost,72,32,40
18839,Qtiepatootie,silvermoon,1260,mage,frost,157,84,73
18840,Zeusmon,ragnaros,1260,mage,frost,41,17,24
18841,Shroomie,eredar,1258,mage,frost,78,35,43
18842,Nuryielle,blackmoore,1256,mage,frost,30,15,15
18843,Проблембойх,gordunni,1248,mage,frost,24,13,11
18844,Ghettomagé,aegwynn,1247,mage,frost,30,13,17
18845,Abruaa,tarren-mill,1246,mage,frost,18,13,5
18846,Crzyubrdrver,blackrock,1246,mage,frost,24,13,11
18847,Bengé,ragnaros,1245,mage,frost,22,14,8
18848,Bceps,stormscale,1245,mage,frost,66,35,31
18849,Xânârchy,minahonda,1242,mage,frost,72,33,39
18850,Rinuria,blackrock,1241,mage,frost,18,13,5
18851,Dabina,sanguino,1240,mage,frost,54,25,29
18852,Donishakur,ragnaros,1240,mage,frost,37,13,24
18853,Track,blackhand,1238,mage,frost,30,13,17
18854,Titanshao,silvermoon,1237,mage,frost,24,16,8
18855,Криолетта,gordunni,1237,mage,frost,78,35,43
18856,Séptímus,kazzak,1237,mage,frost,34,15,19
18857,Вайконд,howling-fjord,1236,mage,frost,50,23,27
18858,Prinskoekie,twisting-nether,1235,mage,frost,100,39,61
18859,Wslyx,dun-morogh,1233,mage,frost,42,13,29
18860,Stace,area-52,1231,mage,frost,42,13,29
18861,Glöden,ravencrest,1228,mage,frost,24,13,11
18862,Luxxurious,xavius,1225,mage,frost,34,14,20
18863,Pyroden,stormscale,1224,mage,frost,42,18,24
18864,Boredpeon,burning-legion,1223,mage,frost,60,31,29
18865,Gliffy,terokkar,1222,mage,frost,49,29,20
18866,Dyx,nemesis,1222,mage,frost,78,33,45
18867,Хблэйз,howling-fjord,1222,mage,frost,36,14,22
18868,Eléaena,argent-dawn,1221,mage,frost,30,13,17
18869,Pwntt,terenas,1219,mage,frost,51,20,31
18870,Suidas,auchindoun,1217,mage,frost,66,28,38
18871,Apic,blackrock,1215,mage,frost,23,15,8
18872,Lupuus,anubarak,1215,mage,frost,24,13,11
18873,Faycia,blackhand,1212,mage,frost,72,30,42
18874,Meydoum,archimonde,1209,mage,frost,24,13,11
18875,Esculapìo,nemesis,1207,mage,frost,124,64,60
18876,Olivaresa,ravencrest,1205,mage,frost,50,17,33
18877,Хоф,deathguard,1204,mage,frost,30,13,17
18878,Zevúlòs,ravencrest,1202,mage,frost,42,28,14
18879,Rektd,blackhand,1193,mage,frost,133,61,72
18880,Vathalis,zuluhed,1193,mage,frost,77,29,48
18881,Phaege,defias-brotherhood,1192,mage,frost,32,15,17
18882,Søphiâ,thrall,1191,mage,frost,72,38,34
18883,Вельдрик,soulflayer,1191,mage,frost,142,71,71
18884,Orelox,kazzak,1191,mage,frost,29,13,16
18885,Вескнам,lich-king,1188,mage,frost,72,30,42
18886,Сибиди,gordunni,1185,mage,frost,24,13,11
18887,Fleurdelacur,ravencrest,1182,mage,frost,57,29,28
18888,Хируэль,gordunni,1180,mage,frost,98,47,51
18889,Scaless,stormscale,1176,mage,frost,77,37,40
18890,Инкрионити,gordunni,1175,mage,frost,23,13,10
18891,Yenkonidas,blackmoore,1175,mage,frost,54,23,31
18892,Quincy,frostwolf,1173,mage,frost,54,24,30
18893,Kótaranka,kazzak,1168,mage,frost,47,21,26
18894,Zvuta,sanguino,1166,mage,frost,18,14,4
18895,Zzombi,sylvanas,1166,mage,frost,81,39,42
18896,Айсвеном,gordunni,1166,mage,frost,36,16,20
18897,Akâri,silvermoon,1166,mage,frost,31,13,18
18898,Морозящий,howling-fjord,1162,mage,frost,165,84,81
18899,Bossgb,twisting-nether,1160,mage,frost,27,15,12
18900,Flamya,stormscale,1160,mage,frost,47,20,27
18901,Nazø,archimonde,1158,mage,frost,80,36,44
18902,Hagiko,archimonde,1156,mage,frost,21,14,7
18903,Baravar,blackrock,1155,mage,frost,35,14,21
18904,Айсбоунт,eversong,1151,mage,frost,49,27,22
18905,Valyndra,twisting-nether,1150,mage,frost,18,12,6
18906,Amicuta,ravencrest,1150,mage,frost,48,24,24
18907,Arcticfury,ravencrest,1149,mage,frost,24,12,12
18908,Anamalhoa,aggra-português,1147,mage,frost,36,18,18
18909,Sukky,todeswache,1146,mage,frost,24,12,12
18910,Gameboycolor,ravencrest,1146,mage,frost,30,12,18
18911,Чистокрут,gordunni,1146,mage,frost,36,12,24
18912,Блья,howling-fjord,1145,mage,frost,54,31,23
18913,Ayoubz,outland,1145,mage,frost,24,12,12
18914,Scoodles,kazzak,1145,mage,frost,30,12,18
18915,Goukí,drakthul,1144,mage,frost,18,12,6
18916,Tiltedpapi,ravencrest,1142,mage,frost,46,24,22
18917,Qulinx,kazzak,1142,mage,frost,29,13,16
18918,Magjaw,twisting-nether,1141,mage,frost,30,18,12
18919,Maggresive,sylvanas,1140,mage,frost,30,15,15
18920,Iceicebáby,draenor,1139,mage,frost,36,17,19
18921,Frostvirgin,twisting-nether,1138,mage,frost,30,12,18
18922,Frostyfart,tarren-mill,1136,mage,frost,24,12,12
18923,Aern,sinstralis,1136,mage,frost,30,12,18
18924,Дивеансерт,blackscar,1136,mage,frost,36,13,23
18925,Rafaeala,argent-dawn,1135,mage,frost,121,64,57
18926,Oathkeepper,silvermoon,1135,mage,frost,124,60,64
18927,Райдзен,greymane,1135,mage,frost,75,30,45
18928,Momotemp,emerald-dream,1133,mage,frost,102,50,52
18929,Roughfked,silvermoon,1132,mage,frost,68,39,29
18930,Iamslow,sylvanas,1130,mage,frost,18,12,6
18931,Stryee,ragnaros,1128,mage,frost,24,12,12
18932,Ewina,twisting-nether,1128,mage,frost,24,12,12
18933,Tomuru,draenor,1127,mage,frost,74,44,30
18934,Gacosane,chamber-of-aspects,1126,mage,frost,75,30,45
18935,Vignoni,the-maelstrom,1125,mage,frost,24,12,12
18936,Lêgólás,blackmoore,1119,mage,frost,24,12,12
18937,Lifemagic,chamber-of-aspects,1118,mage,frost,81,43,38
18938,Pinkis,darkmoon-faire,1116,mage,frost,79,40,39
18939,Kapueca,jaedenar,1110,mage,frost,39,25,14
18940,Roey,defias-brotherhood,1110,mage,frost,30,14,16
18941,Suikune,twisting-nether,1104,mage,frost,18,12,6
18942,Луциаз,gordunni,1104,mage,frost,41,24,17
18943,Popixx,magtheridon,1102,mage,frost,42,13,29
18944,Kalyipso,blackrock,1097,mage,frost,48,14,34
18945,Tygaone,tirion,1096,mage,frost,36,17,19
18946,Саназэр,soulflayer,1095,mage,frost,66,30,36
18947,Latiny,destromath,1091,mage,frost,65,28,37
18948,Kadsy,tarren-mill,1090,mage,frost,41,18,23
18949,Aileean,burning-legion,1087,mage,frost,47,20,27
18950,Saphiregos,dalaran,1085,mage,frost,112,54,58
18951,Goeb,kazzak,1083,mage,frost,35,14,21
18952,Niivel,ysondre,1082,mage,frost,120,68,52
18953,Warwizz,sanguino,1081,mage,frost,22,12,10
18954,Килавый,eversong,1080,mage,frost,24,16,8
18955,Broduy,draenor,1079,mage,frost,90,40,50
18956,Çxçx,dun-modr,1077,mage,frost,30,12,18
18957,Aelire,die-aldor,1077,mage,frost,33,12,21
18958,Isolia,silvermoon,1075,mage,frost,29,12,17
18959,Metaboi,ragnaros,1072,mage,frost,47,14,33
18960,Cardioexpert,ravencrest,1071,mage,frost,19,12,7
18961,Arcanik,archimonde,1065,mage,frost,49,14,35
18962,Miidi,doomhammer,1064,mage,frost,42,23,19
18963,Дедамаг,eversong,1064,mage,frost,36,18,18
18964,Shivah,onyxia,1064,mage,frost,118,46,72
18965,Jodiefroster,bronzebeard,1063,mage,frost,50,29,21
18966,Xèrec,ysondre,1058,mage,frost,36,12,24
18967,Лемозяра,gordunni,1056,mage,frost,12,11,1
18968,Elldiamage,draenor,1056,mage,frost,24,11,13
18969,Унитазныймаг,howling-fjord,1056,mage,frost,24,11,13
18970,Unsaîntly,kult-der-verdammten,1056,mage,frost,28,11,17
18971,Decedé,dun-modr,1055,mage,frost,18,11,7
18972,Xläderz,ravencrest,1055,mage,frost,18,11,7
18973,Tenetic,thrall,1055,mage,frost,20,11,9
18974,Stümpy,ravencrest,1055,mage,frost,24,11,13
18975,Yshax,malganis,1055,mage,frost,36,11,25
18976,Síckmode,khadgar,1055,mage,frost,36,11,25
18977,Rere,zenedar,1054,mage,frost,26,13,13
18978,Kõl,ravencrest,1054,mage,frost,24,11,13
18979,Grömit,drakthul,1053,mage,frost,18,11,7
18980,Ilovedana,dun-modr,1053,mage,frost,38,11,27
18981,Xzp,der-rat-von-dalaran,1052,mage,frost,24,11,13
18982,Pixlet,kazzak,1052,mage,frost,30,11,19
18983,Винилочка,deathguard,1051,mage,frost,24,11,13
18984,Бальзамон,eversong,1051,mage,frost,37,15,22
18985,Ízumi,stormscale,1051,mage,frost,30,11,19
18986,Lyramage,draenor,1051,mage,frost,36,11,25
18987,Destrech,aggra-português,1050,mage,frost,18,11,7
18988,Morozuvko,tarren-mill,1050,mage,frost,18,11,7
18989,Файрусх,blackscar,1049,mage,frost,18,11,7
18990,Жемчужина,eversong,1049,mage,frost,18,11,7
18991,Shakamage,grim-batol,1049,mage,frost,28,14,14
18992,Shøcked,blackrock,1049,mage,frost,36,11,25
18993,Spellsteal,antonidas,1048,mage,frost,24,11,13
18994,Chililol,dun-modr,1048,mage,frost,24,11,13
18995,Ryzea,ravencrest,1047,mage,frost,23,15,8
18996,Риктусемпра,ashenvale,1047,mage,frost,18,11,7
18997,Atixx,aegwynn,1047,mage,frost,36,11,25
18998,Qwixxis,sylvanas,1045,mage,frost,96,44,52
18999,Férécide,ysondre,1045,mage,frost,30,11,19
19000,Умелецмаг,gordunni,1044,mage,frost,54,27,27
19001,Bobbasor,defias-brotherhood,1044,mage,frost,37,14,23
19002,Ãzi,ravencrest,1042,mage,frost,18,11,7
19003,Ørcan,azshara,1042,mage,frost,78,29,49
19004,Thry,bronzebeard,1042,mage,frost,30,11,19
19005,Blinklet,twisting-nether,1040,mage,frost,26,17,9
19006,Юлианх,gordunni,1039,mage,frost,256,124,132
19007,Khoshgele,draenor,1039,mage,frost,24,11,13
19008,Irreversal,ravencrest,1037,mage,frost,59,27,32
19009,Nåzmyz,outland,1035,mage,frost,66,28,38
19010,Clonefcf,sylvanas,1032,mage,frost,55,31,24
19011,Forestie,silvermoon,1032,mage,frost,50,23,27
19012,Mystto,silvermoon,1030,mage,frost,48,29,19
19013,Snowrain,chogall,1030,mage,frost,47,23,24
19014,Ramcoz,twisting-nether,1029,mage,frost,42,21,21
19015,Ananaskana,ragnaros,1025,mage,frost,18,11,7
19016,Lunnysvet,blackrock,1024,mage,frost,47,24,23
19017,Коласольдом,gordunni,1024,mage,frost,24,11,13
19018,Neverblockx,blackrock,1023,mage,frost,16,11,5
19019,Skyra,les-sentinelles,1023,mage,frost,36,21,15
19020,Yasheaa,ysondre,1020,mage,frost,23,11,12
19021,Tiefkühler,norgannon,1019,mage,frost,36,19,17
19022,Icyshot,blackhand,1019,mage,frost,24,11,13
19023,Gønzô,blackmoore,1018,mage,frost,49,21,28
19024,Dumbledores,aegwynn,1018,mage,frost,59,25,34
19025,Sântillius,twisting-nether,1016,mage,frost,18,11,7
19026,Pinguíni,aegwynn,1015,mage,frost,54,25,29
19027,Shíntaro,stormscale,1013,mage,frost,41,12,29
19028,Fôôxy,aegwynn,1009,mage,frost,29,11,18
19029,Илайла,booty-bay,1007,mage,frost,15,12,3
19030,Fashes,sunstrider,1006,mage,frost,81,40,41
19031,Smõóve,hyjal,1005,mage,frost,84,32,52
19032,Thalaja,kazzak,1005,mage,frost,29,11,18
19033,Rusdor,frostwhisper,1000,mage,frost,42,13,29
19034,Этридемус,howling-fjord,1000,mage,frost,42,11,31
19035,Фрайбл,gordunni,997,mage,frost,25,12,13
19036,Erzà,todeswache,991,mage,frost,35,18,17
19037,Labyssra,argent-dawn,990,mage,frost,20,11,9
19038,Kumakara,archimonde,981,mage,frost,24,12,12
19039,Дроййд,gordunni,981,mage,frost,52,14,38
19040,Didub,outland,977,mage,frost,36,13,23
19041,Dnt,twilights-hammer,974,mage,frost,24,11,13
19042,Schtenen,silvermoon,971,mage,frost,192,88,104
19043,Zedsdeadbaby,argent-dawn,968,mage,frost,67,31,36
19044,Acx,drakthul,960,mage,frost,18,10,8
19045,Cosmostms,ravencrest,960,mage,frost,18,10,8
19046,Oblív,ravencrest,960,mage,frost,24,10,14
19047,Reákan,ragnaros,959,mage,frost,18,10,8
19048,Brolyzerr,archimonde,959,mage,frost,19,10,9
19049,Тортикток,soulflayer,959,mage,frost,24,10,14
19050,Spacehoe,stormscale,959,mage,frost,24,10,14
19051,Kyrox,ysondre,959,mage,frost,42,12,30
19052,Spellfaker,drakthul,958,mage,frost,12,10,2
19053,Джинетикс,deathguard,958,mage,frost,18,10,8
19054,Pølåris,outland,958,mage,frost,18,10,8
19055,Javelintouch,eldrethalas,957,mage,frost,18,10,8
19056,Doidadetanga,aggra-português,957,mage,frost,24,10,14
19057,Widurr,burning-legion,956,mage,frost,24,10,14
19058,Соорка,gordunni,956,mage,frost,24,10,14
19059,Zenó,blackrock,956,mage,frost,30,10,20
19060,Gyanni,blackmoore,955,mage,frost,18,10,8
19061,Anthrex,drakthul,955,mage,frost,24,10,14
19062,Grismage,twisting-nether,955,mage,frost,36,10,26
19063,Bambaga,kazzak,954,mage,frost,24,10,14
19064,Vamelia,blackmoore,953,mage,frost,54,22,32
19065,Dollzer,khaz-modan,952,mage,frost,18,10,8
19066,Adagar,chamber-of-aspects,952,mage,frost,24,10,14
19067,Xaerow,archimonde,951,mage,frost,18,10,8
19068,Jobarttrach,les-clairvoyants,951,mage,frost,138,70,68
19069,Ezzekkiel,elune,951,mage,frost,24,12,12
19070,Бабайбайкала,gordunni,951,mage,frost,36,10,26
19071,Haljina,kazzak,949,mage,frost,255,117,138
19072,Celdra,blackrock,949,mage,frost,24,10,14
19073,Shanny,argent-dawn,948,mage,frost,18,10,8
19074,Maybeblood,kazzak,946,mage,frost,28,11,17
19075,Frisstana,outland,946,mage,frost,30,10,20
19076,Evuryl,nemesis,944,mage,frost,24,10,14
19077,Helloimgone,blackmoore,943,mage,frost,23,10,13
19078,Neboonu,sylvanas,942,mage,frost,42,19,23
19079,Chogger,blackmoore,938,mage,frost,30,17,13
19080,Fujitoras,khaz-modan,938,mage,frost,54,25,29
19081,Xæl,ravencrest,929,mage,frost,87,44,43
19082,Speedshatter,aegwynn,928,mage,frost,22,10,12
19083,Мосгормаг,gordunni,924,mage,frost,23,10,13
19084,Qwibbly,kazzak,921,mage,frost,17,10,7
19085,Pyro,eldrethalas,918,mage,frost,32,11,21
19086,Teals,turalyon,915,mage,frost,48,16,32
19087,Piego,turalyon,913,mage,frost,70,37,33
19088,Døliprane,garona,911,mage,frost,54,28,26
19089,Toxttr,drakthul,908,mage,frost,18,11,7
19090,Magicoliwia,ysera,905,mage,frost,30,16,14
19091,Tvångstralla,tarren-mill,905,mage,frost,21,11,10
19092,Mutly,kazzak,900,mage,frost,20,11,9
19093,Ттэль,gordunni,899,mage,frost,46,23,23
19094,Misscandy,doomhammer,898,mage,frost,79,35,44
19095,Мрперут,eversong,895,mage,frost,125,64,61
19096,Funnyzowie,minahonda,895,mage,frost,20,10,10
19097,Pickaachu,doomhammer,893,mage,frost,30,15,15
19098,Çana,thrall,893,mage,frost,22,10,12
19099,Frostspree,wildhammer,892,mage,frost,20,10,10
19100,Wopi,sylvanas,890,mage,frost,36,13,23
19101,Êmmá,blackmoore,885,mage,frost,54,22,32
19102,Heavyfire,kazzak,884,mage,frost,23,12,11
19103,Sammelbot,kargath,872,mage,frost,48,24,24
19104,Lexalia,blackmoore,869,mage,frost,32,14,18
19105,Venu,dun-modr,866,mage,frost,36,17,19
19106,Zauberdose,blackhand,864,mage,frost,12,9,3
19107,Fakeklepter,sylvanas,864,mage,frost,12,9,3
19108,Andors,conseil-des-ombres,864,mage,frost,18,9,9
19109,Mizt,ragnaros,864,mage,frost,24,9,15
19110,Qtpoof,sylvanas,863,mage,frost,18,9,9
19111,Qqcult,ravencrest,863,mage,frost,18,9,9
19112,Мирикон,gordunni,863,mage,frost,18,9,9
19113,Næj,hyjal,863,mage,frost,18,9,9
19114,Авгурей,howling-fjord,863,mage,frost,18,9,9
19115,Musé,kazzak,863,mage,frost,18,9,9
19116,Rodeyy,nathrezim,863,mage,frost,18,9,9
19117,Слизерин,gordunni,863,mage,frost,24,9,15
19118,Muchmage,silvermoon,863,mage,frost,24,9,15
19119,Darkseidez,alonsus,862,mage,frost,18,9,9
19120,Манднесс,azuregos,861,mage,frost,18,9,9
19121,Souleh,ravencrest,861,mage,frost,18,9,9
19122,Strychne,ragnaros,860,mage,frost,12,9,3
19123,Raikøn,blackmoore,860,mage,frost,18,9,9
19124,Noviina,argent-dawn,860,mage,frost,18,9,9
19125,Cybercommand,blackmoore,860,mage,frost,31,15,16
19126,Zanazanelor,twisting-nether,859,mage,frost,18,9,9
19127,Ilikepoly,blackmoore,859,mage,frost,18,9,9
19128,Amazona,veklor,859,mage,frost,38,18,20
19129,Lylla,cthun,859,mage,frost,24,9,15
19130,Klésh,nemesis,858,mage,frost,18,9,9
19131,Naote,blackhand,858,mage,frost,18,9,9
19132,Aûrûm,silvermoon,858,mage,frost,24,9,15
19133,Vexperious,tarren-mill,857,mage,frost,12,9,3
19134,Markasaura,kazzak,856,mage,frost,38,11,27
19135,Voralastor,doomhammer,855,mage,frost,12,9,3
19136,Nargaroc,blackhand,855,mage,frost,24,9,15
19137,Farrä,dun-modr,854,mage,frost,53,26,27
19138,Narzoul,ysondre,849,mage,frost,18,9,9
19139,Банана,lich-king,847,mage,frost,18,9,9
19140,Madzía,ravencrest,842,mage,frost,33,16,17
19141,Ghostgivree,archimonde,839,mage,frost,54,24,30
19142,Лордбелиал,soulflayer,834,mage,frost,24,9,15
19143,Rintoh,pozzo-delleternità,828,mage,frost,30,9,21
19144,Eìnì,kazzak,815,mage,frost,17,9,8
19145,Zenoss,khaz-modan,815,mage,frost,42,18,24
19146,Aerius,lightnings-blade,813,mage,frost,21,9,12
19147,Lemonshelo,archimonde,806,mage,frost,27,9,18
19148,Frigus,khaz-modan,804,mage,frost,27,9,18
19149,Hooffer,stormscale,797,mage,frost,28,9,19
19150,Rusdorcito,frostwhisper,793,mage,frost,25,10,15
19151,Margistikus,die-aldor,776,mage,frost,111,57,54
19152,Rillia,argent-dawn,768,mage,frost,12,8,4
19153,Утрус,soulflayer,768,mage,frost,12,8,4
19154,Arunx,magtheridon,768,mage,frost,12,8,4
19155,Botanicula,the-maelstrom,768,mage,frost,12,8,4
19156,Procahontas,ravencrest,768,mage,frost,12,8,4
19157,Drmng,stormscale,768,mage,frost,12,8,4
19158,Séxmachiné,draenor,768,mage,frost,12,8,4
19159,Ascik,dalaran,768,mage,frost,12,8,4
19160,Ambulancex,kazzak,768,mage,frost,12,8,4
19161,Subzeraxo,archimonde,768,mage,frost,12,8,4
19162,Serclulz,ravencrest,768,mage,frost,12,8,4
19163,Trashmage,blackrock,768,mage,frost,12,8,4
19164,Väänik,draenor,768,mage,frost,18,8,10
19165,Transformo,draenor,768,mage,frost,18,8,10
19166,Terash,ravencrest,768,mage,frost,18,8,10
19167,Nelfchewer,ravencrest,768,mage,frost,18,8,10
19168,Mðj,kazzak,768,mage,frost,18,8,10
19169,Styxmg,blackhand,768,mage,frost,18,8,10
19170,Гдедипфриз,soulflayer,768,mage,frost,18,8,10
19171,Frígíd,outland,768,mage,frost,18,8,10
19172,Bumboozling,kazzak,768,mage,frost,18,8,10
19173,Venque,blackrock,768,mage,frost,24,8,16
19174,Zelimeth,outland,768,mage,frost,24,8,16
19175,Blinkfloyd,blackmoore,768,mage,frost,24,8,16
19176,Wambamm,ravencrest,768,mage,frost,24,8,16
19177,Gagaj,ravencrest,767,mage,frost,12,8,4
19178,Chicke,outland,767,mage,frost,12,8,4
19179,Zili,draenor,767,mage,frost,12,8,4
19180,Tajos,drakthul,767,mage,frost,12,8,4
19181,Нуклер,howling-fjord,767,mage,frost,12,8,4
19182,Экструдия,gordunni,767,mage,frost,12,8,4
19183,Lumberth,sanguino,767,mage,frost,12,8,4
19184,Opíum,tarren-mill,767,mage,frost,12,8,4
19185,Bamz,malganis,767,mage,frost,18,8,10
19186,Goodheadcake,ragnaros,767,mage,frost,18,8,10
19187,Autramage,emerald-dream,767,mage,frost,18,8,10
19188,Archyl,kazzak,767,mage,frost,18,8,10
19189,Khorosho,draenor,767,mage,frost,24,8,16
19190,Vinlimar,drakthul,767,mage,frost,24,8,16
19191,Maximilian,pozzo-delleternità,767,mage,frost,24,8,16
19192,Insanewizard,kazzak,766,mage,frost,12,8,4
19193,Thorstäin,ragnaros,766,mage,frost,12,8,4
19194,Anoez,kargath,766,mage,frost,18,8,10
19195,Illiaria,antonidas,765,mage,frost,12,8,4
19196,Ærrflôw,frostwolf,765,mage,frost,18,8,10
19197,Partagedeco,dalaran,765,mage,frost,18,8,10
19198,Xakiha,kazzak,764,mage,frost,18,8,10
19199,Шанлис,gordunni,763,mage,frost,18,8,10
19200,Skarxaa,sanguino,763,mage,frost,18,8,10
19201,Кельтузат,azuregos,762,mage,frost,12,8,4
19202,Dominos,medivh,762,mage,frost,18,8,10
19203,Archilól,drakthul,762,mage,frost,18,8,10
19204,Полеморв,soulflayer,761,mage,frost,18,8,10
19205,Edwiin,dun-morogh,761,mage,frost,33,9,24
19206,Gedzi,silvermoon,758,mage,frost,12,8,4
19207,Tomjedusor,hyjal,757,mage,frost,12,8,4
19208,Gnoumen,shadowsong,755,mage,frost,18,8,10
19209,Мерджреквест,howling-fjord,745,mage,frost,17,8,9
19210,Qqlool,draenor,735,mage,frost,23,8,15
19211,Amalou,stormscale,729,mage,frost,32,9,23
19212,Mumpii,blackrock,719,mage,frost,17,8,9
19213,Clitch,blutkessel,715,mage,frost,20,9,11
19214,Чогоце,eversong,715,mage,frost,66,19,47
19215,Coldnight,uldum,712,mage,frost,25,9,16
19216,Kaeki,khaz-modan,708,mage,frost,20,10,10
19217,Scoxywoxy,ragnaros,708,mage,frost,22,10,12
19218,Thamagus,burning-legion,702,mage,frost,17,9,8
19219,Tjayy,kazzak,702,mage,frost,26,8,18
19220,Rayniß,blackmoore,702,mage,frost,26,8,18
19221,Щавзорву,gordunni,686,mage,frost,16,8,8
19222,Lanere,argent-dawn,684,mage,frost,19,8,11
19223,Atreu,mazrigos,684,mage,frost,26,10,16
19224,Icéy,kazzak,672,mage,frost,12,7,5
19225,Fîsheye,blackrock,672,mage,frost,12,7,5
19226,Wortyvery,outland,672,mage,frost,12,7,5
19227,Gizzoo,draenor,672,mage,frost,12,7,5
19228,Lyès,uldaman,672,mage,frost,12,7,5
19229,Альмодера,gordunni,672,mage,frost,12,7,5
19230,Monkeydmafia,blackrock,672,mage,frost,12,7,5
19231,Glindalefay,silvermoon,672,mage,frost,12,7,5
19232,Agus,ravencrest,672,mage,frost,12,7,5
19233,Hérä,archimonde,672,mage,frost,12,7,5
19234,Birckin,sanguino,672,mage,frost,12,7,5
19235,Gøsu,rexxar,672,mage,frost,12,7,5
19236,Yobys,burning-legion,672,mage,frost,12,7,5
19237,Hendersson,blackrock,672,mage,frost,12,7,5
19238,Schmutzki,eredar,672,mage,frost,12,7,5
19239,Skyblink,hyjal,672,mage,frost,12,7,5
19240,Candydead,alakir,672,mage,frost,12,7,5
19241,Njl,blackmoore,672,mage,frost,12,7,5
19242,Viro,defias-brotherhood,672,mage,frost,15,8,7
19243,Drwrey,tarren-mill,672,mage,frost,18,7,11
19244,Dalaras,archimonde,672,mage,frost,18,7,11
19245,Mezaiyh,blackmoore,672,mage,frost,18,7,11
19246,Lillelord,defias-brotherhood,672,mage,frost,18,7,11
19247,Drandis,blackmoore,672,mage,frost,18,7,11
19248,Løgi,drakthul,672,mage,frost,18,7,11
19249,Mageyreid,quelthalas,672,mage,frost,18,7,11
19250,Azegodxlul,kazzak,672,mage,frost,18,7,11
19251,Aterso,azshara,672,mage,frost,21,8,13
19252,Krookéd,tarren-mill,672,mage,frost,24,7,17
19253,Wàneís,ravencrest,672,mage,frost,24,7,17
19254,Tabueno,kazzak,672,mage,frost,24,7,17
19255,Митгори,gordunni,671,mage,frost,12,7,5
19256,Ellyson,silvermoon,671,mage,frost,12,7,5
19257,Broccosoup,kazzak,671,mage,frost,12,7,5
19258,Badphaz,frostmane,671,mage,frost,12,7,5
19259,Møstwãntêd,aegwynn,671,mage,frost,12,7,5
19260,Microsmag,thrall,671,mage,frost,12,7,5
19261,Kokenn,hyjal,671,mage,frost,12,7,5
19262,Geepie,twisting-nether,671,mage,frost,12,7,5
19263,Мэлфариус,soulflayer,671,mage,frost,18,7,11
19264,Hardways,archimonde,671,mage,frost,18,7,11
19265,Crayz,magtheridon,671,mage,frost,18,7,11
19266,Primodious,kazzak,671,mage,frost,18,7,11
19267,Finkle,spinebreaker,671,mage,frost,18,7,11
19268,Ice,sargeras,671,mage,frost,18,7,11
19269,Kyrn,zuljin,671,mage,frost,18,7,11
19270,Chread,bronze-dragonflight,671,mage,frost,18,7,11
19271,Fyriel,burning-legion,671,mage,frost,18,7,11
19272,Antaos,drakthul,671,mage,frost,18,7,11
19273,Edelvise,azjolnerub,671,mage,frost,30,7,23
19274,Cns,tarren-mill,670,mage,frost,12,7,5
19275,Suitx,draenor,670,mage,frost,12,7,5
19276,Hotpotatox,ravencrest,670,mage,frost,13,7,6
19277,Комонщик,howling-fjord,670,mage,frost,18,7,11
19278,Ronnyraggare,silvermoon,670,mage,frost,18,7,11
19279,Misskity,blackrock,670,mage,frost,18,7,11
19280,Unreadyx,archimonde,670,mage,frost,18,7,11
19281,Placidius,twisting-nether,670,mage,frost,18,7,11
19282,Nery,ravencrest,670,mage,frost,18,7,11
19283,Quaile,malygos,670,mage,frost,24,7,17
19284,Crematorium,argent-dawn,669,mage,frost,19,7,12
19285,Allotropia,ravencrest,668,mage,frost,18,7,11
19286,Aériza,silvermoon,667,mage,frost,12,7,5
19287,Bolthen,uldum,667,mage,frost,24,7,17
19288,Yojimbot,archimonde,667,mage,frost,36,7,29
19289,Vurtnez,kazzak,665,mage,frost,15,7,8
19290,Listro,argent-dawn,664,mage,frost,12,7,5
19291,Madbad,auchindoun,662,mage,frost,18,7,11
19292,Sinanogan,draenor,658,mage,frost,24,7,17
19293,Xatures,tarren-mill,653,mage,frost,23,7,16
19294,Expulse,blackmoore,639,mage,frost,11,7,4
19295,Escobar,frostmane,622,mage,frost,26,8,18
19296,Skæde,ravencrest,618,mage,frost,17,11,6
19297,Svanteg,kazzak,618,mage,frost,14,8,6
19298,Hidrax,outland,617,mage,frost,15,9,6
19299,Jockin,stormrage,616,mage,frost,19,8,11
19300,Ioriyagami,dragonmaw,608,mage,frost,22,7,15
19301,Sleîhg,sanguino,607,mage,frost,16,7,9
19302,Tharillion,drakthul,606,mage,frost,14,7,7
19303,Estonka,ravencrest,576,mage,frost,6,6,0
19304,Escapematrix,ravencrest,576,mage,frost,6,6,0
19305,Necro,zuljin,576,mage,frost,6,6,0
19306,Sölø,stormscale,576,mage,frost,6,6,0
19307,Kurtcobain,draenor,576,mage,frost,12,6,6
19308,Ouija,kazzak,576,mage,frost,12,6,6
19309,Sainth,sanguino,576,mage,frost,12,6,6
19310,Сизаам,howling-fjord,576,mage,frost,12,6,6
19311,Søo,kazzak,576,mage,frost,12,6,6
19312,Skdroople,ravencrest,576,mage,frost,12,6,6
19313,Shifteurprõ,hyjal,576,mage,frost,12,6,6
19314,Magicdingo,lightnings-blade,576,mage,frost,12,6,6
19315,Azrx,blackmoore,576,mage,frost,12,6,6
19316,Caststuffatu,sylvanas,576,mage,frost,12,6,6
19317,Alirya,stormscale,576,mage,frost,12,6,6
19318,Alcatrax,bronze-dragonflight,576,mage,frost,12,6,6
19319,Dumblemore,ragnaros,576,mage,frost,12,6,6
19320,Sickofme,blackmoore,576,mage,frost,12,6,6
19321,Titarie,ravencrest,576,mage,frost,12,6,6
19322,Watchmylance,blackrock,576,mage,frost,12,6,6
19323,Froststarr,burning-legion,576,mage,frost,12,6,6
19324,Диппро,soulflayer,576,mage,frost,12,6,6
19325,Elgriefo,sylvanas,576,mage,frost,12,6,6
19326,Ecnaclappy,blackrock,576,mage,frost,12,6,6
19327,Invinsible,xavius,576,mage,frost,12,6,6
19328,Рамблз,gordunni,576,mage,frost,12,6,6
19329,Kanjani,antonidas,576,mage,frost,12,6,6
19330,Halfanapple,the-maelstrom,576,mage,frost,12,6,6
19331,Nécrømage,confrérie-du-thorium,576,mage,frost,12,6,6
19332,Creden,frostmane,576,mage,frost,12,6,6
19333,Миллерфест,howling-fjord,576,mage,frost,12,6,6
19334,Jakora,bronze-dragonflight,576,mage,frost,12,6,6
19335,Wheí,ravencrest,576,mage,frost,12,6,6
19336,Insømnium,stormscale,576,mage,frost,12,6,6
19337,Lepronsito,kazzak,576,mage,frost,12,6,6
19338,Wickedblink,ravencrest,576,mage,frost,12,6,6
19339,Zikyo,silvermoon,576,mage,frost,18,6,12
19340,Articunoh,ravencrest,576,mage,frost,18,6,12
19341,Reeroll,arthas,576,mage,frost,18,6,12
19342,Деметрадон,gordunni,576,mage,frost,18,6,12
19343,Ury,hyjal,576,mage,frost,18,6,12
19344,Shakeándbake,ravencrest,576,mage,frost,18,6,12
19345,Wenndrid,draenor,576,mage,frost,24,6,18
19346,Poter,silvermoon,575,mage,frost,12,6,6
19347,Depai,blackrock,575,mage,frost,12,6,6
19348,Zulko,krasus,575,mage,frost,12,6,6
19349,Pitbones,archimonde,575,mage,frost,12,6,6
19350,Tyronesbone,stormscale,575,mage,frost,12,6,6
19351,Jokèr,silvermoon,575,mage,frost,12,6,6
19352,Yvonnita,chamber-of-aspects,575,mage,frost,12,6,6
19353,Cafcaf,archimonde,575,mage,frost,12,6,6
19354,Razzìatore,pozzo-delleternità,575,mage,frost,13,6,7
19355,Длинныеухи,blackscar,575,mage,frost,18,6,12
19356,Saturator,burning-legion,575,mage,frost,18,6,12
19357,Bloodymage,zenedar,575,mage,frost,18,6,12
19358,Kaptenski,stormscale,575,mage,frost,24,6,18
19359,Crashleaf,argent-dawn,575,mage,frost,24,6,18
19360,Zyxiie,sylvanas,575,mage,frost,24,6,18
19361,Panlong,twisting-nether,574,mage,frost,12,6,6
19362,Вхламинка,howling-fjord,574,mage,frost,12,6,6
19363,Larsimore,drakthul,574,mage,frost,12,6,6
19364,Bhaâl,hyjal,574,mage,frost,12,6,6
19365,Galdrari,sylvanas,574,mage,frost,12,6,6
19366,Pumpzy,tarren-mill,574,mage,frost,18,6,12
19367,Stilnox,nemesis,574,mage,frost,18,6,12
19368,Piscialetto,nemesis,572,mage,frost,18,6,12
19369,Oryom,blackhand,566,mage,frost,12,6,6
19370,Hadziaj,doomhammer,565,mage,frost,30,6,24
19371,Soulcatcheus,archimonde,560,mage,frost,24,6,18
19372,Maran,outland,555,mage,frost,24,6,18
19373,Løxyy,ysondre,543,mage,frost,14,7,7
19374,Meign,eredar,537,mage,frost,22,8,14
19375,Mínêrvâ,blackrock,528,mage,frost,15,7,8
19376,Lidin,draenor,527,mage,frost,11,6,5
19377,Arcanom,azjolnerub,527,mage,frost,11,6,5
19378,Avb,twisting-nether,527,mage,frost,17,6,11
19379,Nøxas,archimonde,527,mage,frost,17,6,11
19380,Xyhno,eredar,519,mage,frost,13,7,6
19381,Tschelo,eredar,512,mage,frost,16,6,10
19382,Kukerr,burning-legion,511,mage,frost,16,6,10
19383,Miihawkk,khaz-modan,510,mage,frost,20,6,14
19384,Magicstorm,anubarak,504,mage,frost,16,6,10
19385,Magipus,anetheron,496,mage,frost,20,6,14
19386,Шеллестун,soulflayer,495,mage,frost,13,6,7
19387,Trøll,nemesis,480,mage,frost,6,5,1
19388,Frostmyst,outland,480,mage,frost,6,5,1
19389,Мэдраша,gordunni,480,mage,frost,6,5,1
19390,Cumburlok,silvermoon,480,mage,frost,6,5,1
19391,Chucknoir,draenor,480,mage,frost,6,5,1
19392,Zehnvonzehn,antonidas,480,mage,frost,6,5,1
19393,Barryscótt,stormscale,480,mage,frost,6,5,1
19394,Driana,dragonmaw,480,mage,frost,6,5,1
19395,Veemi,blackmoore,480,mage,frost,6,5,1
19396,Magnopvp,sanguino,480,mage,frost,10,6,4
19397,Moleester,twisting-nether,480,mage,frost,12,5,7
19398,Zaurok,sanguino,480,mage,frost,12,5,7
19399,Vapurx,blackmoore,480,mage,frost,12,5,7
19400,Funkyfriday,twisting-nether,480,mage,frost,12,5,7
19401,Okey,frostwhisper,480,mage,frost,12,5,7
19402,Betomage,blackmoore,480,mage,frost,12,5,7
19403,Reznøør,confrérie-du-thorium,480,mage,frost,12,5,7
19404,Manôu,kirin-tor,480,mage,frost,12,5,7
19405,Лрее,gordunni,480,mage,frost,12,5,7
19406,Kleptomania,archimonde,480,mage,frost,12,5,7
19407,Alytà,ravencrest,480,mage,frost,12,5,7
19408,Barzle,blackmoore,480,mage,frost,12,5,7
19409,Beardyman,haomarush,480,mage,frost,12,5,7
19410,Médivh,archimonde,480,mage,frost,12,5,7
19411,Spell,blackmoore,480,mage,frost,12,5,7
19412,Burnit,dalaran,480,mage,frost,12,5,7
19413,Marikisanx,blackmoore,480,mage,frost,12,5,7
19414,Milkenjoyer,ravencrest,480,mage,frost,12,5,7
19415,Homper,argent-dawn,480,mage,frost,12,5,7
19416,Javellja,ravencrest,480,mage,frost,12,5,7
19417,Chrømy,twisting-nether,480,mage,frost,12,5,7
19418,Moffmage,sylvanas,480,mage,frost,12,5,7
19419,Trevise,ravencrest,480,mage,frost,12,5,7
19420,Leontus,outland,480,mage,frost,12,5,7
19421,Gàtsby,outland,480,mage,frost,12,5,7
19422,Maestrá,outland,480,mage,frost,12,5,7
19423,Deathcast,ravencrest,480,mage,frost,12,5,7
19424,Shirrunn,the-maelstrom,480,mage,frost,12,5,7
19425,Magenox,blackrock,480,mage,frost,12,5,7
19426,Thelastmage,outland,480,mage,frost,12,5,7
19427,Ikefire,draenor,480,mage,frost,12,5,7
19428,Snaapz,kazzak,480,mage,frost,18,5,13
19429,Xoouuboo,eredar,480,mage,frost,18,5,13
19430,Wukidiwn,draenor,480,mage,frost,18,5,13
19431,Vioulette,elune,480,mage,frost,18,5,13
19432,Шипкастермвп,howling-fjord,480,mage,frost,18,5,13
19433,Арара,gordunni,480,mage,frost,18,5,13
19434,Roberx,sanguino,480,mage,frost,18,5,13
19435,Reblink,draenor,480,mage,frost,18,5,13
19436,Kyraja,arthas,480,mage,frost,24,5,19
19437,Intêrnet,archimonde,480,mage,frost,26,5,21
19438,Restinnpiss,twisting-nether,479,mage,frost,6,5,1
19439,Шиллаа,blackscar,479,mage,frost,12,5,7
19440,Kalterfurz,thrall,479,mage,frost,12,5,7
19441,Xýton,azjolnerub,479,mage,frost,12,5,7
19442,Coldstormz,terenas,479,mage,frost,12,5,7
19443,Промагер,gordunni,479,mage,frost,12,5,7
19444,Zionara,stormscale,479,mage,frost,12,5,7
19445,Brutal,thrall,479,mage,frost,12,5,7
19446,Whitestiev,antonidas,479,mage,frost,12,5,7
19447,Deletron,ragnaros,479,mage,frost,18,5,13
19448,Líquiçìty,ragnaros,479,mage,frost,18,5,13
19449,Feuerflamme,theradras,478,mage,frost,12,5,7
19450,Потныйдпс,eversong,478,mage,frost,16,6,10
19451,Furoranight,malfurion,477,mage,frost,12,5,7
19452,Polflop,sylvanas,476,mage,frost,12,5,7
19453,Rifinouu,archimonde,476,mage,frost,12,5,7
19454,Phibonaci,sylvanas,475,mage,frost,12,5,7
19455,Blinkinggoat,ragnaros,448,mage,frost,16,5,11
19456,Azadan,pozzo-delleternità,447,mage,frost,11,5,6
19457,Saytmage,ragnaros,447,mage,frost,17,5,12
19458,Swemagus,outland,432,mage,frost,9,5,4
19459,Dozono,silvermoon,428,mage,frost,15,5,10
19460,Euklid,ravencrest,416,mage,frost,10,5,5
19461,Substitutes,draenor,415,mage,frost,14,5,9
19462,Торар,deathguard,415,mage,frost,16,5,11
19463,Xerathon,ravencrest,414,mage,frost,16,5,11
19464,Leylus,blackmoore,399,mage,frost,5,5,0
19465,Màgí,stormscale,384,mage,frost,6,4,2
19466,Pinkusbruh,aggra-português,384,mage,frost,6,4,2
19467,Вулльф,gordunni,384,mage,frost,6,4,2
19468,Friedkek,ravencrest,384,mage,frost,6,4,2
19469,Doryy,silvermoon,384,mage,frost,6,4,2
19470,Sylvîe,tarren-mill,384,mage,frost,6,4,2
19471,Shatterdude,kazzak,384,mage,frost,6,4,2
19472,Anev,sylvanas,384,mage,frost,6,4,2
19473,Fuhry,tarren-mill,384,mage,frost,6,4,2
19474,Nightcàller,pozzo-delleternità,384,mage,frost,6,4,2
19475,Willmajacki,blackmoore,384,mage,frost,6,4,2
19476,Fontaíne,doomhammer,384,mage,frost,6,4,2
19477,Proudmøøre,argent-dawn,384,mage,frost,6,4,2
19478,Gravelegacy,quelthalas,384,mage,frost,6,4,2
19479,Ón,burning-steppes,384,mage,frost,6,4,2
19480,Jodíefroster,doomhammer,384,mage,frost,6,4,2
19481,Ahøllic,frostwolf,384,mage,frost,6,4,2
19482,Leonora,blackhand,384,mage,frost,6,4,2
19483,Arcitech,tarren-mill,384,mage,frost,6,4,2
19484,Sneakii,the-maelstrom,384,mage,frost,6,4,2
19485,Nötmârtònxø,ragnaros,384,mage,frost,6,4,2
19486,Cesi,silvermoon,384,mage,frost,6,4,2
19487,Поэтик,soulflayer,384,mage,frost,6,4,2
19488,Zerobelow,silvermoon,384,mage,frost,6,4,2
19489,Elor,eredar,384,mage,frost,12,4,8
19490,Newtwo,ravencrest,384,mage,frost,12,4,8
19491,Fikkamika,ragnaros,384,mage,frost,12,4,8
19492,Luckydo,turalyon,384,mage,frost,12,4,8
19493,Proffset,outland,384,mage,frost,12,4,8
19494,Johnnyblazin,outland,384,mage,frost,12,4,8
19495,Querasimar,blackrock,384,mage,frost,12,4,8
19496,Jazzi,blackrock,384,mage,frost,12,4,8
19497,Mobjar,twisting-nether,384,mage,frost,12,4,8
19498,Tarovan,defias-brotherhood,384,mage,frost,12,4,8
19499,Facerollyo,tarren-mill,384,mage,frost,12,4,8
19500,Managurke,blackrock,384,mage,frost,12,4,8
19501,Kaschnatze,blackmoore,384,mage,frost,12,4,8
19502,Wwjd,darksorrow,384,mage,frost,12,4,8
19503,Yajimage,archimonde,384,mage,frost,12,4,8
19504,Stærq,blackrock,384,mage,frost,12,4,8
19505,Kuhwar,echsenkessel,384,mage,frost,12,4,8
19506,Bloodycast,archimonde,384,mage,frost,12,4,8
19507,Babyboyj,blackmoore,384,mage,frost,12,4,8
19508,Mopus,ravencrest,384,mage,frost,12,4,8
19509,Ðarkreaver,kaelthas,384,mage,frost,12,4,8
19510,Muntiks,ravencrest,384,mage,frost,12,4,8
19511,Acclay,malganis,384,mage,frost,12,4,8
19512,Зефенжо,howling-fjord,384,mage,frost,12,4,8
19513,Stellarie,sylvanas,384,mage,frost,12,4,8
19514,Юджегс,soulflayer,384,mage,frost,12,4,8
19515,Lambaa,thrall,384,mage,frost,12,4,8
19516,Gnðmeonfire,sylvanas,384,mage,frost,12,4,8
19517,Пламяорды,soulflayer,384,mage,frost,12,4,8
19518,Faunas,kazzak,384,mage,frost,12,4,8
19519,Ruténa,aegwynn,384,mage,frost,18,4,14
19520,Бигдикмаг,soulflayer,384,mage,frost,18,4,14
19521,Blinkmehome,silvermoon,384,mage,frost,18,4,14
19522,Ripdeepfreez,culte-de-la-rive-noire,384,mage,frost,18,4,14
19523,Cavadrex,arathor,384,mage,frost,18,4,14
19524,Gylith,kirin-tor,384,mage,frost,18,4,14
19525,Waîdø,blackhand,383,mage,frost,6,4,2
19526,Capyla,blackmoore,383,mage,frost,6,4,2
19527,Xblaze,balnazzar,383,mage,frost,6,4,2
19528,Wuffwuffspik,grim-batol,383,mage,frost,6,4,2
19529,Juntara,stormscale,383,mage,frost,12,4,8
19530,Труупоед,borean-tundra,383,mage,frost,12,4,8
19531,Скватро,gordunni,383,mage,frost,12,4,8
19532,Brandonjames,ragnaros,383,mage,frost,12,4,8
19533,Xenodike,blackrock,383,mage,frost,12,4,8
19534,Ashkalor,frostwolf,383,mage,frost,17,4,13
19535,Asnesh,silvermoon,383,mage,frost,18,4,14
19536,Malicä,ravencrest,383,mage,frost,30,4,26
19537,Bibidibabidi,nefarian,382,mage,frost,6,4,2
19538,Skankengine,twisting-nether,382,mage,frost,12,4,8
19539,Bisuke,stormscale,367,mage,frost,11,4,7
19540,Whosthemage,kazzak,351,mage,frost,8,5,3
19541,Nebby,argent-dawn,351,mage,frost,11,4,7
19542,Møøk,magtheridon,336,mage,frost,15,4,11
19543,Tsubas,blackmoore,330,mage,frost,15,5,10
19544,Consquens,aszune,330,mage,frost,18,5,13
19545,Regenn,kazzak,318,mage,frost,5,4,1
19546,Aestus,outland,288,mage,frost,6,3,3
19547,Овеча,gordunni,288,mage,frost,6,3,3
19548,Equálity,blackrock,288,mage,frost,6,3,3
19549,Rèkt,lightbringer,288,mage,frost,6,3,3
19550,Snowberry,blackrock,288,mage,frost,6,3,3
19551,Нефростмаг,gordunni,288,mage,frost,6,3,3
19552,Xlarb,kazzak,288,mage,frost,6,3,3
19553,Ballesteinen,outland,288,mage,frost,6,3,3
19554,Тейемор,gordunni,288,mage,frost,6,3,3
19555,Bóósh,alakir,288,mage,frost,6,3,3
19556,Halø,bloodhoof,288,mage,frost,6,3,3
19557,Siérra,outland,288,mage,frost,6,3,3
19558,Eliosia,drakthul,288,mage,frost,6,3,3
19559,Arandartis,kazzak,288,mage,frost,6,3,3
19560,Olzaa,outland,288,mage,frost,6,3,3
19561,Gladxp,outland,288,mage,frost,6,3,3
19562,Swayyx,sylvanas,288,mage,frost,6,3,3
19563,Fboltprocd,ragnaros,288,mage,frost,6,3,3
19564,Tommyboy,dragonblight,288,mage,frost,6,3,3
19565,Kimfjongmajs,silvermoon,288,mage,frost,6,3,3
19566,Gotone,tarren-mill,288,mage,frost,6,3,3
19567,Blitzo,madmortem,288,mage,frost,6,3,3
19568,Amaterâsu,antonidas,288,mage,frost,6,3,3
19569,Brunettdelux,archimonde,288,mage,frost,6,3,3
19570,Sozie,tarren-mill,288,mage,frost,6,3,3
19571,Blåskjell,kazzak,288,mage,frost,6,3,3
19572,Narcîsa,sanguino,288,mage,frost,6,3,3
19573,Hotpockets,die-aldor,288,mage,frost,6,3,3
19574,Айсъмэджик,azuregos,288,mage,frost,6,3,3
19575,Bigburns,draenor,288,mage,frost,6,3,3
19576,Сайджена,howling-fjord,288,mage,frost,6,3,3
19577,Meras,die-ewige-wacht,288,mage,frost,6,3,3
19578,Muuckie,blackrock,288,mage,frost,6,3,3
19579,Ковенн,howling-fjord,288,mage,frost,6,3,3
19580,Justvik,eredar,288,mage,frost,6,3,3
19581,Askannor,norgannon,288,mage,frost,6,3,3
19582,Волшебну,soulflayer,288,mage,frost,6,3,3
19583,Frökenfrost,stormscale,288,mage,frost,6,3,3
19584,Nevertøxic,ravencrest,288,mage,frost,6,3,3
19585,Verygoodgame,blackrock,288,mage,frost,6,3,3
19586,Frostandrew,twisting-nether,288,mage,frost,6,3,3
19587,Kebkhadar,ravencrest,288,mage,frost,6,3,3
19588,Ørixx,blackhand,288,mage,frost,6,3,3
19589,Periphery,zenedar,288,mage,frost,6,3,3
19590,Vodjka,nemesis,288,mage,frost,6,3,3
19591,Magekaoz,sylvanas,288,mage,frost,6,3,3
19592,ßjwercke,stormscale,288,mage,frost,6,3,3
19593,Zlacked,tarren-mill,288,mage,frost,6,3,3
19594,Illîllîllî,blackrock,288,mage,frost,6,3,3
19595,Zyllu,argent-dawn,288,mage,frost,6,3,3
19596,Каперниан,fordragon,288,mage,frost,6,3,3
19597,Dragotus,dragonblight,288,mage,frost,6,3,3
19598,Ghayaa,defias-brotherhood,288,mage,frost,6,3,3
19599,Bigraphael,ravencrest,288,mage,frost,6,3,3
19600,Onegaisenpai,ragnaros,288,mage,frost,6,3,3
19601,Milminmage,ravencrest,288,mage,frost,6,3,3
19602,Haginatorr,twisting-nether,288,mage,frost,6,3,3
19603,Nynduriella,teldrassil,288,mage,frost,6,3,3
19604,Merlín,malganis,288,mage,frost,6,3,3
19605,Сэрруденкент,soulflayer,288,mage,frost,6,3,3
19606,Дмблдр,soulflayer,288,mage,frost,6,3,3
19607,Sérum,drakthul,288,mage,frost,12,3,9
19608,Synblink,eredar,288,mage,frost,12,3,9
19609,Illastrov,silvermoon,288,mage,frost,12,3,9
19610,Devon,haomarush,288,mage,frost,12,3,9
19611,Imasheeper,silvermoon,288,mage,frost,12,3,9
19612,Naween,hyjal,288,mage,frost,12,3,9
19613,Xeldary,blackmoore,288,mage,frost,12,3,9
19614,Paradigma,sylvanas,288,mage,frost,12,3,9
19615,Kryptass,aegwynn,288,mage,frost,12,3,9
19616,Чоуза,gordunni,288,mage,frost,12,3,9
19617,Эммилиарда,gordunni,288,mage,frost,12,3,9
19618,Micklolz,blackmoore,288,mage,frost,12,3,9
19619,Gogara,kazzak,288,mage,frost,12,3,9
19620,Subtempo,silvermoon,288,mage,frost,12,3,9
19621,Fernandéz,ravencrest,288,mage,frost,12,3,9
19622,Waterhagx,tarren-mill,288,mage,frost,12,3,9
19623,Tadaa,blackmoore,288,mage,frost,12,3,9
19624,Скайлуйт,gordunni,288,mage,frost,12,3,9
19625,Faitha,ravencrest,288,mage,frost,12,3,9
19626,Ахиригиз,gordunni,288,mage,frost,12,3,9
19627,Elreas,blackmoore,288,mage,frost,12,3,9
19628,Kaiyn,argent-dawn,288,mage,frost,12,3,9
19629,Hacimari,hyjal,288,mage,frost,12,3,9
19630,Котофайв,howling-fjord,288,mage,frost,12,3,9
19631,Äßäm,outland,288,mage,frost,12,3,9
19632,Ypy,dragonmaw,288,mage,frost,12,3,9
19633,Heatwavesa,ravencrest,288,mage,frost,12,3,9
19634,Phonkim,stormscale,288,mage,frost,12,3,9
19635,Voraxma,draenor,288,mage,frost,12,3,9
19636,Sérc,ravencrest,288,mage,frost,12,3,9
19637,Тудысюдым,eversong,288,mage,frost,12,3,9
19638,Cortis,outland,288,mage,frost,18,3,15
19639,Reeyymmoo,draenor,287,mage,frost,6,3,3
19640,Tsr,burning-legion,287,mage,frost,6,3,3
19641,Fumachustas,kazzak,287,mage,frost,6,3,3
19642,Magó,eredar,287,mage,frost,6,3,3
19643,Valtarisoo,amanthul,287,mage,frost,6,3,3
19644,Djblink,twisting-nether,287,mage,frost,12,3,9
19645,Kasus,sporeggar,287,mage,frost,12,3,9
19646,Mexxlaz,eredar,287,mage,frost,12,3,9
19647,Nekroulis,agamaggan,287,mage,frost,12,3,9
19648,Familyfrost,thunderhorn,287,mage,frost,12,3,9
19649,Freeto,blackmoore,286,mage,frost,6,3,3
19650,Serlath,defias-brotherhood,286,mage,frost,6,3,3
19651,Rosenkrauz,kul-tiras,280,mage,frost,26,3,23
19652,Torryel,silvermoon,256,mage,frost,10,3,7
19653,Кагумми,gordunni,256,mage,frost,16,3,13
19654,Колдунская,gordunni,255,mage,frost,11,3,8
19655,Delvir,stormreaver,240,mage,frost,9,3,6
19656,Iif,zirkel-des-cenarius,239,mage,frost,5,3,2
19657,Setyon,burning-legion,223,mage,frost,8,3,5
19658,Kairøs,dragonblight,192,mage,frost,9,3,6
19659,Blastus,ragnaros,192,mage,frost,6,2,4
19660,Wumz,blackrock,192,mage,frost,6,2,4
19661,Fearbeäch,ravencrest,192,mage,frost,6,2,4
19662,Smokedaddy,stormscale,192,mage,frost,6,2,4
19663,Brísingamen,outland,192,mage,frost,6,2,4
19664,Dueudafrøven,stormscale,192,mage,frost,6,2,4
19665,Proxanlulz,ravencrest,192,mage,frost,6,2,4
19666,Shealá,blackhand,192,mage,frost,6,2,4
19667,Бд,blackscar,192,mage,frost,6,2,4
19668,Rizzlybear,outland,192,mage,frost,6,2,4
19669,Goodopeners,outland,192,mage,frost,6,2,4
19670,Sany,anubarak,192,mage,frost,6,2,4
19671,Creak,blackhand,192,mage,frost,6,2,4
19672,Zheakz,kazzak,192,mage,frost,6,2,4
19673,Labius,dun-modr,192,mage,frost,6,2,4
19674,Халадель,howling-fjord,192,mage,frost,6,2,4
19675,Димаскунфу,howling-fjord,192,mage,frost,6,2,4
19676,Onlymage,outland,192,mage,frost,6,2,4
19677,Ceinxjk,ravencrest,192,mage,frost,6,2,4
19678,Budgetziqo,ravencrest,192,mage,frost,6,2,4
19679,Feath,ravencrest,192,mage,frost,6,2,4
19680,Thegoodoctor,kazzak,192,mage,frost,6,2,4
19681,Robsn,blackrock,192,mage,frost,6,2,4
19682,Exael,ravencrest,192,mage,frost,6,2,4
19683,Laciee,silvermoon,192,mage,frost,6,2,4
19684,Skylezy,blackrock,192,mage,frost,6,2,4
19685,Sperow,marécage-de-zangar,192,mage,frost,6,2,4
19686,Momolamoto,hyjal,192,mage,frost,6,2,4
19687,Alleii,kazzak,192,mage,frost,6,2,4
19688,Ðøæø,twisting-nether,192,mage,frost,6,2,4
19689,Perfection,cthun,192,mage,frost,6,2,4
19690,Whìtewalker,pozzo-delleternità,192,mage,frost,6,2,4
19691,Etherìon,los-errantes,192,mage,frost,6,2,4
19692,Maeflix,aegwynn,192,mage,frost,6,2,4
19693,Sweetcandy,outland,192,mage,frost,6,2,4
19694,Swørd,aggra-português,192,mage,frost,6,2,4
19695,Sebers,kazzak,192,mage,frost,6,2,4
19696,Zerøsílgødx,antonidas,192,mage,frost,6,2,4
19697,Magovix,archimonde,192,mage,frost,6,2,4
19698,Rachouu,archimonde,192,mage,frost,6,2,4
19699,Мистркорбэн,soulflayer,192,mage,frost,6,2,4
19700,Frostbringer,archimonde,192,mage,frost,6,2,4
19701,Gameart,alexstrasza,192,mage,frost,6,2,4
19702,Barspin,lightnings-blade,192,mage,frost,6,2,4
19703,Ingibjorg,auchindoun,192,mage,frost,6,2,4
19704,Ohateyz,burning-legion,192,mage,frost,6,2,4
19705,Burnem,kult-der-verdammten,192,mage,frost,6,2,4
19706,Zeramage,eredar,192,mage,frost,6,2,4
19707,Maveya,blackmoore,192,mage,frost,6,2,4
19708,Queuefiend,eredar,192,mage,frost,6,2,4
19709,Ipen,bloodfeather,192,mage,frost,6,2,4
19710,Mooryel,burning-legion,192,mage,frost,6,2,4
19711,Arcaneiun,nagrand,192,mage,frost,6,2,4
19712,Галадриелька,gordunni,192,mage,frost,6,2,4
19713,Bodyrocker,sylvanas,192,mage,frost,6,2,4
19714,Estupen,sanguino,192,mage,frost,6,2,4
19715,Tobie,bladefist,192,mage,frost,6,2,4
19716,Yunion,burning-legion,192,mage,frost,6,2,4
19717,Frazztato,tarren-mill,192,mage,frost,6,2,4
19718,Infamage,draenor,192,mage,frost,6,2,4
19719,Tomia,burning-legion,192,mage,frost,6,2,4
19720,Levioosah,draenor,192,mage,frost,6,2,4
19721,Ellianor,drakthul,192,mage,frost,6,2,4
19722,Adetin,tarren-mill,192,mage,frost,6,2,4
19723,Kobrass,spinebreaker,192,mage,frost,6,2,4
19724,Xblaz,draenor,192,mage,frost,6,2,4
19725,Treyz,tichondrius,192,mage,frost,6,2,4
19726,Флоой,gordunni,192,mage,frost,6,2,4
19727,Meteofrost,draenor,192,mage,frost,6,2,4
19728,Medium,der-rat-von-dalaran,192,mage,frost,6,2,4
19729,Welt,drakthul,192,mage,frost,6,2,4
19730,Berylton,argent-dawn,192,mage,frost,6,2,4
19731,Zulkas,stormreaver,192,mage,frost,6,2,4
19732,Banausisch,blackmoore,192,mage,frost,6,2,4
19733,Kàtsu,tarren-mill,192,mage,frost,6,2,4
19734,Ehbehad,doomhammer,192,mage,frost,6,2,4
19735,Harpelmage,auchindoun,192,mage,frost,6,2,4
19736,Alieni,stormreaver,192,mage,frost,6,2,4
19737,Naldora,turalyon,192,mage,frost,6,2,4
19738,Dxdxdxdxdx,drakthul,192,mage,frost,6,2,4
19739,Balmak,doomhammer,192,mage,frost,6,2,4
19740,Rapidfrost,drakthul,192,mage,frost,12,2,10
19741,Boned,ravencrest,192,mage,frost,12,2,10
19742,Myriel,thrall,192,mage,frost,12,2,10
19743,Магниффика,blackscar,192,mage,frost,12,2,10
19744,Mariujana,ravencrest,192,mage,frost,12,2,10
19745,Xawokem,outland,192,mage,frost,12,2,10
19746,Sephis,anubarak,192,mage,frost,12,2,10
19747,Kbd,outland,192,mage,frost,12,2,10
19748,Braínfreeze,kazzak,192,mage,frost,12,2,10
19749,Pogmage,blackrock,192,mage,frost,12,2,10
19750,Bêta,dun-modr,192,mage,frost,12,2,10
19751,Arinel,stormreaver,192,mage,frost,12,2,10
19752,Freezeballs,blackmoore,192,mage,frost,12,2,10
19753,Portnography,draenor,192,mage,frost,12,2,10
19754,Shizzy,onyxia,192,mage,frost,12,2,10
19755,Atírpá,doomhammer,192,mage,frost,12,2,10
19756,Ezìl,nemesis,192,mage,frost,12,2,10
19757,Kaevelin,argent-dawn,192,mage,frost,12,2,10
19758,Illiot,twisting-nether,192,mage,frost,12,2,10
19759,Flamê,ragnaros,192,mage,frost,12,2,10
19760,Shallari,argent-dawn,192,mage,frost,12,2,10
19761,Shiftea,argent-dawn,192,mage,frost,12,2,10
19762,Hruon,ravenholdt,192,mage,frost,15,2,13
19763,Aaropalli,kazzak,191,mage,frost,6,2,4
19764,Illusionx,grim-batol,191,mage,frost,6,2,4
19765,Faithseed,dun-modr,191,mage,frost,6,2,4
19766,Makkertje,silvermoon,191,mage,frost,6,2,4
19767,Duncanidaho,throkferoth,191,mage,frost,6,2,4
19768,Mátraxx,silvermoon,191,mage,frost,12,2,10
19769,Proxj,stormscale,175,mage,frost,11,2,9
19770,Иксайс,soulflayer,168,mage,frost,29,9,20
19771,Ivailo,ravencrest,159,mage,frost,5,2,3
19772,Aerathâ,blackrock,159,mage,frost,5,2,3
19773,Kyan,burning-legion,159,mage,frost,5,2,3
19774,Dødo,archimonde,159,mage,frost,5,2,3
19775,Codeincassie,blackhand,138,mage,frost,10,4,6
19776,Zôot,ravencrest,138,mage,frost,11,4,7
19777,Drinte,blackmoore,138,mage,frost,10,3,7
19778,Distrophy,vashj,138,mage,frost,12,3,9
19779,Lovesosa,malorne,138,mage,frost,13,3,10
19780,Klivapå,aggramar,128,mage,frost,4,2,2
19781,Швайго,gordunni,128,mage,frost,4,2,2
19782,Skitsó,shadowsong,127,mage,frost,4,2,2
19783,Arghen,nemesis,105,mage,frost,13,3,10
19784,Firestárter,ravencrest,96,mage,frost,3,2,1
19785,Ntintsec,tarren-mill,96,mage,frost,3,2,1
19786,Tylic,doomhammer,96,mage,frost,9,2,7
19787,Sheeptonreup,archimonde,96,mage,frost,6,1,5
19788,Alphaburstqx,ragnaros,96,mage,frost,6,1,5
19789,Pflanzenn,nozdormu,96,mage,frost,6,1,5
19790,Pringlesrör,ragnaros,96,mage,frost,6,1,5
19791,Rouxbignol,archimonde,96,mage,frost,6,1,5
19792,Homeessa,stormreaver,96,mage,frost,6,1,5
19793,Loskapaska,stormreaver,96,mage,frost,6,1,5
19794,Ekyoo,blackrock,96,mage,frost,6,1,5
19795,Arogance,archimonde,96,mage,frost,6,1,5
19796,Consulalgeri,archimonde,96,mage,frost,6,1,5
19797,Keïji,khaz-modan,96,mage,frost,6,1,5
19798,Vildfogel,tarren-mill,96,mage,frost,6,1,5
19799,Dóncójones,blackrock,96,mage,frost,6,1,5
19800,Mëgu,silvermoon,96,mage,frost,6,1,5
19801,Magiocre,silvermoon,96,mage,frost,6,1,5
19802,Fîrestorm,doomhammer,96,mage,frost,6,1,5
19803,Dphz,tarren-mill,96,mage,frost,6,1,5
19804,Dwarfyy,frostmane,96,mage,frost,6,1,5
19805,Graell,archimonde,96,mage,frost,6,1,5
19806,Coombuster,kazzak,96,mage,frost,6,1,5
19807,Vali,drakthul,96,mage,frost,6,1,5
19808,Pungvre,kazzak,96,mage,frost,6,1,5
19809,Rezre,stormscale,96,mage,frost,6,1,5
19810,Froostii,aegwynn,96,mage,frost,6,1,5
19811,Холдми,gordunni,96,mage,frost,6,1,5
19812,Aarcheon,kazzak,96,mage,frost,6,1,5
19813,Осуждаюпве,gordunni,96,mage,frost,6,1,5
19814,Niladyel,hyjal,96,mage,frost,6,1,5
19815,Teeclis,twisting-nether,96,mage,frost,6,1,5
19816,Jesjess,ravencrest,96,mage,frost,6,1,5
19817,Dyen,hyjal,96,mage,frost,6,1,5
19818,Petri,laughing-skull,96,mage,frost,6,1,5
19819,Sílvér,draenor,96,mage,frost,6,1,5
19820,Magîny,antonidas,96,mage,frost,6,1,5
19821,Devòna,silvermoon,96,mage,frost,6,1,5
19822,Capz,outland,96,mage,frost,6,1,5
19823,Rmforever,archimonde,96,mage,frost,6,1,5
19824,Babynilli,ravencrest,96,mage,frost,6,1,5
19825,Deathbrínger,alakir,96,mage,frost,6,1,5
19826,Kosso,twisting-nether,96,mage,frost,6,1,5
19827,Chimará,eredar,96,mage,frost,6,1,5
19828,Kpacey,guldan,96,mage,frost,6,1,5
19829,Dzomage,kazzak,96,mage,frost,6,1,5
19830,Bananabread,the-maelstrom,96,mage,frost,6,1,5
19831,Dphalos,ravencrest,96,mage,frost,6,1,5
19832,Ghelder,drakthul,96,mage,frost,6,1,5
19833,Sesseel,veklor,96,mage,frost,6,1,5
19834,Meisterg,frostwolf,96,mage,frost,6,1,5
19835,Testoletku,twisting-nether,96,mage,frost,6,1,5
19836,Luckymango,alakir,96,mage,frost,6,1,5
19837,Crooja,antonidas,96,mage,frost,6,1,5
19838,Nergl,darksorrow,96,mage,frost,6,1,5
19839,Одз,grom,96,mage,frost,6,1,5
19840,Ледянойкекс,gordunni,96,mage,frost,6,1,5
19841,Skinirp,dun-modr,96,mage,frost,6,1,5
19842,Vaessi,doomhammer,96,mage,frost,6,1,5
19843,Squìshy,magtheridon,96,mage,frost,6,1,5
19844,Romaga,quelthalas,96,mage,frost,6,1,5
19845,Nullso,zuljin,96,mage,frost,6,1,5
19846,Сморгонец,gordunni,96,mage,frost,6,1,5
19847,Fumandalonso,sanguino,96,mage,frost,6,1,5
19848,Rilac,nordrassil,96,mage,frost,6,1,5
19849,Колтрэйн,blackscar,96,mage,frost,6,1,5
19850,Мэджиксул,grom,96,mage,frost,6,1,5
19851,Vïto,zuljin,96,mage,frost,12,1,11
19852,Snowy,sargeras,96,mage,frost,12,1,11
19853,Krykz,sanguino,96,mage,frost,12,1,11
19854,Ploufatak,hyjal,96,mage,frost,18,1,17
19855,Floé,twisting-nether,95,mage,frost,6,1,5
19856,Aurayaa,teldrassil,95,mage,frost,11,1,10
19857,Nalord,saurfang,95,mage,frost,12,1,11
19858,Bagss,ysondre,95,mage,frost,12,1,11
19859,Elkayizer,archimonde,95,mage,frost,12,1,11
19860,Milhoux,ysondre,79,mage,frost,5,1,4
19861,Levora,ragnaros,79,mage,frost,5,1,4
19862,Mimicassa,defias-brotherhood,71,mage,frost,24,9,15
19863,Каппашилка,gordunni,64,mage,frost,4,1,3
19864,Деозар,eversong,63,mage,frost,2,2,0
19865,Magebraín,ravencrest,63,mage,frost,2,2,0
19866,Gocu,tarren-mill,63,mage,frost,2,2,0
19867,Ямурайхо,howling-fjord,48,mage,frost,3,1,2
19868,Aeghis,darkspear,42,mage,frost,10,3,7
19869,Grönmonster,shattered-hand,42,mage,frost,7,2,5
19870,Mayreel,antonidas,42,mage,frost,11,3,8
19871,Modjahead,tarren-mill,42,mage,frost,15,3,12
19872,Yoxt,blackhand,31,mage,frost,2,1,1
19873,Интровертка,blackscar,31,mage,frost,2,1,1
19874,Jambonpistol,archimonde,31,mage,frost,8,1,7
19875,Flizwiz,ragnaros,16,mage,frost,7,1,6
19876,Xaramael,colinas-pardas,8,mage,frost,9,3,6
19877,Fisterino,zuljin,2304,monk,mistweaver,54,42,12
19878,Fister,zuljin,2295,monk,mistweaver,77,54,23
19879,Commadore,draenor,2288,monk,mistweaver,137,76,61
19880,Cocojones,tarren-mill,2286,monk,mistweaver,114,79,35
19881,Nnsstt,zuljin,2277,monk,mistweaver,104,64,40
19882,Bankmw,tarren-mill,2265,monk,mistweaver,77,52,25
19883,Brickedup,twisting-nether,2246,monk,mistweaver,139,81,58
19884,Kurbanov,stormscale,2239,monk,mistweaver,117,63,54
19885,Brickeduptwo,twisting-nether,2238,monk,mistweaver,174,127,47
19886,Sâu,twisting-nether,2236,monk,mistweaver,122,76,46
19887,Chsx,ravencrest,2234,monk,mistweaver,138,97,41
19888,Iminar,blackrock,2233,monk,mistweaver,84,54,30
19889,Donitrivegas,blackrock,2225,monk,mistweaver,207,132,75
19890,Montex,stormscale,2210,monk,mistweaver,96,53,43
19891,Lp,mugthol,2206,monk,mistweaver,78,52,26
19892,Kjñ,ravencrest,2204,monk,mistweaver,147,90,57
19893,Ballademager,magtheridon,2191,monk,mistweaver,108,65,43
19894,Kåtsumi,sanguino,2175,monk,mistweaver,131,88,43
19895,Онимэшнеца,gordunni,2170,monk,mistweaver,77,48,29
19896,Øllen,stormscale,2161,monk,mistweaver,107,59,48
19897,Botweaver,tarren-mill,2157,monk,mistweaver,54,36,18
19898,Sofunny,blackrock,2157,monk,mistweaver,141,86,55
19899,Zaerin,eredar,2155,monk,mistweaver,67,39,28
19900,Quendiz,frostwolf,2152,monk,mistweaver,90,49,41
19901,Chichigneux,hyjal,2148,monk,mistweaver,99,67,32
19902,Вульфхильда,soulflayer,2146,monk,mistweaver,246,144,102
19903,Lyashi,dalaran,2144,monk,mistweaver,90,50,40
19904,Nawak,archimonde,2144,monk,mistweaver,201,108,93
19905,Meliowo,ravencrest,2141,monk,mistweaver,102,58,44
19906,Çoomðragon,stormscale,2139,monk,mistweaver,48,33,15
19907,Akanetsu,kazzak,2139,monk,mistweaver,138,80,58
19908,Turricane,blackmoore,2133,monk,mistweaver,114,60,54
19909,Kêkburagol,kazzak,2131,monk,mistweaver,174,109,65
19910,Mønkeÿ,ravencrest,2130,monk,mistweaver,70,42,28
19911,Ltmxy,ravencrest,2127,monk,mistweaver,66,40,26
19912,Vivie,destromath,2126,monk,mistweaver,78,48,30
19913,Umadbrohuh,outland,2126,monk,mistweaver,66,39,27
19914,Willxmonk,silvermoon,2126,monk,mistweaver,101,56,45
19915,Shorus,blackmoore,2125,monk,mistweaver,132,84,48
19916,Фунтос,soulflayer,2124,monk,mistweaver,66,41,25
19917,Mibe,alonsus,2121,monk,mistweaver,126,63,63
19918,Trashcarlita,eredar,2120,monk,mistweaver,90,51,39
19919,Beetlejuicé,stormscale,2118,monk,mistweaver,42,28,14
19920,Loofey,ragnaros,2117,monk,mistweaver,218,128,90
19921,Mharlie,stormscale,2117,monk,mistweaver,291,158,133
19922,Дамбмонк,blackscar,2116,monk,mistweaver,76,46,30
19923,Tryhârdx,stormscale,2115,monk,mistweaver,96,51,45
19924,Bmane,archimonde,2114,monk,mistweaver,71,40,31
19925,Vanost,kazzak,2114,monk,mistweaver,90,45,45
19926,Bighealz,aggra-português,2113,monk,mistweaver,77,43,34
19927,Loiyah,dun-modr,2113,monk,mistweaver,78,40,38
19928,Dekaramw,ravencrest,2112,monk,mistweaver,42,33,9
19929,Bigbøøty,silvermoon,2112,monk,mistweaver,90,46,44
19930,Cranex,terenas,2109,monk,mistweaver,118,72,46
19931,Glooni,blackrock,2108,monk,mistweaver,75,46,29
19932,Кимлейн,blackscar,2108,monk,mistweaver,48,29,19
19933,Shonbadatret,argent-dawn,2108,monk,mistweaver,90,54,36
19934,Mememaster,blackhand,2106,monk,mistweaver,172,105,67
19935,Bobthewild,draenor,2104,monk,mistweaver,449,233,216
19936,Sinted,blackmoore,2103,monk,mistweaver,83,52,31
19937,Lifelessons,blackrock,2103,monk,mistweaver,57,34,23
19938,Fisterbean,outland,2103,monk,mistweaver,72,40,32
19939,Swoshz,ragnaros,2103,monk,mistweaver,66,33,33
19940,Blubberwurst,gorgonnash,2102,monk,mistweaver,130,74,56
19941,Webhottie,twisting-nether,2102,monk,mistweaver,155,88,67
19942,Karsat,hyjal,2102,monk,mistweaver,639,339,300
19943,Wajoba,blackhand,2102,monk,mistweaver,114,58,56
19944,Monkield,kazzak,2101,monk,mistweaver,236,147,89
19945,Diorc,outland,2101,monk,mistweaver,116,67,49
19946,Flowy,uldum,2101,monk,mistweaver,60,31,29
19947,Глитч,deepholm,2100,monk,mistweaver,66,43,23
19948,Hiryu,argent-dawn,2100,monk,mistweaver,125,75,50
19949,Yellowtape,kiljaeden,2100,monk,mistweaver,215,127,88
19950,Dollyqt,ravencrest,2100,monk,mistweaver,90,46,44
19951,Ruurruuru,archimonde,2095,monk,mistweaver,185,110,75
19952,Ðurîmar,ravencrest,2090,monk,mistweaver,75,43,32
19953,Lylleri,darksorrow,2089,monk,mistweaver,68,40,28
19954,Tímmz,blackrock,2088,monk,mistweaver,96,56,40
19955,Kêkbûrâgól,kazzak,2079,monk,mistweaver,157,89,68
19956,Loiyh,dun-modr,2079,monk,mistweaver,90,45,45
19957,Леолайт,borean-tundra,2075,monk,mistweaver,118,68,50
19958,Йорита,soulflayer,2072,monk,mistweaver,72,44,28
19959,Хапаюивтыкаю,gordunni,2069,monk,mistweaver,66,43,23
19960,Pizzabud,ravencrest,2068,monk,mistweaver,64,43,21
19961,Ltmdwarf,ravencrest,2067,monk,mistweaver,84,45,39
19962,Joke,ragnaros,2059,monk,mistweaver,102,51,51
19963,Seeyoulater,nemesis,2047,monk,mistweaver,342,176,166
19964,Bigbummer,blackmoore,2044,monk,mistweaver,144,83,61
19965,Couchfrmikea,twisting-nether,2043,monk,mistweaver,84,46,38
19966,Ashm,shattered-halls,2043,monk,mistweaver,78,42,36
19967,Monkeystar,archimonde,2036,monk,mistweaver,114,63,51
19968,Stringg,zuljin,2036,monk,mistweaver,336,185,151
19969,Zevenblad,stormscale,2036,monk,mistweaver,82,43,39
19970,Monkeyi,silvermoon,2028,monk,mistweaver,119,60,59
19971,Mergina,silvermoon,2026,monk,mistweaver,66,37,29
19972,Pennyflame,stormscale,2026,monk,mistweaver,125,67,58
19973,Quendi,frostwolf,2023,monk,mistweaver,190,92,98
19974,Adgoh,tarren-mill,2018,monk,mistweaver,58,43,15
19975,Qwertyxo,draenor,2017,monk,mistweaver,123,77,46
19976,Mistyhoe,twisting-nether,2017,monk,mistweaver,172,92,80
19977,Tigermw,twisting-nether,2016,monk,mistweaver,100,62,38
19978,Monkeymain,tarren-mill,2013,monk,mistweaver,65,34,31
19979,Кулакх,blackscar,2012,monk,mistweaver,106,59,47
19980,Ðalvan,blackrock,2011,monk,mistweaver,78,39,39
19981,Fåtjøë,ravencrest,2010,monk,mistweaver,48,31,17
19982,Flandersmonk,ravencrest,2008,monk,mistweaver,90,57,33
19983,Шортмневноги,howling-fjord,2008,monk,mistweaver,137,74,63
19984,Speedahx,dun-modr,2006,monk,mistweaver,104,64,40
19985,Neszesmonk,ragnaros,2003,monk,mistweaver,242,133,109
19986,Суммрачная,gordunni,2002,monk,mistweaver,144,89,55
19987,Gronkr,draenor,1999,monk,mistweaver,106,59,47
19988,Timmzý,blackmoore,1998,monk,mistweaver,95,64,31
19989,Ганссмонк,blackscar,1997,monk,mistweaver,120,62,58
19990,Кулачонка,blackscar,1992,monk,mistweaver,59,33,26
19991,Mösêê,eredar,1992,monk,mistweaver,88,39,49
19992,Shadezz,blackmoore,1991,monk,mistweaver,82,54,28
19993,Brxndimonk,antonidas,1990,monk,mistweaver,63,35,28
19994,Teampro,ragnaros,1990,monk,mistweaver,258,138,120
19995,Øméga,ravencrest,1989,monk,mistweaver,194,128,66
19996,Srdarr,kazzak,1987,monk,mistweaver,90,52,38
19997,Marqinio,archimonde,1984,monk,mistweaver,84,47,37
19998,Kanketoe,korgall,1984,monk,mistweaver,54,30,24
19999,Swagmonk,silvermoon,1984,monk,mistweaver,122,65,57
20000,Holyrop,aegwynn,1982,monk,mistweaver,36,25,11
20001,Môûsè,ravencrest,1981,monk,mistweaver,102,62,40
20002,Zeoverx,ragnaros,1977,monk,mistweaver,78,36,42
20003,Yoghurtz,frostmourne,1976,monk,mistweaver,192,110,82
20004,Uao,tarren-mill,1971,monk,mistweaver,66,31,35
20005,Боецкфц,soulflayer,1969,monk,mistweaver,64,37,27
20006,Коконгкд,blackscar,1969,monk,mistweaver,358,192,166
20007,Monkrah,blackmoore,1969,monk,mistweaver,72,37,35
20008,Halùnkè,eredar,1968,monk,mistweaver,177,101,76
20009,Veganweaver,ravencrest,1966,monk,mistweaver,60,37,23
20010,Zonsym,twisting-nether,1966,monk,mistweaver,96,51,45
20011,Magixc,drakthul,1965,monk,mistweaver,104,62,42
20012,Bigmilkies,ysondre,1965,monk,mistweaver,96,52,44
20013,Ouhmaikgød,dun-modr,1964,monk,mistweaver,171,83,88
20014,Manatoiled,draenor,1961,monk,mistweaver,54,34,20
20015,Vienuolè,silvermoon,1961,monk,mistweaver,54,30,24
20016,Rocknreroll,executus,1960,monk,mistweaver,138,82,56
20017,Howtoown,burning-legion,1960,monk,mistweaver,60,34,26
20018,Pyrìt,blackhand,1959,monk,mistweaver,60,41,19
20019,Kapud,twisting-nether,1958,monk,mistweaver,84,47,37
20020,Haìryplotter,kazzak,1957,monk,mistweaver,280,155,125
20021,Notzaele,zuljin,1956,monk,mistweaver,66,35,31
20022,Pwner,daggerspine,1956,monk,mistweaver,287,151,136
20023,Гроксси,howling-fjord,1955,monk,mistweaver,146,89,57
20024,Residùe,kazzak,1954,monk,mistweaver,90,53,37
20025,Prototyp,burning-legion,1953,monk,mistweaver,88,49,39
20026,Roadrunnér,ravencrest,1952,monk,mistweaver,66,35,31
20027,Лабирончик,blackscar,1949,monk,mistweaver,71,50,21
20028,Lanvia,argent-dawn,1946,monk,mistweaver,198,114,84
20029,Beili,ravencrest,1946,monk,mistweaver,79,42,37
20030,Wwvwwvwwvwwv,ragnaros,1946,monk,mistweaver,102,49,53
20031,Skailzkrtwo,hyjal,1943,monk,mistweaver,72,41,31
20032,Chanzey,silvermoon,1943,monk,mistweaver,288,161,127
20033,Manjini,blackhand,1940,monk,mistweaver,92,49,43
20034,Inlakech,auchindoun,1938,monk,mistweaver,141,77,64
20035,Problematic,blackmoore,1932,monk,mistweaver,52,33,19
20036,Пиписечка,gordunni,1932,monk,mistweaver,47,28,19
20037,Stemanit,draenor,1929,monk,mistweaver,77,47,30
20038,Lildaddymunk,ravencrest,1928,monk,mistweaver,54,31,23
20039,Arenatwo,outland,1925,monk,mistweaver,93,56,37
20040,Voltzeig,dentarg,1925,monk,mistweaver,312,163,149
20041,Pudgefeed,silvermoon,1924,monk,mistweaver,108,65,43
20042,Dicedkiwi,quelthalas,1924,monk,mistweaver,334,194,140
20043,Machó,kazzak,1922,monk,mistweaver,71,36,35
20044,Toram,burning-legion,1920,monk,mistweaver,72,37,35
20045,Zöumi,ravencrest,1917,monk,mistweaver,178,97,81
20046,Djsqx,outland,1915,monk,mistweaver,30,20,10
20047,Tinydolls,archimonde,1915,monk,mistweaver,42,24,18
20048,Yexìu,kult-der-verdammten,1914,monk,mistweaver,54,30,24
20049,Cítysushi,draenor,1913,monk,mistweaver,110,63,47
20050,Siphem,ravencrest,1911,monk,mistweaver,287,154,133
20051,Ûnknöw,archimonde,1910,monk,mistweaver,66,39,27
20052,Lxstcxntury,stormscale,1908,monk,mistweaver,47,32,15
20053,Фуфинус,gordunni,1907,monk,mistweaver,59,33,26
20054,Monkwithlove,blackhand,1906,monk,mistweaver,120,72,48
20055,Meemyo,blackmoore,1904,monk,mistweaver,83,34,49
20056,Muchobijca,defias-brotherhood,1900,monk,mistweaver,78,44,34
20057,Limbaskalol,dun-modr,1900,monk,mistweaver,253,133,120
20058,Shirkán,ragnaros,1899,monk,mistweaver,162,90,72
20059,Subàru,draenor,1898,monk,mistweaver,93,60,33
20060,Yuukiiqt,kult-der-verdammten,1897,monk,mistweaver,113,61,52
20061,Sookrates,ragnaros,1896,monk,mistweaver,60,38,22
20062,Seventhirty,ravencrest,1896,monk,mistweaver,36,20,16
20063,Лемонк,gordunni,1895,monk,mistweaver,40,21,19
20064,Æøwyn,ragnaros,1892,monk,mistweaver,88,61,27
20065,Jemp,ravencrest,1892,monk,mistweaver,592,328,264
20066,Uwû,ravencrest,1890,monk,mistweaver,107,73,34
20067,Jam,aerie-peak,1889,monk,mistweaver,24,20,4
20068,Mafiazøo,hyjal,1888,monk,mistweaver,130,81,49
20069,Egg,frostmane,1887,monk,mistweaver,48,30,18
20070,Ínsanez,dun-modr,1886,monk,mistweaver,54,29,25
20071,Killibrew,ravencrest,1885,monk,mistweaver,48,34,14
20072,Melysà,antonidas,1885,monk,mistweaver,45,27,18
20073,Rolxx,twisting-nether,1883,monk,mistweaver,116,59,57
20074,Dmonk,aegwynn,1882,monk,mistweaver,146,69,77
20075,Zanzetsu,twisting-nether,1881,monk,mistweaver,173,93,80
20076,Tierrax,cthun,1880,monk,mistweaver,71,36,35
20077,Deepl,dun-modr,1880,monk,mistweaver,54,27,27
20078,Lmnsx,ravencrest,1875,monk,mistweaver,36,23,13
20079,Nåwãk,archimonde,1875,monk,mistweaver,145,71,74
20080,Siignmonk,ravencrest,1874,monk,mistweaver,194,101,93
20081,Blantai,tarren-mill,1874,monk,mistweaver,78,38,40
20082,Meldi,ravencrest,1873,monk,mistweaver,54,32,22
20083,Texiq,drakthul,1872,monk,mistweaver,213,126,87
20084,Monkeycoke,ragnaros,1870,monk,mistweaver,35,21,14
20085,Brxmonki,antonidas,1870,monk,mistweaver,83,45,38
20086,Kratzl,blackrock,1867,monk,mistweaver,54,34,20
20087,Luru,outland,1867,monk,mistweaver,83,47,36
20088,Ræïzò,dun-morogh,1865,monk,mistweaver,58,34,24
20089,Wrv,kazzak,1864,monk,mistweaver,277,147,130
20090,Perceptîon,thrall,1863,monk,mistweaver,114,61,53
20091,Тащунаскилле,thermaplugg,1862,monk,mistweaver,62,39,23
20092,Jiafei,tarren-mill,1862,monk,mistweaver,42,25,17
20093,Effeots,blackrock,1862,monk,mistweaver,222,116,106
20094,Cptsensey,draenor,1861,monk,mistweaver,42,29,13
20095,Chazu,outland,1861,monk,mistweaver,66,36,30
20096,Hélpx,stormscale,1860,monk,mistweaver,42,23,19
20097,Youkâi,blackrock,1859,monk,mistweaver,48,31,17
20098,Минимонахх,blackscar,1859,monk,mistweaver,84,54,30
20099,Savagex,sanguino,1859,monk,mistweaver,66,35,31
20100,Dragzol,tarren-mill,1858,monk,mistweaver,144,72,72
20101,Rullsimpa,ravencrest,1858,monk,mistweaver,77,34,43
20102,Aromipesäx,outland,1857,monk,mistweaver,71,35,36
20103,Digzzy,draenor,1856,monk,mistweaver,63,35,28
20104,Waramow,eredar,1855,monk,mistweaver,36,25,11
20105,Butterbean,conseil-des-ombres,1855,monk,mistweaver,69,41,28
20106,Shâng,blackhand,1855,monk,mistweaver,54,32,22
20107,Neyoklol,blackrock,1855,monk,mistweaver,117,68,49
20108,Crôcøpx,blackhand,1855,monk,mistweaver,78,39,39
20109,Фунтос,gordunni,1854,monk,mistweaver,48,34,14
20110,Cdriscas,aggra-português,1854,monk,mistweaver,143,80,63
20111,Фейкнаут,soulflayer,1854,monk,mistweaver,132,69,63
20112,Døk,twisting-nether,1852,monk,mistweaver,36,24,12
20113,Vingurd,terokkar,1852,monk,mistweaver,45,28,17
20114,Sugra,frostwolf,1852,monk,mistweaver,63,39,24
20115,Bicmex,archimonde,1852,monk,mistweaver,96,46,50
20116,Muerb,die-arguswacht,1851,monk,mistweaver,45,28,17
20117,Fùckaround,emeriss,1851,monk,mistweaver,95,55,40
20118,Perelman,burning-legion,1851,monk,mistweaver,84,48,36
20119,Buddiline,baelgun,1851,monk,mistweaver,48,24,24
20120,Мичан,howling-fjord,1849,monk,mistweaver,146,88,58
20121,Taeyhung,thrall,1848,monk,mistweaver,99,59,40
20122,Çheeks,kazzak,1848,monk,mistweaver,48,26,22
20123,Wrynja,blackmoore,1847,monk,mistweaver,54,32,22
20124,Керизз,gordunni,1846,monk,mistweaver,42,27,15
20125,Strillen,twisting-nether,1846,monk,mistweaver,138,69,69
20126,Кодизи,gordunni,1845,monk,mistweaver,41,28,13
20127,Yamqt,thrall,1845,monk,mistweaver,42,27,15
20128,Kóan,stormscale,1845,monk,mistweaver,105,56,49
20129,Inuria,ravencrest,1844,monk,mistweaver,129,79,50
20130,Neisha,drakthul,1843,monk,mistweaver,102,63,39
20131,Enveløp,stormscale,1842,monk,mistweaver,42,29,13
20132,Pizelx,alakir,1842,monk,mistweaver,54,28,26
20133,Musclemage,turalyon,1841,monk,mistweaver,60,31,29
20134,Hidekami,archimonde,1840,monk,mistweaver,90,46,44
20135,Péppy,aegwynn,1839,monk,mistweaver,46,28,18
20136,Lîlilîlîlîlí,stormscale,1839,monk,mistweaver,48,24,24
20137,Swaghäuser,blackmoore,1838,monk,mistweaver,174,98,76
20138,Pøhx,ragnaros,1837,monk,mistweaver,87,51,36
20139,Mwmonk,blackrock,1836,monk,mistweaver,65,42,23
20140,Флориус,soulflayer,1836,monk,mistweaver,53,31,22
20141,Rokux,kazzak,1836,monk,mistweaver,43,25,18
20142,Homes,blackmoore,1836,monk,mistweaver,114,61,53
20143,Monkdrak,eredar,1835,monk,mistweaver,39,24,15
20144,Jades,emeriss,1835,monk,mistweaver,198,99,99
20145,Moariann,drakthul,1834,monk,mistweaver,132,67,65
20146,Hajlong,outland,1834,monk,mistweaver,66,32,34
20147,Myeers,dun-modr,1833,monk,mistweaver,180,97,83
20148,Jabington,aegwynn,1832,monk,mistweaver,121,73,48
20149,Рендикаое,soulflayer,1832,monk,mistweaver,199,110,89
20150,Monkbtw,kazzak,1831,monk,mistweaver,36,27,9
20151,Ønlyfäns,kazzak,1831,monk,mistweaver,112,67,45
20152,Jamiedhism,ravencrest,1831,monk,mistweaver,54,28,26
20153,Donkeymønk,hyjal,1830,monk,mistweaver,355,193,162
20154,Santoron,baelgun,1829,monk,mistweaver,75,36,39
20155,Нубстриимс,gordunni,1828,monk,mistweaver,62,33,29
20156,Mistyfox,aszune,1828,monk,mistweaver,95,45,50
20157,Koguosa,outland,1827,monk,mistweaver,42,32,10
20158,Véxyra,draenor,1827,monk,mistweaver,48,32,16
20159,Lanory,blackmoore,1827,monk,mistweaver,42,26,16
20160,Ilovesanrio,kazzak,1827,monk,mistweaver,86,53,33
20161,Trifogeorge,archimonde,1827,monk,mistweaver,48,28,20
20162,Chitea,argent-dawn,1827,monk,mistweaver,53,30,23
20163,Tráïner,madmortem,1827,monk,mistweaver,161,85,76
20164,Мефодийкун,howling-fjord,1826,monk,mistweaver,108,63,45
20165,Playbîrd,archimonde,1826,monk,mistweaver,100,54,46
20166,Cåpybårå,outland,1826,monk,mistweaver,261,137,124
20167,Bmwmthree,draenor,1826,monk,mistweaver,60,31,29
20168,Notachi,doomhammer,1825,monk,mistweaver,243,135,108
20169,Porcman,archimonde,1825,monk,mistweaver,141,71,70
20170,Scribzw,twisting-nether,1824,monk,mistweaver,77,43,34
20171,Элонхаск,gordunni,1824,monk,mistweaver,54,29,25
20172,Maesha,ahnqiraj,1823,monk,mistweaver,90,57,33
20173,Dmonkz,magtheridon,1823,monk,mistweaver,54,30,24
20174,Vizfist,tarren-mill,1823,monk,mistweaver,54,26,28
20175,Grauwe,stormscale,1822,monk,mistweaver,57,35,22
20176,Sadmw,archimonde,1822,monk,mistweaver,48,28,20
20177,Patiencebro,archimonde,1822,monk,mistweaver,78,43,35
20178,Lildaddymonk,ravencrest,1822,monk,mistweaver,54,24,30
20179,Táy,ravencrest,1821,monk,mistweaver,84,52,32
20180,Astromune,draenor,1821,monk,mistweaver,53,32,21
20181,Sikaan,blackhand,1820,monk,mistweaver,42,27,15
20182,Амаранточка,howling-fjord,1820,monk,mistweaver,60,38,22
20183,Trollroll,defias-brotherhood,1820,monk,mistweaver,132,74,58
20184,Mobrac,twisting-nether,1820,monk,mistweaver,50,26,24
20185,Анстапоблх,grom,1820,monk,mistweaver,54,24,30
20186,Hurri,krasus,1819,monk,mistweaver,36,25,11
20187,Kungfublyat,twisting-nether,1818,monk,mistweaver,59,43,16
20188,Шэганэ,deathguard,1818,monk,mistweaver,74,45,29
20189,Fistíe,sylvanas,1817,monk,mistweaver,33,22,11
20190,Nesedondondn,stormscale,1816,monk,mistweaver,30,23,7
20191,Motang,blackmoore,1816,monk,mistweaver,62,34,28
20192,Precocconx,stormreaver,1816,monk,mistweaver,36,19,17
20193,Mugenzen,sanguino,1816,monk,mistweaver,36,19,17
20194,Polch,archimonde,1816,monk,mistweaver,78,38,40
20195,Твикса,soulflayer,1816,monk,mistweaver,114,54,60
20196,Loiythree,dun-modr,1815,monk,mistweaver,60,29,31
20197,Wrox,sylvanas,1814,monk,mistweaver,60,43,17
20198,Zulein,defias-brotherhood,1814,monk,mistweaver,36,21,15
20199,Тамаз,gordunni,1814,monk,mistweaver,59,24,35
20200,Crñ,blackmoore,1813,monk,mistweaver,44,26,18
20201,Basilbrushxd,stormscale,1813,monk,mistweaver,48,27,21
20202,Людзяо,galakrond,1813,monk,mistweaver,107,59,48
20203,Karmasnitch,antonidas,1812,monk,mistweaver,72,41,31
20204,Onlyfist,stormscale,1811,monk,mistweaver,42,28,14
20205,Vxs,blackhand,1811,monk,mistweaver,72,45,27
20206,Sugermum,outland,1811,monk,mistweaver,54,31,23
20207,Insanepace,blackmoore,1811,monk,mistweaver,61,31,30
20208,Xoconut,kazzak,1810,monk,mistweaver,292,160,132
20209,Shyheimyo,outland,1810,monk,mistweaver,54,27,27
20210,Crymonkya,aegwynn,1809,monk,mistweaver,138,88,50
20211,Evad,kazzak,1809,monk,mistweaver,113,69,44
20212,Schizacademy,draenor,1809,monk,mistweaver,44,26,18
20213,Yäffa,archimonde,1809,monk,mistweaver,126,71,55
20214,Schøcker,blackmoore,1809,monk,mistweaver,59,32,27
20215,Wernos,archimonde,1809,monk,mistweaver,60,32,28
20216,Fìstpwnjk,forscherliga,1808,monk,mistweaver,145,93,52
20217,Errowin,blackmoore,1807,monk,mistweaver,108,68,40
20218,Kilograme,tarren-mill,1806,monk,mistweaver,66,36,30
20219,Kîrânâ,eredar,1806,monk,mistweaver,54,29,25
20220,Ранки,lich-king,1806,monk,mistweaver,60,27,33
20221,Fullzi,dalaran,1805,monk,mistweaver,30,19,11
20222,Maybeexm,ravencrest,1805,monk,mistweaver,48,26,22
20223,Yulonian,argent-dawn,1804,monk,mistweaver,166,103,63
20224,Panson,twisting-nether,1804,monk,mistweaver,54,28,26
20225,Dewamønk,blackmoore,1803,monk,mistweaver,70,41,29
20226,Oikodomos,twisting-nether,1803,monk,mistweaver,77,45,32
20227,Wiwâ,outland,1803,monk,mistweaver,85,46,39
20228,Yum,anetheron,1803,monk,mistweaver,90,46,44
20229,Vanicweaver,aegwynn,1802,monk,mistweaver,36,26,10
20230,Cæsifer,ungoro,1802,monk,mistweaver,53,28,25
20231,Alprox,moonglade,1802,monk,mistweaver,170,87,83
20232,Djpunchable,blackrock,1801,monk,mistweaver,50,38,12
20233,Bossmanfred,outland,1801,monk,mistweaver,84,56,28
20234,Сазуко,gordunni,1801,monk,mistweaver,48,27,21
20235,Monkgolitaxd,dun-modr,1801,monk,mistweaver,240,131,109
20236,Heramonk,dun-modr,1801,monk,mistweaver,58,30,28
20237,Jinxini,twisting-nether,1800,monk,mistweaver,24,19,5
20238,Callysra,archimonde,1800,monk,mistweaver,42,30,12
20239,Monknice,sylvanas,1800,monk,mistweaver,77,40,37
20240,Xarêlla,aegwynn,1800,monk,mistweaver,114,58,56
20241,Hurricaine,hyjal,1799,monk,mistweaver,30,19,11
20242,Саас,gordunni,1799,monk,mistweaver,35,21,14
20243,Vienuole,silvermoon,1798,monk,mistweaver,53,27,26
20244,Brewnox,ragnaros,1797,monk,mistweaver,59,30,29
20245,Нимбмонк,soulflayer,1796,monk,mistweaver,53,25,28
20246,Shurdax,silvermoon,1793,monk,mistweaver,90,49,41
20247,Snówtea,silvermoon,1792,monk,mistweaver,45,28,17
20248,Doffm,auchindoun,1791,monk,mistweaver,84,51,33
20249,Claudiå,kazzak,1791,monk,mistweaver,63,31,32
20250,Skïrmíshgødx,ravencrest,1790,monk,mistweaver,54,25,29
20251,Lünara,ambossar,1787,monk,mistweaver,90,52,38
20252,Лиянь,soulflayer,1787,monk,mistweaver,108,61,47
20253,Luvmollý,silvermoon,1787,monk,mistweaver,114,57,57
20254,Jorahmarmond,tarren-mill,1786,monk,mistweaver,48,35,13
20255,Piedliés,ravencrest,1784,monk,mistweaver,84,39,45
20256,Bluran,dalaran,1783,monk,mistweaver,76,42,34
20257,Sushiroller,blackrock,1783,monk,mistweaver,48,26,22
20258,Threesíxníne,dun-morogh,1783,monk,mistweaver,42,22,20
20259,Loobee,ravencrest,1782,monk,mistweaver,48,24,24
20260,Shehulkk,ravencrest,1779,monk,mistweaver,48,26,22
20261,Zoida,azuremyst,1779,monk,mistweaver,144,70,74
20262,Birgitbuddha,gorgonnash,1776,monk,mistweaver,84,48,36
20263,Shortinlegs,silvermoon,1776,monk,mistweaver,60,32,28
20264,Brysiqtx,aegwynn,1775,monk,mistweaver,75,38,37
20265,Yukimøn,hyjal,1774,monk,mistweaver,103,73,30
20266,Papimonkx,garona,1773,monk,mistweaver,48,22,26
20267,Taylorghost,ravencrest,1769,monk,mistweaver,68,44,24
20268,Pamtu,dun-modr,1769,monk,mistweaver,96,61,35
20269,Monkler,blackhand,1769,monk,mistweaver,102,48,54
20270,Baatu,frostmane,1768,monk,mistweaver,108,53,55
20271,Legsweep,blackhand,1767,monk,mistweaver,133,84,49
20272,Soulring,kazzak,1767,monk,mistweaver,63,31,32
20273,Esriin,shattered-hand,1765,monk,mistweaver,36,24,12
20274,Cøcøøn,blackrock,1765,monk,mistweaver,146,79,67
20275,Фунтих,soulflayer,1764,monk,mistweaver,40,21,19
20276,Yungsooth,stormscale,1763,monk,mistweaver,65,40,25
20277,Ultdave,eredar,1760,monk,mistweaver,183,104,79
20278,Bammemw,archimonde,1760,monk,mistweaver,54,25,29
20279,Sícknéss,aegwynn,1759,monk,mistweaver,42,26,16
20280,Riendy,silvermoon,1759,monk,mistweaver,302,167,135
20281,Räpeltäjä,stormreaver,1757,monk,mistweaver,30,24,6
20282,Mêshuggâh,malganis,1757,monk,mistweaver,48,28,20
20283,Gréèñðrägôñ,stormscale,1756,monk,mistweaver,36,26,10
20284,Sîono,antonidas,1755,monk,mistweaver,48,34,14
20285,Key,stormreaver,1755,monk,mistweaver,82,50,32
20286,Holyropx,aegwynn,1755,monk,mistweaver,42,25,17
20287,Inear,chogall,1755,monk,mistweaver,244,132,112
20288,Sniffn,ravencrest,1754,monk,mistweaver,54,35,19
20289,Natsuø,nemesis,1754,monk,mistweaver,36,22,14
20290,Blamethegame,hyjal,1753,monk,mistweaver,35,24,11
20291,Demmonkz,stormreaver,1753,monk,mistweaver,36,24,12
20292,Actionsusi,area-52,1753,monk,mistweaver,48,27,21
20293,Эрмонд,soulflayer,1753,monk,mistweaver,68,37,31
20294,Januslapuce,culte-de-la-rive-noire,1752,monk,mistweaver,35,19,16
20295,Päws,kazzak,1751,monk,mistweaver,42,25,17
20296,Stifmeister,tarren-mill,1750,monk,mistweaver,94,50,44
20297,Jayber,laughing-skull,1749,monk,mistweaver,72,46,26
20298,Эрмилинда,gordunni,1749,monk,mistweaver,54,26,28
20299,Callim,blackrock,1748,monk,mistweaver,30,19,11
20300,Бадика,howling-fjord,1748,monk,mistweaver,221,123,98
20301,Carlteaz,drakthul,1747,monk,mistweaver,85,52,33
20302,Taekwonroll,stormscale,1747,monk,mistweaver,42,23,19
20303,Hôn,sanguino,1746,monk,mistweaver,53,36,17
20304,Kaezm,blackrock,1746,monk,mistweaver,42,26,16
20305,Xámell,ravencrest,1746,monk,mistweaver,36,19,17
20306,Dog,garona,1745,monk,mistweaver,84,36,48
20307,Seandyche,ravencrest,1744,monk,mistweaver,34,23,11
20308,Neash,silvermoon,1744,monk,mistweaver,90,51,39
20309,Teahihi,ravencrest,1742,monk,mistweaver,36,27,9
20310,Mcscrub,ragnaros,1742,monk,mistweaver,35,24,11
20311,Binkote,zuljin,1737,monk,mistweaver,119,72,47
20312,Calmed,tarren-mill,1737,monk,mistweaver,259,148,111
20313,Konnîchîwa,kazzak,1737,monk,mistweaver,167,91,76
20314,Mommymonk,outland,1737,monk,mistweaver,51,27,24
20315,Ipmanlol,archimonde,1736,monk,mistweaver,114,69,45
20316,Fatdad,magtheridon,1735,monk,mistweaver,83,41,42
20317,Zýru,ragnaros,1734,monk,mistweaver,124,75,49
20318,Shishasho,stormreaver,1734,monk,mistweaver,52,28,24
20319,Táuriéll,eredar,1734,monk,mistweaver,42,21,21
20320,Kapitan,sanguino,1732,monk,mistweaver,105,67,38
20321,Mugotea,twisting-nether,1732,monk,mistweaver,90,48,42
20322,Аскмилол,deathweaver,1731,monk,mistweaver,76,44,32
20323,Nsq,ravencrest,1731,monk,mistweaver,48,26,22
20324,Onaiâ,ravencrest,1730,monk,mistweaver,43,29,14
20325,Greentape,kiljaeden,1730,monk,mistweaver,42,27,15
20326,Wørsthealxd,alakir,1728,monk,mistweaver,88,59,29
20327,Súzy,stormscale,1727,monk,mistweaver,124,67,57
20328,Brewstea,kazzak,1727,monk,mistweaver,84,40,44
20329,Ziibaa,outland,1726,monk,mistweaver,81,48,33
20330,Эифорйя,howling-fjord,1726,monk,mistweaver,58,25,33
20331,Фдма,soulflayer,1724,monk,mistweaver,41,26,15
20332,Pikemi,dun-modr,1724,monk,mistweaver,90,56,34
20333,Théverre,uldaman,1724,monk,mistweaver,195,121,74
20334,Yadokaí,darkmoon-faire,1724,monk,mistweaver,48,23,25
20335,Kickin,burning-legion,1723,monk,mistweaver,64,37,27
20336,Chünlii,dun-modr,1723,monk,mistweaver,60,29,31
20337,Nrafflig,draenor,1722,monk,mistweaver,48,32,16
20338,Fulgrem,stormscale,1722,monk,mistweaver,87,53,34
20339,Wajøba,blackhand,1722,monk,mistweaver,36,18,18
20340,Capkum,dun-modr,1721,monk,mistweaver,161,83,78
20341,Jacksa,bronze-dragonflight,1721,monk,mistweaver,164,83,81
20342,Séi,kazzak,1721,monk,mistweaver,36,18,18
20343,Mwrbg,shadowsong,1720,monk,mistweaver,113,63,50
20344,Poohya,silvermoon,1720,monk,mistweaver,36,18,18
20345,Risesx,blackmoore,1719,monk,mistweaver,103,53,50
20346,Chimara,kazzak,1718,monk,mistweaver,79,45,34
20347,Типмах,howling-fjord,1718,monk,mistweaver,56,31,25
20348,Wisear,silvermoon,1718,monk,mistweaver,53,25,28
20349,Déffly,ravencrest,1717,monk,mistweaver,24,18,6
20350,Акли,gordunni,1717,monk,mistweaver,48,31,17
20351,Jackål,silvermoon,1716,monk,mistweaver,27,19,8
20352,Pabloboy,kazzak,1715,monk,mistweaver,42,24,18
20353,Jerymonk,tarren-mill,1715,monk,mistweaver,168,93,75
20354,Pogimonkey,ragnaros,1715,monk,mistweaver,54,28,26
20355,Alë,argent-dawn,1714,monk,mistweaver,105,65,40
20356,Blacktee,eredar,1714,monk,mistweaver,36,21,15
20357,Merína,ragnaros,1714,monk,mistweaver,207,109,98
20358,Onlyfunds,blackrock,1713,monk,mistweaver,24,18,6
20359,Olympiiee,archimonde,1713,monk,mistweaver,293,157,136
20360,Барлиос,soulflayer,1713,monk,mistweaver,331,172,159
20361,Ashjaxa,silvermoon,1710,monk,mistweaver,42,18,24
20362,Ultrasense,outland,1709,monk,mistweaver,30,18,12
20363,Oukaläv,archimonde,1709,monk,mistweaver,40,20,20
20364,Rogvi,argent-dawn,1709,monk,mistweaver,192,94,98
20365,Ivanzamonka,stormscale,1708,monk,mistweaver,71,47,24
20366,Lukeybabyy,defias-brotherhood,1708,monk,mistweaver,111,69,42
20367,Behrens,defias-brotherhood,1708,monk,mistweaver,39,23,16
20368,Babbub,tarren-mill,1707,monk,mistweaver,60,36,24
20369,Bigdaddypump,blackmoore,1707,monk,mistweaver,42,25,17
20370,Tjann,stormscale,1706,monk,mistweaver,48,33,15
20371,Бладмонки,soulflayer,1706,monk,mistweaver,60,38,22
20372,Zlodey,laughing-skull,1706,monk,mistweaver,43,25,18
20373,Jolude,nemesis,1706,monk,mistweaver,133,73,60
20374,Shyheim,outland,1705,monk,mistweaver,48,36,12
20375,ßsøßxx,hyjal,1704,monk,mistweaver,24,18,6
20376,Öhlinmonk,outland,1704,monk,mistweaver,42,24,18
20377,Kebabrolle,blackrock,1704,monk,mistweaver,42,21,21
20378,Adis,nerathor,1703,monk,mistweaver,48,28,20
20379,Moontríx,kazzak,1703,monk,mistweaver,48,21,27
20380,Lurklee,blackhand,1701,monk,mistweaver,48,27,21
20381,Nuke,steamwheedle-cartel,1701,monk,mistweaver,36,18,18
20382,Shigong,hellscream,1700,monk,mistweaver,66,36,30
20383,Fisterinos,blackrock,1699,monk,mistweaver,120,78,42
20384,Orfantal,ravencrest,1698,monk,mistweaver,120,71,49
20385,Erapanzon,nemesis,1698,monk,mistweaver,48,28,20
20386,Callmeks,stormscale,1698,monk,mistweaver,48,28,20
20387,Rullefald,stormscale,1697,monk,mistweaver,102,57,45
20388,Handarbetare,ravencrest,1696,monk,mistweaver,94,46,48
20389,Onlyfunn,sanguino,1695,monk,mistweaver,86,48,38
20390,Вакидзави,gordunni,1694,monk,mistweaver,48,31,17
20391,Mmrkick,kazzak,1694,monk,mistweaver,60,33,27
20392,Кикподхвост,blackscar,1694,monk,mistweaver,66,29,37
20393,Фучой,howling-fjord,1692,monk,mistweaver,57,34,23
20394,Pitrols,twisting-nether,1692,monk,mistweaver,237,134,103
20395,Ryx,twisting-nether,1691,monk,mistweaver,55,26,29
20396,Кербю,gordunni,1690,monk,mistweaver,42,23,19
20397,Doll,stormscale,1689,monk,mistweaver,36,18,18
20398,Zorkev,dun-modr,1688,monk,mistweaver,119,67,52
20399,Irêfutabil,sylvanas,1688,monk,mistweaver,63,34,29
20400,Olgachocolat,blackmoore,1687,monk,mistweaver,108,81,27
20401,Kungfupanda,stormscale,1687,monk,mistweaver,62,33,29
20402,Kukn,twisting-nether,1686,monk,mistweaver,87,44,43
20403,Нийтринно,howling-fjord,1685,monk,mistweaver,102,55,47
20404,Эрумонк,gordunni,1685,monk,mistweaver,36,18,18
20405,Shiftkin,stormscale,1685,monk,mistweaver,54,25,29
20406,Rhatid,twisting-nether,1683,monk,mistweaver,210,113,97
20407,Bullergøjen,ravencrest,1682,monk,mistweaver,90,59,31
20408,Saáru,argent-dawn,1682,monk,mistweaver,66,41,25
20409,Ninetz,tarren-mill,1681,monk,mistweaver,30,18,12
20410,Suliya,zuluhed,1681,monk,mistweaver,48,28,20
20411,Vregorx,twisting-nether,1680,monk,mistweaver,42,25,17
20412,Mîstxd,kazzak,1679,monk,mistweaver,53,30,23
20413,Simonex,ravencrest,1678,monk,mistweaver,24,18,6
20414,Papours,ysondre,1676,monk,mistweaver,30,22,8
20415,Milksbtw,kazzak,1676,monk,mistweaver,113,79,34
20416,Quickmist,draenor,1675,monk,mistweaver,107,65,42
20417,Монккд,gordunni,1675,monk,mistweaver,183,105,78
20418,Whoszeus,archimonde,1673,monk,mistweaver,202,113,89
20419,Финуправ,soulflayer,1672,monk,mistweaver,24,18,6
20420,Aseidith,tarren-mill,1672,monk,mistweaver,48,26,22
20421,Аци,blackscar,1671,monk,mistweaver,47,31,16
20422,Dokternelg,silvermoon,1671,monk,mistweaver,36,23,13
20423,Hokespokus,silvermoon,1671,monk,mistweaver,59,37,22
20424,Jingfeng,arthas,1670,monk,mistweaver,167,79,88
20425,Артэкрио,soulflayer,1669,monk,mistweaver,54,37,17
20426,Coularx,stormscale,1669,monk,mistweaver,48,25,23
20427,Milkhy,minahonda,1669,monk,mistweaver,148,73,75
20428,Elmezz,burning-legion,1668,monk,mistweaver,39,19,20
20429,Macpunchy,defias-brotherhood,1667,monk,mistweaver,48,28,20
20430,Yto,gorgonnash,1667,monk,mistweaver,36,19,17
20431,Notdearmw,shattered-hand,1666,monk,mistweaver,36,24,12
20432,Dearmw,silvermoon,1666,monk,mistweaver,90,50,40
20433,Diffenbachia,outland,1665,monk,mistweaver,87,58,29
20434,Steveé,kazzak,1664,monk,mistweaver,36,25,11
20435,Féfè,archimonde,1663,monk,mistweaver,42,22,20
20436,Calli,auchindoun,1662,monk,mistweaver,82,42,40
20437,Xineeaa,outland,1661,monk,mistweaver,106,58,48
20438,Insømnia,ragnaros,1660,monk,mistweaver,34,21,13
20439,Mistïnguette,dalaran,1660,monk,mistweaver,216,124,92
20440,Linshai,eredar,1659,monk,mistweaver,36,23,13
20441,ßojo,kazzak,1658,monk,mistweaver,101,62,39
20442,Jûzô,illidan,1658,monk,mistweaver,36,21,15
20443,Hamsster,ravencrest,1658,monk,mistweaver,146,74,72
20444,Репаблликуес,gordunni,1656,monk,mistweaver,34,20,14
20445,Varyat,uldum,1656,monk,mistweaver,41,24,17
20446,Chichi,ravencrest,1656,monk,mistweaver,100,52,48
20447,Trollandroll,stormscale,1655,monk,mistweaver,131,71,60
20448,Эддрос,gordunni,1655,monk,mistweaver,66,35,31
20449,Mangi,rexxar,1655,monk,mistweaver,72,37,35
20450,Incmines,ravencrest,1655,monk,mistweaver,62,30,32
20451,Botspec,twisting-nether,1654,monk,mistweaver,69,46,23
20452,Kaàli,pozzo-delleternità,1654,monk,mistweaver,36,21,15
20453,Elhäbedehä,eredar,1654,monk,mistweaver,218,109,109
20454,Meltfistqt,ravencrest,1654,monk,mistweaver,112,52,60
20455,Maikez,stormreaver,1654,monk,mistweaver,46,19,27
20456,Akkadianx,ravencrest,1653,monk,mistweaver,65,38,27
20457,Cochonhalall,archimonde,1653,monk,mistweaver,42,20,22
20458,Джулибубба,borean-tundra,1650,monk,mistweaver,48,30,18
20459,Skailzkrt,hyjal,1649,monk,mistweaver,43,19,24
20460,Tøwtc,outland,1648,monk,mistweaver,63,37,26
20461,Varea,blackrock,1648,monk,mistweaver,95,47,48
20462,Leiwill,stormreaver,1647,monk,mistweaver,42,23,19
20463,Needthát,twisting-nether,1646,monk,mistweaver,48,31,17
20464,Etzu,shattrath,1646,monk,mistweaver,72,43,29
20465,Otemøøn,sanguino,1646,monk,mistweaver,45,25,20
20466,Mankee,kazzak,1646,monk,mistweaver,109,57,52
20467,Xameht,the-maelstrom,1645,monk,mistweaver,134,67,67
20468,Drugashe,archimonde,1645,monk,mistweaver,360,177,183
20469,Darlaa,ravencrest,1644,monk,mistweaver,29,18,11
20470,Imeon,dun-modr,1644,monk,mistweaver,30,18,12
20471,Freyas,outland,1644,monk,mistweaver,89,51,38
20472,Unsanegodx,ravencrest,1643,monk,mistweaver,54,38,16
20473,Eugenn,alonsus,1643,monk,mistweaver,52,29,23
20474,Invadem,shattered-hand,1642,monk,mistweaver,33,22,11
20475,Eedaza,blackrock,1642,monk,mistweaver,93,61,32
20476,Tanata,blackmoore,1642,monk,mistweaver,63,39,24
20477,Nepho,twisting-nether,1642,monk,mistweaver,38,23,15
20478,Belärus,outland,1641,monk,mistweaver,42,23,19
20479,Campix,blackmoore,1640,monk,mistweaver,111,62,49
20480,Mer,outland,1640,monk,mistweaver,44,24,20
20481,Fistify,destromath,1639,monk,mistweaver,24,20,4
20482,Saneshayne,ravencrest,1639,monk,mistweaver,29,18,11
20483,Amatör,frostwolf,1638,monk,mistweaver,30,20,10
20484,Timboqt,blackmoore,1638,monk,mistweaver,70,43,27
20485,Uftis,thrall,1637,monk,mistweaver,77,56,21
20486,Dharmå,norgannon,1637,monk,mistweaver,32,21,11
20487,Uckkm,ragnaros,1637,monk,mistweaver,42,24,18
20488,Phyxone,twisting-nether,1637,monk,mistweaver,42,21,21
20489,Apolskis,ravencrest,1636,monk,mistweaver,42,30,12
20490,Gronoz,drakthul,1636,monk,mistweaver,108,67,41
20491,Frednmonk,twisting-nether,1635,monk,mistweaver,48,26,22
20492,Karoou,kelthuzad,1635,monk,mistweaver,89,48,41
20493,Cykatea,dun-modr,1634,monk,mistweaver,615,320,295
20494,Pe,blackhand,1633,monk,mistweaver,106,58,48
20495,Raveleth,silvermoon,1632,monk,mistweaver,36,21,15
20496,Youssee,silvermoon,1632,monk,mistweaver,192,105,87
20497,Bonk,defias-brotherhood,1631,monk,mistweaver,47,22,25
20498,Schane,zuluhed,1630,monk,mistweaver,24,18,6
20499,Orcimon,draenor,1630,monk,mistweaver,30,17,13
20500,Shyreen,zirkel-des-cenarius,1630,monk,mistweaver,47,25,22
20501,Soulxq,blackrock,1629,monk,mistweaver,141,77,64
20502,Quotes,darksorrow,1629,monk,mistweaver,78,38,40
20503,Brüderlichke,elune,1629,monk,mistweaver,48,21,27
20504,Авентусс,howling-fjord,1628,monk,mistweaver,42,31,11
20505,Xurf,draenor,1628,monk,mistweaver,36,26,10
20506,Rashakura,blackrock,1628,monk,mistweaver,36,23,13
20507,Saduh,thrall,1628,monk,mistweaver,42,24,18
20508,Løta,blackmoore,1627,monk,mistweaver,30,20,10
20509,Papermakerx,blackrock,1627,monk,mistweaver,46,28,18
20510,Çz,tarren-mill,1627,monk,mistweaver,36,20,16
20511,Teamviewer,blackmoore,1627,monk,mistweaver,42,23,19
20512,Egï,azshara,1626,monk,mistweaver,47,26,21
20513,Ðéliora,la-croisade-écarlate,1626,monk,mistweaver,60,30,30
20514,Zaiyox,thrall,1626,monk,mistweaver,42,20,22
20515,Twistie,aegwynn,1626,monk,mistweaver,36,17,19
20516,Фапдао,howling-fjord,1625,monk,mistweaver,236,126,110
20517,Старыйхиро,gordunni,1624,monk,mistweaver,24,17,7
20518,Correforrest,dun-modr,1624,monk,mistweaver,105,66,39
20519,Yotke,ravencrest,1624,monk,mistweaver,48,30,18
20520,Enoffovicz,archimonde,1624,monk,mistweaver,72,43,29
20521,Rulletunna,grim-batol,1623,monk,mistweaver,42,25,17
20522,Шенген,soulflayer,1623,monk,mistweaver,36,19,17
20523,Issho,der-rat-von-dalaran,1620,monk,mistweaver,36,19,17
20524,Glaphan,the-maelstrom,1619,monk,mistweaver,29,20,9
20525,Deadlywuu,antonidas,1619,monk,mistweaver,71,44,27
20526,Endir,mazrigos,1619,monk,mistweaver,119,71,48
20527,Almonkdiga,sanguino,1619,monk,mistweaver,60,26,34
20528,Xadu,frostwolf,1618,monk,mistweaver,65,41,24
20529,Mimimatrick,hyjal,1618,monk,mistweaver,48,28,20
20530,Quezatrix,ravencrest,1617,monk,mistweaver,184,100,84
20531,Jpstwo,gorgonnash,1617,monk,mistweaver,54,28,26
20532,Jetleê,eredar,1617,monk,mistweaver,138,71,67
20533,Kwa,grim-batol,1616,monk,mistweaver,69,37,32
20534,Sonydl,archimonde,1616,monk,mistweaver,34,18,16
20535,Jiuhjitsu,blackmoore,1616,monk,mistweaver,42,21,21
20536,Fansolini,burning-legion,1616,monk,mistweaver,46,22,24
20537,Vasknem,hyjal,1615,monk,mistweaver,66,45,21
20538,Ceeja,blackmoore,1615,monk,mistweaver,137,76,61
20539,Biftas,nagrand,1614,monk,mistweaver,51,30,21
20540,Wwception,blackrock,1614,monk,mistweaver,38,22,16
20541,Harislkwamk,aegwynn,1614,monk,mistweaver,101,58,43
20542,Sensorium,ravencrest,1614,monk,mistweaver,108,59,49
20543,Watchmedamp,draenor,1613,monk,mistweaver,176,104,72
20544,Simòna,dun-modr,1613,monk,mistweaver,287,150,137
20545,Encanthar,blackhand,1613,monk,mistweaver,237,123,114
20546,Junâ,les-sentinelles,1613,monk,mistweaver,37,19,18
20547,Dr,sylvanas,1612,monk,mistweaver,36,20,16
20548,Zanizu,blackhand,1612,monk,mistweaver,60,33,27
20549,Sart,aerie-peak,1612,monk,mistweaver,42,22,20
20550,Zuvzuv,the-maelstrom,1612,monk,mistweaver,72,37,35
20551,Zodyiac,blackrock,1611,monk,mistweaver,41,29,12
20552,Andoran,hyjal,1611,monk,mistweaver,36,22,14
20553,Hydrôlîcz,blackrock,1611,monk,mistweaver,42,23,19
20554,Koraxx,blackmoore,1611,monk,mistweaver,90,46,44
20555,Stanimirov,outland,1611,monk,mistweaver,42,19,23
20556,Zxcursèd,tarren-mill,1610,monk,mistweaver,24,17,7
20557,Сэм,gordunni,1610,monk,mistweaver,30,21,9
20558,Arimira,outland,1610,monk,mistweaver,80,46,34
20559,Биак,howling-fjord,1609,monk,mistweaver,38,23,15
20560,Slizzlie,outland,1609,monk,mistweaver,45,26,19
20561,Kitingbuddha,aegwynn,1609,monk,mistweaver,114,62,52
20562,Plebmonkx,frostmane,1609,monk,mistweaver,185,98,87
20563,Nirexi,blackrock,1609,monk,mistweaver,63,32,31
20564,Лолидевочка,soulflayer,1609,monk,mistweaver,61,24,37
20565,Mikeson,sylvanas,1608,monk,mistweaver,56,35,21
20566,Даопецдын,howling-fjord,1608,monk,mistweaver,32,19,13
20567,Ignygodx,ragnaros,1608,monk,mistweaver,35,19,16
20568,Cerrya,silvermoon,1608,monk,mistweaver,48,21,27
20569,Molgar,tarren-mill,1607,monk,mistweaver,56,36,20
20570,Ulns,blackrock,1607,monk,mistweaver,60,25,35
20571,Áyell,archimonde,1606,monk,mistweaver,171,95,76
20572,Явтильте,blackscar,1606,monk,mistweaver,35,19,16
20573,Òó,vashj,1606,monk,mistweaver,66,33,33
20574,Makïi,archimonde,1605,monk,mistweaver,185,111,74
20575,Elvand,twisting-nether,1605,monk,mistweaver,89,48,41
20576,Happymonktwo,ravencrest,1605,monk,mistweaver,124,64,60
20577,Melamonk,ravencrest,1605,monk,mistweaver,335,172,163
20578,Igozoom,draenor,1604,monk,mistweaver,36,29,7
20579,Crazydingo,lightnings-blade,1604,monk,mistweaver,72,51,21
20580,Sinnermonkk,outland,1604,monk,mistweaver,30,19,11
20581,Çhên,draenor,1604,monk,mistweaver,81,48,33
20582,Якунка,soulflayer,1604,monk,mistweaver,42,20,22
20583,Chinmachine,kazzak,1603,monk,mistweaver,66,39,27
20584,Waitaminute,outland,1603,monk,mistweaver,166,97,69
20585,Bamiegoreng,aegwynn,1603,monk,mistweaver,30,17,13
20586,Амаззонния,soulflayer,1603,monk,mistweaver,168,86,82
20587,Chundan,twisting-nether,1602,monk,mistweaver,93,62,31
20588,Lizardspock,hyjal,1602,monk,mistweaver,30,17,13
20589,Räyh,outland,1602,monk,mistweaver,57,31,26
20590,Yörg,eredar,1600,monk,mistweaver,51,30,21
20591,Snookzlol,aegwynn,1600,monk,mistweaver,65,38,27
20592,Devivify,twilights-hammer,1600,monk,mistweaver,108,61,47
20593,Setup,thrall,1600,monk,mistweaver,197,111,86
20594,Ness,hyjal,1598,monk,mistweaver,30,17,13
20595,Frónzy,kazzak,1598,monk,mistweaver,206,114,92
20596,Jcchi,xavius,1597,monk,mistweaver,72,37,35
20597,Hardi,chamber-of-aspects,1597,monk,mistweaver,90,44,46
20598,Hollymêdx,blackmoore,1596,monk,mistweaver,66,39,27
20599,Nêøø,blackrock,1596,monk,mistweaver,221,130,91
20600,Vooxis,drakthul,1596,monk,mistweaver,60,35,25
20601,Монккд,soulflayer,1595,monk,mistweaver,36,25,11
20602,Demakis,stormscale,1594,monk,mistweaver,83,54,29
20603,Monkiful,haomarush,1594,monk,mistweaver,42,17,25
20604,Zenfir,sylvanas,1593,monk,mistweaver,74,46,28
20605,Rngmåchínè,ravencrest,1593,monk,mistweaver,86,44,42
20606,Saibell,scarshield-legion,1592,monk,mistweaver,42,28,14
20607,Psychoo,ragnaros,1591,monk,mistweaver,42,27,15
20608,Bonnybravo,wildhammer,1590,monk,mistweaver,30,20,10
20609,Elmonkodonko,draenor,1590,monk,mistweaver,30,17,13
20610,Shokko,uldaman,1589,monk,mistweaver,36,21,15
20611,Lacasyto,sanguino,1586,monk,mistweaver,48,34,14
20612,Pitit,outland,1584,monk,mistweaver,78,31,47
20613,Tû,nerathor,1583,monk,mistweaver,72,41,31
20614,Srav,archimonde,1583,monk,mistweaver,36,19,17
20615,Cubw,archimonde,1583,monk,mistweaver,42,20,22
20616,Spicyrice,twisting-nether,1582,monk,mistweaver,100,49,51
20617,Leblatt,blackhand,1581,monk,mistweaver,82,52,30
20618,Факенщет,soulflayer,1581,monk,mistweaver,97,56,41
20619,Слишкомхорош,thermaplugg,1580,monk,mistweaver,23,17,6
20620,Jeydi,ravencrest,1580,monk,mistweaver,86,49,37
20621,Psychocop,drakthul,1580,monk,mistweaver,227,119,108
20622,Lillklappz,outland,1579,monk,mistweaver,24,20,4
20623,Monkim,chogall,1579,monk,mistweaver,42,24,18
20624,Chiuna,sylvanas,1577,monk,mistweaver,48,25,23
20625,Syyn,twisting-nether,1576,monk,mistweaver,150,89,61
20626,Bitbird,zirkel-des-cenarius,1573,monk,mistweaver,48,29,19
20627,Monarko,twisting-nether,1573,monk,mistweaver,61,36,25
20628,Stdzym,tarren-mill,1573,monk,mistweaver,62,26,36
20629,Slugerpigen,stormscale,1572,monk,mistweaver,327,180,147
20630,Vanoarabidze,ravencrest,1572,monk,mistweaver,78,36,42
20631,Sanktxy,blackhand,1572,monk,mistweaver,81,34,47
20632,Kaizetsu,drakthul,1570,monk,mistweaver,42,28,14
20633,Warsox,aegwynn,1570,monk,mistweaver,48,26,22
20634,Orgasmix,tarren-mill,1569,monk,mistweaver,42,21,21
20635,Basthek,blackhand,1568,monk,mistweaver,48,23,25
20636,Hugemuffin,the-maelstrom,1567,monk,mistweaver,60,41,19
20637,Dosakua,silvermoon,1563,monk,mistweaver,66,38,28
20638,Jinhee,nemesis,1562,monk,mistweaver,66,44,22
20639,Jum,blackhand,1561,monk,mistweaver,42,27,15
20640,Chàrràth,blackmoore,1561,monk,mistweaver,128,64,64
20641,Madafis,twisting-nether,1560,monk,mistweaver,42,28,14
20642,Nerdmonkx,tarren-mill,1560,monk,mistweaver,36,21,15
20643,Fungku,azjolnerub,1560,monk,mistweaver,279,143,136
20644,Endorrphine,ravencrest,1560,monk,mistweaver,110,48,62
20645,Mòñkêÿgøðx,outland,1558,monk,mistweaver,36,23,13
20646,Namelessmist,drakthul,1558,monk,mistweaver,60,35,25
20647,Jasonbbmist,stormscale,1558,monk,mistweaver,36,21,15
20648,Musslee,elune,1556,monk,mistweaver,105,54,51
20649,Isadri,madmortem,1555,monk,mistweaver,36,21,15
20650,Mushush,draenor,1554,monk,mistweaver,62,34,28
20651,Thiiogg,archimonde,1553,monk,mistweaver,44,18,26
20652,Ouaipäül,archimonde,1552,monk,mistweaver,36,19,17
20653,Dromarch,dun-modr,1552,monk,mistweaver,51,26,25
20654,Monkymonka,antonidas,1551,monk,mistweaver,127,64,63
20655,Blondefurry,twisting-nether,1550,monk,mistweaver,42,28,14
20656,Garcon,tarren-mill,1550,monk,mistweaver,42,24,18
20657,Klotsobunidi,kazzak,1550,monk,mistweaver,102,52,50
20658,Idrdob,kazzak,1548,monk,mistweaver,140,78,62
20659,Rzi,amanthul,1548,monk,mistweaver,155,86,69
20660,Taìka,archimonde,1546,monk,mistweaver,27,17,10
20661,Prettysus,silvermoon,1546,monk,mistweaver,66,41,25
20662,Visk,blackmoore,1545,monk,mistweaver,131,73,58
20663,Njursten,twilights-hammer,1545,monk,mistweaver,260,132,128
20664,Kirkeý,ravencrest,1544,monk,mistweaver,55,31,24
20665,Barracüs,dun-modr,1544,monk,mistweaver,78,43,35
20666,Кулаквнос,gordunni,1544,monk,mistweaver,78,39,39
20667,Inthepoopa,outland,1543,monk,mistweaver,102,56,46
20668,Eckø,rashgarroth,1542,monk,mistweaver,88,52,36
20669,Milkabtw,kazzak,1542,monk,mistweaver,43,25,18
20670,Вдыхайтуман,gordunni,1542,monk,mistweaver,96,52,44
20671,Тевикс,gordunni,1542,monk,mistweaver,60,30,30
20672,Индоран,howling-fjord,1541,monk,mistweaver,66,47,19
20673,Bîgmø,blades-edge,1540,monk,mistweaver,30,20,10
20674,Kåýðø,archimonde,1540,monk,mistweaver,90,48,42
20675,Zikzer,darksorrow,1536,monk,mistweaver,51,29,22
20676,Smâsh,blackhand,1535,monk,mistweaver,70,44,26
20677,Jusn,tarren-mill,1535,monk,mistweaver,113,64,49
20678,Zenmastêr,twisting-nether,1535,monk,mistweaver,190,107,83
20679,Тучковский,lich-king,1535,monk,mistweaver,102,57,45
20680,Absolutezen,tarren-mill,1535,monk,mistweaver,66,34,32
20681,Desmî,ravencrest,1534,monk,mistweaver,26,20,6
20682,Incapme,outland,1534,monk,mistweaver,121,71,50
20683,Pembi,blades-edge,1534,monk,mistweaver,80,39,41
20684,Vitnam,auchindoun,1533,monk,mistweaver,84,51,33
20685,Ashenore,outland,1533,monk,mistweaver,42,17,25
20686,Loddarita,ravencrest,1532,monk,mistweaver,54,38,16
20687,Progresse,tarren-mill,1532,monk,mistweaver,54,28,26
20688,Chikokon,silvermoon,1531,monk,mistweaver,63,42,21
20689,Windspiritt,ragnaros,1531,monk,mistweaver,60,31,29
20690,Djsnake,blackrock,1528,monk,mistweaver,24,16,8
20691,Woushou,outland,1528,monk,mistweaver,138,81,57
20692,Karatekickyo,ravencrest,1528,monk,mistweaver,40,22,18
20693,Mistbringer,kazzak,1528,monk,mistweaver,244,130,114
20694,Saitamä,archimonde,1528,monk,mistweaver,98,45,53
20695,Urbàs,blackmoore,1526,monk,mistweaver,42,29,13
20696,Àjay,outland,1526,monk,mistweaver,24,16,8
20697,Doingmaster,blackrock,1526,monk,mistweaver,42,22,20
20698,Shkorwi,drakthul,1525,monk,mistweaver,30,17,13
20699,Musashiden,twisting-nether,1525,monk,mistweaver,42,23,19
20700,Xfu,auchindoun,1525,monk,mistweaver,48,24,24
20701,Gravityfist,aegwynn,1525,monk,mistweaver,60,28,32
20702,Clemoine,archimonde,1524,monk,mistweaver,24,16,8
20703,Xoleck,aegwynn,1522,monk,mistweaver,36,16,20
20704,Дилейнх,gordunni,1521,monk,mistweaver,24,16,8
20705,Uncleheal,tarren-mill,1521,monk,mistweaver,37,21,16
20706,Yumhai,dun-modr,1520,monk,mistweaver,48,26,22
20707,Plaguer,nordrassil,1519,monk,mistweaver,30,18,12
20708,Kæmará,blackrock,1519,monk,mistweaver,30,16,14
20709,Bláckøutx,quelthalas,1518,monk,mistweaver,49,30,19
20710,Mightnorn,tarren-mill,1517,monk,mistweaver,36,20,16
20711,Erannas,turalyon,1517,monk,mistweaver,29,16,13
20712,Dmonk,alakir,1517,monk,mistweaver,72,34,38
20713,Misthera,burning-legion,1517,monk,mistweaver,90,41,49
20714,Eynodiggity,blackmoore,1516,monk,mistweaver,72,38,34
20715,Kobudo,burning-legion,1516,monk,mistweaver,110,51,59
20716,Ticktak,archimonde,1515,monk,mistweaver,86,52,34
20717,Timmyßênz,kaelthas,1515,monk,mistweaver,77,46,31
20718,Pundok,blackrock,1515,monk,mistweaver,110,65,45
20719,Sobadzlolz,alexstrasza,1515,monk,mistweaver,60,28,32
20720,Aryaz,ravencrest,1515,monk,mistweaver,69,32,37
20721,Shàká,stormscale,1514,monk,mistweaver,30,22,8
20722,Piednuques,archimonde,1514,monk,mistweaver,46,20,26
20723,Notfist,kazzak,1513,monk,mistweaver,54,35,19
20724,Børis,draenor,1513,monk,mistweaver,92,54,38
20725,Xiaokingqvq,silvermoon,1512,monk,mistweaver,78,41,37
20726,Xado,aegwynn,1511,monk,mistweaver,24,16,8
20727,Aryphus,blackmoore,1511,monk,mistweaver,36,18,18
20728,Elity,archimonde,1510,monk,mistweaver,82,54,28
20729,Medovic,blackmoore,1510,monk,mistweaver,156,89,67
20730,Лалафест,soulflayer,1510,monk,mistweaver,46,25,21
20731,Oneshotmacro,spinebreaker,1509,monk,mistweaver,24,16,8
20732,Orkiya,archimonde,1507,monk,mistweaver,324,170,154
20733,Cbmonk,sylvanas,1506,monk,mistweaver,50,34,16
20734,Spoompls,argent-dawn,1505,monk,mistweaver,54,24,30
20735,Gernokz,antonidas,1504,monk,mistweaver,156,84,72
20736,Darkkmonk,dun-modr,1504,monk,mistweaver,101,51,50
20737,Aeolôs,hyjal,1503,monk,mistweaver,48,27,21
20738,Ричфлекс,howling-fjord,1503,monk,mistweaver,218,122,96
20739,Caniluvz,eredar,1501,monk,mistweaver,24,16,8
20740,Самадайка,howling-fjord,1501,monk,mistweaver,154,80,74
20741,Гачитварина,galakrond,1499,monk,mistweaver,24,16,8
20742,Lefferubie,hyjal,1499,monk,mistweaver,36,20,16
20743,Calmpalms,tarren-mill,1499,monk,mistweaver,87,45,42
20744,Benenutz,archimonde,1498,monk,mistweaver,36,27,9
20745,Trnd,draenor,1497,monk,mistweaver,47,19,28
20746,Shiesel,draenor,1496,monk,mistweaver,42,24,18
20747,Miînd,tarren-mill,1494,monk,mistweaver,60,35,25
20748,Monkzdino,destromath,1494,monk,mistweaver,47,24,23
20749,Civix,sanguino,1492,monk,mistweaver,116,69,47
20750,Stramonk,nemesis,1492,monk,mistweaver,199,96,103
20751,Zukatan,tarren-mill,1491,monk,mistweaver,81,45,36
20752,Chakuro,ravencrest,1488,monk,mistweaver,30,20,10
20753,Gråce,nemesis,1488,monk,mistweaver,140,82,58
20754,Thuz,kazzak,1488,monk,mistweaver,63,34,29
20755,Quicc,ravencrest,1488,monk,mistweaver,72,36,36
20756,Skusle,defias-brotherhood,1487,monk,mistweaver,30,19,11
20757,Oregan,conseil-des-ombres,1487,monk,mistweaver,36,19,17
20758,Kegrøll,doomhammer,1486,monk,mistweaver,54,29,25
20759,Moveietss,stormscale,1485,monk,mistweaver,18,16,2
20760,Nihao,tarren-mill,1485,monk,mistweaver,56,30,26
20761,Bóber,kazzak,1485,monk,mistweaver,42,22,20
20762,Sneezao,ravencrest,1484,monk,mistweaver,150,82,68
20763,Инженерия,howling-fjord,1483,monk,mistweaver,54,32,22
20764,Sindresa,outland,1483,monk,mistweaver,108,51,57
20765,Ohmegah,frostmane,1481,monk,mistweaver,24,18,6
20766,Fluki,twisting-nether,1480,monk,mistweaver,48,24,24
20767,Kano,burning-legion,1479,monk,mistweaver,38,23,15
20768,Kreynich,blackhand,1477,monk,mistweaver,36,25,11
20769,Dìó,tarren-mill,1477,monk,mistweaver,210,117,93
20770,Leôlulu,blackmoore,1476,monk,mistweaver,36,27,9
20771,Влажныйтач,soulflayer,1475,monk,mistweaver,30,19,11
20772,Teninchwilly,outland,1475,monk,mistweaver,31,18,13
20773,Jihaaz,nemesis,1475,monk,mistweaver,106,56,50
20774,Fatskeleton,stormreaver,1475,monk,mistweaver,427,198,229
20775,Kungfubatti,stormscale,1474,monk,mistweaver,173,96,77
20776,Okdontnerf,kazzak,1473,monk,mistweaver,82,39,43
20777,Фешнмонк,soulflayer,1471,monk,mistweaver,30,17,13
20778,Монкиннияя,gordunni,1471,monk,mistweaver,45,21,24
20779,Bullbøx,chamber-of-aspects,1471,monk,mistweaver,93,38,55
20780,Wushin,antonidas,1470,monk,mistweaver,27,17,10
20781,Farmander,silvermoon,1470,monk,mistweaver,149,88,61
20782,Moistweaver,hellfire,1468,monk,mistweaver,84,44,40
20783,Zenified,ragnaros,1468,monk,mistweaver,82,40,42
20784,Zinnout,twisting-nether,1467,monk,mistweaver,54,35,19
20785,Teacup,aegwynn,1467,monk,mistweaver,131,79,52
20786,Venac,burning-legion,1466,monk,mistweaver,185,110,75
20787,Meuhporgg,hyjal,1463,monk,mistweaver,36,25,11
20788,Zeldrís,ragnaros,1463,monk,mistweaver,96,46,50
20789,Пивкотянка,gordunni,1462,monk,mistweaver,30,22,8
20790,Sshbrew,kazzak,1462,monk,mistweaver,48,26,22
20791,Watchôut,blackmoore,1462,monk,mistweaver,74,40,34
20792,Caskgut,ravencrest,1461,monk,mistweaver,95,58,37
20793,Hymonk,draenor,1459,monk,mistweaver,42,25,17
20794,Guthäxlul,khazgoroth,1459,monk,mistweaver,281,152,129
20795,Pøwcow,blackrock,1459,monk,mistweaver,113,61,52
20796,Noni,gorgonnash,1459,monk,mistweaver,65,31,34
20797,Gucciweaver,tarren-mill,1458,monk,mistweaver,30,19,11
20798,Тадоичи,soulflayer,1458,monk,mistweaver,78,47,31
20799,Rheinair,antonidas,1457,monk,mistweaver,78,37,41
20800,Sinthorasas,blackrock,1453,monk,mistweaver,54,28,26
20801,Bambøuéqtz,khaz-modan,1452,monk,mistweaver,42,27,15
20802,Drâcømørt,dalaran,1452,monk,mistweaver,33,21,12
20803,Kroyus,antonidas,1450,monk,mistweaver,120,63,57
20804,Неэверида,deepholm,1449,monk,mistweaver,180,94,86
20805,Rebekko,pozzo-delleternità,1449,monk,mistweaver,126,62,64
20806,Cybert,blackmoore,1449,monk,mistweaver,59,25,34
20807,Jyll,malganis,1449,monk,mistweaver,131,52,79
20808,Aebì,dalaran,1448,monk,mistweaver,36,23,13
20809,Suggy,kilrogg,1447,monk,mistweaver,40,22,18
20810,Lökmedsmör,draenor,1446,monk,mistweaver,30,23,7
20811,Coopers,hyjal,1444,monk,mistweaver,77,42,35
20812,Larå,ravencrest,1444,monk,mistweaver,223,119,104
20813,Daitaro,ravencrest,1443,monk,mistweaver,80,43,37
20814,Bleja,blackhand,1442,monk,mistweaver,160,85,75
20815,Guanglee,silvermoon,1441,monk,mistweaver,56,37,19
20816,Monkadorie,twisting-nether,1441,monk,mistweaver,62,39,23
20817,Mëñghûøx,sylvanas,1439,monk,mistweaver,24,15,9
20818,Mugenzenx,sanguino,1439,monk,mistweaver,24,15,9
20819,Achtal,blackmoore,1439,monk,mistweaver,41,23,18
20820,Chisurgeon,outland,1438,monk,mistweaver,24,15,9
20821,Benzzy,ragnaros,1435,monk,mistweaver,43,26,17
20822,Vivir,stormreaver,1435,monk,mistweaver,133,75,58
20823,Poyi,ravencrest,1434,monk,mistweaver,24,15,9
20824,Ähronius,stormscale,1434,monk,mistweaver,24,15,9
20825,Kungfox,frostwolf,1434,monk,mistweaver,36,17,19
20826,Musaya,chamber-of-aspects,1434,monk,mistweaver,48,21,27
20827,Freebírd,shattered-hand,1431,monk,mistweaver,45,31,14
20828,Heartless,sporeggar,1430,monk,mistweaver,42,30,12
20829,Tokz,ravencrest,1430,monk,mistweaver,30,19,11
20830,Nievah,argent-dawn,1430,monk,mistweaver,39,24,15
20831,Malkaviano,kazzak,1430,monk,mistweaver,80,46,34
20832,Xadoqt,aegwynn,1429,monk,mistweaver,24,15,9
20833,Monkgd,sylvanas,1428,monk,mistweaver,152,85,67
20834,Saliya,draenor,1428,monk,mistweaver,34,16,18
20835,Puddinpop,auchindoun,1427,monk,mistweaver,61,29,32
20836,Slâpzz,ravencrest,1426,monk,mistweaver,18,15,3
20837,Mentonk,frostwolf,1426,monk,mistweaver,24,15,9
20838,Скорпин,ashenvale,1426,monk,mistweaver,68,35,33
20839,Nèver,dalaran,1426,monk,mistweaver,30,15,15
20840,Applestrûdel,blackrock,1425,monk,mistweaver,45,27,18
20841,Brewzleè,ravencrest,1425,monk,mistweaver,52,27,25
20842,Oddessa,ravenholdt,1424,monk,mistweaver,143,79,64
20843,Zavarius,silvermoon,1424,monk,mistweaver,36,17,19
20844,Capwouk,tarren-mill,1423,monk,mistweaver,24,15,9
20845,Yarie,blackmoore,1423,monk,mistweaver,78,39,39
20846,Тсайм,howling-fjord,1423,monk,mistweaver,36,15,21
20847,Pikajeww,kazzak,1422,monk,mistweaver,50,37,13
20848,Zenzu,blackmoore,1422,monk,mistweaver,36,24,12
20849,Dumplings,earthen-ring,1422,monk,mistweaver,48,29,19
20850,Bigchaz,outland,1421,monk,mistweaver,24,15,9
20851,Conguitø,colinas-pardas,1421,monk,mistweaver,30,17,13
20852,Ikuyaa,ravencrest,1421,monk,mistweaver,29,15,14
20853,Xianxiaa,ravencrest,1420,monk,mistweaver,88,51,37
20854,Dudulinda,silvermoon,1419,monk,mistweaver,108,56,52
20855,Imamonk,tarren-mill,1419,monk,mistweaver,30,15,15
20856,Saolin,emeriss,1417,monk,mistweaver,54,31,23
20857,ßountÿ,kazzak,1416,monk,mistweaver,66,46,20
20858,Dachilla,gilneas,1416,monk,mistweaver,28,16,12
20859,Xplosiv,twisting-nether,1416,monk,mistweaver,244,128,116
20860,Affrro,drakthul,1415,monk,mistweaver,42,25,17
20861,Aironqqt,blackhand,1415,monk,mistweaver,29,17,12
20862,Greenshortea,aegwynn,1415,monk,mistweaver,52,30,22
20863,Масакрейн,howling-fjord,1415,monk,mistweaver,182,87,95
20864,Mistsen,kazzak,1414,monk,mistweaver,81,47,34
20865,Hulkules,blackhand,1413,monk,mistweaver,24,19,5
20866,Bendís,twisting-nether,1413,monk,mistweaver,36,18,18
20867,Deusfist,ravencrest,1413,monk,mistweaver,36,15,21
20868,Qlmo,ravencrest,1412,monk,mistweaver,30,21,9
20869,Dipdop,blackhand,1412,monk,mistweaver,171,101,70
20870,Shailene,kazzak,1411,monk,mistweaver,69,50,19
20871,Kyukoku,blackmoore,1411,monk,mistweaver,28,16,12
20872,Shiguru,dun-morogh,1411,monk,mistweaver,149,80,69
20873,Shenson,mazrigos,1409,monk,mistweaver,30,20,10
20874,Snack,mannoroth,1408,monk,mistweaver,24,16,8
20875,Kéza,culte-de-la-rive-noire,1407,monk,mistweaver,28,16,12
20876,Soyuz,die-aldor,1406,monk,mistweaver,36,23,13
20877,Orenjis,kazzak,1405,monk,mistweaver,40,19,21
20878,Мирюзаки,gordunni,1404,monk,mistweaver,58,34,24
20879,Edll,silvermoon,1403,monk,mistweaver,24,15,9
20880,Kify,dun-modr,1402,monk,mistweaver,33,19,14
20881,Gigilonis,korgall,1397,monk,mistweaver,170,89,81
20882,Wryktas,aegwynn,1396,monk,mistweaver,18,15,3
20883,Notadrâgon,sylvanas,1396,monk,mistweaver,28,15,13
20884,Keksmash,ravencrest,1396,monk,mistweaver,68,33,35
20885,Nela,sanguino,1395,monk,mistweaver,36,20,16
20886,Kushvendorx,silvermoon,1394,monk,mistweaver,66,34,32
20887,Pantyypolice,blackrock,1393,monk,mistweaver,22,16,6
20888,Folfimo,silvermoon,1393,monk,mistweaver,29,17,12
20889,Picayune,mazrigos,1391,monk,mistweaver,48,29,19
20890,Panicfist,stormscale,1391,monk,mistweaver,45,21,24
20891,Baddany,sanguino,1390,monk,mistweaver,102,57,45
20892,Popcornn,archimonde,1389,monk,mistweaver,54,29,25
20893,Kungfupandy,blackmoore,1388,monk,mistweaver,180,99,81
20894,Mythadeya,stormscale,1388,monk,mistweaver,54,21,33
20895,Haxxo,die-nachtwache,1387,monk,mistweaver,32,22,10
20896,Romk,darkspear,1387,monk,mistweaver,48,32,16
20897,Badcøwboy,archimonde,1387,monk,mistweaver,122,54,68
20898,Mistfistmw,outland,1387,monk,mistweaver,66,29,37
20899,Rymz,sanguino,1385,monk,mistweaver,85,50,35
20900,Moohamood,argent-dawn,1384,monk,mistweaver,72,29,43
20901,Monkehst,dun-modr,1383,monk,mistweaver,96,50,46
20902,Umagon,chogall,1383,monk,mistweaver,60,29,31
20903,Roidcarry,blackrock,1383,monk,mistweaver,41,16,25
20904,Striptina,blackmoore,1382,monk,mistweaver,90,49,41
20905,Bigballs,ysera,1382,monk,mistweaver,36,15,21
20906,Pandimaci,ragnaros,1381,monk,mistweaver,101,56,45
20907,Pandacus,silvermoon,1381,monk,mistweaver,90,40,50
20908,Tyzin,blackrock,1380,monk,mistweaver,66,37,29
20909,Smmithyy,draenor,1379,monk,mistweaver,34,19,15
20910,Garmuth,tarren-mill,1378,monk,mistweaver,40,25,15
20911,Kruemelkeks,frostwolf,1378,monk,mistweaver,57,33,24
20912,Barks,archimonde,1378,monk,mistweaver,70,40,30
20913,Amélith,kirin-tor,1378,monk,mistweaver,42,23,19
20914,Awesomebrah,the-maelstrom,1377,monk,mistweaver,24,15,9
20915,Onlyvegan,ravencrest,1375,monk,mistweaver,28,16,12
20916,Bukkits,argent-dawn,1375,monk,mistweaver,48,22,26
20917,Xladerzz,kazzak,1374,monk,mistweaver,23,15,8
20918,Jarô,silvermoon,1374,monk,mistweaver,130,58,72
20919,Brofist,emeriss,1374,monk,mistweaver,79,35,44
20920,Германика,soulflayer,1372,monk,mistweaver,225,108,117
20921,Akùmawíns,archimonde,1368,monk,mistweaver,48,21,27
20922,Faa,archimonde,1367,monk,mistweaver,23,17,6
20923,Fuzzypunch,draenor,1366,monk,mistweaver,106,58,48
20924,Torqualis,kazzak,1366,monk,mistweaver,155,81,74
20925,Beaglemo,blackrock,1366,monk,mistweaver,35,15,20
20926,Myfresh,ysondre,1366,monk,mistweaver,38,16,22
20927,Boozmoo,stormscale,1365,monk,mistweaver,40,32,8
20928,Profylaxist,arathor,1365,monk,mistweaver,95,49,46
20929,Konexzx,blackmoore,1364,monk,mistweaver,36,22,14
20930,Coollann,drakthul,1364,monk,mistweaver,58,26,32
20931,Sanhollo,stormscale,1361,monk,mistweaver,23,15,8
20932,Heyami,ravencrest,1360,monk,mistweaver,48,16,32
20933,Mareki,nethersturm,1359,monk,mistweaver,50,28,22
20934,Brêwjob,archimonde,1356,monk,mistweaver,34,20,14
20935,Nevelbeast,rexxar,1356,monk,mistweaver,69,38,31
20936,Дольчипауэр,soulflayer,1355,monk,mistweaver,59,37,22
20937,Dánný,antonidas,1354,monk,mistweaver,43,26,17
20938,Thayne,blades-edge,1354,monk,mistweaver,30,15,15
20939,Патаомальчик,blackscar,1352,monk,mistweaver,35,15,20
20940,Løsang,blackrock,1350,monk,mistweaver,143,86,57
20941,Mécagnóme,dalaran,1350,monk,mistweaver,96,51,45
20942,Touchofmonk,draenor,1348,monk,mistweaver,48,26,22
20943,Discoelysia,outland,1348,monk,mistweaver,96,47,49
20944,Yahní,eredar,1347,monk,mistweaver,65,37,28
20945,Nîcko,ravencrest,1347,monk,mistweaver,30,17,13
20946,Kwacisawhe,die-aldor,1347,monk,mistweaver,56,25,31
20947,Smitheal,outland,1346,monk,mistweaver,18,15,3
20948,Сильфиета,gordunni,1345,monk,mistweaver,65,37,28
20949,Хэйхати,gordunni,1345,monk,mistweaver,158,82,76
20950,Marvboy,aegwynn,1343,monk,mistweaver,18,14,4
20951,Rokobasilisk,outland,1343,monk,mistweaver,24,14,10
20952,Dodomino,archimonde,1343,monk,mistweaver,24,14,10
20953,Æctò,blackmoore,1343,monk,mistweaver,59,27,32
20954,Кувырбек,howling-fjord,1342,monk,mistweaver,18,14,4
20955,Akuuji,silvermoon,1342,monk,mistweaver,24,14,10
20956,Zagar,emeriss,1342,monk,mistweaver,24,14,10
20957,Izuwumi,ragnaros,1342,monk,mistweaver,24,14,10
20958,Scare,stormreaver,1342,monk,mistweaver,49,24,25
20959,Ipmonk,outland,1341,monk,mistweaver,18,14,4
20960,Carloz,drakthul,1340,monk,mistweaver,60,38,22
20961,Brucechi,kargath,1338,monk,mistweaver,36,31,5
20962,Førzãlêvskî,ravencrest,1338,monk,mistweaver,18,14,4
20963,Mônkykong,ravencrest,1338,monk,mistweaver,24,14,10
20964,Kandislee,ravencrest,1338,monk,mistweaver,36,15,21
20965,Jeññie,stormscale,1337,monk,mistweaver,18,14,4
20966,Atenazadonte,sanguino,1337,monk,mistweaver,27,16,11
20967,Lazyslooth,ravencrest,1337,monk,mistweaver,30,14,16
20968,Фериго,gordunni,1336,monk,mistweaver,36,19,17
20969,Tidemist,argent-dawn,1335,monk,mistweaver,24,14,10
20970,Sînê,archimonde,1334,monk,mistweaver,33,19,14
20971,Ilovesnoopy,blackmoore,1333,monk,mistweaver,24,14,10
20972,Evilrui,ravencrest,1333,monk,mistweaver,30,15,15
20973,Boomboôom,outland,1332,monk,mistweaver,24,14,10
20974,Marielo,blackmoore,1331,monk,mistweaver,39,27,12
20975,Maqs,argent-dawn,1331,monk,mistweaver,42,27,15
20976,Spiritualia,kazzak,1331,monk,mistweaver,68,39,29
20977,Acidflexx,kazzak,1331,monk,mistweaver,41,20,21
20978,Mistur,blackrock,1331,monk,mistweaver,30,14,16
20979,Миамита,eversong,1330,monk,mistweaver,57,30,27
20980,Гиббискус,gordunni,1330,monk,mistweaver,42,18,24
20981,Уиннии,soulflayer,1329,monk,mistweaver,24,14,10
20982,Sajin,la-croisade-écarlate,1329,monk,mistweaver,36,15,21
20983,Sÿldae,dun-modr,1328,monk,mistweaver,30,21,9
20984,Wannabejoker,stormscale,1328,monk,mistweaver,24,14,10
20985,Córporation,outland,1327,monk,mistweaver,30,14,16
20986,Ariluna,tarren-mill,1326,monk,mistweaver,24,14,10
20987,Salix,quelthalas,1325,monk,mistweaver,32,20,12
20988,Krylin,antonidas,1322,monk,mistweaver,93,45,48
20989,Lovange,silvermoon,1320,monk,mistweaver,24,14,10
20990,Vladikus,tarren-mill,1320,monk,mistweaver,105,50,55
20991,Monkypunch,tarren-mill,1319,monk,mistweaver,46,23,23
20992,Адскиймех,deathweaver,1317,monk,mistweaver,69,36,33
20993,Scpdevil,outland,1316,monk,mistweaver,22,15,7
20994,Akalaja,alakir,1316,monk,mistweaver,34,19,15
20995,Erenaar,nemesis,1315,monk,mistweaver,42,24,18
20996,Genjosanso,kazzak,1315,monk,mistweaver,177,97,80
20997,Bruceliam,emerald-dream,1315,monk,mistweaver,30,14,16
20998,Thegrudge,dragonblight,1315,monk,mistweaver,42,16,26
20999,Йомо,borean-tundra,1315,monk,mistweaver,54,20,34
21000,Shreckmonk,burning-blade,1313,monk,mistweaver,30,14,16
21001,Brewswíllis,tarren-mill,1312,monk,mistweaver,18,14,4
21002,Lfmasctop,ravencrest,1312,monk,mistweaver,22,16,6
21003,Pinkstar,kazzak,1312,monk,mistweaver,24,15,9
21004,Blinkër,sanguino,1311,monk,mistweaver,36,19,17
21005,Рекилоллз,gordunni,1311,monk,mistweaver,59,31,28
21006,Leefang,neptulon,1311,monk,mistweaver,49,24,25
21007,Extrimist,sylvanas,1310,monk,mistweaver,150,76,74
21008,Rèddit,kazzak,1310,monk,mistweaver,78,37,41
21009,Facetimee,ahnqiraj,1309,monk,mistweaver,34,19,15
21010,Loreo,burning-legion,1305,monk,mistweaver,99,57,42
21011,Трикленд,azuregos,1305,monk,mistweaver,42,21,21
21012,Theichi,draenor,1304,monk,mistweaver,42,23,19
21013,Onlyfísts,stormscale,1304,monk,mistweaver,48,16,32
21014,Bizzet,jaedenar,1303,monk,mistweaver,27,17,10
21015,Applemonk,tarren-mill,1302,monk,mistweaver,58,28,30
21016,Fistingfury,burning-blade,1302,monk,mistweaver,103,46,57
21017,Murdalum,ravencrest,1301,monk,mistweaver,30,17,13
21018,Tetetete,silvermoon,1301,monk,mistweaver,85,38,47
21019,Ðëvx,argent-dawn,1300,monk,mistweaver,96,52,44
21020,Quendi,arthas,1300,monk,mistweaver,191,97,94
21021,Звиздаатый,blackscar,1299,monk,mistweaver,18,14,4
21022,Moinalisaa,outland,1299,monk,mistweaver,30,18,12
21023,Джоский,borean-tundra,1299,monk,mistweaver,72,29,43
21024,Камикадзэн,gordunni,1296,monk,mistweaver,24,15,9
21025,Lanuia,aegwynn,1295,monk,mistweaver,21,14,7
21026,Zenmist,kazzak,1294,monk,mistweaver,23,14,9
21027,Stolas,spinebreaker,1293,monk,mistweaver,36,24,12
21028,Moonica,zenedar,1291,monk,mistweaver,26,17,9
21029,Tintatama,aszune,1291,monk,mistweaver,124,61,63
21030,Boomshaq,defias-brotherhood,1288,monk,mistweaver,119,60,59
21031,Galaxyfist,ragnaros,1287,monk,mistweaver,177,92,85
21032,Proxxyqt,blackrock,1285,monk,mistweaver,20,15,5
21033,Carnat,blackrock,1284,monk,mistweaver,30,17,13
21034,Trivi,blackrock,1284,monk,mistweaver,45,24,21
21035,Siamesedream,outland,1283,monk,mistweaver,60,37,23
21036,Rsk,antonidas,1283,monk,mistweaver,28,16,12
21037,Drboombay,kazzak,1283,monk,mistweaver,38,21,17
21038,Saeedki,wildhammer,1283,monk,mistweaver,27,14,13
21039,Shakal,outland,1280,monk,mistweaver,36,23,13
21040,Jetchi,twisting-nether,1279,monk,mistweaver,101,59,42
21041,Янезнаюкенни,soulflayer,1279,monk,mistweaver,48,26,22
21042,Mischenka,thrall,1279,monk,mistweaver,54,27,27
21043,Marrave,chogall,1279,monk,mistweaver,90,37,53
21044,Amemiya,sanguino,1278,monk,mistweaver,24,14,10
21045,Toshi,argent-dawn,1277,monk,mistweaver,54,32,22
21046,Lízãriñ,ravencrest,1277,monk,mistweaver,52,28,24
21047,Numpys,sanguino,1277,monk,mistweaver,29,14,15
21048,Gottegrisen,sylvanas,1277,monk,mistweaver,51,21,30
21049,Ráây,blackrock,1276,monk,mistweaver,36,22,14
21050,Bruceflea,blackrock,1275,monk,mistweaver,156,83,73
21051,Tsifsakari,silvermoon,1274,monk,mistweaver,102,41,61
21052,Ugras,auchindoun,1273,monk,mistweaver,36,14,22
21053,Cranecannon,aegwynn,1272,monk,mistweaver,24,14,10
21054,Mickjabber,aegwynn,1272,monk,mistweaver,36,19,17
21055,Bloodpanci,ragnaros,1270,monk,mistweaver,57,32,25
21056,Vetocorleone,kazzak,1268,monk,mistweaver,141,71,70
21057,Mishax,draenor,1268,monk,mistweaver,78,38,40
21058,Juicyloux,aegwynn,1266,monk,mistweaver,51,35,16
21059,Bulletproof,bloodscalp,1266,monk,mistweaver,42,24,18
21060,Rotkäppchen,blackmoore,1265,monk,mistweaver,23,14,9
21061,Szilvia,sylvanas,1263,monk,mistweaver,48,25,23
21062,Bluum,ravencrest,1263,monk,mistweaver,54,23,31
21063,Evelios,blackmoore,1262,monk,mistweaver,41,23,18
21064,Boredom,wildhammer,1261,monk,mistweaver,75,42,33
21065,Алли,lich-king,1260,monk,mistweaver,72,31,41
21066,Kîârâ,frostwolf,1259,monk,mistweaver,28,17,11
21067,Macgyverr,outland,1258,monk,mistweaver,24,14,10
21068,Schaulong,blackmoore,1258,monk,mistweaver,72,34,38
21069,Sandrafarm,ragnaros,1257,monk,mistweaver,102,65,37
21070,Юансноу,blackscar,1257,monk,mistweaver,36,19,17
21071,Chígoku,grim-batol,1257,monk,mistweaver,52,23,29
21072,Daltailr,silvermoon,1257,monk,mistweaver,54,22,32
21073,Zaïn,hyjal,1256,monk,mistweaver,43,22,21
21074,Mestro,argent-dawn,1255,monk,mistweaver,172,94,78
21075,Putrezitu,ragnaros,1252,monk,mistweaver,27,17,10
21076,Oogwai,twisting-nether,1249,monk,mistweaver,24,14,10
21077,Sheishot,kazzak,1249,monk,mistweaver,31,15,16
21078,Angeryw,kazzak,1248,monk,mistweaver,18,13,5
21079,Supaverli,archimonde,1248,monk,mistweaver,18,13,5
21080,Katmunk,kazzak,1248,monk,mistweaver,18,13,5
21081,Hialdó,sylvanas,1248,monk,mistweaver,24,14,10
21082,Worf,haomarush,1247,monk,mistweaver,54,30,24
21083,Catmønk,drakthul,1247,monk,mistweaver,24,13,11
21084,Batmanwife,stormscale,1247,monk,mistweaver,24,13,11
21085,Ajay,outland,1247,monk,mistweaver,30,13,17
21086,Xdhehehexd,twisting-nether,1246,monk,mistweaver,18,13,5
21087,Deliveroo,twisting-nether,1246,monk,mistweaver,24,13,11
21088,Йуппи,galakrond,1246,monk,mistweaver,24,13,11
21089,Salsina,nemesis,1246,monk,mistweaver,138,74,64
21090,Nesthorian,draenor,1246,monk,mistweaver,123,61,62
21091,Репабликус,gordunni,1246,monk,mistweaver,30,13,17
21092,Eclipsè,dragonmaw,1245,monk,mistweaver,23,14,9
21093,Deore,kazzak,1245,monk,mistweaver,24,13,11
21094,Mcloving,turalyon,1245,monk,mistweaver,29,14,15
21095,Ana,eredar,1244,monk,mistweaver,24,13,11
21096,Kunolis,kazzak,1244,monk,mistweaver,42,22,20
21097,Spinonyou,silvermoon,1243,monk,mistweaver,18,13,5
21098,Кубермонкер,gordunni,1243,monk,mistweaver,24,13,11
21099,Nìkâ,blackmoore,1243,monk,mistweaver,57,29,28
21100,Yeetkunmeep,outland,1243,monk,mistweaver,54,25,29
21101,Bigmckoy,kazzak,1242,monk,mistweaver,21,14,7
21102,Kuug,ravencrest,1241,monk,mistweaver,24,13,11
21103,Kammia,drekthar,1241,monk,mistweaver,24,13,11
21104,Chibuku,burning-legion,1240,monk,mistweaver,24,13,11
21105,Hoppinxd,burning-blade,1240,monk,mistweaver,24,13,11
21106,Luciellie,archimonde,1240,monk,mistweaver,24,13,11
21107,Freemann,archimonde,1240,monk,mistweaver,295,149,146
21108,Bréwmáster,silvermoon,1238,monk,mistweaver,18,13,5
21109,Kayen,frostwhisper,1238,monk,mistweaver,46,23,23
21110,Ninjasven,bladefist,1238,monk,mistweaver,30,13,17
21111,Wteg,emerald-dream,1237,monk,mistweaver,54,24,30
21112,Loma,drakthul,1234,monk,mistweaver,42,26,16
21113,Drpajhiwo,burning-legion,1234,monk,mistweaver,52,30,22
21114,Astolfochan,silvermoon,1232,monk,mistweaver,24,13,11
21115,Jozo,hyjal,1231,monk,mistweaver,36,18,18
21116,Maiver,stormscale,1230,monk,mistweaver,24,14,10
21117,Chainster,defias-brotherhood,1229,monk,mistweaver,70,35,35
21118,Ytonie,gorgonnash,1228,monk,mistweaver,18,13,5
21119,Rgkekw,dun-modr,1222,monk,mistweaver,66,39,27
21120,Arathos,tichondrius,1220,monk,mistweaver,111,62,49
21121,Namitsa,trollbane,1220,monk,mistweaver,42,21,21
21122,Tripitakâ,dun-modr,1220,monk,mistweaver,65,30,35
21123,Egwane,argent-dawn,1220,monk,mistweaver,55,24,31
21124,Mugn,sanguino,1215,monk,mistweaver,20,14,6
21125,Fistus,dentarg,1214,monk,mistweaver,29,13,16
21126,Bhasundara,turalyon,1212,monk,mistweaver,88,51,37
21127,Pandasia,kargath,1212,monk,mistweaver,62,25,37
21128,Nylzz,archimonde,1210,monk,mistweaver,26,14,12
21129,Badonkamonk,twilights-hammer,1209,monk,mistweaver,42,26,16
21130,Xwtdreamz,hyjal,1209,monk,mistweaver,42,18,24
21131,Mofisto,bladefist,1208,monk,mistweaver,60,29,31
21132,Nainketx,ravencrest,1208,monk,mistweaver,29,13,16
21133,Bensó,stormscale,1207,monk,mistweaver,57,38,19
21134,Ðømínus,blackmoore,1206,monk,mistweaver,86,39,47
21135,Toon,eredar,1203,monk,mistweaver,118,56,62
21136,Ivi,neptulon,1197,monk,mistweaver,58,29,29
21137,Vattghern,blackhand,1196,monk,mistweaver,88,43,45
21138,Eltonj,sylvanas,1193,monk,mistweaver,23,15,8
21139,Heretogo,draenor,1189,monk,mistweaver,72,39,33
21140,Ksll,silvermoon,1189,monk,mistweaver,36,17,19
21141,Légit,argent-dawn,1188,monk,mistweaver,42,25,17
21142,Мистерхюй,gordunni,1186,monk,mistweaver,101,45,56
21143,Slayâtwo,blackrock,1185,monk,mistweaver,21,13,8
21144,Vørdèthxd,outland,1184,monk,mistweaver,24,18,6
21145,Nyrkkiseski,outland,1183,monk,mistweaver,17,13,4
21146,Lcflay,archimonde,1183,monk,mistweaver,75,37,38
21147,Houzagackel,blackrock,1183,monk,mistweaver,48,17,31
21148,Phrynè,silvermoon,1182,monk,mistweaver,31,16,15
21149,Sosyc,malganis,1181,monk,mistweaver,23,13,10
21150,Highmonktain,alakir,1177,monk,mistweaver,41,25,16
21151,Creatinin,ragnaros,1177,monk,mistweaver,36,18,18
21152,Skaadoosh,aggra-português,1176,monk,mistweaver,27,13,14
21153,Elainmonk,thrall,1175,monk,mistweaver,17,13,4
21154,Kelechi,stormreaver,1172,monk,mistweaver,32,13,19
21155,Fistweavr,antonidas,1171,monk,mistweaver,36,14,22
21156,Rag,burning-legion,1161,monk,mistweaver,60,22,38
21157,Hvnm,ravencrest,1158,monk,mistweaver,170,86,84
21158,Dèathpunch,doomhammer,1155,monk,mistweaver,110,58,52
21159,Yayaxoxoxo,archimonde,1152,monk,mistweaver,18,12,6
21160,Yuuhai,ravencrest,1152,monk,mistweaver,18,12,6
21161,Chijis,blackmoore,1152,monk,mistweaver,24,12,12
21162,Bekachu,ragnaros,1151,monk,mistweaver,18,12,6
21163,Statícx,twisting-nether,1151,monk,mistweaver,18,12,6
21164,Pikachi,ysondre,1151,monk,mistweaver,18,12,6
21165,Shixen,ragnaros,1151,monk,mistweaver,24,12,12
21166,Kôtsvlêkjê,outland,1151,monk,mistweaver,24,12,12
21167,Ofwgkta,moonglade,1151,monk,mistweaver,24,12,12
21168,Zesha,zuljin,1151,monk,mistweaver,30,12,18
21169,Дилдобойс,gordunni,1150,monk,mistweaver,18,12,6
21170,Loorda,neptulon,1150,monk,mistweaver,24,13,11
21171,Нунтяк,gordunni,1150,monk,mistweaver,24,12,12
21172,Yshaolin,tarren-mill,1150,monk,mistweaver,24,12,12
21173,Ciridely,thrall,1149,monk,mistweaver,18,12,6
21174,Kackwalker,blackmoore,1149,monk,mistweaver,18,12,6
21175,Chiá,tarren-mill,1149,monk,mistweaver,47,26,21
21176,Fungxi,archimonde,1146,monk,mistweaver,30,12,18
21177,Telder,sylvanas,1145,monk,mistweaver,24,12,12
21178,Антошамв,gordunni,1145,monk,mistweaver,36,12,24
21179,Nimander,burning-legion,1144,monk,mistweaver,24,12,12
21180,Alphafist,argent-dawn,1144,monk,mistweaver,30,14,16
21181,Tokkz,eredar,1143,monk,mistweaver,16,13,3
21182,Октай,gordunni,1143,monk,mistweaver,34,23,11
21183,Pô,sanguino,1143,monk,mistweaver,18,12,6
21184,Shiftchenko,stormscale,1142,monk,mistweaver,42,24,18
21185,Ajita,blackmoore,1141,monk,mistweaver,24,12,12
21186,Hitsumia,archimonde,1141,monk,mistweaver,36,12,24
21187,Icantstopme,argent-dawn,1139,monk,mistweaver,18,12,6
21188,Cicera,kazzak,1138,monk,mistweaver,30,12,18
21189,Syyrø,silvermoon,1137,monk,mistweaver,36,12,24
21190,Валялекарь,gordunni,1135,monk,mistweaver,24,12,12
21191,Fellatia,garrosh,1134,monk,mistweaver,36,24,12
21192,Kapauww,twisting-nether,1134,monk,mistweaver,18,12,6
21193,Gantz,blackhand,1134,monk,mistweaver,72,28,44
21194,Kyuumaa,ravencrest,1132,monk,mistweaver,26,13,13
21195,Lubeï,kirin-tor,1131,monk,mistweaver,34,21,13
21196,Aznreznzfdqs,grim-batol,1129,monk,mistweaver,18,12,6
21197,Hornissy,antonidas,1129,monk,mistweaver,35,22,13
21198,Claudet,das-konsortium,1127,monk,mistweaver,70,32,38
21199,Friartucker,bloodhoof,1126,monk,mistweaver,51,32,19
21200,Vvårdenfell,hyjal,1126,monk,mistweaver,33,13,20
21201,Mondrim,burning-legion,1123,monk,mistweaver,145,63,82
21202,Mislaw,silvermoon,1121,monk,mistweaver,27,16,11
21203,Snitzla,drakthul,1119,monk,mistweaver,21,16,5
21204,Nasaislying,grim-batol,1119,monk,mistweaver,34,14,20
21205,Jumper,xavius,1118,monk,mistweaver,24,12,12
21206,Yèna,pozzo-delleternità,1118,monk,mistweaver,161,70,91
21207,Akiiro,aegwynn,1118,monk,mistweaver,36,15,21
21208,Tsouli,twilights-hammer,1116,monk,mistweaver,24,12,12
21209,Coliusz,bloodhoof,1116,monk,mistweaver,35,12,23
21210,Dankiron,darksorrow,1114,monk,mistweaver,42,13,29
21211,Zøubida,draenor,1111,monk,mistweaver,24,12,12
21212,Katse,eredar,1106,monk,mistweaver,62,29,33
21213,Serilyah,aegwynn,1102,monk,mistweaver,25,14,11
21214,Pussochkram,ravencrest,1101,monk,mistweaver,18,12,6
21215,Kungfuppl,kazzak,1099,monk,mistweaver,23,12,11
21216,Ляосинь,deepholm,1099,monk,mistweaver,24,12,12
21217,Ryanshazier,eredar,1097,monk,mistweaver,30,18,12
21218,Carcasce,la-croisade-écarlate,1096,monk,mistweaver,38,22,16
21219,Thrallergik,ysondre,1093,monk,mistweaver,24,15,9
21220,Bigdickmonk,blackmoore,1092,monk,mistweaver,21,13,8
21221,Kalet,ragnaros,1092,monk,mistweaver,77,36,41
21222,Brünó,kazzak,1089,monk,mistweaver,60,38,22
21223,Апесиинка,gordunni,1084,monk,mistweaver,36,18,18
21224,Cudworth,silvermoon,1082,monk,mistweaver,24,17,7
21225,Gârdt,blackmoore,1081,monk,mistweaver,42,26,16
21226,Chun,arathor,1076,monk,mistweaver,50,24,26
21227,Loctak,nathrezim,1075,monk,mistweaver,54,38,16
21228,Enceladion,burning-legion,1073,monk,mistweaver,54,25,29
21229,Vanquishlølz,archimonde,1070,monk,mistweaver,50,22,28
21230,Bobbyknuckls,ravencrest,1064,monk,mistweaver,54,17,37
21231,Äcé,sylvanas,1063,monk,mistweaver,31,12,19
21232,Ninpou,blackrock,1060,monk,mistweaver,17,12,5
21233,Yoogychi,ravencrest,1056,monk,mistweaver,18,11,7
21234,Totemlygodx,alakir,1056,monk,mistweaver,18,11,7
21235,Traickomonk,eredar,1056,monk,mistweaver,18,11,7
21236,Flãô,draenor,1056,monk,mistweaver,18,11,7
21237,Bjj,blackrock,1056,monk,mistweaver,18,11,7
21238,Vöyage,kazzak,1056,monk,mistweaver,18,11,7
21239,Exbuddhist,outland,1056,monk,mistweaver,18,11,7
21240,Judochops,sylvanas,1056,monk,mistweaver,18,11,7
21241,Coalsack,outland,1056,monk,mistweaver,22,12,10
21242,Darkmonkky,tarren-mill,1056,monk,mistweaver,24,11,13
21243,Ffxivrefugee,argent-dawn,1056,monk,mistweaver,24,11,13
21244,Deii,frostwolf,1056,monk,mistweaver,42,15,27
21245,Kakor,gorgonnash,1055,monk,mistweaver,18,11,7
21246,Busfâhrer,antonidas,1055,monk,mistweaver,18,11,7
21247,Srchi,aggra-português,1055,monk,mistweaver,19,11,8
21248,Jakethestake,twilights-hammer,1054,monk,mistweaver,12,11,1
21249,Hærleyquin,ravencrest,1054,monk,mistweaver,18,11,7
21250,Emblax,blackhand,1054,monk,mistweaver,18,11,7
21251,Kragor,eredar,1054,monk,mistweaver,18,11,7
21252,Neehl,aegwynn,1054,monk,mistweaver,18,11,7
21253,Kispiszock,bloodscalp,1054,monk,mistweaver,18,11,7
21254,Zødiac,quelthalas,1054,monk,mistweaver,18,11,7
21255,Barbielølz,archimonde,1053,monk,mistweaver,18,11,7
21256,Psychømonk,antonidas,1053,monk,mistweaver,18,11,7
21257,Pepesmacks,kazzak,1052,monk,mistweaver,18,11,7
21258,Найтчерри,deathguard,1052,monk,mistweaver,18,11,7
21259,Rebeka,dun-modr,1052,monk,mistweaver,24,11,13
21260,Diabolùs,blackmoore,1052,monk,mistweaver,30,11,19
21261,Lambofmonkz,stormscale,1052,monk,mistweaver,36,11,25
21262,Fithz,kaelthas,1051,monk,mistweaver,12,11,1
21263,Asho,outland,1051,monk,mistweaver,24,11,13
21264,Анамо,blackscar,1050,monk,mistweaver,18,11,7
21265,Brewmâster,kazzak,1050,monk,mistweaver,24,11,13
21266,Irìss,nerzhul,1048,monk,mistweaver,39,19,20
21267,Sydras,silvermoon,1048,monk,mistweaver,301,146,155
21268,Fisticuffs,tarren-mill,1048,monk,mistweaver,24,11,13
21269,Ashulera,archimonde,1048,monk,mistweaver,30,11,19
21270,Mjaweaver,stormscale,1046,monk,mistweaver,62,23,39
21271,Hithxbye,stormscale,1044,monk,mistweaver,66,24,42
21272,Birdymonk,boulderfist,1043,monk,mistweaver,61,36,25
21273,Irphan,ravencrest,1042,monk,mistweaver,18,11,7
21274,Хромдар,gordunni,1040,monk,mistweaver,21,12,9
21275,Graffy,eonar,1040,monk,mistweaver,54,29,25
21276,Gozgajr,twisting-nether,1039,monk,mistweaver,24,11,13
21277,Ívó,ragnaros,1039,monk,mistweaver,24,11,13
21278,ßam,ravencrest,1039,monk,mistweaver,35,14,21
21279,Assfist,drakthul,1038,monk,mistweaver,93,51,42
21280,Badonna,burning-legion,1033,monk,mistweaver,24,11,13
21281,Rumiñawi,ravencrest,1033,monk,mistweaver,30,11,19
21282,Brizs,outland,1032,monk,mistweaver,36,22,14
21283,Mcronald,blackhand,1031,monk,mistweaver,46,23,23
21284,Chimonk,ravencrest,1030,monk,mistweaver,18,11,7
21285,Eldunári,sanguino,1026,monk,mistweaver,24,11,13
21286,Allosthenos,ravencrest,1019,monk,mistweaver,56,29,27
21287,Ugotcraned,tarren-mill,1019,monk,mistweaver,72,27,45
21288,Zedruu,tarren-mill,1015,monk,mistweaver,24,12,12
21289,Madmonki,ragnaros,1011,monk,mistweaver,24,15,9
21290,Shoshin,stormscale,1009,monk,mistweaver,66,37,29
21291,Bèfmoka,sargeras,1008,monk,mistweaver,194,95,99
21292,Mwmkgodxz,archimonde,1007,monk,mistweaver,15,12,3
21293,Nathaanel,argent-dawn,1007,monk,mistweaver,42,20,22
21294,Gøøgodx,tarren-mill,1006,monk,mistweaver,17,11,6
21295,Ivnatorx,outland,1006,monk,mistweaver,17,11,6
21296,Candypoppe,argent-dawn,1004,monk,mistweaver,52,27,25
21297,Kameltreiba,antonidas,1004,monk,mistweaver,23,11,12
21298,Zenchî,ysondre,1001,monk,mistweaver,22,13,9
21299,Lucebree,nozdormu,999,monk,mistweaver,48,18,30
21300,Celestine,mugthol,994,monk,mistweaver,132,64,68
21301,Kégman,silvermoon,992,monk,mistweaver,33,18,15
21302,Pawfong,draenor,987,monk,mistweaver,24,12,12
21303,Andim,frostwolf,986,monk,mistweaver,42,24,18
21304,Wangho,magtheridon,986,monk,mistweaver,96,40,56
21305,Shmidi,antonidas,981,monk,mistweaver,30,15,15
21306,Heäléna,ragnaros,979,monk,mistweaver,21,15,6
21307,Tootenchamun,veklor,971,monk,mistweaver,96,38,58
21308,Samh,twisting-nether,969,monk,mistweaver,29,17,12
21309,Chukwandi,ravencrest,966,monk,mistweaver,64,33,31
21310,Blackmonk,chromaggus,964,monk,mistweaver,21,12,9
21311,Suchergebnis,tarren-mill,964,monk,mistweaver,66,23,43
21312,Brofistmw,outland,960,monk,mistweaver,12,10,2
21313,Vadrigar,drakthul,960,monk,mistweaver,12,10,2
21314,Habmit,ravencrest,960,monk,mistweaver,12,10,2
21315,Kz,culte-de-la-rive-noire,960,monk,mistweaver,12,10,2
21316,Dihsa,ragnaros,960,monk,mistweaver,12,10,2
21317,Sqxgodx,ragnaros,960,monk,mistweaver,12,10,2
21318,Wåñmëíßãøx,sylvanas,960,monk,mistweaver,18,10,8
21319,Zorxen,argent-dawn,960,monk,mistweaver,18,10,8
21320,Cannonk,blackhand,960,monk,mistweaver,18,10,8
21321,Pizelx,ravencrest,960,monk,mistweaver,24,10,14
21322,Garuda,darkspear,959,monk,mistweaver,12,10,2
21323,Citamonk,blackmoore,959,monk,mistweaver,12,10,2
21324,Sioumoo,malganis,959,monk,mistweaver,16,11,5
21325,Ricidora,nerathor,959,monk,mistweaver,18,10,8
21326,Såvonnette,ysondre,959,monk,mistweaver,18,10,8
21327,Energyqt,twisting-nether,959,monk,mistweaver,18,10,8
21328,Mahøni,malganis,959,monk,mistweaver,18,10,8
21329,Chexmonk,silvermoon,959,monk,mistweaver,18,10,8
21330,Mâjô,blackhand,959,monk,mistweaver,18,10,8
21331,Valdaras,runetotem,959,monk,mistweaver,18,10,8
21332,Toaborsten,tarren-mill,958,monk,mistweaver,14,12,2
21333,Zappikmonk,silvermoon,958,monk,mistweaver,12,10,2
21334,Mynokxu,blackmoore,958,monk,mistweaver,12,10,2
21335,Fettakules,eredar,958,monk,mistweaver,18,10,8
21336,Búns,draenor,958,monk,mistweaver,18,10,8
21337,Kbwser,silvermoon,958,monk,mistweaver,18,10,8
21338,Caipha,ravencrest,958,monk,mistweaver,18,10,8
21339,Yuyuni,laughing-skull,958,monk,mistweaver,18,10,8
21340,Паклюха,howling-fjord,958,monk,mistweaver,18,10,8
21341,Sèrafin,burning-legion,958,monk,mistweaver,18,10,8
21342,Kanajambe,twisting-nether,957,monk,mistweaver,12,10,2
21343,Rollsamdi,tarren-mill,957,monk,mistweaver,18,10,8
21344,Teoroll,stormscale,956,monk,mistweaver,18,10,8
21345,Gumar,antonidas,956,monk,mistweaver,18,10,8
21346,Spánkproóf,kazzak,956,monk,mistweaver,18,10,8
21347,Lithenyx,bladefist,956,monk,mistweaver,24,10,14
21348,Lobnx,kazzak,955,monk,mistweaver,18,10,8
21349,Fizted,tarren-mill,955,monk,mistweaver,18,10,8
21350,Ossifist,blackhand,955,monk,mistweaver,24,10,14
21351,Latsu,silvermoon,955,monk,mistweaver,24,10,14
21352,Bottomoré,silvermoon,955,monk,mistweaver,71,24,47
21353,Bråin,ravenholdt,953,monk,mistweaver,24,10,14
21354,Jimbearend,argent-dawn,952,monk,mistweaver,18,10,8
21355,Siouxxsie,thunderhorn,952,monk,mistweaver,84,25,59
21356,Pämella,alleria,951,monk,mistweaver,12,10,2
21357,Tojokirumi,dalaran,951,monk,mistweaver,12,10,2
21358,Dennó,mannoroth,951,monk,mistweaver,18,10,8
21359,Monkyd,stormscale,950,monk,mistweaver,18,10,8
21360,Kakos,eldrethalas,943,monk,mistweaver,12,10,2
21361,Gammelbruno,azshara,942,monk,mistweaver,18,10,8
21362,Serylliah,aegwynn,942,monk,mistweaver,24,10,14
21363,Røär,khaz-modan,934,monk,mistweaver,12,10,2
21364,Puñetaso,los-errantes,934,monk,mistweaver,30,10,20
21365,Ariä,marécage-de-zangar,930,monk,mistweaver,24,13,11
21366,Liathina,sylvanas,928,monk,mistweaver,25,10,15
21367,Keeba,kirin-tor,926,monk,mistweaver,206,98,108
21368,Шадялинь,howling-fjord,920,monk,mistweaver,23,10,13
21369,Ronanze,silvermoon,918,monk,mistweaver,60,30,30
21370,Blackeyé,malganis,914,monk,mistweaver,47,25,22
21371,Millhouse,die-aldor,911,monk,mistweaver,17,10,7
21372,Dícxi,ravencrest,910,monk,mistweaver,17,10,7
21373,Yøøps,dalaran,908,monk,mistweaver,27,13,14
21374,Leafsoup,argent-dawn,906,monk,mistweaver,84,41,43
21375,Indris,dun-modr,895,monk,mistweaver,17,10,7
21376,Мишапяточка,howling-fjord,890,monk,mistweaver,12,11,1
21377,Тиктокмонк,gordunni,877,monk,mistweaver,20,11,9
21378,Greez,tarren-mill,869,monk,mistweaver,22,10,12
21379,Kookmin,doomhammer,864,monk,mistweaver,12,9,3
21380,Sanchios,twisting-nether,864,monk,mistweaver,12,9,3
21381,Iixil,sylvanas,864,monk,mistweaver,12,9,3
21382,Fistpunk,kazzak,864,monk,mistweaver,12,9,3
21383,Turbobär,blackrock,864,monk,mistweaver,12,9,3
21384,Remyhadley,dun-modr,864,monk,mistweaver,12,9,3
21385,Jiest,outland,864,monk,mistweaver,18,9,9
21386,Monkasape,nemesis,864,monk,mistweaver,18,9,9
21387,Kaguræ,hyjal,864,monk,mistweaver,18,9,9
21388,Nule,outland,864,monk,mistweaver,18,9,9
21389,Kareek,sylvanas,864,monk,mistweaver,18,9,9
21390,Miists,kazzak,864,monk,mistweaver,18,9,9
21391,Ультрадевка,blackscar,864,monk,mistweaver,22,9,13
21392,Nillebpgodx,kazzak,864,monk,mistweaver,24,9,15
21393,Fredmonk,stormscale,864,monk,mistweaver,24,9,15
21394,Flowey,uldum,864,monk,mistweaver,24,9,15
21395,Balia,blackrock,864,monk,mistweaver,24,9,15
21396,Malfius,shadowsong,863,monk,mistweaver,12,9,3
21397,Spinalot,eredar,863,monk,mistweaver,12,9,3
21398,Mistwave,eredar,863,monk,mistweaver,12,9,3
21399,Shabaz,draenor,863,monk,mistweaver,12,9,3
21400,Arlot,blackmoore,863,monk,mistweaver,12,9,3
21401,Backseatgmr,ravencrest,863,monk,mistweaver,12,9,3
21402,Bearmw,draenor,863,monk,mistweaver,18,9,9
21403,Kattlåda,darkspear,863,monk,mistweaver,18,9,9
21404,Kyleestrutt,stormscale,863,monk,mistweaver,18,9,9
21405,Torinia,madmortem,863,monk,mistweaver,18,9,9
21406,Phébz,archimonde,863,monk,mistweaver,18,9,9
21407,Monkéy,blackhand,863,monk,mistweaver,18,9,9
21408,Fiddle,archimonde,863,monk,mistweaver,18,9,9
21409,Saadlol,sanguino,863,monk,mistweaver,18,9,9
21410,Nowhaazzer,dun-modr,863,monk,mistweaver,18,9,9
21411,Вондерофъю,gordunni,863,monk,mistweaver,18,9,9
21412,Rminto,twisting-nether,863,monk,mistweaver,24,9,15
21413,Beerbringer,kazzak,862,monk,mistweaver,12,9,3
21414,Missfist,stormscale,862,monk,mistweaver,12,9,3
21415,Niborc,doomhammer,862,monk,mistweaver,12,9,3
21416,Monkjakt,draenor,862,monk,mistweaver,18,9,9
21417,Mwsama,stormscale,861,monk,mistweaver,12,9,3
21418,Puñolou,sanguino,861,monk,mistweaver,12,9,3
21419,Tílidin,malganis,861,monk,mistweaver,12,9,3
21420,Koldar,grim-batol,861,monk,mistweaver,17,12,5
21421,Mistréss,silvermoon,858,monk,mistweaver,18,9,9
21422,Herdom,blackmoore,856,monk,mistweaver,12,9,3
21423,Thymesurge,ravencrest,856,monk,mistweaver,18,9,9
21424,Pafia,sargeras,852,monk,mistweaver,25,12,13
21425,Liwong,antonidas,850,monk,mistweaver,12,9,3
21426,Geckazz,kazzak,847,monk,mistweaver,12,9,3
21427,Wûcm,silvermoon,846,monk,mistweaver,17,9,8
21428,Geeberz,twisting-nether,838,monk,mistweaver,18,9,9
21429,Changzu,sanguino,837,monk,mistweaver,42,17,25
21430,ßæutiful,silvermoon,835,monk,mistweaver,30,13,17
21431,Drakzyr,argent-dawn,831,monk,mistweaver,16,9,7
21432,Fistarfrans,sylvanas,828,monk,mistweaver,14,10,4
21433,Fréýáá,blackrock,827,monk,mistweaver,18,9,9
21434,Tèam,defias-brotherhood,810,monk,mistweaver,15,9,6
21435,Nouraxo,kazzak,809,monk,mistweaver,22,10,12
21436,Xalyà,archimonde,803,monk,mistweaver,18,12,6
21437,Extaszeh,turalyon,802,monk,mistweaver,17,11,6
21438,Mellu,kazzak,798,monk,mistweaver,14,9,5
21439,Zerochi,kazzak,796,monk,mistweaver,19,10,9
21440,Jînex,shattrath,784,monk,mistweaver,13,9,4
21441,Gatubarnet,stormscale,783,monk,mistweaver,13,9,4
21442,Гуппер,howling-fjord,768,monk,mistweaver,12,8,4
21443,Jlo,stormscale,768,monk,mistweaver,12,8,4
21444,Mástermônkèy,tarren-mill,768,monk,mistweaver,12,8,4
21445,Shushux,ysondre,768,monk,mistweaver,12,8,4
21446,Mialena,eredar,768,monk,mistweaver,12,8,4
21447,Guarnounet,hyjal,768,monk,mistweaver,12,8,4
21448,Dexcore,draenor,768,monk,mistweaver,12,8,4
21449,Анимешнеца,gordunni,768,monk,mistweaver,12,8,4
21450,Fckisrael,archimonde,768,monk,mistweaver,12,8,4
21451,Wisebeb,les-clairvoyants,768,monk,mistweaver,12,8,4
21452,Brutamonk,blackmoore,768,monk,mistweaver,12,8,4
21453,Miamalkøva,nemesis,768,monk,mistweaver,12,8,4
21454,Hurjat,stormreaver,768,monk,mistweaver,12,8,4
21455,Bidzi,kazzak,768,monk,mistweaver,12,8,4
21456,Cattleyah,ysondre,768,monk,mistweaver,12,8,4
21457,Xoonaki,turalyon,768,monk,mistweaver,12,8,4
21458,Plancton,kazzak,768,monk,mistweaver,12,8,4
21459,Savvuzzino,nemesis,768,monk,mistweaver,12,8,4
21460,Adrianchase,ravencrest,768,monk,mistweaver,12,8,4
21461,Бэккс,howling-fjord,768,monk,mistweaver,12,8,4
21462,Kradder,nordrassil,768,monk,mistweaver,12,8,4
21463,Shyrea,nazjatar,768,monk,mistweaver,12,8,4
21464,Ånåsenpåi,archimonde,768,monk,mistweaver,12,8,4
21465,Infamøus,uldum,768,monk,mistweaver,12,8,4
21466,Mvm,outland,768,monk,mistweaver,12,8,4
21467,Reivil,kazzak,768,monk,mistweaver,12,8,4
21468,Orki,ragnaros,768,monk,mistweaver,18,8,10
21469,Goamix,ravencrest,768,monk,mistweaver,18,8,10
21470,Adamlól,tarren-mill,768,monk,mistweaver,18,8,10
21471,Träskolasse,tarren-mill,768,monk,mistweaver,18,8,10
21472,Tøxicweaver,kazzak,768,monk,mistweaver,18,8,10
21473,Eldaras,tarren-mill,768,monk,mistweaver,18,8,10
21474,Ronkingkong,ravencrest,768,monk,mistweaver,18,8,10
21475,Loth,archimonde,767,monk,mistweaver,12,8,4
21476,Россиянин,thermaplugg,767,monk,mistweaver,12,8,4
21477,Adzk,tarren-mill,767,monk,mistweaver,12,8,4
21478,Lin,nathrezim,767,monk,mistweaver,12,8,4
21479,Truelo,eredar,767,monk,mistweaver,12,8,4
21480,Souhei,drakthul,767,monk,mistweaver,12,8,4
21481,Draxed,kazzak,767,monk,mistweaver,12,8,4
21482,Xerzulo,silvermoon,767,monk,mistweaver,12,8,4
21483,Hvdo,silvermoon,767,monk,mistweaver,12,8,4
21484,Pvppenergy,silvermoon,767,monk,mistweaver,12,8,4
21485,Мистхоррор,gordunni,767,monk,mistweaver,12,8,4
21486,Maigraith,malganis,767,monk,mistweaver,12,8,4
21487,Æbscourgê,azjolnerub,767,monk,mistweaver,18,8,10
21488,Lerouxx,archimonde,767,monk,mistweaver,18,8,10
21489,Aliyo,aegwynn,767,monk,mistweaver,18,8,10
21490,Gízmö,tarren-mill,767,monk,mistweaver,18,8,10
21491,Nexyyfist,kazzak,767,monk,mistweaver,18,8,10
21492,Shàllýn,antonidas,767,monk,mistweaver,18,8,10
21493,Qî,ravencrest,767,monk,mistweaver,30,8,22
21494,Cocoonkappa,dun-modr,766,monk,mistweaver,12,8,4
21495,Papasan,aggramar,766,monk,mistweaver,12,8,4
21496,Lilithrevan,frostmourne,766,monk,mistweaver,12,8,4
21497,Sinzy,dentarg,766,monk,mistweaver,12,8,4
21498,Nulojeu,archimonde,766,monk,mistweaver,12,8,4
21499,Weavi,kazzak,766,monk,mistweaver,12,8,4
21500,Riip,ysondre,766,monk,mistweaver,12,8,4
21501,Galaxumi,ragnaros,766,monk,mistweaver,18,8,10
21502,Gakunie,blackhand,766,monk,mistweaver,18,8,10
21503,Hersmonk,drakthul,765,monk,mistweaver,12,8,4
21504,Kegbrew,kazzak,765,monk,mistweaver,12,8,4
21505,Lorkas,darkmoon-faire,765,monk,mistweaver,12,8,4
21506,Каземат,booty-bay,765,monk,mistweaver,18,8,10
21507,Lûxz,ragnaros,765,monk,mistweaver,18,8,10
21508,Tolomèo,nemesis,765,monk,mistweaver,18,8,10
21509,Trxy,argent-dawn,765,monk,mistweaver,36,8,28
21510,Lilniccí,blackrock,764,monk,mistweaver,12,8,4
21511,Lumpiiná,antonidas,764,monk,mistweaver,18,8,10
21512,Idkfa,sylvanas,764,monk,mistweaver,18,8,10
21513,Порвуседло,soulflayer,764,monk,mistweaver,18,8,10
21514,Saintmoon,drakthul,762,monk,mistweaver,18,8,10
21515,Pekinn,sanguino,761,monk,mistweaver,18,8,10
21516,Karmasfist,ravencrest,760,monk,mistweaver,12,8,4
21517,Kieteltje,sylvanas,760,monk,mistweaver,12,8,4
21518,Skrøn,kult-der-verdammten,760,monk,mistweaver,12,8,4
21519,Сукавкимоно,soulflayer,758,monk,mistweaver,18,8,10
21520,Slý,archimonde,757,monk,mistweaver,12,8,4
21521,Nezukoko,archimonde,735,monk,mistweaver,16,8,8
21522,Fetchd,blackmoore,733,monk,mistweaver,16,8,8
21523,Ndaula,drakthul,733,monk,mistweaver,25,9,16
21524,Dinxfar,draenor,732,monk,mistweaver,14,9,5
21525,Zóma,ragnaros,714,monk,mistweaver,22,9,13
21526,Moreløs,stormscale,710,monk,mistweaver,24,10,14
21527,Jsuispasheal,dalaran,705,monk,mistweaver,28,12,16
21528,Elasha,archimonde,703,monk,mistweaver,11,8,3
21529,Шаолий,gordunni,683,monk,mistweaver,30,8,22
21530,Simbabsu,thrall,672,monk,mistweaver,10,8,2
21531,Biggesttaf,stormscale,672,monk,mistweaver,10,8,2
21532,Alutzharn,argent-dawn,672,monk,mistweaver,12,7,5
21533,Lamasauce,ravencrest,672,monk,mistweaver,12,7,5
21534,Yàfa,archimonde,672,monk,mistweaver,12,7,5
21535,Longpeng,ysera,672,monk,mistweaver,12,7,5
21536,Aessella,antonidas,672,monk,mistweaver,12,7,5
21537,Franziskanus,das-syndikat,672,monk,mistweaver,12,7,5
21538,Fugmonk,ravencrest,672,monk,mistweaver,12,7,5
21539,Hessuzen,stormreaver,672,monk,mistweaver,12,7,5
21540,Mélêxe,ysondre,672,monk,mistweaver,12,7,5
21541,Cmonbruh,ravencrest,672,monk,mistweaver,12,7,5
21542,Monkamonk,blutkessel,672,monk,mistweaver,12,7,5
21543,Klappzz,outland,672,monk,mistweaver,12,7,5
21544,Starside,tarren-mill,672,monk,mistweaver,12,7,5
21545,Flexify,outland,672,monk,mistweaver,12,7,5
21546,ßreacher,argent-dawn,672,monk,mistweaver,12,7,5
21547,Podrugabomja,outland,672,monk,mistweaver,12,7,5
21548,Yepp,blackmoore,672,monk,mistweaver,12,7,5
21549,Soulcháos,ravencrest,672,monk,mistweaver,12,7,5
21550,Merçury,dun-morogh,672,monk,mistweaver,12,7,5
21551,Mw,magtheridon,672,monk,mistweaver,12,7,5
21552,Tedels,kazzak,672,monk,mistweaver,12,7,5
21553,Medinâ,kult-der-verdammten,672,monk,mistweaver,12,7,5
21554,Mjoo,blackrock,672,monk,mistweaver,12,7,5
21555,Irønmaxx,die-aldor,672,monk,mistweaver,12,7,5
21556,Mistkueefer,tarren-mill,672,monk,mistweaver,12,7,5
21557,Nastyføxÿ,ysondre,672,monk,mistweaver,12,7,5
21558,Prismaticx,ravencrest,672,monk,mistweaver,12,7,5
21559,Yulon,blackrock,672,monk,mistweaver,12,7,5
21560,Фистингкоуч,gordunni,672,monk,mistweaver,12,7,5
21561,Frajer,auchindoun,672,monk,mistweaver,12,7,5
21562,Fshn,sylvanas,672,monk,mistweaver,12,7,5
21563,Astarrserran,drakthul,672,monk,mistweaver,12,7,5
21564,Monkel,frostwolf,672,monk,mistweaver,12,7,5
21565,Вхукьютиикс,howling-fjord,672,monk,mistweaver,13,7,6
21566,Leykom,ravencrest,672,monk,mistweaver,15,8,7
21567,Amzu,kazzak,672,monk,mistweaver,18,7,11
21568,Dråf,ysondre,672,monk,mistweaver,18,7,11
21569,Bâsarä,archimonde,672,monk,mistweaver,18,7,11
21570,Exru,draenor,672,monk,mistweaver,18,7,11
21571,Scz,draenor,672,monk,mistweaver,18,7,11
21572,Atómic,eredar,672,monk,mistweaver,18,7,11
21573,Boîndíl,malfurion,672,monk,mistweaver,18,7,11
21574,Abdulhealer,stormscale,672,monk,mistweaver,18,7,11
21575,Mâki,ravencrest,672,monk,mistweaver,18,7,11
21576,Fistweavingg,tarren-mill,672,monk,mistweaver,18,7,11
21577,Bigkim,khadgar,672,monk,mistweaver,18,7,11
21578,Madraven,ravencrest,672,monk,mistweaver,24,7,17
21579,Mitchell,sylvanas,671,monk,mistweaver,12,7,5
21580,Jagermonk,doomhammer,671,monk,mistweaver,12,7,5
21581,Fonk,blades-edge,671,monk,mistweaver,12,7,5
21582,Agodx,sanguino,671,monk,mistweaver,12,7,5
21583,Shoryugrops,chants-éternels,671,monk,mistweaver,12,7,5
21584,Изимонк,gordunni,671,monk,mistweaver,12,7,5
21585,Wudao,anubarak,671,monk,mistweaver,12,7,5
21586,Åshêrs,stormscale,671,monk,mistweaver,12,7,5
21587,Chigee,kazzak,671,monk,mistweaver,12,7,5
21588,Xanadoll,outland,671,monk,mistweaver,12,7,5
21589,Anadia,blackrock,671,monk,mistweaver,12,7,5
21590,Кисеч,soulflayer,671,monk,mistweaver,12,7,5
21591,Ogpandapo,stormscale,671,monk,mistweaver,12,7,5
21592,Sensëi,bronze-dragonflight,671,monk,mistweaver,13,7,6
21593,Gilario,silvermoon,671,monk,mistweaver,18,7,11
21594,Алунам,soulflayer,671,monk,mistweaver,18,7,11
21595,Hittokick,draenor,671,monk,mistweaver,18,7,11
21596,Lazuros,auchindoun,671,monk,mistweaver,18,7,11
21597,Spinniboi,blackhand,671,monk,mistweaver,18,7,11
21598,Sideswipes,the-maelstrom,671,monk,mistweaver,18,7,11
21599,Аверлорд,fordragon,670,monk,mistweaver,12,7,5
21600,Monkinamight,turalyon,670,monk,mistweaver,12,7,5
21601,Brewm,silvermoon,670,monk,mistweaver,12,7,5
21602,Bréwsléé,ragnaros,670,monk,mistweaver,12,7,5
21603,Healmeup,anetheron,670,monk,mistweaver,12,7,5
21604,Zendyy,argent-dawn,670,monk,mistweaver,12,7,5
21605,Joübar,archimonde,670,monk,mistweaver,12,7,5
21606,Rhuru,argent-dawn,670,monk,mistweaver,14,7,7
21607,Furynextdoor,hyjal,669,monk,mistweaver,12,7,5
21608,Zywoo,emerald-dream,668,monk,mistweaver,18,7,11
21609,Chenpô,gorgonnash,667,monk,mistweaver,12,7,5
21610,Dotheas,argent-dawn,667,monk,mistweaver,18,7,11
21611,Senseithai,trollbane,665,monk,mistweaver,18,7,11
21612,Cheriedevile,drakthul,665,monk,mistweaver,24,7,17
21613,Wuchanglan,blackmoore,665,monk,mistweaver,30,7,23
21614,Pandadoum,ysondre,663,monk,mistweaver,12,7,5
21615,Ràsetsu,nagrand,663,monk,mistweaver,12,7,5
21616,Brewteaful,outland,655,monk,mistweaver,11,7,4
21617,Mistyheals,nagrand,647,monk,mistweaver,18,7,11
21618,Qdwdwqerdads,ravencrest,640,monk,mistweaver,16,8,8
21619,Lylaei,argent-dawn,639,monk,mistweaver,17,7,10
21620,Klischi,taerar,639,monk,mistweaver,17,7,10
21621,Shapumvilla,alonsus,637,monk,mistweaver,8,8,0
21622,Randomxbrew,draenor,624,monk,mistweaver,9,8,1
21623,Vatsmijter,silvermoon,623,monk,mistweaver,11,7,4
21624,Yøda,malganis,621,monk,mistweaver,15,7,8
21625,Nxmonk,sylvanas,618,monk,mistweaver,16,8,8
21626,Tanyà,hyjal,617,monk,mistweaver,12,8,4
21627,Varolul,aegwynn,606,monk,mistweaver,11,7,4
21628,Ronocs,turalyon,606,monk,mistweaver,14,7,7
21629,Chìless,shadowsong,576,monk,mistweaver,6,6,0
21630,Mowì,stormscale,576,monk,mistweaver,6,6,0
21631,Dupengchi,blackrock,576,monk,mistweaver,6,6,0
21632,Althéia,dalaran,576,monk,mistweaver,6,6,0
21633,Redundänt,kazzak,576,monk,mistweaver,6,6,0
21634,Флориусс,soulflayer,576,monk,mistweaver,6,6,0
21635,Djalexmw,kazzak,576,monk,mistweaver,6,6,0
21636,Pivomamrad,drakthul,576,monk,mistweaver,12,6,6
21637,Mozzi,frostmane,576,monk,mistweaver,12,6,6
21638,Iliketofist,ravencrest,576,monk,mistweaver,12,6,6
21639,Bluebery,burning-legion,576,monk,mistweaver,12,6,6
21640,Tiddor,burning-legion,576,monk,mistweaver,12,6,6
21641,Req,darksorrow,576,monk,mistweaver,12,6,6
21642,Garfunkel,emeriss,576,monk,mistweaver,12,6,6
21643,Åmba,blackrock,576,monk,mistweaver,12,6,6
21644,Fistandfury,outland,576,monk,mistweaver,12,6,6
21645,Deepênd,antonidas,576,monk,mistweaver,12,6,6
21646,Aritisi,tarren-mill,576,monk,mistweaver,12,6,6
21647,Leashed,blackmoore,576,monk,mistweaver,12,6,6
21648,Gruslinovica,archimonde,576,monk,mistweaver,12,6,6
21649,Rudiculous,malganis,576,monk,mistweaver,12,6,6
21650,Annoyingtwo,archimonde,576,monk,mistweaver,12,6,6
21651,Yez,azjolnerub,576,monk,mistweaver,12,6,6
21652,Ryac,defias-brotherhood,576,monk,mistweaver,12,6,6
21653,Rashtamonk,blackmoore,576,monk,mistweaver,12,6,6
21654,Oiorie,twisting-nether,576,monk,mistweaver,12,6,6
21655,Garweaver,frostwolf,576,monk,mistweaver,12,6,6
21656,Gosphhell,archimonde,576,monk,mistweaver,12,6,6
21657,Sinensi,conseil-des-ombres,576,monk,mistweaver,12,6,6
21658,Revii,anubarak,576,monk,mistweaver,12,6,6
21659,Mickeyworms,archimonde,576,monk,mistweaver,12,6,6
21660,Vàlky,outland,576,monk,mistweaver,12,6,6
21661,Кончеглаз,soulflayer,576,monk,mistweaver,12,6,6
21662,Icecoldbrew,outland,576,monk,mistweaver,12,6,6
21663,Vedak,stormreaver,576,monk,mistweaver,12,6,6
21664,Дезмимонк,ashenvale,576,monk,mistweaver,12,6,6
21665,Atralês,azshara,576,monk,mistweaver,12,6,6
21666,Миражмонк,howling-fjord,576,monk,mistweaver,12,6,6
21667,Potkuri,stormreaver,576,monk,mistweaver,12,6,6
21668,Kurzgesagt,destromath,576,monk,mistweaver,12,6,6
21669,Ankelstrumpa,tarren-mill,576,monk,mistweaver,12,6,6
21670,Zabjudah,stormscale,576,monk,mistweaver,12,6,6
21671,Mørbradgryde,silvermoon,576,monk,mistweaver,12,6,6
21672,Monjonagger,tyrande,576,monk,mistweaver,12,6,6
21673,Faki,eredar,576,monk,mistweaver,12,6,6
21674,Huricän,drakthul,576,monk,mistweaver,15,7,8
21675,Коумана,gordunni,576,monk,mistweaver,15,7,8
21676,Renegatt,twisting-nether,576,monk,mistweaver,18,6,12
21677,Ayanaami,pozzo-delleternità,576,monk,mistweaver,18,6,12
21678,Дядямаготика,deathguard,576,monk,mistweaver,18,6,12
21679,Торен,soulflayer,576,monk,mistweaver,18,6,12
21680,Modequillo,blackmoore,576,monk,mistweaver,18,6,12
21681,Монкмяу,howling-fjord,576,monk,mistweaver,18,6,12
21682,Vrexza,kazzak,576,monk,mistweaver,18,6,12
21683,Itsthemonkky,tarren-mill,576,monk,mistweaver,24,6,18
21684,Fraideberoa,ravencrest,575,monk,mistweaver,6,6,0
21685,Тэсси,blackscar,575,monk,mistweaver,12,6,6
21686,Drlyn,blackmoore,575,monk,mistweaver,12,6,6
21687,Vexzen,tarren-mill,575,monk,mistweaver,12,6,6
21688,Shenyen,silvermoon,575,monk,mistweaver,12,6,6
21689,Tily,stormreaver,575,monk,mistweaver,12,6,6
21690,Kushinaa,teldrassil,575,monk,mistweaver,12,6,6
21691,Ðoom,sylvanas,575,monk,mistweaver,12,6,6
21692,Skonk,frostmane,575,monk,mistweaver,12,6,6
21693,Khakk,elune,575,monk,mistweaver,12,6,6
21694,Charlett,the-venture-co,575,monk,mistweaver,12,6,6
21695,Rakowo,arthas,575,monk,mistweaver,12,6,6
21696,Drír,archimonde,575,monk,mistweaver,12,6,6
21697,Bbigttgothgf,doomhammer,575,monk,mistweaver,12,6,6
21698,Druni,archimonde,575,monk,mistweaver,12,6,6
21699,Samie,ravencrest,575,monk,mistweaver,12,6,6
21700,Toweliè,thrall,575,monk,mistweaver,12,6,6
21701,Painswîft,blackhand,575,monk,mistweaver,18,6,12
21702,Latify,todeswache,575,monk,mistweaver,18,6,12
21703,Mulana,sanguino,575,monk,mistweaver,18,6,12
21704,Kswis,outland,575,monk,mistweaver,18,6,12
21705,Othalain,silvermoon,574,monk,mistweaver,12,6,6
21706,Kungfusler,twisting-nether,574,monk,mistweaver,12,6,6
21707,Irishdëmon,ravencrest,574,monk,mistweaver,16,6,10
21708,Jackamonk,kazzak,574,monk,mistweaver,18,6,12
21709,Xentimus,kazzak,573,monk,mistweaver,18,6,12
21710,Ghninscare,blackmoore,560,monk,mistweaver,13,8,5
21711,Christien,ungoro,558,monk,mistweaver,23,6,17
21712,Psychö,zuljin,538,monk,mistweaver,17,6,11
21713,Gingerbrew,hyjal,528,monk,mistweaver,9,7,2
21714,Lidalol,silvermoon,527,monk,mistweaver,9,7,2
21715,Trymax,blackmoore,522,monk,mistweaver,17,7,10
21716,Leïsha,ysondre,522,monk,mistweaver,18,7,11
21717,Tondi,malygos,511,monk,mistweaver,10,6,4
21718,Годъяр,gordunni,510,monk,mistweaver,14,6,8
21719,Tarzaki,hyjal,494,monk,mistweaver,13,6,7
21720,Watschensepp,arthas,480,monk,mistweaver,6,5,1
21721,Muix,draenor,480,monk,mistweaver,6,5,1
21722,Sloopkogel,tarren-mill,480,monk,mistweaver,6,5,1
21723,Ribbeh,draenor,480,monk,mistweaver,6,5,1
21724,Saenxz,blackrock,480,monk,mistweaver,6,5,1
21725,Gaalon,ravencrest,480,monk,mistweaver,6,5,1
21726,Павнмонкх,gordunni,480,monk,mistweaver,6,5,1
21727,Notgherit,nemesis,480,monk,mistweaver,6,5,1
21728,Подорожнник,gordunni,480,monk,mistweaver,6,5,1
21729,Monkatapiti,malganis,480,monk,mistweaver,6,5,1
21730,Drylezm,twisting-nether,480,monk,mistweaver,6,5,1
21731,Ørcqt,tarren-mill,480,monk,mistweaver,6,5,1
21732,Nobrainfist,stormscale,480,monk,mistweaver,6,5,1
21733,Veladana,chamber-of-aspects,480,monk,mistweaver,6,5,1
21734,Sio,dentarg,480,monk,mistweaver,6,5,1
21735,Zoruun,quelthalas,480,monk,mistweaver,6,5,1
21736,Kiziibrla,archimonde,480,monk,mistweaver,6,5,1
21737,Chingbag,dalaran,480,monk,mistweaver,6,5,1
21738,Sozzemonk,kazzak,480,monk,mistweaver,6,5,1
21739,Dukhi,kazzak,480,monk,mistweaver,6,5,1
21740,Такиера,gordunni,480,monk,mistweaver,6,5,1
21741,Kaowar,nerzhul,480,monk,mistweaver,6,5,1
21742,Garfeels,sylvanas,480,monk,mistweaver,6,5,1
21743,Stromon,silvermoon,480,monk,mistweaver,6,5,1
21744,Clydemonk,outland,480,monk,mistweaver,6,5,1
21745,Akwaman,stormscale,480,monk,mistweaver,6,5,1
21746,Xkäz,archimonde,480,monk,mistweaver,6,5,1
21747,Zarona,outland,480,monk,mistweaver,6,5,1
21748,Jeanmartin,hyjal,480,monk,mistweaver,12,5,7
21749,Lunì,nathrezim,480,monk,mistweaver,12,5,7
21750,Jodeen,shadowsong,480,monk,mistweaver,12,5,7
21751,Hon,sanguino,480,monk,mistweaver,12,5,7
21752,Ðrçleañ,stormreaver,480,monk,mistweaver,12,5,7
21753,Erandja,silvermoon,480,monk,mistweaver,12,5,7
21754,Otuschxin,blackmoore,480,monk,mistweaver,12,5,7
21755,Andelicek,burning-blade,480,monk,mistweaver,12,5,7
21756,Chimý,tarren-mill,480,monk,mistweaver,12,5,7
21757,Minervaez,grim-batol,480,monk,mistweaver,12,5,7
21758,Jacm,blackhand,480,monk,mistweaver,12,5,7
21759,Siezlebabo,blackrock,480,monk,mistweaver,12,5,7
21760,Hoibglotzn,antonidas,480,monk,mistweaver,12,5,7
21761,Bountyño,dun-modr,480,monk,mistweaver,12,5,7
21762,Gecli,stormscale,480,monk,mistweaver,12,5,7
21763,Виброолег,gordunni,480,monk,mistweaver,12,5,7
21764,Tîptap,blackrock,480,monk,mistweaver,12,5,7
21765,Gemil,argent-dawn,480,monk,mistweaver,12,5,7
21766,Тайви,deepholm,480,monk,mistweaver,12,5,7
21767,Miquella,scarshield-legion,480,monk,mistweaver,12,5,7
21768,Místborn,ravencrest,480,monk,mistweaver,12,5,7
21769,Skiqzy,ravencrest,480,monk,mistweaver,12,5,7
21770,Tino,sylvanas,480,monk,mistweaver,12,5,7
21771,Axelight,chants-éternels,480,monk,mistweaver,12,5,7
21772,Whytoosxy,silvermoon,480,monk,mistweaver,18,5,13
21773,Drumonk,kelthuzad,480,monk,mistweaver,18,5,13
21774,Копытька,gordunni,480,monk,mistweaver,18,5,13
21775,Wkiller,outland,480,monk,mistweaver,18,5,13
21776,Risomonk,blackrock,480,monk,mistweaver,24,5,19
21777,Pandalezanda,silvermoon,479,monk,mistweaver,6,5,1
21778,Proxxona,eredar,479,monk,mistweaver,6,5,1
21779,Bovinebuddha,stormscale,479,monk,mistweaver,12,5,7
21780,Luigimonk,dun-modr,479,monk,mistweaver,12,5,7
21781,Яутжа,soulflayer,479,monk,mistweaver,12,5,7
21782,Stenhård,azjolnerub,479,monk,mistweaver,12,5,7
21783,Lascala,eredar,479,monk,mistweaver,12,5,7
21784,Durand,blackhand,479,monk,mistweaver,12,5,7
21785,Kryopumper,blackmoore,479,monk,mistweaver,12,5,7
21786,Wotaner,eredar,479,monk,mistweaver,12,5,7
21787,Дарума,grom,479,monk,mistweaver,12,5,7
21788,Sotqyy,stormscale,479,monk,mistweaver,12,5,7
21789,Добраядушка,gordunni,479,monk,mistweaver,18,5,13
21790,Knotze,eredar,479,monk,mistweaver,18,5,13
21791,Løkî,culte-de-la-rive-noire,479,monk,mistweaver,24,5,19
21792,Xèrá,antonidas,479,monk,mistweaver,24,5,19
21793,Shontal,ravencrest,478,monk,mistweaver,12,5,7
21794,Zoolloonn,norgannon,478,monk,mistweaver,12,5,7
21795,Wînk,amanthul,478,monk,mistweaver,12,5,7
21796,Backbone,auchindoun,478,monk,mistweaver,12,5,7
21797,Fardareismai,kazzak,478,monk,mistweaver,18,5,13
21798,Брэйки,lich-king,478,monk,mistweaver,18,5,13
21799,Leffe,thunderhorn,476,monk,mistweaver,12,5,7
21800,Drugarix,uldaman,475,monk,mistweaver,12,5,7
21801,Chucknorrís,kilrogg,474,monk,mistweaver,18,7,11
21802,Filomenata,rexxar,469,monk,mistweaver,19,5,14
21803,Zinzyo,aegwynn,447,monk,mistweaver,11,5,6
21804,Pìmpìnelle,garona,432,monk,mistweaver,9,6,3
21805,Mku,kazzak,432,monk,mistweaver,9,6,3
21806,Ygêrne,archimonde,426,monk,mistweaver,15,6,9
21807,Dræk,twisting-nether,426,monk,mistweaver,19,6,13
21808,Chakarma,twisting-nether,416,monk,mistweaver,22,5,17
21809,Lévanà,antonidas,415,monk,mistweaver,8,5,3
21810,Sudoku,thrall,415,monk,mistweaver,14,5,9
21811,Fistyboyuk,tarren-mill,384,monk,mistweaver,6,4,2
21812,Xloxloxloxy,outland,384,monk,mistweaver,6,4,2
21813,Meineaugen,blackhand,384,monk,mistweaver,6,4,2
21814,Roudious,arathi,384,monk,mistweaver,6,4,2
21815,Peaceweaver,ravencrest,384,monk,mistweaver,6,4,2
21816,Ibsmonk,outland,384,monk,mistweaver,6,4,2
21817,Bratana,dun-morogh,384,monk,mistweaver,6,4,2
21818,Highline,draenor,384,monk,mistweaver,6,4,2
21819,Харуказэ,howling-fjord,384,monk,mistweaver,6,4,2
21820,Fakestrxx,aegwynn,384,monk,mistweaver,6,4,2
21821,Bigflex,conseil-des-ombres,384,monk,mistweaver,6,4,2
21822,Tmnmnk,alakir,384,monk,mistweaver,6,4,2
21823,Slokwerk,dentarg,384,monk,mistweaver,6,4,2
21824,Zbamonk,burning-legion,384,monk,mistweaver,6,4,2
21825,Trácybéákérx,kazzak,384,monk,mistweaver,6,4,2
21826,Deniise,kult-der-verdammten,384,monk,mistweaver,6,4,2
21827,Kazéshini,doomhammer,384,monk,mistweaver,6,4,2
21828,Xevol,burning-legion,384,monk,mistweaver,6,4,2
21829,Spîndêmôrt,stormscale,384,monk,mistweaver,6,4,2
21830,Олежатоксик,gordunni,384,monk,mistweaver,6,4,2
21831,Mistfeeder,burning-blade,384,monk,mistweaver,6,4,2
21832,Zugzuwg,ahnqiraj,384,monk,mistweaver,6,4,2
21833,Nêrfmeta,kazzak,384,monk,mistweaver,6,4,2
21834,Lennifer,ragnaros,384,monk,mistweaver,6,4,2
21835,Shenexo,kazzak,384,monk,mistweaver,6,4,2
21836,Dath,outland,384,monk,mistweaver,6,4,2
21837,Podekouil,ysondre,384,monk,mistweaver,6,4,2
21838,Punkfukanda,drakthul,384,monk,mistweaver,6,4,2
21839,Missislee,aegwynn,384,monk,mistweaver,6,4,2
21840,Муррчалкин,howling-fjord,384,monk,mistweaver,6,4,2
21841,Camlen,draenor,384,monk,mistweaver,6,4,2
21842,Леобтв,soulflayer,384,monk,mistweaver,6,4,2
21843,Alomonk,archimonde,384,monk,mistweaver,6,4,2
21844,Naìsh,arygos,384,monk,mistweaver,6,4,2
21845,Monkersquad,doomhammer,384,monk,mistweaver,6,4,2
21846,Jifun,kazzak,384,monk,mistweaver,6,4,2
21847,Trancendent,silvermoon,384,monk,mistweaver,6,4,2
21848,Spittq,ysondre,384,monk,mistweaver,6,4,2
21849,Foaqer,aegwynn,384,monk,mistweaver,6,4,2
21850,Plånck,archimonde,384,monk,mistweaver,6,4,2
21851,Bhrag,die-aldor,384,monk,mistweaver,6,4,2
21852,Cocacolazeró,draenor,384,monk,mistweaver,6,4,2
21853,Claww,blackrock,384,monk,mistweaver,6,4,2
21854,Jemijedno,drakthul,384,monk,mistweaver,6,4,2
21855,Escopetin,los-errantes,384,monk,mistweaver,6,4,2
21856,Ennamoly,blackmoore,384,monk,mistweaver,6,4,2
21857,Gangichi,blackhand,384,monk,mistweaver,9,5,4
21858,Dúlgor,blackmoore,384,monk,mistweaver,11,6,5
21859,Scarymønk,kazzak,384,monk,mistweaver,8,4,4
21860,Päätöksiä,defias-brotherhood,384,monk,mistweaver,12,4,8
21861,Chimail,blackrock,384,monk,mistweaver,12,4,8
21862,Woofi,tarren-mill,384,monk,mistweaver,12,4,8
21863,Bûl,blackmoore,384,monk,mistweaver,12,4,8
21864,Invsionrush,crushridge,384,monk,mistweaver,12,4,8
21865,Suhnukka,stormscale,384,monk,mistweaver,12,4,8
21866,Pikkupotkuri,stormreaver,384,monk,mistweaver,12,4,8
21867,Konïï,dalaran,384,monk,mistweaver,12,4,8
21868,Skelmir,dragonblight,384,monk,mistweaver,12,4,8
21869,Monkmonkesen,stormscale,384,monk,mistweaver,12,4,8
21870,Слишкомхорош,howling-fjord,384,monk,mistweaver,12,4,8
21871,Eth,nagrand,384,monk,mistweaver,12,4,8
21872,Lysanmonk,zuljin,384,monk,mistweaver,12,4,8
21873,Craneovic,kult-der-verdammten,384,monk,mistweaver,12,4,8
21874,Bakersdozen,tarren-mill,384,monk,mistweaver,12,4,8
21875,Карманедаун,howling-fjord,384,monk,mistweaver,12,4,8
21876,Bruceli,darkmoon-faire,384,monk,mistweaver,12,4,8
21877,Audaz,dun-modr,384,monk,mistweaver,12,4,8
21878,Nebelwandler,blackhand,384,monk,mistweaver,12,4,8
21879,Subzxftw,archimonde,384,monk,mistweaver,12,4,8
21880,Betelgeuse,jaedenar,384,monk,mistweaver,18,4,14
21881,Níki,earthen-ring,383,monk,mistweaver,6,4,2
21882,Goldenquinn,sylvanas,383,monk,mistweaver,6,4,2
21883,Vzan,kazzak,383,monk,mistweaver,6,4,2
21884,Wrathing,tarren-mill,383,monk,mistweaver,6,4,2
21885,Supwithat,kazzak,383,monk,mistweaver,6,4,2
21886,Shuzao,steamwheedle-cartel,383,monk,mistweaver,12,4,8
21887,Velicko,ravencrest,383,monk,mistweaver,12,4,8
21888,Korrok,sanguino,383,monk,mistweaver,12,4,8
21889,Gnomebrew,ravencrest,383,monk,mistweaver,12,4,8
21890,Ornithorynke,hyjal,383,monk,mistweaver,12,4,8
21891,Eucalyptuz,draenor,383,monk,mistweaver,12,4,8
21892,Doneithné,stormscale,383,monk,mistweaver,12,4,8
21893,Fkflying,defias-brotherhood,381,monk,mistweaver,12,4,8
21894,Plií,frostwolf,362,monk,mistweaver,19,6,13
21895,Hullumunkki,blackmoore,352,monk,mistweaver,10,4,6
21896,Автотюн,gordunni,352,monk,mistweaver,16,4,12
21897,Matrim,arathor,351,monk,mistweaver,8,5,3
21898,Киото,ashenvale,350,monk,mistweaver,11,4,7
21899,Masimonk,blackrock,350,monk,mistweaver,11,4,7
21900,Frodrin,kazzak,347,monk,mistweaver,11,4,7
21901,Thiccbaby,kazzak,336,monk,mistweaver,9,4,5
21902,Insomniyah,tarren-mill,335,monk,mistweaver,11,4,7
21903,Buckersxo,kazzak,330,monk,mistweaver,11,6,5
21904,Midgetyoda,outland,330,monk,mistweaver,22,5,17
21905,Ilikeducks,ravencrest,319,monk,mistweaver,5,4,1
21906,Zaalleh,draenor,319,monk,mistweaver,5,4,1
21907,Nabenja,madmortem,319,monk,mistweaver,14,4,10
21908,Schellentano,defias-brotherhood,301,monk,mistweaver,13,4,9
21909,Moistweaver,drakthul,288,monk,mistweaver,6,3,3
21910,Loempia,outland,288,monk,mistweaver,6,3,3
21911,Fistwave,malganis,288,monk,mistweaver,6,3,3
21912,Atommyran,frostmane,288,monk,mistweaver,6,3,3
21913,Relentlessly,blackrock,288,monk,mistweaver,6,3,3
21914,Incapp,ysondre,288,monk,mistweaver,6,3,3
21915,Shoskio,chamber-of-aspects,288,monk,mistweaver,6,3,3
21916,Tastyfists,blackmoore,288,monk,mistweaver,6,3,3
21917,Киликххл,deathguard,288,monk,mistweaver,6,3,3
21918,Friidam,lightbringer,288,monk,mistweaver,6,3,3
21919,Shnohh,blackmoore,288,monk,mistweaver,6,3,3
21920,Nexìan,kazzak,288,monk,mistweaver,6,3,3
21921,Louiemon,outland,288,monk,mistweaver,6,3,3
21922,Mistless,ragnaros,288,monk,mistweaver,6,3,3
21923,Кроанла,howling-fjord,288,monk,mistweaver,6,3,3
21924,Norbii,twisting-nether,288,monk,mistweaver,6,3,3
21925,Shiìnx,hyjal,288,monk,mistweaver,6,3,3
21926,Kätelyys,dun-modr,288,monk,mistweaver,6,3,3
21927,Zyrosmonk,blackmoore,288,monk,mistweaver,6,3,3
21928,Menecares,blackhand,288,monk,mistweaver,6,3,3
21929,Monkiz,veknilash,288,monk,mistweaver,6,3,3
21930,Cmgxbrew,blackrock,288,monk,mistweaver,6,3,3
21931,Helacoon,archimonde,288,monk,mistweaver,6,3,3
21932,Xanderpowa,sanguino,288,monk,mistweaver,6,3,3
21933,Uggs,hyjal,288,monk,mistweaver,6,3,3
21934,Leifjuster,stormscale,288,monk,mistweaver,6,3,3
21935,Napqi,malganis,288,monk,mistweaver,6,3,3
21936,Ilsalumiere,nemesis,288,monk,mistweaver,6,3,3
21937,Kaskinhas,archimonde,288,monk,mistweaver,6,3,3
21938,Màlydôr,outland,288,monk,mistweaver,6,3,3
21939,Похмелись,blackscar,288,monk,mistweaver,6,3,3
21940,Leikô,grim-batol,288,monk,mistweaver,6,3,3
21941,Badwithnames,stormscale,288,monk,mistweaver,6,3,3
21942,Rípple,alakir,288,monk,mistweaver,6,3,3
21943,Fairhand,emerald-dream,288,monk,mistweaver,6,3,3
21944,Viggex,outland,288,monk,mistweaver,6,3,3
21945,Shàolïn,dalaran,288,monk,mistweaver,6,3,3
21946,Domedagsdamp,draenor,288,monk,mistweaver,6,3,3
21947,Ipès,archimonde,288,monk,mistweaver,6,3,3
21948,Culiacàn,blackmoore,288,monk,mistweaver,6,3,3
21949,Píco,gorgonnash,288,monk,mistweaver,6,3,3
21950,Mecin,ragnaros,288,monk,mistweaver,6,3,3
21951,Crommul,burning-legion,288,monk,mistweaver,6,3,3
21952,Mønkek,kazzak,288,monk,mistweaver,6,3,3
21953,Wando,defias-brotherhood,288,monk,mistweaver,6,3,3
21954,Grenreaper,twisting-nether,288,monk,mistweaver,6,3,3
21955,Baisi,blackhand,288,monk,mistweaver,6,3,3
21956,Neptulion,ravencrest,288,monk,mistweaver,6,3,3
21957,Yutahon,azjolnerub,288,monk,mistweaver,6,3,3
21958,Коррелир,howling-fjord,288,monk,mistweaver,6,3,3
21959,Kaizenthor,runetotem,288,monk,mistweaver,6,3,3
21960,Kylâas,die-ewige-wacht,288,monk,mistweaver,6,3,3
21961,Fluxqt,ravencrest,288,monk,mistweaver,6,3,3
21962,Koba,frostwolf,288,monk,mistweaver,6,3,3
21963,Perikencito,dun-modr,288,monk,mistweaver,6,3,3
21964,Родо,blackscar,288,monk,mistweaver,6,3,3
21965,Wèéman,grim-batol,288,monk,mistweaver,6,3,3
21966,Trubushatal,ravencrest,288,monk,mistweaver,6,3,3
21967,Lassador,onyxia,288,monk,mistweaver,6,3,3
21968,Yogi,defias-brotherhood,288,monk,mistweaver,6,3,3
21969,Askmeout,ravencrest,288,monk,mistweaver,7,3,4
21970,Karatemonk,stormscale,288,monk,mistweaver,12,3,9
21971,Drunklee,aegwynn,288,monk,mistweaver,12,3,9
21972,Alilith,drakthul,288,monk,mistweaver,12,3,9
21973,Jinora,theradras,288,monk,mistweaver,12,3,9
21974,Xvll,kaelthas,288,monk,mistweaver,12,3,9
21975,Fistmeg,grim-batol,288,monk,mistweaver,12,3,9
21976,Monkiky,hyjal,288,monk,mistweaver,12,3,9
21977,Brewdooms,laughing-skull,288,monk,mistweaver,12,3,9
21978,Aguerxf,alleria,288,monk,mistweaver,12,3,9
21979,Olîvê,ravencrest,288,monk,mistweaver,12,3,9
21980,Albertã,doomhammer,288,monk,mistweaver,12,3,9
21981,Justfistyoux,archimonde,288,monk,mistweaver,12,3,9
21982,Tossen,ragnaros,288,monk,mistweaver,12,3,9
21983,Lonechi,sylvanas,288,monk,mistweaver,12,3,9
21984,Monkenya,kazzak,288,monk,mistweaver,12,3,9
21985,Mîyüki,dalaran,288,monk,mistweaver,12,3,9
21986,Koreanbullet,archimonde,288,monk,mistweaver,12,3,9
21987,Leøni,malfurion,288,monk,mistweaver,12,3,9
21988,Whinestein,the-venture-co,288,monk,mistweaver,12,3,9
21989,Velita,dun-modr,288,monk,mistweaver,18,3,15
21990,Phínez,thunderhorn,288,monk,mistweaver,18,3,15
21991,Munkeguden,ravencrest,288,monk,mistweaver,22,3,19
21992,Nosrewolwer,burning-legion,287,monk,mistweaver,6,3,3
21993,Athëlyn,hyjal,287,monk,mistweaver,6,3,3
21994,Bo,malorne,287,monk,mistweaver,6,3,3
21995,Мастерхилфу,ashenvale,287,monk,mistweaver,6,3,3
21996,Playboicarti,frostwolf,287,monk,mistweaver,6,3,3
21997,Hanumahn,kilrogg,287,monk,mistweaver,12,3,9
21998,Edenbllow,twisting-nether,287,monk,mistweaver,12,3,9
21999,Pepefocho,sanguino,286,monk,mistweaver,6,3,3
22000,Shorebreak,argent-dawn,286,monk,mistweaver,6,3,3
22001,Ragenn,zuljin,256,monk,mistweaver,4,4,0
22002,Mossadjr,blackmoore,256,monk,mistweaver,4,4,0
22003,Maharaj,terenas,255,monk,mistweaver,11,3,8
22004,Trlmøna,gorgonnash,240,monk,mistweaver,9,4,5
22005,Nypö,hyjal,234,monk,mistweaver,10,4,6
22006,Mouhous,hellscream,234,monk,mistweaver,13,4,9
22007,Jackíechen,draenor,234,monk,mistweaver,15,4,11
22008,Арнольдовна,blackscar,234,monk,mistweaver,17,4,13
22009,Colita,kazzak,233,monk,mistweaver,16,5,11
22010,Mynaira,tarren-mill,208,monk,mistweaver,25,3,22
22011,Злюкшо,howling-fjord,192,monk,mistweaver,10,4,6
22012,Fisterxd,blackrock,192,monk,mistweaver,6,2,4
22013,Obeliskbrew,kazzak,192,monk,mistweaver,6,2,4
22014,Nephi,kirin-tor,192,monk,mistweaver,6,2,4
22015,Âsmoran,blackmoore,192,monk,mistweaver,6,2,4
22016,Luffix,outland,192,monk,mistweaver,6,2,4
22017,Scorpìon,blackrock,192,monk,mistweaver,6,2,4
22018,Yinsho,stormscale,192,monk,mistweaver,6,2,4
22019,Loveít,blackrock,192,monk,mistweaver,6,2,4
22020,Skâte,dun-modr,192,monk,mistweaver,6,2,4
22021,Auaaua,ravencrest,192,monk,mistweaver,6,2,4
22022,Dalaipyjama,quelthalas,192,monk,mistweaver,6,2,4
22023,Merlyñ,blackmoore,192,monk,mistweaver,6,2,4
22024,Domingovivas,dun-modr,192,monk,mistweaver,6,2,4
22025,Menazera,antonidas,192,monk,mistweaver,6,2,4
22026,Chegweaver,ravencrest,192,monk,mistweaver,6,2,4
22027,Mystize,shattered-hand,192,monk,mistweaver,6,2,4
22028,Jetsweep,kazzak,192,monk,mistweaver,6,2,4
22029,Wilymonka,dalaran,192,monk,mistweaver,6,2,4
22030,Хере,soulflayer,192,monk,mistweaver,6,2,4
22031,Espectrå,dun-modr,192,monk,mistweaver,6,2,4
22032,Kmorhin,antonidas,192,monk,mistweaver,6,2,4
22033,Люсилью,howling-fjord,192,monk,mistweaver,6,2,4
22034,Dennismansix,sylvanas,192,monk,mistweaver,6,2,4
22035,Âechlz,malfurion,192,monk,mistweaver,6,2,4
22036,Acbcz,draenor,192,monk,mistweaver,6,2,4
22037,Watermelon,laughing-skull,192,monk,mistweaver,6,2,4
22038,Brewsmaster,archimonde,192,monk,mistweaver,6,2,4
22039,Venemy,sanguino,192,monk,mistweaver,6,2,4
22040,Fènja,kult-der-verdammten,192,monk,mistweaver,6,2,4
22041,Karatemooves,kazzak,192,monk,mistweaver,6,2,4
22042,Starwalkin,silvermoon,192,monk,mistweaver,6,2,4
22043,Pleasure,laughing-skull,192,monk,mistweaver,6,2,4
22044,Jolifine,alleria,192,monk,mistweaver,6,2,4
22045,Shinyin,outland,192,monk,mistweaver,6,2,4
22046,Liluzi,aszune,192,monk,mistweaver,6,2,4
22047,Dunkfjås,stormscale,192,monk,mistweaver,6,2,4
22048,Ebonymilfy,archimonde,192,monk,mistweaver,6,2,4
22049,Ïnaho,hyjal,192,monk,mistweaver,6,2,4
22050,Wifeeagro,doomhammer,192,monk,mistweaver,6,2,4
22051,Karmaclit,malganis,192,monk,mistweaver,6,2,4
22052,Yokuboo,ysondre,192,monk,mistweaver,6,2,4
22053,Shaosshoshin,exodar,192,monk,mistweaver,6,2,4
22054,Sînge,archimonde,192,monk,mistweaver,6,2,4
22055,Rbgmachine,burning-legion,192,monk,mistweaver,6,2,4
22056,Mutai,tarren-mill,192,monk,mistweaver,6,2,4
22057,Sashun,blackmoore,192,monk,mistweaver,6,2,4
22058,Зараз,gordunni,192,monk,mistweaver,6,2,4
22059,Kûngfu,tarren-mill,192,monk,mistweaver,6,2,4
22060,Monkfriend,quelthalas,192,monk,mistweaver,6,2,4
22061,Zaheer,xavius,192,monk,mistweaver,6,2,4
22062,Justacomma,outland,192,monk,mistweaver,6,2,4
22063,Altairan,ragnaros,192,monk,mistweaver,6,2,4
22064,Ahaa,kazzak,192,monk,mistweaver,6,2,4
22065,Flyingraven,magtheridon,192,monk,mistweaver,6,2,4
22066,Shynlee,frostwhisper,192,monk,mistweaver,6,2,4
22067,Syy,medivh,192,monk,mistweaver,6,2,4
22068,Ronnchi,twisting-nether,192,monk,mistweaver,6,2,4
22069,Ønøf,rashgarroth,192,monk,mistweaver,6,2,4
22070,Faustíne,blackmoore,192,monk,mistweaver,6,2,4
22071,Tøngpø,argent-dawn,192,monk,mistweaver,6,2,4
22072,Jadefain,argent-dawn,192,monk,mistweaver,6,2,4
22073,Кулаквтебе,borean-tundra,192,monk,mistweaver,6,2,4
22074,Mistya,ragnaros,192,monk,mistweaver,6,2,4
22075,Леронтас,gordunni,192,monk,mistweaver,6,2,4
22076,Xùen,blackrock,192,monk,mistweaver,6,2,4
22077,Монкпех,gordunni,192,monk,mistweaver,6,2,4
22078,Toxicvxpe,archimonde,192,monk,mistweaver,6,2,4
22079,Trippyv,ragnaros,192,monk,mistweaver,6,2,4
22080,Axan,drekthar,192,monk,mistweaver,6,2,4
22081,Beriberi,tichondrius,192,monk,mistweaver,7,2,5
22082,Alexandrovic,hyjal,192,monk,mistweaver,12,2,10
22083,Johnsôn,blackmoore,192,monk,mistweaver,12,2,10
22084,Ascrem,ragnaros,192,monk,mistweaver,12,2,10
22085,Headakzar,kazzak,192,monk,mistweaver,12,2,10
22086,Chîca,ysondre,192,monk,mistweaver,12,2,10
22087,Brixelol,kazzak,192,monk,mistweaver,12,2,10
22088,Clonaz,silvermoon,192,monk,mistweaver,12,2,10
22089,Jacksbäro,zirkel-des-cenarius,192,monk,mistweaver,12,2,10
22090,Anifurry,tarren-mill,192,monk,mistweaver,12,2,10
22091,Sargnorak,dalaran,191,monk,mistweaver,6,2,4
22092,Чвка,booty-bay,191,monk,mistweaver,6,2,4
22093,Hisagi,khaz-modan,191,monk,mistweaver,6,2,4
22094,Arukoru,kazzak,191,monk,mistweaver,18,2,16
22095,Andrah,blackmoore,185,monk,mistweaver,14,4,10
22096,Swiftmonky,azuremyst,159,monk,mistweaver,5,2,3
22097,Мирксимонк,soulflayer,144,monk,mistweaver,3,3,0
22098,Зрти,gordunni,138,monk,mistweaver,12,4,8
22099,Saïtama,krasus,138,monk,mistweaver,10,3,7
22100,Ostarikyttä,stormscale,138,monk,mistweaver,10,3,7
22101,Ghettomonk,blackmoore,138,monk,mistweaver,11,3,8
22102,Shenlong,burning-blade,138,monk,mistweaver,14,3,11
22103,Спартаннка,gordunni,137,monk,mistweaver,8,3,5
22104,Wraq,tarren-mill,128,monk,mistweaver,4,2,2
22105,Cheechong,grim-batol,127,monk,mistweaver,8,2,6
22106,Aequïtas,nemesis,96,monk,mistweaver,6,1,5
22107,Lìlíy,taerar,96,monk,mistweaver,6,1,5
22108,Shîïna,ysondre,96,monk,mistweaver,6,1,5
22109,Ytjin,draenor,96,monk,mistweaver,6,1,5
22110,Brewbunnyqt,thrall,96,monk,mistweaver,6,1,5
22111,Itxelita,zuljin,96,monk,mistweaver,6,1,5
22112,Ätishâ,archimonde,96,monk,mistweaver,6,1,5
22113,Rostick,drakthul,96,monk,mistweaver,6,1,5
22114,Gôeller,stormscale,96,monk,mistweaver,6,1,5
22115,Mailyne,blackmoore,96,monk,mistweaver,6,1,5
22116,Brandy,kazzak,96,monk,mistweaver,6,1,5
22117,Legpunch,the-maelstrom,96,monk,mistweaver,6,1,5
22118,Toté,kazzak,96,monk,mistweaver,6,1,5
22119,Botsmw,kazzak,96,monk,mistweaver,6,1,5
22120,Кукуныч,deathguard,96,monk,mistweaver,6,1,5
22121,Jusex,stormreaver,96,monk,mistweaver,6,1,5
22122,Butrinto,hellfire,96,monk,mistweaver,6,1,5
22123,Jessiemonk,blackhand,96,monk,mistweaver,6,1,5
22124,Moorf,ravencrest,96,monk,mistweaver,6,1,5
22125,Skadchi,blackhand,96,monk,mistweaver,6,1,5
22126,Fapmaster,aegwynn,96,monk,mistweaver,6,1,5
22127,Bruslie,cthun,96,monk,mistweaver,6,1,5
22128,Mongretod,ravencrest,96,monk,mistweaver,6,1,5
22129,Glivilalis,drekthar,96,monk,mistweaver,6,1,5
22130,Bænkai,naxxramas,96,monk,mistweaver,6,1,5
22131,Smlpp,kazzak,96,monk,mistweaver,6,1,5
22132,Pream,blackrock,96,monk,mistweaver,6,1,5
22133,Monkinator,stormreaver,96,monk,mistweaver,6,1,5
22134,Monkolben,blackmoore,96,monk,mistweaver,6,1,5
22135,Cbamonk,tarren-mill,96,monk,mistweaver,6,1,5
22136,Xuaolang,sanguino,96,monk,mistweaver,6,1,5
22137,Àómìñêdâìkí,lightnings-blade,96,monk,mistweaver,6,1,5
22138,Havefunguys,alakir,96,monk,mistweaver,6,1,5
22139,Assaalaria,argent-dawn,96,monk,mistweaver,6,1,5
22140,Sooyung,kazzak,96,monk,mistweaver,6,1,5
22141,Missblack,zuljin,96,monk,mistweaver,6,1,5
22142,Capos,wrathbringer,96,monk,mistweaver,11,1,10
22143,Rhodin,krasus,96,monk,mistweaver,12,1,11
22144,Sigournémist,silvermoon,96,monk,mistweaver,12,1,11
22145,Upbringer,ragnaros,96,monk,mistweaver,12,1,11
22146,Xiâomèi,dun-modr,96,monk,mistweaver,12,1,11
22147,Marrów,chamber-of-aspects,96,monk,mistweaver,14,1,13
22148,Nïkaa,dun-modr,84,monk,mistweaver,9,5,4
22149,Woguo,drakthul,84,monk,mistweaver,10,4,6
22150,Griffens,argent-dawn,79,monk,mistweaver,5,1,4
22151,Barendhoff,sylvanas,64,monk,mistweaver,4,1,3
22152,Бязь,gordunni,63,monk,mistweaver,2,2,0
22153,Fae,kirin-tor,63,monk,mistweaver,14,2,12
22154,Johnnybgood,tarren-mill,42,monk,mistweaver,10,3,7
22155,Axilane,outland,42,monk,mistweaver,7,2,5
22156,Флокэ,soulflayer,42,monk,mistweaver,9,2,7
22157,Monkeykung,defias-brotherhood,40,monk,mistweaver,16,3,13
22158,Sinpho,ahnqiraj,1190,monk,brewmaster,42,16,26
22159,Winchun,ravencrest,820,monk,brewmaster,32,14,18
22160,Padawang,twisting-nether,767,monk,brewmaster,24,8,16
22161,Комбатпро,borean-tundra,764,monk,brewmaster,70,30,40
22162,Jademyst,outland,671,monk,brewmaster,18,7,11
22163,Shirôhige,zirkel-des-cenarius,288,monk,brewmaster,6,3,3
22164,Tauroné,draenor,288,monk,brewmaster,12,3,9
22165,Fullzi,dalaran,192,monk,brewmaster,6,2,4
22166,Zerendir,magtheridon,192,monk,brewmaster,6,2,4
22167,Tayoo,aegwynn,192,monk,brewmaster,6,2,4
22168,Youkaii,alexstrasza,192,monk,brewmaster,12,2,10
22169,Tylee,tarren-mill,96,monk,brewmaster,6,1,5
22170,Mezz,ahnqiraj,96,monk,brewmaster,6,1,5
22171,Badcøwboy,archimonde,96,monk,brewmaster,6,1,5
22172,Lubeï,kirin-tor,96,monk,brewmaster,6,1,5
22173,Lòthbar,confrérie-du-thorium,63,monk,brewmaster,2,2,0
22174,Queteapie,stormscale,2331,monk,windwalker,100,60,40
22175,Sîxmonths,stormscale,2325,monk,windwalker,84,56,28
22176,Fistyw,stormscale,2313,monk,windwalker,104,60,44
22177,Faxax,draenor,2243,monk,windwalker,120,63,57
22178,Ilovehim,antonidas,2237,monk,windwalker,102,58,44
22179,Ewynamonk,silvermoon,2236,monk,windwalker,114,61,53
22180,Rmtexter,ravencrest,2204,monk,windwalker,137,72,65
22181,Senretsu,shattered-halls,2177,monk,windwalker,102,54,48
22182,Plaww,dalaran,2172,monk,windwalker,120,75,45
22183,Monkmeta,frostwolf,2171,monk,windwalker,114,70,44
22184,Щищ,gordunni,2170,monk,windwalker,198,114,84
22185,Wonkeed,hyjal,2144,monk,windwalker,113,68,45
22186,Daosh,nemesis,2137,monk,windwalker,91,48,43
22187,Deretrox,twisting-nether,2127,monk,windwalker,84,47,37
22188,Tabetai,tarren-mill,2125,monk,windwalker,90,46,44
22189,Elinalia,burning-legion,2124,monk,windwalker,120,62,58
22190,Keeferslover,dun-morogh,2123,monk,windwalker,60,35,25
22191,Lilcatlife,tyrande,2123,monk,windwalker,66,36,30
22192,Redundänt,kazzak,2122,monk,windwalker,78,43,35
22193,Brñ,twisting-nether,2121,monk,windwalker,72,39,33
22194,Edenwalker,dun-morogh,2121,monk,windwalker,96,46,50
22195,Unpruneable,stormscale,2116,monk,windwalker,161,81,80
22196,Váinz,ravencrest,2112,monk,windwalker,78,41,37
22197,Rivazsunkick,archimonde,2104,monk,windwalker,208,103,105
22198,Leppix,outland,2103,monk,windwalker,66,35,31
22199,Pichouhuahua,elune,2096,monk,windwalker,120,63,57
22200,Theoww,dragonblight,2094,monk,windwalker,96,48,48
22201,Snusochnocco,the-maelstrom,2088,monk,windwalker,84,41,43
22202,Ladderfiend,stormscale,2072,monk,windwalker,137,66,71
22203,Fistinguhuhu,outland,2067,monk,windwalker,84,45,39
22204,Hitsuwalker,archimonde,2049,monk,windwalker,204,115,89
22205,Fabrina,blackrock,2038,monk,windwalker,96,52,44
22206,Hefners,grim-batol,2028,monk,windwalker,71,36,35
22207,Stepsyzz,stormscale,2021,monk,windwalker,137,65,72
22208,Edenmonk,dun-morogh,2020,monk,windwalker,60,35,25
22209,Fistenjoyer,outland,2020,monk,windwalker,101,52,49
22210,Нелегитимный,howling-fjord,2006,monk,windwalker,379,193,186
22211,Ilovealicia,ragnaros,2005,monk,windwalker,89,47,42
22212,Melyda,ravencrest,2003,monk,windwalker,168,92,76
22213,Zukatan,tarren-mill,2001,monk,windwalker,111,59,52
22214,Gyto,archimonde,1998,monk,windwalker,71,39,32
22215,Balia,blackrock,1997,monk,windwalker,78,39,39
22216,Ninadobrév,stormscale,1993,monk,windwalker,150,90,60
22217,Enerchi,ravencrest,1988,monk,windwalker,72,42,30
22218,Stillwater,thrall,1986,monk,windwalker,172,92,80
22219,Nicesky,ravencrest,1985,monk,windwalker,114,59,55
22220,Минимонахх,blackscar,1985,monk,windwalker,99,46,53
22221,Мистмастер,soulflayer,1984,monk,windwalker,48,30,18
22222,Rismonk,frostmane,1982,monk,windwalker,54,29,25
22223,Niamix,archimonde,1978,monk,windwalker,194,96,98
22224,Orkamonka,burning-legion,1977,monk,windwalker,54,31,23
22225,Erazhen,blackrock,1977,monk,windwalker,60,31,29
22226,Eth,nagrand,1975,monk,windwalker,84,42,42
22227,Инрэйджинкап,soulflayer,1972,monk,windwalker,168,85,83
22228,Yassøux,archimonde,1971,monk,windwalker,270,142,128
22229,Bulluh,blackmoore,1964,monk,windwalker,59,31,28
22230,Juujika,ravencrest,1961,monk,windwalker,53,31,22
22231,Vixia,outland,1956,monk,windwalker,35,21,14
22232,Sayozz,hyjal,1953,monk,windwalker,204,106,98
22233,Sørann,drekthar,1943,monk,windwalker,100,55,45
22234,Имортарион,howling-fjord,1935,monk,windwalker,48,29,19
22235,Ztl,twisting-nether,1931,monk,windwalker,185,103,82
22236,Dänÿww,elune,1926,monk,windwalker,62,32,30
22237,Oberháupt,blackrock,1922,monk,windwalker,72,41,31
22238,Jájsemshadow,drakthul,1922,monk,windwalker,72,37,35
22239,Shînøbi,dalaran,1918,monk,windwalker,84,42,42
22240,Dêsmî,ravencrest,1913,monk,windwalker,34,25,9
22241,Sobadzlolz,alexstrasza,1911,monk,windwalker,184,104,80
22242,Trendyroxy,blackrock,1908,monk,windwalker,103,51,52
22243,Tianzu,twisting-nether,1908,monk,windwalker,96,47,49
22244,Muix,draenor,1906,monk,windwalker,30,20,10
22245,Vexíllum,sylvanas,1906,monk,windwalker,84,46,38
22246,Riskcapcap,dentarg,1905,monk,windwalker,72,37,35
22247,Pitball,ravencrest,1898,monk,windwalker,72,36,36
22248,Милыйколян,soulflayer,1898,monk,windwalker,66,33,33
22249,Ksâin,ravencrest,1896,monk,windwalker,66,34,32
22250,Pandamoniun,aggra-português,1890,monk,windwalker,176,87,89
22251,Копытька,gordunni,1889,monk,windwalker,63,35,28
22252,Rismonk,twisting-nether,1887,monk,windwalker,96,47,49
22253,Санварион,eversong,1884,monk,windwalker,96,48,48
22254,Муррчалкин,howling-fjord,1880,monk,windwalker,48,28,20
22255,Ellipirelli,doomhammer,1880,monk,windwalker,70,30,40
22256,Аррани,thermaplugg,1874,monk,windwalker,58,33,25
22257,Doktormonk,blackrock,1873,monk,windwalker,184,105,79
22258,Domww,outland,1871,monk,windwalker,108,59,49
22259,Shpunk,ravencrest,1870,monk,windwalker,132,64,68
22260,Troopmonk,ravencrest,1867,monk,windwalker,157,76,81
22261,Shrimpcawk,alonsus,1866,monk,windwalker,77,47,30
22262,Rivaz,archimonde,1865,monk,windwalker,54,31,23
22263,Эльморо,goldrinn,1865,monk,windwalker,54,30,24
22264,Ãmaterasû,kazzak,1864,monk,windwalker,61,30,31
22265,Hurricrane,kazzak,1861,monk,windwalker,232,115,117
22266,Эльторо,goldrinn,1860,monk,windwalker,60,29,31
22267,Beernie,tarren-mill,1855,monk,windwalker,66,41,25
22268,Маруты,soulflayer,1855,monk,windwalker,88,35,53
22269,Wolmachégodx,archimonde,1854,monk,windwalker,42,25,17
22270,Shaolinthug,stormscale,1854,monk,windwalker,72,32,40
22271,Mosch,blackrock,1853,monk,windwalker,54,33,21
22272,Carbozø,archimonde,1850,monk,windwalker,101,61,40
22273,Kokushibo,cthun,1850,monk,windwalker,54,28,26
22274,Яагрессивный,howling-fjord,1850,monk,windwalker,74,36,38
22275,Gararasu,eredar,1846,monk,windwalker,42,22,20
22276,Rorkito,sanguino,1846,monk,windwalker,86,45,41
22277,Devilmønk,thrall,1845,monk,windwalker,96,49,47
22278,Boostarevine,stormscale,1842,monk,windwalker,59,38,21
22279,Rêshi,draenor,1841,monk,windwalker,96,62,34
22280,Тихийпук,deathguard,1839,monk,windwalker,164,92,72
22281,Soulja,bloodfeather,1839,monk,windwalker,326,165,161
22282,Teressah,argent-dawn,1838,monk,windwalker,48,24,24
22283,Джэкичача,soulflayer,1837,monk,windwalker,56,29,27
22284,Santanax,ravencrest,1834,monk,windwalker,42,27,15
22285,Zéroneufsix,silvermoon,1834,monk,windwalker,68,31,37
22286,Kitcheneer,twisting-nether,1832,monk,windwalker,65,37,28
22287,Peaceweaver,ravencrest,1832,monk,windwalker,94,53,41
22288,Linuxx,ravencrest,1832,monk,windwalker,90,45,45
22289,Chucknorrîs,doomhammer,1831,monk,windwalker,79,47,32
22290,Toyless,ravencrest,1831,monk,windwalker,54,27,27
22291,Freehelper,stormscale,1831,monk,windwalker,66,28,38
22292,Ванфист,gordunni,1830,monk,windwalker,113,66,47
22293,Iløvealicia,ravencrest,1830,monk,windwalker,58,28,30
22294,Venuki,blackrock,1829,monk,windwalker,60,35,25
22295,Xinxanxonxin,zuljin,1829,monk,windwalker,54,25,29
22296,Диванн,howling-fjord,1827,monk,windwalker,53,27,26
22297,Sàitama,hyjal,1827,monk,windwalker,58,29,29
22298,Jinpachi,ravencrest,1826,monk,windwalker,48,23,25
22299,Reõ,argent-dawn,1825,monk,windwalker,107,64,43
22300,Iceym,stormscale,1825,monk,windwalker,81,41,40
22301,Monkini,kazzak,1823,monk,windwalker,54,27,27
22302,Sororicide,stormscale,1822,monk,windwalker,161,81,80
22303,Klumpenx,draenor,1821,monk,windwalker,80,43,37
22304,Iminzww,ravencrest,1819,monk,windwalker,90,45,45
22305,Denjasftw,culte-de-la-rive-noire,1818,monk,windwalker,42,27,15
22306,Дезмимонк,ashenvale,1816,monk,windwalker,43,21,22
22307,Monkees,twisting-nether,1815,monk,windwalker,65,33,32
22308,Калестонз,howling-fjord,1811,monk,windwalker,54,31,23
22309,Fotmwalker,ragnaros,1811,monk,windwalker,257,129,128
22310,Lullerull,silvermoon,1810,monk,windwalker,51,31,20
22311,Mónkâs,tarren-mill,1810,monk,windwalker,72,32,40
22312,Рэйвх,howling-fjord,1808,monk,windwalker,36,19,17
22313,Sushiroll,stormrage,1808,monk,windwalker,111,55,56
22314,Эвэйжион,gordunni,1807,monk,windwalker,84,54,30
22315,Venrea,archimonde,1807,monk,windwalker,54,31,23
22316,Baltimore,stormscale,1806,monk,windwalker,36,25,11
22317,Arachmk,drakthul,1806,monk,windwalker,72,33,39
22318,Mynokxu,blackmoore,1805,monk,windwalker,92,54,38
22319,Mebrin,ragnaros,1805,monk,windwalker,71,37,34
22320,Åbyssgòd,kazzak,1805,monk,windwalker,60,24,36
22321,Niyka,silvermoon,1804,monk,windwalker,72,40,32
22322,Möîne,arathi,1804,monk,windwalker,84,44,40
22323,Unangebracht,silvermoon,1803,monk,windwalker,227,121,106
22324,Pandafuki,ravencrest,1803,monk,windwalker,62,33,29
22325,Saltotriks,tarren-mill,1802,monk,windwalker,62,28,34
22326,Notmelo,dun-modr,1801,monk,windwalker,48,25,23
22327,Krothus,tarren-mill,1800,monk,windwalker,48,32,16
22328,Windwanker,eredar,1800,monk,windwalker,36,22,14
22329,Fln,blackrock,1800,monk,windwalker,58,33,25
22330,Ревенджж,howling-fjord,1798,monk,windwalker,34,20,14
22331,Yacum,blackrock,1795,monk,windwalker,71,32,39
22332,Twinny,drakthul,1793,monk,windwalker,90,52,38
22333,Akuuji,silvermoon,1793,monk,windwalker,60,32,28
22334,Karmaisabich,ragnaros,1792,monk,windwalker,30,19,11
22335,Yukfou,tarren-mill,1792,monk,windwalker,59,28,31
22336,Kaijam,argent-dawn,1792,monk,windwalker,78,33,45
22337,Цеска,howling-fjord,1790,monk,windwalker,54,29,25
22338,Pàrádìsé,ravencrest,1787,monk,windwalker,119,60,59
22339,Salvaje,stormscale,1786,monk,windwalker,90,56,34
22340,Projectasura,draenor,1786,monk,windwalker,191,97,94
22341,Madelnheaven,burning-legion,1784,monk,windwalker,59,31,28
22342,Megatazz,hyjal,1783,monk,windwalker,82,47,35
22343,Tommypistol,runetotem,1782,monk,windwalker,214,106,108
22344,Healbotzweik,frostwolf,1782,monk,windwalker,54,24,30
22345,Skailzkrt,hyjal,1779,monk,windwalker,48,22,26
22346,Дуэльныйчел,howling-fjord,1774,monk,windwalker,122,64,58
22347,Tinjihn,magtheridon,1774,monk,windwalker,86,39,47
22348,Blïss,kazzak,1773,monk,windwalker,77,42,35
22349,Sponkas,tarren-mill,1768,monk,windwalker,42,20,22
22350,Ароба,blackscar,1766,monk,windwalker,90,42,48
22351,Pwaff,kazzak,1765,monk,windwalker,84,44,40
22352,Korié,ravencrest,1761,monk,windwalker,53,30,23
22353,Heran,ravencrest,1761,monk,windwalker,111,50,61
22354,Moultsou,hyjal,1758,monk,windwalker,66,33,33
22355,Тэсти,blackscar,1758,monk,windwalker,64,32,32
22356,Flunkefar,defias-brotherhood,1758,monk,windwalker,102,45,57
22357,Ackken,twisting-nether,1748,monk,windwalker,51,26,25
22358,Ellevance,draenor,1747,monk,windwalker,36,19,17
22359,Hôllowx,archimonde,1743,monk,windwalker,39,24,15
22360,Pelou,culte-de-la-rive-noire,1743,monk,windwalker,100,56,44
22361,Shoura,blackmoore,1741,monk,windwalker,48,24,24
22362,Фодз,soulflayer,1740,monk,windwalker,76,30,46
22363,Dwdw,aerie-peak,1737,monk,windwalker,54,28,26
22364,Shoenk,blackhand,1734,monk,windwalker,36,21,15
22365,Янакаблуках,howling-fjord,1734,monk,windwalker,245,139,106
22366,Lonechi,sylvanas,1733,monk,windwalker,36,21,15
22367,Лазанья,grom,1731,monk,windwalker,66,30,36
22368,Inkegomonk,draenor,1729,monk,windwalker,66,31,35
22369,Bugrika,tarren-mill,1728,monk,windwalker,42,22,20
22370,Виндволкерша,gordunni,1725,monk,windwalker,54,31,23
22371,Däemon,twisting-nether,1725,monk,windwalker,45,20,25
22372,Zandoy,draenor,1724,monk,windwalker,76,42,34
22373,Locotommy,blackrock,1721,monk,windwalker,42,21,21
22374,Roidcarry,blackrock,1720,monk,windwalker,83,45,38
22375,Omnibar,kazzak,1719,monk,windwalker,36,21,15
22376,Varis,stormreaver,1718,monk,windwalker,39,19,20
22377,Трэйци,blackscar,1716,monk,windwalker,39,23,16
22378,Yiannischan,draenor,1715,monk,windwalker,92,49,43
22379,Narstie,kazzak,1714,monk,windwalker,71,36,35
22380,Виноипиво,soulflayer,1713,monk,windwalker,60,30,30
22381,Ютуми,soulflayer,1712,monk,windwalker,48,24,24
22382,Димакарма,howling-fjord,1712,monk,windwalker,101,45,56
22383,Aslêyia,antonidas,1709,monk,windwalker,49,26,23
22384,Cranekickbot,ravencrest,1709,monk,windwalker,53,23,30
22385,Dansaam,tarren-mill,1706,monk,windwalker,24,18,6
22386,Cheethfu,ragnaros,1705,monk,windwalker,42,29,13
22387,Mikedcrybaby,tarren-mill,1705,monk,windwalker,143,72,71
22388,Yungdrippy,eredar,1705,monk,windwalker,52,26,26
22389,Лагвай,gordunni,1705,monk,windwalker,42,21,21
22390,Moistpocket,stormscale,1705,monk,windwalker,54,22,32
22391,Broner,dunemaul,1703,monk,windwalker,34,19,15
22392,Pili,aegwynn,1702,monk,windwalker,42,25,17
22393,Gorguts,stormscale,1700,monk,windwalker,54,25,29
22394,Xiâomèi,dun-modr,1700,monk,windwalker,78,35,43
22395,Helloimfrank,tarren-mill,1698,monk,windwalker,36,18,18
22396,Меняубило,howling-fjord,1696,monk,windwalker,78,37,41
22397,Osalot,ravencrest,1695,monk,windwalker,60,30,30
22398,Chaospilot,sylvanas,1694,monk,windwalker,122,57,65
22399,Testmonial,hyjal,1694,monk,windwalker,48,21,27
22400,Jeydi,ravencrest,1692,monk,windwalker,72,50,22
22401,Idiot,outland,1691,monk,windwalker,54,28,26
22402,Ashânti,eredar,1691,monk,windwalker,62,30,32
22403,Гладастар,soulflayer,1690,monk,windwalker,96,49,47
22404,Форгетх,soulflayer,1690,monk,windwalker,42,21,21
22405,Ugabugash,silvermoon,1689,monk,windwalker,36,25,11
22406,Bnî,blackmoore,1687,monk,windwalker,75,47,28
22407,Ravelbaby,blackrock,1687,monk,windwalker,51,25,26
22408,Tea,arathor,1686,monk,windwalker,92,52,40
22409,Lørðbrøñkø,blackrock,1686,monk,windwalker,102,56,46
22410,Greenshortea,aegwynn,1684,monk,windwalker,36,18,18
22411,Сугробикк,soulflayer,1683,monk,windwalker,66,24,42
22412,Sesi,drakthul,1682,monk,windwalker,66,28,38
22413,Khrylx,twisting-nether,1681,monk,windwalker,40,25,15
22414,Кианасоломид,gordunni,1681,monk,windwalker,182,91,91
22415,Tenshinhann,outland,1681,monk,windwalker,78,37,41
22416,Tisaki,blackhand,1680,monk,windwalker,41,25,16
22417,Hilzaxsub,archimonde,1679,monk,windwalker,47,29,18
22418,Pazü,ysondre,1679,monk,windwalker,119,57,62
22419,Senguro,frostwolf,1677,monk,windwalker,30,18,12
22420,Holmwalker,twisting-nether,1677,monk,windwalker,70,31,39
22421,Donvishas,aegwynn,1676,monk,windwalker,71,36,35
22422,Fistofrage,ravencrest,1675,monk,windwalker,54,31,23
22423,Шотгар,howling-fjord,1675,monk,windwalker,48,21,27
22424,Mädic,outland,1673,monk,windwalker,42,22,20
22425,Ratslayerz,dun-modr,1669,monk,windwalker,42,24,18
22426,Mionoor,aegwynn,1667,monk,windwalker,237,115,122
22427,Vtx,blackrock,1662,monk,windwalker,30,18,12
22428,Shagzy,ravencrest,1660,monk,windwalker,35,22,13
22429,Mollytov,tarren-mill,1659,monk,windwalker,53,22,31
22430,Geeér,outland,1658,monk,windwalker,42,24,18
22431,Kåýðø,archimonde,1658,monk,windwalker,50,25,25
22432,Leadgen,tarren-mill,1657,monk,windwalker,36,20,16
22433,Shardonay,ravencrest,1655,monk,windwalker,42,26,16
22434,Wuux,tarren-mill,1655,monk,windwalker,66,37,29
22435,Jjslag,stormscale,1655,monk,windwalker,72,31,41
22436,Nightingalê,silvermoon,1653,monk,windwalker,36,20,16
22437,Saduh,thrall,1653,monk,windwalker,44,20,24
22438,Минагороси,galakrond,1652,monk,windwalker,48,28,20
22439,Bîmbâmboom,blackmoore,1650,monk,windwalker,48,25,23
22440,Mîsts,aszune,1650,monk,windwalker,45,23,22
22441,Shirkán,ragnaros,1649,monk,windwalker,36,21,15
22442,Thérez,les-sentinelles,1648,monk,windwalker,42,22,20
22443,Hunkfur,ravencrest,1647,monk,windwalker,44,25,19
22444,Бадхидхаарма,booty-bay,1647,monk,windwalker,78,32,46
22445,Bonepalm,kazzak,1646,monk,windwalker,23,18,5
22446,Кишмякмонк,howling-fjord,1646,monk,windwalker,60,31,29
22447,Гуппер,howling-fjord,1646,monk,windwalker,54,23,31
22448,Capedbaldy,blackhand,1645,monk,windwalker,29,18,11
22449,Faustux,blackmoore,1644,monk,windwalker,60,28,32
22450,Gresmar,defias-brotherhood,1642,monk,windwalker,36,18,18
22451,Alkanphel,kazzak,1641,monk,windwalker,30,20,10
22452,Miløøx,silvermoon,1641,monk,windwalker,76,40,36
22453,Kármo,thrall,1638,monk,windwalker,41,20,21
22454,Мионелолл,goldrinn,1637,monk,windwalker,48,28,20
22455,Schøcker,blackmoore,1637,monk,windwalker,72,33,39
22456,Bastos,blackrock,1636,monk,windwalker,322,167,155
22457,Zenothar,ravencrest,1635,monk,windwalker,36,24,12
22458,Mefîsto,blackrock,1634,monk,windwalker,69,38,31
22459,Yeratel,argent-dawn,1633,monk,windwalker,90,39,51
22460,Gonkun,outland,1631,monk,windwalker,73,36,37
22461,Атакцуки,gordunni,1630,monk,windwalker,42,25,17
22462,Jafandmeja,tarren-mill,1629,monk,windwalker,100,60,40
22463,Hosh,ysondre,1629,monk,windwalker,66,33,33
22464,Sylicia,alleria,1628,monk,windwalker,102,49,53
22465,Пекинес,gordunni,1626,monk,windwalker,42,22,20
22466,Yobo,archimonde,1626,monk,windwalker,47,23,24
22467,Akhlÿs,ysondre,1624,monk,windwalker,30,17,13
22468,Thyf,drakthul,1624,monk,windwalker,54,22,32
22469,Anteric,sylvanas,1623,monk,windwalker,30,20,10
22470,Bossdog,mugthol,1623,monk,windwalker,33,21,12
22471,Gaehitmonlee,ravencrest,1623,monk,windwalker,223,120,103
22472,Монкигодхх,howling-fjord,1621,monk,windwalker,31,21,10
22473,Wwisalright,burning-legion,1621,monk,windwalker,50,28,22
22474,Hybridtheory,doomhammer,1620,monk,windwalker,159,81,78
22475,Iastyn,kazzak,1620,monk,windwalker,99,50,49
22476,Sérrè,tarren-mill,1618,monk,windwalker,48,25,23
22477,Монголгодх,howling-fjord,1617,monk,windwalker,192,110,82
22478,Catchmee,agamaggan,1616,monk,windwalker,30,17,13
22479,Erenaar,nemesis,1614,monk,windwalker,60,43,17
22480,Fijiwater,draenor,1613,monk,windwalker,24,17,7
22481,Тринх,ashenvale,1613,monk,windwalker,54,31,23
22482,Saisha,defias-brotherhood,1613,monk,windwalker,36,20,16
22483,Notsmol,quelthalas,1613,monk,windwalker,54,26,28
22484,Ampm,ravencrest,1613,monk,windwalker,36,17,19
22485,Heyami,ravencrest,1613,monk,windwalker,36,17,19
22486,Morslee,burning-legion,1612,monk,windwalker,97,44,53
22487,Tauti,dun-morogh,1610,monk,windwalker,36,21,15
22488,Steros,die-aldor,1608,monk,windwalker,42,21,21
22489,Nigu,dun-modr,1606,monk,windwalker,67,38,29
22490,Тайммуайтай,howling-fjord,1606,monk,windwalker,90,50,40
22491,Chigre,hyjal,1606,monk,windwalker,60,30,30
22492,Такюн,howling-fjord,1606,monk,windwalker,227,111,116
22493,Vayarah,antonidas,1605,monk,windwalker,54,28,26
22494,Акумах,blackscar,1605,monk,windwalker,99,48,51
22495,Elpuncho,dentarg,1604,monk,windwalker,48,30,18
22496,Thungara,emerald-dream,1604,monk,windwalker,42,22,20
22497,Valduri,stormscale,1604,monk,windwalker,60,27,33
22498,Shypanda,thrall,1602,monk,windwalker,84,52,32
22499,Fistu,silvermoon,1602,monk,windwalker,31,18,13
22500,Faustix,blackmoore,1602,monk,windwalker,78,42,36
22501,Blizò,tarren-mill,1601,monk,windwalker,36,19,17
22502,Lycké,silvermoon,1599,monk,windwalker,72,43,29
22503,Hazzat,nordrassil,1599,monk,windwalker,42,24,18
22504,Mcflaïe,ysondre,1599,monk,windwalker,36,17,19
22505,Lemmeportbk,ravencrest,1599,monk,windwalker,56,24,32
22506,Stormymonk,blackrock,1599,monk,windwalker,53,21,32
22507,Waaks,archimonde,1592,monk,windwalker,36,20,16
22508,Belobe,stormscale,1590,monk,windwalker,36,20,16
22509,Шейдла,soulflayer,1590,monk,windwalker,47,23,24
22510,Ròux,blackmoore,1589,monk,windwalker,53,27,26
22511,Pêterpump,blackrock,1589,monk,windwalker,54,24,30
22512,Saadx,ravencrest,1583,monk,windwalker,31,18,13
22513,Bluumorc,ravencrest,1580,monk,windwalker,30,20,10
22514,Skiplegsweeb,stormscale,1579,monk,windwalker,30,21,9
22515,Samantonah,nemesis,1572,monk,windwalker,51,32,19
22516,Vandamme,archimonde,1570,monk,windwalker,38,18,20
22517,Сандерстрайк,howling-fjord,1567,monk,windwalker,51,28,23
22518,Djshady,sylvanas,1566,monk,windwalker,60,30,30
22519,Uwuhehe,ravencrest,1565,monk,windwalker,30,18,12
22520,Монашкасюэ,howling-fjord,1564,monk,windwalker,30,21,9
22521,Chulli,stormscale,1558,monk,windwalker,39,21,18
22522,Трайтубайтми,gordunni,1556,monk,windwalker,39,18,21
22523,Permagone,argent-dawn,1555,monk,windwalker,54,30,24
22524,Ocëane,sanguino,1554,monk,windwalker,124,59,65
22525,Løllapalooza,ragnaros,1553,monk,windwalker,39,20,19
22526,Sòftx,stormscale,1549,monk,windwalker,34,22,12
22527,Mikz,ravencrest,1548,monk,windwalker,36,22,14
22528,Soxx,arthas,1548,monk,windwalker,85,46,39
22529,Rayokhen,kazzak,1546,monk,windwalker,30,17,13
22530,Рокебайбейби,howling-fjord,1546,monk,windwalker,143,71,72
22531,Zenified,ragnaros,1545,monk,windwalker,36,18,18
22532,Gdkz,tarren-mill,1543,monk,windwalker,48,18,30
22533,Xullon,dragonblight,1542,monk,windwalker,60,27,33
22534,Dankiron,darksorrow,1537,monk,windwalker,38,17,21
22535,Fistedx,twisting-nether,1537,monk,windwalker,87,36,51
22536,Анпапаяя,galakrond,1535,monk,windwalker,53,30,23
22537,Хекмуги,borean-tundra,1535,monk,windwalker,91,44,47
22538,Ryle,forscherliga,1534,monk,windwalker,42,21,21
22539,Thighdiver,emeriss,1532,monk,windwalker,60,40,20
22540,Chireapz,blackrock,1532,monk,windwalker,48,25,23
22541,Муайтайец,howling-fjord,1532,monk,windwalker,47,20,27
22542,Bwayn,blackhand,1531,monk,windwalker,30,16,14
22543,Луэнн,gordunni,1531,monk,windwalker,144,75,69
22544,Jeppehmonk,stormscale,1530,monk,windwalker,30,16,14
22545,Adrianchase,ravencrest,1526,monk,windwalker,30,16,14
22546,Тшейши,howling-fjord,1526,monk,windwalker,54,28,26
22547,Scribzw,twisting-nether,1524,monk,windwalker,24,16,8
22548,Такиера,gordunni,1523,monk,windwalker,30,16,14
22549,Mezz,ahnqiraj,1522,monk,windwalker,36,16,20
22550,Naschitüte,blackrock,1521,monk,windwalker,323,160,163
22551,Jolbucheron,hyjal,1517,monk,windwalker,99,52,47
22552,Qwizqwak,twisting-nether,1516,monk,windwalker,30,16,14
22553,Jackywayne,blackmoore,1513,monk,windwalker,53,29,24
22554,Feyzmonk,ysondre,1513,monk,windwalker,30,16,14
22555,Bloodfist,zuljin,1509,monk,windwalker,28,17,11
22556,Дивипи,blackscar,1506,monk,windwalker,54,24,30
22557,Ànklar,blackrock,1504,monk,windwalker,57,26,31
22558,Artharox,anachronos,1501,monk,windwalker,36,22,14
22559,Wakmo,bladefist,1497,monk,windwalker,61,35,26
22560,Fablemayfly,tarren-mill,1497,monk,windwalker,54,25,29
22561,Nggz,archimonde,1495,monk,windwalker,121,73,48
22562,Eonyzi,kazzak,1491,monk,windwalker,42,20,22
22563,Gotmonkon,tarren-mill,1490,monk,windwalker,36,18,18
22564,Annamonk,tarren-mill,1489,monk,windwalker,48,16,32
22565,Soleriasbrew,blackhand,1482,monk,windwalker,36,18,18
22566,Plsnerfmemor,hyjal,1480,monk,windwalker,64,32,32
22567,Хзт,howling-fjord,1480,monk,windwalker,45,17,28
22568,Awesomebrah,the-maelstrom,1478,monk,windwalker,36,19,17
22569,ßibip,hyjal,1474,monk,windwalker,32,22,10
22570,Vuzashiji,argent-dawn,1473,monk,windwalker,36,17,19
22571,Xuuan,argent-dawn,1472,monk,windwalker,101,57,44
22572,Mynaira,tarren-mill,1471,monk,windwalker,43,18,25
22573,Senshí,stormscale,1468,monk,windwalker,42,20,22
22574,Galaxyfists,blackhand,1467,monk,windwalker,132,68,64
22575,Ролитта,gordunni,1466,monk,windwalker,30,19,11
22576,Agitoyamissj,burning-legion,1466,monk,windwalker,139,66,73
22577,Реброперо,gordunni,1466,monk,windwalker,51,20,31
22578,Embodimonk,twisting-nether,1463,monk,windwalker,132,66,66
22579,Крутотимс,howling-fjord,1463,monk,windwalker,47,18,29
22580,Ìnconnu,dalaran,1460,monk,windwalker,100,51,49
22581,Fungamelol,blackhand,1459,monk,windwalker,30,19,11
22582,Fantazero,burning-legion,1459,monk,windwalker,35,16,19
22583,Dòrâ,archimonde,1459,monk,windwalker,51,22,29
22584,Sagewhisper,ravencrest,1458,monk,windwalker,57,27,30
22585,Kukazamura,silvermoon,1458,monk,windwalker,47,21,26
22586,Antomamonk,ravencrest,1455,monk,windwalker,33,16,17
22587,Andyww,doomhammer,1454,monk,windwalker,54,17,37
22588,Boxpunchkick,kazzak,1452,monk,windwalker,56,27,29
22589,Doobly,kazzak,1451,monk,windwalker,143,74,69
22590,Gatyz,archimonde,1450,monk,windwalker,69,31,38
22591,Bèrïth,kazzak,1447,monk,windwalker,78,35,43
22592,Nikchi,destromath,1444,monk,windwalker,66,30,36
22593,Spinntowin,blackmoore,1442,monk,windwalker,114,57,57
22594,Yesman,quelthalas,1439,monk,windwalker,152,82,70
22595,Пампич,borean-tundra,1438,monk,windwalker,36,17,19
22596,Артемиоксх,blackscar,1437,monk,windwalker,37,15,22
22597,Ðâvàizskÿ,ysondre,1436,monk,windwalker,30,15,15
22598,Saodiseng,outland,1435,monk,windwalker,42,17,25
22599,Флурсон,gordunni,1434,monk,windwalker,24,15,9
22600,Niyatî,draenor,1433,monk,windwalker,34,16,18
22601,Flowér,auchindoun,1433,monk,windwalker,36,15,21
22602,Denji,kargath,1432,monk,windwalker,24,15,9
22603,Домудароги,gordunni,1431,monk,windwalker,60,29,31
22604,Ijji,argent-dawn,1427,monk,windwalker,36,15,21
22605,Anhox,ragnaros,1425,monk,windwalker,30,15,15
22606,Jukei,blackmoore,1425,monk,windwalker,30,15,15
22607,Azato,hyjal,1423,monk,windwalker,54,27,27
22608,Chígoku,grim-batol,1421,monk,windwalker,128,62,66
22609,Løwping,blackmoore,1421,monk,windwalker,95,41,54
22610,Exikûsh,frostwolf,1417,monk,windwalker,45,25,20
22611,Kirkeý,ravencrest,1417,monk,windwalker,61,26,35
22612,Misutò,tarren-mill,1414,monk,windwalker,42,25,17
22613,Циорех,gordunni,1414,monk,windwalker,27,16,11
22614,Анике,howling-fjord,1413,monk,windwalker,33,16,17
22615,Mirôku,onyxia,1412,monk,windwalker,48,27,21
22616,Mink,uldum,1412,monk,windwalker,30,15,15
22617,Votbo,kazzak,1412,monk,windwalker,60,25,35
22618,Pandarok,argent-dawn,1412,monk,windwalker,48,20,28
22619,Enjàz,sylvanas,1410,monk,windwalker,29,17,12
22620,Dræk,twisting-nether,1410,monk,windwalker,116,60,56
22621,Vibé,blackmoore,1407,monk,windwalker,30,17,13
22622,Rãkan,kazzak,1405,monk,windwalker,36,21,15
22623,Euronymesis,silvermoon,1403,monk,windwalker,55,27,28
22624,Kneecapper,ravencrest,1403,monk,windwalker,80,39,41
22625,Белено,deathguard,1402,monk,windwalker,30,15,15
22626,Добраядушка,gordunni,1400,monk,windwalker,36,19,17
22627,Ívó,ragnaros,1400,monk,windwalker,48,20,28
22628,Cac,argent-dawn,1399,monk,windwalker,105,46,59
22629,Akÿo,archimonde,1399,monk,windwalker,35,15,20
22630,Pipatvs,drakthul,1398,monk,windwalker,31,21,10
22631,Бладмонки,soulflayer,1395,monk,windwalker,42,18,24
22632,Fífrelin,archimonde,1394,monk,windwalker,48,24,24
22633,Bakash,ysondre,1394,monk,windwalker,235,112,123
22634,Kyraxs,silvermoon,1392,monk,windwalker,53,26,27
22635,Fratznkicker,blackhand,1391,monk,windwalker,107,56,51
22636,Wazari,nemesis,1389,monk,windwalker,79,39,40
22637,Монахнехилит,howling-fjord,1389,monk,windwalker,66,27,39
22638,Brüshïë,kazzak,1387,monk,windwalker,29,15,14
22639,Mycki,dalaran,1386,monk,windwalker,47,24,23
22640,Kîngjungeîle,dalaran,1384,monk,windwalker,30,17,13
22641,Räudiger,nazjatar,1381,monk,windwalker,186,92,94
22642,Кюзичка,gordunni,1379,monk,windwalker,83,38,45
22643,Nolo,outland,1379,monk,windwalker,99,43,56
22644,Swiftmonky,azuremyst,1376,monk,windwalker,48,27,21
22645,Kyujushigu,silvermoon,1375,monk,windwalker,72,39,33
22646,Recklusa,stormscale,1374,monk,windwalker,69,39,30
22647,Nodzomi,shadowsong,1374,monk,windwalker,58,31,27
22648,Darré,sylvanas,1373,monk,windwalker,199,93,106
22649,Odelagga,draenor,1371,monk,windwalker,36,19,17
22650,Lucaspires,sylvanas,1370,monk,windwalker,72,25,47
22651,Îrønfist,blackmoore,1368,monk,windwalker,41,23,18
22652,Bænkai,naxxramas,1368,monk,windwalker,41,21,20
22653,Йетисан,gordunni,1359,monk,windwalker,137,63,74
22654,Bandiya,archimonde,1358,monk,windwalker,61,28,33
22655,Монкфейс,howling-fjord,1357,monk,windwalker,36,16,20
22656,Greytail,argent-dawn,1350,monk,windwalker,42,16,26
22657,Orkuuddiu,pozzo-delleternità,1350,monk,windwalker,48,18,30
22658,Fantasiløs,twisting-nether,1349,monk,windwalker,30,16,14
22659,Boutarzi,hyjal,1347,monk,windwalker,54,25,29
22660,Risomonk,blackrock,1346,monk,windwalker,33,16,17
22661,Intensivee,silvermoon,1345,monk,windwalker,77,36,41
22662,Icecoldish,tarren-mill,1344,monk,windwalker,78,41,37
22663,Traxxus,sanguino,1344,monk,windwalker,42,20,22
22664,Bubjuu,ravencrest,1343,monk,windwalker,24,14,10
22665,Hôllowx,throkferoth,1342,monk,windwalker,36,14,22
22666,Тхэгык,soulflayer,1342,monk,windwalker,36,14,22
22667,Schmidti,kazzak,1340,monk,windwalker,30,14,16
22668,Arsonists,argent-dawn,1339,monk,windwalker,24,14,10
22669,Domiqx,blackhand,1339,monk,windwalker,30,14,16
22670,Томтью,gordunni,1338,monk,windwalker,119,57,62
22671,Czvibuh,drakthul,1337,monk,windwalker,42,21,21
22672,Bobbyknuckls,ravencrest,1336,monk,windwalker,185,87,98
22673,Piedliés,ravencrest,1336,monk,windwalker,30,14,16
22674,Tubørg,ravencrest,1336,monk,windwalker,30,14,16
22675,Rerowine,magtheridon,1336,monk,windwalker,36,14,22
22676,Undefinedid,ravencrest,1335,monk,windwalker,110,57,53
22677,Matlahon,kazzak,1333,monk,windwalker,113,54,59
22678,Lesauceboss,kazzak,1332,monk,windwalker,30,14,16
22679,Thekaj,kazzak,1324,monk,windwalker,30,18,12
22680,Øbamakush,archimonde,1323,monk,windwalker,36,17,19
22681,Коркирас,howling-fjord,1322,monk,windwalker,90,50,40
22682,Tempestu,twisting-nether,1319,monk,windwalker,30,14,16
22683,Fûràxx,hyjal,1314,monk,windwalker,60,31,29
22684,Огненныйкит,blackscar,1311,monk,windwalker,33,18,15
22685,Vivvy,argent-dawn,1311,monk,windwalker,35,17,18
22686,Óó,los-errantes,1309,monk,windwalker,39,20,19
22687,Sarmal,nemesis,1305,monk,windwalker,62,29,33
22688,Kungfumite,twisting-nether,1296,monk,windwalker,95,49,46
22689,Miyaghï,dun-modr,1296,monk,windwalker,91,46,45
22690,Djînns,blackmoore,1296,monk,windwalker,30,15,15
22691,Xialongbao,khaz-modan,1291,monk,windwalker,47,19,28
22692,Hampocket,ravencrest,1290,monk,windwalker,38,15,23
22693,Cptfist,argent-dawn,1289,monk,windwalker,29,14,15
22694,Phyllochinon,blackrock,1288,monk,windwalker,52,32,20
22695,Яшкациган,howling-fjord,1288,monk,windwalker,70,31,39
22696,Karmachi,ravencrest,1283,monk,windwalker,41,14,27
22697,Gúerrilla,tarren-mill,1280,monk,windwalker,96,55,41
22698,Sajin,la-croisade-écarlate,1279,monk,windwalker,29,14,15
22699,Fatlazypanda,argent-dawn,1273,monk,windwalker,56,33,23
22700,Пивондэполо,gordunni,1271,monk,windwalker,46,22,24
22701,Mønkeydluffy,blackmoore,1269,monk,windwalker,66,33,33
22702,Des,bronzebeard,1265,monk,windwalker,20,14,6
22703,Maino,dalaran,1262,monk,windwalker,30,19,11
22704,Вагонюлеера,howling-fjord,1260,monk,windwalker,28,14,14
22705,Ketakarlsson,tarren-mill,1253,monk,windwalker,128,68,60
22706,Lòthbar,confrérie-du-thorium,1252,monk,windwalker,47,27,20
22707,Malutkie,defias-brotherhood,1252,monk,windwalker,144,68,76
22708,Kylerøne,hyjal,1249,monk,windwalker,42,19,23
22709,Thänkky,kazzak,1247,monk,windwalker,18,13,5
22710,Vajawalkerx,twisting-nether,1247,monk,windwalker,18,13,5
22711,Атммо,soulflayer,1247,monk,windwalker,24,13,11
22712,Djpunchable,blackrock,1247,monk,windwalker,24,13,11
22713,Meineaugen,blackhand,1246,monk,windwalker,18,13,5
22714,Moonkeeye,stormscale,1246,monk,windwalker,114,59,55
22715,Owalker,ravencrest,1245,monk,windwalker,18,13,5
22716,Фортрен,deepholm,1244,monk,windwalker,30,13,17
22717,Blyatfist,draenor,1243,monk,windwalker,24,13,11
22718,Pawsgodx,ragnaros,1242,monk,windwalker,24,13,11
22719,Pacimaru,silvermoon,1242,monk,windwalker,30,13,17
22720,Brandy,kazzak,1242,monk,windwalker,30,13,17
22721,Fullzi,dalaran,1241,monk,windwalker,24,13,11
22722,Sweeneyboo,outland,1241,monk,windwalker,24,13,11
22723,Monkeystar,archimonde,1240,monk,windwalker,18,13,5
22724,Shapzxd,archimonde,1240,monk,windwalker,24,13,11
22725,Брэгандерт,gordunni,1238,monk,windwalker,24,13,11
22726,Pandermann,antonidas,1238,monk,windwalker,30,16,14
22727,Fisty,lightbringer,1238,monk,windwalker,30,13,17
22728,Miyagisensei,ravencrest,1237,monk,windwalker,24,13,11
22729,Кирокко,gordunni,1235,monk,windwalker,30,20,10
22730,Чвка,booty-bay,1235,monk,windwalker,73,36,37
22731,Kouradoskylo,twisting-nether,1234,monk,windwalker,29,16,13
22732,Panzeerotto,nemesis,1234,monk,windwalker,60,26,34
22733,Meltfistqt,ravencrest,1234,monk,windwalker,30,13,17
22734,Blyatfast,draenor,1233,monk,windwalker,24,13,11
22735,Blumonk,argent-dawn,1233,monk,windwalker,140,69,71
22736,Lumpero,stormreaver,1232,monk,windwalker,24,16,8
22737,Bal,tyrande,1232,monk,windwalker,33,20,13
22738,Янасру,gordunni,1232,monk,windwalker,273,136,137
22739,Kegrøll,doomhammer,1231,monk,windwalker,42,21,21
22740,Gorskie,silvermoon,1230,monk,windwalker,27,13,14
22741,Merilwyn,argent-dawn,1229,monk,windwalker,22,14,8
22742,Phesxm,sylvanas,1229,monk,windwalker,23,13,10
22743,Hazmad,archimonde,1229,monk,windwalker,60,28,32
22744,Jesmander,kazzak,1224,monk,windwalker,30,16,14
22745,Лаодзы,deathguard,1220,monk,windwalker,36,13,23
22746,Bruzuh,outland,1215,monk,windwalker,31,15,16
22747,Vushao,blackmoore,1215,monk,windwalker,174,81,93
22748,Néroburnsred,eredar,1215,monk,windwalker,39,16,23
22749,Клепер,soulflayer,1213,monk,windwalker,24,14,10
22750,Kanõ,outland,1210,monk,windwalker,81,40,41
22751,Likethat,hyjal,1210,monk,windwalker,77,34,43
22752,Keskonriz,ysondre,1209,monk,windwalker,108,46,62
22753,Imvengeance,stormscale,1205,monk,windwalker,40,19,21
22754,Joaquuin,sylvanas,1204,monk,windwalker,54,27,27
22755,Билльбо,fordragon,1203,monk,windwalker,132,65,67
22756,Yøøps,dalaran,1191,monk,windwalker,71,33,38
22757,Smørc,the-maelstrom,1186,monk,windwalker,32,14,18
22758,Bogey,ragnaros,1182,monk,windwalker,26,13,13
22759,Vercya,dun-morogh,1173,monk,windwalker,43,22,21
22760,Trunks,turalyon,1164,monk,windwalker,42,20,22
22761,Брысьли,howling-fjord,1162,monk,windwalker,32,14,18
22762,Djstepmom,ravencrest,1152,monk,windwalker,12,12,0
22763,Bellarika,nemesis,1152,monk,windwalker,12,12,0
22764,Wajoba,blackhand,1152,monk,windwalker,18,12,6
22765,Monk,shattered-hand,1152,monk,windwalker,30,12,18
22766,Stronkman,frostwhisper,1151,monk,windwalker,30,20,10
22767,Kungfuhkyou,tarren-mill,1151,monk,windwalker,18,12,6
22768,Tðptier,drakthul,1151,monk,windwalker,18,12,6
22769,Çhina,twisting-nether,1151,monk,windwalker,24,12,12
22770,Bigfistah,tarren-mill,1150,monk,windwalker,24,12,12
22771,Coollann,drakthul,1150,monk,windwalker,30,12,18
22772,Elfisto,baelgun,1149,monk,windwalker,26,13,13
22773,Monk,dun-modr,1148,monk,windwalker,24,12,12
22774,Brorsantuck,frostmane,1147,monk,windwalker,18,12,6
22775,Траблы,howling-fjord,1147,monk,windwalker,24,12,12
22776,Sugura,dethecus,1146,monk,windwalker,24,12,12
22777,Yipmaan,kazzak,1146,monk,windwalker,24,12,12
22778,Гномкия,gordunni,1146,monk,windwalker,24,12,12
22779,Kagëra,ysondre,1145,monk,windwalker,24,12,12
22780,Silvrt,tarren-mill,1145,monk,windwalker,24,12,12
22781,Omoi,twisting-nether,1142,monk,windwalker,24,12,12
22782,Blickx,draenor,1141,monk,windwalker,28,13,15
22783,Mistbeever,ragnaros,1136,monk,windwalker,24,12,12
22784,Thichquang,sylvanas,1134,monk,windwalker,18,12,6
22785,Monkgol,stormscale,1129,monk,windwalker,24,12,12
22786,Халиосфа,gordunni,1129,monk,windwalker,30,12,18
22787,Azangar,kazzak,1114,monk,windwalker,22,12,10
22788,Djbuttholex,tarren-mill,1114,monk,windwalker,23,12,11
22789,Noodlesauce,silvermoon,1100,monk,windwalker,15,12,3
22790,Malarie,magtheridon,1096,monk,windwalker,110,58,52
22791,Chæli,tarren-mill,1094,monk,windwalker,23,12,11
22792,Непорядочная,gordunni,1094,monk,windwalker,42,17,25
22793,Ехерех,blackscar,1084,monk,windwalker,36,21,15
22794,Martial,arthas,1081,monk,windwalker,59,26,33
22795,Jayline,kazzak,1069,monk,windwalker,54,21,33
22796,Kusid,ragnaros,1066,monk,windwalker,21,12,9
22797,Daybaobao,the-maelstrom,1062,monk,windwalker,22,12,10
22798,Одиниз,gordunni,1059,monk,windwalker,54,34,20
22799,Monkiatsu,turalyon,1059,monk,windwalker,38,22,16
22800,Ørlandéa,archimonde,1057,monk,windwalker,35,20,15
22801,Hàtéppl,ravencrest,1056,monk,windwalker,18,11,7
22802,Astriz,outland,1056,monk,windwalker,18,11,7
22803,Зестус,galakrond,1056,monk,windwalker,24,11,13
22804,Dévíllíá,ragnaros,1056,monk,windwalker,24,11,13
22805,Monksea,ravencrest,1056,monk,windwalker,24,11,13
22806,Padawang,twisting-nether,1056,monk,windwalker,24,11,13
22807,Гкдшка,blackscar,1056,monk,windwalker,24,11,13
22808,Weezé,outland,1055,monk,windwalker,18,11,7
22809,Cirixx,outland,1055,monk,windwalker,18,11,7
22810,Tecisharmony,ravencrest,1055,monk,windwalker,18,11,7
22811,Runefists,twisting-nether,1055,monk,windwalker,18,11,7
22812,Mabkww,ravencrest,1055,monk,windwalker,18,11,7
22813,Turbofistsqt,kazzak,1054,monk,windwalker,18,11,7
22814,Melaz,ravencrest,1054,monk,windwalker,18,11,7
22815,Garlä,archimonde,1054,monk,windwalker,18,11,7
22816,Leolilu,ravencrest,1054,monk,windwalker,18,11,7
22817,Goldengem,silvermoon,1054,monk,windwalker,24,11,13
22818,Вэилэй,gordunni,1054,monk,windwalker,24,11,13
22819,Ñinjakick,outland,1054,monk,windwalker,30,11,19
22820,Futtefut,ravencrest,1054,monk,windwalker,30,11,19
22821,Tiaqa,aegwynn,1053,monk,windwalker,12,11,1
22822,Ноупэйн,soulflayer,1053,monk,windwalker,30,11,19
22823,Cleør,blackmoore,1052,monk,windwalker,18,11,7
22824,Degentz,alakir,1051,monk,windwalker,21,12,9
22825,Realiaze,tichondrius,1051,monk,windwalker,30,11,19
22826,Вамптолкер,howling-fjord,1049,monk,windwalker,18,11,7
22827,Dokuziq,twisting-nether,1046,monk,windwalker,28,12,16
22828,Нежненький,gordunni,1045,monk,windwalker,24,11,13
22829,Klapptoast,blackmoore,1036,monk,windwalker,24,11,13
22830,Napqi,malganis,1023,monk,windwalker,17,11,6
22831,Chlamydious,silvermoon,1019,monk,windwalker,60,24,36
22832,Roptoglad,hyjal,1017,monk,windwalker,29,11,18
22833,Secretmonk,ravencrest,1007,monk,windwalker,23,11,12
22834,Laggedfist,kazzak,1007,monk,windwalker,27,11,16
22835,Kebabvevaren,twisting-nether,1005,monk,windwalker,21,12,9
22836,Buggaa,dalaran,996,monk,windwalker,23,11,12
22837,Dionee,twisting-nether,992,monk,windwalker,27,14,13
22838,Marcianorock,archimonde,987,monk,windwalker,30,13,17
22839,Agress,sanguino,984,monk,windwalker,72,33,39
22840,Ekincheng,twisting-nether,964,monk,windwalker,30,15,15
22841,Pïpöu,archimonde,960,monk,windwalker,12,10,2
22842,Elfisto,eredar,960,monk,windwalker,12,10,2
22843,Wreckpuss,tarren-mill,960,monk,windwalker,18,10,8
22844,Senniñ,ravencrest,960,monk,windwalker,18,10,8
22845,Rìnox,blackmoore,960,monk,windwalker,18,10,8
22846,Martur,bronzebeard,960,monk,windwalker,18,10,8
22847,Ðävàizskó,ysondre,960,monk,windwalker,18,10,8
22848,Mcscrub,ragnaros,960,monk,windwalker,18,10,8
22849,Ilovefreddy,stormscale,960,monk,windwalker,18,10,8
22850,Plånck,archimonde,960,monk,windwalker,18,10,8
22851,Sqoobie,tarren-mill,960,monk,windwalker,18,10,8
22852,Волкейн,soulflayer,960,monk,windwalker,24,10,14
22853,Kåtsumi,sanguino,960,monk,windwalker,24,10,14
22854,Eggroll,archimonde,959,monk,windwalker,18,10,8
22855,Nycea,blackrock,959,monk,windwalker,18,10,8
22856,Såsha,sanguino,959,monk,windwalker,18,10,8
22857,Miridius,silvermoon,959,monk,windwalker,24,10,14
22858,Драконзмей,soulflayer,959,monk,windwalker,30,10,20
22859,Crewladal,arakarahm,959,monk,windwalker,30,10,20
22860,Lottelita,tarren-mill,958,monk,windwalker,18,10,8
22861,Купейчик,gordunni,958,monk,windwalker,24,10,14
22862,Symaro,aegwynn,958,monk,windwalker,24,10,14
22863,Sigath,emeriss,958,monk,windwalker,36,10,26
22864,Heffertonne,eredar,957,monk,windwalker,18,10,8
22865,Doreese,moonglade,955,monk,windwalker,18,10,8
22866,Duches,tarren-mill,955,monk,windwalker,24,10,14
22867,Runny,sanguino,930,monk,windwalker,36,10,26
22868,Sebbii,twisting-nether,927,monk,windwalker,23,10,13
22869,Chilleê,blackmoore,909,monk,windwalker,17,10,7
22870,Scedadle,outland,909,monk,windwalker,21,10,11
22871,Концептуалик,gordunni,896,monk,windwalker,21,11,10
22872,Gidmonk,darkspear,894,monk,windwalker,24,12,12
22873,Апесиинка,gordunni,874,monk,windwalker,23,11,12
22874,Broussly,voljin,871,monk,windwalker,36,15,21
22875,Pattafixcrin,blackrock,864,monk,windwalker,12,9,3
22876,Weaverman,ragnaros,864,monk,windwalker,18,9,9
22877,Brols,dalaran,864,monk,windwalker,18,9,9
22878,Zmile,ragnaros,864,monk,windwalker,18,9,9
22879,Øåæøæøåæ,ravencrest,864,monk,windwalker,18,9,9
22880,Gankplank,nemesis,864,monk,windwalker,18,9,9
22881,Notadrâgon,sylvanas,864,monk,windwalker,18,9,9
22882,Skriptzy,blackmoore,864,monk,windwalker,18,9,9
22883,Джобишоп,howling-fjord,864,monk,windwalker,18,9,9
22884,Snookzlol,aegwynn,864,monk,windwalker,18,9,9
22885,Lrizz,argent-dawn,864,monk,windwalker,18,9,9
22886,Alandriai,blackmoore,863,monk,windwalker,12,9,3
22887,Barneyzan,tarren-mill,863,monk,windwalker,18,9,9
22888,Otp,hyjal,863,monk,windwalker,18,9,9
22889,Wâgwân,hyjal,863,monk,windwalker,18,9,9
22890,Thawy,sargeras,863,monk,windwalker,24,9,15
22891,Gálaxyfist,blackhand,863,monk,windwalker,24,9,15
22892,Nouraxo,kazzak,862,monk,windwalker,18,9,9
22893,Sûûn,hyjal,862,monk,windwalker,18,9,9
22894,Mcsmack,argent-dawn,861,monk,windwalker,12,9,3
22895,Lin,nathrezim,861,monk,windwalker,18,9,9
22896,Teztouza,kazzak,861,monk,windwalker,18,9,9
22897,Linocence,draenor,860,monk,windwalker,95,47,48
22898,Franziskanus,das-syndikat,860,monk,windwalker,24,9,15
22899,Iluvatareru,twisting-nether,859,monk,windwalker,18,9,9
22900,Кримсон,blackscar,858,monk,windwalker,12,9,3
22901,Sinziana,silvermoon,858,monk,windwalker,12,9,3
22902,Tetetete,silvermoon,858,monk,windwalker,18,9,9
22903,Somonks,twisting-nether,857,monk,windwalker,18,9,9
22904,Zoyrac,malygos,856,monk,windwalker,18,9,9
22905,Meff,hyjal,855,monk,windwalker,16,10,6
22906,Patadademijo,tarren-mill,855,monk,windwalker,24,9,15
22907,Mozzaks,doomhammer,852,monk,windwalker,12,9,3
22908,Jgma,auchindoun,852,monk,windwalker,30,9,21
22909,Goltigald,archimonde,838,monk,windwalker,23,9,14
22910,Apprentice,ravencrest,815,monk,windwalker,17,9,8
22911,Yamo,blackrock,814,monk,windwalker,17,9,8
22912,Okilexsan,sanguino,797,monk,windwalker,11,9,2
22913,Karatiy,doomhammer,795,monk,windwalker,99,33,66
22914,Monkiki,hyjal,784,monk,windwalker,25,9,16
22915,Sultanofrizz,draenor,768,monk,windwalker,12,8,4
22916,Gøøgodx,tarren-mill,768,monk,windwalker,12,8,4
22917,Wladqz,stormscale,768,monk,windwalker,12,8,4
22918,Ðìør,kazzak,768,monk,windwalker,12,8,4
22919,Fistyfast,hyjal,768,monk,windwalker,12,8,4
22920,Gojò,outland,768,monk,windwalker,12,8,4
22921,Karels,archimonde,768,monk,windwalker,12,8,4
22922,Slayh,archimonde,768,monk,windwalker,12,8,4
22923,Cuteshygirl,shattrath,768,monk,windwalker,18,8,10
22924,Jamiedhism,ravencrest,768,monk,windwalker,18,8,10
22925,Stÿvww,archimonde,768,monk,windwalker,24,8,16
22926,Дыня,gordunni,767,monk,windwalker,12,8,4
22927,Sêssai,outland,767,monk,windwalker,12,8,4
22928,Daizz,magtheridon,767,monk,windwalker,12,8,4
22929,Nízra,archimonde,767,monk,windwalker,12,8,4
22930,Yungbaren,frostwolf,767,monk,windwalker,12,8,4
22931,Pimahz,aggra-português,767,monk,windwalker,12,8,4
22932,Earendil,culte-de-la-rive-noire,767,monk,windwalker,12,8,4
22933,Kaztruman,draenor,767,monk,windwalker,15,9,6
22934,Vyneth,draenor,767,monk,windwalker,20,10,10
22935,Johnsôn,blackmoore,767,monk,windwalker,18,8,10
22936,Lellaccio,pozzo-delleternità,767,monk,windwalker,18,8,10
22937,Kryzu,ragnaros,767,monk,windwalker,18,8,10
22938,Alurymnk,blackrock,767,monk,windwalker,18,8,10
22939,Bansheerrz,hyjal,767,monk,windwalker,18,8,10
22940,Plsnerfrogue,tarren-mill,766,monk,windwalker,12,8,4
22941,Wilywolxx,silvermoon,766,monk,windwalker,12,8,4
22942,Pocaa,arakarahm,766,monk,windwalker,18,8,10
22943,Verfa,twisting-nether,765,monk,windwalker,18,8,10
22944,Rollah,ravencrest,765,monk,windwalker,18,8,10
22945,Kaipo,ragnaros,765,monk,windwalker,24,8,16
22946,Chiroidz,kazzak,764,monk,windwalker,18,8,10
22947,Krâr,onyxia,763,monk,windwalker,18,8,10
22948,Rangomind,silvermoon,761,monk,windwalker,12,8,4
22949,Elayja,twisting-nether,717,monk,windwalker,17,8,9
22950,Zledriasa,ravencrest,703,monk,windwalker,20,8,12
22951,Fredder,blackrock,701,monk,windwalker,23,8,15
22952,Dmeenmonk,kazzak,672,monk,windwalker,12,7,5
22953,Vixiatwo,outland,672,monk,windwalker,12,7,5
22954,Dopi,frostmane,672,monk,windwalker,12,7,5
22955,Dennismansix,sylvanas,672,monk,windwalker,12,7,5
22956,Мандаирины,gordunni,672,monk,windwalker,12,7,5
22957,Chryan,marécage-de-zangar,672,monk,windwalker,12,7,5
22958,Bryggarn,draenor,672,monk,windwalker,12,7,5
22959,Sàlêxz,ysondre,672,monk,windwalker,12,7,5
22960,Chiscake,blackrock,672,monk,windwalker,12,7,5
22961,Despéradø,archimonde,672,monk,windwalker,12,7,5
22962,Arthanaar,drakthul,672,monk,windwalker,12,7,5
22963,Njursten,twilights-hammer,672,monk,windwalker,12,7,5
22964,Shoelaren,ragnaros,672,monk,windwalker,12,7,5
22965,Wrizz,area-52,672,monk,windwalker,12,7,5
22966,Balanceqt,ravencrest,672,monk,windwalker,12,7,5
22967,Cander,stormscale,672,monk,windwalker,12,7,5
22968,Potsymist,twisting-nether,672,monk,windwalker,12,7,5
22969,Kàrmà,aegwynn,672,monk,windwalker,12,7,5
22970,Tortasauro,sanguino,672,monk,windwalker,12,7,5
22971,Breezzmonka,twisting-nether,672,monk,windwalker,12,7,5
22972,Daltailr,silvermoon,672,monk,windwalker,12,7,5
22973,Chanzey,silvermoon,672,monk,windwalker,12,7,5
22974,Âdonis,twisting-nether,672,monk,windwalker,12,7,5
22975,Pawsy,twisting-nether,672,monk,windwalker,12,7,5
22976,Jiya,blackmoore,672,monk,windwalker,18,7,11
22977,Elababe,ravencrest,672,monk,windwalker,18,7,11
22978,Risingspud,frostmane,672,monk,windwalker,18,7,11
22979,Quï,hyjal,672,monk,windwalker,18,7,11
22980,Ráây,blackrock,672,monk,windwalker,18,7,11
22981,Keberathom,stormscale,672,monk,windwalker,18,7,11
22982,Джийви,goldrinn,672,monk,windwalker,18,7,11
22983,Winifspin,twisting-nether,672,monk,windwalker,18,7,11
22984,Bonkboi,tarren-mill,672,monk,windwalker,18,7,11
22985,Mayliene,stormscale,672,monk,windwalker,18,7,11
22986,Zymonks,silvermoon,672,monk,windwalker,18,7,11
22987,Jkmonkyo,blackrock,672,monk,windwalker,18,7,11
22988,Galexuz,blackrock,672,monk,windwalker,18,7,11
22989,Qtv,arthas,672,monk,windwalker,18,7,11
22990,Sungødx,blackrock,672,monk,windwalker,18,7,11
22991,Sonofelrond,twisting-nether,671,monk,windwalker,12,7,5
22992,Mystikmonk,blackrock,671,monk,windwalker,12,7,5
22993,Bierdame,blackhand,671,monk,windwalker,12,7,5
22994,Эзархадон,lich-king,671,monk,windwalker,12,7,5
22995,Dubhira,blackmoore,671,monk,windwalker,12,7,5
22996,Discosean,frostmane,671,monk,windwalker,18,7,11
22997,Arshy,silvermoon,671,monk,windwalker,18,7,11
22998,Velita,dun-modr,671,monk,windwalker,18,7,11
22999,Авентусс,howling-fjord,671,monk,windwalker,18,7,11
23000,Tysonwonka,thrall,670,monk,windwalker,12,7,5
23001,Zhiothe,argent-dawn,670,monk,windwalker,12,7,5
23002,Dummars,ragnaros,670,monk,windwalker,18,7,11
23003,Mwoinesamdi,hyjal,670,monk,windwalker,18,7,11
23004,Xamaan,sanguino,670,monk,windwalker,18,7,11
23005,Digô,malganis,669,monk,windwalker,12,7,5
23006,Kirara,talnivarr,668,monk,windwalker,12,7,5
23007,Рочч,gordunni,668,monk,windwalker,12,7,5
23008,Monktoon,doomhammer,668,monk,windwalker,18,7,11
23009,Bâmbêlvî,tyrande,667,monk,windwalker,15,7,8
23010,Brucilli,dalaran,666,monk,windwalker,12,7,5
23011,Undgrund,burning-legion,661,monk,windwalker,18,7,11
23012,Humpenpower,blackhand,655,monk,windwalker,17,7,10
23013,Fusetonww,tarren-mill,623,monk,windwalker,11,7,4
23014,Ahlu,argent-dawn,623,monk,windwalker,21,7,14
23015,Ktrina,ravencrest,618,monk,windwalker,21,9,12
23016,Pïpöu,kirin-tor,607,monk,windwalker,11,7,4
23017,Sori,mazrigos,592,monk,windwalker,19,7,12
23018,Koreangirlx,archimonde,576,monk,windwalker,6,6,0
23019,Rezuz,draenor,576,monk,windwalker,6,6,0
23020,Rigbone,kazzak,576,monk,windwalker,12,6,6
23021,Balance,laughing-skull,576,monk,windwalker,12,6,6
23022,Fistweavs,ravencrest,576,monk,windwalker,12,6,6
23023,Pabu,emeriss,576,monk,windwalker,12,6,6
23024,Shaokïng,exodar,576,monk,windwalker,12,6,6
23025,Luckyjones,tarren-mill,576,monk,windwalker,12,6,6
23026,Geezer,the-maelstrom,576,monk,windwalker,12,6,6
23027,Worasemonk,hyjal,576,monk,windwalker,12,6,6
23028,Gîø,blackmoore,576,monk,windwalker,12,6,6
23029,Whoszeus,archimonde,576,monk,windwalker,12,6,6
23030,Мэрджик,soulflayer,576,monk,windwalker,12,6,6
23031,Doyoubleed,twisting-nether,576,monk,windwalker,12,6,6
23032,Ogelele,twisting-nether,576,monk,windwalker,12,6,6
23033,Rainymonday,ravencrest,576,monk,windwalker,12,6,6
23034,Tenszangetsu,ragnaros,576,monk,windwalker,12,6,6
23035,Níko,korgall,576,monk,windwalker,12,6,6
23036,Jollyzug,blackrock,576,monk,windwalker,12,6,6
23037,Xàrslòulolz,kazzak,576,monk,windwalker,12,6,6
23038,Ferree,tarren-mill,576,monk,windwalker,12,6,6
23039,Nyrkkikylpy,ravencrest,576,monk,windwalker,12,6,6
23040,Yeol,ravencrest,576,monk,windwalker,12,6,6
23041,Муаннуар,soulflayer,576,monk,windwalker,12,6,6
23042,Rhâzalgûl,khaz-modan,576,monk,windwalker,12,6,6
23043,Ilovecravmag,draenor,576,monk,windwalker,12,6,6
23044,Jam,aerie-peak,576,monk,windwalker,12,6,6
23045,Naynayrb,draenor,576,monk,windwalker,12,6,6
23046,Lîlilîlîlîlí,stormscale,576,monk,windwalker,12,6,6
23047,Gramkin,ravencrest,576,monk,windwalker,12,6,6
23048,Fiddyy,outland,576,monk,windwalker,12,6,6
23049,Мишадуротар,borean-tundra,576,monk,windwalker,16,7,9
23050,Bbcmonkinc,aegwynn,576,monk,windwalker,16,7,9
23051,Fiststowin,blackrock,576,monk,windwalker,18,6,12
23052,Xoconut,ravencrest,576,monk,windwalker,18,6,12
23053,Desmî,ravencrest,576,monk,windwalker,18,6,12
23054,Norgamx,alakir,576,monk,windwalker,18,6,12
23055,Шоты,soulflayer,575,monk,windwalker,6,6,0
23056,Woknroll,draenor,575,monk,windwalker,12,6,6
23057,Raychi,draenor,575,monk,windwalker,12,6,6
23058,Teetoor,argent-dawn,575,monk,windwalker,12,6,6
23059,Woalter,silvermoon,575,monk,windwalker,12,6,6
23060,Okpm,marécage-de-zangar,575,monk,windwalker,12,6,6
23061,Mongole,hellscream,575,monk,windwalker,18,6,12
23062,Крэйзимедвед,howling-fjord,575,monk,windwalker,18,6,12
23063,Sixqtn,blackrock,575,monk,windwalker,18,6,12
23064,Jaylée,thrall,574,monk,windwalker,12,6,6
23065,Mönchdog,blackmoore,573,monk,windwalker,12,6,6
23066,Veila,the-maelstrom,573,monk,windwalker,12,6,6
23067,Izabell,bronzebeard,573,monk,windwalker,18,6,12
23068,Mullan,eonar,573,monk,windwalker,24,6,18
23069,Монкуем,gordunni,567,monk,windwalker,12,6,6
23070,Жарптыца,gordunni,559,monk,windwalker,17,6,11
23071,Dianly,ravencrest,543,monk,windwalker,23,6,17
23072,Merjis,stormscale,527,monk,windwalker,11,6,5
23073,Armutschkerl,blackhand,522,monk,windwalker,23,8,15
23074,Everydayrain,ravencrest,511,monk,windwalker,14,6,8
23075,Eaghor,draenor,510,monk,windwalker,10,6,4
23076,Жекадобряк,howling-fjord,503,monk,windwalker,15,7,8
23077,Boxarnsgrabb,shattered-hand,480,monk,windwalker,6,5,1
23078,Монкигодх,howling-fjord,480,monk,windwalker,6,5,1
23079,Энвишь,soulflayer,480,monk,windwalker,6,5,1
23080,Ameri,burning-steppes,480,monk,windwalker,6,5,1
23081,Killabees,stormscale,480,monk,windwalker,6,5,1
23082,Kapud,twisting-nether,480,monk,windwalker,6,5,1
23083,Wheelchairqt,stormscale,480,monk,windwalker,6,5,1
23084,Prototypx,blackmoore,480,monk,windwalker,6,5,1
23085,Nastyvibes,dun-modr,480,monk,windwalker,6,5,1
23086,Larsowns,ragnaros,480,monk,windwalker,6,5,1
23087,Emptyeyés,kazzak,480,monk,windwalker,6,5,1
23088,Loordcraft,silvermoon,480,monk,windwalker,6,5,1
23089,Threevthree,kazzak,480,monk,windwalker,6,5,1
23090,Расселкроу,galakrond,480,monk,windwalker,12,5,7
23091,Aljabbar,ravencrest,480,monk,windwalker,12,5,7
23092,Kenjibsen,blackhand,480,monk,windwalker,12,5,7
23093,Áutumnfalls,stormscale,480,monk,windwalker,12,5,7
23094,Badcøwboy,archimonde,480,monk,windwalker,12,5,7
23095,Archnun,stormscale,480,monk,windwalker,12,5,7
23096,Enrookiejr,aegwynn,480,monk,windwalker,12,5,7
23097,Qdwdwqerdads,ravencrest,480,monk,windwalker,12,5,7
23098,Dertekk,archimonde,480,monk,windwalker,12,5,7
23099,Mickjabber,aegwynn,480,monk,windwalker,12,5,7
23100,Çùçé,dalaran,480,monk,windwalker,12,5,7
23101,Udon,argent-dawn,480,monk,windwalker,12,5,7
23102,Nevertouch,blackrock,480,monk,windwalker,12,5,7
23103,Babyfax,draenor,480,monk,windwalker,12,5,7
23104,Investing,silvermoon,480,monk,windwalker,12,5,7
23105,Bimberta,argent-dawn,480,monk,windwalker,12,5,7
23106,Pîna,onyxia,480,monk,windwalker,12,5,7
23107,Onlypressw,tarren-mill,480,monk,windwalker,12,5,7
23108,Øåæøæøåæ,kazzak,480,monk,windwalker,12,5,7
23109,Kaelwind,burning-legion,480,monk,windwalker,12,5,7
23110,Käsefäuste,azshara,480,monk,windwalker,12,5,7
23111,Fistus,dentarg,480,monk,windwalker,12,5,7
23112,Màrlux,kazzak,480,monk,windwalker,12,5,7
23113,Nerd,argent-dawn,480,monk,windwalker,12,5,7
23114,Grintilif,malygos,480,monk,windwalker,12,5,7
23115,Yaxleyx,dragonblight,480,monk,windwalker,12,5,7
23116,Béarly,outland,480,monk,windwalker,12,5,7
23117,Npkwalker,outland,480,monk,windwalker,12,5,7
23118,Diagmonk,kazzak,480,monk,windwalker,12,5,7
23119,Tonikor,kazzak,480,monk,windwalker,12,5,7
23120,Кунфумастер,gordunni,480,monk,windwalker,12,5,7
23121,Krazylegs,sanguino,480,monk,windwalker,12,5,7
23122,Joshxao,blackmoore,480,monk,windwalker,12,5,7
23123,Charlett,the-venture-co,480,monk,windwalker,12,5,7
23124,Betelgeuse,jaedenar,480,monk,windwalker,12,5,7
23125,Мяуки,soulflayer,480,monk,windwalker,12,5,7
23126,Plingpong,sylvanas,480,monk,windwalker,12,5,7
23127,Drfistalot,blackrock,480,monk,windwalker,12,5,7
23128,Nicetrybuddy,draenor,480,monk,windwalker,18,5,13
23129,Draxaxa,hyjal,480,monk,windwalker,18,5,13
23130,Немонахх,howling-fjord,480,monk,windwalker,18,5,13
23131,Диксэш,ashenvale,479,monk,windwalker,12,5,7
23132,Askarg,khaz-modan,479,monk,windwalker,12,5,7
23133,Alopécida,voljin,479,monk,windwalker,15,6,9
23134,Øñ,cthun,479,monk,windwalker,18,5,13
23135,Effeots,blackrock,479,monk,windwalker,18,5,13
23136,Tjukkas,bloodhoof,479,monk,windwalker,24,5,19
23137,Nichonne,khaz-modan,478,monk,windwalker,12,5,7
23138,Blackdu,drakthul,477,monk,windwalker,16,6,10
23139,Sadwhi,turalyon,472,monk,windwalker,12,5,7
23140,Lqp,outland,447,monk,windwalker,11,5,6
23141,Wodniuch,defias-brotherhood,447,monk,windwalker,11,5,6
23142,Iamzra,kazzak,431,monk,windwalker,17,5,12
23143,Dushimonk,runetotem,416,monk,windwalker,10,5,5
23144,Twdabuser,tarren-mill,415,monk,windwalker,8,5,3
23145,Камагами,howling-fjord,400,monk,windwalker,7,5,2
23146,Theoalt,dragonblight,399,monk,windwalker,5,5,0
23147,Larrý,sylvanas,384,monk,windwalker,6,4,2
23148,Toúch,blackmoore,384,monk,windwalker,6,4,2
23149,Møønkëy,archimonde,384,monk,windwalker,6,4,2
23150,Vjelan,forscherliga,384,monk,windwalker,6,4,2
23151,Windstormcro,ragnaros,384,monk,windwalker,6,4,2
23152,Baisi,blackhand,384,monk,windwalker,6,4,2
23153,Rugys,ravenholdt,384,monk,windwalker,6,4,2
23154,Willempie,stormreaver,384,monk,windwalker,6,4,2
23155,Màlydôr,outland,384,monk,windwalker,6,4,2
23156,Soulspar,ragnaros,384,monk,windwalker,6,4,2
23157,Venersere,eitrigg,384,monk,windwalker,6,4,2
23158,Пашаскороход,gordunni,384,monk,windwalker,6,4,2
23159,Styxmk,blackhand,384,monk,windwalker,6,4,2
23160,Емопацан,gordunni,384,monk,windwalker,6,4,2
23161,Zéroneufsizz,silvermoon,384,monk,windwalker,6,4,2
23162,Wushin,antonidas,384,monk,windwalker,6,4,2
23163,Orênda,silvermoon,384,monk,windwalker,6,4,2
23164,Ilcooljay,ravencrest,384,monk,windwalker,6,4,2
23165,Sprizzfuaz,blackmoore,384,monk,windwalker,6,4,2
23166,Silcet,stormscale,384,monk,windwalker,6,4,2
23167,Blazeuu,drakthul,384,monk,windwalker,6,4,2
23168,Diagmonk,arathi,384,monk,windwalker,6,4,2
23169,Stormsong,arthas,384,monk,windwalker,6,4,2
23170,Orenichi,antonidas,384,monk,windwalker,6,4,2
23171,Alâkhai,nerzhul,384,monk,windwalker,6,4,2
23172,Pandaria,bronze-dragonflight,384,monk,windwalker,6,4,2
23173,Sepi,hellfire,384,monk,windwalker,6,4,2
23174,Palarîns,dalaran,384,monk,windwalker,6,4,2
23175,Piednuques,archimonde,384,monk,windwalker,6,4,2
23176,Jériícho,khaz-modan,384,monk,windwalker,6,4,2
23177,Ubap,emeriss,384,monk,windwalker,6,4,2
23178,Hertel,boulderfist,384,monk,windwalker,6,4,2
23179,Karatemonk,stormscale,384,monk,windwalker,6,4,2
23180,Monkflexi,draenor,384,monk,windwalker,6,4,2
23181,Nicomonk,ravencrest,384,monk,windwalker,6,4,2
23182,Àyoörts,archimonde,384,monk,windwalker,6,4,2
23183,Милосердие,eversong,384,monk,windwalker,6,4,2
23184,Jakkeez,twisting-nether,384,monk,windwalker,6,4,2
23185,Elahn,outland,384,monk,windwalker,6,4,2
23186,Disciprín,tarren-mill,384,monk,windwalker,6,4,2
23187,Onn,outland,384,monk,windwalker,6,4,2
23188,Windvibes,antonidas,384,monk,windwalker,6,4,2
23189,Tàlo,anachronos,384,monk,windwalker,6,4,2
23190,Dadrael,argent-dawn,384,monk,windwalker,6,4,2
23191,Twinkletoe,twisting-nether,384,monk,windwalker,6,4,2
23192,Jetcee,kazzak,384,monk,windwalker,6,4,2
23193,Seyley,tarren-mill,384,monk,windwalker,6,4,2
23194,Vetocorleone,kazzak,384,monk,windwalker,6,4,2
23195,Rulliya,kazzak,384,monk,windwalker,6,4,2
23196,Karrin,ghostlands,384,monk,windwalker,6,4,2
23197,Clìtfister,silvermoon,384,monk,windwalker,6,4,2
23198,Wingwalker,twisting-nether,384,monk,windwalker,6,4,2
23199,Andrah,blackmoore,384,monk,windwalker,12,4,8
23200,Räyh,outland,384,monk,windwalker,12,4,8
23201,Fueradeserie,dun-modr,384,monk,windwalker,12,4,8
23202,Blutáar,khazgoroth,384,monk,windwalker,12,4,8
23203,Ketrie,argent-dawn,384,monk,windwalker,12,4,8
23204,Showmeskillz,blackmoore,384,monk,windwalker,12,4,8
23205,Hoøo,hyjal,384,monk,windwalker,12,4,8
23206,Ожиганов,soulflayer,384,monk,windwalker,12,4,8
23207,Rhift,draenor,384,monk,windwalker,12,4,8
23208,Ragobd,argent-dawn,384,monk,windwalker,12,4,8
23209,Deathmøøn,tyrande,384,monk,windwalker,12,4,8
23210,Fishweaver,ravencrest,384,monk,windwalker,12,4,8
23211,Kunjo,earthen-ring,384,monk,windwalker,12,4,8
23212,Kushvendorx,silvermoon,384,monk,windwalker,12,4,8
23213,Scribzz,twisting-nether,384,monk,windwalker,12,4,8
23214,Løkî,culte-de-la-rive-noire,384,monk,windwalker,12,4,8
23215,Jessie,bloodscalp,384,monk,windwalker,12,4,8
23216,Ledoz,ravencrest,384,monk,windwalker,12,4,8
23217,Аоепуп,soulflayer,384,monk,windwalker,12,4,8
23218,Axan,drekthar,384,monk,windwalker,12,4,8
23219,Bluum,ravencrest,384,monk,windwalker,12,4,8
23220,Dëvilliä,ragnaros,384,monk,windwalker,12,4,8
23221,Гарчи,azuregos,384,monk,windwalker,12,4,8
23222,Байтли,gordunni,384,monk,windwalker,12,4,8
23223,Bigkim,khadgar,384,monk,windwalker,12,4,8
23224,Кириешек,deathguard,384,monk,windwalker,12,4,8
23225,Aesthetìc,draenor,384,monk,windwalker,12,4,8
23226,Goremancey,draenor,384,monk,windwalker,12,4,8
23227,Azia,bronzebeard,384,monk,windwalker,12,4,8
23228,Bbinzu,lothar,383,monk,windwalker,6,4,2
23229,Yuchiiro,hyjal,383,monk,windwalker,6,4,2
23230,Югэн,azuregos,383,monk,windwalker,12,4,8
23231,Youngmonk,tarren-mill,351,monk,windwalker,23,4,19
23232,Benkkei,ysondre,336,monk,windwalker,15,4,11
23233,Shamarinator,kazzak,330,monk,windwalker,15,5,10
23234,Jujujitsu,archimonde,330,monk,windwalker,17,4,13
23235,Choje,blackmoore,319,monk,windwalker,5,4,1
23236,Alë,argent-dawn,319,monk,windwalker,8,4,4
23237,Shàllýn,antonidas,304,monk,windwalker,13,4,9
23238,Marcjess,kazzak,288,monk,windwalker,6,3,3
23239,Klotsobunidi,kazzak,288,monk,windwalker,6,3,3
23240,Homelanderxx,tarren-mill,288,monk,windwalker,6,3,3
23241,Bobblasfists,tarren-mill,288,monk,windwalker,6,3,3
23242,Aaronm,tarren-mill,288,monk,windwalker,6,3,3
23243,Exòar,ravencrest,288,monk,windwalker,6,3,3
23244,Jweise,tarren-mill,288,monk,windwalker,6,3,3
23245,Wowweaver,outland,288,monk,windwalker,6,3,3
23246,Jogiemonk,ravencrest,288,monk,windwalker,6,3,3
23247,Billyebbasta,nemesis,288,monk,windwalker,6,3,3
23248,Ratfacè,outland,288,monk,windwalker,6,3,3
23249,Fapmaster,aegwynn,288,monk,windwalker,6,3,3
23250,Møngøwéávé,argent-dawn,288,monk,windwalker,6,3,3
23251,Testibuul,archimonde,288,monk,windwalker,6,3,3
23252,Zunixxww,terrordar,288,monk,windwalker,6,3,3
23253,Ybnobama,outland,288,monk,windwalker,6,3,3
23254,Zìnko,eredar,288,monk,windwalker,6,3,3
23255,Räpeltäjä,stormreaver,288,monk,windwalker,6,3,3
23256,Tshajek,hyjal,288,monk,windwalker,6,3,3
23257,Shaol,stormreaver,288,monk,windwalker,6,3,3
23258,Serizawã,hyjal,288,monk,windwalker,6,3,3
23259,Mushush,draenor,288,monk,windwalker,6,3,3
23260,Vultzm,draenor,288,monk,windwalker,6,3,3
23261,Droozy,silvermoon,288,monk,windwalker,6,3,3
23262,Jakfuki,ragnaros,288,monk,windwalker,6,3,3
23263,Пингкин,deathweaver,288,monk,windwalker,6,3,3
23264,Realfighter,arathor,288,monk,windwalker,6,3,3
23265,Månkey,ahnqiraj,288,monk,windwalker,6,3,3
23266,Iluvfistinjk,sylvanas,288,monk,windwalker,6,3,3
23267,Ðoom,sylvanas,288,monk,windwalker,6,3,3
23268,Adewelee,dalaran,288,monk,windwalker,6,3,3
23269,Zéná,gilneas,288,monk,windwalker,6,3,3
23270,Monkacek,drakthul,288,monk,windwalker,6,3,3
23271,Бреэйн,howling-fjord,288,monk,windwalker,6,3,3
23272,Дзинкс,howling-fjord,288,monk,windwalker,6,3,3
23273,Válkyrìe,ravencrest,288,monk,windwalker,6,3,3
23274,Zelraqt,burning-steppes,288,monk,windwalker,6,3,3
23275,Blyadislav,ravencrest,288,monk,windwalker,6,3,3
23276,Koot,ragnaros,288,monk,windwalker,6,3,3
23277,Рендикаое,soulflayer,288,monk,windwalker,6,3,3
23278,Sizok,blackmoore,288,monk,windwalker,6,3,3
23279,Астрал,soulflayer,288,monk,windwalker,6,3,3
23280,Rma,twisting-nether,288,monk,windwalker,6,3,3
23281,Lokregar,blackmoore,288,monk,windwalker,6,3,3
23282,Tjmnk,ravencrest,288,monk,windwalker,6,3,3
23283,Velduin,dun-modr,288,monk,windwalker,6,3,3
23284,Xpobak,ravencrest,288,monk,windwalker,6,3,3
23285,Междунамиад,gordunni,288,monk,windwalker,6,3,3
23286,Dasjinso,blackhand,288,monk,windwalker,6,3,3
23287,Migg,burning-legion,288,monk,windwalker,6,3,3
23288,Stonkss,ragnaros,288,monk,windwalker,6,3,3
23289,Kungf,twisting-nether,288,monk,windwalker,6,3,3
23290,Monkelibonk,ravencrest,288,monk,windwalker,6,3,3
23291,Atrøciøus,ravencrest,288,monk,windwalker,6,3,3
23292,Xen,uldum,288,monk,windwalker,6,3,3
23293,Nüffelbüffel,blackrock,288,monk,windwalker,6,3,3
23294,Tossen,ragnaros,288,monk,windwalker,6,3,3
23295,Arisua,blackhand,288,monk,windwalker,6,3,3
23296,Hästgodx,the-maelstrom,288,monk,windwalker,6,3,3
23297,Chakkal,twisting-nether,288,monk,windwalker,6,3,3
23298,Bg,blackhand,288,monk,windwalker,6,3,3
23299,Бичмэн,deathguard,288,monk,windwalker,6,3,3
23300,Street,nethersturm,288,monk,windwalker,7,3,4
23301,Balkanbeastt,draenor,288,monk,windwalker,10,4,6
23302,Clamps,darkspear,288,monk,windwalker,12,3,9
23303,Ikasama,culte-de-la-rive-noire,288,monk,windwalker,12,3,9
23304,Mönchfatih,blackhand,288,monk,windwalker,12,3,9
23305,Geliôs,kazzak,288,monk,windwalker,12,3,9
23306,Barylen,outland,288,monk,windwalker,12,3,9
23307,Roxmonk,ravencrest,288,monk,windwalker,12,3,9
23308,Howkong,archimonde,288,monk,windwalker,12,3,9
23309,Cøbrakaï,archimonde,288,monk,windwalker,12,3,9
23310,Ayyee,blackmoore,288,monk,windwalker,18,3,15
23311,Мистерхюй,gordunni,288,monk,windwalker,18,3,15
23312,Lewimoäne,khaz-modan,287,monk,windwalker,6,3,3
23313,Baazoka,blackmoore,287,monk,windwalker,6,3,3
23314,Михот,eversong,287,monk,windwalker,6,3,3
23315,Wallky,burning-blade,287,monk,windwalker,18,3,15
23316,Соловьюх,gordunni,286,monk,windwalker,12,3,9
23317,Syaóran,exodar,286,monk,windwalker,12,3,9
23318,Touchgodx,blackrock,256,monk,windwalker,8,4,4
23319,Пкмлкм,gordunni,255,monk,windwalker,11,3,8
23320,Dolkenm,tarren-mill,240,monk,windwalker,9,4,5
23321,Yamqt,thrall,240,monk,windwalker,9,3,6
23322,Zerno,archimonde,239,monk,windwalker,5,3,2
23323,Kungfupandy,blackmoore,224,monk,windwalker,10,3,7
23324,Trolleurz,archimonde,224,monk,windwalker,16,3,13
23325,Idointcare,ravencrest,192,monk,windwalker,4,3,1
23326,Bignessb,draenor,192,monk,windwalker,4,3,1
23327,Wickly,stormscale,192,monk,windwalker,10,4,6
23328,Kano,burning-legion,192,monk,windwalker,9,3,6
23329,Geochi,tarren-mill,192,monk,windwalker,6,2,4
23330,Lildaddymonk,ravencrest,192,monk,windwalker,6,2,4
23331,Loorda,neptulon,192,monk,windwalker,6,2,4
23332,Keisy,kazzak,192,monk,windwalker,6,2,4
23333,Tayoo,aegwynn,192,monk,windwalker,6,2,4
23334,Loriodas,tarren-mill,192,monk,windwalker,6,2,4
23335,Bensil,ravencrest,192,monk,windwalker,6,2,4
23336,Márliene,twisting-nether,192,monk,windwalker,6,2,4
23337,Youruba,dun-modr,192,monk,windwalker,6,2,4
23338,Fístfillet,twisting-nether,192,monk,windwalker,6,2,4
23339,Emå,nemesis,192,monk,windwalker,6,2,4
23340,Karateboy,dun-modr,192,monk,windwalker,6,2,4
23341,Melombus,dun-modr,192,monk,windwalker,6,2,4
23342,Bamboosnack,kazzak,192,monk,windwalker,6,2,4
23343,Stenhård,azjolnerub,192,monk,windwalker,6,2,4
23344,Psyhooz,burning-legion,192,monk,windwalker,6,2,4
23345,Bloodychi,ravencrest,192,monk,windwalker,6,2,4
23346,Дедизшишки,soulflayer,192,monk,windwalker,6,2,4
23347,Lollonko,kazzak,192,monk,windwalker,6,2,4
23348,Mtmonk,tarren-mill,192,monk,windwalker,6,2,4
23349,Monkkr,argent-dawn,192,monk,windwalker,6,2,4
23350,Såliten,tarren-mill,192,monk,windwalker,6,2,4
23351,Panicfist,stormscale,192,monk,windwalker,6,2,4
23352,Icaena,ravencrest,192,monk,windwalker,6,2,4
23353,Tyrastel,dalaran,192,monk,windwalker,6,2,4
23354,Nebelpanda,ravencrest,192,monk,windwalker,6,2,4
23355,Mychigun,ravencrest,192,monk,windwalker,6,2,4
23356,Yaevinn,burning-legion,192,monk,windwalker,6,2,4
23357,Shyriu,kazzak,192,monk,windwalker,6,2,4
23358,Fistingfury,burning-blade,192,monk,windwalker,6,2,4
23359,Brewroll,ravencrest,192,monk,windwalker,6,2,4
23360,Îreful,tarren-mill,192,monk,windwalker,6,2,4
23361,Akkadianx,ravencrest,192,monk,windwalker,6,2,4
23362,Friidam,lightbringer,192,monk,windwalker,6,2,4
23363,Deathpùlse,ravencrest,192,monk,windwalker,6,2,4
23364,Popox,stormreaver,192,monk,windwalker,6,2,4
23365,Påiñ,silvermoon,192,monk,windwalker,6,2,4
23366,Bludclart,outland,192,monk,windwalker,6,2,4
23367,Pawpipe,ravencrest,192,monk,windwalker,6,2,4
23368,Shïma,sargeras,192,monk,windwalker,6,2,4
23369,Panzerfall,hyjal,192,monk,windwalker,6,2,4
23370,Walterwayne,blackrock,192,monk,windwalker,6,2,4
23371,Joachi,outland,192,monk,windwalker,6,2,4
23372,Khirazim,ysondre,192,monk,windwalker,6,2,4
23373,Karradine,khaz-modan,192,monk,windwalker,6,2,4
23374,Bobthewild,draenor,192,monk,windwalker,6,2,4
23375,Glorïagaynor,archimonde,192,monk,windwalker,6,2,4
23376,Musclorww,ysondre,192,monk,windwalker,6,2,4
23377,Mezeko,stormscale,192,monk,windwalker,6,2,4
23378,Rationis,blackmoore,192,monk,windwalker,6,2,4
23379,Madinsane,thrall,192,monk,windwalker,6,2,4
23380,Frajer,auchindoun,192,monk,windwalker,6,2,4
23381,Adis,nerathor,192,monk,windwalker,6,2,4
23382,Псилоцибин,gordunni,192,monk,windwalker,6,2,4
23383,Wahrye,hyjal,192,monk,windwalker,6,2,4
23384,Пекник,gordunni,192,monk,windwalker,6,2,4
23385,Lxq,blackhand,192,monk,windwalker,6,2,4
23386,Eynodiggity,blackmoore,192,monk,windwalker,6,2,4
23387,Qtk,arthas,192,monk,windwalker,6,2,4
23388,Miamausebär,blackmoore,192,monk,windwalker,6,2,4
23389,Беглыйлаваш,gordunni,192,monk,windwalker,6,2,4
23390,Latify,todeswache,192,monk,windwalker,6,2,4
23391,Lilßaby,archimonde,192,monk,windwalker,6,2,4
23392,Нагиботар,thermaplugg,192,monk,windwalker,6,2,4
23393,Akazuki,frostwolf,192,monk,windwalker,6,2,4
23394,Brevduwan,ragnaros,192,monk,windwalker,6,2,4
23395,Priosia,ragnaros,192,monk,windwalker,6,2,4
23396,Gabbah,blackrock,192,monk,windwalker,6,2,4
23397,Niborc,doomhammer,192,monk,windwalker,6,2,4
23398,Jackonk,eredar,192,monk,windwalker,6,2,4
23399,Zýru,ragnaros,192,monk,windwalker,6,2,4
23400,Dodoglad,hyjal,192,monk,windwalker,6,2,4
23401,Манамба,blackscar,192,monk,windwalker,6,2,4
23402,Schneewase,blackrock,192,monk,windwalker,6,2,4
23403,Drýton,blackrock,192,monk,windwalker,6,2,4
23404,Orcword,ragnaros,192,monk,windwalker,6,2,4
23405,Майамибитч,howling-fjord,192,monk,windwalker,6,2,4
23406,Savecdfornxt,blackmoore,192,monk,windwalker,6,2,4
23407,Píkachuu,ragnaros,192,monk,windwalker,9,2,7
23408,Tongat,ravencrest,192,monk,windwalker,12,2,10
23409,Гнидожор,booty-bay,192,monk,windwalker,12,2,10
23410,Shaow,hyjal,192,monk,windwalker,12,2,10
23411,Lilotus,ragnaros,192,monk,windwalker,12,2,10
23412,Yianjih,blackmoore,191,monk,windwalker,6,2,4
23413,Mashalar,ravencrest,191,monk,windwalker,6,2,4
23414,Crokmoche,archimonde,143,monk,windwalker,3,3,0
23415,Marqinio,archimonde,138,monk,windwalker,9,4,5
23416,Yanmonk,silvermoon,138,monk,windwalker,8,3,5
23417,Astmönk,archimonde,127,monk,windwalker,8,2,6
23418,Uftis,thrall,127,monk,windwalker,8,2,6
23419,Butrinto,hellfire,96,monk,windwalker,6,1,5
23420,Jongoatjones,outland,96,monk,windwalker,6,1,5
23421,Gøsù,antonidas,96,monk,windwalker,6,1,5
23422,Umbrâsyl,ravencrest,96,monk,windwalker,6,1,5
23423,Dìó,tarren-mill,96,monk,windwalker,6,1,5
23424,Mjaweaver,stormscale,96,monk,windwalker,6,1,5
23425,Kazéshini,doomhammer,96,monk,windwalker,6,1,5
23426,Smâsh,blackhand,96,monk,windwalker,6,1,5
23427,Родиер,gordunni,96,monk,windwalker,6,1,5
23428,Kickboxer,burning-legion,96,monk,windwalker,6,1,5
23429,Мяяумяу,gordunni,96,monk,windwalker,6,1,5
23430,Kinføu,hyjal,96,monk,windwalker,6,1,5
23431,Cumspiller,ravencrest,96,monk,windwalker,6,1,5
23432,Sînge,archimonde,96,monk,windwalker,6,1,5
23433,Fistyouslow,kazzak,96,monk,windwalker,6,1,5
23434,Dudulinda,silvermoon,96,monk,windwalker,6,1,5
23435,Harislkwamk,aegwynn,96,monk,windwalker,6,1,5
23436,Musaya,chamber-of-aspects,96,monk,windwalker,6,1,5
23437,Jakaron,kazzak,96,monk,windwalker,6,1,5
23438,Синнэрли,soulflayer,96,monk,windwalker,6,1,5
23439,Chucknøørys,archimonde,96,monk,windwalker,6,1,5
23440,Konnîchîwa,kazzak,96,monk,windwalker,6,1,5
23441,Doneithné,stormscale,96,monk,windwalker,6,1,5
23442,Тиронфлакс,soulflayer,96,monk,windwalker,6,1,5
23443,Gilario,silvermoon,96,monk,windwalker,6,1,5
23444,Olgachocolat,blackmoore,96,monk,windwalker,6,1,5
23445,Zugzuwg,ahnqiraj,96,monk,windwalker,6,1,5
23446,Lîlpumpx,outland,96,monk,windwalker,6,1,5
23447,Salderlol,stormscale,96,monk,windwalker,6,1,5
23448,Mìcrøb,blackmoore,96,monk,windwalker,6,1,5
23449,Dadeldo,blackrock,96,monk,windwalker,6,1,5
23450,Olympeá,silvermoon,96,monk,windwalker,6,1,5
23451,Yvètte,ravencrest,96,monk,windwalker,6,1,5
23452,Tooweezé,outland,96,monk,windwalker,6,1,5
23453,Kaizenthor,runetotem,96,monk,windwalker,6,1,5
23454,Masbrew,ravencrest,96,monk,windwalker,6,1,5
23455,Monkenya,kazzak,96,monk,windwalker,6,1,5
23456,Бумчака,blackscar,96,monk,windwalker,6,1,5
23457,Drlightorc,tarren-mill,96,monk,windwalker,6,1,5
23458,Draina,archimonde,96,monk,windwalker,6,1,5
23459,Nightninja,drakthul,96,monk,windwalker,6,1,5
23460,Yunxi,stormreaver,96,monk,windwalker,6,1,5
23461,Bâsarä,archimonde,96,monk,windwalker,6,1,5
23462,Onisakebi,nemesis,96,monk,windwalker,10,1,9
23463,Chifù,silvermoon,96,monk,windwalker,10,1,9
23464,Deuxmonk,outland,96,monk,windwalker,12,1,11
23465,Araey,argent-dawn,89,monk,windwalker,9,3,6
23466,Xtcc,kazzak,79,monk,windwalker,5,1,4
23467,Odanobunaga,ravencrest,79,monk,windwalker,5,1,4
23468,Tenzen,dun-modr,79,monk,windwalker,11,1,10
23469,Kûma,echsenkessel,64,monk,windwalker,4,1,3
23470,Xámell,ravencrest,48,monk,windwalker,3,1,2
23471,Monkinko,tarren-mill,42,monk,windwalker,10,2,8
23472,Pjetro,draenor,31,monk,windwalker,2,1,1
23473,Makïi,archimonde,31,monk,windwalker,2,1,1
23474,Åbx,argent-dawn,2191,paladin,holy,113,59,54
23475,Wiriday,draenor,2139,paladin,holy,353,183,170
23476,Crewxdlolz,frostmane,2123,paladin,holy,211,118,93
23477,Likkik,ravencrest,2121,paladin,holy,86,42,44
23478,Royki,the-maelstrom,2111,paladin,holy,70,38,32
23479,Алексендлер,howling-fjord,2061,paladin,holy,356,194,162
23480,Ranchiek,ravencrest,2019,paladin,holy,60,31,29
23481,Lickssi,outland,2001,paladin,holy,94,56,38
23482,Nemesisbot,dun-modr,1965,paladin,holy,102,59,43
23483,Zabrok,outland,1964,paladin,holy,70,42,28
23484,Måvé,tarren-mill,1945,paladin,holy,108,63,45
23485,Goyimslayer,ravencrest,1939,paladin,holy,120,64,56
23486,Rekieuna,archimonde,1937,paladin,holy,402,213,189
23487,Jìmjim,ysondre,1916,paladin,holy,114,53,61
23488,Peacerainer,stormscale,1915,paladin,holy,72,32,40
23489,Rïzé,ravencrest,1911,paladin,holy,54,26,28
23490,Odrareg,kazzak,1899,paladin,holy,83,37,46
23491,Seabrook,stormscale,1895,paladin,holy,111,49,62
23492,Galaxys,blackhand,1887,paladin,holy,145,74,71
23493,Aww,anachronos,1874,paladin,holy,150,77,73
23494,Kyoma,burning-legion,1869,paladin,holy,149,70,79
23495,Pointguard,blackrock,1862,paladin,holy,54,28,26
23496,Tipmax,ravencrest,1856,paladin,holy,61,37,24
23497,Goodpeace,kazzak,1855,paladin,holy,73,35,38
23498,Niwariel,silvermoon,1852,paladin,holy,60,37,23
23499,Типмакс,howling-fjord,1851,paladin,holy,42,25,17
23500,Áftershøck,ravencrest,1850,paladin,holy,60,32,28
23501,Powertilt,ravencrest,1848,paladin,holy,159,77,82
23502,Гигашмяк,howling-fjord,1845,paladin,holy,251,135,116
23503,Wheelybin,argent-dawn,1843,paladin,holy,53,23,30
23504,Optîmuslîme,veklor,1835,paladin,holy,42,27,15
23505,Insanez,stormscale,1834,paladin,holy,48,25,23
23506,Shufflenjoyr,argent-dawn,1824,paladin,holy,125,64,61
23507,Phalphlingo,stormscale,1824,paladin,holy,84,40,44
23508,Wokyo,tarren-mill,1823,paladin,holy,231,134,97
23509,Jeø,stormscale,1823,paladin,holy,54,28,26
23510,Eldorín,blackmoore,1823,paladin,holy,54,20,34
23511,Welivewewin,defias-brotherhood,1820,paladin,holy,175,90,85
23512,Kianpal,silvermoon,1818,paladin,holy,158,89,69
23513,Danipaladin,tarren-mill,1817,paladin,holy,88,51,37
23514,Neverlostx,ravencrest,1816,paladin,holy,48,31,17
23515,Popecrusade,archimonde,1813,paladin,holy,107,66,41
23516,Ránchìek,ravencrest,1812,paladin,holy,54,26,28
23517,Majör,ysondre,1809,paladin,holy,66,34,32
23518,Vaîjin,aegwynn,1807,paladin,holy,194,95,99
23519,Jûliâ,archimonde,1802,paladin,holy,94,53,41
23520,Svyata,twisting-nether,1783,paladin,holy,119,56,63
23521,Edelarøs,ysondre,1771,paladin,holy,54,27,27
23522,Гола,gordunni,1771,paladin,holy,97,44,53
23523,Reckx,argent-dawn,1766,paladin,holy,53,26,27
23524,Runtheshôw,tarren-mill,1766,paladin,holy,166,79,87
23525,Holylightxz,runetotem,1765,paladin,holy,93,46,47
23526,Pêacerainer,stormscale,1765,paladin,holy,186,78,108
23527,Pignonn,dalaran,1763,paladin,holy,149,77,72
23528,Макстипчик,howling-fjord,1758,paladin,holy,63,29,34
23529,Ajani,la-croisade-écarlate,1750,paladin,holy,54,23,31
23530,Holysacx,aegwynn,1745,paladin,holy,42,25,17
23531,Rettyfield,blackrock,1744,paladin,holy,42,23,19
23532,Wollymolly,ravencrest,1741,paladin,holy,60,30,30
23533,Everflame,blackmoore,1739,paladin,holy,84,50,34
23534,Dbblou,draenor,1739,paladin,holy,42,20,22
23535,Jüther,pozzo-delleternità,1736,paladin,holy,35,19,16
23536,Vindîcator,defias-brotherhood,1736,paladin,holy,191,91,100
23537,Skyf,outland,1717,paladin,holy,239,116,123
23538,Valia,argent-dawn,1715,paladin,holy,75,40,35
23539,Tyrsa,defias-brotherhood,1715,paladin,holy,53,23,30
23540,Haylø,archimonde,1714,paladin,holy,45,24,21
23541,Stratarxis,kazzak,1714,paladin,holy,82,43,39
23542,Kwinn,aggra-português,1713,paladin,holy,36,18,18
23543,Pigpiss,ravencrest,1707,paladin,holy,46,19,27
23544,Акунделар,gordunni,1706,paladin,holy,125,63,62
23545,Думгохан,howling-fjord,1706,paladin,holy,48,21,27
23546,Аришалисичка,blackscar,1704,paladin,holy,76,38,38
23547,Beefcrusher,outland,1704,paladin,holy,42,18,24
23548,Faíren,mugthol,1697,paladin,holy,66,36,30
23549,Emlight,kazzak,1693,paladin,holy,53,32,21
23550,Фьюжндрайв,gordunni,1693,paladin,holy,36,18,18
23551,Drohim,aegwynn,1688,paladin,holy,46,23,23
23552,Tibælius,ravencrest,1683,paladin,holy,65,33,32
23553,Xaérulus,draenor,1682,paladin,holy,47,26,21
23554,Thaderyl,auchindoun,1678,paladin,holy,168,82,86
23555,Lycerax,antonidas,1677,paladin,holy,42,24,18
23556,Voklane,tarren-mill,1676,paladin,holy,48,23,25
23557,Мылонеуроних,deathguard,1675,paladin,holy,54,26,28
23558,Narkal,archimonde,1672,paladin,holy,99,51,48
23559,Callístó,amanthul,1670,paladin,holy,316,159,157
23560,Holysac,aegwynn,1669,paladin,holy,48,26,22
23561,Isøri,antonidas,1667,paladin,holy,114,58,56
23562,Andûrîl,tarren-mill,1665,paladin,holy,107,54,53
23563,Mðnsterz,archimonde,1661,paladin,holy,54,25,29
23564,Shabbyy,bronzebeard,1659,paladin,holy,102,58,44
23565,Emloses,outland,1653,paladin,holy,330,168,162
23566,Kakii,gorgonnash,1645,paladin,holy,59,24,35
23567,Spinne,tarren-mill,1642,paladin,holy,142,71,71
23568,Itsjulie,sylvanas,1642,paladin,holy,94,46,48
23569,Chosenlight,darkspear,1641,paladin,holy,169,81,88
23570,Powarpufgirl,blackrock,1638,paladin,holy,42,22,20
23571,Faíren,blackrock,1634,paladin,holy,48,22,26
23572,Хегия,gordunni,1633,paladin,holy,48,28,20
23573,Wíw,kazzak,1633,paladin,holy,142,73,69
23574,Мускатер,gordunni,1633,paladin,holy,58,26,32
23575,Baazil,ragnaros,1631,paladin,holy,84,38,46
23576,Chowo,argent-dawn,1631,paladin,holy,63,26,37
23577,Insanevegan,ravencrest,1628,paladin,holy,66,33,33
23578,Marcope,kazzak,1628,paladin,holy,36,17,19
23579,Fleshgraft,silvermoon,1627,paladin,holy,60,31,29
23580,Holeck,aegwynn,1627,paladin,holy,66,26,40
23581,Máttés,antonidas,1626,paladin,holy,59,21,38
23582,Chryme,thrall,1625,paladin,holy,66,36,30
23583,Jeromesavile,tarren-mill,1625,paladin,holy,143,68,75
23584,Lofé,drakthul,1623,paladin,holy,44,22,22
23585,Crucifiction,balnazzar,1623,paladin,holy,60,29,31
23586,Jambbo,twisting-nether,1622,paladin,holy,148,81,67
23587,Dewastor,veklor,1619,paladin,holy,48,25,23
23588,Jcbubs,xavius,1619,paladin,holy,180,91,89
23589,Nezâ,blackhand,1619,paladin,holy,58,26,32
23590,Blazerlolz,kazzak,1616,paladin,holy,60,33,27
23591,Athenewins,tarren-mill,1616,paladin,holy,400,210,190
23592,Crankaess,tarren-mill,1616,paladin,holy,73,37,36
23593,Lexolex,ravencrest,1616,paladin,holy,36,17,19
23594,Papasito,tarren-mill,1616,paladin,holy,48,17,31
23595,Vxqt,blackrock,1614,paladin,holy,53,25,28
23596,Percocetx,tarren-mill,1613,paladin,holy,54,24,30
23597,Buntqt,kazzak,1612,paladin,holy,100,54,46
23598,Jinyssa,silvermoon,1610,paladin,holy,42,25,17
23599,ßestsacjk,kazzak,1610,paladin,holy,54,22,32
23600,Rickstone,kazzak,1609,paladin,holy,42,17,25
23601,Zondãn,blackrock,1608,paladin,holy,95,51,44
23602,Pisr,draenor,1607,paladin,holy,48,21,27
23603,Kaputs,twisting-nether,1606,paladin,holy,31,18,13
23604,Острит,gordunni,1605,paladin,holy,78,45,33
23605,Dömötörp,ragnaros,1604,paladin,holy,135,71,64
23606,Джонниджага,blackscar,1604,paladin,holy,58,28,30
23607,Lexó,ravencrest,1604,paladin,holy,42,20,22
23608,Enemylosers,stormscale,1603,paladin,holy,180,99,81
23609,Kristelle,argent-dawn,1602,paladin,holy,102,55,47
23610,Stepsislana,tarren-mill,1601,paladin,holy,30,17,13
23611,Judgejuryexe,kazzak,1600,paladin,holy,92,44,48
23612,Xray,ahnqiraj,1598,paladin,holy,53,27,26
23613,Лайтпалочка,soulflayer,1596,paladin,holy,334,163,171
23614,Easypala,blackrock,1595,paladin,holy,114,50,64
23615,Дарксайгн,gordunni,1593,paladin,holy,48,17,31
23616,Ìschtarsdad,blackrock,1591,paladin,holy,192,96,96
23617,Сэлфхил,gordunni,1591,paladin,holy,107,47,60
23618,Erathoor,grim-batol,1589,paladin,holy,66,32,34
23619,Astollfo,hyjal,1588,paladin,holy,42,26,16
23620,Gloonî,blackmoore,1588,paladin,holy,47,19,28
23621,Holychît,sanguino,1586,paladin,holy,117,54,63
23622,Smightypal,silvermoon,1582,paladin,holy,123,62,61
23623,Xenyaa,arygos,1581,paladin,holy,103,53,50
23624,Пчелодин,howling-fjord,1581,paladin,holy,36,17,19
23625,Louiepal,outland,1580,paladin,holy,41,25,16
23626,Fourshaw,ravencrest,1578,paladin,holy,167,87,80
23627,Myssa,uldum,1577,paladin,holy,42,21,21
23628,Fannypoo,sylvanas,1574,paladin,holy,215,105,110
23629,Аронасхе,blackscar,1573,paladin,holy,89,39,50
23630,Umirinbruv,zenedar,1573,paladin,holy,50,20,30
23631,Arysur,defias-brotherhood,1566,paladin,holy,332,161,171
23632,Потокденег,howling-fjord,1563,paladin,holy,152,71,81
23633,Nîkå,ravencrest,1561,paladin,holy,109,62,47
23634,Femaleelf,eredar,1561,paladin,holy,48,20,28
23635,Ретриксвета,eversong,1559,paladin,holy,48,31,17
23636,Deodas,kazzak,1555,paladin,holy,293,145,148
23637,Erao,the-maelstrom,1554,paladin,holy,48,24,24
23638,Skurly,ragnaros,1551,paladin,holy,42,19,23
23639,Tibelious,ravencrest,1548,paladin,holy,114,47,67
23640,Pablok,minahonda,1548,paladin,holy,48,17,31
23641,Fløcki,blackhand,1547,paladin,holy,100,54,46
23642,Drdeus,kazzak,1547,paladin,holy,166,85,81
23643,Алукартик,deathguard,1546,paladin,holy,89,44,45
23644,Mistsx,kazzak,1546,paladin,holy,60,27,33
23645,Strûgglebûs,outland,1543,paladin,holy,47,25,22
23646,Срувтапкизз,blackscar,1543,paladin,holy,89,32,57
23647,Cozm,silvermoon,1540,paladin,holy,60,31,29
23648,Asenae,draenor,1540,paladin,holy,72,29,43
23649,Тошанич,soulflayer,1539,paladin,holy,54,24,30
23650,Gasilol,frostwolf,1537,paladin,holy,81,41,40
23651,Andronar,blackmoore,1536,paladin,holy,66,29,37
23652,Nstea,zuljin,1534,paladin,holy,30,16,14
23653,Lóde,silvermoon,1530,paladin,holy,148,77,71
23654,Pooncy,ragnaros,1530,paladin,holy,60,27,33
23655,Sncx,ravencrest,1528,paladin,holy,42,22,20
23656,Бадбх,howling-fjord,1527,paladin,holy,90,39,51
23657,Búbblicioús,ravencrest,1524,paladin,holy,84,49,35
23658,Леонящер,gordunni,1524,paladin,holy,288,157,131
23659,Всехилящий,gordunni,1522,paladin,holy,48,21,27
23660,Devinèqt,tarren-mill,1521,paladin,holy,67,38,29
23661,Aiyäna,argent-dawn,1521,paladin,holy,83,40,43
23662,Marygueguete,archimonde,1518,paladin,holy,108,53,55
23663,Lrnz,tarren-mill,1518,paladin,holy,42,16,26
23664,Dathróhán,silvermoon,1512,paladin,holy,267,135,132
23665,Sorfalinka,silvermoon,1511,paladin,holy,24,17,7
23666,Rotana,eredar,1511,paladin,holy,36,24,12
23667,Selphii,twisting-nether,1511,paladin,holy,40,22,18
23668,Powerpufgirl,blackrock,1511,paladin,holy,36,19,17
23669,Снупарь,blackscar,1509,paladin,holy,138,72,66
23670,Sofishoida,blackmoore,1508,paladin,holy,78,47,31
23671,Sonil,les-sentinelles,1507,paladin,holy,57,24,33
23672,Jaesa,lordaeron,1506,paladin,holy,71,32,39
23673,Ironmikë,outland,1505,paladin,holy,42,24,18
23674,Fatmidget,kazzak,1503,paladin,holy,66,43,23
23675,Aíe,draenor,1503,paladin,holy,81,44,37
23676,Sorfalik,silvermoon,1502,paladin,holy,30,18,12
23677,Astarox,kazzak,1501,paladin,holy,173,74,99
23678,Hawki,blackmoore,1500,paladin,holy,42,23,19
23679,Aese,dun-modr,1499,paladin,holy,102,51,51
23680,Эндемичный,soulflayer,1498,paladin,holy,48,28,20
23681,Rùfus,tarren-mill,1497,paladin,holy,162,84,78
23682,Sübôvîñ,ravencrest,1497,paladin,holy,135,69,66
23683,Foxywild,aszune,1497,paladin,holy,54,24,30
23684,Сатангодх,gordunni,1497,paladin,holy,78,30,48
23685,Delmothounet,ysondre,1496,paladin,holy,46,28,18
23686,Chocòbon,archimonde,1496,paladin,holy,56,32,24
23687,Delicztwo,der-rat-von-dalaran,1490,paladin,holy,30,16,14
23688,Xsÿde,archimonde,1489,paladin,holy,48,17,31
23689,Emistesía,stormscale,1488,paladin,holy,54,24,30
23690,Hirolde,zenedar,1487,paladin,holy,128,61,67
23691,Shaevira,ravencrest,1487,paladin,holy,66,30,36
23692,Elsewhere,archimonde,1487,paladin,holy,47,18,29
23693,Rookbeef,eredar,1486,paladin,holy,42,22,20
23694,Мифариан,blackscar,1486,paladin,holy,135,67,68
23695,Флэшкапро,soulflayer,1485,paladin,holy,208,102,106
23696,Ирестли,azuregos,1480,paladin,holy,78,39,39
23697,Волнысвета,howling-fjord,1479,paladin,holy,82,46,36
23698,Эллиарэй,gordunni,1478,paladin,holy,95,46,49
23699,Tuoppi,steamwheedle-cartel,1478,paladin,holy,90,42,48
23700,Drzärc,sanguino,1478,paladin,holy,60,28,32
23701,Nano,veknilash,1478,paladin,holy,60,27,33
23702,Kfcmanager,archimonde,1478,paladin,holy,36,16,20
23703,Nåmï,culte-de-la-rive-noire,1475,paladin,holy,48,26,22
23704,Stidi,frostmane,1475,paladin,holy,60,24,36
23705,Skinstructor,silvermoon,1473,paladin,holy,72,37,35
23706,Veléxis,outland,1464,paladin,holy,87,45,42
23707,Arenalena,sylvanas,1464,paladin,holy,181,88,93
23708,Брилз,soulflayer,1462,paladin,holy,71,33,38
23709,Curufin,grim-batol,1460,paladin,holy,149,80,69
23710,Jajmentx,kazzak,1459,paladin,holy,78,40,38
23711,Hairybabe,outland,1456,paladin,holy,48,29,19
23712,Nemesi,archimonde,1455,paladin,holy,42,20,22
23713,Konane,drekthar,1454,paladin,holy,37,17,20
23714,Divinetollen,ravencrest,1454,paladin,holy,62,26,36
23715,Realpalla,ravenholdt,1452,paladin,holy,126,62,64
23716,Archaegis,silvermoon,1452,paladin,holy,48,19,29
23717,Luxxorr,outland,1451,paladin,holy,21,17,4
23718,Крусейдор,soulflayer,1450,paladin,holy,91,40,51
23719,Emistesia,stormscale,1448,paladin,holy,47,22,25
23720,Scrimple,stormscale,1447,paladin,holy,73,35,38
23721,Norandel,turalyon,1447,paladin,holy,42,16,26
23722,Mercedes,arthas,1443,paladin,holy,35,20,15
23723,Alessaqas,ravencrest,1443,paladin,holy,63,28,35
23724,Présidential,grim-batol,1441,paladin,holy,59,28,31
23725,Коварное,borean-tundra,1440,paladin,holy,52,25,27
23726,Паладинас,lich-king,1440,paladin,holy,64,21,43
23727,Thaifo,silvermoon,1439,paladin,holy,33,20,13
23728,Глиндес,gordunni,1439,paladin,holy,168,80,88
23729,Уретроград,soulflayer,1436,paladin,holy,72,36,36
23730,Hpal,aegwynn,1435,paladin,holy,123,55,68
23731,Flouzz,blackmoore,1434,paladin,holy,30,15,15
23732,Holydawnx,kazzak,1432,paladin,holy,62,30,32
23733,Tiffanyqt,frostwolf,1428,paladin,holy,24,16,8
23734,Injection,khaz-modan,1428,paladin,holy,87,40,47
23735,Toohotty,archimonde,1428,paladin,holy,53,22,31
23736,Sacbøt,stormscale,1427,paladin,holy,259,132,127
23737,Ekzykes,ravencrest,1427,paladin,holy,48,21,27
23738,Séphiran,hyjal,1426,paladin,holy,53,28,25
23739,Slezz,tarren-mill,1426,paladin,holy,356,184,172
23740,Taiso,alonsus,1422,paladin,holy,132,64,68
23741,Xenaké,kazzak,1421,paladin,holy,155,68,87
23742,Jackieb,dun-modr,1421,paladin,holy,39,16,23
23743,Phalex,outland,1416,paladin,holy,36,23,13
23744,Swâpxy,proudmoore,1414,paladin,holy,24,15,9
23745,Preyy,eredar,1414,paladin,holy,54,30,24
23746,Bécasszelium,varimathras,1414,paladin,holy,165,82,83
23747,Mamporro,dun-modr,1413,paladin,holy,36,19,17
23748,Zilu,kazzak,1413,paladin,holy,47,24,23
23749,Maitrelampe,argent-dawn,1413,paladin,holy,84,42,42
23750,Wepalapvpbop,ravencrest,1413,paladin,holy,30,15,15
23751,Böllerbarbie,silvermoon,1411,paladin,holy,36,21,15
23752,Blazeberg,tirion,1411,paladin,holy,36,20,16
23753,Сашафистинг,gordunni,1411,paladin,holy,159,77,82
23754,Nimeron,ravencrest,1411,paladin,holy,72,30,42
23755,Curtfizzle,kazzak,1411,paladin,holy,65,26,39
23756,Vadomar,emerald-dream,1409,paladin,holy,78,33,45
23757,Ðenlox,destromath,1408,paladin,holy,104,53,51
23758,Дифицит,blackscar,1407,paladin,holy,87,50,37
23759,Rekolon,antonidas,1407,paladin,holy,273,145,128
23760,Aachenbrand,blackhand,1407,paladin,holy,131,55,76
23761,Gzerloth,ragnaros,1407,paladin,holy,36,15,21
23762,Кельдерик,howling-fjord,1406,paladin,holy,45,24,21
23763,Blessedpapi,draenor,1406,paladin,holy,72,32,40
23764,Diamir,rajaxx,1404,paladin,holy,75,55,20
23765,Dimetrix,stormscale,1403,paladin,holy,30,15,15
23766,Beecq,tarren-mill,1402,paladin,holy,54,30,24
23767,Alciera,silvermoon,1402,paladin,holy,54,24,30
23768,Аяпал,blackscar,1401,paladin,holy,72,39,33
23769,Deathsfate,defias-brotherhood,1397,paladin,holy,39,18,21
23770,Грор,galakrond,1395,paladin,holy,79,35,44
23771,Витёнокь,howling-fjord,1394,paladin,holy,44,29,15
23772,Hazø,silvermoon,1394,paladin,holy,48,26,22
23773,Stinkepieet,blackmoore,1390,paladin,holy,48,20,28
23774,Реколори,gordunni,1389,paladin,holy,167,91,76
23775,Эверейс,howling-fjord,1389,paladin,holy,47,22,25
23776,Mestgone,dalaran,1388,paladin,holy,65,30,35
23777,Kantfyrste,ravencrest,1388,paladin,holy,139,59,80
23778,Бэнкли,soulflayer,1387,paladin,holy,78,45,33
23779,Expot,blackmoore,1387,paladin,holy,60,34,26
23780,Moeixu,kazzak,1387,paladin,holy,33,15,18
23781,Fenye,twisting-nether,1386,paladin,holy,68,32,36
23782,Эскейпми,howling-fjord,1385,paladin,holy,35,18,17
23783,Locofatguy,drakthul,1385,paladin,holy,149,70,79
23784,Салфеточник,thermaplugg,1384,paladin,holy,72,28,44
23785,Noliferx,ravencrest,1383,paladin,holy,82,49,33
23786,Cerinae,tarren-mill,1383,paladin,holy,57,26,31
23787,Rullstolen,the-maelstrom,1382,paladin,holy,48,28,20
23788,Artherius,silvermoon,1381,paladin,holy,60,34,26
23789,Cykadin,dun-modr,1380,paladin,holy,72,30,42
23790,Danepala,defias-brotherhood,1378,paladin,holy,59,29,30
23791,Rëtnuhka,drakthul,1378,paladin,holy,50,24,26
23792,Zycqo,silvermoon,1377,paladin,holy,174,84,90
23793,Wingcomandêr,aegwynn,1377,paladin,holy,36,15,21
23794,Бирко,blackscar,1377,paladin,holy,45,17,28
23795,Elvandara,blackmoore,1377,paladin,holy,65,23,42
23796,Gabriev,twisting-nether,1376,paladin,holy,49,25,24
23797,Gimch,magtheridon,1375,paladin,holy,24,15,9
23798,Døgstømper,outland,1370,paladin,holy,29,15,14
23799,Louiepalmoo,outland,1370,paladin,holy,34,17,17
23800,Badckes,sylvanas,1367,paladin,holy,116,54,62
23801,Vivalabeef,stormscale,1367,paladin,holy,60,26,34
23802,Unpal,ravencrest,1366,paladin,holy,42,18,24
23803,Mecah,hyjal,1365,paladin,holy,42,21,21
23804,Pullheavy,silvermoon,1363,paladin,holy,89,38,51
23805,Xelqt,draenor,1361,paladin,holy,36,15,21
23806,Goodbit,dentarg,1360,paladin,holy,59,36,23
23807,Ramos,aggra-português,1360,paladin,holy,60,22,38
23808,Ассантийка,deathguard,1358,paladin,holy,45,21,24
23809,Ostardo,blackhand,1357,paladin,holy,24,15,9
23810,Flowerbud,tarren-mill,1357,paladin,holy,48,23,25
23811,Dlfî,hyjal,1356,paladin,holy,50,30,20
23812,Aebî,dalaran,1355,paladin,holy,42,24,18
23813,Shakalol,dun-modr,1355,paladin,holy,60,23,37
23814,Heilgaharald,blackrock,1351,paladin,holy,110,51,59
23815,Honeygodx,antonidas,1350,paladin,holy,45,24,21
23816,Sixtynien,outland,1350,paladin,holy,54,28,26
23817,Mikemyers,blackhand,1350,paladin,holy,42,20,22
23818,Talimañ,kazzak,1349,paladin,holy,42,23,19
23819,Demonskiller,alakir,1346,paladin,holy,89,47,42
23820,Кольт,borean-tundra,1346,paladin,holy,79,40,39
23821,Nerdpallyx,tarren-mill,1346,paladin,holy,69,28,41
23822,Европпа,soulflayer,1346,paladin,holy,93,30,63
23823,Pussdocta,ravencrest,1345,paladin,holy,89,48,41
23824,Arlette,moonglade,1345,paladin,holy,72,32,40
23825,Nudzolini,tarren-mill,1344,paladin,holy,36,22,14
23826,Derpe,hellscream,1344,paladin,holy,24,14,10
23827,Эсерпи,gordunni,1343,paladin,holy,299,148,151
23828,Jerryhârvey,kazzak,1342,paladin,holy,24,14,10
23829,Ballantine,thunderhorn,1341,paladin,holy,30,18,12
23830,Keele,stormscale,1341,paladin,holy,69,32,37
23831,Expander,draenor,1341,paladin,holy,36,14,22
23832,Vonat,outland,1340,paladin,holy,42,16,26
23833,Shamoo,archimonde,1338,paladin,holy,24,14,10
23834,Рэймондх,gordunni,1338,paladin,holy,24,14,10
23835,Itsgossiplol,twisting-nether,1338,paladin,holy,205,104,101
23836,Freaak,dethecus,1337,paladin,holy,60,24,36
23837,Alphaøne,stormscale,1336,paladin,holy,30,14,16
23838,Lugnals,hyjal,1336,paladin,holy,114,52,62
23839,Holypapa,argent-dawn,1336,paladin,holy,60,27,33
23840,Elians,outland,1336,paladin,holy,54,22,32
23841,Sangriul,outland,1336,paladin,holy,93,37,56
23842,Лимфома,goldrinn,1334,paladin,holy,65,25,40
23843,Anythíng,kazzak,1333,paladin,holy,115,58,57
23844,Alldo,drakthul,1333,paladin,holy,124,58,66
23845,Ztiina,tarren-mill,1332,paladin,holy,60,27,33
23846,Ugolf,kazzak,1331,paladin,holy,78,43,35
23847,Mitsaklas,grim-batol,1331,paladin,holy,150,65,85
23848,Steggeh,argent-dawn,1331,paladin,holy,120,48,72
23849,Lightbrîng,hyjal,1327,paladin,holy,53,26,27
23850,Бэдмэн,deathguard,1327,paladin,holy,53,16,37
23851,Dàrckness,ravencrest,1326,paladin,holy,269,142,127
23852,Lastaid,azshara,1326,paladin,holy,156,73,83
23853,Wrathlol,ravencrest,1325,paladin,holy,195,97,98
23854,Watras,drakthul,1324,paladin,holy,72,26,46
23855,Aytu,blackmoore,1321,paladin,holy,39,19,20
23856,Nde,silvermoon,1320,paladin,holy,47,20,27
23857,Holynstuff,auchindoun,1319,paladin,holy,37,26,11
23858,Даниэль,howling-fjord,1319,paladin,holy,66,36,30
23859,Alard,sanguino,1319,paladin,holy,96,42,54
23860,Maxôr,norgannon,1317,paladin,holy,48,27,21
23861,Öbedö,malganis,1316,paladin,holy,69,34,35
23862,Dogmatic,blackmoore,1316,paladin,holy,30,14,16
23863,Lazyknight,silvermoon,1316,paladin,holy,60,25,35
23864,Crusherpala,laughing-skull,1316,paladin,holy,83,33,50
23865,Neyd,hyjal,1314,paladin,holy,60,21,39
23866,Necrozi,stormscale,1311,paladin,holy,60,35,25
23867,Agadin,ysondre,1310,paladin,holy,35,19,16
23868,Bigfailure,blackmoore,1309,paladin,holy,65,21,44
23869,Bagull,zuljin,1308,paladin,holy,94,45,49
23870,Rookx,stormscale,1308,paladin,holy,66,23,43
23871,Mythsion,blackmoore,1307,paladin,holy,36,16,20
23872,Daizen,blackrock,1306,paladin,holy,67,45,22
23873,Skengdaddy,ragnaros,1306,paladin,holy,84,39,45
23874,Рэймета,soulflayer,1306,paladin,holy,42,16,26
23875,Подлыйдим,fordragon,1303,paladin,holy,84,34,50
23876,Pokébowl,outland,1302,paladin,holy,48,27,21
23877,Evo,drakthul,1301,paladin,holy,55,25,30
23878,Wyllian,grim-batol,1300,paladin,holy,83,44,39
23879,Malodos,archimonde,1299,paladin,holy,62,33,29
23880,Bladê,kazzak,1299,paladin,holy,66,26,40
23881,Keltinne,ysondre,1298,paladin,holy,39,23,16
23882,Noskillze,ravencrest,1298,paladin,holy,24,14,10
23883,Bovinequeef,twisting-nether,1298,paladin,holy,42,21,21
23884,Æmiø,blackmoore,1298,paladin,holy,59,27,32
23885,Lapew,eredar,1297,paladin,holy,27,16,11
23886,Vuup,silvermoon,1295,paladin,holy,44,25,19
23887,Hîfi,blackmoore,1295,paladin,holy,147,80,67
23888,Wernøw,archimonde,1294,paladin,holy,27,14,13
23889,Matagladis,dun-modr,1294,paladin,holy,84,42,42
23890,Îiî,archimonde,1294,paladin,holy,30,14,16
23891,Kerven,doomhammer,1293,paladin,holy,54,22,32
23892,Scholzpala,twisting-nether,1292,paladin,holy,30,18,12
23893,Kapikøoqt,suramar,1291,paladin,holy,151,80,71
23894,Kocovic,tarren-mill,1289,paladin,holy,48,24,24
23895,Alphä,auchindoun,1287,paladin,holy,30,14,16
23896,Dedy,frostwhisper,1286,paladin,holy,47,24,23
23897,Zeratris,defias-brotherhood,1286,paladin,holy,43,20,23
23898,Gegge,kazzak,1285,paladin,holy,50,19,31
23899,Алекхей,gordunni,1282,paladin,holy,66,28,38
23900,Åsaruki,emerald-dream,1281,paladin,holy,42,17,25
23901,Paellysuir,blackmoore,1280,paladin,holy,38,19,19
23902,Ggiwastheret,kazzak,1277,paladin,holy,23,14,9
23903,Arand,blackrock,1275,paladin,holy,63,37,26
23904,Tyktyk,draenor,1275,paladin,holy,42,24,18
23905,Holyfrick,kazzak,1275,paladin,holy,42,17,25
23906,Holyppower,frostmane,1275,paladin,holy,35,14,21
23907,Ärinváyá,defias-brotherhood,1274,paladin,holy,57,33,24
23908,Taligon,arathor,1272,paladin,holy,42,21,21
23909,Albertina,silvermoon,1271,paladin,holy,38,19,19
23910,Mifuttoasort,draenor,1270,paladin,holy,54,26,28
23911,Gucix,sylvanas,1269,paladin,holy,89,37,52
23912,Toradin,thunderhorn,1268,paladin,holy,49,22,27
23913,Делатор,gordunni,1267,paladin,holy,48,22,26
23914,Polydeukis,stormscale,1267,paladin,holy,90,34,56
23915,Trisunonvaki,khazgoroth,1266,paladin,holy,144,78,66
23916,Кузнейц,borean-tundra,1264,paladin,holy,52,18,34
23917,Tíep,blackmoore,1262,paladin,holy,71,36,35
23918,Pajtash,doomhammer,1261,paladin,holy,59,29,30
23919,Bloodsoldier,twisting-nether,1258,paladin,holy,88,45,43
23920,Hotub,twisting-nether,1258,paladin,holy,123,57,66
23921,Bulten,twilights-hammer,1257,paladin,holy,58,18,40
23922,Strudell,terrordar,1254,paladin,holy,60,31,29
23923,Kaitlyne,tarren-mill,1254,paladin,holy,97,49,48
23924,Анбели,gordunni,1252,paladin,holy,60,24,36
23925,Reeley,drakthul,1251,paladin,holy,107,53,54
23926,Ginbeam,aegwynn,1251,paladin,holy,100,48,52
23927,Hogma,hyjal,1250,paladin,holy,36,14,22
23928,Luraa,drakthul,1249,paladin,holy,42,21,21
23929,Alastrr,hyjal,1248,paladin,holy,73,44,29
23930,Opopoï,dalaran,1247,paladin,holy,24,15,9
23931,Рустиктоп,gordunni,1247,paladin,holy,30,13,17
23932,Sheroo,rexxar,1244,paladin,holy,18,13,5
23933,Pupsihasi,kelthuzad,1244,paladin,holy,35,19,16
23934,Valkhana,draenor,1244,paladin,holy,58,29,29
23935,Hÿrrøkk,ysondre,1243,paladin,holy,60,40,20
23936,Paiadinho,malganis,1243,paladin,holy,83,27,56
23937,Tommoffwarrs,archimonde,1241,paladin,holy,73,35,38
23938,Вертуосгодх,soulflayer,1240,paladin,holy,49,24,25
23939,Haros,xavius,1239,paladin,holy,31,16,15
23940,Зондарк,booty-bay,1239,paladin,holy,65,23,42
23941,Neithi,twisting-nether,1238,paladin,holy,42,20,22
23942,Askmy,stormscale,1237,paladin,holy,24,13,11
23943,Aelly,hyjal,1237,paladin,holy,112,56,56
23944,Rookzter,sylvanas,1237,paladin,holy,78,39,39
23945,Skailzpal,hyjal,1236,paladin,holy,36,21,15
23946,Alesiah,blackhand,1235,paladin,holy,61,26,35
23947,Judgealdo,sylvanas,1234,paladin,holy,25,14,11
23948,Nitrous,zuljin,1232,paladin,holy,36,22,14
23949,Jaezlin,tarren-mill,1232,paladin,holy,130,70,60
23950,Neverbuble,archimonde,1231,paladin,holy,76,33,43
23951,Reudi,argent-dawn,1230,paladin,holy,54,28,26
23952,Farata,ravencrest,1230,paladin,holy,160,78,82
23953,Ashbrìnger,aegwynn,1227,paladin,holy,24,13,11
23954,Skolisse,kazzak,1225,paladin,holy,131,69,62
23955,Kherathan,argent-dawn,1225,paladin,holy,42,21,21
23956,Cowvid,grim-batol,1225,paladin,holy,30,13,17
23957,Naenel,dun-modr,1225,paladin,holy,37,16,21
23958,Ninko,sylvanas,1224,paladin,holy,54,29,25
23959,Emilíá,kazzak,1223,paladin,holy,24,13,11
23960,Regis,dragonblight,1223,paladin,holy,74,40,34
23961,Schrikii,archimonde,1221,paladin,holy,66,27,39
23962,Ðeswynd,hyjal,1220,paladin,holy,83,35,48
23963,Lightmachine,kirin-tor,1218,paladin,holy,54,36,18
23964,Baubble,silvermoon,1218,paladin,holy,48,28,20
23965,Pegason,twisting-nether,1218,paladin,holy,49,26,23
23966,Ritiv,stormreaver,1218,paladin,holy,102,46,56
23967,Lianndrin,blackhand,1218,paladin,holy,58,25,33
23968,Aranael,nemesis,1218,paladin,holy,52,21,31
23969,Trastos,wildhammer,1217,paladin,holy,54,28,26
23970,Fleny,thrall,1215,paladin,holy,24,13,11
23971,Paladins,archimonde,1214,paladin,holy,38,20,18
23972,Weserwehr,laughing-skull,1214,paladin,holy,54,27,27
23973,Lightmamba,draenor,1214,paladin,holy,48,16,32
23974,Eline,zenedar,1213,paladin,holy,36,13,23
23975,Cmelacek,wildhammer,1212,paladin,holy,30,18,12
23976,Babybeater,outland,1212,paladin,holy,77,36,41
23977,Lucá,silvermoon,1211,paladin,holy,23,13,10
23978,Ромерл,gordunni,1210,paladin,holy,223,103,120
23979,Святстраж,gordunni,1210,paladin,holy,32,14,18
23980,Johnnydeeps,blackrock,1210,paladin,holy,35,13,22
23981,Johnaggro,outland,1209,paladin,holy,46,23,23
23982,Johnnÿsins,hyjal,1209,paladin,holy,63,28,35
23983,Stuzzyy,ravencrest,1209,paladin,holy,36,16,20
23984,Uzuriel,chogall,1206,paladin,holy,353,159,194
23985,Rébél,argent-dawn,1206,paladin,holy,42,17,25
23986,Нинтендо,grom,1205,paladin,holy,126,53,73
23987,Skarn,pozzo-delleternità,1205,paladin,holy,37,15,22
23988,Satipal,sargeras,1205,paladin,holy,116,45,71
23989,Warkyria,sanguino,1204,paladin,holy,31,15,16
23990,Faildin,arathor,1204,paladin,holy,96,46,50
23991,Xastur,rexxar,1201,paladin,holy,33,17,16
23992,Майдмен,gordunni,1200,paladin,holy,66,37,29
23993,Demecir,twisting-nether,1198,paladin,holy,204,96,108
23994,Tucibi,hyjal,1196,paladin,holy,42,24,18
23995,Trístesse,tarren-mill,1193,paladin,holy,167,86,81
23996,Lightaldo,bladefist,1188,paladin,holy,24,14,10
23997,Holymax,gorgonnash,1188,paladin,holy,45,25,20
23998,Линвэль,gordunni,1188,paladin,holy,27,13,14
23999,Сашокс,gordunni,1188,paladin,holy,54,23,31
24000,Кейлол,soulflayer,1186,paladin,holy,71,31,40
24001,Boric,bloodhoof,1184,paladin,holy,29,16,13
24002,Keryann,argent-dawn,1183,paladin,holy,108,53,55
24003,Pisdez,malganis,1183,paladin,holy,54,24,30
24004,Skwáru,burning-legion,1179,paladin,holy,77,30,47
24005,Фэрплэйн,gordunni,1178,paladin,holy,48,22,26
24006,Kayndornek,ravencrest,1178,paladin,holy,78,35,43
24007,Shiidori,aegwynn,1175,paladin,holy,57,23,34
24008,Kiyam,kelthuzad,1174,paladin,holy,18,13,5
24009,Rhulana,blackrock,1171,paladin,holy,67,41,26
24010,Affiicous,silvermoon,1171,paladin,holy,60,19,41
24011,Dawnforged,stormscale,1170,paladin,holy,78,34,44
24012,Claudîax,kazzak,1170,paladin,holy,81,31,50
24013,Manole,ravencrest,1168,paladin,holy,35,17,18
24014,Цитология,borean-tundra,1166,paladin,holy,39,15,24
24015,Seinz,talnivarr,1165,paladin,holy,66,29,37
24016,Puiçanpal,archimonde,1163,paladin,holy,30,15,15
24017,Elohim,echsenkessel,1163,paladin,holy,154,71,83
24018,Mjabubble,stormscale,1158,paladin,holy,78,44,34
24019,Rivanii,kazzak,1155,paladin,holy,129,60,69
24020,Taraniah,argent-dawn,1154,paladin,holy,71,36,35
24021,Kaki,gorgonnash,1151,paladin,holy,18,12,6
24022,Wedervärdig,twilights-hammer,1151,paladin,holy,54,23,31
24023,Djspresty,ravencrest,1150,paladin,holy,18,12,6
24024,Алексендлерх,soulflayer,1149,paladin,holy,18,12,6
24025,Strykar,aggra-português,1147,paladin,holy,54,27,27
24026,Irefutabila,stormscale,1146,paladin,holy,30,12,18
24027,Crispydixx,draenor,1143,paladin,holy,77,37,40
24028,Eskorbuto,dun-modr,1143,paladin,holy,51,24,27
24029,Trolladincho,twisting-nether,1141,paladin,holy,54,25,29
24030,Gromezrael,elune,1141,paladin,holy,42,19,23
24031,Thickets,argent-dawn,1140,paladin,holy,38,18,20
24032,Naylaeh,draenor,1138,paladin,holy,24,12,12
24033,Kambood,twisting-nether,1138,paladin,holy,165,72,93
24034,Мэйр,howling-fjord,1137,paladin,holy,42,17,25
24035,Yonì,thrall,1136,paladin,holy,18,12,6
24036,Minouminou,archimonde,1136,paladin,holy,24,13,11
24037,Lezoom,draenor,1136,paladin,holy,79,40,39
24038,Slistrash,outland,1135,paladin,holy,71,36,35
24039,Milesteris,medivh,1134,paladin,holy,24,14,10
24040,Cadila,silvermoon,1134,paladin,holy,54,25,29
24041,Mirabol,hyjal,1133,paladin,holy,42,16,26
24042,Jasiv,draenor,1132,paladin,holy,36,14,22
24043,Palix,dalaran,1132,paladin,holy,36,12,24
24044,Ниссида,blackscar,1131,paladin,holy,65,32,33
24045,Dunka,twisting-nether,1130,paladin,holy,130,67,63
24046,Spankmeproof,kazzak,1128,paladin,holy,30,12,18
24047,Yaj,magtheridon,1122,paladin,holy,59,27,32
24048,Zebramann,silvermoon,1121,paladin,holy,48,20,28
24049,Psycholas,ysondre,1118,paladin,holy,29,15,14
24050,Zerfleddern,aegwynn,1118,paladin,holy,149,73,76
24051,Truthbearer,darksorrow,1118,paladin,holy,116,53,63
24052,Striike,drakthul,1117,paladin,holy,29,12,17
24053,Luzcian,zuljin,1117,paladin,holy,46,17,29
24054,Guidone,sylvanas,1116,paladin,holy,30,13,17
24055,Echooes,ravencrest,1116,paladin,holy,237,101,136
24056,Mozzie,archimonde,1116,paladin,holy,158,67,91
24057,Sepha,eonar,1115,paladin,holy,39,21,18
24058,Kanina,outland,1114,paladin,holy,58,23,35
24059,Ithealy,twisting-nether,1113,paladin,holy,60,29,31
24060,Tscheba,kazzak,1109,paladin,holy,82,42,40
24061,Unithral,durotan,1107,paladin,holy,24,12,12
24062,Новирка,deathguard,1107,paladin,holy,48,20,28
24063,Ðelusion,sanguino,1103,paladin,holy,17,12,5
24064,Kaleto,ragnaros,1102,paladin,holy,65,38,27
24065,Paidi,die-todeskrallen,1101,paladin,holy,74,34,40
24066,Джонигодх,gordunni,1100,paladin,holy,21,12,9
24067,Minui,onyxia,1100,paladin,holy,30,12,18
24068,Shoby,silvermoon,1100,paladin,holy,30,12,18
24069,Eastranspal,ravencrest,1096,paladin,holy,36,13,23
24070,Dryntee,blackmoore,1095,paladin,holy,21,13,8
24071,Darkironpala,argent-dawn,1095,paladin,holy,59,28,31
24072,Кукусяшка,gordunni,1094,paladin,holy,32,12,20
24073,Yokurolel,sanguino,1092,paladin,holy,48,29,19
24074,Debts,aggramar,1092,paladin,holy,40,13,27
24075,Stonebeard,ahnqiraj,1088,paladin,holy,81,48,33
24076,Ampoula,ravencrest,1088,paladin,holy,28,12,16
24077,Nosn,ravencrest,1087,paladin,holy,66,34,32
24078,Verianer,shadowsong,1086,paladin,holy,46,27,19
24079,Dabstar,antonidas,1086,paladin,holy,88,41,47
24080,Макспал,lich-king,1085,paladin,holy,22,14,8
24081,Rejst,drakthul,1085,paladin,holy,35,12,23
24082,Ларенси,gordunni,1084,paladin,holy,41,18,23
24083,Ragua,tarren-mill,1082,paladin,holy,66,23,43
24084,Paladzor,twisting-nether,1082,paladin,holy,38,13,25
24085,Poundcake,stormscale,1080,paladin,holy,86,43,43
24086,Darvius,auchindoun,1080,paladin,holy,93,44,49
24087,Ashmaden,tarren-mill,1077,paladin,holy,87,49,38
24088,Mscrabtree,aggramar,1076,paladin,holy,30,13,17
24089,Ðuïvel,grim-batol,1076,paladin,holy,28,12,16
24090,Naliax,ravencrest,1072,paladin,holy,29,12,17
24091,Zeret,twisting-nether,1068,paladin,holy,35,15,20
24092,Bàldur,dalaran,1067,paladin,holy,42,22,20
24093,Paliat,silvermoon,1066,paladin,holy,31,12,19
24094,Vintar,quelthalas,1058,paladin,holy,57,31,26
24095,Feldrøider,nemesis,1057,paladin,holy,60,32,28
24096,Djaléxx,kazzak,1056,paladin,holy,36,11,25
24097,Flashyplays,silvermoon,1055,paladin,holy,36,26,10
24098,Casmira,blackrock,1055,paladin,holy,18,11,7
24099,Palanolmal,dun-modr,1055,paladin,holy,45,22,23
24100,Necrocursed,blackrock,1055,paladin,holy,24,11,13
24101,Zendæ,archimonde,1054,paladin,holy,18,11,7
24102,Palaadschin,festung-der-stürme,1054,paladin,holy,54,25,29
24103,Misarosh,drakthul,1054,paladin,holy,24,11,13
24104,Superalt,archimonde,1052,paladin,holy,18,11,7
24105,Kaktuszfüge,ragnaros,1052,paladin,holy,58,35,23
24106,Nicewar,silvermoon,1052,paladin,holy,58,29,29
24107,Penth,doomhammer,1052,paladin,holy,24,11,13
24108,Thaliasword,sylvanas,1052,paladin,holy,30,11,19
24109,Дезоиль,gordunni,1052,paladin,holy,30,11,19
24110,Billkop,silvermoon,1051,paladin,holy,49,24,25
24111,Borndark,stormscale,1051,paladin,holy,24,11,13
24112,Impro,archimonde,1051,paladin,holy,30,11,19
24113,Whatisapalla,ragnaros,1051,paladin,holy,30,11,19
24114,Скайлайтх,soulflayer,1050,paladin,holy,24,11,13
24115,Pâmê,kazzak,1049,paladin,holy,30,12,18
24116,Mvppaladin,thrall,1048,paladin,holy,12,11,1
24117,Serim,dun-modr,1048,paladin,holy,149,67,82
24118,Rdypaladin,ravencrest,1047,paladin,holy,24,11,13
24119,Høpé,malganis,1046,paladin,holy,86,42,44
24120,Shaggybeard,frostmane,1045,paladin,holy,24,11,13
24121,Cmen,silvermoon,1043,paladin,holy,109,54,55
24122,Grimbold,hellfire,1042,paladin,holy,18,11,7
24123,Паландис,howling-fjord,1042,paladin,holy,54,23,31
24124,Niechepala,grim-batol,1042,paladin,holy,30,11,19
24125,Fearleß,malganis,1041,paladin,holy,18,11,7
24126,Fract,aggramar,1041,paladin,holy,63,32,31
24127,Lènnja,baelgun,1041,paladin,holy,24,11,13
24128,Kuhs,eredar,1038,paladin,holy,59,23,36
24129,Satip,archimonde,1036,paladin,holy,48,31,17
24130,Sheldon,sylvanas,1034,paladin,holy,35,14,21
24131,Çrúsader,frostmane,1032,paladin,holy,36,18,18
24132,Фломастер,gordunni,1031,paladin,holy,66,28,38
24133,Iovä,twisting-nether,1031,paladin,holy,142,54,88
24134,Mowik,archimonde,1030,paladin,holy,72,32,40
24135,Crusadelight,alakir,1026,paladin,holy,134,65,69
24136,Mjølnîr,eredar,1025,paladin,holy,36,12,24
24137,Purificatoru,draenor,1024,paladin,holy,54,26,28
24138,Jessìca,ravenholdt,1020,paladin,holy,54,26,28
24139,Ugurpala,sylvanas,1016,paladin,holy,24,11,13
24140,Darhuun,antonidas,1012,paladin,holy,60,23,37
24141,Mccrit,ravencrest,1011,paladin,holy,37,21,16
24142,Palir,ysondre,1010,paladin,holy,24,11,13
24143,Golldy,burning-legion,1008,paladin,holy,21,12,9
24144,Paliester,stormscale,1007,paladin,holy,18,12,6
24145,Ланиакеа,deathguard,1007,paladin,holy,24,12,12
24146,Zetla,khaz-modan,1001,paladin,holy,40,18,22
24147,Флаила,ashenvale,999,paladin,holy,36,18,18
24148,Hëüss,suramar,998,paladin,holy,23,11,12
24149,Пегая,soulflayer,994,paladin,holy,24,13,11
24150,Buddy,conseil-des-ombres,988,paladin,holy,50,24,26
24151,Marik,argent-dawn,987,paladin,holy,17,11,6
24152,Arkkipiispa,outland,987,paladin,holy,66,32,34
24153,Ryuzu,khazgoroth,985,paladin,holy,41,20,21
24154,Áfx,blackmoore,985,paladin,holy,44,17,27
24155,Первыйпал,blackscar,982,paladin,holy,91,48,43
24156,Cerseï,frostmane,979,paladin,holy,41,13,28
24157,Kpunkpam,dun-modr,976,paladin,holy,44,24,20
24158,Skydor,silvermoon,974,paladin,holy,57,21,36
24159,Fleshoflight,arathor,972,paladin,holy,74,26,48
24160,Leon,veknilash,971,paladin,holy,102,41,61
24161,Pappipala,tarren-mill,967,paladin,holy,25,11,14
24162,Øsirix,archimonde,966,paladin,holy,66,26,40
24163,Rapidforce,kazzak,965,paladin,holy,102,51,51
24164,Ударник,soulflayer,964,paladin,holy,54,30,24
24165,Rafox,malygos,964,paladin,holy,42,17,25
24166,Byoß,ravencrest,960,paladin,holy,18,10,8
24167,Юмэйнару,deepholm,959,paladin,holy,18,10,8
24168,Ozzuum,twisting-nether,959,paladin,holy,18,10,8
24169,Lofotof,silvermoon,958,paladin,holy,12,10,2
24170,Herayo,aegwynn,958,paladin,holy,24,10,14
24171,Whórainzóne,eredar,958,paladin,holy,36,10,26
24172,Kapsloch,twisting-nether,958,paladin,holy,36,10,26
24173,Padraic,scarshield-legion,957,paladin,holy,18,10,8
24174,Demytxx,silvermoon,957,paladin,holy,30,10,20
24175,Rubadubskrub,silvermoon,957,paladin,holy,54,17,37
24176,Crashband,bronzebeard,956,paladin,holy,18,10,8
24177,Shockhoe,tarren-mill,955,paladin,holy,24,10,14
24178,Zymotíx,stormscale,954,paladin,holy,30,10,20
24179,Pb,twilights-hammer,953,paladin,holy,18,10,8
24180,Brøadway,eredar,953,paladin,holy,19,10,9
24181,Roshï,tarren-mill,953,paladin,holy,30,10,20
24182,Iauna,tarren-mill,952,paladin,holy,30,10,20
24183,Runeington,silvermoon,951,paladin,holy,18,10,8
24184,Swungling,outland,951,paladin,holy,18,10,8
24185,Dánn,outland,950,paladin,holy,18,10,8
24186,Dunutunicorn,argent-dawn,950,paladin,holy,18,10,8
24187,Tömmÿ,draenor,950,paladin,holy,52,24,28
24188,Bcrp,ragnaros,950,paladin,holy,30,10,20
24189,Випанк,howling-fjord,949,paladin,holy,155,60,95
24190,Arcanïk,archimonde,949,paladin,holy,30,10,20
24191,Churrucuca,minahonda,948,paladin,holy,33,13,20
24192,Алекссис,blackscar,948,paladin,holy,78,30,48
24193,Tepowze,twisting-nether,947,paladin,holy,18,10,8
24194,Legenda,grim-batol,946,paladin,holy,48,20,28
24195,Tmàc,twisting-nether,946,paladin,holy,36,10,26
24196,Datz,nerathor,943,paladin,holy,24,10,14
24197,Groove,colinas-pardas,941,paladin,holy,34,11,23
24198,Selenaluna,turalyon,941,paladin,holy,42,13,29
24199,Messîah,outland,939,paladin,holy,43,19,24
24200,Colpadeltank,kazzak,939,paladin,holy,54,15,39
24201,Clerik,eredar,936,paladin,holy,88,42,46
24202,Tärkan,chogall,935,paladin,holy,24,10,14
24203,Синрайчик,gordunni,934,paladin,holy,36,16,20
24204,Paladons,darksorrow,933,paladin,holy,41,22,19
24205,Menagron,tarren-mill,932,paladin,holy,31,14,17
24206,Catali,sanguino,931,paladin,holy,115,54,61
24207,Yasmira,frostmourne,930,paladin,holy,30,16,14
24208,Ázot,burning-legion,929,paladin,holy,48,19,29
24209,Djalexx,kazzak,927,paladin,holy,23,10,13
24210,Perpon,exodar,925,paladin,holy,42,16,26
24211,Ridethelight,nemesis,922,paladin,holy,30,15,15
24212,Santtox,dun-modr,919,paladin,holy,34,11,23
24213,Imaturtle,darksorrow,915,paladin,holy,41,10,31
24214,Divinelightz,kazzak,914,paladin,holy,25,14,11
24215,Fifisztos,burning-legion,911,paladin,holy,27,13,14
24216,Scumbakitty,ysondre,911,paladin,holy,29,10,19
24217,Equablex,argent-dawn,910,paladin,holy,20,11,9
24218,Reeceboss,ravencrest,906,paladin,holy,29,12,17
24219,Cøllinz,ragnaros,904,paladin,holy,21,10,11
24220,Heyley,twisting-nether,903,paladin,holy,21,11,10
24221,Khaerhadur,argent-dawn,901,paladin,holy,83,24,59
24222,Míxu,stormreaver,896,paladin,holy,29,12,17
24223,Sweestance,minahonda,895,paladin,holy,230,100,130
24224,Holycoomer,silvermoon,894,paladin,holy,20,10,10
24225,Shakziva,draenor,892,paladin,holy,35,14,21
24226,Amolan,drakthul,888,paladin,holy,115,63,52
24227,Яполковник,gordunni,887,paladin,holy,53,30,23
24228,Aéther,quelthalas,883,paladin,holy,20,11,9
24229,Theisixtus,drakthul,883,paladin,holy,23,12,11
24230,Àkí,blackmoore,883,paladin,holy,35,14,21
24231,Даурия,soulflayer,883,paladin,holy,28,10,18
24232,Nykothpn,ghostlands,881,paladin,holy,59,19,40
24233,Silvers,steamwheedle-cartel,880,paladin,holy,76,22,54
24234,Karnwield,kirin-tor,875,paladin,holy,38,16,22
24235,Likkik,tarren-mill,864,paladin,holy,12,9,3
24236,Profundus,zuluhed,864,paladin,holy,12,9,3
24237,Криптонитх,blackscar,864,paladin,holy,18,9,9
24238,Лайхтни,gordunni,864,paladin,holy,18,9,9
24239,Rezvaya,tarren-mill,864,paladin,holy,24,9,15
24240,Holylightxz,archimonde,864,paladin,holy,24,9,15
24241,Cunix,draenor,863,paladin,holy,12,9,3
24242,Дэнриэль,howling-fjord,863,paladin,holy,24,9,15
24243,Язвавгорле,soulflayer,863,paladin,holy,24,9,15
24244,Évo,drakthul,863,paladin,holy,24,9,15
24245,Этосальвабро,lich-king,863,paladin,holy,32,9,23
24246,Висперок,soulflayer,862,paladin,holy,12,9,3
24247,Yoanie,draenor,862,paladin,holy,12,9,3
24248,Niou,alleria,861,paladin,holy,24,9,15
24249,Mohamedx,tarren-mill,861,paladin,holy,24,9,15
24250,Ванябублгам,soulflayer,861,paladin,holy,24,9,15
24251,Firetorch,twisting-nether,861,paladin,holy,30,9,21
24252,Инблумхх,blackscar,860,paladin,holy,18,9,9
24253,Calipse,outland,860,paladin,holy,24,9,15
24254,Elfaza,uldum,860,paladin,holy,36,9,27
24255,Savitri,drakthul,859,paladin,holy,18,9,9
24256,Bjammin,burning-legion,859,paladin,holy,42,15,27
24257,Toxicmo,kazzak,858,paladin,holy,12,9,3
24258,Palolog,burning-legion,858,paladin,holy,49,10,39
24259,Smirk,aggra-português,857,paladin,holy,12,9,3
24260,Ырбис,soulflayer,857,paladin,holy,22,9,13
24261,Truko,frostwolf,857,paladin,holy,24,9,15
24262,Elganor,hyjal,856,paladin,holy,18,9,9
24263,Lurdz,sylvanas,855,paladin,holy,20,11,9
24264,Ауё,blackscar,855,paladin,holy,24,9,15
24265,Elisiell,turalyon,854,paladin,holy,18,9,9
24266,Degods,ravencrest,854,paladin,holy,18,9,9
24267,Burkaal,antonidas,852,paladin,holy,24,9,15
24268,Qyrija,malganis,845,paladin,holy,18,9,9
24269,Vanghelie,doomhammer,843,paladin,holy,24,11,13
24270,Tarhal,guldan,841,paladin,holy,18,9,9
24271,Veelris,kazzak,825,paladin,holy,72,33,39
24272,Миллагрессия,soulflayer,824,paladin,holy,143,59,84
24273,Odensson,sylvanas,823,paladin,holy,30,9,21
24274,Chantal,gilneas,822,paladin,holy,42,18,24
24275,Mustangs,archimonde,821,paladin,holy,45,15,30
24276,Arabicbomb,archimonde,819,paladin,holy,23,9,14
24277,Salubrifie,archimonde,817,paladin,holy,18,9,9
24278,Syrenia,die-silberne-hand,814,paladin,holy,40,9,31
24279,Pepegasensei,ravencrest,805,paladin,holy,19,10,9
24280,Marcosaurio,stormscale,800,paladin,holy,28,9,19
24281,Bbcanalyzed,blackmoore,798,paladin,holy,32,10,22
24282,Autyzmterror,silvermoon,795,paladin,holy,38,9,29
24283,Lèonarth,pozzo-delleternità,794,paladin,holy,22,10,12
24284,Pölark,archimonde,790,paladin,holy,41,14,27
24285,Palafrugell,sanguino,789,paladin,holy,32,13,19
24286,Oscardrei,norgannon,786,paladin,holy,30,10,20
24287,Халлейя,gordunni,768,paladin,holy,12,8,4
24288,Meldi,dalaran,768,paladin,holy,12,8,4
24289,Gayestpala,ravencrest,768,paladin,holy,18,8,10
24290,Imapala,tarren-mill,767,paladin,holy,12,8,4
24291,Ivailo,outland,767,paladin,holy,12,8,4
24292,Darkoulipal,ravencrest,767,paladin,holy,12,8,4
24293,Demytx,burning-legion,767,paladin,holy,16,9,7
24294,Micrøsi,thrall,767,paladin,holy,18,8,10
24295,Shiøn,zuljin,767,paladin,holy,18,8,10
24296,Defnotsikaan,blackhand,767,paladin,holy,18,8,10
24297,Qpax,twisting-nether,767,paladin,holy,18,8,10
24298,Spårvagn,draenor,767,paladin,holy,24,8,16
24299,Bezvakost,thunderhorn,766,paladin,holy,18,8,10
24300,Tytharion,silvermoon,766,paladin,holy,18,8,10
24301,Бебралом,howling-fjord,766,paladin,holy,18,8,10
24302,Thudor,ravencrest,766,paladin,holy,27,9,18
24303,Môdhân,archimonde,765,paladin,holy,12,8,4
24304,Coopz,defias-brotherhood,765,paladin,holy,18,8,10
24305,Bighammerx,ravencrest,765,paladin,holy,18,8,10
24306,Анофарин,gordunni,765,paladin,holy,18,8,10
24307,Спэнсэр,gordunni,764,paladin,holy,12,8,4
24308,Даняхгод,gordunni,763,paladin,holy,18,8,10
24309,Syfaria,eldrethalas,761,paladin,holy,18,8,10
24310,Ikbenmani,tarren-mill,760,paladin,holy,18,8,10
24311,Galadørn,elune,760,paladin,holy,24,8,16
24312,Wrede,the-maelstrom,760,paladin,holy,24,8,16
24313,Эвердрим,soulflayer,756,paladin,holy,30,12,18
24314,Kubrat,eredar,740,paladin,holy,84,28,56
24315,Оберинмартел,blackscar,731,paladin,holy,18,8,10
24316,Amnésía,twisting-nether,728,paladin,holy,23,8,15
24317,Anemonaa,argent-dawn,722,paladin,holy,18,8,10
24318,Pallnatoke,silvermoon,711,paladin,holy,29,9,20
24319,Ubiquitous,kazzak,700,paladin,holy,23,8,15
24320,Kárlsberg,aegwynn,683,paladin,holy,32,13,19
24321,Аидахо,gordunni,679,paladin,holy,31,12,19
24322,Yimnotprot,ravencrest,672,paladin,holy,12,7,5
24323,Gigajudge,blackrock,672,paladin,holy,12,7,5
24324,Электрокинг,lich-king,672,paladin,holy,12,7,5
24325,Babaluga,blackrock,672,paladin,holy,12,7,5
24326,Gtgpiscine,kirin-tor,672,paladin,holy,12,7,5
24327,Sínístèr,kazzak,672,paladin,holy,12,7,5
24328,Minpaladin,aegwynn,672,paladin,holy,16,8,8
24329,Léinãd,kazzak,672,paladin,holy,18,7,11
24330,Djalex,kazzak,672,paladin,holy,18,7,11
24331,Нетораре,howling-fjord,672,paladin,holy,18,7,11
24332,Вивай,howling-fjord,672,paladin,holy,18,7,11
24333,Achtfufzig,eredar,672,paladin,holy,18,7,11
24334,Istani,twisting-nether,672,paladin,holy,18,7,11
24335,Wizqy,ravencrest,672,paladin,holy,18,7,11
24336,Cahirs,ravencrest,672,paladin,holy,24,7,17
24337,Obviously,echsenkessel,672,paladin,holy,24,7,17
24338,Rápunzél,blackmoore,671,paladin,holy,12,7,5
24339,Daddysiliam,ravencrest,671,paladin,holy,12,7,5
24340,Хоулик,howling-fjord,671,paladin,holy,18,7,11
24341,Ämkaz,archimonde,671,paladin,holy,18,7,11
24342,Skatiaringos,silvermoon,671,paladin,holy,18,7,11
24343,Hampoof,blackrock,671,paladin,holy,18,7,11
24344,Ownkas,kazzak,670,paladin,holy,12,7,5
24345,Hølymaid,blackmoore,670,paladin,holy,12,7,5
24346,Pârabellum,the-maelstrom,670,paladin,holy,18,7,11
24347,Tyrallan,ragnaros,670,paladin,holy,24,7,17
24348,Videogame,twilights-hammer,669,paladin,holy,12,7,5
24349,Avengers,sylvanas,669,paladin,holy,12,7,5
24350,Med,malganis,669,paladin,holy,18,7,11
24351,Luckies,drakthul,668,paladin,holy,12,7,5
24352,Holyhooves,thrall,667,paladin,holy,12,7,5
24353,Eledhwen,mannoroth,667,paladin,holy,12,7,5
24354,Edwín,tichondrius,667,paladin,holy,12,7,5
24355,Luminix,ragnaros,667,paladin,holy,12,7,5
24356,Koreanpistol,aegwynn,667,paladin,holy,19,7,12
24357,Рамго,grom,665,paladin,holy,12,7,5
24358,Leadfoot,argent-dawn,665,paladin,holy,24,7,17
24359,Juicemachine,silvermoon,663,paladin,holy,12,7,5
24360,Oswoldio,ravencrest,659,paladin,holy,24,7,17
24361,Langibo,malfurion,658,paladin,holy,12,7,5
24362,Strugglebusx,outland,650,paladin,holy,19,9,10
24363,Finpála,kul-tiras,648,paladin,holy,13,9,4
24364,Jargot,antonidas,645,paladin,holy,18,7,11
24365,Rezilience,archimonde,639,paladin,holy,10,7,3
24366,Kansenbass,outland,637,paladin,holy,17,7,10
24367,Кизарыч,galakrond,624,paladin,holy,33,7,26
24368,Торсгард,howling-fjord,622,paladin,holy,15,8,7
24369,Meive,sanguino,622,paladin,holy,17,7,10
24370,Yezel,dalaran,621,paladin,holy,17,7,10
24371,Bonsamedi,garona,620,paladin,holy,27,8,19
24372,Djozeeph,burning-legion,618,paladin,holy,11,7,4
24373,Fluentx,ravencrest,618,paladin,holy,22,8,14
24374,Gunshøtx,archimonde,616,paladin,holy,28,10,18
24375,Пауэрлайт,blackscar,610,paladin,holy,34,9,25
24376,Catsnek,darksorrow,590,paladin,holy,19,7,12
24377,Дантепаладос,soulflayer,583,paladin,holy,49,7,42
24378,Holyfuchsia,ravencrest,576,paladin,holy,12,6,6
24379,Жухолова,howling-fjord,576,paladin,holy,12,6,6
24380,Держинский,gordunni,576,paladin,holy,12,6,6
24381,Nefarius,malganis,576,paladin,holy,12,6,6
24382,Roqu,nathrezim,576,paladin,holy,12,6,6
24383,Ajany,blackmoore,576,paladin,holy,12,6,6
24384,Bubblig,silvermoon,576,paladin,holy,12,6,6
24385,Kiingen,ragnaros,576,paladin,holy,12,6,6
24386,Iîvîl,ravencrest,576,paladin,holy,12,6,6
24387,Bapêe,thrall,576,paladin,holy,12,6,6
24388,Verlinya,archimonde,576,paladin,holy,12,6,6
24389,Хохахо,howling-fjord,576,paladin,holy,12,6,6
24390,Nádrüstál,kazzak,576,paladin,holy,12,6,6
24391,Ben,ghostlands,576,paladin,holy,12,6,6
24392,Fahqmeh,thrall,576,paladin,holy,12,6,6
24393,Linnea,kazzak,576,paladin,holy,18,6,12
24394,Westranspal,ravencrest,576,paladin,holy,18,6,12
24395,Демига,ashenvale,576,paladin,holy,18,6,12
24396,Amôn,outland,576,paladin,holy,28,6,22
24397,Heldarim,ysondre,576,paladin,holy,36,6,30
24398,Rohanan,blackrock,575,paladin,holy,12,6,6
24399,Dragonwingz,kazzak,575,paladin,holy,12,6,6
24400,Omgsoholy,stormscale,575,paladin,holy,12,6,6
24401,Friendadin,chamber-of-aspects,575,paladin,holy,12,6,6
24402,Cóól,cthun,575,paladin,holy,12,6,6
24403,Kraajp,stormscale,575,paladin,holy,12,6,6
24404,Lichbörnè,outland,575,paladin,holy,18,6,12
24405,Pussas,burning-legion,575,paladin,holy,18,6,12
24406,Холиэвил,gordunni,575,paladin,holy,18,6,12
24407,Zodshock,stormscale,575,paladin,holy,18,6,12
24408,Jeyløl,antonidas,574,paladin,holy,12,6,6
24409,Masuroc,antonidas,574,paladin,holy,12,6,6
24410,Talies,ravencrest,574,paladin,holy,12,6,6
24411,Holyherb,the-maelstrom,574,paladin,holy,12,6,6
24412,Elsirosel,dun-modr,574,paladin,holy,12,6,6
24413,Nezrus,dun-modr,574,paladin,holy,18,6,12
24414,Darthdin,stormscale,572,paladin,holy,12,6,6
24415,Rosemary,mugthol,570,paladin,holy,12,6,6
24416,Mýv,archimonde,568,paladin,holy,24,6,18
24417,Gaskohle,blackmoore,543,paladin,holy,17,6,11
24418,Nam,culte-de-la-rive-noire,527,paladin,holy,11,6,5
24419,Heavel,thrall,527,paladin,holy,17,6,11
24420,Elp,ysondre,526,paladin,holy,15,6,9
24421,Dragg,kirin-tor,522,paladin,holy,17,8,9
24422,Hearten,outland,512,paladin,holy,10,6,4
24423,Holÿbeard,ravencrest,495,paladin,holy,19,6,13
24424,Teksor,frostmourne,480,paladin,holy,6,5,1
24425,Tejbzx,blackmoore,480,paladin,holy,6,5,1
24426,Abroxis,alleria,480,paladin,holy,6,5,1
24427,Athàs,ysondre,480,paladin,holy,6,5,1
24428,Deliveröö,silvermoon,480,paladin,holy,6,5,1
24429,Shinesalot,kazzak,480,paladin,holy,6,5,1
24430,Æffy,nemesis,480,paladin,holy,6,5,1
24431,Bossedin,aszune,480,paladin,holy,12,5,7
24432,Sweetjane,deathwing,480,paladin,holy,12,5,7
24433,Kîsyhrâ,aegwynn,480,paladin,holy,12,5,7
24434,Ethurospal,tarren-mill,480,paladin,holy,12,5,7
24435,Holdmybible,the-maelstrom,480,paladin,holy,12,5,7
24436,Sumecbtw,aegwynn,480,paladin,holy,12,5,7
24437,Plaeschrmaex,aegwynn,480,paladin,holy,12,5,7
24438,Docoùla,twisting-nether,480,paladin,holy,12,5,7
24439,Stierchen,aegwynn,480,paladin,holy,12,5,7
24440,Înphy,cthun,480,paladin,holy,12,5,7
24441,Dimdon,silvermoon,480,paladin,holy,12,5,7
24442,Ÿani,argent-dawn,480,paladin,holy,12,5,7
24443,Astridx,kazzak,480,paladin,holy,12,5,7
24444,Ornosh,draenor,480,paladin,holy,12,5,7
24445,Listina,twisting-nether,480,paladin,holy,12,5,7
24446,Diffay,tarren-mill,480,paladin,holy,12,5,7
24447,Chodegobbler,draenor,480,paladin,holy,12,5,7
24448,Alennya,dalaran,480,paladin,holy,12,5,7
24449,Аффикстинка,soulflayer,480,paladin,holy,12,5,7
24450,Drdeus,silvermoon,480,paladin,holy,12,5,7
24451,Justix,arathor,480,paladin,holy,12,5,7
24452,Morthiel,burning-blade,480,paladin,holy,12,5,7
24453,Fluv,ravencrest,480,paladin,holy,12,5,7
24454,Lezin,thrall,480,paladin,holy,12,5,7
24455,Holydeals,silvermoon,480,paladin,holy,12,5,7
24456,Padrak,eredar,480,paladin,holy,12,5,7
24457,Санэрдин,soulflayer,480,paladin,holy,12,5,7
24458,Zunis,jaedenar,480,paladin,holy,12,5,7
24459,Glassbaren,draenor,480,paladin,holy,12,5,7
24460,Zaphiri,pozzo-delleternità,480,paladin,holy,12,5,7
24461,Fotmfactory,burning-blade,480,paladin,holy,12,5,7
24462,Snoogléface,grim-batol,480,paladin,holy,14,5,9
24463,Katsümï,archimonde,480,paladin,holy,18,5,13
24464,Холидугги,howling-fjord,480,paladin,holy,18,5,13
24465,Holydhanas,outland,480,paladin,holy,18,5,13
24466,Conker,malganis,480,paladin,holy,18,5,13
24467,Screws,dun-modr,480,paladin,holy,18,5,13
24468,Ãgra,hyjal,480,paladin,holy,18,5,13
24469,Palagrom,kazzak,480,paladin,holy,18,5,13
24470,Дюве,blackscar,480,paladin,holy,18,5,13
24471,Omgimapala,kazzak,480,paladin,holy,20,5,15
24472,Polixeni,draenor,480,paladin,holy,24,5,19
24473,Vilcochon,kaelthas,479,paladin,holy,6,5,1
24474,Руслаанеш,soulflayer,479,paladin,holy,12,5,7
24475,Малимон,soulflayer,479,paladin,holy,12,5,7
24476,Dreamwatcher,outland,479,paladin,holy,12,5,7
24477,Paluladin,turalyon,479,paladin,holy,12,5,7
24478,Лазуриса,deathguard,479,paladin,holy,12,5,7
24479,Spacepal,archimonde,479,paladin,holy,12,5,7
24480,Stinkytoes,draenor,479,paladin,holy,12,5,7
24481,Gavril,bloodfeather,479,paladin,holy,12,5,7
24482,Axpala,ragnaros,479,paladin,holy,12,5,7
24483,Erthelios,silvermoon,479,paladin,holy,17,5,12
24484,Vulgati,kazzak,479,paladin,holy,18,5,13
24485,Sultaani,ravencrest,479,paladin,holy,18,5,13
24486,Hùrikan,hyjal,479,paladin,holy,18,5,13
24487,Bellamy,vashj,479,paladin,holy,18,5,13
24488,Brölin,sanguino,479,paladin,holy,18,5,13
24489,Khalicies,archimonde,479,paladin,holy,30,5,25
24490,Omnimus,draenor,478,paladin,holy,6,5,1
24491,Radhya,sargeras,478,paladin,holy,12,5,7
24492,Bubblegum,dentarg,478,paladin,holy,18,5,13
24493,Kaedena,kaelthas,476,paladin,holy,12,5,7
24494,Styflor,dalaran,476,paladin,holy,18,5,13
24495,Grayscale,dun-morogh,476,paladin,holy,18,5,13
24496,Cenox,antonidas,475,paladin,holy,12,5,7
24497,Palabel,blackrock,475,paladin,holy,24,5,19
24498,Alone,sporeggar,473,paladin,holy,12,5,7
24499,Лералучшая,gordunni,464,paladin,holy,19,7,12
24500,Árcangel,minahonda,447,paladin,holy,17,5,12
24501,Himmelsfuror,proudmoore,445,paladin,holy,17,5,12
24502,Bämbunga,madmortem,426,paladin,holy,16,6,10
24503,Memewings,tarren-mill,426,paladin,holy,23,7,16
24504,Тейдехан,gordunni,426,paladin,holy,21,6,15
24505,Battalgazi,azjolnerub,423,paladin,holy,23,7,16
24506,Ralo,shattrath,415,paladin,holy,16,5,11
24507,Exødus,defias-brotherhood,414,paladin,holy,14,5,9
24508,Superpopa,twisting-nether,400,paladin,holy,13,5,8
24509,Idontknow,nemesis,384,paladin,holy,6,4,2
24510,Bloednicht,dentarg,384,paladin,holy,6,4,2
24511,Ринрэи,howling-fjord,384,paladin,holy,6,4,2
24512,Ellisdee,kazzak,384,paladin,holy,6,4,2
24513,Wiffy,ravencrest,384,paladin,holy,6,4,2
24514,Pastabianco,ravencrest,384,paladin,holy,6,4,2
24515,Rikiji,ravencrest,384,paladin,holy,6,4,2
24516,Wontbubblejk,tarren-mill,384,paladin,holy,6,4,2
24517,Kesq,ravencrest,384,paladin,holy,6,4,2
24518,Chewwaka,bloodhoof,384,paladin,holy,6,4,2
24519,Bjôrnstad,ravencrest,384,paladin,holy,6,4,2
24520,Shaleq,cthun,384,paladin,holy,12,4,8
24521,Waldpaladin,malganis,384,paladin,holy,12,4,8
24522,Superkudden,kazzak,384,paladin,holy,12,4,8
24523,Freý,ravencrest,384,paladin,holy,12,4,8
24524,Psikatchuu,hyjal,384,paladin,holy,12,4,8
24525,Akazâ,ysondre,384,paladin,holy,12,4,8
24526,Fedaikin,stormscale,384,paladin,holy,12,4,8
24527,Mooderna,ravencrest,384,paladin,holy,12,4,8
24528,Hammarfall,ravencrest,384,paladin,holy,12,4,8
24529,Visersion,tarren-mill,384,paladin,holy,12,4,8
24530,Bimylover,archimonde,384,paladin,holy,12,4,8
24531,Brüllt,dun-modr,384,paladin,holy,12,4,8
24532,Victwo,burning-legion,384,paladin,holy,12,4,8
24533,Nobodycanxit,twisting-nether,384,paladin,holy,12,4,8
24534,Vânwêêd,thrall,384,paladin,holy,12,4,8
24535,Sebatrøz,ravencrest,384,paladin,holy,12,4,8
24536,Бладиполи,soulflayer,384,paladin,holy,12,4,8
24537,Tyrø,ravencrest,384,paladin,holy,12,4,8
24538,Êggsy,grim-batol,384,paladin,holy,12,4,8
24539,Madlightsxd,dun-modr,384,paladin,holy,12,4,8
24540,Tharelion,twisting-nether,384,paladin,holy,12,4,8
24541,Chopocrisp,dun-modr,384,paladin,holy,12,4,8
24542,Pristín,blackhand,384,paladin,holy,12,4,8
24543,Shívah,auchindoun,384,paladin,holy,12,4,8
24544,Небулариум,howling-fjord,384,paladin,holy,12,4,8
24545,Imitrex,hyjal,384,paladin,holy,12,4,8
24546,Jokkepaappa,darksorrow,384,paladin,holy,12,4,8
24547,Padisonmeth,blackmoore,384,paladin,holy,12,4,8
24548,Divinemove,stormscale,384,paladin,holy,12,4,8
24549,Сакон,borean-tundra,384,paladin,holy,18,4,14
24550,Талрэн,howling-fjord,384,paladin,holy,18,4,14
24551,Лортремар,howling-fjord,384,paladin,holy,18,4,14
24552,Elfaza,dun-modr,384,paladin,holy,18,4,14
24553,Gardaken,draenor,384,paladin,holy,18,4,14
24554,Taxpayer,aegwynn,384,paladin,holy,24,4,20
24555,Гниленький,razuvious,384,paladin,holy,24,4,20
24556,Tôra,hyjal,383,paladin,holy,6,4,2
24557,Uoloop,kazzak,383,paladin,holy,12,4,8
24558,Anfe,silvermoon,383,paladin,holy,12,4,8
24559,Thorhum,moonglade,383,paladin,holy,12,4,8
24560,Rôlfzukowzky,guldan,383,paladin,holy,12,4,8
24561,Ênmâ,archimonde,383,paladin,holy,12,4,8
24562,Aggressìon,twisting-nether,383,paladin,holy,12,4,8
24563,Кэлви,blackscar,383,paladin,holy,12,4,8
24564,Caumon,los-errantes,383,paladin,holy,12,4,8
24565,Duine,the-venture-co,383,paladin,holy,12,4,8
24566,Grafes,sanguino,383,paladin,holy,12,4,8
24567,Allesandra,antonidas,383,paladin,holy,12,4,8
24568,Nyryon,ysondre,383,paladin,holy,18,4,14
24569,Superpaladin,draenor,383,paladin,holy,18,4,14
24570,Scissors,dun-morogh,383,paladin,holy,18,4,14
24571,Mortalitis,tarren-mill,383,paladin,holy,30,4,26
24572,Avengilo,silvermoon,382,paladin,holy,12,4,8
24573,Овахус,soulflayer,382,paladin,holy,12,4,8
24574,Thranduïl,tarren-mill,382,paladin,holy,18,4,14
24575,Nêkro,dun-modr,382,paladin,holy,18,4,14
24576,Preamx,blackrock,367,paladin,holy,11,4,7
24577,Konpala,blackmoore,367,paladin,holy,11,4,7
24578,Justyowx,archimonde,352,paladin,holy,16,5,11
24579,Xe,kaelthas,352,paladin,holy,16,4,12
24580,Browario,burning-legion,351,paladin,holy,11,4,7
24581,Soulskin,sylvanas,350,paladin,holy,11,4,7
24582,Liadry,sylvanas,329,paladin,holy,16,5,11
24583,Ysnee,sanguino,320,paladin,holy,16,4,12
24584,Tyralia,archimonde,288,paladin,holy,6,3,3
24585,Wäsabi,khaz-modan,288,paladin,holy,6,3,3
24586,Nikcsy,ragnaros,288,paladin,holy,6,3,3
24587,Tacodin,blackrock,288,paladin,holy,6,3,3
24588,Bandrogina,shattered-hand,288,paladin,holy,6,3,3
24589,Jogging,thrall,288,paladin,holy,6,3,3
24590,Mearsheimer,ysondre,288,paladin,holy,6,3,3
24591,Tadjmahal,ravencrest,288,paladin,holy,6,3,3
24592,Zunis,ravencrest,288,paladin,holy,6,3,3
24593,Trudi,arthas,288,paladin,holy,6,3,3
24594,Tyn,dragonmaw,288,paladin,holy,6,3,3
24595,Íva,twisting-nether,288,paladin,holy,6,3,3
24596,Kiwia,burning-legion,288,paladin,holy,6,3,3
24597,Naiconpala,kazzak,288,paladin,holy,6,3,3
24598,Гиркин,ashenvale,288,paladin,holy,6,3,3
24599,Solumon,gorgonnash,288,paladin,holy,6,3,3
24600,Unhittable,draenor,288,paladin,holy,6,3,3
24601,Yungboii,kazzak,288,paladin,holy,6,3,3
24602,Nidaime,zuljin,288,paladin,holy,6,3,3
24603,Lunalovesyou,blackmoore,288,paladin,holy,6,3,3
24604,Belzepal,blackrock,288,paladin,holy,6,3,3
24605,Holynoby,kazzak,288,paladin,holy,6,3,3
24606,Penthxoxo,outland,288,paladin,holy,6,3,3
24607,Vôltuxx,outland,288,paladin,holy,6,3,3
24608,Ramels,hyjal,288,paladin,holy,6,3,3
24609,Gulyas,tarren-mill,288,paladin,holy,6,3,3
24610,Runtheshow,deathwing,288,paladin,holy,10,4,6
24611,Lògàn,pozzo-delleternità,288,paladin,holy,9,3,6
24612,Tyraïa,archimonde,288,paladin,holy,12,3,9
24613,Влажныйбоб,soulflayer,288,paladin,holy,12,3,9
24614,Azthin,outland,288,paladin,holy,12,3,9
24615,Monaatamis,kazzak,288,paladin,holy,12,3,9
24616,Kelmarr,blackmoore,288,paladin,holy,12,3,9
24617,Arbuzno,draenor,288,paladin,holy,12,3,9
24618,Daneyholy,ravencrest,288,paladin,holy,12,3,9
24619,Telarii,die-nachtwache,288,paladin,holy,12,3,9
24620,Jctp,ravencrest,288,paladin,holy,12,3,9
24621,Chusterb,draenor,288,paladin,holy,12,3,9
24622,Vissticks,nagrand,288,paladin,holy,12,3,9
24623,Гуэргос,gordunni,288,paladin,holy,12,3,9
24624,Krayzier,nordrassil,288,paladin,holy,12,3,9
24625,Lifthorn,twisting-nether,288,paladin,holy,12,3,9
24626,Баблейми,gordunni,288,paladin,holy,12,3,9
24627,Bigdamjudge,argent-dawn,288,paladin,holy,12,3,9
24628,Breez,die-aldor,288,paladin,holy,12,3,9
24629,Hotchíck,outland,288,paladin,holy,12,3,9
24630,Zerohour,kilrogg,288,paladin,holy,12,3,9
24631,Linxo,argent-dawn,288,paladin,holy,12,3,9
24632,Nÿwa,temple-noir,288,paladin,holy,12,3,9
24633,Kaelorian,silvermoon,288,paladin,holy,18,3,15
24634,Averyholycow,the-maelstrom,287,paladin,holy,6,3,3
24635,Toxií,argent-dawn,287,paladin,holy,12,3,9
24636,Auliæ,chogall,287,paladin,holy,12,3,9
24637,Kcore,blackrock,287,paladin,holy,12,3,9
24638,Jellish,argent-dawn,287,paladin,holy,12,3,9
24639,Faustan,rexxar,287,paladin,holy,12,3,9
24640,Järnkroken,tarren-mill,287,paladin,holy,13,3,10
24641,Biót,tarren-mill,287,paladin,holy,18,3,15
24642,Мерасфард,howling-fjord,287,paladin,holy,18,3,15
24643,Zàrílâ,dun-morogh,286,paladin,holy,6,3,3
24644,Belgblue,ravenholdt,286,paladin,holy,6,3,3
24645,Lorithias,sargeras,286,paladin,holy,12,3,9
24646,Flamxd,blackmoore,234,paladin,holy,10,5,5
24647,Тамерланх,gordunni,234,paladin,holy,9,4,5
24648,Xila,blackrock,234,paladin,holy,9,4,5
24649,Mustardio,tarren-mill,234,paladin,holy,14,4,10
24650,Dewastør,blackmoore,234,paladin,holy,15,4,11
24651,Zeiserig,antonidas,234,paladin,holy,17,4,13
24652,Faranume,sylvanas,233,paladin,holy,16,4,12
24653,Elrack,blackhand,192,paladin,holy,6,2,4
24654,Heilbuch,durotan,192,paladin,holy,6,2,4
24655,Rane,arthas,192,paladin,holy,6,2,4
24656,Durnell,sylvanas,192,paladin,holy,6,2,4
24657,Eim,moonglade,192,paladin,holy,6,2,4
24658,Fruitschaal,moonglade,192,paladin,holy,6,2,4
24659,Tsomoo,antonidas,192,paladin,holy,6,2,4
24660,Keyla,los-errantes,192,paladin,holy,6,2,4
24661,Defianze,tarren-mill,192,paladin,holy,6,2,4
24662,Wvwwvwvwvwwv,ravencrest,192,paladin,holy,6,2,4
24663,Realdeal,argent-dawn,192,paladin,holy,6,2,4
24664,Palidi,tarren-mill,192,paladin,holy,6,2,4
24665,Pagadi,blackhand,192,paladin,holy,6,2,4
24666,Прожектор,gordunni,192,paladin,holy,6,2,4
24667,Palaneuía,antonidas,192,paladin,holy,6,2,4
24668,Böbble,twisting-nether,192,paladin,holy,6,2,4
24669,Yuz,archimonde,192,paladin,holy,6,2,4
24670,Poonky,dun-modr,192,paladin,holy,6,2,4
24671,Benedikt,stormscale,192,paladin,holy,6,2,4
24672,Lacertosus,nemesis,192,paladin,holy,6,2,4
24673,Bàrlo,kazzak,192,paladin,holy,6,2,4
24674,Edyk,silvermoon,192,paladin,holy,6,2,4
24675,Pátish,terenas,192,paladin,holy,6,2,4
24676,Skølir,rashgarroth,192,paladin,holy,6,2,4
24677,Холлихэйт,howling-fjord,192,paladin,holy,6,2,4
24678,Superpiniouf,archimonde,192,paladin,holy,6,2,4
24679,Galadrion,dun-modr,192,paladin,holy,6,2,4
24680,Unstobubblex,burning-blade,192,paladin,holy,6,2,4
24681,Teflonmagìc,ravencrest,192,paladin,holy,6,2,4
24682,Solazola,blackmoore,192,paladin,holy,6,2,4
24683,Rulîx,blackmoore,192,paladin,holy,6,2,4
24684,Alisonquínn,defias-brotherhood,192,paladin,holy,6,2,4
24685,Lompe,karazhan,192,paladin,holy,6,2,4
24686,Lafrogge,culte-de-la-rive-noire,192,paladin,holy,6,2,4
24687,Envli,ragnaros,192,paladin,holy,6,2,4
24688,Dafukx,ragnaros,192,paladin,holy,6,2,4
24689,Ришардебюр,soulflayer,192,paladin,holy,6,2,4
24690,Schukka,azshara,192,paladin,holy,6,2,4
24691,Xirôs,zirkel-des-cenarius,192,paladin,holy,6,2,4
24692,Botaref,kazzak,192,paladin,holy,6,2,4
24693,Lxvideoscom,blackrock,192,paladin,holy,6,2,4
24694,Holysac,kazzak,192,paladin,holy,6,2,4
24695,Kapigentil,suramar,192,paladin,holy,6,2,4
24696,Nirvanä,drakthul,192,paladin,holy,6,2,4
24697,Edgï,confrérie-du-thorium,192,paladin,holy,6,2,4
24698,Bígmachine,draenor,192,paladin,holy,6,2,4
24699,Andokaî,blackrock,192,paladin,holy,6,2,4
24700,Archîmondê,marécage-de-zangar,192,paladin,holy,6,2,4
24701,Паблойд,deathguard,192,paladin,holy,6,2,4
24702,Вишенций,howling-fjord,192,paladin,holy,12,2,10
24703,Bala,ravenholdt,192,paladin,holy,12,2,10
24704,Bígpumprz,archimonde,192,paladin,holy,12,2,10
24705,Essina,argent-dawn,192,paladin,holy,12,2,10
24706,Pichuflor,sanguino,192,paladin,holy,12,2,10
24707,Tsukaima,uldaman,192,paladin,holy,12,2,10
24708,Týr,forscherliga,192,paladin,holy,12,2,10
24709,Zeleron,darksorrow,192,paladin,holy,12,2,10
24710,Uldurin,ravencrest,192,paladin,holy,12,2,10
24711,Aienest,ragnaros,192,paladin,holy,12,2,10
24712,Keft,twisting-nether,192,paladin,holy,12,2,10
24713,Krièr,aggra-português,192,paladin,holy,12,2,10
24714,Ucu,terokkar,192,paladin,holy,12,2,10
24715,Kÿsse,hyjal,192,paladin,holy,12,2,10
24716,Theodun,xavius,192,paladin,holy,12,2,10
24717,Croptol,dun-modr,192,paladin,holy,12,2,10
24718,Кирюшафридом,gordunni,192,paladin,holy,13,2,11
24719,Bjutiful,silvermoon,192,paladin,holy,15,2,13
24720,Eky,stormreaver,192,paladin,holy,18,2,16
24721,Blancucky,kazzak,192,paladin,holy,18,2,16
24722,Getblessed,rexxar,192,paladin,holy,18,2,16
24723,Harycon,thrall,192,paladin,holy,24,2,22
24724,Jeunepadawan,dalaran,191,paladin,holy,6,2,4
24725,Aodren,varimathras,191,paladin,holy,6,2,4
24726,Tiboeufpéi,archimonde,191,paladin,holy,6,2,4
24727,Zuplex,deathwing,191,paladin,holy,6,2,4
24728,Chasie,antonidas,191,paladin,holy,12,2,10
24729,Droseros,sylvanas,175,paladin,holy,23,2,21
24730,Arshlicht,frostwolf,159,paladin,holy,5,2,3
24731,Orogerrabbit,archimonde,144,paladin,holy,3,3,0
24732,Drylink,kazzak,138,paladin,holy,11,3,8
24733,Pïñkñætðøðÿ,tarren-mill,138,paladin,holy,14,3,11
24734,Switchflip,frostmane,96,paladin,holy,6,1,5
24735,Xephiroxus,the-venture-co,96,paladin,holy,6,1,5
24736,Dedicatèd,draenor,96,paladin,holy,6,1,5
24737,Shanik,zuljin,96,paladin,holy,6,1,5
24738,Whiskeypal,draenor,96,paladin,holy,6,1,5
24739,Kyarï,culte-de-la-rive-noire,96,paladin,holy,6,1,5
24740,Visaria,twisting-nether,96,paladin,holy,6,1,5
24741,Lyciha,blackrock,96,paladin,holy,6,1,5
24742,Eàrànël,les-clairvoyants,96,paladin,holy,6,1,5
24743,Buladin,darkspear,96,paladin,holy,6,1,5
24744,Flashhèart,draenor,96,paladin,holy,6,1,5
24745,Tønyx,les-clairvoyants,96,paladin,holy,6,1,5
24746,Playprist,aegwynn,96,paladin,holy,6,1,5
24747,Tacita,nazjatar,96,paladin,holy,6,1,5
24748,Bubblebun,kazzak,96,paladin,holy,6,1,5
24749,Palariaan,defias-brotherhood,96,paladin,holy,6,1,5
24750,Wingcomander,aegwynn,96,paladin,holy,6,1,5
24751,Therador,dun-morogh,96,paladin,holy,6,1,5
24752,Xzarat,kazzak,96,paladin,holy,6,1,5
24753,Dobbygotsock,kazzak,96,paladin,holy,6,1,5
24754,Holyfalls,blackmoore,96,paladin,holy,6,1,5
24755,Bubbleheart,ahnqiraj,96,paladin,holy,6,1,5
24756,Пепсекольный,soulflayer,96,paladin,holy,6,1,5
24757,Хочусметанки,howling-fjord,96,paladin,holy,6,1,5
24758,Whatapity,silvermoon,96,paladin,holy,6,1,5
24759,Noanoshy,eredar,96,paladin,holy,6,1,5
24760,Enriel,temple-noir,96,paladin,holy,6,1,5
24761,Mínara,drakthul,96,paladin,holy,6,1,5
24762,Fükdîscláss,ravencrest,96,paladin,holy,6,1,5
24763,Nôxi,garona,96,paladin,holy,6,1,5
24764,Синерина,blackscar,96,paladin,holy,6,1,5
24765,Iamyellow,silvermoon,96,paladin,holy,6,1,5
24766,Agorasieya,frostwolf,96,paladin,holy,6,1,5
24767,Minirempart,khaz-modan,96,paladin,holy,6,1,5
24768,Andrøiz,dun-modr,96,paladin,holy,6,1,5
24769,Moobykin,stormscale,96,paladin,holy,6,1,5
24770,Nhum,destromath,96,paladin,holy,6,1,5
24771,Awer,magtheridon,96,paladin,holy,6,1,5
24772,Holysheto,sanguino,96,paladin,holy,6,1,5
24773,Rehtu,malganis,96,paladin,holy,6,1,5
24774,Eoox,outland,96,paladin,holy,6,1,5
24775,Belgradee,silvermoon,96,paladin,holy,6,1,5
24776,Razztafari,tarren-mill,96,paladin,holy,6,1,5
24777,Mybadvibes,tarren-mill,96,paladin,holy,6,1,5
24778,Bittersweex,stormscale,96,paladin,holy,6,1,5
24779,Lunaary,antonidas,96,paladin,holy,12,1,11
24780,Лейфи,howling-fjord,96,paladin,holy,12,1,11
24781,Veest,doomhammer,96,paladin,holy,12,1,11
24782,Pigma,outland,96,paladin,holy,12,1,11
24783,Zerafic,sylvanas,96,paladin,holy,12,1,11
24784,Mathelac,argent-dawn,96,paladin,holy,12,1,11
24785,Fúrion,burning-blade,96,paladin,holy,12,1,11
24786,Ganadorie,twisting-nether,96,paladin,holy,12,1,11
24787,Goldenstern,blackhand,96,paladin,holy,12,1,11
24788,Ahronius,stormscale,96,paladin,holy,12,1,11
24789,Encod,magtheridon,96,paladin,holy,12,1,11
24790,Hasler,drakthul,96,paladin,holy,12,1,11
24791,Callon,das-syndikat,95,paladin,holy,6,1,5
24792,Hancipapa,ragnaros,95,paladin,holy,6,1,5
24793,Laidevon,twisting-nether,84,paladin,holy,21,6,15
24794,Защешот,gordunni,79,paladin,holy,5,1,4
24795,Shaxxzii,kazzak,79,paladin,holy,5,1,4
24796,Firfiris,twisting-nether,64,paladin,holy,4,1,3
24797,Hitaki,tarren-mill,64,paladin,holy,4,1,3
24798,Barundarr,arthas,48,paladin,holy,9,1,8
24799,Jâybee,ravencrest,42,paladin,holy,8,2,6
24800,Holymerda,grim-batol,42,paladin,holy,8,2,6
24801,Xonika,outland,42,paladin,holy,9,2,7
24802,Waltgyubeef,argent-dawn,42,paladin,holy,9,2,7
24803,Xpurcica,twisting-nether,42,paladin,holy,10,2,8
24804,Acongojante,zuljin,42,paladin,holy,15,2,13
24805,Syruplol,blackrock,2387,paladin,retribution,117,69,48
24806,Pïkachû,ravencrest,2213,paladin,retribution,84,45,39
24807,Ctierpala,ravencrest,2161,paladin,retribution,90,47,43
24808,Ðâny,elune,2128,paladin,retribution,135,68,67
24809,Royki,the-maelstrom,2127,paladin,retribution,186,95,91
24810,Drkp,blackrock,2126,paladin,retribution,61,42,19
24811,Отловщик,gordunni,2123,paladin,retribution,82,43,39
24812,Âlßêdø,ravencrest,2118,paladin,retribution,201,102,99
24813,Mcweedy,aegwynn,2108,paladin,retribution,84,42,42
24814,Аеррис,gordunni,2106,paladin,retribution,113,57,56
24815,Bakawolf,burning-legion,2103,paladin,retribution,89,46,43
24816,Cosmicstâr,kazzak,2100,paladin,retribution,167,84,83
24817,Stracciatell,archimonde,2097,paladin,retribution,103,74,29
24818,Miilicium,archimonde,2091,paladin,retribution,83,41,42
24819,Sacredwrath,burning-legion,2089,paladin,retribution,65,35,30
24820,Ufø,magtheridon,2082,paladin,retribution,102,53,49
24821,Herrius,ravencrest,2076,paladin,retribution,84,41,43
24822,Ricexoxo,blackhand,2066,paladin,retribution,98,48,50
24823,Sonne,tarren-mill,2058,paladin,retribution,102,52,50
24824,Elypsia,tarren-mill,2058,paladin,retribution,104,53,51
24825,Mýstíc,ravencrest,2049,paladin,retribution,118,56,62
24826,Steelsuit,argent-dawn,2044,paladin,retribution,254,134,120
24827,Стимулин,howling-fjord,2034,paladin,retribution,126,67,59
24828,Davewins,dragonblight,2033,paladin,retribution,42,34,8
24829,Bigspin,ravencrest,2030,paladin,retribution,202,103,99
24830,Fkadin,kazzak,2028,paladin,retribution,137,77,60
24831,Miriokekw,archimonde,2027,paladin,retribution,102,48,54
24832,Nedith,pozzo-delleternità,2026,paladin,retribution,168,89,79
24833,Мевар,gordunni,2024,paladin,retribution,96,45,51
24834,Альмор,blackscar,2023,paladin,retribution,54,28,26
24835,Franclovis,hyjal,2019,paladin,retribution,63,28,35
24836,Qshadow,frostwhisper,2018,paladin,retribution,112,54,58
24837,Jowanno,stormscale,2013,paladin,retribution,107,57,50
24838,Bernhoftxd,ravencrest,2010,paladin,retribution,260,126,134
24839,Tròth,twisting-nether,2004,paladin,retribution,66,33,33
24840,Nîhil,silvermoon,2004,paladin,retribution,88,43,45
24841,Shinøaa,wrathbringer,2003,paladin,retribution,167,89,78
24842,Xourens,twisting-nether,2003,paladin,retribution,73,33,40
24843,Rankoneretri,arathor,2002,paladin,retribution,54,30,24
24844,Kazuroo,blackmoore,2002,paladin,retribution,102,56,46
24845,Retwar,ravencrest,1986,paladin,retribution,77,49,28
24846,Peiker,blackrock,1984,paladin,retribution,172,81,91
24847,Fullsendbro,ravencrest,1982,paladin,retribution,113,66,47
24848,Msharix,kazzak,1982,paladin,retribution,114,58,56
24849,Марчи,howling-fjord,1982,paladin,retribution,107,52,55
24850,Агинон,gordunni,1981,paladin,retribution,60,30,30
24851,Tj,dun-modr,1981,paladin,retribution,114,53,61
24852,Нейтхигерс,howling-fjord,1974,paladin,retribution,83,43,40
24853,Синодх,eversong,1974,paladin,retribution,101,46,55
24854,Аполодориан,gordunni,1972,paladin,retribution,120,64,56
24855,Vabz,blackrock,1968,paladin,retribution,65,30,35
24856,Sitekx,burning-legion,1968,paladin,retribution,99,45,54
24857,Mcret,ravencrest,1965,paladin,retribution,82,38,44
24858,Galaadh,archimonde,1960,paladin,retribution,78,35,43
24859,Xillindion,blackhand,1955,paladin,retribution,314,158,156
24860,Gluttön,tarren-mill,1954,paladin,retribution,83,42,41
24861,Legodudex,ravencrest,1954,paladin,retribution,72,36,36
24862,Greywords,silvermoon,1952,paladin,retribution,53,30,23
24863,Wingsteak,draenor,1952,paladin,retribution,81,44,37
24864,Beautýbeast,ravencrest,1950,paladin,retribution,125,65,60
24865,Martoretard,archimonde,1949,paladin,retribution,358,181,177
24866,Prex,dun-modr,1948,paladin,retribution,72,39,33
24867,Мрч,howling-fjord,1947,paladin,retribution,60,31,29
24868,Günykoloke,blackrock,1939,paladin,retribution,60,33,27
24869,Kriszi,burning-legion,1938,paladin,retribution,90,39,51
24870,Timmes,blackhand,1936,paladin,retribution,60,28,32
24871,Bigdblaster,twisting-nether,1935,paladin,retribution,102,49,53
24872,Запалтосик,blackscar,1934,paladin,retribution,36,23,13
24873,Doomsoom,kazzak,1931,paladin,retribution,46,34,12
24874,Spacknas,blackmoore,1931,paladin,retribution,110,62,48
24875,Pallyprinces,dentarg,1927,paladin,retribution,72,30,42
24876,Yungboii,kazzak,1925,paladin,retribution,95,61,34
24877,Monkeytm,archimonde,1923,paladin,retribution,64,28,36
24878,Kírin,drakthul,1921,paladin,retribution,66,32,34
24879,Nabbi,ravencrest,1921,paladin,retribution,72,30,42
24880,Retbùll,stormscale,1919,paladin,retribution,37,29,8
24881,Milkyavenger,sylvanas,1915,paladin,retribution,107,71,36
24882,Réfractio,die-aldor,1915,paladin,retribution,90,46,44
24883,Exolix,archimonde,1914,paladin,retribution,48,27,21
24884,Smilé,sylvanas,1911,paladin,retribution,84,44,40
24885,Реальныйпал,gordunni,1911,paladin,retribution,90,46,44
24886,Daybreak,kazzak,1911,paladin,retribution,69,34,35
24887,Vatix,trollbane,1911,paladin,retribution,66,31,35
24888,Mezor,dun-modr,1910,paladin,retribution,202,100,102
24889,Mélli,eredar,1907,paladin,retribution,99,55,44
24890,Tazken,tarren-mill,1906,paladin,retribution,96,48,48
24891,Littlelíght,silvermoon,1905,paladin,retribution,83,41,42
24892,Courage,stormscale,1902,paladin,retribution,71,37,34
24893,Yungboihoj,twisting-nether,1901,paladin,retribution,221,111,110
24894,Tadashì,aegwynn,1901,paladin,retribution,78,35,43
24895,Jualom,colinas-pardas,1900,paladin,retribution,68,35,33
24896,Rígel,silvermoon,1899,paladin,retribution,58,35,23
24897,Ðeathron,blackmoore,1898,paladin,retribution,128,62,66
24898,Byths,blackmoore,1896,paladin,retribution,127,56,71
24899,Harridin,ravencrest,1895,paladin,retribution,178,84,94
24900,Холирайз,gordunni,1894,paladin,retribution,42,21,21
24901,Лиспорий,gordunni,1894,paladin,retribution,60,29,31
24902,Zscrew,nemesis,1892,paladin,retribution,42,24,18
24903,Nastalia,elune,1892,paladin,retribution,101,54,47
24904,Brassaren,stormscale,1890,paladin,retribution,67,36,31
24905,Carlá,silvermoon,1890,paladin,retribution,73,37,36
24906,Eysn,blackrock,1890,paladin,retribution,60,30,30
24907,Pancakee,the-maelstrom,1889,paladin,retribution,66,32,34
24908,Rùuru,archimonde,1889,paladin,retribution,168,77,91
24909,Sloug,archimonde,1888,paladin,retribution,60,29,31
24910,Hojinson,blackrock,1883,paladin,retribution,60,39,21
24911,Kamata,kazzak,1883,paladin,retribution,57,28,29
24912,Biggerspin,ravencrest,1882,paladin,retribution,24,20,4
24913,Модрит,soulflayer,1882,paladin,retribution,70,47,23
24914,Bersercute,sylvanas,1882,paladin,retribution,124,60,64
24915,Толвард,gordunni,1881,paladin,retribution,25,21,4
24916,Jedzy,ragnaros,1881,paladin,retribution,42,24,18
24917,Tj,sanguino,1881,paladin,retribution,42,20,22
24918,Хохахо,howling-fjord,1880,paladin,retribution,54,32,22
24919,Меварх,howling-fjord,1878,paladin,retribution,42,22,20
24920,Melantus,eredar,1878,paladin,retribution,83,41,42
24921,Saygexx,draenor,1875,paladin,retribution,57,34,23
24922,Apolloos,grim-batol,1873,paladin,retribution,89,40,49
24923,Crysania,twisting-nether,1872,paladin,retribution,60,27,33
24924,Pâsla,hyjal,1871,paladin,retribution,158,81,77
24925,Hódle,silvermoon,1870,paladin,retribution,78,46,32
24926,Kjn,tarren-mill,1870,paladin,retribution,54,31,23
24927,Kiriel,dun-modr,1869,paladin,retribution,90,40,50
24928,Анофарин,gordunni,1868,paladin,retribution,153,77,76
24929,Zerørespect,ravencrest,1868,paladin,retribution,113,51,62
24930,Дэнискарз,gordunni,1866,paladin,retribution,48,26,22
24931,Thyrec,blackmoore,1865,paladin,retribution,54,32,22
24932,Sumecbtw,aegwynn,1865,paladin,retribution,49,24,25
24933,Hammarfall,ravencrest,1863,paladin,retribution,156,88,68
24934,Nellyrld,stormscale,1863,paladin,retribution,77,32,45
24935,Swahadon,stormscale,1862,paladin,retribution,60,29,31
24936,Davoss,outland,1862,paladin,retribution,63,29,34
24937,Holysiah,kazzak,1861,paladin,retribution,96,46,50
24938,Freshreroll,tarren-mill,1860,paladin,retribution,48,30,18
24939,Smirk,aggra-português,1860,paladin,retribution,102,46,56
24940,Mhehø,hyjal,1855,paladin,retribution,273,137,136
24941,Chyve,tarren-mill,1855,paladin,retribution,66,28,38
24942,Ollebala,ravencrest,1854,paladin,retribution,103,64,39
24943,Ðeusvult,draenor,1854,paladin,retribution,48,26,22
24944,Vanthael,chamber-of-aspects,1853,paladin,retribution,201,115,86
24945,Phix,outland,1853,paladin,retribution,165,81,84
24946,Alphaladin,stormscale,1852,paladin,retribution,54,31,23
24947,Hammerzemall,tarren-mill,1852,paladin,retribution,65,34,31
24948,Galenhad,kazzak,1852,paladin,retribution,84,41,43
24949,Jicob,ravencrest,1851,paladin,retribution,48,30,18
24950,Zion,runetotem,1851,paladin,retribution,42,25,17
24951,Dasar,twisting-nether,1851,paladin,retribution,72,31,41
24952,Súnshìne,blackhand,1850,paladin,retribution,42,29,13
24953,Clessington,die-aldor,1850,paladin,retribution,63,33,30
24954,Pog,azshara,1850,paladin,retribution,63,30,33
24955,Elganor,hyjal,1849,paladin,retribution,113,72,41
24956,Агинон,howling-fjord,1849,paladin,retribution,60,34,26
24957,Pætter,aggra-português,1849,paladin,retribution,60,34,26
24958,Jessrabit,tarren-mill,1848,paladin,retribution,54,25,29
24959,Nein,blackhand,1848,paladin,retribution,102,47,55
24960,Valkûn,rexxar,1846,paladin,retribution,66,32,34
24961,Exolia,archimonde,1845,paladin,retribution,54,30,24
24962,Dibzi,argent-dawn,1845,paladin,retribution,54,27,27
24963,Djstompyamom,stormscale,1845,paladin,retribution,99,47,52
24964,Risingfi,kult-der-verdammten,1844,paladin,retribution,78,47,31
24965,Nam,culte-de-la-rive-noire,1844,paladin,retribution,48,26,22
24966,Palior,sylvanas,1841,paladin,retribution,54,31,23
24967,Allenn,tarren-mill,1841,paladin,retribution,41,21,20
24968,Vadya,ravencrest,1840,paladin,retribution,187,95,92
24969,Retforlife,sylvanas,1839,paladin,retribution,42,26,16
24970,Hornyret,kazzak,1839,paladin,retribution,96,46,50
24971,Wingsmode,kazzak,1839,paladin,retribution,90,36,54
24972,Crîîngêr,blackhand,1838,paladin,retribution,44,24,20
24973,Holyhäätz,aegwynn,1838,paladin,retribution,63,33,30
24974,Zóran,kazzak,1838,paladin,retribution,78,38,40
24975,Surian,kazzak,1835,paladin,retribution,72,45,27
24976,Antimov,twisting-nether,1835,paladin,retribution,156,77,79
24977,Ophillan,draenor,1835,paladin,retribution,72,34,38
24978,Murkyxd,sanguino,1835,paladin,retribution,66,30,36
24979,Стьюпидбой,howling-fjord,1834,paladin,retribution,179,90,89
24980,Yuber,ravencrest,1833,paladin,retribution,78,34,44
24981,Сотранокинг,soulflayer,1832,paladin,retribution,36,20,16
24982,Riyo,twisting-nether,1832,paladin,retribution,48,21,27
24983,Skyf,outland,1832,paladin,retribution,80,33,47
24984,Miju,blackmoore,1831,paladin,retribution,51,28,23
24985,Ilòvekris,draenor,1831,paladin,retribution,195,99,96
24986,Neiiz,ragnaros,1831,paladin,retribution,76,34,42
24987,Baxuz,draenor,1830,paladin,retribution,64,33,31
24988,Декионзхц,howling-fjord,1830,paladin,retribution,78,29,49
24989,Ðaegos,blackmoore,1829,paladin,retribution,107,49,58
24990,Opettaja,ravencrest,1828,paladin,retribution,60,30,30
24991,Exolis,archimonde,1827,paladin,retribution,54,26,28
24992,Nizzlee,eredar,1827,paladin,retribution,90,43,47
24993,Denastys,nemesis,1827,paladin,retribution,72,31,41
24994,Dréamypie,silvermoon,1827,paladin,retribution,65,26,39
24995,Holzer,azshara,1826,paladin,retribution,65,35,30
24996,Maxes,twisting-nether,1826,paladin,retribution,60,29,31
24997,Lättäkamerus,ravencrest,1826,paladin,retribution,80,32,48
24998,Ablaa,blackhand,1825,paladin,retribution,36,21,15
24999,Tremelay,silvermoon,1825,paladin,retribution,240,122,118
25000,Eimaqt,stormscale,1825,paladin,retribution,70,33,37
25001,Zagwan,ravencrest,1824,paladin,retribution,90,51,39
25002,Игры,gordunni,1823,paladin,retribution,76,39,37
25003,Cqt,ravencrest,1823,paladin,retribution,66,30,36
25004,Keinah,silvermoon,1822,paladin,retribution,54,36,18
25005,Iagö,argent-dawn,1822,paladin,retribution,71,32,39
25006,Lorex,grim-batol,1821,paladin,retribution,54,26,28
25007,Ërzã,outland,1821,paladin,retribution,72,31,41
25008,Muhnnin,archimonde,1820,paladin,retribution,72,37,35
25009,Foreskinx,draenor,1819,paladin,retribution,42,25,17
25010,Номос,soulflayer,1819,paladin,retribution,72,41,31
25011,Arígato,argent-dawn,1819,paladin,retribution,173,95,78
25012,Дюрьвючыф,razuvious,1819,paladin,retribution,143,74,69
25013,Âtlas,ragnaros,1819,paladin,retribution,48,24,24
25014,Nìcky,stormscale,1819,paladin,retribution,83,37,46
25015,Bulkpwders,burning-legion,1818,paladin,retribution,42,20,22
25016,Wingsgodx,archimonde,1818,paladin,retribution,60,28,32
25017,Xsÿde,archimonde,1818,paladin,retribution,108,50,58
25018,Кошкотяночка,ashenvale,1818,paladin,retribution,54,23,31
25019,Nikkibenzqt,blackmoore,1818,paladin,retribution,84,35,49
25020,Taurski,sylvanas,1817,paladin,retribution,48,35,13
25021,Quelän,draenor,1817,paladin,retribution,47,29,18
25022,Hirako,nemesis,1817,paladin,retribution,72,39,33
25023,Thedarksteel,ravencrest,1817,paladin,retribution,70,34,36
25024,Calaestra,twisting-nether,1817,paladin,retribution,63,30,33
25025,Astragore,archimonde,1817,paladin,retribution,71,30,41
25026,Кхабелех,howling-fjord,1817,paladin,retribution,78,32,46
25027,Фэйсрол,gordunni,1817,paladin,retribution,93,37,56
25028,Jacadin,sunstrider,1816,paladin,retribution,54,34,20
25029,Шакиори,gordunni,1816,paladin,retribution,64,35,29
25030,Katanaclówn,eredar,1816,paladin,retribution,215,116,99
25031,Angryturk,ravencrest,1816,paladin,retribution,36,19,17
25032,Батллграунд,soulflayer,1815,paladin,retribution,90,50,40
25033,Соулерт,ashenvale,1815,paladin,retribution,54,28,26
25034,Madmartigane,ysondre,1815,paladin,retribution,114,48,66
25035,Wellick,ravencrest,1814,paladin,retribution,35,20,15
25036,Фемдом,blackscar,1814,paladin,retribution,48,27,21
25037,Wickedwings,silvermoon,1814,paladin,retribution,47,23,24
25038,Morri,ravencrest,1814,paladin,retribution,171,83,88
25039,Ганка,blackscar,1814,paladin,retribution,83,31,52
25040,Umîrînbrah,twisting-nether,1813,paladin,retribution,76,45,31
25041,Déna,draenor,1813,paladin,retribution,52,29,23
25042,Ktk,ravencrest,1813,paladin,retribution,121,67,54
25043,Rekktadin,grim-batol,1813,paladin,retribution,155,79,76
25044,Granfort,argent-dawn,1813,paladin,retribution,114,55,59
25045,Хадакур,howling-fjord,1813,paladin,retribution,60,27,33
25046,Торсгард,howling-fjord,1813,paladin,retribution,108,46,62
25047,Малиновыйбох,gordunni,1812,paladin,retribution,123,70,53
25048,Bangßros,archimonde,1812,paladin,retribution,54,30,24
25049,Durenai,aegwynn,1812,paladin,retribution,170,79,91
25050,Losër,ravencrest,1812,paladin,retribution,66,27,39
25051,Ykzy,hyjal,1811,paladin,retribution,36,24,12
25052,Elbígotes,dun-modr,1811,paladin,retribution,72,40,32
25053,Деленка,gordunni,1810,paladin,retribution,118,68,50
25054,Коварное,borean-tundra,1810,paladin,retribution,66,36,30
25055,Alloüt,outland,1809,paladin,retribution,37,20,17
25056,Ironquist,doomhammer,1809,paladin,retribution,42,22,20
25057,Bätïk,blackmoore,1809,paladin,retribution,60,30,30
25058,Purgebop,ravencrest,1808,paladin,retribution,45,30,15
25059,Mâttyy,stormscale,1808,paladin,retribution,66,29,37
25060,Ças,quelthalas,1808,paladin,retribution,72,30,42
25061,Kêkbûrâgol,kazzak,1807,paladin,retribution,42,26,16
25062,Wannabis,twisting-nether,1807,paladin,retribution,113,66,47
25063,Exolie,archimonde,1807,paladin,retribution,48,25,23
25064,Васапрагиб,howling-fjord,1806,paladin,retribution,60,35,25
25065,Bregowine,doomhammer,1806,paladin,retribution,243,137,106
25066,Malthred,ravenholdt,1806,paladin,retribution,171,91,80
25067,Weekly,outland,1806,paladin,retribution,36,19,17
25068,Аниф,ashenvale,1806,paladin,retribution,210,110,100
25069,Lightlogic,ravencrest,1806,paladin,retribution,71,35,36
25070,Réaxon,archimonde,1806,paladin,retribution,69,30,39
25071,Matriarchxd,kazzak,1805,paladin,retribution,48,24,24
25072,Vhardan,archimonde,1805,paladin,retribution,143,71,72
25073,Geneundreitt,dethecus,1805,paladin,retribution,54,26,28
25074,Îiî,archimonde,1805,paladin,retribution,45,21,24
25075,Магрейм,gordunni,1805,paladin,retribution,77,35,42
25076,Gimly,anachronos,1805,paladin,retribution,72,31,41
25077,Taneren,argent-dawn,1804,paladin,retribution,48,29,19
25078,Heiimdal,dun-morogh,1804,paladin,retribution,46,26,20
25079,Tsorig,tarren-mill,1804,paladin,retribution,177,98,79
25080,Zarrex,blackrock,1804,paladin,retribution,54,28,26
25081,Делимнаноль,blackscar,1804,paladin,retribution,183,92,91
25082,Netharia,antonidas,1804,paladin,retribution,120,59,61
25083,Блэканус,blackscar,1804,paladin,retribution,60,28,32
25084,Aqualisse,hyjal,1804,paladin,retribution,66,30,36
25085,Qpala,quelthalas,1803,paladin,retribution,36,19,17
25086,Flaapz,hyjal,1802,paladin,retribution,112,69,43
25087,Selina,burning-legion,1802,paladin,retribution,111,59,52
25088,Атмх,soulflayer,1802,paladin,retribution,54,28,26
25089,Antou,twisting-nether,1802,paladin,retribution,211,108,103
25090,Meruem,blackrock,1802,paladin,retribution,53,26,27
25091,Karadøc,archimonde,1802,paladin,retribution,90,41,49
25092,Ibnkrook,archimonde,1801,paladin,retribution,54,28,26
25093,Brõw,hyjal,1801,paladin,retribution,42,21,21
25094,Lesterqt,thrall,1801,paladin,retribution,114,54,60
25095,Delgato,kazzak,1800,paladin,retribution,152,80,72
25096,Zachäus,kirin-tor,1800,paladin,retribution,114,57,57
25097,Tauskiz,sylvanas,1800,paladin,retribution,48,19,29
25098,Мидэас,gordunni,1798,paladin,retribution,96,44,52
25099,Gladiator,die-aldor,1796,paladin,retribution,54,30,24
25100,Icekissz,hyjal,1795,paladin,retribution,24,19,5
25101,Телканапалке,blackscar,1795,paladin,retribution,48,35,13
25102,Pepehands,nazjatar,1795,paladin,retribution,54,27,27
25103,Papichuló,aegwynn,1794,paladin,retribution,96,45,51
25104,Zialo,ravencrest,1792,paladin,retribution,99,44,55
25105,Møøgødx,bronzebeard,1792,paladin,retribution,120,49,71
25106,Arayël,archimonde,1790,paladin,retribution,96,54,42
25107,Xairo,twisting-nether,1790,paladin,retribution,54,27,27
25108,Pestomp,tarren-mill,1789,paladin,retribution,65,28,37
25109,Pridehammer,stormscale,1788,paladin,retribution,48,31,17
25110,Ниашес,howling-fjord,1788,paladin,retribution,65,29,36
25111,Киото,gordunni,1788,paladin,retribution,48,19,29
25112,Simjon,defias-brotherhood,1787,paladin,retribution,181,102,79
25113,Elitest,hyjal,1787,paladin,retribution,73,34,39
25114,Guilt,aegwynn,1787,paladin,retribution,69,30,39
25115,ßlacklight,archimonde,1787,paladin,retribution,66,26,40
25116,Astilia,sylvanas,1785,paladin,retribution,90,44,46
25117,Kayllan,ravencrest,1784,paladin,retribution,113,65,48
25118,Кухонныйвор,howling-fjord,1784,paladin,retribution,54,29,25
25119,Mayhemx,ravencrest,1779,paladin,retribution,277,133,144
25120,Ромерл,gordunni,1778,paladin,retribution,107,58,49
25121,Posttal,aggra-português,1775,paladin,retribution,42,19,23
25122,Deriøt,dun-modr,1773,paladin,retribution,96,52,44
25123,Dacilez,ravencrest,1773,paladin,retribution,117,58,59
25124,Goofymits,twisting-nether,1772,paladin,retribution,60,32,28
25125,Skyrose,ravencrest,1772,paladin,retribution,162,86,76
25126,Vankwok,stormscale,1771,paladin,retribution,33,20,13
25127,Cheradin,ragnaros,1771,paladin,retribution,49,22,27
25128,Répo,twisting-nether,1770,paladin,retribution,42,22,20
25129,Riares,darkspear,1768,paladin,retribution,103,53,50
25130,Dalemiar,ravencrest,1767,paladin,retribution,117,55,62
25131,ßancu,ragnaros,1767,paladin,retribution,54,22,32
25132,Алепос,soulflayer,1766,paladin,retribution,54,21,33
25133,Valterus,burning-legion,1765,paladin,retribution,84,40,44
25134,Refuse,blackrock,1761,paladin,retribution,89,43,46
25135,Ослепителен,eversong,1761,paladin,retribution,60,26,34
25136,Tsunà,antonidas,1760,paladin,retribution,48,21,27
25137,Sofhiya,silvermoon,1759,paladin,retribution,42,24,18
25138,Опгоп,gordunni,1758,paladin,retribution,89,45,44
25139,Tanny,kazzak,1758,paladin,retribution,66,29,37
25140,Extremnäsa,outland,1758,paladin,retribution,102,43,59
25141,Tcret,sanguino,1757,paladin,retribution,47,25,22
25142,Saabnaab,outland,1754,paladin,retribution,216,126,90
25143,Naneno,silvermoon,1754,paladin,retribution,63,30,33
25144,Zubxp,ravencrest,1753,paladin,retribution,76,37,39
25145,Данхайк,gordunni,1750,paladin,retribution,114,68,46
25146,Loratheon,stormscale,1745,paladin,retribution,36,22,14
25147,Hýox,malganis,1745,paladin,retribution,55,27,28
25148,Darkkissret,lightbringer,1745,paladin,retribution,66,28,38
25149,Akoumb,twisting-nether,1743,paladin,retribution,108,58,50
25150,Molgran,defias-brotherhood,1743,paladin,retribution,102,45,57
25151,Justyowx,archimonde,1740,paladin,retribution,42,20,22
25152,Мува,soulflayer,1739,paladin,retribution,62,29,33
25153,Мегопалл,blackscar,1738,paladin,retribution,90,38,52
25154,Jíyü,blackmoore,1737,paladin,retribution,42,23,19
25155,Холиврас,gordunni,1737,paladin,retribution,36,19,17
25156,Plarbo,blackmoore,1737,paladin,retribution,66,32,34
25157,Halevia,kazzak,1737,paladin,retribution,71,32,39
25158,Tekåpal,tarren-mill,1736,paladin,retribution,72,34,38
25159,Охоху,gordunni,1735,paladin,retribution,113,61,52
25160,Caladys,silvermoon,1735,paladin,retribution,91,49,42
25161,Valnyr,the-maelstrom,1735,paladin,retribution,66,35,31
25162,Liendry,antonidas,1735,paladin,retribution,53,28,25
25163,Солошафл,howling-fjord,1735,paladin,retribution,48,24,24
25164,Shakkur,varimathras,1734,paladin,retribution,36,23,13
25165,Bajheeroth,kazzak,1734,paladin,retribution,78,49,29
25166,Ruath,xavius,1734,paladin,retribution,112,58,54
25167,Yana,blackrock,1733,paladin,retribution,49,26,23
25168,Kanyewesh,dalaran,1733,paladin,retribution,42,21,21
25169,Johannx,tarren-mill,1733,paladin,retribution,198,96,102
25170,Vanques,burning-legion,1732,paladin,retribution,41,20,21
25171,Лакостик,howling-fjord,1732,paladin,retribution,66,31,35
25172,Zazalamel,hyjal,1731,paladin,retribution,48,28,20
25173,Ÿani,argent-dawn,1730,paladin,retribution,42,25,17
25174,Justivo,tarren-mill,1730,paladin,retribution,67,39,28
25175,Claymore,ravenholdt,1730,paladin,retribution,59,24,35
25176,Runhexi,silvermoon,1728,paladin,retribution,169,91,78
25177,Чупаа,howling-fjord,1728,paladin,retribution,88,47,41
25178,Пинкпуссибой,howling-fjord,1727,paladin,retribution,58,32,26
25179,Inkzen,silvermoon,1727,paladin,retribution,42,22,20
25180,Sántouryu,ravencrest,1725,paladin,retribution,269,135,134
25181,Elisight,ravencrest,1724,paladin,retribution,48,25,23
25182,Mouku,stormreaver,1724,paladin,retribution,66,29,37
25183,Mimð,kazzak,1723,paladin,retribution,42,24,18
25184,Trølled,aegwynn,1722,paladin,retribution,168,81,87
25185,Лайтфури,gordunni,1722,paladin,retribution,42,19,23
25186,Sübôvîñ,ravencrest,1721,paladin,retribution,71,40,31
25187,Djrayk,archimonde,1721,paladin,retribution,36,18,18
25188,Miru,defias-brotherhood,1719,paladin,retribution,30,18,12
25189,Dankin,pozzo-delleternità,1719,paladin,retribution,58,31,27
25190,Milipal,hyjal,1719,paladin,retribution,36,18,18
25191,Bigbuffdaddy,draenor,1718,paladin,retribution,328,165,163
25192,Ezetrol,xavius,1718,paladin,retribution,42,20,22
25193,Xeaa,tarren-mill,1718,paladin,retribution,42,18,24
25194,Highfivè,ravencrest,1717,paladin,retribution,48,28,20
25195,Xinze,ravencrest,1716,paladin,retribution,42,24,18
25196,Xyzl,argent-dawn,1715,paladin,retribution,108,66,42
25197,Larnbert,argent-dawn,1715,paladin,retribution,54,27,27
25198,Ryxxii,ravencrest,1715,paladin,retribution,54,26,28
25199,Beigerbala,blackrock,1715,paladin,retribution,42,18,24
25200,Testør,ragnaros,1714,paladin,retribution,123,55,68
25201,Honorkill,silvermoon,1713,paladin,retribution,211,118,93
25202,Русэльф,howling-fjord,1713,paladin,retribution,105,56,49
25203,Fullflavor,bladefist,1713,paladin,retribution,90,39,51
25204,Wingsuit,eredar,1713,paladin,retribution,62,25,37
25205,Dannyvye,outland,1712,paladin,retribution,48,21,27
25206,Guskey,draenor,1711,paladin,retribution,72,39,33
25207,Odin,silvermoon,1711,paladin,retribution,77,41,36
25208,Lazaraat,antonidas,1711,paladin,retribution,65,25,40
25209,Kinvqt,tarren-mill,1710,paladin,retribution,76,36,40
25210,Matinacc,tarren-mill,1709,paladin,retribution,30,18,12
25211,Slapmedaddy,die-ewige-wacht,1709,paladin,retribution,54,29,25
25212,Ayylmeow,tarren-mill,1709,paladin,retribution,56,28,28
25213,Ilikejudge,blackmoore,1709,paladin,retribution,96,43,53
25214,Deidâra,blackhand,1709,paladin,retribution,42,18,24
25215,Shockashy,stormscale,1708,paladin,retribution,56,31,25
25216,Drownlord,eredar,1707,paladin,retribution,30,18,12
25217,Wickedret,kazzak,1707,paladin,retribution,30,18,12
25218,Zarispal,tarren-mill,1707,paladin,retribution,39,23,16
25219,Релаин,gordunni,1707,paladin,retribution,60,27,33
25220,Starcker,sanguino,1707,paladin,retribution,72,24,48
25221,Sigmud,turalyon,1706,paladin,retribution,42,23,19
25222,Babaluga,blackrock,1706,paladin,retribution,42,21,21
25223,Gùtz,xavius,1704,paladin,retribution,57,27,30
25224,Draìgo,nemesis,1703,paladin,retribution,35,21,14
25225,Alatie,dentarg,1703,paladin,retribution,84,45,39
25226,Яидваклоуна,soulflayer,1703,paladin,retribution,36,18,18
25227,Dominikcro,sylvanas,1702,paladin,retribution,30,18,12
25228,Nutqtgodx,archimonde,1702,paladin,retribution,36,21,15
25229,Gwynel,argent-dawn,1702,paladin,retribution,60,28,32
25230,Pârabellum,the-maelstrom,1702,paladin,retribution,93,40,53
25231,Витурус,howling-fjord,1702,paladin,retribution,72,28,44
25232,Winkz,rajaxx,1701,paladin,retribution,36,18,18
25233,Cowwithspell,stormscale,1701,paladin,retribution,122,60,62
25234,Dainan,blackmoore,1701,paladin,retribution,134,65,69
25235,Mirøku,silvermoon,1701,paladin,retribution,79,37,42
25236,Baraya,archimonde,1701,paladin,retribution,41,19,22
25237,Thórvaldr,argent-dawn,1700,paladin,retribution,54,30,24
25238,Mordar,ravencrest,1700,paladin,retribution,67,33,34
25239,Staticdeath,ravencrest,1699,paladin,retribution,240,123,117
25240,Ðenlox,destromath,1699,paladin,retribution,72,29,43
25241,Холихит,gordunni,1698,paladin,retribution,100,50,50
25242,Smirky,silvermoon,1697,paladin,retribution,42,20,22
25243,Rullatôrsven,stormscale,1697,paladin,retribution,48,18,30
25244,Mefrandie,frostwolf,1696,paladin,retribution,42,24,18
25245,Glàdiator,outland,1696,paladin,retribution,81,38,43
25246,Qarak,argent-dawn,1695,paladin,retribution,71,32,39
25247,Алекхей,gordunni,1695,paladin,retribution,80,29,51
25248,Zayaka,ragnaros,1695,paladin,retribution,90,32,58
25249,Яправ,borean-tundra,1694,paladin,retribution,66,38,28
25250,Lecutus,sunstrider,1694,paladin,retribution,99,42,57
25251,Dragonwingz,kazzak,1693,paladin,retribution,40,24,16
25252,Salti,magtheridon,1693,paladin,retribution,142,77,65
25253,Starworkal,ragnaros,1693,paladin,retribution,70,36,34
25254,Сводимиаое,soulflayer,1692,paladin,retribution,52,24,28
25255,Rli,twisting-nether,1691,paladin,retribution,80,41,39
25256,Инфернох,howling-fjord,1691,paladin,retribution,155,78,77
25257,Эвангер,gordunni,1691,paladin,retribution,48,22,26
25258,Almighty,ravencrest,1690,paladin,retribution,66,28,38
25259,Jout,tarren-mill,1689,paladin,retribution,144,73,71
25260,Bubbleteâ,blackhand,1688,paladin,retribution,78,35,43
25261,Lightsaint,kazzak,1687,paladin,retribution,66,37,29
25262,Утипутя,goldrinn,1687,paladin,retribution,48,21,27
25263,Зондарк,booty-bay,1687,paladin,retribution,77,33,44
25264,Holyshet,blackrock,1686,paladin,retribution,79,44,35
25265,Ertheus,argent-dawn,1686,paladin,retribution,54,25,29
25266,Yo,azshara,1684,paladin,retribution,66,34,32
25267,Mistérion,archimonde,1683,paladin,retribution,66,27,39
25268,Thàø,chants-éternels,1682,paladin,retribution,58,30,28
25269,Yséria,kirin-tor,1682,paladin,retribution,72,35,37
25270,Вайлдбебриз,eversong,1680,paladin,retribution,48,32,16
25271,Бэйгреон,gordunni,1680,paladin,retribution,142,81,61
25272,Данбро,borean-tundra,1680,paladin,retribution,60,29,31
25273,Instaquez,stormscale,1679,paladin,retribution,97,50,47
25274,Varunyyo,blackrock,1679,paladin,retribution,82,40,42
25275,Møg,blackrock,1679,paladin,retribution,59,24,35
25276,Dudjaw,stormscale,1679,paladin,retribution,96,38,58
25277,Obackbarama,outland,1678,paladin,retribution,42,23,19
25278,Ratklng,ravencrest,1677,paladin,retribution,72,47,25
25279,Blakethorn,silvermoon,1676,paladin,retribution,36,18,18
25280,Cursedd,sanguino,1675,paladin,retribution,30,18,12
25281,Scorebit,draenor,1675,paladin,retribution,41,19,22
25282,Socx,outland,1675,paladin,retribution,60,21,39
25283,Mcfëë,ysondre,1673,paladin,retribution,95,50,45
25284,Lílou,blackmoore,1673,paladin,retribution,57,30,27
25285,Bjornulfr,ravencrest,1673,paladin,retribution,107,46,61
25286,Justyferr,nemesis,1673,paladin,retribution,93,38,55
25287,Wootschi,arthas,1672,paladin,retribution,59,30,29
25288,Eldrial,argent-dawn,1672,paladin,retribution,65,32,33
25289,Shanice,twilights-hammer,1671,paladin,retribution,42,23,19
25290,Tyri,silvermoon,1671,paladin,retribution,96,50,46
25291,Дракула,howling-fjord,1671,paladin,retribution,102,53,49
25292,Грайндсет,galakrond,1671,paladin,retribution,41,18,23
25293,Shmndr,kazzak,1670,paladin,retribution,42,24,18
25294,Mainôs,ravencrest,1670,paladin,retribution,42,22,20
25295,Kaileena,archimonde,1669,paladin,retribution,42,25,17
25296,Puers,burning-blade,1669,paladin,retribution,35,20,15
25297,Bullsy,kazzak,1669,paladin,retribution,62,32,30
25298,Merkury,sanguino,1669,paladin,retribution,48,21,27
25299,Xciepo,rexxar,1669,paladin,retribution,66,28,38
25300,Дохлаяженах,gordunni,1668,paladin,retribution,36,20,16
25301,Bigducc,draenor,1668,paladin,retribution,47,22,25
25302,Saintseiya,pozzo-delleternità,1667,paladin,retribution,36,23,13
25303,Xtekz,tarren-mill,1667,paladin,retribution,62,33,29
25304,Youmistpew,antonidas,1667,paladin,retribution,48,19,29
25305,Pingla,argent-dawn,1666,paladin,retribution,37,23,14
25306,Holymerda,grim-batol,1666,paladin,retribution,47,23,24
25307,Hèllkeepêr,archimonde,1666,paladin,retribution,41,20,21
25308,Hojacat,ravencrest,1665,paladin,retribution,36,20,16
25309,Оззмо,howling-fjord,1665,paladin,retribution,165,85,80
25310,Korendil,frostmane,1665,paladin,retribution,60,25,35
25311,Keft,twisting-nether,1664,paladin,retribution,47,25,22
25312,Zeggayodax,nemesis,1663,paladin,retribution,42,22,20
25313,Ivarladin,draenor,1663,paladin,retribution,66,30,36
25314,Vickdicator,stormscale,1663,paladin,retribution,68,30,38
25315,Deadholland,ravencrest,1662,paladin,retribution,140,73,67
25316,Pruntadin,silvermoon,1661,paladin,retribution,78,36,42
25317,Denounce,defias-brotherhood,1661,paladin,retribution,57,22,35
25318,Sünlight,nemesis,1660,paladin,retribution,116,54,62
25319,Bumaye,tarren-mill,1659,paladin,retribution,42,24,18
25320,Focuspally,outland,1659,paladin,retribution,54,29,25
25321,Âyasê,blackhand,1659,paladin,retribution,100,49,51
25322,Meìster,blackmoore,1658,paladin,retribution,63,30,33
25323,Limitles,nemesis,1658,paladin,retribution,51,19,32
25324,Misako,sanguino,1657,paladin,retribution,124,62,62
25325,Trendragon,argent-dawn,1657,paladin,retribution,41,19,22
25326,Drakingsang,blackhand,1657,paladin,retribution,84,35,49
25327,Auriuss,defias-brotherhood,1656,paladin,retribution,177,95,82
25328,Kouyhalaide,hyjal,1656,paladin,retribution,48,24,24
25329,Warmâchiine,burning-legion,1655,paladin,retribution,143,75,68
25330,Telionrootan,die-aldor,1655,paladin,retribution,58,29,29
25331,Novania,perenolde,1655,paladin,retribution,69,32,37
25332,Ёйхйё,blackscar,1654,paladin,retribution,109,62,47
25333,Niou,alleria,1654,paladin,retribution,53,27,26
25334,Vuup,silvermoon,1654,paladin,retribution,72,35,37
25335,Сёмаигрок,soulflayer,1654,paladin,retribution,54,26,28
25336,Aylion,blackrock,1653,paladin,retribution,42,28,14
25337,Earendìl,blackmoore,1653,paladin,retribution,54,31,23
25338,Zynuwu,blackmoore,1653,paladin,retribution,42,22,20
25339,Ruotollo,ravencrest,1653,paladin,retribution,51,23,28
25340,Valin,frostmane,1653,paladin,retribution,66,29,37
25341,Irondawg,rajaxx,1653,paladin,retribution,56,21,35
25342,Rugila,ragnaros,1652,paladin,retribution,164,93,71
25343,Íbossít,doomhammer,1652,paladin,retribution,66,36,30
25344,Райтивуд,howling-fjord,1652,paladin,retribution,110,58,52
25345,Modeladin,ragnaros,1652,paladin,retribution,70,32,38
25346,Xila,blackrock,1652,paladin,retribution,60,24,36
25347,Gaalarr,burning-legion,1650,paladin,retribution,36,20,16
25348,Palwig,tarren-mill,1650,paladin,retribution,148,78,70
25349,Harlequina,argent-dawn,1650,paladin,retribution,40,20,20
25350,Zuveron,the-maelstrom,1650,paladin,retribution,54,23,31
25351,Screws,dun-modr,1650,paladin,retribution,54,22,32
25352,Unschúld,blackrock,1649,paladin,retribution,127,71,56
25353,Aederec,argent-dawn,1649,paladin,retribution,78,42,36
25354,Shenwarr,twisting-nether,1649,paladin,retribution,36,19,17
25355,Хаспадин,gordunni,1649,paladin,retribution,42,21,21
25356,Elisabeth,kazzak,1648,paladin,retribution,72,31,41
25357,Spegepølse,silvermoon,1647,paladin,retribution,74,42,32
25358,Namapala,silvermoon,1647,paladin,retribution,95,46,49
25359,Reito,eredar,1647,paladin,retribution,60,28,32
25360,Wakke,outland,1646,paladin,retribution,32,23,9
25361,Exoblade,twisting-nether,1646,paladin,retribution,72,40,32
25362,Saintys,sylvanas,1646,paladin,retribution,68,36,32
25363,Сандалар,gordunni,1646,paladin,retribution,54,24,30
25364,Batteldin,blackmoore,1644,paladin,retribution,152,89,63
25365,Cîzzar,burning-legion,1644,paladin,retribution,153,85,68
25366,Аилерия,howling-fjord,1644,paladin,retribution,248,134,114
25367,Bubbledøtcøm,blackmoore,1644,paladin,retribution,60,29,31
25368,Xòtrios,argent-dawn,1643,paladin,retribution,48,24,24
25369,Milkadìn,twisting-nether,1642,paladin,retribution,66,35,31
25370,Ysell,sargeras,1642,paladin,retribution,62,31,31
25371,Nøvå,ravencrest,1642,paladin,retribution,78,36,42
25372,Panicmaker,ravencrest,1641,paladin,retribution,42,28,14
25373,Bikkuz,kazzak,1641,paladin,retribution,42,28,14
25374,Gigasack,ravencrest,1641,paladin,retribution,36,23,13
25375,Саймум,blackscar,1641,paladin,retribution,57,29,28
25376,Powerpuffret,antonidas,1640,paladin,retribution,72,40,32
25377,Иев,howling-fjord,1640,paladin,retribution,53,23,30
25378,Димасгачи,gordunni,1638,paladin,retribution,42,32,10
25379,Аскеттх,gordunni,1638,paladin,retribution,66,33,33
25380,Zeroeffect,blackhand,1638,paladin,retribution,48,24,24
25381,Zaaen,burning-legion,1637,paladin,retribution,84,45,39
25382,Brabop,zirkel-des-cenarius,1637,paladin,retribution,42,22,20
25383,Tîrana,ysondre,1637,paladin,retribution,69,31,38
25384,Dízeltekurva,ragnaros,1636,paladin,retribution,42,21,21
25385,Bancu,outland,1636,paladin,retribution,36,18,18
25386,Badbuññy,sylvanas,1636,paladin,retribution,54,24,30
25387,Skoopey,twisting-nether,1636,paladin,retribution,54,23,31
25388,Trenvendor,ravencrest,1635,paladin,retribution,33,22,11
25389,Mácá,outland,1635,paladin,retribution,30,20,10
25390,Naexea,archimonde,1635,paladin,retribution,60,28,32
25391,Kýríl,antonidas,1635,paladin,retribution,44,18,26
25392,Arturius,ravencrest,1634,paladin,retribution,60,30,30
25393,Djandja,blackrock,1634,paladin,retribution,59,29,30
25394,Breakdøwñ,blackrock,1634,paladin,retribution,148,63,85
25395,Palagray,blackmoore,1633,paladin,retribution,173,100,73
25396,Retaxx,outland,1633,paladin,retribution,36,19,17
25397,Прожектор,gordunni,1633,paladin,retribution,48,25,23
25398,Theladrie,blackhand,1632,paladin,retribution,48,24,24
25399,Itsgossiplol,twisting-nether,1632,paladin,retribution,74,30,44
25400,Flipzz,blackrock,1631,paladin,retribution,26,18,8
25401,Needel,argent-dawn,1631,paladin,retribution,47,26,21
25402,Кавайнекс,azuregos,1631,paladin,retribution,134,67,67
25403,Draizor,twisting-nether,1631,paladin,retribution,89,42,47
25404,Батллграунт,soulflayer,1630,paladin,retribution,101,64,37
25405,Ibuc,blackrock,1630,paladin,retribution,36,21,15
25406,Djcurry,archimonde,1630,paladin,retribution,30,17,13
25407,Кельритос,soulflayer,1630,paladin,retribution,64,28,36
25408,Antsh,nemesis,1629,paladin,retribution,36,22,14
25409,Bobiwan,ravencrest,1629,paladin,retribution,30,17,13
25410,Krîstal,aegwynn,1629,paladin,retribution,41,20,21
25411,Ønlyfâns,dragonblight,1629,paladin,retribution,78,34,44
25412,Akrobatka,sanguino,1629,paladin,retribution,76,33,43
25413,Gilet,argent-dawn,1628,paladin,retribution,30,18,12
25414,Tyrael,darksorrow,1628,paladin,retribution,200,100,100
25415,Wyllian,grim-batol,1628,paladin,retribution,48,23,25
25416,Suprisexd,ravencrest,1628,paladin,retribution,42,20,22
25417,Коссандра,greymane,1628,paladin,retribution,47,21,26
25418,Таптыгин,gordunni,1628,paladin,retribution,54,23,31
25419,Lifepower,nemesis,1627,paladin,retribution,34,21,13
25420,Эйзенхорн,grom,1626,paladin,retribution,42,23,19
25421,Торсгад,gordunni,1626,paladin,retribution,42,23,19
25422,Crusshqt,silvermoon,1626,paladin,retribution,126,63,63
25423,Zeusp,archimonde,1626,paladin,retribution,42,21,21
25424,Zarron,blackrock,1626,paladin,retribution,42,20,22
25425,Serratus,thunderhorn,1626,paladin,retribution,50,22,28
25426,Ragen,kazzak,1626,paladin,retribution,48,21,27
25427,Kasualwrath,stormscale,1625,paladin,retribution,30,17,13
25428,Strykar,aggra-português,1625,paladin,retribution,42,19,23
25429,Bluehustler,tarren-mill,1625,paladin,retribution,117,48,69
25430,Wyzpal,archimonde,1624,paladin,retribution,42,24,18
25431,Akaasix,stormscale,1624,paladin,retribution,57,31,26
25432,Babyboo,aggra-português,1624,paladin,retribution,36,17,19
25433,Misú,ravencrest,1623,paladin,retribution,30,17,13
25434,Lisma,bloodfeather,1623,paladin,retribution,47,26,21
25435,Blazeer,pozzo-delleternità,1623,paladin,retribution,42,23,19
25436,Leoxander,outland,1623,paladin,retribution,60,30,30
25437,Notpitball,kazzak,1623,paladin,retribution,48,23,25
25438,Brecs,frostmourne,1623,paladin,retribution,84,36,48
25439,Diccari,stormreaver,1623,paladin,retribution,42,18,24
25440,Ghosti,festung-der-stürme,1622,paladin,retribution,30,17,13
25441,Ливх,blackscar,1622,paladin,retribution,79,42,37
25442,Relius,outland,1622,paladin,retribution,67,25,42
25443,Gøretterøg,archimonde,1621,paladin,retribution,30,18,12
25444,Threathor,outland,1621,paladin,retribution,135,72,63
25445,Kraakz,sanguino,1621,paladin,retribution,35,18,17
25446,Анастэриан,thermaplugg,1621,paladin,retribution,78,39,39
25447,Dreamwatcher,outland,1621,paladin,retribution,48,21,27
25448,Elendor,shadowsong,1620,paladin,retribution,36,20,16
25449,Ajkulaa,kazzak,1620,paladin,retribution,74,35,39
25450,Tpainjr,kazzak,1620,paladin,retribution,36,17,19
25451,Valhella,stormscale,1619,paladin,retribution,137,70,67
25452,Combinecka,chamber-of-aspects,1619,paladin,retribution,118,60,58
25453,Kaleyra,argent-dawn,1619,paladin,retribution,48,20,28
25454,Rullatorsvèn,stormscale,1619,paladin,retribution,42,17,25
25455,Charmxx,stormscale,1618,paladin,retribution,30,18,12
25456,Lonesolo,sylvanas,1618,paladin,retribution,36,20,16
25457,Menephannt,outland,1618,paladin,retribution,39,18,21
25458,Sletlana,burning-blade,1618,paladin,retribution,48,21,27
25459,Bloodsworn,stormrage,1617,paladin,retribution,90,58,32
25460,Фатумм,howling-fjord,1617,paladin,retribution,36,18,18
25461,Okcså,ragnaros,1617,paladin,retribution,64,25,39
25462,Typhadin,sylvanas,1616,paladin,retribution,42,20,22
25463,Harbiter,ravencrest,1616,paladin,retribution,36,17,19
25464,Ассайоу,soulflayer,1616,paladin,retribution,60,21,39
25465,Mommyret,draenor,1615,paladin,retribution,84,45,39
25466,Mâterîa,antonidas,1615,paladin,retribution,102,54,48
25467,Holyblast,archimonde,1615,paladin,retribution,42,22,20
25468,Bloodaxjr,archimonde,1614,paladin,retribution,178,95,83
25469,Lightbrîng,hyjal,1614,paladin,retribution,114,57,57
25470,Хексали,soulflayer,1614,paladin,retribution,51,25,26
25471,Cloudlight,argent-dawn,1613,paladin,retribution,30,18,12
25472,Budgetcara,stormscale,1613,paladin,retribution,35,19,16
25473,Kayøz,aegwynn,1613,paladin,retribution,72,36,36
25474,Nanisunda,thrall,1613,paladin,retribution,132,63,69
25475,Koly,dun-modr,1613,paladin,retribution,38,18,20
25476,Oliverrar,blackrock,1613,paladin,retribution,48,21,27
25477,Vanithar,thrall,1613,paladin,retribution,60,25,35
25478,Аностазия,ashenvale,1613,paladin,retribution,78,30,48
25479,Holyzero,ravencrest,1612,paladin,retribution,24,17,7
25480,Mangz,ysondre,1612,paladin,retribution,36,25,11
25481,Briman,neptulon,1612,paladin,retribution,60,37,23
25482,Девствениица,gordunni,1612,paladin,retribution,54,32,22
25483,Johnßlake,dun-modr,1612,paladin,retribution,95,51,44
25484,Nergigante,drekthar,1612,paladin,retribution,48,23,25
25485,Paradoxiâ,thrall,1612,paladin,retribution,60,28,32
25486,Lyraestra,hyjal,1612,paladin,retribution,66,28,38
25487,Wellmetqt,aegwynn,1611,paladin,retribution,95,40,55
25488,Karyouka,archimonde,1610,paladin,retribution,54,33,21
25489,Мяумяухх,soulflayer,1610,paladin,retribution,196,104,92
25490,Discølove,blackmoore,1610,paladin,retribution,43,21,22
25491,Testament,antonidas,1610,paladin,retribution,54,25,29
25492,Vylnoa,twisting-nether,1610,paladin,retribution,139,62,77
25493,Grimstark,argent-dawn,1609,paladin,retribution,36,23,13
25494,Promise,dun-modr,1609,paladin,retribution,60,32,28
25495,Bíceron,sanguino,1609,paladin,retribution,64,32,32
25496,Lazone,ysondre,1609,paladin,retribution,46,22,24
25497,Кхарнх,soulflayer,1609,paladin,retribution,36,17,19
25498,Racduck,dunemaul,1609,paladin,retribution,64,30,34
25499,Snødunkern,outland,1609,paladin,retribution,96,41,55
25500,Rettalius,ravencrest,1609,paladin,retribution,99,41,58
25501,Mystixd,talnivarr,1608,paladin,retribution,42,31,11
25502,Hølypowah,tarren-mill,1608,paladin,retribution,24,17,7
25503,Alammar,burning-legion,1608,paladin,retribution,30,18,12
25504,Ämÿcüs,zuljin,1608,paladin,retribution,72,41,31
25505,Uliko,twisting-nether,1608,paladin,retribution,60,33,27
25506,Vodax,argent-dawn,1608,paladin,retribution,72,37,35
25507,Elohim,echsenkessel,1608,paladin,retribution,75,36,39
25508,Рикшак,howling-fjord,1608,paladin,retribution,42,17,25
25509,Biggboii,twisting-nether,1608,paladin,retribution,48,19,29
25510,Кинбул,ashenvale,1607,paladin,retribution,30,17,13
25511,Ревирант,gordunni,1607,paladin,retribution,39,21,18
25512,Thmas,tarren-mill,1607,paladin,retribution,90,48,42
25513,Vitacé,burning-legion,1607,paladin,retribution,66,33,33
25514,Ттиаматт,howling-fjord,1607,paladin,retribution,36,17,19
25515,Эллесар,blackscar,1607,paladin,retribution,132,62,70
25516,Fisslol,kazzak,1606,paladin,retribution,66,31,35
25517,Arosyr,alleria,1605,paladin,retribution,60,36,24
25518,Asærý,blackmoore,1605,paladin,retribution,51,26,25
25519,Torvik,eredar,1605,paladin,retribution,96,46,50
25520,Frankostyle,sanguino,1605,paladin,retribution,59,28,31
25521,Elesmerias,dalaran,1604,paladin,retribution,65,36,29
25522,Tìtan,ravencrest,1604,paladin,retribution,48,25,23
25523,Кронкс,howling-fjord,1604,paladin,retribution,141,73,68
25524,Emìnem,kazzak,1604,paladin,retribution,122,63,59
25525,Tinyandy,blackrock,1604,paladin,retribution,48,21,27
25526,Майлайт,gordunni,1603,paladin,retribution,100,59,41
25527,Hargreeve,ravencrest,1602,paladin,retribution,48,24,24
25528,Синодушка,blackscar,1602,paladin,retribution,40,19,21
25529,Fordragon,twisting-nether,1602,paladin,retribution,54,21,33
25530,Quasimod,ravencrest,1601,paladin,retribution,30,17,13
25531,Pappnas,aegwynn,1601,paladin,retribution,30,17,13
25532,Flashyo,archimonde,1601,paladin,retribution,36,20,16
25533,Nashret,kazzak,1601,paladin,retribution,54,28,26
25534,Thun,azjolnerub,1601,paladin,retribution,36,17,19
25535,Zwergicus,alexstrasza,1601,paladin,retribution,71,33,38
25536,Lübu,archimonde,1601,paladin,retribution,42,19,23
25537,Guccishock,twisting-nether,1600,paladin,retribution,85,48,37
25538,Skippadin,ravencrest,1600,paladin,retribution,59,30,29
25539,Carlash,draenor,1599,paladin,retribution,96,53,43
25540,Djcrusade,twisting-nether,1599,paladin,retribution,140,77,63
25541,Daoht,ysondre,1599,paladin,retribution,54,28,26
25542,Рамзеса,soulflayer,1599,paladin,retribution,48,22,26
25543,Azlaya,sargeras,1598,paladin,retribution,135,65,70
25544,Wuzzle,azshara,1597,paladin,retribution,36,22,14
25545,Салутан,thermaplugg,1597,paladin,retribution,92,43,49
25546,Братстепина,gordunni,1596,paladin,retribution,48,21,27
25547,Nlyrld,magtheridon,1595,paladin,retribution,36,19,17
25548,Spéos,archimonde,1595,paladin,retribution,52,26,26
25549,Grìmmjøw,silvermoon,1595,paladin,retribution,39,19,20
25550,Ïdø,hyjal,1594,paladin,retribution,108,46,62
25551,Joniopala,stormreaver,1594,paladin,retribution,47,19,28
25552,Crohnox,nemesis,1593,paladin,retribution,62,30,32
25553,Topzin,argent-dawn,1592,paladin,retribution,45,27,18
25554,Neverknõw,draenor,1592,paladin,retribution,36,21,15
25555,Siorraidh,archimonde,1592,paladin,retribution,42,23,19
25556,Salelol,ravencrest,1591,paladin,retribution,60,22,38
25557,Dabeefchief,outland,1590,paladin,retribution,28,21,7
25558,Kedaris,antonidas,1590,paladin,retribution,54,30,24
25559,Redex,tarren-mill,1590,paladin,retribution,48,26,22
25560,Атикинс,gordunni,1590,paladin,retribution,114,54,60
25561,Pallidino,antonidas,1590,paladin,retribution,47,20,27
25562,Draeymora,thrall,1589,paladin,retribution,61,33,28
25563,Фэрплэйн,gordunni,1589,paladin,retribution,36,19,17
25564,Sstalowy,silvermoon,1589,paladin,retribution,151,74,77
25565,Ahpoual,archimonde,1588,paladin,retribution,64,39,25
25566,Владыкасвета,borean-tundra,1588,paladin,retribution,120,64,56
25567,Gigajudge,ravencrest,1588,paladin,retribution,48,25,23
25568,Raoun,archimonde,1588,paladin,retribution,48,23,25
25569,Serjudge,kazzak,1588,paladin,retribution,42,19,23
25570,Shaylaru,tarren-mill,1587,paladin,retribution,41,22,19
25571,Altundrdel,ravencrest,1587,paladin,retribution,60,31,29
25572,Yaldly,dun-modr,1586,paladin,retribution,36,18,18
25573,Асканиэль,howling-fjord,1586,paladin,retribution,84,37,47
25574,Grobididi,malygos,1585,paladin,retribution,155,85,70
25575,Eniste,silvermoon,1585,paladin,retribution,80,36,44
25576,Emostylex,draenor,1585,paladin,retribution,101,40,61
25577,Джамбит,howling-fjord,1584,paladin,retribution,42,22,20
25578,Cilise,bronzebeard,1583,paladin,retribution,54,24,30
25579,Шэйкер,blackscar,1583,paladin,retribution,79,35,44
25580,Slump,ravencrest,1582,paladin,retribution,73,38,35
25581,Aerieon,draenor,1582,paladin,retribution,42,21,21
25582,Талрэн,howling-fjord,1582,paladin,retribution,66,32,34
25583,Дезоиль,gordunni,1582,paladin,retribution,42,19,23
25584,Irenita,kazzak,1582,paladin,retribution,54,23,31
25585,Retstarr,draenor,1580,paladin,retribution,114,57,57
25586,Диманватикан,howling-fjord,1580,paladin,retribution,66,27,39
25587,Bagok,drakthul,1576,paladin,retribution,42,26,16
25588,Elektek,archimonde,1576,paladin,retribution,30,18,12
25589,Твойвайб,gordunni,1576,paladin,retribution,108,58,50
25590,Lawtõn,argent-dawn,1575,paladin,retribution,132,70,62
25591,Azûl,archimonde,1575,paladin,retribution,138,70,68
25592,Наспидах,grom,1575,paladin,retribution,55,20,35
25593,Báldür,silvermoon,1574,paladin,retribution,60,30,30
25594,Thazyru,frostmane,1573,paladin,retribution,42,30,12
25595,Opsyoudie,kazzak,1573,paladin,retribution,111,51,60
25596,Gulinborsti,aegwynn,1572,paladin,retribution,54,36,18
25597,Seductîve,kazzak,1572,paladin,retribution,108,63,45
25598,Heallgodxx,ragnaros,1572,paladin,retribution,30,17,13
25599,Zaatar,stormscale,1572,paladin,retribution,53,30,23
25600,Nukss,silvermoon,1572,paladin,retribution,54,21,33
25601,Jaro,alleria,1571,paladin,retribution,51,26,25
25602,Nexzz,outland,1570,paladin,retribution,35,26,9
25603,Ксенджин,gordunni,1570,paladin,retribution,34,19,15
25604,Mearsheimer,ysondre,1570,paladin,retribution,42,18,24
25605,Mazekiel,archimonde,1569,paladin,retribution,36,22,14
25606,Йосяфлексер,howling-fjord,1569,paladin,retribution,102,56,46
25607,Luhae,archimonde,1568,paladin,retribution,72,44,28
25608,Биоразлагаем,gordunni,1568,paladin,retribution,78,41,37
25609,Paellysuir,blackmoore,1567,paladin,retribution,108,54,54
25610,Afhvahj,tichondrius,1566,paladin,retribution,143,71,72
25611,Orti,sanguino,1565,paladin,retribution,65,37,28
25612,Bsepal,silvermoon,1565,paladin,retribution,188,99,89
25613,Aethelwold,ragnaros,1565,paladin,retribution,132,56,76
25614,Kathí,kazzak,1563,paladin,retribution,24,18,6
25615,Trixzie,blackhand,1563,paladin,retribution,36,18,18
25616,Сэдвиг,gordunni,1563,paladin,retribution,35,17,18
25617,Jiraaqi,silvermoon,1562,paladin,retribution,53,27,26
25618,Dalbo,aegwynn,1561,paladin,retribution,30,23,7
25619,Kuhfleisch,eredar,1561,paladin,retribution,79,48,31
25620,Qïkarï,antonidas,1561,paladin,retribution,61,35,26
25621,Imaturtle,darksorrow,1561,paladin,retribution,54,19,35
25622,Eiennoai,argent-dawn,1560,paladin,retribution,32,19,13
25623,Lysander,antonidas,1560,paladin,retribution,36,17,19
25624,Thesavage,magtheridon,1558,paladin,retribution,42,20,22
25625,Blówout,tarren-mill,1557,paladin,retribution,42,23,19
25626,Búbbles,nerathor,1556,paladin,retribution,30,18,12
25627,Seraphyonhd,blackmoore,1556,paladin,retribution,82,44,38
25628,Argentø,ravencrest,1556,paladin,retribution,168,87,81
25629,Røck,aggra-português,1555,paladin,retribution,131,72,59
25630,Giroud,dalaran,1555,paladin,retribution,36,17,19
25631,Спидфрик,blackscar,1554,paladin,retribution,62,35,27
25632,Ùthér,sylvanas,1554,paladin,retribution,43,22,21
25633,Belnadris,eredar,1552,paladin,retribution,76,41,35
25634,Taiso,alonsus,1552,paladin,retribution,59,30,29
25635,Ketherian,blutkessel,1552,paladin,retribution,52,20,32
25636,Cauze,ravencrest,1551,paladin,retribution,144,75,69
25637,Drylands,ravencrest,1551,paladin,retribution,54,28,26
25638,Elyox,ravencrest,1551,paladin,retribution,36,18,18
25639,Naree,stormreaver,1549,paladin,retribution,42,21,21
25640,Sunhalo,twisting-nether,1548,paladin,retribution,41,18,23
25641,Lightwitcher,silvermoon,1548,paladin,retribution,96,42,54
25642,Дорогаснега,gordunni,1547,paladin,retribution,42,23,19
25643,Addwyr,blackrock,1547,paladin,retribution,60,30,30
25644,Цитрон,blackscar,1546,paladin,retribution,24,17,7
25645,Лаитнем,gordunni,1546,paladin,retribution,66,40,26
25646,Zneeks,shattered-hand,1545,paladin,retribution,30,19,11
25647,Letharen,argent-dawn,1545,paladin,retribution,32,17,15
25648,Paakz,stormscale,1545,paladin,retribution,172,84,88
25649,Мизуриэль,howling-fjord,1543,paladin,retribution,42,24,18
25650,Maybach,onyxia,1543,paladin,retribution,66,31,35
25651,Темплеар,gordunni,1543,paladin,retribution,66,23,43
25652,Xëlâ,archimonde,1542,paladin,retribution,57,29,28
25653,Раффаэло,borean-tundra,1542,paladin,retribution,96,46,50
25654,Kènpachî,blackrock,1542,paladin,retribution,48,22,26
25655,Isora,twisting-nether,1542,paladin,retribution,93,39,54
25656,Baxxster,blackhand,1542,paladin,retribution,60,23,37
25657,Interop,tarren-mill,1541,paladin,retribution,54,30,24
25658,Эеомли,blackscar,1541,paladin,retribution,51,25,26
25659,Nîcolascage,stormscale,1541,paladin,retribution,42,19,23
25660,Obsidyen,outland,1541,paladin,retribution,38,17,21
25661,Гневнебес,howling-fjord,1541,paladin,retribution,84,36,48
25662,Zeldalòl,outland,1541,paladin,retribution,59,25,34
25663,Ceccil,dun-modr,1540,paladin,retribution,78,46,32
25664,Rimlod,saurfang,1540,paladin,retribution,84,46,38
25665,Zehnya,grim-batol,1540,paladin,retribution,162,88,74
25666,Arrious,frostmane,1540,paladin,retribution,47,25,22
25667,Волатбай,gordunni,1539,paladin,retribution,60,36,24
25668,Deloréane,archimonde,1539,paladin,retribution,62,30,32
25669,Холишокович,deathweaver,1539,paladin,retribution,54,26,28
25670,Лакоста,ashenvale,1538,paladin,retribution,57,26,31
25671,Lycasia,hyjal,1538,paladin,retribution,66,27,39
25672,Forja,silvermoon,1537,paladin,retribution,63,31,32
25673,Runcarsnwpen,kazzak,1536,paladin,retribution,41,27,14
25674,Cos,stormscale,1536,paladin,retribution,34,20,14
25675,Darkdeal,tarren-mill,1536,paladin,retribution,32,17,15
25676,Lavawraith,argent-dawn,1536,paladin,retribution,34,17,17
25677,Krivonis,tarren-mill,1536,paladin,retribution,41,18,23
25678,Catar,arathor,1535,paladin,retribution,169,95,74
25679,Drdo,blackrock,1534,paladin,retribution,18,16,2
25680,Vleisboom,ravencrest,1534,paladin,retribution,42,23,19
25681,Byakkospal,tarren-mill,1534,paladin,retribution,114,58,56
25682,Руказакона,deathguard,1533,paladin,retribution,67,32,35
25683,Zerad,quelthalas,1533,paladin,retribution,80,32,48
25684,Sikthorlan,ravencrest,1532,paladin,retribution,42,22,20
25685,Rqd,blackrock,1532,paladin,retribution,36,16,20
25686,Mofawilli,blackrock,1531,paladin,retribution,60,35,25
25687,Fítzgerald,antonidas,1531,paladin,retribution,46,26,20
25688,Hanksolos,drakthul,1531,paladin,retribution,40,22,18
25689,Jorhall,antonidas,1531,paladin,retribution,103,54,49
25690,Myrieni,silvermoon,1530,paladin,retribution,36,19,17
25691,Bullstorm,burning-legion,1530,paladin,retribution,36,19,17
25692,Tharizod,nagrand,1530,paladin,retribution,68,34,34
25693,Riskha,archimonde,1529,paladin,retribution,45,31,14
25694,Kawabanga,the-maelstrom,1529,paladin,retribution,46,25,21
25695,Mimsy,dalaran,1529,paladin,retribution,107,54,53
25696,Igrael,argent-dawn,1529,paladin,retribution,42,21,21
25697,Júdger,twisting-nether,1528,paladin,retribution,77,38,39
25698,Борссалино,gordunni,1528,paladin,retribution,99,48,51
25699,Ришардебюр,soulflayer,1528,paladin,retribution,71,34,37
25700,Valkyrjai,silvermoon,1528,paladin,retribution,65,30,35
25701,Tyristrum,kilrogg,1528,paladin,retribution,42,17,25
25702,Myridan,bloodhoof,1527,paladin,retribution,48,23,25
25703,Apokalipsnik,drakthul,1527,paladin,retribution,48,22,26
25704,Мётод,howling-fjord,1526,paladin,retribution,42,22,20
25705,Galevar,argent-dawn,1526,paladin,retribution,132,68,64
25706,Lamohru,argent-dawn,1526,paladin,retribution,66,29,37
25707,Pný,silvermoon,1525,paladin,retribution,42,20,22
25708,Saedrick,nemesis,1525,paladin,retribution,45,17,28
25709,Xawier,ghostlands,1524,paladin,retribution,60,31,29
25710,Wingzy,hyjal,1523,paladin,retribution,36,16,20
25711,Mograine,die-aldor,1522,paladin,retribution,106,55,51
25712,Shroomez,frostmane,1522,paladin,retribution,46,23,23
25713,Retdead,nordrassil,1522,paladin,retribution,36,16,20
25714,Stazo,drakthul,1522,paladin,retribution,36,16,20
25715,Auryel,nemesis,1521,paladin,retribution,44,22,22
25716,Snackzy,twisting-nether,1521,paladin,retribution,54,25,29
25717,Dantrag,eredar,1521,paladin,retribution,60,24,36
25718,Imreallybadx,blackrock,1520,paladin,retribution,55,31,24
25719,Créo,draenor,1520,paladin,retribution,36,17,19
25720,Supergallows,shattered-hand,1520,paladin,retribution,54,22,32
25721,Buyamazon,kazzak,1519,paladin,retribution,36,17,19
25722,Копаю,gordunni,1518,paladin,retribution,90,54,36
25723,Adiútrix,silvermoon,1517,paladin,retribution,48,30,18
25724,Codindio,silvermoon,1516,paladin,retribution,76,39,37
25725,Timal,eitrigg,1516,paladin,retribution,109,55,54
25726,Swàyz,archimonde,1516,paladin,retribution,126,55,71
25727,Llaynn,argent-dawn,1516,paladin,retribution,54,20,34
25728,Gashqx,hyjal,1515,paladin,retribution,45,32,13
25729,Stelanâal,archimonde,1515,paladin,retribution,86,44,42
25730,Rapwnzel,sylvanas,1515,paladin,retribution,60,30,30
25731,Zoltes,twisting-nether,1515,paladin,retribution,63,31,32
25732,Hys,stormscale,1514,paladin,retribution,42,23,19
25733,Yømø,antonidas,1514,paladin,retribution,48,26,22
25734,Сангвиний,howling-fjord,1514,paladin,retribution,162,74,88
25735,Ojn,tarren-mill,1513,paladin,retribution,36,27,9
25736,Io,frostwolf,1512,paladin,retribution,161,75,86
25737,Theodór,antonidas,1512,paladin,retribution,83,35,48
25738,Akâshi,dalaran,1511,paladin,retribution,48,28,20
25739,Nataii,argent-dawn,1511,paladin,retribution,30,16,14
25740,Lawlight,frostmane,1511,paladin,retribution,81,42,39
25741,Вэис,borean-tundra,1510,paladin,retribution,53,29,24
25742,Impaross,shattrath,1509,paladin,retribution,159,87,72
25743,Mooses,stormscale,1509,paladin,retribution,66,34,32
25744,Lestaf,the-maelstrom,1509,paladin,retribution,80,40,40
25745,Clamjam,sylvanas,1509,paladin,retribution,72,28,44
25746,Вэндрик,azuregos,1509,paladin,retribution,42,16,26
25747,Vedaar,dun-modr,1508,paladin,retribution,30,24,6
25748,Günselsen,antonidas,1507,paladin,retribution,228,119,109
25749,Ínvi,aegwynn,1507,paladin,retribution,57,29,28
25750,Истенен,blackscar,1507,paladin,retribution,90,39,51
25751,Nfxx,argent-dawn,1506,paladin,retribution,58,35,23
25752,Farata,ravencrest,1506,paladin,retribution,66,37,29
25753,Росиель,soulflayer,1506,paladin,retribution,80,40,40
25754,Hülä,antonidas,1506,paladin,retribution,36,16,20
25755,Ulrhik,nemesis,1506,paladin,retribution,75,30,45
25756,Enlightendz,ravencrest,1506,paladin,retribution,42,16,26
25757,Koami,blackmoore,1505,paladin,retribution,56,30,26
25758,Paradoax,quelthalas,1505,paladin,retribution,30,16,14
25759,Tazkaz,archimonde,1505,paladin,retribution,56,27,29
25760,Лусейд,howling-fjord,1503,paladin,retribution,47,32,15
25761,Шоринг,gordunni,1503,paladin,retribution,48,25,23
25762,Séanors,archimonde,1502,paladin,retribution,22,17,5
25763,Notdeadfred,silvermoon,1502,paladin,retribution,48,28,20
25764,Zélix,bronzebeard,1502,paladin,retribution,95,51,44
25765,Elrandil,kazzak,1501,paladin,retribution,78,35,43
25766,Enveador,garrosh,1500,paladin,retribution,60,35,25
25767,Jathx,silvermoon,1498,paladin,retribution,62,36,26
25768,Ralphias,tarren-mill,1498,paladin,retribution,72,32,40
25769,Rafflesia,sanguino,1498,paladin,retribution,47,16,31
25770,Válé,silvermoon,1497,paladin,retribution,92,42,50
25771,Apolytos,laughing-skull,1497,paladin,retribution,85,35,50
25772,Mattiesko,kazzak,1496,paladin,retribution,139,72,67
25773,Колсет,soulflayer,1496,paladin,retribution,43,20,23
25774,Eärendil,drakthul,1496,paladin,retribution,72,32,40
25775,Dananas,draenor,1496,paladin,retribution,72,27,45
25776,Варблэйз,gordunni,1495,paladin,retribution,30,16,14
25777,Morninnstaar,kazzak,1495,paladin,retribution,30,16,14
25778,Azhrei,archimonde,1495,paladin,retribution,36,16,20
25779,Knigh,draenor,1494,paladin,retribution,96,47,49
25780,Hornybìlly,stormscale,1494,paladin,retribution,42,16,26
25781,Santaclaus,zuljin,1493,paladin,retribution,42,26,16
25782,Маркант,gordunni,1493,paladin,retribution,72,42,30
25783,Trisunonvaki,khazgoroth,1493,paladin,retribution,119,65,54
25784,Тьёрн,gordunni,1493,paladin,retribution,48,26,22
25785,Петуретрик,gordunni,1493,paladin,retribution,106,55,51
25786,Majk,hellscream,1493,paladin,retribution,79,34,45
25787,Ben,ghostlands,1492,paladin,retribution,24,16,8
25788,Enolaer,ragnaros,1492,paladin,retribution,39,19,20
25789,Галиор,soulflayer,1491,paladin,retribution,40,24,16
25790,Násty,twisting-nether,1491,paladin,retribution,137,68,69
25791,Havefunzqt,archimonde,1491,paladin,retribution,96,46,50
25792,Jimrogier,argent-dawn,1491,paladin,retribution,60,28,32
25793,Blader,darksorrow,1491,paladin,retribution,81,37,44
25794,Angelcore,tarren-mill,1490,paladin,retribution,176,91,85
25795,Малоко,thermaplugg,1490,paladin,retribution,36,18,18
25796,Tuppo,argent-dawn,1490,paladin,retribution,109,51,58
25797,Slayfer,dun-modr,1490,paladin,retribution,72,31,41
25798,Eleuterus,bloodfeather,1490,paladin,retribution,48,19,29
25799,Cassandrina,kazzak,1489,paladin,retribution,59,32,27
25800,Selaphíel,kazzak,1489,paladin,retribution,150,78,72
25801,Riukÿ,nemesis,1489,paladin,retribution,47,24,23
25802,Sonarix,blackrock,1488,paladin,retribution,51,26,25
25803,Менетиил,galakrond,1488,paladin,retribution,52,17,35
25804,Azryn,kazzak,1487,paladin,retribution,32,18,14
25805,Qpalax,outland,1487,paladin,retribution,38,17,21
25806,Bloodyret,outland,1486,paladin,retribution,72,32,40
25807,Astolfia,silvermoon,1485,paladin,retribution,37,21,16
25808,Humphry,vashj,1485,paladin,retribution,54,27,27
25809,Baldivar,silvermoon,1484,paladin,retribution,66,38,28
25810,Nînaninja,silvermoon,1484,paladin,retribution,69,34,35
25811,Pav,eredar,1484,paladin,retribution,53,24,29
25812,Мистеравадон,gordunni,1484,paladin,retribution,158,71,87
25813,Poohsie,ravencrest,1481,paladin,retribution,30,19,11
25814,Osïrïs,kazzak,1481,paladin,retribution,81,35,46
25815,Uxxer,sanguino,1479,paladin,retribution,41,23,18
25816,Wrathlight,nemesis,1479,paladin,retribution,42,23,19
25817,Portgas,hyjal,1479,paladin,retribution,48,24,24
25818,Beefdaddyy,kazzak,1478,paladin,retribution,41,20,21
25819,Rimva,alleria,1477,paladin,retribution,24,16,8
25820,Романтик,deathweaver,1477,paladin,retribution,42,18,24
25821,Râoh,arathi,1476,paladin,retribution,78,38,40
25822,Neltix,blackrock,1476,paladin,retribution,77,37,40
25823,Krakr,ravencrest,1476,paladin,retribution,36,17,19
25824,Bloodpaly,silvermoon,1476,paladin,retribution,64,27,37
25825,Boomboomciao,draenor,1473,paladin,retribution,30,21,9
25826,Snibsxpala,silvermoon,1473,paladin,retribution,41,20,21
25827,Rulîx,blackmoore,1473,paladin,retribution,80,30,50
25828,Aurroraa,doomhammer,1471,paladin,retribution,45,22,23
25829,Puré,festung-der-stürme,1470,paladin,retribution,41,18,23
25830,Arfeniel,stormscale,1470,paladin,retribution,66,27,39
25831,Graeme,ysondre,1469,paladin,retribution,36,16,20
25832,Angelisho,zuljin,1469,paladin,retribution,101,39,62
25833,Ðivine,stormscale,1468,paladin,retribution,76,42,34
25834,Craaw,archimonde,1468,paladin,retribution,71,28,43
25835,Ippî,blackmoore,1467,paladin,retribution,37,23,14
25836,Schôck,eredar,1467,paladin,retribution,33,16,17
25837,Ярослэйв,howling-fjord,1467,paladin,retribution,92,39,53
25838,Annyaiva,outland,1467,paladin,retribution,66,27,39
25839,Scarabeus,ravencrest,1466,paladin,retribution,52,30,22
25840,Sieghard,aegwynn,1466,paladin,retribution,138,68,70
25841,Leeroyjinks,twisting-nether,1464,paladin,retribution,36,21,15
25842,Noxxiê,blackmoore,1464,paladin,retribution,36,20,16
25843,Gazïel,kaelthas,1464,paladin,retribution,60,32,28
25844,Avalindro,wrathbringer,1463,paladin,retribution,54,22,32
25845,Gymly,kazzak,1462,paladin,retribution,156,87,69
25846,Albz,laughing-skull,1461,paladin,retribution,36,17,19
25847,Wälläce,sanguino,1461,paladin,retribution,41,16,25
25848,Khouvec,tarren-mill,1460,paladin,retribution,30,19,11
25849,Malemanlad,silvermoon,1460,paladin,retribution,132,67,65
25850,Teryanna,ragnaros,1460,paladin,retribution,74,29,45
25851,Цитология,borean-tundra,1459,paladin,retribution,108,63,45
25852,Zanreti,outland,1458,paladin,retribution,110,57,53
25853,Sangiorgio,nemesis,1458,paladin,retribution,36,18,18
25854,Альфазеро,howling-fjord,1458,paladin,retribution,46,19,27
25855,Leroya,blackrock,1457,paladin,retribution,35,18,17
25856,Ветрум,gordunni,1456,paladin,retribution,36,18,18
25857,Moodý,ragnaros,1455,paladin,retribution,88,43,45
25858,Хамили,gordunni,1455,paladin,retribution,48,20,28
25859,Elinmogz,kazzak,1454,paladin,retribution,26,16,10
25860,Грузор,gordunni,1454,paladin,retribution,48,28,20
25861,Holyhi,silvermoon,1454,paladin,retribution,58,32,26
25862,Atemes,malorne,1453,paladin,retribution,27,17,10
25863,Dvouklik,burning-blade,1453,paladin,retribution,47,28,19
25864,Whitebreeze,sanguino,1453,paladin,retribution,70,37,33
25865,Iljanaqt,blackrock,1452,paladin,retribution,64,26,38
25866,Ficsuur,ragnaros,1451,paladin,retribution,187,94,93
25867,Термотравка,grom,1451,paladin,retribution,186,86,100
25868,Essenz,eredar,1451,paladin,retribution,64,23,41
25869,Джагадаптер,gordunni,1450,paladin,retribution,88,49,39
25870,Айэмбомб,howling-fjord,1450,paladin,retribution,40,20,20
25871,Тюрр,lich-king,1450,paladin,retribution,49,23,26
25872,Жанож,gordunni,1449,paladin,retribution,42,23,19
25873,Wadey,tarren-mill,1449,paladin,retribution,54,25,29
25874,Bubblebuttx,ghostlands,1448,paladin,retribution,59,29,30
25875,Oldsqlmofu,blackrock,1448,paladin,retribution,36,17,19
25876,Splasher,grim-batol,1448,paladin,retribution,84,39,45
25877,Àræs,archimonde,1448,paladin,retribution,66,27,39
25878,Logikoma,tarren-mill,1447,paladin,retribution,54,30,24
25879,Асшура,howling-fjord,1447,paladin,retribution,40,20,20
25880,Архэла,gordunni,1447,paladin,retribution,42,20,22
25881,Dimes,argent-dawn,1446,paladin,retribution,25,18,7
25882,Teìltaus,eredar,1446,paladin,retribution,60,28,32
25883,Сакермвп,howling-fjord,1445,paladin,retribution,36,23,13
25884,Рипкарт,gordunni,1445,paladin,retribution,30,18,12
25885,Finñ,sylvanas,1445,paladin,retribution,65,32,33
25886,Lerie,ravencrest,1444,paladin,retribution,39,19,20
25887,Feelmylight,tarren-mill,1444,paladin,retribution,35,16,19
25888,Frutte,malganis,1443,paladin,retribution,48,27,21
25889,Valarians,nemesis,1443,paladin,retribution,30,16,14
25890,Protos,ambossar,1443,paladin,retribution,42,21,21
25891,Pliscken,kazzak,1443,paladin,retribution,47,20,27
25892,Хиккудоджер,eversong,1442,paladin,retribution,196,104,92
25893,Evililz,kazzak,1442,paladin,retribution,85,43,42
25894,Torpala,burning-legion,1441,paladin,retribution,36,18,18
25895,Neêsoldr,blackmoore,1441,paladin,retribution,54,25,29
25896,Nothonnest,archimonde,1440,paladin,retribution,34,23,11
25897,Legendaryxw,drakthul,1440,paladin,retribution,57,29,28
25898,Hugins,chamber-of-aspects,1440,paladin,retribution,36,17,19
25899,Pak,amanthul,1440,paladin,retribution,45,18,27
25900,Soossi,silvermoon,1439,paladin,retribution,24,15,9
25901,Naethan,malganis,1439,paladin,retribution,48,24,24
25902,Андерлайт,azuregos,1439,paladin,retribution,41,19,22
25903,Jcpd,drakthul,1439,paladin,retribution,40,16,24
25904,Æthëlflæd,ravencrest,1438,paladin,retribution,83,53,30
25905,Zebramann,silvermoon,1438,paladin,retribution,81,45,36
25906,Hogan,blackmoore,1438,paladin,retribution,36,20,16
25907,Dinønuggets,ravencrest,1438,paladin,retribution,30,15,15
25908,Veckra,kazzak,1438,paladin,retribution,47,23,24
25909,Dijkie,boulderfist,1438,paladin,retribution,36,16,20
25910,Amburet,kazzak,1438,paladin,retribution,36,15,21
25911,Chíllpills,silvermoon,1437,paladin,retribution,60,25,35
25912,Mezzí,aegwynn,1436,paladin,retribution,48,27,21
25913,Exceed,blackmoore,1436,paladin,retribution,30,15,15
25914,Джибути,soulflayer,1436,paladin,retribution,105,51,54
25915,Sebatrøz,ravencrest,1435,paladin,retribution,30,17,13
25916,Alvagur,zirkel-des-cenarius,1435,paladin,retribution,46,26,20
25917,Shröömïë,silvermoon,1435,paladin,retribution,140,69,71
25918,Aumium,sunstrider,1435,paladin,retribution,112,51,61
25919,Крода,deepholm,1434,paladin,retribution,36,18,18
25920,Whitebronco,tarren-mill,1434,paladin,retribution,36,15,21
25921,Holÿbeard,ravencrest,1433,paladin,retribution,42,26,16
25922,Lipsvirgin,kazzak,1433,paladin,retribution,30,15,15
25923,Lezira,ravencrest,1433,paladin,retribution,36,15,21
25924,Drhammerdin,antonidas,1433,paladin,retribution,36,15,21
25925,Campo,tarren-mill,1433,paladin,retribution,60,23,37
25926,Vanyon,malganis,1432,paladin,retribution,26,16,10
25927,Артреал,blackscar,1432,paladin,retribution,96,56,40
25928,Lightstrike,stormrage,1432,paladin,retribution,30,17,13
25929,Kyrokonserve,blackmoore,1431,paladin,retribution,73,38,35
25930,Alithyra,earthen-ring,1431,paladin,retribution,85,42,43
25931,Hammertime,guldan,1431,paladin,retribution,54,25,29
25932,Logossh,dun-modr,1430,paladin,retribution,26,16,10
25933,Sickbolt,eredar,1429,paladin,retribution,96,52,44
25934,Jøøs,sargeras,1429,paladin,retribution,105,56,49
25935,Holyshied,silvermoon,1429,paladin,retribution,36,16,20
25936,Laptop,aegwynn,1427,paladin,retribution,24,15,9
25937,Хоулик,howling-fjord,1427,paladin,retribution,69,37,32
25938,Милостьрока,gordunni,1427,paladin,retribution,48,24,24
25939,Refléx,zirkel-des-cenarius,1427,paladin,retribution,36,15,21
25940,Сазар,gordunni,1426,paladin,retribution,51,21,30
25941,Komen,dalaran,1424,paladin,retribution,24,15,9
25942,Кериас,gordunni,1424,paladin,retribution,24,15,9
25943,Rhyvar,outland,1424,paladin,retribution,30,15,15
25944,Uraraka,burning-blade,1423,paladin,retribution,36,24,12
25945,Cracish,ragnaros,1422,paladin,retribution,30,15,15
25946,Каштоуны,soulflayer,1422,paladin,retribution,50,19,31
25947,Nillenkäse,antonidas,1421,paladin,retribution,24,15,9
25948,Slipmax,eredar,1421,paladin,retribution,42,17,25
25949,Flaweldin,ravencrest,1420,paladin,retribution,18,15,3
25950,Jâybee,ravencrest,1420,paladin,retribution,48,25,23
25951,Shtaladin,sylvanas,1420,paladin,retribution,118,55,63
25952,Fredas,hyjal,1419,paladin,retribution,78,42,36
25953,Somixd,ragnaros,1418,paladin,retribution,176,83,93
25954,Olivaresx,ravencrest,1418,paladin,retribution,54,19,35
25955,Hydrath,ysondre,1417,paladin,retribution,90,41,49
25956,Diamir,rajaxx,1417,paladin,retribution,51,20,31
25957,Fryl,quelthalas,1416,paladin,retribution,66,37,29
25958,Offa,draenor,1416,paladin,retribution,48,23,25
25959,Jac,nemesis,1416,paladin,retribution,122,58,64
25960,Ljumá,kazzak,1416,paladin,retribution,114,54,60
25961,Madman,drakthul,1416,paladin,retribution,36,15,21
25962,Fumaça,dun-modr,1415,paladin,retribution,107,61,46
25963,Пивняк,eversong,1414,paladin,retribution,48,29,19
25964,Воркаллес,gordunni,1414,paladin,retribution,66,39,27
25965,Primle,thrall,1413,paladin,retribution,82,46,36
25966,Valerionn,blackmoore,1413,paladin,retribution,37,19,18
25967,Vaako,blackrock,1412,paladin,retribution,36,19,17
25968,Синфуледи,gordunni,1412,paladin,retribution,66,23,43
25969,Диваин,gordunni,1411,paladin,retribution,78,42,36
25970,Lukeus,the-maelstrom,1411,paladin,retribution,84,45,39
25971,Kaitlyne,tarren-mill,1411,paladin,retribution,271,129,142
25972,Pállis,ravencrest,1410,paladin,retribution,24,16,8
25973,Iklohz,sanguino,1410,paladin,retribution,76,43,33
25974,Horgar,nagrand,1410,paladin,retribution,100,51,49
25975,Izolated,aegwynn,1410,paladin,retribution,78,34,44
25976,Kaelthir,bladefist,1409,paladin,retribution,47,30,17
25977,Квемсис,ashenvale,1409,paladin,retribution,99,62,37
25978,Йзериль,howling-fjord,1408,paladin,retribution,18,15,3
25979,Наолина,gordunni,1408,paladin,retribution,59,28,31
25980,Holyblast,shattered-hand,1407,paladin,retribution,30,23,7
25981,Tóxicpaladín,kazzak,1407,paladin,retribution,103,46,57
25982,Taiiki,archimonde,1406,paladin,retribution,72,42,30
25983,Argonak,sanguino,1406,paladin,retribution,42,22,20
25984,Grapaladin,sanguino,1406,paladin,retribution,44,23,21
25985,Melior,skullcrusher,1406,paladin,retribution,94,47,47
25986,Maltazar,arygos,1404,paladin,retribution,24,15,9
25987,Fleshoflight,arathor,1404,paladin,retribution,45,27,18
25988,Hagën,minahonda,1404,paladin,retribution,47,26,21
25989,Keladen,burning-legion,1404,paladin,retribution,36,19,17
25990,Ashent,stormscale,1404,paladin,retribution,76,38,38
25991,Spartain,draenor,1404,paladin,retribution,42,19,23
25992,Doomgape,alakir,1404,paladin,retribution,88,35,53
25993,Crazzylight,kazzak,1403,paladin,retribution,74,35,39
25994,Блуудс,howling-fjord,1403,paladin,retribution,55,25,30
25995,Хилерскийхил,soulflayer,1403,paladin,retribution,38,15,23
25996,Loscar,silvermoon,1402,paladin,retribution,30,15,15
25997,Swan,chogall,1402,paladin,retribution,48,23,25
25998,Nomurabeta,naxxramas,1401,paladin,retribution,50,24,26
25999,Кветирон,soulflayer,1400,paladin,retribution,102,46,56
26000,Boabux,draenor,1399,paladin,retribution,92,48,44
26001,Баблспула,soulflayer,1399,paladin,retribution,109,51,58
26002,Benno,dun-modr,1398,paladin,retribution,106,47,59
26003,Ekzykes,ravencrest,1397,paladin,retribution,24,15,9
26004,Samueel,blackmoore,1397,paladin,retribution,42,23,19
26005,Пурджпал,soulflayer,1397,paladin,retribution,36,19,17
26006,Panthalassá,argent-dawn,1396,paladin,retribution,48,26,22
26007,Jeriiret,khaz-modan,1396,paladin,retribution,60,28,32
26008,Vendikor,nemesis,1396,paladin,retribution,156,69,87
26009,Gojesi,silvermoon,1395,paladin,retribution,48,21,27
26010,Eulion,burning-legion,1394,paladin,retribution,18,15,3
26011,Lééroÿ,sylvanas,1394,paladin,retribution,84,41,43
26012,Sîlversun,grim-batol,1394,paladin,retribution,36,15,21
26013,Vorber,darksorrow,1393,paladin,retribution,35,15,20
26014,Gigap,ragnaros,1391,paladin,retribution,30,15,15
26015,Buddabob,antonidas,1391,paladin,retribution,96,33,63
26016,Jackub,draenor,1390,paladin,retribution,44,24,20
26017,Thrinea,blackrock,1390,paladin,retribution,36,18,18
26018,Ðøñe,draenor,1390,paladin,retribution,36,17,19
26019,Софилион,gordunni,1389,paladin,retribution,57,30,27
26020,Windsor,argent-dawn,1389,paladin,retribution,66,31,35
26021,Syracx,blackhand,1389,paladin,retribution,59,27,32
26022,Wisupl,silvermoon,1387,paladin,retribution,42,29,13
26023,Booyaahh,ravencrest,1387,paladin,retribution,48,26,22
26024,Блейзерфайт,eversong,1387,paladin,retribution,42,19,23
26025,Блатш,greymane,1387,paladin,retribution,55,16,39
26026,Shrøømz,antonidas,1386,paladin,retribution,48,25,23
26027,Blekadin,ragnaros,1386,paladin,retribution,74,34,40
26028,Zandorath,argent-dawn,1386,paladin,retribution,54,24,30
26029,Rudî,sanguino,1384,paladin,retribution,34,25,9
26030,Càrláßrùní,hyjal,1384,paladin,retribution,30,20,10
26031,Unkillablee,stormscale,1384,paladin,retribution,64,34,30
26032,Støøk,shendralar,1383,paladin,retribution,95,50,45
26033,Parlma,naxxramas,1383,paladin,retribution,49,24,25
26034,Ëlësilf,sanguino,1381,paladin,retribution,42,23,19
26035,Ayàhuazka,ysondre,1381,paladin,retribution,96,43,53
26036,Dmytropal,draenor,1380,paladin,retribution,36,17,19
26037,Террорх,blackscar,1380,paladin,retribution,48,18,30
26038,Palyx,cthun,1379,paladin,retribution,24,15,9
26039,Илюшагодх,gordunni,1379,paladin,retribution,54,30,24
26040,Vangottwald,drakthul,1379,paladin,retribution,54,25,29
26041,Perrinaybull,magtheridon,1379,paladin,retribution,50,21,29
26042,Vlodthar,uldum,1378,paladin,retribution,30,18,12
26043,Далходж,soulflayer,1378,paladin,retribution,47,15,32
26044,Мизиола,galakrond,1377,paladin,retribution,108,57,51
26045,Кузькинамать,greymane,1377,paladin,retribution,102,42,60
26046,Хеллкик,howling-fjord,1377,paladin,retribution,43,15,28
26047,Tríbunus,blackmoore,1376,paladin,retribution,31,17,14
26048,Retgaffeooku,conseil-des-ombres,1376,paladin,retribution,66,35,31
26049,Tobzin,argent-dawn,1376,paladin,retribution,42,19,23
26050,Algoric,suramar,1376,paladin,retribution,42,16,26
26051,Sagittaxx,kazzak,1375,paladin,retribution,80,42,38
26052,Walladin,stormscale,1375,paladin,retribution,93,45,48
26053,Xavios,eredar,1375,paladin,retribution,42,18,24
26054,Morniarn,argent-dawn,1374,paladin,retribution,54,29,25
26055,Мэднессх,howling-fjord,1374,paladin,retribution,32,15,17
26056,Dd,blackmoore,1374,paladin,retribution,76,35,41
26057,Darnero,blackrock,1373,paladin,retribution,24,16,8
26058,Бэдбой,howling-fjord,1373,paladin,retribution,48,23,25
26059,Esdras,sanguino,1373,paladin,retribution,36,17,19
26060,Gìne,archimonde,1373,paladin,retribution,32,15,17
26061,Soulglo,ragnaros,1373,paladin,retribution,36,16,20
26062,Duckiboy,ragnaros,1372,paladin,retribution,102,56,46
26063,Bezúziusz,ragnaros,1372,paladin,retribution,56,30,26
26064,Aleixodolphi,argent-dawn,1372,paladin,retribution,197,86,111
26065,Дджаб,booty-bay,1372,paladin,retribution,46,20,26
26066,Telredor,rexxar,1372,paladin,retribution,42,15,27
26067,Palladain,draenor,1370,paladin,retribution,46,28,18
26068,Hazorarh,argent-dawn,1370,paladin,retribution,31,17,14
26069,Mexou,la-croisade-écarlate,1370,paladin,retribution,42,20,22
26070,Hella,dunemaul,1368,paladin,retribution,47,26,21
26071,Beyma,twisting-nether,1368,paladin,retribution,29,15,14
26072,Goldhand,vashj,1368,paladin,retribution,72,34,38
26073,Uwelist,arathor,1368,paladin,retribution,73,34,39
26074,Ùthër,silvermoon,1367,paladin,retribution,36,20,16
26075,Aeyalana,ragnaros,1367,paladin,retribution,35,17,18
26076,Svetijuju,kazzak,1367,paladin,retribution,60,29,31
26077,Töphuria,silvermoon,1366,paladin,retribution,53,27,26
26078,Andocay,das-syndikat,1366,paladin,retribution,66,32,34
26079,Серёжблондин,gordunni,1366,paladin,retribution,54,26,28
26080,Rodakinos,outland,1365,paladin,retribution,52,30,22
26081,Bladê,kazzak,1365,paladin,retribution,33,19,14
26082,Memororo,stormscale,1365,paladin,retribution,38,15,23
26083,Lovetospoonn,ravencrest,1364,paladin,retribution,30,18,12
26084,Burstyléz,silvermoon,1364,paladin,retribution,30,18,12
26085,Yaoiri,argent-dawn,1364,paladin,retribution,41,21,20
26086,Синдикатх,soulflayer,1363,paladin,retribution,125,66,59
26087,Ямыч,ashenvale,1362,paladin,retribution,34,17,17
26088,Викиллер,grom,1361,paladin,retribution,42,22,20
26089,Aasimar,twilights-hammer,1361,paladin,retribution,167,85,82
26090,Pascual,magtheridon,1360,paladin,retribution,50,24,26
26091,Vorsip,tarren-mill,1360,paladin,retribution,42,19,23
26092,Эзарх,gordunni,1359,paladin,retribution,58,29,29
26093,Ханпаладин,howling-fjord,1358,paladin,retribution,24,17,7
26094,Azaël,illidan,1358,paladin,retribution,34,17,17
26095,Sødaz,hyjal,1358,paladin,retribution,89,44,45
26096,Тромбб,soulflayer,1358,paladin,retribution,36,15,21
26097,Denlow,silvermoon,1357,paladin,retribution,66,32,34
26098,Juliea,aegwynn,1357,paladin,retribution,84,39,45
26099,Brigholm,argent-dawn,1357,paladin,retribution,74,30,44
26100,Archibäld,silvermoon,1356,paladin,retribution,25,15,10
26101,Гучив,howling-fjord,1354,paladin,retribution,48,27,21
26102,Apolomaeuz,blackhand,1354,paladin,retribution,36,20,16
26103,Âlßêdø,silvermoon,1354,paladin,retribution,84,43,41
26104,Chimurei,silvermoon,1354,paladin,retribution,42,20,22
26105,Bloodlord,twisting-nether,1354,paladin,retribution,55,24,31
26106,Curtwizz,silvermoon,1353,paladin,retribution,39,19,20
26107,Flawx,blackmoore,1352,paladin,retribution,47,23,24
26108,Рэгнволд,deathguard,1352,paladin,retribution,52,25,27
26109,Тэлматос,soulflayer,1351,paladin,retribution,36,15,21
26110,Iamnami,earthen-ring,1351,paladin,retribution,58,23,35
26111,Straxotia,twisting-nether,1350,paladin,retribution,36,19,17
26112,Aisnil,twilights-hammer,1350,paladin,retribution,95,46,49
26113,Troublebuble,silvermoon,1350,paladin,retribution,68,30,38
26114,Sacredlol,blackmoore,1350,paladin,retribution,48,15,33
26115,Yunax,silvermoon,1349,paladin,retribution,36,23,13
26116,Raerion,ragnaros,1348,paladin,retribution,42,31,11
26117,Sanduciorba,chamber-of-aspects,1348,paladin,retribution,32,19,13
26118,Tønyx,les-clairvoyants,1346,paladin,retribution,38,16,22
26119,Vâskt,dun-modr,1345,paladin,retribution,96,49,47
26120,Forneus,nemesis,1344,paladin,retribution,84,47,37
26121,Таурусс,booty-bay,1344,paladin,retribution,54,24,30
26122,Budweison,silvermoon,1344,paladin,retribution,54,22,32
26123,Esito,draenor,1343,paladin,retribution,28,15,13
26124,Mashijudge,blackhand,1343,paladin,retribution,60,31,29
26125,Джедай,blackscar,1343,paladin,retribution,30,14,16
26126,Prosteprazak,ragnaros,1343,paladin,retribution,45,20,25
26127,Защешот,gordunni,1343,paladin,retribution,36,14,22
26128,Якунии,blackscar,1342,paladin,retribution,24,14,10
26129,Маразоточка,howling-fjord,1342,paladin,retribution,35,17,18
26130,Hislifelmao,kazzak,1342,paladin,retribution,36,14,22
26131,Блэкхарм,gordunni,1342,paladin,retribution,42,14,28
26132,Balthassar,kirin-tor,1341,paladin,retribution,60,28,32
26133,Тайронх,soulflayer,1341,paladin,retribution,30,14,16
26134,Chocbear,tarren-mill,1341,paladin,retribution,30,14,16
26135,Аргонис,gordunni,1341,paladin,retribution,30,14,16
26136,Wordup,senjin,1341,paladin,retribution,36,14,22
26137,Тэмплари,galakrond,1340,paladin,retribution,93,48,45
26138,Teho,dragonblight,1340,paladin,retribution,143,72,71
26139,Zeyz,defias-brotherhood,1340,paladin,retribution,42,21,21
26140,Brölin,sanguino,1340,paladin,retribution,48,22,26
26141,Гуэргос,gordunni,1338,paladin,retribution,30,14,16
26142,Screâm,eredar,1338,paladin,retribution,42,14,28
26143,Aisolôn,thrall,1337,paladin,retribution,36,18,18
26144,Ahzut,rashgarroth,1337,paladin,retribution,30,15,15
26145,Mustach,aggra-português,1337,paladin,retribution,41,20,21
26146,Razrpal,tarren-mill,1337,paladin,retribution,30,14,16
26147,Stavrosy,outland,1337,paladin,retribution,36,14,22
26148,Proximo,burning-legion,1336,paladin,retribution,24,14,10
26149,Orzix,sylvanas,1336,paladin,retribution,47,26,21
26150,Proletardk,draenor,1336,paladin,retribution,102,51,51
26151,Dodgerwilly,outland,1336,paladin,retribution,30,14,16
26152,Неиспоримый,soulflayer,1335,paladin,retribution,18,14,4
26153,Yull,twisting-nether,1335,paladin,retribution,41,20,21
26154,Мэибибэиби,howling-fjord,1335,paladin,retribution,36,14,22
26155,Blaîzer,archimonde,1335,paladin,retribution,42,14,28
26156,Zipoohun,arathor,1334,paladin,retribution,97,52,45
26157,Radamanthes,ysondre,1334,paladin,retribution,66,32,34
26158,Кранштейн,gordunni,1334,paladin,retribution,36,17,19
26159,Neithi,twisting-nether,1334,paladin,retribution,30,14,16
26160,Medieh,ravencrest,1334,paladin,retribution,33,15,18
26161,Hisblade,emerald-dream,1333,paladin,retribution,30,17,13
26162,Vaníos,nazjatar,1333,paladin,retribution,34,19,15
26163,Блэквилл,howling-fjord,1333,paladin,retribution,114,55,59
26164,Fløcki,blackhand,1333,paladin,retribution,30,14,16
26165,Garthoronir,antonidas,1333,paladin,retribution,39,15,24
26166,Deadlydawn,kazzak,1333,paladin,retribution,48,14,34
26167,Disadin,sylvanas,1332,paladin,retribution,24,14,10
26168,Eruth,ravencrest,1331,paladin,retribution,24,14,10
26169,Romfis,arathor,1331,paladin,retribution,42,22,20
26170,Белкоксю,booty-bay,1331,paladin,retribution,84,39,45
26171,Dàrkùsh,archimonde,1330,paladin,retribution,35,21,14
26172,Blakkjack,xavius,1330,paladin,retribution,24,14,10
26173,Sharkayne,anubarak,1330,paladin,retribution,42,14,28
26174,Imoss,hyjal,1329,paladin,retribution,36,22,14
26175,Obé,argent-dawn,1329,paladin,retribution,184,102,82
26176,Baé,drakthul,1329,paladin,retribution,37,15,22
26177,Unohana,shattered-halls,1329,paladin,retribution,100,40,60
26178,Ædrenn,archimonde,1329,paladin,retribution,42,14,28
26179,Беспощадие,gordunni,1328,paladin,retribution,30,14,16
26180,Egx,draenor,1328,paladin,retribution,36,15,21
26181,Endar,drakthul,1327,paladin,retribution,48,21,27
26182,Drivenlight,twisting-nether,1326,paladin,retribution,24,14,10
26183,Doubtfire,tarren-mill,1325,paladin,retribution,30,14,16
26184,Кливерти,gordunni,1325,paladin,retribution,36,14,22
26185,Enriel,temple-noir,1324,paladin,retribution,30,16,14
26186,Chelan,thrall,1324,paladin,retribution,36,14,22
26187,Divinenoob,ravencrest,1321,paladin,retribution,24,14,10
26188,Steakenstein,nathrezim,1320,paladin,retribution,48,26,22
26189,Hydarr,twisting-nether,1320,paladin,retribution,62,33,29
26190,Vvaarok,blackmoore,1320,paladin,retribution,77,33,44
26191,Rothmans,aggra-português,1319,paladin,retribution,36,20,16
26192,Ahnaa,argent-dawn,1319,paladin,retribution,100,50,50
26193,Klittsurf,bloodhoof,1317,paladin,retribution,66,39,27
26194,Barakisback,silvermoon,1317,paladin,retribution,40,22,18
26195,Karthvitall,kaelthas,1316,paladin,retribution,24,14,10
26196,Rosallyn,argent-dawn,1316,paladin,retribution,77,26,51
26197,Hàsbulla,khaz-modan,1315,paladin,retribution,124,61,63
26198,Sparrda,dun-modr,1314,paladin,retribution,48,24,24
26199,Синерина,blackscar,1314,paladin,retribution,47,20,27
26200,Valaeryanae,nemesis,1313,paladin,retribution,42,18,24
26201,Howard,dalaran,1313,paladin,retribution,36,14,22
26202,Foxare,burning-legion,1312,paladin,retribution,53,29,24
26203,Пепсекольный,soulflayer,1312,paladin,retribution,48,25,23
26204,Angarx,draenor,1311,paladin,retribution,28,16,12
26205,Viiri,burning-legion,1311,paladin,retribution,71,40,31
26206,Mendril,malorne,1309,paladin,retribution,36,23,13
26207,Nardindindou,ysondre,1309,paladin,retribution,164,83,81
26208,Zethadin,kazzak,1306,paladin,retribution,27,15,12
26209,Kaizêr,silvermoon,1306,paladin,retribution,97,46,51
26210,Slageth,argent-dawn,1306,paladin,retribution,42,17,25
26211,Mataleo,archimonde,1305,paladin,retribution,66,41,25
26212,Флаила,ashenvale,1304,paladin,retribution,66,37,29
26213,Беймикс,gordunni,1303,paladin,retribution,72,36,36
26214,Светонносец,gordunni,1303,paladin,retribution,72,28,44
26215,Bonzai,blackrock,1302,paladin,retribution,109,54,55
26216,Gavril,bloodfeather,1302,paladin,retribution,126,61,65
26217,Darhuun,antonidas,1299,paladin,retribution,99,47,52
26218,Nevermoore,doomhammer,1299,paladin,retribution,42,19,23
26219,Serkunkoira,emeriss,1298,paladin,retribution,24,14,10
26220,Jackypala,ravencrest,1298,paladin,retribution,48,25,23
26221,Truezero,draenor,1297,paladin,retribution,42,23,19
26222,Palangel,eldrethalas,1296,paladin,retribution,114,51,63
26223,Elení,thrall,1296,paladin,retribution,37,15,22
26224,Ретриванлав,gordunni,1296,paladin,retribution,72,24,48
26225,Raweo,kilrogg,1294,paladin,retribution,78,47,31
26226,Olaghkan,dun-modr,1294,paladin,retribution,26,14,12
26227,Ultrabenzo,ravencrest,1294,paladin,retribution,35,14,21
26228,Erin,wildhammer,1293,paladin,retribution,51,25,26
26229,Варасса,grom,1293,paladin,retribution,30,14,16
26230,Хен,blackscar,1292,paladin,retribution,50,26,24
26231,Хоулишит,blackscar,1291,paladin,retribution,42,26,16
26232,Orseis,anubarak,1291,paladin,retribution,29,15,14
26233,Købìtø,archimonde,1291,paladin,retribution,48,21,27
26234,Mantinel,hellfire,1290,paladin,retribution,32,20,12
26235,Ahramanyu,blackrock,1289,paladin,retribution,42,20,22
26236,Kreyvin,argent-dawn,1289,paladin,retribution,77,33,44
26237,Uragan,blackmoore,1287,paladin,retribution,62,31,31
26238,Raerk,dalaran,1286,paladin,retribution,73,41,32
26239,Tomiris,twisting-nether,1286,paladin,retribution,36,16,20
26240,Epoke,archimonde,1285,paladin,retribution,36,21,15
26241,Angrykorean,blackmoore,1284,paladin,retribution,59,28,31
26242,Holylimx,draenor,1283,paladin,retribution,114,56,58
26243,Корсаро,deepholm,1283,paladin,retribution,109,53,56
26244,Miqee,burning-legion,1283,paladin,retribution,47,20,27
26245,Trollarage,confrérie-du-thorium,1281,paladin,retribution,54,28,26
26246,Mughena,kazzak,1281,paladin,retribution,36,16,20
26247,Ludø,ysondre,1280,paladin,retribution,26,15,11
26248,Dieversity,stormscale,1280,paladin,retribution,41,16,25
26249,Nazdarvole,drakthul,1279,paladin,retribution,54,29,25
26250,Aikm,tarren-mill,1279,paladin,retribution,74,36,38
26251,Zulem,grim-batol,1276,paladin,retribution,36,17,19
26252,Aegend,antonidas,1275,paladin,retribution,169,79,90
26253,Doxynator,silvermoon,1275,paladin,retribution,35,14,21
26254,Кетран,howling-fjord,1273,paladin,retribution,48,20,28
26255,Gonhilda,kazzak,1272,paladin,retribution,48,25,23
26256,Lightmonger,drakthul,1271,paladin,retribution,30,17,13
26257,Лейфи,howling-fjord,1271,paladin,retribution,48,23,25
26258,Hammexõr,sylvanas,1271,paladin,retribution,87,39,48
26259,Lightheartx,argent-dawn,1271,paladin,retribution,52,18,34
26260,Hornox,ragnaros,1270,paladin,retribution,54,27,27
26261,Молотоборец,gordunni,1269,paladin,retribution,74,40,34
26262,Cästiël,arathor,1269,paladin,retribution,41,21,20
26263,Plésmo,blackmoore,1269,paladin,retribution,41,20,21
26264,Malagat,die-todeskrallen,1269,paladin,retribution,50,19,31
26265,Кенториус,soulflayer,1268,paladin,retribution,30,21,9
26266,Боевикс,ashenvale,1268,paladin,retribution,42,21,21
26267,Эльбабло,lich-king,1268,paladin,retribution,45,21,24
26268,Monkeylight,ambossar,1268,paladin,retribution,46,20,26
26269,Перизкопец,gordunni,1267,paladin,retribution,32,17,15
26270,Jagen,tyrande,1267,paladin,retribution,63,30,33
26271,Auditõr,argent-dawn,1267,paladin,retribution,85,32,53
26272,Dehanath,draenor,1266,paladin,retribution,41,18,23
26273,Conserva,jaedenar,1265,paladin,retribution,52,32,20
26274,Масачусетсс,gordunni,1263,paladin,retribution,54,28,26
26275,Палочка,howling-fjord,1263,paladin,retribution,102,50,52
26276,Dragonous,darkmoon-faire,1263,paladin,retribution,120,54,66
26277,Irinor,rashgarroth,1262,paladin,retribution,36,18,18
26278,Belldog,tarren-mill,1262,paladin,retribution,42,17,25
26279,Splendida,festung-der-stürme,1260,paladin,retribution,17,14,3
26280,Owiganowi,ulduar,1260,paladin,retribution,36,22,14
26281,Shuler,silvermoon,1260,paladin,retribution,64,37,27
26282,Teogrim,blackmoore,1259,paladin,retribution,54,32,22
26283,Hemdâl,kirin-tor,1259,paladin,retribution,60,31,29
26284,Icearth,pozzo-delleternità,1259,paladin,retribution,140,66,74
26285,Takaret,hyjal,1259,paladin,retribution,145,68,77
26286,Émøùki,dalaran,1258,paladin,retribution,41,19,22
26287,Bärghest,sanguino,1256,paladin,retribution,48,29,19
26288,Carpetcummer,ravencrest,1255,paladin,retribution,36,15,21
26289,Lightppl,outland,1254,paladin,retribution,54,28,26
26290,Миоцуки,gordunni,1254,paladin,retribution,82,37,45
26291,Faithsmemory,silvermoon,1254,paladin,retribution,74,31,43
26292,Derian,antonidas,1253,paladin,retribution,48,18,30
26293,Hollylady,outland,1251,paladin,retribution,42,25,17
26294,Gxdéon,hyjal,1249,paladin,retribution,69,39,30
26295,Snottybrat,draenor,1249,paladin,retribution,86,45,41
26296,Galadrion,dun-modr,1248,paladin,retribution,30,13,17
26297,Asorte,chants-éternels,1248,paladin,retribution,96,40,56
26298,Maloumnik,stormscale,1247,paladin,retribution,18,13,5
26299,Retdream,nemesis,1247,paladin,retribution,18,13,5
26300,Revinox,silvermoon,1247,paladin,retribution,24,15,9
26301,Xanrian,kazzak,1247,paladin,retribution,24,13,11
26302,Liadrineá,burning-blade,1247,paladin,retribution,24,13,11
26303,Moløk,ysondre,1247,paladin,retribution,56,28,28
26304,Leyawin,sanguino,1247,paladin,retribution,48,24,24
26305,Zâre,sanguino,1247,paladin,retribution,71,34,37
26306,Тардариус,gordunni,1247,paladin,retribution,30,13,17
26307,Paladiodinos,hyjal,1247,paladin,retribution,42,16,26
26308,Ilealstras,twisting-nether,1247,paladin,retribution,36,13,23
26309,Khoping,silvermoon,1246,paladin,retribution,18,13,5
26310,Нурти,gordunni,1246,paladin,retribution,18,13,5
26311,Luckyman,aszune,1246,paladin,retribution,24,13,11
26312,Kriszaa,burning-legion,1246,paladin,retribution,36,13,23
26313,Тутн,gordunni,1245,paladin,retribution,24,13,11
26314,Leith,neptulon,1245,paladin,retribution,46,24,22
26315,Eagleone,shattrath,1245,paladin,retribution,30,15,15
26316,Heavensfang,outland,1245,paladin,retribution,30,13,17
26317,Hito,sylvanas,1245,paladin,retribution,30,13,17
26318,Gromzed,ravencrest,1245,paladin,retribution,30,13,17
26319,Sukinsin,aegwynn,1244,paladin,retribution,30,13,17
26320,Marthawise,eredar,1244,paladin,retribution,30,13,17
26321,Proxidus,blackmoore,1244,paladin,retribution,41,16,25
26322,Fufth,pozzo-delleternità,1243,paladin,retribution,30,13,17
26323,Mattüsälëmm,sanguino,1242,paladin,retribution,33,22,11
26324,Jannene,draenor,1242,paladin,retribution,36,13,23
26325,Arkura,nozdormu,1241,paladin,retribution,24,14,10
26326,Joelosteen,neptulon,1241,paladin,retribution,54,29,25
26327,Ague,spinebreaker,1241,paladin,retribution,36,13,23
26328,Ïnata,khaz-modan,1240,paladin,retribution,36,15,21
26329,Níthag,ragnaros,1239,paladin,retribution,24,13,11
26330,Jdizzy,tarren-mill,1239,paladin,retribution,24,13,11
26331,Aguerx,alleria,1239,paladin,retribution,30,13,17
26332,Deldrina,nozdormu,1239,paladin,retribution,42,17,25
26333,Geilershrimp,blackrock,1239,paladin,retribution,42,13,29
26334,Nowitzki,sanguino,1238,paladin,retribution,18,13,5
26335,Moraru,neptulon,1238,paladin,retribution,75,28,47
26336,Cianna,shattered-hand,1237,paladin,retribution,40,13,27
26337,Æe,blackmoore,1236,paladin,retribution,37,22,15
26338,Ventsi,kazzak,1236,paladin,retribution,149,75,74
26339,Singedth,defias-brotherhood,1236,paladin,retribution,57,28,29
26340,Teliriyon,blackrock,1236,paladin,retribution,32,14,18
26341,Khaelor,frostwolf,1235,paladin,retribution,24,13,11
26342,Yrgin,ravencrest,1235,paladin,retribution,120,59,61
26343,Нормвал,gordunni,1235,paladin,retribution,37,13,24
26344,Lewp,tarren-mill,1234,paladin,retribution,18,13,5
26345,Anatorka,drakthul,1234,paladin,retribution,78,39,39
26346,Skénder,kazzak,1234,paladin,retribution,78,29,49
26347,Akelad,arathor,1234,paladin,retribution,48,13,35
26348,Гермесиус,deepholm,1233,paladin,retribution,41,21,20
26349,Valpen,veknilash,1233,paladin,retribution,30,15,15
26350,Хентайбогиня,ashenvale,1233,paladin,retribution,30,13,17
26351,Irhoy,dalaran,1232,paladin,retribution,22,14,8
26352,Zhaz,blackmoore,1232,paladin,retribution,84,38,46
26353,Émilia,frostwolf,1232,paladin,retribution,40,14,26
26354,Цвандр,gordunni,1231,paladin,retribution,64,30,34
26355,Ликанн,soulflayer,1231,paladin,retribution,54,20,34
26356,Bornir,khaz-modan,1230,paladin,retribution,71,33,38
26357,Gerin,ulduar,1230,paladin,retribution,36,15,21
26358,Wumbo,sinstralis,1229,paladin,retribution,36,19,17
26359,Наваляка,deathguard,1228,paladin,retribution,24,13,11
26360,Uthelf,ragnaros,1228,paladin,retribution,36,16,20
26361,Nessùm,hyjal,1228,paladin,retribution,72,28,44
26362,Painshield,outland,1228,paladin,retribution,41,13,28
26363,Walorez,ragnaros,1227,paladin,retribution,23,13,10
26364,Tillak,draenor,1227,paladin,retribution,24,13,11
26365,Llya,blackrock,1227,paladin,retribution,26,14,12
26366,Fintros,silvermoon,1227,paladin,retribution,30,14,16
26367,Roxter,burning-legion,1227,paladin,retribution,30,13,17
26368,Вандиир,soulflayer,1226,paladin,retribution,24,13,11
26369,Barqin,ragnaros,1225,paladin,retribution,31,15,16
26370,Atomicbubble,balnazzar,1225,paladin,retribution,54,26,28
26371,Palantex,drakthul,1225,paladin,retribution,30,13,17
26372,Juozas,argent-dawn,1225,paladin,retribution,30,13,17
26373,Pytha,nozdormu,1224,paladin,retribution,79,43,36
26374,Nollieflip,tarren-mill,1224,paladin,retribution,30,15,15
26375,Ðarkjøjø,hyjal,1224,paladin,retribution,36,17,19
26376,Bootybanger,thrall,1223,paladin,retribution,24,13,11
26377,Patsani,twilights-hammer,1222,paladin,retribution,54,31,23
26378,Cinderlight,aszune,1221,paladin,retribution,24,15,9
26379,Velkar,frostmane,1221,paladin,retribution,56,29,27
26380,Энилейт,lich-king,1220,paladin,retribution,70,44,26
26381,Öwai,dun-modr,1220,paladin,retribution,47,28,19
26382,Valerner,argent-dawn,1220,paladin,retribution,24,13,11
26383,Swagged,kazzak,1220,paladin,retribution,46,21,25
26384,Юлец,galakrond,1220,paladin,retribution,30,13,17
26385,Lagaminë,dalaran,1219,paladin,retribution,111,53,58
26386,Línke,sanguino,1218,paladin,retribution,55,32,23
26387,Ragnarük,khaz-modan,1217,paladin,retribution,42,20,22
26388,Helmed,tarren-mill,1215,paladin,retribution,57,31,26
26389,Kyríé,tarren-mill,1215,paladin,retribution,24,13,11
26390,Гарраж,howling-fjord,1215,paladin,retribution,36,14,22
26391,Джекадамс,gordunni,1215,paladin,retribution,195,74,121
26392,Бьюттасттл,howling-fjord,1215,paladin,retribution,35,13,22
26393,Rilledread,stormscale,1214,paladin,retribution,114,57,57
26394,Джагашарага,soulflayer,1214,paladin,retribution,29,13,16
26395,Jynxedxoxo,blackrock,1214,paladin,retribution,36,16,20
26396,Snowydin,tarren-mill,1213,paladin,retribution,30,17,13
26397,Petitê,blackmoore,1210,paladin,retribution,29,17,12
26398,Platanid,doomhammer,1210,paladin,retribution,62,35,27
26399,Эезекииль,howling-fjord,1210,paladin,retribution,68,34,34
26400,Aistor,burning-legion,1209,paladin,retribution,42,17,25
26401,Lynaé,blackhand,1208,paladin,retribution,25,13,12
26402,Hehtmonghour,sanguino,1208,paladin,retribution,36,17,19
26403,Kýrp,stormreaver,1207,paladin,retribution,43,16,27
26404,Diøstemplar,dun-modr,1206,paladin,retribution,70,36,34
26405,Hypothalamus,silvermoon,1206,paladin,retribution,36,17,19
26406,Storpixpala,drakthul,1205,paladin,retribution,24,13,11
26407,Светлыйкит,blackscar,1204,paladin,retribution,48,25,23
26408,Thorold,earthen-ring,1202,paladin,retribution,63,36,27
26409,Dwangl,silvermoon,1201,paladin,retribution,30,13,17
26410,Pitusá,dun-modr,1201,paladin,retribution,54,20,34
26411,Edyk,silvermoon,1200,paladin,retribution,95,51,44
26412,Лютыйчпок,fordragon,1200,paladin,retribution,76,34,42
26413,Ramsay,arthas,1199,paladin,retribution,25,15,10
26414,Flashyplays,silvermoon,1197,paladin,retribution,24,16,8
26415,Tivv,blackhand,1197,paladin,retribution,29,13,16
26416,Ironstealman,shattered-hand,1196,paladin,retribution,42,13,29
26417,Ustex,argent-dawn,1195,paladin,retribution,29,13,16
26418,Siuras,blackmoore,1194,paladin,retribution,23,13,10
26419,Самерваль,borean-tundra,1194,paladin,retribution,91,47,44
26420,Sertoli,frostwhisper,1194,paladin,retribution,30,15,15
26421,Malianterø,ravencrest,1193,paladin,retribution,132,59,73
26422,Dinøx,archimonde,1192,paladin,retribution,140,67,73
26423,Mma,sylvanas,1192,paladin,retribution,65,31,34
26424,Yanisx,burning-legion,1191,paladin,retribution,43,21,22
26425,Thyalon,ragnaros,1191,paladin,retribution,30,14,16
26426,Hïto,dun-modr,1189,paladin,retribution,24,14,10
26427,Flòope,destromath,1188,paladin,retribution,60,33,27
26428,Ocgynle,alonsus,1188,paladin,retribution,167,88,79
26429,Мистерху,gordunni,1188,paladin,retribution,145,73,72
26430,Freyjä,turalyon,1188,paladin,retribution,120,55,65
26431,Keith,dragonmaw,1188,paladin,retribution,42,17,25
26432,Toshvarak,turalyon,1187,paladin,retribution,60,29,31
26433,Syng,garona,1186,paladin,retribution,36,14,22
26434,Акерсарин,gordunni,1185,paladin,retribution,31,17,14
26435,Shorella,malganis,1183,paladin,retribution,41,22,19
26436,Tracsiee,twisting-nether,1183,paladin,retribution,32,14,18
26437,Perfectum,burning-legion,1182,paladin,retribution,28,13,15
26438,Remthas,argent-dawn,1181,paladin,retribution,57,24,33
26439,Neijih,blackrock,1181,paladin,retribution,32,13,19
26440,Bázer,antonidas,1181,paladin,retribution,34,13,21
26441,Trainingdumy,aszune,1179,paladin,retribution,30,16,14
26442,Raê,hyjal,1179,paladin,retribution,66,26,40
26443,Ylvannka,blackmoore,1177,paladin,retribution,48,23,25
26444,Ункаль,ashenvale,1177,paladin,retribution,156,74,82
26445,Palitard,turalyon,1176,paladin,retribution,48,27,21
26446,Ashernos,tarren-mill,1176,paladin,retribution,29,13,16
26447,Tomkü,burning-legion,1174,paladin,retribution,34,15,19
26448,Æternäl,arathor,1174,paladin,retribution,48,21,27
26449,Exiztant,ravencrest,1173,paladin,retribution,60,32,28
26450,Seigi,tarren-mill,1173,paladin,retribution,42,20,22
26451,Atanasum,dun-modr,1172,paladin,retribution,20,13,7
26452,Spanzer,dun-modr,1172,paladin,retribution,30,16,14
26453,Антисеептик,gordunni,1172,paladin,retribution,69,35,34
26454,Mirauda,nemesis,1171,paladin,retribution,66,23,43
26455,Paladie,dalaran,1168,paladin,retribution,239,126,113
26456,Paillasson,nerzhul,1167,paladin,retribution,52,31,21
26457,Khrotos,draenor,1166,paladin,retribution,72,33,39
26458,Lumino,twilights-hammer,1166,paladin,retribution,47,20,27
26459,Whiffy,silvermoon,1165,paladin,retribution,60,24,36
26460,Zemoss,kazzak,1164,paladin,retribution,24,14,10
26461,Djpalacinka,drakthul,1164,paladin,retribution,36,16,20
26462,Мильфорд,eversong,1162,paladin,retribution,84,37,47
26463,Пропала,greymane,1161,paladin,retribution,60,28,32
26464,Vallorum,ravencrest,1161,paladin,retribution,35,13,22
26465,Holybubo,tarren-mill,1160,paladin,retribution,66,34,32
26466,Beastyblodne,sylvanas,1160,paladin,retribution,36,18,18
26467,Judgemented,turalyon,1160,paladin,retribution,60,27,33
26468,Sufrion,outland,1159,paladin,retribution,42,18,24
26469,Judgement,quelthalas,1158,paladin,retribution,30,20,10
26470,Mosih,bloodfeather,1158,paladin,retribution,56,33,23
26471,Vrgingamer,kazzak,1158,paladin,retribution,48,16,32
26472,Pery,malganis,1157,paladin,retribution,48,28,20
26473,Messîah,outland,1156,paladin,retribution,218,112,106
26474,Vörtëx,tarren-mill,1155,paladin,retribution,29,15,14
26475,Artplex,ravencrest,1154,paladin,retribution,27,15,12
26476,Donwone,aegwynn,1152,paladin,retribution,18,12,6
26477,Ixøne,kazzak,1152,paladin,retribution,18,12,6
26478,Kilô,sylvanas,1152,paladin,retribution,24,12,12
26479,Bighugg,draenor,1152,paladin,retribution,30,12,18
26480,Aflogistina,sylvanas,1151,paladin,retribution,18,12,6
26481,Vorthir,khaz-modan,1151,paladin,retribution,32,16,16
26482,Валандор,gordunni,1151,paladin,retribution,24,12,12
26483,Ретриксвета,eversong,1151,paladin,retribution,24,12,12
26484,Рашенс,gordunni,1151,paladin,retribution,62,26,36
26485,Arkk,blackrock,1151,paladin,retribution,30,12,18
26486,Rizzdaddy,outland,1151,paladin,retribution,30,12,18
26487,Memeadinxx,ravencrest,1151,paladin,retribution,30,12,18
26488,Строу,blackscar,1150,paladin,retribution,18,12,6
26489,Swânn,sanguino,1150,paladin,retribution,18,12,6
26490,Гацкан,gordunni,1150,paladin,retribution,23,13,10
26491,Cigyal,hyjal,1150,paladin,retribution,54,28,26
26492,Stepamusicz,stormreaver,1150,paladin,retribution,42,21,21
26493,Shatar,culte-de-la-rive-noire,1150,paladin,retribution,24,12,12
26494,Käyle,alakir,1150,paladin,retribution,24,12,12
26495,Knusern,dunemaul,1150,paladin,retribution,30,12,18
26496,Konardos,burning-legion,1150,paladin,retribution,30,12,18
26497,Missoii,khaz-modan,1149,paladin,retribution,18,12,6
26498,Jkøø,sanguino,1149,paladin,retribution,24,12,12
26499,Verbrännter,grim-batol,1149,paladin,retribution,30,12,18
26500,Badjake,stormscale,1148,paladin,retribution,18,12,6
26501,Spooder,xavius,1148,paladin,retribution,29,12,17
26502,Deathlaf,argent-dawn,1147,paladin,retribution,18,12,6
26503,Hippiehuman,darkspear,1147,paladin,retribution,18,12,6
26504,Vakaza,cthun,1147,paladin,retribution,24,12,12
26505,Unzufrieden,silvermoon,1147,paladin,retribution,24,12,12
26506,Kirkmeister,terokkar,1147,paladin,retribution,43,19,24
26507,Думклиф,gordunni,1147,paladin,retribution,36,12,24
26508,Nebrii,doomhammer,1146,paladin,retribution,36,19,17
26509,Ruftadin,ragnaros,1146,paladin,retribution,24,12,12
26510,Хельдотер,howling-fjord,1146,paladin,retribution,25,12,13
26511,Retenki,silvermoon,1146,paladin,retribution,30,12,18
26512,Kreselia,ravencrest,1146,paladin,retribution,30,12,18
26513,Иродиада,gordunni,1146,paladin,retribution,30,12,18
26514,Aderos,sylvanas,1145,paladin,retribution,18,12,6
26515,Analnydarek,silvermoon,1145,paladin,retribution,27,12,15
26516,Trefino,blackrock,1144,paladin,retribution,18,12,6
26517,Ultret,silvermoon,1144,paladin,retribution,24,12,12
26518,Paulìe,draenor,1144,paladin,retribution,24,12,12
26519,Медверус,gordunni,1144,paladin,retribution,37,15,22
26520,Whatapity,silvermoon,1144,paladin,retribution,30,12,18
26521,Glarcouf,eldrethalas,1143,paladin,retribution,29,16,13
26522,Rînedaman,ysondre,1143,paladin,retribution,24,12,12
26523,Eleiktra,suramar,1143,paladin,retribution,36,15,21
26524,Bigdamjudge,argent-dawn,1142,paladin,retribution,18,12,6
26525,Gucix,sylvanas,1142,paladin,retribution,24,12,12
26526,Rayshield,tarren-mill,1142,paladin,retribution,47,23,24
26527,Hèmera,archimonde,1141,paladin,retribution,24,12,12
26528,Lerîan,dun-modr,1141,paladin,retribution,24,12,12
26529,Eywinn,silvermoon,1141,paladin,retribution,30,12,18
26530,Unogym,dragonblight,1140,paladin,retribution,24,12,12
26531,Aipal,silvermoon,1138,paladin,retribution,30,12,18
26532,Velikor,dun-modr,1137,paladin,retribution,24,12,12
26533,Névér,steamwheedle-cartel,1134,paladin,retribution,24,12,12
26534,Хампал,howling-fjord,1134,paladin,retribution,29,12,17
26535,Animouse,drakthul,1133,paladin,retribution,18,12,6
26536,Cpsuper,azuremyst,1133,paladin,retribution,24,14,10
26537,Krïstâlùlz,archimonde,1132,paladin,retribution,58,30,28
26538,Palaur,silvermoon,1131,paladin,retribution,30,12,18
26539,Mimkoo,wildhammer,1130,paladin,retribution,27,16,11
26540,Questos,burning-legion,1130,paladin,retribution,45,25,20
26541,Thoorval,silvermoon,1130,paladin,retribution,34,14,20
26542,Quoque,turalyon,1129,paladin,retribution,63,35,28
26543,Pyronort,eredar,1128,paladin,retribution,24,12,12
26544,Nelasson,eredar,1126,paladin,retribution,26,13,13
26545,Deathzinger,aszune,1126,paladin,retribution,24,12,12
26546,Sunsaiy,doomhammer,1125,paladin,retribution,119,63,56
26547,Troj,ahnqiraj,1125,paladin,retribution,51,24,27
26548,Sessian,bronze-dragonflight,1123,paladin,retribution,72,39,33
26549,Адептустер,gordunni,1123,paladin,retribution,38,17,21
26550,Bucaxin,cthun,1121,paladin,retribution,18,12,6
26551,Buckfizz,ysondre,1121,paladin,retribution,36,22,14
26552,Bulle,the-venture-co,1121,paladin,retribution,24,12,12
26553,Ghallandre,khaz-modan,1120,paladin,retribution,24,13,11
26554,Mystíque,die-todeskrallen,1119,paladin,retribution,66,34,32
26555,Duralyon,marécage-de-zangar,1119,paladin,retribution,42,20,22
26556,Joti,proudmoore,1119,paladin,retribution,30,12,18
26557,Bàroo,twisting-nether,1117,paladin,retribution,29,12,17
26558,Enîgmä,ravencrest,1117,paladin,retribution,40,12,28
26559,Themlstake,kazzak,1115,paladin,retribution,18,12,6
26560,Makiwara,emeriss,1113,paladin,retribution,91,44,47
26561,Dafe,zuluhed,1113,paladin,retribution,50,21,29
26562,Dewios,silvermoon,1112,paladin,retribution,30,14,16
26563,Mindoxlawlz,sanguino,1111,paladin,retribution,36,12,24
26564,Ghostfacê,khaz-modan,1105,paladin,retribution,42,20,22
26565,Shädyss,hyjal,1105,paladin,retribution,76,34,42
26566,Prínce,blackmoore,1105,paladin,retribution,32,12,20
26567,Sylazz,blackrock,1104,paladin,retribution,130,60,70
26568,Palabido,nemesis,1101,paladin,retribution,191,85,106
26569,Fëanôr,tarren-mill,1100,paladin,retribution,200,102,98
26570,Ayba,defias-brotherhood,1100,paladin,retribution,30,14,16
26571,Javalie,sanguino,1099,paladin,retribution,21,12,9
26572,Akeemys,ragnaros,1099,paladin,retribution,23,12,11
26573,Baldarlyset,tarren-mill,1099,paladin,retribution,39,13,26
26574,Kaljir,archimonde,1098,paladin,retribution,21,13,8
26575,Ranitwo,tarren-mill,1098,paladin,retribution,28,14,14
26576,Миссйеллоу,gordunni,1097,paladin,retribution,23,12,11
26577,Xflye,khaz-modan,1096,paladin,retribution,41,22,19
26578,Runkpaladin,kazzak,1096,paladin,retribution,60,32,28
26579,Veshnu,blackrock,1095,paladin,retribution,50,20,30
26580,Gropleindsup,ysondre,1095,paladin,retribution,36,14,22
26581,Gnarlds,doomhammer,1094,paladin,retribution,42,24,18
26582,Retrystyle,ragnaros,1093,paladin,retribution,53,24,29
26583,Jebenatreba,sporeggar,1091,paladin,retribution,29,12,17
26584,Irini,sylvanas,1089,paladin,retribution,25,14,11
26585,Milojcica,kazzak,1087,paladin,retribution,17,12,5
26586,Rileys,turalyon,1086,paladin,retribution,114,52,62
26587,Opgezwolle,draenor,1085,paladin,retribution,56,35,21
26588,Phaenre,pozzo-delleternità,1085,paladin,retribution,52,26,26
26589,Azzael,thrall,1085,paladin,retribution,95,35,60
26590,Mírato,blackhand,1083,paladin,retribution,42,19,23
26591,Gllorya,ragnaros,1083,paladin,retribution,40,13,27
26592,Valgar,ragnaros,1081,paladin,retribution,17,12,5
26593,Nenenita,cthun,1081,paladin,retribution,115,58,57
26594,Kollak,dun-modr,1081,paladin,retribution,51,20,31
26595,Sandorr,area-52,1079,paladin,retribution,30,17,13
26596,Aerathil,nethersturm,1079,paladin,retribution,41,22,19
26597,Böb,garona,1078,paladin,retribution,36,14,22
26598,Goungokuhrbo,doomhammer,1077,paladin,retribution,40,24,16
26599,Samail,malganis,1076,paladin,retribution,30,13,17
26600,Thardran,ravencrest,1075,paladin,retribution,30,14,16
26601,Coelslaw,azjolnerub,1074,paladin,retribution,35,12,23
26602,Zelphyr,pozzo-delleternità,1073,paladin,retribution,50,28,22
26603,Starstríder,aszune,1073,paladin,retribution,24,12,12
26604,Êxood,archimonde,1071,paladin,retribution,47,18,29
26605,Gaizilla,burning-blade,1068,paladin,retribution,27,13,14
26606,Wexo,frostwolf,1065,paladin,retribution,40,12,28
26607,Apoffis,burning-legion,1064,paladin,retribution,36,19,17
26608,Durwin,mazrigos,1063,paladin,retribution,55,23,32
26609,Lliissaa,kazzak,1059,paladin,retribution,54,31,23
26610,Хеллпанч,howling-fjord,1059,paladin,retribution,54,29,25
26611,Lytza,frostwolf,1059,paladin,retribution,30,15,15
26612,Doban,shattered-hand,1057,paladin,retribution,27,14,13
26613,Йёкипавер,gordunni,1056,paladin,retribution,16,12,4
26614,Nissesolsken,outland,1056,paladin,retribution,18,11,7
26615,Sølitude,kazzak,1056,paladin,retribution,18,11,7
26616,Сакон,borean-tundra,1056,paladin,retribution,24,11,13
26617,Pia,twisting-nether,1056,paladin,retribution,24,11,13
26618,Franzîskûs,blackmoore,1056,paladin,retribution,24,11,13
26619,Phaewingsftw,kazzak,1056,paladin,retribution,24,11,13
26620,Таурмакус,howling-fjord,1056,paladin,retribution,30,12,18
26621,Nyxbane,kazzak,1056,paladin,retribution,30,11,19
26622,Djmontana,archimonde,1056,paladin,retribution,30,11,19
26623,Evölution,frostmane,1056,paladin,retribution,30,11,19
26624,Turskah,shattered-hand,1055,paladin,retribution,18,11,7
26625,Terrozina,stormscale,1055,paladin,retribution,18,11,7
26626,Holydhanas,outland,1055,paladin,retribution,18,11,7
26627,Erasdin,silvermoon,1055,paladin,retribution,18,11,7
26628,Eléndrên,blackrock,1055,paladin,retribution,18,11,7
26629,Tavil,sylvanas,1055,paladin,retribution,18,11,7
26630,Kalimgor,theradras,1055,paladin,retribution,24,11,13
26631,Шульц,borean-tundra,1055,paladin,retribution,24,11,13
26632,Blademasteer,jaedenar,1055,paladin,retribution,24,11,13
26633,Ijudgeppl,stormscale,1055,paladin,retribution,24,11,13
26634,Mîakhalîfa,tarren-mill,1055,paladin,retribution,24,11,13
26635,Stukker,silvermoon,1055,paladin,retribution,24,11,13
26636,Mythsion,blackmoore,1055,paladin,retribution,24,11,13
26637,Neverdeath,stormscale,1055,paladin,retribution,24,11,13
26638,Vvsdiamonds,archimonde,1055,paladin,retribution,24,11,13
26639,Roostersucka,stormreaver,1055,paladin,retribution,24,11,13
26640,Palandiade,draenor,1055,paladin,retribution,24,11,13
26641,Takezop,dun-modr,1055,paladin,retribution,24,11,13
26642,Spiritbreak,archimonde,1055,paladin,retribution,24,11,13
26643,Kaní,eredar,1055,paladin,retribution,30,11,19
26644,Nukkss,silvermoon,1055,paladin,retribution,30,11,19
26645,Hetrox,silvermoon,1054,paladin,retribution,18,11,7
26646,Aludra,twisting-nether,1054,paladin,retribution,59,33,26
26647,Sinthoràs,shattered-hand,1054,paladin,retribution,36,20,16
26648,Blademàster,twisting-nether,1054,paladin,retribution,22,12,10
26649,Palidos,blackrock,1054,paladin,retribution,24,11,13
26650,Fleckige,nethersturm,1054,paladin,retribution,30,11,19
26651,Phalex,outland,1054,paladin,retribution,30,11,19
26652,Bailleya,drakthul,1054,paladin,retribution,30,11,19
26653,Этокомедия,howling-fjord,1054,paladin,retribution,30,11,19
26654,Redeem,nemesis,1054,paladin,retribution,30,11,19
26655,Хилоретка,blackscar,1053,paladin,retribution,18,11,7
26656,Vendil,tarren-mill,1053,paladin,retribution,18,11,7
26657,Ridethelight,nemesis,1053,paladin,retribution,21,12,9
26658,Snaty,khaz-modan,1053,paladin,retribution,83,44,39
26659,Bartelemeus,draenor,1053,paladin,retribution,24,11,13
26660,Mufuqa,ragnaros,1053,paladin,retribution,24,11,13
26661,Moarcry,outland,1053,paladin,retribution,24,11,13
26662,Trollilolz,eredar,1053,paladin,retribution,24,11,13
26663,Deceneü,kazzak,1053,paladin,retribution,24,11,13
26664,Némesis,frostmane,1053,paladin,retribution,24,11,13
26665,Palaradis,doomhammer,1052,paladin,retribution,18,11,7
26666,Ryaz,blackrock,1052,paladin,retribution,18,11,7
26667,Hideinlight,hellscream,1052,paladin,retribution,24,11,13
26668,Shufflee,drakthul,1052,paladin,retribution,24,11,13
26669,Alard,sanguino,1052,paladin,retribution,30,11,19
26670,Phorios,agamaggan,1052,paladin,retribution,36,11,25
26671,Widj,silvermoon,1051,paladin,retribution,24,11,13
26672,Rinocerb,ravencrest,1051,paladin,retribution,30,11,19
26673,Омникнайтх,howling-fjord,1051,paladin,retribution,36,11,25
26674,Ratedge,hyjal,1050,paladin,retribution,18,11,7
26675,Traýan,blackmoore,1050,paladin,retribution,18,11,7
26676,Dufftroll,kazzak,1050,paladin,retribution,24,11,13
26677,Anamary,ravencrest,1050,paladin,retribution,45,18,27
26678,Antidrasi,turalyon,1050,paladin,retribution,37,12,25
26679,Lóyal,kazzak,1049,paladin,retribution,18,11,7
26680,Plato,arthas,1049,paladin,retribution,30,16,14
26681,Inkuboss,nemesis,1049,paladin,retribution,24,11,13
26682,Freetimer,norgannon,1049,paladin,retribution,30,11,19
26683,Justïce,twisting-nether,1049,paladin,retribution,30,11,19
26684,Malleius,ravencrest,1049,paladin,retribution,30,11,19
26685,Cornfalke,silvermoon,1048,paladin,retribution,18,11,7
26686,Âchîle,garona,1048,paladin,retribution,55,31,24
26687,Gerannan,kirin-tor,1048,paladin,retribution,48,24,24
26688,Huhuu,outland,1048,paladin,retribution,24,11,13
26689,Raptasenda,archimonde,1048,paladin,retribution,68,27,41
26690,Crazybones,marécage-de-zangar,1047,paladin,retribution,36,16,20
26691,Aury,mannoroth,1046,paladin,retribution,18,11,7
26692,Arhu,stormscale,1046,paladin,retribution,24,14,10
26693,Spizz,dun-modr,1046,paladin,retribution,30,11,19
26694,Krustenkaese,kelthuzad,1045,paladin,retribution,18,11,7
26695,Leilak,draenor,1045,paladin,retribution,44,26,18
26696,Daicic,kazzak,1045,paladin,retribution,19,11,8
26697,Palakag,blackhand,1045,paladin,retribution,42,12,30
26698,Jooki,drakthul,1044,paladin,retribution,18,11,7
26699,Kaelron,sanguino,1044,paladin,retribution,18,11,7
26700,Traqnbilkarq,stormscale,1044,paladin,retribution,24,12,12
26701,Shadderkpal,draenor,1042,paladin,retribution,30,11,19
26702,Harycon,thrall,1041,paladin,retribution,30,11,19
26703,Xinti,silvermoon,1039,paladin,retribution,17,11,6
26704,Dildotbagins,argent-dawn,1039,paladin,retribution,58,34,24
26705,Bigdamjudgee,outland,1039,paladin,retribution,23,11,12
26706,Sinalia,shattrath,1039,paladin,retribution,24,11,13
26707,Killa,stormrage,1038,paladin,retribution,24,11,13
26708,Janky,draenor,1038,paladin,retribution,30,11,19
26709,Rêmo,blackrock,1037,paladin,retribution,28,17,11
26710,Поласс,gordunni,1037,paladin,retribution,23,11,12
26711,Bitether,burning-legion,1037,paladin,retribution,24,11,13
26712,Lowen,deathwing,1037,paladin,retribution,41,11,30
26713,Эллессар,howling-fjord,1036,paladin,retribution,30,12,18
26714,Kaedena,kaelthas,1035,paladin,retribution,18,11,7
26715,Saró,ravencrest,1035,paladin,retribution,22,12,10
26716,Celdrin,silvermoon,1035,paladin,retribution,23,12,11
26717,Лефша,soulflayer,1034,paladin,retribution,18,11,7
26718,Фокспро,lich-king,1032,paladin,retribution,24,11,13
26719,Gôdfâthér,kazzak,1031,paladin,retribution,23,11,12
26720,Nykothpn,ghostlands,1028,paladin,retribution,12,11,1
26721,Aégon,archimonde,1026,paladin,retribution,54,23,31
26722,Khveasir,argent-dawn,1026,paladin,retribution,36,11,25
26723,Арморих,gordunni,1024,paladin,retribution,22,11,11
26724,Hateless,tarren-mill,1024,paladin,retribution,28,11,17
26725,Zanathos,onyxia,1023,paladin,retribution,30,20,10
26726,Justrhino,kazzak,1023,paladin,retribution,29,11,18
26727,Crazypits,silvermoon,1022,paladin,retribution,42,18,24
26728,Nomeel,twisting-nether,1019,paladin,retribution,157,81,76
26729,Devilsangel,antonidas,1019,paladin,retribution,29,11,18
26730,Arathorin,ravencrest,1016,paladin,retribution,30,15,15
26731,Matikosik,steamwheedle-cartel,1014,paladin,retribution,30,12,18
26732,Quasimotto,turalyon,1014,paladin,retribution,36,13,23
26733,Vonryan,defias-brotherhood,1011,paladin,retribution,51,20,31
26734,Crynó,blackmoore,1010,paladin,retribution,30,13,17
26735,Mickeyvorace,archimonde,1009,paladin,retribution,24,11,13
26736,Danneris,sanguino,1008,paladin,retribution,31,15,16
26737,Morhgain,kazzak,1007,paladin,retribution,42,21,21
26738,Renaseh,twisting-nether,1007,paladin,retribution,23,11,12
26739,Kipperb,kazzak,1007,paladin,retribution,23,11,12
26740,ßrav,hyjal,1007,paladin,retribution,27,12,15
26741,Bomsamdi,draenor,1007,paladin,retribution,85,37,48
26742,Rdmhrvojehr,tarren-mill,1005,paladin,retribution,31,15,16
26743,Dadpally,shattered-hand,1005,paladin,retribution,60,27,33
26744,Ilovemylay,area-52,1004,paladin,retribution,21,11,10
26745,Akakaboto,draenor,1003,paladin,retribution,30,11,19
26746,Монбиин,soulflayer,1001,paladin,retribution,24,12,12
26747,Sheïkka,hyjal,1001,paladin,retribution,68,30,38
26748,Нэксти,howling-fjord,1001,paladin,retribution,29,11,18
26749,Loire,blackmoore,1000,paladin,retribution,17,11,6
26750,Сверхпаладин,howling-fjord,999,paladin,retribution,18,11,7
26751,Tomales,aggramar,998,paladin,retribution,36,18,18
26752,Killtauren,kazzak,998,paladin,retribution,78,36,42
26753,Эксвайп,howling-fjord,997,paladin,retribution,23,11,12
26754,Kealen,nemesis,997,paladin,retribution,85,34,51
26755,Bryllks,die-todeskrallen,996,paladin,retribution,42,25,17
26756,Pratt,deathwing,989,paladin,retribution,20,11,9
26757,Zerohour,kilrogg,987,paladin,retribution,34,11,23
26758,Jenyu,sanguino,986,paladin,retribution,29,13,16
26759,Assyr,blackmoore,984,paladin,retribution,17,11,6
26760,Cydor,khaz-modan,983,paladin,retribution,36,13,23
26761,Ukey,sanguino,978,paladin,retribution,48,27,21
26762,Haquiles,shendralar,974,paladin,retribution,22,12,10
26763,Summuno,eredar,973,paladin,retribution,150,59,91
26764,Supou,twisting-nether,972,paladin,retribution,24,14,10
26765,Almohalhil,tarren-mill,972,paladin,retribution,24,13,11
26766,Бунча,gordunni,971,paladin,retribution,66,23,43
26767,Thebestpala,tarren-mill,969,paladin,retribution,25,11,14
26768,Ârthâstrâs,terrordar,968,paladin,retribution,30,17,13
26769,Fannii,ravencrest,968,paladin,retribution,24,11,13
26770,Eltruite,archimonde,962,paladin,retribution,60,25,35
26771,Joekickass,madmortem,960,paladin,retribution,12,10,2
26772,Fîzè,blackmoore,960,paladin,retribution,16,11,5
26773,Vhalkur,dun-modr,960,paladin,retribution,18,10,8
26774,Nzmamba,burning-legion,960,paladin,retribution,18,10,8
26775,Blazerlolz,kazzak,960,paladin,retribution,18,10,8
26776,Navayo,frostmourne,960,paladin,retribution,18,10,8
26777,Roklim,blackhand,960,paladin,retribution,18,10,8
26778,Rubína,aegwynn,960,paladin,retribution,20,10,10
26779,Daveboss,dragonblight,960,paladin,retribution,24,10,14
26780,Sulask,argent-dawn,960,paladin,retribution,24,10,14
26781,Darkkissx,lightbringer,960,paladin,retribution,24,10,14
26782,Байстр,soulflayer,960,paladin,retribution,24,10,14
26783,Dioxius,stormscale,960,paladin,retribution,24,10,14
26784,Валькирия,grom,960,paladin,retribution,24,10,14
26785,Styxpl,blackhand,960,paladin,retribution,30,10,20
26786,Садистка,soulflayer,960,paladin,retribution,30,10,20
26787,Атласс,gordunni,960,paladin,retribution,30,10,20
26788,Saulencio,zuljin,960,paladin,retribution,36,10,26
26789,Dìe,silvermoon,959,paladin,retribution,18,10,8
26790,Malapal,hyjal,959,paladin,retribution,18,10,8
26791,Lonesoul,tarren-mill,959,paladin,retribution,18,10,8
26792,Gangb,ravencrest,959,paladin,retribution,18,10,8
26793,Bunurata,silvermoon,959,paladin,retribution,18,10,8
26794,Адвакаад,soulflayer,959,paladin,retribution,18,10,8
26795,Aroyul,silvermoon,959,paladin,retribution,18,10,8
26796,Omaw,ragnaros,959,paladin,retribution,18,10,8
26797,Makakí,twisting-nether,959,paladin,retribution,18,10,8
26798,Vindicatê,stormscale,959,paladin,retribution,18,10,8
26799,Naenel,dun-modr,959,paladin,retribution,24,10,14
26800,Croptol,dun-modr,959,paladin,retribution,24,10,14
26801,Thaddios,burning-blade,959,paladin,retribution,24,10,14
26802,Нижмубабл,soulflayer,959,paladin,retribution,27,11,16
26803,Armas,stormscale,959,paladin,retribution,28,11,17
26804,Annurra,quelthalas,959,paladin,retribution,30,10,20
26805,Teshkipowa,kazzak,959,paladin,retribution,30,10,20
26806,Mögräine,grim-batol,959,paladin,retribution,30,10,20
26807,Coralinê,sanguino,958,paladin,retribution,12,10,2
26808,Eosan,argent-dawn,958,paladin,retribution,12,10,2
26809,Nyren,guldan,958,paladin,retribution,12,10,2
26810,Милликсайс,howling-fjord,958,paladin,retribution,18,10,8
26811,Sorciex,blackmoore,958,paladin,retribution,18,10,8
26812,Arcardi,dun-morogh,958,paladin,retribution,18,10,8
26813,Антрасс,soulflayer,958,paladin,retribution,18,10,8
26814,Balderstomp,jaedenar,958,paladin,retribution,18,10,8
26815,Valanysa,blackmoore,958,paladin,retribution,18,10,8
26816,Béhèlit,sargeras,958,paladin,retribution,18,10,8
26817,Леаркус,blackscar,958,paladin,retribution,24,10,14
26818,Évert,twisting-nether,957,paladin,retribution,12,10,2
26819,Keógh,kazzak,957,paladin,retribution,12,10,2
26820,Rèmi,pozzo-delleternità,957,paladin,retribution,16,11,5
26821,Xalthan,defias-brotherhood,957,paladin,retribution,18,10,8
26822,Кадаврициан,howling-fjord,957,paladin,retribution,24,10,14
26823,Winterwall,sylvanas,957,paladin,retribution,24,10,14
26824,Dimdon,silvermoon,957,paladin,retribution,24,10,14
26825,Feenux,drakthul,956,paladin,retribution,16,11,5
26826,Malodos,archimonde,956,paladin,retribution,18,10,8
26827,Ayoub,argent-dawn,956,paladin,retribution,18,10,8
26828,Mílkme,antonidas,956,paladin,retribution,18,10,8
26829,Injustice,chamber-of-aspects,956,paladin,retribution,25,11,14
26830,Szaporító,ragnaros,956,paladin,retribution,24,10,14
26831,Diaéna,kirin-tor,956,paladin,retribution,30,10,20
26832,Didtaras,terokkar,956,paladin,retribution,30,10,20
26833,Løøktår,ysondre,955,paladin,retribution,18,10,8
26834,Mííss,silvermoon,955,paladin,retribution,24,10,14
26835,Crawladin,eonar,955,paladin,retribution,24,10,14
26836,Holypurger,shattered-hand,955,paladin,retribution,25,10,15
26837,Calluk,turalyon,955,paladin,retribution,29,11,18
26838,Рапсодихх,gordunni,955,paladin,retribution,32,10,22
26839,Palahôlika,antonidas,953,paladin,retribution,18,10,8
26840,Iqso,argent-dawn,953,paladin,retribution,18,10,8
26841,Palädörette,dalaran,951,paladin,retribution,17,11,6
26842,Ressurection,outland,951,paladin,retribution,58,25,33
26843,Nözderg,archimonde,951,paladin,retribution,30,10,20
26844,Gottfrid,sunstrider,949,paladin,retribution,18,10,8
26845,Groelin,frostmane,949,paladin,retribution,18,10,8
26846,Cáli,forscherliga,949,paladin,retribution,18,10,8
26847,Cyclope,frostmane,948,paladin,retribution,26,10,16
26848,Xemoth,kazzak,947,paladin,retribution,18,10,8
26849,Olwie,argent-dawn,947,paladin,retribution,18,10,8
26850,Bierkapítän,blackrock,946,paladin,retribution,12,10,2
26851,Ziggyz,kul-tiras,945,paladin,retribution,19,10,9
26852,Thëone,exodar,945,paladin,retribution,22,11,11
26853,Donttaskwhy,sylvanas,942,paladin,retribution,30,10,20
26854,Patzi,die-todeskrallen,941,paladin,retribution,67,33,34
26855,Kawakii,outland,940,paladin,retribution,18,10,8
26856,Glotzkowski,kelthuzad,938,paladin,retribution,18,10,8
26857,Meneth,elune,930,paladin,retribution,55,15,40
26858,Josuaa,ragnaros,929,paladin,retribution,80,36,44
26859,Wolya,blackrock,927,paladin,retribution,21,11,10
26860,Ghéttørèt,das-konsortium,927,paladin,retribution,26,11,15
26861,Куоширо,goldrinn,925,paladin,retribution,36,16,20
26862,Lightblaze,doomhammer,924,paladin,retribution,54,18,36
26863,Eatfasteatas,doomhammer,923,paladin,retribution,12,10,2
26864,Zayonix,amanthul,923,paladin,retribution,17,10,7
26865,Stfortt,ragnaros,920,paladin,retribution,18,11,7
26866,Zingler,norgannon,920,paladin,retribution,30,16,14
26867,Atacan,twisting-nether,920,paladin,retribution,48,23,25
26868,Luxor,sporeggar,919,paladin,retribution,24,14,10
26869,Ressler,tichondrius,919,paladin,retribution,27,12,15
26870,Klikas,twisting-nether,918,paladin,retribution,36,18,18
26871,Схемас,gordunni,910,paladin,retribution,36,14,22
26872,Helvirya,defias-brotherhood,909,paladin,retribution,198,87,111
26873,Rustig,talnivarr,906,paladin,retribution,17,10,7
26874,Ranish,aegwynn,906,paladin,retribution,33,11,22
26875,Апония,gordunni,906,paladin,retribution,34,11,23
26876,Vibeer,ravencrest,901,paladin,retribution,122,59,63
26877,Érléuchtas,kazzak,899,paladin,retribution,22,11,11
26878,Танси,fordragon,898,paladin,retribution,18,11,7
26879,Gurutze,ragnaros,896,paladin,retribution,16,10,6
26880,Nordiusek,drakthul,896,paladin,retribution,28,10,18
26881,Tigerherz,antonidas,895,paladin,retribution,28,10,18
26882,Lògàn,pozzo-delleternità,894,paladin,retribution,20,10,10
26883,Lolladin,blackmoore,894,paladin,retribution,26,10,16
26884,Reiwyn,archimonde,893,paladin,retribution,28,10,18
26885,Vexxus,blackrock,892,paladin,retribution,48,22,26
26886,Milicos,sylvanas,891,paladin,retribution,48,24,24
26887,Tánk,twilights-hammer,888,paladin,retribution,48,22,26
26888,Purjolöken,tarren-mill,887,paladin,retribution,26,10,16
26889,Romkaq,silvermoon,884,paladin,retribution,18,11,7
26890,Pepsimaxpvp,blackmoore,880,paladin,retribution,25,10,15
26891,Celébriel,twisting-nether,877,paladin,retribution,19,10,9
26892,Fardahr,ravencrest,877,paladin,retribution,24,10,14
26893,Evilerpaly,stormscale,873,paladin,retribution,17,11,6
26894,Фэнон,gordunni,864,paladin,retribution,12,9,3
26895,Stitchup,argent-dawn,864,paladin,retribution,12,9,3
26896,Unleashed,antonidas,864,paladin,retribution,12,9,3
26897,Eazybubble,blackhand,864,paladin,retribution,12,9,3
26898,Сынбогов,gordunni,864,paladin,retribution,12,9,3
26899,Subzie,archimonde,864,paladin,retribution,12,9,3
26900,Duno,archimonde,864,paladin,retribution,12,9,3
26901,Holmat,twisting-nether,864,paladin,retribution,12,9,3
26902,Ðox,frostmane,864,paladin,retribution,12,9,3
26903,Holysnickers,tarren-mill,864,paladin,retribution,12,9,3
26904,Camusa,kazzak,864,paladin,retribution,12,9,3
26905,Camusax,kazzak,864,paladin,retribution,12,9,3
26906,Loani,dalaran,864,paladin,retribution,18,9,9
26907,Hølypwnjk,forscherliga,864,paladin,retribution,18,9,9
26908,Retgodx,eredar,864,paladin,retribution,18,9,9
26909,Püshup,archimonde,864,paladin,retribution,18,9,9
26910,Pesterci,draenor,864,paladin,retribution,18,9,9
26911,Zey,auchindoun,864,paladin,retribution,18,9,9
26912,Gulyas,tarren-mill,864,paladin,retribution,18,9,9
26913,Kaarsius,defias-brotherhood,864,paladin,retribution,18,9,9
26914,Noxy,thrall,864,paladin,retribution,18,9,9
26915,Cùpìdstunt,draenor,864,paladin,retribution,18,9,9
26916,Limitlez,blackhand,864,paladin,retribution,18,9,9
26917,Paterymon,ravencrest,864,paladin,retribution,18,9,9
26918,Mitsoû,archimonde,864,paladin,retribution,18,9,9
26919,Jicekaa,archimonde,864,paladin,retribution,18,9,9
26920,Xinxin,azshara,864,paladin,retribution,18,9,9
26921,Scillá,aegwynn,864,paladin,retribution,18,9,9
26922,Reckonin,nagrand,864,paladin,retribution,18,9,9
26923,Lagrops,chants-éternels,864,paladin,retribution,24,9,15
26924,Krýptø,ravencrest,864,paladin,retribution,24,9,15
26925,Thoriz,elune,864,paladin,retribution,24,9,15
26926,Shuukz,blackmoore,864,paladin,retribution,24,9,15
26927,Veldora,zuljin,864,paladin,retribution,24,9,15
26928,Kæycc,blackmoore,864,paladin,retribution,24,9,15
26929,Saiyaan,silvermoon,864,paladin,retribution,24,9,15
26930,Lindrone,aggra-português,864,paladin,retribution,24,9,15
26931,Святстраж,gordunni,864,paladin,retribution,27,10,17
26932,Umirinbruv,zenedar,864,paladin,retribution,30,9,21
26933,Døgpaladin,outland,864,paladin,retribution,30,9,21
26934,Âtom,outland,864,paladin,retribution,30,9,21
26935,Aksios,kazzak,863,paladin,retribution,12,9,3
26936,Vootele,draenor,863,paladin,retribution,12,9,3
26937,Nakedholy,draenor,863,paladin,retribution,12,9,3
26938,Váliant,tarren-mill,863,paladin,retribution,12,9,3
26939,Koltop,ravencrest,863,paladin,retribution,12,9,3
26940,Тарйья,gordunni,863,paladin,retribution,13,9,4
26941,Paidien,twisting-nether,863,paladin,retribution,17,9,8
26942,Dälaghetto,kilrogg,863,paladin,retribution,18,9,9
26943,Nordkreuz,aegwynn,863,paladin,retribution,18,9,9
26944,Fujszi,arathor,863,paladin,retribution,18,9,9
26945,Durnell,sylvanas,863,paladin,retribution,18,9,9
26946,Veejxo,silvermoon,863,paladin,retribution,18,9,9
26947,Yngild,antonidas,863,paladin,retribution,18,9,9
26948,Thaldrael,colinas-pardas,863,paladin,retribution,18,9,9
26949,Lightsbreath,ragnaros,863,paladin,retribution,18,9,9
26950,Sildrit,draenor,863,paladin,retribution,18,9,9
26951,Зольвинталь,deathguard,863,paladin,retribution,18,9,9
26952,Frequencer,ragnaros,863,paladin,retribution,18,9,9
26953,Добегуубью,thermaplugg,863,paladin,retribution,21,10,11
26954,Galerian,twilights-hammer,863,paladin,retribution,24,9,15
26955,Celerius,trollbane,863,paladin,retribution,24,9,15
26956,Palarezz,ysondre,863,paladin,retribution,24,9,15
26957,Axone,ravencrest,863,paladin,retribution,24,9,15
26958,Дэвсон,greymane,863,paladin,retribution,24,9,15
26959,Asgardietis,kazzak,863,paladin,retribution,27,10,17
26960,Anesthesiax,ravencrest,863,paladin,retribution,33,10,23
26961,Tapsgg,silvermoon,863,paladin,retribution,30,9,21
26962,Саламанлдрыч,soulflayer,863,paladin,retribution,42,9,33
26963,Blatrix,kazzak,862,paladin,retribution,12,9,3
26964,Wtyou,blackhand,862,paladin,retribution,12,9,3
26965,Kabóm,kazzak,862,paladin,retribution,12,9,3
26966,Ephialtis,hyjal,862,paladin,retribution,12,9,3
26967,Paduj,kazzak,862,paladin,retribution,12,9,3
26968,Stinkytoes,draenor,862,paladin,retribution,18,9,9
26969,Slipoj,blackhand,862,paladin,retribution,18,9,9
26970,Alâkir,kazzak,862,paladin,retribution,18,9,9
26971,Lìmier,ysondre,862,paladin,retribution,18,9,9
26972,Darkenorr,silvermoon,862,paladin,retribution,18,9,9
26973,Yæø,archimonde,862,paladin,retribution,18,9,9
26974,Mugraine,ravencrest,862,paladin,retribution,18,9,9
26975,Роллита,gordunni,862,paladin,retribution,24,9,15
26976,Ллосла,howling-fjord,862,paladin,retribution,36,9,27
26977,Viffi,darkspear,861,paladin,retribution,12,9,3
26978,Skittlespala,twisting-nether,861,paladin,retribution,12,9,3
26979,Retributon,madmortem,861,paladin,retribution,18,9,9
26980,Bubblefett,ysera,861,paladin,retribution,18,9,9
26981,Paajaxd,drakthul,861,paladin,retribution,18,9,9
26982,Jpally,ravencrest,861,paladin,retribution,18,9,9
26983,Wøømy,hyjal,861,paladin,retribution,24,9,15
26984,Sölaria,silvermoon,860,paladin,retribution,18,9,9
26985,Catsnek,darksorrow,860,paladin,retribution,18,9,9
26986,Banister,eredar,860,paladin,retribution,24,9,15
26987,Artorya,outland,859,paladin,retribution,18,9,9
26988,Jêzus,blackrock,858,paladin,retribution,12,9,3
26989,Кс,greymane,858,paladin,retribution,18,9,9
26990,Rètbull,blackhand,858,paladin,retribution,18,9,9
26991,Ènyalius,silvermoon,858,paladin,retribution,24,9,15
26992,Immortalkrux,archimonde,858,paladin,retribution,71,23,48
26993,Gljeto,tarren-mill,856,paladin,retribution,12,9,3
26994,Mootaindew,tarren-mill,855,paladin,retribution,12,9,3
26995,Holytrol,kazzak,855,paladin,retribution,18,9,9
26996,Сапфирия,galakrond,855,paladin,retribution,30,9,21
26997,Legiønr,ravencrest,854,paladin,retribution,12,9,3
26998,Greyeyed,kazzak,854,paladin,retribution,32,10,22
26999,Bubblemama,aegwynn,853,paladin,retribution,18,9,9
27000,Fortination,dalaran,853,paladin,retribution,18,9,9
27001,Fløki,blackrock,848,paladin,retribution,20,10,10
27002,Fortplus,pozzo-delleternità,846,paladin,retribution,28,13,15
27003,Bellùm,archimonde,846,paladin,retribution,20,9,11
27004,Atírpákja,doomhammer,846,paladin,retribution,21,9,12
27005,Ericafontës,kazzak,846,paladin,retribution,23,9,14
27006,Knygnesys,silvermoon,844,paladin,retribution,15,11,4
27007,Orelius,guldan,838,paladin,retribution,42,16,26
27008,Тельбрук,gordunni,832,paladin,retribution,22,9,13
27009,Humangüy,kazzak,831,paladin,retribution,23,9,14
27010,Драгун,gordunni,830,paladin,retribution,61,27,34
27011,Dôrä,ysondre,830,paladin,retribution,23,9,14
27012,Pàlàthor,khaz-modan,826,paladin,retribution,18,9,9
27013,Kolam,khaz-modan,825,paladin,retribution,24,10,14
27014,Spánkit,stormscale,825,paladin,retribution,26,10,16
27015,Pyrogon,malorne,823,paladin,retribution,164,76,88
27016,Vuzetevacabo,doomhammer,823,paladin,retribution,114,51,63
27017,Scralet,tarren-mill,815,paladin,retribution,17,9,8
27018,Mckellen,antonidas,810,paladin,retribution,15,10,5
27019,Valaudu,stormscale,810,paladin,retribution,17,9,8
27020,Ararion,tarren-mill,809,paladin,retribution,18,10,8
27021,Khadet,draenor,809,paladin,retribution,22,10,12
27022,Fumatelo,tyrande,808,paladin,retribution,18,9,9
27023,Fufenzee,stormscale,808,paladin,retribution,101,41,60
27024,Choyoki,blackmoore,802,paladin,retribution,26,9,17
27025,Melnes,draenor,801,paladin,retribution,23,12,11
27026,Ксамо,howling-fjord,798,paladin,retribution,11,9,2
27027,Юримия,blackscar,798,paladin,retribution,17,9,8
27028,Penknife,ravencrest,797,paladin,retribution,20,9,11
27029,Altrazel,archimonde,795,paladin,retribution,20,10,10
27030,Guckzu,malganis,794,paladin,retribution,25,10,15
27031,Сенторин,borean-tundra,791,paladin,retribution,28,9,19
27032,Kubrat,eredar,788,paladin,retribution,42,16,26
27033,Legitpower,silvermoon,783,paladin,retribution,46,19,27
27034,Сильвернайт,soulflayer,779,paladin,retribution,29,10,19
27035,Баблыч,borean-tundra,771,paladin,retribution,42,17,25
27036,Sunfather,twilights-hammer,769,paladin,retribution,71,32,39
27037,Xoriun,norgannon,768,paladin,retribution,12,8,4
27038,Biqmac,mugthol,768,paladin,retribution,12,8,4
27039,Pakór,blackrock,768,paladin,retribution,12,8,4
27040,Enanon,zuljin,768,paladin,retribution,12,8,4
27041,Touch,vashj,768,paladin,retribution,12,8,4
27042,Jïncks,anachronos,768,paladin,retribution,12,8,4
27043,Sweyz,archimonde,768,paladin,retribution,12,8,4
27044,Odisea,burning-blade,768,paladin,retribution,12,8,4
27045,Øttøø,outland,768,paladin,retribution,12,8,4
27046,Фантаззер,soulflayer,768,paladin,retribution,12,8,4
27047,Herô,drakthul,768,paladin,retribution,12,8,4
27048,Superhick,veknilash,768,paladin,retribution,12,8,4
27049,Khyleancbum,sanguino,768,paladin,retribution,12,8,4
27050,Insanepvplol,archimonde,768,paladin,retribution,12,8,4
27051,Mooriel,burning-legion,768,paladin,retribution,15,9,6
27052,Ласковыйкуфа,howling-fjord,768,paladin,retribution,15,9,6
27053,Легейнда,soulflayer,768,paladin,retribution,18,8,10
27054,Rùfus,tarren-mill,768,paladin,retribution,18,8,10
27055,Endavour,ravencrest,768,paladin,retribution,18,8,10
27056,Пчелодин,howling-fjord,768,paladin,retribution,18,8,10
27057,Mudan,stormscale,768,paladin,retribution,18,8,10
27058,ßßæßßæßß,stormscale,768,paladin,retribution,18,8,10
27059,Хитвэйв,soulflayer,768,paladin,retribution,18,8,10
27060,Dadyolimp,kazzak,768,paladin,retribution,18,8,10
27061,Sekztokio,blackmoore,768,paladin,retribution,18,8,10
27062,Retrigodx,ragnaros,768,paladin,retribution,18,8,10
27063,Iiwar,silvermoon,768,paladin,retribution,18,8,10
27064,Círuq,eredar,768,paladin,retribution,18,8,10
27065,Valiscar,antonidas,768,paladin,retribution,18,8,10
27066,Кисаммэ,howling-fjord,768,paladin,retribution,18,8,10
27067,Laaserjörö,outland,768,paladin,retribution,18,8,10
27068,Bubblor,ravencrest,768,paladin,retribution,18,8,10
27069,Чемеряк,gordunni,768,paladin,retribution,18,8,10
27070,Holyinstinct,bronze-dragonflight,768,paladin,retribution,18,8,10
27071,Enmà,archimonde,768,paladin,retribution,18,8,10
27072,Deresos,anetheron,768,paladin,retribution,18,8,10
27073,Chuy,burning-legion,768,paladin,retribution,18,8,10
27074,Ngel,marécage-de-zangar,768,paladin,retribution,18,8,10
27075,Bloodbeard,twisting-nether,768,paladin,retribution,18,8,10
27076,Getpawned,rexxar,768,paladin,retribution,18,8,10
27077,Hydrolic,blackrock,768,paladin,retribution,18,8,10
27078,Bâbass,sargeras,768,paladin,retribution,18,8,10
27079,Postî,eredar,768,paladin,retribution,18,8,10
27080,Зена,gordunni,768,paladin,retribution,18,8,10
27081,Abbendis,twisting-nether,768,paladin,retribution,18,8,10
27082,Ббпп,howling-fjord,768,paladin,retribution,18,8,10
27083,Retlikeme,ravencrest,768,paladin,retribution,18,8,10
27084,Летвамар,gordunni,768,paladin,retribution,18,8,10
27085,Palamag,grim-batol,768,paladin,retribution,18,8,10
27086,Goüstà,ysondre,768,paladin,retribution,18,8,10
27087,Piratalpha,thrall,768,paladin,retribution,18,8,10
27088,Sinclo,hyjal,768,paladin,retribution,20,8,12
27089,Vilayesyo,ravencrest,768,paladin,retribution,24,8,16
27090,Piti,burning-legion,768,paladin,retribution,24,8,16
27091,Ashmaker,khaz-modan,768,paladin,retribution,24,8,16
27092,Benzimus,ragnaros,768,paladin,retribution,24,8,16
27093,Powerphally,outland,768,paladin,retribution,24,8,16
27094,Tjabo,burning-blade,768,paladin,retribution,24,8,16
27095,Wankerjim,ghostlands,768,paladin,retribution,24,8,16
27096,Mythorpala,dun-modr,768,paladin,retribution,24,8,16
27097,Найдэкер,gordunni,768,paladin,retribution,24,8,16
27098,Toxií,argent-dawn,768,paladin,retribution,30,8,22
27099,Ландри,greymane,767,paladin,retribution,12,8,4
27100,Dawnnslayer,kazzak,767,paladin,retribution,12,8,4
27101,Spinzr,draenor,767,paladin,retribution,12,8,4
27102,Crossfaded,azjolnerub,767,paladin,retribution,12,8,4
27103,Unforsakenx,silvermoon,767,paladin,retribution,12,8,4
27104,Serenityxo,twisting-nether,767,paladin,retribution,12,8,4
27105,Acp,twisting-nether,767,paladin,retribution,12,8,4
27106,Hutimeni,turalyon,767,paladin,retribution,12,8,4
27107,Lightblaster,argent-dawn,767,paladin,retribution,12,8,4
27108,Blagori,blackhand,767,paladin,retribution,12,8,4
27109,Londonn,silvermoon,767,paladin,retribution,12,8,4
27110,Pitux,dun-modr,767,paladin,retribution,16,9,7
27111,Samuel,ahnqiraj,767,paladin,retribution,18,8,10
27112,Mïnnîe,ysondre,767,paladin,retribution,18,8,10
27113,Манддалорец,howling-fjord,767,paladin,retribution,18,8,10
27114,Belight,burning-legion,767,paladin,retribution,18,8,10
27115,Retenki,draenor,767,paladin,retribution,18,8,10
27116,Aston,sylvanas,767,paladin,retribution,18,8,10
27117,Athain,sanguino,767,paladin,retribution,18,8,10
27118,Baxteria,dun-modr,767,paladin,retribution,18,8,10
27119,Hôrrible,ravencrest,767,paladin,retribution,18,8,10
27120,Palachdinka,drakthul,767,paladin,retribution,18,8,10
27121,Бальтазёрыч,soulflayer,767,paladin,retribution,18,8,10
27122,Retgrets,kazzak,767,paladin,retribution,18,8,10
27123,Xersys,draenor,767,paladin,retribution,18,8,10
27124,Phlakorn,blackhand,767,paladin,retribution,18,8,10
27125,Uweósas,aegwynn,767,paladin,retribution,18,8,10
27126,Dideta,colinas-pardas,767,paladin,retribution,18,8,10
27127,Gaveren,ravencrest,767,paladin,retribution,18,8,10
27128,Nicolae,colinas-pardas,767,paladin,retribution,18,8,10
27129,Thoreas,perenolde,767,paladin,retribution,24,8,16
27130,Brightgrove,silvermoon,767,paladin,retribution,24,8,16
27131,Freeloliipop,darksorrow,767,paladin,retribution,24,8,16
27132,Saath,malfurion,767,paladin,retribution,24,8,16
27133,Lusugo,alakir,767,paladin,retribution,24,8,16
27134,Konithis,doomhammer,766,paladin,retribution,12,8,4
27135,Fremuduin,argent-dawn,766,paladin,retribution,12,8,4
27136,Laugan,ysondre,766,paladin,retribution,12,8,4
27137,Ryozupala,frostwolf,766,paladin,retribution,12,8,4
27138,Méény,archimonde,766,paladin,retribution,18,8,10
27139,Beefbombs,blackmoore,766,paladin,retribution,18,8,10
27140,Quordthor,sanguino,766,paladin,retribution,24,8,16
27141,Quaterbâck,antonidas,766,paladin,retribution,24,8,16
27142,Mareshki,outland,766,paladin,retribution,24,8,16
27143,Notsomuch,alakir,765,paladin,retribution,15,9,6
27144,Liardin,draenor,765,paladin,retribution,18,8,10
27145,Wtfudo,sylvanas,765,paladin,retribution,18,8,10
27146,Mikipaki,tarren-mill,765,paladin,retribution,18,8,10
27147,Trøllørd,shattrath,764,paladin,retribution,18,8,10
27148,Retroon,doomhammer,764,paladin,retribution,18,8,10
27149,Luridity,argent-dawn,764,paladin,retribution,24,8,16
27150,Wingedguard,ragnaros,763,paladin,retribution,12,8,4
27151,Ahritea,blackrock,763,paladin,retribution,12,8,4
27152,Lewanor,tarren-mill,763,paladin,retribution,12,8,4
27153,Ночнаябуря,gordunni,763,paladin,retribution,12,8,4
27154,Yúlía,ravencrest,763,paladin,retribution,18,8,10
27155,Nauriell,blackmoore,762,paladin,retribution,12,8,4
27156,Tank,uldum,762,paladin,retribution,12,8,4
27157,Цабля,gordunni,762,paladin,retribution,18,8,10
27158,Vondarkmoor,magtheridon,761,paladin,retribution,18,8,10
27159,Torczy,frostwhisper,760,paladin,retribution,12,8,4
27160,Tripani,twisting-nether,760,paladin,retribution,18,8,10
27161,Rivela,bloodhoof,758,paladin,retribution,18,8,10
27162,Grundgron,burning-legion,753,paladin,retribution,27,8,19
27163,Nazaninez,tarren-mill,749,paladin,retribution,18,8,10
27164,Lawrence,deathwing,748,paladin,retribution,24,8,16
27165,Ryüü,uldaman,748,paladin,retribution,42,13,29
27166,Grayparser,silvermoon,735,paladin,retribution,14,9,5
27167,Nollieflipx,tarren-mill,735,paladin,retribution,17,8,9
27168,Ragnarauc,elune,720,paladin,retribution,15,8,7
27169,Caleel,nemesis,719,paladin,retribution,15,9,6
27170,Ritoru,drekthar,719,paladin,retribution,17,8,9
27171,Serawyn,twisting-nether,718,paladin,retribution,15,8,7
27172,Депреседмодх,soulflayer,717,paladin,retribution,15,9,6
27173,Unbreakable,eredar,717,paladin,retribution,15,8,7
27174,Darkironpala,argent-dawn,717,paladin,retribution,21,8,13
27175,Áramor,blackmoore,716,paladin,retribution,17,8,9
27176,Äthénâ,archimonde,713,paladin,retribution,23,9,14
27177,ßean,dun-modr,704,paladin,retribution,16,8,8
27178,Aelthir,kazzak,703,paladin,retribution,11,8,3
27179,Myxas,tarren-mill,702,paladin,retribution,14,8,6
27180,Demsi,ravencrest,702,paladin,retribution,14,8,6
27181,Ericpala,turalyon,702,paladin,retribution,17,8,9
27182,Angelepetit,hyjal,701,paladin,retribution,16,8,8
27183,Veliios,silvermoon,701,paladin,retribution,25,9,16
27184,Milisha,the-maelstrom,696,paladin,retribution,26,8,18
27185,Derbrècher,azshara,688,paladin,retribution,16,8,8
27186,Luveria,der-rat-von-dalaran,687,paladin,retribution,13,8,5
27187,Gradepal,drakthul,687,paladin,retribution,19,8,11
27188,Neicha,trollbane,672,paladin,retribution,12,7,5
27189,Windwings,drakthul,672,paladin,retribution,12,7,5
27190,Mullinsilmä,stormreaver,672,paladin,retribution,12,7,5
27191,Ginka,blackrock,672,paladin,retribution,12,7,5
27192,Anatollia,silvermoon,672,paladin,retribution,12,7,5
27193,Veganbeefman,draenor,672,paladin,retribution,12,7,5
27194,Punlac,draenor,672,paladin,retribution,12,7,5
27195,Sunwalker,bronzebeard,672,paladin,retribution,12,7,5
27196,Eldrack,defias-brotherhood,672,paladin,retribution,12,7,5
27197,Gîn,aszune,672,paladin,retribution,12,7,5
27198,Arkhàn,ravencrest,672,paladin,retribution,12,7,5
27199,Curt,sanguino,672,paladin,retribution,12,7,5
27200,Shjami,rexxar,672,paladin,retribution,12,7,5
27201,Проверялка,thermaplugg,672,paladin,retribution,12,7,5
27202,Шефлион,soulflayer,672,paladin,retribution,12,7,5
27203,Израф,borean-tundra,672,paladin,retribution,12,7,5
27204,Uriens,zuljin,672,paladin,retribution,12,7,5
27205,Миллиционер,razuvious,672,paladin,retribution,12,7,5
27206,Ceca,lightnings-blade,672,paladin,retribution,12,7,5
27207,Fatherabdul,ravencrest,672,paladin,retribution,12,7,5
27208,Нефростинг,gordunni,672,paladin,retribution,12,7,5
27209,Dragon,zenedar,672,paladin,retribution,12,7,5
27210,Падаетслезаа,howling-fjord,672,paladin,retribution,12,7,5
27211,Miriem,twisting-nether,672,paladin,retribution,12,7,5
27212,Mâlâk,dun-modr,672,paladin,retribution,12,7,5
27213,Davè,blackmoore,672,paladin,retribution,12,7,5
27214,Noiwings,sanguino,672,paladin,retribution,12,7,5
27215,Estellar,bronze-dragonflight,672,paladin,retribution,12,7,5
27216,Wohx,archimonde,672,paladin,retribution,12,7,5
27217,Vircy,outland,672,paladin,retribution,12,7,5
27218,Petsadin,ravencrest,672,paladin,retribution,12,7,5
27219,Negash,archimonde,672,paladin,retribution,12,7,5
27220,Purrifire,sylvanas,672,paladin,retribution,12,7,5
27221,Ellünca,ravencrest,672,paladin,retribution,12,7,5
27222,Shénggi,kazzak,672,paladin,retribution,12,7,5
27223,Pallygân,thrall,672,paladin,retribution,12,7,5
27224,Fabsy,frostwolf,672,paladin,retribution,12,7,5
27225,Xônia,sylvanas,672,paladin,retribution,12,7,5
27226,Silverglaze,defias-brotherhood,672,paladin,retribution,12,7,5
27227,Pratiarch,kazzak,672,paladin,retribution,12,7,5
27228,Ilpreside,nemesis,672,paladin,retribution,12,7,5
27229,Lighteousnes,blackmoore,672,paladin,retribution,12,7,5
27230,Даракар,deathguard,672,paladin,retribution,12,7,5
27231,Okroschka,blackrock,672,paladin,retribution,12,7,5
27232,Лиривель,howling-fjord,672,paladin,retribution,12,7,5
27233,Skycraft,kazzak,672,paladin,retribution,12,7,5
27234,Блудиз,howling-fjord,672,paladin,retribution,12,7,5
27235,Holymolee,blackmoore,672,paladin,retribution,15,7,8
27236,Destaen,kazzak,672,paladin,retribution,18,7,11
27237,Trýhærd,ragnaros,672,paladin,retribution,18,7,11
27238,Ritaora,aggramar,672,paladin,retribution,18,7,11
27239,Elyrax,nemesis,672,paladin,retribution,18,7,11
27240,Tezmodian,antonidas,672,paladin,retribution,18,7,11
27241,Apocalypsé,twisting-nether,672,paladin,retribution,18,7,11
27242,Mawrâ,twisting-nether,672,paladin,retribution,18,7,11
27243,Melyntholdra,argent-dawn,672,paladin,retribution,18,7,11
27244,Alersia,twisting-nether,672,paladin,retribution,18,7,11
27245,Arethos,twisting-nether,672,paladin,retribution,18,7,11
27246,Shownómercy,stormscale,672,paladin,retribution,18,7,11
27247,Trixbunny,arathor,672,paladin,retribution,18,7,11
27248,Sucsii,outland,672,paladin,retribution,18,7,11
27249,Calliopes,tarren-mill,672,paladin,retribution,18,7,11
27250,Norganpala,die-aldor,672,paladin,retribution,18,7,11
27251,Мериатас,soulflayer,672,paladin,retribution,18,7,11
27252,Pìnkyy,draenor,672,paladin,retribution,18,7,11
27253,Scairtin,ravencrest,672,paladin,retribution,18,7,11
27254,Deltapower,archimonde,672,paladin,retribution,18,7,11
27255,Nicklovsofia,silvermoon,672,paladin,retribution,18,7,11
27256,Seekêr,tarren-mill,672,paladin,retribution,18,7,11
27257,Arbuzno,draenor,672,paladin,retribution,18,7,11
27258,Kjobergen,tarren-mill,672,paladin,retribution,18,7,11
27259,Milkzaddy,kazzak,672,paladin,retribution,18,7,11
27260,Бэкворд,soulflayer,672,paladin,retribution,18,7,11
27261,Frazyl,kilrogg,672,paladin,retribution,18,7,11
27262,Алепос,gordunni,672,paladin,retribution,18,7,11
27263,Blickyman,arathor,672,paladin,retribution,18,7,11
27264,Атмта,razuvious,672,paladin,retribution,18,7,11
27265,Drident,die-nachtwache,672,paladin,retribution,18,7,11
27266,Littlenight,emerald-dream,672,paladin,retribution,18,7,11
27267,Lightstorm,voljin,672,paladin,retribution,18,7,11
27268,Emíly,dun-morogh,672,paladin,retribution,18,7,11
27269,Holybubble,stormscale,672,paladin,retribution,18,7,11
27270,Snowlyi,stormscale,672,paladin,retribution,18,7,11
27271,Arshiaa,ravencrest,672,paladin,retribution,21,8,13
27272,Stellartois,thunderhorn,672,paladin,retribution,19,7,12
27273,Глаймис,gordunni,672,paladin,retribution,22,8,14
27274,Chiriner,drakthul,672,paladin,retribution,21,7,14
27275,Boscho,argent-dawn,672,paladin,retribution,24,7,17
27276,Pikoman,hellfire,672,paladin,retribution,24,7,17
27277,Ваэлин,deathweaver,672,paladin,retribution,24,7,17
27278,Zerlat,twisting-nether,672,paladin,retribution,24,7,17
27279,Aliceredlips,dun-modr,672,paladin,retribution,24,7,17
27280,Jaegeer,draenor,672,paladin,retribution,24,7,17
27281,Vivike,silvermoon,672,paladin,retribution,24,7,17
27282,Nurix,dun-modr,672,paladin,retribution,24,7,17
27283,Ящеры,gordunni,672,paladin,retribution,24,7,17
27284,Cáranthír,draenor,672,paladin,retribution,24,7,17
27285,Manole,ravencrest,672,paladin,retribution,24,7,17
27286,Cheesus,argent-dawn,672,paladin,retribution,24,7,17
27287,ßlitzkrieg,blackmoore,672,paladin,retribution,24,7,17
27288,Aranael,nemesis,672,paladin,retribution,30,7,23
27289,Zycqo,silvermoon,672,paladin,retribution,31,7,24
27290,Mýv,archimonde,671,paladin,retribution,12,7,5
27291,Retzzo,ravencrest,671,paladin,retribution,12,7,5
27292,Gavain,blackhand,671,paladin,retribution,12,7,5
27293,Liamisi,blackhand,671,paladin,retribution,12,7,5
27294,Sixqti,blackrock,671,paladin,retribution,12,7,5
27295,Kolts,ragnaros,671,paladin,retribution,12,7,5
27296,Merkurial,sylvanas,671,paladin,retribution,12,7,5
27297,Bronan,draenor,671,paladin,retribution,12,7,5
27298,Liliána,ragnaros,671,paladin,retribution,12,7,5
27299,Odregon,draenor,671,paladin,retribution,12,7,5
27300,Sakred,hellscream,671,paladin,retribution,12,7,5
27301,Архемор,ashenvale,671,paladin,retribution,12,7,5
27302,Saviourself,silvermoon,671,paladin,retribution,12,7,5
27303,Granadir,doomhammer,671,paladin,retribution,12,7,5
27304,Wolfpala,drakthul,671,paladin,retribution,12,7,5
27305,Amatar,ravencrest,671,paladin,retribution,12,7,5
27306,Dramaking,the-maelstrom,671,paladin,retribution,12,7,5
27307,Gbejr,xavius,671,paladin,retribution,12,7,5
27308,Ralfx,ragnaros,671,paladin,retribution,12,7,5
27309,Titoturixd,dun-modr,671,paladin,retribution,12,7,5
27310,Gindolon,blackhand,671,paladin,retribution,12,7,5
27311,Zpock,archimonde,671,paladin,retribution,12,7,5
27312,Baltyros,thrall,671,paladin,retribution,12,7,5
27313,Indye,hyjal,671,paladin,retribution,12,7,5
27314,Ljusbågen,silvermoon,671,paladin,retribution,13,7,6
27315,Ôrâ,archimonde,671,paladin,retribution,15,8,7
27316,Тешеус,gordunni,671,paladin,retribution,17,7,10
27317,Testovasara,ravencrest,671,paladin,retribution,18,7,11
27318,Laenira,nemesis,671,paladin,retribution,18,7,11
27319,Альбусор,galakrond,671,paladin,retribution,18,7,11
27320,Sytrexxer,frostwolf,671,paladin,retribution,18,7,11
27321,Erethes,magtheridon,671,paladin,retribution,18,7,11
27322,Чотут,howling-fjord,671,paladin,retribution,18,7,11
27323,Giglix,twisting-nether,671,paladin,retribution,18,7,11
27324,Кесару,goldrinn,671,paladin,retribution,18,7,11
27325,Konori,mannoroth,671,paladin,retribution,18,7,11
27326,Sheaps,les-sentinelles,671,paladin,retribution,18,7,11
27327,Рогафайти,goldrinn,671,paladin,retribution,18,7,11
27328,Ardalìon,archimonde,671,paladin,retribution,18,7,11
27329,Alvíss,sanguino,671,paladin,retribution,18,7,11
27330,Labier,tarren-mill,671,paladin,retribution,18,7,11
27331,Fishnchips,twisting-nether,671,paladin,retribution,18,7,11
27332,Disconnector,aegwynn,671,paladin,retribution,18,7,11
27333,Eken,hyjal,671,paladin,retribution,18,7,11
27334,Öbedö,malganis,671,paladin,retribution,24,7,17
27335,Paladson,burning-blade,671,paladin,retribution,24,7,17
27336,Eldrielle,culte-de-la-rive-noire,671,paladin,retribution,24,7,17
27337,Zyklôn,antonidas,671,paladin,retribution,30,7,23
27338,Onestone,wrathbringer,671,paladin,retribution,30,7,23
27339,Edb,silvermoon,670,paladin,retribution,12,7,5
27340,Keol,sanguino,670,paladin,retribution,12,7,5
27341,Patriok,moonglade,670,paladin,retribution,12,7,5
27342,Atrexie,lightbringer,670,paladin,retribution,12,7,5
27343,Prótpál,the-maelstrom,670,paladin,retribution,18,7,11
27344,Blessmedaddy,tarren-mill,670,paladin,retribution,18,7,11
27345,Thandoro,amanthul,670,paladin,retribution,18,7,11
27346,Amoxapine,hyjal,670,paladin,retribution,18,7,11
27347,Tidus,conseil-des-ombres,670,paladin,retribution,18,7,11
27348,Lighttitan,ravencrest,670,paladin,retribution,18,7,11
27349,Babajõ,twisting-nether,669,paladin,retribution,12,7,5
27350,Solarouz,draenor,669,paladin,retribution,12,7,5
27351,Zvirblis,chamber-of-aspects,669,paladin,retribution,15,8,7
27352,Baymanda,tarren-mill,669,paladin,retribution,18,7,11
27353,Rangorian,defias-brotherhood,669,paladin,retribution,24,7,17
27354,Bandaga,sanguino,668,paladin,retribution,12,7,5
27355,Эррор,azuregos,668,paladin,retribution,18,7,11
27356,Ратомир,howling-fjord,668,paladin,retribution,20,7,13
27357,Shennzo,wildhammer,667,paladin,retribution,12,7,5
27358,Stêx,anubarak,667,paladin,retribution,12,7,5
27359,Oheiligster,kult-der-verdammten,667,paladin,retribution,12,7,5
27360,Megara,bronze-dragonflight,667,paladin,retribution,12,7,5
27361,Tobebryant,eonar,667,paladin,retribution,12,7,5
27362,Willmasmashn,blackmoore,667,paladin,retribution,18,7,11
27363,Bedrock,kirin-tor,666,paladin,retribution,12,7,5
27364,Rocaviva,sanguino,666,paladin,retribution,12,7,5
27365,Ксинем,howling-fjord,666,paladin,retribution,16,8,8
27366,Шелволк,eversong,665,paladin,retribution,18,7,11
27367,Zealotic,doomhammer,664,paladin,retribution,12,7,5
27368,Pallido,exodar,664,paladin,retribution,12,7,5
27369,Chikaz,archimonde,664,paladin,retribution,20,10,10
27370,Azlan,nagrand,664,paladin,retribution,16,8,8
27371,Halimox,terokkar,664,paladin,retribution,18,7,11
27372,Blinklys,ragnaros,664,paladin,retribution,18,7,11
27373,Purpledurple,twisting-nether,663,paladin,retribution,18,7,11
27374,Ruffus,magtheridon,662,paladin,retribution,12,7,5
27375,Sarinise,draenor,662,paladin,retribution,12,7,5
27376,Thebøss,blackmoore,662,paladin,retribution,18,7,11
27377,Mechoka,auchindoun,661,paladin,retribution,13,7,6
27378,Belzed,draenor,660,paladin,retribution,15,8,7
27379,Сашок,gordunni,657,paladin,retribution,12,7,5
27380,Bebcho,turalyon,646,paladin,retribution,27,9,18
27381,Ordain,senjin,643,paladin,retribution,18,7,11
27382,Benkenoah,ragnaros,641,paladin,retribution,30,7,23
27383,Alë,sanguino,639,paladin,retribution,11,7,4
27384,Keele,stormscale,639,paladin,retribution,17,7,10
27385,Breezpal,twisting-nether,639,paladin,retribution,17,7,10
27386,Rîex,alleria,639,paladin,retribution,26,8,18
27387,Arear,kazzak,624,paladin,retribution,15,8,7
27388,Badpal,blackhand,624,paladin,retribution,15,7,8
27389,Samànta,nemesis,623,paladin,retribution,11,7,4
27390,Маефис,gordunni,622,paladin,retribution,24,8,16
27391,Nybrash,sanguino,620,paladin,retribution,15,7,8
27392,Séphiran,hyjal,618,paladin,retribution,15,9,6
27393,Goofyaf,ravencrest,618,paladin,retribution,16,9,7
27394,Скадих,soulflayer,618,paladin,retribution,22,8,14
27395,Sunrazor,kazzak,617,paladin,retribution,20,9,11
27396,Pelbo,ravencrest,617,paladin,retribution,21,8,13
27397,Mariaremarc,silvermoon,617,paladin,retribution,25,8,17
27398,Авереон,gordunni,617,paladin,retribution,29,8,21
27399,Ренегадер,thermaplugg,615,paladin,retribution,12,8,4
27400,Leouric,argent-dawn,607,paladin,retribution,20,7,13
27401,Palladxx,twilights-hammer,596,paladin,retribution,16,7,9
27402,Алланор,fordragon,584,paladin,retribution,13,8,5
27403,Deathlyblaze,draenor,576,paladin,retribution,6,6,0
27404,Necorínex,silvermoon,576,paladin,retribution,6,6,0
27405,Twomog,ravencrest,576,paladin,retribution,6,6,0
27406,Zatoxi,frostmane,576,paladin,retribution,6,6,0
27407,Classicheroo,stormscale,576,paladin,retribution,6,6,0
27408,Blacked,baelgun,576,paladin,retribution,10,7,3
27409,Blindhoj,ravencrest,576,paladin,retribution,12,6,6
27410,Lévrone,alexstrasza,576,paladin,retribution,12,6,6
27411,Госпелька,blackscar,576,paladin,retribution,12,6,6
27412,Plainrage,blackrock,576,paladin,retribution,12,6,6
27413,Rothus,bronze-dragonflight,576,paladin,retribution,12,6,6
27414,Qotro,ravencrest,576,paladin,retribution,12,6,6
27415,Waaynejudgeu,blackhand,576,paladin,retribution,12,6,6
27416,Luciter,silvermoon,576,paladin,retribution,12,6,6
27417,Abukasol,kazzak,576,paladin,retribution,12,6,6
27418,Cycodin,garrosh,576,paladin,retribution,12,6,6
27419,Rétalin,blackhand,576,paladin,retribution,12,6,6
27420,Drekio,blackrock,576,paladin,retribution,12,6,6
27421,Crusxder,kazzak,576,paladin,retribution,12,6,6
27422,Stève,ravencrest,576,paladin,retribution,12,6,6
27423,Ruggero,stormscale,576,paladin,retribution,12,6,6
27424,Elendíl,azjolnerub,576,paladin,retribution,12,6,6
27425,Askmy,stormscale,576,paladin,retribution,12,6,6
27426,Noforgivenes,kazzak,576,paladin,retribution,12,6,6
27427,Erthelios,silvermoon,576,paladin,retribution,12,6,6
27428,Бэнсон,ashenvale,576,paladin,retribution,12,6,6
27429,Стальгор,ashenvale,576,paladin,retribution,12,6,6
27430,Lbj,eredar,576,paladin,retribution,12,6,6
27431,Søulréaper,stormscale,576,paladin,retribution,12,6,6
27432,Téralus,ravencrest,576,paladin,retribution,12,6,6
27433,Palamauka,kazzak,576,paladin,retribution,12,6,6
27434,Armion,stormscale,576,paladin,retribution,12,6,6
27435,Sämaelia,ysondre,576,paladin,retribution,12,6,6
27436,Sorkohoho,silvermoon,576,paladin,retribution,12,6,6
27437,Divineovic,ravencrest,576,paladin,retribution,12,6,6
27438,Jaing,magtheridon,576,paladin,retribution,12,6,6
27439,Shailwo,ysondre,576,paladin,retribution,12,6,6
27440,Éllé,der-rat-von-dalaran,576,paladin,retribution,12,6,6
27441,Gabrîel,sanguino,576,paladin,retribution,12,6,6
27442,Ultimatix,stormscale,576,paladin,retribution,12,6,6
27443,Bigdaddypump,ravencrest,576,paladin,retribution,12,6,6
27444,Nanduil,stormscale,576,paladin,retribution,12,6,6
27445,Palamanyaka,kazzak,576,paladin,retribution,12,6,6
27446,Pallachyrk,kazzak,576,paladin,retribution,12,6,6
27447,Seothor,argent-dawn,576,paladin,retribution,12,6,6
27448,Ríppex,kazzak,576,paladin,retribution,12,6,6
27449,Zondãn,blackrock,576,paladin,retribution,12,6,6
27450,Kptayn,archimonde,576,paladin,retribution,12,6,6
27451,Sienna,kazzak,576,paladin,retribution,12,6,6
27452,Raceper,the-maelstrom,576,paladin,retribution,12,6,6
27453,Анфлераж,gordunni,576,paladin,retribution,12,6,6
27454,Yurinovsky,aggra-português,576,paladin,retribution,12,6,6
27455,Vysavo,draenor,576,paladin,retribution,12,6,6
27456,Tarenath,aegwynn,576,paladin,retribution,12,6,6
27457,Vuutnëx,twisting-nether,576,paladin,retribution,12,6,6
27458,Керантий,gordunni,576,paladin,retribution,12,6,6
27459,Melverti,kazzak,576,paladin,retribution,12,6,6
27460,Lostfire,sinstralis,576,paladin,retribution,12,6,6
27461,Yourredead,shadowsong,576,paladin,retribution,12,6,6
27462,Ibanez,lightnings-blade,576,paladin,retribution,12,6,6
27463,Бляля,gordunni,576,paladin,retribution,12,6,6
27464,Mouncake,archimonde,576,paladin,retribution,12,6,6
27465,Mekluba,twisting-nether,576,paladin,retribution,12,6,6
27466,Aldio,pozzo-delleternità,576,paladin,retribution,12,6,6
27467,Азов,thermaplugg,576,paladin,retribution,12,6,6
27468,Drdax,wildhammer,576,paladin,retribution,12,6,6
27469,Blubbajoe,blackmoore,576,paladin,retribution,12,6,6
27470,Paliax,outland,576,paladin,retribution,12,6,6
27471,Lommeuld,auchindoun,576,paladin,retribution,12,6,6
27472,Reth,tarren-mill,576,paladin,retribution,12,6,6
27473,Cildan,talnivarr,576,paladin,retribution,12,6,6
27474,Nesquikudder,kazzak,576,paladin,retribution,12,6,6
27475,Moossolin,tarren-mill,576,paladin,retribution,12,6,6
27476,Wingdude,ysera,576,paladin,retribution,12,6,6
27477,Greko,ysera,576,paladin,retribution,12,6,6
27478,Таймкил,gordunni,576,paladin,retribution,12,6,6
27479,Упругийтуз,gordunni,576,paladin,retribution,12,6,6
27480,Tharduk,outland,576,paladin,retribution,12,6,6
27481,Néero,defias-brotherhood,576,paladin,retribution,12,6,6
27482,Илонка,gordunni,576,paladin,retribution,12,6,6
27483,Teahero,doomhammer,576,paladin,retribution,12,6,6
27484,Karnator,eldrethalas,576,paladin,retribution,12,6,6
27485,Stankow,kazzak,576,paladin,retribution,12,6,6
27486,Моррзито,soulflayer,576,paladin,retribution,12,6,6
27487,Argeltal,auchindoun,576,paladin,retribution,12,6,6
27488,Emlo,thrall,576,paladin,retribution,12,6,6
27489,Стифаний,booty-bay,576,paladin,retribution,12,6,6
27490,Pabló,azshara,576,paladin,retribution,12,6,6
27491,Lightmyst,outland,576,paladin,retribution,12,6,6
27492,Ashery,elune,576,paladin,retribution,12,6,6
27493,Aalbringer,blackmoore,576,paladin,retribution,12,6,6
27494,Kjellus,tarren-mill,576,paladin,retribution,12,6,6
27495,Диджейнобабл,howling-fjord,576,paladin,retribution,12,6,6
27496,Mingyao,sanguino,576,paladin,retribution,12,6,6
27497,Ærîo,dalaran,576,paladin,retribution,12,6,6
27498,Скварлетх,howling-fjord,576,paladin,retribution,12,6,6
27499,Milner,stormreaver,576,paladin,retribution,12,6,6
27500,Notnerb,outland,576,paladin,retribution,12,6,6
27501,Бордюрчег,howling-fjord,576,paladin,retribution,12,6,6
27502,Snowife,drakthul,576,paladin,retribution,12,6,6
27503,Fatâl,antonidas,576,paladin,retribution,15,7,8
27504,Aimee,draenor,576,paladin,retribution,16,7,9
27505,Кольт,borean-tundra,576,paladin,retribution,16,6,10
27506,Mipendz,draenor,576,paladin,retribution,18,6,12
27507,Myrmidan,magtheridon,576,paladin,retribution,18,6,12
27508,Kelduril,draenor,576,paladin,retribution,18,6,12
27509,Bothways,stormscale,576,paladin,retribution,18,6,12
27510,Dunklerzwerg,the-maelstrom,576,paladin,retribution,18,6,12
27511,Gunpowderx,silvermoon,576,paladin,retribution,18,6,12
27512,Vazayo,ravencrest,576,paladin,retribution,18,6,12
27513,Thickets,argent-dawn,576,paladin,retribution,18,6,12
27514,Hermmes,alakir,576,paladin,retribution,18,6,12
27515,Ironkra,stormscale,576,paladin,retribution,18,6,12
27516,Exfire,daggerspine,576,paladin,retribution,18,6,12
27517,Генатрамбон,howling-fjord,576,paladin,retribution,18,6,12
27518,Îshybî,archimonde,576,paladin,retribution,18,6,12
27519,Retrehsacul,blackrock,576,paladin,retribution,18,6,12
27520,Hegazy,darkmoon-faire,576,paladin,retribution,18,6,12
27521,Bigfatpig,ravencrest,576,paladin,retribution,18,6,12
27522,Tosá,antonidas,576,paladin,retribution,18,6,12
27523,Yaloh,sylvanas,576,paladin,retribution,18,6,12
27524,Mâêdhrøsx,ravencrest,576,paladin,retribution,18,6,12
27525,Czachadymii,defias-brotherhood,576,paladin,retribution,18,6,12
27526,Mooderna,ravencrest,576,paladin,retribution,18,6,12
27527,Saht,silvermoon,576,paladin,retribution,18,6,12
27528,Pinx,kazzak,576,paladin,retribution,18,6,12
27529,Byczorek,turalyon,576,paladin,retribution,18,6,12
27530,Meldø,drakthul,576,paladin,retribution,18,6,12
27531,Sházen,silvermoon,576,paladin,retribution,18,6,12
27532,Реализатор,howling-fjord,576,paladin,retribution,23,6,17
27533,Эйтэр,howling-fjord,576,paladin,retribution,24,6,18
27534,Vokesh,silvermoon,576,paladin,retribution,24,6,18
27535,Actionjack,area-52,576,paladin,retribution,24,6,18
27536,Ethurospal,tarren-mill,576,paladin,retribution,24,6,18
27537,Badtrip,bloodscalp,576,paladin,retribution,24,6,18
27538,Nikibrahboi,outland,576,paladin,retribution,24,6,18
27539,Huevo,frostmane,576,paladin,retribution,24,6,18
27540,Berethas,darksorrow,575,paladin,retribution,6,6,0
27541,Zenfret,kazzak,575,paladin,retribution,10,7,3
27542,Eyebluee,tarren-mill,575,paladin,retribution,12,6,6
27543,Ustnivkusni,kazzak,575,paladin,retribution,12,6,6
27544,Bcrp,ragnaros,575,paladin,retribution,12,6,6
27545,Tehdark,outland,575,paladin,retribution,12,6,6
27546,Hylion,kirin-tor,575,paladin,retribution,12,6,6
27547,Тамплиир,gordunni,575,paladin,retribution,12,6,6
27548,Myradur,burning-legion,575,paladin,retribution,12,6,6
27549,Skieras,draenor,575,paladin,retribution,12,6,6
27550,Blazix,kazzak,575,paladin,retribution,12,6,6
27551,Greatme,frostmane,575,paladin,retribution,12,6,6
27552,Faventu,ragnaros,575,paladin,retribution,12,6,6
27553,Vandorin,dun-morogh,575,paladin,retribution,12,6,6
27554,Proteiin,drakthul,575,paladin,retribution,12,6,6
27555,Holycide,twisting-nether,575,paladin,retribution,12,6,6
27556,Nishe,earthen-ring,575,paladin,retribution,12,6,6
27557,Rohb,blackmoore,575,paladin,retribution,12,6,6
27558,Ньюзеропал,howling-fjord,575,paladin,retribution,12,6,6
27559,Humungus,sylvanas,575,paladin,retribution,12,6,6
27560,Antón,dun-modr,575,paladin,retribution,12,6,6
27561,Mbp,blackmoore,575,paladin,retribution,12,6,6
27562,Phillipe,illidan,575,paladin,retribution,12,6,6
27563,Kimberveils,blackrock,575,paladin,retribution,12,6,6
27564,Helson,draenor,575,paladin,retribution,12,6,6
27565,Sæsh,die-aldor,575,paladin,retribution,12,6,6
27566,Eldivin,hyjal,575,paladin,retribution,12,6,6
27567,Oûtplâyêd,blackmoore,575,paladin,retribution,12,6,6
27568,Ysunna,magtheridon,575,paladin,retribution,12,6,6
27569,Poutoux,archimonde,575,paladin,retribution,12,6,6
27570,Labadin,darkspear,575,paladin,retribution,12,6,6
27571,Celsia,blackrock,575,paladin,retribution,12,6,6
27572,Kendomendo,ravencrest,575,paladin,retribution,12,6,6
27573,Pewpews,twisting-nether,575,paladin,retribution,12,6,6
27574,Йенфира,gordunni,575,paladin,retribution,12,6,6
27575,Andrõs,argent-dawn,575,paladin,retribution,15,7,8
27576,Gotra,stormscale,575,paladin,retribution,21,7,14
27577,Edathar,argent-dawn,575,paladin,retribution,24,6,18
27578,Легионор,galakrond,574,paladin,retribution,12,6,6
27579,Duris,drakthul,574,paladin,retribution,12,6,6
27580,Mormazor,outland,574,paladin,retribution,12,6,6
27581,Askimo,twisting-nether,574,paladin,retribution,12,6,6
27582,Goouse,marécage-de-zangar,574,paladin,retribution,12,6,6
27583,Roxian,burning-blade,574,paladin,retribution,12,6,6
27584,Dönki,hyjal,574,paladin,retribution,12,6,6
27585,Gatsßy,archimonde,574,paladin,retribution,18,6,12
27586,Babarush,nozdormu,574,paladin,retribution,18,6,12
27587,Humaladi,draenor,574,paladin,retribution,18,6,12
27588,Jelcz,burning-legion,574,paladin,retribution,24,6,18
27589,Draarks,archimonde,573,paladin,retribution,12,6,6
27590,Paxillustral,twisting-nether,573,paladin,retribution,12,6,6
27591,Windîr,draenor,573,paladin,retribution,18,6,12
27592,Moriex,drakthul,573,paladin,retribution,24,6,18
27593,Renalex,ravencrest,572,paladin,retribution,12,6,6
27594,Fatique,twisting-nether,572,paladin,retribution,12,6,6
27595,Nhum,destromath,572,paladin,retribution,12,6,6
27596,Beefix,blackmoore,572,paladin,retribution,12,6,6
27597,Jesophar,archimonde,572,paladin,retribution,18,6,12
27598,Virusee,doomhammer,571,paladin,retribution,12,6,6
27599,Taomeba,runetotem,571,paladin,retribution,12,6,6
27600,Boaka,outland,571,paladin,retribution,18,6,12
27601,Elannor,sylvanas,569,paladin,retribution,12,6,6
27602,Mhorcain,silvermoon,569,paladin,retribution,18,6,12
27603,Nicgr,nemesis,566,paladin,retribution,12,6,6
27604,Vengryn,turalyon,566,paladin,retribution,37,8,29
27605,Shendis,uldaman,565,paladin,retribution,12,6,6
27606,Årés,sanguino,565,paladin,retribution,12,6,6
27607,Севенола,galakrond,565,paladin,retribution,18,6,12
27608,Нероблр,gordunni,560,paladin,retribution,19,7,12
27609,Toruk,burning-legion,559,paladin,retribution,15,7,8
27610,Bugo,drakthul,559,paladin,retribution,17,6,11
27611,Иусто,howling-fjord,559,paladin,retribution,17,6,11
27612,Ràwx,twisting-nether,559,paladin,retribution,23,6,17
27613,Uriziel,the-shatar,558,paladin,retribution,18,6,12
27614,Tavyy,sylvanas,551,paladin,retribution,15,9,6
27615,Ретроградий,howling-fjord,543,paladin,retribution,16,6,10
27616,Wlåð,archimonde,543,paladin,retribution,17,6,11
27617,Gundahar,das-syndikat,531,paladin,retribution,16,6,10
27618,Kelianna,drakthul,528,paladin,retribution,12,7,5
27619,Optì,eredar,527,paladin,retribution,11,6,5
27620,Ichimaru,burning-legion,527,paladin,retribution,11,6,5
27621,Сенлеида,gordunni,527,paladin,retribution,15,7,8
27622,Mozg,silvermoon,527,paladin,retribution,17,6,11
27623,Sàbèr,blackmoore,527,paladin,retribution,17,6,11
27624,Zoomzoom,sylvanas,527,paladin,retribution,22,7,15
27625,Plsdøntusemd,ravencrest,522,paladin,retribution,17,8,9
27626,Митахо,gordunni,522,paladin,retribution,21,7,14
27627,Окилан,gordunni,522,paladin,retribution,21,7,14
27628,Тошши,soulflayer,522,paladin,retribution,28,8,20
27629,Uriel,scarshield-legion,520,paladin,retribution,16,8,8
27630,Thormentâ,sanguino,512,paladin,retribution,10,6,4
27631,Råckamoo,emerald-dream,512,paladin,retribution,22,6,16
27632,Вессори,blackscar,511,paladin,retribution,8,6,2
27633,Vell,bronze-dragonflight,511,paladin,retribution,11,6,5
27634,Babypic,ambossar,511,paladin,retribution,14,6,8
27635,Hanterus,antonidas,507,paladin,retribution,14,6,8
27636,Rockymarcian,hyjal,506,paladin,retribution,16,6,10
27637,Briggybomb,outland,506,paladin,retribution,19,7,12
27638,Рэдиенс,howling-fjord,496,paladin,retribution,7,6,1
27639,Prínce,earthen-ring,495,paladin,retribution,13,6,7
27640,Bramonier,blackmoore,480,paladin,retribution,6,5,1
27641,Vardin,sanguino,480,paladin,retribution,6,5,1
27642,Voycetwo,frostwolf,480,paladin,retribution,6,5,1
27643,Salladín,stormscale,480,paladin,retribution,6,5,1
27644,Neldöwn,dalaran,480,paladin,retribution,6,5,1
27645,Тенькопыт,howling-fjord,480,paladin,retribution,6,5,1
27646,Luzmortal,zuljin,480,paladin,retribution,6,5,1
27647,Henklord,jaedenar,480,paladin,retribution,6,5,1
27648,Римидал,howling-fjord,480,paladin,retribution,6,5,1
27649,Röland,sanguino,480,paladin,retribution,6,5,1
27650,Holyfatherr,draenor,480,paladin,retribution,6,5,1
27651,Percocetx,tarren-mill,480,paladin,retribution,6,5,1
27652,Yezitzme,blackrock,480,paladin,retribution,6,5,1
27653,Tryggt,the-shatar,480,paladin,retribution,6,5,1
27654,Zïons,hyjal,480,paladin,retribution,6,5,1
27655,Nocleanse,argent-dawn,480,paladin,retribution,6,5,1
27656,Daj,draenor,480,paladin,retribution,6,5,1
27657,Feaná,silvermoon,480,paladin,retribution,6,5,1
27658,Sabríel,ragnaros,480,paladin,retribution,6,5,1
27659,Taurantes,garona,480,paladin,retribution,6,5,1
27660,Libertum,silvermoon,480,paladin,retribution,6,5,1
27661,Escanør,anetheron,480,paladin,retribution,6,5,1
27662,Demecir,twisting-nether,480,paladin,retribution,6,5,1
27663,Yasuomid,sanguino,480,paladin,retribution,6,5,1
27664,Daminika,das-syndikat,480,paladin,retribution,6,5,1
27665,Violetex,blackmoore,480,paladin,retribution,6,5,1
27666,Paradok,thrall,480,paladin,retribution,6,5,1
27667,Esköll,hyjal,480,paladin,retribution,6,5,1
27668,Chocodin,drakthul,480,paladin,retribution,6,5,1
27669,Melvòó,blackrock,480,paladin,retribution,9,6,3
27670,Lightswrath,thunderhorn,480,paladin,retribution,8,5,3
27671,Pigma,outland,480,paladin,retribution,13,7,6
27672,Sawier,ragnaros,480,paladin,retribution,12,5,7
27673,Swapxyr,aegwynn,480,paladin,retribution,12,5,7
27674,Necadin,ravencrest,480,paladin,retribution,12,5,7
27675,Mozaiczny,burning-legion,480,paladin,retribution,12,5,7
27676,Onishu,blackhand,480,paladin,retribution,12,5,7
27677,Morggann,drakthul,480,paladin,retribution,12,5,7
27678,Bacilla,archimonde,480,paladin,retribution,12,5,7
27679,Kewell,dun-modr,480,paladin,retribution,12,5,7
27680,Эрогот,gordunni,480,paladin,retribution,12,5,7
27681,Evohammer,silvermoon,480,paladin,retribution,12,5,7
27682,Arakir,ragnaros,480,paladin,retribution,12,5,7
27683,Kylaz,die-ewige-wacht,480,paladin,retribution,12,5,7
27684,Froxies,drakthul,480,paladin,retribution,12,5,7
27685,Títanîa,blackmoore,480,paladin,retribution,12,5,7
27686,Llighthand,ravencrest,480,paladin,retribution,12,5,7
27687,Cameron,taerar,480,paladin,retribution,12,5,7
27688,Quelly,das-syndikat,480,paladin,retribution,12,5,7
27689,Lïnea,aegwynn,480,paladin,retribution,12,5,7
27690,Dêstî,silvermoon,480,paladin,retribution,12,5,7
27691,Рукибудды,soulflayer,480,paladin,retribution,12,5,7
27692,Destroyer,archimonde,480,paladin,retribution,12,5,7
27693,Vaalé,aegwynn,480,paladin,retribution,12,5,7
27694,Måxrajoy,dun-modr,480,paladin,retribution,12,5,7
27695,Bopstar,tarren-mill,480,paladin,retribution,12,5,7
27696,Тевеон,gordunni,480,paladin,retribution,12,5,7
27697,Пашштет,gordunni,480,paladin,retribution,12,5,7
27698,Darnito,blackmoore,480,paladin,retribution,12,5,7
27699,Illythia,anachronos,480,paladin,retribution,12,5,7
27700,Poporfour,archimonde,480,paladin,retribution,12,5,7
27701,Palladia,rexxar,480,paladin,retribution,12,5,7
27702,Skinriper,stormscale,480,paladin,retribution,12,5,7
27703,Pappnas,blackmoore,480,paladin,retribution,12,5,7
27704,Emloses,outland,480,paladin,retribution,12,5,7
27705,Karatus,ravencrest,480,paladin,retribution,12,5,7
27706,Pompée,dalaran,480,paladin,retribution,12,5,7
27707,Зеппели,gordunni,480,paladin,retribution,12,5,7
27708,Mikalia,aegwynn,480,paladin,retribution,12,5,7
27709,Fotoniy,kazzak,480,paladin,retribution,12,5,7
27710,Brinkz,argent-dawn,480,paladin,retribution,12,5,7
27711,Hännó,malganis,480,paladin,retribution,12,5,7
27712,Enviniv,tarren-mill,480,paladin,retribution,12,5,7
27713,Harakiri,kargath,480,paladin,retribution,12,5,7
27714,Célésté,ravencrest,480,paladin,retribution,12,5,7
27715,Hifyve,kazzak,480,paladin,retribution,12,5,7
27716,Гниленький,razuvious,480,paladin,retribution,12,5,7
27717,Pianiste,sinstralis,480,paladin,retribution,12,5,7
27718,Palacetámol,gorgonnash,480,paladin,retribution,12,5,7
27719,Сладупся,gordunni,480,paladin,retribution,12,5,7
27720,Meriween,ravencrest,480,paladin,retribution,12,5,7
27721,Lôrelei,blackrock,480,paladin,retribution,12,5,7
27722,Roflemente,bladefist,480,paladin,retribution,12,5,7
27723,Palá,dun-modr,480,paladin,retribution,12,5,7
27724,Hipo,zuljin,480,paladin,retribution,12,5,7
27725,Zethhx,stormscale,480,paladin,retribution,12,5,7
27726,Scoobywooby,sanguino,480,paladin,retribution,12,5,7
27727,Dobbygotsock,kazzak,480,paladin,retribution,12,5,7
27728,Takálus,eredar,480,paladin,retribution,12,5,7
27729,Alus,blackmoore,480,paladin,retribution,12,5,7
27730,Héphäistos,silvermoon,480,paladin,retribution,12,5,7
27731,Krisbull,kazzak,480,paladin,retribution,12,5,7
27732,Solcustos,tarren-mill,480,paladin,retribution,12,5,7
27733,Glückskreuza,die-aldor,480,paladin,retribution,12,5,7
27734,Serethor,blackrock,480,paladin,retribution,12,5,7
27735,Роллерблэйд,gordunni,480,paladin,retribution,12,5,7
27736,Hazura,blackmoore,480,paladin,retribution,12,5,7
27737,Lyan,archimonde,480,paladin,retribution,12,5,7
27738,Ênma,archimonde,480,paladin,retribution,12,5,7
27739,Docoùla,twisting-nether,480,paladin,retribution,12,5,7
27740,Cêa,blackrock,480,paladin,retribution,12,5,7
27741,Ðesolace,twisting-nether,480,paladin,retribution,12,5,7
27742,Morsadin,burning-legion,480,paladin,retribution,12,5,7
27743,Fannypoo,sylvanas,480,paladin,retribution,12,5,7
27744,Palafrugell,sanguino,480,paladin,retribution,12,5,7
27745,Blazkowicz,twisting-nether,480,paladin,retribution,12,5,7
27746,Valonforth,magtheridon,480,paladin,retribution,12,5,7
27747,Holysznajt,burning-legion,480,paladin,retribution,12,5,7
27748,Retzrik,kazzak,480,paladin,retribution,12,5,7
27749,Chillmachine,stormscale,480,paladin,retribution,12,5,7
27750,Himèji,pozzo-delleternità,480,paladin,retribution,12,5,7
27751,Pallajalla,the-maelstrom,480,paladin,retribution,12,5,7
27752,Aïzo,archimonde,480,paladin,retribution,12,5,7
27753,Bascelik,outland,480,paladin,retribution,12,5,7
27754,Blokeedaro,sanguino,480,paladin,retribution,12,5,7
27755,Oldsurehand,blackmoore,480,paladin,retribution,12,5,7
27756,Equityy,burning-legion,480,paladin,retribution,12,5,7
27757,Gambá,stormscale,480,paladin,retribution,12,5,7
27758,Yuvile,destromath,480,paladin,retribution,12,5,7
27759,Shanderhilo,pozzo-delleternità,480,paladin,retribution,12,5,7
27760,Crupth,outland,480,paladin,retribution,12,5,7
27761,Ноулайфир,eversong,480,paladin,retribution,12,5,7
27762,Bobilous,twisting-nether,480,paladin,retribution,12,5,7
27763,Ksama,ysondre,480,paladin,retribution,12,5,7
27764,Milenia,nemesis,480,paladin,retribution,12,5,7
27765,Angelynor,ysondre,480,paladin,retribution,12,5,7
27766,Goodfail,sanguino,480,paladin,retribution,12,5,7
27767,Freedomwinds,kazzak,480,paladin,retribution,12,5,7
27768,Нойззмс,gordunni,480,paladin,retribution,12,5,7
27769,Bobjohnny,bloodfeather,480,paladin,retribution,12,5,7
27770,Zaopink,blackhand,480,paladin,retribution,12,5,7
27771,Холивеник,gordunni,480,paladin,retribution,12,5,7
27772,Instaraid,blackmoore,480,paladin,retribution,12,5,7
27773,Skølir,rashgarroth,480,paladin,retribution,12,5,7
27774,Valunajhnwar,azuremyst,480,paladin,retribution,12,5,7
27775,Arator,terenas,480,paladin,retribution,12,5,7
27776,Боремир,borean-tundra,480,paladin,retribution,12,5,7
27777,Mecah,hyjal,480,paladin,retribution,12,5,7
27778,Ëhra,hyjal,480,paladin,retribution,12,5,7
27779,Faldrinx,hyjal,480,paladin,retribution,12,5,7
27780,Syjinora,teldrassil,480,paladin,retribution,12,5,7
27781,Víii,outland,480,paladin,retribution,15,6,9
27782,Aresian,burning-legion,480,paladin,retribution,13,5,8
27783,Dhb,darksorrow,480,paladin,retribution,14,5,9
27784,Destroyér,blackmoore,480,paladin,retribution,18,5,13
27785,Lancelotas,defias-brotherhood,480,paladin,retribution,18,5,13
27786,Мэркес,fordragon,480,paladin,retribution,18,5,13
27787,Cøygonne,archimonde,480,paladin,retribution,18,5,13
27788,Cøctab,kirin-tor,480,paladin,retribution,18,5,13
27789,Arthuriân,outland,480,paladin,retribution,18,5,13
27790,Legâin,twisting-nether,480,paladin,retribution,18,5,13
27791,Ywrow,burning-blade,480,paladin,retribution,18,5,13
27792,Juicycheeks,frostwolf,480,paladin,retribution,18,5,13
27793,Ramhal,stormscale,480,paladin,retribution,18,5,13
27794,Ashbi,dun-modr,480,paladin,retribution,18,5,13
27795,Nëphilim,arakarahm,480,paladin,retribution,18,5,13
27796,Xiuya,dun-modr,480,paladin,retribution,18,5,13
27797,Øsgar,dun-modr,480,paladin,retribution,18,5,13
27798,Nalaea,arathor,480,paladin,retribution,18,5,13
27799,Авараан,galakrond,480,paladin,retribution,18,5,13
27800,Retisfine,silvermoon,480,paladin,retribution,18,5,13
27801,Strätholme,drakthul,480,paladin,retribution,18,5,13
27802,Boyard,silvermoon,480,paladin,retribution,18,5,13
27803,Копранесса,soulflayer,480,paladin,retribution,18,5,13
27804,Bumboombeem,stormscale,480,paladin,retribution,18,5,13
27805,Powericius,drakthul,480,paladin,retribution,18,5,13
27806,Kreozz,destromath,480,paladin,retribution,21,5,16
27807,Exobyte,stormscale,480,paladin,retribution,24,5,19
27808,Cadearas,antonidas,480,paladin,retribution,24,5,19
27809,Korgant,burning-legion,480,paladin,retribution,30,5,25
27810,Phlek,drakthul,479,paladin,retribution,6,5,1
27811,Grynd,blackmoore,479,paladin,retribution,6,5,1
27812,Deyvan,dalaran,479,paladin,retribution,12,5,7
27813,Майнстер,gordunni,479,paladin,retribution,12,5,7
27814,Edwards,sanguino,479,paladin,retribution,12,5,7
27815,Dayr,sylvanas,479,paladin,retribution,12,5,7
27816,Rettarded,draenor,479,paladin,retribution,12,5,7
27817,Drizuc,bloodhoof,479,paladin,retribution,12,5,7
27818,Subzerox,ravenholdt,479,paladin,retribution,12,5,7
27819,Grannybash,silvermoon,479,paladin,retribution,12,5,7
27820,Bakasnoop,hyjal,479,paladin,retribution,12,5,7
27821,Lightsblood,outland,479,paladin,retribution,12,5,7
27822,Missti,azjolnerub,479,paladin,retribution,12,5,7
27823,Сасмен,blackscar,479,paladin,retribution,12,5,7
27824,Vcd,kazzak,479,paladin,retribution,12,5,7
27825,Notholy,defias-brotherhood,479,paladin,retribution,12,5,7
27826,Dykopala,doomhammer,479,paladin,retribution,12,5,7
27827,Taffz,burning-legion,479,paladin,retribution,12,5,7
27828,Gaab,aggra-português,479,paladin,retribution,12,5,7
27829,Angelwings,nefarian,479,paladin,retribution,12,5,7
27830,Brammers,doomhammer,479,paladin,retribution,12,5,7
27831,Solyra,blackhand,479,paladin,retribution,12,5,7
27832,Benø,malganis,479,paladin,retribution,12,5,7
27833,Sorâ,archimonde,479,paladin,retribution,12,5,7
27834,Aion,chamber-of-aspects,479,paladin,retribution,18,5,13
27835,Aelaris,dunemaul,479,paladin,retribution,18,5,13
27836,Drestaen,drakthul,479,paladin,retribution,18,5,13
27837,Eriesh,cthun,479,paladin,retribution,18,5,13
27838,Hazeman,colinas-pardas,478,paladin,retribution,6,5,1
27839,Mysticlight,sylvanas,478,paladin,retribution,18,8,10
27840,Nerdcore,blackrock,478,paladin,retribution,12,5,7
27841,Mirelaw,drakthul,478,paladin,retribution,12,5,7
27842,Atreyu,stormscale,478,paladin,retribution,12,5,7
27843,Kanot,outland,478,paladin,retribution,12,5,7
27844,Shrékhead,hellfire,478,paladin,retribution,12,5,7
27845,Четкийчервь,soulflayer,478,paladin,retribution,18,5,13
27846,Ragnàr,aggra-português,477,paladin,retribution,12,5,7
27847,Chofre,thunderhorn,477,paladin,retribution,18,5,13
27848,Zantria,alleria,476,paladin,retribution,12,5,7
27849,Luciiano,malygos,476,paladin,retribution,12,5,7
27850,Lysân,eredar,475,paladin,retribution,12,5,7
27851,Izri,hellscream,475,paladin,retribution,12,5,7
27852,Sindur,perenolde,474,paladin,retribution,12,5,7
27853,Thiccfreak,tarren-mill,474,paladin,retribution,14,5,9
27854,Parkla,twisting-nether,473,paladin,retribution,12,5,7
27855,Yeohinyiu,khaz-modan,472,paladin,retribution,12,5,7
27856,Hateze,kazzak,472,paladin,retribution,12,5,7
27857,Yeretria,krasus,472,paladin,retribution,12,5,7
27858,Лонса,soulflayer,463,paladin,retribution,11,5,6
27859,Kurøneko,hyjal,463,paladin,retribution,11,5,6
27860,Demool,the-maelstrom,463,paladin,retribution,11,5,6
27861,Slayton,twisting-nether,447,paladin,retribution,11,5,6
27862,Гкм,howling-fjord,447,paladin,retribution,11,5,6
27863,Эсканор,galakrond,447,paladin,retribution,14,6,8
27864,Davairabotai,kazzak,447,paladin,retribution,20,6,14
27865,Kevlar,frostmane,446,paladin,retribution,12,6,6
27866,Аркрум,gordunni,446,paladin,retribution,11,5,6
27867,Æïs,blackrock,432,paladin,retribution,9,5,4
27868,Åvra,ysondre,432,paladin,retribution,15,5,10
27869,Sunnyboy,tarren-mill,431,paladin,retribution,11,5,6
27870,Theodun,xavius,430,paladin,retribution,11,5,6
27871,Caps,the-venture-co,416,paladin,retribution,16,5,11
27872,Willmot,stormscale,415,paladin,retribution,8,5,3
27873,Jobsu,defias-brotherhood,415,paladin,retribution,9,5,4
27874,Zell,silvermoon,414,paladin,retribution,16,5,11
27875,Zouppis,ravencrest,400,paladin,retribution,7,5,2
27876,Veléxis,outland,384,paladin,retribution,6,4,2
27877,Giggs,turalyon,384,paladin,retribution,6,4,2
27878,Jøløz,hyjal,384,paladin,retribution,6,4,2
27879,Missybugla,turalyon,384,paladin,retribution,6,4,2
27880,Firfiris,twisting-nether,384,paladin,retribution,6,4,2
27881,Léona,hyjal,384,paladin,retribution,6,4,2
27882,Nezgrôs,hyjal,384,paladin,retribution,6,4,2
27883,Uhtrèd,turalyon,384,paladin,retribution,6,4,2
27884,Aprânax,twisting-nether,384,paladin,retribution,6,4,2
27885,Cattelsaan,hyjal,384,paladin,retribution,6,4,2
27886,Раикерс,gordunni,384,paladin,retribution,6,4,2
27887,Michelineous,auchindoun,384,paladin,retribution,6,4,2
27888,Kralenko,archimonde,384,paladin,retribution,6,4,2
27889,Вэйсспал,howling-fjord,384,paladin,retribution,6,4,2
27890,Hiloqtpala,blackmoore,384,paladin,retribution,6,4,2
27891,Oriath,draenor,384,paladin,retribution,6,4,2
27892,Idin,nemesis,384,paladin,retribution,6,4,2
27893,Драгмитухел,gordunni,384,paladin,retribution,6,4,2
27894,Boaz,norgannon,384,paladin,retribution,6,4,2
27895,Daddyolimpp,kazzak,384,paladin,retribution,6,4,2
27896,Zhàø,ysondre,384,paladin,retribution,6,4,2
27897,Udrik,proudmoore,384,paladin,retribution,6,4,2
27898,Jaime,magtheridon,384,paladin,retribution,6,4,2
27899,Kaähz,archimonde,384,paladin,retribution,6,4,2
27900,Jiricech,tarren-mill,384,paladin,retribution,6,4,2
27901,Cerfica,drakthul,384,paladin,retribution,6,4,2
27902,Wiither,argent-dawn,384,paladin,retribution,6,4,2
27903,Peacekeep,stormscale,384,paladin,retribution,6,4,2
27904,Hurrier,outland,384,paladin,retribution,6,4,2
27905,Missmyhoj,archimonde,384,paladin,retribution,6,4,2
27906,Hanknpank,quelthalas,384,paladin,retribution,6,4,2
27907,Tigurius,zuljin,384,paladin,retribution,6,4,2
27908,Kayback,archimonde,384,paladin,retribution,6,4,2
27909,Miskok,twisting-nether,384,paladin,retribution,6,4,2
27910,Morgoth,daggerspine,384,paladin,retribution,6,4,2
27911,Neverdiex,blackrock,384,paladin,retribution,6,4,2
27912,Haudrupp,blackmoore,384,paladin,retribution,6,4,2
27913,Kazui,lordaeron,384,paladin,retribution,6,4,2
27914,Адирон,booty-bay,384,paladin,retribution,6,4,2
27915,Arcillus,stormscale,384,paladin,retribution,6,4,2
27916,Raek,stormscale,384,paladin,retribution,6,4,2
27917,Zùlka,krasus,384,paladin,retribution,6,4,2
27918,Dornu,tarren-mill,384,paladin,retribution,6,4,2
27919,Spartacøn,kazzak,384,paladin,retribution,6,4,2
27920,Paladoom,magtheridon,384,paladin,retribution,6,4,2
27921,Petrzajonc,outland,384,paladin,retribution,6,4,2
27922,Òlymp,blackhand,384,paladin,retribution,6,4,2
27923,Любитель,azuregos,384,paladin,retribution,6,4,2
27924,Angeal,ysondre,384,paladin,retribution,6,4,2
27925,Skrýmir,marécage-de-zangar,384,paladin,retribution,6,4,2
27926,Aresdin,blackmoore,384,paladin,retribution,6,4,2
27927,Baldrheim,culte-de-la-rive-noire,384,paladin,retribution,6,4,2
27928,Скидульф,blackscar,384,paladin,retribution,6,4,2
27929,Хашон,gordunni,384,paladin,retribution,6,4,2
27930,Holaa,blackrock,384,paladin,retribution,6,4,2
27931,Pawelinus,blackrock,384,paladin,retribution,6,4,2
27932,Sunstrider,quelthalas,384,paladin,retribution,6,4,2
27933,Zeportpala,archimonde,384,paladin,retribution,6,4,2
27934,Соргосош,gordunni,384,paladin,retribution,6,4,2
27935,Zeggayoda,nemesis,384,paladin,retribution,6,4,2
27936,Fluppy,the-maelstrom,384,paladin,retribution,6,4,2
27937,Lothacia,blackmoore,384,paladin,retribution,6,4,2
27938,Cake,alakir,384,paladin,retribution,6,4,2
27939,Teebxu,outland,384,paladin,retribution,6,4,2
27940,Sabriaña,silvermoon,384,paladin,retribution,6,4,2
27941,Dragongîrl,lothar,384,paladin,retribution,6,4,2
27942,Blessedpapi,draenor,384,paladin,retribution,6,4,2
27943,Sneptica,draenor,384,paladin,retribution,6,4,2
27944,Kirlight,blackrock,384,paladin,retribution,6,4,2
27945,Sheldon,sylvanas,384,paladin,retribution,6,4,2
27946,Madarä,arathi,384,paladin,retribution,6,4,2
27947,Elenia,baelgun,384,paladin,retribution,6,4,2
27948,Zeackzs,rajaxx,384,paladin,retribution,6,4,2
27949,Imtheßoss,pozzo-delleternità,384,paladin,retribution,6,4,2
27950,Deworld,tarren-mill,384,paladin,retribution,6,4,2
27951,Keem,aszune,384,paladin,retribution,6,4,2
27952,Marmotaxx,dun-modr,384,paladin,retribution,6,4,2
27953,Retqt,eredar,384,paladin,retribution,6,4,2
27954,Rölfchen,frostwolf,384,paladin,retribution,6,4,2
27955,Shevøçk,ravencrest,384,paladin,retribution,6,4,2
27956,Minpala,kazzak,384,paladin,retribution,6,4,2
27957,Позабытый,deathweaver,384,paladin,retribution,6,4,2
27958,Лиадринель,howling-fjord,384,paladin,retribution,6,4,2
27959,Фоггихохо,gordunni,384,paladin,retribution,6,4,2
27960,Chobb,thunderhorn,384,paladin,retribution,6,4,2
27961,Clementine,spinebreaker,384,paladin,retribution,6,4,2
27962,Кукусяшка,gordunni,384,paladin,retribution,6,4,2
27963,Timoxas,kazzak,384,paladin,retribution,6,4,2
27964,Судья,greymane,384,paladin,retribution,6,4,2
27965,Alciera,silvermoon,384,paladin,retribution,6,4,2
27966,Röcc,draenor,384,paladin,retribution,6,4,2
27967,Volkai,zuljin,384,paladin,retribution,6,4,2
27968,Boëndil,ravencrest,384,paladin,retribution,6,4,2
27969,Raratina,draenor,384,paladin,retribution,6,4,2
27970,Джиблэйд,gordunni,384,paladin,retribution,6,4,2
27971,Бабичпал,soulflayer,384,paladin,retribution,6,4,2
27972,Tuxa,blackrock,384,paladin,retribution,6,4,2
27973,Phiana,blackmoore,384,paladin,retribution,6,4,2
27974,Maýlin,das-konsortium,384,paladin,retribution,6,4,2
27975,Mariahuana,sanguino,384,paladin,retribution,6,4,2
27976,Naizem,dun-modr,384,paladin,retribution,6,4,2
27977,Néméssisx,ravencrest,384,paladin,retribution,6,4,2
27978,Unhittable,draenor,384,paladin,retribution,6,4,2
27979,Mcnnuggets,ravencrest,384,paladin,retribution,6,4,2
27980,Colpadeltank,kazzak,384,paladin,retribution,6,4,2
27981,Tdchopa,ravencrest,384,paladin,retribution,6,4,2
27982,Exley,blackmoore,384,paladin,retribution,6,4,2
27983,Æmiø,blackmoore,384,paladin,retribution,6,4,2
27984,Кэшбэкер,fordragon,384,paladin,retribution,6,4,2
27985,Pâlâpâm,blackmoore,384,paladin,retribution,6,4,2
27986,Crussaden,stormscale,384,paladin,retribution,7,4,3
27987,Ковбаскаа,gordunni,384,paladin,retribution,9,5,4
27988,Lotarios,tarren-mill,384,paladin,retribution,9,5,4
27989,Ashengelm,silvermoon,384,paladin,retribution,9,5,4
27990,Crêuyf,elune,384,paladin,retribution,10,5,5
27991,Shoogle,alonsus,384,paladin,retribution,9,4,5
27992,Хилвкд,blackscar,384,paladin,retribution,11,4,7
27993,Athênâ,azjolnerub,384,paladin,retribution,15,5,10
27994,Ревирант,howling-fjord,384,paladin,retribution,12,4,8
27995,Suavé,ravencrest,384,paladin,retribution,12,4,8
27996,Sorkara,argent-dawn,384,paladin,retribution,12,4,8
27997,Æternal,arathor,384,paladin,retribution,12,4,8
27998,Холигор,deathguard,384,paladin,retribution,12,4,8
27999,Lûvmølly,silvermoon,384,paladin,retribution,12,4,8
28000,Бладриус,howling-fjord,384,paladin,retribution,12,4,8
28001,Beefcake,bladefist,384,paladin,retribution,12,4,8
28002,Халва,deathguard,384,paladin,retribution,12,4,8
28003,Hasart,tarren-mill,384,paladin,retribution,12,4,8
28004,Aleya,arathor,384,paladin,retribution,12,4,8
28005,Thiccdeeps,aegwynn,384,paladin,retribution,12,4,8
28006,Liléa,hyjal,384,paladin,retribution,12,4,8
28007,Decain,twisting-nether,384,paladin,retribution,12,4,8
28008,Sgiach,draenor,384,paladin,retribution,12,4,8
28009,One,grim-batol,384,paladin,retribution,12,4,8
28010,Хэймердингер,howling-fjord,384,paladin,retribution,12,4,8
28011,Cheerrios,arathor,384,paladin,retribution,12,4,8
28012,Kimozabie,ravencrest,384,paladin,retribution,12,4,8
28013,Trefata,kazzak,384,paladin,retribution,12,4,8
28014,Дрейв,soulflayer,384,paladin,retribution,12,4,8
28015,Beefdaddykuu,ravencrest,384,paladin,retribution,12,4,8
28016,Waks,dalaran,384,paladin,retribution,12,4,8
28017,Lucretius,kilrogg,384,paladin,retribution,12,4,8
28018,Eîon,argent-dawn,384,paladin,retribution,12,4,8
28019,Redmoo,tarren-mill,384,paladin,retribution,12,4,8
28020,Trainors,chamber-of-aspects,384,paladin,retribution,12,4,8
28021,Karsini,arathor,384,paladin,retribution,12,4,8
28022,Bugohoss,nathrezim,384,paladin,retribution,12,4,8
28023,Myû,die-aldor,384,paladin,retribution,12,4,8
28024,Âgreë,frostwhisper,384,paladin,retribution,12,4,8
28025,Лаунесса,gordunni,384,paladin,retribution,12,4,8
28026,Valoren,todeswache,384,paladin,retribution,12,4,8
28027,Ekber,ravencrest,384,paladin,retribution,12,4,8
28028,Azrpal,kazzak,384,paladin,retribution,12,4,8
28029,Ambîorix,dun-modr,384,paladin,retribution,12,4,8
28030,Stjusmussel,ragnaros,384,paladin,retribution,12,4,8
28031,Alawdi,ysondre,384,paladin,retribution,12,4,8
28032,Blockitp,stormscale,384,paladin,retribution,12,4,8
28033,Турбобит,gordunni,384,paladin,retribution,12,4,8
28034,Etzann,draenor,384,paladin,retribution,12,4,8
28035,Artoriaz,ravencrest,384,paladin,retribution,12,4,8
28036,Krullfar,ravencrest,384,paladin,retribution,12,4,8
28037,Popelarr,burning-blade,384,paladin,retribution,12,4,8
28038,Serim,dun-modr,384,paladin,retribution,12,4,8
28039,Dennyboy,sylvanas,384,paladin,retribution,12,4,8
28040,Pålegg,emerald-dream,384,paladin,retribution,12,4,8
28041,Adevald,silvermoon,384,paladin,retribution,12,4,8
28042,Mystràs,khaz-modan,384,paladin,retribution,12,4,8
28043,Xerya,dun-modr,384,paladin,retribution,12,4,8
28044,Arkkipiispa,outland,384,paladin,retribution,12,4,8
28045,Jericcho,dun-modr,384,paladin,retribution,12,4,8
28046,Minfa,argent-dawn,384,paladin,retribution,12,4,8
28047,Øazimutø,archimonde,384,paladin,retribution,12,4,8
28048,Киилаа,gordunni,384,paladin,retribution,12,4,8
28049,Nexo,bloodscalp,384,paladin,retribution,12,4,8
28050,Ragonas,mannoroth,384,paladin,retribution,12,4,8
28051,Cyban,twisting-nether,384,paladin,retribution,12,4,8
28052,Эсмория,gordunni,384,paladin,retribution,12,4,8
28053,Chïefen,twisting-nether,384,paladin,retribution,12,4,8
28054,Yeetholy,ragnaros,384,paladin,retribution,12,4,8
28055,Dêadgame,aegwynn,384,paladin,retribution,12,4,8
28056,Vhestas,dun-modr,384,paladin,retribution,12,4,8
28057,Avengence,dragonblight,384,paladin,retribution,12,4,8
28058,Phazio,twisting-nether,384,paladin,retribution,12,4,8
28059,Lullabye,runetotem,384,paladin,retribution,12,4,8
28060,Æfhm,blackrock,384,paladin,retribution,12,4,8
28061,Quarrel,kul-tiras,384,paladin,retribution,12,4,8
28062,Kyrín,onyxia,384,paladin,retribution,12,4,8
28063,Strongman,twilights-hammer,384,paladin,retribution,12,4,8
28064,Cafa,turalyon,384,paladin,retribution,12,4,8
28065,Palapaye,archimonde,384,paladin,retribution,12,4,8
28066,Retfull,sylvanas,384,paladin,retribution,12,4,8
28067,Nobo,hellfire,384,paladin,retribution,12,4,8
28068,Zarifence,ragnaros,384,paladin,retribution,12,4,8
28069,Kielonpala,kazzak,384,paladin,retribution,12,4,8
28070,Somaxpala,burning-legion,384,paladin,retribution,12,4,8
28071,Zhroomxx,blackmoore,384,paladin,retribution,12,4,8
28072,Highcrown,argent-dawn,384,paladin,retribution,12,4,8
28073,Valzyffs,twisting-nether,384,paladin,retribution,12,4,8
28074,Bundagains,silvermoon,384,paladin,retribution,12,4,8
28075,Yakuron,blackhand,384,paladin,retribution,12,4,8
28076,Катсес,eversong,384,paladin,retribution,12,4,8
28077,Lopal,silvermoon,384,paladin,retribution,12,4,8
28078,Madeofsteel,silvermoon,384,paladin,retribution,12,4,8
28079,Kÿsse,hyjal,384,paladin,retribution,12,4,8
28080,Ippex,silvermoon,384,paladin,retribution,12,4,8
28081,Pecar,stormscale,384,paladin,retribution,12,4,8
28082,Розовыйбабл,gordunni,384,paladin,retribution,12,4,8
28083,Зираэлис,gordunni,384,paladin,retribution,12,4,8
28084,Phannelle,ysondre,384,paladin,retribution,12,4,8
28085,Поддыхдам,gordunni,384,paladin,retribution,12,4,8
28086,Denathar,draenor,384,paladin,retribution,12,4,8
28087,Yasfy,stormscale,384,paladin,retribution,12,4,8
28088,Cyborg,ysondre,384,paladin,retribution,12,4,8
28089,Heidfield,draenor,384,paladin,retribution,12,4,8
28090,Ríék,lightbringer,384,paladin,retribution,12,4,8
28091,Бойкийкот,eversong,384,paladin,retribution,12,4,8
28092,Astamye,ysondre,384,paladin,retribution,12,4,8
28093,Grymbol,boulderfist,384,paladin,retribution,12,4,8
28094,Perxx,stormscale,384,paladin,retribution,12,4,8
28095,Cartell,dun-morogh,384,paladin,retribution,12,4,8
28096,Gellmar,the-maelstrom,384,paladin,retribution,12,4,8
28097,Monaatamis,kazzak,384,paladin,retribution,12,4,8
28098,Ruttodidio,outland,384,paladin,retribution,12,4,8
28099,Stoneð,antonidas,384,paladin,retribution,12,4,8
28100,Crowdev,zuljin,384,paladin,retribution,12,4,8
28101,Millianoxys,norgannon,384,paladin,retribution,12,4,8
28102,Douglazz,tarren-mill,384,paladin,retribution,13,4,9
28103,Artonus,sylvanas,384,paladin,retribution,14,4,10
28104,Nitay,blades-edge,384,paladin,retribution,16,4,12
28105,Nôva,stormscale,384,paladin,retribution,17,4,13
28106,Forthy,drakthul,384,paladin,retribution,18,4,14
28107,Orbia,draenor,384,paladin,retribution,18,4,14
28108,Masuroc,antonidas,384,paladin,retribution,18,4,14
28109,Caribbean,outland,384,paladin,retribution,18,4,14
28110,Wftw,draenor,384,paladin,retribution,18,4,14
28111,Trismegistos,bloodhoof,384,paladin,retribution,18,4,14
28112,Астарин,gordunni,384,paladin,retribution,18,4,14
28113,Pepegasensei,ravencrest,384,paladin,retribution,18,4,14
28114,Загошслакер,howling-fjord,384,paladin,retribution,18,4,14
28115,Halldòr,ravencrest,384,paladin,retribution,18,4,14
28116,Kaatha,archimonde,384,paladin,retribution,18,4,14
28117,Galaerøn,elune,384,paladin,retribution,18,4,14
28118,Neyd,hyjal,384,paladin,retribution,18,4,14
28119,Sorannian,hyjal,384,paladin,retribution,24,4,20
28120,Gélan,stormscale,384,paladin,retribution,24,4,20
28121,Цитри,borean-tundra,383,paladin,retribution,6,4,2
28122,Supersnubben,grim-batol,383,paladin,retribution,6,4,2
28123,Krögerelf,garrosh,383,paladin,retribution,6,4,2
28124,Рукаф,soulflayer,383,paladin,retribution,6,4,2
28125,Lancelhot,archimonde,383,paladin,retribution,6,4,2
28126,Buddy,conseil-des-ombres,383,paladin,retribution,9,5,4
28127,Donfilippo,burning-legion,383,paladin,retribution,12,4,8
28128,Omixlis,ragnaros,383,paladin,retribution,12,4,8
28129,Chunpala,silvermoon,383,paladin,retribution,12,4,8
28130,Elvyri,silvermoon,383,paladin,retribution,12,4,8
28131,Giuliagirod,kazzak,383,paladin,retribution,12,4,8
28132,Ashreaver,burning-legion,383,paladin,retribution,12,4,8
28133,Käylä,silvermoon,383,paladin,retribution,12,4,8
28134,Timesover,doomhammer,383,paladin,retribution,12,4,8
28135,Paladoon,ravencrest,383,paladin,retribution,12,4,8
28136,Hilkisen,ragnaros,383,paladin,retribution,12,4,8
28137,Syrenia,die-silberne-hand,383,paladin,retribution,12,4,8
28138,Ságé,thrall,383,paladin,retribution,16,4,12
28139,Lavacalistar,turalyon,383,paladin,retribution,21,5,16
28140,Shurikèn,khaz-modan,382,paladin,retribution,6,4,2
28141,Larth,the-maelstrom,382,paladin,retribution,6,4,2
28142,Pelaghia,tarren-mill,382,paladin,retribution,6,4,2
28143,Kaezerg,khaz-modan,382,paladin,retribution,12,4,8
28144,Kulgan,aerie-peak,380,paladin,retribution,12,4,8
28145,Palastratos,turalyon,379,paladin,retribution,12,4,8
28146,Bellight,sinstralis,376,paladin,retribution,19,4,15
28147,Errn,ragnaros,367,paladin,retribution,11,4,7
28148,Emakk,darksorrow,351,paladin,retribution,8,5,3
28149,Spóntaneous,ravencrest,351,paladin,retribution,8,5,3
28150,Madzy,archimonde,351,paladin,retribution,11,4,7
28151,Hàppy,malfurion,351,paladin,retribution,11,4,7
28152,Joeintkaa,ragnaros,351,paladin,retribution,11,4,7
28153,Kantfyrste,ravencrest,351,paladin,retribution,11,4,7
28154,Олегсудья,howling-fjord,351,paladin,retribution,11,4,7
28155,Taigetos,draenor,351,paladin,retribution,11,4,7
28156,Freemain,doomhammer,336,paladin,retribution,9,4,5
28157,Strcker,sylvanas,336,paladin,retribution,9,4,5
28158,Нимбоо,soulflayer,335,paladin,retribution,11,4,7
28159,Sunsera,blackrock,330,paladin,retribution,8,5,3
28160,Alanore,tarren-mill,330,paladin,retribution,13,6,7
28161,Хочучерешни,lich-king,330,paladin,retribution,14,5,9
28162,Enary,zuljin,330,paladin,retribution,15,5,10
28163,Каплясвета,gordunni,330,paladin,retribution,15,5,10
28164,Rafistor,khaz-modan,330,paladin,retribution,24,7,17
28165,Matharr,kazzak,330,paladin,retribution,19,5,14
28166,Respen,trollbane,330,paladin,retribution,22,5,17
28167,Stonebeard,ahnqiraj,329,paladin,retribution,25,5,20
28168,Bafbaf,arathi,329,paladin,retribution,30,5,25
28169,Glâdiatør,blackrock,320,paladin,retribution,10,4,6
28170,Lgbtqlover,kazzak,319,paladin,retribution,5,4,1
28171,Kyazar,sylvanas,319,paladin,retribution,5,4,1
28172,Strìke,ragnaros,319,paladin,retribution,8,4,4
28173,Vermilia,blackmoore,319,paladin,retribution,8,4,4
28174,Артуроэльф,eversong,318,paladin,retribution,11,4,7
28175,Ønyxqt,archimonde,304,paladin,retribution,7,4,3
28176,Stárchy,terenas,288,paladin,retribution,6,3,3
28177,Môôses,kazzak,288,paladin,retribution,6,3,3
28178,Lightfôrce,blackmoore,288,paladin,retribution,6,3,3
28179,Partur,stormreaver,288,paladin,retribution,6,3,3
28180,Hione,burning-legion,288,paladin,retribution,6,3,3
28181,Sparckqt,nemesis,288,paladin,retribution,6,3,3
28182,Mayhem,area-52,288,paladin,retribution,6,3,3
28183,Isgarot,pozzo-delleternità,288,paladin,retribution,6,3,3
28184,Novà,ravencrest,288,paladin,retribution,6,3,3
28185,Staturos,burning-legion,288,paladin,retribution,6,3,3
28186,Kelsumi,draenor,288,paladin,retribution,6,3,3
28187,Ráydrax,dun-modr,288,paladin,retribution,6,3,3
28188,Tìberias,blackmoore,288,paladin,retribution,6,3,3
28189,Septèmber,draenor,288,paladin,retribution,6,3,3
28190,Vaciusta,silvermoon,288,paladin,retribution,6,3,3
28191,Senteha,stormscale,288,paladin,retribution,6,3,3
28192,Taukkï,kazzak,288,paladin,retribution,6,3,3
28193,Dominoeffect,sylvanas,288,paladin,retribution,6,3,3
28194,Akcope,thunderhorn,288,paladin,retribution,6,3,3
28195,Fogell,ravencrest,288,paladin,retribution,6,3,3
28196,Tyn,dragonmaw,288,paladin,retribution,6,3,3
28197,Holythore,shadowsong,288,paladin,retribution,6,3,3
28198,Thalyia,neptulon,288,paladin,retribution,6,3,3
28199,Swäagg,hyjal,288,paladin,retribution,6,3,3
28200,Bootysmasher,silvermoon,288,paladin,retribution,6,3,3
28201,Lolsurprise,twisting-nether,288,paladin,retribution,6,3,3
28202,Редрот,gordunni,288,paladin,retribution,6,3,3
28203,Alekks,silvermoon,288,paladin,retribution,6,3,3
28204,Isotun,kazzak,288,paladin,retribution,6,3,3
28205,Crazydiamond,garona,288,paladin,retribution,6,3,3
28206,Muradun,aegwynn,288,paladin,retribution,6,3,3
28207,Valeantz,draenor,288,paladin,retribution,6,3,3
28208,Strangerx,blackrock,288,paladin,retribution,6,3,3
28209,Illmindofyou,twisting-nether,288,paladin,retribution,6,3,3
28210,Krístjan,silvermoon,288,paladin,retribution,6,3,3
28211,Andriâ,blackhand,288,paladin,retribution,6,3,3
28212,Belåkor,silvermoon,288,paladin,retribution,6,3,3
28213,Wonkans,draenor,288,paladin,retribution,6,3,3
28214,Bashx,outland,288,paladin,retribution,6,3,3
28215,Ñusret,aegwynn,288,paladin,retribution,6,3,3
28216,Paladiaz,blackhand,288,paladin,retribution,6,3,3
28217,Bogrács,silvermoon,288,paladin,retribution,6,3,3
28218,Mansoureagle,kazzak,288,paladin,retribution,6,3,3
28219,Shaká,ravencrest,288,paladin,retribution,6,3,3
28220,Feliora,magtheridon,288,paladin,retribution,6,3,3
28221,Synthesis,uldum,288,paladin,retribution,6,3,3
28222,Astralz,aegwynn,288,paladin,retribution,6,3,3
28223,Sekoran,sunstrider,288,paladin,retribution,6,3,3
28224,Deckardpain,shattered-hand,288,paladin,retribution,6,3,3
28225,Azzaelea,tarren-mill,288,paladin,retribution,6,3,3
28226,Watchmestomp,draenor,288,paladin,retribution,6,3,3
28227,Animegifx,ragnaros,288,paladin,retribution,6,3,3
28228,Holydeath,aegwynn,288,paladin,retribution,6,3,3
28229,Лайсен,gordunni,288,paladin,retribution,6,3,3
28230,Thomususholy,silvermoon,288,paladin,retribution,6,3,3
28231,Rômtone,dalaran,288,paladin,retribution,6,3,3
28232,Véngeance,twilights-hammer,288,paladin,retribution,6,3,3
28233,Heyley,twisting-nether,288,paladin,retribution,6,3,3
28234,Goofyret,ravencrest,288,paladin,retribution,6,3,3
28235,Hatoms,hyjal,288,paladin,retribution,6,3,3
28236,Exero,frostmane,288,paladin,retribution,6,3,3
28237,Хэппипала,soulflayer,288,paladin,retribution,6,3,3
28238,Sérath,twisting-nether,288,paladin,retribution,6,3,3
28239,Divinemove,stormscale,288,paladin,retribution,6,3,3
28240,Amq,blackhand,288,paladin,retribution,6,3,3
28241,Ráikou,sylvanas,288,paladin,retribution,6,3,3
28242,Uoloop,kazzak,288,paladin,retribution,6,3,3
28243,Synexy,kazzak,288,paladin,retribution,6,3,3
28244,Stocks,burning-blade,288,paladin,retribution,6,3,3
28245,Drwings,drakthul,288,paladin,retribution,6,3,3
28246,Meezu,ravencrest,288,paladin,retribution,6,3,3
28247,Prâtox,blackmoore,288,paladin,retribution,6,3,3
28248,Partysyster,defias-brotherhood,288,paladin,retribution,6,3,3
28249,Împala,twisting-nether,288,paladin,retribution,6,3,3
28250,Xirôs,zirkel-des-cenarius,288,paladin,retribution,6,3,3
28251,Neoz,ravencrest,288,paladin,retribution,6,3,3
28252,Epipheny,frostmane,288,paladin,retribution,6,3,3
28253,Dezaster,dentarg,288,paladin,retribution,6,3,3
28254,Tyranius,bronzebeard,288,paladin,retribution,6,3,3
28255,Ruben,kirin-tor,288,paladin,retribution,6,3,3
28256,Tørque,archimonde,288,paladin,retribution,6,3,3
28257,Zetnic,kazzak,288,paladin,retribution,6,3,3
28258,Muieiulica,twisting-nether,288,paladin,retribution,6,3,3
28259,Steínsgate,ravencrest,288,paladin,retribution,6,3,3
28260,Paladikt,teldrassil,288,paladin,retribution,6,3,3
28261,Ðåøóýöøðí,ravencrest,288,paladin,retribution,6,3,3
28262,Judgedude,stormscale,288,paladin,retribution,6,3,3
28263,Dédoniste,archimonde,288,paladin,retribution,6,3,3
28264,Yoggsaron,dun-modr,288,paladin,retribution,6,3,3
28265,Ollepala,draenor,288,paladin,retribution,6,3,3
28266,Phystos,culte-de-la-rive-noire,288,paladin,retribution,6,3,3
28267,Reptoglad,archimonde,288,paladin,retribution,6,3,3
28268,Nympa,sylvanas,288,paladin,retribution,6,3,3
28269,Astralenigma,hyjal,288,paladin,retribution,6,3,3
28270,Palapouffe,khaz-modan,288,paladin,retribution,6,3,3
28271,Pappipala,tarren-mill,288,paladin,retribution,6,3,3
28272,Moolurk,stormscale,288,paladin,retribution,6,3,3
28273,Bahamamama,ambossar,288,paladin,retribution,6,3,3
28274,Киръпич,grom,288,paladin,retribution,6,3,3
28275,Failhammer,tarren-mill,288,paladin,retribution,6,3,3
28276,Кузнейц,borean-tundra,288,paladin,retribution,6,3,3
28277,Bämschi,blackrock,288,paladin,retribution,6,3,3
28278,Freakks,twisting-nether,288,paladin,retribution,6,3,3
28279,Lóde,silvermoon,288,paladin,retribution,6,3,3
28280,Minirempart,khaz-modan,288,paladin,retribution,6,3,3
28281,Hyroshima,archimonde,288,paladin,retribution,6,3,3
28282,Tonynox,hyjal,288,paladin,retribution,6,3,3
28283,Thunderwoman,ragnaros,288,paladin,retribution,6,3,3
28284,Aklime,blackmoore,288,paladin,retribution,6,3,3
28285,Hondur,blackmoore,288,paladin,retribution,6,3,3
28286,Holyshêêt,draenor,288,paladin,retribution,6,3,3
28287,Xirac,antonidas,288,paladin,retribution,6,3,3
28288,Hotchíck,outland,288,paladin,retribution,6,3,3
28289,Svipdag,quelthalas,288,paladin,retribution,6,3,3
28290,Glorfindel,tarren-mill,288,paladin,retribution,6,3,3
28291,Myrtîllê,archimonde,288,paladin,retribution,6,3,3
28292,Daemøs,antonidas,288,paladin,retribution,6,3,3
28293,Retroxy,stormreaver,288,paladin,retribution,6,3,3
28294,Pastabianco,ravencrest,288,paladin,retribution,6,3,3
28295,Lixîa,hyjal,288,paladin,retribution,6,3,3
28296,Aoldur,ragnaros,288,paladin,retribution,6,3,3
28297,Ozen,blackrock,288,paladin,retribution,6,3,3
28298,Cilodin,blackrock,288,paladin,retribution,6,3,3
28299,Dyonisøs,archimonde,288,paladin,retribution,6,3,3
28300,Lotheirid,antonidas,288,paladin,retribution,6,3,3
28301,Vîdelle,eldrethalas,288,paladin,retribution,6,3,3
28302,Razztafari,tarren-mill,288,paladin,retribution,6,3,3
28303,Kirikoro,blackmoore,288,paladin,retribution,6,3,3
28304,Elyeasia,silvermoon,288,paladin,retribution,6,3,3
28305,Sixtynien,outland,288,paladin,retribution,6,3,3
28306,Gipas,quelthalas,288,paladin,retribution,6,3,3
28307,Khrogan,bronzebeard,288,paladin,retribution,6,3,3
28308,Мортлайт,soulflayer,288,paladin,retribution,6,3,3
28309,Kishijoten,archimonde,288,paladin,retribution,6,3,3
28310,Raketenreiko,blackrock,288,paladin,retribution,6,3,3
28311,Vérdugo,quelthalas,288,paladin,retribution,6,3,3
28312,Иретис,gordunni,288,paladin,retribution,6,3,3
28313,Бигтедо,gordunni,288,paladin,retribution,6,3,3
28314,Sarunan,ravencrest,288,paladin,retribution,6,3,3
28315,Londrette,kazzak,288,paladin,retribution,6,3,3
28316,Nicolae,saurfang,288,paladin,retribution,6,3,3
28317,Shealby,thrall,288,paladin,retribution,6,3,3
28318,Bonkkar,antonidas,288,paladin,retribution,6,3,3
28319,Golgel,turalyon,288,paladin,retribution,6,3,3
28320,Emet,twisting-nether,288,paladin,retribution,6,3,3
28321,Veo,sylvanas,288,paladin,retribution,6,3,3
28322,Ênmâ,archimonde,288,paladin,retribution,6,3,3
28323,Môdhân,archimonde,288,paladin,retribution,6,3,3
28324,Sakulchan,antonidas,288,paladin,retribution,6,3,3
28325,Faté,madmortem,288,paladin,retribution,6,3,3
28326,Fahrèl,hyjal,288,paladin,retribution,6,3,3
28327,Sileria,kazzak,288,paladin,retribution,6,3,3
28328,Даркхолмь,howling-fjord,288,paladin,retribution,6,3,3
28329,Брюхатая,howling-fjord,288,paladin,retribution,6,3,3
28330,Белоус,howling-fjord,288,paladin,retribution,6,3,3
28331,Hium,zuljin,288,paladin,retribution,6,3,3
28332,Nøradin,argent-dawn,288,paladin,retribution,6,3,3
28333,Paidi,die-todeskrallen,288,paladin,retribution,6,3,3
28334,Lyrïcs,ysondre,288,paladin,retribution,6,3,3
28335,Ïrönhämmër,argent-dawn,288,paladin,retribution,6,3,3
28336,Blookedaro,sanguino,288,paladin,retribution,6,3,3
28337,Guko,frostwolf,288,paladin,retribution,6,3,3
28338,Khredo,eredar,288,paladin,retribution,6,3,3
28339,Лантана,howling-fjord,288,paladin,retribution,6,3,3
28340,Vultrix,tarren-mill,288,paladin,retribution,6,3,3
28341,Dathrohan,sanguino,288,paladin,retribution,6,3,3
28342,Milkâ,burning-legion,288,paladin,retribution,6,3,3
28343,Zeltose,uldaman,288,paladin,retribution,6,3,3
28344,Киэрсис,howling-fjord,288,paladin,retribution,6,3,3
28345,Noanoshy,eredar,288,paladin,retribution,6,3,3
28346,Tjú,mannoroth,288,paladin,retribution,6,3,3
28347,Ryuzu,khazgoroth,288,paladin,retribution,6,3,3
28348,Синтел,eversong,288,paladin,retribution,6,3,3
28349,Бинур,eversong,288,paladin,retribution,6,3,3
28350,Fumbz,alakir,288,paladin,retribution,6,3,3
28351,Рамстафарай,gordunni,288,paladin,retribution,6,3,3
28352,Rhadamentes,ysondre,288,paladin,retribution,6,3,3
28353,Grial,eredar,288,paladin,retribution,6,3,3
28354,Blessbabe,tarren-mill,288,paladin,retribution,6,3,3
28355,Alexii,azjolnerub,288,paladin,retribution,10,4,6
28356,Dorlen,argent-dawn,288,paladin,retribution,10,4,6
28357,Songg,zuljin,288,paladin,retribution,8,3,5
28358,Hýpærpøp,ravencrest,288,paladin,retribution,8,3,5
28359,Aenhel,zuljin,288,paladin,retribution,11,4,7
28360,Tastán,aegwynn,288,paladin,retribution,9,3,6
28361,Dragg,kirin-tor,288,paladin,retribution,10,3,7
28362,Gabe,aggra-português,288,paladin,retribution,15,4,11
28363,Taptreus,antonidas,288,paladin,retribution,12,3,9
28364,Kiytrew,ravencrest,288,paladin,retribution,12,3,9
28365,Mathrixo,silvermoon,288,paladin,retribution,12,3,9
28366,Schoolbus,blackrock,288,paladin,retribution,12,3,9
28367,Liquesco,draenor,288,paladin,retribution,12,3,9
28368,Бетте,gordunni,288,paladin,retribution,12,3,9
28369,Ауё,blackscar,288,paladin,retribution,12,3,9
28370,Shassera,ravencrest,288,paladin,retribution,12,3,9
28371,Ahreesh,blackrock,288,paladin,retribution,12,3,9
28372,Whórainzóne,eredar,288,paladin,retribution,12,3,9
28373,Xzpal,silvermoon,288,paladin,retribution,12,3,9
28374,Çolette,silvermoon,288,paladin,retribution,12,3,9
28375,Strikè,stormscale,288,paladin,retribution,12,3,9
28376,Lucyd,stormscale,288,paladin,retribution,12,3,9
28377,Dmascus,blackrock,288,paladin,retribution,12,3,9
28378,Râkim,malganis,288,paladin,retribution,12,3,9
28379,Notnding,draenor,288,paladin,retribution,12,3,9
28380,Azmocore,blackhand,288,paladin,retribution,12,3,9
28381,Trollpaladin,blackmoore,288,paladin,retribution,12,3,9
28382,Souror,blackmoore,288,paladin,retribution,12,3,9
28383,Каадзуто,eversong,288,paladin,retribution,12,3,9
28384,Popolelo,dun-modr,288,paladin,retribution,12,3,9
28385,Darkham,nemesis,288,paladin,retribution,12,3,9
28386,Dalaly,kazzak,288,paladin,retribution,12,3,9
28387,Галлионн,gordunni,288,paladin,retribution,12,3,9
28388,Эледвен,howling-fjord,288,paladin,retribution,12,3,9
28389,Fuyúrí,burning-legion,288,paladin,retribution,12,3,9
28390,Dathea,aegwynn,288,paladin,retribution,12,3,9
28391,Blecheîmer,aegwynn,288,paladin,retribution,12,3,9
28392,Daddysiliam,ravencrest,288,paladin,retribution,12,3,9
28393,Synáx,blackhand,288,paladin,retribution,12,3,9
28394,Астта,fordragon,288,paladin,retribution,12,3,9
28395,Flogiston,burning-legion,288,paladin,retribution,12,3,9
28396,Wolluna,frostwolf,288,paladin,retribution,12,3,9
28397,Slaaneesh,zuljin,288,paladin,retribution,12,3,9
28398,Shneéz,blackmoore,288,paladin,retribution,12,3,9
28399,Tehacê,blackrock,288,paladin,retribution,12,3,9
28400,Arthàs,blackmoore,288,paladin,retribution,12,3,9
28401,Inmortality,sanguino,288,paladin,retribution,12,3,9
28402,Ахелеззик,gordunni,288,paladin,retribution,12,3,9
28403,Lacrossé,kazzak,288,paladin,retribution,12,3,9
28404,Lylennâ,argent-dawn,288,paladin,retribution,12,3,9
28405,Trwwsano,stormscale,288,paladin,retribution,12,3,9
28406,Mandingbull,stormscale,288,paladin,retribution,12,3,9
28407,Radeto,outland,288,paladin,retribution,12,3,9
28408,Skuzee,archimonde,288,paladin,retribution,12,3,9
28409,Jojomann,stormscale,288,paladin,retribution,12,3,9
28410,Aurasis,archimonde,288,paladin,retribution,12,3,9
28411,Harvel,outland,288,paladin,retribution,12,3,9
28412,Notingvar,doomhammer,288,paladin,retribution,12,3,9
28413,Nasrudan,ravenholdt,288,paladin,retribution,12,3,9
28414,Valarïs,outland,288,paladin,retribution,12,3,9
28415,Simsaii,stormscale,288,paladin,retribution,12,3,9
28416,Leoniidas,cthun,288,paladin,retribution,12,3,9
28417,Câlon,twisting-nether,288,paladin,retribution,12,3,9
28418,Murodin,twisting-nether,288,paladin,retribution,12,3,9
28419,Harnêlia,marécage-de-zangar,288,paladin,retribution,12,3,9
28420,Djuwuu,twisting-nether,288,paladin,retribution,12,3,9
28421,Artemes,malorne,288,paladin,retribution,12,3,9
28422,Kypamop,argent-dawn,288,paladin,retribution,12,3,9
28423,Iñgkara,tarren-mill,288,paladin,retribution,12,3,9
28424,Izelv,dalaran,288,paladin,retribution,12,3,9
28425,Coldcuts,sylvanas,288,paladin,retribution,12,3,9
28426,Cigoveth,sylvanas,288,paladin,retribution,12,3,9
28427,Аладушок,gordunni,288,paladin,retribution,12,3,9
28428,Steelrose,auchindoun,288,paladin,retribution,12,3,9
28429,Sangaro,ragnaros,288,paladin,retribution,12,3,9
28430,Dasvidania,uldum,288,paladin,retribution,12,3,9
28431,Deholyloa,frostwhisper,288,paladin,retribution,12,3,9
28432,Ашилолпро,soulflayer,288,paladin,retribution,12,3,9
28433,Cilla,kult-der-verdammten,288,paladin,retribution,12,3,9
28434,Amadeo,genjuros,288,paladin,retribution,12,3,9
28435,Thærõck,thrall,288,paladin,retribution,12,3,9
28436,Turbopal,burning-blade,288,paladin,retribution,12,3,9
28437,Korneta,sanguino,288,paladin,retribution,12,3,9
28438,Japsee,runetotem,288,paladin,retribution,12,3,9
28439,Pokexx,ragnaros,288,paladin,retribution,12,3,9
28440,Крутикрит,goldrinn,288,paladin,retribution,13,3,10
28441,Agrkan,defias-brotherhood,288,paladin,retribution,17,3,14
28442,Fenik,dun-modr,288,paladin,retribution,18,3,15
28443,Razzim,eredar,288,paladin,retribution,18,3,15
28444,Paladinslaye,dun-modr,288,paladin,retribution,18,3,15
28445,Skemfar,sanguino,288,paladin,retribution,18,3,15
28446,Shârâs,kazzak,288,paladin,retribution,18,3,15
28447,Ulderoth,dun-modr,288,paladin,retribution,18,3,15
28448,Paintdafence,kazzak,288,paladin,retribution,18,3,15
28449,Símp,grim-batol,288,paladin,retribution,18,3,15
28450,Sztat,burning-legion,288,paladin,retribution,18,3,15
28451,Mêyra,blackhand,288,paladin,retribution,20,3,17
28452,Айронс,ashenvale,287,paladin,retribution,6,3,3
28453,Стекловатный,gordunni,287,paladin,retribution,6,3,3
28454,Malzj,garrosh,287,paladin,retribution,6,3,3
28455,Ïwâ,hyjal,287,paladin,retribution,6,3,3
28456,Arthane,frostmane,287,paladin,retribution,6,3,3
28457,Moodypala,doomhammer,287,paladin,retribution,6,3,3
28458,Sìegfrìed,sargeras,287,paladin,retribution,6,3,3
28459,Hrubo,drakthul,287,paladin,retribution,6,3,3
28460,Magott,doomhammer,287,paladin,retribution,6,3,3
28461,Psihar,kazzak,287,paladin,retribution,6,3,3
28462,Trevorion,argent-dawn,287,paladin,retribution,12,3,9
28463,Bore,culte-de-la-rive-noire,287,paladin,retribution,12,3,9
28464,Neftys,aegwynn,287,paladin,retribution,12,3,9
28465,Cajikpal,drakthul,287,paladin,retribution,12,3,9
28466,Voraxpa,draenor,287,paladin,retribution,12,3,9
28467,Rsanchez,frostwolf,286,paladin,retribution,6,3,3
28468,Brictom,tarren-mill,271,paladin,retribution,11,3,8
28469,Рбгхил,howling-fjord,271,paladin,retribution,11,3,8
28470,Tofrus,kazzak,271,paladin,retribution,11,3,8
28471,Стилбич,gordunni,256,paladin,retribution,10,3,7
28472,Msammus,kazzak,255,paladin,retribution,11,3,8
28473,Bloodl,hakkar,255,paladin,retribution,11,3,8
28474,Dodgemyhoj,kazzak,240,paladin,retribution,21,3,18
28475,Manyouk,kazzak,239,paladin,retribution,5,3,2
28476,Gõm,aegwynn,239,paladin,retribution,5,3,2
28477,Kurasame,eredar,239,paladin,retribution,5,3,2
28478,Erannor,kirin-tor,239,paladin,retribution,5,3,2
28479,Papel,kul-tiras,239,paladin,retribution,5,3,2
28480,Ксандэр,soulflayer,239,paladin,retribution,5,3,2
28481,Pooncy,ragnaros,239,paladin,retribution,5,3,2
28482,Aufstapelnx,hyjal,239,paladin,retribution,5,3,2
28483,Tÿy,sylvanas,234,paladin,retribution,8,4,4
28484,Dørvâp,culte-de-la-rive-noire,234,paladin,retribution,11,4,7
28485,Andrøiz,dun-modr,234,paladin,retribution,15,4,11
28486,Psykoosi,defias-brotherhood,232,paladin,retribution,11,4,7
28487,Purpleháze,drekthar,220,paladin,retribution,19,9,10
28488,Bigwings,stormscale,208,paladin,retribution,7,3,4
28489,Valteryl,argent-dawn,192,paladin,retribution,4,3,1
28490,Тазикчая,soulflayer,192,paladin,retribution,4,3,1
28491,Denko,ravencrest,192,paladin,retribution,4,3,1
28492,Casiimuero,los-errantes,192,paladin,retribution,4,3,1
28493,Ryanretnolds,stormscale,192,paladin,retribution,4,3,1
28494,Salthar,dun-modr,192,paladin,retribution,6,2,4
28495,Arthacalan,silvermoon,192,paladin,retribution,6,2,4
28496,Vikingensven,silvermoon,192,paladin,retribution,6,2,4
28497,Pipifeng,silvermoon,192,paladin,retribution,6,2,4
28498,Yumhi,dun-modr,192,paladin,retribution,6,2,4
28499,Abellá,silvermoon,192,paladin,retribution,6,2,4
28500,Alberix,tarren-mill,192,paladin,retribution,6,2,4
28501,Daviaa,silvermoon,192,paladin,retribution,6,2,4
28502,Doormat,stormreaver,192,paladin,retribution,6,2,4
28503,Tópgee,ravencrest,192,paladin,retribution,6,2,4
28504,Seradawn,ravencrest,192,paladin,retribution,6,2,4
28505,Wzzy,ravencrest,192,paladin,retribution,6,2,4
28506,Radiantblood,ravencrest,192,paladin,retribution,6,2,4
28507,Louxoxo,ravencrest,192,paladin,retribution,6,2,4
28508,Garzad,ravencrest,192,paladin,retribution,6,2,4
28509,Timias,silvermoon,192,paladin,retribution,6,2,4
28510,Rdypaladin,ravencrest,192,paladin,retribution,6,2,4
28511,Hupson,dun-modr,192,paladin,retribution,6,2,4
28512,Marshmallów,silvermoon,192,paladin,retribution,6,2,4
28513,Yaxz,ravencrest,192,paladin,retribution,6,2,4
28514,Lightsimper,silvermoon,192,paladin,retribution,6,2,4
28515,Escanoir,azshara,192,paladin,retribution,6,2,4
28516,Daizen,blackrock,192,paladin,retribution,6,2,4
28517,Bigolcritty,silvermoon,192,paladin,retribution,6,2,4
28518,Tindal,stormscale,192,paladin,retribution,6,2,4
28519,Panomecon,magtheridon,192,paladin,retribution,6,2,4
28520,Necrozi,stormscale,192,paladin,retribution,6,2,4
28521,Azraise,stormscale,192,paladin,retribution,6,2,4
28522,Cjis,kazzak,192,paladin,retribution,6,2,4
28523,Retrikuc,stormscale,192,paladin,retribution,6,2,4
28524,Cripxoo,sanguino,192,paladin,retribution,6,2,4
28525,Vans,nazjatar,192,paladin,retribution,6,2,4
28526,Reticles,ravencrest,192,paladin,retribution,6,2,4
28527,Soralî,dethecus,192,paladin,retribution,6,2,4
28528,Blindevotion,the-maelstrom,192,paladin,retribution,6,2,4
28529,Antitodas,argent-dawn,192,paladin,retribution,6,2,4
28530,Туларион,grom,192,paladin,retribution,6,2,4
28531,Teenage,colinas-pardas,192,paladin,retribution,6,2,4
28532,Eneomaos,blackrock,192,paladin,retribution,6,2,4
28533,Arndt,lightbringer,192,paladin,retribution,6,2,4
28534,Zephale,sunstrider,192,paladin,retribution,6,2,4
28535,Onys,onyxia,192,paladin,retribution,6,2,4
28536,Paladéán,malganis,192,paladin,retribution,6,2,4
28537,Chizpal,silvermoon,192,paladin,retribution,6,2,4
28538,Blurengo,blackrock,192,paladin,retribution,6,2,4
28539,Nozgot,chromaggus,192,paladin,retribution,6,2,4
28540,Yuri,voljin,192,paladin,retribution,6,2,4
28541,Xoconuttv,ravencrest,192,paladin,retribution,6,2,4
28542,Asthellis,kazzak,192,paladin,retribution,6,2,4
28543,Trainwréck,ravencrest,192,paladin,retribution,6,2,4
28544,Grømit,drakthul,192,paladin,retribution,6,2,4
28545,Tybrain,blackhand,192,paladin,retribution,6,2,4
28546,Kamas,antonidas,192,paladin,retribution,6,2,4
28547,Thelinara,antonidas,192,paladin,retribution,6,2,4
28548,Ibus,silvermoon,192,paladin,retribution,6,2,4
28549,Yami,blackrock,192,paladin,retribution,6,2,4
28550,Gottesbann,blackrock,192,paladin,retribution,6,2,4
28551,Tpaktopuct,kazzak,192,paladin,retribution,6,2,4
28552,Wingsftw,blackhand,192,paladin,retribution,6,2,4
28553,Boturak,blackrock,192,paladin,retribution,6,2,4
28554,Alto,nordrassil,192,paladin,retribution,6,2,4
28555,Elites,arathor,192,paladin,retribution,6,2,4
28556,Faithsealer,nordrassil,192,paladin,retribution,6,2,4
28557,Strøb,antonidas,192,paladin,retribution,6,2,4
28558,Heilgaharald,blackrock,192,paladin,retribution,6,2,4
28559,Drasir,nemesis,192,paladin,retribution,6,2,4
28560,Ráyøn,antonidas,192,paladin,retribution,6,2,4
28561,Maxunius,antonidas,192,paladin,retribution,6,2,4
28562,Liféféar,tarren-mill,192,paladin,retribution,6,2,4
28563,Shirohige,pozzo-delleternità,192,paladin,retribution,6,2,4
28564,Athomos,pozzo-delleternità,192,paladin,retribution,6,2,4
28565,Кизайрус,soulflayer,192,paladin,retribution,6,2,4
28566,Encoreret,kilrogg,192,paladin,retribution,6,2,4
28567,Vrotkarpala,azjolnerub,192,paladin,retribution,6,2,4
28568,Valanyr,kazzak,192,paladin,retribution,6,2,4
28569,Hekta,wildhammer,192,paladin,retribution,6,2,4
28570,Tusti,tarren-mill,192,paladin,retribution,6,2,4
28571,Djstompyasis,blackmoore,192,paladin,retribution,6,2,4
28572,Malbi,kazzak,192,paladin,retribution,6,2,4
28573,Blazeê,blackrock,192,paladin,retribution,6,2,4
28574,Kamaska,antonidas,192,paladin,retribution,6,2,4
28575,Tsomoo,antonidas,192,paladin,retribution,6,2,4
28576,Izõu,aegwynn,192,paladin,retribution,6,2,4
28577,Kathly,madmortem,192,paladin,retribution,6,2,4
28578,Гачипаладинн,galakrond,192,paladin,retribution,6,2,4
28579,Kíamhalifa,twisting-nether,192,paladin,retribution,6,2,4
28580,Saliver,frostwolf,192,paladin,retribution,6,2,4
28581,Waramo,eredar,192,paladin,retribution,6,2,4
28582,Présidential,grim-batol,192,paladin,retribution,6,2,4
28583,Месатил,deathguard,192,paladin,retribution,6,2,4
28584,Leelemon,frostmane,192,paladin,retribution,6,2,4
28585,Rhonda,tarren-mill,192,paladin,retribution,6,2,4
28586,Aal,eredar,192,paladin,retribution,6,2,4
28587,Miscodepala,twisting-nether,192,paladin,retribution,6,2,4
28588,Clerik,eredar,192,paladin,retribution,6,2,4
28589,Dàk,grim-batol,192,paladin,retribution,6,2,4
28590,Bpontes,aggra-português,192,paladin,retribution,6,2,4
28591,Quennten,grim-batol,192,paladin,retribution,6,2,4
28592,Hompra,outland,192,paladin,retribution,6,2,4
28593,Beiluoshimen,archimonde,192,paladin,retribution,6,2,4
28594,Legrandnain,archimonde,192,paladin,retribution,6,2,4
28595,Bozznamaan,thrall,192,paladin,retribution,6,2,4
28596,Pava,blackmoore,192,paladin,retribution,6,2,4
28597,Raigun,sylvanas,192,paladin,retribution,6,2,4
28598,Krhamos,archimonde,192,paladin,retribution,6,2,4
28599,Xephiroxus,the-venture-co,192,paladin,retribution,6,2,4
28600,Aragonm,outland,192,paladin,retribution,6,2,4
28601,Zuldekk,sanguino,192,paladin,retribution,6,2,4
28602,Xîndra,blackmoore,192,paladin,retribution,6,2,4
28603,Galodina,blackmoore,192,paladin,retribution,6,2,4
28604,Slymm,archimonde,192,paladin,retribution,6,2,4
28605,Nickko,ysondre,192,paladin,retribution,6,2,4
28606,Kårnaj,archimonde,192,paladin,retribution,6,2,4
28607,Iamdurumrush,outland,192,paladin,retribution,6,2,4
28608,Karnabahar,twisting-nether,192,paladin,retribution,6,2,4
28609,Spellcrow,argent-dawn,192,paladin,retribution,6,2,4
28610,Palacheatlol,ysondre,192,paladin,retribution,6,2,4
28611,Brolaf,drakthul,192,paladin,retribution,6,2,4
28612,Frías,zuljin,192,paladin,retribution,6,2,4
28613,Dollicia,outland,192,paladin,retribution,6,2,4
28614,Brihgiul,archimonde,192,paladin,retribution,6,2,4
28615,Lorthaél,karazhan,192,paladin,retribution,6,2,4
28616,Pipiczek,outland,192,paladin,retribution,6,2,4
28617,Lùthér,argent-dawn,192,paladin,retribution,6,2,4
28618,Sacrémounf,archimonde,192,paladin,retribution,6,2,4
28619,Tomforøl,aggramar,192,paladin,retribution,6,2,4
28620,Kapaeus,aggramar,192,paladin,retribution,6,2,4
28621,Ejoz,suramar,192,paladin,retribution,6,2,4
28622,Blauerwürger,blackmoore,192,paladin,retribution,6,2,4
28623,Eisenbiaga,blackmoore,192,paladin,retribution,6,2,4
28624,Антитеррор,greymane,192,paladin,retribution,6,2,4
28625,Stupidgame,outland,192,paladin,retribution,6,2,4
28626,Aksoû,hyjal,192,paladin,retribution,6,2,4
28627,Zixxo,outland,192,paladin,retribution,6,2,4
28628,Maxximuss,drekthar,192,paladin,retribution,6,2,4
28629,Logmár,sanguino,192,paladin,retribution,6,2,4
28630,Altoangelo,outland,192,paladin,retribution,6,2,4
28631,Holyape,argent-dawn,192,paladin,retribution,6,2,4
28632,Gryan,stormscale,192,paladin,retribution,6,2,4
28633,Ðeswynd,hyjal,192,paladin,retribution,6,2,4
28634,Meatslice,boulderfist,192,paladin,retribution,6,2,4
28635,Everessa,sylvanas,192,paladin,retribution,6,2,4
28636,Jÿnxx,hyjal,192,paladin,retribution,6,2,4
28637,Dáimion,defias-brotherhood,192,paladin,retribution,6,2,4
28638,Lionknight,sylvanas,192,paladin,retribution,6,2,4
28639,Svåger,stormscale,192,paladin,retribution,6,2,4
28640,Azapala,kazzak,192,paladin,retribution,6,2,4
28641,Gornim,die-nachtwache,192,paladin,retribution,6,2,4
28642,Hølly,twisting-nether,192,paladin,retribution,6,2,4
28643,Светлолик,eversong,192,paladin,retribution,6,2,4
28644,Kerplonk,burning-legion,192,paladin,retribution,6,2,4
28645,Samypalouf,naxxramas,192,paladin,retribution,6,2,4
28646,Razarus,sylvanas,192,paladin,retribution,6,2,4
28647,Дэвайнэвил,gordunni,192,paladin,retribution,6,2,4
28648,Drjudge,draenor,192,paladin,retribution,6,2,4
28649,Пепескарлет,howling-fjord,192,paladin,retribution,6,2,4
28650,Lightshedder,twisting-nether,192,paladin,retribution,6,2,4
28651,Crownroyal,twisting-nether,192,paladin,retribution,6,2,4
28652,Вишенций,howling-fjord,192,paladin,retribution,6,2,4
28653,Sangrèin,nerathor,192,paladin,retribution,6,2,4
28654,Breakafly,doomhammer,192,paladin,retribution,6,2,4
28655,Загадзуга,howling-fjord,192,paladin,retribution,6,2,4
28656,Starr,confrérie-du-thorium,192,paladin,retribution,6,2,4
28657,Halori,ragnaros,192,paladin,retribution,6,2,4
28658,Almiraj,conseil-des-ombres,192,paladin,retribution,6,2,4
28659,Никитаберс,gordunni,192,paladin,retribution,6,2,4
28660,Soxsnort,twisting-nether,192,paladin,retribution,6,2,4
28661,Скруддж,howling-fjord,192,paladin,retribution,6,2,4
28662,Светочпок,howling-fjord,192,paladin,retribution,6,2,4
28663,Boonner,burning-legion,192,paladin,retribution,6,2,4
28664,Всеволорд,howling-fjord,192,paladin,retribution,6,2,4
28665,Thaldriel,la-croisade-écarlate,192,paladin,retribution,6,2,4
28666,Apokalypson,draenor,192,paladin,retribution,6,2,4
28667,Ashariah,die-aldor,192,paladin,retribution,6,2,4
28668,Ainnamash,twisting-nether,192,paladin,retribution,6,2,4
28669,Zbykmasta,burning-legion,192,paladin,retribution,6,2,4
28670,Fizzyy,ragnaros,192,paladin,retribution,6,2,4
28671,Shápzx,draenor,192,paladin,retribution,6,2,4
28672,Paradice,ragnaros,192,paladin,retribution,6,2,4
28673,Потрепал,blackscar,192,paladin,retribution,6,2,4
28674,Элестаге,gordunni,192,paladin,retribution,6,2,4
28675,Héraclèss,marécage-de-zangar,192,paladin,retribution,6,2,4
28676,Kael,darkspear,192,paladin,retribution,6,2,4
28677,Димаходж,blackscar,192,paladin,retribution,6,2,4
28678,Canihavesome,sylvanas,192,paladin,retribution,6,2,4
28679,Malvax,ragnaros,192,paladin,retribution,6,2,4
28680,Palek,burning-legion,192,paladin,retribution,6,2,4
28681,Lemarobebsi,draenor,192,paladin,retribution,6,2,4
28682,Naylaeh,draenor,192,paladin,retribution,6,2,4
28683,Розовыйужас,howling-fjord,192,paladin,retribution,6,2,4
28684,Ярлд,gordunni,192,paladin,retribution,6,2,4
28685,Palalightdfq,dalaran,192,paladin,retribution,6,2,4
28686,Flashhèart,draenor,192,paladin,retribution,6,2,4
28687,Сильверный,gordunni,192,paladin,retribution,6,2,4
28688,Csvepanszul,ragnaros,192,paladin,retribution,6,2,4
28689,Имраил,gordunni,192,paladin,retribution,6,2,4
28690,Pallyman,arthas,192,paladin,retribution,6,2,4
28691,Dorian,durotan,192,paladin,retribution,6,2,4
28692,Pryzmath,burning-legion,192,paladin,retribution,6,2,4
28693,Афликтшаман,howling-fjord,192,paladin,retribution,6,2,4
28694,Эйлара,howling-fjord,192,paladin,retribution,6,2,4
28695,Elfiama,draenor,192,paladin,retribution,6,2,4
28696,Tecknó,ragnaros,192,paladin,retribution,6,2,4
28697,Blinkdrink,ragnaros,192,paladin,retribution,6,2,4
28698,Тайела,gordunni,192,paladin,retribution,10,3,7
28699,Votiones,tarren-mill,192,paladin,retribution,7,2,5
28700,Плат,gordunni,192,paladin,retribution,7,2,5
28701,Aldèbaràn,pozzo-delleternità,192,paladin,retribution,11,3,8
28702,Damelu,frostwhisper,192,paladin,retribution,8,2,6
28703,Angeliqué,alakir,192,paladin,retribution,12,2,10
28704,Samious,draenor,192,paladin,retribution,12,2,10
28705,Rhyua,eredar,192,paladin,retribution,12,2,10
28706,Galath,drakthul,192,paladin,retribution,12,2,10
28707,Verix,thrall,192,paladin,retribution,12,2,10
28708,Lihli,wildhammer,192,paladin,retribution,12,2,10
28709,Cunix,draenor,192,paladin,retribution,12,2,10
28710,Erathör,sanguino,192,paladin,retribution,12,2,10
28711,Lâlexâ,blackrock,192,paladin,retribution,12,2,10
28712,Kauto,aggra-português,192,paladin,retribution,12,2,10
28713,Stefàn,sylvanas,192,paladin,retribution,12,2,10
28714,Heavenfist,stormscale,192,paladin,retribution,12,2,10
28715,Holythings,kazzak,192,paladin,retribution,12,2,10
28716,Mommy,darksorrow,192,paladin,retribution,12,2,10
28717,Bergalerga,frostmane,192,paladin,retribution,12,2,10
28718,Lightian,twisting-nether,192,paladin,retribution,12,2,10
28719,Stormtrooper,azuremyst,192,paladin,retribution,12,2,10
28720,Tyrallan,ragnaros,192,paladin,retribution,12,2,10
28721,Chitanta,sylvanas,192,paladin,retribution,12,2,10
28722,Remedios,archimonde,192,paladin,retribution,12,2,10
28723,Zimmt,blackmoore,192,paladin,retribution,12,2,10
28724,Docdoolittle,magtheridon,192,paladin,retribution,12,2,10
28725,Ultravíolett,kargath,192,paladin,retribution,12,2,10
28726,Crawini,ragnaros,192,paladin,retribution,12,2,10
28727,Mariuhûna,blackmoore,192,paladin,retribution,12,2,10
28728,Ragneal,hyjal,192,paladin,retribution,12,2,10
28729,Wigbilly,tarren-mill,192,paladin,retribution,12,2,10
28730,Larialaya,thrall,192,paladin,retribution,12,2,10
28731,Tressðr,dun-modr,192,paladin,retribution,12,2,10
28732,Reinwaltz,the-maelstrom,192,paladin,retribution,12,2,10
28733,Muuclear,twisting-nether,192,paladin,retribution,12,2,10
28734,Jacare,ravencrest,192,paladin,retribution,12,2,10
28735,Lunarrider,ravencrest,192,paladin,retribution,12,2,10
28736,Ibubbleqt,outland,192,paladin,retribution,12,2,10
28737,Hordium,doomhammer,192,paladin,retribution,12,2,10
28738,Мунрейм,gordunni,192,paladin,retribution,12,2,10
28739,Pârâsite,hyjal,192,paladin,retribution,12,2,10
28740,Svddendeäthx,ragnaros,192,paladin,retribution,12,2,10
28741,Lowfi,argent-dawn,192,paladin,retribution,12,2,10
28742,Posidin,nemesis,192,paladin,retribution,12,2,10
28743,Djasuo,burning-blade,192,paladin,retribution,12,2,10
28744,Séntúrús,kazzak,192,paladin,retribution,12,2,10
28745,Leriell,ravencrest,192,paladin,retribution,12,2,10
28746,Ijego,silvermoon,192,paladin,retribution,12,2,10
28747,Лимфома,goldrinn,192,paladin,retribution,12,2,10
28748,Bubblekanta,antonidas,192,paladin,retribution,12,2,10
28749,Kesra,die-todeskrallen,192,paladin,retribution,12,2,10
28750,Палагэнг,howling-fjord,192,paladin,retribution,12,2,10
28751,Poloqq,burning-legion,192,paladin,retribution,12,2,10
28752,Berenguer,outland,192,paladin,retribution,12,2,10
28753,Kökslaktarn,sylvanas,192,paladin,retribution,21,3,18
28754,Stillgard,ghostlands,192,paladin,retribution,15,2,13
28755,Cyxanacma,silvermoon,192,paladin,retribution,18,2,16
28756,Snakedubaby,blackrock,192,paladin,retribution,24,2,22
28757,Broziopath,blackrock,191,paladin,retribution,6,2,4
28758,Zuklaus,hyjal,191,paladin,retribution,6,2,4
28759,Zerocar,minahonda,191,paladin,retribution,6,2,4
28760,Duckula,ravenholdt,191,paladin,retribution,6,2,4
28761,Palazs,ravencrest,191,paladin,retribution,6,2,4
28762,Skullreaper,mannoroth,185,paladin,retribution,12,4,8
28763,Maitrelampe,argent-dawn,180,paladin,retribution,29,7,22
28764,Thelronis,kelthuzad,175,paladin,retribution,11,2,9
28765,Hegolas,terrordar,175,paladin,retribution,17,2,15
28766,Blundd,tarren-mill,159,paladin,retribution,5,2,3
28767,Geronimooh,vashj,159,paladin,retribution,5,2,3
28768,Shoqzix,korgall,159,paladin,retribution,5,2,3
28769,Heiemdall,azuremyst,159,paladin,retribution,5,2,3
28770,Vâlthenea,dun-modr,159,paladin,retribution,5,2,3
28771,Serita,archimonde,159,paladin,retribution,11,2,9
28772,Trístesse,tarren-mill,159,paladin,retribution,11,2,9
28773,Амнон,goldrinn,144,paladin,retribution,9,2,7
28774,Tayun,blackmoore,144,paladin,retribution,21,2,19
28775,Еребор,howling-fjord,143,paladin,retribution,15,2,13
28776,Braiinafk,thrall,138,paladin,retribution,6,3,3
28777,Скелфер,soulflayer,138,paladin,retribution,8,3,5
28778,Gerisha,blackrock,138,paladin,retribution,9,3,6
28779,Jesamine,blackmoore,138,paladin,retribution,9,3,6
28780,Luzk,sanguino,138,paladin,retribution,22,4,18
28781,Kaydou,the-maelstrom,128,paladin,retribution,4,2,2
28782,Qpax,twisting-nether,128,paladin,retribution,4,2,2
28783,Mouzimaru,tarren-mill,128,paladin,retribution,10,2,8
28784,Aalyaah,zirkel-des-cenarius,96,paladin,retribution,3,2,1
28785,Zenfuki,draenor,96,paladin,retribution,3,2,1
28786,Nijówka,burning-legion,96,paladin,retribution,6,1,5
28787,Methynox,khaz-modan,96,paladin,retribution,6,1,5
28788,Røse,argent-dawn,96,paladin,retribution,6,1,5
28789,Tibiscovus,silvermoon,96,paladin,retribution,6,1,5
28790,Ansonia,ravencrest,96,paladin,retribution,6,1,5
28791,Hiilton,silvermoon,96,paladin,retribution,6,1,5
28792,Highlòrd,silvermoon,96,paladin,retribution,6,1,5
28793,Holyherb,the-maelstrom,96,paladin,retribution,6,1,5
28794,Serberen,ravencrest,96,paladin,retribution,6,1,5
28795,Dildodin,ravencrest,96,paladin,retribution,6,1,5
28796,Sanctùs,argent-dawn,96,paladin,retribution,6,1,5
28797,Lyliananl,argent-dawn,96,paladin,retribution,6,1,5
28798,Oepabakkez,burning-legion,96,paladin,retribution,6,1,5
28799,Vittosbubu,ravencrest,96,paladin,retribution,6,1,5
28800,Dumbala,ravencrest,96,paladin,retribution,6,1,5
28801,Traxxces,ravencrest,96,paladin,retribution,6,1,5
28802,Palatarlouze,khaz-modan,96,paladin,retribution,6,1,5
28803,Dänie,silvermoon,96,paladin,retribution,6,1,5
28804,Defuzes,twisting-nether,96,paladin,retribution,6,1,5
28805,Bobsing,silvermoon,96,paladin,retribution,6,1,5
28806,Молотуля,howling-fjord,96,paladin,retribution,6,1,5
28807,Tíríón,nethersturm,96,paladin,retribution,6,1,5
28808,Pussas,burning-legion,96,paladin,retribution,6,1,5
28809,Zeroskills,tarren-mill,96,paladin,retribution,6,1,5
28810,Shanilia,argent-dawn,96,paladin,retribution,6,1,5
28811,Thozne,cthun,96,paladin,retribution,6,1,5
28812,Subzery,blackrock,96,paladin,retribution,6,1,5
28813,Graphpora,argent-dawn,96,paladin,retribution,6,1,5
28814,Светиздырки,howling-fjord,96,paladin,retribution,6,1,5
28815,Винзерг,ashenvale,96,paladin,retribution,6,1,5
28816,Kefalas,ravencrest,96,paladin,retribution,6,1,5
28817,Hyggë,sanguino,96,paladin,retribution,6,1,5
28818,Donpascualo,dun-modr,96,paladin,retribution,6,1,5
28819,Lezoom,draenor,96,paladin,retribution,6,1,5
28820,Xblaj,draenor,96,paladin,retribution,6,1,5
28821,Zefiehd,dun-modr,96,paladin,retribution,6,1,5
28822,Ilaris,amanthul,96,paladin,retribution,6,1,5
28823,Пилоттыч,gordunni,96,paladin,retribution,6,1,5
28824,Fatalism,draenor,96,paladin,retribution,6,1,5
28825,Friemelaar,silvermoon,96,paladin,retribution,6,1,5
28826,Dawnbringer,stormscale,96,paladin,retribution,6,1,5
28827,Akagami,ysondre,96,paladin,retribution,6,1,5
28828,Vonadams,ysondre,96,paladin,retribution,6,1,5
28829,Tifer,sanguino,96,paladin,retribution,6,1,5
28830,Omranator,stormscale,96,paladin,retribution,6,1,5
28831,Эльтарус,soulflayer,96,paladin,retribution,6,1,5
28832,Старыйграф,gordunni,96,paladin,retribution,6,1,5
28833,Rataxes,stormreaver,96,paladin,retribution,6,1,5
28834,Stabilisator,blackrock,96,paladin,retribution,6,1,5
28835,Késha,malganis,96,paladin,retribution,6,1,5
28836,Schukow,blackhand,96,paladin,retribution,6,1,5
28837,Sfantull,spinebreaker,96,paladin,retribution,6,1,5
28838,Starcheto,silvermoon,96,paladin,retribution,6,1,5
28839,Destya,eredar,96,paladin,retribution,6,1,5
28840,Cazzanova,draenor,96,paladin,retribution,6,1,5
28841,Notanother,ravencrest,96,paladin,retribution,6,1,5
28842,Diggs,draenor,96,paladin,retribution,6,1,5
28843,Pripravka,burning-blade,96,paladin,retribution,6,1,5
28844,Brightboy,bronze-dragonflight,96,paladin,retribution,6,1,5
28845,Kanollaras,tarren-mill,96,paladin,retribution,6,1,5
28846,Palamaister,stormscale,96,paladin,retribution,6,1,5
28847,Styleez,blackrock,96,paladin,retribution,6,1,5
28848,Évo,drakthul,96,paladin,retribution,6,1,5
28849,Rèdjàck,nemesis,96,paladin,retribution,6,1,5
28850,Naska,nemesis,96,paladin,retribution,6,1,5
28851,Eylina,ragnaros,96,paladin,retribution,6,1,5
28852,Dunksunk,draenor,96,paladin,retribution,6,1,5
28853,Miawyn,blackmoore,96,paladin,retribution,6,1,5
28854,Holyloa,laughing-skull,96,paladin,retribution,6,1,5
28855,Bráders,thunderhorn,96,paladin,retribution,6,1,5
28856,Jehovaa,ragnaros,96,paladin,retribution,6,1,5
28857,Karo,wildhammer,96,paladin,retribution,6,1,5
28858,Amnell,marécage-de-zangar,96,paladin,retribution,6,1,5
28859,Mèlow,dalaran,96,paladin,retribution,6,1,5
28860,Tubie,draenor,96,paladin,retribution,6,1,5
28861,Stealop,malfurion,96,paladin,retribution,6,1,5
28862,Lightbreaker,alleria,96,paladin,retribution,6,1,5
28863,Päyback,nagrand,96,paladin,retribution,6,1,5
28864,Tamuz,chamber-of-aspects,96,paladin,retribution,6,1,5
28865,Zandathor,chamber-of-aspects,96,paladin,retribution,6,1,5
28866,Syfaria,eldrethalas,96,paladin,retribution,6,1,5
28867,Tazsol,kazzak,96,paladin,retribution,6,1,5
28868,Каридин,galakrond,96,paladin,retribution,6,1,5
28869,Plasmadieter,blackrock,96,paladin,retribution,6,1,5
28870,Holyhannes,blackmoore,96,paladin,retribution,6,1,5
28871,Wingzko,draenor,96,paladin,retribution,6,1,5
28872,Shabbyy,bronzebeard,96,paladin,retribution,6,1,5
28873,Xôpâl,kazzak,96,paladin,retribution,6,1,5
28874,Хам,razuvious,96,paladin,retribution,6,1,5
28875,Týrone,blackrock,96,paladin,retribution,6,1,5
28876,Hølyshøckz,blackmoore,96,paladin,retribution,6,1,5
28877,Жмышенко,gordunni,96,paladin,retribution,6,1,5
28878,Wiiso,grim-batol,96,paladin,retribution,6,1,5
28879,Battlelord,terokkar,96,paladin,retribution,6,1,5
28880,Ellisdee,kazzak,96,paladin,retribution,6,1,5
28881,Equalizer,kilrogg,96,paladin,retribution,6,1,5
28882,Brechtje,nagrand,96,paladin,retribution,6,1,5
28883,Istani,twisting-nether,96,paladin,retribution,6,1,5
28884,Édèn,les-sentinelles,96,paladin,retribution,6,1,5
28885,Aggressìon,twisting-nether,96,paladin,retribution,6,1,5
28886,Kambood,twisting-nether,96,paladin,retribution,6,1,5
28887,Jûliâ,archimonde,96,paladin,retribution,6,1,5
28888,Cherenpetur,neptulon,96,paladin,retribution,6,1,5
28889,Zlätän,outland,96,paladin,retribution,6,1,5
28890,Ogpullava,sylvanas,96,paladin,retribution,6,1,5
28891,Tozzey,defias-brotherhood,96,paladin,retribution,6,1,5
28892,Bôomayé,archimonde,96,paladin,retribution,6,1,5
28893,Unkxd,outland,96,paladin,retribution,6,1,5
28894,Xrilled,stormreaver,96,paladin,retribution,6,1,5
28895,Bigorbøøbs,archimonde,96,paladin,retribution,6,1,5
28896,Vindorus,archimonde,96,paladin,retribution,6,1,5
28897,Zanszul,blackmoore,96,paladin,retribution,6,1,5
28898,Liqudic,bloodscalp,96,paladin,retribution,6,1,5
28899,Zala,culte-de-la-rive-noire,96,paladin,retribution,6,1,5
28900,Thaderyl,auchindoun,96,paladin,retribution,6,1,5
28901,Elisun,twisting-nether,96,paladin,retribution,6,1,5
28902,Healsgoodman,twisting-nether,96,paladin,retribution,6,1,5
28903,Humbatäterä,blackmoore,96,paladin,retribution,6,1,5
28904,Ragie,twisting-nether,96,paladin,retribution,6,1,5
28905,Paladzor,twisting-nether,96,paladin,retribution,6,1,5
28906,Яшкино,soulflayer,96,paladin,retribution,6,1,5
28907,Aluzza,sylvanas,96,paladin,retribution,6,1,5
28908,Sínístre,hyjal,96,paladin,retribution,6,1,5
28909,Хилтонепта,gordunni,96,paladin,retribution,6,1,5
28910,Блейзр,ashenvale,96,paladin,retribution,6,1,5
28911,Choppychop,defias-brotherhood,96,paladin,retribution,6,1,5
28912,Skarium,hyjal,96,paladin,retribution,6,1,5
28913,Fraubest,antonidas,96,paladin,retribution,6,1,5
28914,Rekkt,ravenholdt,96,paladin,retribution,6,1,5
28915,Монспьет,borean-tundra,96,paladin,retribution,6,1,5
28916,Taraniah,argent-dawn,96,paladin,retribution,6,1,5
28917,Jezrien,khazgoroth,96,paladin,retribution,6,1,5
28918,Синодушка,howling-fjord,96,paladin,retribution,6,1,5
28919,Reivah,silvermoon,96,paladin,retribution,6,1,5
28920,Kurå,sargeras,96,paladin,retribution,6,1,5
28921,Monmo,emerald-dream,96,paladin,retribution,6,1,5
28922,Sâfcon,eredar,96,paladin,retribution,7,1,6
28923,Borons,silvermoon,96,paladin,retribution,9,1,8
28924,Xvoodoo,antonidas,96,paladin,retribution,11,1,10
28925,Nauy,korgall,96,paladin,retribution,12,1,11
28926,Kavíár,kazzak,96,paladin,retribution,12,1,11
28927,Akinret,twisting-nether,96,paladin,retribution,12,1,11
28928,Wârlørd,sylvanas,96,paladin,retribution,12,1,11
28929,Jaexpaladin,draenor,96,paladin,retribution,12,1,11
28930,Lokinder,pozzo-delleternità,96,paladin,retribution,12,1,11
28931,Purgator,sanguino,96,paladin,retribution,12,1,11
28932,Dawner,defias-brotherhood,96,paladin,retribution,12,1,11
28933,Ляпкин,fordragon,96,paladin,retribution,12,1,11
28934,Vali,burning-blade,96,paladin,retribution,12,1,11
28935,Jayce,durotan,96,paladin,retribution,12,1,11
28936,Zerosixsix,silvermoon,96,paladin,retribution,12,1,11
28937,Kaelorian,silvermoon,96,paladin,retribution,12,1,11
28938,Anemonaa,argent-dawn,96,paladin,retribution,12,1,11
28939,Malvado,blackhand,96,paladin,retribution,12,1,11
28940,Lylu,aggramar,96,paladin,retribution,12,1,11
28941,Dondadajr,ysondre,96,paladin,retribution,12,1,11
28942,Sèrgàs,blackhand,96,paladin,retribution,12,1,11
28943,Brengier,dun-morogh,96,paladin,retribution,18,1,17
28944,Charlybrown,archimonde,95,paladin,retribution,6,1,5
28945,Mittyswag,kazzak,84,paladin,retribution,15,4,11
28946,Albertina,silvermoon,79,paladin,retribution,5,1,4
28947,Rhauk,dun-modr,79,paladin,retribution,5,1,4
28948,Snobypala,onyxia,64,paladin,retribution,4,1,3
28949,Pastaflwras,twisting-nether,64,paladin,retribution,4,1,3
28950,Чиленикс,soulflayer,63,paladin,retribution,2,2,0
28951,Reliikt,blackrock,48,paladin,retribution,3,1,2
28952,Варкуш,soulflayer,48,paladin,retribution,3,1,2
28953,Lafrogge,culte-de-la-rive-noire,48,paladin,retribution,3,1,2
28954,Leköngen,ravencrest,48,paladin,retribution,3,1,2
28955,Doruk,stormscale,48,paladin,retribution,9,1,8
28956,Bálerion,bronze-dragonflight,42,paladin,retribution,11,3,8
28957,Блейзблю,howling-fjord,42,paladin,retribution,8,2,6
28958,Böserbube,tarren-mill,42,paladin,retribution,13,2,11
28959,Alïstia,archimonde,42,paladin,retribution,16,2,14
28960,Melkmy,laughing-skull,31,paladin,retribution,2,1,1
28961,Hajzlbaba,outland,31,paladin,retribution,2,1,1
28962,Tosuro,sunstrider,31,paladin,retribution,2,1,1
28963,Davidas,drakthul,16,paladin,retribution,1,1,0
28964,Exødius,sinstralis,16,paladin,retribution,1,1,0
28965,Паланр,fordragon,16,paladin,retribution,1,1,0
28966,Bjoorrn,hyjal,16,paladin,retribution,1,1,0
28967,Ornsein,sylvanas,16,paladin,retribution,1,1,0
28968,Arbuzno,draenor,1955,paladin,protection,72,53,19
28969,Leotheron,boulderfist,1758,paladin,protection,233,153,80
28970,Âmba,blackrock,1751,paladin,protection,69,45,24
28971,Sterben,aegwynn,1750,paladin,protection,72,35,37
28972,Sartshield,aerie-peak,1734,paladin,protection,54,34,20
28973,Гниленький,razuvious,1712,paladin,protection,29,20,9
28974,Arkhàn,ravencrest,1694,paladin,protection,47,32,15
28975,Justífiéd,kazzak,1683,paladin,protection,42,20,22
28976,Statscowski,thrall,1678,paladin,protection,37,22,15
28977,Maximumtaste,ravencrest,1662,paladin,protection,30,22,8
28978,Collinnawin,aegwynn,1661,paladin,protection,255,124,131
28979,Tippressure,ravencrest,1630,paladin,protection,40,26,14
28980,Sonnywalkman,twisting-nether,1620,paladin,protection,18,17,1
28981,Timbadin,frostwolf,1608,paladin,protection,47,32,15
28982,Elitest,hyjal,1560,paladin,protection,195,75,120
28983,Schrikii,archimonde,1556,paladin,protection,72,44,28
28984,Bariy,auchindoun,1550,paladin,protection,53,34,19
28985,Phlakorn,blackhand,1525,paladin,protection,48,29,19
28986,Mocnyreka,silvermoon,1503,paladin,protection,65,37,28
28987,Силугор,soulflayer,1498,paladin,protection,48,26,22
28988,Gabubex,tarren-mill,1482,paladin,protection,135,83,52
28989,Supremerage,silvermoon,1474,paladin,protection,80,42,38
28990,Баибар,soulflayer,1460,paladin,protection,120,65,55
28991,Haringoth,argent-dawn,1459,paladin,protection,66,35,31
28992,Uswieconyra,silvermoon,1459,paladin,protection,71,34,37
28993,Ðivine,stormscale,1447,paladin,protection,113,57,56
28994,Vivalabeef,stormscale,1431,paladin,protection,24,15,9
28995,Ðizzmo,bloodfeather,1421,paladin,protection,46,23,23
28996,Galevar,argent-dawn,1416,paladin,protection,134,65,69
28997,Swiatlomiecz,silvermoon,1378,paladin,protection,48,18,30
28998,Youness,ysondre,1371,paladin,protection,162,92,70
28999,Medium,frostwolf,1362,paladin,protection,29,15,14
29000,Хэбит,soulflayer,1343,paladin,protection,42,27,15
29001,Lóu,hyjal,1340,paladin,protection,92,45,47
29002,Vangorn,burning-legion,1334,paladin,protection,58,29,29
29003,Shybia,kirin-tor,1327,paladin,protection,35,19,16
29004,Galadrion,dun-modr,1321,paladin,protection,23,14,9
29005,Helladin,haomarush,1321,paladin,protection,60,24,36
29006,Velkar,frostmane,1310,paladin,protection,124,63,61
29007,Zerhakz,ysondre,1310,paladin,protection,84,41,43
29008,Бранв,gordunni,1305,paladin,protection,54,30,24
29009,Jûstice,kirin-tor,1298,paladin,protection,134,63,71
29010,Gaffel,dethecus,1288,paladin,protection,41,19,22
29011,Leadfoot,argent-dawn,1286,paladin,protection,51,32,19
29012,Trufetteuh,hyjal,1283,paladin,protection,178,90,88
29013,Yunalêsca,mugthol,1283,paladin,protection,131,59,72
29014,Krispce,bloodhoof,1281,paladin,protection,30,17,13
29015,Manupierre,ysondre,1270,paladin,protection,48,22,26
29016,Ragonas,mannoroth,1255,paladin,protection,36,15,21
29017,Milliemaître,elune,1253,paladin,protection,90,41,49
29018,Faranume,sylvanas,1227,paladin,protection,24,16,8
29019,Augroni,antonidas,1227,paladin,protection,117,50,67
29020,Flakkson,stormscale,1206,paladin,protection,131,49,82
29021,Valeriu,stormreaver,1205,paladin,protection,36,14,22
29022,Sutbeyaz,twisting-nether,1201,paladin,protection,20,14,6
29023,Xrules,blackhand,1201,paladin,protection,47,21,26
29024,Ichbin,sanguino,1194,paladin,protection,213,89,124
29025,Celyne,kirin-tor,1180,paladin,protection,36,14,22
29026,Проц,soulflayer,1179,paladin,protection,54,20,34
29027,Neopronouns,minahonda,1144,paladin,protection,18,12,6
29028,Oldsqlmofu,blackrock,1142,paladin,protection,19,12,7
29029,Whiteraven,rexxar,1126,paladin,protection,24,12,12
29030,Rudra,kiljaeden,1086,paladin,protection,29,12,17
29031,Yruqrem,ravencrest,1055,paladin,protection,18,11,7
29032,Шмыгапал,eversong,1049,paladin,protection,26,11,15
29033,Vladium,argent-dawn,1046,paladin,protection,24,11,13
29034,Lotheriem,argent-dawn,992,paladin,protection,42,11,31
29035,Толинель,soulflayer,990,paladin,protection,17,11,6
29036,Savión,silvermoon,957,paladin,protection,12,10,2
29037,Maeltesar,kult-der-verdammten,955,paladin,protection,13,10,3
29038,Dolff,argent-dawn,767,paladin,protection,12,8,4
29039,Thraliss,hyjal,767,paladin,protection,12,8,4
29040,Fumbz,alakir,767,paladin,protection,12,8,4
29041,Tíríón,nethersturm,763,paladin,protection,18,8,10
29042,Lägolas,thrall,701,paladin,protection,17,8,9
29043,Mørfi,antonidas,687,paladin,protection,11,8,3
29044,Kraljevic,silvermoon,672,paladin,protection,12,7,5
29045,Ванябублгам,soulflayer,672,paladin,protection,18,7,11
29046,Figustyle,archimonde,605,paladin,protection,16,7,9
29047,Emistesia,stormscale,576,paladin,protection,6,6,0
29048,Marihuána,ragnaros,576,paladin,protection,18,6,12
29049,Casstiel,anetheron,575,paladin,protection,12,6,6
29050,Ekenpala,kazzak,575,paladin,protection,12,6,6
29051,Exion,ravenholdt,543,paladin,protection,11,6,5
29052,Furiosio,ysondre,543,paladin,protection,15,7,8
29053,Arkera,blackrock,494,paladin,protection,19,6,13
29054,Кельдерик,howling-fjord,480,paladin,protection,6,5,1
29055,Onefrostyboi,defias-brotherhood,479,paladin,protection,12,5,7
29056,Thrinea,blackrock,479,paladin,protection,12,5,7
29057,Такуан,fordragon,479,paladin,protection,12,5,7
29058,Xairios,blackhand,479,paladin,protection,12,5,7
29059,Quantox,frostwolf,478,paladin,protection,24,5,19
29060,Aarrb,sylvanas,438,paladin,protection,27,8,19
29061,Elkka,azjolnerub,415,paladin,protection,17,5,12
29062,Eriellè,kazzak,384,paladin,protection,6,4,2
29063,Æåæxâëæ,dun-modr,384,paladin,protection,6,4,2
29064,Fleshoflight,arathor,384,paladin,protection,6,4,2
29065,Testos,ulduar,384,paladin,protection,6,4,2
29066,Røse,argent-dawn,384,paladin,protection,12,4,8
29067,Palan,cthun,384,paladin,protection,12,4,8
29068,Снайпик,azuregos,384,paladin,protection,12,4,8
29069,Astragore,archimonde,384,paladin,protection,18,4,14
29070,Valädar,sanguino,351,paladin,protection,11,4,7
29071,Дюве,blackscar,351,paladin,protection,11,4,7
29072,Butchertom,ravencrest,330,paladin,protection,11,5,6
29073,Babaluga,blackrock,288,paladin,protection,6,3,3
29074,Рустиктоп,gordunni,288,paladin,protection,6,3,3
29075,Craft,frostwolf,288,paladin,protection,6,3,3
29076,Æero,blackhand,288,paladin,protection,6,3,3
29077,Swäagg,hyjal,288,paladin,protection,6,3,3
29078,Zuplex,deathwing,288,paladin,protection,6,3,3
29079,Aümagad,confrérie-du-thorium,288,paladin,protection,6,3,3
29080,Ponce,los-errantes,288,paladin,protection,12,3,9
29081,Duxbellorum,the-maelstrom,288,paladin,protection,12,3,9
29082,Biffle,korgall,288,paladin,protection,12,3,9
29083,Kawakai,blackrock,287,paladin,protection,12,3,9
29084,Meneth,elune,240,paladin,protection,9,3,6
29085,Yourmomz,kazzak,239,paladin,protection,5,3,2
29086,Emakk,darksorrow,192,paladin,protection,6,2,4
29087,Gornim,die-nachtwache,192,paladin,protection,6,2,4
29088,Slainer,zuljin,192,paladin,protection,6,2,4
29089,Derina,silvermoon,192,paladin,protection,6,2,4
29090,Синерина,blackscar,192,paladin,protection,6,2,4
29091,Khrak,conseil-des-ombres,192,paladin,protection,12,2,10
29092,Palacaplaca,cthun,175,paladin,protection,11,2,9
29093,Soxsnort,twisting-nether,159,paladin,protection,5,2,3
29094,Taptreus,antonidas,96,paladin,protection,6,1,5
29095,Чиксапомойка,gordunni,96,paladin,protection,6,1,5
29096,Thôrwald,les-sentinelles,96,paladin,protection,12,1,11
29097,Lokinder,pozzo-delleternità,96,paladin,protection,12,1,11
29098,Bobilous,twisting-nether,79,paladin,protection,5,1,4
29099,Солошафл,howling-fjord,42,paladin,protection,12,4,8
29100,Candrä,archimonde,2213,priest,holy,96,52,44
29101,Køzukï,ravencrest,2167,priest,holy,275,144,131
29102,Itsmeminglee,ravencrest,2143,priest,holy,132,68,64
29103,Lmnsqzy,ravencrest,2050,priest,holy,124,65,59
29104,Yötönyö,ravencrest,2043,priest,holy,60,32,28
29105,Leadeur,kazzak,2039,priest,holy,247,124,123
29106,Кальвейт,deathweaver,2020,priest,holy,181,92,89
29107,Ladá,stormscale,1993,priest,holy,180,96,84
29108,Cosines,ravencrest,1970,priest,holy,113,61,52
29109,Výra,der-rat-von-dalaran,1939,priest,holy,71,46,25
29110,Шотыказау,blackscar,1919,priest,holy,141,74,67
29111,Tangent,ravencrest,1909,priest,holy,224,121,103
29112,Boonlai,ravencrest,1897,priest,holy,47,25,22
29113,Grafius,stormscale,1885,priest,holy,48,26,22
29114,Carlitastock,eredar,1885,priest,holy,53,28,25
29115,Tmnstrtw,alakir,1879,priest,holy,126,63,63
29116,Testdeath,ravencrest,1875,priest,holy,54,31,23
29117,Zuniya,tarren-mill,1868,priest,holy,60,30,30
29118,Fleischesser,ravencrest,1862,priest,holy,62,33,29
29119,Lenyp,sanguino,1862,priest,holy,150,75,75
29120,Beatrixz,twisting-nether,1852,priest,holy,384,199,185
29121,Weezing,ysondre,1851,priest,holy,132,66,66
29122,Rippertmepls,ravencrest,1850,priest,holy,124,73,51
29123,Servêy,twisting-nether,1845,priest,holy,42,22,20
29124,Finizkram,sylvanas,1840,priest,holy,48,25,23
29125,Dmnz,blackrock,1836,priest,holy,87,39,48
29126,Kaiikoo,ravencrest,1824,priest,holy,54,31,23
29127,Yateh,blackmoore,1824,priest,holy,62,32,30
29128,Катккат,soulflayer,1823,priest,holy,48,27,21
29129,Лоаресс,gordunni,1820,priest,holy,90,40,50
29130,Ancientalien,khadgar,1817,priest,holy,66,29,37
29131,Sayne,arathor,1815,priest,holy,168,91,77
29132,Maruh,malganis,1812,priest,holy,113,60,53
29133,Dmnz,antonidas,1811,priest,holy,40,22,18
29134,Eriónd,ravencrest,1811,priest,holy,66,34,32
29135,Muchos,blackrock,1811,priest,holy,132,61,71
29136,Kaalu,frostmane,1809,priest,holy,254,131,123
29137,Мамкалол,soulflayer,1807,priest,holy,132,69,63
29138,Lîrana,ravencrest,1803,priest,holy,136,82,54
29139,Teatime,aegwynn,1800,priest,holy,84,42,42
29140,Kunen,sanguino,1789,priest,holy,138,77,61
29141,Psi,hakkar,1789,priest,holy,301,165,136
29142,Друмги,gordunni,1787,priest,holy,173,80,93
29143,Yhoundey,blackrock,1780,priest,holy,54,27,27
29144,Imbitterx,stormscale,1777,priest,holy,30,21,9
29145,Stanyú,tarren-mill,1770,priest,holy,48,21,27
29146,Bigwik,tarren-mill,1764,priest,holy,77,36,41
29147,Servey,twisting-nether,1764,priest,holy,48,20,28
29148,Basilette,hyjal,1761,priest,holy,48,27,21
29149,Holyholy,stormscale,1761,priest,holy,62,24,38
29150,Weezïng,ysondre,1742,priest,holy,108,60,48
29151,Siign,ravencrest,1740,priest,holy,72,32,40
29152,Harmónia,outland,1739,priest,holy,187,99,88
29153,Møhammed,wrathbringer,1734,priest,holy,341,171,170
29154,Calithria,kazzak,1731,priest,holy,196,107,89
29155,Sàweetie,archimonde,1721,priest,holy,54,27,27
29156,Myste,nemesis,1715,priest,holy,91,48,43
29157,Peisetti,stormscale,1712,priest,holy,48,24,24
29158,Wåtrux,alakir,1711,priest,holy,411,218,193
29159,Jim,saurfang,1711,priest,holy,257,127,130
29160,Anníng,tarren-mill,1708,priest,holy,186,108,78
29161,Thelunara,sanguino,1703,priest,holy,77,37,40
29162,Pigdestroyin,frostmane,1701,priest,holy,66,38,28
29163,Dolens,argent-dawn,1699,priest,holy,112,55,57
29164,Sisko,stormscale,1699,priest,holy,66,32,34
29165,Jâde,bloodhoof,1690,priest,holy,132,75,57
29166,Shizzlol,silvermoon,1684,priest,holy,366,177,189
29167,Meanbabe,argent-dawn,1683,priest,holy,48,22,26
29168,Ilenna,dun-morogh,1682,priest,holy,78,46,32
29169,Phobò,blackrock,1678,priest,holy,89,42,47
29170,Gladíator,blackhand,1677,priest,holy,102,58,44
29171,Гоплзнекст,gordunni,1676,priest,holy,372,187,185
29172,Gokumødex,outland,1676,priest,holy,54,24,30
29173,Каткааткат,soulflayer,1674,priest,holy,48,23,25
29174,Alpháømegá,outland,1671,priest,holy,99,51,48
29175,Kÿokó,ravencrest,1670,priest,holy,72,40,32
29176,Limeslayerx,veklor,1668,priest,holy,48,35,13
29177,Stickpas,ysondre,1661,priest,holy,41,18,23
29178,Fízwow,stormscale,1659,priest,holy,88,38,50
29179,Jiffie,twisting-nether,1655,priest,holy,54,23,31
29180,Oide,area-52,1653,priest,holy,54,28,26
29181,Simpadisco,ravencrest,1649,priest,holy,48,24,24
29182,Câlyr,ragnaros,1647,priest,holy,48,21,27
29183,Sausageboy,tarren-mill,1640,priest,holy,123,54,69
29184,Dogshtpriest,ravencrest,1639,priest,holy,68,39,29
29185,Gøkumodex,tarren-mill,1639,priest,holy,46,22,24
29186,Løøney,kazzak,1638,priest,holy,48,30,18
29187,Xianxia,twisting-nether,1636,priest,holy,154,77,77
29188,Эльдиремонт,gordunni,1631,priest,holy,124,56,68
29189,Инзора,gordunni,1624,priest,holy,135,74,61
29190,Budgetdp,archimonde,1622,priest,holy,90,39,51
29191,Dranbor,argent-dawn,1619,priest,holy,166,87,79
29192,Malaki,ysondre,1618,priest,holy,62,34,28
29193,Ksn,silvermoon,1618,priest,holy,110,58,52
29194,Gnomemonk,stormscale,1618,priest,holy,150,74,76
29195,Eleutheria,grim-batol,1618,priest,holy,57,27,30
29196,Adare,sanguino,1618,priest,holy,48,22,26
29197,Xxmybaxxo,archimonde,1617,priest,holy,30,21,9
29198,Alchemïst,ravencrest,1617,priest,holy,46,21,25
29199,Smïlë,ravencrest,1616,priest,holy,204,102,102
29200,Coolwnbnamex,ravencrest,1614,priest,holy,36,19,17
29201,Affro,drakthul,1613,priest,holy,54,27,27
29202,Shanya,thrall,1613,priest,holy,257,127,130
29203,Sïxsïxsïx,ravencrest,1613,priest,holy,43,21,22
29204,Нубстрим,gordunni,1611,priest,holy,60,28,32
29205,Bzzdontplay,ravencrest,1610,priest,holy,42,20,22
29206,Alizeé,nazjatar,1609,priest,holy,179,100,79
29207,Ysalute,sylvanas,1608,priest,holy,33,18,15
29208,Ghettothug,darksorrow,1608,priest,holy,66,28,38
29209,Salvatíon,sanguino,1607,priest,holy,106,46,60
29210,Prëdz,stormscale,1606,priest,holy,238,129,109
29211,Anabananaa,ravencrest,1604,priest,holy,88,50,38
29212,Найтингеилл,gordunni,1604,priest,holy,36,17,19
29213,Eox,kazzak,1602,priest,holy,42,23,19
29214,Joeasaurs,ragnaros,1602,priest,holy,106,51,55
29215,Zxø,ravencrest,1601,priest,holy,160,88,72
29216,Camina,shattered-hand,1601,priest,holy,135,74,61
29217,Cleoana,blackhand,1600,priest,holy,42,23,19
29218,Çhéåtçødé,ravencrest,1594,priest,holy,72,33,39
29219,Anaqt,silvermoon,1593,priest,holy,101,56,45
29220,Aykò,blackmoore,1588,priest,holy,90,42,48
29221,Dairox,blackrock,1584,priest,holy,143,77,66
29222,Hiimgreen,blackhand,1580,priest,holy,126,62,64
29223,Dìsclol,draenor,1576,priest,holy,75,40,35
29224,Goytka,tarren-mill,1576,priest,holy,66,31,35
29225,Преттисмайл,gordunni,1576,priest,holy,193,89,104
29226,Dény,ravencrest,1573,priest,holy,102,56,46
29227,Icybae,archimonde,1572,priest,holy,48,34,14
29228,Xzklol,twisting-nether,1572,priest,holy,62,31,31
29229,Cølï,ravencrest,1572,priest,holy,55,25,30
29230,Highn,anetheron,1570,priest,holy,60,33,27
29231,Gratcrug,stormrage,1570,priest,holy,48,26,22
29232,Goofdookie,outland,1563,priest,holy,36,20,16
29233,Overdosedtw,die-aldor,1561,priest,holy,36,24,12
29234,Xïâ,hyjal,1561,priest,holy,42,19,23
29235,Nastylex,magtheridon,1559,priest,holy,36,21,15
29236,Elmaestrø,aegwynn,1558,priest,holy,48,25,23
29237,Phobò,antonidas,1545,priest,holy,170,79,91
29238,Senkín,aegwynn,1542,priest,holy,161,78,83
29239,Isadriel,madmortem,1541,priest,holy,52,31,21
29240,Èlysium,grim-batol,1540,priest,holy,48,28,20
29241,Evabae,the-maelstrom,1537,priest,holy,54,29,25
29242,Hyonra,kazzak,1536,priest,holy,66,34,32
29243,Vregoa,twisting-nether,1532,priest,holy,36,17,19
29244,Aethanira,ravencrest,1532,priest,holy,60,27,33
29245,Seeyae,archimonde,1528,priest,holy,36,17,19
29246,Xzklolz,twisting-nether,1527,priest,holy,59,28,31
29247,Kubbarn,stormscale,1526,priest,holy,208,116,92
29248,Koíré,defias-brotherhood,1523,priest,holy,321,166,155
29249,Zellita,ravencrest,1522,priest,holy,60,26,34
29250,Sehlia,kazzak,1520,priest,holy,211,108,103
29251,Divinetouch,ravencrest,1516,priest,holy,78,35,43
29252,Кодис,gordunni,1515,priest,holy,18,16,2
29253,Dokkaebì,kazzak,1514,priest,holy,135,67,68
29254,Mylini,silvermoon,1510,priest,holy,204,116,88
29255,Eddíémorphin,kazzak,1509,priest,holy,30,16,14
29256,Cartøøns,ravencrest,1506,priest,holy,66,39,27
29257,Thalane,das-konsortium,1504,priest,holy,48,23,25
29258,Wilby,archimonde,1503,priest,holy,48,21,27
29259,Kotipope,silvermoon,1502,priest,holy,74,38,36
29260,Voodoo,the-maelstrom,1502,priest,holy,108,46,62
29261,Fjonnski,blackmoore,1500,priest,holy,61,33,28
29262,Usw,outland,1496,priest,holy,69,23,46
29263,Заволончик,blackscar,1494,priest,holy,102,48,54
29264,Malkàv,hyjal,1493,priest,holy,54,28,26
29265,Краббожий,greymane,1493,priest,holy,53,22,31
29266,Draster,blackrock,1490,priest,holy,53,28,25
29267,Rines,thrall,1488,priest,holy,183,92,91
29268,Stinkydog,kazzak,1481,priest,holy,328,162,166
29269,Justheal,stormscale,1481,priest,holy,54,23,31
29270,Gigotdagneau,dalaran,1479,priest,holy,41,16,25
29271,Karpiest,stormscale,1476,priest,holy,113,61,52
29272,Zlejkadlec,drakthul,1476,priest,holy,93,47,46
29273,Эилинг,gordunni,1474,priest,holy,192,105,87
29274,Sïlvëräzz,drekthar,1472,priest,holy,53,25,28
29275,Xnda,ravencrest,1472,priest,holy,36,16,20
29276,Maah,defias-brotherhood,1471,priest,holy,80,46,34
29277,Fatherliam,emerald-dream,1469,priest,holy,54,24,30
29278,Symbolofhope,ravencrest,1465,priest,holy,201,105,96
29279,Sixtyseven,blackhand,1464,priest,holy,78,39,39
29280,Ilkar,archimonde,1461,priest,holy,60,29,31
29281,Isilros,dalaran,1460,priest,holy,46,25,21
29282,Liquoriced,tarren-mill,1460,priest,holy,43,23,20
29283,Suxino,stormscale,1455,priest,holy,185,94,91
29284,Пингзеро,soulflayer,1454,priest,holy,190,95,95
29285,Mcdeady,tarren-mill,1454,priest,holy,42,19,23
29286,Snåttabaias,stormscale,1451,priest,holy,35,19,16
29287,Bubbleup,defias-brotherhood,1449,priest,holy,125,70,55
29288,Mezegis,draenor,1449,priest,holy,48,26,22
29289,Angrk,kazzak,1441,priest,holy,84,51,33
29290,Jaisuu,ravencrest,1439,priest,holy,30,15,15
29291,Sqwabblepee,stormscale,1438,priest,holy,53,27,26
29292,Lylska,stormreaver,1437,priest,holy,36,15,21
29293,Slakkieslak,archimonde,1435,priest,holy,67,39,28
29294,Momopriesto,draenor,1435,priest,holy,47,20,27
29295,Иссатея,galakrond,1434,priest,holy,48,23,25
29296,Maerlene,nemesis,1433,priest,holy,54,31,23
29297,Hyonzy,silvermoon,1433,priest,holy,159,84,75
29298,Hoeneygodx,antonidas,1432,priest,holy,36,16,20
29299,Tavra,stormscale,1428,priest,holy,48,20,28
29300,Jinxa,draenor,1428,priest,holy,42,15,27
29301,Ptiteminette,archimonde,1426,priest,holy,32,17,15
29302,Fizzlesp,tarren-mill,1425,priest,holy,30,15,15
29303,Alphacub,ragnaros,1425,priest,holy,82,36,46
29304,Алеброн,gordunni,1421,priest,holy,36,19,17
29305,Caihla,silvermoon,1421,priest,holy,30,15,15
29306,Fabs,laughing-skull,1419,priest,holy,61,39,22
29307,Lómesilme,dun-modr,1419,priest,holy,217,112,105
29308,Bilbobanging,aggramar,1419,priest,holy,30,15,15
29309,Kbakå,kazzak,1419,priest,holy,78,37,41
29310,Pleistex,sylvanas,1418,priest,holy,30,16,14
29311,Lädi,ravencrest,1416,priest,holy,96,53,43
29312,Virginmaris,sanguino,1415,priest,holy,113,64,49
29313,Penvon,ravencrest,1415,priest,holy,66,22,44
29314,Markianos,silvermoon,1412,priest,holy,114,58,56
29315,Ankî,aegwynn,1411,priest,holy,30,15,15
29316,Hmanco,burning-legion,1408,priest,holy,263,140,123
29317,Мектран,gordunni,1408,priest,holy,54,27,27
29318,Hara,elune,1407,priest,holy,47,20,27
29319,Bifs,blackmoore,1405,priest,holy,50,32,18
29320,Scartay,outland,1405,priest,holy,29,15,14
29321,Blacklemons,thrall,1403,priest,holy,48,26,22
29322,Scrxppe,twisting-nether,1402,priest,holy,42,26,16
29323,Вакидзачи,gordunni,1402,priest,holy,209,105,104
29324,Swd,burning-blade,1400,priest,holy,34,15,19
29325,Neoark,archimonde,1397,priest,holy,164,83,81
29326,Certe,twisting-nether,1396,priest,holy,133,66,67
29327,Elessee,the-maelstrom,1395,priest,holy,83,38,45
29328,Rägà,archimonde,1388,priest,holy,85,46,39
29329,Womanwonderf,ravencrest,1388,priest,holy,65,31,34
29330,Penitence,drekthar,1385,priest,holy,44,18,26
29331,Cøvu,draenor,1378,priest,holy,94,41,53
29332,Insaner,ahnqiraj,1374,priest,holy,45,19,26
29333,Seladine,ravencrest,1373,priest,holy,152,77,75
29334,Veurjin,uldaman,1373,priest,holy,53,25,28
29335,Madcole,blackhand,1371,priest,holy,85,43,42
29336,Mianxpriest,tarren-mill,1370,priest,holy,36,17,19
29337,Konstigadan,twisting-nether,1369,priest,holy,56,26,30
29338,Góldfinger,norgannon,1365,priest,holy,181,85,96
29339,Phénylanine,khaz-modan,1364,priest,holy,278,141,137
29340,Nomakprst,sanguino,1362,priest,holy,60,31,29
29341,Xytael,burning-legion,1360,priest,holy,96,49,47
29342,Elunos,blackrock,1358,priest,holy,130,65,65
29343,Tëmärï,ravencrest,1356,priest,holy,72,46,26
29344,Возхд,soulflayer,1356,priest,holy,48,27,21
29345,Zorea,twisting-nether,1356,priest,holy,153,76,77
29346,Davìna,sunstrider,1354,priest,holy,73,36,37
29347,Ebolaidman,ravencrest,1353,priest,holy,24,15,9
29348,Tyene,voljin,1351,priest,holy,107,59,48
29349,Owait,tarren-mill,1351,priest,holy,36,17,19
29350,Judâspriest,twisting-nether,1351,priest,holy,72,33,39
29351,Delphina,archimonde,1350,priest,holy,225,118,107
29352,Juco,draenor,1348,priest,holy,54,24,30
29353,Pridepriest,twisting-nether,1346,priest,holy,84,42,42
29354,Prencø,sanguino,1345,priest,holy,34,16,18
29355,Bierbändiger,blackhand,1345,priest,holy,120,56,64
29356,Chibrausorus,archimonde,1344,priest,holy,118,61,57
29357,Blazekk,sylvanas,1343,priest,holy,54,19,35
29358,Moirgana,minahonda,1340,priest,holy,43,21,22
29359,Skíps,sylvanas,1339,priest,holy,34,18,16
29360,Daftî,twisting-nether,1339,priest,holy,36,18,18
29361,Hydraximus,garrosh,1337,priest,holy,648,320,328
29362,Nálá,nethersturm,1335,priest,holy,115,59,56
29363,Nino,gorgonnash,1335,priest,holy,66,30,36
29364,Tyrhaa,blackmoore,1334,priest,holy,163,81,82
29365,Ангеланика,gordunni,1330,priest,holy,29,18,11
29366,Fedorah,ragnaros,1330,priest,holy,114,63,51
29367,Orcid,chogall,1327,priest,holy,146,75,71
29368,Alú,draenor,1327,priest,holy,153,73,80
29369,Luxtrii,blackrock,1326,priest,holy,48,20,28
29370,Рилия,howling-fjord,1324,priest,holy,30,14,16
29371,Libetha,ysondre,1323,priest,holy,41,23,18
29372,Migam,kazzak,1321,priest,holy,66,30,36
29373,Велост,gordunni,1319,priest,holy,60,31,29
29374,Jaz,ysondre,1319,priest,holy,58,29,29
29375,Bobitä,ravencrest,1318,priest,holy,30,15,15
29376,Byzzi,draenor,1318,priest,holy,215,107,108
29377,Hereticroka,ysondre,1318,priest,holy,80,35,45
29378,Alros,elune,1315,priest,holy,60,28,32
29379,Lasuora,nemesis,1315,priest,holy,60,26,34
29380,Aïmée,ravencrest,1313,priest,holy,55,26,29
29381,Cherron,argent-dawn,1305,priest,holy,61,27,34
29382,Lupinx,terokkar,1304,priest,holy,24,14,10
29383,Stàrlîght,chants-éternels,1300,priest,holy,30,17,13
29384,Eazzyy,kazzak,1299,priest,holy,51,25,26
29385,Eurydike,blackrock,1297,priest,holy,64,37,27
29386,Åluneth,kazzak,1297,priest,holy,162,80,82
29387,Emipriest,tarren-mill,1297,priest,holy,133,63,70
29388,Маракеда,soulflayer,1295,priest,holy,41,18,23
29389,Pasqualz,ravencrest,1290,priest,holy,83,39,44
29390,Lazheal,khaz-modan,1288,priest,holy,78,44,34
29391,Hølýðéåthjçç,tarren-mill,1285,priest,holy,41,21,20
29392,Mashimaro,blackhand,1285,priest,holy,41,21,20
29393,Sodatsu,cthun,1284,priest,holy,30,15,15
29394,Midycine,ysondre,1282,priest,holy,199,98,101
29395,Papadrak,kazzak,1278,priest,holy,83,43,40
29396,Síuu,kazzak,1277,priest,holy,72,35,37
29397,Tomassur,drakthul,1276,priest,holy,103,52,51
29398,Draconux,terenas,1273,priest,holy,54,21,33
29399,Wintercurse,twisting-nether,1272,priest,holy,52,24,28
29400,Djdesha,tarren-mill,1272,priest,holy,35,16,19
29401,Zakhun,stormrage,1271,priest,holy,82,42,40
29402,Asare,outland,1269,priest,holy,124,66,58
29403,Ezechiel,twisting-nether,1267,priest,holy,53,28,25
29404,Ethery,argent-dawn,1266,priest,holy,65,33,32
29405,Lykarion,argent-dawn,1265,priest,holy,72,37,35
29406,Elynä,silvermoon,1261,priest,holy,70,44,26
29407,Tudiiheals,frostwolf,1261,priest,holy,91,48,43
29408,Vickepriest,stormreaver,1260,priest,holy,48,23,25
29409,Dôppler,archimonde,1256,priest,holy,23,14,9
29410,Yuhé,elune,1256,priest,holy,26,14,12
29411,Nosgot,earthen-ring,1251,priest,holy,66,32,34
29412,Sohryø,drekthar,1249,priest,holy,48,28,20
29413,Soapie,defias-brotherhood,1249,priest,holy,24,14,10
29414,Zên,argent-dawn,1248,priest,holy,21,14,7
29415,Ayess,aegwynn,1248,priest,holy,47,24,23
29416,Avelynn,ravencrest,1248,priest,holy,85,38,47
29417,Misscure,draenor,1247,priest,holy,130,59,71
29418,Maybelline,ravencrest,1245,priest,holy,48,23,25
29419,Catstretch,ravencrest,1243,priest,holy,95,39,56
29420,Boomixed,twisting-nether,1242,priest,holy,24,13,11
29421,Shanny,kazzak,1239,priest,holy,24,13,11
29422,Badguymike,ragnaros,1239,priest,holy,24,13,11
29423,Бенигана,soulflayer,1239,priest,holy,48,25,23
29424,Rozå,argent-dawn,1238,priest,holy,18,13,5
29425,Fareeya,thrall,1235,priest,holy,30,15,15
29426,Åzjol,magtheridon,1235,priest,holy,30,13,17
29427,Nerfnerf,kazzak,1232,priest,holy,51,27,24
29428,Holydolly,doomhammer,1229,priest,holy,48,27,21
29429,Dazé,ravencrest,1219,priest,holy,72,39,33
29430,Sapphos,ravencrest,1216,priest,holy,47,23,24
29431,Neenä,ravencrest,1214,priest,holy,50,25,25
29432,Dúréx,sanguino,1212,priest,holy,42,28,14
29433,Speltmor,stormscale,1211,priest,holy,30,13,17
29434,Atiyesh,arthas,1210,priest,holy,219,116,103
29435,Sak,uldaman,1206,priest,holy,94,38,56
29436,Omnissiiah,silvermoon,1203,priest,holy,30,13,17
29437,Prästera,draenor,1202,priest,holy,24,13,11
29438,Хилтихон,howling-fjord,1200,priest,holy,42,26,16
29439,Dathlight,argent-dawn,1200,priest,holy,113,57,56
29440,Скартэикс,howling-fjord,1200,priest,holy,42,20,22
29441,Elián,silvermoon,1198,priest,holy,30,15,15
29442,Testdeex,ravencrest,1197,priest,holy,23,13,10
29443,Иннерон,soulflayer,1197,priest,holy,233,116,117
29444,Kbakå,stormscale,1193,priest,holy,65,27,38
29445,Benificent,argent-dawn,1192,priest,holy,76,38,38
29446,Angelsdust,ravencrest,1190,priest,holy,34,14,20
29447,Lhyria,baelgun,1189,priest,holy,48,21,27
29448,Ripjuice,sylvanas,1186,priest,holy,84,44,40
29449,Gummi,blackhand,1183,priest,holy,66,25,41
29450,Холимыша,blackscar,1182,priest,holy,63,32,31
29451,Nakali,the-maelstrom,1182,priest,holy,42,15,27
29452,Карнотит,howling-fjord,1182,priest,holy,48,16,32
29453,Avtarra,ravencrest,1181,priest,holy,70,34,36
29454,Хасгерион,gordunni,1180,priest,holy,66,27,39
29455,Крайл,blackscar,1180,priest,holy,93,27,66
29456,Morrydin,stormreaver,1177,priest,holy,78,31,47
29457,Nykah,antonidas,1177,priest,holy,73,26,47
29458,Ниеса,lich-king,1174,priest,holy,110,52,58
29459,Jarnary,blackmoore,1171,priest,holy,75,33,42
29460,Голнар,deathguard,1168,priest,holy,32,15,17
29461,Torcena,garrosh,1166,priest,holy,141,70,71
29462,Meatyshaft,doomhammer,1166,priest,holy,51,19,32
29463,Killtrew,ravencrest,1165,priest,holy,39,13,26
29464,Gloxina,argent-dawn,1160,priest,holy,96,43,53
29465,Nemista,hyjal,1160,priest,holy,70,26,44
29466,Voreno,alonsus,1160,priest,holy,59,21,38
29467,Lyla,frostwolf,1149,priest,holy,48,27,21
29468,Willxzz,silvermoon,1149,priest,holy,30,12,18
29469,Tansk,stormscale,1147,priest,holy,24,12,12
29470,Kiånå,teldrassil,1142,priest,holy,125,51,74
29471,Zrada,dalaran,1138,priest,holy,24,12,12
29472,Morphuz,tarren-mill,1137,priest,holy,144,66,78
29473,Асггард,borean-tundra,1134,priest,holy,39,25,14
29474,Rastafaja,doomhammer,1133,priest,holy,83,34,49
29475,Andreel,ravencrest,1131,priest,holy,24,12,12
29476,Elëkträ,dalaran,1131,priest,holy,24,12,12
29477,Ròka,ysondre,1131,priest,holy,36,12,24
29478,Cazzîe,eredar,1129,priest,holy,18,12,6
29479,Kímbérléy,argent-dawn,1128,priest,holy,93,49,44
29480,Meowcakes,stormscale,1127,priest,holy,54,30,24
29481,Nou,aegwynn,1127,priest,holy,30,12,18
29482,Nicksiz,silvermoon,1126,priest,holy,34,13,21
29483,Sücre,dalaran,1125,priest,holy,30,16,14
29484,Quatorze,voljin,1124,priest,holy,34,19,15
29485,Tákú,blackmoore,1118,priest,holy,92,45,47
29486,Like,frostwolf,1114,priest,holy,24,12,12
29487,Vitae,gorgonnash,1113,priest,holy,26,13,13
29488,Mundwerk,malganis,1107,priest,holy,60,22,38
29489,Crimatoriá,rajaxx,1105,priest,holy,66,36,30
29490,Copperplume,ravenholdt,1104,priest,holy,132,58,74
29491,Dotterin,draenor,1102,priest,holy,24,12,12
29492,Anàriel,elune,1100,priest,holy,42,16,26
29493,Balin,veklor,1096,priest,holy,27,12,15
29494,Shaniqua,saurfang,1093,priest,holy,104,53,51
29495,Holypowér,twisting-nether,1088,priest,holy,30,17,13
29496,Ломаюключики,gordunni,1081,priest,holy,45,22,23
29497,Pryna,dunemaul,1076,priest,holy,30,12,18
29498,Deeforce,argent-dawn,1072,priest,holy,97,53,44
29499,Larisä,uldum,1067,priest,holy,75,28,47
29500,Xxanthos,ysondre,1058,priest,holy,169,92,77
29501,Ludriel,turalyon,1056,priest,holy,54,26,28
29502,Zen,talnivarr,1056,priest,holy,24,11,13
29503,Seanoob,turalyon,1055,priest,holy,18,11,7
29504,Миррен,gordunni,1055,priest,holy,18,11,7
29505,Луилэнс,howling-fjord,1055,priest,holy,18,11,7
29506,Narwarion,die-aldor,1055,priest,holy,60,28,32
29507,Pandakhlys,ysondre,1055,priest,holy,24,11,13
29508,Штанга,blackscar,1055,priest,holy,29,12,17
29509,Cãlyr,ragnaros,1055,priest,holy,30,11,19
29510,Hotforus,silvermoon,1054,priest,holy,18,11,7
29511,Laewen,die-aldor,1054,priest,holy,45,22,23
29512,Рейеан,soulflayer,1054,priest,holy,24,11,13
29513,Rehnstek,wildhammer,1054,priest,holy,30,11,19
29514,Uro,tirion,1053,priest,holy,30,11,19
29515,Elinaa,die-aldor,1050,priest,holy,24,11,13
29516,Тевтонка,goldrinn,1047,priest,holy,62,28,34
29517,Ageo,sanguino,1046,priest,holy,18,11,7
29518,Letmehêal,archimonde,1043,priest,holy,30,11,19
29519,Harlemsfnest,blackrock,1042,priest,holy,24,13,11
29520,Applecrumßle,ragnaros,1032,priest,holy,47,25,22
29521,Leyea,kazzak,1029,priest,holy,49,24,25
29522,Naieli,antonidas,1028,priest,holy,56,28,28
29523,Nathamo,archimonde,1028,priest,holy,24,11,13
29524,Haregnor,gorgonnash,1028,priest,holy,42,16,26
29525,Baabaak,frostmane,1026,priest,holy,57,34,23
29526,Kæos,blackrock,1026,priest,holy,78,32,46
29527,Valdos,hyjal,1026,priest,holy,48,16,32
29528,Orcü,tarren-mill,1021,priest,holy,60,27,33
29529,Touddixz,blackrock,1020,priest,holy,32,12,20
29530,Sickheals,doomhammer,1018,priest,holy,62,35,27
29531,Brigied,turalyon,1018,priest,holy,99,43,56
29532,Ankhepope,outland,1013,priest,holy,56,33,23
29533,Lobogaust,kargath,1012,priest,holy,60,32,28
29534,Bowie,frostwhisper,1012,priest,holy,36,11,25
29535,Asraje,eredar,1007,priest,holy,21,16,5
29536,Türapea,draenor,1006,priest,holy,36,17,19
29537,Dampfwalze,nozdormu,1002,priest,holy,38,19,19
29538,Zerula,outland,990,priest,holy,42,21,21
29539,Covidios,twisting-nether,990,priest,holy,93,43,50
29540,Hipnotika,nemesis,988,priest,holy,53,18,35
29541,Valtessian,medivh,983,priest,holy,69,33,36
29542,Siarai,pozzo-delleternità,964,priest,holy,43,21,22
29543,Maxý,ravencrest,963,priest,holy,42,18,24
29544,Sâtânica,kelthuzad,963,priest,holy,122,51,71
29545,Yamai,thrall,960,priest,holy,24,10,14
29546,Десемин,deathguard,960,priest,holy,47,18,29
29547,Mcmuffin,runetotem,959,priest,holy,21,13,8
29548,Dqt,ragnaros,959,priest,holy,18,10,8
29549,Padisonpain,blackmoore,959,priest,holy,18,10,8
29550,Ksn,argent-dawn,959,priest,holy,24,10,14
29551,Xlhealscptn,arathor,959,priest,holy,60,19,41
29552,Cånniekekw,tarren-mill,958,priest,holy,18,10,8
29553,Mesticore,nethersturm,958,priest,holy,24,10,14
29554,Lenneyqt,blackmoore,958,priest,holy,24,10,14
29555,Bigpinkballs,tarren-mill,956,priest,holy,12,10,2
29556,Byebee,stormscale,956,priest,holy,12,10,2
29557,Melodyn,silvermoon,956,priest,holy,24,10,14
29558,Rennic,stormscale,955,priest,holy,18,10,8
29559,Melancholly,thunderhorn,951,priest,holy,41,19,22
29560,Aureï,khaz-modan,938,priest,holy,24,10,14
29561,Fatherted,nagrand,926,priest,holy,36,10,26
29562,Discxqt,ysondre,924,priest,holy,14,11,3
29563,Protegee,draenor,922,priest,holy,69,23,46
29564,Archangel,terokkar,916,priest,holy,60,30,30
29565,Авэнсис,howling-fjord,913,priest,holy,36,14,22
29566,Thingsy,draenor,912,priest,holy,59,27,32
29567,Infinitiy,sylvanas,905,priest,holy,36,18,18
29568,Zêlestia,antonidas,905,priest,holy,22,11,11
29569,Ламедрис,gordunni,904,priest,holy,41,10,31
29570,Rahela,dun-modr,897,priest,holy,23,11,12
29571,Sîanah,archimonde,886,priest,holy,28,11,17
29572,Hegêan,argent-dawn,880,priest,holy,53,22,31
29573,Сказочки,gordunni,864,priest,holy,18,9,9
29574,Rhæveth,ravencrest,864,priest,holy,18,9,9
29575,Âlolexx,archimonde,863,priest,holy,12,9,3
29576,Wèèzing,ysondre,863,priest,holy,12,9,3
29577,Azeeza,stormscale,863,priest,holy,12,9,3
29578,Fomstable,outland,862,priest,holy,12,9,3
29579,Kalkudis,blackmoore,862,priest,holy,18,9,9
29580,Swdjack,blackrock,862,priest,holy,24,9,15
29581,Pprxd,ysondre,862,priest,holy,24,9,15
29582,Faelvirin,aegwynn,861,priest,holy,18,9,9
29583,Hodza,frostmane,861,priest,holy,41,19,22
29584,Kaleycuoco,blackhand,860,priest,holy,18,9,9
29585,Hwren,auchindoun,860,priest,holy,18,9,9
29586,Marey,blackmoore,860,priest,holy,24,9,15
29587,Athissa,draenor,857,priest,holy,18,9,9
29588,Ayahuascarli,ravencrest,847,priest,holy,17,9,8
29589,Xal,drekthar,839,priest,holy,76,27,49
29590,Beatla,khaz-modan,833,priest,holy,24,9,15
29591,Kanki,haomarush,828,priest,holy,60,25,35
29592,Eglantinna,ravencrest,809,priest,holy,14,10,4
29593,Gertie,blackhand,807,priest,holy,28,9,19
29594,Nokizzle,antonidas,795,priest,holy,14,9,5
29595,Zongiz,azjolnerub,786,priest,holy,22,9,13
29596,Methmakka,kazzak,778,priest,holy,19,10,9
29597,Vyrá,der-rat-von-dalaran,768,priest,holy,12,8,4
29598,Evílz,tarren-mill,768,priest,holy,12,8,4
29599,Flyffi,tarren-mill,768,priest,holy,12,8,4
29600,Dès,ravencrest,768,priest,holy,12,8,4
29601,Dotzey,outland,768,priest,holy,12,8,4
29602,Ltmp,ravencrest,768,priest,holy,18,8,10
29603,Suili,twisting-nether,768,priest,holy,18,8,10
29604,Heilop,kazzak,768,priest,holy,23,8,15
29605,Ÿolo,nemesis,768,priest,holy,24,8,16
29606,Маквиэлла,howling-fjord,767,priest,holy,12,8,4
29607,Drunkshufler,stormscale,767,priest,holy,12,8,4
29608,Weedony,hyjal,766,priest,holy,18,8,10
29609,Knóld,draenor,766,priest,holy,24,8,16
29610,Krilight,sargeras,765,priest,holy,24,8,16
29611,Ахмох,gordunni,763,priest,holy,18,8,10
29612,Melissasky,ragnaros,760,priest,holy,60,22,38
29613,Båbak,frostmane,759,priest,holy,12,8,4
29614,Fratio,krasus,758,priest,holy,18,8,10
29615,Avinci,blackrock,757,priest,holy,18,8,10
29616,Nakkenils,tarren-mill,751,priest,holy,17,8,9
29617,Besmrtna,saurfang,749,priest,holy,23,8,15
29618,Eternitiy,auchindoun,744,priest,holy,18,8,10
29619,Blaulienchen,proudmoore,737,priest,holy,30,9,21
29620,Englishheart,auchindoun,734,priest,holy,17,8,9
29621,Adenisia,hyjal,733,priest,holy,19,9,10
29622,Valentinus,dragonmaw,702,priest,holy,26,8,18
29623,Mélínâ,blackmoore,691,priest,holy,28,9,19
29624,Willzah,outland,672,priest,holy,12,7,5
29625,Iiamx,antonidas,672,priest,holy,12,7,5
29626,Dødy,hyjal,672,priest,holy,12,7,5
29627,Jedimind,kazzak,672,priest,holy,12,7,5
29628,Ladderpolice,blackmoore,672,priest,holy,12,7,5
29629,Ainadaxz,ravencrest,672,priest,holy,12,7,5
29630,Ðoxy,frostmane,672,priest,holy,12,7,5
29631,Darkoul,conseil-des-ombres,672,priest,holy,12,7,5
29632,Гшд,gordunni,672,priest,holy,12,7,5
29633,Geilerheiler,dalvengyr,672,priest,holy,12,7,5
29634,Ticklypriest,outland,672,priest,holy,18,7,11
29635,Naïcos,dun-modr,672,priest,holy,18,7,11
29636,Sehrhübsch,malygos,672,priest,holy,18,7,11
29637,Valinoru,silvermoon,672,priest,holy,18,7,11
29638,Russianpvp,outland,672,priest,holy,18,7,11
29639,Gintøníc,blackmoore,671,priest,holy,12,7,5
29640,Vibby,moonglade,671,priest,holy,18,7,11
29641,Shannywen,nemesis,671,priest,holy,24,7,17
29642,Zloop,tarren-mill,670,priest,holy,12,7,5
29643,Qazar,draenor,670,priest,holy,12,7,5
29644,Smolbøi,tarren-mill,670,priest,holy,24,7,17
29645,Dwano,balnazzar,669,priest,holy,12,7,5
29646,Fuloo,stormscale,669,priest,holy,24,7,17
29647,Zinary,silvermoon,667,priest,holy,18,7,11
29648,Isiriah,archimonde,666,priest,holy,12,7,5
29649,Yayaxoxo,archimonde,660,priest,holy,26,10,16
29650,Ledarz,dun-morogh,658,priest,holy,18,7,11
29651,Sarafîsthole,ysondre,655,priest,holy,18,7,11
29652,Naid,exodar,654,priest,holy,24,7,17
29653,Iliridan,pozzo-delleternità,639,priest,holy,138,42,96
29654,Killtrewerty,stormscale,638,priest,holy,17,7,10
29655,Åshlol,ravencrest,617,priest,holy,21,8,13
29656,Waycrest,ravencrest,614,priest,holy,14,8,6
29657,Kirvane,outland,610,priest,holy,15,8,7
29658,Blâdes,gorgonnash,589,priest,holy,17,7,10
29659,Haineko,burning-legion,576,priest,holy,6,6,0
29660,Darkoul,ravencrest,576,priest,holy,12,6,6
29661,Priestok,archimonde,576,priest,holy,12,6,6
29662,Ixxmp,blackrock,576,priest,holy,12,6,6
29663,Nancey,draenor,576,priest,holy,12,6,6
29664,Redy,drakthul,576,priest,holy,12,6,6
29665,Квваззар,gordunni,576,priest,holy,12,6,6
29666,Bij,outland,576,priest,holy,12,6,6
29667,Danina,outland,576,priest,holy,12,6,6
29668,Ahilarry,tarren-mill,576,priest,holy,12,6,6
29669,Resuscitator,spinebreaker,576,priest,holy,12,6,6
29670,Zoophobîa,stormscale,576,priest,holy,12,6,6
29671,Gigamind,blackrock,576,priest,holy,12,6,6
29672,Смайткен,gordunni,576,priest,holy,18,6,12
29673,Мотд,gordunni,576,priest,holy,18,6,12
29674,Altarboy,dun-modr,576,priest,holy,18,6,12
29675,Gød,magtheridon,576,priest,holy,24,6,18
29676,Waters,lightbringer,575,priest,holy,12,6,6
29677,Кариелла,fordragon,575,priest,holy,12,6,6
29678,Wasfürsaft,tarren-mill,575,priest,holy,12,6,6
29679,Healiea,outland,575,priest,holy,18,6,12
29680,Dokurochan,tarren-mill,575,priest,holy,24,6,18
29681,Cayden,bloodfeather,573,priest,holy,12,6,6
29682,Spàgno,nemesis,571,priest,holy,18,6,12
29683,Proxypriest,the-maelstrom,571,priest,holy,20,6,14
29684,Drop,los-errantes,569,priest,holy,12,6,6
29685,Valves,saurfang,569,priest,holy,12,6,6
29686,Carbonic,khaz-modan,568,priest,holy,20,10,10
29687,Bloodelfoula,draenor,563,priest,holy,18,6,12
29688,Alloktonos,ravencrest,544,priest,holy,101,44,57
29689,Priestxx,twilights-hammer,543,priest,holy,11,6,5
29690,Cherrih,argent-dawn,543,priest,holy,11,6,5
29691,Rezzurrectum,doomhammer,527,priest,holy,15,6,9
29692,Dotreveal,ravencrest,521,priest,holy,20,7,13
29693,Madvortexe,kazzak,496,priest,holy,19,6,13
29694,Ralek,hyjal,495,priest,holy,17,6,11
29695,Secundis,silvermoon,480,priest,holy,6,5,1
29696,Felaenna,argent-dawn,480,priest,holy,6,5,1
29697,Shinesomnya,aegwynn,480,priest,holy,6,5,1
29698,Эйттёрналинь,fordragon,480,priest,holy,6,5,1
29699,Tokkzz,ragnaros,480,priest,holy,6,5,1
29700,Celliapriest,antonidas,480,priest,holy,12,5,7
29701,Darkoulito,dalaran,480,priest,holy,12,5,7
29702,Nýkah,antonidas,480,priest,holy,12,5,7
29703,Purist,arthas,480,priest,holy,12,5,7
29704,Velenthan,ragnaros,480,priest,holy,12,5,7
29705,Enèr,hyjal,480,priest,holy,12,5,7
29706,Caz,cthun,480,priest,holy,12,5,7
29707,Shâru,frostmourne,480,priest,holy,12,5,7
29708,Quiwzx,blackrock,480,priest,holy,12,5,7
29709,Onixa,tarren-mill,480,priest,holy,12,5,7
29710,Ogiez,sylvanas,480,priest,holy,12,5,7
29711,Mazeari,sylvanas,480,priest,holy,12,5,7
29712,Holymamba,silvermoon,480,priest,holy,12,5,7
29713,Neeyø,blackhand,480,priest,holy,12,5,7
29714,Лайхтни,howling-fjord,480,priest,holy,12,5,7
29715,Velfchurch,draenor,480,priest,holy,12,5,7
29716,Bamboleon,blackrock,480,priest,holy,12,5,7
29717,Mönster,cthun,480,priest,holy,13,5,8
29718,Mayalolz,chogall,480,priest,holy,14,5,9
29719,Jagardoden,stormscale,480,priest,holy,18,5,13
29720,Minimalist,ravencrest,480,priest,holy,18,5,13
29721,Vannax,arygos,479,priest,holy,6,5,1
29722,Chabbe,ragnaros,479,priest,holy,12,5,7
29723,Cocolasticot,garona,479,priest,holy,12,5,7
29724,Datek,silvermoon,479,priest,holy,12,5,7
29725,Двакамня,soulflayer,479,priest,holy,12,5,7
29726,Novella,kult-der-verdammten,479,priest,holy,12,5,7
29727,Inzané,doomhammer,479,priest,holy,12,5,7
29728,Árcadoom,quelthalas,479,priest,holy,12,5,7
29729,Бредяка,gordunni,479,priest,holy,12,5,7
29730,Alaeddin,kazzak,479,priest,holy,24,5,19
29731,Amemiya,ragnaros,478,priest,holy,12,5,7
29732,Laxara,arthas,478,priest,holy,12,5,7
29733,Monetaria,das-syndikat,477,priest,holy,18,5,13
29734,Xaeo,burning-legion,477,priest,holy,26,5,21
29735,Azaza,burning-legion,472,priest,holy,12,5,7
29736,Nevermd,blackrock,426,priest,holy,21,6,15
29737,Nannymcfee,stormscale,414,priest,holy,11,5,6
29738,Даймэн,gordunni,384,priest,holy,6,4,2
29739,Burnesenbois,chogall,384,priest,holy,6,4,2
29740,Tëst,ravencrest,384,priest,holy,6,4,2
29741,Experimentix,silvermoon,384,priest,holy,6,4,2
29742,Макстин,howling-fjord,384,priest,holy,6,4,2
29743,Wixzyx,ravencrest,384,priest,holy,6,4,2
29744,Yredias,dalaran,384,priest,holy,6,4,2
29745,Indrades,blackmoore,384,priest,holy,6,4,2
29746,Пристотян,gordunni,384,priest,holy,6,4,2
29747,Yanclown,tarren-mill,384,priest,holy,6,4,2
29748,Piizzdiica,twisting-nether,384,priest,holy,6,4,2
29749,Arithon,blackrock,384,priest,holy,6,4,2
29750,Tyog,khazgoroth,384,priest,holy,6,4,2
29751,Missdemerè,nemesis,384,priest,holy,12,4,8
29752,Mydicine,ysondre,384,priest,holy,12,4,8
29753,Sayash,chamber-of-aspects,384,priest,holy,12,4,8
29754,Alterlight,twisting-nether,384,priest,holy,12,4,8
29755,Bebwaz,kazzak,384,priest,holy,12,4,8
29756,Zarez,stormscale,384,priest,holy,12,4,8
29757,Flurri,tarren-mill,384,priest,holy,12,4,8
29758,Jukester,stormscale,384,priest,holy,12,4,8
29759,Disillusíon,tarren-mill,384,priest,holy,12,4,8
29760,Chaendral,darkmoon-faire,384,priest,holy,12,4,8
29761,Alshah,emerald-dream,384,priest,holy,12,4,8
29762,Spamplague,stormscale,384,priest,holy,12,4,8
29763,Aladriela,exodar,384,priest,holy,12,4,8
29764,Bloodie,drakthul,384,priest,holy,12,4,8
29765,Ripperdepip,magtheridon,384,priest,holy,12,4,8
29766,Sinf,sanguino,384,priest,holy,12,4,8
29767,Øbz,sylvanas,384,priest,holy,12,4,8
29768,Clergy,hellfire,384,priest,holy,12,4,8
29769,Avïlia,dalaran,384,priest,holy,12,4,8
29770,Egozyp,kazzak,384,priest,holy,12,4,8
29771,Skytheory,eredar,384,priest,holy,13,4,9
29772,Virgosenpai,silvermoon,384,priest,holy,18,4,14
29773,Ømegagødx,outland,384,priest,holy,18,4,14
29774,Кэндимен,gordunni,384,priest,holy,18,4,14
29775,Ðlcz,blackrock,384,priest,holy,18,4,14
29776,Kheenah,argent-dawn,383,priest,holy,6,4,2
29777,Fivequeens,tarren-mill,383,priest,holy,6,4,2
29778,Allwhitte,confrérie-du-thorium,383,priest,holy,6,4,2
29779,Taint,khadgar,383,priest,holy,6,4,2
29780,Ruebi,blackmoore,383,priest,holy,12,4,8
29781,Blackwidow,chromaggus,383,priest,holy,12,4,8
29782,Tolteck,ravencrest,383,priest,holy,12,4,8
29783,Ynnaria,blackmoore,383,priest,holy,12,4,8
29784,Harukaa,aggra-português,383,priest,holy,12,4,8
29785,Centauria,burning-legion,381,priest,holy,30,4,26
29786,Amanthus,draenor,377,priest,holy,16,6,10
29787,Эгнерия,eversong,367,priest,holy,17,4,13
29788,Nxtlvl,stormscale,352,priest,holy,10,5,5
29789,Pínacoladáqt,stormscale,352,priest,holy,10,4,6
29790,Apuessii,dun-modr,351,priest,holy,11,4,7
29791,Shyvi,ravencrest,319,priest,holy,5,4,1
29792,Vídel,cthun,319,priest,holy,8,4,4
29793,Zahadoom,stormscale,319,priest,holy,12,5,7
29794,Aiewn,elune,288,priest,holy,6,3,3
29795,Ariyia,argent-dawn,288,priest,holy,6,3,3
29796,Badhêalz,aegwynn,288,priest,holy,6,3,3
29797,Kyokaze,silvermoon,288,priest,holy,6,3,3
29798,Verycute,argent-dawn,288,priest,holy,6,3,3
29799,Tebzy,ravencrest,288,priest,holy,6,3,3
29800,Pyropenance,twisting-nether,288,priest,holy,6,3,3
29801,Shadowkym,blackrock,288,priest,holy,6,3,3
29802,Elf,tarren-mill,288,priest,holy,6,3,3
29803,Vanadii,blackhand,288,priest,holy,6,3,3
29804,Dathanosp,outland,288,priest,holy,6,3,3
29805,Хексорик,howling-fjord,288,priest,holy,6,3,3
29806,Aevery,onyxia,288,priest,holy,6,3,3
29807,Proteco,antonidas,288,priest,holy,6,3,3
29808,Drdiscospec,tarren-mill,288,priest,holy,6,3,3
29809,Xelivia,draenor,288,priest,holy,6,3,3
29810,Hilerki,draenor,288,priest,holy,6,3,3
29811,Arabpriest,draenor,288,priest,holy,6,3,3
29812,Pristern,tarren-mill,288,priest,holy,6,3,3
29813,Mcx,stormscale,288,priest,holy,6,3,3
29814,ßestworld,draenor,288,priest,holy,6,3,3
29815,Grindgames,pozzo-delleternità,288,priest,holy,6,3,3
29816,Catrex,draenor,288,priest,holy,6,3,3
29817,Góli,argent-dawn,288,priest,holy,6,3,3
29818,Holyheartx,argent-dawn,288,priest,holy,6,3,3
29819,Shmoly,stormscale,288,priest,holy,6,3,3
29820,Juicedmaboi,tarren-mill,288,priest,holy,6,3,3
29821,Asolan,drakthul,288,priest,holy,6,3,3
29822,Dãrkmedic,silvermoon,288,priest,holy,6,3,3
29823,Gimeurgold,destromath,288,priest,holy,6,3,3
29824,Alaelis,burning-legion,288,priest,holy,6,3,3
29825,Bambus,shattered-hand,288,priest,holy,6,3,3
29826,Aruna,ravencrest,288,priest,holy,6,3,3
29827,Mneme,aggramar,288,priest,holy,6,3,3
29828,Подчинись,ashenvale,288,priest,holy,6,3,3
29829,Lynéssa,silvermoon,288,priest,holy,6,3,3
29830,Carnacia,tarren-mill,288,priest,holy,6,3,3
29831,Zyrusen,sanguino,288,priest,holy,6,3,3
29832,Atremius,dragonmaw,288,priest,holy,6,3,3
29833,Аржан,soulflayer,288,priest,holy,6,3,3
29834,Nimsi,ravencrest,288,priest,holy,6,3,3
29835,Pharli,stormscale,288,priest,holy,6,3,3
29836,Namsolo,kazzak,288,priest,holy,6,3,3
29837,Шанэкс,howling-fjord,288,priest,holy,6,3,3
29838,Tribz,kargath,288,priest,holy,6,3,3
29839,Фионыч,blackscar,288,priest,holy,6,3,3
29840,Salzholy,malygos,288,priest,holy,6,3,3
29841,Jeboc,ravencrest,288,priest,holy,6,3,3
29842,Alentissar,nemesis,288,priest,holy,6,3,3
29843,Inà,thrall,288,priest,holy,6,3,3
29844,Холихэйт,howling-fjord,288,priest,holy,6,3,3
29845,Prisht,ravencrest,288,priest,holy,6,3,3
29846,Egî,azshara,288,priest,holy,6,3,3
29847,Hellhámmer,azshara,288,priest,holy,6,3,3
29848,Sebbepriest,twisting-nether,288,priest,holy,10,3,7
29849,Daenaerys,dun-morogh,288,priest,holy,12,3,9
29850,Eihran,stormscale,288,priest,holy,12,3,9
29851,Xver,dun-morogh,288,priest,holy,12,3,9
29852,Drminduskâ,ysondre,288,priest,holy,12,3,9
29853,Pretzioso,nemesis,288,priest,holy,12,3,9
29854,Javvi,sylvanas,288,priest,holy,12,3,9
29855,Parzivál,argent-dawn,288,priest,holy,12,3,9
29856,Lurri,tarren-mill,288,priest,holy,12,3,9
29857,Quami,dun-modr,288,priest,holy,12,3,9
29858,Люблюкофе,deathguard,288,priest,holy,12,3,9
29859,Farae,arathor,288,priest,holy,24,3,21
29860,Ларуса,gordunni,287,priest,holy,6,3,3
29861,Clerìc,argent-dawn,255,priest,holy,11,3,8
29862,Elthrone,kazzak,240,priest,holy,9,4,5
29863,Lr,aszune,240,priest,holy,9,3,6
29864,Кэрия,blackscar,239,priest,holy,5,3,2
29865,Azrpr,ravencrest,239,priest,holy,5,3,2
29866,Outcast,korgall,224,priest,holy,10,3,7
29867,Notatrap,outland,192,priest,holy,6,2,4
29868,Dinma,argent-dawn,192,priest,holy,6,2,4
29869,Dami,defias-brotherhood,192,priest,holy,6,2,4
29870,Discobrill,silvermoon,192,priest,holy,6,2,4
29871,Келебриана,deepholm,192,priest,holy,6,2,4
29872,Eyllise,ragnaros,192,priest,holy,6,2,4
29873,Solaclypsa,destromath,192,priest,holy,6,2,4
29874,Zenholy,kazzak,192,priest,holy,6,2,4
29875,Асуартхас,gordunni,192,priest,holy,6,2,4
29876,Llounal,silvermoon,192,priest,holy,6,2,4
29877,Shkzz,hyjal,192,priest,holy,6,2,4
29878,Jinxies,twisting-nether,192,priest,holy,6,2,4
29879,Burnex,thrall,192,priest,holy,6,2,4
29880,Yukirito,drakthul,192,priest,holy,6,2,4
29881,Utsuro,stormscale,192,priest,holy,6,2,4
29882,Prästpojken,frostwhisper,192,priest,holy,6,2,4
29883,Dîakon,antonidas,192,priest,holy,6,2,4
29884,Krematorio,twisting-nether,192,priest,holy,6,2,4
29885,Marrisa,khaz-modan,192,priest,holy,6,2,4
29886,Tiphereth,blackmoore,192,priest,holy,6,2,4
29887,Absórb,quelthalas,192,priest,holy,6,2,4
29888,Lahammy,kazzak,192,priest,holy,6,2,4
29889,Tygstycke,tarren-mill,192,priest,holy,6,2,4
29890,Ibunnyqt,aegwynn,192,priest,holy,6,2,4
29891,Soül,sylvanas,192,priest,holy,6,2,4
29892,Korzec,dun-modr,192,priest,holy,6,2,4
29893,Ihefyehvjrm,ravencrest,192,priest,holy,6,2,4
29894,Micix,tarren-mill,192,priest,holy,6,2,4
29895,Sinetrax,tarren-mill,192,priest,holy,6,2,4
29896,Lutzki,the-maelstrom,192,priest,holy,6,2,4
29897,Troedelsuppe,destromath,192,priest,holy,6,2,4
29898,Hunfall,stormscale,192,priest,holy,6,2,4
29899,Buzzy,twisting-nether,192,priest,holy,6,2,4
29900,Skryllette,archimonde,192,priest,holy,6,2,4
29901,Dertar,archimonde,192,priest,holy,6,2,4
29902,Priesless,sylvanas,192,priest,holy,6,2,4
29903,Djingischan,twisting-nether,192,priest,holy,6,2,4
29904,Tinypump,silvermoon,192,priest,holy,6,2,4
29905,Noukeé,blackrock,192,priest,holy,6,2,4
29906,Grøums,blackmoore,192,priest,holy,6,2,4
29907,Frvrfridayy,stormscale,192,priest,holy,6,2,4
29908,Sigor,hellfire,192,priest,holy,6,2,4
29909,Haxxøn,die-nachtwache,192,priest,holy,6,2,4
29910,Cheefto,blackmoore,192,priest,holy,6,2,4
29911,Dangerfred,stormscale,192,priest,holy,6,2,4
29912,Crackbär,blackmoore,192,priest,holy,6,2,4
29913,Луножрец,gordunni,192,priest,holy,6,2,4
29914,Wyez,blackmoore,192,priest,holy,6,2,4
29915,Бранлор,howling-fjord,192,priest,holy,8,2,6
29916,Nøfear,tarren-mill,192,priest,holy,11,2,9
29917,Jawjie,tarren-mill,192,priest,holy,12,2,10
29918,Гидранист,soulflayer,192,priest,holy,12,2,10
29919,Authentic,dalaran,192,priest,holy,12,2,10
29920,Daedarkis,twisting-nether,192,priest,holy,12,2,10
29921,Køzøxîä,dalaran,192,priest,holy,12,2,10
29922,Ittei,stormscale,192,priest,holy,12,2,10
29923,Twh,outland,192,priest,holy,12,2,10
29924,Злыденькая,gordunni,192,priest,holy,12,2,10
29925,Hónòr,sylvanas,192,priest,holy,12,2,10
29926,Meynola,ysondre,191,priest,holy,6,2,4
29927,Bianchi,los-errantes,191,priest,holy,6,2,4
29928,Riogas,khaz-modan,191,priest,holy,12,2,10
29929,Safiira,argent-dawn,190,priest,holy,12,2,10
29930,Rankonejames,silvermoon,159,priest,holy,5,2,3
29931,Pinkfloydx,lightbringer,138,priest,holy,9,4,5
29932,Spae,twisting-nether,138,priest,holy,11,4,7
29933,Paterlurki,blackhand,138,priest,holy,10,3,7
29934,Пейлон,howling-fjord,137,priest,holy,10,4,6
29935,Mavisqt,draenor,128,priest,holy,4,2,2
29936,Ûñrêpørtablë,outland,96,priest,holy,3,2,1
29937,Kipnuggetz,burning-legion,96,priest,holy,6,1,5
29938,Superdude,stormscale,96,priest,holy,6,1,5
29939,Яестькенни,soulflayer,96,priest,holy,6,1,5
29940,Decimerad,kazzak,96,priest,holy,6,1,5
29941,Lasanka,sylvanas,96,priest,holy,6,1,5
29942,Peg,talnivarr,96,priest,holy,6,1,5
29943,Lujka,outland,96,priest,holy,6,1,5
29944,Isendriel,outland,96,priest,holy,6,1,5
29945,Shicu,blackmoore,96,priest,holy,6,1,5
29946,Rankoneprazt,stormscale,96,priest,holy,6,1,5
29947,Saheila,defias-brotherhood,96,priest,holy,6,1,5
29948,Remkoja,blackrock,96,priest,holy,6,1,5
29949,Pattie,ragnaros,96,priest,holy,6,1,5
29950,Goupillou,hyjal,96,priest,holy,6,1,5
29951,Батлджес,gordunni,96,priest,holy,6,1,5
29952,Tÿona,hyjal,96,priest,holy,6,1,5
29953,Spoc,blackrock,96,priest,holy,6,1,5
29954,Nuph,ravencrest,96,priest,holy,6,1,5
29955,Elvedâ,blackhand,96,priest,holy,6,1,5
29956,Blastor,ravencrest,96,priest,holy,6,1,5
29957,Сакредлайв,gordunni,96,priest,holy,6,1,5
29958,Эллвинг,howling-fjord,96,priest,holy,6,1,5
29959,Valyreon,outland,96,priest,holy,6,1,5
29960,Laadyybirkee,blackhand,96,priest,holy,6,1,5
29961,Elfhelp,ravencrest,96,priest,holy,6,1,5
29962,Mauralin,zirkel-des-cenarius,96,priest,holy,6,1,5
29963,Lâughing,ravencrest,96,priest,holy,6,1,5
29964,Мишатемный,gordunni,96,priest,holy,6,1,5
29965,Itstooney,doomhammer,96,priest,holy,6,1,5
29966,Myrrha,les-sentinelles,96,priest,holy,6,1,5
29967,Wísp,die-aldor,96,priest,holy,6,1,5
29968,Borá,twisting-nether,96,priest,holy,6,1,5
29969,Eloundir,dalaran,96,priest,holy,6,1,5
29970,Systerstål,twisting-nether,96,priest,holy,6,1,5
29971,Venomrush,ravencrest,96,priest,holy,6,1,5
29972,Kakuzuke,nemesis,96,priest,holy,6,1,5
29973,Herwin,twisting-nether,96,priest,holy,6,1,5
29974,Wrongwrong,draenor,96,priest,holy,6,1,5
29975,Iirina,draenor,96,priest,holy,6,1,5
29976,Jaesabøyx,twisting-nether,96,priest,holy,6,1,5
29977,Ximenia,eredar,96,priest,holy,6,1,5
29978,Vierfingerjo,eredar,96,priest,holy,6,1,5
29979,Slêq,antonidas,96,priest,holy,6,1,5
29980,Jaatjak,ravencrest,96,priest,holy,6,1,5
29981,Ylenae,twisting-nether,96,priest,holy,6,1,5
29982,Kasáya,thrall,96,priest,holy,14,2,12
29983,Plaguestrike,darkspear,96,priest,holy,12,1,11
29984,Onlyfans,burning-steppes,96,priest,holy,12,1,11
29985,Åme,kirin-tor,96,priest,holy,12,1,11
29986,Doublehealix,argent-dawn,96,priest,holy,12,1,11
29987,Kæzm,blackrock,96,priest,holy,12,1,11
29988,Felvytwo,stormscale,96,priest,holy,12,1,11
29989,Mswagner,outland,79,priest,holy,5,1,4
29990,Xaey,ravencrest,48,priest,holy,3,1,2
29991,Freshpope,ravencrest,48,priest,holy,3,1,2
29992,Darkyos,azshara,42,priest,holy,6,2,4
29993,Tabítha,blackrock,42,priest,holy,9,2,7
29994,Priestyo,blackrock,42,priest,holy,10,2,8
29995,Bøij,pozzo-delleternità,42,priest,holy,10,2,8
29996,Prêtresacré,archimonde,2244,priest,discipline,89,52,37
29997,Gaalonikus,blackmoore,2235,priest,discipline,92,54,38
29998,Vanostsp,kazzak,2230,priest,discipline,102,56,46
29999,Jayti,ravencrest,2205,priest,discipline,115,65,50
30000,Primayodbain,archimonde,2185,priest,discipline,82,47,35
30001,Vengefulmaze,ravencrest,2174,priest,discipline,120,65,55
30002,Dripcheck,draenor,2174,priest,discipline,337,178,159
30003,Èfflux,ravencrest,2172,priest,discipline,86,54,32
30004,Jackiqt,nemesis,2161,priest,discipline,119,77,42
30005,Bedfirez,ravencrest,2161,priest,discipline,211,122,89
30006,Jagardoden,stormscale,2144,priest,discipline,117,71,46
30007,Jtî,ravencrest,2134,priest,discipline,72,47,25
30008,Saentainen,kazzak,2133,priest,discipline,95,68,27
30009,Cylizx,stormscale,2133,priest,discipline,114,62,52
30010,Ltr,tarren-mill,2132,priest,discipline,61,39,22
30011,Moonriver,archimonde,2132,priest,discipline,66,39,27
30012,Jaywie,twisting-nether,2132,priest,discipline,156,79,77
30013,Artle,sanguino,2131,priest,discipline,83,44,39
30014,Izzý,antonidas,2129,priest,discipline,90,57,33
30015,Efflúx,ravencrest,2128,priest,discipline,124,71,53
30016,Azrpr,ravencrest,2128,priest,discipline,82,45,37
30017,Релакз,soulflayer,2124,priest,discipline,120,66,54
30018,Kleot,ragnaros,2124,priest,discipline,385,205,180
30019,Cringê,ravencrest,2124,priest,discipline,89,46,43
30020,Rébörn,tarren-mill,2123,priest,discipline,71,44,27
30021,Asanti,die-aldor,2122,priest,discipline,252,145,107
30022,Unréål,ravencrest,2122,priest,discipline,198,102,96
30023,Hukkuvahirvi,ravencrest,2122,priest,discipline,99,50,49
30024,Jidammy,ravencrest,2120,priest,discipline,80,41,39
30025,Duckiethot,twisting-nether,2120,priest,discipline,196,99,97
30026,Деадхостх,soulflayer,2117,priest,discipline,72,46,26
30027,Jacknapier,kazzak,2117,priest,discipline,66,39,27
30028,Rñd,ravencrest,2117,priest,discipline,78,40,38
30029,Voxtwo,blackrock,2114,priest,discipline,66,41,25
30030,Råcòøñ,ravencrest,2110,priest,discipline,109,55,54
30031,Sfÿ,ysondre,2106,priest,discipline,84,43,41
30032,Blessedmix,korgall,2105,priest,discipline,84,48,36
30033,Swdswdswdswd,blackmoore,2105,priest,discipline,100,55,45
30034,Wetnpuffy,ravencrest,2104,priest,discipline,274,145,129
30035,Neverdome,ravencrest,2100,priest,discipline,405,218,187
30036,Øbserverx,stormscale,2100,priest,discipline,114,61,53
30037,Мамкалол,soulflayer,2096,priest,discipline,288,150,138
30038,Chasx,ravencrest,2092,priest,discipline,136,67,69
30039,Klonyaryk,ravencrest,2089,priest,discipline,90,52,38
30040,Loví,twisting-nether,2081,priest,discipline,107,53,54
30041,Prästpåven,stormscale,2078,priest,discipline,66,40,26
30042,Gudóngmae,ravencrest,2076,priest,discipline,48,32,16
30043,Luxurygirl,nemesis,2076,priest,discipline,54,35,19
30044,Kangaroogodx,ravencrest,2070,priest,discipline,126,62,64
30045,Pheen,kazzak,2065,priest,discipline,262,140,122
30046,Thelïght,ravencrest,2062,priest,discipline,165,81,84
30047,Twinkboyx,ragnaros,2060,priest,discipline,129,66,63
30048,Mentalboom,emerald-dream,2060,priest,discipline,185,94,91
30049,Shøy,nemesis,2059,priest,discipline,228,115,113
30050,Holypoppa,ravencrest,2051,priest,discipline,295,146,149
30051,Aist,ragnaros,2044,priest,discipline,90,44,46
30052,Flongoletta,xavius,2042,priest,discipline,144,80,64
30053,Schattenface,blackmoore,2041,priest,discipline,194,112,82
30054,Plsdontnerf,onyxia,2039,priest,discipline,95,55,40
30055,Imprøved,outland,2036,priest,discipline,102,70,32
30056,Lloreen,ravencrest,2035,priest,discipline,131,72,59
30057,Artístx,twisting-nether,2035,priest,discipline,83,44,39
30058,Rhâpsødy,ravencrest,2033,priest,discipline,107,65,42
30059,Bindw,tarren-mill,2025,priest,discipline,41,22,19
30060,Reflector,sunstrider,2025,priest,discipline,93,44,49
30061,Sèco,sylvanas,2024,priest,discipline,90,44,46
30062,Faithz,ragnaros,2023,priest,discipline,84,39,45
30063,Mavisqt,draenor,2022,priest,discipline,114,61,53
30064,Crinji,blackmoore,2022,priest,discipline,169,83,86
30065,Loaffeh,ragnaros,2021,priest,discipline,48,28,20
30066,Leahbtw,ravencrest,2020,priest,discipline,216,114,102
30067,Dakystepmom,stormreaver,2017,priest,discipline,119,57,62
30068,Гопикзашквар,blackscar,2017,priest,discipline,104,47,57
30069,Priestqtx,kelthuzad,2016,priest,discipline,60,34,26
30070,Wet,twisting-nether,2015,priest,discipline,90,41,49
30071,Gerryqt,draenor,2013,priest,discipline,72,38,34
30072,Villagebike,shadowsong,2012,priest,discipline,42,22,20
30073,Разрухаз,gordunni,2011,priest,discipline,95,48,47
30074,Eau,quelthalas,2011,priest,discipline,142,71,71
30075,Synxii,ravencrest,2010,priest,discipline,100,50,50
30076,Trialight,ravencrest,2009,priest,discipline,89,57,32
30077,Shadothat,turalyon,2008,priest,discipline,173,93,80
30078,Фастэксп,razuvious,2008,priest,discipline,263,135,128
30079,Nêxt,ravencrest,2007,priest,discipline,102,67,35
30080,Timbsheal,tarren-mill,2007,priest,discipline,150,77,73
30081,Ävbmârsík,kazzak,2006,priest,discipline,143,80,63
30082,Shmoly,stormscale,2006,priest,discipline,97,50,47
30083,Duckiethotx,ragnaros,2005,priest,discipline,108,53,55
30084,Фанпау,soulflayer,2005,priest,discipline,84,39,45
30085,Tanlytwo,ravencrest,2003,priest,discipline,76,38,38
30086,Underdogx,eredar,2002,priest,discipline,551,282,269
30087,Vajadisc,twisting-nether,2000,priest,discipline,136,59,77
30088,Ðontargueok,blackmoore,1996,priest,discipline,90,50,40
30089,Nothappy,ragnaros,1996,priest,discipline,66,32,34
30090,Mentalist,dun-modr,1996,priest,discipline,189,91,98
30091,Билетлолпро,borean-tundra,1995,priest,discipline,256,124,132
30092,Rhauru,tyrande,1994,priest,discipline,146,69,77
30093,Yânux,aegwynn,1991,priest,discipline,91,50,41
30094,Хомяктьмы,gordunni,1991,priest,discipline,108,57,51
30095,Stavfel,stormscale,1990,priest,discipline,117,63,54
30096,Dabalthazar,ravencrest,1985,priest,discipline,163,83,80
30097,Ilumiinatrix,dun-modr,1982,priest,discipline,696,345,351
30098,Dpriesta,aegwynn,1979,priest,discipline,88,52,36
30099,Painchampion,draenor,1978,priest,discipline,88,43,45
30100,Acondisc,kazzak,1977,priest,discipline,76,43,33
30101,Boltygnome,blades-edge,1977,priest,discipline,96,52,44
30102,Flao,ravencrest,1977,priest,discipline,64,34,30
30103,Ekman,twisting-nether,1977,priest,discipline,128,67,61
30104,Önnÿ,dun-modr,1975,priest,discipline,149,76,73
30105,Oioiio,kazzak,1975,priest,discipline,84,42,42
30106,Sinetrax,tarren-mill,1973,priest,discipline,96,57,39
30107,Clapped,ravencrest,1973,priest,discipline,78,38,40
30108,Mercilégion,sargeras,1971,priest,discipline,66,34,32
30109,Prådâshådëzz,blackmoore,1970,priest,discipline,59,36,23
30110,Sleepypriest,frostmane,1970,priest,discipline,54,31,23
30111,Хомячпочка,gordunni,1970,priest,discipline,82,42,40
30112,Jawake,twisting-nether,1970,priest,discipline,54,27,27
30113,Lyrvanax,ravencrest,1968,priest,discipline,241,119,122
30114,Ziknait,sargeras,1967,priest,discipline,54,34,20
30115,Comedii,blackmoore,1965,priest,discipline,477,247,230
30116,Eukmassus,archimonde,1964,priest,discipline,82,43,39
30117,Wernou,archimonde,1963,priest,discipline,60,36,24
30118,Djsüssi,frostwolf,1963,priest,discipline,163,76,87
30119,Kâiøxx,outland,1958,priest,discipline,228,120,108
30120,Spinebuster,frostwolf,1958,priest,discipline,78,38,40
30121,Líluqt,sanguino,1957,priest,discipline,93,46,47
30122,Asdfgfhtjy,stormscale,1955,priest,discipline,84,40,44
30123,Krawnz,dun-modr,1953,priest,discipline,54,29,25
30124,Semagdnim,aggra-português,1951,priest,discipline,87,44,43
30125,Rlyeh,argent-dawn,1949,priest,discipline,65,35,30
30126,Klered,ragnaros,1948,priest,discipline,88,54,34
30127,Secø,sylvanas,1948,priest,discipline,48,26,22
30128,Salvinia,kelthuzad,1948,priest,discipline,114,57,57
30129,Artle,dun-modr,1945,priest,discipline,88,61,27
30130,Mainputa,pozzo-delleternità,1943,priest,discipline,113,54,59
30131,Kekkons,sylvanas,1941,priest,discipline,119,61,58
30132,Ebuglatatrov,ravencrest,1941,priest,discipline,120,57,63
30133,Нтти,soulflayer,1940,priest,discipline,90,50,40
30134,Místerbiceps,outland,1940,priest,discipline,95,48,47
30135,Concetto,nazjatar,1939,priest,discipline,48,27,21
30136,Sathie,ravencrest,1939,priest,discipline,114,57,57
30137,Puckhorde,outland,1938,priest,discipline,96,59,37
30138,Lyrvatwo,ravencrest,1938,priest,discipline,55,33,22
30139,Mysterymucus,draenor,1938,priest,discipline,102,61,41
30140,Porkhunt,stormscale,1938,priest,discipline,90,52,38
30141,Scortie,blackrock,1938,priest,discipline,78,41,37
30142,Senga,kazzak,1937,priest,discipline,78,38,40
30143,Summerfinn,ravencrest,1937,priest,discipline,93,44,49
30144,Tjackpanda,kazzak,1935,priest,discipline,54,30,24
30145,Бенджаминлол,blackscar,1934,priest,discipline,60,27,33
30146,Джагонх,soulflayer,1932,priest,discipline,72,40,32
30147,Zularia,rexxar,1932,priest,discipline,132,70,62
30148,Rngånxiety,ravencrest,1931,priest,discipline,142,72,70
30149,Невертрикахд,gordunni,1931,priest,discipline,113,52,61
30150,Healseri,defias-brotherhood,1929,priest,discipline,222,114,108
30151,Mswagner,outland,1926,priest,discipline,65,36,29
30152,Psyheea,stormscale,1926,priest,discipline,139,62,77
30153,Лёнятреппер,blackscar,1925,priest,discipline,183,102,81
30154,Trashedd,outland,1925,priest,discipline,123,58,65
30155,Uwuslayerx,stormscale,1922,priest,discipline,137,70,67
30156,Azoran,dentarg,1922,priest,discipline,78,39,39
30157,Akaria,kelthuzad,1922,priest,discipline,66,30,36
30158,Deadsloth,hyjal,1921,priest,discipline,71,37,34
30159,Arthezz,ravencrest,1920,priest,discipline,92,50,42
30160,Sharkouly,blackmoore,1920,priest,discipline,54,27,27
30161,Алинкалол,howling-fjord,1916,priest,discipline,192,110,82
30162,Niniell,blackmoore,1915,priest,discipline,66,43,23
30163,Делреона,blackscar,1914,priest,discipline,102,58,44
30164,Soloshuffle,draenor,1914,priest,discipline,76,40,36
30165,Listrix,frostmane,1914,priest,discipline,180,91,89
30166,Nirvz,silvermoon,1913,priest,discipline,78,56,22
30167,Dermaul,kazzak,1913,priest,discipline,42,24,18
30168,Shinjicum,kazzak,1912,priest,discipline,255,145,110
30169,Justyø,archimonde,1909,priest,discipline,290,166,124
30170,Eestpr,tarren-mill,1908,priest,discipline,69,37,32
30171,Verti,outland,1906,priest,discipline,118,56,62
30172,Hampådenbååd,kazzak,1905,priest,discipline,54,26,28
30173,Bonzu,ravencrest,1904,priest,discipline,60,30,30
30174,Georgeshxx,ravencrest,1903,priest,discipline,95,50,45
30175,Kenzah,ysondre,1902,priest,discipline,48,28,20
30176,Demora,ysondre,1901,priest,discipline,156,81,75
30177,Evpisces,archimonde,1901,priest,discipline,333,164,169
30178,Kevinsorbo,destromath,1899,priest,discipline,66,35,31
30179,Bigextendo,blackmoore,1899,priest,discipline,144,76,68
30180,Donvyto,blackmoore,1899,priest,discipline,48,24,24
30181,Maxfly,archimonde,1898,priest,discipline,54,29,25
30182,Notnøw,silvermoon,1897,priest,discipline,59,36,23
30183,Лайбаси,howling-fjord,1897,priest,discipline,126,64,62
30184,Rîeka,antonidas,1897,priest,discipline,83,40,43
30185,Галюхах,soulflayer,1895,priest,discipline,48,25,23
30186,Kêkwshádêzz,blackmoore,1895,priest,discipline,54,27,27
30187,Citadelle,blackmoore,1894,priest,discipline,83,48,35
30188,Discishârd,ravencrest,1893,priest,discipline,117,60,57
30189,Fearxyz,aegwynn,1891,priest,discipline,66,34,32
30190,Разорлайтх,gordunni,1890,priest,discipline,29,21,8
30191,ßrb,sylvanas,1888,priest,discipline,174,98,76
30192,Wangewover,ravencrest,1888,priest,discipline,147,82,65
30193,Xghj,sylvanas,1887,priest,discipline,72,36,36
30194,Potatojuicer,argent-dawn,1886,priest,discipline,165,82,83
30195,Infamoussftw,drakthul,1886,priest,discipline,360,174,186
30196,Ananous,hyjal,1885,priest,discipline,189,99,90
30197,Fabzen,grim-batol,1884,priest,discipline,66,32,34
30198,Йеэгер,soulflayer,1883,priest,discipline,70,31,39
30199,Melphixia,stormscale,1882,priest,discipline,53,25,28
30200,Voideffsucks,stormscale,1881,priest,discipline,60,32,28
30201,Tweely,drakthul,1881,priest,discipline,87,46,41
30202,Tazn,thrall,1880,priest,discipline,42,23,19
30203,Merylle,ragnaros,1880,priest,discipline,60,29,31
30204,Goldensp,sanguino,1878,priest,discipline,81,47,34
30205,Nolnilian,archimonde,1877,priest,discipline,60,35,25
30206,Faderfarbror,tarren-mill,1872,priest,discipline,109,68,41
30207,Elethia,blackmoore,1872,priest,discipline,38,21,17
30208,Yeetedmycat,stormscale,1872,priest,discipline,66,34,32
30209,Onyoureyebal,vashj,1872,priest,discipline,132,61,71
30210,Imsaltyxd,tarren-mill,1871,priest,discipline,66,39,27
30211,Maybeexp,ravencrest,1871,priest,discipline,42,23,19
30212,Svakkanxd,kazzak,1871,priest,discipline,70,33,37
30213,Cdïs,tyrande,1870,priest,discipline,54,36,18
30214,Rpriest,outland,1870,priest,discipline,60,34,26
30215,Egî,azshara,1870,priest,discipline,42,20,22
30216,Depridolens,argent-dawn,1869,priest,discipline,42,27,15
30217,Limerençe,ravencrest,1869,priest,discipline,44,25,19
30218,Интеллиджент,gordunni,1868,priest,discipline,42,24,18
30219,ßlinkytwinky,outland,1868,priest,discipline,42,22,20
30220,Zhadow,outland,1868,priest,discipline,150,78,72
30221,Свэпи,blackscar,1868,priest,discipline,71,34,37
30222,Nalakis,archimonde,1866,priest,discipline,115,67,48
30223,Elsuzette,hyjal,1866,priest,discipline,58,30,28
30224,Saniqt,kazzak,1865,priest,discipline,57,35,22
30225,Jimpah,outland,1865,priest,discipline,112,49,63
30226,Phosdia,festung-der-stürme,1864,priest,discipline,36,24,12
30227,Moyoo,kazzak,1864,priest,discipline,100,45,55
30228,Jellypie,blackrock,1863,priest,discipline,48,31,17
30229,Asdfghqwezxc,twisting-nether,1863,priest,discipline,65,35,30
30230,Neffty,aegwynn,1863,priest,discipline,138,73,65
30231,Прощайдуде,gordunni,1863,priest,discipline,65,34,31
30232,Asyncx,ravencrest,1862,priest,discipline,68,35,33
30233,Xutira,silvermoon,1861,priest,discipline,207,118,89
30234,Бенджаминлол,deathguard,1861,priest,discipline,66,33,33
30235,Свдпро,soulflayer,1861,priest,discipline,150,70,80
30236,Pricemg,thrall,1860,priest,discipline,48,29,19
30237,Incaflamesex,sanguino,1860,priest,discipline,59,33,26
30238,Debeo,ragnaros,1860,priest,discipline,133,74,59
30239,Кошечка,deathguard,1860,priest,discipline,41,21,20
30240,Thalanas,ravencrest,1859,priest,discipline,158,90,68
30241,Sublab,kazzak,1859,priest,discipline,60,33,27
30242,Artìst,ravencrest,1858,priest,discipline,30,20,10
30243,Мефодийприст,howling-fjord,1858,priest,discipline,102,62,40
30244,Cdplz,archimonde,1858,priest,discipline,119,59,60
30245,Monopolygoat,arathor,1858,priest,discipline,181,84,97
30246,Фрайонель,gordunni,1857,priest,discipline,42,32,10
30247,Entenpanda,kazzak,1855,priest,discipline,122,66,56
30248,Ðènnis,argent-dawn,1855,priest,discipline,139,71,68
30249,Unfaithful,twisting-nether,1854,priest,discipline,70,43,27
30250,Cellia,antonidas,1853,priest,discipline,42,25,17
30251,Kripteksx,ravencrest,1853,priest,discipline,53,29,24
30252,Enilion,draenor,1853,priest,discipline,56,29,27
30253,Dieterdose,tarren-mill,1852,priest,discipline,44,29,15
30254,Crushmyballs,ravencrest,1852,priest,discipline,60,36,24
30255,Eolîn,draenor,1852,priest,discipline,60,35,25
30256,Лэсивэснэс,soulflayer,1852,priest,discipline,72,30,42
30257,Zêxy,stormscale,1851,priest,discipline,101,53,48
30258,Djswdgodx,twisting-nether,1850,priest,discipline,84,43,41
30259,Rynnegan,zuljin,1849,priest,discipline,72,31,41
30260,Çhåosgòddess,kazzak,1848,priest,discipline,42,25,17
30261,Карпинчо,soulflayer,1848,priest,discipline,186,91,95
30262,Flensu,stormscale,1847,priest,discipline,94,54,40
30263,Shonsized,argent-dawn,1847,priest,discipline,154,88,66
30264,Çiione,archimonde,1847,priest,discipline,71,34,37
30265,Aédeira,blackhand,1847,priest,discipline,83,34,49
30266,Flokè,stormscale,1846,priest,discipline,42,26,16
30267,Andrë,ragnaros,1845,priest,discipline,46,29,17
30268,Malfredx,stormscale,1844,priest,discipline,33,21,12
30269,Soyloverjuan,auchindoun,1843,priest,discipline,52,27,25
30270,Аэтпио,soulflayer,1843,priest,discipline,126,64,62
30271,Bæsts,ravencrest,1842,priest,discipline,47,35,12
30272,Minilove,ravencrest,1842,priest,discipline,36,22,14
30273,Maulerion,tarren-mill,1842,priest,discipline,92,53,39
30274,Aiwass,twisting-nether,1842,priest,discipline,54,27,27
30275,Indîcâ,outland,1842,priest,discipline,72,33,39
30276,Kianprie,silvermoon,1842,priest,discipline,101,46,55
30277,Trolldý,outland,1841,priest,discipline,54,33,21
30278,Mend,tarren-mill,1841,priest,discipline,77,34,43
30279,Danglar,defias-brotherhood,1840,priest,discipline,102,58,44
30280,Луилэнс,howling-fjord,1840,priest,discipline,82,46,36
30281,Tacochrist,kazzak,1840,priest,discipline,168,90,78
30282,Bølzer,blackrock,1840,priest,discipline,360,180,180
30283,Twinkerz,ravencrest,1839,priest,discipline,114,70,44
30284,Kàrèm,blutkessel,1839,priest,discipline,48,28,20
30285,Shîn,zirkel-des-cenarius,1839,priest,discipline,72,32,40
30286,Втильте,blackscar,1838,priest,discipline,138,77,61
30287,Sheelah,ravencrest,1838,priest,discipline,66,32,34
30288,Kolerps,ravencrest,1838,priest,discipline,54,25,29
30289,Xíøn,draenor,1837,priest,discipline,48,28,20
30290,Fitu,drakthul,1837,priest,discipline,167,86,81
30291,Drlovke,stormscale,1837,priest,discipline,114,54,60
30292,Virulence,twisting-nether,1836,priest,discipline,223,124,99
30293,Aeogon,kazzak,1836,priest,discipline,179,79,100
30294,Nevercared,aegwynn,1835,priest,discipline,30,25,5
30295,Некронево,howling-fjord,1835,priest,discipline,51,30,21
30296,Indrades,blackmoore,1835,priest,discipline,54,31,23
30297,Xraid,blackmoore,1835,priest,discipline,62,35,27
30298,Trevorlahey,draenor,1835,priest,discipline,171,96,75
30299,Giatros,kazzak,1835,priest,discipline,89,48,41
30300,Видзар,blackscar,1834,priest,discipline,42,27,15
30301,Alwaysøøm,kazzak,1834,priest,discipline,120,77,43
30302,Níghty,ravencrest,1834,priest,discipline,48,28,20
30303,Смотривнебоь,soulflayer,1834,priest,discipline,194,103,91
30304,Gødsfåvørite,blackrock,1834,priest,discipline,264,140,124
30305,Luvdisc,ysondre,1834,priest,discipline,68,34,34
30306,Ксенонх,gordunni,1834,priest,discipline,66,30,36
30307,Touchmypink,ragnaros,1833,priest,discipline,246,119,127
30308,Azaciúx,sylvanas,1832,priest,discipline,48,29,19
30309,Feeqamikka,ragnaros,1832,priest,discipline,61,32,29
30310,Frida,blackrock,1832,priest,discipline,66,33,33
30311,Sazuki,sylvanas,1830,priest,discipline,119,71,48
30312,Discberg,kazzak,1830,priest,discipline,54,29,25
30313,Лизагодх,howling-fjord,1830,priest,discipline,306,161,145
30314,Kuusistöö,kazzak,1830,priest,discipline,110,57,53
30315,Stazqt,conseil-des-ombres,1830,priest,discipline,328,167,161
30316,Nasdaq,ravencrest,1830,priest,discipline,79,38,41
30317,Swiftdemise,sylvanas,1830,priest,discipline,202,97,105
30318,Kaizza,burning-legion,1829,priest,discipline,48,30,18
30319,Alusiepriest,ravencrest,1829,priest,discipline,164,102,62
30320,Chnechnechne,outland,1829,priest,discipline,58,35,23
30321,Qhub,sylvanas,1829,priest,discipline,225,123,102
30322,Minipõppy,ravencrest,1829,priest,discipline,250,132,118
30323,Aliciaiscute,ravencrest,1829,priest,discipline,52,27,25
30324,Bijaqt,blackmoore,1829,priest,discipline,54,27,27
30325,Akeno,sylvanas,1829,priest,discipline,70,31,39
30326,Pradrak,eredar,1828,priest,discipline,54,31,23
30327,Illuminarexo,sylvanas,1828,priest,discipline,145,82,63
30328,Chivalryy,argent-dawn,1828,priest,discipline,119,64,55
30329,Ingelosi,eredar,1828,priest,discipline,220,118,102
30330,Jconnelly,antonidas,1828,priest,discipline,62,32,30
30331,Itayyxd,doomhammer,1828,priest,discipline,66,34,32
30332,Poulet,sylvanas,1827,priest,discipline,52,30,22
30333,Blazingad,kazzak,1827,priest,discipline,173,93,80
30334,Fainttnt,stormscale,1827,priest,discipline,78,39,39
30335,Noelretsof,jaedenar,1827,priest,discipline,62,31,31
30336,Ltmp,ravencrest,1827,priest,discipline,48,24,24
30337,Whýççpèrx,ravencrest,1826,priest,discipline,60,33,27
30338,Nadøney,hyjal,1826,priest,discipline,172,87,85
30339,Nissha,stormscale,1826,priest,discipline,66,32,34
30340,Двачх,soulflayer,1826,priest,discipline,66,32,34
30341,Sinetrax,draenor,1825,priest,discipline,48,30,18
30342,Асверай,howling-fjord,1825,priest,discipline,90,55,35
30343,Theythem,stormscale,1825,priest,discipline,42,25,17
30344,Bebydaniwey,eredar,1825,priest,discipline,48,27,21
30345,Moglimeister,blackrock,1825,priest,discipline,72,40,32
30346,Myggsparv,stormscale,1825,priest,discipline,72,39,33
30347,Nothic,blackmoore,1825,priest,discipline,196,105,91
30348,Gimeurgold,destromath,1825,priest,discipline,66,32,34
30349,Chechenkata,ravencrest,1825,priest,discipline,57,27,30
30350,Undeathy,ravencrest,1825,priest,discipline,60,28,32
30351,Charlotten,shattered-hand,1825,priest,discipline,196,89,107
30352,Yourholynes,nemesis,1824,priest,discipline,39,24,15
30353,Ayõu,ravencrest,1824,priest,discipline,60,36,24
30354,Src,ravencrest,1824,priest,discipline,95,54,41
30355,Collinna,aegwynn,1824,priest,discipline,105,57,48
30356,Kirtarah,aegwynn,1824,priest,discipline,238,124,114
30357,Holó,stormscale,1824,priest,discipline,54,25,29
30358,Lanata,blackrock,1823,priest,discipline,60,34,26
30359,Мухаглот,soulflayer,1823,priest,discipline,71,37,34
30360,Sovereignp,aegwynn,1823,priest,discipline,60,28,32
30361,Cener,ravencrest,1822,priest,discipline,38,31,7
30362,Imahipstaqt,eredar,1822,priest,discipline,57,32,25
30363,Mamaa,stormscale,1822,priest,discipline,72,40,32
30364,Tecc,draenor,1822,priest,discipline,130,65,65
30365,Mèlindra,tarren-mill,1821,priest,discipline,35,28,7
30366,Билет,borean-tundra,1821,priest,discipline,42,26,16
30367,Aâraks,khaz-modan,1821,priest,discipline,134,82,52
30368,Tribz,kargath,1821,priest,discipline,36,22,14
30369,Traxtoor,tarren-mill,1821,priest,discipline,141,81,60
30370,Cyabish,twisting-nether,1821,priest,discipline,263,142,121
30371,Miklós,die-aldor,1821,priest,discipline,54,28,26
30372,Scaryolol,blackmoore,1821,priest,discipline,161,83,78
30373,Yamai,thrall,1820,priest,discipline,42,24,18
30374,Holyblóod,ravencrest,1820,priest,discipline,43,23,20
30375,Tingoess,silvermoon,1820,priest,discipline,150,75,75
30376,Dotzey,outland,1820,priest,discipline,101,43,58
30377,Yunusgødx,kazzak,1819,priest,discipline,102,65,37
30378,Силесттиль,gordunni,1819,priest,discipline,77,49,28
30379,Øk,draenor,1819,priest,discipline,125,73,52
30380,Омилая,gordunni,1819,priest,discipline,42,24,18
30381,Изишвд,gordunni,1819,priest,discipline,59,33,26
30382,Дорогасмеха,howling-fjord,1819,priest,discipline,66,36,30
30383,Felaenna,argent-dawn,1819,priest,discipline,139,75,64
30384,Ðês,ravencrest,1819,priest,discipline,120,62,58
30385,Ilovelily,antonidas,1819,priest,discipline,60,30,30
30386,Vibéz,outland,1819,priest,discipline,54,27,27
30387,Lucyx,antonidas,1818,priest,discipline,36,25,11
30388,Jaesabøyx,twisting-nether,1818,priest,discipline,168,100,68
30389,Kimspriest,ragnaros,1818,priest,discipline,42,24,18
30390,Dendegodx,kazzak,1818,priest,discipline,120,64,56
30391,Egi,lothar,1818,priest,discipline,51,27,24
30392,Cæsífer,senjin,1818,priest,discipline,78,41,37
30393,Monsterzx,outland,1818,priest,discipline,90,44,46
30394,Sakulus,malganis,1818,priest,discipline,66,31,35
30395,Spiritina,darkmoon-faire,1817,priest,discipline,76,52,24
30396,Lovdisc,ysondre,1817,priest,discipline,54,34,20
30397,Inhibitor,tarren-mill,1817,priest,discipline,48,29,19
30398,Holycuddles,ysondre,1817,priest,discipline,78,47,31
30399,Williamz,ravencrest,1817,priest,discipline,57,31,26
30400,Ashenflexj,draenor,1817,priest,discipline,226,115,111
30401,Ferpy,ragnaros,1817,priest,discipline,66,31,35
30402,Chekkó,blackrock,1817,priest,discipline,77,35,42
30403,Deadandugly,eredar,1817,priest,discipline,84,36,48
30404,Swd,dun-morogh,1816,priest,discipline,36,23,13
30405,Hanniri,archimonde,1816,priest,discipline,48,28,20
30406,Aenon,argent-dawn,1816,priest,discipline,129,72,57
30407,Fatalx,grim-batol,1816,priest,discipline,70,37,33
30408,Saygg,ysondre,1816,priest,discipline,120,63,57
30409,Yzïam,ravencrest,1816,priest,discipline,86,45,41
30410,Соникида,gordunni,1816,priest,discipline,76,39,37
30411,Nedex,thrall,1816,priest,discipline,55,28,27
30412,Semper,sylvanas,1816,priest,discipline,52,26,26
30413,Sebbi,ragnaros,1816,priest,discipline,60,29,31
30414,Thaeres,stormscale,1816,priest,discipline,65,31,34
30415,Оченьнеочень,howling-fjord,1816,priest,discipline,72,33,39
30416,Psychout,ravencrest,1816,priest,discipline,66,30,36
30417,Fandac,sylvanas,1815,priest,discipline,60,39,21
30418,Jowaba,ravencrest,1815,priest,discipline,60,38,22
30419,Milamati,kazzak,1815,priest,discipline,90,50,40
30420,Виллавелл,blackscar,1815,priest,discipline,48,24,24
30421,Løs,argent-dawn,1815,priest,discipline,108,53,55
30422,Skitspill,ravencrest,1815,priest,discipline,216,104,112
30423,Zyzx,blackrock,1815,priest,discipline,66,29,37
30424,Menarille,kazzak,1814,priest,discipline,30,25,5
30425,Jannejanne,ravencrest,1814,priest,discipline,30,19,11
30426,Анстахоуп,grom,1814,priest,discipline,192,121,71
30427,Йуп,ashenvale,1814,priest,discipline,52,32,20
30428,Bizqit,tarren-mill,1814,priest,discipline,311,168,143
30429,Awön,stormscale,1814,priest,discipline,58,31,27
30430,Discusting,anachronos,1814,priest,discipline,78,40,38
30431,Sdn,twisting-nether,1814,priest,discipline,118,60,58
30432,Syreet,silvermoon,1814,priest,discipline,428,216,212
30433,Mobcal,twisting-nether,1814,priest,discipline,66,28,38
30434,Daniweyy,eredar,1813,priest,discipline,30,19,11
30435,Dzyxx,ravencrest,1813,priest,discipline,66,37,29
30436,Iwariel,blackmoore,1813,priest,discipline,102,55,47
30437,Architectx,ravencrest,1813,priest,discipline,119,60,59
30438,Dhassy,sanguino,1812,priest,discipline,71,44,27
30439,Elataqt,silvermoon,1812,priest,discipline,91,51,40
30440,Viiu,eredar,1812,priest,discipline,45,25,20
30441,Eedazap,argent-dawn,1812,priest,discipline,58,32,26
30442,Discoqt,aegwynn,1812,priest,discipline,60,30,30
30443,Isalvation,stormscale,1812,priest,discipline,78,38,40
30444,Drillin,ravencrest,1812,priest,discipline,75,33,42
30445,Mïserygødx,nemesis,1811,priest,discipline,84,57,27
30446,Maxmoto,blackrock,1811,priest,discipline,92,56,36
30447,Антошашвп,azuregos,1811,priest,discipline,42,25,17
30448,Cæsifer,blackrock,1811,priest,discipline,100,55,45
30449,Leahuwu,ravencrest,1811,priest,discipline,72,37,35
30450,Miraña,kazzak,1810,priest,discipline,24,19,5
30451,Holyshiiet,stormscale,1810,priest,discipline,138,81,57
30452,Indulgence,eredar,1810,priest,discipline,57,30,27
30453,Gaussqt,ravencrest,1810,priest,discipline,120,62,58
30454,Xrq,stormscale,1809,priest,discipline,36,27,9
30455,Delftware,tarren-mill,1809,priest,discipline,36,27,9
30456,Thedisco,kazzak,1809,priest,discipline,84,56,28
30457,Abdcefgihljk,tarren-mill,1809,priest,discipline,48,27,21
30458,Leahx,dalvengyr,1809,priest,discipline,46,25,21
30459,Qzrx,draenor,1809,priest,discipline,84,44,40
30460,Kuxk,stormscale,1809,priest,discipline,48,24,24
30461,Fønss,sanguino,1809,priest,discipline,77,34,43
30462,Stola,archimonde,1809,priest,discipline,101,41,60
30463,Ohlinsqt,outland,1808,priest,discipline,66,36,30
30464,Уровеньб,soulflayer,1808,priest,discipline,114,60,54
30465,Prips,bladefist,1808,priest,discipline,223,117,106
30466,Aòo,twisting-nether,1808,priest,discipline,95,48,47
30467,Ellinha,tarren-mill,1808,priest,discipline,71,34,37
30468,Aprilfalls,blackmoore,1808,priest,discipline,54,25,29
30469,Chaxxpriest,blackrock,1808,priest,discipline,113,51,62
30470,Ðézø,twisting-nether,1807,priest,discipline,108,71,37
30471,Ÿolo,nemesis,1807,priest,discipline,80,47,33
30472,Вашачесть,gordunni,1807,priest,discipline,156,84,72
30473,Immortalled,twisting-nether,1807,priest,discipline,144,77,67
30474,Cucurulla,sanguino,1807,priest,discipline,90,47,43
30475,Raw,dragonblight,1807,priest,discipline,72,36,36
30476,Seasonf,tarren-mill,1807,priest,discipline,60,28,32
30477,Priestdos,sanguino,1806,priest,discipline,49,32,17
30478,Hexybtw,stormscale,1806,priest,discipline,30,19,11
30479,Zarahard,draenor,1806,priest,discipline,120,65,55
30480,Zeruhphin,eredar,1806,priest,discipline,54,28,26
30481,Lucksy,antonidas,1806,priest,discipline,60,31,29
30482,Karmev,twisting-nether,1806,priest,discipline,53,26,27
30483,Brigittë,ravencrest,1806,priest,discipline,66,29,37
30484,Jamienism,ravencrest,1806,priest,discipline,82,33,49
30485,Youngfade,twisting-nether,1806,priest,discipline,76,30,46
30486,Светжрец,blackscar,1805,priest,discipline,36,26,10
30487,Tattum,ragnaros,1805,priest,discipline,84,57,27
30488,Артфуул,howling-fjord,1805,priest,discipline,78,43,35
30489,Поршкаенн,gordunni,1805,priest,discipline,60,32,28
30490,Andaar,ravencrest,1805,priest,discipline,60,32,28
30491,Ipâ,hyjal,1805,priest,discipline,417,207,210
30492,Jeanprêtre,ysondre,1805,priest,discipline,66,30,36
30493,Neems,twisting-nether,1805,priest,discipline,42,19,23
30494,Ïcön,ravencrest,1804,priest,discipline,60,43,17
30495,Ljusmor,silvermoon,1804,priest,discipline,99,62,37
30496,Bennyjamin,kazzak,1804,priest,discipline,74,45,29
30497,Coldyxz,blackrock,1804,priest,discipline,48,29,19
30498,Floyyd,kazzak,1804,priest,discipline,42,24,18
30499,Шэдоура,gordunni,1804,priest,discipline,135,76,59
30500,Needsboorst,ravencrest,1804,priest,discipline,66,36,30
30501,Nooxid,eredar,1804,priest,discipline,159,86,73
30502,Rezzdar,lightnings-blade,1804,priest,discipline,121,62,59
30503,Remkoja,blackrock,1804,priest,discipline,102,52,50
30504,Altruistx,ravencrest,1804,priest,discipline,78,39,39
30505,Aêalama,argent-dawn,1804,priest,discipline,54,27,27
30506,Chochoo,argent-dawn,1804,priest,discipline,60,25,35
30507,Fogel,turalyon,1803,priest,discipline,96,82,14
30508,Laonar,silvermoon,1803,priest,discipline,181,115,66
30509,Frëija,ravencrest,1803,priest,discipline,59,37,22
30510,Lasêr,kazzak,1803,priest,discipline,133,73,60
30511,Kàalyx,archimonde,1803,priest,discipline,107,55,52
30512,Lunatique,shadowsong,1803,priest,discipline,56,28,28
30513,Gehrke,silvermoon,1803,priest,discipline,105,51,54
30514,Hamsicam,frostwolf,1803,priest,discipline,176,83,93
30515,Deoxx,kazzak,1803,priest,discipline,126,58,68
30516,Ebiso,ravencrest,1803,priest,discipline,90,41,49
30517,Assiduous,stormreaver,1802,priest,discipline,40,25,15
30518,Ronnyvandamm,destromath,1802,priest,discipline,136,78,58
30519,Bassepriest,tarren-mill,1802,priest,discipline,101,53,48
30520,Enteja,outland,1802,priest,discipline,898,456,442
30521,Jpucciù,ysondre,1802,priest,discipline,66,31,35
30522,Cx,mazrigos,1801,priest,discipline,65,42,23
30523,Shínx,illidan,1801,priest,discipline,90,52,38
30524,Rabbai,twisting-nether,1801,priest,discipline,66,37,29
30525,Батлджес,gordunni,1801,priest,discipline,54,29,25
30526,Reckxp,twisting-nether,1801,priest,discipline,114,52,62
30527,Зулфар,razuvious,1800,priest,discipline,48,36,12
30528,Wardshield,ravencrest,1800,priest,discipline,29,20,9
30529,Felwy,stormscale,1800,priest,discipline,48,31,17
30530,Hasnoaim,dun-morogh,1800,priest,discipline,66,41,25
30531,Doublefreak,draenor,1800,priest,discipline,78,48,30
30532,Soziy,silvermoon,1800,priest,discipline,33,19,14
30533,Wóllo,stormscale,1800,priest,discipline,66,36,30
30534,Mautiya,blackrock,1800,priest,discipline,96,52,44
30535,Mpßx,tarren-mill,1800,priest,discipline,39,21,18
30536,Enzineum,twisting-nether,1800,priest,discipline,54,28,26
30537,Zuniqa,die-aldor,1800,priest,discipline,221,112,109
30538,Cätälin,twisting-nether,1800,priest,discipline,386,195,191
30539,Некрогуро,gordunni,1800,priest,discipline,54,27,27
30540,Mafakor,ravencrest,1800,priest,discipline,357,176,181
30541,Lazyx,tarren-mill,1800,priest,discipline,59,29,30
30542,Mcdodgens,auchindoun,1800,priest,discipline,233,112,121
30543,Stahpit,twisting-nether,1800,priest,discipline,65,31,34
30544,Gothicpriest,blackrock,1799,priest,discipline,54,34,20
30545,Discisiipeli,sylvanas,1799,priest,discipline,72,42,30
30546,Prsx,ravencrest,1799,priest,discipline,126,63,63
30547,Cnqz,archimonde,1799,priest,discipline,78,36,42
30548,Jâde,bloodhoof,1798,priest,discipline,189,92,97
30549,Фенджидисплх,blackscar,1798,priest,discipline,114,54,60
30550,Dokwhite,blackrock,1797,priest,discipline,41,20,21
30551,Sùzy,ravencrest,1797,priest,discipline,72,30,42
30552,Alessana,antonidas,1796,priest,discipline,47,30,17
30553,Georgesheenx,ravencrest,1796,priest,discipline,190,90,100
30554,Seankingkong,ravencrest,1795,priest,discipline,37,23,14
30555,Siezlababo,blackrock,1795,priest,discipline,35,21,14
30556,Bigballer,stormscale,1795,priest,discipline,51,26,25
30557,Bandulskii,twisting-nether,1795,priest,discipline,409,205,204
30558,Sosûke,archimonde,1794,priest,discipline,54,33,21
30559,Keijunâ,ravencrest,1794,priest,discipline,41,21,20
30560,Nàlak,archimonde,1793,priest,discipline,72,34,38
30561,Сайдвиндер,blackscar,1792,priest,discipline,115,59,56
30562,Racecar,executus,1792,priest,discipline,144,71,73
30563,Ihefyehvjrm,ravencrest,1792,priest,discipline,113,55,58
30564,Lolylights,tarren-mill,1791,priest,discipline,216,109,107
30565,Owrly,bladefist,1789,priest,discipline,178,89,89
30566,Phyxiusx,stormscale,1788,priest,discipline,96,53,43
30567,Drillinx,tarren-mill,1788,priest,discipline,66,32,34
30568,Hopesallgone,stormscale,1787,priest,discipline,96,58,38
30569,Amtoxic,stormscale,1786,priest,discipline,467,239,228
30570,Alicanx,silvermoon,1785,priest,discipline,129,78,51
30571,Holyholy,stormscale,1784,priest,discipline,60,40,20
30572,Talbyslegacý,blackmoore,1784,priest,discipline,108,60,48
30573,Ssjfoxyo,sylvanas,1783,priest,discipline,119,57,62
30574,Maikzky,stormreaver,1780,priest,discipline,36,19,17
30575,Zèl,blackmoore,1780,priest,discipline,52,26,26
30576,Emryth,blackhand,1779,priest,discipline,294,152,142
30577,Trickyteè,tarren-mill,1779,priest,discipline,42,19,23
30578,Mindx,sylvanas,1777,priest,discipline,191,98,93
30579,Eliana,blackrock,1777,priest,discipline,151,77,74
30580,Stormmyy,kazzak,1777,priest,discipline,42,21,21
30581,Alexsmite,twisting-nether,1777,priest,discipline,41,19,22
30582,Lakeworth,argent-dawn,1776,priest,discipline,134,61,73
30583,Mndvx,sylvanas,1775,priest,discipline,140,70,70
30584,Tanly,outland,1774,priest,discipline,102,45,57
30585,Vespbruv,kazzak,1773,priest,discipline,36,25,11
30586,Wodpriest,ravencrest,1772,priest,discipline,30,20,10
30587,Hellhammer,stormreaver,1772,priest,discipline,154,82,72
30588,Андерприст,soulflayer,1772,priest,discipline,180,93,87
30589,Отклонен,soulflayer,1772,priest,discipline,66,32,34
30590,Tiphereth,blackmoore,1772,priest,discipline,48,23,25
30591,Gajos,frostwolf,1771,priest,discipline,108,63,45
30592,Леддигага,gordunni,1769,priest,discipline,48,27,21
30593,Ironqt,malfurion,1769,priest,discipline,136,61,75
30594,Jaytï,ravencrest,1766,priest,discipline,42,26,16
30595,Øpra,nemesis,1766,priest,discipline,60,31,29
30596,Magetrainer,tarren-mill,1765,priest,discipline,60,42,18
30597,Denunciation,argent-dawn,1765,priest,discipline,215,115,100
30598,Ohiofromntty,ravencrest,1764,priest,discipline,24,20,4
30599,Hyw,hyjal,1764,priest,discipline,39,22,17
30600,Swkunz,dun-modr,1764,priest,discipline,142,69,73
30601,Nameit,eredar,1763,priest,discipline,194,91,103
30602,Aridarpriest,silvermoon,1762,priest,discipline,86,37,49
30603,Aruna,ravencrest,1761,priest,discipline,70,35,35
30604,Ladderpolice,blackmoore,1761,priest,discipline,54,26,28
30605,Justdänce,hyjal,1760,priest,discipline,52,25,27
30606,Susaj,tarren-mill,1759,priest,discipline,41,23,18
30607,Spaanseslof,silvermoon,1759,priest,discipline,174,82,92
30608,Muncett,dun-modr,1758,priest,discipline,83,50,33
30609,Filthyzx,argent-dawn,1758,priest,discipline,54,27,27
30610,Legiondisc,blackmoore,1758,priest,discipline,157,71,86
30611,Rogeron,blackrock,1758,priest,discipline,100,45,55
30612,Aelisendi,draenor,1757,priest,discipline,83,46,37
30613,Sekker,silvermoon,1757,priest,discipline,303,161,142
30614,Bunnydisc,outland,1757,priest,discipline,77,37,40
30615,Mgx,defias-brotherhood,1756,priest,discipline,54,25,29
30616,Шкурюклады,gordunni,1756,priest,discipline,90,40,50
30617,Roshmanoff,stormscale,1755,priest,discipline,54,27,27
30618,Brilho,frostmane,1755,priest,discipline,183,90,93
30619,Dreifearfünf,arygos,1754,priest,discipline,90,50,40
30620,Duelistfied,blackrock,1754,priest,discipline,50,24,26
30621,Кирюшасэмпай,gordunni,1753,priest,discipline,117,63,54
30622,Khristo,illidan,1753,priest,discipline,84,36,48
30623,Dès,ravencrest,1752,priest,discipline,165,80,85
30624,ßçøûzýìñ,ravencrest,1751,priest,discipline,28,21,7
30625,Merylle,outland,1751,priest,discipline,41,27,14
30626,Jempi,argent-dawn,1751,priest,discipline,141,84,57
30627,Destinychild,norgannon,1751,priest,discipline,64,34,30
30628,Kîlo,sylvanas,1750,priest,discipline,42,19,23
30629,Ytsal,stormscale,1750,priest,discipline,60,24,36
30630,Isuckmattsd,aggramar,1749,priest,discipline,30,21,9
30631,Uo,kilrogg,1749,priest,discipline,128,73,55
30632,Healêl,sanguino,1749,priest,discipline,81,40,41
30633,Sdlman,nemesis,1749,priest,discipline,60,29,31
30634,Таравера,soulflayer,1748,priest,discipline,125,60,65
30635,Iloveilka,madmortem,1747,priest,discipline,29,19,10
30636,Holyblóod,kazzak,1747,priest,discipline,56,34,22
30637,Pikaboom,the-maelstrom,1747,priest,discipline,48,27,21
30638,Дъикиймвп,deepholm,1747,priest,discipline,48,24,24
30639,Kèvin,das-syndikat,1746,priest,discipline,89,54,35
30640,Devoura,sylvanas,1746,priest,discipline,48,23,25
30641,Mystz,dun-modr,1744,priest,discipline,63,34,29
30642,Rippertmepls,ravencrest,1744,priest,discipline,101,52,49
30643,Rngamer,silvermoon,1743,priest,discipline,30,23,7
30644,Ampara,thrall,1743,priest,discipline,102,52,50
30645,Ðårkìnlol,ravencrest,1741,priest,discipline,23,19,4
30646,Eliriya,thrall,1741,priest,discipline,290,148,142
30647,Alpháømegá,outland,1741,priest,discipline,88,40,48
30648,Abømination,hyjal,1740,priest,discipline,123,69,54
30649,Tricavla,frostmane,1740,priest,discipline,108,59,49
30650,Holytop,aegwynn,1740,priest,discipline,48,25,23
30651,Øxxgodx,blackrock,1740,priest,discipline,87,43,44
30652,Pâww,kazzak,1740,priest,discipline,54,26,28
30653,Savta,ravencrest,1740,priest,discipline,42,19,23
30654,Xeldrania,azshara,1739,priest,discipline,41,22,19
30655,Darktemplarx,magtheridon,1739,priest,discipline,165,83,82
30656,Lyrina,twisting-nether,1738,priest,discipline,364,199,165
30657,Ostrogami,silvermoon,1738,priest,discipline,525,255,270
30658,Massbimba,tarren-mill,1737,priest,discipline,289,161,128
30659,Антошашвп,gordunni,1737,priest,discipline,48,25,23
30660,Zërøx,ysondre,1737,priest,discipline,95,39,56
30661,Twizl,hyjal,1736,priest,discipline,90,47,43
30662,Holyasprin,sylvanas,1735,priest,discipline,72,44,28
30663,Фокусшвд,soulflayer,1735,priest,discipline,132,68,64
30664,Sydnex,blackmoore,1734,priest,discipline,77,45,32
30665,Sausageboy,tarren-mill,1734,priest,discipline,54,30,24
30666,Mommymilkrx,argent-dawn,1734,priest,discipline,251,125,126
30667,Spatzdom,malygos,1734,priest,discipline,53,25,28
30668,Aetas,hyjal,1732,priest,discipline,72,41,31
30669,Pieceoftrash,stormscale,1731,priest,discipline,77,42,35
30670,Lilypalmer,stormscale,1731,priest,discipline,72,36,36
30671,Jøjmenejøj,ravencrest,1731,priest,discipline,150,73,77
30672,Vigoria,stormreaver,1731,priest,discipline,101,49,52
30673,Tÿona,hyjal,1730,priest,discipline,176,101,75
30674,Mitha,tarren-mill,1730,priest,discipline,80,45,35
30675,Lobbygriefer,ravencrest,1730,priest,discipline,436,231,205
30676,Preme,blackhand,1730,priest,discipline,72,34,38
30677,Snuskong,kazzak,1730,priest,discipline,54,25,29
30678,Mamabeer,draenor,1727,priest,discipline,150,91,59
30679,Teradros,blackhand,1727,priest,discipline,53,28,25
30680,Pristern,tarren-mill,1727,priest,discipline,68,34,34
30681,Nihpolz,ragnaros,1726,priest,discipline,105,59,46
30682,Darkshdwbrst,malorne,1726,priest,discipline,271,148,123
30683,Zwu,antonidas,1726,priest,discipline,70,38,32
30684,Zoophobîa,stormscale,1726,priest,discipline,78,42,36
30685,Namîxoxo,ysondre,1726,priest,discipline,66,33,33
30686,Cedifanboyx,archimonde,1726,priest,discipline,66,33,33
30687,Gailiugà,kazzak,1725,priest,discipline,40,26,14
30688,Savagex,dun-modr,1725,priest,discipline,256,136,120
30689,Akzar,blackrock,1725,priest,discipline,450,230,220
30690,Roylian,ravencrest,1725,priest,discipline,45,23,22
30691,Noviriel,argent-dawn,1725,priest,discipline,94,47,47
30692,Felvytwo,stormscale,1725,priest,discipline,48,24,24
30693,Hoses,twisting-nether,1725,priest,discipline,211,104,107
30694,Keypo,khaz-modan,1725,priest,discipline,59,26,33
30695,Ranchikswp,ravencrest,1724,priest,discipline,30,18,12
30696,Rytmusqt,outland,1724,priest,discipline,42,20,22
30697,Lucìanà,blackmoore,1723,priest,discipline,30,18,12
30698,Mentaldeadp,draenor,1723,priest,discipline,147,88,59
30699,Paterfisl,ragnaros,1723,priest,discipline,72,41,31
30700,Alexpriest,twisting-nether,1723,priest,discipline,513,266,247
30701,Rickerstrike,stormscale,1723,priest,discipline,143,71,72
30702,Аскеронх,howling-fjord,1723,priest,discipline,87,41,46
30703,Xians,alakir,1722,priest,discipline,30,18,12
30704,Leåh,ravencrest,1722,priest,discipline,48,28,20
30705,Naivah,dun-modr,1722,priest,discipline,127,68,59
30706,Plsdontcry,blackrock,1722,priest,discipline,54,27,27
30707,Duqes,stormreaver,1721,priest,discipline,45,33,12
30708,Skevitche,hyjal,1721,priest,discipline,208,108,100
30709,Neliica,silvermoon,1721,priest,discipline,90,37,53
30710,Gwinzy,blackmoore,1720,priest,discipline,36,22,14
30711,Legitha,blackmoore,1720,priest,discipline,45,26,19
30712,Folelli,ysondre,1720,priest,discipline,113,58,55
30713,Utrd,kazzak,1720,priest,discipline,251,119,132
30714,Pinipom,kazzak,1719,priest,discipline,38,26,12
30715,Leffie,outland,1719,priest,discipline,51,26,25
30716,Cctw,archimonde,1718,priest,discipline,90,46,44
30717,Kekkonh,sylvanas,1718,priest,discipline,47,23,24
30718,Spodermen,ravencrest,1718,priest,discipline,54,25,29
30719,Holymoly,talnivarr,1718,priest,discipline,120,55,65
30720,Shdwxy,blackrock,1717,priest,discipline,90,53,37
30721,Milchzáhn,frostwolf,1717,priest,discipline,74,38,36
30722,Touddixz,blackrock,1716,priest,discipline,30,19,11
30723,Fuzzymerge,ravencrest,1716,priest,discipline,76,42,34
30724,Spìrít,ghostlands,1716,priest,discipline,48,24,24
30725,Smiteyoudown,blackrock,1716,priest,discipline,42,21,21
30726,Looney,shadowsong,1715,priest,discipline,36,25,11
30727,Pehmoinen,korgall,1715,priest,discipline,147,75,72
30728,Pestmorran,sylvanas,1715,priest,discipline,318,153,165
30729,Holysjodin,tarren-mill,1714,priest,discipline,36,18,18
30730,Zeröone,silvermoon,1714,priest,discipline,101,44,57
30731,Lowhealing,kazzak,1713,priest,discipline,48,29,19
30732,Lerdameur,arakarahm,1712,priest,discipline,155,78,77
30733,Baptized,baelgun,1712,priest,discipline,102,47,55
30734,Hannirï,archimonde,1711,priest,discipline,89,62,27
30735,Holyarnold,silvermoon,1710,priest,discipline,155,70,85
30736,Ðarkan,kaelthas,1709,priest,discipline,132,76,56
30737,Furtnajebany,tarren-mill,1709,priest,discipline,63,29,34
30738,Trashpriest,blackrock,1708,priest,discipline,47,19,28
30739,Kijhun,uldaman,1707,priest,discipline,72,40,32
30740,Bengtas,ravencrest,1707,priest,discipline,194,93,101
30741,Obie,exodar,1707,priest,discipline,46,19,27
30742,Scarylol,blackmoore,1706,priest,discipline,30,18,12
30743,Irefutåbil,stormscale,1706,priest,discipline,120,70,50
30744,Nyxoqtxd,ravencrest,1706,priest,discipline,94,54,40
30745,Uivi,azjolnerub,1706,priest,discipline,42,22,20
30746,Scarified,aggramar,1706,priest,discipline,72,36,36
30747,Patriamore,jaedenar,1706,priest,discipline,64,30,34
30748,Syntaria,pozzo-delleternità,1705,priest,discipline,48,28,20
30749,Finiskram,sylvanas,1705,priest,discipline,42,24,18
30750,Targolina,argent-dawn,1705,priest,discipline,417,214,203
30751,Fulgus,sanguino,1705,priest,discipline,254,127,127
30752,Krematorio,twisting-nether,1705,priest,discipline,36,18,18
30753,Yukasa,silvermoon,1705,priest,discipline,78,34,44
30754,Covidisc,outland,1705,priest,discipline,60,26,34
30755,Kaldhor,ysondre,1705,priest,discipline,71,29,42
30756,Sokratina,ragnaros,1704,priest,discipline,88,58,30
30757,Splf,blackrock,1704,priest,discipline,90,56,34
30758,Dállas,ravencrest,1704,priest,discipline,72,41,31
30759,Pleadz,tarren-mill,1704,priest,discipline,54,25,29
30760,Babibayle,arakarahm,1704,priest,discipline,60,24,36
30761,Lîke,shattrath,1703,priest,discipline,36,18,18
30762,Убикрофт,soulflayer,1703,priest,discipline,49,24,25
30763,Calling,nozdormu,1702,priest,discipline,65,37,28
30764,Bockx,ragnaros,1702,priest,discipline,66,27,39
30765,Anotu,tarren-mill,1701,priest,discipline,48,28,20
30766,Bekznfiend,ragnaros,1701,priest,discipline,48,22,26
30767,Noxr,ravencrest,1701,priest,discipline,68,28,40
30768,Kapts,twisting-nether,1700,priest,discipline,30,18,12
30769,Healbotmvp,ravencrest,1700,priest,discipline,42,24,18
30770,Nimb,blackrock,1700,priest,discipline,66,33,33
30771,Ðeep,archimonde,1700,priest,discipline,48,23,25
30772,Roxeal,archimonde,1699,priest,discipline,210,115,95
30773,Naphell,outland,1699,priest,discipline,108,54,54
30774,Nancey,draenor,1699,priest,discipline,36,18,18
30775,Verjin,kazzak,1699,priest,discipline,90,36,54
30776,Sîena,ravencrest,1698,priest,discipline,36,27,9
30777,Reticlel,kazzak,1698,priest,discipline,140,80,60
30778,Shieldyman,silvermoon,1698,priest,discipline,48,25,23
30779,Jämar,archimonde,1698,priest,discipline,60,29,31
30780,Закс,blackscar,1698,priest,discipline,48,22,26
30781,Dqt,ragnaros,1698,priest,discipline,71,31,40
30782,Areyqt,ravencrest,1697,priest,discipline,36,22,14
30783,Gòldfinger,norgannon,1697,priest,discipline,162,76,86
30784,Døppëlápfèl,tarren-mill,1696,priest,discipline,30,20,10
30785,Kahir,ravencrest,1696,priest,discipline,98,52,46
30786,Ssjx,ravencrest,1696,priest,discipline,48,25,23
30787,Kolinamenuss,dun-morogh,1696,priest,discipline,60,27,33
30788,Cptisus,draenor,1696,priest,discipline,72,31,41
30789,Mixoo,throkferoth,1696,priest,discipline,95,40,55
30790,Luckystar,grim-batol,1695,priest,discipline,102,54,48
30791,Fizzy,arthas,1695,priest,discipline,82,42,40
30792,Mezan,tarren-mill,1695,priest,discipline,71,36,35
30793,Swdommeil,aegwynn,1695,priest,discipline,48,24,24
30794,Mcdeady,tarren-mill,1695,priest,discipline,72,34,38
30795,Эвэргарден,eversong,1695,priest,discipline,108,45,63
30796,Mopriest,eredar,1694,priest,discipline,56,36,20
30797,Seemedotin,aegwynn,1694,priest,discipline,41,23,18
30798,Flào,draenor,1694,priest,discipline,42,20,22
30799,Angrypiex,stormscale,1694,priest,discipline,83,38,45
30800,Luxør,blackrock,1694,priest,discipline,42,18,24
30801,Arlekin,ravencrest,1693,priest,discipline,114,70,44
30802,Kyderr,blackrock,1693,priest,discipline,108,59,49
30803,Windywendy,blackrock,1693,priest,discipline,141,75,66
30804,Karanas,archimonde,1693,priest,discipline,66,34,32
30805,Сонясоукьют,gordunni,1693,priest,discipline,54,26,28
30806,Samaya,blackrock,1693,priest,discipline,147,68,79
30807,Yroe,gorgonnash,1693,priest,discipline,48,22,26
30808,Verweven,twisting-nether,1692,priest,discipline,47,26,21
30809,Kavrack,dalaran,1692,priest,discipline,41,22,19
30810,Pierrebourne,blackmoore,1692,priest,discipline,48,23,25
30811,Шаастраха,gordunni,1692,priest,discipline,97,44,53
30812,Rainbowroll,kazzak,1692,priest,discipline,52,23,29
30813,Xulgarath,silvermoon,1691,priest,discipline,52,35,17
30814,Shadowlander,dun-modr,1691,priest,discipline,87,46,41
30815,Nidetha,draenor,1691,priest,discipline,42,18,24
30816,Ayoutbt,ravencrest,1690,priest,discipline,48,24,24
30817,Lexìì,archimonde,1690,priest,discipline,36,18,18
30818,Alsalty,stormscale,1690,priest,discipline,65,26,39
30819,Шестьнадцать,gordunni,1689,priest,discipline,107,60,47
30820,Pixe,argent-dawn,1689,priest,discipline,66,27,39
30821,Eagrh,ravencrest,1688,priest,discipline,328,185,143
30822,Wérrýxs,kazzak,1688,priest,discipline,148,83,65
30823,Афганский,gordunni,1688,priest,discipline,46,24,22
30824,Прристуха,gordunni,1688,priest,discipline,66,27,39
30825,Hrtbrxkn,ravencrest,1687,priest,discipline,64,39,25
30826,Voidbone,stormscale,1687,priest,discipline,42,22,20
30827,Berseenreikä,the-venture-co,1687,priest,discipline,60,29,31
30828,Dorkama,silvermoon,1686,priest,discipline,30,18,12
30829,Kuraimb,the-maelstrom,1686,priest,discipline,81,38,43
30830,Dispelgodxx,eredar,1686,priest,discipline,60,27,33
30831,Zychopriest,antonidas,1686,priest,discipline,48,21,27
30832,Freddyprinze,ravencrest,1685,priest,discipline,87,50,37
30833,Seherbazqt,twisting-nether,1685,priest,discipline,177,90,87
30834,Wiguwigu,blackrock,1685,priest,discipline,66,26,40
30835,Mantra,blackmoore,1684,priest,discipline,294,146,148
30836,Hinorist,kazzak,1684,priest,discipline,154,74,80
30837,Traicklebron,antonidas,1683,priest,discipline,33,21,12
30838,Tabaç,stormscale,1683,priest,discipline,42,26,16
30839,Zzbleh,stormscale,1683,priest,discipline,96,53,43
30840,Пристижнаяя,gordunni,1683,priest,discipline,99,52,47
30841,Barackomana,blackrock,1683,priest,discipline,120,56,64
30842,Oscoolytb,archimonde,1683,priest,discipline,138,63,75
30843,Mythrixia,draenor,1682,priest,discipline,99,54,45
30844,Efeslol,dun-modr,1682,priest,discipline,214,107,107
30845,Doorix,nethersturm,1682,priest,discipline,68,31,37
30846,Prc,stormscale,1681,priest,discipline,60,41,19
30847,Jumpàxx,archimonde,1681,priest,discipline,48,22,26
30848,Blâdéira,ravencrest,1681,priest,discipline,141,64,77
30849,Marôs,antonidas,1681,priest,discipline,60,26,34
30850,Donipriest,ravencrest,1680,priest,discipline,72,42,30
30851,Deathgodx,archimonde,1680,priest,discipline,154,85,69
30852,Артжрец,soulflayer,1680,priest,discipline,82,45,37
30853,Swdommeil,blackrock,1680,priest,discipline,36,19,17
30854,Sheeash,kazzak,1679,priest,discipline,36,18,18
30855,Grouptherpst,draenor,1679,priest,discipline,294,141,153
30856,ßrûm,archimonde,1679,priest,discipline,48,23,25
30857,Goodra,sylvanas,1678,priest,discipline,36,23,13
30858,Junglemafia,nemesis,1678,priest,discipline,42,24,18
30859,Céira,malganis,1678,priest,discipline,42,23,19
30860,Anheduanna,outland,1678,priest,discipline,925,462,463
30861,Sloee,kazzak,1677,priest,discipline,42,24,18
30862,Майти,gordunni,1677,priest,discipline,172,98,74
30863,Assacine,aegwynn,1677,priest,discipline,65,35,30
30864,Шайтсунг,soulflayer,1677,priest,discipline,56,30,26
30865,Приствалера,howling-fjord,1677,priest,discipline,407,204,203
30866,Necronidas,burning-legion,1676,priest,discipline,97,53,44
30867,Clownspec,twisting-nether,1676,priest,discipline,54,26,28
30868,Holytopp,aegwynn,1675,priest,discipline,42,25,17
30869,Glyss,draenor,1675,priest,discipline,72,40,32
30870,Aloegarten,ravencrest,1675,priest,discipline,83,40,43
30871,Scarletstory,ravencrest,1675,priest,discipline,148,70,78
30872,Саммерфинн,gordunni,1675,priest,discipline,46,20,26
30873,Apuessii,dun-modr,1675,priest,discipline,83,36,47
30874,Файкахохо,soulflayer,1675,priest,discipline,59,24,35
30875,Kaksel,blackrock,1674,priest,discipline,120,62,58
30876,Meltmvp,thrall,1674,priest,discipline,66,33,33
30877,Уэйнестелл,booty-bay,1674,priest,discipline,54,24,30
30878,Geforcès,archimonde,1674,priest,discipline,113,45,68
30879,Разрухаовнз,gordunni,1673,priest,discipline,36,22,14
30880,Forcedtoheal,sylvanas,1673,priest,discipline,85,51,34
30881,Mèix,ysondre,1673,priest,discipline,72,42,30
30882,Scurrp,aegwynn,1673,priest,discipline,72,36,36
30883,Lorimac,dun-modr,1673,priest,discipline,195,97,98
30884,Awcute,kazzak,1673,priest,discipline,370,181,189
30885,Xianstwo,alakir,1673,priest,discipline,54,24,30
30886,Tmnetwo,ravencrest,1673,priest,discipline,42,18,24
30887,Ggbenis,ragnaros,1672,priest,discipline,42,23,19
30888,Devotedape,draenor,1672,priest,discipline,83,45,38
30889,Byef,kazzak,1671,priest,discipline,56,31,25
30890,Kæzm,blackrock,1671,priest,discipline,77,42,35
30891,Finalprayer,silvermoon,1670,priest,discipline,53,38,15
30892,Swoptoplong,blackhand,1670,priest,discipline,503,263,240
30893,Mysticmäc,aegwynn,1670,priest,discipline,66,33,33
30894,Сосиска,deathguard,1670,priest,discipline,41,20,21
30895,Csúforck,ragnaros,1669,priest,discipline,48,26,22
30896,Cestrial,sylvanas,1669,priest,discipline,104,55,49
30897,Psjk,blackrock,1669,priest,discipline,100,51,49
30898,Anbish,burning-legion,1668,priest,discipline,200,113,87
30899,Cultaken,kazzak,1668,priest,discipline,82,45,37
30900,Pokahonta,silvermoon,1668,priest,discipline,249,131,118
30901,Títarie,aegwynn,1668,priest,discipline,42,22,20
30902,Bilbobanging,aggramar,1668,priest,discipline,54,27,27
30903,Sologrifer,sylvanas,1668,priest,discipline,39,19,20
30904,Jarvinia,blackmoore,1668,priest,discipline,58,28,30
30905,Zzoska,burning-legion,1668,priest,discipline,83,40,43
30906,Lindvorm,tarren-mill,1667,priest,discipline,120,61,59
30907,Toxp,kazzak,1667,priest,discipline,178,85,93
30908,Hadis,tarren-mill,1667,priest,discipline,108,49,59
30909,Kevokko,silvermoon,1667,priest,discipline,54,23,31
30910,Maerlene,nemesis,1667,priest,discipline,74,31,43
30911,Blerd,eredar,1666,priest,discipline,46,27,19
30912,Мэдсанван,howling-fjord,1666,priest,discipline,209,116,93
30913,Kollis,twilights-hammer,1666,priest,discipline,243,123,120
30914,Coqa,blackrock,1666,priest,discipline,42,21,21
30915,Salvatíon,sanguino,1666,priest,discipline,236,105,131
30916,Plåtpriest,twisting-nether,1665,priest,discipline,46,35,11
30917,Trntypr,senjin,1665,priest,discipline,84,48,36
30918,Rêstlêss,blackrock,1665,priest,discipline,89,46,43
30919,Obbdasknob,ravencrest,1665,priest,discipline,100,51,49
30920,Tepevelf,dun-modr,1665,priest,discipline,324,156,168
30921,Азмоддан,azuregos,1665,priest,discipline,95,42,53
30922,Fsnx,sylvanas,1664,priest,discipline,40,26,14
30923,Gehrketwo,silvermoon,1664,priest,discipline,42,24,18
30924,Abudhabi,blackhand,1664,priest,discipline,409,206,203
30925,Yro,gorgonnash,1664,priest,discipline,54,24,30
30926,Фруктовыйса,gordunni,1663,priest,discipline,44,26,18
30927,Lymhk,blackrock,1663,priest,discipline,48,24,24
30928,Sinnestrike,tarren-mill,1663,priest,discipline,46,22,24
30929,Elsieexø,ravencrest,1663,priest,discipline,102,47,55
30930,Alahkazam,alakir,1663,priest,discipline,56,24,32
30931,Fäke,dunemaul,1662,priest,discipline,179,105,74
30932,Sikaanyo,blackhand,1662,priest,discipline,72,38,34
30933,Raesd,argent-dawn,1662,priest,discipline,82,42,40
30934,Dìsclol,draenor,1662,priest,discipline,55,28,27
30935,Enzysama,sanguino,1662,priest,discipline,91,45,46
30936,Ислейн,howling-fjord,1662,priest,discipline,59,24,35
30937,Twirlylocks,emerald-dream,1662,priest,discipline,47,18,29
30938,Malapriest,dalaran,1661,priest,discipline,66,38,28
30939,Syntara,twisting-nether,1661,priest,discipline,424,223,201
30940,Lethalhealz,outland,1661,priest,discipline,330,171,159
30941,Бонзайка,blackscar,1660,priest,discipline,53,25,28
30942,Алеброн,gordunni,1660,priest,discipline,54,25,29
30943,Wikpriest,ravencrest,1660,priest,discipline,58,26,32
30944,Ascendedpwnz,silvermoon,1659,priest,discipline,30,20,10
30945,Priewyn,ragnaros,1659,priest,discipline,299,156,143
30946,Krystynal,archimonde,1659,priest,discipline,47,24,23
30947,Xzep,archimonde,1659,priest,discipline,422,208,214
30948,Жентельмен,deathguard,1659,priest,discipline,96,41,55
30949,Менестрели,gordunni,1658,priest,discipline,303,172,131
30950,Athelsta,alleria,1658,priest,discipline,93,51,42
30951,Seranà,hyjal,1658,priest,discipline,96,51,45
30952,Yugemilkers,kazzak,1658,priest,discipline,131,66,65
30953,Pepeflex,draenor,1658,priest,discipline,119,59,60
30954,Ew,shattered-halls,1658,priest,discipline,58,26,32
30955,Phamy,antonidas,1657,priest,discipline,53,30,23
30956,Krottus,antonidas,1657,priest,discipline,53,28,25
30957,Krokkete,archimonde,1657,priest,discipline,36,19,17
30958,Вакариия,soulflayer,1657,priest,discipline,35,18,17
30959,Nocdsusage,draenor,1657,priest,discipline,214,107,107
30960,Gød,magtheridon,1657,priest,discipline,197,97,100
30961,Virdeo,aegwynn,1657,priest,discipline,54,26,28
30962,Notnowelf,silvermoon,1657,priest,discipline,54,22,32
30963,Splís,ravencrest,1657,priest,discipline,65,24,41
30964,Nyrziâ,archimonde,1656,priest,discipline,36,23,13
30965,Valadaris,outland,1656,priest,discipline,114,61,53
30966,Mald,ravencrest,1656,priest,discipline,108,57,51
30967,Niagarafalls,ragnaros,1656,priest,discipline,135,71,64
30968,Violentha,kazzak,1656,priest,discipline,232,118,114
30969,Healdeal,stormscale,1656,priest,discipline,280,140,140
30970,Drë,daggerspine,1656,priest,discipline,41,20,21
30971,Obnoxious,sunstrider,1656,priest,discipline,174,84,90
30972,Kaleycuoco,blackrock,1656,priest,discipline,78,36,42
30973,Wonderdispel,ragnaros,1656,priest,discipline,83,34,49
30974,Zsg,draenor,1655,priest,discipline,78,46,32
30975,Йефа,gordunni,1655,priest,discipline,60,32,28
30976,Beabanane,aegwynn,1655,priest,discipline,179,93,86
30977,Gurgaue,argent-dawn,1655,priest,discipline,94,42,52
30978,Фалд,gordunni,1654,priest,discipline,42,21,21
30979,Wasnezov,blackhand,1654,priest,discipline,82,39,43
30980,Prästmåns,tarren-mill,1654,priest,discipline,102,48,54
30981,Hexonite,burning-legion,1653,priest,discipline,42,25,17
30982,Bebwaz,kazzak,1653,priest,discipline,141,76,65
30983,Kavrack,sargeras,1653,priest,discipline,42,22,20
30984,Lowery,argent-dawn,1653,priest,discipline,48,22,26
30985,Zaak,kazzak,1653,priest,discipline,71,31,40
30986,Sutenör,kazzak,1653,priest,discipline,162,69,93
30987,Tygstycke,tarren-mill,1652,priest,discipline,24,18,6
30988,Nexìan,ravencrest,1652,priest,discipline,54,28,26
30989,Ðiiez,ysondre,1652,priest,discipline,85,40,45
30990,Tryhàrdx,stormscale,1652,priest,discipline,54,25,29
30991,Blackbertha,ravencrest,1652,priest,discipline,144,66,78
30992,Danina,outland,1651,priest,discipline,76,44,32
30993,Alesthion,silvermoon,1651,priest,discipline,110,62,48
30994,Danucd,ragnaros,1650,priest,discipline,206,124,82
30995,Неох,gordunni,1650,priest,discipline,54,29,25
30996,Pilgram,twilights-hammer,1650,priest,discipline,47,25,22
30997,Анклфрост,gordunni,1650,priest,discipline,54,24,30
30998,Dathanosp,outland,1649,priest,discipline,48,25,23
30999,Элишана,deathguard,1649,priest,discipline,111,54,57
31000,Chèéks,kazzak,1648,priest,discipline,72,43,29
31001,Gravebrain,draenor,1648,priest,discipline,226,112,114
31002,Пустотность,gordunni,1648,priest,discipline,351,172,179
31003,Joeelz,blackmoore,1647,priest,discipline,36,25,11
31004,Ðæððÿsgïrl,ravencrest,1647,priest,discipline,171,89,82
31005,Ahpøual,archimonde,1647,priest,discipline,180,89,91
31006,Sills,twisting-nether,1647,priest,discipline,53,23,30
31007,Følísh,hyjal,1646,priest,discipline,54,38,16
31008,Strawhât,eredar,1646,priest,discipline,53,31,22
31009,Tøxicboy,ravencrest,1646,priest,discipline,89,48,41
31010,Watchmedark,ravencrest,1646,priest,discipline,42,21,21
31011,Urizal,defias-brotherhood,1646,priest,discipline,36,18,18
31012,Yungblessing,stormscale,1646,priest,discipline,42,20,22
31013,Yzina,archimonde,1646,priest,discipline,48,21,27
31014,Drée,hyjal,1645,priest,discipline,48,24,24
31015,Qpapi,quelthalas,1645,priest,discipline,36,18,18
31016,Zyrean,bronzebeard,1645,priest,discipline,52,25,27
31017,Gødisc,blackrock,1644,priest,discipline,36,23,13
31018,Smitemachine,ysondre,1644,priest,discipline,33,19,14
31019,Rmt,darksorrow,1644,priest,discipline,42,23,19
31020,Feedergodx,dun-modr,1644,priest,discipline,42,21,21
31021,Vardogz,tirion,1644,priest,discipline,95,44,51
31022,Élsias,blackmoore,1644,priest,discipline,48,22,26
31023,Эридия,soulflayer,1643,priest,discipline,84,43,41
31024,Hwren,auchindoun,1643,priest,discipline,146,66,80
31025,Нед,greymane,1642,priest,discipline,297,160,137
31026,Shadowbread,tarren-mill,1642,priest,discipline,90,47,43
31027,Тыкофка,gordunni,1642,priest,discipline,224,108,116
31028,Cinnamoroll,ravencrest,1642,priest,discipline,54,26,28
31029,Kuqezi,archimonde,1641,priest,discipline,96,53,43
31030,Dyliz,stormscale,1641,priest,discipline,340,176,164
31031,Репабликуес,gordunni,1641,priest,discipline,36,18,18
31032,Babybeyle,arakarahm,1641,priest,discipline,107,48,59
31033,Xtracheesy,ragnaros,1640,priest,discipline,72,45,27
31034,Fluvnidi,ravencrest,1640,priest,discipline,66,38,28
31035,Prästbaazil,ragnaros,1640,priest,discipline,72,40,32
31036,Azrella,ravencrest,1640,priest,discipline,48,25,23
31037,Phucme,deathwing,1640,priest,discipline,54,23,31
31038,Cvp,twisting-nether,1640,priest,discipline,54,22,32
31039,Pentøs,archimonde,1639,priest,discipline,32,18,14
31040,Dapope,drakthul,1639,priest,discipline,47,20,27
31041,Vigodis,alleria,1638,priest,discipline,150,83,67
31042,Slimcharles,ravencrest,1638,priest,discipline,219,116,103
31043,Eliverax,outland,1638,priest,discipline,122,58,64
31044,Waaqa,outland,1638,priest,discipline,116,52,64
31045,Zanshin,ravencrest,1637,priest,discipline,29,18,11
31046,Painxd,stormscale,1637,priest,discipline,57,34,23
31047,Tuitio,blackmoore,1637,priest,discipline,83,46,37
31048,Discih,ragnaros,1637,priest,discipline,51,25,26
31049,Schlämpie,blackmoore,1637,priest,discipline,73,32,41
31050,Randmbare,nemesis,1636,priest,discipline,36,21,15
31051,Gepeitschter,frostwolf,1636,priest,discipline,250,130,120
31052,Voidtouched,drakthul,1636,priest,discipline,41,21,20
31053,Ванальная,soulflayer,1636,priest,discipline,42,21,21
31054,Milania,ravencrest,1636,priest,discipline,118,57,61
31055,Mohammedx,tarren-mill,1636,priest,discipline,125,58,67
31056,Klugzy,silvermoon,1636,priest,discipline,60,22,38
31057,Nintendó,sylvanas,1635,priest,discipline,90,46,44
31058,Yûnalescá,blackmoore,1634,priest,discipline,82,44,38
31059,Eluveitieq,kazzak,1634,priest,discipline,166,87,79
31060,Аая,blackscar,1634,priest,discipline,96,49,47
31061,Wraithtrippz,stormscale,1634,priest,discipline,210,105,105
31062,Echonic,aegwynn,1634,priest,discipline,231,113,118
31063,Emopunkgodx,draenor,1633,priest,discipline,94,58,36
31064,Sickboy,nordrassil,1633,priest,discipline,46,26,20
31065,Eyecry,sylvanas,1633,priest,discipline,93,49,44
31066,Giggí,malganis,1633,priest,discipline,95,48,47
31067,Anzee,tarren-mill,1633,priest,discipline,72,35,37
31068,Acidrops,hyjal,1633,priest,discipline,54,25,29
31069,Yameru,stormreaver,1633,priest,discipline,60,22,38
31070,Misántropo,dun-modr,1632,priest,discipline,59,38,21
31071,Симпоз,howling-fjord,1632,priest,discipline,92,44,48
31072,Yungmazikeen,archimonde,1631,priest,discipline,24,17,7
31073,Babywayn,onyxia,1631,priest,discipline,194,105,89
31074,Uppiediscyo,ravencrest,1631,priest,discipline,545,282,263
31075,Nooway,kazzak,1631,priest,discipline,108,55,53
31076,Snutz,draenor,1631,priest,discipline,42,21,21
31077,Ankus,tarren-mill,1631,priest,discipline,48,23,25
31078,Freezeage,stormscale,1630,priest,discipline,48,29,19
31079,Elvibeast,twisting-nether,1630,priest,discipline,42,21,21
31080,Choron,kult-der-verdammten,1630,priest,discipline,107,50,57
31081,Burnesenbois,chogall,1630,priest,discipline,47,18,29
31082,Лютаяшиза,gordunni,1629,priest,discipline,83,51,32
31083,Kolinamenus,dun-morogh,1629,priest,discipline,142,73,69
31084,Onaltnoqs,silvermoon,1629,priest,discipline,46,22,24
31085,Frojka,outland,1629,priest,discipline,42,19,23
31086,Superdude,stormscale,1629,priest,discipline,59,26,33
31087,Japral,blackhand,1628,priest,discipline,36,25,11
31088,Reäzx,archimonde,1628,priest,discipline,90,57,33
31089,Réquell,twisting-nether,1628,priest,discipline,42,24,18
31090,Såra,ravencrest,1628,priest,discipline,110,53,57
31091,Leviakerman,blackrock,1628,priest,discipline,42,18,24
31092,Estelle,silvermoon,1627,priest,discipline,72,47,25
31093,Sølvfox,stormscale,1627,priest,discipline,42,25,17
31094,Bambus,shattered-hand,1627,priest,discipline,48,28,20
31095,Garbins,stormscale,1627,priest,discipline,42,24,18
31096,Lauriinda,culte-de-la-rive-noire,1627,priest,discipline,219,113,106
31097,Pshan,blackmoore,1627,priest,discipline,188,96,92
31098,Женяшилд,howling-fjord,1627,priest,discipline,221,112,109
31099,Krazuk,theradras,1627,priest,discipline,54,27,27
31100,Нз,soulflayer,1627,priest,discipline,47,23,24
31101,Kaiikoo,ravencrest,1627,priest,discipline,36,17,19
31102,Brutalmaze,archimonde,1627,priest,discipline,36,17,19
31103,Karmasmom,kazzak,1627,priest,discipline,48,21,27
31104,Aleluia,alonsus,1627,priest,discipline,99,43,56
31105,Aldebrand,dun-modr,1627,priest,discipline,66,27,39
31106,Epa,zuljin,1626,priest,discipline,54,32,22
31107,Tylér,stormscale,1626,priest,discipline,90,52,38
31108,Skaliq,tarren-mill,1626,priest,discipline,201,108,93
31109,Тоориал,howling-fjord,1626,priest,discipline,72,38,34
31110,Inoru,stormreaver,1626,priest,discipline,198,104,94
31111,Хомие,soulflayer,1626,priest,discipline,85,44,41
31112,Chrïskz,archimonde,1626,priest,discipline,66,23,43
31113,Discxqt,ysondre,1625,priest,discipline,83,51,32
31114,Asgà,stormscale,1625,priest,discipline,30,17,13
31115,Wiwzi,outland,1625,priest,discipline,84,43,41
31116,Простосори,gordunni,1625,priest,discipline,540,267,273
31117,Luziaa,outland,1625,priest,discipline,83,41,42
31118,Chabih,ravencrest,1625,priest,discipline,54,23,31
31119,Betatasty,dalaran,1624,priest,discipline,24,17,7
31120,Labadudala,aegwynn,1624,priest,discipline,84,54,30
31121,Garsdal,tarren-mill,1624,priest,discipline,78,43,35
31122,Hâlez,antonidas,1624,priest,discipline,410,212,198
31123,Darktheu,sanguino,1624,priest,discipline,39,20,19
31124,Znàdix,silvermoon,1624,priest,discipline,252,128,124
31125,Alicewhydel,blackhand,1624,priest,discipline,46,23,23
31126,Deazypriest,blackrock,1624,priest,discipline,42,19,23
31127,Farae,arathor,1624,priest,discipline,44,19,25
31128,Iyannà,blackrock,1623,priest,discipline,36,24,12
31129,Spbosse,aszune,1623,priest,discipline,54,33,21
31130,Artist,outland,1623,priest,discipline,30,17,13
31131,Kedrack,draenor,1623,priest,discipline,78,41,37
31132,Yîrâ,antonidas,1623,priest,discipline,227,114,113
31133,Cnqx,archimonde,1623,priest,discipline,48,21,27
31134,Nelielto,stormscale,1622,priest,discipline,28,21,7
31135,Djleffe,stormscale,1622,priest,discipline,39,23,16
31136,Systerstål,twisting-nether,1622,priest,discipline,124,72,52
31137,Mnu,blackrock,1622,priest,discipline,52,30,22
31138,Lerión,ravencrest,1622,priest,discipline,108,62,46
31139,Мплехибои,gordunni,1622,priest,discipline,54,30,24
31140,Feed,burning-legion,1622,priest,discipline,84,45,39
31141,Gûardianwisp,ravencrest,1622,priest,discipline,223,117,106
31142,Кролс,gordunni,1622,priest,discipline,42,22,20
31143,Grimdream,ragnaros,1622,priest,discipline,206,105,101
31144,Waffur,twisting-nether,1622,priest,discipline,47,23,24
31145,Двелегитоп,howling-fjord,1621,priest,discipline,36,23,13
31146,Zinzor,archimonde,1621,priest,discipline,61,37,24
31147,Eyesønyou,nemesis,1621,priest,discipline,33,19,14
31148,Sicarium,aegwynn,1621,priest,discipline,102,56,46
31149,Babybelle,arakarahm,1621,priest,discipline,61,33,28
31150,Sotriggered,sylvanas,1621,priest,discipline,36,17,19
31151,Mindfiend,stormscale,1621,priest,discipline,81,37,44
31152,Dêmôn,stormscale,1620,priest,discipline,24,17,7
31153,Pewpewpew,krasus,1620,priest,discipline,42,29,13
31154,Fuzzybae,ravencrest,1620,priest,discipline,72,38,34
31155,Veryfine,draenor,1620,priest,discipline,106,52,54
31156,Shallteár,doomhammer,1620,priest,discipline,192,94,98
31157,Soloqbob,kazzak,1620,priest,discipline,48,22,26
31158,Outtloor,twisting-nether,1619,priest,discipline,39,25,14
31159,Wifta,ravencrest,1619,priest,discipline,54,30,24
31160,Roxxes,kazzak,1619,priest,discipline,42,23,19
31161,Szelén,ragnaros,1619,priest,discipline,54,29,25
31162,Eyllise,ragnaros,1619,priest,discipline,419,217,202
31163,Nadoreille,hyjal,1619,priest,discipline,253,131,122
31164,Dnsxx,thrall,1619,priest,discipline,890,453,437
31165,Llamamepadre,dun-modr,1619,priest,discipline,84,42,42
31166,Quïzzler,ragnaros,1619,priest,discipline,47,23,24
31167,Naripriest,eredar,1619,priest,discipline,48,22,26
31168,Melord,thunderhorn,1618,priest,discipline,44,27,17
31169,Yoii,nemesis,1618,priest,discipline,64,38,26
31170,Mønsterx,kazzak,1618,priest,discipline,64,37,27
31171,Atothéèx,outland,1618,priest,discipline,48,26,22
31172,Deathblind,blackmoore,1618,priest,discipline,36,17,19
31173,Medipack,khaz-modan,1617,priest,discipline,54,38,16
31174,Stargal,blackmoore,1617,priest,discipline,30,21,9
31175,Биркох,blackscar,1617,priest,discipline,101,67,34
31176,Prost,aerie-peak,1617,priest,discipline,71,47,24
31177,Neverlandx,bladefist,1617,priest,discipline,52,30,22
31178,Hamati,blackhand,1617,priest,discipline,138,77,61
31179,Worldgamer,blackrock,1617,priest,discipline,142,69,73
31180,Ödriaell,the-venture-co,1617,priest,discipline,150,72,78
31181,Asherá,kazzak,1617,priest,discipline,94,41,53
31182,Mikeypi,laughing-skull,1616,priest,discipline,36,25,11
31183,Isweariheal,twisting-nether,1616,priest,discipline,58,37,21
31184,Hötchick,outland,1616,priest,discipline,198,103,95
31185,Xaey,ravencrest,1616,priest,discipline,234,119,115
31186,Saniss,tarren-mill,1616,priest,discipline,78,39,39
31187,Интенси,gordunni,1616,priest,discipline,119,59,60
31188,Рнкх,lich-king,1616,priest,discipline,46,21,25
31189,Binder,tarren-mill,1616,priest,discipline,60,26,34
31190,Krolox,blackhand,1616,priest,discipline,60,25,35
31191,Ñíò,archimonde,1615,priest,discipline,48,27,21
31192,Èightsix,draenor,1615,priest,discipline,161,88,73
31193,Softie,zuljin,1615,priest,discipline,120,65,55
31194,Wencis,kazzak,1615,priest,discipline,96,50,46
31195,Naberus,ragnaros,1615,priest,discipline,73,38,35
31196,Deepsea,kazzak,1615,priest,discipline,473,233,240
31197,Supemi,stormscale,1615,priest,discipline,42,18,24
31198,Mythasz,archimonde,1615,priest,discipline,52,21,31
31199,Woodywoodpkr,senjin,1614,priest,discipline,94,55,39
31200,Absôlutvôdka,twisting-nether,1614,priest,discipline,66,37,29
31201,Jmp,tarren-mill,1614,priest,discipline,40,21,19
31202,Feardotexe,frostwolf,1614,priest,discipline,163,82,81
31203,Parzivál,argent-dawn,1614,priest,discipline,122,58,64
31204,Cøvu,draenor,1613,priest,discipline,39,25,14
31205,Gnzysan,blackrock,1613,priest,discipline,66,39,27
31206,Appuesi,dun-modr,1613,priest,discipline,30,17,13
31207,Shyria,argent-dawn,1613,priest,discipline,91,47,44
31208,Carnegi,burning-legion,1613,priest,discipline,170,86,84
31209,Jp,gorgonnash,1613,priest,discipline,42,21,21
31210,Swdjack,blackrock,1613,priest,discipline,192,92,100
31211,Zýgzäg,hyjal,1613,priest,discipline,172,81,91
31212,Louiepr,outland,1613,priest,discipline,54,22,32
31213,Burningheatx,kazzak,1612,priest,discipline,71,47,24
31214,Nwo,twisting-nether,1612,priest,discipline,36,23,13
31215,Purplex,aggra-português,1612,priest,discipline,42,23,19
31216,Няжик,azuregos,1612,priest,discipline,66,33,33
31217,Cptatonement,draenor,1612,priest,discipline,60,30,30
31218,Xoxogg,burning-blade,1611,priest,discipline,108,69,39
31219,Matwucss,outland,1611,priest,discipline,48,28,20
31220,Verminous,ravencrest,1611,priest,discipline,68,38,30
31221,Shadowboness,twisting-nether,1611,priest,discipline,58,31,27
31222,Xaeroow,archimonde,1611,priest,discipline,49,26,23
31223,Ecg,silvermoon,1611,priest,discipline,48,23,25
31224,Диспайзх,gordunni,1611,priest,discipline,204,97,107
31225,Taslight,stormscale,1610,priest,discipline,60,40,20
31226,Judgementdaý,kazzak,1610,priest,discipline,30,20,10
31227,Sosabgd,azjolnerub,1610,priest,discipline,36,20,16
31228,Lavendertown,tarren-mill,1610,priest,discipline,92,47,45
31229,Jibrael,draenor,1610,priest,discipline,84,40,44
31230,Viu,eredar,1610,priest,discipline,51,22,29
31231,Rylpriest,blackmoore,1609,priest,discipline,36,21,15
31232,Holyshiz,stormrage,1609,priest,discipline,42,24,18
31233,Kdot,drakthul,1609,priest,discipline,86,48,38
31234,Vregoa,twisting-nether,1609,priest,discipline,89,49,40
31235,Fazzy,nagrand,1609,priest,discipline,76,41,35
31236,Türsteherxxl,mannoroth,1608,priest,discipline,36,21,15
31237,Tremrfinger,dun-modr,1608,priest,discipline,104,60,44
31238,Dotreveal,ravencrest,1608,priest,discipline,113,58,55
31239,Fakecats,sargeras,1608,priest,discipline,51,22,29
31240,Monataamis,kazzak,1608,priest,discipline,47,20,27
31241,Mightnáre,tarren-mill,1607,priest,discipline,36,21,15
31242,Suxino,stormscale,1607,priest,discipline,264,149,115
31243,Zehakky,tarren-mill,1607,priest,discipline,151,85,66
31244,Шмэтар,gordunni,1607,priest,discipline,48,25,23
31245,Aurosa,argent-dawn,1607,priest,discipline,123,64,59
31246,Cizer,kazzak,1607,priest,discipline,116,57,59
31247,Zloyvrach,ravencrest,1607,priest,discipline,126,60,66
31248,Fricia,zuljin,1606,priest,discipline,82,45,37
31249,Solaçe,antonidas,1606,priest,discipline,48,26,22
31250,Stampo,draenor,1606,priest,discipline,75,35,40
31251,Дардж,blackscar,1605,priest,discipline,24,17,7
31252,Anabølixx,ravencrest,1605,priest,discipline,36,23,13
31253,Dtpe,kazzak,1605,priest,discipline,93,59,34
31254,Føxy,emerald-dream,1605,priest,discipline,41,23,18
31255,Tárget,frostwolf,1605,priest,discipline,48,22,26
31256,Shadowfishey,grim-batol,1605,priest,discipline,76,33,43
31257,Tritíana,blackrock,1604,priest,discipline,192,110,82
31258,Flurri,tarren-mill,1604,priest,discipline,160,91,69
31259,Voleck,aegwynn,1604,priest,discipline,30,17,13
31260,Saénna,burning-legion,1604,priest,discipline,44,22,22
31261,Zofiiee,tarren-mill,1604,priest,discipline,80,38,42
31262,Artì,kazzak,1604,priest,discipline,119,55,64
31263,Lizka,kazzak,1604,priest,discipline,96,43,53
31264,Thejambura,ragnaros,1603,priest,discipline,116,71,45
31265,Ostberger,twisting-nether,1603,priest,discipline,227,130,97
31266,Tiragosaure,arakarahm,1603,priest,discipline,48,26,22
31267,Mcdced,archimonde,1603,priest,discipline,90,45,45
31268,Troedelsuppe,destromath,1603,priest,discipline,282,130,152
31269,Хилботгодикс,borean-tundra,1602,priest,discipline,42,32,10
31270,Iløvelena,ravencrest,1602,priest,discipline,39,23,16
31271,Zurlyne,ravencrest,1602,priest,discipline,39,22,17
31272,Хеликси,gordunni,1602,priest,discipline,235,127,108
31273,Horrðr,kazzak,1602,priest,discipline,108,58,50
31274,Cadierna,argent-dawn,1602,priest,discipline,42,19,23
31275,Flygar,outland,1602,priest,discipline,60,27,33
31276,Jackboss,draenor,1602,priest,discipline,74,31,43
31277,Märlborö,aggra-português,1602,priest,discipline,66,26,40
31278,Jhaazx,nemesis,1601,priest,discipline,233,124,109
31279,Ashuramaru,drakthul,1601,priest,discipline,47,24,23
31280,Мастди,ashenvale,1601,priest,discipline,41,20,21
31281,Smitebone,tarren-mill,1601,priest,discipline,90,40,50
31282,Киллус,ashenvale,1601,priest,discipline,72,29,43
31283,Lgbtgodx,archimonde,1600,priest,discipline,61,45,16
31284,Discipleotl,stormscale,1600,priest,discipline,95,61,34
31285,Ellfle,kazzak,1600,priest,discipline,42,26,16
31286,Trì,thrall,1600,priest,discipline,35,20,15
31287,Dêrbómbêr,guldan,1600,priest,discipline,54,30,24
31288,Sinîra,frostwolf,1600,priest,discipline,110,59,51
31289,Darkprist,sanguino,1600,priest,discipline,66,34,32
31290,Старлайтх,gordunni,1600,priest,discipline,35,18,17
31291,Shalvy,aegwynn,1600,priest,discipline,218,111,107
31292,Xangha,burning-legion,1600,priest,discipline,264,133,131
31293,Mirupriest,sanguino,1600,priest,discipline,42,20,22
31294,Foh,antonidas,1600,priest,discipline,36,17,19
31295,Shento,blackhand,1600,priest,discipline,48,21,27
31296,Marícanqt,tarren-mill,1599,priest,discipline,30,23,7
31297,Tashziehn,blackrock,1599,priest,discipline,123,65,58
31298,Géèk,alakir,1599,priest,discipline,100,52,48
31299,Blindmymind,malganis,1599,priest,discipline,87,44,43
31300,Целитель,gordunni,1599,priest,discipline,86,43,43
31301,Спсчтоживой,blackscar,1598,priest,discipline,108,57,51
31302,Norganp,die-aldor,1598,priest,discipline,124,64,60
31303,Srakabot,burning-legion,1598,priest,discipline,140,70,70
31304,Raffá,blackhand,1597,priest,discipline,98,43,55
31305,Sebikpri,ravencrest,1596,priest,discipline,60,34,26
31306,Cav,archimonde,1596,priest,discipline,137,70,67
31307,Fancytrash,ravencrest,1596,priest,discipline,94,41,53
31308,Баблби,soulflayer,1596,priest,discipline,169,73,96
31309,Alèxy,tarren-mill,1596,priest,discipline,48,19,29
31310,Dush,draenor,1595,priest,discipline,56,31,25
31311,Faintly,emeriss,1595,priest,discipline,48,23,25
31312,Эскирия,gordunni,1595,priest,discipline,48,17,31
31313,Cylantharia,eredar,1594,priest,discipline,135,69,66
31314,Légít,argent-dawn,1594,priest,discipline,102,43,59
31315,Haakon,tarren-mill,1593,priest,discipline,30,17,13
31316,Døgfîsh,stormscale,1593,priest,discipline,78,41,37
31317,Øbz,sylvanas,1593,priest,discipline,78,34,44
31318,Padisonfire,blackmoore,1593,priest,discipline,48,19,29
31319,Серью,booty-bay,1592,priest,discipline,47,28,19
31320,Bercxu,ragnaros,1592,priest,discipline,105,53,52
31321,Badorange,kazzak,1592,priest,discipline,59,29,30
31322,Бэнжэминг,gordunni,1592,priest,discipline,101,43,58
31323,Exoduz,stormscale,1591,priest,discipline,353,177,176
31324,Priestqt,kelthuzad,1590,priest,discipline,57,31,26
31325,Farnese,archimonde,1590,priest,discipline,395,212,183
31326,Holycrapx,chromaggus,1589,priest,discipline,117,60,57
31327,Armward,twisting-nether,1588,priest,discipline,34,25,9
31328,Ичисанчик,howling-fjord,1588,priest,discipline,30,17,13
31329,Yuuvi,ravencrest,1588,priest,discipline,216,117,99
31330,Oecgreg,ysondre,1588,priest,discipline,76,41,35
31331,Walkmydome,twisting-nether,1588,priest,discipline,168,83,85
31332,Arvonpenaali,defias-brotherhood,1587,priest,discipline,42,25,17
31333,Yassjr,archimonde,1587,priest,discipline,50,25,25
31334,Hodgins,bloodscalp,1587,priest,discipline,36,18,18
31335,Vänskap,kazzak,1587,priest,discipline,132,65,67
31336,Gobblestick,draenor,1587,priest,discipline,47,21,26
31337,Yugata,archimonde,1587,priest,discipline,112,50,62
31338,Darknun,aggra-português,1587,priest,discipline,65,29,36
31339,Astralscare,outland,1586,priest,discipline,133,77,56
31340,Polymonkey,stormscale,1586,priest,discipline,41,17,24
31341,Toba,hellscream,1585,priest,discipline,113,65,48
31342,Aphroditê,blackrock,1585,priest,discipline,40,22,18
31343,Intentoso,nemesis,1585,priest,discipline,42,21,21
31344,Sahorie,archimonde,1584,priest,discipline,141,82,59
31345,Copperpriest,draenor,1584,priest,discipline,74,38,36
31346,Fatherlou,outland,1584,priest,discipline,42,21,21
31347,Skynoxx,ragnaros,1584,priest,discipline,114,56,58
31348,Dreythan,stormrage,1584,priest,discipline,74,33,41
31349,Terno,sylvanas,1583,priest,discipline,438,220,218
31350,Interrupted,kazzak,1583,priest,discipline,120,57,63
31351,Omgitshuux,blackmoore,1583,priest,discipline,66,31,35
31352,Rankoneprazt,stormscale,1583,priest,discipline,83,38,45
31353,Соулвардинг,soulflayer,1583,priest,discipline,60,26,34
31354,Buan,blackmoore,1582,priest,discipline,98,58,40
31355,Logath,archimonde,1582,priest,discipline,30,17,13
31356,Lekken,kazzak,1582,priest,discipline,69,36,33
31357,Xaerroow,archimonde,1581,priest,discipline,36,23,13
31358,Амберис,gordunni,1581,priest,discipline,54,27,27
31359,Чилюнахиле,gordunni,1581,priest,discipline,71,23,48
31360,Rhæveth,ravencrest,1580,priest,discipline,36,22,14
31361,Slikjar,stormscale,1580,priest,discipline,58,24,34
31362,Twosugars,sylvanas,1579,priest,discipline,144,74,70
31363,Ínsäníty,outland,1578,priest,discipline,36,27,9
31364,Holineß,burning-blade,1578,priest,discipline,84,51,33
31365,Toiga,lightnings-blade,1578,priest,discipline,48,29,19
31366,Psíquica,sanguino,1578,priest,discipline,45,23,22
31367,Riptile,outland,1578,priest,discipline,70,33,37
31368,Saturno,chogall,1578,priest,discipline,54,21,33
31369,Tâmshi,dun-modr,1577,priest,discipline,54,26,28
31370,Maccz,hyjal,1577,priest,discipline,68,32,36
31371,Keryin,draenor,1577,priest,discipline,156,63,93
31372,Макимасама,gordunni,1576,priest,discipline,49,26,23
31373,Флафика,deathguard,1575,priest,discipline,78,45,33
31374,Skyløl,dun-modr,1575,priest,discipline,36,19,17
31375,Вилайф,galakrond,1575,priest,discipline,76,40,36
31376,Botstyleswdx,ravencrest,1575,priest,discipline,190,88,102
31377,Angelofdeàth,kazzak,1574,priest,discipline,132,76,56
31378,Tifa,ravencrest,1574,priest,discipline,119,65,54
31379,Leyasu,eredar,1574,priest,discipline,57,31,26
31380,Limeslayerx,veklor,1574,priest,discipline,48,26,22
31381,Avaichquirit,tarren-mill,1574,priest,discipline,130,70,60
31382,Goky,kazzak,1574,priest,discipline,36,18,18
31383,Люблюкофе,deathguard,1574,priest,discipline,89,44,45
31384,Xîz,silvermoon,1574,priest,discipline,72,34,38
31385,Olurin,rajaxx,1574,priest,discipline,78,30,48
31386,Фотосз,soulflayer,1573,priest,discipline,35,19,16
31387,Ptrspriest,twisting-nether,1573,priest,discipline,207,101,106
31388,Aia,tyrande,1573,priest,discipline,88,41,47
31389,Biophyzix,aegwynn,1573,priest,discipline,41,18,23
31390,Остроухх,howling-fjord,1572,priest,discipline,132,73,59
31391,Amysantiàgo,sylvanas,1572,priest,discipline,163,87,76
31392,Foobi,the-maelstrom,1572,priest,discipline,409,215,194
31393,Nyarlatothep,boulderfist,1572,priest,discipline,148,77,71
31394,Alterlight,twisting-nether,1572,priest,discipline,352,169,183
31395,Smilézz,eredar,1572,priest,discipline,132,59,73
31396,Jpjp,gorgonnash,1571,priest,discipline,47,34,13
31397,Acrio,die-ewige-wacht,1571,priest,discipline,78,39,39
31398,Nzothapostle,baelgun,1571,priest,discipline,249,115,134
31399,Licktheheal,outland,1570,priest,discipline,54,31,23
31400,Deadwen,stormscale,1570,priest,discipline,252,139,113
31401,Miikkap,blackhand,1570,priest,discipline,60,29,31
31402,Макстин,howling-fjord,1570,priest,discipline,179,85,94
31403,Bubbelchên,blackhand,1570,priest,discipline,72,32,40
31404,Wâneis,stormscale,1569,priest,discipline,65,38,27
31405,Holysheett,magtheridon,1569,priest,discipline,102,58,44
31406,Alinone,uldum,1569,priest,discipline,99,53,46
31407,Valfore,eldrethalas,1569,priest,discipline,58,31,27
31408,Hèmera,tichondrius,1568,priest,discipline,55,41,14
31409,Pipperxp,ravencrest,1568,priest,discipline,48,31,17
31410,Ripperdepip,magtheridon,1568,priest,discipline,213,120,93
31411,Piperxp,ravencrest,1568,priest,discipline,48,24,24
31412,Dreê,hyjal,1568,priest,discipline,42,19,23
31413,Yënâs,hyjal,1567,priest,discipline,109,63,46
31414,Southyz,stormscale,1566,priest,discipline,111,61,50
31415,Snusprällen,sylvanas,1566,priest,discipline,65,31,34
31416,Denyz,blackrock,1566,priest,discipline,54,21,33
31417,Этотьмадетка,howling-fjord,1565,priest,discipline,42,26,16
31418,Aternia,draenor,1565,priest,discipline,89,48,41
31419,Spirítbox,argent-dawn,1565,priest,discipline,213,114,99
31420,Rizzlerx,blackmoore,1564,priest,discipline,66,40,26
31421,Whattson,colinas-pardas,1564,priest,discipline,35,17,18
31422,Hopepriest,magtheridon,1564,priest,discipline,42,20,22
31423,Выдокбля,soulflayer,1563,priest,discipline,34,25,9
31424,Redøm,stormreaver,1563,priest,discipline,42,23,19
31425,Yacine,blackrock,1563,priest,discipline,126,60,66
31426,Alicanx,twisting-nether,1563,priest,discipline,84,37,47
31427,Zackshock,sanguino,1563,priest,discipline,66,23,43
31428,Unfaker,drakthul,1562,priest,discipline,36,23,13
31429,Марабудх,soulflayer,1562,priest,discipline,104,57,47
31430,Ranevskiy,kazzak,1562,priest,discipline,189,96,93
31431,Pvpalt,argent-dawn,1562,priest,discipline,69,33,36
31432,Шатолюгран,soulflayer,1561,priest,discipline,124,73,51
31433,Veltrag,sanguino,1560,priest,discipline,60,34,26
31434,Raezi,defias-brotherhood,1560,priest,discipline,196,105,91
31435,Lurri,tarren-mill,1560,priest,discipline,150,79,71
31436,Cpzach,tarren-mill,1560,priest,discipline,82,39,43
31437,Zlejkadlec,drakthul,1559,priest,discipline,103,59,44
31438,Рвотка,gordunni,1559,priest,discipline,124,68,56
31439,Aêbi,dalaran,1558,priest,discipline,48,28,20
31440,Eördög,ragnaros,1558,priest,discipline,96,54,42
31441,Luuña,ravencrest,1558,priest,discipline,179,98,81
31442,Ftiersp,ravencrest,1558,priest,discipline,48,21,27
31443,Daddydisc,tarren-mill,1557,priest,discipline,34,18,16
31444,Dreamscapez,tarren-mill,1557,priest,discipline,67,35,32
31445,Lishado,twisting-nether,1557,priest,discipline,96,49,47
31446,Олдмэнсэйд,soulflayer,1557,priest,discipline,134,68,66
31447,Shielddanke,blackmoore,1557,priest,discipline,84,40,44
31448,Пальтишко,howling-fjord,1557,priest,discipline,96,45,51
31449,Raawri,blackmoore,1557,priest,discipline,54,24,30
31450,Валифа,gordunni,1556,priest,discipline,68,41,27
31451,Lïnkz,kazzak,1556,priest,discipline,72,41,31
31452,Tamy,draenor,1556,priest,discipline,62,33,29
31453,Enimao,tarren-mill,1556,priest,discipline,55,29,26
31454,Träskfarfar,tarren-mill,1556,priest,discipline,42,20,22
31455,Ecrisis,twisting-nether,1556,priest,discipline,128,57,71
31456,Ivÿx,ravencrest,1556,priest,discipline,89,38,51
31457,Darkprofit,aegwynn,1555,priest,discipline,137,71,66
31458,Mojmir,drakthul,1555,priest,discipline,66,32,34
31459,Vhim,hyjal,1555,priest,discipline,52,24,28
31460,Khrtp,silvermoon,1555,priest,discipline,48,22,26
31461,Fearadelia,thrall,1554,priest,discipline,24,18,6
31462,Priestin,dun-modr,1554,priest,discipline,35,20,15
31463,Cathocrasty,draenor,1554,priest,discipline,123,69,54
31464,Eßola,silvermoon,1554,priest,discipline,88,44,44
31465,Frednshield,tarren-mill,1554,priest,discipline,69,34,35
31466,Mustatomi,stormreaver,1554,priest,discipline,39,17,22
31467,Rher,blackmoore,1553,priest,discipline,85,52,33
31468,Sháady,ravencrest,1553,priest,discipline,78,41,37
31469,Senosaurus,tarren-mill,1553,priest,discipline,84,43,41
31470,Рэйкар,razuvious,1553,priest,discipline,65,33,32
31471,Khâléd,kazzak,1553,priest,discipline,36,17,19
31472,Juggster,bloodhoof,1552,priest,discipline,174,91,83
31473,Cresellia,twisting-nether,1552,priest,discipline,170,81,89
31474,Deathspren,stormscale,1552,priest,discipline,42,19,23
31475,Расспутана,howling-fjord,1551,priest,discipline,320,158,162
31476,Soraal,argent-dawn,1551,priest,discipline,79,39,40
31477,Redpriestess,kazzak,1550,priest,discipline,41,24,17
31478,Надийя,gordunni,1550,priest,discipline,132,74,58
31479,Korzec,dun-modr,1550,priest,discipline,108,57,51
31480,Jandice,blackrock,1550,priest,discipline,36,18,18
31481,Zastyx,drakthul,1550,priest,discipline,42,20,22
31482,Xaerah,blackmoore,1549,priest,discipline,78,41,37
31483,Nêlumar,aegwynn,1549,priest,discipline,82,42,40
31484,Arkkinunna,outland,1549,priest,discipline,124,59,65
31485,Колдрексх,deathguard,1549,priest,discipline,72,31,41
31486,Paìnz,blackhand,1548,priest,discipline,80,48,32
31487,Олегстразза,howling-fjord,1548,priest,discipline,207,104,103
31488,Húlda,auchindoun,1548,priest,discipline,48,24,24
31489,Sctheal,outland,1548,priest,discipline,75,37,38
31490,Runekpriest,tarren-mill,1548,priest,discipline,51,25,26
31491,Sonics,antonidas,1548,priest,discipline,66,31,35
31492,Delarus,perenolde,1547,priest,discipline,72,47,25
31493,Arima,kargath,1547,priest,discipline,74,36,38
31494,Aclass,outland,1547,priest,discipline,92,44,48
31495,Máv,tarren-mill,1546,priest,discipline,64,42,22
31496,Anarame,silvermoon,1546,priest,discipline,45,24,21
31497,Èzì,burning-legion,1546,priest,discipline,173,89,84
31498,Poonies,silvermoon,1546,priest,discipline,124,61,63
31499,Numi,blackmoore,1545,priest,discipline,163,94,69
31500,Alphabreyf,tarren-mill,1545,priest,discipline,83,43,40
31501,Trénboloné,tarren-mill,1545,priest,discipline,90,44,46
31502,Rezzurrectum,doomhammer,1545,priest,discipline,105,51,54
31503,Dîablø,eredar,1545,priest,discipline,99,45,54
31504,Pandalulz,turalyon,1544,priest,discipline,93,55,38
31505,Aasgard,frostwolf,1544,priest,discipline,90,46,44
31506,Disillusíon,tarren-mill,1544,priest,discipline,144,70,74
31507,Diszi,norgannon,1544,priest,discipline,58,28,30
31508,Jesuispasbon,hyjal,1543,priest,discipline,30,17,13
31509,Kitanai,silvermoon,1543,priest,discipline,54,29,25
31510,Arjak,stormscale,1543,priest,discipline,41,20,21
31511,Mêmphìs,twisting-nether,1543,priest,discipline,83,38,45
31512,Алуан,blackscar,1543,priest,discipline,66,23,43
31513,Блексебет,soulflayer,1542,priest,discipline,148,80,68
31514,Admiration,eredar,1542,priest,discipline,47,23,24
31515,Батямелднул,blackscar,1541,priest,discipline,60,36,24
31516,Mtbalt,tarren-mill,1541,priest,discipline,120,71,49
31517,Gingerflexay,archimonde,1541,priest,discipline,36,21,15
31518,Bublelicious,silvermoon,1541,priest,discipline,90,48,42
31519,Ojh,defias-brotherhood,1541,priest,discipline,48,22,26
31520,Tjat,silvermoon,1540,priest,discipline,66,34,32
31521,Whiskie,twisting-nether,1540,priest,discipline,60,30,30
31522,Psi,hakkar,1540,priest,discipline,36,18,18
31523,Grzmocillaa,burning-legion,1540,priest,discipline,54,26,28
31524,Шарадин,gordunni,1539,priest,discipline,157,86,71
31525,Lahammy,kazzak,1539,priest,discipline,68,36,32
31526,Vicwix,draenor,1539,priest,discipline,53,27,26
31527,Keyfear,kazzak,1539,priest,discipline,87,44,43
31528,Grautesk,chogall,1539,priest,discipline,48,23,25
31529,Влажныйшп,soulflayer,1538,priest,discipline,66,37,29
31530,Grêy,dun-modr,1538,priest,discipline,65,34,31
31531,Джахия,soulflayer,1537,priest,discipline,307,161,146
31532,Scodây,blackmoore,1537,priest,discipline,278,143,135
31533,Ptsd,argent-dawn,1537,priest,discipline,96,46,50
31534,Natapriest,antonidas,1536,priest,discipline,266,145,121
31535,Styilepriest,twisting-nether,1536,priest,discipline,36,18,18
31536,Treen,silvermoon,1535,priest,discipline,110,60,50
31537,Saintpri,twisting-nether,1535,priest,discipline,96,52,44
31538,Hérune,outland,1535,priest,discipline,80,41,39
31539,Chamelthoe,the-maelstrom,1535,priest,discipline,114,54,60
31540,Yuukii,kult-der-verdammten,1535,priest,discipline,36,17,19
31541,Goblex,hyjal,1535,priest,discipline,63,28,35
31542,Майндоф,howling-fjord,1534,priest,discipline,60,34,26
31543,Discomacka,twisting-nether,1534,priest,discipline,48,26,22
31544,Obeng,tarren-mill,1534,priest,discipline,30,16,14
31545,Íhðly,silvermoon,1534,priest,discipline,102,54,48
31546,Pmh,kazzak,1534,priest,discipline,120,60,60
31547,Марина,howling-fjord,1534,priest,discipline,54,23,31
31548,Tinre,ravenholdt,1533,priest,discipline,48,23,25
31549,Voidsnitch,antonidas,1533,priest,discipline,96,44,52
31550,Remlos,der-rat-von-dalaran,1532,priest,discipline,72,35,37
31551,Valnor,pozzo-delleternità,1532,priest,discipline,57,27,30
31552,Mysticforces,silvermoon,1532,priest,discipline,78,34,44
31553,Zxèlá,tarren-mill,1531,priest,discipline,59,37,22
31554,Володябигуди,howling-fjord,1531,priest,discipline,64,36,28
31555,Sebekklawl,wrathbringer,1531,priest,discipline,97,52,45
31556,Фыбра,soulflayer,1531,priest,discipline,30,16,14
31557,Elämäntypy,stormscale,1531,priest,discipline,120,60,60
31558,Wiildsy,tarren-mill,1531,priest,discipline,53,24,29
31559,Ectria,ravencrest,1531,priest,discipline,54,22,32
31560,Glaedahr,blackmoore,1531,priest,discipline,66,26,40
31561,Asmodeux,alakir,1530,priest,discipline,24,19,5
31562,Амбракадабра,blackscar,1530,priest,discipline,36,26,10
31563,Psnextxp,eredar,1530,priest,discipline,87,51,36
31564,Tutoress,stormscale,1530,priest,discipline,48,23,25
31565,Swallowship,twisting-nether,1530,priest,discipline,36,16,20
31566,Remkojatwo,blackrock,1529,priest,discipline,30,16,14
31567,Onelovexx,thrall,1529,priest,discipline,60,28,32
31568,Nevor,nemesis,1528,priest,discipline,124,57,67
31569,Prioheal,hyjal,1527,priest,discipline,78,44,34
31570,Ohbenji,ravencrest,1527,priest,discipline,140,67,73
31571,Nightreaver,argent-dawn,1526,priest,discipline,63,35,28
31572,Mautijr,blackrock,1526,priest,discipline,302,158,144
31573,Discgodx,ravencrest,1526,priest,discipline,60,31,29
31574,Kyseki,ravencrest,1526,priest,discipline,496,253,243
31575,Eleatros,blackrock,1526,priest,discipline,106,52,54
31576,Sethp,hyjal,1525,priest,discipline,30,21,9
31577,Huffinctus,tarren-mill,1525,priest,discipline,112,59,53
31578,Shînnøk,silvermoon,1525,priest,discipline,141,74,67
31579,Gotikaa,blackrock,1525,priest,discipline,96,50,46
31580,Kamiyasa,blackmoore,1525,priest,discipline,139,71,68
31581,Данягантеля,gordunni,1525,priest,discipline,42,21,21
31582,Sørcedote,dun-modr,1525,priest,discipline,36,16,20
31583,Nurbanu,ravencrest,1524,priest,discipline,77,49,28
31584,Skylar,xavius,1524,priest,discipline,48,29,19
31585,Enoriya,blackrock,1524,priest,discipline,259,140,119
31586,Zoe,aegwynn,1523,priest,discipline,213,112,101
31587,Chôrdi,aegwynn,1523,priest,discipline,154,76,78
31588,Виспх,eversong,1523,priest,discipline,269,120,149
31589,Jackyz,tarren-mill,1523,priest,discipline,60,21,39
31590,Raeratwo,archimonde,1522,priest,discipline,30,16,14
31591,Юлих,booty-bay,1522,priest,discipline,160,80,80
31592,Lythi,eredar,1522,priest,discipline,118,52,66
31593,Deadthicc,hyjal,1521,priest,discipline,50,33,17
31594,Árî,dun-modr,1521,priest,discipline,141,77,64
31595,Prästpojken,frostwhisper,1521,priest,discipline,137,65,72
31596,Yonkerz,frostmane,1521,priest,discipline,222,104,118
31597,Nightsøul,ragnaros,1520,priest,discipline,30,19,11
31598,Êvîlêvê,blackmoore,1520,priest,discipline,76,47,29
31599,Chocoly,tarren-mill,1520,priest,discipline,98,52,46
31600,Drxz,twilights-hammer,1520,priest,discipline,46,24,22
31601,Evõmax,sylvanas,1520,priest,discipline,304,157,147
31602,Mamis,anetheron,1520,priest,discipline,48,22,26
31603,Benau,aegwynn,1519,priest,discipline,60,38,22
31604,Dalylla,aggra-português,1519,priest,discipline,100,55,45
31605,Lilpi,rexxar,1519,priest,discipline,105,56,49
31606,Hateyeleison,burning-legion,1519,priest,discipline,72,34,38
31607,Effectx,ravencrest,1519,priest,discipline,90,42,48
31608,Durmadanbas,ravencrest,1518,priest,discipline,51,28,23
31609,Badhêalz,aegwynn,1518,priest,discipline,109,55,54
31610,Трихоманиаз,ashenvale,1518,priest,discipline,48,23,25
31611,Greyanna,twisting-nether,1518,priest,discipline,42,20,22
31612,Phasmöphobia,zuljin,1518,priest,discipline,150,70,80
31613,Freaki,blackrock,1517,priest,discipline,48,28,20
31614,Lemontea,frostwolf,1517,priest,discipline,48,27,21
31615,Gojó,outland,1517,priest,discipline,57,25,32
31616,Babloche,archimonde,1516,priest,discipline,48,27,21
31617,Bornxgood,kazzak,1516,priest,discipline,42,18,24
31618,Utsuro,stormscale,1515,priest,discipline,42,22,20
31619,Tinypump,silvermoon,1514,priest,discipline,29,17,12
31620,Гоплзнекст,gordunni,1514,priest,discipline,30,16,14
31621,Lukéy,silvermoon,1514,priest,discipline,66,33,33
31622,Burnex,thrall,1514,priest,discipline,108,53,55
31623,Blackbox,burning-legion,1514,priest,discipline,175,84,91
31624,Hiddenhealz,blackrock,1514,priest,discipline,60,25,35
31625,Mêduse,ravencrest,1514,priest,discipline,69,23,46
31626,Papkalácss,hellfire,1513,priest,discipline,32,19,13
31627,Ticklypriest,outland,1513,priest,discipline,30,17,13
31628,Colèy,blackhand,1513,priest,discipline,168,90,78
31629,Kratzîgel,blackmoore,1512,priest,discipline,120,69,51
31630,Mindfreakxx,twisting-nether,1512,priest,discipline,42,24,18
31631,Erupyks,archimonde,1512,priest,discipline,36,18,18
31632,Helalolsun,archimonde,1512,priest,discipline,97,48,49
31633,Nerfpriest,tarren-mill,1512,priest,discipline,156,76,80
31634,Buerak,tarren-mill,1511,priest,discipline,34,20,14
31635,Ciri,die-aldor,1511,priest,discipline,31,18,13
31636,Golletz,twisting-nether,1511,priest,discipline,84,48,36
31637,Aestina,silvermoon,1511,priest,discipline,120,58,62
31638,Blazekk,sylvanas,1511,priest,discipline,127,56,71
31639,Shkzz,hyjal,1510,priest,discipline,36,26,10
31640,Kirchhoffina,die-nachtwache,1510,priest,discipline,43,23,20
31641,Axxul,blackrock,1510,priest,discipline,36,18,18
31642,Опрометчивый,soulflayer,1510,priest,discipline,42,19,23
31643,Pumpkin,aggramar,1509,priest,discipline,30,19,11
31644,Aéríthx,ravencrest,1509,priest,discipline,153,78,75
31645,Johen,terenas,1509,priest,discipline,144,72,72
31646,Goldgot,tarren-mill,1509,priest,discipline,42,20,22
31647,Фриерли,howling-fjord,1508,priest,discipline,30,21,9
31648,Ledania,aegwynn,1508,priest,discipline,37,25,12
31649,Knazh,twisting-nether,1508,priest,discipline,36,20,16
31650,Dairox,blackrock,1508,priest,discipline,130,72,58
31651,Arkatina,outland,1508,priest,discipline,70,38,32
31652,Ethaz,twisting-nether,1508,priest,discipline,30,16,14
31653,Axla,stormscale,1508,priest,discipline,59,29,30
31654,Gulch,blackmoore,1508,priest,discipline,84,40,44
31655,Mjamc,stormscale,1508,priest,discipline,129,60,69
31656,Лоео,ashenvale,1508,priest,discipline,60,26,34
31657,Crims,twisting-nether,1507,priest,discipline,108,62,46
31658,Anyndra,twisting-nether,1507,priest,discipline,42,24,18
31659,Healicious,teldrassil,1507,priest,discipline,30,16,14
31660,Kurt,blackrock,1507,priest,discipline,136,66,70
31661,Zealtron,darksorrow,1507,priest,discipline,47,19,28
31662,Winnever,dun-modr,1506,priest,discipline,314,169,145
31663,Edoran,ragnaros,1506,priest,discipline,115,59,56
31664,Апититька,soulflayer,1506,priest,discipline,126,64,62
31665,Исусиприст,deepholm,1506,priest,discipline,42,20,22
31666,Safemode,ravencrest,1505,priest,discipline,47,25,22
31667,Celiara,argent-dawn,1505,priest,discipline,160,85,75
31668,Смайтвайфу,howling-fjord,1505,priest,discipline,54,27,27
31669,Altargirl,defias-brotherhood,1505,priest,discipline,36,17,19
31670,Mortarz,ragnaros,1505,priest,discipline,71,31,40
31671,Dench,azjolnerub,1505,priest,discipline,60,25,35
31672,Derylium,kazzak,1504,priest,discipline,63,42,21
31673,Getötet,blackrock,1504,priest,discipline,78,47,31
31674,Jumperlawl,khaz-modan,1504,priest,discipline,54,30,24
31675,Akemmì,sylvanas,1504,priest,discipline,162,82,80
31676,Аферона,soulflayer,1504,priest,discipline,48,24,24
31677,Makemyday,dun-modr,1504,priest,discipline,76,36,40
31678,Supernal,twisting-nether,1504,priest,discipline,72,34,38
31679,Nomorelight,stormscale,1503,priest,discipline,157,88,69
31680,Heilerharry,blackmoore,1503,priest,discipline,34,19,15
31681,Antainis,silvermoon,1503,priest,discipline,185,99,86
31682,Cinri,argent-dawn,1503,priest,discipline,247,118,129
31683,Jamii,kazzak,1502,priest,discipline,95,62,33
31684,Tansk,stormscale,1502,priest,discipline,204,107,97
31685,Тэтэшник,ashenvale,1502,priest,discipline,200,104,96
31686,Мэдмод,gordunni,1502,priest,discipline,142,64,78
31687,Sundæ,antonidas,1502,priest,discipline,42,18,24
31688,Maskinjundre,bronzebeard,1502,priest,discipline,51,21,30
31689,Fartsponge,ragnaros,1501,priest,discipline,31,17,14
31690,Makesnosense,kilrogg,1501,priest,discipline,60,31,29
31691,Kobri,gilneas,1501,priest,discipline,126,65,61
31692,Watchmedeath,sargeras,1501,priest,discipline,43,21,22
31693,Laërhia,archimonde,1501,priest,discipline,98,44,54
31694,Nextvbestapp,ravencrest,1501,priest,discipline,42,18,24
31695,Sickwill,blackrock,1500,priest,discipline,52,29,23
31696,Мьюсх,deathguard,1500,priest,discipline,77,42,35
31697,Cúrt,sanguino,1500,priest,discipline,60,29,31
31698,Sláin,outland,1500,priest,discipline,221,106,115
31699,Nahni,teldrassil,1500,priest,discipline,211,97,114
31700,Dreamhatcher,deathwing,1500,priest,discipline,42,18,24
31701,Elwing,darkmoon-faire,1500,priest,discipline,48,18,30
31702,Bromine,twisting-nether,1499,priest,discipline,39,29,10
31703,Cursedme,blackrock,1499,priest,discipline,42,24,18
31704,Ræpriestx,ragnaros,1499,priest,discipline,117,66,51
31705,Anaqt,silvermoon,1499,priest,discipline,317,160,157
31706,Noobpriest,blackrock,1499,priest,discipline,118,56,62
31707,Dìsc,ravencrest,1499,priest,discipline,78,37,41
31708,Архиэрей,soulflayer,1499,priest,discipline,51,24,27
31709,Ixdeadxl,stormscale,1498,priest,discipline,79,48,31
31710,Bloodie,drakthul,1498,priest,discipline,30,18,12
31711,Мненосина,goldrinn,1498,priest,discipline,58,28,30
31712,Пэрдёж,howling-fjord,1498,priest,discipline,35,16,19
31713,Deki,outland,1498,priest,discipline,60,27,33
31714,Diarolz,sanguino,1497,priest,discipline,81,46,35
31715,Luznywiesiek,burning-legion,1496,priest,discipline,36,22,14
31716,Энвиньяттар,howling-fjord,1496,priest,discipline,60,33,27
31717,Холиблэк,blackscar,1496,priest,discipline,36,16,20
31718,Massasax,kazzak,1495,priest,discipline,54,33,21
31719,Knøw,ravencrest,1495,priest,discipline,68,36,32
31720,Nubso,aegwynn,1495,priest,discipline,54,25,29
31721,Aïezn,culte-de-la-rive-noire,1495,priest,discipline,206,93,113
31722,Faouzia,argent-dawn,1495,priest,discipline,36,16,20
31723,Towelie,stormscale,1495,priest,discipline,36,16,20
31724,Шимату,howling-fjord,1495,priest,discipline,72,25,47
31725,Onetwo,silvermoon,1494,priest,discipline,30,18,12
31726,Drawun,burning-legion,1494,priest,discipline,116,67,49
31727,Ballsbrawlz,sylvanas,1494,priest,discipline,42,24,18
31728,Sheshan,destromath,1494,priest,discipline,53,29,24
31729,Hïstërïä,silvermoon,1494,priest,discipline,57,28,29
31730,Olio,outland,1494,priest,discipline,76,35,41
31731,Tarîs,archimonde,1494,priest,discipline,72,31,41
31732,Vorynax,silvermoon,1493,priest,discipline,86,40,46
31733,Tinpr,sanguino,1492,priest,discipline,111,50,61
31734,Blackheall,nemesis,1491,priest,discipline,42,22,20
31735,Spoggle,kazzak,1491,priest,discipline,108,55,53
31736,Holycrit,aszune,1491,priest,discipline,59,29,30
31737,Aurunea,blackrock,1490,priest,discipline,45,30,15
31738,Littleflash,lightbringer,1490,priest,discipline,87,43,44
31739,Cárith,nemesis,1489,priest,discipline,46,26,20
31740,Bleedingeyes,tarren-mill,1489,priest,discipline,51,27,24
31741,Neagica,kazzak,1489,priest,discipline,126,65,61
31742,Nastynina,frostwhisper,1489,priest,discipline,88,42,46
31743,Loverxz,dun-modr,1489,priest,discipline,42,20,22
31744,Лилатэль,blackscar,1489,priest,discipline,132,58,74
31745,Dadheal,dalaran,1489,priest,discipline,48,21,27
31746,Tynsxd,silvermoon,1488,priest,discipline,149,83,66
31747,Ceraghk,tichondrius,1488,priest,discipline,144,76,68
31748,Khazidhea,frostwolf,1488,priest,discipline,87,41,46
31749,Sebbepriest,twisting-nether,1487,priest,discipline,42,27,15
31750,Discomarcel,burning-legion,1487,priest,discipline,42,23,19
31751,Céph,sylvanas,1487,priest,discipline,42,21,21
31752,Radegast,jaedenar,1487,priest,discipline,204,100,104
31753,Iqr,blackmoore,1487,priest,discipline,42,20,22
31754,Fiskpung,draenor,1486,priest,discipline,48,28,20
31755,Triuna,sylvanas,1486,priest,discipline,41,20,21
31756,Nomakprst,sanguino,1486,priest,discipline,130,63,67
31757,Mewpew,azjolnerub,1486,priest,discipline,54,23,31
31758,Dímension,ragnaros,1485,priest,discipline,110,64,46
31759,Viì,ravencrest,1485,priest,discipline,30,16,14
31760,Senpumara,malganis,1485,priest,discipline,300,150,150
31761,Stevep,tarren-mill,1485,priest,discipline,72,36,36
31762,Aguerran,spinebreaker,1485,priest,discipline,36,16,20
31763,Cbsad,madmortem,1484,priest,discipline,90,49,41
31764,Daddyfinger,argent-dawn,1483,priest,discipline,109,63,46
31765,Хахеха,gordunni,1483,priest,discipline,30,17,13
31766,Snuifje,azjolnerub,1483,priest,discipline,155,77,78
31767,Enzyme,drakthul,1482,priest,discipline,36,24,12
31768,Jetlìfe,ysondre,1482,priest,discipline,42,18,24
31769,Ihaveibs,doomhammer,1481,priest,discipline,77,36,41
31770,Rikipope,ravencrest,1480,priest,discipline,42,25,17
31771,Spiochpr,burning-legion,1480,priest,discipline,144,81,63
31772,Zarozina,pozzo-delleternità,1480,priest,discipline,42,21,21
31773,Neoni,blackmoore,1480,priest,discipline,216,107,109
31774,Averagenoob,ragnaros,1480,priest,discipline,81,35,46
31775,Sehek,sanguino,1480,priest,discipline,72,31,41
31776,Джелесана,gordunni,1479,priest,discipline,99,45,54
31777,Ømñyx,outland,1479,priest,discipline,36,16,20
31778,Banaynay,bronzebeard,1479,priest,discipline,59,24,35
31779,Myrmz,archimonde,1478,priest,discipline,30,16,14
31780,Лимью,soulflayer,1478,priest,discipline,62,26,36
31781,Yhraeliaegh,defias-brotherhood,1478,priest,discipline,69,26,43
31782,Migaz,runetotem,1477,priest,discipline,60,37,23
31783,Juîcycheeks,frostwolf,1477,priest,discipline,132,70,62
31784,Scréam,eredar,1477,priest,discipline,72,33,39
31785,Pumpmenow,drakthul,1477,priest,discipline,48,22,26
31786,Chrispriest,argent-dawn,1477,priest,discipline,56,24,32
31787,Pristerline,antonidas,1476,priest,discipline,37,24,13
31788,Fluba,thrall,1476,priest,discipline,65,39,26
31789,Ssol,tarren-mill,1476,priest,discipline,60,33,27
31790,Zhenni,ravencrest,1476,priest,discipline,30,16,14
31791,Ilovedisc,kazzak,1476,priest,discipline,56,29,27
31792,Noany,ravencrest,1475,priest,discipline,92,50,42
31793,Пеппаслав,soulflayer,1475,priest,discipline,42,22,20
31794,Keewix,ysondre,1475,priest,discipline,95,46,49
31795,Hailor,blackmoore,1474,priest,discipline,48,29,19
31796,Devot,outland,1474,priest,discipline,126,68,58
31797,Mzpriest,dalaran,1474,priest,discipline,76,41,35
31798,Jakeow,auchindoun,1474,priest,discipline,87,46,41
31799,Buzzy,twisting-nether,1474,priest,discipline,144,75,69
31800,Hunfall,stormscale,1474,priest,discipline,70,34,36
31801,Chuckline,eredar,1474,priest,discipline,90,43,47
31802,Tinteolo,blackrock,1474,priest,discipline,45,21,24
31803,Avgenjoyer,kazzak,1474,priest,discipline,180,83,97
31804,Holymöly,archimonde,1474,priest,discipline,49,20,29
31805,Санггвиний,soulflayer,1473,priest,discipline,108,55,53
31806,Sannti,twisting-nether,1473,priest,discipline,48,24,24
31807,Sorrybowtdat,tarren-mill,1473,priest,discipline,120,56,64
31808,Джулибуба,borean-tundra,1473,priest,discipline,57,26,31
31809,Chimara,eredar,1472,priest,discipline,166,89,77
31810,Acik,bladefist,1472,priest,discipline,59,27,32
31811,Rasha,kazzak,1471,priest,discipline,111,60,51
31812,Themistia,kazzak,1471,priest,discipline,151,70,81
31813,Veilon,defias-brotherhood,1471,priest,discipline,60,24,36
31814,Isuckpriest,aegwynn,1471,priest,discipline,54,21,33
31815,Вичкрафт,howling-fjord,1471,priest,discipline,60,23,37
31816,Porklifer,tarren-mill,1470,priest,discipline,54,32,22
31817,Maneipriest,drakthul,1470,priest,discipline,65,35,30
31818,Loarderonx,stormscale,1470,priest,discipline,35,16,19
31819,Karoopi,ysondre,1469,priest,discipline,203,105,98
31820,Liviúss,draenor,1469,priest,discipline,144,70,74
31821,Doktoritca,kazzak,1469,priest,discipline,66,27,39
31822,Agatioxd,dun-modr,1468,priest,discipline,48,31,17
31823,Mástermínd,kazzak,1468,priest,discipline,57,34,23
31824,Battra,argent-dawn,1468,priest,discipline,78,41,37
31825,Unpsofablé,outland,1468,priest,discipline,52,27,25
31826,Pewkz,draenor,1468,priest,discipline,164,83,81
31827,Niholie,sinstralis,1468,priest,discipline,78,32,46
31828,Drwlad,archimonde,1468,priest,discipline,66,26,40
31829,Ykiotonegawa,twisting-nether,1468,priest,discipline,117,45,72
31830,Жариха,gordunni,1467,priest,discipline,54,31,23
31831,Tallzoné,ravencrest,1467,priest,discipline,86,48,38
31832,Shaov,archimonde,1467,priest,discipline,42,22,20
31833,Mylini,silvermoon,1467,priest,discipline,153,80,73
31834,Властьтени,gordunni,1467,priest,discipline,175,87,88
31835,Ёджих,blackscar,1467,priest,discipline,133,65,68
31836,Brutapriestx,stormscale,1467,priest,discipline,35,16,19
31837,Emon,nemesis,1466,priest,discipline,54,32,22
31838,Prezica,stormscale,1466,priest,discipline,155,81,74
31839,Yákizå,darksorrow,1466,priest,discipline,72,30,42
31840,Khaag,korgall,1465,priest,discipline,54,27,27
31841,Defineless,outland,1465,priest,discipline,165,76,89
31842,Kanî,eredar,1465,priest,discipline,78,35,43
31843,Sochnaochen,outland,1464,priest,discipline,84,48,36
31844,Vanadii,blackhand,1464,priest,discipline,66,37,29
31845,Jupiter,silvermoon,1464,priest,discipline,125,67,58
31846,Sînálà,antonidas,1464,priest,discipline,68,35,33
31847,Могулас,soulflayer,1464,priest,discipline,430,214,216
31848,ßabylexa,ravencrest,1464,priest,discipline,140,65,75
31849,Syrell,sanguino,1464,priest,discipline,35,16,19
31850,Geierlol,blackrock,1464,priest,discipline,42,17,25
31851,Shilôz,hyjal,1463,priest,discipline,138,75,63
31852,Scade,kazzak,1463,priest,discipline,98,47,51
31853,Асуартхас,gordunni,1463,priest,discipline,211,101,110
31854,Хербоб,howling-fjord,1463,priest,discipline,202,95,107
31855,Galadrielkä,drakthul,1462,priest,discipline,121,67,54
31856,Ботхесатва,deepholm,1462,priest,discipline,77,35,42
31857,Amoxkys,nemesis,1462,priest,discipline,86,39,47
31858,Mackópriest,ragnaros,1462,priest,discipline,151,68,83
31859,Unsáinted,stormscale,1461,priest,discipline,24,16,8
31860,Krayziest,tarren-mill,1461,priest,discipline,42,26,16
31861,Suaakypriest,tyrande,1461,priest,discipline,48,24,24
31862,Мдзшка,gordunni,1461,priest,discipline,752,375,377
31863,Лэрикус,howling-fjord,1461,priest,discipline,36,16,20
31864,Goodgirl,frostmane,1460,priest,discipline,40,27,13
31865,Elizabéth,blackrock,1460,priest,discipline,43,26,17
31866,Crowdd,turalyon,1460,priest,discipline,118,67,51
31867,Трэй,deathguard,1459,priest,discipline,90,50,40
31868,Ðiscobiscuit,argent-dawn,1459,priest,discipline,104,55,49
31869,Arize,dun-modr,1459,priest,discipline,48,24,24
31870,Nÿpô,hyjal,1459,priest,discipline,89,40,49
31871,Laxímink,sylvanas,1459,priest,discipline,101,41,60
31872,Elfarity,tarren-mill,1458,priest,discipline,35,21,14
31873,Ivysaurus,ravencrest,1458,priest,discipline,74,42,32
31874,Yvaini,xavius,1458,priest,discipline,90,49,41
31875,Leerzeichen,aegwynn,1458,priest,discipline,48,24,24
31876,Ruly,ragnaros,1458,priest,discipline,51,25,26
31877,Moarein,twisting-nether,1458,priest,discipline,72,32,40
31878,Дюшапинанс,soulflayer,1456,priest,discipline,56,33,23
31879,Enigam,alakir,1456,priest,discipline,78,41,37
31880,Unholyfield,draenor,1456,priest,discipline,144,71,73
31881,Dotdotggwp,stormscale,1456,priest,discipline,96,45,51
31882,Péntagón,festung-der-stürme,1456,priest,discipline,48,19,29
31883,Ijzerehenk,outland,1456,priest,discipline,94,35,59
31884,Nyxalia,silvermoon,1455,priest,discipline,30,18,12
31885,Sémi,twisting-nether,1455,priest,discipline,60,34,26
31886,Kåstå,archimonde,1455,priest,discipline,92,51,41
31887,Dêxter,hyjal,1455,priest,discipline,126,63,63
31888,Boostpriest,archimonde,1454,priest,discipline,111,59,52
31889,Фейкай,blackscar,1454,priest,discipline,54,28,26
31890,Apøcalypso,antonidas,1454,priest,discipline,138,71,67
31891,Disturbdtwo,archimonde,1454,priest,discipline,66,31,35
31892,Panoio,aggra-português,1454,priest,discipline,95,41,54
31893,Walúpe,draenor,1453,priest,discipline,30,21,9
31894,Pedopräst,stormscale,1453,priest,discipline,83,42,41
31895,Dealtime,ysondre,1453,priest,discipline,32,16,16
31896,Алуриэлия,gordunni,1453,priest,discipline,83,40,43
31897,Holyshart,magtheridon,1453,priest,discipline,77,37,40
31898,Mvuu,kazzak,1452,priest,discipline,42,25,17
31899,Otuschpriest,blackmoore,1452,priest,discipline,36,20,16
31900,Troublemaker,durotan,1451,priest,discipline,66,37,29
31901,Okeymokey,malganis,1451,priest,discipline,54,29,25
31902,Kätsulol,ysondre,1451,priest,discipline,48,24,24
31903,Boarheals,blackmoore,1451,priest,discipline,59,28,31
31904,Baloopriest,grim-batol,1450,priest,discipline,42,17,25
31905,Ylvanna,arthas,1450,priest,discipline,52,21,31
31906,Sweetxq,tarren-mill,1449,priest,discipline,102,57,45
31907,Chigreru,uldum,1449,priest,discipline,29,16,13
31908,Kimozabi,ravencrest,1448,priest,discipline,50,25,25
31909,Schmatzy,blackmoore,1448,priest,discipline,48,24,24
31910,Vanillå,silvermoon,1448,priest,discipline,84,41,43
31911,Ryazz,blackrock,1448,priest,discipline,48,22,26
31912,Adolin,onyxia,1447,priest,discipline,47,24,23
31913,Frekio,eitrigg,1447,priest,discipline,155,79,76
31914,Angelic,ragnaros,1447,priest,discipline,191,92,99
31915,Mysticks,kirin-tor,1447,priest,discipline,36,17,19
31916,Mòly,archimonde,1446,priest,discipline,27,17,10
31917,Æsia,archimonde,1446,priest,discipline,45,25,20
31918,Toorree,stormscale,1446,priest,discipline,137,70,67
31919,Kâltak,aegwynn,1446,priest,discipline,48,24,24
31920,Sáshagrey,arathor,1446,priest,discipline,49,24,25
31921,Sameec,drakthul,1446,priest,discipline,129,60,69
31922,Крутосанка,blackscar,1445,priest,discipline,42,22,20
31923,Solaqt,tarren-mill,1445,priest,discipline,48,19,29
31924,Miileys,arthas,1444,priest,discipline,43,26,17
31925,Серыйлог,galakrond,1444,priest,discipline,90,49,41
31926,Jazzmind,stormscale,1444,priest,discipline,150,77,73
31927,Hypernym,eredar,1443,priest,discipline,32,20,12
31928,Возрождающее,soulflayer,1443,priest,discipline,90,47,43
31929,Arkkupiispa,stormreaver,1443,priest,discipline,459,228,231
31930,Trekztwo,archimonde,1443,priest,discipline,66,32,34
31931,Chankilolx,dun-modr,1443,priest,discipline,175,81,94
31932,Arctoczax,ravencrest,1443,priest,discipline,66,27,39
31933,Lâughing,ravencrest,1442,priest,discipline,36,24,12
31934,Sombralúz,sanguino,1442,priest,discipline,36,20,16
31935,Verzeichnis,thrall,1442,priest,discipline,148,81,67
31936,Aizakku,frostmane,1442,priest,discipline,36,19,17
31937,Benificent,argent-dawn,1442,priest,discipline,213,108,105
31938,Shanny,kazzak,1442,priest,discipline,89,43,46
31939,Kreador,twisting-nether,1442,priest,discipline,48,23,25
31940,Chibrausorus,archimonde,1442,priest,discipline,60,27,33
31941,Aeritha,blackmoore,1441,priest,discipline,30,19,11
31942,Tarellia,argent-dawn,1441,priest,discipline,217,123,94
31943,Laurent,sanguino,1441,priest,discipline,36,16,20
31944,Pinkyladdy,argent-dawn,1441,priest,discipline,53,23,30
31945,Svistis,ravencrest,1440,priest,discipline,28,20,8
31946,Смегмачет,soulflayer,1440,priest,discipline,122,63,59
31947,Yesdaddypls,draenor,1439,priest,discipline,36,21,15
31948,Lyés,uldaman,1439,priest,discipline,247,141,106
31949,Squidlicker,twisting-nether,1439,priest,discipline,46,23,23
31950,Voxqt,blackrock,1439,priest,discipline,30,15,15
31951,Cáss,archimonde,1439,priest,discipline,30,15,15
31952,Zeraphïn,eredar,1439,priest,discipline,30,15,15
31953,Bedkara,ravencrest,1439,priest,discipline,30,15,15
31954,Sinfulmaze,outland,1439,priest,discipline,30,15,15
31955,Zedrus,azshara,1439,priest,discipline,111,53,58
31956,Youkounkoun,garona,1438,priest,discipline,41,26,15
31957,Jerzay,hyjal,1438,priest,discipline,112,53,59
31958,Åshbé,archimonde,1437,priest,discipline,18,15,3
31959,Hopeso,silvermoon,1437,priest,discipline,18,15,3
31960,Zooster,pozzo-delleternità,1437,priest,discipline,48,29,19
31961,Helikipope,kazzak,1437,priest,discipline,30,17,13
31962,Sadkitten,sylvanas,1437,priest,discipline,301,164,137
31963,Чилюотферала,eversong,1437,priest,discipline,30,15,15
31964,Mainhunter,aegwynn,1437,priest,discipline,30,15,15
31965,Yøløswagg,silvermoon,1437,priest,discipline,116,49,67
31966,Fotmape,stormscale,1437,priest,discipline,36,15,21
31967,Rihx,ysondre,1436,priest,discipline,25,17,8
31968,Syro,defias-brotherhood,1436,priest,discipline,45,26,19
31969,Tony,agamaggan,1436,priest,discipline,71,38,33
31970,Orophar,antonidas,1436,priest,discipline,221,111,110
31971,Nolosme,blackrock,1436,priest,discipline,42,21,21
31972,Rmpriest,blackhand,1436,priest,discipline,30,15,15
31973,Feniyxa,die-aldor,1436,priest,discipline,30,15,15
31974,Anotherdisc,aegwynn,1436,priest,discipline,244,115,129
31975,Dzoo,kazzak,1436,priest,discipline,58,27,31
31976,Kbakå,stormscale,1436,priest,discipline,84,37,47
31977,Jàckîe,aegwynn,1436,priest,discipline,40,17,23
31978,Xayrin,thrall,1435,priest,discipline,78,43,35
31979,Darkoze,kazzak,1435,priest,discipline,54,29,25
31980,Pàndoràh,nemesis,1435,priest,discipline,42,22,20
31981,Carolyna,ravencrest,1435,priest,discipline,36,15,21
31982,Mindcrackr,stormscale,1434,priest,discipline,36,22,14
31983,Xubeqi,kazzak,1434,priest,discipline,213,112,101
31984,Kæyc,blackmoore,1434,priest,discipline,71,35,36
31985,Anniegelic,ravencrest,1434,priest,discipline,42,19,23
31986,Cajolîne,archimonde,1434,priest,discipline,162,73,89
31987,Villagegirlx,stormscale,1433,priest,discipline,30,18,12
31988,Barcodes,kazzak,1433,priest,discipline,69,40,29
31989,Selëne,blackrock,1433,priest,discipline,42,22,20
31990,Simplesam,ravencrest,1433,priest,discipline,94,49,45
31991,Prayxlol,outland,1433,priest,discipline,30,15,15
31992,Størmblaze,stormreaver,1433,priest,discipline,30,15,15
31993,Nirsis,dun-modr,1433,priest,discipline,93,45,48
31994,Bochonok,stormrage,1433,priest,discipline,36,15,21
31995,Bigwik,tarren-mill,1433,priest,discipline,42,15,27
31996,Dimsim,kazzak,1432,priest,discipline,24,15,9
31997,Elderiel,turalyon,1432,priest,discipline,331,173,158
31998,Fantästic,kazzak,1432,priest,discipline,197,100,97
31999,Swera,twisting-nether,1431,priest,discipline,24,15,9
32000,Letmehêal,archimonde,1431,priest,discipline,48,28,20
32001,Сашадвасм,gordunni,1431,priest,discipline,111,60,51
32002,Ebashuvkashu,stormscale,1431,priest,discipline,45,24,21
32003,Nazhara,hyjal,1431,priest,discipline,30,15,15
32004,Scràppy,malganis,1431,priest,discipline,30,15,15
32005,Mungam,draenor,1431,priest,discipline,81,38,43
32006,Kâmy,archimonde,1430,priest,discipline,54,33,21
32007,Altar,grim-batol,1430,priest,discipline,125,72,53
32008,Гачибунта,blackscar,1430,priest,discipline,142,79,63
32009,Vaetrilla,doomhammer,1430,priest,discipline,37,20,17
32010,Soulreapper,blackhand,1430,priest,discipline,219,115,104
32011,Черныйсписок,gordunni,1430,priest,discipline,54,27,27
32012,Inzàné,kazzak,1430,priest,discipline,60,25,35
32013,Delinsx,outland,1430,priest,discipline,36,15,21
32014,Mírá,burning-blade,1429,priest,discipline,42,29,13
32015,Lanaineuwu,archimonde,1429,priest,discipline,32,22,10
32016,Эмжи,howling-fjord,1429,priest,discipline,24,15,9
32017,Eladri,silvermoon,1429,priest,discipline,24,15,9
32018,Lalgorithme,hyjal,1429,priest,discipline,30,18,12
32019,Ashérs,ravencrest,1429,priest,discipline,99,58,41
32020,ßrain,garona,1429,priest,discipline,30,15,15
32021,Sbeecha,argent-dawn,1429,priest,discipline,108,48,60
32022,Yurrij,thrall,1428,priest,discipline,39,23,16
32023,Lucidluke,blackmoore,1428,priest,discipline,55,25,30
32024,Ninetzz,tarren-mill,1427,priest,discipline,36,26,10
32025,Nätrix,tarren-mill,1427,priest,discipline,24,15,9
32026,Diddlefiddle,stormscale,1427,priest,discipline,64,36,28
32027,Baybe,ravencrest,1427,priest,discipline,129,71,58
32028,Illüminaty,sylvanas,1427,priest,discipline,115,60,55
32029,Putinkuilo,outland,1427,priest,discipline,48,25,23
32030,Azarseth,exodar,1427,priest,discipline,48,24,24
32031,Klituriis,twisting-nether,1427,priest,discipline,89,44,45
32032,Holydreed,ragnaros,1427,priest,discipline,36,17,19
32033,Blaçkout,ravencrest,1427,priest,discipline,48,21,27
32034,Randomm,shadowsong,1427,priest,discipline,60,23,37
32035,Ylenae,twisting-nether,1427,priest,discipline,42,15,27
32036,Amanojakü,ravencrest,1426,priest,discipline,48,34,14
32037,Holymøly,earthen-ring,1426,priest,discipline,57,29,28
32038,Joeasaurs,ragnaros,1426,priest,discipline,33,16,17
32039,Viagrà,outland,1426,priest,discipline,120,53,67
32040,Emala,hyjal,1426,priest,discipline,35,15,20
32041,Massdispell,silvermoon,1425,priest,discipline,34,20,14
32042,Нэилшери,gordunni,1425,priest,discipline,48,25,23
32043,Jael,frostmane,1425,priest,discipline,62,30,32
32044,Урголиафа,howling-fjord,1425,priest,discipline,54,25,29
32045,Miris,ysondre,1425,priest,discipline,48,21,27
32046,Maidie,stormscale,1424,priest,discipline,66,41,25
32047,Whiskeyhaze,burning-legion,1424,priest,discipline,78,42,36
32048,Berstkraft,blackmoore,1424,priest,discipline,30,15,15
32049,Хальтэнис,gordunni,1424,priest,discipline,48,23,25
32050,Zymai,ravencrest,1424,priest,discipline,42,15,27
32051,Hónòr,sylvanas,1424,priest,discipline,59,20,39
32052,Кэндимен,gordunni,1423,priest,discipline,321,165,156
32053,Кхарли,howling-fjord,1423,priest,discipline,30,15,15
32054,Nyxém,blackmoore,1423,priest,discipline,36,15,21
32055,Huhu,defias-brotherhood,1422,priest,discipline,36,21,15
32056,Юлечка,blackscar,1422,priest,discipline,36,19,17
32057,Phreyst,draenor,1422,priest,discipline,177,91,86
32058,Ahmnesia,archimonde,1422,priest,discipline,218,111,107
32059,Pìkachù,stormscale,1422,priest,discipline,60,28,32
32060,Îlkari,hyjal,1421,priest,discipline,24,17,7
32061,Dankopriest,drakthul,1421,priest,discipline,54,28,26
32062,Kathja,outland,1421,priest,discipline,30,15,15
32063,Птист,azuregos,1421,priest,discipline,42,17,25
32064,Halastrâ,tarren-mill,1420,priest,discipline,50,33,17
32065,Kenzaiq,aegwynn,1420,priest,discipline,42,24,18
32066,Lapinvicieux,archimonde,1420,priest,discipline,60,32,28
32067,Klosso,anachronos,1420,priest,discipline,66,35,31
32068,Тенсаи,howling-fjord,1420,priest,discipline,76,40,36
32069,Bandgap,antonidas,1420,priest,discipline,176,88,88
32070,Yorap,blackrock,1420,priest,discipline,36,17,19
32071,Zarez,stormscale,1420,priest,discipline,50,17,33
32072,Arthyria,archimonde,1419,priest,discipline,48,26,22
32073,Сафири,blackscar,1419,priest,discipline,30,15,15
32074,Meanazer,antonidas,1419,priest,discipline,66,30,36
32075,Alianza,hellfire,1418,priest,discipline,36,25,11
32076,Voltáren,blackmoore,1418,priest,discipline,50,33,17
32077,Noreal,twisting-nether,1418,priest,discipline,36,23,13
32078,Nazzghul,silvermoon,1418,priest,discipline,24,15,9
32079,Нэстикус,gordunni,1418,priest,discipline,30,16,14
32080,Aeternethy,ravencrest,1418,priest,discipline,36,18,18
32081,Медиив,deepholm,1418,priest,discipline,66,32,34
32082,Gbpjr,xavius,1418,priest,discipline,211,102,109
32083,Banshzz,ragnaros,1418,priest,discipline,83,34,49
32084,Holywann,argent-dawn,1417,priest,discipline,29,18,11
32085,Eagleess,silvermoon,1417,priest,discipline,42,25,17
32086,Sprutch,kazzak,1417,priest,discipline,56,30,26
32087,Тучанх,greymane,1417,priest,discipline,49,24,25
32088,Vividots,draenor,1417,priest,discipline,42,20,22
32089,Malyzion,draenor,1416,priest,discipline,136,77,59
32090,Hlyhoe,silvermoon,1415,priest,discipline,72,41,31
32091,Zivy,silvermoon,1415,priest,discipline,110,61,49
32092,Priesticchi,stormscale,1415,priest,discipline,101,56,45
32093,Mertérésa,hyjal,1415,priest,discipline,67,36,31
32094,Salyisra,draenor,1415,priest,discipline,119,63,56
32095,Cryksî,eredar,1415,priest,discipline,96,46,50
32096,Рейсина,gordunni,1415,priest,discipline,36,15,21
32097,Теньраа,soulflayer,1415,priest,discipline,54,21,33
32098,Bakony,ravencrest,1414,priest,discipline,60,41,19
32099,Yukíø,antonidas,1414,priest,discipline,30,18,12
32100,Praybro,blackmoore,1414,priest,discipline,41,24,17
32101,Тесира,blackscar,1414,priest,discipline,42,23,19
32102,Ghostroller,pozzo-delleternità,1414,priest,discipline,55,28,27
32103,Vynivan,korgall,1414,priest,discipline,54,24,30
32104,Lucéa,antonidas,1413,priest,discipline,38,26,12
32105,Kaeldara,ysondre,1413,priest,discipline,24,15,9
32106,Deathchicka,draenor,1413,priest,discipline,64,37,27
32107,Ylivoima,stormscale,1413,priest,discipline,42,24,18
32108,Zïn,silvermoon,1413,priest,discipline,58,29,29
32109,Toratorap,burning-legion,1413,priest,discipline,30,15,15
32110,Indicta,darksorrow,1413,priest,discipline,33,16,17
32111,Joseantuan,sanguino,1412,priest,discipline,30,18,12
32112,Vqny,archimonde,1412,priest,discipline,153,85,68
32113,Cntrl,frostmane,1412,priest,discipline,164,91,73
32114,Castalia,ravencrest,1412,priest,discipline,101,48,53
32115,Bekareth,archimonde,1411,priest,discipline,119,65,54
32116,Mortex,nemesis,1411,priest,discipline,66,36,30
32117,Вестайс,gordunni,1411,priest,discipline,77,36,41
32118,Rwaphouu,ysondre,1410,priest,discipline,66,39,27
32119,Ецци,howling-fjord,1410,priest,discipline,44,23,21
32120,Faelvirin,aegwynn,1410,priest,discipline,41,21,20
32121,Shanya,thrall,1410,priest,discipline,42,20,22
32122,Jóhnnybravó,kazzak,1410,priest,discipline,36,16,20
32123,Krasawìtch,onyxia,1410,priest,discipline,113,50,63
32124,Вутитути,howling-fjord,1410,priest,discipline,36,15,21
32125,Èlysium,grim-batol,1410,priest,discipline,54,21,33
32126,Munchies,scarshield-legion,1409,priest,discipline,30,17,13
32127,Aiewn,elune,1409,priest,discipline,113,63,50
32128,Undeabniss,nathrezim,1409,priest,discipline,29,16,13
32129,Бомжскадилом,gordunni,1409,priest,discipline,237,125,112
32130,Dunderprälle,outland,1409,priest,discipline,30,15,15
32131,Slasherh,ravencrest,1409,priest,discipline,195,96,99
32132,Vadhänder,the-maelstrom,1409,priest,discipline,60,29,31
32133,Cainactor,drakthul,1409,priest,discipline,54,25,29
32134,Acidpills,hyjal,1409,priest,discipline,52,23,29
32135,Lévention,stormscale,1408,priest,discipline,36,20,16
32136,Пакетикдот,gordunni,1408,priest,discipline,297,163,134
32137,Lekadolplusc,doomhammer,1408,priest,discipline,414,220,194
32138,Дядяврач,howling-fjord,1408,priest,discipline,194,97,97
32139,Bananensuppe,kult-der-verdammten,1408,priest,discipline,72,33,39
32140,Ascendare,tarren-mill,1408,priest,discipline,83,35,48
32141,Tarana,mannoroth,1407,priest,discipline,32,18,14
32142,Ensamstående,twisting-nether,1407,priest,discipline,108,57,51
32143,Ysharrj,hyjal,1407,priest,discipline,42,22,20
32144,Sensor,kazzak,1407,priest,discipline,105,52,53
32145,Sppid,sanguino,1407,priest,discipline,350,170,180
32146,Castpenance,blackrock,1407,priest,discipline,161,71,90
32147,Некроликон,grom,1406,priest,discipline,30,18,12
32148,Gothixs,draenor,1406,priest,discipline,44,26,18
32149,Garfriest,aggra-português,1406,priest,discipline,78,46,32
32150,Doctep,sargeras,1406,priest,discipline,52,30,22
32151,Carlye,stormreaver,1406,priest,discipline,30,17,13
32152,Tyrhaa,blackmoore,1406,priest,discipline,30,16,14
32153,Medivs,blackmoore,1405,priest,discipline,30,17,13
32154,Elosen,darkspear,1405,priest,discipline,48,27,21
32155,ßowforme,aegwynn,1405,priest,discipline,66,37,29
32156,Valeriana,stormreaver,1405,priest,discipline,192,102,90
32157,Kappa,darksorrow,1405,priest,discipline,54,28,26
32158,Marllen,twisting-nether,1405,priest,discipline,337,164,173
32159,Holysquirt,twisting-nether,1405,priest,discipline,42,18,24
32160,Трезида,gordunni,1404,priest,discipline,48,24,24
32161,Летиин,gordunni,1404,priest,discipline,83,40,43
32162,Dragovic,chogall,1404,priest,discipline,80,38,42
32163,Flaskandeux,tarren-mill,1404,priest,discipline,194,76,118
32164,Divinekat,tarren-mill,1403,priest,discipline,52,34,18
32165,Chilie,ravencrest,1403,priest,discipline,44,23,21
32166,Пэйтен,deathguard,1403,priest,discipline,30,15,15
32167,Madkes,ravencrest,1403,priest,discipline,186,92,94
32168,Eileengu,silvermoon,1402,priest,discipline,70,42,28
32169,Ùçù,dalaran,1402,priest,discipline,70,40,30
32170,Goosebot,stormscale,1402,priest,discipline,30,15,15
32171,Kalestharia,blackmoore,1402,priest,discipline,192,90,102
32172,Kbakå,kazzak,1402,priest,discipline,32,15,17
32173,Dejica,kult-der-verdammten,1402,priest,discipline,102,46,56
32174,Virulent,nemesis,1402,priest,discipline,36,15,21
32175,Preachyjeg,ravencrest,1402,priest,discipline,114,46,68
32176,Fireflowers,silvermoon,1401,priest,discipline,108,54,54
32177,Dysko,alakir,1401,priest,discipline,30,15,15
32178,Synoé,la-croisade-écarlate,1401,priest,discipline,101,49,52
32179,Durinko,thunderhorn,1401,priest,discipline,72,31,41
32180,Tsipaz,outland,1401,priest,discipline,35,15,20
32181,Dènna,eldrethalas,1401,priest,discipline,54,22,32
32182,Бархомелфой,gordunni,1400,priest,discipline,51,26,25
32183,Рукатёмная,soulflayer,1400,priest,discipline,83,37,46
32184,Cyberlunatic,antonidas,1400,priest,discipline,184,80,104
32185,Вурти,howling-fjord,1400,priest,discipline,65,28,37
32186,Crazyname,outland,1399,priest,discipline,235,119,116
32187,Quetraxz,chogall,1398,priest,discipline,36,19,17
32188,Laadyybirkee,blackhand,1398,priest,discipline,140,70,70
32189,Diva,malfurion,1398,priest,discipline,52,24,28
32190,Avázàr,stormscale,1398,priest,discipline,36,16,20
32191,Fiilaaja,stormreaver,1397,priest,discipline,42,26,16
32192,Vrynna,kazzak,1397,priest,discipline,138,74,64
32193,Menda,eredar,1397,priest,discipline,130,68,62
32194,Ventorina,die-aldor,1397,priest,discipline,62,32,30
32195,Шпангл,gordunni,1397,priest,discipline,222,110,112
32196,Marryisme,twisting-nether,1397,priest,discipline,102,46,56
32197,Холишитс,gordunni,1396,priest,discipline,115,64,51
32198,Sebatröz,ravencrest,1396,priest,discipline,42,23,19
32199,Морикаа,lich-king,1396,priest,discipline,30,16,14
32200,Crimsõn,kazzak,1396,priest,discipline,48,24,24
32201,Hellscon,kazzak,1396,priest,discipline,42,21,21
32202,Rahan,stormscale,1396,priest,discipline,93,46,47
32203,Ministry,tirion,1396,priest,discipline,48,23,25
32204,Darkest,ysondre,1396,priest,discipline,83,37,46
32205,Rixis,la-croisade-écarlate,1396,priest,discipline,72,32,40
32206,Nudavbrne,drakthul,1395,priest,discipline,18,15,3
32207,Calisé,argent-dawn,1395,priest,discipline,24,15,9
32208,Deadpxlz,ravencrest,1395,priest,discipline,30,17,13
32209,Evilangèl,ravenholdt,1395,priest,discipline,83,45,38
32210,Alakkiria,ravencrest,1394,priest,discipline,77,38,39
32211,Fåtkidx,ravencrest,1394,priest,discipline,79,35,44
32212,Бленди,howling-fjord,1394,priest,discipline,36,15,21
32213,Kroa,ragnaros,1393,priest,discipline,24,15,9
32214,Kiropap,silvermoon,1393,priest,discipline,43,26,17
32215,Littleheal,ghostlands,1393,priest,discipline,49,24,25
32216,Oxborn,thrall,1392,priest,discipline,95,45,50
32217,Skarnir,uldaman,1392,priest,discipline,105,40,65
32218,Xarxis,twisting-nether,1392,priest,discipline,54,20,34
32219,Pøsæ,uldaman,1391,priest,discipline,26,16,10
32220,Exila,rashgarroth,1391,priest,discipline,37,18,19
32221,Animepfp,stormreaver,1391,priest,discipline,140,67,73
32222,Anzil,dun-modr,1391,priest,discipline,146,67,79
32223,Thorhammer,turalyon,1390,priest,discipline,36,22,14
32224,Zombîe,draenor,1390,priest,discipline,42,16,26
32225,Judine,kazzak,1389,priest,discipline,23,15,8
32226,Paine,pozzo-delleternità,1389,priest,discipline,65,38,27
32227,Hardcode,twisting-nether,1389,priest,discipline,96,45,51
32228,Меинбиг,gordunni,1389,priest,discipline,52,21,31
32229,Hashoko,draenor,1388,priest,discipline,30,22,8
32230,Aaron,aegwynn,1388,priest,discipline,31,20,11
32231,Amnesztia,ragnaros,1388,priest,discipline,53,28,25
32232,Yeahr,kazzak,1388,priest,discipline,29,15,14
32233,Уноханагодх,howling-fjord,1388,priest,discipline,92,46,46
32234,Taiyöshin,silvermoon,1388,priest,discipline,106,52,54
32235,Juco,draenor,1388,priest,discipline,36,17,19
32236,Neverswap,blackmoore,1387,priest,discipline,26,16,10
32237,Hidr,nemesis,1387,priest,discipline,84,46,38
32238,Эйвиг,blackscar,1387,priest,discipline,75,32,43
32239,Cooriolis,sylvanas,1386,priest,discipline,24,17,7
32240,Nakali,the-maelstrom,1386,priest,discipline,30,16,14
32241,Grravehheart,kazzak,1386,priest,discipline,85,45,40
32242,Альфреска,gordunni,1386,priest,discipline,94,48,46
32243,Blaelel,dun-modr,1386,priest,discipline,30,15,15
32244,Aisha,rajaxx,1386,priest,discipline,87,42,45
32245,Pyropenance,twisting-nether,1386,priest,discipline,83,35,48
32246,Гшд,gordunni,1385,priest,discipline,78,43,35
32247,Rosalina,ravencrest,1385,priest,discipline,228,120,108
32248,Jaatjak,ravencrest,1385,priest,discipline,78,37,41
32249,Kaémon,twisting-nether,1385,priest,discipline,118,51,67
32250,Mazzekeen,burning-legion,1385,priest,discipline,43,17,26
32251,Atremius,dragonmaw,1384,priest,discipline,54,24,30
32252,Snuffanious,ragnaros,1384,priest,discipline,60,26,34
32253,Borrex,sanguino,1383,priest,discipline,19,16,3
32254,Vendormeq,darkspear,1383,priest,discipline,30,16,14
32255,Holynelph,kazzak,1383,priest,discipline,32,16,16
32256,Insekta,ragnaros,1383,priest,discipline,36,16,20
32257,Predpriest,twisting-nether,1383,priest,discipline,43,16,27
32258,Libido,outland,1382,priest,discipline,119,66,53
32259,Tintapri,aszune,1382,priest,discipline,122,62,60
32260,Naïlu,hyjal,1381,priest,discipline,66,38,28
32261,Cring,kirin-tor,1381,priest,discipline,132,73,59
32262,Ruderali,blackmoore,1381,priest,discipline,306,157,149
32263,Selenee,scarshield-legion,1381,priest,discipline,102,47,55
32264,Tiktokdancér,kazzak,1380,priest,discipline,132,72,60
32265,Иванпугачев,soulflayer,1380,priest,discipline,36,18,18
32266,Thrakoun,twilights-hammer,1380,priest,discipline,242,120,122
32267,Lothyf,archimonde,1379,priest,discipline,52,29,23
32268,Micobra,dalaran,1379,priest,discipline,41,22,19
32269,Elderath,eredar,1379,priest,discipline,116,55,61
32270,Phèbz,archimonde,1378,priest,discipline,48,29,19
32271,Vaewyn,ravencrest,1378,priest,discipline,79,42,37
32272,Лимоняшечка,soulflayer,1378,priest,discipline,110,58,52
32273,Woid,aegwynn,1378,priest,discipline,30,15,15
32274,Streety,nethersturm,1378,priest,discipline,90,43,47
32275,Bubidiblumpr,twisting-nether,1377,priest,discipline,84,47,37
32276,Gangreana,kazzak,1377,priest,discipline,78,42,36
32277,Sílvana,nordrassil,1377,priest,discipline,154,82,72
32278,Carnacia,tarren-mill,1376,priest,discipline,84,48,36
32279,Annisa,kazzak,1376,priest,discipline,131,71,60
32280,Vilanae,hyjal,1376,priest,discipline,110,57,53
32281,Punkrockgirl,destromath,1376,priest,discipline,48,24,24
32282,Эстрогенс,gordunni,1376,priest,discipline,60,22,38
32283,Bacberon,skullcrusher,1375,priest,discipline,48,30,18
32284,Джороко,howling-fjord,1375,priest,discipline,36,22,14
32285,Dolifrius,dalaran,1375,priest,discipline,50,30,20
32286,Ompala,shattered-hand,1375,priest,discipline,43,23,20
32287,Dotterin,draenor,1375,priest,discipline,162,78,84
32288,Invexx,tarren-mill,1375,priest,discipline,267,123,144
32289,Synteria,gilneas,1375,priest,discipline,78,31,47
32290,Dazé,ravencrest,1374,priest,discipline,59,43,16
32291,Symeria,sylvanas,1374,priest,discipline,78,43,35
32292,Qïx,ravencrest,1374,priest,discipline,45,24,21
32293,Psyfir,outland,1374,priest,discipline,224,117,107
32294,Spiriman,zuljin,1374,priest,discipline,30,15,15
32295,Otheym,the-maelstrom,1374,priest,discipline,39,18,21
32296,Pocketissue,ravencrest,1373,priest,discipline,32,21,11
32297,Blackheal,sanguino,1373,priest,discipline,68,29,39
32298,Juliane,trollbane,1373,priest,discipline,90,35,55
32299,Waramoly,eredar,1372,priest,discipline,30,16,14
32300,Majinme,kazzak,1372,priest,discipline,60,31,29
32301,Rabbît,stormscale,1372,priest,discipline,82,42,40
32302,Hiereia,khadgar,1372,priest,discipline,139,61,78
32303,Geesuz,outland,1372,priest,discipline,39,16,23
32304,Bomzhik,silvermoon,1371,priest,discipline,229,126,103
32305,Скизма,gordunni,1370,priest,discipline,42,25,17
32306,Smitey,terenas,1370,priest,discipline,124,68,56
32307,Kayeen9DF0F1,tarren-mill,1370,priest,discipline,130,65,65
32308,Kotipope,silvermoon,1369,priest,discipline,83,49,34
32309,Nûwa,draenor,1369,priest,discipline,77,45,32
32310,Feelmypainn,kazzak,1369,priest,discipline,96,51,45
32311,Holypepper,outland,1369,priest,discipline,137,69,68
32312,Baddly,silvermoon,1369,priest,discipline,170,81,89
32313,Sâtânica,kelthuzad,1369,priest,discipline,119,55,64
32314,Lunegrise,archimonde,1369,priest,discipline,60,27,33
32315,Asprine,kazzak,1368,priest,discipline,72,44,28
32316,Priesturz,aggramar,1368,priest,discipline,30,16,14
32317,Zoose,defias-brotherhood,1368,priest,discipline,32,17,15
32318,Aykò,blackmoore,1368,priest,discipline,38,16,22
32319,Discobrill,silvermoon,1368,priest,discipline,84,34,50
32320,Joxdox,archimonde,1367,priest,discipline,42,20,22
32321,Aethana,ravencrest,1367,priest,discipline,40,18,22
32322,Speltmor,stormscale,1367,priest,discipline,42,18,24
32323,Burtarul,argent-dawn,1366,priest,discipline,27,16,11
32324,Ghorfindel,kaelthas,1366,priest,discipline,53,30,23
32325,Mamaoh,ravencrest,1366,priest,discipline,69,34,35
32326,Minsie,silvermoon,1366,priest,discipline,59,26,33
32327,Valythria,blackhand,1365,priest,discipline,74,38,36
32328,Nattramnone,blackmoore,1365,priest,discipline,36,18,18
32329,Xelivia,draenor,1365,priest,discipline,113,56,57
32330,Berrylee,twisting-nether,1365,priest,discipline,61,26,35
32331,Elûnä,ysondre,1364,priest,discipline,340,179,161
32332,Carcaz,blackmoore,1364,priest,discipline,59,27,32
32333,Hidary,ysondre,1364,priest,discipline,67,30,37
32334,Veecna,the-maelstrom,1363,priest,discipline,144,77,67
32335,Durness,argent-dawn,1363,priest,discipline,84,42,42
32336,Raî,durotan,1363,priest,discipline,48,24,24
32337,Manuba,antonidas,1363,priest,discipline,36,17,19
32338,Priszt,arathor,1363,priest,discipline,36,15,21
32339,Злюкыч,gordunni,1362,priest,discipline,84,48,36
32340,Экспл,lich-king,1362,priest,discipline,28,15,13
32341,Созвонимся,gordunni,1362,priest,discipline,97,47,50
32342,Xyfas,azshara,1362,priest,discipline,54,25,29
32343,Joniop,stormreaver,1362,priest,discipline,72,33,39
32344,Bjornqt,ragnaros,1362,priest,discipline,86,35,51
32345,Rzpa,blackhand,1361,priest,discipline,93,48,45
32346,Grausami,zuluhed,1361,priest,discipline,48,24,24
32347,Wish,blackmoore,1361,priest,discipline,134,65,69
32348,Híppokrates,dethecus,1361,priest,discipline,85,37,48
32349,Liaru,aegwynn,1361,priest,discipline,84,32,52
32350,Darkweed,twilights-hammer,1360,priest,discipline,72,42,30
32351,Matsipri,sylvanas,1360,priest,discipline,96,50,46
32352,Carrhyks,archimonde,1360,priest,discipline,108,56,52
32353,Morerespect,lothar,1360,priest,discipline,30,15,15
32354,Chaosxo,draenor,1360,priest,discipline,102,49,53
32355,Pètunia,ravencrest,1359,priest,discipline,314,164,150
32356,Dooga,draenor,1359,priest,discipline,30,15,15
32357,Ÿë,stormreaver,1359,priest,discipline,37,15,22
32358,Prellish,draenor,1358,priest,discipline,72,33,39
32359,Krìnzy,illidan,1358,priest,discipline,82,36,46
32360,Priesless,sylvanas,1357,priest,discipline,34,20,14
32361,Mércíless,ravencrest,1357,priest,discipline,71,39,32
32362,Простойа,deathguard,1357,priest,discipline,134,71,63
32363,Gïanna,archimonde,1357,priest,discipline,132,65,67
32364,Элизабетшорт,soulflayer,1357,priest,discipline,60,26,34
32365,Nerfy,tarren-mill,1356,priest,discipline,48,23,25
32366,Xdthe,tarren-mill,1356,priest,discipline,144,68,76
32367,Smilyface,sylvanas,1356,priest,discipline,73,34,39
32368,Лакукарача,howling-fjord,1356,priest,discipline,60,24,36
32369,Äkvä,ragnaros,1356,priest,discipline,66,26,40
32370,Dànè,defias-brotherhood,1355,priest,discipline,30,21,9
32371,Cé,magtheridon,1355,priest,discipline,85,43,42
32372,Paterpaisios,kazzak,1355,priest,discipline,54,20,34
32373,Sasabsi,malorne,1354,priest,discipline,48,27,21
32374,Nésha,dun-modr,1354,priest,discipline,41,21,20
32375,Byxoph,sanguino,1354,priest,discipline,95,47,48
32376,Miabelle,argent-dawn,1354,priest,discipline,58,27,31
32377,Тодохил,gordunni,1354,priest,discipline,149,69,80
32378,Evolís,blackmoore,1354,priest,discipline,72,31,41
32379,Vanillahaze,sylvanas,1353,priest,discipline,36,23,13
32380,Sphero,kazzak,1353,priest,discipline,48,27,21
32381,Keltalador,zuljin,1353,priest,discipline,47,21,26
32382,Solarïah,garona,1352,priest,discipline,32,19,13
32383,Priestige,spinebreaker,1352,priest,discipline,36,21,15
32384,Adev,drakthul,1352,priest,discipline,71,35,36
32385,Alliora,dalaran,1352,priest,discipline,122,52,70
32386,Anaalipeura,stormreaver,1352,priest,discipline,72,30,42
32387,Littlehelper,shendralar,1352,priest,discipline,39,16,23
32388,Chealsey,thrall,1351,priest,discipline,57,36,21
32389,Shîn,aegwynn,1351,priest,discipline,90,44,46
32390,Zellia,frostmane,1351,priest,discipline,102,48,54
32391,Jcnun,xavius,1351,priest,discipline,98,45,53
32392,Brelett,the-maelstrom,1351,priest,discipline,36,16,20
32393,Давалкасвета,gordunni,1351,priest,discipline,74,32,42
32394,Torî,blackrock,1351,priest,discipline,66,26,40
32395,Dirtydoc,area-52,1350,priest,discipline,48,27,21
32396,Маимморта,howling-fjord,1350,priest,discipline,72,39,33
32397,Bublies,silvermoon,1349,priest,discipline,43,24,19
32398,Levy,azuremyst,1349,priest,discipline,37,20,17
32399,Sytawa,blackmoore,1349,priest,discipline,104,55,49
32400,Katrynax,ravencrest,1349,priest,discipline,121,63,58
32401,Sabaxdxd,dun-modr,1349,priest,discipline,173,84,89
32402,Anubisones,uldum,1349,priest,discipline,89,43,46
32403,Девственен,soulflayer,1349,priest,discipline,54,26,28
32404,Levinson,zuljin,1348,priest,discipline,60,40,20
32405,Jerichó,blackmoore,1348,priest,discipline,58,38,20
32406,Sykra,magtheridon,1348,priest,discipline,136,75,61
32407,Styrbjörn,shattered-hand,1348,priest,discipline,91,48,43
32408,Крашдайс,soulflayer,1348,priest,discipline,115,53,62
32409,Dstars,archimonde,1348,priest,discipline,42,16,26
32410,Cottyx,outland,1347,priest,discipline,69,42,27
32411,Vzã,krasus,1347,priest,discipline,42,23,19
32412,Fatishcribe,twisting-nether,1347,priest,discipline,261,135,126
32413,Greedyaf,stormscale,1347,priest,discipline,101,48,53
32414,Brênos,blackmoore,1346,priest,discipline,29,17,12
32415,Хаварь,gordunni,1346,priest,discipline,134,71,63
32416,Chowhone,archimonde,1346,priest,discipline,142,74,68
32417,Holyfussell,antonidas,1346,priest,discipline,80,38,42
32418,Iamfrosty,draenor,1346,priest,discipline,66,31,35
32419,Шруня,howling-fjord,1346,priest,discipline,102,43,59
32420,Boulotpas,hyjal,1345,priest,discipline,106,65,41
32421,Lydrian,argent-dawn,1345,priest,discipline,28,17,11
32422,Salzgehalt,antonidas,1345,priest,discipline,116,66,50
32423,Pwjetlifelol,grim-batol,1345,priest,discipline,97,52,45
32424,Hugeaf,antonidas,1344,priest,discipline,37,24,13
32425,Smålbenör,stormreaver,1344,priest,discipline,51,27,24
32426,Gothandor,der-rat-von-dalaran,1344,priest,discipline,42,22,20
32427,Дэтметал,grom,1344,priest,discipline,254,127,127
32428,Alz,rashgarroth,1344,priest,discipline,147,71,76
32429,Batsu,hyjal,1344,priest,discipline,94,43,51
32430,Dibelo,eredar,1344,priest,discipline,41,17,24
32431,Disconsick,vashj,1344,priest,discipline,118,45,73
32432,Buan,outland,1343,priest,discipline,24,14,10
32433,Nëw,los-errantes,1343,priest,discipline,24,14,10
32434,Rptr,ravencrest,1342,priest,discipline,18,14,4
32435,Chuckbarry,kazzak,1342,priest,discipline,24,15,9
32436,Zaradana,tarren-mill,1342,priest,discipline,96,51,45
32437,Barracuda,burning-legion,1342,priest,discipline,104,52,52
32438,Xandrial,blackmoore,1342,priest,discipline,30,14,16
32439,Поднялбабки,deathguard,1342,priest,discipline,36,14,22
32440,Rukiä,chogall,1341,priest,discipline,24,14,10
32441,Nerfnerf,kazzak,1341,priest,discipline,574,291,283
32442,Soreboners,stormscale,1341,priest,discipline,30,14,16
32443,Nietzsche,area-52,1341,priest,discipline,128,59,69
32444,Jagersmite,twisting-nether,1340,priest,discipline,120,64,56
32445,Phórkys,kazzak,1340,priest,discipline,645,327,318
32446,Cutename,burning-blade,1340,priest,discipline,36,18,18
32447,Sephìrøth,malganis,1340,priest,discipline,66,32,34
32448,Fakebob,draenor,1340,priest,discipline,42,20,22
32449,Svevo,ravencrest,1340,priest,discipline,139,66,73
32450,Далайна,galakrond,1340,priest,discipline,36,14,22
32451,Дармирэль,gordunni,1340,priest,discipline,65,25,40
32452,Ýbëzz,ravencrest,1339,priest,discipline,24,14,10
32453,Staatsfeind,blackmoore,1339,priest,discipline,77,44,33
32454,Nakenhäst,ravencrest,1339,priest,discipline,36,14,22
32455,Guerilagusto,draenor,1339,priest,discipline,42,16,26
32456,Stargóddess,kazzak,1338,priest,discipline,164,89,75
32457,Батлграунтт,soulflayer,1338,priest,discipline,78,42,36
32458,Ziaz,the-maelstrom,1338,priest,discipline,46,23,23
32459,Zéntius,twisting-nether,1338,priest,discipline,30,14,16
32460,Skelica,ragnaros,1337,priest,discipline,24,14,10
32461,Yaoz,sanguino,1337,priest,discipline,24,14,10
32462,Wortgottes,blackrock,1337,priest,discipline,40,23,17
32463,Tumlaa,ravencrest,1337,priest,discipline,56,31,25
32464,Holybunny,blackrock,1337,priest,discipline,98,54,44
32465,Gimcho,magtheridon,1337,priest,discipline,42,23,19
32466,Cheja,ravencrest,1337,priest,discipline,102,52,50
32467,Ahree,sargeras,1337,priest,discipline,258,126,132
32468,Îwi,archimonde,1337,priest,discipline,30,14,16
32469,Pouffi,garona,1336,priest,discipline,24,14,10
32470,Maryjanè,twisting-nether,1336,priest,discipline,24,14,10
32471,Sariss,ravencrest,1336,priest,discipline,24,14,10
32472,Halysis,chamber-of-aspects,1336,priest,discipline,28,14,14
32473,Makkesfil,stormscale,1335,priest,discipline,24,14,10
32474,Kojee,blackrock,1335,priest,discipline,48,18,30
32475,Biscuits,ravencrest,1335,priest,discipline,48,14,34
32476,Ràthaløs,sanguino,1334,priest,discipline,64,38,26
32477,Esüna,ysondre,1334,priest,discipline,30,17,13
32478,Convulsiveq,silvermoon,1334,priest,discipline,317,156,161
32479,Весенняя,gordunni,1334,priest,discipline,87,41,46
32480,Noneedpriest,stormscale,1333,priest,discipline,24,14,10
32481,Аидкабтв,gordunni,1333,priest,discipline,24,14,10
32482,Memoniia,ravencrest,1333,priest,discipline,48,27,21
32483,Aeo,twisting-nether,1333,priest,discipline,116,61,55
32484,Radiance,emeriss,1333,priest,discipline,40,15,25
32485,Teedye,ravencrest,1332,priest,discipline,18,14,4
32486,Amädeuss,tarren-mill,1331,priest,discipline,60,30,30
32487,Miliane,twisting-nether,1331,priest,discipline,30,14,16
32488,Waafa,kazzak,1331,priest,discipline,42,14,28
32489,Happyprocs,dun-modr,1330,priest,discipline,29,15,14
32490,Valaç,turalyon,1330,priest,discipline,149,76,73
32491,Nuph,ravencrest,1330,priest,discipline,62,29,33
32492,Hekro,thrall,1329,priest,discipline,79,40,39
32493,Xieen,outland,1329,priest,discipline,198,100,98
32494,Hellsaya,ysondre,1328,priest,discipline,48,27,21
32495,Buszeekk,outland,1328,priest,discipline,40,22,18
32496,Cleancf,blackhand,1328,priest,discipline,250,115,135
32497,Peersh,ahnqiraj,1327,priest,discipline,18,14,4
32498,Janclod,pozzo-delleternità,1327,priest,discipline,30,20,10
32499,Spánkproof,kazzak,1327,priest,discipline,24,14,10
32500,Starnote,auchindoun,1327,priest,discipline,36,18,18
32501,Jimmbosmite,stormscale,1327,priest,discipline,54,26,28
32502,Lanthypriest,hyjal,1327,priest,discipline,30,14,16
32503,Jävlarottá,ravencrest,1327,priest,discipline,30,14,16
32504,Gudrinieks,shattered-halls,1327,priest,discipline,44,20,24
32505,Сатанчикгод,howling-fjord,1327,priest,discipline,32,14,18
32506,Nou,aegwynn,1327,priest,discipline,36,14,22
32507,Ximenia,eredar,1325,priest,discipline,43,25,18
32508,Seinaruki,emerald-dream,1325,priest,discipline,34,18,16
32509,Skrnz,turalyon,1325,priest,discipline,59,26,33
32510,Absórb,quelthalas,1325,priest,discipline,54,23,31
32511,Nidrana,drakthul,1325,priest,discipline,36,14,22
32512,Германий,deathguard,1324,priest,discipline,35,21,14
32513,Jodge,ravencrest,1324,priest,discipline,48,26,22
32514,Chodia,silvermoon,1324,priest,discipline,89,48,41
32515,Kalisy,ravencrest,1324,priest,discipline,52,27,25
32516,Calsote,sanguino,1324,priest,discipline,60,25,35
32517,Snylia,blackrock,1324,priest,discipline,36,14,22
32518,Bolflo,khaz-modan,1323,priest,discipline,141,77,64
32519,Reìdood,stormscale,1323,priest,discipline,110,59,51
32520,Déspaír,silvermoon,1323,priest,discipline,173,90,83
32521,Lexojam,ravencrest,1323,priest,discipline,29,14,15
32522,Eîkro,blackmoore,1323,priest,discipline,30,14,16
32523,Bakër,dalaran,1323,priest,discipline,51,23,28
32524,Avengëd,nagrand,1323,priest,discipline,54,24,30
32525,Buttafly,archimonde,1322,priest,discipline,42,23,19
32526,Mercîlezz,eredar,1321,priest,discipline,18,14,4
32527,Endlin,silvermoon,1321,priest,discipline,36,20,16
32528,Tech,draenor,1321,priest,discipline,36,18,18
32529,Filtro,eredar,1321,priest,discipline,232,114,118
32530,Bottemg,defias-brotherhood,1321,priest,discipline,30,14,16
32531,Lenanitro,blackrock,1321,priest,discipline,41,19,22
32532,Никорете,soulflayer,1320,priest,discipline,50,29,21
32533,Blackchrist,uldum,1320,priest,discipline,89,45,44
32534,Nirvánabang,sylvanas,1320,priest,discipline,42,21,21
32535,Выхилютебя,galakrond,1320,priest,discipline,57,27,30
32536,Докторпэйн,howling-fjord,1320,priest,discipline,128,60,68
32537,Fùkøff,stormscale,1319,priest,discipline,32,19,13
32538,Nygel,kazzak,1319,priest,discipline,75,43,32
32539,Soupana,darksorrow,1319,priest,discipline,103,52,51
32540,Shadowsig,silvermoon,1319,priest,discipline,154,76,78
32541,Damnatíon,ravencrest,1318,priest,discipline,18,14,4
32542,Alaeddin,kazzak,1318,priest,discipline,404,196,208
32543,Марджелла,howling-fjord,1318,priest,discipline,46,22,24
32544,Eldrathir,burning-legion,1318,priest,discipline,66,27,39
32545,Babbúb,tarren-mill,1318,priest,discipline,35,14,21
32546,Khato,rexxar,1317,priest,discipline,27,17,10
32547,Schlúckunweg,antonidas,1317,priest,discipline,24,14,10
32548,Papynou,garona,1317,priest,discipline,24,14,10
32549,Мидэрка,howling-fjord,1317,priest,discipline,72,39,33
32550,Apeist,outland,1317,priest,discipline,98,51,47
32551,Phobica,frostmane,1317,priest,discipline,30,14,16
32552,Lizium,kazzak,1316,priest,discipline,42,16,26
32553,Subha,drakthul,1315,priest,discipline,22,15,7
32554,Drioz,ysondre,1315,priest,discipline,108,63,45
32555,Radulfus,stormrage,1314,priest,discipline,24,14,10
32556,Hewwo,sylvanas,1314,priest,discipline,162,83,79
32557,Aboû,archimonde,1314,priest,discipline,51,26,25
32558,Yugo,outland,1314,priest,discipline,41,15,26
32559,Tritonis,draenor,1313,priest,discipline,30,16,14
32560,Senorvåc,ravencrest,1313,priest,discipline,149,75,74
32561,Nukksch,antonidas,1312,priest,discipline,271,131,140
32562,Relaxmom,bloodhoof,1312,priest,discipline,30,14,16
32563,Форсибучи,soulflayer,1312,priest,discipline,66,30,36
32564,Aliciakeys,twilights-hammer,1312,priest,discipline,40,15,25
32565,Quisira,aegwynn,1311,priest,discipline,24,16,8
32566,Ассарх,lich-king,1311,priest,discipline,78,39,39
32567,Spèrman,frostwolf,1311,priest,discipline,48,18,30
32568,Suzziee,silvermoon,1310,priest,discipline,48,25,23
32569,Violentha,silvermoon,1310,priest,discipline,30,15,15
32570,Byebee,stormscale,1309,priest,discipline,23,15,8
32571,Empí,sanguino,1309,priest,discipline,42,23,19
32572,Clua,draenor,1309,priest,discipline,66,35,31
32573,Noserenity,outland,1308,priest,discipline,23,14,9
32574,Curanders,sanguino,1308,priest,discipline,54,26,28
32575,Эннхэтэуэй,soulflayer,1308,priest,discipline,84,39,45
32576,Deadonmyscrn,ravencrest,1307,priest,discipline,24,20,4
32577,Txz,kazzak,1307,priest,discipline,24,14,10
32578,Eowins,blackmoore,1307,priest,discipline,76,40,36
32579,Mirelaw,stormscale,1307,priest,discipline,125,65,60
32580,Chukapi,stormscale,1306,priest,discipline,54,31,23
32581,Tlc,dragonmaw,1306,priest,discipline,103,50,53
32582,Claudefrollo,the-maelstrom,1306,priest,discipline,90,39,51
32583,Juiccyluccy,ravencrest,1306,priest,discipline,35,14,21
32584,Faderken,tarren-mill,1305,priest,discipline,66,42,24
32585,Якакиисус,gordunni,1305,priest,discipline,99,51,48
32586,Щакактрахнем,gordunni,1305,priest,discipline,114,57,57
32587,Shadowmend,aegwynn,1305,priest,discipline,29,14,15
32588,Skuhlx,blackrock,1305,priest,discipline,90,39,51
32589,Tigrok,burning-legion,1304,priest,discipline,101,53,48
32590,Ангеланика,gordunni,1304,priest,discipline,42,22,20
32591,Kutjeskopper,silvermoon,1304,priest,discipline,96,46,50
32592,Fixyou,aggra-português,1303,priest,discipline,114,58,56
32593,Ginebra,archimonde,1302,priest,discipline,42,24,18
32594,Fkup,twisting-nether,1302,priest,discipline,36,20,16
32595,Appox,amanthul,1302,priest,discipline,36,16,20
32596,Missdreavus,draenor,1301,priest,discipline,40,24,16
32597,Щявыхилим,howling-fjord,1301,priest,discipline,85,48,37
32598,Genthus,kazzak,1301,priest,discipline,96,47,49
32599,Overhealzz,blackmoore,1301,priest,discipline,126,59,67
32600,Curlo,ravencrest,1300,priest,discipline,42,20,22
32601,Морисгринх,gordunni,1300,priest,discipline,30,14,16
32602,Xypri,nordrassil,1300,priest,discipline,115,52,63
32603,Хъи,gordunni,1299,priest,discipline,24,16,8
32604,Keimohansio,twisting-nether,1299,priest,discipline,102,57,45
32605,Fatherliam,emerald-dream,1299,priest,discipline,54,24,30
32606,Kidri,kilrogg,1298,priest,discipline,36,20,16
32607,Agorasii,frostwolf,1298,priest,discipline,42,22,20
32608,Voidvania,drakthul,1298,priest,discipline,35,18,17
32609,Velles,nazjatar,1298,priest,discipline,507,255,252
32610,Centaurio,nemesis,1298,priest,discipline,135,65,70
32611,Chocopríest,blackmoore,1298,priest,discipline,52,25,27
32612,Tiefergelegt,arthas,1298,priest,discipline,30,14,16
32613,Nimuëh,ragnaros,1298,priest,discipline,52,24,28
32614,Quecum,draenor,1297,priest,discipline,36,16,20
32615,Matiagmenh,stormscale,1297,priest,discipline,42,18,24
32616,Сайларс,howling-fjord,1297,priest,discipline,36,15,21
32617,Шкуропльот,gordunni,1296,priest,discipline,88,46,42
32618,Лоперамедик,gordunni,1296,priest,discipline,60,28,32
32619,Eloapriest,blackhand,1295,priest,discipline,24,14,10
32620,Nâmîz,blackrock,1295,priest,discipline,27,14,13
32621,Nérôck,frostwolf,1295,priest,discipline,45,22,23
32622,Ciordel,draenor,1295,priest,discipline,59,28,31
32623,Vannax,arygos,1295,priest,discipline,78,35,43
32624,Voidwaffel,blackmoore,1295,priest,discipline,38,17,21
32625,Enduring,darksorrow,1295,priest,discipline,90,39,51
32626,Hauntzer,veknilash,1295,priest,discipline,54,18,36
32627,Powerless,blackmoore,1293,priest,discipline,33,22,11
32628,Duaijhutari,outland,1293,priest,discipline,52,30,22
32629,Oohopeoo,blackmoore,1293,priest,discipline,42,23,19
32630,Pl,sunstrider,1293,priest,discipline,42,22,20
32631,Várósh,blackmoore,1293,priest,discipline,63,32,31
32632,Hensynsløs,draenor,1293,priest,discipline,48,24,24
32633,Credor,blackrock,1293,priest,discipline,42,19,23
32634,Thaiboimby,veknilash,1292,priest,discipline,98,57,41
32635,Tsumu,archimonde,1292,priest,discipline,29,14,15
32636,Nikotyna,doomhammer,1292,priest,discipline,107,51,56
32637,Onicolla,terokkar,1292,priest,discipline,126,60,66
32638,Khoria,drakthul,1292,priest,discipline,30,14,16
32639,Blondi,darksorrow,1292,priest,discipline,46,20,26
32640,Lighter,dragonblight,1291,priest,discipline,88,55,33
32641,Асади,gordunni,1291,priest,discipline,70,37,33
32642,Фурлена,blackscar,1291,priest,discipline,109,56,53
32643,Pocketsimp,stormscale,1291,priest,discipline,56,25,31
32644,Rotzpippn,blackhand,1291,priest,discipline,66,23,43
32645,Gøðlìke,aegwynn,1290,priest,discipline,91,42,49
32646,Relöaded,kazzak,1290,priest,discipline,72,28,44
32647,Alfaböna,outland,1289,priest,discipline,122,66,56
32648,Navid,ravencrest,1289,priest,discipline,45,24,21
32649,Makariotatos,xavius,1289,priest,discipline,36,19,17
32650,Brainwash,darksorrow,1289,priest,discipline,53,18,35
32651,Henreita,darksorrow,1288,priest,discipline,42,23,19
32652,Ebolaidman,ravencrest,1288,priest,discipline,48,24,24
32653,Tristar,nethersturm,1287,priest,discipline,35,19,16
32654,Veýýon,blackmoore,1287,priest,discipline,66,35,31
32655,Nuklash,burning-legion,1287,priest,discipline,57,24,33
32656,Pulttipiispa,ravencrest,1285,priest,discipline,47,24,23
32657,Битуну,fordragon,1285,priest,discipline,84,40,44
32658,Jaheim,tarren-mill,1285,priest,discipline,75,33,42
32659,Liliashet,sanguino,1284,priest,discipline,69,39,30
32660,Keppas,doomhammer,1284,priest,discipline,75,39,36
32661,Pregrip,twisting-nether,1284,priest,discipline,236,116,120
32662,Ufos,stormscale,1284,priest,discipline,62,25,37
32663,Тэвиель,gordunni,1284,priest,discipline,90,36,54
32664,Azazzel,nathrezim,1284,priest,discipline,36,14,22
32665,Yourmann,quelthalas,1283,priest,discipline,54,27,27
32666,Flayin,kazzak,1282,priest,discipline,51,26,25
32667,Shidori,dalaran,1282,priest,discipline,36,17,19
32668,Mynameisebe,twisting-nether,1282,priest,discipline,42,18,24
32669,Gilfir,stormscale,1282,priest,discipline,71,29,42
32670,Glärë,burning-legion,1281,priest,discipline,81,50,31
32671,Jimmyhoffa,stormscale,1281,priest,discipline,54,32,22
32672,Skyggepraest,stormscale,1281,priest,discipline,44,24,20
32673,Makrophage,mannoroth,1281,priest,discipline,28,15,13
32674,Инстенли,howling-fjord,1281,priest,discipline,60,25,35
32675,Dinma,argent-dawn,1280,priest,discipline,197,106,91
32676,Superfelyn,ragnaros,1280,priest,discipline,51,27,24
32677,Doncamïllo,blackrock,1280,priest,discipline,47,22,25
32678,Olereo,blackhand,1280,priest,discipline,84,39,45
32679,Alexnator,malganis,1280,priest,discipline,60,26,34
32680,Purityn,blackhand,1280,priest,discipline,42,14,28
32681,Ûbér,darksorrow,1279,priest,discipline,28,15,13
32682,Доминантрикс,soulflayer,1279,priest,discipline,67,34,33
32683,Zthul,draenor,1279,priest,discipline,33,15,18
32684,Pixelpriest,argent-dawn,1278,priest,discipline,80,52,28
32685,Jokaël,ysondre,1278,priest,discipline,114,48,66
32686,Kïmbo,kazzak,1278,priest,discipline,65,26,39
32687,Spaghettoni,tarren-mill,1278,priest,discipline,35,14,21
32688,Ilvia,antonidas,1277,priest,discipline,28,19,9
32689,Freshpope,ravencrest,1277,priest,discipline,53,31,22
32690,Токсичка,howling-fjord,1277,priest,discipline,36,19,17
32691,Svartochelak,stormscale,1277,priest,discipline,48,19,29
32692,Juhduss,tarren-mill,1276,priest,discipline,35,20,15
32693,Скорлупкина,gordunni,1276,priest,discipline,47,26,21
32694,Fullymetalz,defias-brotherhood,1276,priest,discipline,64,34,30
32695,Asuriyan,ravenholdt,1276,priest,discipline,69,34,35
32696,Zenoo,argent-dawn,1275,priest,discipline,36,22,14
32697,Sinnzz,ysondre,1275,priest,discipline,30,14,16
32698,Hardloker,ravencrest,1275,priest,discipline,84,38,46
32699,Yinyangyø,eredar,1275,priest,discipline,36,16,20
32700,Capriestun,hellfire,1274,priest,discipline,34,20,14
32701,Jezlung,frostmane,1274,priest,discipline,105,59,46
32702,Noodlesoup,daggerspine,1274,priest,discipline,157,81,76
32703,Топчикс,gordunni,1274,priest,discipline,100,51,49
32704,Arrlina,magtheridon,1274,priest,discipline,77,34,43
32705,Snoopqt,dalaran,1274,priest,discipline,67,29,38
32706,Harume,argent-dawn,1273,priest,discipline,24,14,10
32707,Aladorius,la-croisade-écarlate,1273,priest,discipline,52,28,24
32708,Æternadead,nemesis,1273,priest,discipline,185,94,91
32709,Voidjutsu,draenor,1273,priest,discipline,182,92,90
32710,Vedina,bronze-dragonflight,1273,priest,discipline,96,46,50
32711,Nuvie,ravencrest,1273,priest,discipline,60,28,32
32712,Styleexdd,ragnaros,1272,priest,discipline,74,40,34
32713,Overshadowed,kazzak,1272,priest,discipline,175,80,95
32714,Имудонка,gordunni,1272,priest,discipline,48,18,30
32715,Amambo,chamber-of-aspects,1271,priest,discipline,48,26,22
32716,Argaar,burning-legion,1271,priest,discipline,78,41,37
32717,Eros,illidan,1271,priest,discipline,36,16,20
32718,Filit,hyjal,1271,priest,discipline,36,15,21
32719,Jerolol,sanguino,1271,priest,discipline,80,33,47
32720,Skarn,blackmoore,1270,priest,discipline,48,31,17
32721,Viroxian,outland,1270,priest,discipline,38,23,15
32722,Mishas,draenor,1270,priest,discipline,42,24,18
32723,Nerul,twisting-nether,1270,priest,discipline,70,35,35
32724,Mediumheals,tarren-mill,1270,priest,discipline,107,53,54
32725,Priestpvp,dun-modr,1270,priest,discipline,77,38,39
32726,Zùt,ysondre,1269,priest,discipline,48,28,20
32727,Holycowheals,the-maelstrom,1269,priest,discipline,119,67,52
32728,Outcast,korgall,1269,priest,discipline,60,30,30
32729,Haligato,archimonde,1269,priest,discipline,106,51,55
32730,Mallkie,ysondre,1268,priest,discipline,36,21,15
32731,Buzzingg,tarren-mill,1268,priest,discipline,65,36,29
32732,Дюрэкс,soulflayer,1268,priest,discipline,48,22,26
32733,Howaya,la-croisade-écarlate,1267,priest,discipline,78,42,36
32734,Holyschidt,amanthul,1267,priest,discipline,415,205,210
32735,Rodshun,dun-modr,1267,priest,discipline,146,67,79
32736,Аришвд,gordunni,1267,priest,discipline,38,17,21
32737,Пофанчику,gordunni,1266,priest,discipline,58,27,31
32738,Amaloo,ravencrest,1266,priest,discipline,66,29,37
32739,Blagovesta,ravencrest,1266,priest,discipline,42,14,28
32740,Praizejeebus,auchindoun,1265,priest,discipline,24,14,10
32741,Hêsêkiêl,eredar,1265,priest,discipline,48,23,25
32742,Рискаль,borean-tundra,1265,priest,discipline,52,22,30
32743,Jeanpipe,khaz-modan,1264,priest,discipline,24,18,6
32744,Shadowpeste,aggra-português,1264,priest,discipline,156,86,70
32745,Isore,culte-de-la-rive-noire,1264,priest,discipline,125,61,64
32746,Maylà,aegwynn,1264,priest,discipline,106,43,63
32747,Negcntsm,aegwynn,1263,priest,discipline,41,25,16
32748,Акктуальная,deepholm,1263,priest,discipline,54,28,26
32749,Nestélle,drakthul,1263,priest,discipline,153,76,77
32750,Kaktosz,ragnaros,1263,priest,discipline,66,26,40
32751,Ruîzz,sanguino,1262,priest,discipline,170,80,90
32752,Nøheall,ysondre,1261,priest,discipline,101,39,62
32753,Rhåenyra,ravencrest,1260,priest,discipline,36,23,13
32754,Earnzy,outland,1260,priest,discipline,29,15,14
32755,Virgosenpai,silvermoon,1260,priest,discipline,57,28,29
32756,Euphorius,blackmoore,1260,priest,discipline,66,32,34
32757,Brøwney,blackmoore,1260,priest,discipline,42,17,25
32758,Vésph,draenor,1260,priest,discipline,67,24,43
32759,Søînx,archimonde,1259,priest,discipline,27,17,10
32760,Liasanya,kelthuzad,1259,priest,discipline,30,18,12
32761,Popelings,twisting-nether,1259,priest,discipline,54,20,34
32762,Luxumbra,quelthalas,1258,priest,discipline,39,15,24
32763,Аэрэта,deathguard,1257,priest,discipline,60,36,24
32764,Flokz,archimonde,1257,priest,discipline,24,14,10
32765,Rog,norgannon,1257,priest,discipline,30,17,13
32766,Añgêl,ravencrest,1257,priest,discipline,195,99,96
32767,Jordí,darkspear,1257,priest,discipline,191,88,103
32768,Piitixd,burning-legion,1257,priest,discipline,48,22,26
32769,Удзумукец,howling-fjord,1257,priest,discipline,118,51,67
32770,Aszneê,proudmoore,1256,priest,discipline,24,14,10
32771,Øwlsoo,confrérie-du-thorium,1256,priest,discipline,136,70,66
32772,Amphôra,archimonde,1256,priest,discipline,46,22,24
32773,Møldark,silvermoon,1256,priest,discipline,116,48,68
32774,Lothbruke,twisting-nether,1256,priest,discipline,48,17,31
32775,Brach,nazjatar,1255,priest,discipline,90,47,43
32776,Shieldyblaze,frostwolf,1255,priest,discipline,125,64,61
32777,Dotsin,kazzak,1255,priest,discipline,271,137,134
32778,Фрустрациия,soulflayer,1255,priest,discipline,34,17,17
32779,Rightx,outland,1255,priest,discipline,125,60,65
32780,Míllerzz,ragnaros,1255,priest,discipline,54,22,32
32781,Pxescalol,aegwynn,1254,priest,discipline,23,14,9
32782,Praystatîon,dragonblight,1254,priest,discipline,132,80,52
32783,Mournus,defias-brotherhood,1253,priest,discipline,47,35,12
32784,Feriant,argent-dawn,1253,priest,discipline,47,27,20
32785,Buckless,kazzak,1253,priest,discipline,30,17,13
32786,Одинокаягора,gordunni,1253,priest,discipline,72,36,36
32787,Enerpriest,ysondre,1253,priest,discipline,42,21,21
32788,Тварьгосподя,gordunni,1253,priest,discipline,344,170,174
32789,Mercies,kazzak,1252,priest,discipline,23,14,9
32790,Slitenprest,kazzak,1252,priest,discipline,42,24,18
32791,Torcena,garrosh,1252,priest,discipline,48,16,32
32792,Shaydi,todeswache,1251,priest,discipline,24,18,6
32793,Kelras,grim-batol,1251,priest,discipline,104,63,41
32794,Elyradp,dun-modr,1251,priest,discipline,78,43,35
32795,Pindakong,dragonblight,1251,priest,discipline,55,28,27
32796,Даркфолс,soulflayer,1251,priest,discipline,59,30,29
32797,Eksel,silvermoon,1251,priest,discipline,72,33,39
32798,Triksas,sylvanas,1250,priest,discipline,66,42,24
32799,Pleistras,magtheridon,1250,priest,discipline,192,107,85
32800,Spoc,blackrock,1250,priest,discipline,53,29,24
32801,Healyourmum,stormscale,1250,priest,discipline,102,51,51
32802,Seneth,twisting-nether,1250,priest,discipline,35,15,20
32803,Deneye,thunderhorn,1249,priest,discipline,72,42,30
32804,Lzmad,archimonde,1249,priest,discipline,60,34,26
32805,Shomäre,ysondre,1249,priest,discipline,36,20,16
32806,Arenarooky,eredar,1249,priest,discipline,42,22,20
32807,Yojoyo,draenor,1249,priest,discipline,171,82,89
32808,Suprenext,draenor,1248,priest,discipline,24,13,11
32809,Mazikeen,stormscale,1248,priest,discipline,24,13,11
32810,Pvpriestess,silvermoon,1248,priest,discipline,138,66,72
32811,Dpxd,tarren-mill,1248,priest,discipline,36,16,20
32812,Còsmo,ravencrest,1248,priest,discipline,30,13,17
32813,Stmichael,silvermoon,1248,priest,discipline,38,15,23
32814,Zolfiqar,tarren-mill,1247,priest,discipline,24,18,6
32815,Møelester,antonidas,1247,priest,discipline,18,13,5
32816,Niíall,skullcrusher,1247,priest,discipline,18,13,5
32817,Lánî,blackmoore,1247,priest,discipline,20,13,7
32818,Zathada,twisting-nether,1247,priest,discipline,30,19,11
32819,Mqsx,stormscale,1247,priest,discipline,24,13,11
32820,Swdömmel,aegwynn,1247,priest,discipline,24,13,11
32821,Krautfunding,blackrock,1247,priest,discipline,24,13,11
32822,Krokkete,hyjal,1247,priest,discipline,24,13,11
32823,Nakenhäst,stormscale,1247,priest,discipline,24,13,11
32824,Аквариусс,gordunni,1247,priest,discipline,82,40,42
32825,Sissi,blackmoore,1247,priest,discipline,114,54,60
32826,Garie,thrall,1247,priest,discipline,80,35,45
32827,Эсминза,gordunni,1247,priest,discipline,30,13,17
32828,Lasyran,outland,1247,priest,discipline,30,13,17
32829,Xourin,blackrock,1247,priest,discipline,34,14,20
32830,Smallsmilesx,blackrock,1247,priest,discipline,36,13,23
32831,Noukeé,blackrock,1247,priest,discipline,36,13,23
32832,Ørrak,hyjal,1246,priest,discipline,24,14,10
32833,Bottom,blackmoore,1246,priest,discipline,24,13,11
32834,Exola,outland,1246,priest,discipline,24,13,11
32835,Quepimquepam,tarren-mill,1246,priest,discipline,41,18,23
32836,Ishkà,stormscale,1246,priest,discipline,30,13,17
32837,Arklim,burning-blade,1246,priest,discipline,80,32,48
32838,Deliâz,aegwynn,1246,priest,discipline,36,14,22
32839,Padregianni,nemesis,1246,priest,discipline,36,13,23
32840,Оуаы,soulflayer,1245,priest,discipline,123,62,61
32841,Умом,gordunni,1245,priest,discipline,30,13,17
32842,Drïxit,illidan,1245,priest,discipline,36,13,23
32843,Undeadpriest,aegwynn,1245,priest,discipline,36,13,23
32844,Theycmedotin,blackhand,1245,priest,discipline,42,13,29
32845,Hotdog,kult-der-verdammten,1244,priest,discipline,30,17,13
32846,Egî,lothar,1244,priest,discipline,24,13,11
32847,Jumby,outland,1244,priest,discipline,30,13,17
32848,Doombrew,blackmoore,1244,priest,discipline,30,13,17
32849,Tackerjoè,eredar,1244,priest,discipline,48,20,28
32850,Шадоухоррор,gordunni,1244,priest,discipline,57,23,34
32851,Wedoburgers,ravencrest,1243,priest,discipline,18,13,5
32852,Takeoff,dun-morogh,1243,priest,discipline,36,23,13
32853,Vokuheala,tarren-mill,1243,priest,discipline,29,16,13
32854,Tjackballé,tarren-mill,1243,priest,discipline,24,13,11
32855,Lalola,tarren-mill,1243,priest,discipline,77,41,36
32856,Hurtless,ravencrest,1243,priest,discipline,33,13,20
32857,Eitukaeitai,outland,1243,priest,discipline,36,13,23
32858,Shadowburst,archimonde,1242,priest,discipline,24,13,11
32859,Gumer,antonidas,1242,priest,discipline,24,13,11
32860,Мсикатана,gordunni,1242,priest,discipline,24,13,11
32861,Chîllipriest,draenor,1242,priest,discipline,24,13,11
32862,Rrdisc,kazzak,1242,priest,discipline,69,31,38
32863,Дцевгений,gordunni,1242,priest,discipline,36,13,23
32864,Darkpræcher,hyjal,1241,priest,discipline,38,28,10
32865,Romero,sylvanas,1241,priest,discipline,18,13,5
32866,Herapeutic,argent-dawn,1241,priest,discipline,23,15,8
32867,Педаньтяйка,gordunni,1241,priest,discipline,228,130,98
32868,Deyxq,lothar,1241,priest,discipline,24,13,11
32869,Striderz,outland,1241,priest,discipline,24,13,11
32870,Bellanote,dalaran,1241,priest,discipline,171,83,88
32871,Nashára,defias-brotherhood,1241,priest,discipline,90,42,48
32872,Loreleì,sylvanas,1240,priest,discipline,18,13,5
32873,Qoryn,ravencrest,1240,priest,discipline,30,13,17
32874,Dartheon,twisting-nether,1240,priest,discipline,101,43,58
32875,Aptz,twisting-nether,1240,priest,discipline,36,13,23
32876,Rmp,stormscale,1240,priest,discipline,39,13,26
32877,Nightfearqt,outland,1239,priest,discipline,20,13,7
32878,Diçkhëad,ravencrest,1239,priest,discipline,67,35,32
32879,Yante,ragnaros,1239,priest,discipline,69,34,35
32880,Mamasmilk,draenor,1238,priest,discipline,40,25,15
32881,Apèx,blackrock,1238,priest,discipline,78,40,38
32882,Türapea,draenor,1238,priest,discipline,122,61,61
32883,Crop,nemesis,1238,priest,discipline,54,21,33
32884,Sordag,lordaeron,1238,priest,discipline,36,13,23
32885,Джейнкелли,borean-tundra,1237,priest,discipline,150,90,60
32886,Tephutes,ravencrest,1237,priest,discipline,27,14,13
32887,Новокшан,soulflayer,1237,priest,discipline,36,18,18
32888,Holydoughnut,stormscale,1237,priest,discipline,54,25,29
32889,Sazo,drakthul,1237,priest,discipline,38,16,22
32890,Djchinoix,archimonde,1236,priest,discipline,18,13,5
32891,Kochepri,archimonde,1236,priest,discipline,36,21,15
32892,Héntai,argent-dawn,1236,priest,discipline,30,15,15
32893,Sahu,kult-der-verdammten,1236,priest,discipline,44,21,23
32894,Bldnl,ragnaros,1236,priest,discipline,49,22,27
32895,Xet,outland,1236,priest,discipline,56,24,32
32896,Crazypablito,burning-legion,1236,priest,discipline,59,25,34
32897,Jbte,silvermoon,1235,priest,discipline,102,57,45
32898,Smellypecker,argent-dawn,1235,priest,discipline,36,19,17
32899,Ticklebell,ravencrest,1235,priest,discipline,255,133,122
32900,Discovery,aggra-português,1235,priest,discipline,54,28,26
32901,Mivale,aszune,1234,priest,discipline,26,15,11
32902,Palitox,kazzak,1234,priest,discipline,42,23,19
32903,Holyswift,dun-morogh,1234,priest,discipline,173,91,82
32904,Zofa,sunstrider,1234,priest,discipline,50,23,27
32905,Divaz,eredar,1234,priest,discipline,48,18,30
32906,Fetmeister,drakthul,1233,priest,discipline,24,13,11
32907,Soehzz,khaz-modan,1233,priest,discipline,90,45,45
32908,Wandéline,arathi,1233,priest,discipline,59,26,33
32909,Самурайко,booty-bay,1233,priest,discipline,48,21,27
32910,Pretee,nemesis,1233,priest,discipline,30,13,17
32911,Anotherlife,stormscale,1232,priest,discipline,18,13,5
32912,Felanris,blackmoore,1232,priest,discipline,42,26,16
32913,Neytirinqt,doomhammer,1232,priest,discipline,108,56,52
32914,Glaces,archimonde,1232,priest,discipline,47,24,23
32915,Janinw,sylvanas,1232,priest,discipline,30,13,17
32916,Samtig,malganis,1232,priest,discipline,57,23,34
32917,Nogz,rashgarroth,1231,priest,discipline,56,34,22
32918,Akingodxz,twisting-nether,1231,priest,discipline,24,13,11
32919,Tristessê,tarren-mill,1231,priest,discipline,132,55,77
32920,Пнух,soulflayer,1231,priest,discipline,36,13,23
32921,Cöpahue,sanguino,1230,priest,discipline,18,13,5
32922,Svartylol,outland,1230,priest,discipline,24,14,10
32923,Lucianßk,sanguino,1230,priest,discipline,48,27,21
32924,Asnur,argent-dawn,1230,priest,discipline,48,24,24
32925,Darkheall,sanguino,1230,priest,discipline,81,35,46
32926,Aroghul,eredar,1230,priest,discipline,108,46,62
32927,Omnissiiah,silvermoon,1230,priest,discipline,42,14,28
32928,Séfaron,blackmoore,1229,priest,discipline,28,20,8
32929,Levimm,turalyon,1229,priest,discipline,103,52,51
32930,Héternel,ysondre,1229,priest,discipline,80,39,41
32931,Пенансиня,gordunni,1229,priest,discipline,36,13,23
32932,Diff,thrall,1228,priest,discipline,75,37,38
32933,Deathstrike,blackrock,1228,priest,discipline,36,15,21
32934,Ggsus,outland,1228,priest,discipline,66,25,41
32935,Felerman,kazzak,1228,priest,discipline,36,13,23
32936,Holybestie,eredar,1227,priest,discipline,30,18,12
32937,Selenar,neptulon,1227,priest,discipline,54,30,24
32938,Мазка,galakrond,1227,priest,discipline,54,23,31
32939,Ødelia,anubarak,1226,priest,discipline,18,13,5
32940,Sytrix,frostwolf,1226,priest,discipline,30,18,12
32941,Nioubèy,archimonde,1226,priest,discipline,35,19,16
32942,Фрит,lich-king,1226,priest,discipline,93,50,43
32943,Seum,ravencrest,1226,priest,discipline,92,48,44
32944,Gacoo,silvermoon,1226,priest,discipline,150,70,80
32945,Netomv,kazzak,1225,priest,discipline,41,21,20
32946,Duem,kazzak,1225,priest,discipline,54,27,27
32947,Kenderke,ragnaros,1225,priest,discipline,35,16,19
32948,Nielar,onyxia,1225,priest,discipline,30,13,17
32949,Saat,dalaran,1224,priest,discipline,32,21,11
32950,Baglet,ravencrest,1224,priest,discipline,24,13,11
32951,Chuwbakka,kazzak,1224,priest,discipline,100,53,47
32952,Drennaria,draenor,1224,priest,discipline,65,31,34
32953,Therezzer,burning-legion,1224,priest,discipline,36,16,20
32954,Prodan,frostmane,1223,priest,discipline,66,37,29
32955,Ästûr,sanguino,1223,priest,discipline,84,43,41
32956,Angusbeêf,blackrock,1223,priest,discipline,212,108,104
32957,Gobie,sunstrider,1223,priest,discipline,30,13,17
32958,Miraev,argent-dawn,1223,priest,discipline,30,13,17
32959,Dosentti,ragnaros,1222,priest,discipline,24,14,10
32960,Csiillux,ragnaros,1222,priest,discipline,42,22,20
32961,Дракулесса,gordunni,1221,priest,discipline,63,31,32
32962,Сегуната,howling-fjord,1221,priest,discipline,36,13,23
32963,Vès,stormscale,1220,priest,discipline,72,37,35
32964,Aerosoll,drakthul,1220,priest,discipline,42,21,21
32965,Verrottênd,frostwolf,1220,priest,discipline,94,40,54
32966,Hopsalopsa,argent-dawn,1219,priest,discipline,18,13,5
32967,Holyrage,frostwhisper,1219,priest,discipline,24,13,11
32968,Карнотит,howling-fjord,1219,priest,discipline,180,82,98
32969,Bigfnatlund,silvermoon,1219,priest,discipline,41,18,23
32970,Elusivv,blackhand,1219,priest,discipline,30,13,17
32971,Xghazo,sylvanas,1218,priest,discipline,45,25,20
32972,Talonjean,conseil-des-ombres,1218,priest,discipline,24,13,11
32973,Лолиэль,soulflayer,1218,priest,discipline,63,34,29
32974,Залупский,gordunni,1218,priest,discipline,41,19,22
32975,Shadowhawke,argent-dawn,1218,priest,discipline,35,15,20
32976,Bzets,jaedenar,1217,priest,discipline,77,45,32
32977,Eremit,silvermoon,1217,priest,discipline,115,58,57
32978,Allotment,silvermoon,1217,priest,discipline,48,24,24
32979,Attenna,ravencrest,1217,priest,discipline,81,34,47
32980,Nìak,ysondre,1217,priest,discipline,100,39,61
32981,Дайбчик,gordunni,1216,priest,discipline,44,25,19
32982,Капляболи,gordunni,1216,priest,discipline,51,28,23
32983,Xail,blackrock,1216,priest,discipline,54,23,31
32984,Rngq,burning-blade,1215,priest,discipline,23,13,10
32985,Patoroch,terokkar,1215,priest,discipline,48,26,22
32986,Elfdarkholme,stormscale,1215,priest,discipline,48,26,22
32987,Shadoomed,kazzak,1215,priest,discipline,72,29,43
32988,Feydottir,draenor,1214,priest,discipline,36,19,17
32989,Valnaya,draenor,1214,priest,discipline,146,77,69
32990,Healsquad,draenor,1214,priest,discipline,106,53,53
32991,Флэнсер,soulflayer,1214,priest,discipline,276,131,145
32992,Astraniaa,blackmoore,1214,priest,discipline,42,19,23
32993,Roosy,malganis,1214,priest,discipline,41,16,25
32994,Nymrasus,ravencrest,1213,priest,discipline,24,13,11
32995,Sandaal,drakthul,1213,priest,discipline,72,36,36
32996,Littleabs,the-maelstrom,1213,priest,discipline,77,38,39
32997,Antiexhile,kazzak,1213,priest,discipline,41,20,21
32998,Lãwh,hyjal,1213,priest,discipline,89,43,46
32999,Imbadancer,turalyon,1212,priest,discipline,78,42,36
33000,Ðøð,dalaran,1210,priest,discipline,54,33,21
33001,Vempress,neptulon,1210,priest,discipline,48,24,24
33002,Nixxaa,drakthul,1210,priest,discipline,36,16,20
33003,Swaggerboy,alakir,1210,priest,discipline,41,13,28
33004,Äncient,ragnaros,1209,priest,discipline,24,13,11
33005,Jeuwls,argent-dawn,1209,priest,discipline,121,64,57
33006,Whitehusky,antonidas,1209,priest,discipline,42,21,21
33007,Vèrcs,silvermoon,1209,priest,discipline,30,14,16
33008,Thimble,blackhand,1209,priest,discipline,37,17,20
33009,Лин,howling-fjord,1208,priest,discipline,22,13,9
33010,Pestaso,shendralar,1208,priest,discipline,24,13,11
33011,Iømÿnudir,archimonde,1208,priest,discipline,115,57,58
33012,Confess,archimonde,1207,priest,discipline,36,20,16
33013,Dúréx,sanguino,1207,priest,discipline,39,19,20
33014,Nëophytë,zuljin,1207,priest,discipline,72,35,37
33015,Жрицазла,soulflayer,1207,priest,discipline,60,28,32
33016,Petitcaca,outland,1207,priest,discipline,99,45,54
33017,Whiteshadöw,archimonde,1207,priest,discipline,36,13,23
33018,Paulinka,auchindoun,1207,priest,discipline,36,13,23
33019,Joebando,ravencrest,1206,priest,discipline,86,43,43
33020,Marylin,senjin,1206,priest,discipline,219,107,112
33021,Thyrandis,dragonblight,1206,priest,discipline,34,14,20
33022,Nostramo,kirin-tor,1206,priest,discipline,54,19,35
33023,Nethenielle,malganis,1205,priest,discipline,42,20,22
33024,Texstil,blackmoore,1205,priest,discipline,30,14,16
33025,Norlyset,silvermoon,1205,priest,discipline,102,46,56
33026,Linara,frostmane,1204,priest,discipline,18,13,5
33027,Asolan,drakthul,1204,priest,discipline,192,98,94
33028,Mcbooee,outland,1204,priest,discipline,42,21,21
33029,Kårejonny,tarren-mill,1204,priest,discipline,61,30,31
33030,Crazyhemsire,twisting-nether,1203,priest,discipline,30,19,11
33031,Nazo,sylvanas,1203,priest,discipline,83,46,37
33032,Novilas,thrall,1203,priest,discipline,42,21,21
33033,Werita,frostmane,1203,priest,discipline,122,54,68
33034,Свежага,howling-fjord,1203,priest,discipline,76,33,43
33035,Umbraya,blackhand,1203,priest,discipline,78,26,52
33036,Beaglep,blackrock,1203,priest,discipline,53,13,40
33037,Calah,frostwhisper,1202,priest,discipline,36,13,23
33038,Pontifex,baelgun,1201,priest,discipline,126,73,53
33039,Perdítá,thrall,1200,priest,discipline,219,107,112
33040,Dementzia,argent-dawn,1200,priest,discipline,89,43,46
33041,Shzuna,archimonde,1200,priest,discipline,54,26,28
33042,Jeuhy,talnivarr,1200,priest,discipline,131,62,69
33043,Balhlin,argent-dawn,1200,priest,discipline,88,38,50
33044,Мегаствол,howling-fjord,1200,priest,discipline,66,28,38
33045,Índica,stormreaver,1199,priest,discipline,18,13,5
33046,Saru,uldaman,1199,priest,discipline,70,38,32
33047,Leprie,draenor,1199,priest,discipline,39,15,24
33048,Drtickomaru,drakthul,1197,priest,discipline,32,16,16
33049,Adeeva,ravencrest,1196,priest,discipline,65,40,25
33050,Sisdenna,doomhammer,1196,priest,discipline,272,141,131
33051,Sacerfull,sanguino,1196,priest,discipline,100,46,54
33052,Wynkx,zuljin,1196,priest,discipline,66,24,42
33053,Zamurak,outland,1195,priest,discipline,75,35,40
33054,Подчинись,ashenvale,1193,priest,discipline,150,81,69
33055,Lyim,stormscale,1192,priest,discipline,23,13,10
33056,Mandarinee,blackmoore,1192,priest,discipline,166,73,93
33057,Mukake,burning-legion,1192,priest,discipline,82,36,46
33058,Achillesheal,alakir,1192,priest,discipline,30,13,17
33059,Xakala,cthun,1191,priest,discipline,93,52,41
33060,Elronmcbông,ravencrest,1191,priest,discipline,72,32,40
33061,Clergy,hellfire,1190,priest,discipline,78,50,28
33062,Obeliskprist,kazzak,1190,priest,discipline,30,14,16
33063,Perimortal,norgannon,1190,priest,discipline,57,26,31
33064,Salves,blackmoore,1190,priest,discipline,53,24,29
33065,Uro,tirion,1190,priest,discipline,41,14,27
33066,Kovács,tarren-mill,1189,priest,discipline,75,42,33
33067,Eník,blackrock,1189,priest,discipline,60,27,33
33068,Radizzel,thrall,1189,priest,discipline,34,13,21
33069,Zergo,karazhan,1189,priest,discipline,52,18,34
33070,Galadríel,malganis,1188,priest,discipline,23,13,10
33071,Megalodön,draenor,1187,priest,discipline,45,17,28
33072,Lillthya,kazzak,1186,priest,discipline,58,24,34
33073,Zranda,magtheridon,1185,priest,discipline,78,36,42
33074,Devîlcry,nordrassil,1184,priest,discipline,96,55,41
33075,Obito,outland,1183,priest,discipline,23,13,10
33076,Freezydot,silvermoon,1183,priest,discipline,87,49,38
33077,Sickz,blackrock,1183,priest,discipline,42,15,27
33078,Камшотхил,gordunni,1182,priest,discipline,64,35,29
33079,Holydörte,aegwynn,1182,priest,discipline,99,47,52
33080,Výra,der-rat-von-dalaran,1182,priest,discipline,32,13,19
33081,Dezriah,tarren-mill,1181,priest,discipline,157,81,76
33082,Goldenapples,ravencrest,1181,priest,discipline,43,22,21
33083,Praywingsebb,nazjatar,1181,priest,discipline,30,14,16
33084,Swtt,sanguino,1180,priest,discipline,84,41,43
33085,Dopemine,ragnaros,1179,priest,discipline,36,18,18
33086,Medycus,blackrock,1179,priest,discipline,60,25,35
33087,Riseandshine,draenor,1178,priest,discipline,36,15,21
33088,Jaimeê,der-rat-von-dalaran,1177,priest,discipline,31,16,15
33089,Nnaoy,ysondre,1177,priest,discipline,26,13,13
33090,Whitepitch,doomhammer,1177,priest,discipline,89,39,50
33091,Zentro,turalyon,1177,priest,discipline,79,34,45
33092,Firstkiss,rexxar,1176,priest,discipline,42,24,18
33093,Шуали,grom,1176,priest,discipline,54,28,26
33094,Vrêth,blackmoore,1176,priest,discipline,39,15,24
33095,Fimor,die-nachtwache,1175,priest,discipline,48,26,22
33096,Fleamana,stormscale,1175,priest,discipline,60,25,35
33097,Tyog,khazgoroth,1174,priest,discipline,25,14,11
33098,Скорояпомощь,gordunni,1174,priest,discipline,107,58,49
33099,Loetharion,archimonde,1174,priest,discipline,71,36,35
33100,Nelvor,silvermoon,1174,priest,discipline,42,21,21
33101,Silvdarr,hyjal,1174,priest,discipline,101,48,53
33102,Elfhelp,ravencrest,1174,priest,discipline,68,28,40
33103,Xkv,blackmoore,1173,priest,discipline,42,24,18
33104,Rashyd,sylvanas,1173,priest,discipline,42,24,18
33105,Забвениеждёт,gordunni,1173,priest,discipline,83,37,46
33106,Gesucristò,pozzo-delleternità,1172,priest,discipline,24,14,10
33107,Парикнахер,soulflayer,1171,priest,discipline,36,23,13
33108,Ksiadzrydzyk,draenor,1171,priest,discipline,36,20,16
33109,Captn,draenor,1171,priest,discipline,54,22,32
33110,Cøøbrà,hyjal,1170,priest,discipline,70,38,32
33111,Petshopboi,sylvanas,1170,priest,discipline,27,14,13
33112,Antibiotic,auchindoun,1170,priest,discipline,106,52,54
33113,Aetherah,outland,1170,priest,discipline,36,16,20
33114,Àri,magtheridon,1170,priest,discipline,41,15,26
33115,Allisandre,hellscream,1169,priest,discipline,24,13,11
33116,Сайннз,howling-fjord,1169,priest,discipline,180,86,94
33117,Ноубадди,howling-fjord,1169,priest,discipline,67,32,35
33118,Gertie,blackhand,1168,priest,discipline,100,52,48
33119,Elclasico,blackrock,1168,priest,discipline,68,28,40
33120,Popegoat,ragnaros,1167,priest,discipline,53,38,15
33121,Luedieniel,draenor,1167,priest,discipline,29,15,14
33122,Kizzorde,ragnaros,1166,priest,discipline,98,49,49
33123,Drsmort,blackrock,1166,priest,discipline,78,37,41
33124,Cupcakes,ahnqiraj,1166,priest,discipline,60,26,34
33125,Эски,howling-fjord,1165,priest,discipline,36,13,23
33126,Szeky,ragnaros,1165,priest,discipline,36,13,23
33127,Gooldan,draenor,1164,priest,discipline,66,39,27
33128,Свапмиплиз,gordunni,1164,priest,discipline,175,81,94
33129,Монесса,howling-fjord,1164,priest,discipline,44,20,24
33130,Olîra,hyjal,1163,priest,discipline,30,14,16
33131,Andhoras,dalaran,1163,priest,discipline,35,13,22
33132,Ribbins,outland,1162,priest,discipline,54,22,32
33133,Blàckângel,blackrock,1161,priest,discipline,312,156,156
33134,Klaura,blackmoore,1161,priest,discipline,30,15,15
33135,Worldjudge,kazzak,1160,priest,discipline,53,27,26
33136,Flyingdutch,tarren-mill,1160,priest,discipline,263,123,140
33137,Milessa,steamwheedle-cartel,1160,priest,discipline,66,29,37
33138,Déxguard,silvermoon,1160,priest,discipline,70,26,44
33139,Акимбопушка,howling-fjord,1159,priest,discipline,74,27,47
33140,Javvi,sylvanas,1158,priest,discipline,78,44,34
33141,Vebbysor,sylvanas,1158,priest,discipline,30,15,15
33142,Myrmeen,silvermoon,1158,priest,discipline,97,46,51
33143,Гуляль,howling-fjord,1157,priest,discipline,76,43,33
33144,Brunestùd,pozzo-delleternità,1157,priest,discipline,68,33,35
33145,Mjölkpelle,twisting-nether,1156,priest,discipline,24,18,6
33146,Klaniara,silvermoon,1156,priest,discipline,76,41,35
33147,Réborn,tarren-mill,1156,priest,discipline,36,19,17
33148,Qyi,the-maelstrom,1156,priest,discipline,36,18,18
33149,Kínson,the-maelstrom,1155,priest,discipline,67,37,30
33150,Vecaya,blackrock,1155,priest,discipline,42,22,20
33151,Døline,hyjal,1155,priest,discipline,29,13,16
33152,Xyliqa,aegwynn,1155,priest,discipline,35,14,21
33153,Chega,malganis,1154,priest,discipline,84,34,50
33154,Гундяй,soulflayer,1153,priest,discipline,51,28,23
33155,Karellian,silvermoon,1153,priest,discipline,36,17,19
33156,Barbiemeth,silvermoon,1153,priest,discipline,144,66,78
33157,Lidlpriest,frostwolf,1152,priest,discipline,18,12,6
33158,Oldnbad,archimonde,1152,priest,discipline,18,12,6
33159,Tobadforglad,khaz-modan,1152,priest,discipline,18,12,6
33160,Fkitweball,argent-dawn,1152,priest,discipline,18,12,6
33161,Keijuñâ,tarren-mill,1152,priest,discipline,24,12,12
33162,Proxsjr,ravencrest,1152,priest,discipline,24,12,12
33163,Heab,aegwynn,1152,priest,discipline,24,12,12
33164,Найтингеилл,gordunni,1152,priest,discipline,24,12,12
33165,Djros,magtheridon,1152,priest,discipline,24,12,12
33166,Незерхэвэн,soulflayer,1152,priest,discipline,24,12,12
33167,Tjackmackann,kazzak,1152,priest,discipline,24,12,12
33168,Donpedrila,kazzak,1152,priest,discipline,24,12,12
33169,Djrussia,tarren-mill,1152,priest,discipline,30,12,18
33170,Djokui,uldum,1152,priest,discipline,30,12,18
33171,Yarok,anubarak,1151,priest,discipline,18,12,6
33172,Uncreative,ravencrest,1151,priest,discipline,18,12,6
33173,Árnyékfing,ragnaros,1151,priest,discipline,47,24,23
33174,Arythc,ahnqiraj,1151,priest,discipline,24,12,12
33175,Dotctor,ysondre,1151,priest,discipline,49,24,25
33176,Shadeblaze,draenor,1151,priest,discipline,38,16,22
33177,Oesterput,stormscale,1151,priest,discipline,30,12,18
33178,Кошкаенот,blackscar,1151,priest,discipline,30,12,18
33179,Shììnx,hyjal,1151,priest,discipline,30,12,18
33180,Ykwah,kazzak,1151,priest,discipline,30,12,18
33181,Aerael,auchindoun,1150,priest,discipline,18,12,6
33182,Хильдинда,soulflayer,1150,priest,discipline,54,27,27
33183,Davóss,outland,1150,priest,discipline,24,12,12
33184,Naomirussell,sylvanas,1150,priest,discipline,24,12,12
33185,Reclue,silvermoon,1150,priest,discipline,24,12,12
33186,Fléxéd,burning-legion,1150,priest,discipline,24,12,12
33187,Trixtrex,aegwynn,1150,priest,discipline,30,12,18
33188,Alptoxlôl,blackhand,1150,priest,discipline,36,14,22
33189,Nuriva,frostmane,1150,priest,discipline,36,12,24
33190,Dogfx,blackhand,1150,priest,discipline,42,12,30
33191,Roskva,archimonde,1149,priest,discipline,21,13,8
33192,Floorpovx,blackmoore,1149,priest,discipline,24,12,12
33193,Ghoul,destromath,1149,priest,discipline,24,12,12
33194,Denarne,blackrock,1149,priest,discipline,24,12,12
33195,Simbaba,archimonde,1149,priest,discipline,66,30,36
33196,Hialdo,bladefist,1149,priest,discipline,36,12,24
33197,Discmoo,kazzak,1148,priest,discipline,20,12,8
33198,Yörüichi,kazzak,1148,priest,discipline,24,12,12
33199,Rokil,ravencrest,1148,priest,discipline,24,12,12
33200,Skinandbones,sylvanas,1148,priest,discipline,36,12,24
33201,Isendth,archimonde,1148,priest,discipline,42,12,30
33202,Ribberull,burning-blade,1147,priest,discipline,24,12,12
33203,Meganx,ravencrest,1147,priest,discipline,24,12,12
33204,Hydroxizine,ragnaros,1147,priest,discipline,24,12,12
33205,Уртримас,gordunni,1147,priest,discipline,128,59,69
33206,Pakmopriest,ragnaros,1147,priest,discipline,30,12,18
33207,Zêlða,ravencrest,1147,priest,discipline,30,12,18
33208,Nack,marécage-de-zangar,1147,priest,discipline,30,12,18
33209,Deicidex,blackrock,1147,priest,discipline,36,12,24
33210,Badguymike,ragnaros,1146,priest,discipline,18,12,6
33211,Tyrial,outland,1146,priest,discipline,18,12,6
33212,Teirok,ambossar,1146,priest,discipline,60,29,31
33213,Джоега,grom,1146,priest,discipline,41,12,29
33214,Resgan,archimonde,1145,priest,discipline,22,13,9
33215,Яестькенни,soulflayer,1145,priest,discipline,48,24,24
33216,Saitani,stormscale,1145,priest,discipline,24,12,12
33217,Фикспрайз,gordunni,1145,priest,discipline,24,12,12
33218,Docpower,twisting-nether,1145,priest,discipline,24,12,12
33219,Impecabllo,outland,1145,priest,discipline,24,12,12
33220,Zielonymisiu,burning-legion,1145,priest,discipline,54,26,28
33221,Floory,twisting-nether,1145,priest,discipline,151,70,81
33222,Limpopon,doomhammer,1145,priest,discipline,45,19,26
33223,Shadowkym,blackrock,1144,priest,discipline,18,12,6
33224,Freazi,burning-blade,1144,priest,discipline,24,14,10
33225,Johnnypleb,blackrock,1144,priest,discipline,114,58,56
33226,Dêrp,frostwolf,1144,priest,discipline,24,12,12
33227,Blacklemons,thrall,1144,priest,discipline,24,12,12
33228,Штецель,howling-fjord,1144,priest,discipline,30,12,18
33229,Loliheal,blackmoore,1144,priest,discipline,34,13,21
33230,Ilovechildrn,silvermoon,1143,priest,discipline,18,12,6
33231,Doomey,ravencrest,1142,priest,discipline,18,12,6
33232,Ciqua,frostmane,1142,priest,discipline,18,12,6
33233,Morava,tarren-mill,1142,priest,discipline,36,20,16
33234,Plaguetale,archimonde,1142,priest,discipline,65,35,30
33235,Саня,razuvious,1142,priest,discipline,24,12,12
33236,Manau,culte-de-la-rive-noire,1142,priest,discipline,30,12,18
33237,Barnicha,grim-batol,1141,priest,discipline,18,12,6
33238,Talyie,argent-dawn,1141,priest,discipline,18,12,6
33239,Noskan,silvermoon,1141,priest,discipline,21,13,8
33240,Kinn,kaelthas,1141,priest,discipline,36,18,18
33241,Aviz,tarren-mill,1141,priest,discipline,24,12,12
33242,Karzin,aggra-português,1141,priest,discipline,66,32,34
33243,Daesa,defias-brotherhood,1140,priest,discipline,24,14,10
33244,Убивал,soulflayer,1140,priest,discipline,24,12,12
33245,Dizpel,stormscale,1140,priest,discipline,35,13,22
33246,Celina,quelthalas,1140,priest,discipline,36,12,24
33247,Canthms,twisting-nether,1139,priest,discipline,42,25,17
33248,Mädmän,draenor,1139,priest,discipline,72,38,34
33249,Healmebaby,kiljaeden,1139,priest,discipline,24,12,12
33250,Teleriah,blackmoore,1139,priest,discipline,47,16,31
33251,Voldream,ravencrest,1139,priest,discipline,36,12,24
33252,Kaydenkross,eredar,1139,priest,discipline,42,12,30
33253,Dionegativ,draenor,1139,priest,discipline,42,12,30
33254,Quinax,shattered-hand,1138,priest,discipline,24,12,12
33255,Bauscia,nemesis,1138,priest,discipline,24,12,12
33256,Clapclap,frostmourne,1138,priest,discipline,34,13,21
33257,Chankro,sanguino,1137,priest,discipline,24,12,12
33258,Æøí,blackmoore,1137,priest,discipline,31,15,16
33259,Drüdkh,tarren-mill,1137,priest,discipline,36,12,24
33260,Zenitsu,khadgar,1136,priest,discipline,76,35,41
33261,Drissz,archimonde,1135,priest,discipline,24,12,12
33262,Deneris,ravencrest,1135,priest,discipline,35,12,23
33263,Dafemboi,ravencrest,1134,priest,discipline,18,12,6
33264,Neosix,sanguino,1134,priest,discipline,48,24,24
33265,Joncartagena,sanguino,1133,priest,discipline,24,12,12
33266,Velosp,defias-brotherhood,1133,priest,discipline,30,12,18
33267,Deliverme,frostmane,1132,priest,discipline,18,12,6
33268,Ожившийприст,soulflayer,1132,priest,discipline,123,64,59
33269,Dyrios,drakthul,1132,priest,discipline,30,13,17
33270,Vrenel,burning-legion,1131,priest,discipline,29,15,14
33271,Zák,sylvanas,1131,priest,discipline,24,12,12
33272,Stclemens,defias-brotherhood,1130,priest,discipline,45,20,25
33273,Iloa,dun-morogh,1129,priest,discipline,65,37,28
33274,Gromalia,hyjal,1129,priest,discipline,24,12,12
33275,Uncleben,grim-batol,1129,priest,discipline,31,14,17
33276,Hasnaa,silvermoon,1128,priest,discipline,21,15,6
33277,Paparockatos,sylvanas,1127,priest,discipline,36,24,12
33278,Priestagon,azjolnerub,1127,priest,discipline,24,12,12
33279,Nhajÿ,hyjal,1127,priest,discipline,30,12,18
33280,Jeez,twilights-hammer,1127,priest,discipline,36,12,24
33281,Carlotta,dalaran,1126,priest,discipline,69,32,37
33282,Smooky,arakarahm,1126,priest,discipline,26,12,14
33283,Хилогайка,howling-fjord,1126,priest,discipline,45,20,25
33284,Whysomadx,stormscale,1126,priest,discipline,40,16,24
33285,Таймыр,gordunni,1125,priest,discipline,173,79,94
33286,Гандболист,soulflayer,1125,priest,discipline,30,12,18
33287,Курумничек,gordunni,1124,priest,discipline,18,12,6
33288,Frittê,anetheron,1124,priest,discipline,57,29,28
33289,Чупатаявошь,soulflayer,1123,priest,discipline,78,39,39
33290,Enaches,twisting-nether,1123,priest,discipline,61,30,31
33291,Spookyfive,blackhand,1123,priest,discipline,73,26,47
33292,Kurtse,archimonde,1121,priest,discipline,28,14,14
33293,Biblebabe,tarren-mill,1121,priest,discipline,24,12,12
33294,Fordead,krasus,1120,priest,discipline,72,22,50
33295,Kenton,ysondre,1119,priest,discipline,24,12,12
33296,Stigy,auchindoun,1119,priest,discipline,48,23,25
33297,Killerkende,ragnaros,1119,priest,discipline,46,22,24
33298,Neremin,argent-dawn,1118,priest,discipline,48,27,21
33299,Jeus,malganis,1118,priest,discipline,36,14,22
33300,Thiela,ravencrest,1117,priest,discipline,20,13,7
33301,Spooka,ravencrest,1117,priest,discipline,23,12,11
33302,Boyraz,argent-dawn,1117,priest,discipline,66,30,36
33303,Pèrejoe,arathi,1117,priest,discipline,42,15,27
33304,Devilscousin,aggra-português,1116,priest,discipline,25,16,9
33305,Малмортис,soulflayer,1116,priest,discipline,54,26,28
33306,Nyell,silvermoon,1115,priest,discipline,22,12,10
33307,Pnokos,ravencrest,1115,priest,discipline,36,13,23
33308,Bigwoopsie,stormscale,1114,priest,discipline,24,14,10
33309,Mewdewrewrx,arathor,1114,priest,discipline,84,46,38
33310,Ehrmantràut,draenor,1113,priest,discipline,31,17,14
33311,Bluxon,kazzak,1113,priest,discipline,22,12,10
33312,Draenera,silvermoon,1113,priest,discipline,93,46,47
33313,Prognosis,frostwhisper,1112,priest,discipline,48,25,23
33314,Qsandria,ravencrest,1112,priest,discipline,50,24,26
33315,Maskia,sanguino,1112,priest,discipline,30,12,18
33316,Латрам,greymane,1112,priest,discipline,88,35,53
33317,Гролгул,eversong,1111,priest,discipline,24,12,12
33318,Dalyn,zuljin,1110,priest,discipline,24,12,12
33319,Miralou,ravencrest,1110,priest,discipline,338,168,170
33320,Nykothp,ghostlands,1110,priest,discipline,30,12,18
33321,Attiny,draenor,1110,priest,discipline,48,14,34
33322,Zeuws,kazzak,1109,priest,discipline,36,13,23
33323,Стаминабаф,gordunni,1108,priest,discipline,21,13,8
33324,Moritura,nefarian,1108,priest,discipline,24,13,11
33325,Ezrox,neptulon,1108,priest,discipline,30,13,17
33326,Yoloh,sanguino,1108,priest,discipline,51,19,32
33327,Dilbert,twilights-hammer,1107,priest,discipline,70,29,41
33328,Taili,ysondre,1107,priest,discipline,32,13,19
33329,Bangrinu,chamber-of-aspects,1107,priest,discipline,33,12,21
33330,Nigellä,azjolnerub,1107,priest,discipline,36,12,24
33331,Healheal,outland,1106,priest,discipline,78,42,36
33332,Templanzaa,cthun,1106,priest,discipline,24,12,12
33333,Deckardkain,pozzo-delleternità,1105,priest,discipline,60,33,27
33334,Thörbjorn,confrérie-du-thorium,1105,priest,discipline,30,15,15
33335,Valente,twisting-nether,1105,priest,discipline,60,22,38
33336,Mambanero,nemesis,1104,priest,discipline,135,60,75
33337,Elyssez,thrall,1104,priest,discipline,61,22,39
33338,Fetuz,ravenholdt,1103,priest,discipline,76,34,42
33339,Lydîâ,blackhand,1102,priest,discipline,23,12,11
33340,Scotpriest,draenor,1101,priest,discipline,24,12,12
33341,Bepbepp,archimonde,1101,priest,discipline,26,12,14
33342,Kiieevv,blackrock,1101,priest,discipline,206,94,112
33343,Velenthøs,argent-dawn,1100,priest,discipline,24,12,12
33344,Plagegeist,blutkessel,1100,priest,discipline,24,12,12
33345,Möd,ragnaros,1100,priest,discipline,30,13,17
33346,Tutenhamonek,outland,1099,priest,discipline,30,14,16
33347,Enlîl,zuljin,1098,priest,discipline,65,33,32
33348,Imsöbäd,archimonde,1098,priest,discipline,30,12,18
33349,Vaurork,stormscale,1096,priest,discipline,23,12,11
33350,Crizto,argent-dawn,1094,priest,discipline,54,22,32
33351,Ünholy,burning-legion,1093,priest,discipline,33,17,16
33352,Healy,blackrock,1091,priest,discipline,114,48,66
33353,Мояродная,howling-fjord,1091,priest,discipline,43,13,30
33354,Necromania,cthun,1089,priest,discipline,123,58,65
33355,Lerissea,argent-dawn,1088,priest,discipline,22,12,10
33356,Lísan,ravencrest,1088,priest,discipline,30,14,16
33357,Szalsza,arathor,1088,priest,discipline,84,39,45
33358,Pilip,dragonmaw,1087,priest,discipline,24,13,11
33359,Khai,tarren-mill,1087,priest,discipline,71,31,40
33360,Sildane,kirin-tor,1087,priest,discipline,35,15,20
33361,Artymox,sylvanas,1086,priest,discipline,41,13,28
33362,Røläck,ragnaros,1085,priest,discipline,36,15,21
33363,Эрьеро,gordunni,1085,priest,discipline,48,17,31
33364,Clutchp,blackmoore,1084,priest,discipline,21,13,8
33365,Dragthal,malganis,1084,priest,discipline,32,13,19
33366,Xmassdispel,tarren-mill,1084,priest,discipline,36,14,22
33367,Mundwerk,malganis,1081,priest,discipline,57,21,36
33368,Nellytaa,dalaran,1080,priest,discipline,33,17,16
33369,Waxosc,silvermoon,1080,priest,discipline,68,28,40
33370,Salskagripme,ragnaros,1079,priest,discipline,18,12,6
33371,Bojestvena,neptulon,1079,priest,discipline,46,25,21
33372,Гомотряс,howling-fjord,1079,priest,discipline,102,54,48
33373,Bálíé,blackmoore,1078,priest,discipline,72,35,37
33374,Yelowsnowman,burning-legion,1078,priest,discipline,48,22,26
33375,Jediminds,tarren-mill,1076,priest,discipline,22,12,10
33376,Lapeür,archimonde,1076,priest,discipline,24,12,12
33377,Lunacarle,zuljin,1075,priest,discipline,44,24,20
33378,Dinamix,tarren-mill,1075,priest,discipline,48,25,23
33379,Pénancé,defias-brotherhood,1075,priest,discipline,36,13,23
33380,Deathspawn,hellscream,1073,priest,discipline,69,37,32
33381,Makrit,outland,1073,priest,discipline,69,28,41
33382,Dafúq,draenor,1072,priest,discipline,22,12,10
33383,Seanoob,turalyon,1071,priest,discipline,31,12,19
33384,Deppara,twisting-nether,1070,priest,discipline,38,23,15
33385,Discoprillan,twisting-nether,1069,priest,discipline,43,23,20
33386,Lunairess,silvermoon,1069,priest,discipline,84,28,56
33387,Гальционна,gordunni,1068,priest,discipline,31,13,18
33388,Unleet,sylvanas,1067,priest,discipline,69,33,36
33389,Deeforce,argent-dawn,1067,priest,discipline,74,29,45
33390,Malîken,silvermoon,1066,priest,discipline,30,15,15
33391,Эйнрив,howling-fjord,1066,priest,discipline,113,53,60
33392,Юкич,soulflayer,1065,priest,discipline,34,12,22
33393,Hðly,doomhammer,1064,priest,discipline,18,12,6
33394,Заплетальщик,howling-fjord,1064,priest,discipline,60,34,26
33395,Celero,silvermoon,1063,priest,discipline,54,23,31
33396,Avor,hellfire,1062,priest,discipline,24,16,8
33397,Prazefin,twisting-nether,1060,priest,discipline,22,13,9
33398,Ãbømînåtîøn,blackrock,1059,priest,discipline,28,22,6
33399,Mocnymaco,burning-blade,1059,priest,discipline,193,98,95
33400,Norah,kirin-tor,1058,priest,discipline,35,15,20
33401,Swpain,argent-dawn,1056,priest,discipline,12,11,1
33402,Yânùx,aegwynn,1056,priest,discipline,12,11,1
33403,Surfingbird,ragnaros,1056,priest,discipline,18,11,7
33404,Bindww,tarren-mill,1056,priest,discipline,18,11,7
33405,Kirobreika,twisting-nether,1056,priest,discipline,18,11,7
33406,Daskemaskinx,the-maelstrom,1056,priest,discipline,18,11,7
33407,Schwypsvnr,garona,1056,priest,discipline,18,11,7
33408,Lmnsqzy,ravencrest,1056,priest,discipline,18,11,7
33409,Fatyoyo,frostwolf,1056,priest,discipline,18,11,7
33410,Nyàh,stormscale,1056,priest,discipline,18,11,7
33411,Drnoob,tarren-mill,1056,priest,discipline,50,25,25
33412,Dexlolo,stormscale,1056,priest,discipline,24,11,13
33413,Ðanilosp,dun-modr,1056,priest,discipline,24,11,13
33414,Onceup,thrall,1056,priest,discipline,24,11,13
33415,Carpathîan,blackhand,1056,priest,discipline,72,25,47
33416,Kenobai,kazzak,1055,priest,discipline,18,11,7
33417,Nelyø,destromath,1055,priest,discipline,18,11,7
33418,Zælÿ,archimonde,1055,priest,discipline,18,11,7
33419,Парадайси,gordunni,1055,priest,discipline,18,11,7
33420,Балантайсх,soulflayer,1055,priest,discipline,18,11,7
33421,Fractu,tarren-mill,1055,priest,discipline,24,11,13
33422,Squishylol,tarren-mill,1055,priest,discipline,24,11,13
33423,Ahun,taerar,1055,priest,discipline,24,11,13
33424,Manäka,hyjal,1055,priest,discipline,24,11,13
33425,Pureàngel,ravencrest,1055,priest,discipline,24,11,13
33426,Haffination,frostmane,1055,priest,discipline,24,11,13
33427,Redempt,nemesis,1055,priest,discipline,24,11,13
33428,Deshka,tarren-mill,1055,priest,discipline,30,11,19
33429,Dubai,silvermoon,1055,priest,discipline,36,11,25
33430,Unstopp,blackhand,1054,priest,discipline,18,11,7
33431,Ræwïllûñgøðx,ravencrest,1054,priest,discipline,18,11,7
33432,Leleg,blackhand,1054,priest,discipline,18,11,7
33433,Bäckay,silvermoon,1054,priest,discipline,24,11,13
33434,Arya,dunemaul,1054,priest,discipline,24,11,13
33435,Hòllymèdx,blackmoore,1054,priest,discipline,24,11,13
33436,Peg,talnivarr,1054,priest,discipline,30,11,19
33437,Auroree,stormscale,1054,priest,discipline,30,11,19
33438,Szycho,burning-legion,1054,priest,discipline,36,11,25
33439,Whopzi,blackmoore,1053,priest,discipline,18,11,7
33440,Zeatt,ysera,1053,priest,discipline,18,11,7
33441,Tsunadesaama,silvermoon,1053,priest,discipline,24,11,13
33442,Залик,soulflayer,1053,priest,discipline,29,12,17
33443,Aléhyl,la-croisade-écarlate,1053,priest,discipline,72,28,44
33444,Stepsisstuck,ragnaros,1053,priest,discipline,30,11,19
33445,Drwho,zuljin,1053,priest,discipline,33,12,21
33446,Challengepro,burning-legion,1052,priest,discipline,18,11,7
33447,Вайфими,gordunni,1052,priest,discipline,24,11,13
33448,Købzar,tarren-mill,1052,priest,discipline,30,11,19
33449,Chokmâh,sanguino,1051,priest,discipline,18,11,7
33450,Пристохилю,gordunni,1051,priest,discipline,24,14,10
33451,Bejud,tarren-mill,1051,priest,discipline,24,11,13
33452,Nevermyndz,blackmoore,1051,priest,discipline,24,11,13
33453,Monstretpr,dragonblight,1051,priest,discipline,24,11,13
33454,Clæude,tarren-mill,1051,priest,discipline,30,11,19
33455,Fakéy,draenor,1050,priest,discipline,12,11,1
33456,Iiamx,antonidas,1050,priest,discipline,18,11,7
33457,Cahuña,thrall,1050,priest,discipline,33,19,14
33458,Junglepriest,ravencrest,1050,priest,discipline,24,11,13
33459,Smokäy,blackhand,1050,priest,discipline,24,11,13
33460,Rachelsz,ravencrest,1050,priest,discipline,24,11,13
33461,Zatón,dun-modr,1050,priest,discipline,30,11,19
33462,Celadriel,ravencrest,1050,priest,discipline,30,11,19
33463,Lacrum,ragnaros,1049,priest,discipline,26,15,11
33464,Ungeheuer,taerar,1049,priest,discipline,54,25,29
33465,Grimor,talnivarr,1049,priest,discipline,24,11,13
33466,Nimiqt,tarren-mill,1049,priest,discipline,24,11,13
33467,Madilim,kazzak,1049,priest,discipline,29,13,16
33468,Soupriest,ysondre,1049,priest,discipline,27,12,15
33469,Varrês,kazzak,1049,priest,discipline,30,11,19
33470,Nøwénna,ravencrest,1049,priest,discipline,42,11,31
33471,Merendir,scarshield-legion,1049,priest,discipline,42,11,31
33472,Icyc,outland,1049,priest,discipline,42,11,31
33473,Ehther,dun-modr,1048,priest,discipline,18,11,7
33474,Sophoula,silvermoon,1048,priest,discipline,18,11,7
33475,Diskogoblin,drakthul,1048,priest,discipline,24,11,13
33476,Sanril,ragnaros,1048,priest,discipline,24,11,13
33477,Axewound,neptulon,1048,priest,discipline,25,11,14
33478,Redlight,ysondre,1048,priest,discipline,30,11,19
33479,Rredss,ravencrest,1047,priest,discipline,22,14,8
33480,Neseig,blutkessel,1047,priest,discipline,18,11,7
33481,Blasfemo,nemesis,1047,priest,discipline,24,11,13
33482,Drumont,kelthuzad,1047,priest,discipline,24,11,13
33483,Shæzè,antonidas,1047,priest,discipline,24,11,13
33484,Ilostmybible,runetotem,1047,priest,discipline,28,12,16
33485,Derathon,eredar,1046,priest,discipline,18,11,7
33486,Broer,twisting-nether,1046,priest,discipline,18,11,7
33487,Мерседулька,howling-fjord,1046,priest,discipline,22,12,10
33488,Zerula,outland,1046,priest,discipline,225,115,110
33489,Ichpvpeuch,eredar,1046,priest,discipline,24,11,13
33490,Lightless,baelgun,1046,priest,discipline,84,38,46
33491,Болътвоя,gordunni,1045,priest,discipline,18,11,7
33492,Billypriest,argent-dawn,1044,priest,discipline,18,11,7
33493,Pescá,cthun,1044,priest,discipline,25,13,12
33494,Needmana,hyjal,1044,priest,discipline,36,15,21
33495,Kaos,anetheron,1043,priest,discipline,15,13,2
33496,Ráka,earthen-ring,1043,priest,discipline,26,13,13
33497,Iluras,thunderhorn,1043,priest,discipline,24,11,13
33498,Desperion,ragnaros,1043,priest,discipline,139,60,79
33499,Эллвинг,howling-fjord,1042,priest,discipline,23,12,11
33500,Malíficent,draenor,1042,priest,discipline,24,11,13
33501,Rhésùs,archimonde,1041,priest,discipline,44,25,19
33502,Nynren,doomhammer,1041,priest,discipline,50,22,28
33503,Holyskull,magtheridon,1041,priest,discipline,124,51,73
33504,Whitemané,argent-dawn,1040,priest,discipline,56,28,28
33505,Prïstië,drakthul,1040,priest,discipline,62,29,33
33506,Jonnyklebrig,aegwynn,1040,priest,discipline,47,18,29
33507,Kranrekan,archimonde,1040,priest,discipline,54,18,36
33508,Swdscript,drakthul,1039,priest,discipline,24,11,13
33509,Worstdisceu,draenor,1039,priest,discipline,24,11,13
33510,Priestar,madmortem,1038,priest,discipline,24,11,13
33511,Myskou,ragnaros,1037,priest,discipline,12,11,1
33512,Fingerblast,sanguino,1037,priest,discipline,24,12,12
33513,Sphard,ysondre,1037,priest,discipline,104,39,65
33514,Лилсейнтс,gordunni,1036,priest,discipline,42,11,31
33515,Metapri,blackhand,1035,priest,discipline,41,20,21
33516,Inaeries,argent-dawn,1034,priest,discipline,41,22,19
33517,Dorisdiesel,ravencrest,1033,priest,discipline,30,11,19
33518,Трахмэйстер,gordunni,1032,priest,discipline,23,17,6
33519,Tokushiro,sylvanas,1031,priest,discipline,24,11,13
33520,Pasalacabra,zuljin,1030,priest,discipline,24,11,13
33521,Zdrowíé,todeswache,1029,priest,discipline,78,45,33
33522,Nupzie,stormscale,1029,priest,discipline,39,15,24
33523,Ahgnus,silvermoon,1029,priest,discipline,30,11,19
33524,Kreem,frostmane,1028,priest,discipline,18,11,7
33525,Rydzyk,laughing-skull,1028,priest,discipline,24,13,11
33526,Hèlp,sanguino,1028,priest,discipline,24,12,12
33527,Zbll,ragnaros,1028,priest,discipline,30,12,18
33528,Marryjade,ragnaros,1026,priest,discipline,32,14,18
33529,Leønix,malfurion,1025,priest,discipline,21,12,9
33530,Bakris,twisting-nether,1024,priest,discipline,24,11,13
33531,Galpriest,tarren-mill,1023,priest,discipline,17,11,6
33532,Tmnewho,outland,1022,priest,discipline,22,12,10
33533,Anethron,ragnaros,1022,priest,discipline,90,45,45
33534,Tori,marécage-de-zangar,1021,priest,discipline,20,12,8
33535,Sharae,malfurion,1020,priest,discipline,77,41,36
33536,Psychoboris,outland,1020,priest,discipline,127,67,60
33537,Äwësömë,aggra-português,1019,priest,discipline,66,34,32
33538,Shnookfour,agamaggan,1019,priest,discipline,58,29,29
33539,Sòsò,archimonde,1018,priest,discipline,60,25,35
33540,Grgovan,kazzak,1017,priest,discipline,15,12,3
33541,Rexxár,aszune,1016,priest,discipline,121,58,63
33542,Verxalas,stormscale,1014,priest,discipline,16,12,4
33543,Roshaltar,argent-dawn,1014,priest,discipline,104,54,50
33544,Xanndro,argent-dawn,1014,priest,discipline,34,13,21
33545,Kyrédan,dalaran,1013,priest,discipline,192,94,98
33546,Gronni,argent-dawn,1012,priest,discipline,30,15,15
33547,Варинган,howling-fjord,1011,priest,discipline,22,12,10
33548,Fericul,argent-dawn,1011,priest,discipline,30,11,19
33549,Howlscastie,stormscale,1010,priest,discipline,60,26,34
33550,Morrydin,stormreaver,1009,priest,discipline,22,11,11
33551,Trimégiste,hyjal,1009,priest,discipline,145,72,73
33552,Seras,bloodfeather,1009,priest,discipline,143,67,76
33553,Yøzø,blackhand,1009,priest,discipline,63,27,36
33554,Awien,kazzak,1008,priest,discipline,27,12,15
33555,Bicepvein,sylvanas,1007,priest,discipline,15,11,4
33556,Discoruzki,ravencrest,1007,priest,discipline,23,11,12
33557,Gutfroy,conseil-des-ombres,1006,priest,discipline,16,12,4
33558,Priestør,onyxia,1006,priest,discipline,19,12,7
33559,Boomhilde,aegwynn,1004,priest,discipline,218,108,110
33560,Lamovtabrood,kazzak,1004,priest,discipline,23,11,12
33561,Телоури,galakrond,1004,priest,discipline,27,12,15
33562,Kallsen,ravencrest,1002,priest,discipline,45,28,17
33563,Stahj,sanguino,1002,priest,discipline,23,11,12
33564,Sixeus,outland,1002,priest,discipline,26,12,14
33565,Slufse,alakir,1001,priest,discipline,29,13,16
33566,Dirim,silvermoon,1001,priest,discipline,90,32,58
33567,Steadyog,doomhammer,1000,priest,discipline,24,16,8
33568,Mijuuk,zuljin,1000,priest,discipline,36,23,13
33569,Buzzard,frostmourne,1000,priest,discipline,24,15,9
33570,Nobbisnice,drakthul,1000,priest,discipline,88,36,52
33571,Rrpriest,silvermoon,998,priest,discipline,68,23,45
33572,Talbädar,draenor,997,priest,discipline,26,13,13
33573,Îndura,drakthul,997,priest,discipline,99,44,55
33574,Вальдемарс,howling-fjord,996,priest,discipline,29,11,18
33575,Kilrog,blackrock,995,priest,discipline,27,13,14
33576,Ccatchme,sylvanas,995,priest,discipline,91,41,50
33577,Negativeapm,archimonde,991,priest,discipline,17,11,6
33578,Absinthamos,eredar,989,priest,discipline,22,11,11
33579,Góldfinger,norgannon,988,priest,discipline,27,11,16
33580,Рыск,grom,986,priest,discipline,15,13,2
33581,Hinkelstein,defias-brotherhood,983,priest,discipline,44,23,21
33582,Huzlin,kazzak,983,priest,discipline,28,11,17
33583,Aprima,culte-de-la-rive-noire,983,priest,discipline,48,17,31
33584,Nabira,pozzo-delleternità,980,priest,discipline,19,12,7
33585,Lichtelaaie,quelthalas,980,priest,discipline,24,15,9
33586,Junkz,eredar,977,priest,discipline,42,19,23
33587,Satanspawn,neptulon,977,priest,discipline,64,23,41
33588,Shalacho,blackrock,976,priest,discipline,58,26,32
33589,Арабет,galakrond,975,priest,discipline,107,57,50
33590,Eronnsalis,burning-legion,975,priest,discipline,96,43,53
33591,Yoóngí,ravencrest,973,priest,discipline,17,11,6
33592,Havanna,dethecus,973,priest,discipline,30,18,12
33593,Therealopa,blackmoore,973,priest,discipline,116,54,62
33594,Vepa,blackrock,972,priest,discipline,52,27,25
33595,Amaretta,perenolde,972,priest,discipline,85,43,42
33596,Sigor,hellfire,970,priest,discipline,35,16,19
33597,Васпохилить,howling-fjord,969,priest,discipline,32,15,17
33598,Chaniu,throkferoth,967,priest,discipline,30,11,19
33599,Priincess,ragnaros,966,priest,discipline,34,14,20
33600,Rosilana,blackrock,966,priest,discipline,54,20,34
33601,Teyranamin,defias-brotherhood,965,priest,discipline,25,11,14
33602,Morgoh,die-arguswacht,962,priest,discipline,162,81,81
33603,Holyheartx,argent-dawn,962,priest,discipline,34,12,22
33604,Rizeup,darksorrow,961,priest,discipline,32,18,14
33605,Presbyter,mazrigos,961,priest,discipline,21,11,10
33606,Didinini,outland,961,priest,discipline,46,24,22
33607,Piccolamorte,ysondre,960,priest,discipline,12,10,2
33608,Lanat,ravencrest,960,priest,discipline,12,10,2
33609,Ghettonelf,sylvanas,960,priest,discipline,12,10,2
33610,Ilovesumecx,aegwynn,960,priest,discipline,18,10,8
33611,Asýnc,ravencrest,960,priest,discipline,18,10,8
33612,Sadsadsad,ravencrest,960,priest,discipline,18,10,8
33613,Nelakya,blackmoore,960,priest,discipline,18,10,8
33614,Пухлаясвинка,fordragon,960,priest,discipline,18,10,8
33615,Lerrapriest,eredar,960,priest,discipline,18,10,8
33616,Wyrofear,ragnaros,960,priest,discipline,18,10,8
33617,Neska,antonidas,960,priest,discipline,18,10,8
33618,Ринкуку,howling-fjord,960,priest,discipline,18,10,8
33619,Mindhøven,veklor,960,priest,discipline,18,10,8
33620,Theblank,pozzo-delleternità,960,priest,discipline,24,10,14
33621,Dxlkekss,blackmoore,960,priest,discipline,24,10,14
33622,ßestworld,draenor,960,priest,discipline,24,10,14
33623,Mythaaz,archimonde,960,priest,discipline,27,10,17
33624,Tmnstrtw,alakir,960,priest,discipline,30,10,20
33625,Leykop,ravencrest,960,priest,discipline,36,10,26
33626,Casic,blackhand,959,priest,discipline,12,10,2
33627,Døtgdx,archimonde,959,priest,discipline,18,10,8
33628,Yadif,tarren-mill,959,priest,discipline,18,10,8
33629,Animalrescue,draenor,959,priest,discipline,18,10,8
33630,Ðaala,blackrock,959,priest,discipline,18,10,8
33631,Lèss,ysondre,959,priest,discipline,18,10,8
33632,Dunderpriest,silvermoon,959,priest,discipline,18,10,8
33633,Рыжаякискис,soulflayer,959,priest,discipline,18,10,8
33634,Óói,outland,959,priest,discipline,19,10,9
33635,Notpetya,kazzak,959,priest,discipline,24,10,14
33636,Aurorä,burning-legion,959,priest,discipline,24,10,14
33637,Alìsa,ravencrest,959,priest,discipline,24,10,14
33638,Râây,blackrock,959,priest,discipline,24,10,14
33639,Grimezot,ragnaros,959,priest,discipline,24,10,14
33640,Surpsgodx,ravencrest,959,priest,discipline,30,10,20
33641,Phucu,the-maelstrom,959,priest,discipline,30,10,20
33642,Raphyx,blackhand,959,priest,discipline,36,10,26
33643,Awakenedmyth,draenor,958,priest,discipline,12,10,2
33644,Sadgelands,outland,958,priest,discipline,18,10,8
33645,Elinaa,die-aldor,958,priest,discipline,18,10,8
33646,Ezcobar,twilights-hammer,958,priest,discipline,18,10,8
33647,Misspingle,sunstrider,958,priest,discipline,18,10,8
33648,Vo,dentarg,958,priest,discipline,18,10,8
33649,Thicolascage,draenor,958,priest,discipline,24,10,14
33650,Faíht,blackrock,958,priest,discipline,24,10,14
33651,Radiancekey,sanguino,958,priest,discipline,24,10,14
33652,Narkofashist,sanguino,958,priest,discipline,84,33,51
33653,Adallon,blackmoore,958,priest,discipline,30,10,20
33654,Discönnect,kazzak,957,priest,discipline,12,10,2
33655,Sws,throkferoth,957,priest,discipline,12,10,2
33656,Reivno,ravencrest,957,priest,discipline,12,10,2
33657,Vaßpera,tarren-mill,957,priest,discipline,18,10,8
33658,Bougetonboul,archimonde,957,priest,discipline,18,10,8
33659,Anetalol,zuluhed,957,priest,discipline,18,10,8
33660,Попячебрило,gordunni,957,priest,discipline,88,45,43
33661,Dexodus,sylvanas,957,priest,discipline,24,10,14
33662,Hazedoktor,twisting-nether,957,priest,discipline,24,10,14
33663,Anankea,malganis,957,priest,discipline,27,10,17
33664,Вейтарен,gordunni,957,priest,discipline,30,10,20
33665,Белыйшеколад,blackscar,956,priest,discipline,12,10,2
33666,Cidrea,saurfang,956,priest,discipline,18,10,8
33667,Zaein,malganis,956,priest,discipline,18,10,8
33668,Chîlliz,draenor,956,priest,discipline,18,10,8
33669,Myzaree,silvermoon,956,priest,discipline,18,10,8
33670,Techipriest,ravencrest,955,priest,discipline,12,10,2
33671,Abdibio,twisting-nether,955,priest,discipline,24,10,14
33672,Evangelyne,tarren-mill,955,priest,discipline,24,10,14
33673,Zyrexan,defias-brotherhood,955,priest,discipline,30,10,20
33674,Slight,aggra-português,954,priest,discipline,18,10,8
33675,Gîpsyjoe,ragnaros,954,priest,discipline,18,10,8
33676,Suchetto,kazzak,954,priest,discipline,24,10,14
33677,Hempukka,spinebreaker,954,priest,discipline,24,10,14
33678,Kyuuma,ravencrest,954,priest,discipline,24,10,14
33679,Chilltcaster,blackrock,954,priest,discipline,26,10,16
33680,Юбич,soulflayer,953,priest,discipline,18,10,8
33681,Aká,kazzak,953,priest,discipline,24,10,14
33682,Подорваный,gordunni,953,priest,discipline,30,10,20
33683,Votiqt,tarren-mill,952,priest,discipline,18,10,8
33684,Ghøstyx,blackrock,952,priest,discipline,18,10,8
33685,Abî,frostwolf,952,priest,discipline,21,11,10
33686,Саксесфул,howling-fjord,952,priest,discipline,24,10,14
33687,Kaleshiry,kazzak,952,priest,discipline,24,10,14
33688,Eclaír,blackhand,952,priest,discipline,30,10,20
33689,Hugerage,stormreaver,952,priest,discipline,42,10,32
33690,Maiel,die-aldor,951,priest,discipline,24,10,14
33691,Фионыч,blackscar,951,priest,discipline,24,10,14
33692,Boniesmack,stormscale,951,priest,discipline,24,10,14
33693,Немашка,blackscar,950,priest,discipline,18,10,8
33694,Nasirjones,outland,950,priest,discipline,18,10,8
33695,Guérissolog,kaelthas,950,priest,discipline,24,10,14
33696,Gaidy,ravencrest,949,priest,discipline,18,10,8
33697,Robiee,twisting-nether,949,priest,discipline,24,10,14
33698,Senghe,argent-dawn,949,priest,discipline,36,14,22
33699,Chris,laughing-skull,948,priest,discipline,12,10,2
33700,Perxonx,twisting-nether,946,priest,discipline,12,10,2
33701,Pínx,nerathor,946,priest,discipline,24,10,14
33702,Raptichou,hyjal,945,priest,discipline,18,10,8
33703,Jimcarre,eredar,945,priest,discipline,24,11,13
33704,Sacristy,aggra-português,945,priest,discipline,62,23,39
33705,Joblob,guldan,944,priest,discipline,20,10,10
33706,Izaa,silvermoon,943,priest,discipline,30,10,20
33707,Mønti,onyxia,942,priest,discipline,35,17,18
33708,Pabli,argent-dawn,942,priest,discipline,24,10,14
33709,Togx,silvermoon,942,priest,discipline,24,10,14
33710,Lèviåthån,stormscale,942,priest,discipline,29,10,19
33711,Søb,silvermoon,942,priest,discipline,29,10,19
33712,Perlo,sanguino,940,priest,discipline,89,47,42
33713,Lumartos,ungoro,939,priest,discipline,127,60,67
33714,Priezeke,aggramar,937,priest,discipline,60,32,28
33715,Энтанант,gordunni,935,priest,discipline,30,15,15
33716,Felbs,defias-brotherhood,935,priest,discipline,69,25,44
33717,Bolíngbroke,argent-dawn,935,priest,discipline,47,12,35
33718,Eleveno,ravencrest,934,priest,discipline,54,26,28
33719,Lhh,blackmoore,934,priest,discipline,26,12,14
33720,Paradigma,outland,933,priest,discipline,59,30,29
33721,Sednâ,conseil-des-ombres,931,priest,discipline,23,10,13
33722,Satyxian,draenor,929,priest,discipline,18,10,8
33723,Chukwundi,ravencrest,929,priest,discipline,84,29,55
33724,Ifkströmsund,stormscale,928,priest,discipline,18,10,8
33725,Pavyone,twisting-nether,926,priest,discipline,23,10,13
33726,Aliasus,archimonde,924,priest,discipline,17,10,7
33727,Meodor,antonidas,923,priest,discipline,24,14,10
33728,Flaylol,stormscale,923,priest,discipline,23,10,13
33729,Docoktokok,guldan,921,priest,discipline,30,14,16
33730,Fordöbroo,ragnaros,921,priest,discipline,39,16,23
33731,Kashmirweed,ravencrest,921,priest,discipline,54,20,34
33732,Rickermortis,defias-brotherhood,917,priest,discipline,28,10,18
33733,Goldische,dun-morogh,917,priest,discipline,56,18,38
33734,Elba,defias-brotherhood,916,priest,discipline,24,10,14
33735,Arondir,defias-brotherhood,914,priest,discipline,22,11,11
33736,Аргла,soulflayer,912,priest,discipline,66,24,42
33737,Nunnis,kazzak,911,priest,discipline,254,129,125
33738,Clergy,nagrand,910,priest,discipline,30,11,19
33739,Cesiom,culte-de-la-rive-noire,909,priest,discipline,48,25,23
33740,Moinmeister,frostmourne,909,priest,discipline,47,22,25
33741,Ryuuzaki,stormscale,909,priest,discipline,23,10,13
33742,Titibolls,sanguino,908,priest,discipline,23,10,13
33743,Immórtal,tarren-mill,908,priest,discipline,30,10,20
33744,Koderpl,burning-legion,906,priest,discipline,93,45,48
33745,Stórmén,kazzak,906,priest,discipline,34,11,23
33746,Lubdub,drakthul,905,priest,discipline,24,10,14
33747,Seidel,aggramar,904,priest,discipline,34,17,17
33748,Theunknown,stormscale,903,priest,discipline,29,11,18
33749,Pugnatorius,archimonde,900,priest,discipline,27,10,17
33750,Beellzo,sylvanas,899,priest,discipline,107,44,63
33751,Wørmiexz,stormscale,895,priest,discipline,20,10,10
33752,Deshaz,tarren-mill,895,priest,discipline,34,10,24
33753,Shidolah,antonidas,894,priest,discipline,36,15,21
33754,Amoxí,blackmoore,892,priest,discipline,18,10,8
33755,Nosgot,earthen-ring,889,priest,discipline,30,14,16
33756,Abstauberin,blackrock,889,priest,discipline,28,11,17
33757,Minnaq,burning-legion,888,priest,discipline,24,10,14
33758,Caprice,kelthuzad,888,priest,discipline,36,13,23
33759,Adolosh,thrall,886,priest,discipline,24,12,12
33760,Chandria,veknilash,886,priest,discipline,54,24,30
33761,Kenyka,silvermoon,883,priest,discipline,56,19,37
33762,Sétsukó,aegwynn,880,priest,discipline,16,10,6
33763,Blååb,draenor,879,priest,discipline,19,10,9
33764,Voided,nemesis,879,priest,discipline,19,10,9
33765,Chillx,blackmoore,878,priest,discipline,85,45,40
33766,Madvortexe,kazzak,874,priest,discipline,19,10,9
33767,Saskiaa,doomhammer,874,priest,discipline,60,28,32
33768,Æç,malganis,871,priest,discipline,11,10,1
33769,Daria,teldrassil,871,priest,discipline,213,104,109
33770,Borgír,burning-legion,871,priest,discipline,27,11,16
33771,Toks,stormscale,871,priest,discipline,45,10,35
33772,Elfiontko,burning-legion,870,priest,discipline,24,11,13
33773,Chaendral,darkmoon-faire,868,priest,discipline,19,10,9
33774,Slovak,stormscale,864,priest,discipline,12,9,3
33775,Ahilarry,tarren-mill,864,priest,discipline,12,9,3
33776,Hemmis,ravencrest,864,priest,discipline,12,9,3
33777,Ratapain,argent-dawn,864,priest,discipline,12,9,3
33778,Zyç,der-rat-von-dalaran,864,priest,discipline,12,9,3
33779,Littledoc,blackmoore,864,priest,discipline,12,9,3
33780,Pohja,veknilash,864,priest,discipline,12,9,3
33781,Flipflops,kirin-tor,864,priest,discipline,12,9,3
33782,Chimpanzoo,kazzak,864,priest,discipline,12,9,3
33783,Cyúxyúvteea,ravencrest,864,priest,discipline,12,9,3
33784,Priestyboyuk,tarren-mill,864,priest,discipline,12,9,3
33785,Tridus,eitrigg,864,priest,discipline,12,9,3
33786,Moonacky,bronze-dragonflight,864,priest,discipline,12,9,3
33787,Byzzi,draenor,864,priest,discipline,12,9,3
33788,Vyrá,der-rat-von-dalaran,864,priest,discipline,12,9,3
33789,Cbbigbape,thrall,864,priest,discipline,12,9,3
33790,Skycity,silvermoon,864,priest,discipline,12,9,3
33791,Monflouz,archimonde,864,priest,discipline,12,9,3
33792,Priéstitude,kazzak,864,priest,discipline,12,9,3
33793,Finalvirus,draenor,864,priest,discipline,12,9,3
33794,Svetozarov,wildhammer,864,priest,discipline,18,9,9
33795,Lâñàt,ravencrest,864,priest,discipline,18,9,9
33796,Infandus,pozzo-delleternità,864,priest,discipline,18,9,9
33797,Muant,twisting-nether,864,priest,discipline,18,9,9
33798,Ilovepmr,outland,864,priest,discipline,18,9,9
33799,Dreythan,alakir,864,priest,discipline,18,9,9
33800,Celliapriest,antonidas,864,priest,discipline,18,9,9
33801,Donvasco,kazzak,864,priest,discipline,18,9,9
33802,Goldeagle,archimonde,864,priest,discipline,18,9,9
33803,Ynys,dentarg,864,priest,discipline,18,9,9
33804,Heavensfire,twisting-nether,864,priest,discipline,18,9,9
33805,Ilovecala,ravencrest,864,priest,discipline,18,9,9
33806,Gloffoló,ragnaros,864,priest,discipline,18,9,9
33807,Shaneya,silvermoon,864,priest,discipline,18,9,9
33808,Jtep,ravencrest,864,priest,discipline,18,9,9
33809,Thaykza,blackmoore,864,priest,discipline,18,9,9
33810,Ycvdfghrkynu,sylvanas,864,priest,discipline,18,9,9
33811,Siign,ravencrest,864,priest,discipline,22,10,12
33812,Падлез,howling-fjord,864,priest,discipline,24,9,15
33813,Itsdiscobaby,auchindoun,864,priest,discipline,24,9,15
33814,Aspertina,outland,864,priest,discipline,24,9,15
33815,Azymi,ravencrest,864,priest,discipline,24,9,15
33816,Frígídhealz,outland,864,priest,discipline,24,9,15
33817,Péntagon,festung-der-stürme,864,priest,discipline,24,9,15
33818,Próxs,ravencrest,864,priest,discipline,24,9,15
33819,Víd,dun-morogh,864,priest,discipline,24,9,15
33820,Teresie,argent-dawn,864,priest,discipline,24,9,15
33821,Chocomiette,archimonde,864,priest,discipline,25,9,16
33822,Spezzato,nemesis,864,priest,discipline,30,9,21
33823,Neverswapx,kazzak,864,priest,discipline,30,9,21
33824,Devastris,ravencrest,864,priest,discipline,30,9,21
33825,Evabae,the-maelstrom,864,priest,discipline,30,9,21
33826,Justtpro,twisting-nether,863,priest,discipline,12,9,3
33827,Franciscus,bladefist,863,priest,discipline,12,9,3
33828,Весёлыйкоил,gordunni,863,priest,discipline,12,9,3
33829,Grishnat,ragnaros,863,priest,discipline,12,9,3
33830,Dhalsim,the-shatar,863,priest,discipline,12,9,3
33831,Grainbames,sylvanas,863,priest,discipline,12,9,3
33832,Simza,azuremyst,863,priest,discipline,12,9,3
33833,Magicdisco,nemesis,863,priest,discipline,12,9,3
33834,Qjju,blackmoore,863,priest,discipline,12,9,3
33835,Eustâche,suramar,863,priest,discipline,12,9,3
33836,Grandpatea,silvermoon,863,priest,discipline,12,9,3
33837,Lehava,archimonde,863,priest,discipline,13,9,4
33838,Priestlol,outland,863,priest,discipline,18,9,9
33839,Coldxzera,tarren-mill,863,priest,discipline,18,9,9
33840,Sonoja,blackhand,863,priest,discipline,18,9,9
33841,Gorti,ravencrest,863,priest,discipline,18,9,9
33842,Markianos,silvermoon,863,priest,discipline,18,9,9
33843,Nilera,frostwolf,863,priest,discipline,18,9,9
33844,Fabuliciøus,blackrock,863,priest,discipline,18,9,9
33845,Mïxa,eitrigg,863,priest,discipline,18,9,9
33846,Pollution,ragnaros,863,priest,discipline,18,9,9
33847,Smitelay,alleria,863,priest,discipline,18,9,9
33848,Ratingfeeder,tarren-mill,863,priest,discipline,18,9,9
33849,Alshah,emerald-dream,863,priest,discipline,18,9,9
33850,Giily,archimonde,863,priest,discipline,18,9,9
33851,Ache,defias-brotherhood,863,priest,discipline,18,9,9
33852,Ромиопвп,gordunni,863,priest,discipline,18,9,9
33853,Sacreth,ragnaros,863,priest,discipline,18,9,9
33854,Mojoo,aggramar,863,priest,discipline,24,9,15
33855,Senza,ysondre,863,priest,discipline,24,9,15
33856,Униакт,gordunni,863,priest,discipline,24,9,15
33857,Shadokzor,ragnaros,863,priest,discipline,30,9,21
33858,Capslk,ravencrest,863,priest,discipline,30,9,21
33859,Valyreon,outland,863,priest,discipline,36,9,27
33860,Hymn,defias-brotherhood,862,priest,discipline,12,9,3
33861,Rawelf,ravencrest,862,priest,discipline,12,9,3
33862,Vizire,ravencrest,862,priest,discipline,12,9,3
33863,Gnomeeater,silvermoon,862,priest,discipline,12,9,3
33864,Jána,argent-dawn,862,priest,discipline,12,9,3
33865,Eshania,frostwolf,862,priest,discipline,12,9,3
33866,Søkariss,elune,862,priest,discipline,12,9,3
33867,Joeshmoex,blackrock,862,priest,discipline,12,9,3
33868,Kildöre,hyjal,862,priest,discipline,12,9,3
33869,Vandansk,kazzak,862,priest,discipline,12,9,3
33870,Бахчи,thermaplugg,862,priest,discipline,18,9,9
33871,Bonzux,dethecus,862,priest,discipline,18,9,9
33872,Trasslarn,tarren-mill,862,priest,discipline,18,9,9
33873,Hiimpinxî,ragnaros,862,priest,discipline,18,9,9
33874,Sandcastles,ravencrest,862,priest,discipline,18,9,9
33875,Skyalpha,silvermoon,862,priest,discipline,18,9,9
33876,Солнцева,greymane,862,priest,discipline,24,9,15
33877,Kämels,ravencrest,862,priest,discipline,24,9,15
33878,Mxcey,ravencrest,862,priest,discipline,24,9,15
33879,Merrysmiting,ravencrest,862,priest,discipline,30,9,21
33880,Söultaker,ravencrest,861,priest,discipline,12,9,3
33881,Vædan,drakthul,861,priest,discipline,12,9,3
33882,Ghostee,twisting-nether,861,priest,discipline,12,9,3
33883,Yusepmikel,cthun,861,priest,discipline,12,9,3
33884,Vierfingerjo,eredar,861,priest,discipline,18,9,9
33885,Fatalyse,ysondre,861,priest,discipline,72,33,39
33886,Rennic,stormscale,861,priest,discipline,24,9,15
33887,Clastro,outland,861,priest,discipline,24,9,15
33888,Sorrop,sanguino,860,priest,discipline,18,9,9
33889,Voodoo,the-maelstrom,860,priest,discipline,18,9,9
33890,Bhlad,silvermoon,860,priest,discipline,18,9,9
33891,Xharyo,ravencrest,860,priest,discipline,22,9,13
33892,Codeincindy,blackhand,860,priest,discipline,24,9,15
33893,Rafikii,eredar,860,priest,discipline,24,9,15
33894,Morgrith,twisting-nether,859,priest,discipline,18,9,9
33895,ßlowska,hyjal,859,priest,discipline,24,9,15
33896,Myxeh,ravencrest,859,priest,discipline,24,9,15
33897,Скумизарг,gordunni,859,priest,discipline,24,9,15
33898,Dotmaker,sanguino,858,priest,discipline,24,9,15
33899,Plzhealme,stormscale,857,priest,discipline,12,9,3
33900,Märx,conseil-des-ombres,857,priest,discipline,12,9,3
33901,Healpapa,blackhand,857,priest,discipline,18,9,9
33902,Merkabah,azjolnerub,857,priest,discipline,24,9,15
33903,Madreöscura,cthun,857,priest,discipline,33,10,23
33904,Хомячише,lich-king,857,priest,discipline,30,9,21
33905,Slyntan,ragnaros,856,priest,discipline,18,9,9
33906,Ellianore,les-sentinelles,856,priest,discipline,24,9,15
33907,Magnificito,silvermoon,855,priest,discipline,18,9,9
33908,Lunarg,die-ewige-wacht,855,priest,discipline,18,9,9
33909,Calenberhtil,burning-legion,855,priest,discipline,18,9,9
33910,Deliriumxd,ravencrest,855,priest,discipline,26,12,14
33911,Шадия,ashenvale,852,priest,discipline,21,12,9
33912,Tykhe,burning-blade,851,priest,discipline,12,9,3
33913,Orbea,sinstralis,850,priest,discipline,12,9,3
33914,Reighl,drakthul,850,priest,discipline,18,9,9
33915,Míjagí,blackhand,850,priest,discipline,31,11,20
33916,Tacko,tarren-mill,849,priest,discipline,30,9,21
33917,Ruebi,blackmoore,848,priest,discipline,18,9,9
33918,Drynte,blackmoore,847,priest,discipline,23,9,14
33919,Socratés,antonidas,846,priest,discipline,72,30,42
33920,Arîbeth,antonidas,846,priest,discipline,48,9,39
33921,Durell,blackrock,845,priest,discipline,30,11,19
33922,Seiigops,ysondre,839,priest,discipline,12,9,3
33923,Evastemplar,turalyon,836,priest,discipline,24,9,15
33924,Valinoru,silvermoon,831,priest,discipline,17,9,8
33925,Mílérí,ravencrest,830,priest,discipline,23,9,14
33926,Тэслос,howling-fjord,829,priest,discipline,23,9,14
33927,Lightofsuny,alakir,828,priest,discipline,35,11,24
33928,Waikiki,ambossar,827,priest,discipline,16,10,6
33929,Yoloswaglørd,blackmoore,822,priest,discipline,26,11,15
33930,Ladá,stormscale,815,priest,discipline,19,9,10
33931,Solaní,antonidas,808,priest,discipline,26,11,15
33932,Floydovka,ragnaros,804,priest,discipline,32,11,21
33933,Majestíc,blackmoore,802,priest,discipline,27,10,17
33934,Rhanira,aegwynn,800,priest,discipline,17,9,8
33935,Pb,stormscale,799,priest,discipline,11,9,2
33936,Pillian,nordrassil,799,priest,discipline,16,9,7
33937,Shikibu,sylvanas,798,priest,discipline,11,9,2
33938,Svetidjordje,tarren-mill,795,priest,discipline,17,9,8
33939,Roqu,ravencrest,792,priest,discipline,15,10,5
33940,Bartolómeo,hellfire,792,priest,discipline,38,9,29
33941,Duwendu,drakthul,791,priest,discipline,17,9,8
33942,Gandzaa,silvermoon,785,priest,discipline,21,9,12
33943,Протомуу,gordunni,783,priest,discipline,11,9,2
33944,Goatz,ragnaros,778,priest,discipline,24,17,7
33945,Homxcxde,ravencrest,777,priest,discipline,26,10,16
33946,Anabølix,ravencrest,768,priest,discipline,12,8,4
33947,Dezless,tarren-mill,768,priest,discipline,12,8,4
33948,Junglepls,burning-blade,768,priest,discipline,12,8,4
33949,Arnn,hyjal,768,priest,discipline,12,8,4
33950,Nitroze,stormscale,768,priest,discipline,12,8,4
33951,Mewdi,outland,768,priest,discipline,12,8,4
33952,Ewalouvia,drakthul,768,priest,discipline,12,8,4
33953,Ewamlf,drakthul,768,priest,discipline,12,8,4
33954,Bammerr,stormscale,768,priest,discipline,12,8,4
33955,Abcdefghijk,sanguino,768,priest,discipline,12,8,4
33956,Boogereater,kazzak,768,priest,discipline,12,8,4
33957,Alexuwu,kazzak,768,priest,discipline,12,8,4
33958,Zerovision,nemesis,768,priest,discipline,12,8,4
33959,Røylian,ravencrest,768,priest,discipline,12,8,4
33960,Katleiya,ysondre,768,priest,discipline,12,8,4
33961,Gerrylol,draenor,768,priest,discipline,12,8,4
33962,Appraiser,draenor,768,priest,discipline,12,8,4
33963,Noxoth,amanthul,768,priest,discipline,12,8,4
33964,Killafoolx,silvermoon,768,priest,discipline,12,8,4
33965,Krecik,deathwing,768,priest,discipline,12,8,4
33966,Meldgodx,das-konsortium,768,priest,discipline,12,8,4
33967,Joeblowx,blackrock,768,priest,discipline,12,8,4
33968,Soylaleche,ravencrest,768,priest,discipline,12,8,4
33969,Jesster,sylvanas,768,priest,discipline,12,8,4
33970,Jesslol,archimonde,768,priest,discipline,12,8,4
33971,Celopital,archimonde,768,priest,discipline,12,8,4
33972,Anticorona,twisting-nether,768,priest,discipline,12,8,4
33973,Wasserbache,antonidas,768,priest,discipline,12,8,4
33974,Orkanwal,ravencrest,768,priest,discipline,12,8,4
33975,Bellrock,nemesis,768,priest,discipline,16,9,7
33976,Tobijara,proudmoore,768,priest,discipline,18,8,10
33977,Фростингшп,goldrinn,768,priest,discipline,18,8,10
33978,Ttmlht,alakir,768,priest,discipline,18,8,10
33979,Finizkram,sylvanas,768,priest,discipline,18,8,10
33980,Alexwinkwink,kazzak,768,priest,discipline,18,8,10
33981,Uanna,ravencrest,768,priest,discipline,18,8,10
33982,Azpr,ravencrest,768,priest,discipline,18,8,10
33983,Aelíth,archimonde,768,priest,discipline,18,8,10
33984,Chrònos,das-konsortium,768,priest,discipline,18,8,10
33985,Nstp,zuljin,768,priest,discipline,18,8,10
33986,Kristianburn,arathi,768,priest,discipline,18,8,10
33987,Skjelett,stormscale,768,priest,discipline,18,8,10
33988,Stealtsøul,outland,768,priest,discipline,18,8,10
33989,Mercila,drakthul,768,priest,discipline,18,8,10
33990,Tanjaspano,twisting-nether,768,priest,discipline,18,8,10
33991,Сандейрейн,gordunni,768,priest,discipline,24,8,16
33992,Тёмныйвид,soulflayer,768,priest,discipline,24,8,16
33993,Avp,the-maelstrom,768,priest,discipline,24,8,16
33994,Brainbadly,aegwynn,768,priest,discipline,24,8,16
33995,Prestigé,vashj,768,priest,discipline,24,8,16
33996,Shyiox,frostwolf,768,priest,discipline,24,8,16
33997,Neeti,kazzak,767,priest,discipline,12,8,4
33998,Ðelftware,tarren-mill,767,priest,discipline,12,8,4
33999,Srysx,nazjatar,767,priest,discipline,12,8,4
34000,Sunfire,twisting-nether,767,priest,discipline,12,8,4
34001,Unckus,defias-brotherhood,767,priest,discipline,12,8,4
34002,Jappsolut,outland,767,priest,discipline,12,8,4
34003,Aexlius,silvermoon,767,priest,discipline,12,8,4
34004,Kletroll,archimonde,767,priest,discipline,12,8,4
34005,Стромъяр,gordunni,767,priest,discipline,12,8,4
34006,Lightmyshimy,silvermoon,767,priest,discipline,12,8,4
34007,Szerelmi,ragnaros,767,priest,discipline,12,8,4
34008,Leçke,ravencrest,767,priest,discipline,12,8,4
34009,Reeta,stormscale,767,priest,discipline,12,8,4
34010,Ingvár,blackrock,767,priest,discipline,12,8,4
34011,Tothegrave,draenor,767,priest,discipline,18,8,10
34012,Isadian,kazzak,767,priest,discipline,18,8,10
34013,Jessijones,gorgonnash,767,priest,discipline,18,8,10
34014,Dathanosx,outland,767,priest,discipline,18,8,10
34015,Célaz,blackmoore,767,priest,discipline,18,8,10
34016,Priestyo,blackrock,767,priest,discipline,18,8,10
34017,Missandeí,frostmane,767,priest,discipline,18,8,10
34018,Holyshifts,silvermoon,767,priest,discipline,18,8,10
34019,Zelensky,stormscale,767,priest,discipline,18,8,10
34020,Johnblack,dun-morogh,767,priest,discipline,18,8,10
34021,Arwén,zuljin,767,priest,discipline,18,8,10
34022,Joex,arathor,767,priest,discipline,18,8,10
34023,Tryingtomc,archimonde,767,priest,discipline,18,8,10
34024,Luminouzilla,tarren-mill,767,priest,discipline,18,8,10
34025,Dfourc,blackhand,767,priest,discipline,18,8,10
34026,Saurap,uldum,767,priest,discipline,18,8,10
34027,Disclol,aegwynn,767,priest,discipline,24,8,16
34028,Anadyia,aegwynn,767,priest,discipline,24,8,16
34029,Ìstarï,sylvanas,767,priest,discipline,24,8,16
34030,Healenax,ravencrest,767,priest,discipline,30,8,22
34031,Eurocodex,antonidas,766,priest,discipline,12,8,4
34032,Evangíline,stormreaver,766,priest,discipline,12,8,4
34033,Okfartpå,ravencrest,766,priest,discipline,12,8,4
34034,Chrissirr,culte-de-la-rive-noire,766,priest,discipline,12,8,4
34035,Celrin,chamber-of-aspects,766,priest,discipline,12,8,4
34036,Sameasal,kazzak,766,priest,discipline,12,8,4
34037,Snickwomen,silvermoon,766,priest,discipline,14,8,6
34038,Кфень,soulflayer,766,priest,discipline,16,9,7
34039,Lianny,sylvanas,766,priest,discipline,18,8,10
34040,Kaliboom,archimonde,766,priest,discipline,18,8,10
34041,Børisheal,draenor,766,priest,discipline,18,8,10
34042,Shimajo,steamwheedle-cartel,766,priest,discipline,18,8,10
34043,Chuntriest,shadowsong,766,priest,discipline,18,8,10
34044,Ezor,dalvengyr,766,priest,discipline,18,8,10
34045,Kangkong,ravencrest,766,priest,discipline,18,8,10
34046,Thesunbeam,silvermoon,766,priest,discipline,24,8,16
34047,Paulina,auchindoun,766,priest,discipline,24,8,16
34048,Metabeta,shattered-hand,766,priest,discipline,24,8,16
34049,Chaosweavèr,outland,766,priest,discipline,24,8,16
34050,Akadras,blackmoore,765,priest,discipline,12,8,4
34051,Pure,kazzak,765,priest,discipline,12,8,4
34052,Poxqt,thrall,765,priest,discipline,12,8,4
34053,Addickted,defias-brotherhood,765,priest,discipline,12,8,4
34054,Regenerous,bloodhoof,765,priest,discipline,22,11,11
34055,Djmouniax,archimonde,765,priest,discipline,18,8,10
34056,Julianpriest,nethersturm,765,priest,discipline,22,9,13
34057,Ноатоэль,gordunni,765,priest,discipline,24,8,16
34058,Thakjing,bladefist,765,priest,discipline,24,8,16
34059,Uglypriest,grim-batol,764,priest,discipline,12,8,4
34060,Demorog,stormscale,764,priest,discipline,12,8,4
34061,Battleprey,the-maelstrom,764,priest,discipline,12,8,4
34062,Irenedwen,silvermoon,764,priest,discipline,18,8,10
34063,Вартэг,blackscar,764,priest,discipline,18,8,10
34064,Aurea,deathwing,764,priest,discipline,18,8,10
34065,Шелоу,deathguard,764,priest,discipline,27,9,18
34066,Ishande,los-errantes,763,priest,discipline,12,8,4
34067,Itokkzhul,draenor,763,priest,discipline,18,8,10
34068,Кравос,soulflayer,763,priest,discipline,18,8,10
34069,Mefeon,draenor,763,priest,discipline,18,8,10
34070,Inoy,dun-modr,763,priest,discipline,18,8,10
34071,Hmanco,burning-legion,763,priest,discipline,18,8,10
34072,Biigy,hyjal,763,priest,discipline,18,8,10
34073,Áphrodite,outland,763,priest,discipline,18,8,10
34074,Nyuu,aggra-português,762,priest,discipline,12,8,4
34075,Nightshådøw,silvermoon,762,priest,discipline,22,10,12
34076,Tëmärï,ravencrest,762,priest,discipline,18,8,10
34077,Fusiroxx,thrall,762,priest,discipline,22,9,13
34078,Fillî,antonidas,761,priest,discipline,18,8,10
34079,Urticaire,arathi,761,priest,discipline,18,8,10
34080,Могвайи,soulflayer,761,priest,discipline,18,8,10
34081,Velanrous,kazzak,760,priest,discipline,18,8,10
34082,Arwen,azjolnerub,760,priest,discipline,18,8,10
34083,Келебриана,deepholm,759,priest,discipline,12,8,4
34084,Enchanttress,burning-legion,759,priest,discipline,12,8,4
34085,Sîanah,archimonde,754,priest,discipline,12,8,4
34086,Wisdoms,thrall,754,priest,discipline,37,8,29
34087,Shattow,ravencrest,751,priest,discipline,17,8,9
34088,Omened,nemesis,751,priest,discipline,17,8,9
34089,Insaner,ahnqiraj,751,priest,discipline,17,8,9
34090,Tïniebla,dun-modr,750,priest,discipline,18,8,10
34091,Seypercillo,dun-modr,746,priest,discipline,24,8,16
34092,Lazzariah,ravencrest,742,priest,discipline,18,8,10
34093,Nilsatis,grim-batol,741,priest,discipline,71,26,45
34094,Hombre,anetheron,734,priest,discipline,22,9,13
34095,Blorpan,tarren-mill,734,priest,discipline,26,9,17
34096,Bälöö,archimonde,733,priest,discipline,22,8,14
34097,Amoorâ,twisting-nether,732,priest,discipline,11,8,3
34098,Kipnuggetz,burning-legion,732,priest,discipline,17,8,9
34099,Jashmin,eredar,732,priest,discipline,35,10,25
34100,Killermoon,rexxar,728,priest,discipline,16,8,8
34101,Cthultist,dun-modr,728,priest,discipline,26,9,17
34102,Ortarn,defias-brotherhood,727,priest,discipline,25,10,15
34103,Pnsl,dun-morogh,723,priest,discipline,36,11,25
34104,Stormééz,bronzebeard,722,priest,discipline,32,9,23
34105,Coldyx,blackrock,719,priest,discipline,11,8,3
34106,Otacon,burning-legion,719,priest,discipline,15,8,7
34107,Quintanaro,thrall,719,priest,discipline,33,8,25
34108,Oprahpriest,ragnaros,718,priest,discipline,11,8,3
34109,Sneed,moonglade,718,priest,discipline,36,9,27
34110,Kikoke,sanguino,717,priest,discipline,15,8,7
34111,Amanojaku,archimonde,716,priest,discipline,24,9,15
34112,Sméctà,marécage-de-zangar,713,priest,discipline,16,9,7
34113,Дакимакурах,gordunni,713,priest,discipline,23,9,14
34114,Zubrowkâ,kazzak,712,priest,discipline,27,9,18
34115,Telpriest,blackrock,710,priest,discipline,25,9,16
34116,Anariell,ravencrest,706,priest,discipline,19,9,10
34117,Jimmymcgill,ravencrest,704,priest,discipline,16,8,8
34118,Greenlizard,stormreaver,704,priest,discipline,22,8,14
34119,Nällytq,nefarian,703,priest,discipline,11,8,3
34120,Ðøñtårmørýmë,der-abyssische-rat,703,priest,discipline,20,8,12
34121,Sacerdotini,outland,702,priest,discipline,19,9,10
34122,Khomic,archimonde,702,priest,discipline,17,8,9
34123,Зиибак,soulflayer,699,priest,discipline,20,8,12
34124,Sapieha,burning-legion,687,priest,discipline,11,8,3
34125,Sollante,onyxia,686,priest,discipline,11,8,3
34126,Wintersônne,kult-der-verdammten,684,priest,discipline,13,8,5
34127,Trixix,ragnaros,684,priest,discipline,14,8,6
34128,Renesmè,archimonde,684,priest,discipline,19,8,11
34129,Holymoni,ragnaros,680,priest,discipline,16,8,8
34130,Itachiuchiha,bloodfeather,677,priest,discipline,27,8,19
34131,Womanwonderf,ravencrest,672,priest,discipline,12,7,5
34132,Magiclands,twisting-nether,672,priest,discipline,12,7,5
34133,Отменяю,howling-fjord,672,priest,discipline,12,7,5
34134,Plåster,dunemaul,672,priest,discipline,12,7,5
34135,Longheals,stormscale,672,priest,discipline,12,7,5
34136,Bunnygxrl,ravencrest,672,priest,discipline,12,7,5
34137,Êva,ravencrest,672,priest,discipline,12,7,5
34138,Somai,aegwynn,672,priest,discipline,12,7,5
34139,Sneboldìs,sylvanas,672,priest,discipline,12,7,5
34140,Ранзегодх,soulflayer,672,priest,discipline,12,7,5
34141,Touchypunk,ravencrest,672,priest,discipline,12,7,5
34142,Ajioli,frostwolf,672,priest,discipline,12,7,5
34143,Tortellìno,stormscale,672,priest,discipline,12,7,5
34144,Xethh,stormscale,672,priest,discipline,12,7,5
34145,Leronia,stormscale,672,priest,discipline,12,7,5
34146,Gudjon,dragonblight,672,priest,discipline,12,7,5
34147,Дефаенс,soulflayer,672,priest,discipline,12,7,5
34148,Jaytî,ravencrest,672,priest,discipline,12,7,5
34149,Fåye,ravencrest,672,priest,discipline,12,7,5
34150,Pattie,ragnaros,672,priest,discipline,12,7,5
34151,Dombili,frostmane,672,priest,discipline,12,7,5
34152,Priestedy,ravencrest,672,priest,discipline,12,7,5
34153,Ranocchio,the-maelstrom,672,priest,discipline,12,7,5
34154,Excell,hellfire,672,priest,discipline,12,7,5
34155,Gladíator,blackhand,672,priest,discipline,12,7,5
34156,Monkeywave,stormscale,672,priest,discipline,12,7,5
34157,Angemir,nemesis,672,priest,discipline,12,7,5
34158,Têmplârx,stormscale,672,priest,discipline,12,7,5
34159,Discmachinex,stormscale,672,priest,discipline,12,7,5
34160,Nishto,twisting-nether,672,priest,discipline,12,7,5
34161,Moppriest,twisting-nether,672,priest,discipline,12,7,5
34162,Ahrimal,turalyon,672,priest,discipline,12,7,5
34163,Barbïelolz,sargeras,672,priest,discipline,12,7,5
34164,Petitogré,silvermoon,672,priest,discipline,12,7,5
34165,Fortítude,draenor,672,priest,discipline,12,7,5
34166,Agms,sanguino,672,priest,discipline,12,7,5
34167,Dashxzz,silvermoon,672,priest,discipline,12,7,5
34168,Dîàna,archimonde,672,priest,discipline,12,7,5
34169,Pflanzenmann,nozdormu,672,priest,discipline,12,7,5
34170,Shuya,archimonde,672,priest,discipline,12,7,5
34171,Wurstpriest,silvermoon,672,priest,discipline,12,7,5
34172,Ziz,outland,672,priest,discipline,12,7,5
34173,Holymamba,silvermoon,672,priest,discipline,12,7,5
34174,Morphics,silvermoon,672,priest,discipline,12,7,5
34175,Zenfangirlx,kazzak,672,priest,discipline,12,7,5
34176,Aevery,onyxia,672,priest,discipline,12,7,5
34177,Shenkt,ravenholdt,672,priest,discipline,12,7,5
34178,Smiteweaver,drakthul,672,priest,discipline,12,7,5
34179,Binkx,tarren-mill,672,priest,discipline,12,7,5
34180,Mdmaster,stormreaver,672,priest,discipline,12,7,5
34181,Luuniisboost,blackmoore,672,priest,discipline,12,7,5
34182,Blutleid,malfurion,672,priest,discipline,12,7,5
34183,Discobeb,les-clairvoyants,672,priest,discipline,12,7,5
34184,Kosa,tarren-mill,672,priest,discipline,12,7,5
34185,Zsozsopapa,tarren-mill,672,priest,discipline,12,7,5
34186,Evypriest,draenor,672,priest,discipline,12,7,5
34187,Ganakenp,tarren-mill,672,priest,discipline,12,7,5
34188,Sapholie,kirin-tor,672,priest,discipline,12,7,5
34189,Néantine,ysondre,672,priest,discipline,12,7,5
34190,Mahraxyr,hyjal,672,priest,discipline,12,7,5
34191,Skallya,ysondre,672,priest,discipline,12,7,5
34192,Rixfoulah,ysondre,672,priest,discipline,12,7,5
34193,Deluxgodx,kazzak,672,priest,discipline,12,7,5
34194,Uadedez,tarren-mill,672,priest,discipline,13,7,6
34195,Ominoushell,twisting-nether,672,priest,discipline,15,7,8
34196,Shockpriest,grim-batol,672,priest,discipline,18,7,11
34197,Touchmé,blackmoore,672,priest,discipline,18,7,11
34198,Comple,kazzak,672,priest,discipline,18,7,11
34199,Solerona,blackmoore,672,priest,discipline,18,7,11
34200,Zivl,blackrock,672,priest,discipline,18,7,11
34201,Wyroofear,ragnaros,672,priest,discipline,18,7,11
34202,Toxicx,aegwynn,672,priest,discipline,18,7,11
34203,Люциусмелфой,howling-fjord,672,priest,discipline,18,7,11
34204,Cház,sanguino,672,priest,discipline,18,7,11
34205,Djariisimp,tarren-mill,672,priest,discipline,18,7,11
34206,Bebsenpai,hyjal,672,priest,discipline,18,7,11
34207,Venitate,kazzak,672,priest,discipline,18,7,11
34208,Ârth,kirin-tor,672,priest,discipline,18,7,11
34209,Bubblebuddy,draenor,672,priest,discipline,18,7,11
34210,Byez,kazzak,672,priest,discipline,18,7,11
34211,Sardine,ravencrest,672,priest,discipline,18,7,11
34212,Bij,outland,672,priest,discipline,18,7,11
34213,Vate,aszune,672,priest,discipline,18,7,11
34214,Malpractîce,draenor,672,priest,discipline,18,7,11
34215,Jimski,stormscale,672,priest,discipline,24,7,17
34216,Sweity,dun-modr,672,priest,discipline,24,7,17
34217,Exaneo,ragnaros,672,priest,discipline,24,7,17
34218,Хексорик,howling-fjord,672,priest,discipline,24,7,17
34219,Yaaoz,dun-modr,672,priest,discipline,24,7,17
34220,Sàvia,pozzo-delleternità,672,priest,discipline,24,7,17
34221,Lunærÿ,hyjal,672,priest,discipline,24,7,17
34222,Колабезгаза,howling-fjord,671,priest,discipline,12,7,5
34223,Giggidee,tarren-mill,671,priest,discipline,12,7,5
34224,Szederina,outland,671,priest,discipline,12,7,5
34225,Manî,quelthalas,671,priest,discipline,12,7,5
34226,Rines,thrall,671,priest,discipline,12,7,5
34227,Zzero,kazzak,671,priest,discipline,12,7,5
34228,Löspajen,stormscale,671,priest,discipline,12,7,5
34229,Boomboxk,darksorrow,671,priest,discipline,12,7,5
34230,Атинка,gordunni,671,priest,discipline,12,7,5
34231,Taksí,tarren-mill,671,priest,discipline,12,7,5
34232,Chayz,thrall,671,priest,discipline,12,7,5
34233,Taxprayer,blackmoore,671,priest,discipline,12,7,5
34234,Роа,soulflayer,671,priest,discipline,12,7,5
34235,Flode,draenor,671,priest,discipline,12,7,5
34236,Gagai,ravencrest,671,priest,discipline,12,7,5
34237,Lish,dun-modr,671,priest,discipline,12,7,5
34238,Phoskitos,sanguino,671,priest,discipline,12,7,5
34239,Saltfeskball,tarren-mill,671,priest,discipline,12,7,5
34240,Dannebrog,eonar,671,priest,discipline,12,7,5
34241,Xvpr,trollbane,671,priest,discipline,12,7,5
34242,Reól,blackmoore,671,priest,discipline,12,7,5
34243,Froboz,the-venture-co,671,priest,discipline,12,7,5
34244,Oikus,minahonda,671,priest,discipline,12,7,5
34245,Köftemcc,blackrock,671,priest,discipline,12,7,5
34246,Liljohnny,silvermoon,671,priest,discipline,12,7,5
34247,Aemi,draenor,671,priest,discipline,12,7,5
34248,Highpriestqt,pozzo-delleternità,671,priest,discipline,12,7,5
34249,Ezhealing,ravencrest,671,priest,discipline,12,7,5
34250,Exorcizamus,khaz-modan,671,priest,discipline,12,7,5
34251,Fargall,eonar,671,priest,discipline,12,7,5
34252,Schnîttchen,blackrock,671,priest,discipline,12,7,5
34253,Àlucárd,blackhand,671,priest,discipline,12,7,5
34254,Zazeriño,dun-modr,671,priest,discipline,13,7,6
34255,Ziap,dentarg,671,priest,discipline,20,8,12
34256,Kasuny,outland,671,priest,discipline,18,7,11
34257,Текилашотёп,soulflayer,671,priest,discipline,18,7,11
34258,Lezz,ragnaros,671,priest,discipline,18,7,11
34259,Lillaego,ragnaros,671,priest,discipline,18,7,11
34260,Débthèønë,ravencrest,671,priest,discipline,18,7,11
34261,Botoxo,zirkel-des-cenarius,671,priest,discipline,18,7,11
34262,Lysium,sylvanas,671,priest,discipline,18,7,11
34263,Pixa,dalaran,671,priest,discipline,18,7,11
34264,Cronershadow,stormscale,671,priest,discipline,18,7,11
34265,Маджори,azuregos,671,priest,discipline,18,7,11
34266,Психоз,gordunni,671,priest,discipline,18,7,11
34267,Nyù,kazzak,671,priest,discipline,18,7,11
34268,Carlolol,blackmoore,671,priest,discipline,22,8,14
34269,Holykebab,defias-brotherhood,671,priest,discipline,24,7,17
34270,Maâti,kazzak,671,priest,discipline,24,7,17
34271,Pandariel,argent-dawn,671,priest,discipline,24,7,17
34272,Höfi,ragnaros,671,priest,discipline,24,7,17
34273,Orqz,anetheron,670,priest,discipline,12,7,5
34274,Exo,blackmoore,670,priest,discipline,12,7,5
34275,Këkhtaräkh,tarren-mill,670,priest,discipline,12,7,5
34276,Fathermaxii,stormrage,670,priest,discipline,12,7,5
34277,Cheesegód,outland,670,priest,discipline,12,7,5
34278,Byshadow,silvermoon,670,priest,discipline,12,7,5
34279,Tilah,azjolnerub,670,priest,discipline,12,7,5
34280,Хемех,soulflayer,670,priest,discipline,12,7,5
34281,Reizer,argent-dawn,670,priest,discipline,12,7,5
34282,Ремкомплект,soulflayer,670,priest,discipline,12,7,5
34283,Mapplish,eredar,670,priest,discipline,12,7,5
34284,Noralía,die-aldor,670,priest,discipline,12,7,5
34285,Nekros,agamaggan,670,priest,discipline,14,7,7
34286,Каратэк,howling-fjord,670,priest,discipline,17,7,10
34287,Aggresivdisc,hyjal,670,priest,discipline,18,7,11
34288,Cabuto,darksorrow,670,priest,discipline,18,7,11
34289,Olikharma,archimonde,670,priest,discipline,18,7,11
34290,Makkalisser,kazzak,670,priest,discipline,24,7,17
34291,Nswqt,kazzak,669,priest,discipline,12,7,5
34292,Freeak,hellfire,669,priest,discipline,12,7,5
34293,Eentii,twisting-nether,669,priest,discipline,12,7,5
34294,Belithia,argent-dawn,669,priest,discipline,12,7,5
34295,Sadira,malganis,669,priest,discipline,18,7,11
34296,Зашохэйт,soulflayer,669,priest,discipline,18,7,11
34297,Дэйвора,ashenvale,669,priest,discipline,18,7,11
34298,Dizdae,rashgarroth,669,priest,discipline,18,7,11
34299,Йениферх,gordunni,669,priest,discipline,24,7,17
34300,Æzy,burning-blade,669,priest,discipline,24,7,17
34301,Абсорберша,gordunni,668,priest,discipline,12,7,5
34302,Пакспамир,gordunni,668,priest,discipline,12,7,5
34303,Wärtheur,sanguino,668,priest,discipline,18,7,11
34304,Mescaminator,blackmoore,668,priest,discipline,18,7,11
34305,Isoris,hyjal,668,priest,discipline,18,7,11
34306,Lacaena,deathwing,668,priest,discipline,18,7,11
34307,Darknëss,malganis,668,priest,discipline,18,7,11
34308,Prgkek,sanguino,668,priest,discipline,24,7,17
34309,Shyktar,sanguino,667,priest,discipline,12,7,5
34310,Дуззер,howling-fjord,667,priest,discipline,12,7,5
34311,Romelu,archimonde,666,priest,discipline,18,7,11
34312,Святаядухота,soulflayer,664,priest,discipline,24,7,17
34313,Timmemeep,outland,663,priest,discipline,18,7,11
34314,Холисшит,gordunni,662,priest,discipline,18,7,11
34315,Alminä,archimonde,661,priest,discipline,12,7,5
34316,Camellight,stormscale,661,priest,discipline,18,7,11
34317,Hiliom,ahnqiraj,660,priest,discipline,38,12,26
34318,Willibad,executus,658,priest,discipline,18,7,11
34319,Vatizinium,veklor,655,priest,discipline,17,7,10
34320,Widöw,cthun,653,priest,discipline,31,11,20
34321,Jaein,thrall,640,priest,discipline,16,8,8
34322,Samimnot,ravencrest,639,priest,discipline,14,8,6
34323,Øxx,blackrock,639,priest,discipline,17,7,10
34324,Yazzyz,eredar,639,priest,discipline,23,7,16
34325,Chooser,stormscale,638,priest,discipline,20,8,12
34326,Nepheliel,ysondre,628,priest,discipline,12,8,4
34327,Zuigen,lightbringer,624,priest,discipline,9,8,1
34328,Ysteriagødx,twisting-nether,624,priest,discipline,15,8,7
34329,Submexoxo,archimonde,624,priest,discipline,15,7,8
34330,Yourholiness,rexxar,624,priest,discipline,15,7,8
34331,Akril,silvermoon,622,priest,discipline,11,7,4
34332,Cezzar,kazzak,622,priest,discipline,11,7,4
34333,Рейаста,howling-fjord,622,priest,discipline,15,7,8
34334,Zénack,stormscale,622,priest,discipline,17,7,10
34335,Susee,nozdormu,621,priest,discipline,15,8,7
34336,Darktattoo,twisting-nether,621,priest,discipline,21,8,13
34337,Blastor,ravencrest,621,priest,discipline,21,7,14
34338,Argôs,ravencrest,620,priest,discipline,14,8,6
34339,Voilencia,kazzak,620,priest,discipline,21,7,14
34340,Giibboo,emerald-dream,618,priest,discipline,22,9,13
34341,Rallzken,stormscale,614,priest,discipline,29,10,19
34342,Jumbe,eredar,607,priest,discipline,11,7,4
34343,Shymouni,norgannon,606,priest,discipline,13,8,5
34344,Atibarát,hellfire,605,priest,discipline,16,7,9
34345,Dumstrut,twisting-nether,602,priest,discipline,17,7,10
34346,Пофанчику,soulflayer,597,priest,discipline,35,14,21
34347,Diccen,twilights-hammer,592,priest,discipline,13,7,6
34348,Schnüschnü,blackmoore,592,priest,discipline,25,7,18
34349,Maetena,archimonde,589,priest,discipline,13,7,6
34350,Yummelol,dun-modr,585,priest,discipline,20,8,12
34351,Nemex,jaedenar,576,priest,discipline,6,6,0
34352,Illiest,ravencrest,576,priest,discipline,6,6,0
34353,Cluelesstwo,ravencrest,576,priest,discipline,6,6,0
34354,Rqx,stormscale,576,priest,discipline,6,6,0
34355,Retardé,tarren-mill,576,priest,discipline,6,6,0
34356,Måzikeen,stormscale,576,priest,discipline,6,6,0
34357,Táliss,arthas,576,priest,discipline,6,6,0
34358,Scrubydoo,ravencrest,576,priest,discipline,6,6,0
34359,Nòvã,kazzak,576,priest,discipline,6,6,0
34360,Willzah,outland,576,priest,discipline,6,6,0
34361,Brainwashed,malorne,576,priest,discipline,10,7,3
34362,Tifrahat,the-maelstrom,576,priest,discipline,12,6,6
34363,Nicolovato,draenor,576,priest,discipline,12,6,6
34364,Whynolove,ragnaros,576,priest,discipline,12,6,6
34365,Seemywatch,ungoro,576,priest,discipline,12,6,6
34366,Peign,eredar,576,priest,discipline,12,6,6
34367,Roxxurios,khazgoroth,576,priest,discipline,12,6,6
34368,Шарлизх,gordunni,576,priest,discipline,12,6,6
34369,Nyxara,outland,576,priest,discipline,12,6,6
34370,Ascindra,ravencrest,576,priest,discipline,12,6,6
34371,Popor,archimonde,576,priest,discipline,12,6,6
34372,Zyreenx,blackrock,576,priest,discipline,12,6,6
34373,Mitasdi,stormscale,576,priest,discipline,12,6,6
34374,Randpriets,nemesis,576,priest,discipline,12,6,6
34375,Ènma,archimonde,576,priest,discipline,12,6,6
34376,Healinrbglol,blackmoore,576,priest,discipline,12,6,6
34377,Dødy,hyjal,576,priest,discipline,12,6,6
34378,Wortmonster,malganis,576,priest,discipline,12,6,6
34379,Вакидзачи,gordunni,576,priest,discipline,12,6,6
34380,Corrâ,aegwynn,576,priest,discipline,12,6,6
34381,Pukkadtfasz,ragnaros,576,priest,discipline,12,6,6
34382,Eiw,drakthul,576,priest,discipline,12,6,6
34383,Sensimiya,dalaran,576,priest,discipline,12,6,6
34384,Notthatbad,draenor,576,priest,discipline,12,6,6
34385,Ballarr,burning-legion,576,priest,discipline,12,6,6
34386,Laddets,ravencrest,576,priest,discipline,12,6,6
34387,Stuhlgänger,blackhand,576,priest,discipline,12,6,6
34388,Menjo,silvermoon,576,priest,discipline,12,6,6
34389,Apeminister,nemesis,576,priest,discipline,12,6,6
34390,Çhéåtçødé,ravencrest,576,priest,discipline,12,6,6
34391,Ryyne,ravencrest,576,priest,discipline,12,6,6
34392,Steroidkidx,ravencrest,576,priest,discipline,12,6,6
34393,Щещенская,gordunni,576,priest,discipline,12,6,6
34394,Nogsn,kazzak,576,priest,discipline,12,6,6
34395,Fästrak,dalaran,576,priest,discipline,12,6,6
34396,Ranagöl,ragnaros,576,priest,discipline,12,6,6
34397,Jogug,mannoroth,576,priest,discipline,12,6,6
34398,Ahyha,ravencrest,576,priest,discipline,12,6,6
34399,Zeksii,kazzak,576,priest,discipline,12,6,6
34400,Pallimpallam,blackrock,576,priest,discipline,12,6,6
34401,Visàge,silvermoon,576,priest,discipline,12,6,6
34402,Kankstery,kazzak,576,priest,discipline,12,6,6
34403,Holishiit,xavius,576,priest,discipline,12,6,6
34404,Данке,soulflayer,576,priest,discipline,12,6,6
34405,Densen,burning-legion,576,priest,discipline,12,6,6
34406,Lafap,eredar,576,priest,discipline,12,6,6
34407,Inánis,argent-dawn,576,priest,discipline,12,6,6
34408,Pøh,kilrogg,576,priest,discipline,12,6,6
34409,Wispyx,kazzak,576,priest,discipline,12,6,6
34410,Hardstylewtf,chromaggus,576,priest,discipline,12,6,6
34411,Dunkelseele,ahnqiraj,576,priest,discipline,12,6,6
34412,Giygas,malganis,576,priest,discipline,12,6,6
34413,Boysa,earthen-ring,576,priest,discipline,12,6,6
34414,Vladhealsyou,outland,576,priest,discipline,12,6,6
34415,Kaylaylaylay,draenor,576,priest,discipline,12,6,6
34416,Jaduheart,ravencrest,576,priest,discipline,12,6,6
34417,Aveix,silvermoon,576,priest,discipline,12,6,6
34418,Awalneczarem,magtheridon,576,priest,discipline,12,6,6
34419,Yllaenia,twisting-nether,576,priest,discipline,12,6,6
34420,Kintsugí,ragnaros,576,priest,discipline,12,6,6
34421,Becknarbritt,stormscale,576,priest,discipline,12,6,6
34422,Zøid,ysondre,576,priest,discipline,12,6,6
34423,Idisck,kazzak,576,priest,discipline,12,6,6
34424,Nithraw,kazzak,576,priest,discipline,12,6,6
34425,Vulreth,culte-de-la-rive-noire,576,priest,discipline,12,6,6
34426,Resuscitator,spinebreaker,576,priest,discipline,12,6,6
34427,Ordeal,tarren-mill,576,priest,discipline,12,6,6
34428,Chalecø,dun-modr,576,priest,discipline,12,6,6
34429,Jesper,outland,576,priest,discipline,12,6,6
34430,Chira,thunderhorn,576,priest,discipline,12,6,6
34431,Vorsie,tarren-mill,576,priest,discipline,12,6,6
34432,Vhis,ragnaros,576,priest,discipline,12,6,6
34433,Pigo,tarren-mill,576,priest,discipline,12,6,6
34434,Shadowzrip,twilights-hammer,576,priest,discipline,12,6,6
34435,Свао,howling-fjord,576,priest,discipline,12,6,6
34436,Димавампирик,howling-fjord,576,priest,discipline,12,6,6
34437,Редженерэйшн,gordunni,576,priest,discipline,12,6,6
34438,Родохрозит,blackscar,576,priest,discipline,12,6,6
34439,Steelbird,ravencrest,576,priest,discipline,12,6,6
34440,Rune,ravencrest,576,priest,discipline,12,6,6
34441,Manethø,twisting-nether,576,priest,discipline,12,6,6
34442,Tâssên,kazzak,576,priest,discipline,12,6,6
34443,Mârcwel,burning-legion,576,priest,discipline,12,6,6
34444,Jaylove,frostwolf,576,priest,discipline,12,6,6
34445,Йодтс,soulflayer,576,priest,discipline,12,6,6
34446,Sejká,malganis,576,priest,discipline,12,6,6
34447,Lectrá,kazzak,576,priest,discipline,12,6,6
34448,Sleepzqt,blackrock,576,priest,discipline,12,6,6
34449,Yunggoth,eredar,576,priest,discipline,12,6,6
34450,Shttygame,nazjatar,576,priest,discipline,12,6,6
34451,Msbald,shattered-hand,576,priest,discipline,12,6,6
34452,Eviscerätor,draenor,576,priest,discipline,12,6,6
34453,Whitemask,kazzak,576,priest,discipline,12,6,6
34454,Belfu,twisting-nether,576,priest,discipline,12,6,6
34455,Imaut,emerald-dream,576,priest,discipline,12,6,6
34456,Oddarne,twisting-nether,576,priest,discipline,12,6,6
34457,Wush,tarren-mill,576,priest,discipline,12,6,6
34458,Stee,sylvanas,576,priest,discipline,12,6,6
34459,Samerika,tarren-mill,576,priest,discipline,12,6,6
34460,Abyl,nethersturm,576,priest,discipline,12,6,6
34461,Rotulos,stormrage,576,priest,discipline,12,6,6
34462,Ðèvì,ravencrest,576,priest,discipline,12,6,6
34463,Vallstwo,zuljin,576,priest,discipline,12,6,6
34464,Aethanira,silvermoon,576,priest,discipline,12,6,6
34465,Maistuu,tarren-mill,576,priest,discipline,12,6,6
34466,Melcarth,blades-edge,576,priest,discipline,12,6,6
34467,Ранзерито,soulflayer,576,priest,discipline,17,8,9
34468,Naìt,ragnaros,576,priest,discipline,15,7,8
34469,Iqy,kazzak,576,priest,discipline,15,7,8
34470,Chrisdorner,archimonde,576,priest,discipline,15,6,9
34471,Wixzyx,ravencrest,576,priest,discipline,16,6,10
34472,Волия,gordunni,576,priest,discipline,17,6,11
34473,Respectwømen,ravencrest,576,priest,discipline,18,6,12
34474,Бичиотаке,azuregos,576,priest,discipline,18,6,12
34475,Deadbishop,kazzak,576,priest,discipline,18,6,12
34476,Abrakahudder,tarren-mill,576,priest,discipline,18,6,12
34477,Alros,elune,576,priest,discipline,18,6,12
34478,Jph,thrall,576,priest,discipline,18,6,12
34479,Velri,runetotem,576,priest,discipline,18,6,12
34480,Hélgå,kazzak,576,priest,discipline,18,6,12
34481,Швдшка,howling-fjord,576,priest,discipline,18,6,12
34482,Broksigar,the-maelstrom,576,priest,discipline,18,6,12
34483,Ballepresten,outland,576,priest,discipline,18,6,12
34484,Sosionomi,argent-dawn,576,priest,discipline,18,6,12
34485,ßøunty,dun-modr,576,priest,discipline,18,6,12
34486,Сашашвд,howling-fjord,576,priest,discipline,18,6,12
34487,Limbas,dun-modr,576,priest,discipline,18,6,12
34488,Zinzo,frostwolf,576,priest,discipline,18,6,12
34489,Thielaxx,ravencrest,576,priest,discipline,18,6,12
34490,Achardia,argent-dawn,576,priest,discipline,18,6,12
34491,Gødsmack,blackhand,576,priest,discipline,18,6,12
34492,Decimerad,kazzak,576,priest,discipline,18,6,12
34493,Prarch,sylvanas,576,priest,discipline,18,6,12
34494,Stvilde,ragnaros,576,priest,discipline,18,6,12
34495,Rabbai,ravencrest,576,priest,discipline,18,6,12
34496,Венэма,azuregos,576,priest,discipline,18,6,12
34497,Декорий,soulflayer,576,priest,discipline,18,6,12
34498,Cinjá,thrall,576,priest,discipline,19,6,13
34499,Twisty,malganis,576,priest,discipline,19,6,13
34500,Alwiel,kazzak,576,priest,discipline,24,6,18
34501,Dunbaltaris,blackrock,576,priest,discipline,24,6,18
34502,Holytang,grim-batol,575,priest,discipline,6,6,0
34503,Sørney,aegwynn,575,priest,discipline,9,7,2
34504,Tira,darksorrow,575,priest,discipline,12,6,6
34505,Чикхоп,blackscar,575,priest,discipline,12,6,6
34506,Bandäid,ravencrest,575,priest,discipline,12,6,6
34507,Handmännchen,kelthuzad,575,priest,discipline,12,6,6
34508,Mithralas,doomhammer,575,priest,discipline,12,6,6
34509,Insicompany,antonidas,575,priest,discipline,12,6,6
34510,Kanketopries,korgall,575,priest,discipline,12,6,6
34511,Grazz,grim-batol,575,priest,discipline,12,6,6
34512,Doxs,terokkar,575,priest,discipline,12,6,6
34513,Highlightss,outland,575,priest,discipline,12,6,6
34514,Lichtl,ysera,575,priest,discipline,12,6,6
34515,Gæxelademad,draenor,575,priest,discipline,12,6,6
34516,Vastüdö,ragnaros,575,priest,discipline,12,6,6
34517,Noyxz,frostmourne,575,priest,discipline,12,6,6
34518,Hùrtyoux,outland,575,priest,discipline,12,6,6
34519,Phexon,outland,575,priest,discipline,12,6,6
34520,Montane,wrathbringer,575,priest,discipline,12,6,6
34521,Лерасапорт,gordunni,575,priest,discipline,12,6,6
34522,Ysharg,sinstralis,575,priest,discipline,12,6,6
34523,Ðotgød,nemesis,575,priest,discipline,12,6,6
34524,Hâmmel,blackrock,575,priest,discipline,12,6,6
34525,Oversole,kazzak,575,priest,discipline,12,6,6
34526,Flackiepi,tarren-mill,575,priest,discipline,12,6,6
34527,Zembowae,drakthul,575,priest,discipline,12,6,6
34528,Costhina,alakir,575,priest,discipline,12,6,6
34529,Naid,exodar,575,priest,discipline,12,6,6
34530,Grêndine,blackmoore,575,priest,discipline,12,6,6
34531,Hanagaki,ragnaros,575,priest,discipline,12,6,6
34532,Brronxx,frostwolf,575,priest,discipline,12,6,6
34533,Priestvnr,hyjal,575,priest,discipline,12,6,6
34534,Bigbootyheal,silvermoon,575,priest,discipline,12,6,6
34535,Ponpon,onyxia,575,priest,discipline,12,6,6
34536,Noxxill,eredar,575,priest,discipline,12,6,6
34537,Hypnòz,archimonde,575,priest,discipline,12,6,6
34538,Undeadv,twisting-nether,575,priest,discipline,15,6,9
34539,Каэден,blackscar,575,priest,discipline,18,6,12
34540,Thehealer,twisting-nether,575,priest,discipline,18,6,12
34541,Sulla,draenor,575,priest,discipline,18,6,12
34542,Estarôn,antonidas,575,priest,discipline,18,6,12
34543,Skytheory,eredar,575,priest,discipline,18,6,12
34544,Noncuro,tarren-mill,575,priest,discipline,18,6,12
34545,Priestbiyy,sunstrider,575,priest,discipline,18,6,12
34546,Castêr,silvermoon,575,priest,discipline,18,6,12
34547,Kafrooss,silvermoon,575,priest,discipline,18,6,12
34548,Хегендцп,galakrond,575,priest,discipline,18,6,12
34549,Savíour,kazzak,575,priest,discipline,24,6,18
34550,Вэстервилли,howling-fjord,575,priest,discipline,24,6,18
34551,Drgrey,archimonde,575,priest,discipline,25,6,19
34552,Бобадамс,gordunni,574,priest,discipline,12,6,6
34553,Tindoriel,bronzebeard,574,priest,discipline,12,6,6
34554,Leonard,nemesis,574,priest,discipline,12,6,6
34555,Konstantyne,hyjal,574,priest,discipline,12,6,6
34556,Nienni,mannoroth,574,priest,discipline,12,6,6
34557,Preacia,twisting-nether,574,priest,discipline,12,6,6
34558,Dontouch,nemesis,574,priest,discipline,12,6,6
34559,Avinci,blackrock,574,priest,discipline,12,6,6
34560,Vebuya,blackmoore,574,priest,discipline,12,6,6
34561,Fréyja,sanguino,574,priest,discipline,18,6,12
34562,Æisa,blackmoore,574,priest,discipline,18,6,12
34563,Pæx,antonidas,574,priest,discipline,18,6,12
34564,Muftl,thrall,574,priest,discipline,18,6,12
34565,Zoratha,kazzak,574,priest,discipline,18,6,12
34566,Prigart,sylvanas,574,priest,discipline,18,6,12
34567,Easxyx,veklor,573,priest,discipline,6,6,0
34568,Këller,hyjal,573,priest,discipline,12,6,6
34569,Yeeni,doomhammer,573,priest,discipline,12,6,6
34570,Tycrael,hyjal,573,priest,discipline,12,6,6
34571,Lolenjoyer,ravencrest,573,priest,discipline,18,6,12
34572,Priestmrt,doomhammer,573,priest,discipline,18,6,12
34573,Esthea,malganis,573,priest,discipline,18,6,12
34574,Hólyeárth,twisting-nether,573,priest,discipline,18,6,12
34575,Ilynïa,quelthalas,573,priest,discipline,19,6,13
34576,Wanah,ravencrest,573,priest,discipline,24,6,18
34577,Kelthurus,die-nachtwache,572,priest,discipline,12,6,6
34578,Saraph,argent-dawn,572,priest,discipline,12,6,6
34579,Loriny,ragnaros,572,priest,discipline,14,6,8
34580,Dathot,the-maelstrom,572,priest,discipline,18,6,12
34581,Glutenhode,stormscale,571,priest,discipline,12,6,6
34582,Крайне,soulflayer,571,priest,discipline,18,6,12
34583,Destally,kirin-tor,570,priest,discipline,12,6,6
34584,Thechieftain,twilights-hammer,570,priest,discipline,12,6,6
34585,Rawkilla,stormrage,570,priest,discipline,12,6,6
34586,Lyss,zirkel-des-cenarius,570,priest,discipline,18,6,12
34587,Mijola,thrall,565,priest,discipline,12,6,6
34588,Ahbe,stormscale,559,priest,discipline,11,6,5
34589,Superbianka,stormscale,544,priest,discipline,10,7,3
34590,Drlight,stormscale,543,priest,discipline,11,6,5
34591,Cavadaya,eredar,543,priest,discipline,14,7,7
34592,Jumpaxx,archimonde,543,priest,discipline,17,6,11
34593,Jasty,nemesis,543,priest,discipline,23,6,17
34594,Clescy,ravencrest,542,priest,discipline,11,6,5
34595,Lemowae,doomhammer,542,priest,discipline,22,6,16
34596,Imdeadxd,twisting-nether,528,priest,discipline,9,7,2
34597,Nàvy,archimonde,528,priest,discipline,15,6,9
34598,Nécromant,frostwolf,527,priest,discipline,9,7,2
34599,Adare,sanguino,527,priest,discipline,11,6,5
34600,Icecoldleap,grim-batol,527,priest,discipline,11,6,5
34601,Splintplays,zuljin,527,priest,discipline,11,6,5
34602,Craquylx,hyjal,527,priest,discipline,17,6,11
34603,Lankydoc,blackmoore,522,priest,discipline,16,7,9
34604,Demmi,dun-modr,522,priest,discipline,22,7,15
34605,Полуниця,galakrond,522,priest,discipline,23,7,16
34606,Xotz,thrall,521,priest,discipline,15,8,7
34607,Teologen,outland,520,priest,discipline,19,7,12
34608,Isson,earthen-ring,519,priest,discipline,19,7,12
34609,Malorian,khadgar,512,priest,discipline,20,8,12
34610,Cummask,silvermoon,512,priest,discipline,16,6,10
34611,Spirina,terokkar,511,priest,discipline,14,6,8
34612,Shadiè,sylvanas,511,priest,discipline,14,6,8
34613,Figpucker,silvermoon,496,priest,discipline,13,6,7
34614,Tarboba,tarren-mill,496,priest,discipline,13,6,7
34615,Stàrlîght,chants-éternels,495,priest,discipline,11,6,5
34616,Rulz,zuluhed,486,priest,discipline,22,7,15
34617,Schustraja,blackrock,480,priest,discipline,6,5,1
34618,Bendforpi,outland,480,priest,discipline,6,5,1
34619,Vampiro,blackhand,480,priest,discipline,6,5,1
34620,Instantcasts,ravencrest,480,priest,discipline,6,5,1
34621,Bec,ragnaros,480,priest,discipline,6,5,1
34622,Trippinorbs,stormscale,480,priest,discipline,6,5,1
34623,Петрушка,gordunni,480,priest,discipline,6,5,1
34624,Ounxx,blackrock,480,priest,discipline,6,5,1
34625,Пристмиша,gordunni,480,priest,discipline,6,5,1
34626,Loldisc,arthas,480,priest,discipline,6,5,1
34627,Slowinmotion,twisting-nether,480,priest,discipline,6,5,1
34628,Swep,ragnaros,480,priest,discipline,6,5,1
34629,Usermane,ravencrest,480,priest,discipline,6,5,1
34630,Nayballistic,tarren-mill,480,priest,discipline,6,5,1
34631,Lightform,twisting-nether,480,priest,discipline,6,5,1
34632,Chane,blackmoore,480,priest,discipline,6,5,1
34633,Hannïri,archimonde,480,priest,discipline,6,5,1
34634,Warm,auchindoun,480,priest,discipline,6,5,1
34635,Qkidow,kult-der-verdammten,480,priest,discipline,6,5,1
34636,Sorchad,hyjal,480,priest,discipline,6,5,1
34637,Nttyfromohio,ravencrest,480,priest,discipline,6,5,1
34638,Lamp,terokkar,480,priest,discipline,6,5,1
34639,Våfflán,silvermoon,480,priest,discipline,6,5,1
34640,Kemari,aegwynn,480,priest,discipline,6,5,1
34641,Нэриэлл,gordunni,480,priest,discipline,6,5,1
34642,Gydramist,ragnaros,480,priest,discipline,6,5,1
34643,Kinkshamer,emeriss,480,priest,discipline,6,5,1
34644,Naivegnome,draenor,480,priest,discipline,6,5,1
34645,Gidy,blackmoore,480,priest,discipline,6,5,1
34646,Confusedleaf,ragnaros,480,priest,discipline,6,5,1
34647,Coloringßook,zuljin,480,priest,discipline,6,5,1
34648,Гачидварфич,gordunni,480,priest,discipline,6,5,1
34649,Ronnmoss,defias-brotherhood,480,priest,discipline,6,5,1
34650,Åzjol,magtheridon,480,priest,discipline,6,5,1
34651,Proteinsnack,auchindoun,480,priest,discipline,6,5,1
34652,Daniriuz,minahonda,480,priest,discipline,6,5,1
34653,Turboshadow,stormscale,480,priest,discipline,12,5,7
34654,Chaapsbbq,archimonde,480,priest,discipline,12,5,7
34655,Dogfacex,ravencrest,480,priest,discipline,12,5,7
34656,Selí,die-aldor,480,priest,discipline,12,5,7
34657,Amayko,kazzak,480,priest,discipline,12,5,7
34658,Artemïsïa,ravencrest,480,priest,discipline,12,5,7
34659,Mindblown,arthas,480,priest,discipline,12,5,7
34660,Djleapgødx,twisting-nether,480,priest,discipline,12,5,7
34661,Djplay,aegwynn,480,priest,discipline,12,5,7
34662,Discokuken,outland,480,priest,discipline,12,5,7
34663,Pdead,kazzak,480,priest,discipline,12,5,7
34664,Wontdispel,ravencrest,480,priest,discipline,12,5,7
34665,Immutable,twisting-nether,480,priest,discipline,12,5,7
34666,Mariahscarey,blackhand,480,priest,discipline,12,5,7
34667,Faloty,draenor,480,priest,discipline,12,5,7
34668,Hôtseitdank,blackrock,480,priest,discipline,12,5,7
34669,Seskipr,stormreaver,480,priest,discipline,12,5,7
34670,Besmrtna,saurfang,480,priest,discipline,12,5,7
34671,Romeqt,tarren-mill,480,priest,discipline,12,5,7
34672,Alejandrothe,outland,480,priest,discipline,12,5,7
34673,Playax,silvermoon,480,priest,discipline,12,5,7
34674,Funzies,doomhammer,480,priest,discipline,12,5,7
34675,Adrigodx,malganis,480,priest,discipline,12,5,7
34676,Bonsoin,kirin-tor,480,priest,discipline,12,5,7
34677,Skyland,emeriss,480,priest,discipline,12,5,7
34678,Nizrå,archimonde,480,priest,discipline,12,5,7
34679,Jumbypri,outland,480,priest,discipline,12,5,7
34680,Wckd,tarren-mill,480,priest,discipline,12,5,7
34681,Grozozo,tarren-mill,480,priest,discipline,12,5,7
34682,Yö,stormscale,480,priest,discipline,12,5,7
34683,Xeay,blackrock,480,priest,discipline,12,5,7
34684,Лиэся,gordunni,480,priest,discipline,12,5,7
34685,Buchânân,archimonde,480,priest,discipline,12,5,7
34686,Hollylicious,kazzak,480,priest,discipline,12,5,7
34687,Späxxi,amanthul,480,priest,discipline,12,5,7
34688,Schnikki,mannoroth,480,priest,discipline,12,5,7
34689,Caramello,stormscale,480,priest,discipline,12,5,7
34690,Вайтбласт,howling-fjord,480,priest,discipline,12,5,7
34691,Kde,burning-legion,480,priest,discipline,12,5,7
34692,Libertero,drakthul,480,priest,discipline,12,5,7
34693,Windieqt,drakthul,480,priest,discipline,12,5,7
34694,Saphèa,burning-legion,480,priest,discipline,12,5,7
34695,Sak,uldaman,480,priest,discipline,12,5,7
34696,Smehp,outland,480,priest,discipline,12,5,7
34697,Jeboc,ravencrest,480,priest,discipline,12,5,7
34698,Mcx,stormscale,480,priest,discipline,12,5,7
34699,Nayballsp,tarren-mill,480,priest,discipline,12,5,7
34700,Холигард,grom,480,priest,discipline,12,5,7
34701,Ghettothug,darksorrow,480,priest,discipline,12,5,7
34702,Karpi,twisting-nether,480,priest,discipline,12,5,7
34703,Theplague,kazzak,480,priest,discipline,12,5,7
34704,Ðæthshaðow,dalaran,480,priest,discipline,12,5,7
34705,Nibhou,dalaran,480,priest,discipline,12,5,7
34706,Kolsy,twisting-nether,480,priest,discipline,12,5,7
34707,Dsyleixa,archimonde,480,priest,discipline,12,5,7
34708,Rutjake,stormscale,480,priest,discipline,12,5,7
34709,Qtdorr,ravencrest,480,priest,discipline,12,5,7
34710,Discgødx,thrall,480,priest,discipline,12,5,7
34711,Donbas,tarren-mill,480,priest,discipline,12,5,7
34712,Shyvi,ravencrest,480,priest,discipline,12,5,7
34713,Phaedisc,defias-brotherhood,480,priest,discipline,12,5,7
34714,Lunatrix,sanguino,480,priest,discipline,12,5,7
34715,Kryckmongo,tarren-mill,480,priest,discipline,12,5,7
34716,Уер,galakrond,480,priest,discipline,12,5,7
34717,Rektom,archimonde,480,priest,discipline,12,5,7
34718,Altarboi,veknilash,480,priest,discipline,12,5,7
34719,Yukîna,blackrock,480,priest,discipline,12,5,7
34720,Чотки,deepholm,480,priest,discipline,12,5,7
34721,Prencø,sanguino,480,priest,discipline,12,5,7
34722,Забейка,howling-fjord,480,priest,discipline,12,5,7
34723,Supfamskrrt,stormscale,480,priest,discipline,12,5,7
34724,Marypops,outland,480,priest,discipline,12,5,7
34725,Абсорбиболь,howling-fjord,480,priest,discipline,12,5,7
34726,Magthalor,twisting-nether,480,priest,discipline,12,5,7
34727,Shadew,stormscale,480,priest,discipline,12,5,7
34728,Darkfreak,malygos,480,priest,discipline,12,5,7
34729,Chir,burning-legion,480,priest,discipline,12,5,7
34730,Sagart,ravencrest,480,priest,discipline,12,5,7
34731,Pwsx,draenor,480,priest,discipline,12,5,7
34732,Ptipotam,archimonde,480,priest,discipline,12,5,7
34733,Лизота,gordunni,480,priest,discipline,12,5,7
34734,Tessaben,silvermoon,480,priest,discipline,12,5,7
34735,Navihato,silvermoon,480,priest,discipline,12,5,7
34736,Borgamor,frostmane,480,priest,discipline,12,5,7
34737,Ajaxfreak,blackmoore,480,priest,discipline,12,5,7
34738,Mayday,silvermoon,480,priest,discipline,12,5,7
34739,Døtzillah,kazzak,480,priest,discipline,12,5,7
34740,Ponting,kazzak,480,priest,discipline,12,5,7
34741,Healysith,archimonde,480,priest,discipline,12,5,7
34742,Jupilen,chogall,480,priest,discipline,12,5,7
34743,Thonidas,das-syndikat,480,priest,discipline,12,5,7
34744,Tîwele,dalvengyr,480,priest,discipline,12,5,7
34745,Æðwyñ,ragnaros,480,priest,discipline,12,5,7
34746,Cirøpriest,ravencrest,480,priest,discipline,12,5,7
34747,Katsikatsika,silvermoon,480,priest,discipline,12,5,7
34748,Вегельдэрс,gordunni,480,priest,discipline,12,5,7
34749,Meheal,lothar,480,priest,discipline,12,5,7
34750,Easyzx,tarren-mill,480,priest,discipline,12,5,7
34751,Hyonra,kazzak,480,priest,discipline,12,5,7
34752,Gooflord,ravencrest,480,priest,discipline,12,5,7
34753,Muradawg,nemesis,480,priest,discipline,12,5,7
34754,Terstyana,hyjal,480,priest,discipline,12,5,7
34755,Graveyards,tarren-mill,480,priest,discipline,12,5,7
34756,Litera,silvermoon,480,priest,discipline,12,5,7
34757,Bimbax,dun-modr,480,priest,discipline,12,5,7
34758,Schockerjr,blackmoore,480,priest,discipline,12,5,7
34759,Åmåndå,ravencrest,480,priest,discipline,12,5,7
34760,Soed,defias-brotherhood,480,priest,discipline,12,5,7
34761,Teladorne,ravencrest,480,priest,discipline,12,5,7
34762,Akhaida,argent-dawn,480,priest,discipline,12,5,7
34763,Sbj,bronze-dragonflight,480,priest,discipline,12,5,7
34764,Fardatxo,colinas-pardas,480,priest,discipline,12,5,7
34765,Missbarbados,blackmoore,480,priest,discipline,12,5,7
34766,Moeshy,kazzak,480,priest,discipline,12,5,7
34767,Upo,kazzak,480,priest,discipline,12,5,7
34768,Bibleenjoyer,blackmoore,480,priest,discipline,12,5,7
34769,Chebaben,argent-dawn,480,priest,discipline,12,5,7
34770,Allaría,bronze-dragonflight,480,priest,discipline,12,5,7
34771,Twitty,argent-dawn,480,priest,discipline,12,5,7
34772,Ameja,sylvanas,480,priest,discipline,13,5,8
34773,Kimlie,baelgun,480,priest,discipline,16,6,10
34774,Карбонит,fordragon,480,priest,discipline,18,5,13
34775,Étesech,zuljin,480,priest,discipline,18,5,13
34776,Kehz,ysondre,480,priest,discipline,18,5,13
34777,Góli,argent-dawn,480,priest,discipline,18,5,13
34778,Kalór,kult-der-verdammten,480,priest,discipline,18,5,13
34779,Momopriesto,draenor,480,priest,discipline,18,5,13
34780,Zeslash,suramar,480,priest,discipline,18,5,13
34781,Calonex,kazzak,480,priest,discipline,18,5,13
34782,Ча,thermaplugg,480,priest,discipline,18,5,13
34783,Taimani,burning-legion,480,priest,discipline,18,5,13
34784,Iskáral,frostmourne,480,priest,discipline,18,5,13
34785,Saishi,rashgarroth,480,priest,discipline,18,5,13
34786,Omnimento,blackrock,480,priest,discipline,18,5,13
34787,Hodscha,aegwynn,480,priest,discipline,18,5,13
34788,Notapriestx,ravencrest,480,priest,discipline,18,5,13
34789,Seniya,argent-dawn,480,priest,discipline,18,5,13
34790,Элдерле,gordunni,480,priest,discipline,24,5,19
34791,Sarinà,archimonde,480,priest,discipline,24,5,19
34792,Blackwidow,chromaggus,480,priest,discipline,24,5,19
34793,Fictus,tarren-mill,480,priest,discipline,24,5,19
34794,Elpitiimigré,sinstralis,479,priest,discipline,6,5,1
34795,Colte,dalaran,479,priest,discipline,6,5,1
34796,Elakith,bronze-dragonflight,479,priest,discipline,12,5,7
34797,Sarafîsthole,ysondre,479,priest,discipline,12,5,7
34798,Schatty,blackmoore,479,priest,discipline,12,5,7
34799,Flappí,argent-dawn,479,priest,discipline,12,5,7
34800,Haiga,zuljin,479,priest,discipline,12,5,7
34801,Дигмана,soulflayer,479,priest,discipline,12,5,7
34802,Ръасмурт,soulflayer,479,priest,discipline,12,5,7
34803,Cobrix,nemesis,479,priest,discipline,12,5,7
34804,Ethylene,ysondre,479,priest,discipline,12,5,7
34805,Zonar,eitrigg,479,priest,discipline,12,5,7
34806,Jessicar,the-maelstrom,479,priest,discipline,12,5,7
34807,Eluñeblessed,silvermoon,479,priest,discipline,12,5,7
34808,Piotrek,hyjal,479,priest,discipline,12,5,7
34809,Serach,ravencrest,479,priest,discipline,12,5,7
34810,Pontiff,the-maelstrom,479,priest,discipline,12,5,7
34811,Helming,magtheridon,479,priest,discipline,12,5,7
34812,Sastry,drakthul,479,priest,discipline,12,5,7
34813,Kaladriel,die-aldor,479,priest,discipline,12,5,7
34814,Sanoe,twisting-nether,479,priest,discipline,12,5,7
34815,Хилюня,howling-fjord,479,priest,discipline,12,5,7
34816,Haigoku,archimonde,479,priest,discipline,12,5,7
34817,Tetukiss,zuljin,479,priest,discipline,12,5,7
34818,Bòóny,ravencrest,479,priest,discipline,12,5,7
34819,Lightbulp,draenor,479,priest,discipline,12,5,7
34820,Грамыч,howling-fjord,479,priest,discipline,12,5,7
34821,Aethiel,drakthul,479,priest,discipline,12,5,7
34822,Tota,frostmane,479,priest,discipline,12,5,7
34823,Miséricordïe,dalaran,479,priest,discipline,12,5,7
34824,Шпалкоклоб,soulflayer,479,priest,discipline,12,5,7
34825,Shyvannas,antonidas,479,priest,discipline,12,5,7
34826,Velenthan,stormrage,479,priest,discipline,12,5,7
34827,Pohyoloo,turalyon,479,priest,discipline,12,5,7
34828,Upsbro,outland,479,priest,discipline,12,5,7
34829,Tedcrilly,dentarg,479,priest,discipline,12,5,7
34830,Konantenshi,doomhammer,479,priest,discipline,12,5,7
34831,Elunerei,tarren-mill,479,priest,discipline,12,5,7
34832,Thecraft,antonidas,479,priest,discipline,12,5,7
34833,Pluf,nefarian,479,priest,discipline,12,5,7
34834,Sewerperson,doomhammer,479,priest,discipline,12,5,7
34835,Warkez,terokkar,479,priest,discipline,14,5,9
34836,Nemista,hyjal,479,priest,discipline,18,5,13
34837,Gaehla,silvermoon,479,priest,discipline,18,5,13
34838,Seehz,ysondre,479,priest,discipline,18,5,13
34839,Scarlovni,archimonde,479,priest,discipline,18,5,13
34840,Alsyidan,khaz-modan,479,priest,discipline,18,5,13
34841,Sleeyz,blackmoore,479,priest,discipline,24,5,19
34842,Avesatana,khadgar,478,priest,discipline,6,5,1
34843,Veryssra,archimonde,478,priest,discipline,12,5,7
34844,Raitharin,argent-dawn,478,priest,discipline,12,5,7
34845,Небеснаяроса,grom,478,priest,discipline,12,5,7
34846,Tarik,nemesis,478,priest,discipline,12,5,7
34847,Hotwheal,ysondre,478,priest,discipline,12,5,7
34848,Morcana,gorgonnash,478,priest,discipline,12,5,7
34849,Sadystica,kazzak,478,priest,discipline,12,5,7
34850,Rastuvius,twisting-nether,478,priest,discipline,18,5,13
34851,Bénjamín,outland,478,priest,discipline,18,5,13
34852,Arathiell,nordrassil,477,priest,discipline,12,5,7
34853,Oknelim,blackmoore,477,priest,discipline,12,5,7
34854,Phosphorus,blackhand,476,priest,discipline,12,5,7
34855,Marlite,stormscale,476,priest,discipline,12,5,7
34856,Feloriya,antonidas,476,priest,discipline,12,5,7
34857,Rettsche,eredar,475,priest,discipline,12,5,7
34858,Wipipi,draenor,474,priest,discipline,12,5,7
34859,Crenî,blackrock,463,priest,discipline,17,5,12
34860,Madclownz,blackrock,448,priest,discipline,10,5,5
34861,Woukitos,drekthar,448,priest,discipline,16,5,11
34862,Hitaro,antonidas,447,priest,discipline,11,5,6
34863,Zakkypriest,tarren-mill,447,priest,discipline,11,5,6
34864,Dhed,turalyon,447,priest,discipline,14,6,8
34865,Zumítø,zuljin,446,priest,discipline,11,5,6
34866,Sandgambler,draenor,432,priest,discipline,9,5,4
34867,Incorporeal,eredar,431,priest,discipline,11,5,6
34868,Numatrash,stormscale,426,priest,discipline,16,8,8
34869,Äliénør,khaz-modan,426,priest,discipline,17,7,10
34870,Hoca,ravencrest,426,priest,discipline,17,7,10
34871,Theboulshìts,ravencrest,426,priest,discipline,15,6,9
34872,Kasáya,thrall,426,priest,discipline,18,6,12
34873,Kak,gorgonnash,426,priest,discipline,19,6,13
34874,Holybøi,ragnaros,426,priest,discipline,29,7,22
34875,Capheny,ravencrest,425,priest,discipline,29,7,22
34876,Snowlhad,argent-dawn,423,priest,discipline,21,6,15
34877,Prisht,ravencrest,416,priest,discipline,10,5,5
34878,Randomxdisc,draenor,415,priest,discipline,14,5,9
34879,Kuïß,tarren-mill,394,priest,discipline,20,6,14
34880,Amélianna,dalaran,384,priest,discipline,6,4,2
34881,Leonardz,nemesis,384,priest,discipline,6,4,2
34882,Kookpri,twisting-nether,384,priest,discipline,6,4,2
34883,Darkoulito,dalaran,384,priest,discipline,6,4,2
34884,Zumbae,tarren-mill,384,priest,discipline,6,4,2
34885,Umbralx,ragnaros,384,priest,discipline,6,4,2
34886,Jaisuu,ravencrest,384,priest,discipline,6,4,2
34887,Toasttwo,kazzak,384,priest,discipline,6,4,2
34888,Pankp,kazzak,384,priest,discipline,6,4,2
34889,Heindl,ravencrest,384,priest,discipline,6,4,2
34890,Flaiya,kazzak,384,priest,discipline,6,4,2
34891,Sîlfa,hyjal,384,priest,discipline,6,4,2
34892,Papêrcut,kazzak,384,priest,discipline,6,4,2
34893,Patoon,ravencrest,384,priest,discipline,6,4,2
34894,Verrou,hyjal,384,priest,discipline,6,4,2
34895,Bòóni,ravencrest,384,priest,discipline,6,4,2
34896,Above,hyjal,384,priest,discipline,6,4,2
34897,Thean,twilights-hammer,384,priest,discipline,6,4,2
34898,Vixös,silvermoon,384,priest,discipline,6,4,2
34899,Rýzera,tarren-mill,384,priest,discipline,6,4,2
34900,Kitågåwå,ravencrest,384,priest,discipline,6,4,2
34901,Atomíc,eredar,384,priest,discipline,6,4,2
34902,Frekko,outland,384,priest,discipline,6,4,2
34903,Binno,outland,384,priest,discipline,6,4,2
34904,Lergdaddy,zenedar,384,priest,discipline,6,4,2
34905,Zenholy,kazzak,384,priest,discipline,6,4,2
34906,Орбит,blackscar,384,priest,discipline,6,4,2
34907,Iirina,draenor,384,priest,discipline,6,4,2
34908,Topdamage,stormscale,384,priest,discipline,6,4,2
34909,Xsp,dun-modr,384,priest,discipline,6,4,2
34910,Badballs,doomhammer,384,priest,discipline,6,4,2
34911,Elankä,terokkar,384,priest,discipline,6,4,2
34912,Giffelgrethe,sylvanas,384,priest,discipline,6,4,2
34913,Priestutute,tarren-mill,384,priest,discipline,6,4,2
34914,Feedtherich,stormscale,384,priest,discipline,6,4,2
34915,Inthemoöd,twisting-nether,384,priest,discipline,6,4,2
34916,Mit,tarren-mill,384,priest,discipline,6,4,2
34917,Experimentix,silvermoon,384,priest,discipline,6,4,2
34918,Félrebarmok,ragnaros,384,priest,discipline,6,4,2
34919,Hiela,outland,384,priest,discipline,6,4,2
34920,Ðapperðan,draenor,384,priest,discipline,6,4,2
34921,Neddeadlius,outland,384,priest,discipline,6,4,2
34922,Mvce,outland,384,priest,discipline,6,4,2
34923,Bootypillow,stormscale,384,priest,discipline,6,4,2
34924,Piixld,aegwynn,384,priest,discipline,6,4,2
34925,Pisso,outland,384,priest,discipline,6,4,2
34926,Goblingøs,ravencrest,384,priest,discipline,6,4,2
34927,Erfofthesop,chants-éternels,384,priest,discipline,6,4,2
34928,Sede,silvermoon,384,priest,discipline,6,4,2
34929,Yukirito,drakthul,384,priest,discipline,6,4,2
34930,Seeyae,ravencrest,384,priest,discipline,6,4,2
34931,Cerdapriesst,dun-modr,384,priest,discipline,6,4,2
34932,Nesar,stormscale,384,priest,discipline,6,4,2
34933,Acarru,stormscale,384,priest,discipline,6,4,2
34934,Flaynbones,tarren-mill,384,priest,discipline,6,4,2
34935,Büssi,blackrock,384,priest,discipline,6,4,2
34936,Hadk,blackrock,384,priest,discipline,6,4,2
34937,Larialool,malorne,384,priest,discipline,6,4,2
34938,Sïgmund,draenor,384,priest,discipline,6,4,2
34939,Xqzmydotz,outland,384,priest,discipline,6,4,2
34940,Gravedoll,draenor,384,priest,discipline,6,4,2
34941,ßlinkywinky,outland,384,priest,discipline,6,4,2
34942,Deadlyhealer,draenor,384,priest,discipline,6,4,2
34943,Sàyaa,draenor,384,priest,discipline,6,4,2
34944,Dimentions,sylvanas,384,priest,discipline,6,4,2
34945,Tipps,ravencrest,384,priest,discipline,6,4,2
34946,Challa,magtheridon,384,priest,discipline,6,4,2
34947,Hunnty,magtheridon,384,priest,discipline,6,4,2
34948,Sixtyseven,blackhand,384,priest,discipline,6,4,2
34949,Healywealy,stormrage,384,priest,discipline,6,4,2
34950,Taypsi,kelthuzad,384,priest,discipline,6,4,2
34951,Magicstarss,the-maelstrom,384,priest,discipline,6,4,2
34952,Dshara,the-maelstrom,384,priest,discipline,6,4,2
34953,Tntbigheal,silvermoon,384,priest,discipline,6,4,2
34954,Terakes,kiljaeden,384,priest,discipline,6,4,2
34955,Bosco,kult-der-verdammten,384,priest,discipline,6,4,2
34956,Arduhil,burning-legion,384,priest,discipline,6,4,2
34957,Halps,silvermoon,384,priest,discipline,6,4,2
34958,Fxd,talnivarr,384,priest,discipline,6,4,2
34959,Brobert,nerathor,384,priest,discipline,6,4,2
34960,Floofz,auchindoun,384,priest,discipline,6,4,2
34961,Noxx,kilrogg,384,priest,discipline,6,4,2
34962,Shadowuknow,silvermoon,384,priest,discipline,9,4,5
34963,Kloxy,archimonde,384,priest,discipline,15,5,10
34964,Drdré,blackrock,384,priest,discipline,12,4,8
34965,Uwupriestowo,kazzak,384,priest,discipline,12,4,8
34966,Mérce,kazzak,384,priest,discipline,12,4,8
34967,Corthas,sporeggar,384,priest,discipline,12,4,8
34968,Babambaba,sylvanas,384,priest,discipline,12,4,8
34969,Osteograhm,eldrethalas,384,priest,discipline,12,4,8
34970,Mylox,blackrock,384,priest,discipline,12,4,8
34971,Pwnance,twisting-nether,384,priest,discipline,12,4,8
34972,Druzhok,sylvanas,384,priest,discipline,12,4,8
34973,Asdfsds,kazzak,384,priest,discipline,12,4,8
34974,Mariio,blackmoore,384,priest,discipline,12,4,8
34975,Refuze,blackrock,384,priest,discipline,12,4,8
34976,Zackher,dun-modr,384,priest,discipline,12,4,8
34977,Harrymotter,blackrock,384,priest,discipline,12,4,8
34978,Drzork,sylvanas,384,priest,discipline,12,4,8
34979,Sls,sylvanas,384,priest,discipline,12,4,8
34980,Raybangx,blackrock,384,priest,discipline,12,4,8
34981,Goatrocker,kazzak,384,priest,discipline,12,4,8
34982,Hyggêê,sanguino,384,priest,discipline,12,4,8
34983,Stajp,blackrock,384,priest,discipline,12,4,8
34984,Сайлентхилл,howling-fjord,384,priest,discipline,12,4,8
34985,Dominos,thrall,384,priest,discipline,12,4,8
34986,Trolar,zuljin,384,priest,discipline,12,4,8
34987,Sedaris,blackrock,384,priest,discipline,12,4,8
34988,Streptococus,sanguino,384,priest,discipline,12,4,8
34989,Ревентонх,howling-fjord,384,priest,discipline,12,4,8
34990,Заак,howling-fjord,384,priest,discipline,12,4,8
34991,Vanisse,uldum,384,priest,discipline,12,4,8
34992,Blumm,khaz-modan,384,priest,discipline,12,4,8
34993,Renewa,kazzak,384,priest,discipline,12,4,8
34994,Rîîper,khaz-modan,384,priest,discipline,12,4,8
34995,Freepriest,darksorrow,384,priest,discipline,12,4,8
34996,Braingames,kazzak,384,priest,discipline,12,4,8
34997,Пристошке,gordunni,384,priest,discipline,12,4,8
34998,Magras,xavius,384,priest,discipline,12,4,8
34999,Kerzhul,blackhand,384,priest,discipline,12,4,8
35000,Gstah,taerar,384,priest,discipline,12,4,8
35001,Støney,xavius,384,priest,discipline,12,4,8
35002,Santainphy,cthun,384,priest,discipline,12,4,8
35003,Absolution,stormscale,384,priest,discipline,12,4,8
35004,Oneheal,rexxar,384,priest,discipline,12,4,8
35005,Велост,gordunni,384,priest,discipline,12,4,8
35006,Фадб,howling-fjord,384,priest,discipline,12,4,8
35007,Facemelterx,azjolnerub,384,priest,discipline,12,4,8
35008,Dangerfred,stormscale,384,priest,discipline,12,4,8
35009,Soleyy,outland,384,priest,discipline,12,4,8
35010,Whatspray,drakthul,384,priest,discipline,12,4,8
35011,Shadowful,drakthul,384,priest,discipline,12,4,8
35012,Благовер,howling-fjord,384,priest,discipline,12,4,8
35013,Holyorshadow,drakthul,384,priest,discipline,12,4,8
35014,Vicetøne,stormscale,384,priest,discipline,12,4,8
35015,Çelph,silvermoon,384,priest,discipline,12,4,8
35016,Eba,daggerspine,384,priest,discipline,12,4,8
35017,Jordbærtærte,outland,384,priest,discipline,12,4,8
35018,Stòkkè,stormscale,384,priest,discipline,12,4,8
35019,Seskip,stormreaver,384,priest,discipline,12,4,8
35020,Арейша,gordunni,384,priest,discipline,12,4,8
35021,Toasttrii,outland,384,priest,discipline,12,4,8
35022,Xýz,tarren-mill,384,priest,discipline,12,4,8
35023,Saemyra,tarren-mill,384,priest,discipline,12,4,8
35024,Numa,stormscale,384,priest,discipline,12,4,8
35025,Amèn,archimonde,384,priest,discipline,12,4,8
35026,Mukkin,tarren-mill,384,priest,discipline,12,4,8
35027,Linaklein,hyjal,384,priest,discipline,12,4,8
35028,Nordrenalin,tarren-mill,384,priest,discipline,12,4,8
35029,Misttpriest,hyjal,384,priest,discipline,12,4,8
35030,Kourguette,hyjal,384,priest,discipline,12,4,8
35031,Алурелис,blackscar,384,priest,discipline,12,4,8
35032,Dìscìplìned,ravencrest,384,priest,discipline,12,4,8
35033,Xayona,argent-dawn,384,priest,discipline,12,4,8
35034,Хенели,blackscar,384,priest,discipline,12,4,8
35035,Nariny,argent-dawn,384,priest,discipline,12,4,8
35036,Flet,emerald-dream,384,priest,discipline,12,4,8
35037,Hanrej,ravencrest,384,priest,discipline,12,4,8
35038,Robgee,ravencrest,384,priest,discipline,12,4,8
35039,Ankî,aegwynn,384,priest,discipline,12,4,8
35040,Нахилета,soulflayer,384,priest,discipline,12,4,8
35041,Derl,pozzo-delleternità,384,priest,discipline,12,4,8
35042,Sarenko,turalyon,384,priest,discipline,12,4,8
35043,Дэкспрут,soulflayer,384,priest,discipline,12,4,8
35044,Azriael,draenor,384,priest,discipline,12,4,8
35045,Rafaled,ravencrest,384,priest,discipline,12,4,8
35046,Maquivel,aggra-português,384,priest,discipline,12,4,8
35047,Teresalisbon,eredar,384,priest,discipline,12,4,8
35048,Иннрей,soulflayer,384,priest,discipline,12,4,8
35049,Sumecxo,aegwynn,384,priest,discipline,12,4,8
35050,Lalock,grim-batol,384,priest,discipline,12,4,8
35051,Deathtrapx,draenor,384,priest,discipline,12,4,8
35052,Alyzée,aegwynn,384,priest,discipline,12,4,8
35053,Sabakk,archimonde,384,priest,discipline,12,4,8
35054,Bownsamdi,tarren-mill,384,priest,discipline,15,4,11
35055,Celestias,sanguino,384,priest,discipline,15,4,11
35056,Shyvàree,les-clairvoyants,384,priest,discipline,18,4,14
35057,Sbubbi,ravencrest,384,priest,discipline,18,4,14
35058,Ajcz,draenor,384,priest,discipline,18,4,14
35059,Pbwser,silvermoon,384,priest,discipline,18,4,14
35060,Ulquiørra,blackmoore,384,priest,discipline,18,4,14
35061,Лилинтель,gordunni,384,priest,discipline,24,4,20
35062,Tsuser,blackrock,384,priest,discipline,24,4,20
35063,Hanic,kazzak,2326,priest,shadow,92,57,35
35064,Permafeetup,aegwynn,2324,priest,shadow,102,59,43
35065,Syedi,drakthul,2304,priest,shadow,315,160,155
35066,Shåmssv,kazzak,2299,priest,shadow,90,52,38
35067,Медовыедотки,soulflayer,2297,priest,shadow,143,78,65
35068,Хедмэнмвп,gordunni,2287,priest,shadow,228,117,111
35069,Darthlie,draenor,2275,priest,shadow,166,88,78
35070,Yggdra,ragnaros,2229,priest,shadow,66,44,22
35071,Standtall,blackrock,2226,priest,shadow,138,76,62
35072,Dbeezy,tarren-mill,2217,priest,shadow,100,53,47
35073,Польскийбуль,gordunni,2215,priest,shadow,96,53,43
35074,Cheesecake,defias-brotherhood,2202,priest,shadow,102,58,44
35075,Notsoholy,blackmoore,2186,priest,shadow,120,67,53
35076,Deathlý,blackrock,2169,priest,shadow,114,62,52
35077,Tentoumushi,ravencrest,2153,priest,shadow,72,42,30
35078,Dollyboo,tarren-mill,2152,priest,shadow,125,77,48
35079,Ilovemycat,silvermoon,2152,priest,shadow,78,47,31
35080,Yuzuflex,hyjal,2151,priest,shadow,87,46,41
35081,Rrj,ravencrest,2147,priest,shadow,106,64,42
35082,Безрассудица,howling-fjord,2147,priest,shadow,91,49,42
35083,Walterwhite,stormscale,2145,priest,shadow,96,51,45
35084,Devoura,sylvanas,2138,priest,shadow,78,46,32
35085,Randyrhoads,kazzak,2138,priest,shadow,71,41,30
35086,Slimcharles,ravencrest,2137,priest,shadow,185,107,78
35087,Crainoo,ravencrest,2137,priest,shadow,158,80,78
35088,Blacktrain,burning-blade,2136,priest,shadow,118,60,58
35089,Сделайсам,gordunni,2133,priest,shadow,105,59,46
35090,Talbatex,blackmoore,2130,priest,shadow,102,51,51
35091,Mérce,kazzak,2123,priest,shadow,78,43,35
35092,Stjärtsten,tarren-mill,2118,priest,shadow,231,132,99
35093,Xsß,dun-modr,2116,priest,shadow,107,59,48
35094,Èxtêrmìnätör,kazzak,2114,priest,shadow,84,47,37
35095,Bréézee,ravencrest,2114,priest,shadow,107,58,49
35096,Шадоупуз,soulflayer,2114,priest,shadow,95,50,45
35097,Voidfi,kult-der-verdammten,2111,priest,shadow,114,64,50
35098,Infernión,tarren-mill,2110,priest,shadow,78,42,36
35099,Rzkp,eredar,2110,priest,shadow,93,50,43
35100,Даняпимпгадх,soulflayer,2109,priest,shadow,72,45,27
35101,Pepeshadow,twisting-nether,2106,priest,shadow,169,89,80
35102,Thanatae,kazzak,2105,priest,shadow,85,50,35
35103,Dippy,blackrock,2101,priest,shadow,64,39,25
35104,Sphero,earthen-ring,2101,priest,shadow,130,73,57
35105,Ekkfwiedrice,ragnaros,2084,priest,shadow,96,54,42
35106,Bidraget,ravencrest,2083,priest,shadow,94,57,37
35107,Nousey,twisting-nether,2077,priest,shadow,148,81,67
35108,Purpl,tarren-mill,2076,priest,shadow,138,75,63
35109,Liptonolda,blackhand,2067,priest,shadow,202,107,95
35110,Swdjkbad,kazzak,2063,priest,shadow,72,42,30
35111,Sinthaa,mannoroth,2053,priest,shadow,72,36,36
35112,Infuséd,aegwynn,2047,priest,shadow,66,36,30
35113,Ottii,thrall,2046,priest,shadow,95,56,39
35114,Rzktwo,eredar,2039,priest,shadow,65,37,28
35115,Pu,outland,2039,priest,shadow,90,43,47
35116,Синфал,blackscar,2034,priest,shadow,298,149,149
35117,Genjutzux,kazzak,2026,priest,shadow,72,40,32
35118,Даняпампгодх,soulflayer,2026,priest,shadow,223,108,115
35119,Zodzín,ragnaros,2023,priest,shadow,60,30,30
35120,Minblock,sanguino,2021,priest,shadow,150,78,72
35121,Donenigma,stormscale,2019,priest,shadow,132,82,50
35122,Bluxon,kazzak,2016,priest,shadow,172,100,72
35123,Хьёх,blackscar,2015,priest,shadow,66,41,25
35124,Zoodiacp,blackrock,2012,priest,shadow,124,61,63
35125,Amtoxic,stormscale,2011,priest,shadow,77,42,35
35126,Raikup,ravencrest,2011,priest,shadow,65,30,35
35127,Миладиель,gordunni,2008,priest,shadow,137,69,68
35128,Destinyhero,aegwynn,2007,priest,shadow,87,44,43
35129,Zhadum,stormscale,2000,priest,shadow,136,72,64
35130,Waltergoblin,sylvanas,1990,priest,shadow,36,27,9
35131,Бвонсаамди,soulflayer,1988,priest,shadow,149,81,68
35132,Nabøøbies,blackmoore,1986,priest,shadow,68,39,29
35133,Sethÿr,sanguino,1983,priest,shadow,150,78,72
35134,Qoryn,ravencrest,1981,priest,shadow,96,54,42
35135,Bönfire,silvermoon,1981,priest,shadow,316,157,159
35136,Huffle,argent-dawn,1964,priest,shadow,39,28,11
35137,Akibom,drakthul,1963,priest,shadow,89,52,37
35138,Lâughing,ravencrest,1962,priest,shadow,129,69,60
35139,Rnkz,sanguino,1961,priest,shadow,66,41,25
35140,Melábufeis,dun-modr,1960,priest,shadow,66,39,27
35141,Mímou,kazzak,1955,priest,shadow,101,59,42
35142,Moretti,ravencrest,1953,priest,shadow,54,32,22
35143,Rýzera,aegwynn,1950,priest,shadow,36,25,11
35144,Evazhang,outland,1950,priest,shadow,54,31,23
35145,Justtpro,twisting-nether,1950,priest,shadow,205,117,88
35146,Енотхд,soulflayer,1946,priest,shadow,84,45,39
35147,Perché,silvermoon,1945,priest,shadow,66,48,18
35148,Weekfortyone,blackhand,1945,priest,shadow,86,42,44
35149,Demølishes,ravencrest,1942,priest,shadow,60,36,24
35150,Smxkÿÿ,eredar,1939,priest,shadow,53,36,17
35151,Physxd,blackrock,1938,priest,shadow,54,38,16
35152,Dhurza,shendralar,1938,priest,shadow,66,39,27
35153,Duzurîx,burning-blade,1938,priest,shadow,54,29,25
35154,Rãpidi,hyjal,1932,priest,shadow,89,56,33
35155,Buøbuarns,sanguino,1930,priest,shadow,63,31,32
35156,Айсиоу,howling-fjord,1929,priest,shadow,42,26,16
35157,Léandrä,magtheridon,1927,priest,shadow,90,45,45
35158,Бхонсамди,blackscar,1926,priest,shadow,101,60,41
35159,Elnyashka,ravencrest,1922,priest,shadow,121,72,49
35160,Yoe,twisting-nether,1921,priest,shadow,60,31,29
35161,Prøphetx,thrall,1916,priest,shadow,195,99,96
35162,Estragon,quelthalas,1912,priest,shadow,75,40,35
35163,Räke,blackrock,1912,priest,shadow,78,39,39
35164,Manofonéway,outland,1909,priest,shadow,66,35,31
35165,Shadowvoice,outland,1905,priest,shadow,48,30,18
35166,Djalex,ravencrest,1905,priest,shadow,89,48,41
35167,Термидор,booty-bay,1903,priest,shadow,107,66,41
35168,Cathrix,kazzak,1900,priest,shadow,72,45,27
35169,Heal,hyjal,1900,priest,shadow,248,137,111
35170,Некрозмх,soulflayer,1899,priest,shadow,30,20,10
35171,Hansmaul,thrall,1897,priest,shadow,36,20,16
35172,Nanna,agamaggan,1896,priest,shadow,154,80,74
35173,Voldemort,blackrock,1894,priest,shadow,36,23,13
35174,Cornflays,outland,1894,priest,shadow,49,29,20
35175,Newkidx,draenor,1892,priest,shadow,48,27,21
35176,Døubtful,kazzak,1890,priest,shadow,36,20,16
35177,Эсдаль,howling-fjord,1889,priest,shadow,60,41,19
35178,Shádówý,kazzak,1889,priest,shadow,36,20,16
35179,Tankeløs,kazzak,1884,priest,shadow,48,29,19
35180,Ûñträînablê,outland,1882,priest,shadow,60,42,18
35181,Yaboyboompie,blackrock,1874,priest,shadow,75,34,41
35182,Lløthx,ravencrest,1870,priest,shadow,66,37,29
35183,Ølle,ravencrest,1869,priest,shadow,84,51,33
35184,Shuturmouth,ravencrest,1869,priest,shadow,96,57,39
35185,Drarianna,nemesis,1868,priest,shadow,30,22,8
35186,Vilayetko,ravencrest,1868,priest,shadow,48,25,23
35187,Knútx,stormscale,1867,priest,shadow,60,30,30
35188,Râvyn,silvermoon,1866,priest,shadow,44,35,9
35189,Heffer,outland,1866,priest,shadow,123,73,50
35190,Pandacore,frostmane,1864,priest,shadow,54,28,26
35191,Simôc,eredar,1864,priest,shadow,66,34,32
35192,Billybay,argent-dawn,1863,priest,shadow,32,28,4
35193,Voideffsucks,stormscale,1863,priest,shadow,30,21,9
35194,Sepharis,runetotem,1863,priest,shadow,209,124,85
35195,Actionjezuz,shattered-hand,1861,priest,shadow,54,33,21
35196,Hoesfavorite,onyxia,1861,priest,shadow,128,78,50
35197,Zuhä,twisting-nether,1861,priest,shadow,60,34,26
35198,Moonword,archimonde,1859,priest,shadow,36,21,15
35199,Xayona,argent-dawn,1858,priest,shadow,54,26,28
35200,Криптика,soulflayer,1856,priest,shadow,48,30,18
35201,Milkysmite,twisting-nether,1856,priest,shadow,52,32,20
35202,Iodjsaiojoij,kazzak,1856,priest,shadow,54,30,24
35203,Rockness,blackmoore,1854,priest,shadow,137,91,46
35204,Ptxd,alakir,1853,priest,shadow,64,38,26
35205,Liloz,eredar,1852,priest,shadow,59,34,25
35206,Angsty,blackrock,1851,priest,shadow,97,48,49
35207,Ageyr,ragnaros,1848,priest,shadow,89,57,32
35208,Dingopriest,blackrock,1848,priest,shadow,78,46,32
35209,Either,kazzak,1848,priest,shadow,65,36,29
35210,Mafiasnipers,ravencrest,1847,priest,shadow,36,21,15
35211,Blindöts,tarren-mill,1847,priest,shadow,47,27,20
35212,Rýzera,tarren-mill,1847,priest,shadow,35,20,15
35213,Animesenpai,kazzak,1847,priest,shadow,60,32,28
35214,Versio,dalvengyr,1847,priest,shadow,54,28,26
35215,Pipf,blackmoore,1844,priest,shadow,65,41,24
35216,Dreamhatcher,deathwing,1844,priest,shadow,90,51,39
35217,Akolyte,blackmoore,1843,priest,shadow,36,22,14
35218,Trisks,ravencrest,1843,priest,shadow,34,20,14
35219,Voidgodx,blackrock,1842,priest,shadow,41,24,17
35220,Lebronjay,ravencrest,1842,priest,shadow,94,53,41
35221,Пристатеист,howling-fjord,1842,priest,shadow,72,35,37
35222,Gymbró,kazzak,1841,priest,shadow,60,33,27
35223,Velence,ravencrest,1839,priest,shadow,89,51,38
35224,Arendt,blackhand,1837,priest,shadow,48,29,19
35225,Птумерианец,gordunni,1837,priest,shadow,76,41,35
35226,Yêl,thrall,1836,priest,shadow,253,140,113
35227,Johnnybanana,argent-dawn,1835,priest,shadow,36,26,10
35228,Sadix,ravencrest,1835,priest,shadow,66,38,28
35229,Mýxir,burning-legion,1834,priest,shadow,89,45,44
35230,Ымц,gordunni,1834,priest,shadow,78,39,39
35231,Ezlife,blackrock,1832,priest,shadow,78,42,36
35232,Холихэйт,howling-fjord,1831,priest,shadow,51,30,21
35233,Shadowmate,silvermoon,1829,priest,shadow,56,31,25
35234,Tupal,ysondre,1829,priest,shadow,78,43,35
35235,Schmetter,tarren-mill,1829,priest,shadow,65,29,36
35236,Dianaxd,dun-modr,1827,priest,shadow,41,25,16
35237,Selëne,blackrock,1827,priest,shadow,72,43,29
35238,Megamann,dun-morogh,1827,priest,shadow,54,32,22
35239,Sÿrax,ysondre,1827,priest,shadow,61,34,27
35240,Игорянатакуе,eversong,1826,priest,shadow,154,86,68
35241,Rakamain,ravencrest,1825,priest,shadow,48,31,17
35242,Zindrix,silvermoon,1825,priest,shadow,84,50,34
35243,Anateoris,turalyon,1825,priest,shadow,76,43,33
35244,Ансор,lich-king,1825,priest,shadow,95,52,43
35245,Quezaris,stormscale,1825,priest,shadow,48,23,25
35246,Cantsqell,silvermoon,1823,priest,shadow,48,34,14
35247,Cnsnn,ysondre,1823,priest,shadow,114,76,38
35248,Morseeii,baelgun,1823,priest,shadow,56,31,25
35249,Djops,outland,1823,priest,shadow,84,45,39
35250,Трейдарк,blackscar,1823,priest,shadow,60,31,29
35251,Тарренмилл,gordunni,1822,priest,shadow,92,53,39
35252,Ondskabsfuld,kazzak,1822,priest,shadow,60,26,34
35253,Староезло,gordunni,1821,priest,shadow,68,33,35
35254,Vaccineboost,silvermoon,1821,priest,shadow,102,45,57
35255,Yirico,argent-dawn,1820,priest,shadow,47,31,16
35256,Blóódfart,kazzak,1819,priest,shadow,89,43,46
35257,Marbellexd,pozzo-delleternità,1818,priest,shadow,157,91,66
35258,Voidshuffle,laughing-skull,1818,priest,shadow,42,24,18
35259,Jeppehpräst,stormscale,1817,priest,shadow,66,40,26
35260,Диспайзх,gordunni,1817,priest,shadow,66,38,28
35261,Omedo,stormscale,1816,priest,shadow,36,19,17
35262,Magicalme,kult-der-verdammten,1815,priest,shadow,42,26,16
35263,Backpedaling,kazzak,1815,priest,shadow,84,42,42
35264,Theunknown,thrall,1814,priest,shadow,42,30,12
35265,Physx,blackrock,1814,priest,shadow,30,19,11
35266,Øctawtöuch,kazzak,1814,priest,shadow,88,53,35
35267,Depridolens,argent-dawn,1814,priest,shadow,49,28,21
35268,Genjutzu,kazzak,1814,priest,shadow,36,19,17
35269,Cutepangolin,khaz-modan,1813,priest,shadow,42,29,13
35270,Kylähullu,ravencrest,1813,priest,shadow,80,46,34
35271,Stèálth,sylvanas,1812,priest,shadow,24,19,5
35272,Luvlyrah,draenor,1812,priest,shadow,81,52,29
35273,Namsolo,kazzak,1811,priest,shadow,78,42,36
35274,Shiannâ,malganis,1810,priest,shadow,44,24,20
35275,Skillmåsterx,ravencrest,1810,priest,shadow,54,29,25
35276,Drvoidit,blackrock,1809,priest,shadow,48,28,20
35277,Magicstarss,the-maelstrom,1809,priest,shadow,78,42,36
35278,Фростингшп,goldrinn,1808,priest,shadow,42,31,11
35279,Necrofeel,silvermoon,1807,priest,shadow,30,20,10
35280,Meatyshaft,doomhammer,1807,priest,shadow,99,64,35
35281,Salkerer,stormscale,1807,priest,shadow,30,19,11
35282,Stümpý,ravencrest,1807,priest,shadow,52,29,23
35283,Megajuicy,blackmoore,1807,priest,shadow,258,143,115
35284,Lr,aszune,1806,priest,shadow,36,25,11
35285,Синатро,deathguard,1806,priest,shadow,190,119,71
35286,Debbski,tarren-mill,1806,priest,shadow,48,30,18
35287,Snarks,sylvanas,1806,priest,shadow,36,20,16
35288,Claritycraft,twisting-nether,1805,priest,shadow,36,22,14
35289,Galatea,les-sentinelles,1805,priest,shadow,78,44,34
35290,Vajainap,outland,1804,priest,shadow,30,19,11
35291,Aliocha,dalaran,1804,priest,shadow,54,27,27
35292,Петушшара,gordunni,1804,priest,shadow,63,31,32
35293,Solaclypsa,destromath,1803,priest,shadow,36,26,10
35294,Mataî,kazzak,1803,priest,shadow,84,49,35
35295,Jpd,outland,1803,priest,shadow,48,25,23
35296,Stazia,ravencrest,1802,priest,shadow,36,22,14
35297,Alfredosauce,ravencrest,1802,priest,shadow,64,34,30
35298,Margots,kazzak,1802,priest,shadow,42,22,20
35299,Mizulol,ravencrest,1801,priest,shadow,80,42,38
35300,Akroama,archimonde,1801,priest,shadow,92,46,46
35301,Maedhrós,ravencrest,1800,priest,shadow,30,24,6
35302,Sleypriest,draenor,1800,priest,shadow,48,32,16
35303,Theoniss,draenor,1799,priest,shadow,125,70,55
35304,Tacøgxd,ravencrest,1796,priest,shadow,66,40,26
35305,Pizzagigante,kazzak,1796,priest,shadow,48,29,19
35306,Nyotux,blackrock,1794,priest,shadow,72,47,25
35307,Homxcxde,ravencrest,1793,priest,shadow,48,26,22
35308,Shøana,archimonde,1793,priest,shadow,60,26,34
35309,Ревентонх,howling-fjord,1792,priest,shadow,211,119,92
35310,Raisedbyrap,blackrock,1791,priest,shadow,60,33,27
35311,Kujiua,ravencrest,1790,priest,shadow,124,69,55
35312,Ecquidozx,ravencrest,1790,priest,shadow,41,22,19
35313,Tbs,sylvanas,1788,priest,shadow,113,66,47
35314,Uselessxasel,sanguino,1788,priest,shadow,48,28,20
35315,Helín,hellfire,1786,priest,shadow,102,60,42
35316,Shucks,stormscale,1785,priest,shadow,36,19,17
35317,Insanious,skullcrusher,1785,priest,shadow,65,34,31
35318,Erenndriel,twisting-nether,1784,priest,shadow,126,69,57
35319,Тоних,deathguard,1784,priest,shadow,42,21,21
35320,Babarøga,blackrock,1783,priest,shadow,47,28,19
35321,Zabpriest,blackhand,1782,priest,shadow,54,31,23
35322,Fläschheal,aegwynn,1781,priest,shadow,36,24,12
35323,Свдпрох,soulflayer,1781,priest,shadow,51,26,25
35324,Ounxx,blackrock,1779,priest,shadow,65,41,24
35325,Spklooril,hyjal,1778,priest,shadow,360,188,172
35326,Lostcause,alakir,1773,priest,shadow,78,46,32
35327,Andreel,ravencrest,1773,priest,shadow,90,49,41
35328,Maryhugette,archimonde,1770,priest,shadow,156,75,81
35329,Мистериум,howling-fjord,1769,priest,shadow,89,50,39
35330,Tremrfinger,dun-modr,1769,priest,shadow,98,53,45
35331,Adub,tarren-mill,1769,priest,shadow,48,25,23
35332,Schizophrens,outland,1766,priest,shadow,48,28,20
35333,Vibéz,outland,1765,priest,shadow,48,24,24
35334,Garycash,outland,1762,priest,shadow,111,57,54
35335,Шандресса,deepholm,1761,priest,shadow,48,31,17
35336,Fakecastguru,ravencrest,1761,priest,shadow,66,37,29
35337,Cizer,kazzak,1760,priest,shadow,50,26,24
35338,Heilsarmee,blackhand,1760,priest,shadow,119,61,58
35339,Xiä,archimonde,1758,priest,shadow,72,37,35
35340,Skeida,bloodhoof,1758,priest,shadow,77,39,38
35341,Darthmantle,silvermoon,1758,priest,shadow,59,29,30
35342,Sonâkî,archimonde,1757,priest,shadow,36,21,15
35343,Hypnocat,blackrock,1754,priest,shadow,64,36,28
35344,Ninjajane,sylvanas,1753,priest,shadow,53,32,21
35345,Иннрей,soulflayer,1751,priest,shadow,69,29,40
35346,Ансарм,gordunni,1744,priest,shadow,200,109,91
35347,Voodkaa,drakthul,1743,priest,shadow,69,42,27
35348,Spherics,ravencrest,1743,priest,shadow,54,27,27
35349,Staljon,burning-legion,1742,priest,shadow,54,32,22
35350,Anabølix,ravencrest,1741,priest,shadow,48,27,21
35351,Sakuyasp,blackrock,1740,priest,shadow,174,89,85
35352,Facemeltina,kiljaeden,1739,priest,shadow,42,20,22
35353,Wérrýxs,kazzak,1738,priest,shadow,94,60,34
35354,Víppe,stormreaver,1738,priest,shadow,65,40,25
35355,Erdine,ravencrest,1738,priest,shadow,60,33,27
35356,Máv,tarren-mill,1737,priest,shadow,104,63,41
35357,Zeythz,ravencrest,1737,priest,shadow,179,100,79
35358,Geløpr,eredar,1736,priest,shadow,102,58,44
35359,Önnÿ,dun-modr,1736,priest,shadow,54,26,28
35360,Mehtz,ravencrest,1735,priest,shadow,269,135,134
35361,Zultor,ragnaros,1734,priest,shadow,43,24,19
35362,Lindp,stormreaver,1732,priest,shadow,66,42,24
35363,Wixzyx,ravencrest,1732,priest,shadow,48,26,22
35364,Hasa,stormreaver,1730,priest,shadow,66,36,30
35365,Barthólomew,doomhammer,1730,priest,shadow,114,61,53
35366,Zhyn,turalyon,1729,priest,shadow,110,65,45
35367,Edoran,ragnaros,1728,priest,shadow,35,19,16
35368,Absolution,stormscale,1728,priest,shadow,269,146,123
35369,Carmechanic,defias-brotherhood,1728,priest,shadow,94,49,45
35370,Mackings,the-maelstrom,1726,priest,shadow,136,74,62
35371,Казуямисима,gordunni,1723,priest,shadow,170,93,77
35372,Ксерф,soulflayer,1723,priest,shadow,114,58,56
35373,Waina,defias-brotherhood,1723,priest,shadow,138,67,71
35374,Spamplague,stormscale,1721,priest,shadow,72,38,34
35375,Flexzpriest,destromath,1720,priest,shadow,108,58,50
35376,Miruh,malganis,1718,priest,shadow,161,101,60
35377,Кломми,gordunni,1718,priest,shadow,84,45,39
35378,Nukyo,blackmoore,1718,priest,shadow,44,21,23
35379,Ктулсотум,soulflayer,1717,priest,shadow,46,28,18
35380,Becknarbritt,stormscale,1717,priest,shadow,256,142,114
35381,Klosso,anachronos,1717,priest,shadow,244,117,127
35382,Перекованный,soulflayer,1716,priest,shadow,129,69,60
35383,Всезнайка,soulflayer,1715,priest,shadow,114,61,53
35384,Ðrßøtÿcûs,la-croisade-écarlate,1714,priest,shadow,30,18,12
35385,Holyshadów,azjolnerub,1714,priest,shadow,89,52,37
35386,Æßsåløønå,la-croisade-écarlate,1712,priest,shadow,30,18,12
35387,Скайвэйуокер,howling-fjord,1712,priest,shadow,71,42,29
35388,Массаракъш,razuvious,1709,priest,shadow,24,18,6
35389,Whynolove,ragnaros,1708,priest,shadow,89,59,30
35390,Dakotapriest,ravencrest,1706,priest,shadow,30,18,12
35391,Xangha,burning-legion,1705,priest,shadow,114,67,47
35392,Daisyduke,veknilash,1705,priest,shadow,69,37,32
35393,Dümbledore,aggra-português,1704,priest,shadow,24,18,6
35394,Voidlink,kazzak,1704,priest,shadow,36,21,15
35395,Sheto,burning-legion,1704,priest,shadow,204,104,100
35396,Fueguchi,anubarak,1703,priest,shadow,90,49,41
35397,Ankî,aegwynn,1703,priest,shadow,84,44,40
35398,Elishîa,ragnaros,1703,priest,shadow,54,24,30
35399,Milania,ravencrest,1701,priest,shadow,42,33,9
35400,Daspyen,silvermoon,1700,priest,shadow,67,37,30
35401,Фиброз,blackscar,1697,priest,shadow,120,68,52
35402,Miraçlê,kazzak,1696,priest,shadow,36,25,11
35403,Соргоху,gordunni,1695,priest,shadow,54,32,22
35404,Hiddenhealz,blackrock,1691,priest,shadow,53,30,23
35405,Kamish,twisting-nether,1690,priest,shadow,138,74,64
35406,Rumbo,lightnings-blade,1689,priest,shadow,59,34,25
35407,Imaut,emerald-dream,1689,priest,shadow,56,31,25
35408,Snoopý,dun-modr,1689,priest,shadow,90,49,41
35409,Iessei,outland,1688,priest,shadow,84,42,42
35410,Zahadoom,stormscale,1687,priest,shadow,78,46,32
35411,Томрэдл,blackscar,1687,priest,shadow,64,33,31
35412,Phucu,the-maelstrom,1684,priest,shadow,54,32,22
35413,Rubín,sylvanas,1683,priest,shadow,44,28,16
35414,Framesxøxø,ravencrest,1683,priest,shadow,48,29,19
35415,Клаима,soulflayer,1683,priest,shadow,71,41,30
35416,Rasha,kazzak,1683,priest,shadow,74,42,32
35417,Sleeg,tarren-mill,1681,priest,shadow,35,19,16
35418,Файерин,soulflayer,1676,priest,shadow,48,21,27
35419,Cthultist,dun-modr,1675,priest,shadow,108,52,56
35420,Yngp,blackmoore,1673,priest,shadow,66,36,30
35421,Raspberrypíe,silvermoon,1672,priest,shadow,84,49,35
35422,Reapzbolt,blackrock,1672,priest,shadow,60,28,32
35423,Dreadest,blackhand,1671,priest,shadow,42,26,16
35424,Peprama,stormscale,1670,priest,shadow,66,39,27
35425,Papie,kazzak,1670,priest,shadow,42,23,19
35426,Tsunadesaama,silvermoon,1668,priest,shadow,63,32,31
35427,Флэшх,soulflayer,1666,priest,shadow,76,44,32
35428,Mcdced,archimonde,1665,priest,shadow,61,38,23
35429,Levitation,alakir,1665,priest,shadow,72,42,30
35430,Raitwo,kazzak,1663,priest,shadow,101,55,46
35431,Jóhnnybravó,kazzak,1662,priest,shadow,34,23,11
35432,Goodsuck,tarren-mill,1662,priest,shadow,54,29,25
35433,Tosem,antonidas,1661,priest,shadow,30,19,11
35434,Sandcastles,ravencrest,1659,priest,shadow,90,58,32
35435,Violatio,aegwynn,1658,priest,shadow,104,59,45
35436,Киндзер,blackscar,1658,priest,shadow,54,29,25
35437,Øxytøcin,ravencrest,1658,priest,shadow,168,87,81
35438,Buffholy,dun-modr,1657,priest,shadow,66,39,27
35439,Mentax,kazzak,1657,priest,shadow,42,24,18
35440,Strunkiin,defias-brotherhood,1656,priest,shadow,108,60,48
35441,Dotreveal,ravencrest,1656,priest,shadow,42,23,19
35442,Пурпле,soulflayer,1655,priest,shadow,41,18,23
35443,Anexxia,outland,1654,priest,shadow,42,20,22
35444,Виталябард,gordunni,1654,priest,shadow,66,30,36
35445,Healzonwiilz,tarren-mill,1652,priest,shadow,30,18,12
35446,Sqwabblepee,stormscale,1652,priest,shadow,113,64,49
35447,Galadrielkä,drakthul,1651,priest,shadow,42,24,18
35448,Финдовский,gordunni,1649,priest,shadow,102,54,48
35449,Ruhe,silvermoon,1648,priest,shadow,48,27,21
35450,Cdplz,archimonde,1647,priest,shadow,30,20,10
35451,Been,ravencrest,1646,priest,shadow,42,22,20
35452,Malaíka,silvermoon,1645,priest,shadow,41,25,16
35453,Eupz,argent-dawn,1644,priest,shadow,50,27,23
35454,Atahalni,argent-dawn,1644,priest,shadow,156,71,85
35455,Djariisimp,tarren-mill,1643,priest,shadow,36,21,15
35456,Христианин,gordunni,1642,priest,shadow,96,54,42
35457,Kiesp,tarren-mill,1642,priest,shadow,186,97,89
35458,Rakkha,ravencrest,1642,priest,shadow,90,46,44
35459,Rházael,blackrock,1642,priest,shadow,42,20,22
35460,Pedopräst,stormscale,1640,priest,shadow,62,39,23
35461,Weebi,silvermoon,1640,priest,shadow,65,39,26
35462,Milo,argent-dawn,1640,priest,shadow,102,61,41
35463,Bownsamdi,tarren-mill,1640,priest,shadow,39,23,16
35464,Mirill,tarren-mill,1640,priest,shadow,151,79,72
35465,Jacep,kazzak,1639,priest,shadow,36,23,13
35466,Nøwmäck,archimonde,1639,priest,shadow,42,23,19
35467,Ikaytsym,ravencrest,1638,priest,shadow,36,22,14
35468,Priestfive,stormscale,1638,priest,shadow,48,28,20
35469,Aaj,twisting-nether,1638,priest,shadow,57,29,28
35470,Mikizu,die-aldor,1638,priest,shadow,42,21,21
35471,Momomomomomo,blackrock,1637,priest,shadow,118,61,57
35472,Djzerøgodx,frostwolf,1637,priest,shadow,41,18,23
35473,Belialzs,blackrock,1636,priest,shadow,45,24,21
35474,Dezerta,nozdormu,1636,priest,shadow,74,39,35
35475,Asterixsu,sylvanas,1635,priest,shadow,42,28,14
35476,Undefined,chamber-of-aspects,1634,priest,shadow,40,28,12
35477,Mojibien,burning-legion,1633,priest,shadow,134,73,61
35478,Дикаях,gordunni,1633,priest,shadow,106,51,55
35479,Bigdogone,arathor,1632,priest,shadow,52,29,23
35480,Sosûke,archimonde,1631,priest,shadow,36,22,14
35481,Vaßpera,tarren-mill,1631,priest,shadow,111,60,51
35482,Muyhuman,eredar,1630,priest,shadow,24,17,7
35483,Jaimë,ravencrest,1630,priest,shadow,30,17,13
35484,Ðanilox,dun-modr,1629,priest,shadow,24,17,7
35485,Shåmssp,kazzak,1628,priest,shadow,18,17,1
35486,Baldracca,shendralar,1628,priest,shadow,108,58,50
35487,Ахаххааха,gordunni,1628,priest,shadow,60,32,28
35488,Shreedx,stormscale,1627,priest,shadow,60,35,25
35489,Билетлолпро,borean-tundra,1627,priest,shadow,30,17,13
35490,Чикхоп,blackscar,1625,priest,shadow,108,69,39
35491,Марриаза,blackscar,1625,priest,shadow,48,23,25
35492,Lênax,arthas,1624,priest,shadow,46,25,21
35493,Jønnybanana,blackrock,1623,priest,shadow,39,20,19
35494,Affex,tarren-mill,1622,priest,shadow,30,18,12
35495,Emala,hyjal,1622,priest,shadow,36,17,19
35496,Pennywïse,kargath,1622,priest,shadow,108,50,58
35497,Luphriest,ravencrest,1621,priest,shadow,36,17,19
35498,Brøwnyez,zuljin,1620,priest,shadow,66,31,35
35499,Shyasianpr,area-52,1619,priest,shadow,42,23,19
35500,Malip,ragnaros,1619,priest,shadow,39,19,20
35501,Rubzler,ravencrest,1618,priest,shadow,36,18,18
35502,Najany,archimonde,1617,priest,shadow,36,20,16
35503,Амбрелка,fordragon,1617,priest,shadow,193,98,95
35504,Jegred,draenor,1616,priest,shadow,48,32,16
35505,Toesxcker,stormscale,1616,priest,shadow,35,21,14
35506,Priestazie,madmortem,1616,priest,shadow,96,57,39
35507,Sweetepi,blackmoore,1616,priest,shadow,42,24,18
35508,Педрец,howling-fjord,1616,priest,shadow,60,32,28
35509,Cielavinja,aszune,1616,priest,shadow,44,23,21
35510,Babarøqa,blackmoore,1616,priest,shadow,277,143,134
35511,Алурелис,blackscar,1615,priest,shadow,30,17,13
35512,Poposy,hyjal,1614,priest,shadow,36,23,13
35513,Mukkin,tarren-mill,1614,priest,shadow,60,35,25
35514,Knoffp,blackhand,1614,priest,shadow,72,41,31
35515,Шпх,howling-fjord,1614,priest,shadow,36,20,16
35516,Neitter,zuljin,1613,priest,shadow,72,40,32
35517,Widdlprest,sylvanas,1613,priest,shadow,36,17,19
35518,Svettvrede,sylvanas,1613,priest,shadow,75,35,40
35519,Marsheil,blackhand,1612,priest,shadow,54,31,23
35520,Пампнавечерх,blackscar,1612,priest,shadow,41,22,19
35521,Nûtqt,archimonde,1612,priest,shadow,94,49,45
35522,Charmebolzen,blackrock,1612,priest,shadow,96,50,46
35523,Azæriø,rashgarroth,1612,priest,shadow,89,46,43
35524,Asträlaws,archimonde,1611,priest,shadow,64,34,30
35525,Ihu,nazjatar,1611,priest,shadow,131,62,69
35526,Essumies,stormreaver,1610,priest,shadow,38,26,12
35527,Bigblackdot,grim-batol,1610,priest,shadow,30,17,13
35528,Адскийприст,gordunni,1610,priest,shadow,36,17,19
35529,Fearocity,outland,1609,priest,shadow,42,23,19
35530,Lenneyqt,blackmoore,1609,priest,shadow,48,26,22
35531,Quezaris,kazzak,1607,priest,shadow,23,20,3
35532,Vatikanet,ravencrest,1607,priest,shadow,111,65,46
35533,Tùcøcø,archimonde,1607,priest,shadow,48,21,27
35534,ßelfy,twisting-nether,1606,priest,shadow,25,19,6
35535,Ittei,stormscale,1606,priest,shadow,69,47,22
35536,Hòllymèdx,blackmoore,1605,priest,shadow,33,21,12
35537,Waycrest,ravencrest,1605,priest,shadow,71,45,26
35538,Øhlø,ysondre,1604,priest,shadow,27,19,8
35539,Æäõ,turalyon,1604,priest,shadow,36,19,17
35540,Mindtyson,dun-morogh,1603,priest,shadow,30,18,12
35541,Trancemaster,dun-modr,1602,priest,shadow,30,18,12
35542,Jonesy,blackmoore,1602,priest,shadow,82,46,36
35543,Sunehxp,blackrock,1602,priest,shadow,47,20,27
35544,Sadskîx,dun-modr,1601,priest,shadow,33,23,10
35545,Sudeki,blackmoore,1601,priest,shadow,42,20,22
35546,Satin,twilights-hammer,1600,priest,shadow,33,21,12
35547,Caera,blackrock,1600,priest,shadow,36,21,15
35548,Toba,hellscream,1600,priest,shadow,42,23,19
35549,Willzah,outland,1600,priest,shadow,38,20,18
35550,Cifhilis,ravencrest,1600,priest,shadow,66,32,34
35551,Syam,dun-morogh,1600,priest,shadow,42,17,25
35552,Shyvi,ravencrest,1598,priest,shadow,30,20,10
35553,Fandac,sylvanas,1598,priest,shadow,36,20,16
35554,Everdark,twisting-nether,1598,priest,shadow,172,92,80
35555,Terrored,ravencrest,1598,priest,shadow,48,20,28
35556,Энвиньяттар,howling-fjord,1597,priest,shadow,47,32,15
35557,Llothx,ravencrest,1597,priest,shadow,62,34,28
35558,Lavidu,antonidas,1597,priest,shadow,48,26,22
35559,Трубишоп,howling-fjord,1595,priest,shadow,106,52,54
35560,Cooldgreyjoy,archimonde,1594,priest,shadow,40,19,21
35561,Ephara,outland,1593,priest,shadow,59,33,26
35562,Makethemstop,bronzebeard,1591,priest,shadow,66,47,19
35563,Priestgrade,darkspear,1590,priest,shadow,36,20,16
35564,Даркфолс,soulflayer,1588,priest,shadow,48,29,19
35565,Kimosabee,kazzak,1588,priest,shadow,48,25,23
35566,Pombär,ragnaros,1587,priest,shadow,54,36,18
35567,Chinko,blackmoore,1587,priest,shadow,86,54,32
35568,Genthus,kazzak,1586,priest,shadow,78,41,37
35569,Axelbre,blackrock,1585,priest,shadow,30,19,11
35570,Meshen,ysondre,1585,priest,shadow,274,150,124
35571,Faminé,outland,1584,priest,shadow,65,29,36
35572,Бомжскадилом,gordunni,1583,priest,shadow,78,43,35
35573,Lowisa,sylvanas,1580,priest,shadow,76,45,31
35574,Энмунд,borean-tundra,1580,priest,shadow,159,91,68
35575,Imøteph,ragnaros,1579,priest,shadow,77,44,33
35576,Cryptoflame,silvermoon,1579,priest,shadow,45,25,20
35577,Офелла,howling-fjord,1579,priest,shadow,454,234,220
35578,Hemaplex,dun-modr,1578,priest,shadow,53,32,21
35579,Lilakaii,chamber-of-aspects,1578,priest,shadow,98,53,45
35580,Sakanade,twisting-nether,1576,priest,shadow,42,34,8
35581,Kuddles,hyjal,1576,priest,shadow,128,77,51
35582,Cykdwojeczka,burning-legion,1576,priest,shadow,101,51,50
35583,Milamati,kazzak,1576,priest,shadow,60,28,32
35584,Basxcbxtchx,ravencrest,1575,priest,shadow,30,19,11
35585,Basicpr,ravencrest,1575,priest,shadow,63,38,25
35586,Baihoi,twilights-hammer,1570,priest,shadow,108,65,43
35587,Kêrrýgold,blackrock,1570,priest,shadow,115,62,53
35588,Supahot,sylvanas,1569,priest,shadow,60,36,24
35589,Skerduddle,stormscale,1568,priest,shadow,48,29,19
35590,Phplaravel,tarren-mill,1568,priest,shadow,63,31,32
35591,Kantar,ragnaros,1567,priest,shadow,106,58,48
35592,Solaní,antonidas,1567,priest,shadow,132,72,60
35593,Beonin,tarren-mill,1565,priest,shadow,55,34,21
35594,Филяфан,gordunni,1565,priest,shadow,60,30,30
35595,Саксесфул,howling-fjord,1564,priest,shadow,115,63,52
35596,Insaniro,argent-dawn,1562,priest,shadow,66,34,32
35597,Selaria,magtheridon,1562,priest,shadow,42,19,23
35598,Умора,razuvious,1560,priest,shadow,29,17,12
35599,Рэнфан,fordragon,1558,priest,shadow,52,35,17
35600,Zayden,ragnaros,1557,priest,shadow,83,41,42
35601,Kwolinger,norgannon,1557,priest,shadow,48,23,25
35602,Эззи,soulflayer,1556,priest,shadow,90,50,40
35603,Shivaja,aegwynn,1555,priest,shadow,30,17,13
35604,Jonig,blackmoore,1555,priest,shadow,66,32,34
35605,Lothlórien,dun-modr,1552,priest,shadow,42,31,11
35606,Bubidiblumpr,twisting-nether,1552,priest,shadow,78,51,27
35607,Malisna,argent-dawn,1551,priest,shadow,29,17,12
35608,Vavulya,blackhand,1551,priest,shadow,147,80,67
35609,Corruptx,ysondre,1550,priest,shadow,36,18,18
35610,Healiea,outland,1549,priest,shadow,89,38,51
35611,Anathemas,draenor,1548,priest,shadow,42,30,12
35612,Xyo,alleria,1548,priest,shadow,72,35,37
35613,Sebbepriest,twisting-nether,1544,priest,shadow,173,93,80
35614,Coupdekaraté,sylvanas,1543,priest,shadow,36,18,18
35615,Xooxl,ragnaros,1542,priest,shadow,102,60,42
35616,Inferius,shadowsong,1542,priest,shadow,46,18,28
35617,Hâicu,antonidas,1540,priest,shadow,60,38,22
35618,Кхэрри,goldrinn,1540,priest,shadow,30,19,11
35619,Амгар,galakrond,1540,priest,shadow,125,69,56
35620,Warplague,argent-dawn,1539,priest,shadow,42,19,23
35621,Hellscon,kazzak,1538,priest,shadow,125,62,63
35622,Babydark,ravencrest,1535,priest,shadow,30,16,14
35623,Ankhh,bloodscalp,1535,priest,shadow,90,42,48
35624,Apèx,blackrock,1535,priest,shadow,40,18,22
35625,Bøts,ravencrest,1534,priest,shadow,55,27,28
35626,Sopsy,stormscale,1533,priest,shadow,42,21,21
35627,Tekdogx,blackmoore,1533,priest,shadow,36,16,20
35628,Putríd,sylvanas,1532,priest,shadow,30,19,11
35629,Zekonja,doomhammer,1532,priest,shadow,82,42,40
35630,Massbimba,tarren-mill,1531,priest,shadow,65,33,32
35631,Lightform,twisting-nether,1530,priest,shadow,69,43,26
35632,Kightz,twisting-nether,1530,priest,shadow,63,32,31
35633,Ðrwiz,ravencrest,1528,priest,shadow,30,16,14
35634,Thmas,outland,1525,priest,shadow,71,32,39
35635,Thoryän,ragnaros,1523,priest,shadow,42,24,18
35636,Psycos,kazzak,1523,priest,shadow,66,33,33
35637,Cederpriest,tarren-mill,1522,priest,shadow,57,21,36
35638,Мишатемный,gordunni,1520,priest,shadow,54,31,23
35639,Valirda,twisting-nether,1520,priest,shadow,122,61,61
35640,Прыст,howling-fjord,1519,priest,shadow,24,16,8
35641,Kättare,stormscale,1519,priest,shadow,48,25,23
35642,Nahyra,dalaran,1519,priest,shadow,113,58,55
35643,Cannapriest,frostwolf,1518,priest,shadow,48,27,21
35644,Рейвор,gordunni,1518,priest,shadow,35,19,16
35645,Yoii,nemesis,1518,priest,shadow,36,16,20
35646,Chrønös,hyjal,1517,priest,shadow,131,68,63
35647,Whocare,tarren-mill,1517,priest,shadow,48,24,24
35648,Leckpriest,sanguino,1517,priest,shadow,100,49,51
35649,Rynsym,ravencrest,1517,priest,shadow,47,20,27
35650,Stölpen,ravencrest,1515,priest,shadow,48,22,26
35651,Flyp,stormscale,1514,priest,shadow,54,26,28
35652,Discknight,kazzak,1514,priest,shadow,42,16,26
35653,Umbralx,ragnaros,1513,priest,shadow,77,45,32
35654,Fumiiko,stormscale,1511,priest,shadow,50,20,30
35655,Beasteaksx,thrall,1510,priest,shadow,30,17,13
35656,Êttân,ravencrest,1510,priest,shadow,56,30,26
35657,Jingling,kazzak,1509,priest,shadow,24,16,8
35658,Zászàsmaster,kazzak,1509,priest,shadow,96,55,41
35659,Voidis,hyjal,1509,priest,shadow,30,16,14
35660,Morsy,alleria,1509,priest,shadow,44,23,21
35661,Skypray,burning-legion,1507,priest,shadow,99,50,49
35662,Cylantharia,eredar,1506,priest,shadow,30,16,14
35663,Ðòóm,archimonde,1505,priest,shadow,61,33,28
35664,Йоййо,gordunni,1504,priest,shadow,112,58,54
35665,Hinorist,kazzak,1503,priest,shadow,29,17,12
35666,Ormarn,twisting-nether,1503,priest,shadow,48,28,20
35667,Dyshexia,bronze-dragonflight,1503,priest,shadow,78,39,39
35668,Деплитфофан,gordunni,1502,priest,shadow,83,50,33
35669,Brighty,sylvanas,1502,priest,shadow,108,56,52
35670,Shadowplay,theradras,1502,priest,shadow,64,30,34
35671,Varjomies,ragnaros,1499,priest,shadow,96,50,46
35672,Fiftyfives,hyjal,1496,priest,shadow,51,25,26
35673,Bubbleup,defias-brotherhood,1494,priest,shadow,30,21,9
35674,Sypnos,zuljin,1493,priest,shadow,36,21,15
35675,Äiri,blackmoore,1492,priest,shadow,30,17,13
35676,Blasphemiia,outland,1491,priest,shadow,72,44,28
35677,Kajifoxi,frostmane,1490,priest,shadow,60,38,22
35678,Skûggpräst,silvermoon,1490,priest,shadow,41,22,19
35679,Miruvai,tarren-mill,1490,priest,shadow,36,18,18
35680,Даняпампх,soulflayer,1489,priest,shadow,212,112,100
35681,Bercxu,ragnaros,1487,priest,shadow,60,34,26
35682,Bierbändiger,blackhand,1487,priest,shadow,30,17,13
35683,Lëshder,sanguino,1487,priest,shadow,107,55,52
35684,Juxtapose,argent-dawn,1485,priest,shadow,30,23,7
35685,Lynseanna,ravencrest,1485,priest,shadow,29,18,11
35686,Ryik,ravencrest,1484,priest,shadow,68,36,32
35687,Castêr,silvermoon,1483,priest,shadow,54,29,25
35688,Ankus,tarren-mill,1482,priest,shadow,66,36,30
35689,Statìk,outland,1482,priest,shadow,66,33,33
35690,Zeto,blackmoore,1479,priest,shadow,51,31,20
35691,Shinesomnya,aegwynn,1478,priest,shadow,40,23,17
35692,Mightyfool,aegwynn,1478,priest,shadow,102,49,53
35693,Apfelrisotta,outland,1478,priest,shadow,69,33,36
35694,Зонкк,thermaplugg,1477,priest,shadow,114,62,52
35695,Baptizer,nemesis,1476,priest,shadow,110,69,41
35696,Akris,ragnaros,1476,priest,shadow,66,35,31
35697,Galilea,sanguino,1475,priest,shadow,20,17,3
35698,Pregrip,twisting-nether,1473,priest,shadow,43,21,22
35699,Thawx,stormscale,1472,priest,shadow,30,16,14
35700,Hælmenøw,archimonde,1472,priest,shadow,54,28,26
35701,Ariyáh,antonidas,1471,priest,shadow,114,60,54
35702,Kisala,kazzak,1470,priest,shadow,47,32,15
35703,Adaseth,tarren-mill,1469,priest,shadow,78,51,27
35704,Wingufreebrø,sanguino,1468,priest,shadow,76,36,40
35705,Hiyahen,silvermoon,1467,priest,shadow,60,34,26
35706,Люблюкофе,deathguard,1467,priest,shadow,92,51,41
35707,Sháady,ravencrest,1466,priest,shadow,60,29,31
35708,Youguessedit,twisting-nether,1466,priest,shadow,36,16,20
35709,Spideypap,ragnaros,1464,priest,shadow,58,33,25
35710,Mozahn,ragnaros,1464,priest,shadow,39,20,19
35711,Kayeen9DF0F1,tarren-mill,1464,priest,shadow,118,58,60
35712,Xceliann,stormscale,1462,priest,shadow,30,18,12
35713,Карбираторх,gordunni,1462,priest,shadow,59,30,29
35714,Tyene,voljin,1461,priest,shadow,70,40,30
35715,Maxhima,defias-brotherhood,1461,priest,shadow,72,39,33
35716,Багбери,eversong,1460,priest,shadow,322,170,152
35717,Lapinvicieux,archimonde,1460,priest,shadow,53,27,26
35718,Erkay,kazzak,1459,priest,shadow,54,30,24
35719,Psycoscream,blackmoore,1459,priest,shadow,47,23,24
35720,Nomorelight,stormscale,1458,priest,shadow,48,23,25
35721,Kellen,burning-blade,1457,priest,shadow,320,167,153
35722,Xîneâ,outland,1456,priest,shadow,30,16,14
35723,Дикрия,eversong,1456,priest,shadow,114,59,55
35724,Venomspawn,ragnaros,1456,priest,shadow,36,18,18
35725,Celz,kazzak,1455,priest,shadow,36,21,15
35726,Îndura,drakthul,1455,priest,shadow,50,29,21
35727,Hemovoid,nagrand,1454,priest,shadow,24,17,7
35728,Kendea,silvermoon,1453,priest,shadow,139,76,63
35729,Vedina,bronze-dragonflight,1453,priest,shadow,105,49,56
35730,Lousp,tarren-mill,1452,priest,shadow,42,17,25
35731,Chaddius,stormscale,1450,priest,shadow,122,63,59
35732,Самаэльз,blackscar,1448,priest,shadow,62,31,31
35733,Kurzik,zuljin,1447,priest,shadow,46,30,16
35734,Vhayna,kazzak,1447,priest,shadow,77,45,32
35735,Dípp,ravencrest,1447,priest,shadow,36,18,18
35736,Veryssra,archimonde,1446,priest,shadow,48,37,11
35737,Thebesp,ravencrest,1446,priest,shadow,42,19,23
35738,Voidjeanzqt,blackmoore,1445,priest,shadow,30,21,9
35739,Nygel,kazzak,1445,priest,shadow,112,59,53
35740,Galle,frostmane,1444,priest,shadow,32,20,12
35741,Cinaedus,stormreaver,1444,priest,shadow,63,33,30
35742,Cringelørd,alakir,1441,priest,shadow,70,41,29
35743,Palitox,kazzak,1439,priest,shadow,70,38,32
35744,Otecduchovny,burning-blade,1437,priest,shadow,24,15,9
35745,Taeraz,archimonde,1435,priest,shadow,24,15,9
35746,Odium,alakir,1434,priest,shadow,80,46,34
35747,Sanebassoff,kazzak,1433,priest,shadow,190,102,88
35748,Tarantos,uldum,1433,priest,shadow,39,18,21
35749,Jlox,stormscale,1433,priest,shadow,39,16,23
35750,Valdiona,tarren-mill,1431,priest,shadow,36,22,14
35751,Fish,arathor,1431,priest,shadow,66,29,37
35752,Smiles,burning-steppes,1430,priest,shadow,36,20,16
35753,Yaoshih,draenor,1430,priest,shadow,53,28,25
35754,Hörror,twisting-nether,1430,priest,shadow,42,21,21
35755,Astangia,nemesis,1429,priest,shadow,183,99,84
35756,Forhandleren,draenor,1429,priest,shadow,72,34,38
35757,Gyom,sargeras,1426,priest,shadow,24,15,9
35758,Lamaovic,archimonde,1426,priest,shadow,59,31,28
35759,Jaimee,zirkel-des-cenarius,1425,priest,shadow,24,15,9
35760,Xbeau,bronze-dragonflight,1425,priest,shadow,60,31,29
35761,Даркхон,howling-fjord,1423,priest,shadow,38,21,17
35762,Fnúggí,kazzak,1423,priest,shadow,42,21,21
35763,Afrophobia,archimonde,1422,priest,shadow,84,45,39
35764,Skypez,blackhand,1419,priest,shadow,78,40,38
35765,Sharmidix,kazzak,1419,priest,shadow,30,15,15
35766,Ladouce,archimonde,1418,priest,shadow,33,17,16
35767,Vøidtheorem,ragnaros,1417,priest,shadow,36,15,21
35768,Элдерле,gordunni,1415,priest,shadow,36,18,18
35769,Søcrax,blackrock,1414,priest,shadow,60,34,26
35770,Старкстрим,gordunni,1413,priest,shadow,66,34,32
35771,Îzî,sanguino,1412,priest,shadow,42,23,19
35772,Shopify,nagrand,1412,priest,shadow,30,15,15
35773,Xelathor,twisting-nether,1412,priest,shadow,82,39,43
35774,Simplesam,ravencrest,1412,priest,shadow,76,35,41
35775,Icyîce,kazzak,1411,priest,shadow,24,15,9
35776,Flayin,kazzak,1411,priest,shadow,48,29,19
35777,Saintethérez,archimonde,1410,priest,shadow,45,30,15
35778,Iamreaper,outland,1409,priest,shadow,36,18,18
35779,Токиото,gordunni,1408,priest,shadow,30,15,15
35780,Сашашвд,howling-fjord,1407,priest,shadow,42,22,20
35781,Dopey,kazzak,1406,priest,shadow,24,17,7
35782,Dotsin,kazzak,1406,priest,shadow,124,61,63
35783,Mojoo,aggramar,1405,priest,shadow,26,16,10
35784,Niecheqt,tarren-mill,1403,priest,shadow,44,24,20
35785,Tazera,boulderfist,1403,priest,shadow,66,33,33
35786,Experimentix,silvermoon,1402,priest,shadow,30,16,14
35787,Voidbro,grim-batol,1401,priest,shadow,29,15,14
35788,Fosil,xavius,1400,priest,shadow,36,18,18
35789,Isusgaspodi,argent-dawn,1399,priest,shadow,103,57,46
35790,Nicorøbin,uldum,1398,priest,shadow,62,37,25
35791,Nightshådøw,silvermoon,1398,priest,shadow,122,64,58
35792,Lamess,drakthul,1397,priest,shadow,49,30,19
35793,Ohboy,eredar,1397,priest,shadow,60,29,31
35794,Xíøn,draenor,1397,priest,shadow,35,16,19
35795,Divledann,lightnings-blade,1395,priest,shadow,30,18,12
35796,Низара,deathguard,1395,priest,shadow,54,22,32
35797,Sxynix,thrall,1394,priest,shadow,41,24,17
35798,Zevulós,ravencrest,1393,priest,shadow,71,26,45
35799,Дэспира,howling-fjord,1391,priest,shadow,28,16,12
35800,Chokipoki,twisting-nether,1390,priest,shadow,30,17,13
35801,Ammp,outland,1390,priest,shadow,124,66,58
35802,Mylini,silvermoon,1390,priest,shadow,95,50,45
35803,Nemw,chamber-of-aspects,1389,priest,shadow,34,21,13
35804,Chillx,blackmoore,1389,priest,shadow,162,94,68
35805,Voidpbody,nerathor,1388,priest,shadow,29,16,13
35806,Squîzz,archimonde,1387,priest,shadow,57,27,30
35807,Сариандра,gordunni,1386,priest,shadow,68,39,29
35808,Superdude,stormscale,1386,priest,shadow,37,17,20
35809,Ðotgød,nemesis,1385,priest,shadow,24,18,6
35810,Hek,sylvanas,1384,priest,shadow,72,36,36
35811,Fordöbroo,ragnaros,1383,priest,shadow,174,91,83
35812,Daenie,elune,1383,priest,shadow,42,21,21
35813,Damyo,eredar,1381,priest,shadow,54,29,25
35814,Nairima,argent-dawn,1377,priest,shadow,30,15,15
35815,Zinxe,ravencrest,1374,priest,shadow,31,19,12
35816,Ðivinà,archimonde,1371,priest,shadow,30,16,14
35817,Shinígamí,frostmane,1370,priest,shadow,54,28,26
35818,Seneth,twisting-nether,1368,priest,shadow,100,49,51
35819,Atheniss,drakthul,1366,priest,shadow,60,34,26
35820,Rogmisa,cthun,1366,priest,shadow,54,30,24
35821,Eryxial,antonidas,1365,priest,shadow,47,22,25
35822,Shizo,blutkessel,1364,priest,shadow,29,20,9
35823,Synexia,sylvanas,1364,priest,shadow,99,56,43
35824,Bimboxo,argent-dawn,1363,priest,shadow,137,78,59
35825,Sucukpriest,blackrock,1363,priest,shadow,42,23,19
35826,Daltheria,daggerspine,1358,priest,shadow,77,44,33
35827,Имморталрё,galakrond,1354,priest,shadow,42,29,13
35828,Kourroucé,archimonde,1354,priest,shadow,137,70,67
35829,Офинсия,deathguard,1354,priest,shadow,47,18,29
35830,Вексион,goldrinn,1353,priest,shadow,36,19,17
35831,Силесттиль,gordunni,1353,priest,shadow,58,29,29
35832,Adssdfhjgh,outland,1350,priest,shadow,32,22,10
35833,Aleetheia,silvermoon,1350,priest,shadow,155,77,78
35834,Ulquiørra,blackmoore,1349,priest,shadow,60,31,29
35835,Hoon,destromath,1345,priest,shadow,60,31,29
35836,Nyróx,malganis,1345,priest,shadow,122,59,63
35837,Gumayusi,ravencrest,1344,priest,shadow,24,14,10
35838,Нинаврач,howling-fjord,1344,priest,shadow,24,14,10
35839,ßeastx,nethersturm,1344,priest,shadow,36,19,17
35840,Syreet,silvermoon,1342,priest,shadow,24,14,10
35841,Alexwinkwink,kazzak,1342,priest,shadow,24,14,10
35842,Amazingame,tarren-mill,1342,priest,shadow,30,14,16
35843,Возрождающее,soulflayer,1342,priest,shadow,30,14,16
35844,Vtspam,stormscale,1341,priest,shadow,24,14,10
35845,Maysiex,twisting-nether,1341,priest,shadow,24,14,10
35846,Slimshadey,malganis,1341,priest,shadow,24,14,10
35847,Apuessii,dun-modr,1340,priest,shadow,59,31,28
35848,Shadowsister,burning-blade,1340,priest,shadow,42,20,22
35849,Velenthøs,argent-dawn,1338,priest,shadow,41,23,18
35850,Morteous,twisting-nether,1338,priest,shadow,265,136,129
35851,Wtrix,stormscale,1337,priest,shadow,24,14,10
35852,Hecaté,blackhand,1337,priest,shadow,55,31,24
35853,Emilyvvillis,outland,1337,priest,shadow,36,14,22
35854,Весенняя,gordunni,1336,priest,shadow,44,25,19
35855,Шаасит,soulflayer,1336,priest,shadow,30,17,13
35856,Seni,gilneas,1336,priest,shadow,55,26,29
35857,Zerovision,nemesis,1335,priest,shadow,24,14,10
35858,Sleepyshadow,drakthul,1335,priest,shadow,60,29,31
35859,Gød,magtheridon,1335,priest,shadow,30,14,16
35860,Settemsen,tarren-mill,1334,priest,shadow,18,14,4
35861,Morgoh,die-arguswacht,1334,priest,shadow,84,45,39
35862,Broncos,twisting-nether,1331,priest,shadow,58,33,25
35863,Inei,doomhammer,1331,priest,shadow,48,25,23
35864,Donkyrobert,tarren-mill,1331,priest,shadow,30,14,16
35865,Adägïo,dun-modr,1329,priest,shadow,96,41,55
35866,Giruga,eredar,1327,priest,shadow,24,14,10
35867,Dumámày,silvermoon,1326,priest,shadow,24,17,7
35868,Callmegød,archimonde,1324,priest,shadow,24,14,10
35869,Grouptherpst,draenor,1323,priest,shadow,24,14,10
35870,Kertith,argent-dawn,1323,priest,shadow,153,75,78
35871,Mellandoh,tarren-mill,1322,priest,shadow,53,31,22
35872,Joniop,stormreaver,1322,priest,shadow,24,14,10
35873,Khalphus,argent-dawn,1322,priest,shadow,36,15,21
35874,Сэлунна,goldrinn,1321,priest,shadow,36,14,22
35875,Shadowsig,silvermoon,1319,priest,shadow,30,14,16
35876,Kdot,drakthul,1317,priest,shadow,24,16,8
35877,Clergy,hellfire,1317,priest,shadow,55,33,22
35878,Littlebugger,argent-dawn,1317,priest,shadow,63,28,35
35879,Míjagí,blackhand,1314,priest,shadow,59,30,29
35880,Meloo,dalaran,1313,priest,shadow,103,54,49
35881,Gauge,frostmane,1312,priest,shadow,150,77,73
35882,Lathas,bloodfeather,1311,priest,shadow,36,23,13
35883,Saviour,spinebreaker,1311,priest,shadow,42,23,19
35884,Prästpojken,frostwhisper,1311,priest,shadow,36,19,17
35885,Lurmus,outland,1311,priest,shadow,30,15,15
35886,Xxede,dun-modr,1310,priest,shadow,81,37,44
35887,Kasyrra,sylvanas,1309,priest,shadow,79,42,37
35888,Хоозяин,blackscar,1308,priest,shadow,18,14,4
35889,Ggdoll,twisting-nether,1308,priest,shadow,191,97,94
35890,Battlefog,turalyon,1307,priest,shadow,54,29,25
35891,Redoubtablee,kazzak,1306,priest,shadow,42,16,26
35892,Secundis,silvermoon,1305,priest,shadow,30,16,14
35893,Kåz,argent-dawn,1301,priest,shadow,35,21,14
35894,Inzàné,kazzak,1301,priest,shadow,82,46,36
35895,Unerfedsp,archimonde,1297,priest,shadow,139,66,73
35896,Aíushtha,frostmane,1295,priest,shadow,36,14,22
35897,Røst,ravencrest,1294,priest,shadow,23,14,9
35898,Shifune,blackhand,1293,priest,shadow,54,25,29
35899,Hexmon,tarren-mill,1292,priest,shadow,30,21,9
35900,Slenderdoom,stormscale,1291,priest,shadow,24,14,10
35901,Цитамин,deathguard,1291,priest,shadow,85,39,46
35902,Boomboxk,darksorrow,1290,priest,shadow,24,15,9
35903,Абасали,howling-fjord,1290,priest,shadow,54,22,32
35904,Васпохилить,howling-fjord,1289,priest,shadow,90,39,51
35905,Eytrhfb,stormscale,1288,priest,shadow,24,14,10
35906,Piixld,aegwynn,1288,priest,shadow,54,28,26
35907,Prøfesor,nemesis,1284,priest,shadow,33,15,18
35908,Eslo,outland,1280,priest,shadow,38,17,21
35909,Nagatary,blackmoore,1279,priest,shadow,66,35,31
35910,Psystorm,frostmane,1279,priest,shadow,36,18,18
35911,Kíssme,archimonde,1277,priest,shadow,30,21,9
35912,Неймхичгодх,gordunni,1277,priest,shadow,28,15,13
35913,Chowhone,archimonde,1277,priest,shadow,42,14,28
35914,Bonifacio,la-croisade-écarlate,1276,priest,shadow,30,14,16
35915,Voidlord,hyjal,1275,priest,shadow,60,31,29
35916,Fåith,twilights-hammer,1275,priest,shadow,90,46,44
35917,Onskansmoder,shattered-hand,1274,priest,shadow,69,33,36
35918,Oöm,hyjal,1271,priest,shadow,30,20,10
35919,Seehz,ysondre,1271,priest,shadow,35,14,21
35920,Kristiflicka,kazzak,1268,priest,shadow,42,26,16
35921,Daretox,turalyon,1268,priest,shadow,34,15,19
35922,Ваккарий,gordunni,1266,priest,shadow,106,55,51
35923,Nûwa,draenor,1265,priest,shadow,24,18,6
35924,Dazé,ravencrest,1263,priest,shadow,45,22,23
35925,Evilspel,ravencrest,1261,priest,shadow,33,18,15
35926,Controlled,tarren-mill,1261,priest,shadow,71,35,36
35927,Mundwerk,malganis,1260,priest,shadow,153,70,83
35928,Hëllokitty,sanguino,1253,priest,shadow,86,42,44
35929,Soulsuckerr,silvermoon,1249,priest,shadow,48,24,24
35930,Bensherman,dalaran,1248,priest,shadow,18,13,5
35931,Balthe,defias-brotherhood,1248,priest,shadow,18,13,5
35932,Bizzlebabe,lightbringer,1247,priest,shadow,18,13,5
35933,Xktr,aggra-português,1247,priest,shadow,18,13,5
35934,Sadgepriest,draenor,1247,priest,shadow,24,13,11
35935,Rippeep,emerald-dream,1247,priest,shadow,24,13,11
35936,Testorwp,ragnaros,1245,priest,shadow,48,30,18
35937,Majinmadara,ravencrest,1245,priest,shadow,28,14,14
35938,Because,nemesis,1244,priest,shadow,18,13,5
35939,Scade,kazzak,1243,priest,shadow,30,13,17
35940,Drakzx,kazzak,1242,priest,shadow,18,13,5
35941,Пристаболик,gordunni,1242,priest,shadow,18,13,5
35942,Henaheals,ragnaros,1242,priest,shadow,18,13,5
35943,Shîn,aegwynn,1242,priest,shadow,139,68,71
35944,Ruojatar,stormreaver,1241,priest,shadow,18,13,5
35945,Greyford,blackhand,1240,priest,shadow,18,13,5
35946,Peikkousva,twisting-nether,1240,priest,shadow,24,13,11
35947,Lilyrosemary,arathor,1239,priest,shadow,24,13,11
35948,Buan,blackmoore,1236,priest,shadow,24,13,11
35949,Szalsza,arathor,1236,priest,shadow,41,18,23
35950,Bonbonici,sylvanas,1235,priest,shadow,30,21,9
35951,Horrðr,kazzak,1235,priest,shadow,24,13,11
35952,Pehmoinen,korgall,1233,priest,shadow,24,13,11
35953,Omnissiiah,silvermoon,1232,priest,shadow,54,24,30
35954,Sodomix,tarren-mill,1227,priest,shadow,178,92,86
35955,Delaiya,antonidas,1227,priest,shadow,60,27,33
35956,Smâshëd,stormscale,1225,priest,shadow,42,19,23
35957,Vilhiil,darksorrow,1224,priest,shadow,31,14,17
35958,Enemypriest,argent-dawn,1223,priest,shadow,42,20,22
35959,Powna,blackrock,1222,priest,shadow,42,21,21
35960,Shadowchunks,argent-dawn,1222,priest,shadow,26,13,13
35961,Seum,ravencrest,1218,priest,shadow,30,13,17
35962,Tesz,perenolde,1217,priest,shadow,36,16,20
35963,Bromiaris,dun-morogh,1217,priest,shadow,30,13,17
35964,Yonaka,amanthul,1216,priest,shadow,102,44,58
35965,Montane,wrathbringer,1215,priest,shadow,18,13,5
35966,Skuggzter,outland,1215,priest,shadow,42,26,16
35967,Kagarr,kazzak,1214,priest,shadow,33,17,16
35968,Xanelor,tarren-mill,1213,priest,shadow,30,17,13
35969,Damnedangel,drakthul,1212,priest,shadow,30,13,17
35970,Mirelaw,stormscale,1210,priest,shadow,84,53,31
35971,Neychen,blackrock,1209,priest,shadow,30,13,17
35972,Cptnahab,blackmoore,1206,priest,shadow,49,35,14
35973,Zedrus,azshara,1206,priest,shadow,29,13,16
35974,Ayuntamiento,proudmoore,1202,priest,shadow,36,23,13
35975,Mylox,blackrock,1200,priest,shadow,22,14,8
35976,Gaidemar,blackmoore,1200,priest,shadow,48,24,24
35977,Farseerx,ravencrest,1194,priest,shadow,135,74,61
35978,Veshania,blackhand,1194,priest,shadow,56,25,31
35979,Абсорб,gordunni,1193,priest,shadow,24,13,11
35980,Avatars,kirin-tor,1188,priest,shadow,64,33,31
35981,Ælîta,blackhand,1186,priest,shadow,42,26,16
35982,Foxiekitten,tarren-mill,1178,priest,shadow,22,13,9
35983,Alaeddin,kazzak,1177,priest,shadow,96,45,51
35984,Cottyx,outland,1176,priest,shadow,22,13,9
35985,Cronershadow,stormscale,1176,priest,shadow,32,15,17
35986,Driptoohard,archimonde,1165,priest,shadow,19,14,5
35987,Tiinia,hyjal,1165,priest,shadow,40,15,25
35988,Mynithir,chants-éternels,1163,priest,shadow,36,18,18
35989,Holymonstah,sanguino,1161,priest,shadow,46,24,22
35990,Sayash,chamber-of-aspects,1158,priest,shadow,26,13,13
35991,Scaryman,ravencrest,1157,priest,shadow,23,14,9
35992,Миссклик,goldrinn,1156,priest,shadow,22,13,9
35993,Thergozar,stormscale,1153,priest,shadow,60,37,23
35994,Dogstav,kazzak,1152,priest,shadow,24,12,12
35995,Aritrosp,kargath,1152,priest,shadow,24,12,12
35996,Hotdog,kult-der-verdammten,1152,priest,shadow,42,20,22
35997,Julîane,aegwynn,1151,priest,shadow,18,12,6
35998,Мсикатана,gordunni,1151,priest,shadow,18,12,6
35999,Cyrená,ravencrest,1151,priest,shadow,18,12,6
36000,Grayraven,azjolnerub,1151,priest,shadow,36,12,24
36001,Dingqt,chogall,1150,priest,shadow,24,12,12
36002,Psychø,kazzak,1149,priest,shadow,24,12,12
36003,Onlyfansp,ravencrest,1149,priest,shadow,30,12,18
36004,Pórt,kazzak,1148,priest,shadow,21,13,8
36005,Söörpriest,the-maelstrom,1148,priest,shadow,30,16,14
36006,Harukaa,aggra-português,1147,priest,shadow,24,19,5
36007,Zetapp,argent-dawn,1147,priest,shadow,24,12,12
36008,Tweenitopg,les-clairvoyants,1146,priest,shadow,18,12,6
36009,Turbosucc,burning-blade,1146,priest,shadow,30,12,18
36010,Отчепадре,gordunni,1145,priest,shadow,24,12,12
36011,Kirrako,tarren-mill,1145,priest,shadow,24,12,12
36012,Abjure,silvermoon,1144,priest,shadow,24,12,12
36013,Lasdrael,dun-modr,1141,priest,shadow,66,34,32
36014,Medovina,silvermoon,1139,priest,shadow,18,12,6
36015,Qsandria,ravencrest,1139,priest,shadow,24,12,12
36016,Дитеприста,greymane,1138,priest,shadow,24,15,9
36017,Hârlequin,draenor,1138,priest,shadow,281,141,140
36018,Дикосвет,howling-fjord,1137,priest,shadow,48,15,33
36019,Eliana,blackrock,1136,priest,shadow,18,12,6
36020,Suurona,die-aldor,1135,priest,shadow,54,26,28
36021,Evna,chogall,1135,priest,shadow,30,12,18
36022,Fuzzydude,ravencrest,1135,priest,shadow,36,12,24
36023,Evypriest,draenor,1133,priest,shadow,24,12,12
36024,Cerbero,doomhammer,1128,priest,shadow,18,12,6
36025,Семмэр,gordunni,1125,priest,shadow,73,31,42
36026,Maximandreic,kazzak,1124,priest,shadow,42,13,29
36027,Реврос,gordunni,1118,priest,shadow,26,13,13
36028,Ocastia,antonidas,1116,priest,shadow,18,12,6
36029,Druska,ragnaros,1116,priest,shadow,42,23,19
36030,Spwin,silvermoon,1116,priest,shadow,36,16,20
36031,Абракабра,howling-fjord,1116,priest,shadow,30,12,18
36032,Cabalist,silvermoon,1115,priest,shadow,114,58,56
36033,Shidoya,tarren-mill,1114,priest,shadow,23,12,11
36034,Ziglinde,shattrath,1113,priest,shadow,30,16,14
36035,Уртримас,gordunni,1110,priest,shadow,42,18,24
36036,Angleka,argent-dawn,1105,priest,shadow,101,45,56
36037,Nellytaa,dalaran,1103,priest,shadow,35,18,17
36038,Yuhé,elune,1100,priest,shadow,24,16,8
36039,Sáro,ravencrest,1099,priest,shadow,24,13,11
36040,Акциуми,howling-fjord,1097,priest,shadow,76,43,33
36041,Ðizzi,dun-modr,1096,priest,shadow,21,14,7
36042,Bonka,sanguino,1093,priest,shadow,24,13,11
36043,Ixdeadxl,stormscale,1093,priest,shadow,30,13,17
36044,Cthulou,tarren-mill,1092,priest,shadow,200,100,100
36045,Alsyidan,khaz-modan,1091,priest,shadow,19,17,2
36046,Hellena,neptulon,1089,priest,shadow,42,21,21
36047,Equalìzer,ravencrest,1087,priest,shadow,14,12,2
36048,Crishroc,stormreaver,1084,priest,shadow,42,20,22
36049,Brainwash,darksorrow,1084,priest,shadow,28,12,16
36050,Frëyha,archimonde,1082,priest,shadow,49,28,21
36051,Ниомана,gordunni,1077,priest,shadow,28,17,11
36052,Амфетаминная,howling-fjord,1076,priest,shadow,32,18,14
36053,Valdemar,alakir,1075,priest,shadow,33,18,15
36054,Sacher,shendralar,1074,priest,shadow,72,34,38
36055,Тэтсу,greymane,1073,priest,shadow,36,22,14
36056,Некросиний,eversong,1072,priest,shadow,25,14,11
36057,Løxi,blackmoore,1070,priest,shadow,19,13,6
36058,Syfl,defias-brotherhood,1060,priest,shadow,30,13,17
36059,Phasmofobia,ragnaros,1059,priest,shadow,38,20,18
36060,Kishoengi,ravencrest,1056,priest,shadow,12,11,1
36061,Gladinbedirl,ravencrest,1056,priest,shadow,12,11,1
36062,Mindseven,emeriss,1056,priest,shadow,18,11,7
36063,Draryanna,nemesis,1056,priest,shadow,18,11,7
36064,Häst,the-maelstrom,1055,priest,shadow,15,12,3
36065,Noyam,dun-morogh,1055,priest,shadow,24,11,13
36066,Elyziz,tarren-mill,1054,priest,shadow,18,11,7
36067,Нед,greymane,1054,priest,shadow,18,11,7
36068,Uzü,ysondre,1054,priest,shadow,28,12,16
36069,Khålyst,archimonde,1054,priest,shadow,30,11,19
36070,Шанэкс,howling-fjord,1053,priest,shadow,12,11,1
36071,Umyqt,ragnaros,1053,priest,shadow,18,11,7
36072,Говорун,grom,1053,priest,shadow,18,11,7
36073,Peaksp,stormscale,1053,priest,shadow,18,11,7
36074,Dexploit,frostwolf,1053,priest,shadow,18,11,7
36075,Yoggies,tarren-mill,1053,priest,shadow,21,12,9
36076,Санятруу,blackscar,1053,priest,shadow,78,42,36
36077,Блюмсик,blackscar,1052,priest,shadow,30,18,12
36078,Jadæ,ragnaros,1052,priest,shadow,24,11,13
36079,Simularcum,tarren-mill,1052,priest,shadow,24,11,13
36080,Tigrok,burning-legion,1050,priest,shadow,18,11,7
36081,Phobò,blackrock,1050,priest,shadow,24,11,13
36082,Dardinio,ravencrest,1049,priest,shadow,30,11,19
36083,Вэйворс,blackscar,1048,priest,shadow,22,12,10
36084,Zák,sylvanas,1048,priest,shadow,30,16,14
36085,Sundae,nemesis,1048,priest,shadow,30,11,19
36086,Xatori,arthas,1047,priest,shadow,24,11,13
36087,Zubrowkâ,kazzak,1043,priest,shadow,24,11,13
36088,Missadventur,skullcrusher,1041,priest,shadow,18,11,7
36089,Holypowér,twisting-nether,1041,priest,shadow,24,11,13
36090,Mistaké,the-maelstrom,1039,priest,shadow,42,18,24
36091,Sigor,hellfire,1039,priest,shadow,29,12,17
36092,Atelstan,drakthul,1030,priest,shadow,72,29,43
36093,Umbrazoid,sanguino,1030,priest,shadow,36,11,25
36094,Festiz,tichondrius,1024,priest,shadow,30,14,16
36095,Кинраналь,eversong,1021,priest,shadow,30,17,13
36096,Shdwmeld,ravencrest,1020,priest,shadow,23,11,12
36097,Mimox,kaelthas,1017,priest,shadow,24,14,10
36098,Bodeeney,hellfire,1015,priest,shadow,68,28,40
36099,Shíàpríést,kazzak,1015,priest,shadow,35,11,24
36100,Tarissa,ravenholdt,1008,priest,shadow,24,12,12
36101,Lisua,blackmoore,1008,priest,shadow,48,15,33
36102,Phïljr,ravencrest,1007,priest,shadow,18,11,7
36103,Iceys,stormscale,1005,priest,shadow,17,11,6
36104,Jawoflash,antonidas,1004,priest,shadow,27,12,15
36105,Froffzy,tarren-mill,1002,priest,shadow,30,12,18
36106,Лапушок,borean-tundra,1001,priest,shadow,24,13,11
36107,Fanberra,the-venture-co,1001,priest,shadow,24,11,13
36108,Mydianá,aegwynn,999,priest,shadow,23,14,9
36109,Beellzo,sylvanas,997,priest,shadow,57,21,36
36110,Caballococo,dun-modr,994,priest,shadow,114,50,64
36111,Серебрия,gordunni,991,priest,shadow,63,35,28
36112,Pipen,stormscale,990,priest,shadow,29,11,18
36113,Portvin,terenas,989,priest,shadow,56,21,35
36114,Asdaprice,hellfire,986,priest,shadow,18,12,6
36115,Minabonxx,silvermoon,984,priest,shadow,93,34,59
36116,Zargoss,sylvanas,974,priest,shadow,19,11,8
36117,Мргорсан,eversong,974,priest,shadow,30,16,14
36118,Kasimobbel,alexstrasza,962,priest,shadow,55,16,39
36119,Reimagined,sylvanas,960,priest,shadow,12,10,2
36120,Sinsofmany,ragnaros,960,priest,shadow,12,10,2
36121,Theythem,stormscale,960,priest,shadow,12,10,2
36122,Achára,ravencrest,960,priest,shadow,18,10,8
36123,Cometopastor,skullcrusher,960,priest,shadow,18,10,8
36124,Drë,daggerspine,960,priest,shadow,18,10,8
36125,Peep,emerald-dream,960,priest,shadow,18,10,8
36126,Gbc,emerald-dream,960,priest,shadow,18,10,8
36127,Swl,blackrock,960,priest,shadow,22,11,11
36128,Tribz,kargath,959,priest,shadow,12,10,2
36129,Aiewn,elune,959,priest,shadow,18,12,6
36130,Gwyneth,archimonde,959,priest,shadow,24,14,10
36131,Seankingkong,ravencrest,959,priest,shadow,18,10,8
36132,Ialoricha,dun-modr,959,priest,shadow,18,10,8
36133,Zapreyy,kazzak,959,priest,shadow,18,10,8
36134,Fluffedup,twisting-nether,959,priest,shadow,18,10,8
36135,Goodison,outland,959,priest,shadow,24,10,14
36136,Supriest,alakir,959,priest,shadow,24,10,14
36137,Ciqua,frostmane,958,priest,shadow,16,11,5
36138,Ravenbell,chamber-of-aspects,958,priest,shadow,18,10,8
36139,Diha,argent-dawn,958,priest,shadow,18,10,8
36140,Qiandra,argent-dawn,958,priest,shadow,24,10,14
36141,Seenoend,neptulon,957,priest,shadow,18,10,8
36142,Vo,dentarg,957,priest,shadow,24,10,14
36143,Deshaz,tarren-mill,957,priest,shadow,24,10,14
36144,Taxthepoor,blackhand,955,priest,shadow,24,10,14
36145,Khäñ,ravencrest,955,priest,shadow,36,10,26
36146,Twisty,malganis,953,priest,shadow,26,15,11
36147,Wewo,drakthul,952,priest,shadow,27,11,16
36148,Nekemtenee,magtheridon,951,priest,shadow,18,10,8
36149,Otheym,the-maelstrom,948,priest,shadow,24,10,14
36150,Иннй,howling-fjord,947,priest,shadow,24,11,13
36151,Brainmuscle,ravencrest,945,priest,shadow,12,10,2
36152,Szpinx,stormscale,942,priest,shadow,30,10,20
36153,Эсттелла,gordunni,941,priest,shadow,72,33,39
36154,Ruhoniy,ysondre,934,priest,shadow,30,17,13
36155,Abrakahudder,tarren-mill,927,priest,shadow,17,10,7
36156,Умом,gordunni,927,priest,shadow,26,11,15
36157,Xartasfen,archimonde,926,priest,shadow,20,11,9
36158,Силабездны,deathguard,926,priest,shadow,67,34,33
36159,Aezef,ysondre,926,priest,shadow,26,11,15
36160,Satànâs,twisting-nether,919,priest,shadow,17,10,7
36161,Kloown,conseil-des-ombres,917,priest,shadow,47,24,23
36162,Dayowe,antonidas,916,priest,shadow,166,80,86
36163,Fârge,elune,911,priest,shadow,17,10,7
36164,Csksablanca,sargeras,911,priest,shadow,17,10,7
36165,Priestoll,draenor,911,priest,shadow,21,10,11
36166,Valaç,turalyon,910,priest,shadow,21,10,11
36167,Shaaq,stormscale,905,priest,shadow,12,11,1
36168,Reckpump,twisting-nether,891,priest,shadow,23,10,13
36169,Triinkett,doomhammer,881,priest,shadow,75,31,44
36170,Pneumay,tarren-mill,878,priest,shadow,18,10,8
36171,Clori,argent-dawn,864,priest,shadow,12,9,3
36172,Alinfinito,ravencrest,864,priest,shadow,12,9,3
36173,Tailjob,silvermoon,864,priest,shadow,12,9,3
36174,Raffá,blackhand,864,priest,shadow,12,9,3
36175,Sonah,der-abyssische-rat,864,priest,shadow,12,9,3
36176,Hanyk,kazzak,864,priest,shadow,12,9,3
36177,Anabølixx,ravencrest,864,priest,shadow,12,9,3
36178,Honeydots,ravencrest,864,priest,shadow,12,9,3
36179,Tylb,tarren-mill,864,priest,shadow,12,9,3
36180,Døtgdx,archimonde,864,priest,shadow,12,9,3
36181,Фримекс,soulflayer,864,priest,shadow,12,9,3
36182,Svagis,draenor,864,priest,shadow,18,9,9
36183,Cruncher,ravencrest,864,priest,shadow,18,9,9
36184,Spyrono,kazzak,864,priest,shadow,18,9,9
36185,Felaenna,argent-dawn,864,priest,shadow,18,9,9
36186,Manyus,archimonde,864,priest,shadow,18,9,9
36187,Æåeåeåé,twisting-nether,864,priest,shadow,18,9,9
36188,Brobox,blackmoore,864,priest,shadow,18,9,9
36189,Fjonnski,blackmoore,864,priest,shadow,21,10,11
36190,Ok,blackrock,864,priest,shadow,24,9,15
36191,Schmatzy,blackmoore,864,priest,shadow,24,9,15
36192,Späxxi,amanthul,863,priest,shadow,12,9,3
36193,Pewkz,draenor,863,priest,shadow,12,9,3
36194,Potati,defias-brotherhood,863,priest,shadow,12,9,3
36195,Klayjamin,draenor,863,priest,shadow,12,9,3
36196,Azsaryn,magtheridon,863,priest,shadow,18,9,9
36197,Tygstycke,tarren-mill,863,priest,shadow,18,9,9
36198,Ризорпанда,soulflayer,863,priest,shadow,18,9,9
36199,Txypii,dun-modr,863,priest,shadow,18,9,9
36200,Наярда,howling-fjord,863,priest,shadow,18,9,9
36201,Вайзмейстер,blackscar,863,priest,shadow,18,9,9
36202,Qzrx,outland,863,priest,shadow,18,9,9
36203,Alterspflege,eredar,863,priest,shadow,18,9,9
36204,Prodan,frostmane,862,priest,shadow,12,9,3
36205,Kaleycuoco,blackrock,862,priest,shadow,12,9,3
36206,Skaliq,tarren-mill,862,priest,shadow,12,9,3
36207,Oblivita,twisting-nether,862,priest,shadow,18,9,9
36208,Ilostmybible,runetotem,862,priest,shadow,24,9,15
36209,Aelwïn,ysondre,861,priest,shadow,12,9,3
36210,Dívíne,ravenholdt,861,priest,shadow,12,9,3
36211,Dutchstuff,karazhan,861,priest,shadow,18,9,9
36212,Kavie,ravencrest,861,priest,shadow,18,9,9
36213,Claudefrollo,the-maelstrom,861,priest,shadow,19,9,10
36214,Pristara,bloodhoof,860,priest,shadow,12,9,3
36215,Priëstitute,stormscale,860,priest,shadow,12,9,3
36216,Plimpi,blackmoore,860,priest,shadow,18,9,9
36217,Rèd,antonidas,860,priest,shadow,30,9,21
36218,Kìckurâss,aegwynn,859,priest,shadow,24,9,15
36219,Дроус,borean-tundra,858,priest,shadow,30,12,18
36220,Elfriede,twisting-nether,856,priest,shadow,12,9,3
36221,Farilight,draenor,850,priest,shadow,12,9,3
36222,Ethalia,kirin-tor,849,priest,shadow,18,9,9
36223,Madizuluka,aggra-português,849,priest,shadow,27,10,17
36224,Ftiersp,ravencrest,847,priest,shadow,17,9,8
36225,Trencharse,draenor,845,priest,shadow,23,9,14
36226,Shaddyr,thrall,828,priest,shadow,17,9,8
36227,Endchor,eredar,826,priest,shadow,37,16,21
36228,Happychap,stormreaver,815,priest,shadow,21,9,12
36229,Boomhilde,aegwynn,813,priest,shadow,23,9,14
36230,Stoffig,aggramar,806,priest,shadow,18,9,9
36231,Bäckay,silvermoon,799,priest,shadow,16,9,7
36232,Õðæßìùa,kazzak,799,priest,shadow,17,9,8
36233,Arunp,magtheridon,799,priest,shadow,26,9,17
36234,Alicanx,silvermoon,798,priest,shadow,17,9,8
36235,Deadlymoda,zenedar,797,priest,shadow,20,9,11
36236,Calor,nemesis,792,priest,shadow,16,9,7
36237,Djstache,tarren-mill,768,priest,shadow,12,8,4
36238,Nätrix,tarren-mill,768,priest,shadow,12,8,4
36239,Jynii,eredar,768,priest,shadow,12,8,4
36240,Evílshadows,tarren-mill,768,priest,shadow,12,8,4
36241,Shadowirl,ravencrest,768,priest,shadow,12,8,4
36242,Spriestisbad,hyjal,768,priest,shadow,12,8,4
36243,Ktulsotum,twisting-nether,768,priest,shadow,12,8,4
36244,Notthatbad,draenor,768,priest,shadow,12,8,4
36245,Raëkon,nemesis,768,priest,shadow,12,8,4
36246,Диградейшен,gordunni,768,priest,shadow,12,8,4
36247,Шадоуприст,blackscar,768,priest,shadow,12,8,4
36248,Inavea,hyjal,768,priest,shadow,12,8,4
36249,Strvnge,stormreaver,768,priest,shadow,17,8,9
36250,Hizumi,stormreaver,768,priest,shadow,18,8,10
36251,Ahle,darkspear,768,priest,shadow,18,8,10
36252,Hilerki,draenor,768,priest,shadow,18,8,10
36253,Хелектро,deathweaver,768,priest,shadow,18,8,10
36254,Gomor,mannoroth,768,priest,shadow,18,8,10
36255,Jaanny,defias-brotherhood,768,priest,shadow,18,8,10
36256,Jellypie,blackrock,768,priest,shadow,18,8,10
36257,Джианитто,borean-tundra,767,priest,shadow,12,8,4
36258,Zappikpriest,silvermoon,767,priest,shadow,12,8,4
36259,Holineß,burning-blade,767,priest,shadow,12,8,4
36260,Липоскай,howling-fjord,767,priest,shadow,12,8,4
36261,Septembér,draenor,767,priest,shadow,12,8,4
36262,Бравер,soulflayer,767,priest,shadow,12,8,4
36263,Холиспирт,deathguard,767,priest,shadow,12,8,4
36264,Симпоз,howling-fjord,767,priest,shadow,12,8,4
36265,Leleg,blackhand,767,priest,shadow,15,9,6
36266,Волкановская,eversong,767,priest,shadow,18,8,10
36267,Unreal,nagrand,767,priest,shadow,18,8,10
36268,Marcellina,argent-dawn,767,priest,shadow,18,8,10
36269,Aereza,darkspear,767,priest,shadow,18,8,10
36270,Dimorinny,silvermoon,767,priest,shadow,18,8,10
36271,Urfkncringe,sylvanas,767,priest,shadow,18,8,10
36272,Bigdumber,kazzak,767,priest,shadow,18,8,10
36273,Maela,uldum,767,priest,shadow,18,8,10
36274,Jyugins,alonsus,767,priest,shadow,18,8,10
36275,Xuzilul,antonidas,767,priest,shadow,18,8,10
36276,Priestlolx,aegwynn,767,priest,shadow,24,8,16
36277,Maskinjundre,bronzebeard,767,priest,shadow,24,8,16
36278,Ехереу,blackscar,766,priest,shadow,12,8,4
36279,Kumpi,azjolnerub,766,priest,shadow,12,8,4
36280,Mavaai,burning-legion,766,priest,shadow,12,8,4
36281,Aducanpea,blackmoore,766,priest,shadow,12,8,4
36282,Ihaveibs,doomhammer,766,priest,shadow,19,9,10
36283,Dvärg,ravencrest,766,priest,shadow,18,8,10
36284,Darkmayham,silvermoon,766,priest,shadow,18,8,10
36285,Comptonzity,outland,766,priest,shadow,18,8,10
36286,Ичисанчик,howling-fjord,766,priest,shadow,24,8,16
36287,Derl,pozzo-delleternità,765,priest,shadow,12,8,4
36288,Johnnysp,eredar,765,priest,shadow,12,8,4
36289,Géèk,alakir,765,priest,shadow,19,8,11
36290,Blååb,draenor,765,priest,shadow,24,8,16
36291,Shalnorei,drakthul,764,priest,shadow,12,8,4
36292,Holyface,twisting-nether,764,priest,shadow,12,8,4
36293,Каратэк,howling-fjord,763,priest,shadow,12,8,4
36294,Sammel,moonglade,763,priest,shadow,18,8,10
36295,Zathada,twisting-nether,763,priest,shadow,18,8,10
36296,Ruad,blackrock,762,priest,shadow,12,8,4
36297,Zakkonnik,burning-legion,762,priest,shadow,18,8,10
36298,Лайкшеди,soulflayer,761,priest,shadow,12,8,4
36299,Никорете,soulflayer,759,priest,shadow,18,8,10
36300,Святаятряпка,fordragon,754,priest,shadow,18,8,10
36301,Намдандар,howling-fjord,753,priest,shadow,18,8,10
36302,Treasons,tarren-mill,752,priest,shadow,30,8,22
36303,Barcodes,kazzak,749,priest,shadow,20,9,11
36304,Teleriah,blackmoore,735,priest,shadow,17,8,9
36305,Aeo,twisting-nether,732,priest,shadow,17,8,9
36306,Zennen,ragnaros,720,priest,shadow,19,9,10
36307,Chas,argent-dawn,720,priest,shadow,27,8,19
36308,Nightchime,silvermoon,717,priest,shadow,11,8,3
36309,Nbayoungboy,the-maelstrom,714,priest,shadow,20,10,10
36310,Fathedead,stormreaver,713,priest,shadow,30,10,20
36311,Fleshcraft,ravencrest,703,priest,shadow,14,8,6
36312,Raetwo,stormscale,703,priest,shadow,14,8,6
36313,Манддалорец,gordunni,702,priest,shadow,22,8,14
36314,Reptika,tichondrius,696,priest,shadow,16,8,8
36315,Мараес,howling-fjord,686,priest,shadow,14,8,6
36316,Ðarcø,archimonde,685,priest,shadow,25,8,17
36317,Shendiva,nathrezim,681,priest,shadow,13,8,5
36318,Libstik,hyjal,672,priest,shadow,12,7,5
36319,Uria,moonglade,672,priest,shadow,12,7,5
36320,Deethraa,argent-dawn,672,priest,shadow,12,7,5
36321,Belìal,thrall,672,priest,shadow,12,7,5
36322,Kíguwu,draenor,672,priest,shadow,12,7,5
36323,Vladï,conseil-des-ombres,672,priest,shadow,12,7,5
36324,Миррен,gordunni,672,priest,shadow,12,7,5
36325,Xùÿø,culte-de-la-rive-noire,672,priest,shadow,12,7,5
36326,Azazoth,sylvanas,672,priest,shadow,12,7,5
36327,Cskgbénébéné,garona,672,priest,shadow,12,7,5
36328,Påsøk,stormscale,672,priest,shadow,12,7,5
36329,Roastie,frostmane,672,priest,shadow,12,7,5
36330,Eriezel,shattered-halls,672,priest,shadow,12,7,5
36331,Mcdutchy,arygos,672,priest,shadow,12,7,5
36332,Extazia,ravencrest,672,priest,shadow,12,7,5
36333,Mindboorst,kazzak,672,priest,shadow,12,7,5
36334,Fairylite,outland,672,priest,shadow,12,7,5
36335,Systerstål,twisting-nether,672,priest,shadow,12,7,5
36336,Deform,argent-dawn,672,priest,shadow,12,7,5
36337,Nordrenalin,tarren-mill,672,priest,shadow,12,7,5
36338,Dolens,argent-dawn,672,priest,shadow,12,7,5
36339,Moodzlol,eredar,672,priest,shadow,12,7,5
36340,Laradiel,dun-modr,672,priest,shadow,12,7,5
36341,Stevenfly,outland,672,priest,shadow,12,7,5
36342,Vittelk,stormscale,672,priest,shadow,12,7,5
36343,Leggat,draenor,672,priest,shadow,15,8,7
36344,Рэйам,fordragon,672,priest,shadow,18,7,11
36345,Клаенз,fordragon,672,priest,shadow,18,7,11
36346,Crazyname,outland,672,priest,shadow,18,7,11
36347,Heygoogle,ravencrest,672,priest,shadow,18,7,11
36348,Umayyaa,sylvanas,672,priest,shadow,18,7,11
36349,Majinbuù,sargeras,672,priest,shadow,18,7,11
36350,Irlfatguy,ravencrest,672,priest,shadow,20,7,13
36351,Serayhx,blackrock,672,priest,shadow,24,7,17
36352,Scorbute,conseil-des-ombres,671,priest,shadow,12,7,5
36353,Karnatia,burning-legion,671,priest,shadow,12,7,5
36354,Xæe,blackrock,671,priest,shadow,12,7,5
36355,Слышуфонк,howling-fjord,671,priest,shadow,12,7,5
36356,Мариаглорум,gordunni,671,priest,shadow,12,7,5
36357,Shiekma,norgannon,671,priest,shadow,12,7,5
36358,Neeyø,blackhand,671,priest,shadow,12,7,5
36359,Syntára,blackhand,671,priest,shadow,12,7,5
36360,Kogarrashi,aegwynn,671,priest,shadow,12,7,5
36361,Cryptoniite,kazzak,671,priest,shadow,12,7,5
36362,Elarya,zenedar,671,priest,shadow,12,7,5
36363,Allanna,talnivarr,671,priest,shadow,12,7,5
36364,Badomens,draenor,671,priest,shadow,12,7,5
36365,Bazazath,thrall,671,priest,shadow,15,8,7
36366,Freshpope,ravencrest,671,priest,shadow,16,8,8
36367,Idontmind,eredar,671,priest,shadow,18,7,11
36368,Chaarronn,drakthul,671,priest,shadow,18,7,11
36369,Jerolol,sanguino,671,priest,shadow,18,7,11
36370,Gooflord,ravencrest,671,priest,shadow,18,7,11
36371,Deriont,argent-dawn,671,priest,shadow,18,7,11
36372,Neggan,chamber-of-aspects,671,priest,shadow,18,7,11
36373,Wivienne,defias-brotherhood,671,priest,shadow,26,8,18
36374,Haxxøn,die-nachtwache,670,priest,shadow,12,7,5
36375,Voina,ravencrest,670,priest,shadow,12,7,5
36376,Kitasia,tarren-mill,670,priest,shadow,12,7,5
36377,Hiela,outland,670,priest,shadow,12,7,5
36378,Rétestészta,arathor,670,priest,shadow,12,7,5
36379,Copperplume,ravenholdt,670,priest,shadow,12,7,5
36380,Antigospa,kazzak,670,priest,shadow,18,7,11
36381,Ансин,azuregos,669,priest,shadow,12,7,5
36382,Hotsanddots,auchindoun,668,priest,shadow,12,7,5
36383,Hulluh,tarren-mill,665,priest,shadow,12,7,5
36384,Nerfnerf,kazzak,663,priest,shadow,22,10,12
36385,Redfield,frostmane,663,priest,shadow,24,7,17
36386,Spaghettoni,tarren-mill,662,priest,shadow,12,7,5
36387,Swarzie,outland,653,priest,shadow,17,7,10
36388,Vregoa,twisting-nether,639,priest,shadow,17,7,10
36389,Reeflix,blackmoore,607,priest,shadow,17,8,9
36390,Thudre,ravencrest,606,priest,shadow,14,7,7
36391,Lipzip,twisting-nether,591,priest,shadow,19,7,12
36392,Deadandugly,eredar,576,priest,shadow,6,6,0
36393,Адария,booty-bay,576,priest,shadow,6,6,0
36394,Shacoat,draenor,576,priest,shadow,6,6,0
36395,Viánná,sylvanas,576,priest,shadow,10,7,3
36396,Noggorran,teldrassil,576,priest,shadow,10,7,3
36397,Littlefräu,ravencrest,576,priest,shadow,10,7,3
36398,Yixi,blackmoore,576,priest,shadow,12,6,6
36399,Cluelêss,blackrock,576,priest,shadow,12,6,6
36400,Lilsayx,blackrock,576,priest,shadow,12,6,6
36401,Saliâ,blackmoore,576,priest,shadow,12,6,6
36402,Шучунекошмар,soulflayer,576,priest,shadow,12,6,6
36403,Submeplz,stormscale,576,priest,shadow,12,6,6
36404,Бранлор,howling-fjord,576,priest,shadow,12,6,6
36405,Lovelessp,stormscale,576,priest,shadow,12,6,6
36406,Cocolasticot,garona,576,priest,shadow,12,6,6
36407,Skillmåster,ravencrest,576,priest,shadow,12,6,6
36408,Kunayu,ravencrest,576,priest,shadow,12,6,6
36409,Dakystepmom,stormreaver,576,priest,shadow,12,6,6
36410,Arratør,ysondre,576,priest,shadow,12,6,6
36411,Shadoxx,malganis,576,priest,shadow,12,6,6
36412,Старлайтх,gordunni,576,priest,shadow,12,6,6
36413,Farotep,tarren-mill,576,priest,shadow,12,6,6
36414,Deekon,argent-dawn,576,priest,shadow,12,6,6
36415,Ztrolol,archimonde,576,priest,shadow,12,6,6
36416,Prästjäväln,stormscale,576,priest,shadow,12,6,6
36417,Despéri,ysondre,576,priest,shadow,12,6,6
36418,Gorali,the-venture-co,576,priest,shadow,12,6,6
36419,Toxxjq,sylvanas,576,priest,shadow,12,6,6
36420,Skyfour,blackmoore,576,priest,shadow,12,6,6
36421,Wakizashi,ravencrest,576,priest,shadow,12,6,6
36422,Vogthon,aggra-português,576,priest,shadow,12,6,6
36423,Mephiras,kult-der-verdammten,576,priest,shadow,12,6,6
36424,Cultist,defias-brotherhood,576,priest,shadow,12,6,6
36425,Noreal,twisting-nether,576,priest,shadow,12,6,6
36426,Pepitzaftw,sylvanas,576,priest,shadow,12,6,6
36427,Loldawg,stormscale,576,priest,shadow,12,6,6
36428,Oniakusa,outland,576,priest,shadow,12,6,6
36429,Kraanocska,outland,576,priest,shadow,12,6,6
36430,Fluffieh,ravencrest,576,priest,shadow,12,6,6
36431,Ellfle,kazzak,576,priest,shadow,12,6,6
36432,Grapemachine,dentarg,576,priest,shadow,12,6,6
36433,Dboi,tarren-mill,576,priest,shadow,12,6,6
36434,Сакта,howling-fjord,576,priest,shadow,12,6,6
36435,Sselycrem,dun-morogh,576,priest,shadow,12,6,6
36436,Shadowpdots,sargeras,576,priest,shadow,12,6,6
36437,Vardrium,antonidas,576,priest,shadow,12,6,6
36438,Talandra,drakthul,576,priest,shadow,12,6,6
36439,Landliebe,outland,576,priest,shadow,12,6,6
36440,Balan,argent-dawn,576,priest,shadow,12,6,6
36441,Styxpr,blackhand,576,priest,shadow,18,6,12
36442,Ràvèn,dun-modr,576,priest,shadow,18,6,12
36443,Øro,ysondre,576,priest,shadow,24,6,18
36444,Shendilka,drakthul,575,priest,shadow,9,7,2
36445,Лиройгеморой,gordunni,575,priest,shadow,12,6,6
36446,Silverfate,outland,575,priest,shadow,12,6,6
36447,Torquemad,sunstrider,575,priest,shadow,12,6,6
36448,Bigorna,frostmane,575,priest,shadow,12,6,6
36449,Sliey,blackrock,575,priest,shadow,12,6,6
36450,Mariosee,wrathbringer,575,priest,shadow,12,6,6
36451,Bozia,chamber-of-aspects,575,priest,shadow,12,6,6
36452,Attaxx,dragonmaw,575,priest,shadow,12,6,6
36453,Нитровина,howling-fjord,575,priest,shadow,12,6,6
36454,Princéssà,aegwynn,575,priest,shadow,12,6,6
36455,Husqvarnasåg,tarren-mill,575,priest,shadow,21,7,14
36456,Wintercurse,twisting-nether,575,priest,shadow,18,6,12
36457,Булькозавр,razuvious,574,priest,shadow,12,6,6
36458,Luxumbra,pozzo-delleternità,574,priest,shadow,12,6,6
36459,Azshanna,argent-dawn,574,priest,shadow,12,6,6
36460,Sacreth,ragnaros,574,priest,shadow,24,6,18
36461,Zerim,blackmoore,574,priest,shadow,24,6,18
36462,Сендрагон,blackscar,572,priest,shadow,18,6,12
36463,Karmapollys,silvermoon,570,priest,shadow,12,6,6
36464,Karabin,culte-de-la-rive-noire,558,priest,shadow,18,6,12
36465,Notcute,the-maelstrom,543,priest,shadow,11,6,5
36466,Anshes,draenor,537,priest,shadow,10,7,3
36467,Lildiggy,outland,511,priest,shadow,14,6,8
36468,Нудная,galakrond,511,priest,shadow,16,6,10
36469,Genjorss,pozzo-delleternità,480,priest,shadow,6,5,1
36470,Arondir,defias-brotherhood,480,priest,shadow,6,5,1
36471,Graveyards,tarren-mill,480,priest,shadow,6,5,1
36472,Darkqt,ravencrest,480,priest,shadow,6,5,1
36473,Disillusíon,tarren-mill,480,priest,shadow,6,5,1
36474,Скизма,gordunni,480,priest,shadow,6,5,1
36475,Qiguai,outland,480,priest,shadow,6,5,1
36476,Fabulicious,blackrock,480,priest,shadow,6,5,1
36477,Gladíator,blackhand,480,priest,shadow,6,5,1
36478,Rinkahands,silvermoon,480,priest,shadow,6,5,1
36479,Easyc,gorgonnash,480,priest,shadow,6,5,1
36480,Pâww,kazzak,480,priest,shadow,6,5,1
36481,Зоргдаркнесс,howling-fjord,480,priest,shadow,6,5,1
36482,Attilerg,stormscale,480,priest,shadow,6,5,1
36483,Zeawee,frostmane,480,priest,shadow,6,5,1
36484,Алуриэлия,gordunni,480,priest,shadow,6,5,1
36485,Nøskillzz,nemesis,480,priest,shadow,6,5,1
36486,Boniesmack,stormscale,480,priest,shadow,6,5,1
36487,Harkøn,draenor,480,priest,shadow,6,5,1
36488,Qúetee,silvermoon,480,priest,shadow,10,6,4
36489,Korzec,dun-modr,480,priest,shadow,12,5,7
36490,Lyssandre,stormreaver,480,priest,shadow,12,5,7
36491,Singularity,ravencrest,480,priest,shadow,12,5,7
36492,Mondiie,drakthul,480,priest,shadow,12,5,7
36493,Дакимакурах,gordunni,480,priest,shadow,12,5,7
36494,Shadowful,drakthul,480,priest,shadow,12,5,7
36495,Frv,tarren-mill,480,priest,shadow,12,5,7
36496,Kidkuddo,blackmoore,480,priest,shadow,12,5,7
36497,Megadima,norgannon,480,priest,shadow,12,5,7
36498,Jarkk,ysondre,480,priest,shadow,12,5,7
36499,Löspajen,stormscale,480,priest,shadow,12,5,7
36500,Darkmus,quelthalas,480,priest,shadow,12,5,7
36501,Tokkz,kelthuzad,480,priest,shadow,12,5,7
36502,Prayypray,eredar,480,priest,shadow,12,5,7
36503,Stickyjamxx,frostmane,480,priest,shadow,12,5,7
36504,Neverfade,dun-modr,480,priest,shadow,12,5,7
36505,Rovensin,ravencrest,480,priest,shadow,12,5,7
36506,Sheerzo,twisting-nether,480,priest,shadow,12,5,7
36507,Xpy,kazzak,480,priest,shadow,12,5,7
36508,Mahist,ravencrest,480,priest,shadow,12,5,7
36509,Bonsoin,kirin-tor,480,priest,shadow,12,5,7
36510,Rokil,ravencrest,480,priest,shadow,12,5,7
36511,Appraiser,draenor,480,priest,shadow,12,5,7
36512,Lillclubbina,stormscale,480,priest,shadow,12,5,7
36513,Taikki,stormreaver,480,priest,shadow,12,5,7
36514,Qwertyuioasd,ravencrest,480,priest,shadow,12,5,7
36515,Cmonbro,hyjal,480,priest,shadow,12,5,7
36516,Shadowleech,ragnaros,480,priest,shadow,12,5,7
36517,Dpyo,ravencrest,480,priest,shadow,12,5,7
36518,Svenskabarn,twisting-nether,480,priest,shadow,12,5,7
36519,Raeratwo,archimonde,480,priest,shadow,12,5,7
36520,Drakharys,dun-modr,480,priest,shadow,12,5,7
36521,Хенели,blackscar,480,priest,shadow,12,5,7
36522,Elixier,frostmane,480,priest,shadow,12,5,7
36523,Haiduka,burning-legion,480,priest,shadow,12,5,7
36524,Môrtïciâ,tarren-mill,480,priest,shadow,12,5,7
36525,Rexonaqq,kazzak,480,priest,shadow,12,5,7
36526,Darrianna,outland,480,priest,shadow,12,5,7
36527,Chibz,twisting-nether,480,priest,shadow,18,5,13
36528,Moogie,archimonde,480,priest,shadow,18,5,13
36529,Блэксикер,greymane,479,priest,shadow,12,5,7
36530,Heinricht,ragnaros,479,priest,shadow,12,5,7
36531,Rehpotsirhc,blackrock,479,priest,shadow,12,5,7
36532,Tøucher,silvermoon,479,priest,shadow,12,5,7
36533,Xieraxe,ravencrest,479,priest,shadow,12,5,7
36534,Tronixcs,boulderfist,479,priest,shadow,12,5,7
36535,Gimcho,magtheridon,479,priest,shadow,12,5,7
36536,Балзик,blackscar,479,priest,shadow,12,5,7
36537,Лейля,goldrinn,479,priest,shadow,18,5,13
36538,Falbäla,suramar,473,priest,shadow,12,5,7
36539,Wàks,dalaran,463,priest,shadow,11,6,5
36540,Chïefpapi,twisting-nether,463,priest,shadow,11,5,6
36541,Дзинкз,howling-fjord,448,priest,shadow,10,6,4
36542,Sàd,thrall,447,priest,shadow,11,5,6
36543,Kuusistöö,kazzak,430,priest,shadow,13,6,7
36544,Bloodimand,terenas,422,priest,shadow,12,6,6
36545,Elderath,eredar,409,priest,shadow,23,6,17
36546,Grainbames,sylvanas,384,priest,shadow,6,4,2
36547,Goldenapples,ravencrest,384,priest,shadow,6,4,2
36548,Lysium,sylvanas,384,priest,shadow,6,4,2
36549,Looó,los-errantes,384,priest,shadow,6,4,2
36550,Virtualworld,ragnaros,384,priest,shadow,6,4,2
36551,Stonymontana,ravencrest,384,priest,shadow,6,4,2
36552,Majestíc,blackmoore,384,priest,shadow,6,4,2
36553,Pinkfloydx,lightbringer,384,priest,shadow,6,4,2
36554,Høly,chogall,384,priest,shadow,6,4,2
36555,Вэстервилли,howling-fjord,384,priest,shadow,6,4,2
36556,Atropin,silvermoon,384,priest,shadow,6,4,2
36557,Олдмэнсэйд,soulflayer,384,priest,shadow,6,4,2
36558,Éllipses,kazzak,384,priest,shadow,6,4,2
36559,Jdotp,silvermoon,384,priest,shadow,6,4,2
36560,Floodey,defias-brotherhood,384,priest,shadow,6,4,2
36561,Daftî,twisting-nether,384,priest,shadow,6,4,2
36562,Dokurochan,tarren-mill,384,priest,shadow,6,4,2
36563,Napriest,kazzak,384,priest,shadow,6,4,2
36564,Xxon,blackrock,384,priest,shadow,6,4,2
36565,Viperbites,tarren-mill,384,priest,shadow,6,4,2
36566,Ylenae,twisting-nether,384,priest,shadow,6,4,2
36567,Awator,ysondre,384,priest,shadow,6,4,2
36568,Rutah,the-maelstrom,384,priest,shadow,6,4,2
36569,Lxz,twisting-nether,384,priest,shadow,6,4,2
36570,Sekeios,sanguino,384,priest,shadow,6,4,2
36571,Alicanx,twisting-nether,384,priest,shadow,6,4,2
36572,Shadowboness,twisting-nether,384,priest,shadow,6,4,2
36573,Spae,twisting-nether,384,priest,shadow,6,4,2
36574,Clungeslag,argent-dawn,384,priest,shadow,6,4,2
36575,Lorthonor,silvermoon,384,priest,shadow,6,4,2
36576,Chamelthoe,the-maelstrom,384,priest,shadow,6,4,2
36577,Usw,outland,384,priest,shadow,6,4,2
36578,Трихоманиаз,ashenvale,384,priest,shadow,6,4,2
36579,Текл,blackscar,384,priest,shadow,6,4,2
36580,Nebunia,twisting-nether,384,priest,shadow,6,4,2
36581,Cheryli,alleria,384,priest,shadow,6,4,2
36582,Àæn,blackrock,384,priest,shadow,6,4,2
36583,Torino,kazzak,384,priest,shadow,6,4,2
36584,Coqa,blackrock,384,priest,shadow,6,4,2
36585,Mønzie,stormscale,384,priest,shadow,6,4,2
36586,Secretagentx,kazzak,384,priest,shadow,6,4,2
36587,Mysticforces,silvermoon,384,priest,shadow,6,4,2
36588,Jpxoxo,blackhand,384,priest,shadow,6,4,2
36589,Dairox,blackrock,384,priest,shadow,6,4,2
36590,Kobiden,stormreaver,384,priest,shadow,6,4,2
36591,Pharli,stormscale,384,priest,shadow,6,4,2
36592,Temtem,ravencrest,384,priest,shadow,6,4,2
36593,Tøm,silvermoon,384,priest,shadow,6,4,2
36594,Lumex,aegwynn,384,priest,shadow,6,4,2
36595,Calsote,sanguino,384,priest,shadow,6,4,2
36596,Sheid,zuljin,384,priest,shadow,6,4,2
36597,Hotdoge,zenedar,384,priest,shadow,6,4,2
36598,Alusiepriest,ravencrest,384,priest,shadow,6,4,2
36599,Vantek,antonidas,384,priest,shadow,6,4,2
36600,Metabeta,shattered-hand,384,priest,shadow,6,4,2
36601,Syrïal,hyjal,384,priest,shadow,6,4,2
36602,Arwen,azjolnerub,384,priest,shadow,6,4,2
36603,Êlectron,ravencrest,384,priest,shadow,6,4,2
36604,Torpedobæver,silvermoon,384,priest,shadow,6,4,2
36605,Spum,ravencrest,384,priest,shadow,6,4,2
36606,Thogrey,archimonde,384,priest,shadow,6,4,2
36607,Nálá,nethersturm,384,priest,shadow,6,4,2
36608,Pangoffy,burning-legion,384,priest,shadow,6,4,2
36609,Jesuispasbon,hyjal,384,priest,shadow,6,4,2
36610,Nìak,ysondre,384,priest,shadow,15,5,10
36611,Xaphen,kirin-tor,384,priest,shadow,12,4,8
36612,Арлектакль,blackscar,384,priest,shadow,12,4,8
36613,Darkoze,kazzak,384,priest,shadow,12,4,8
36614,Zaoza,dentarg,384,priest,shadow,12,4,8
36615,Skilled,stormscale,384,priest,shadow,12,4,8
36616,Fùkøff,stormscale,384,priest,shadow,12,4,8
36617,Dellarien,stormscale,384,priest,shadow,12,4,8
36618,Crimatoriá,rajaxx,384,priest,shadow,12,4,8
36619,Gerase,blackrock,384,priest,shadow,12,4,8
36620,Dotmaster,darkspear,384,priest,shadow,12,4,8
36621,Voidknight,darkspear,384,priest,shadow,12,4,8
36622,Xalgâzor,zuljin,384,priest,shadow,12,4,8
36623,Созвонимся,gordunni,384,priest,shadow,12,4,8
36624,Æro,malganis,384,priest,shadow,12,4,8
36625,Râây,blackrock,384,priest,shadow,12,4,8
36626,Preodek,kazzak,384,priest,shadow,12,4,8
36627,Lfgarcatraz,aegwynn,384,priest,shadow,12,4,8
36628,Obscurity,burning-steppes,384,priest,shadow,12,4,8
36629,Dpriesta,aegwynn,384,priest,shadow,12,4,8
36630,Datscrazi,ravencrest,384,priest,shadow,12,4,8
36631,Shadøwz,grim-batol,384,priest,shadow,12,4,8
36632,Elpsycongoro,aegwynn,384,priest,shadow,12,4,8
36633,Swoptoplong,blackhand,384,priest,shadow,12,4,8
36634,Oggiz,archimonde,384,priest,shadow,12,4,8
36635,Kirtách,dun-modr,384,priest,shadow,12,4,8
36636,Niikki,blackrock,384,priest,shadow,12,4,8
36637,Morzâr,outland,384,priest,shadow,12,4,8
36638,Thyrena,twisting-nether,384,priest,shadow,12,4,8
36639,Bilalhassâni,archimonde,384,priest,shadow,12,4,8
36640,Baubsy,ghostlands,384,priest,shadow,12,4,8
36641,Ларчшп,gordunni,384,priest,shadow,12,4,8
36642,Самоэль,gordunni,384,priest,shadow,12,4,8
36643,Bacovia,tarren-mill,384,priest,shadow,12,4,8
36644,Gonorreolga,tarren-mill,384,priest,shadow,12,4,8
36645,Phycobabe,sylvanas,384,priest,shadow,12,4,8
36646,Shroomza,blackmoore,384,priest,shadow,12,4,8
36647,Chlorohhkine,chogall,384,priest,shadow,13,4,9
36648,Iamshadow,blackrock,384,priest,shadow,17,4,13
36649,Tobirama,stormscale,384,priest,shadow,17,4,13
36650,Абрасд,gordunni,384,priest,shadow,18,4,14
36651,Infliction,auchindoun,384,priest,shadow,18,4,14
36652,Словаболь,gordunni,383,priest,shadow,6,4,2
36653,Abnórmus,tarren-mill,383,priest,shadow,6,4,2
36654,Newik,burning-legion,383,priest,shadow,6,4,2
36655,Orochimaruh,pozzo-delleternità,383,priest,shadow,6,4,2
36656,Хароки,howling-fjord,383,priest,shadow,6,4,2
36657,Darettii,blackrock,383,priest,shadow,7,4,3
36658,Exörcíst,outland,383,priest,shadow,9,5,4
36659,Shikamarudmx,burning-legion,383,priest,shadow,15,5,10
36660,Sphard,ysondre,383,priest,shadow,12,4,8
36661,Perchédue,silvermoon,367,priest,shadow,11,4,7
36662,Llounal,silvermoon,351,priest,shadow,11,4,7
36663,Levitating,argent-dawn,336,priest,shadow,9,5,4
36664,Tweediertie,argent-dawn,335,priest,shadow,11,4,7
36665,Prìestìalìty,draenor,330,priest,shadow,11,6,5
36666,Verbs,kazzak,330,priest,shadow,15,5,10
36667,Zetara,archimonde,320,priest,shadow,10,4,6
36668,Shagoku,blackmoore,319,priest,shadow,8,4,4
36669,Флэнсер,soulflayer,288,priest,shadow,6,3,3
36670,Canthms,twisting-nether,288,priest,shadow,6,3,3
36671,Wizarxmentar,stormscale,288,priest,shadow,6,3,3
36672,Papynou,garona,288,priest,shadow,6,3,3
36673,Hollywoôd,draenor,288,priest,shadow,6,3,3
36674,Злыденькая,gordunni,288,priest,shadow,6,3,3
36675,Lutzki,the-maelstrom,288,priest,shadow,6,3,3
36676,Skymning,tarren-mill,288,priest,shadow,6,3,3
36677,Slight,aggra-português,288,priest,shadow,6,3,3
36678,Неприст,ashenvale,288,priest,shadow,6,3,3
36679,Imadîa,dalaran,288,priest,shadow,6,3,3
36680,Cloudfactory,ravencrest,288,priest,shadow,6,3,3
36681,Prastas,archimonde,288,priest,shadow,6,3,3
36682,Lethaa,twisting-nether,288,priest,shadow,6,3,3
36683,Voidkäfer,ravencrest,288,priest,shadow,6,3,3
36684,Syntara,twisting-nether,288,priest,shadow,6,3,3
36685,Eldrathir,burning-legion,288,priest,shadow,6,3,3
36686,Mysticks,kirin-tor,288,priest,shadow,6,3,3
36687,Lirrydoz,ravencrest,288,priest,shadow,6,3,3
36688,Discmaskinen,aggramar,288,priest,shadow,6,3,3
36689,Деняприст,gordunni,288,priest,shadow,6,3,3
36690,Smerenia,tarren-mill,288,priest,shadow,6,3,3
36691,Zzoska,burning-legion,288,priest,shadow,6,3,3
36692,Whýççpèrx,ravencrest,288,priest,shadow,6,3,3
36693,Дюрэкс,soulflayer,288,priest,shadow,6,3,3
36694,Hélp,stormscale,288,priest,shadow,6,3,3
36695,Gstah,taerar,288,priest,shadow,6,3,3
36696,Taklamakan,alakir,288,priest,shadow,6,3,3
36697,Kallsen,ravencrest,288,priest,shadow,6,3,3
36698,Thimble,blackhand,288,priest,shadow,6,3,3
36699,Miikkap,blackhand,288,priest,shadow,6,3,3
36700,Byzzi,draenor,288,priest,shadow,6,3,3
36701,Yazh,argent-dawn,288,priest,shadow,6,3,3
36702,Wkid,draenor,288,priest,shadow,6,3,3
36703,Trinnity,drakthul,288,priest,shadow,6,3,3
36704,Stinkycreep,executus,288,priest,shadow,6,3,3
36705,Aéltess,kirin-tor,288,priest,shadow,6,3,3
36706,Ksiadzrydzyk,draenor,288,priest,shadow,6,3,3
36707,Holybestie,eredar,288,priest,shadow,6,3,3
36708,Roxfer,ysondre,288,priest,shadow,6,3,3
36709,Dunkelseele,ahnqiraj,288,priest,shadow,6,3,3
36710,Fionsacré,archimonde,288,priest,shadow,6,3,3
36711,Shannannanna,darkspear,288,priest,shadow,6,3,3
36712,Grimer,talnivarr,288,priest,shadow,6,3,3
36713,Нечавкай,deathweaver,288,priest,shadow,6,3,3
36714,Resgan,archimonde,288,priest,shadow,6,3,3
36715,Забвениеждёт,gordunni,288,priest,shadow,6,3,3
36716,Ragwitch,draenor,288,priest,shadow,6,3,3
36717,Vampiro,blackhand,288,priest,shadow,6,3,3
36718,Grootts,burning-blade,288,priest,shadow,6,3,3
36719,Gesees,ravencrest,288,priest,shadow,6,3,3
36720,Vividots,draenor,288,priest,shadow,6,3,3
36721,Susaj,tarren-mill,288,priest,shadow,6,3,3
36722,Worwp,burning-blade,288,priest,shadow,6,3,3
36723,Noskillzz,nemesis,288,priest,shadow,6,3,3
36724,Linara,frostmane,288,priest,shadow,6,3,3
36725,Yukíø,antonidas,288,priest,shadow,6,3,3
36726,Salzgehalt,antonidas,288,priest,shadow,6,3,3
36727,Sofuny,neptulon,288,priest,shadow,6,3,3
36728,Nhajÿ,hyjal,288,priest,shadow,6,3,3
36729,Sanctimo,stormscale,288,priest,shadow,6,3,3
36730,Zøid,ysondre,288,priest,shadow,6,3,3
36731,Пристотян,gordunni,288,priest,shadow,6,3,3
36732,Stepsisstuck,ragnaros,288,priest,shadow,6,3,3
36733,Notra,shattrath,288,priest,shadow,6,3,3
36734,Shasdöw,hyjal,288,priest,shadow,6,3,3
36735,Runristad,ravencrest,288,priest,shadow,6,3,3
36736,Смегмачет,soulflayer,288,priest,shadow,6,3,3
36737,Neopriest,stormscale,288,priest,shadow,6,3,3
36738,Sweedensp,hyjal,288,priest,shadow,6,3,3
36739,Eyvvah,twisting-nether,288,priest,shadow,6,3,3
36740,Sàyaa,draenor,288,priest,shadow,6,3,3
36741,Liliashet,sanguino,288,priest,shadow,6,3,3
36742,Grocx,kazzak,288,priest,shadow,6,3,3
36743,Mgx,defias-brotherhood,288,priest,shadow,6,3,3
36744,Plagegeist,blutkessel,288,priest,shadow,6,3,3
36745,Freezydot,silvermoon,288,priest,shadow,6,3,3
36746,Xaviá,blackrock,288,priest,shadow,6,3,3
36747,Drynte,blackmoore,288,priest,shadow,6,3,3
36748,Snoopydawgs,blackmoore,288,priest,shadow,6,3,3
36749,Bhlad,silvermoon,288,priest,shadow,6,3,3
36750,Cðsima,blackmoore,288,priest,shadow,6,3,3
36751,Averye,kazzak,288,priest,shadow,6,3,3
36752,Kilmmiis,defias-brotherhood,288,priest,shadow,6,3,3
36753,Chuckbarry,kazzak,288,priest,shadow,6,3,3
36754,Chandria,veknilash,288,priest,shadow,6,3,3
36755,Voilencia,kazzak,288,priest,shadow,6,3,3
36756,Pbwser,silvermoon,288,priest,shadow,6,3,3
36757,Ggsus,outland,288,priest,shadow,6,3,3
36758,Nahtod,blackmoore,288,priest,shadow,6,3,3
36759,Lexivenera,silvermoon,288,priest,shadow,6,3,3
36760,Covidisc,outland,288,priest,shadow,6,3,3
36761,Nitza,silvermoon,288,priest,shadow,6,3,3
36762,Poonies,silvermoon,288,priest,shadow,6,3,3
36763,Presbyter,mazrigos,288,priest,shadow,6,3,3
36764,Hasnaa,silvermoon,288,priest,shadow,6,3,3
36765,Elreâ,blackrock,288,priest,shadow,6,3,3
36766,Momet,defias-brotherhood,288,priest,shadow,6,3,3
36767,Xotz,thrall,288,priest,shadow,6,3,3
36768,Abyssonmind,dun-modr,288,priest,shadow,6,3,3
36769,Sîçkzømßiê,kazzak,288,priest,shadow,6,3,3
36770,Cé,magtheridon,288,priest,shadow,6,3,3
36771,Kopfsache,blackmoore,288,priest,shadow,7,3,4
36772,Kåstå,archimonde,288,priest,shadow,11,3,8
36773,Amaretta,perenolde,288,priest,shadow,12,3,9
36774,Elumi,the-maelstrom,288,priest,shadow,12,3,9
36775,Aaluvor,blackmoore,288,priest,shadow,12,3,9
36776,Xrystal,wrathbringer,288,priest,shadow,12,3,9
36777,Shreedz,blackmoore,288,priest,shadow,12,3,9
36778,Anariell,ravencrest,288,priest,shadow,12,3,9
36779,Preast,aegwynn,288,priest,shadow,12,3,9
36780,Goldische,dun-morogh,288,priest,shadow,12,3,9
36781,Supermacy,eredar,288,priest,shadow,12,3,9
36782,Hâstur,ravencrest,288,priest,shadow,12,3,9
36783,Nesar,stormscale,288,priest,shadow,12,3,9
36784,Powergodz,exodar,288,priest,shadow,12,3,9
36785,Øzya,kirin-tor,288,priest,shadow,12,3,9
36786,Kaenlin,the-maelstrom,288,priest,shadow,18,3,15
36787,Jês,thrall,287,priest,shadow,6,3,3
36788,Rulna,die-aldor,287,priest,shadow,12,3,9
36789,Irrtum,nozdormu,286,priest,shadow,6,3,3
36790,Nuger,tarren-mill,286,priest,shadow,6,3,3
36791,Жруля,ashenvale,286,priest,shadow,18,3,15
36792,Czikibriki,ravenholdt,256,priest,shadow,4,4,0
36793,Shadepencoin,silvermoon,256,priest,shadow,10,3,7
36794,Szelén,ragnaros,256,priest,shadow,10,3,7
36795,Бледноват,ashenvale,255,priest,shadow,8,4,4
36796,Guccimaane,twisting-nether,239,priest,shadow,5,3,2
36797,Herro,thrall,239,priest,shadow,5,3,2
36798,Caski,stormreaver,239,priest,shadow,5,3,2
36799,Deeforce,argent-dawn,234,priest,shadow,6,4,2
36800,Фьюриреидж,soulflayer,234,priest,shadow,8,4,4
36801,Ainoa,grim-batol,234,priest,shadow,9,4,5
36802,Coffíndodger,magtheridon,192,priest,shadow,4,3,1
36803,Shadowflamè,outland,192,priest,shadow,4,3,1
36804,Szycho,burning-legion,192,priest,shadow,9,3,6
36805,Priath,magtheridon,192,priest,shadow,6,2,4
36806,Misántropo,dun-modr,192,priest,shadow,6,2,4
36807,Жрецдуши,gordunni,192,priest,shadow,6,2,4
36808,Calïxløve,der-rat-von-dalaran,192,priest,shadow,6,2,4
36809,Illordz,nemesis,192,priest,shadow,6,2,4
36810,Shokkapriest,draenor,192,priest,shadow,6,2,4
36811,Andérsón,magtheridon,192,priest,shadow,6,2,4
36812,Lugburzz,draenor,192,priest,shadow,6,2,4
36813,Phobò,antonidas,192,priest,shadow,6,2,4
36814,Шарадин,gordunni,192,priest,shadow,6,2,4
36815,Шестьнадцать,gordunni,192,priest,shadow,6,2,4
36816,Нефрида,gordunni,192,priest,shadow,6,2,4
36817,Jarnary,blackmoore,192,priest,shadow,6,2,4
36818,Kharòn,grim-batol,192,priest,shadow,6,2,4
36819,Amáni,die-aldor,192,priest,shadow,6,2,4
36820,Madpandax,blackmoore,192,priest,shadow,6,2,4
36821,Helheïm,chants-éternels,192,priest,shadow,6,2,4
36822,Zootx,magtheridon,192,priest,shadow,6,2,4
36823,Безмездная,gordunni,192,priest,shadow,6,2,4
36824,Дашажмитучу,howling-fjord,192,priest,shadow,6,2,4
36825,Makemyday,dun-modr,192,priest,shadow,6,2,4
36826,Omejan,frostmane,192,priest,shadow,6,2,4
36827,Встанислав,gordunni,192,priest,shadow,6,2,4
36828,Crzzy,dun-modr,192,priest,shadow,6,2,4
36829,Zikár,kazzak,192,priest,shadow,6,2,4
36830,Сорвиголов,howling-fjord,192,priest,shadow,6,2,4
36831,Bandgap,antonidas,192,priest,shadow,6,2,4
36832,Yugata,archimonde,192,priest,shadow,6,2,4
36833,Putoeinstein,sylvanas,192,priest,shadow,6,2,4
36834,Keijuna,kazzak,192,priest,shadow,6,2,4
36835,Getitoffme,auchindoun,192,priest,shadow,6,2,4
36836,Lythra,burning-legion,192,priest,shadow,6,2,4
36837,Harleyquiñ,burning-legion,192,priest,shadow,6,2,4
36838,Elthrone,kazzak,192,priest,shadow,6,2,4
36839,Ompala,shattered-hand,192,priest,shadow,6,2,4
36840,Сайннз,howling-fjord,192,priest,shadow,6,2,4
36841,Pleshiv,sanguino,192,priest,shadow,6,2,4
36842,Sotriggered,sylvanas,192,priest,shadow,6,2,4
36843,Mømmymilkers,archimonde,192,priest,shadow,6,2,4
36844,Abî,frostwolf,192,priest,shadow,6,2,4
36845,Ximenia,eredar,192,priest,shadow,6,2,4
36846,Nõlîfer,archimonde,192,priest,shadow,6,2,4
36847,Ørbänvîktôrx,ragnaros,192,priest,shadow,6,2,4
36848,Xaeroow,archimonde,192,priest,shadow,6,2,4
36849,Voidgasm,kazzak,192,priest,shadow,6,2,4
36850,Периссвет,thermaplugg,192,priest,shadow,6,2,4
36851,Øxyzën,marécage-de-zangar,192,priest,shadow,6,2,4
36852,Oknelim,blackmoore,192,priest,shadow,6,2,4
36853,Elëctra,vashj,192,priest,shadow,6,2,4
36854,Hayvo,blackmoore,192,priest,shadow,6,2,4
36855,Grimor,talnivarr,192,priest,shadow,6,2,4
36856,Gidy,blackmoore,192,priest,shadow,6,2,4
36857,Ðex,chromaggus,192,priest,shadow,6,2,4
36858,Holycrapx,chromaggus,192,priest,shadow,6,2,4
36859,Våfflán,silvermoon,192,priest,shadow,6,2,4
36860,Cto,gorgonnash,192,priest,shadow,6,2,4
36861,Yshaarjy,silvermoon,192,priest,shadow,6,2,4
36862,Hans,thrall,192,priest,shadow,6,2,4
36863,Funstopshere,ravencrest,192,priest,shadow,6,2,4
36864,Tuljan,twisting-nether,192,priest,shadow,6,2,4
36865,Wiglere,argent-dawn,192,priest,shadow,6,2,4
36866,Vengigodxx,ravencrest,192,priest,shadow,6,2,4
36867,Piizzdiica,twisting-nether,192,priest,shadow,6,2,4
36868,Lollithu,argent-dawn,192,priest,shadow,6,2,4
36869,Sïfën,tarren-mill,192,priest,shadow,6,2,4
36870,Ràthaløs,sanguino,192,priest,shadow,6,2,4
36871,Velansera,argent-dawn,192,priest,shadow,6,2,4
36872,Alpharîus,argent-dawn,192,priest,shadow,6,2,4
36873,Несущийсерп,soulflayer,192,priest,shadow,6,2,4
36874,Гундяй,soulflayer,192,priest,shadow,6,2,4
36875,Bòóny,ravencrest,192,priest,shadow,6,2,4
36876,Wsp,tarren-mill,192,priest,shadow,6,2,4
36877,Шиписс,soulflayer,192,priest,shadow,6,2,4
36878,Hadsup,stormscale,192,priest,shadow,6,2,4
36879,Aruna,ravencrest,192,priest,shadow,6,2,4
36880,Eosar,blackhand,192,priest,shadow,6,2,4
36881,Avowed,stormscale,192,priest,shadow,6,2,4
36882,Joezero,the-maelstrom,192,priest,shadow,6,2,4
36883,Voidreaver,stormscale,192,priest,shadow,6,2,4
36884,Turah,the-maelstrom,192,priest,shadow,6,2,4
36885,Deternity,stormscale,192,priest,shadow,6,2,4
36886,Rustyroll,stormscale,192,priest,shadow,6,2,4
36887,Clemexyo,stormscale,192,priest,shadow,6,2,4
36888,Reïny,tarren-mill,192,priest,shadow,6,2,4
36889,Notdespo,kazzak,192,priest,shadow,6,2,4
36890,Nomarak,drakthul,192,priest,shadow,6,2,4
36891,Lèviåthån,stormscale,192,priest,shadow,6,2,4
36892,Shmoly,stormscale,192,priest,shadow,6,2,4
36893,Esthea,malganis,192,priest,shadow,6,2,4
36894,Daven,ysondre,192,priest,shadow,6,2,4
36895,Wasgehtjungs,blackrock,192,priest,shadow,6,2,4
36896,Zaop,blackhand,192,priest,shadow,6,2,4
36897,Kaleshiry,kazzak,192,priest,shadow,6,2,4
36898,Fqú,wrathbringer,192,priest,shadow,6,2,4
36899,Purplereign,stormscale,192,priest,shadow,6,2,4
36900,Sephìrøth,malganis,192,priest,shadow,6,2,4
36901,Rallzken,stormscale,192,priest,shadow,6,2,4
36902,Madclownz,blackrock,192,priest,shadow,6,2,4
36903,Chekkó,blackrock,192,priest,shadow,6,2,4
36904,Siezlababo,blackrock,192,priest,shadow,6,2,4
36905,Shalacho,blackrock,192,priest,shadow,6,2,4
36906,Бихар,gordunni,192,priest,shadow,10,2,8
36907,Awcute,kazzak,192,priest,shadow,12,2,10
36908,Господствуй,gordunni,192,priest,shadow,12,2,10
36909,Wortmonster,malganis,192,priest,shadow,12,2,10
36910,Hûndling,blackrock,192,priest,shadow,12,2,10
36911,Noir,nemesis,192,priest,shadow,12,2,10
36912,Anglaran,hellscream,192,priest,shadow,12,2,10
36913,Andorelya,blackhand,191,priest,shadow,6,2,4
36914,Luziz,blackmoore,159,priest,shadow,5,2,3
36915,Girlidlion,twisting-nether,159,priest,shadow,5,2,3
36916,Qku,ravencrest,144,priest,shadow,9,3,6
36917,Føxy,emerald-dream,138,priest,shadow,7,3,4
36918,Alswynn,draenor,138,priest,shadow,13,3,10
36919,Yologrumples,tarren-mill,128,priest,shadow,4,2,2
36920,Heeyø,drakthul,128,priest,shadow,4,2,2
36921,Vampirski,kazzak,96,priest,shadow,3,2,1
36922,Aureï,khaz-modan,96,priest,shadow,3,2,1
36923,Slitenprest,kazzak,96,priest,shadow,6,2,4
36924,Beckett,outland,96,priest,shadow,6,1,5
36925,Arliston,draenor,96,priest,shadow,6,1,5
36926,Bij,outland,96,priest,shadow,6,1,5
36927,Prostamolle,conseil-des-ombres,96,priest,shadow,6,1,5
36928,Izarath,outland,96,priest,shadow,6,1,5
36929,Попячебрило,gordunni,96,priest,shadow,6,1,5
36930,Radenox,stormscale,96,priest,shadow,6,1,5
36931,Corefusion,blackrock,96,priest,shadow,6,1,5
36932,Deicidex,blackrock,96,priest,shadow,6,1,5
36933,Scrotoepalle,nemesis,96,priest,shadow,6,1,5
36934,Катранасс,eversong,96,priest,shadow,6,1,5
36935,Príêstjklòl,stormscale,96,priest,shadow,6,1,5
36936,Vtqt,outland,96,priest,shadow,6,1,5
36937,Vès,stormscale,96,priest,shadow,6,1,5
36938,Soulmedic,draenor,96,priest,shadow,6,1,5
36939,Maddøc,die-aldor,96,priest,shadow,6,1,5
36940,Zukatana,tarren-mill,96,priest,shadow,6,1,5
36941,Nestélle,drakthul,96,priest,shadow,6,1,5
36942,Skitcy,ghostlands,96,priest,shadow,6,1,5
36943,Гучии,gordunni,96,priest,shadow,6,1,5
36944,Абсорбиболь,howling-fjord,96,priest,shadow,6,1,5
36945,Ghostroller,pozzo-delleternità,96,priest,shadow,6,1,5
36946,Adlareg,silvermoon,96,priest,shadow,6,1,5
36947,Tryagain,ravencrest,96,priest,shadow,6,1,5
36948,Daphne,thunderhorn,96,priest,shadow,6,1,5
36949,Abudhabi,blackhand,96,priest,shadow,6,1,5
36950,Nextdawn,kazzak,96,priest,shadow,6,1,5
36951,Koíré,defias-brotherhood,96,priest,shadow,6,1,5
36952,Мегаствол,howling-fjord,96,priest,shadow,6,1,5
36953,Exila,rashgarroth,96,priest,shadow,6,1,5
36954,Ölümsüz,blackmoore,96,priest,shadow,6,1,5
36955,Hampådenbååd,kazzak,96,priest,shadow,6,1,5
36956,Míllerzz,ragnaros,96,priest,shadow,6,1,5
36957,Gobie,sunstrider,96,priest,shadow,6,1,5
36958,Rines,thrall,96,priest,shadow,6,1,5
36959,Bädx,silvermoon,96,priest,shadow,6,1,5
36960,Jakepriest,twisting-nether,96,priest,shadow,6,1,5
36961,Adev,drakthul,96,priest,shadow,6,1,5
36962,Barbïelolz,sargeras,96,priest,shadow,6,1,5
36963,Kales,grim-batol,96,priest,shadow,6,1,5
36964,Baltrom,ravencrest,96,priest,shadow,6,1,5
36965,Shonsized,argent-dawn,96,priest,shadow,6,1,5
36966,Stola,archimonde,96,priest,shadow,6,1,5
36967,Lubudu,burning-legion,96,priest,shadow,6,1,5
36968,Higgle,argent-dawn,96,priest,shadow,6,1,5
36969,Löô,archimonde,96,priest,shadow,6,1,5
36970,Kianprie,silvermoon,96,priest,shadow,6,1,5
36971,Enduring,darksorrow,96,priest,shadow,6,1,5
36972,Uwucatgir,silvermoon,96,priest,shadow,6,1,5
36973,Чупатаявошь,soulflayer,96,priest,shadow,6,1,5
36974,Winstõn,sanguino,96,priest,shadow,6,1,5
36975,Infâme,culte-de-la-rive-noire,96,priest,shadow,6,1,5
36976,Nelpriest,hyjal,96,priest,shadow,6,1,5
36977,Rastuvius,twisting-nether,96,priest,shadow,6,1,5
36978,Serach,ravencrest,96,priest,shadow,6,1,5
36979,Chimara,eredar,96,priest,shadow,6,1,5
36980,Nukksch,antonidas,96,priest,shadow,6,1,5
36981,Aerîs,veknilash,96,priest,shadow,6,1,5
36982,Endlin,silvermoon,96,priest,shadow,6,1,5
36983,Jannire,dun-modr,96,priest,shadow,12,1,11
36984,Câtryona,sylvanas,96,priest,shadow,12,1,11
36985,Darkspeech,arygos,96,priest,shadow,12,1,11
36986,Tiras,argent-dawn,96,priest,shadow,12,1,11
36987,Prästisjag,kazzak,84,priest,shadow,10,5,5
36988,Peesussy,kazzak,79,priest,shadow,5,1,4
36989,Xharyo,ravencrest,64,priest,shadow,4,1,3
36990,Xavyos,eredar,64,priest,shadow,4,1,3
36991,Gandals,shadowsong,64,priest,shadow,4,1,3
36992,Immurrtal,arathor,63,priest,shadow,2,2,0
36993,Møldark,silvermoon,48,priest,shadow,3,1,2
36994,Achesita,sylvanas,48,priest,shadow,3,1,2
36995,Psyp,kazzak,42,priest,shadow,8,2,6
36996,Holyhigh,baelgun,31,priest,shadow,2,1,1
36997,Mjuk,tarren-mill,16,priest,shadow,1,1,0
36998,Rãz,stormscale,2130,rogue,outlaw,66,36,30
36999,Макевин,gordunni,1876,rogue,outlaw,100,49,51
37000,Krixor,ravencrest,1855,rogue,outlaw,134,66,68
37001,Rivso,auchindoun,1821,rogue,outlaw,64,26,38
37002,Kekuriix,vashj,1796,rogue,outlaw,130,66,64
37003,Феинт,galakrond,1739,rogue,outlaw,48,19,29
37004,Lidiaubaro,ravencrest,1725,rogue,outlaw,362,185,177
37005,Yessa,argent-dawn,1721,rogue,outlaw,36,18,18
37006,Déjávu,ravencrest,1704,rogue,outlaw,48,25,23
37007,Дизелюжн,howling-fjord,1673,rogue,outlaw,326,159,167
37008,Koopa,argent-dawn,1666,rogue,outlaw,60,29,31
37009,Kreayx,ysondre,1666,rogue,outlaw,42,19,23
37010,Radiogodx,stormscale,1660,rogue,outlaw,163,79,84
37011,Jalsket,tarren-mill,1637,rogue,outlaw,48,25,23
37012,Scotlander,argent-dawn,1627,rogue,outlaw,60,34,26
37013,Kreay,ysondre,1620,rogue,outlaw,42,20,22
37014,Ålûñàhlulz,kilrogg,1604,rogue,outlaw,48,30,18
37015,Estriil,dalaran,1603,rogue,outlaw,42,24,18
37016,Kreay,tarren-mill,1576,rogue,outlaw,40,29,11
37017,Syrn,ravencrest,1559,rogue,outlaw,66,31,35
37018,Nèwt,aggramar,1528,rogue,outlaw,132,68,64
37019,Ранконх,lich-king,1528,rogue,outlaw,54,20,34
37020,Chillo,ravencrest,1525,rogue,outlaw,52,25,27
37021,Izzmonab,blackmoore,1519,rogue,outlaw,24,16,8
37022,Bannedfrigid,outland,1501,rogue,outlaw,66,25,41
37023,Зувер,blackscar,1494,rogue,outlaw,106,57,49
37024,Bonelesschic,silvermoon,1491,rogue,outlaw,209,112,97
37025,Arathir,ravencrest,1482,rogue,outlaw,50,25,25
37026,Deevoll,tarren-mill,1481,rogue,outlaw,102,45,57
37027,Sigleif,argent-dawn,1471,rogue,outlaw,111,57,54
37028,Shredfngrz,garona,1455,rogue,outlaw,44,22,22
37029,Loubina,silvermoon,1446,rogue,outlaw,36,16,20
37030,Carvyn,defias-brotherhood,1443,rogue,outlaw,111,59,52
37031,Delrøq,draenor,1435,rogue,outlaw,76,40,36
37032,Zbojník,ravencrest,1434,rogue,outlaw,36,15,21
37033,Röguetönerö,dun-modr,1429,rogue,outlaw,77,28,49
37034,Cryneth,ravencrest,1373,rogue,outlaw,51,25,26
37035,Åråmsëß,grim-batol,1370,rogue,outlaw,31,19,12
37036,Pistolpete,grim-batol,1343,rogue,outlaw,30,14,16
37037,Callmerose,ravencrest,1334,rogue,outlaw,24,14,10
37038,Dritzdourden,dun-modr,1333,rogue,outlaw,30,15,15
37039,Zep,auchindoun,1332,rogue,outlaw,24,14,10
37040,Murkyy,gilneas,1329,rogue,outlaw,32,16,16
37041,Djeud,archimonde,1325,rogue,outlaw,64,34,30
37042,Tidløs,dun-morogh,1324,rogue,outlaw,71,30,41
37043,Rasponi,ragnaros,1316,rogue,outlaw,82,45,37
37044,Джулт,soulflayer,1309,rogue,outlaw,72,27,45
37045,Örog,hyjal,1288,rogue,outlaw,47,26,21
37046,Jasolo,silvermoon,1269,rogue,outlaw,408,212,196
37047,Mawrat,mazrigos,1248,rogue,outlaw,30,13,17
37048,Ðaegr,ravencrest,1226,rogue,outlaw,72,35,37
37049,Dimmu,haomarush,1224,rogue,outlaw,53,24,29
37050,Sqz,archimonde,1222,rogue,outlaw,30,18,12
37051,Zapunk,argent-dawn,1221,rogue,outlaw,53,19,34
37052,Cipusan,kazzak,1219,rogue,outlaw,24,13,11
37053,Шторкаа,gordunni,1214,rogue,outlaw,33,19,14
37054,Omgjkgtfo,ravencrest,1207,rogue,outlaw,30,13,17
37055,Xsanji,kazzak,1140,rogue,outlaw,30,12,18
37056,Pasarelo,dun-modr,1137,rogue,outlaw,59,26,33
37057,Pidroseus,argent-dawn,1133,rogue,outlaw,30,13,17
37058,Jinzou,blackmoore,1128,rogue,outlaw,57,27,30
37059,Alatheril,argent-dawn,1101,rogue,outlaw,62,28,34
37060,Mirajen,archimonde,1080,rogue,outlaw,35,13,22
37061,Lättja,hyjal,1059,rogue,outlaw,24,12,12
37062,Drdaggerstwo,outland,1056,rogue,outlaw,24,11,13
37063,Terya,ragnaros,1052,rogue,outlaw,30,11,19
37064,Bxtchslayer,blackmoore,1044,rogue,outlaw,35,21,14
37065,Génn,silvermoon,1041,rogue,outlaw,44,21,23
37066,Badabôôm,wrathbringer,1041,rogue,outlaw,24,11,13
37067,Drunks,aegwynn,1036,rogue,outlaw,24,11,13
37068,Svddendeath,ragnaros,1034,rogue,outlaw,24,11,13
37069,Melahl,kazzak,1021,rogue,outlaw,77,42,35
37070,Spiochrr,burning-legion,1020,rogue,outlaw,84,35,49
37071,Soothinqq,emerald-dream,963,rogue,outlaw,23,15,8
37072,Lïke,frostwolf,960,rogue,outlaw,18,10,8
37073,Foulsteel,stormscale,951,rogue,outlaw,18,10,8
37074,Shinõbikék,outland,938,rogue,outlaw,29,10,19
37075,Neolamer,pozzo-delleternità,898,rogue,outlaw,74,31,43
37076,Omuspan,magtheridon,881,rogue,outlaw,66,28,38
37077,Sneakysteve,bloodfeather,864,rogue,outlaw,18,9,9
37078,Rogiko,twisting-nether,864,rogue,outlaw,24,9,15
37079,Жижель,howling-fjord,859,rogue,outlaw,18,9,9
37080,Маллестар,ashenvale,856,rogue,outlaw,18,9,9
37081,Mcgora,doomhammer,822,rogue,outlaw,36,15,21
37082,Hânnäh,hyjal,805,rogue,outlaw,42,18,24
37083,Blàckbèàrd,silvermoon,788,rogue,outlaw,42,17,25
37084,Фораст,gordunni,768,rogue,outlaw,12,8,4
37085,Bikrut,hyjal,768,rogue,outlaw,12,8,4
37086,Vokhun,outland,768,rogue,outlaw,18,8,10
37087,Gerzy,drakthul,768,rogue,outlaw,18,8,10
37088,Alizwood,aegwynn,767,rogue,outlaw,18,10,8
37089,Swaeard,ravencrest,767,rogue,outlaw,18,8,10
37090,Kirby,kaelthas,767,rogue,outlaw,18,8,10
37091,Okani,hyjal,761,rogue,outlaw,18,8,10
37092,Dredge,kaelthas,761,rogue,outlaw,24,8,16
37093,Shichi,archimonde,751,rogue,outlaw,23,8,15
37094,Riviele,argent-dawn,732,rogue,outlaw,14,9,5
37095,Viligar,kazzak,687,rogue,outlaw,21,8,13
37096,Backstabjr,blackmoore,672,rogue,outlaw,12,7,5
37097,Dían,ravencrest,672,rogue,outlaw,12,7,5
37098,Dêlaral,der-rat-von-dalaran,672,rogue,outlaw,16,8,8
37099,Kidneyou,ragnaros,672,rogue,outlaw,18,7,11
37100,Trixnaz,silvermoon,671,rogue,outlaw,18,7,11
37101,Skygann,burning-legion,670,rogue,outlaw,12,7,5
37102,Redfinshadow,stormrage,661,rogue,outlaw,17,8,9
37103,Cornvus,burning-legion,658,rogue,outlaw,12,7,5
37104,Фофламидзе,gordunni,611,rogue,outlaw,15,7,8
37105,Masteez,ahnqiraj,598,rogue,outlaw,11,7,4
37106,Shåð,zuljin,576,rogue,outlaw,12,6,6
37107,Anom,kargath,575,rogue,outlaw,12,6,6
37108,Noodlegoose,tarren-mill,575,rogue,outlaw,12,6,6
37109,Ружнуар,gordunni,575,rogue,outlaw,18,6,12
37110,Кингксу,gordunni,575,rogue,outlaw,24,6,18
37111,Rã,archimonde,574,rogue,outlaw,12,6,6
37112,Тимареканец,eversong,572,rogue,outlaw,18,6,12
37113,Helax,turalyon,569,rogue,outlaw,24,6,18
37114,Aaronblade,aggra-português,557,rogue,outlaw,18,6,12
37115,Gloomykenny,tarren-mill,543,rogue,outlaw,17,6,11
37116,Tipok,tarren-mill,515,rogue,outlaw,23,7,16
37117,Barisso,burning-legion,511,rogue,outlaw,14,6,8
37118,Zômbiê,blackrock,491,rogue,outlaw,13,6,7
37119,Tåxic,sylvanas,480,rogue,outlaw,6,5,1
37120,Акаарикс,gordunni,480,rogue,outlaw,6,5,1
37121,Fivepoint,blackmoore,480,rogue,outlaw,12,5,7
37122,Cox,nagrand,480,rogue,outlaw,12,5,7
37123,Faoil,defias-brotherhood,480,rogue,outlaw,12,5,7
37124,Featfawkes,ragnaros,480,rogue,outlaw,12,5,7
37125,Ладжо,gordunni,480,rogue,outlaw,18,5,13
37126,Rujo,magtheridon,479,rogue,outlaw,12,5,7
37127,Nocrath,blades-edge,479,rogue,outlaw,12,5,7
37128,Gotfrey,darkspear,479,rogue,outlaw,12,5,7
37129,Toxîne,archimonde,479,rogue,outlaw,12,5,7
37130,Djsapblindx,archimonde,479,rogue,outlaw,18,5,13
37131,Hosenpinkler,lordaeron,478,rogue,outlaw,12,5,7
37132,Darkchomeur,archimonde,384,rogue,outlaw,6,4,2
37133,Machmacan,thrall,384,rogue,outlaw,12,4,8
37134,Кортикос,gordunni,384,rogue,outlaw,12,4,8
37135,Synexo,sylvanas,384,rogue,outlaw,12,4,8
37136,Minimælk,saurfang,383,rogue,outlaw,6,4,2
37137,Alena,arathi,383,rogue,outlaw,6,4,2
37138,Mïta,blackmoore,383,rogue,outlaw,6,4,2
37139,Yoruichì,kazzak,383,rogue,outlaw,12,4,8
37140,Groendienst,quelthalas,381,rogue,outlaw,12,4,8
37141,Trímønâ,gorgonnash,351,rogue,outlaw,11,4,7
37142,Играючестно,howling-fjord,288,rogue,outlaw,6,3,3
37143,Cigarette,emeriss,288,rogue,outlaw,6,3,3
37144,Spiike,culte-de-la-rive-noire,288,rogue,outlaw,6,3,3
37145,Mol,defias-brotherhood,288,rogue,outlaw,6,3,3
37146,Shadxwstep,ravencrest,288,rogue,outlaw,6,3,3
37147,Onlyluvhurt,dun-modr,288,rogue,outlaw,6,3,3
37148,Cobaka,blackrock,288,rogue,outlaw,12,3,9
37149,Finisher,sanguino,288,rogue,outlaw,12,3,9
37150,Heulleise,die-ewige-wacht,288,rogue,outlaw,12,3,9
37151,Szpachela,burning-legion,288,rogue,outlaw,12,3,9
37152,Ванэйти,gordunni,287,rogue,outlaw,6,3,3
37153,Kedrus,turalyon,286,rogue,outlaw,6,3,3
37154,Blackmetall,aegwynn,286,rogue,outlaw,12,3,9
37155,Сереф,gordunni,239,rogue,outlaw,11,3,8
37156,Cardsharkjoe,argent-dawn,223,rogue,outlaw,14,3,11
37157,Banaulikode,twisting-nether,192,rogue,outlaw,6,2,4
37158,Rashaz,blackhand,192,rogue,outlaw,6,2,4
37159,Snøv,outland,192,rogue,outlaw,6,2,4
37160,Knifeyknifey,ravencrest,192,rogue,outlaw,6,2,4
37161,Razaah,ravencrest,192,rogue,outlaw,6,2,4
37162,Invisage,grim-batol,192,rogue,outlaw,6,2,4
37163,Cheapshotwin,nethersturm,192,rogue,outlaw,6,2,4
37164,Nyxal,argent-dawn,192,rogue,outlaw,6,2,4
37165,Dawnsaber,argent-dawn,192,rogue,outlaw,6,2,4
37166,Shåggy,vashj,192,rogue,outlaw,6,2,4
37167,Оргельна,gordunni,192,rogue,outlaw,6,2,4
37168,Zind,dalaran,192,rogue,outlaw,6,2,4
37169,Mycki,voljin,192,rogue,outlaw,6,2,4
37170,Berneo,burning-legion,192,rogue,outlaw,6,2,4
37171,Stunlock,silvermoon,192,rogue,outlaw,6,2,4
37172,Paralisis,zuljin,192,rogue,outlaw,6,2,4
37173,Zyhmø,archimonde,192,rogue,outlaw,6,2,4
37174,Nomota,sanguino,192,rogue,outlaw,6,2,4
37175,Vyze,blackmoore,192,rogue,outlaw,12,2,10
37176,Alvoriace,hyjal,192,rogue,outlaw,12,2,10
37177,Stabkanta,antonidas,192,rogue,outlaw,12,2,10
37178,Valtesse,medivh,159,rogue,outlaw,5,2,3
37179,Piperx,ravencrest,159,rogue,outlaw,11,2,9
37180,Геопанк,howling-fjord,144,rogue,outlaw,3,3,0
37181,Zyreanxy,blackrock,138,rogue,outlaw,10,3,7
37182,Ñøway,archimonde,96,rogue,outlaw,3,2,1
37183,Akira,outland,96,rogue,outlaw,6,1,5
37184,Ciaordel,sylvanas,96,rogue,outlaw,6,1,5
37185,Sty,aerie-peak,96,rogue,outlaw,6,1,5
37186,Аутянин,soulflayer,96,rogue,outlaw,6,1,5
37187,Vaze,ravencrest,96,rogue,outlaw,6,1,5
37188,Feucht,argent-dawn,96,rogue,outlaw,6,1,5
37189,Yüm,burning-blade,96,rogue,outlaw,6,1,5
37190,Ótsutsukí,kazzak,96,rogue,outlaw,6,1,5
37191,Леронда,deepholm,96,rogue,outlaw,6,1,5
37192,Mallaurya,dalaran,96,rogue,outlaw,6,1,5
37193,Øníxßtw,eitrigg,96,rogue,outlaw,6,1,5
37194,Natillaa,dun-modr,96,rogue,outlaw,6,1,5
37195,Jester,bladefist,96,rogue,outlaw,12,1,11
37196,Tiltman,dun-morogh,79,rogue,outlaw,5,1,4
37197,Nabatean,magtheridon,48,rogue,outlaw,3,1,2
37198,Getbleeded,stormscale,31,rogue,outlaw,2,1,1
37199,Howton,archimonde,2424,rogue,subtlety,86,57,29
37200,Pridå,thrall,2380,rogue,subtlety,126,73,53
37201,Ncroxd,ravencrest,2316,rogue,subtlety,72,56,16
37202,Ncrø,aszune,2310,rogue,subtlety,85,54,31
37203,Shoxy,ravencrest,2307,rogue,subtlety,94,56,38
37204,Pridå,ravencrest,2299,rogue,subtlety,106,58,48
37205,Sunø,archimonde,2276,rogue,subtlety,216,114,102
37206,Naláa,ravencrest,2228,rogue,subtlety,228,121,107
37207,Cazzette,ravencrest,2204,rogue,subtlety,81,48,33
37208,Asumah,ravencrest,2200,rogue,subtlety,90,55,35
37209,Pulvèr,dalaran,2159,rogue,subtlety,90,52,38
37210,Лолелт,borean-tundra,2131,rogue,subtlety,104,53,51
37211,Nothingleft,draenor,2130,rogue,subtlety,173,99,74
37212,Ewynarog,silvermoon,2129,rogue,subtlety,65,37,28
37213,Nàsklolz,hyjal,2117,rogue,subtlety,84,45,39
37214,Lfgenjoyer,tarren-mill,2114,rogue,subtlety,126,77,49
37215,Änanké,outland,2108,rogue,subtlety,90,47,43
37216,Denjinx,culte-de-la-rive-noire,2107,rogue,subtlety,78,43,35
37217,Vulkos,lightbringer,2101,rogue,subtlety,117,61,56
37218,Пожилойпупь,gordunni,2095,rogue,subtlety,59,39,20
37219,Лолелт,howling-fjord,2074,rogue,subtlety,89,51,38
37220,Smøkyyx,eredar,2072,rogue,subtlety,88,47,41
37221,Løre,blackrock,2041,rogue,subtlety,84,43,41
37222,Asm,the-maelstrom,2024,rogue,subtlety,130,64,66
37223,Vensq,drakthul,2021,rogue,subtlety,78,44,34
37224,Tracersxrude,ravencrest,2018,rogue,subtlety,173,86,87
37225,Эмилилавс,galakrond,2015,rogue,subtlety,182,107,75
37226,Baboonx,burning-legion,2014,rogue,subtlety,54,37,17
37227,Fîññ,ravencrest,2014,rogue,subtlety,60,35,25
37228,Iqws,ravencrest,2014,rogue,subtlety,90,49,41
37229,Makethemrog,archimonde,2014,rogue,subtlety,136,67,69
37230,Troxerboxer,tarren-mill,2000,rogue,subtlety,60,32,28
37231,Lkzx,archimonde,1998,rogue,subtlety,149,71,78
37232,Chatbann,blackrock,1995,rogue,subtlety,190,109,81
37233,Chatdisabled,drakthul,1991,rogue,subtlety,191,100,91
37234,Смертьвсмоке,gordunni,1981,rogue,subtlety,284,141,143
37235,Lówskill,outland,1967,rogue,subtlety,259,137,122
37236,Çvß,kazzak,1966,rogue,subtlety,66,36,30
37237,Guççí,blackrock,1958,rogue,subtlety,131,72,59
37238,Aythusha,twisting-nether,1957,rogue,subtlety,54,31,23
37239,Drydamage,kazzak,1957,rogue,subtlety,131,69,62
37240,Máuul,ravencrest,1956,rogue,subtlety,78,36,42
37241,Sfyr,ysondre,1951,rogue,subtlety,148,86,62
37242,Magepèt,tarren-mill,1946,rogue,subtlety,130,73,57
37243,Сильфитт,gordunni,1945,rogue,subtlety,76,44,32
37244,Флексити,soulflayer,1939,rogue,subtlety,114,59,55
37245,Kallelelel,tarren-mill,1933,rogue,subtlety,42,26,16
37246,Terrorman,ravencrest,1932,rogue,subtlety,60,34,26
37247,Unìque,sylvanas,1918,rogue,subtlety,96,51,45
37248,Physic,silvermoon,1915,rogue,subtlety,70,39,31
37249,Teskes,tyrande,1907,rogue,subtlety,114,66,48
37250,Zuqzwang,outland,1901,rogue,subtlety,54,30,24
37251,Clawdíte,blackrock,1895,rogue,subtlety,48,21,27
37252,Çåñçér,sylvanas,1893,rogue,subtlety,78,38,40
37253,Illmatíc,ravencrest,1892,rogue,subtlety,62,32,30
37254,Shadezlöl,ravencrest,1889,rogue,subtlety,280,142,138
37255,Çhimaev,ravencrest,1886,rogue,subtlety,28,21,7
37256,Rãz,stormscale,1880,rogue,subtlety,48,31,17
37257,Xiro,dalaran,1879,rogue,subtlety,66,32,34
37258,Sbx,alakir,1877,rogue,subtlety,164,92,72
37259,Престиж,greymane,1871,rogue,subtlety,42,23,19
37260,Sariena,sylvanas,1869,rogue,subtlety,167,91,76
37261,Randomidiot,ravencrest,1868,rogue,subtlety,60,36,24
37262,Ладжо,gordunni,1867,rogue,subtlety,114,59,55
37263,Sapécomejaja,archimonde,1866,rogue,subtlety,38,24,14
37264,Социалистсс,gordunni,1866,rogue,subtlety,92,49,43
37265,Critmakër,outland,1865,rogue,subtlety,107,57,50
37266,Brensø,nemesis,1857,rogue,subtlety,99,60,39
37267,Âkame,argent-dawn,1853,rogue,subtlety,59,32,27
37268,Nahj,ravencrest,1851,rogue,subtlety,42,28,14
37269,Renhri,burning-legion,1846,rogue,subtlety,266,141,125
37270,Slapshot,das-konsortium,1845,rogue,subtlety,54,28,26
37271,Lilaven,turalyon,1841,rogue,subtlety,156,80,76
37272,Amén,sanguino,1833,rogue,subtlety,60,27,33
37273,Nøctürnë,archimonde,1829,rogue,subtlety,42,26,16
37274,Bleakhøuse,ravencrest,1829,rogue,subtlety,58,29,29
37275,Dêlaral,der-mithrilorden,1828,rogue,subtlety,72,36,36
37276,Lízåriñ,ravencrest,1827,rogue,subtlety,48,38,10
37277,Rímen,archimonde,1826,rogue,subtlety,66,28,38
37278,Chizué,sylvanas,1824,rogue,subtlety,54,34,20
37279,Noraex,silvermoon,1822,rogue,subtlety,81,47,34
37280,Asterisyup,silvermoon,1822,rogue,subtlety,107,61,46
37281,Тохуо,lich-king,1822,rogue,subtlety,42,20,22
37282,Погибайдуде,gordunni,1821,rogue,subtlety,41,34,7
37283,Whaazlysnipz,tarren-mill,1821,rogue,subtlety,24,19,5
37284,Роземсти,gordunni,1821,rogue,subtlety,180,95,85
37285,Crøweta,argent-dawn,1821,rogue,subtlety,66,34,32
37286,Radiogodx,stormscale,1817,rogue,subtlety,60,31,29
37287,Abej,malygos,1813,rogue,subtlety,48,23,25
37288,Kekful,defias-brotherhood,1811,rogue,subtlety,36,26,10
37289,Deevoll,tarren-mill,1810,rogue,subtlety,95,58,37
37290,Keophz,tarren-mill,1809,rogue,subtlety,140,90,50
37291,Keeganx,tarren-mill,1808,rogue,subtlety,71,39,32
37292,Gløøm,ravencrest,1806,rogue,subtlety,42,23,19
37293,Ooqu,silvermoon,1804,rogue,subtlety,30,23,7
37294,Xtoyo,zuljin,1804,rogue,subtlety,54,29,25
37295,Liquidité,azuremyst,1803,rogue,subtlety,194,105,89
37296,Knutten,wildhammer,1802,rogue,subtlety,123,72,51
37297,Releaserage,draenor,1800,rogue,subtlety,49,26,23
37298,Kenjí,silvermoon,1797,rogue,subtlety,143,73,70
37299,Insomnla,silvermoon,1796,rogue,subtlety,126,67,59
37300,Læffgøðx,stormscale,1794,rogue,subtlety,52,32,20
37301,Лайнэл,deathweaver,1794,rogue,subtlety,83,48,35
37302,Lhitriân,saurfang,1793,rogue,subtlety,73,40,33
37303,Subzerõ,archimonde,1792,rogue,subtlety,262,124,138
37304,Sly,emerald-dream,1789,rogue,subtlety,66,36,30
37305,Featfawkes,ragnaros,1787,rogue,subtlety,78,41,37
37306,Stonyhavana,ravencrest,1785,rogue,subtlety,84,49,35
37307,Locgog,argent-dawn,1774,rogue,subtlety,36,25,11
37308,Shadowprank,ravencrest,1774,rogue,subtlety,84,44,40
37309,Zzemzza,kazzak,1772,rogue,subtlety,59,36,23
37310,Ennvi,defias-brotherhood,1769,rogue,subtlety,30,19,11
37311,Holaszemed,ragnaros,1757,rogue,subtlety,177,91,86
37312,Deadraw,aegwynn,1756,rogue,subtlety,66,33,33
37313,Stråwberrý,archimonde,1753,rogue,subtlety,57,28,29
37314,Calestrian,tarren-mill,1750,rogue,subtlety,114,57,57
37315,Trîçk,aegwynn,1747,rogue,subtlety,78,43,35
37316,Sábros,ravencrest,1742,rogue,subtlety,126,60,66
37317,Инфера,lich-king,1741,rogue,subtlety,72,33,39
37318,Márto,archimonde,1740,rogue,subtlety,119,66,53
37319,Иждолк,gordunni,1739,rogue,subtlety,126,66,60
37320,Путьказаха,gordunni,1737,rogue,subtlety,54,31,23
37321,Whøråcle,tarren-mill,1736,rogue,subtlety,53,26,27
37322,Cheapshôt,archimonde,1734,rogue,subtlety,166,90,76
37323,Cheapshotwin,nethersturm,1733,rogue,subtlety,36,20,16
37324,Starfighter,pozzo-delleternità,1732,rogue,subtlety,121,67,54
37325,Бладстейн,blackscar,1730,rogue,subtlety,112,63,49
37326,Bruckmann,ragnaros,1730,rogue,subtlety,51,23,28
37327,Ccedox,stormscale,1729,rogue,subtlety,30,20,10
37328,Sunøbrain,archimonde,1729,rogue,subtlety,46,25,21
37329,Krida,archimonde,1727,rogue,subtlety,66,32,34
37330,Grifika,outland,1725,rogue,subtlety,87,56,31
37331,Китей,howling-fjord,1723,rogue,subtlety,78,40,38
37332,Läêkz,archimonde,1719,rogue,subtlety,36,18,18
37333,Naïmitsu,hyjal,1717,rogue,subtlety,102,53,49
37334,Брайнз,gordunni,1716,rogue,subtlety,78,53,25
37335,Хавиа,gordunni,1712,rogue,subtlety,59,37,22
37336,Морхалл,gordunni,1712,rogue,subtlety,66,36,30
37337,Rinj,antonidas,1712,rogue,subtlety,42,22,20
37338,Рели,blackscar,1711,rogue,subtlety,72,37,35
37339,Tanssy,ragnaros,1710,rogue,subtlety,62,38,24
37340,Namelless,twisting-nether,1708,rogue,subtlety,126,65,61
37341,Tïnderhoe,dalaran,1705,rogue,subtlety,30,25,5
37342,Malasap,archimonde,1705,rogue,subtlety,289,148,141
37343,Architeggt,eredar,1700,rogue,subtlety,102,47,55
37344,Yumiee,arygos,1697,rogue,subtlety,80,44,36
37345,Rhayesh,silvermoon,1694,rogue,subtlety,106,51,55
37346,Grindz,ravencrest,1693,rogue,subtlety,430,230,200
37347,Knoffchad,blackhand,1692,rogue,subtlety,158,83,75
37348,Nippzy,twisting-nether,1691,rogue,subtlety,108,69,39
37349,Ninjaassasin,aegwynn,1691,rogue,subtlety,106,62,44
37350,Ishízu,exodar,1690,rogue,subtlety,90,44,46
37351,Kickcake,ravencrest,1688,rogue,subtlety,98,53,45
37352,Lotorr,burning-legion,1687,rogue,subtlety,120,64,56
37353,Azirios,kazzak,1687,rogue,subtlety,106,56,50
37354,Denjastwo,archimonde,1686,rogue,subtlety,30,21,9
37355,Dópamine,hyjal,1683,rogue,subtlety,52,29,23
37356,Rantie,eredar,1675,rogue,subtlety,30,18,12
37357,Rindar,dun-modr,1675,rogue,subtlety,176,95,81
37358,Bloodsmell,outland,1673,rogue,subtlety,77,50,27
37359,Anr,burning-legion,1673,rogue,subtlety,76,41,35
37360,Susquehanna,ragnaros,1672,rogue,subtlety,96,51,45
37361,Zayøn,outland,1671,rogue,subtlety,30,19,11
37362,Xzr,stormscale,1668,rogue,subtlety,36,27,9
37363,Notôríous,ravencrest,1668,rogue,subtlety,54,29,25
37364,Ámbush,sylvanas,1668,rogue,subtlety,85,42,43
37365,Воронкхал,ashenvale,1668,rogue,subtlety,60,29,31
37366,Memphismp,drakthul,1667,rogue,subtlety,35,18,17
37367,Ccedolol,stormscale,1666,rogue,subtlety,71,38,33
37368,Kidneyyou,blackmoore,1660,rogue,subtlety,77,40,37
37369,Mâêl,blackmoore,1659,rogue,subtlety,173,88,85
37370,Fivepoint,blackmoore,1652,rogue,subtlety,30,20,10
37371,Zerotyluv,silvermoon,1652,rogue,subtlety,30,20,10
37372,Moroz,ravencrest,1652,rogue,subtlety,42,23,19
37373,Handuil,blackmoore,1647,rogue,subtlety,205,108,97
37374,Subsònik,tarren-mill,1645,rogue,subtlety,52,31,21
37375,Txm,argent-dawn,1643,rogue,subtlety,42,22,20
37376,Søllek,culte-de-la-rive-noire,1642,rogue,subtlety,36,22,14
37377,Lânnïster,kazzak,1642,rogue,subtlety,48,23,25
37378,Getschwîfty,ravencrest,1639,rogue,subtlety,27,18,9
37379,Sodarogue,blackrock,1638,rogue,subtlety,38,22,16
37380,Эдкенуэй,gordunni,1636,rogue,subtlety,131,77,54
37381,Ratirl,kult-der-verdammten,1635,rogue,subtlety,71,41,30
37382,Azziinoth,ragnaros,1635,rogue,subtlety,48,20,28
37383,Dancex,kazzak,1634,rogue,subtlety,48,31,17
37384,Rakzena,ravencrest,1634,rogue,subtlety,36,21,15
37385,Tinylol,dun-morogh,1634,rogue,subtlety,73,42,31
37386,Pheq,ravencrest,1633,rogue,subtlety,54,28,26
37387,Дэмайо,gordunni,1632,rogue,subtlety,42,25,17
37388,Slimshadyqt,terokkar,1631,rogue,subtlety,48,25,23
37389,Ач,gordunni,1630,rogue,subtlety,54,27,27
37390,Redcutter,silvermoon,1629,rogue,subtlety,48,27,21
37391,Nihilix,dalaran,1629,rogue,subtlety,107,54,53
37392,Doritomix,dun-modr,1628,rogue,subtlety,44,26,18
37393,Кишмякх,howling-fjord,1627,rogue,subtlety,78,28,50
37394,Weird,blackmoore,1624,rogue,subtlety,40,27,13
37395,Mortecieca,ravencrest,1624,rogue,subtlety,36,17,19
37396,Râpidø,elune,1624,rogue,subtlety,51,19,32
37397,Whîspyr,blackmoore,1623,rogue,subtlety,42,21,21
37398,Pcessleia,twisting-nether,1622,rogue,subtlety,30,17,13
37399,Salakelmi,sylvanas,1620,rogue,subtlety,36,22,14
37400,Plsðõntcry,ravencrest,1618,rogue,subtlety,60,33,27
37401,Monero,thrall,1617,rogue,subtlety,73,44,29
37402,Морзо,howling-fjord,1617,rogue,subtlety,72,43,29
37403,Stormhardt,stormscale,1616,rogue,subtlety,51,21,30
37404,Rmp,khaz-modan,1616,rogue,subtlety,54,21,33
37405,Ålleyézonme,ravencrest,1615,rogue,subtlety,322,151,171
37406,Ipøuli,quelthalas,1614,rogue,subtlety,30,17,13
37407,Jëllyxøxø,twisting-nether,1614,rogue,subtlety,164,89,75
37408,Oczku,burning-legion,1612,rogue,subtlety,30,17,13
37409,Bahi,ysondre,1612,rogue,subtlety,72,34,38
37410,Солевыегубки,gordunni,1610,rogue,subtlety,46,29,17
37411,Zourkan,archimonde,1609,rogue,subtlety,283,158,125
37412,Krsty,antonidas,1609,rogue,subtlety,36,20,16
37413,Meccura,silvermoon,1607,rogue,subtlety,93,53,40
37414,Åluñahtøpg,azjolnerub,1606,rogue,subtlety,54,23,31
37415,Dìsørderx,ravencrest,1605,rogue,subtlety,82,44,38
37416,Háttori,twisting-nether,1604,rogue,subtlety,42,24,18
37417,Aszaryn,magtheridon,1601,rogue,subtlety,54,32,22
37418,Sunå,archimonde,1600,rogue,subtlety,36,19,17
37419,Хасилей,booty-bay,1596,rogue,subtlety,116,59,57
37420,Dawnsaber,argent-dawn,1593,rogue,subtlety,36,21,15
37421,Sÿkz,hyjal,1593,rogue,subtlety,56,25,31
37422,Cøntrøl,stormreaver,1587,rogue,subtlety,120,66,54
37423,Sniiky,kazzak,1586,rogue,subtlety,138,76,62
37424,Evivalarte,burning-legion,1585,rogue,subtlety,61,34,27
37425,Baldoh,kazzak,1584,rogue,subtlety,36,24,12
37426,Вр,blackscar,1582,rogue,subtlety,30,18,12
37427,Oxyrog,ravencrest,1580,rogue,subtlety,42,22,20
37428,Chipicaua,silvermoon,1578,rogue,subtlety,42,19,23
37429,Nitroxygen,outland,1572,rogue,subtlety,67,36,31
37430,Smílèy,ravencrest,1572,rogue,subtlety,36,18,18
37431,Shyy,dun-modr,1572,rogue,subtlety,54,26,28
37432,Zømbië,kazzak,1571,rogue,subtlety,200,97,103
37433,Màrto,archimonde,1570,rogue,subtlety,29,20,9
37434,Madisonivyqt,blackmoore,1570,rogue,subtlety,88,46,42
37435,Zilemjr,stormscale,1566,rogue,subtlety,104,59,45
37436,Djswaghetti,stormscale,1566,rogue,subtlety,36,18,18
37437,Зорго,deathguard,1564,rogue,subtlety,60,34,26
37438,Carvyn,defias-brotherhood,1563,rogue,subtlety,30,17,13
37439,Ÿøßø,archimonde,1562,rogue,subtlety,66,34,32
37440,Злойкиллер,howling-fjord,1561,rogue,subtlety,48,24,24
37441,Exiv,ragnaros,1561,rogue,subtlety,54,21,33
37442,Quq,kazzak,1560,rogue,subtlety,147,80,67
37443,Reezr,stormscale,1559,rogue,subtlety,78,33,45
37444,Xkebyzlobg,outland,1558,rogue,subtlety,35,21,14
37445,Deok,tarren-mill,1557,rogue,subtlety,30,19,11
37446,Сармонн,howling-fjord,1556,rogue,subtlety,60,41,19
37447,Liarø,archimonde,1555,rogue,subtlety,151,76,75
37448,Røgger,ragnaros,1553,rogue,subtlety,141,65,76
37449,Exanimu,ravencrest,1550,rogue,subtlety,132,58,74
37450,Opaska,ravencrest,1549,rogue,subtlety,77,40,37
37451,Frequenzalfa,silvermoon,1549,rogue,subtlety,40,20,20
37452,Pfourtwenty,eredar,1547,rogue,subtlety,36,18,18
37453,Voki,dalaran,1546,rogue,subtlety,105,58,47
37454,Droomprins,stormscale,1541,rogue,subtlety,42,23,19
37455,Старллесс,gordunni,1540,rogue,subtlety,256,137,119
37456,Jaikka,archimonde,1539,rogue,subtlety,36,24,12
37457,Meldee,burning-legion,1539,rogue,subtlety,42,21,21
37458,Mxx,stormscale,1537,rogue,subtlety,151,89,62
37459,Gøldzahn,antonidas,1536,rogue,subtlety,36,18,18
37460,Kidneyou,ragnaros,1535,rogue,subtlety,30,18,12
37461,Shadystabby,stormscale,1534,rogue,subtlety,89,48,41
37462,Alexandra,kazzak,1534,rogue,subtlety,90,42,48
37463,Ziqqi,thrall,1531,rogue,subtlety,78,37,41
37464,Sinist,twisting-nether,1531,rogue,subtlety,50,23,27
37465,Счастливое,howling-fjord,1529,rogue,subtlety,110,57,53
37466,Нэйлио,deepholm,1527,rogue,subtlety,24,16,8
37467,Súpremé,ravencrest,1526,rogue,subtlety,54,35,19
37468,Ipresskidney,tarren-mill,1523,rogue,subtlety,158,84,74
37469,Fivepointx,blackmoore,1523,rogue,subtlety,66,33,33
37470,Zôuloulou,archimonde,1522,rogue,subtlety,63,35,28
37471,Royalflüx,grim-batol,1522,rogue,subtlety,81,41,40
37472,Kidknee,outland,1522,rogue,subtlety,36,18,18
37473,Rogueas,stormscale,1521,rogue,subtlety,41,25,16
37474,Ванэйти,gordunni,1520,rogue,subtlety,316,164,152
37475,Skýfire,ravencrest,1519,rogue,subtlety,60,28,32
37476,Шадовкилер,blackscar,1517,rogue,subtlety,90,48,42
37477,Бэрнии,howling-fjord,1517,rogue,subtlety,176,89,87
37478,Nopzs,outland,1516,rogue,subtlety,48,27,21
37479,Trapstar,stormscale,1516,rogue,subtlety,90,44,46
37480,Dölf,archimonde,1515,rogue,subtlety,164,90,74
37481,Hoodrogue,blackrock,1514,rogue,subtlety,74,39,35
37482,Loopermann,silvermoon,1514,rogue,subtlety,100,51,49
37483,Îüçkÿmêñ,outland,1512,rogue,subtlety,31,19,12
37484,Zodracir,scarshield-legion,1512,rogue,subtlety,36,17,19
37485,Daggerdashx,ravencrest,1511,rogue,subtlety,455,246,209
37486,Xãwé,kazzak,1509,rogue,subtlety,45,26,19
37487,Shinzaoh,khaz-modan,1509,rogue,subtlety,64,33,31
37488,Yourexwifey,ravencrest,1508,rogue,subtlety,92,52,40
37489,Txf,aegwynn,1508,rogue,subtlety,36,20,16
37490,Ripcurll,grim-batol,1507,rogue,subtlety,39,21,18
37491,Onlyluvhurt,dun-modr,1506,rogue,subtlety,106,58,48
37492,Säxnthecrity,blackmoore,1506,rogue,subtlety,306,154,152
37493,Shâdowfreeze,onyxia,1505,rogue,subtlety,72,39,33
37494,Вагнеса,howling-fjord,1504,rogue,subtlety,89,46,43
37495,Falewyn,ragnaros,1503,rogue,subtlety,24,16,8
37496,Vögue,burning-legion,1500,rogue,subtlety,61,27,34
37497,Críppléz,ravencrest,1494,rogue,subtlety,90,47,43
37498,Haikyu,blackhand,1493,rogue,subtlety,42,17,25
37499,Абисиан,soulflayer,1490,rogue,subtlety,78,42,36
37500,Dødgez,cthun,1489,rogue,subtlety,28,16,12
37501,Akwaaba,ravencrest,1489,rogue,subtlety,81,38,43
37502,Xok,draenor,1487,rogue,subtlety,52,26,26
37503,Шпилля,gordunni,1487,rogue,subtlety,77,38,39
37504,Leepz,outland,1486,rogue,subtlety,60,38,22
37505,Miiløx,silvermoon,1484,rogue,subtlety,47,20,27
37506,Пусякиллерх,gordunni,1482,rogue,subtlety,24,16,8
37507,Diazz,aegwynn,1482,rogue,subtlety,36,20,16
37508,Shízzel,blackhand,1481,rogue,subtlety,72,37,35
37509,Roanz,stormreaver,1479,rogue,subtlety,49,24,25
37510,Kire,daggerspine,1478,rogue,subtlety,65,30,35
37511,Ramses,onyxia,1478,rogue,subtlety,60,25,35
37512,Гэнт,soulflayer,1477,rogue,subtlety,42,20,22
37513,Pérplèxîty,thrall,1475,rogue,subtlety,49,28,21
37514,Maroshko,argent-dawn,1475,rogue,subtlety,36,20,16
37515,Ömme,archimonde,1474,rogue,subtlety,84,44,40
37516,Nâzaar,antonidas,1473,rogue,subtlety,84,49,35
37517,Belwarx,darksorrow,1471,rogue,subtlety,49,16,33
37518,Jqmie,ravencrest,1470,rogue,subtlety,50,28,22
37519,Распяздяй,gordunni,1469,rogue,subtlety,48,30,18
37520,Spr,malfurion,1468,rogue,subtlety,106,58,48
37521,Xalupa,dun-modr,1468,rogue,subtlety,42,19,23
37522,Jaydeeñ,ravencrest,1468,rogue,subtlety,36,16,20
37523,Neirdà,hyjal,1468,rogue,subtlety,43,19,24
37524,Ghøstkid,blackrock,1467,rogue,subtlety,78,40,38
37525,Dígga,nemesis,1467,rogue,subtlety,66,32,34
37526,Veryscaryguý,twisting-nether,1464,rogue,subtlety,54,33,21
37527,Tripleníne,silvermoon,1464,rogue,subtlety,59,34,25
37528,Röguelol,outland,1460,rogue,subtlety,42,20,22
37529,Winwin,silvermoon,1459,rogue,subtlety,148,90,58
37530,Ænutz,ysondre,1458,rogue,subtlety,33,18,15
37531,Tonaxstab,ragnaros,1458,rogue,subtlety,42,21,21
37532,Sashikorosu,archimonde,1457,rogue,subtlety,116,65,51
37533,Absol,hellscream,1456,rogue,subtlety,48,29,19
37534,Azovrouge,terokkar,1456,rogue,subtlety,159,88,71
37535,Norlix,ravencrest,1455,rogue,subtlety,66,30,36
37536,Johnnyprep,ravencrest,1454,rogue,subtlety,54,29,25
37537,Sacrehptit,naxxramas,1450,rogue,subtlety,42,26,16
37538,Nightq,tarren-mill,1450,rogue,subtlety,57,34,23
37539,Unsullièd,kazzak,1449,rogue,subtlety,30,16,14
37540,Helloimjohn,darksorrow,1449,rogue,subtlety,47,25,22
37541,Critmaker,outland,1448,rogue,subtlety,24,16,8
37542,Текин,howling-fjord,1448,rogue,subtlety,54,31,23
37543,Peechiyy,blackmoore,1447,rogue,subtlety,69,39,30
37544,Shaeni,silvermoon,1447,rogue,subtlety,205,105,100
37545,Местьбучи,howling-fjord,1446,rogue,subtlety,78,42,36
37546,Zerozsub,tarren-mill,1445,rogue,subtlety,111,64,47
37547,Tinyshank,drakthul,1444,rogue,subtlety,50,28,22
37548,Mortnoïre,naxxramas,1443,rogue,subtlety,72,36,36
37549,Mont,nemesis,1443,rogue,subtlety,72,36,36
37550,Rat,mazrigos,1440,rogue,subtlety,24,15,9
37551,Calpic,sanguino,1439,rogue,subtlety,148,79,69
37552,Panigalex,veknilash,1438,rogue,subtlety,33,19,14
37553,Inyria,outland,1438,rogue,subtlety,118,61,57
37554,Aläen,ravencrest,1437,rogue,subtlety,37,20,17
37555,Dêlaral,blackhand,1437,rogue,subtlety,30,15,15
37556,Тира,grom,1436,rogue,subtlety,30,15,15
37557,Лютьер,soulflayer,1435,rogue,subtlety,120,62,58
37558,Ruck,madmortem,1434,rogue,subtlety,30,18,12
37559,Trashbàg,alakir,1432,rogue,subtlety,30,15,15
37560,Achterom,tarren-mill,1432,rogue,subtlety,128,59,69
37561,Morgan,argent-dawn,1431,rogue,subtlety,60,35,25
37562,Nairobii,tarren-mill,1430,rogue,subtlety,30,19,11
37563,Strangeboy,ravencrest,1430,rogue,subtlety,24,15,9
37564,Jaqenhghar,pozzo-delleternità,1429,rogue,subtlety,97,51,46
37565,Grzech,burning-legion,1429,rogue,subtlety,82,40,42
37566,Mâtâtâ,die-ewige-wacht,1428,rogue,subtlety,77,42,35
37567,Reprouvette,dalaran,1425,rogue,subtlety,24,16,8
37568,Ilrunne,silvermoon,1425,rogue,subtlety,34,17,17
37569,Ibizå,ravencrest,1423,rogue,subtlety,82,39,43
37570,Smo,kargath,1422,rogue,subtlety,32,16,16
37571,Givilwtf,eredar,1421,rogue,subtlety,66,33,33
37572,Zx,frostmane,1420,rogue,subtlety,36,17,19
37573,Sùbzerø,archimonde,1419,rogue,subtlety,36,18,18
37574,Grimdoll,tarren-mill,1418,rogue,subtlety,193,108,85
37575,Nìghtwalker,ravencrest,1416,rogue,subtlety,94,49,45
37576,Darkxenojiva,blackmoore,1415,rogue,subtlety,54,22,32
37577,Doperog,antonidas,1414,rogue,subtlety,78,45,33
37578,Xblackhole,tarren-mill,1414,rogue,subtlety,104,52,52
37579,Elfreyja,archimonde,1413,rogue,subtlety,69,33,36
37580,Жабоклик,gordunni,1412,rogue,subtlety,92,47,45
37581,Svddendeath,ragnaros,1412,rogue,subtlety,59,30,29
37582,Самерон,howling-fjord,1411,rogue,subtlety,36,24,12
37583,Xulem,silvermoon,1411,rogue,subtlety,58,34,24
37584,Augustina,draenor,1410,rogue,subtlety,30,15,15
37585,Сабик,howling-fjord,1408,rogue,subtlety,36,22,14
37586,Râáy,blackrock,1408,rogue,subtlety,114,52,62
37587,Doxxei,draenor,1407,rogue,subtlety,148,78,70
37588,Kyssme,archimonde,1407,rogue,subtlety,36,15,21
37589,Jamzyrogue,emerald-dream,1405,rogue,subtlety,36,19,17
37590,Teba,cthun,1404,rogue,subtlety,40,19,21
37591,Ворейн,howling-fjord,1402,rogue,subtlety,114,57,57
37592,Sumsarx,ravencrest,1400,rogue,subtlety,77,38,39
37593,Decoyed,sylvanas,1400,rogue,subtlety,36,17,19
37594,Морнер,howling-fjord,1398,rogue,subtlety,54,27,27
37595,Deathcvlt,hyjal,1398,rogue,subtlety,226,112,114
37596,Jáyjay,antonidas,1395,rogue,subtlety,66,28,38
37597,Galathea,turalyon,1394,rogue,subtlety,90,46,44
37598,Zeiden,sanguino,1393,rogue,subtlety,48,23,25
37599,Exbandit,sanguino,1392,rogue,subtlety,54,36,18
37600,Rhûlf,ravencrest,1392,rogue,subtlety,55,27,28
37601,Actualcarry,dentarg,1391,rogue,subtlety,50,28,22
37602,Chipson,kazzak,1391,rogue,subtlety,36,17,19
37603,Cortzy,stormscale,1391,rogue,subtlety,40,15,25
37604,Skillissuex,tarren-mill,1389,rogue,subtlety,298,160,138
37605,Midoa,nerathor,1388,rogue,subtlety,34,23,11
37606,Ðàrx,archimonde,1388,rogue,subtlety,36,17,19
37607,Billybang,outland,1387,rogue,subtlety,88,48,40
37608,Daekrun,argent-dawn,1387,rogue,subtlety,56,30,26
37609,Fullblind,tarren-mill,1387,rogue,subtlety,51,27,24
37610,Бэтх,soulflayer,1386,rogue,subtlety,54,32,22
37611,Rêve,the-maelstrom,1386,rogue,subtlety,34,19,15
37612,Смекрус,soulflayer,1386,rogue,subtlety,117,59,58
37613,Rexore,ravencrest,1385,rogue,subtlety,30,15,15
37614,Lechatbotté,tarren-mill,1384,rogue,subtlety,48,29,19
37615,Ryzem,archimonde,1383,rogue,subtlety,381,200,181
37616,Tripoid,draenor,1381,rogue,subtlety,54,25,29
37617,Дакоока,soulflayer,1378,rogue,subtlety,24,16,8
37618,Óoo,outland,1377,rogue,subtlety,36,18,18
37619,Trímønâ,gorgonnash,1374,rogue,subtlety,36,16,20
37620,Crimatoria,rajaxx,1373,rogue,subtlety,51,23,28
37621,Binbág,draenor,1372,rogue,subtlety,108,62,46
37622,Дернирог,howling-fjord,1372,rogue,subtlety,67,33,34
37623,Анивиана,howling-fjord,1371,rogue,subtlety,134,64,70
37624,Appatras,tarren-mill,1369,rogue,subtlety,23,15,8
37625,Kryptonite,nemesis,1368,rogue,subtlety,52,27,25
37626,Behindü,frostmane,1368,rogue,subtlety,54,27,27
37627,Ванябигпуш,blackscar,1367,rogue,subtlety,54,27,27
37628,Subhub,ragnaros,1366,rogue,subtlety,48,21,27
37629,Gankbang,frostmane,1363,rogue,subtlety,78,35,43
37630,Dàwn,boulderfist,1361,rogue,subtlety,58,32,26
37631,Эвисирейт,gordunni,1356,rogue,subtlety,36,17,19
37632,Feinted,kazzak,1354,rogue,subtlety,80,40,40
37633,Зенофар,soulflayer,1353,rogue,subtlety,190,88,102
37634,Gamezcorex,aegwynn,1353,rogue,subtlety,52,22,30
37635,Кэйтлис,howling-fjord,1353,rogue,subtlety,42,17,25
37636,Trimøná,gorgonnash,1351,rogue,subtlety,24,15,9
37637,Kãlí,blackmoore,1349,rogue,subtlety,42,19,23
37638,Vexior,argent-dawn,1347,rogue,subtlety,51,22,29
37639,Эквалири,gordunni,1345,rogue,subtlety,71,33,38
37640,Lilrookie,argent-dawn,1344,rogue,subtlety,104,58,46
37641,Freemmr,draenor,1344,rogue,subtlety,65,32,33
37642,Evasión,aegwynn,1343,rogue,subtlety,42,22,20
37643,Såj,tarren-mill,1343,rogue,subtlety,30,14,16
37644,Stealthi,stormscale,1343,rogue,subtlety,36,14,22
37645,Lilbubblegum,emerald-dream,1342,rogue,subtlety,24,14,10
37646,Roguestuff,silvermoon,1341,rogue,subtlety,18,14,4
37647,Lêmon,argent-dawn,1341,rogue,subtlety,40,24,16
37648,Aati,the-maelstrom,1341,rogue,subtlety,48,25,23
37649,Akyô,archimonde,1340,rogue,subtlety,24,14,10
37650,Tripx,ravencrest,1340,rogue,subtlety,121,64,57
37651,Althieves,ravencrest,1339,rogue,subtlety,94,51,43
37652,Sapperinö,sylvanas,1338,rogue,subtlety,227,114,113
37653,Venøøm,eredar,1338,rogue,subtlety,56,28,28
37654,Эренх,gordunni,1337,rogue,subtlety,137,71,66
37655,Simsub,tarren-mill,1337,rogue,subtlety,30,14,16
37656,Nitelite,outland,1335,rogue,subtlety,30,14,16
37657,Yakio,silvermoon,1334,rogue,subtlety,48,19,29
37658,Isucu,burning-legion,1333,rogue,subtlety,72,40,32
37659,Ñavy,archimonde,1332,rogue,subtlety,78,33,45
37660,Maam,ravencrest,1331,rogue,subtlety,48,26,22
37661,Пораменяться,gordunni,1328,rogue,subtlety,117,55,62
37662,Akira,outland,1327,rogue,subtlety,78,46,32
37663,Wraithh,minahonda,1327,rogue,subtlety,60,31,29
37664,Bleeds,thrall,1324,rogue,subtlety,47,24,23
37665,Jenz,blackmoore,1321,rogue,subtlety,30,14,16
37666,Mercyã,outland,1316,rogue,subtlety,54,29,25
37667,Knifeparty,silvermoon,1316,rogue,subtlety,30,16,14
37668,Pidroseus,argent-dawn,1316,rogue,subtlety,35,16,19
37669,Saptrinket,stormscale,1316,rogue,subtlety,337,154,183
37670,Decrios,outland,1315,rogue,subtlety,36,14,22
37671,Shiréz,blackmoore,1311,rogue,subtlety,54,29,25
37672,Boorza,silvermoon,1309,rogue,subtlety,30,16,14
37673,Ultraviølett,gorgonnash,1308,rogue,subtlety,46,20,26
37674,Levíeus,blackrock,1305,rogue,subtlety,132,73,59
37675,Bloodwraith,stormscale,1305,rogue,subtlety,36,14,22
37676,Monoxid,eredar,1302,rogue,subtlety,63,31,32
37677,Sicariø,argent-dawn,1301,rogue,subtlety,53,25,28
37678,Luckeri,antonidas,1300,rogue,subtlety,66,32,34
37679,Эйфуча,gordunni,1298,rogue,subtlety,52,26,26
37680,Моямайя,eversong,1293,rogue,subtlety,53,25,28
37681,Интерфи,blackscar,1293,rogue,subtlety,68,31,37
37682,Roguebot,draenor,1290,rogue,subtlety,65,32,33
37683,Cataleýa,outland,1289,rogue,subtlety,24,16,8
37684,Qiiss,stormscale,1287,rogue,subtlety,48,26,22
37685,Kouru,outland,1287,rogue,subtlety,42,20,22
37686,Yokze,ravencrest,1287,rogue,subtlety,36,15,21
37687,Cnac,stormscale,1286,rogue,subtlety,46,18,28
37688,Йзвинись,howling-fjord,1284,rogue,subtlety,42,21,21
37689,Jimaal,stormscale,1283,rogue,subtlety,42,20,22
37690,Прошмандэ,gordunni,1282,rogue,subtlety,30,15,15
37691,Тучёна,soulflayer,1281,rogue,subtlety,60,35,25
37692,Ракфорн,howling-fjord,1281,rogue,subtlety,161,77,84
37693,Fugly,ragnaros,1281,rogue,subtlety,37,14,23
37694,Swâggerino,kazzak,1280,rogue,subtlety,62,32,30
37695,Xeggy,turalyon,1279,rogue,subtlety,166,92,74
37696,Niapro,dun-morogh,1277,rogue,subtlety,42,21,21
37697,Лофиан,gordunni,1275,rogue,subtlety,60,28,32
37698,Pixelrogue,argent-dawn,1274,rogue,subtlety,34,20,14
37699,Backcracker,thunderhorn,1274,rogue,subtlety,30,15,15
37700,Мипракн,fordragon,1273,rogue,subtlety,36,25,11
37701,Ézzah,blackhand,1273,rogue,subtlety,110,47,63
37702,Ouvrebwate,archimonde,1272,rogue,subtlety,23,14,9
37703,Guiltythief,stormscale,1272,rogue,subtlety,37,18,19
37704,Янимагу,soulflayer,1271,rogue,subtlety,55,24,31
37705,Zanaken,stormscale,1270,rogue,subtlety,181,90,91
37706,Sénsorium,draenor,1267,rogue,subtlety,119,58,61
37707,Шикорро,soulflayer,1266,rogue,subtlety,36,18,18
37708,Chãøs,silvermoon,1265,rogue,subtlety,24,15,9
37709,Smeyra,magtheridon,1262,rogue,subtlety,114,63,51
37710,Ултра,gordunni,1262,rogue,subtlety,141,69,72
37711,Subzy,burning-legion,1260,rogue,subtlety,120,63,57
37712,Usainßreak,chogall,1258,rogue,subtlety,24,14,10
37713,Cesârion,antonidas,1258,rogue,subtlety,255,123,132
37714,Callboy,turalyon,1256,rogue,subtlety,42,20,22
37715,Yasu,outland,1256,rogue,subtlety,46,20,26
37716,Фирмиана,howling-fjord,1253,rogue,subtlety,66,35,31
37717,Axelaz,ravencrest,1247,rogue,subtlety,24,13,11
37718,Xyúmopjoßblú,ravencrest,1247,rogue,subtlety,30,13,17
37719,Missesinvis,blackmoore,1246,rogue,subtlety,18,13,5
37720,Latscholol,malorne,1245,rogue,subtlety,96,50,46
37721,Зити,blackscar,1243,rogue,subtlety,24,13,11
37722,Masanari,die-nachtwache,1243,rogue,subtlety,38,15,23
37723,Cørek,blackhand,1241,rogue,subtlety,24,13,11
37724,Vanquishz,arathor,1240,rogue,subtlety,30,13,17
37725,Gingahboy,doomhammer,1239,rogue,subtlety,161,93,68
37726,Лэйкиро,gordunni,1239,rogue,subtlety,24,13,11
37727,Sambä,sanguino,1238,rogue,subtlety,54,27,27
37728,Cowmbat,tarren-mill,1238,rogue,subtlety,32,14,18
37729,Злайа,blackscar,1238,rogue,subtlety,42,17,25
37730,Eriksonn,drakthul,1237,rogue,subtlety,37,17,20
37731,Лиргенвард,deathguard,1236,rogue,subtlety,64,25,39
37732,Siktiritos,malganis,1232,rogue,subtlety,66,30,36
37733,Sheldowws,tarren-mill,1231,rogue,subtlety,24,13,11
37734,Alekkush,silvermoon,1231,rogue,subtlety,30,13,17
37735,Nexieane,ravencrest,1230,rogue,subtlety,154,76,78
37736,Jugalos,ravencrest,1230,rogue,subtlety,35,13,22
37737,Djeud,archimonde,1229,rogue,subtlety,76,45,31
37738,Kïdney,stormscale,1228,rogue,subtlety,48,26,22
37739,Silnce,outland,1227,rogue,subtlety,78,36,42
37740,Yamajinzu,blackmoore,1227,rogue,subtlety,72,33,39
37741,Suikastman,silvermoon,1225,rogue,subtlety,22,14,8
37742,Vorsix,tarren-mill,1222,rogue,subtlety,32,18,14
37743,Wøølfgang,archimonde,1222,rogue,subtlety,83,39,44
37744,Пузэн,howling-fjord,1221,rogue,subtlety,72,48,24
37745,Misantropia,nemesis,1220,rogue,subtlety,96,41,55
37746,Галиновна,soulflayer,1218,rogue,subtlety,67,33,34
37747,Arrzhan,silvermoon,1217,rogue,subtlety,80,47,33
37748,Inextricabil,stormscale,1217,rogue,subtlety,30,14,16
37749,Эрихард,howling-fjord,1217,rogue,subtlety,35,16,19
37750,Asine,boulderfist,1217,rogue,subtlety,30,13,17
37751,Zergroidz,kazzak,1215,rogue,subtlety,140,67,73
37752,Buttonsfly,silvermoon,1214,rogue,subtlety,74,49,25
37753,Ксионас,gordunni,1212,rogue,subtlety,82,36,46
37754,Zavebe,nathrezim,1212,rogue,subtlety,33,14,19
37755,Stin,blackrock,1212,rogue,subtlety,94,39,55
37756,Mealy,auchindoun,1211,rogue,subtlety,66,32,34
37757,Duzhel,kazzak,1211,rogue,subtlety,29,14,15
37758,Vanéry,ravencrest,1210,rogue,subtlety,24,13,11
37759,Theriaeu,ravencrest,1207,rogue,subtlety,51,26,25
37760,Gansull,nemesis,1207,rogue,subtlety,30,13,17
37761,Ganker,antonidas,1202,rogue,subtlety,30,15,15
37762,Heulleise,die-ewige-wacht,1201,rogue,subtlety,27,15,12
37763,Трикстэд,soulflayer,1197,rogue,subtlety,24,14,10
37764,Nínjutsu,ravencrest,1197,rogue,subtlety,32,14,18
37765,Xaiko,baelgun,1196,rogue,subtlety,38,23,15
37766,Erenyeagerx,kazzak,1194,rogue,subtlety,89,41,48
37767,Zelìx,frostmane,1190,rogue,subtlety,48,29,19
37768,Maxtnulaujeu,archimonde,1190,rogue,subtlety,59,29,30
37769,Чайрлайн,blackscar,1190,rogue,subtlety,40,17,23
37770,Zvarka,drakthul,1185,rogue,subtlety,18,13,5
37771,Киржик,soulflayer,1183,rogue,subtlety,36,18,18
37772,Рестинписер,soulflayer,1183,rogue,subtlety,135,65,70
37773,Venom,stormscale,1182,rogue,subtlety,17,13,4
37774,Adwl,archimonde,1182,rogue,subtlety,135,62,73
37775,Hashlund,stormscale,1181,rogue,subtlety,38,17,21
37776,Ithru,twisting-nether,1179,rogue,subtlety,225,118,107
37777,Валанбалас,soulflayer,1179,rogue,subtlety,48,25,23
37778,Попочке,soulflayer,1175,rogue,subtlety,36,23,13
37779,Thehand,eonar,1175,rogue,subtlety,72,39,33
37780,Tyrly,ravencrest,1175,rogue,subtlety,112,50,62
37781,Shuffeyrt,frostmane,1172,rogue,subtlety,48,26,22
37782,Сладкийперец,borean-tundra,1172,rogue,subtlety,52,24,28
37783,Rogueseanne,blackrock,1171,rogue,subtlety,72,32,40
37784,Jisz,doomhammer,1170,rogue,subtlety,78,39,39
37785,Mckk,tarren-mill,1168,rogue,subtlety,71,36,35
37786,Taniwa,archimonde,1167,rogue,subtlety,53,23,30
37787,Ropedrink,stormscale,1161,rogue,subtlety,21,13,8
37788,Heskmad,kazzak,1161,rogue,subtlety,50,22,28
37789,Lêgòlàs,blackmoore,1160,rogue,subtlety,101,56,45
37790,Ðarëk,dun-modr,1159,rogue,subtlety,48,19,29
37791,Darkan,kaelthas,1158,rogue,subtlety,66,38,28
37792,Instealth,draenor,1155,rogue,subtlety,108,45,63
37793,Flambî,dalaran,1153,rogue,subtlety,82,41,41
37794,Скорпеон,deathguard,1152,rogue,subtlety,48,32,16
37795,Nasklagattv,hyjal,1152,rogue,subtlety,18,12,6
37796,Skitzo,ravencrest,1152,rogue,subtlety,24,12,12
37797,Озхоггер,gordunni,1151,rogue,subtlety,18,12,6
37798,Vizifyx,ravencrest,1150,rogue,subtlety,18,12,6
37799,Stepdancer,blackmoore,1150,rogue,subtlety,24,12,12
37800,Нойсеен,gordunni,1150,rogue,subtlety,24,12,12
37801,Hængøvèr,antonidas,1150,rogue,subtlety,30,12,18
37802,Mecu,ravencrest,1149,rogue,subtlety,18,12,6
37803,Byebyé,ravencrest,1149,rogue,subtlety,24,12,12
37804,Narar,stormscale,1147,rogue,subtlety,36,23,13
37805,Teralala,kazzak,1146,rogue,subtlety,24,12,12
37806,Коффемолка,ashenvale,1146,rogue,subtlety,66,26,40
37807,Sâybyëbæ,dun-modr,1142,rogue,subtlety,30,12,18
37808,Jomoama,norgannon,1142,rogue,subtlety,36,14,22
37809,Mitaktika,silvermoon,1140,rogue,subtlety,18,12,6
37810,Lovetospoon,ravencrest,1140,rogue,subtlety,43,22,21
37811,Turrok,ravencrest,1139,rogue,subtlety,36,17,19
37812,Avøry,antonidas,1139,rogue,subtlety,48,15,33
37813,Smoothiè,twisting-nether,1138,rogue,subtlety,82,37,45
37814,Valiéna,dun-morogh,1136,rogue,subtlety,52,20,32
37815,Ithilyien,blackmoore,1134,rogue,subtlety,62,21,41
37816,Paveli,ravencrest,1133,rogue,subtlety,66,28,38
37817,Berneo,burning-legion,1133,rogue,subtlety,36,13,23
37818,Niinim,draenor,1129,rogue,subtlety,207,112,95
37819,Duo,karazhan,1128,rogue,subtlety,54,18,36
37820,Anala,stormreaver,1123,rogue,subtlety,24,14,10
37821,Faelylanea,argent-dawn,1122,rogue,subtlety,36,16,20
37822,Ambushmike,gorgonnash,1121,rogue,subtlety,87,40,47
37823,Sebik,ravencrest,1118,rogue,subtlety,23,12,11
37824,Neoly,outland,1117,rogue,subtlety,24,16,8
37825,Mysies,ysondre,1117,rogue,subtlety,29,13,16
37826,Coronababy,argent-dawn,1111,rogue,subtlety,24,13,11
37827,Lånaya,sylvanas,1111,rogue,subtlety,42,17,25
37828,Obsçuritý,ragnaros,1106,rogue,subtlety,56,31,25
37829,Unreallx,silvermoon,1102,rogue,subtlety,80,36,44
37830,Denjas,archimonde,1098,rogue,subtlety,28,15,13
37831,Stuxothug,silvermoon,1097,rogue,subtlety,61,33,28
37832,Coaraze,eldrethalas,1096,rogue,subtlety,30,12,18
37833,Jailkaz,thrall,1093,rogue,subtlety,29,13,16
37834,Koutzai,stormscale,1090,rogue,subtlety,53,20,33
37835,Syneth,drakthul,1087,rogue,subtlety,21,13,8
37836,Беточка,gordunni,1087,rogue,subtlety,54,31,23
37837,Yüm,burning-blade,1087,rogue,subtlety,59,25,34
37838,Blantek,defias-brotherhood,1083,rogue,subtlety,30,16,14
37839,Dallrend,stormscale,1078,rogue,subtlety,36,16,20
37840,Underarmor,kul-tiras,1078,rogue,subtlety,45,14,31
37841,Fastspectre,ravencrest,1077,rogue,subtlety,54,29,25
37842,Stâr,archimonde,1077,rogue,subtlety,28,13,15
37843,Зацеп,gordunni,1073,rogue,subtlety,36,22,14
37844,Zenajlz,outland,1073,rogue,subtlety,22,12,10
37845,Streîk,hyjal,1072,rogue,subtlety,72,32,40
37846,Löka,amanthul,1071,rogue,subtlety,117,59,58
37847,Псиихооз,eversong,1070,rogue,subtlety,25,13,12
37848,Vampor,sylvanas,1070,rogue,subtlety,42,13,29
37849,Jacktripper,blackrock,1066,rogue,subtlety,30,12,18
37850,Розбэйник,gordunni,1065,rogue,subtlety,42,23,19
37851,Copoka,dun-morogh,1063,rogue,subtlety,30,16,14
37852,Zkittlez,blackhand,1056,rogue,subtlety,18,11,7
37853,Elnyasha,ravencrest,1056,rogue,subtlety,24,11,13
37854,Sátyrícon,ravencrest,1056,rogue,subtlety,24,11,13
37855,Roundrobin,ravencrest,1056,rogue,subtlety,30,11,19
37856,Xyzonk,kazzak,1055,rogue,subtlety,18,11,7
37857,Like,aegwynn,1055,rogue,subtlety,21,12,9
37858,Сабанутый,howling-fjord,1055,rogue,subtlety,96,52,44
37859,Aouron,archimonde,1055,rogue,subtlety,25,13,12
37860,Флеймсфорт,gordunni,1055,rogue,subtlety,35,16,19
37861,Hersuub,blackmoore,1055,rogue,subtlety,41,18,23
37862,Adskydroch,ravencrest,1054,rogue,subtlety,18,11,7
37863,Kleptomancy,sylvanas,1054,rogue,subtlety,18,11,7
37864,Режупополам,howling-fjord,1052,rogue,subtlety,18,11,7
37865,Murkyy,gilneas,1052,rogue,subtlety,18,11,7
37866,Zappsarap,onyxia,1052,rogue,subtlety,24,11,13
37867,Bamsejuicee,kazzak,1050,rogue,subtlety,18,11,7
37868,Johnyqt,hyjal,1049,rogue,subtlety,18,11,7
37869,Shirá,hyjal,1049,rogue,subtlety,18,11,7
37870,Йованов,gordunni,1048,rogue,subtlety,18,11,7
37871,Celendyl,ravencrest,1045,rogue,subtlety,24,13,11
37872,Соважь,soulflayer,1044,rogue,subtlety,24,11,13
37873,Meshay,kazzak,1043,rogue,subtlety,19,11,8
37874,Вишнуизм,gordunni,1043,rogue,subtlety,30,11,19
37875,Snack,burning-legion,1040,rogue,subtlety,27,12,15
37876,Fodepalmas,sanguino,1040,rogue,subtlety,53,22,31
37877,Pochîta,blackrock,1038,rogue,subtlety,53,24,29
37878,Mojojina,theradras,1037,rogue,subtlety,24,12,12
37879,Drakaess,archimonde,1032,rogue,subtlety,24,11,13
37880,Protolink,zuljin,1032,rogue,subtlety,64,25,39
37881,Bandèra,ragnaros,1032,rogue,subtlety,42,16,26
37882,Whaiipy,ravencrest,1031,rogue,subtlety,95,53,42
37883,Горланг,ashenvale,1031,rogue,subtlety,29,15,14
37884,Calyon,hyjal,1031,rogue,subtlety,47,12,35
37885,ßøß,ysondre,1030,rogue,subtlety,74,32,42
37886,Shibaii,archimonde,1029,rogue,subtlety,54,17,37
37887,Finkle,blackmoore,1027,rogue,subtlety,30,11,19
37888,Nirvána,outland,1026,rogue,subtlety,73,35,38
37889,Byonics,durotan,1024,rogue,subtlety,18,11,7
37890,Зебол,howling-fjord,1024,rogue,subtlety,36,17,19
37891,Yamoshí,sanguino,1024,rogue,subtlety,34,15,19
37892,Рэйбэк,howling-fjord,1024,rogue,subtlety,30,11,19
37893,Умбрен,lich-king,1016,rogue,subtlety,30,18,12
37894,Mercìles,kazzak,1011,rogue,subtlety,43,25,18
37895,Idrîl,rashgarroth,1009,rogue,subtlety,24,14,10
37896,Вайлиция,ashenvale,1007,rogue,subtlety,39,21,18
37897,Lyroth,silvermoon,1002,rogue,subtlety,17,11,6
37898,Xoxoxoxoxoxö,archimonde,1001,rogue,subtlety,29,13,16
37899,Skankky,ragnaros,1000,rogue,subtlety,18,12,6
37900,Sênsus,antonidas,999,rogue,subtlety,86,30,56
37901,Leylaris,argent-dawn,998,rogue,subtlety,30,12,18
37902,Axeldarq,draenor,998,rogue,subtlety,39,11,28
37903,Cuckboy,chogall,997,rogue,subtlety,55,31,24
37904,Rêdbello,dun-morogh,997,rogue,subtlety,57,32,25
37905,Drakhez,sanguino,995,rogue,subtlety,18,12,6
37906,Bartolomew,hellscream,995,rogue,subtlety,27,12,15
37907,Pitmaster,burning-legion,992,rogue,subtlety,71,35,36
37908,Sassasine,amanthul,992,rogue,subtlety,58,26,32
37909,Garretygdar,nazjatar,991,rogue,subtlety,30,14,16
37910,Mïta,blackmoore,991,rogue,subtlety,30,11,19
37911,Эбиб,soulflayer,987,rogue,subtlety,22,11,11
37912,Jorppe,kazzak,986,rogue,subtlety,24,12,12
37913,Charbiya,silvermoon,986,rogue,subtlety,24,12,12
37914,Fizgaroth,argent-dawn,980,rogue,subtlety,55,31,24
37915,Thicck,twisting-nether,980,rogue,subtlety,48,13,35
37916,Gimliwitdega,doomhammer,977,rogue,subtlety,142,74,68
37917,Sycko,alakir,976,rogue,subtlety,48,28,20
37918,Dudemar,ravencrest,975,rogue,subtlety,24,11,13
37919,Тайнушка,soulflayer,973,rogue,subtlety,42,17,25
37920,Reginlief,argent-dawn,972,rogue,subtlety,47,21,26
37921,Ratolí,dun-modr,970,rogue,subtlety,18,12,6
37922,Mannheim,kazzak,968,rogue,subtlety,42,23,19
37923,Asukabed,ravencrest,960,rogue,subtlety,18,10,8
37924,Ripuli,alakir,960,rogue,subtlety,18,10,8
37925,Katarïnä,khaz-modan,960,rogue,subtlety,36,19,17
37926,Párbajkároj,ragnaros,960,rogue,subtlety,24,10,14
37927,Mestarikélmi,ravencrest,960,rogue,subtlety,27,10,17
37928,Noboorstsub,ravencrest,959,rogue,subtlety,12,10,2
37929,Spykee,culte-de-la-rive-noire,959,rogue,subtlety,12,10,2
37930,Doomdagger,chamber-of-aspects,959,rogue,subtlety,18,10,8
37931,Bizzarerogue,tarren-mill,959,rogue,subtlety,18,10,8
37932,Meowkek,kazzak,959,rogue,subtlety,24,10,14
37933,Reichy,ravencrest,959,rogue,subtlety,24,10,14
37934,Jussylol,stormscale,958,rogue,subtlety,18,10,8
37935,Bountyhunter,malygos,958,rogue,subtlety,18,10,8
37936,Jdç,tarren-mill,958,rogue,subtlety,18,10,8
37937,Dedka,hyjal,958,rogue,subtlety,24,10,14
37938,Ruckusxx,ravencrest,957,rogue,subtlety,15,11,4
37939,Clinz,ravencrest,956,rogue,subtlety,24,10,14
37940,Ilyrya,azuremyst,955,rogue,subtlety,18,10,8
37941,Cozu,stormrage,955,rogue,subtlety,74,39,35
37942,Øê,ravencrest,955,rogue,subtlety,21,10,11
37943,Oazo,ysondre,954,rogue,subtlety,47,18,29
37944,Stabymoose,draenor,953,rogue,subtlety,18,10,8
37945,Káríc,draenor,953,rogue,subtlety,18,10,8
37946,Ассаин,gordunni,952,rogue,subtlety,19,12,7
37947,Helcof,emerald-dream,951,rogue,subtlety,24,10,14
37948,Bzuco,tarren-mill,950,rogue,subtlety,12,10,2
37949,Baldim,silvermoon,949,rogue,subtlety,19,10,9
37950,Gìngèr,kazzak,948,rogue,subtlety,18,10,8
37951,Cantseeme,anachronos,947,rogue,subtlety,30,10,20
37952,Neymar,ysondre,943,rogue,subtlety,24,10,14
37953,Синграйм,soulflayer,942,rogue,subtlety,48,26,22
37954,Prøven,archimonde,940,rogue,subtlety,30,10,20
37955,Mishøna,kazzak,939,rogue,subtlety,73,41,32
37956,Ramone,ravencrest,935,rogue,subtlety,19,11,8
37957,Sentaria,argent-dawn,930,rogue,subtlety,60,31,29
37958,Hemorhoid,outland,928,rogue,subtlety,96,50,46
37959,Owoaho,eonar,926,rogue,subtlety,24,14,10
37960,Снарки,booty-bay,925,rogue,subtlety,64,31,33
37961,Roguegutten,quelthalas,917,rogue,subtlety,20,11,9
37962,Strikes,eredar,915,rogue,subtlety,30,16,14
37963,Exi,elune,912,rogue,subtlety,27,11,16
37964,Sensule,darkspear,908,rogue,subtlety,23,10,13
37965,Petsakos,ravencrest,903,rogue,subtlety,27,11,16
37966,Wìzléy,ravencrest,901,rogue,subtlety,63,32,31
37967,Kezaay,silvermoon,900,rogue,subtlety,36,18,18
37968,Trinchö,sanguino,894,rogue,subtlety,56,25,31
37969,Bursthilde,blackmoore,893,rogue,subtlety,23,10,13
37970,Lenwe,blackmoore,892,rogue,subtlety,24,10,14
37971,Saroumani,eitrigg,891,rogue,subtlety,30,16,14
37972,Dainhek,gilneas,889,rogue,subtlety,37,19,18
37973,Lolblizard,gorgonnash,881,rogue,subtlety,21,12,9
37974,Liquidgaba,ravencrest,878,rogue,subtlety,78,37,41
37975,Mortdorei,argent-dawn,877,rogue,subtlety,79,39,40
37976,Sneakysáp,ravencrest,864,rogue,subtlety,12,9,3
37977,Фрозенденс,gordunni,864,rogue,subtlety,12,9,3
37978,Kostik,ravencrest,864,rogue,subtlety,12,9,3
37979,Hængøver,antonidas,864,rogue,subtlety,12,9,3
37980,Rúckus,ravencrest,864,rogue,subtlety,18,9,9
37981,Geá,ravencrest,864,rogue,subtlety,18,9,9
37982,Axroa,blackmoore,864,rogue,subtlety,18,9,9
37983,Ðéstr,ravencrest,864,rogue,subtlety,18,9,9
37984,Nasklagatv,rashgarroth,864,rogue,subtlety,18,9,9
37985,Ambulances,kazzak,863,rogue,subtlety,12,9,3
37986,Visegrád,aggra-português,863,rogue,subtlety,12,9,3
37987,Behêmoth,hyjal,863,rogue,subtlety,12,9,3
37988,Skullboy,blackmoore,863,rogue,subtlety,18,9,9
37989,Monstermads,kazzak,863,rogue,subtlety,18,9,9
37990,Lenani,blackrock,863,rogue,subtlety,18,9,9
37991,Рэкрейвон,gordunni,863,rogue,subtlety,18,9,9
37992,Ryvz,ravencrest,863,rogue,subtlety,24,9,15
37993,Oldschool,sanguino,862,rogue,subtlety,18,9,9
37994,Ibizà,ravencrest,862,rogue,subtlety,18,9,9
37995,Psg,argent-dawn,862,rogue,subtlety,19,9,10
37996,Crixor,blackrock,861,rogue,subtlety,12,9,3
37997,Orestes,pozzo-delleternità,861,rogue,subtlety,18,9,9
37998,Duffbeer,silvermoon,861,rogue,subtlety,18,9,9
37999,Isodad,kazzak,861,rogue,subtlety,18,9,9
38000,Shinkillua,archimonde,860,rogue,subtlety,18,9,9
38001,Eightball,frostmane,859,rogue,subtlety,18,9,9
38002,Jäshin,hyjal,859,rogue,subtlety,30,9,21
38003,Куцитар,gordunni,858,rogue,subtlety,18,9,9
38004,Sequoja,blackrock,858,rogue,subtlety,24,9,15
38005,Zhopsy,nemesis,857,rogue,subtlety,24,9,15
38006,Davshadows,magtheridon,855,rogue,subtlety,42,18,24
38007,Антиппод,razuvious,854,rogue,subtlety,15,10,5
38008,Vanquish,laughing-skull,844,rogue,subtlety,12,9,3
38009,Пандафей,deathweaver,831,rogue,subtlety,24,9,15
38010,Lastkiss,aggramar,828,rogue,subtlety,17,9,8
38011,Cabalion,draenor,828,rogue,subtlety,24,11,13
38012,Aeønaxx,hyjal,827,rogue,subtlety,76,32,44
38013,Муфдшы,gordunni,823,rogue,subtlety,16,10,6
38014,Tnk,twisting-nether,817,rogue,subtlety,18,10,8
38015,Jabbo,silvermoon,809,rogue,subtlety,29,9,20
38016,Jénny,sylvanas,799,rogue,subtlety,74,34,40
38017,Hahårry,ravencrest,797,rogue,subtlety,20,9,11
38018,Singularität,silvermoon,796,rogue,subtlety,27,11,16
38019,Houston,aegwynn,792,rogue,subtlety,20,9,11
38020,Knifeex,ravencrest,788,rogue,subtlety,26,9,17
38021,Ecray,burning-legion,784,rogue,subtlety,74,34,40
38022,Skene,sanguino,780,rogue,subtlety,35,13,22
38023,Danori,grim-batol,768,rogue,subtlety,12,8,4
38024,Devourswine,argent-dawn,768,rogue,subtlety,12,8,4
38025,Djdillá,kazzak,768,rogue,subtlety,12,8,4
38026,Фрозенблейдс,gordunni,768,rogue,subtlety,12,8,4
38027,Rannec,der-rat-von-dalaran,768,rogue,subtlety,12,8,4
38028,Kerim,antonidas,768,rogue,subtlety,12,8,4
38029,Tilikum,pozzo-delleternità,768,rogue,subtlety,12,8,4
38030,Кишмякх,gordunni,768,rogue,subtlety,15,9,6
38031,Whoton,archimonde,768,rogue,subtlety,16,9,7
38032,Amuini,magtheridon,768,rogue,subtlety,18,8,10
38033,Zygzäg,hyjal,768,rogue,subtlety,18,8,10
38034,Slonerbrah,ravencrest,768,rogue,subtlety,18,8,10
38035,Slayered,burning-legion,768,rogue,subtlety,24,8,16
38036,Ferrãof,aggra-português,767,rogue,subtlety,12,8,4
38037,Silesi,kazzak,767,rogue,subtlety,12,8,4
38038,Huro,aggramar,767,rogue,subtlety,12,8,4
38039,Thelones,antonidas,767,rogue,subtlety,12,8,4
38040,Neyokqt,blackrock,767,rogue,subtlety,12,8,4
38041,Zëkke,sanguino,767,rogue,subtlety,12,8,4
38042,Ultriz,twisting-nether,767,rogue,subtlety,18,8,10
38043,Aahz,tarren-mill,767,rogue,subtlety,18,8,10
38044,Mdadx,stormreaver,767,rogue,subtlety,18,8,10
38045,Neverdyingx,ragnaros,767,rogue,subtlety,18,8,10
38046,Strangeboyxx,ravencrest,767,rogue,subtlety,18,8,10
38047,Unbanmepls,ravencrest,767,rogue,subtlety,18,8,10
38048,Evi,korgall,767,rogue,subtlety,18,8,10
38049,Cirell,tarren-mill,767,rogue,subtlety,18,8,10
38050,Whîspêr,ravencrest,767,rogue,subtlety,24,8,16
38051,Mns,drakthul,767,rogue,subtlety,24,8,16
38052,Иордани,gordunni,767,rogue,subtlety,24,8,16
38053,Chazsakaï,chogall,766,rogue,subtlety,12,8,4
38054,Чернабаев,soulflayer,766,rogue,subtlety,12,8,4
38055,Ytaku,stormscale,766,rogue,subtlety,13,8,5
38056,Dägorath,dun-modr,766,rogue,subtlety,16,9,7
38057,Sokillu,silvermoon,766,rogue,subtlety,18,8,10
38058,Jkrx,draenor,766,rogue,subtlety,18,8,10
38059,Dræmz,twisting-nether,765,rogue,subtlety,12,8,4
38060,Rhytmic,drakthul,765,rogue,subtlety,18,8,10
38061,Poughkeepsie,outland,765,rogue,subtlety,18,8,10
38062,Люняшка,booty-bay,765,rogue,subtlety,18,8,10
38063,Лоулайф,soulflayer,765,rogue,subtlety,18,8,10
38064,Pirry,sanguino,764,rogue,subtlety,12,8,4
38065,Behiq,aggramar,764,rogue,subtlety,12,8,4
38066,Purexrogue,dragonblight,764,rogue,subtlety,18,8,10
38067,Johncéná,stormscale,764,rogue,subtlety,18,8,10
38068,Chuckloriss,garona,764,rogue,subtlety,18,8,10
38069,Darkral,nemesis,764,rogue,subtlety,27,10,17
38070,Ojisanx,outland,764,rogue,subtlety,24,8,16
38071,Akcell,silvermoon,762,rogue,subtlety,12,8,4
38072,Deprress,silvermoon,762,rogue,subtlety,12,8,4
38073,Djinnx,malganis,762,rogue,subtlety,24,8,16
38074,Stabwøund,the-maelstrom,761,rogue,subtlety,12,8,4
38075,Onemine,sanguino,752,rogue,subtlety,12,8,4
38076,Всечтобыло,howling-fjord,748,rogue,subtlety,12,8,4
38077,Abomïñatïøñ,ravencrest,731,rogue,subtlety,48,16,32
38078,Gizr,haomarush,717,rogue,subtlety,47,17,30
38079,Briggo,silvermoon,714,rogue,subtlety,23,9,14
38080,Nakli,antonidas,713,rogue,subtlety,21,9,12
38081,Anklash,blackrock,711,rogue,subtlety,33,9,24
38082,Faable,silvermoon,709,rogue,subtlety,59,19,40
38083,Allchatoff,drakthul,703,rogue,subtlety,11,8,3
38084,Zygzåg,hyjal,703,rogue,subtlety,11,8,3
38085,Войенх,gordunni,703,rogue,subtlety,22,8,14
38086,Benvagin,hyjal,700,rogue,subtlety,26,8,18
38087,Naiikaii,aegwynn,688,rogue,subtlety,14,8,6
38088,Энбонни,gordunni,688,rogue,subtlety,19,8,11
38089,Триплсап,howling-fjord,672,rogue,subtlety,12,7,5
38090,Caípi,frostwolf,672,rogue,subtlety,12,7,5
38091,Steal,nemesis,672,rogue,subtlety,12,7,5
38092,Кумоо,gordunni,672,rogue,subtlety,12,7,5
38093,Lemaroxd,tarren-mill,672,rogue,subtlety,12,7,5
38094,Cucumber,laughing-skull,672,rogue,subtlety,12,7,5
38095,Fibpatrool,ravencrest,672,rogue,subtlety,12,7,5
38096,Zyggz,hyjal,672,rogue,subtlety,12,7,5
38097,Natillaa,dun-modr,672,rogue,subtlety,12,7,5
38098,Kolto,argent-dawn,672,rogue,subtlety,12,7,5
38099,Lovethighs,argent-dawn,672,rogue,subtlety,12,7,5
38100,Misttrogue,hyjal,672,rogue,subtlety,12,7,5
38101,Käz,argent-dawn,672,rogue,subtlety,18,7,11
38102,Rantie,onyxia,672,rogue,subtlety,18,7,11
38103,Sxpped,stormscale,672,rogue,subtlety,18,7,11
38104,Proilas,draenor,672,rogue,subtlety,18,7,11
38105,Rîzer,ravencrest,672,rogue,subtlety,18,7,11
38106,Hyake,zuljin,671,rogue,subtlety,12,7,5
38107,Zep,auchindoun,671,rogue,subtlety,12,7,5
38108,Казутора,lich-king,671,rogue,subtlety,12,7,5
38109,Qylu,argent-dawn,671,rogue,subtlety,12,7,5
38110,Faptastíc,blackmoore,671,rogue,subtlety,12,7,5
38111,Zyhmø,archimonde,671,rogue,subtlety,12,7,5
38112,Epi,stormrage,671,rogue,subtlety,12,7,5
38113,Evadeez,tarren-mill,671,rogue,subtlety,18,7,11
38114,Сабстил,soulflayer,671,rogue,subtlety,18,7,11
38115,Shadowgraph,eredar,671,rogue,subtlety,18,7,11
38116,Ellira,stormscale,671,rogue,subtlety,18,7,11
38117,Roronao,sanguino,671,rogue,subtlety,18,7,11
38118,Guzirogue,azshara,671,rogue,subtlety,18,7,11
38119,Totentánz,silvermoon,671,rogue,subtlety,18,7,11
38120,Daggoth,kiljaeden,671,rogue,subtlety,24,7,17
38121,Princip,drakthul,671,rogue,subtlety,24,7,17
38122,Nøtiçe,kazzak,671,rogue,subtlety,24,7,17
38123,Gpóínt,blackmoore,670,rogue,subtlety,12,7,5
38124,Shâdow,ravenholdt,670,rogue,subtlety,18,7,11
38125,Edaniel,draenor,670,rogue,subtlety,18,7,11
38126,Rekaens,sylvanas,670,rogue,subtlety,18,7,11
38127,Lepreuchan,archimonde,669,rogue,subtlety,12,7,5
38128,Elnos,conseil-des-ombres,668,rogue,subtlety,12,7,5
38129,Shanos,ravencrest,667,rogue,subtlety,12,7,5
38130,Pepperbox,twisting-nether,667,rogue,subtlety,12,7,5
38131,Malfeasance,argent-dawn,667,rogue,subtlety,18,7,11
38132,Natekoti,kazzak,667,rogue,subtlety,36,8,28
38133,Cacucoxpahu,kazzak,666,rogue,subtlety,12,7,5
38134,Энвитио,gordunni,665,rogue,subtlety,12,7,5
38135,Posaydon,malorne,664,rogue,subtlety,18,7,11
38136,Dellya,twisting-nether,660,rogue,subtlety,18,7,11
38137,Shaadowz,ragnaros,658,rogue,subtlety,12,7,5
38138,Waluuz,silvermoon,655,rogue,subtlety,11,7,4
38139,Kikkshifter,zuluhed,650,rogue,subtlety,18,7,11
38140,Snogri,burning-legion,648,rogue,subtlety,24,7,17
38141,Nineball,frostmane,638,rogue,subtlety,17,7,10
38142,Drspectres,tarren-mill,626,rogue,subtlety,78,20,58
38143,Wurzelzepp,blackrock,622,rogue,subtlety,17,7,10
38144,Ccrogue,nemesis,618,rogue,subtlety,15,7,8
38145,Snake,nethersturm,609,rogue,subtlety,39,8,31
38146,Alyannå,culte-de-la-rive-noire,607,rogue,subtlety,11,7,4
38147,Кийян,howling-fjord,606,rogue,subtlety,11,7,4
38148,Фогус,greymane,601,rogue,subtlety,14,8,6
38149,Zervi,silvermoon,586,rogue,subtlety,13,7,6
38150,Thiranor,cthun,583,rogue,subtlety,13,7,6
38151,Naiikaii,antonidas,576,rogue,subtlety,6,6,0
38152,Wítchblades,ravencrest,576,rogue,subtlety,6,6,0
38153,Shinti,eredar,576,rogue,subtlety,12,6,6
38154,Джокэссиди,blackscar,576,rogue,subtlety,12,6,6
38155,Babøønx,burning-legion,576,rogue,subtlety,12,6,6
38156,Nerfalliance,ravencrest,576,rogue,subtlety,12,6,6
38157,Nephology,ravencrest,576,rogue,subtlety,12,6,6
38158,Wraiith,chogall,576,rogue,subtlety,12,6,6
38159,Àlleyezonme,ravencrest,576,rogue,subtlety,12,6,6
38160,Veronkierto,stormreaver,576,rogue,subtlety,12,6,6
38161,Radgaa,draenor,576,rogue,subtlety,12,6,6
38162,Wtbmeld,tarren-mill,576,rogue,subtlety,12,6,6
38163,Ðelvin,dalaran,576,rogue,subtlety,12,6,6
38164,Уммиикк,goldrinn,576,rogue,subtlety,12,6,6
38165,Jabbz,blackhand,576,rogue,subtlety,12,6,6
38166,Nícks,tarren-mill,576,rogue,subtlety,12,6,6
38167,Leanderrisin,ragnaros,576,rogue,subtlety,12,6,6
38168,Feradelia,thrall,576,rogue,subtlety,12,6,6
38169,Ciosy,blackrock,576,rogue,subtlety,12,6,6
38170,Shreddera,ravencrest,576,rogue,subtlety,12,6,6
38171,Sapco,ravencrest,576,rogue,subtlety,12,6,6
38172,Marcel,blackrock,576,rogue,subtlety,12,6,6
38173,Prky,doomhammer,576,rogue,subtlety,12,6,6
38174,Daichi,onyxia,576,rogue,subtlety,12,6,6
38175,Deceptionz,ravencrest,576,rogue,subtlety,12,6,6
38176,Lesbinan,kazzak,576,rogue,subtlety,12,6,6
38177,Shoamunj,archimonde,576,rogue,subtlety,12,6,6
38178,Asäp,archimonde,576,rogue,subtlety,12,6,6
38179,Dimidimi,wildhammer,576,rogue,subtlety,12,6,6
38180,Coolbassoff,kazzak,576,rogue,subtlety,12,6,6
38181,Jljr,twisting-nether,576,rogue,subtlety,12,6,6
38182,Ghøßt,outland,576,rogue,subtlety,12,6,6
38183,Cander,kazzak,576,rogue,subtlety,12,6,6
38184,Hazero,frostmane,576,rogue,subtlety,12,6,6
38185,Draytonlove,nemesis,576,rogue,subtlety,12,6,6
38186,Rmp,outland,576,rogue,subtlety,12,6,6
38187,Soulriver,kelthuzad,576,rogue,subtlety,15,7,8
38188,Andrizle,blackmoore,576,rogue,subtlety,18,6,12
38189,Хаймох,gordunni,576,rogue,subtlety,18,6,12
38190,Kleptomaniac,aggra-português,576,rogue,subtlety,18,6,12
38191,Åvírøñgðd,ravencrest,576,rogue,subtlety,18,6,12
38192,Kerìon,nemesis,576,rogue,subtlety,18,6,12
38193,Cobrâk,archimonde,576,rogue,subtlety,18,6,12
38194,Blihhubba,silvermoon,576,rogue,subtlety,24,6,18
38195,Batskcab,blackmoore,576,rogue,subtlety,24,6,18
38196,Tason,argent-dawn,575,rogue,subtlety,12,6,6
38197,Knivestikker,twisting-nether,575,rogue,subtlety,12,6,6
38198,Botnet,blackmoore,575,rogue,subtlety,12,6,6
38199,Igel,antonidas,575,rogue,subtlety,12,6,6
38200,Mozzart,ragnaros,575,rogue,subtlety,12,6,6
38201,Melfîce,blackhand,575,rogue,subtlety,12,6,6
38202,Crispflake,frostwolf,575,rogue,subtlety,12,6,6
38203,Exine,sanguino,575,rogue,subtlety,12,6,6
38204,Фордрэн,deathguard,575,rogue,subtlety,16,7,9
38205,Lookbehîndu,aegwynn,575,rogue,subtlety,18,6,12
38206,Sombredagues,ysondre,575,rogue,subtlety,18,6,12
38207,Varne,les-sentinelles,575,rogue,subtlety,18,6,12
38208,Coolspot,archimonde,575,rogue,subtlety,18,6,12
38209,Jaffar,mannoroth,575,rogue,subtlety,24,6,18
38210,Zëd,draenor,574,rogue,subtlety,12,6,6
38211,Тучс,gordunni,574,rogue,subtlety,13,6,7
38212,Sylvielle,azshara,573,rogue,subtlety,12,6,6
38213,Graymyst,outland,573,rogue,subtlety,18,6,12
38214,Oboejoe,burning-legion,572,rogue,subtlety,18,6,12
38215,Kucheenstab,blackrock,572,rogue,subtlety,18,6,12
38216,Freddybst,twisting-nether,571,rogue,subtlety,12,6,6
38217,Wolffgang,dalaran,571,rogue,subtlety,12,6,6
38218,Lêvî,sanguino,569,rogue,subtlety,12,6,6
38219,Demonrok,stormscale,569,rogue,subtlety,12,6,6
38220,Mishana,thrall,567,rogue,subtlety,18,6,12
38221,Geroge,sylvanas,566,rogue,subtlety,12,6,6
38222,Frézzer,tirion,566,rogue,subtlety,12,6,6
38223,Rhaacvar,magtheridon,566,rogue,subtlety,12,6,6
38224,Grikra,argent-dawn,566,rogue,subtlety,12,6,6
38225,Auarg,argent-dawn,565,rogue,subtlety,12,6,6
38226,Owlcat,argent-dawn,559,rogue,subtlety,18,6,12
38227,Grekén,bronze-dragonflight,558,rogue,subtlety,17,6,11
38228,Puge,norgannon,557,rogue,subtlety,23,6,17
38229,Sizzurp,kargath,555,rogue,subtlety,36,6,30
38230,Brancovich,magtheridon,543,rogue,subtlety,11,6,5
38231,Marryhim,blackhand,543,rogue,subtlety,17,6,11
38232,Pavlo,nathrezim,543,rogue,subtlety,17,6,11
38233,Zobrak,twisting-nether,542,rogue,subtlety,14,7,7
38234,Notwhaazz,ravencrest,528,rogue,subtlety,9,7,2
38235,Malignance,drakthul,511,rogue,subtlety,14,7,7
38236,Saanka,eredar,511,rogue,subtlety,14,6,8
38237,Stealthr,silvermoon,495,rogue,subtlety,11,6,5
38238,Ripinpiece,outland,494,rogue,subtlety,19,6,13
38239,Araniana,kazzak,480,rogue,subtlety,6,5,1
38240,Deinorsin,outland,480,rogue,subtlety,6,5,1
38241,Rngkillaz,archimonde,480,rogue,subtlety,6,5,1
38242,Фэйкуои,gordunni,480,rogue,subtlety,6,5,1
38243,Бонястелс,gordunni,480,rogue,subtlety,6,5,1
38244,Astereex,sylvanas,480,rogue,subtlety,6,5,1
38245,Ðoppex,blackmoore,480,rogue,subtlety,6,5,1
38246,Beefboss,neptulon,480,rogue,subtlety,6,5,1
38247,Mastrmind,twisting-nether,480,rogue,subtlety,6,5,1
38248,Penetrantos,eredar,480,rogue,subtlety,6,5,1
38249,Janx,aegwynn,480,rogue,subtlety,12,5,7
38250,Рюджик,soulflayer,480,rogue,subtlety,12,5,7
38251,Blazestórm,stormscale,480,rogue,subtlety,12,5,7
38252,Øptì,ravencrest,480,rogue,subtlety,12,5,7
38253,ßuha,stormscale,480,rogue,subtlety,12,5,7
38254,Звиздаттый,blackscar,480,rogue,subtlety,12,5,7
38255,Mzaa,ravencrest,480,rogue,subtlety,12,5,7
38256,Lëmönhäzë,dun-modr,480,rogue,subtlety,12,5,7
38257,Slicéndicé,wildhammer,480,rogue,subtlety,12,5,7
38258,Kohakugawa,kazzak,480,rogue,subtlety,12,5,7
38259,Menajerie,outland,480,rogue,subtlety,12,5,7
38260,Cêline,silvermoon,480,rogue,subtlety,12,5,7
38261,Khepaso,sanguino,480,rogue,subtlety,12,5,7
38262,Стеллакокс,howling-fjord,480,rogue,subtlety,12,5,7
38263,Protpaladin,sylvanas,480,rogue,subtlety,12,5,7
38264,Киднитучер,fordragon,480,rogue,subtlety,12,5,7
38265,Fragmint,aggra-português,480,rogue,subtlety,12,5,7
38266,Soufraki,tarren-mill,480,rogue,subtlety,12,5,7
38267,Khazren,ravencrest,480,rogue,subtlety,12,5,7
38268,Фрозеншедов,gordunni,480,rogue,subtlety,12,5,7
38269,Кашеварить,gordunni,480,rogue,subtlety,12,5,7
38270,Lurk,saurfang,480,rogue,subtlety,12,5,7
38271,Ddhelpra,blackrock,480,rogue,subtlety,12,5,7
38272,Кмска,soulflayer,480,rogue,subtlety,12,5,7
38273,Rsksrb,tarren-mill,480,rogue,subtlety,12,5,7
38274,Loznah,outland,480,rogue,subtlety,12,5,7
38275,Smörkniven,argent-dawn,480,rogue,subtlety,12,5,7
38276,Served,twisting-nether,480,rogue,subtlety,12,5,7
38277,Aluneran,silvermoon,480,rogue,subtlety,12,5,7
38278,Tashunkosapa,xavius,480,rogue,subtlety,12,5,7
38279,Xatra,hyjal,480,rogue,subtlety,12,5,7
38280,Waakø,todeswache,480,rogue,subtlety,12,5,7
38281,Akazuki,alleria,480,rogue,subtlety,12,5,7
38282,Késs,aegwynn,480,rogue,subtlety,12,5,7
38283,Srtumor,zuljin,480,rogue,subtlety,12,5,7
38284,Takenòtes,nemesis,480,rogue,subtlety,12,5,7
38285,Darkveil,xavius,480,rogue,subtlety,12,5,7
38286,Nhonhonho,silvermoon,480,rogue,subtlety,12,5,7
38287,Ajwenx,ravencrest,480,rogue,subtlety,18,5,13
38288,Ðefsmøkêz,tyrande,480,rogue,subtlety,18,5,13
38289,Typhoo,ravencrest,480,rogue,subtlety,30,5,25
38290,Andayn,shattered-hand,479,rogue,subtlety,6,5,1
38291,Giftdolken,outland,479,rogue,subtlety,12,5,7
38292,Spinetapper,ravencrest,479,rogue,subtlety,12,5,7
38293,Shiverbane,sargeras,479,rogue,subtlety,12,5,7
38294,Smorcoolio,stormscale,479,rogue,subtlety,12,5,7
38295,Raizø,argent-dawn,479,rogue,subtlety,12,5,7
38296,Ryxon,arathor,479,rogue,subtlety,12,5,7
38297,Tøxykø,archimonde,479,rogue,subtlety,12,5,7
38298,Optoo,ragnaros,479,rogue,subtlety,12,5,7
38299,Nanary,blackrock,479,rogue,subtlety,12,5,7
38300,Abrhykoo,hyjal,479,rogue,subtlety,12,5,7
38301,Emìlia,tarren-mill,479,rogue,subtlety,12,5,7
38302,Grocco,doomhammer,479,rogue,subtlety,12,5,7
38303,Nøxia,hyjal,479,rogue,subtlety,12,5,7
38304,Ôzzi,draenor,479,rogue,subtlety,12,5,7
38305,Smøth,ysondre,479,rogue,subtlety,15,6,9
38306,Zyklvn,zuljin,479,rogue,subtlety,18,5,13
38307,Bultars,argent-dawn,479,rogue,subtlety,18,5,13
38308,Sayy,nemesis,479,rogue,subtlety,18,5,13
38309,Lylestra,neptulon,479,rogue,subtlety,18,5,13
38310,Misscash,ragnaros,478,rogue,subtlety,6,5,1
38311,Soulreapeer,twisting-nether,478,rogue,subtlety,21,6,15
38312,Mozenn,draenor,478,rogue,subtlety,19,5,14
38313,Эльтаэрон,gordunni,477,rogue,subtlety,12,5,7
38314,Приколдэсса,gordunni,477,rogue,subtlety,18,5,13
38315,Shurkan,antonidas,475,rogue,subtlety,12,5,7
38316,Mallaurya,dalaran,474,rogue,subtlety,12,5,7
38317,Roguevatar,quelthalas,471,rogue,subtlety,18,5,13
38318,Kalstab,silvermoon,447,rogue,subtlety,8,6,2
38319,Кумаме,howling-fjord,447,rogue,subtlety,11,5,6
38320,Sedái,twisting-nether,447,rogue,subtlety,14,6,8
38321,Сексикаесу,soulflayer,431,rogue,subtlety,11,5,6
38322,Райан,fordragon,431,rogue,subtlety,11,5,6
38323,Iwillberone,ravencrest,431,rogue,subtlety,17,5,12
38324,Itsforme,kazzak,415,rogue,subtlety,14,5,9
38325,Yakku,drakthul,415,rogue,subtlety,20,5,15
38326,Bystroscy,silvermoon,398,rogue,subtlety,10,5,5
38327,Algopyrin,ragnaros,396,rogue,subtlety,13,5,8
38328,Kilabre,twisting-nether,384,rogue,subtlety,6,4,2
38329,Ocklol,archimonde,384,rogue,subtlety,6,4,2
38330,Takiya,ysondre,384,rogue,subtlety,6,4,2
38331,Lulune,frostmane,384,rogue,subtlety,6,4,2
38332,Тенероби,soulflayer,384,rogue,subtlety,6,4,2
38333,Yörgs,eredar,384,rogue,subtlety,6,4,2
38334,Thedarkness,sylvanas,384,rogue,subtlety,6,4,2
38335,Siele,twisting-nether,384,rogue,subtlety,6,4,2
38336,Rakuwata,the-maelstrom,384,rogue,subtlety,6,4,2
38337,Nxnja,silvermoon,384,rogue,subtlety,6,4,2
38338,Rubberducky,argent-dawn,384,rogue,subtlety,6,4,2
38339,Darx,sunstrider,384,rogue,subtlety,6,4,2
38340,Иннхотеп,howling-fjord,384,rogue,subtlety,6,4,2
38341,Ðazzrog,archimonde,384,rogue,subtlety,6,4,2
38342,Supremacy,sylvanas,384,rogue,subtlety,6,4,2
38343,Джеанит,gordunni,384,rogue,subtlety,6,4,2
38344,Elyndri,archimonde,384,rogue,subtlety,6,4,2
38345,Spyzie,hyjal,384,rogue,subtlety,6,4,2
38346,Ënd,ravencrest,384,rogue,subtlety,6,4,2
38347,Choclatéosol,archimonde,384,rogue,subtlety,6,4,2
38348,Talayr,argent-dawn,384,rogue,subtlety,6,4,2
38349,Okiboo,silvermoon,384,rogue,subtlety,6,4,2
38350,Mega,nordrassil,384,rogue,subtlety,6,4,2
38351,Arkblenderx,silvermoon,384,rogue,subtlety,6,4,2
38352,Omeger,thrall,384,rogue,subtlety,6,4,2
38353,Stabmaster,outland,384,rogue,subtlety,6,4,2
38354,Shreya,blackrock,384,rogue,subtlety,6,4,2
38355,Mol,defias-brotherhood,384,rogue,subtlety,6,4,2
38356,Лолнайт,blackscar,384,rogue,subtlety,6,4,2
38357,Körtel,tarren-mill,384,rogue,subtlety,6,4,2
38358,Møgzu,blackmoore,384,rogue,subtlety,6,4,2
38359,Djnelly,stormreaver,384,rogue,subtlety,6,4,2
38360,Blckrogue,bloodfeather,384,rogue,subtlety,6,4,2
38361,Pinnar,blackmoore,384,rogue,subtlety,6,4,2
38362,Shadôwcraft,outland,384,rogue,subtlety,6,4,2
38363,Seeralex,anetheron,384,rogue,subtlety,6,4,2
38364,Kppz,burning-legion,384,rogue,subtlety,6,4,2
38365,Snýz,darksorrow,384,rogue,subtlety,6,4,2
38366,Артимидушка,gordunni,384,rogue,subtlety,6,4,2
38367,Альтушкаа,gordunni,384,rogue,subtlety,6,4,2
38368,Cawzi,silvermoon,384,rogue,subtlety,6,4,2
38369,Дракакула,blackscar,384,rogue,subtlety,9,5,4
38370,Nîmaj,hyjal,384,rogue,subtlety,12,6,6
38371,Hyrule,onyxia,384,rogue,subtlety,12,4,8
38372,Øzs,argent-dawn,384,rogue,subtlety,12,4,8
38373,Kurichu,archimonde,384,rogue,subtlety,12,4,8
38374,Senorino,tarren-mill,384,rogue,subtlety,12,4,8
38375,Даняпрекринж,azuregos,384,rogue,subtlety,12,4,8
38376,Fatedancer,outland,384,rogue,subtlety,12,4,8
38377,Zélla,twisting-nether,384,rogue,subtlety,12,4,8
38378,Нунас,soulflayer,384,rogue,subtlety,12,4,8
38379,Battousai,burning-legion,384,rogue,subtlety,12,4,8
38380,Lupos,anubarak,384,rogue,subtlety,12,4,8
38381,Mînz,twisting-nether,384,rogue,subtlety,12,4,8
38382,Kénzos,silvermoon,384,rogue,subtlety,12,4,8
38383,Whiteløtûs,dun-modr,384,rogue,subtlety,12,4,8
38384,Rekki,terokkar,384,rogue,subtlety,12,4,8
38385,Misamia,nemesis,384,rogue,subtlety,12,4,8
38386,Later,saurfang,384,rogue,subtlety,12,4,8
38387,Huprâ,ravencrest,384,rogue,subtlety,12,4,8
38388,Xanders,draenor,384,rogue,subtlety,12,4,8
38389,Raglaron,draenor,384,rogue,subtlety,12,4,8
38390,Taishani,thrall,384,rogue,subtlety,12,4,8
38391,Dîspatchx,defias-brotherhood,384,rogue,subtlety,12,4,8
38392,Szabina,outland,384,rogue,subtlety,12,4,8
38393,Alleyezonme,stormscale,384,rogue,subtlety,12,4,8
38394,Vanisha,outland,384,rogue,subtlety,12,4,8
38395,Бейнс,howling-fjord,384,rogue,subtlety,12,4,8
38396,Zordochrog,kazzak,384,rogue,subtlety,12,4,8
38397,Ýýçyka,kazzak,384,rogue,subtlety,12,4,8
38398,Skaúr,malganis,384,rogue,subtlety,12,4,8
38399,Zhadowên,kazzak,384,rogue,subtlety,12,4,8
38400,Asmodal,antonidas,384,rogue,subtlety,12,4,8
38401,Saryotv,silvermoon,384,rogue,subtlety,12,4,8
38402,Bagirä,sylvanas,384,rogue,subtlety,15,4,11
38403,Galore,azjolnerub,384,rogue,subtlety,18,4,14
38404,Очч,blackscar,384,rogue,subtlety,18,4,14
38405,Бллейз,gordunni,384,rogue,subtlety,18,4,14
38406,Backstabjr,blackmoore,384,rogue,subtlety,18,4,14
38407,Vaelaestra,argent-dawn,384,rogue,subtlety,18,4,14
38408,Plot,zenedar,384,rogue,subtlety,18,4,14
38409,Haregan,gorgonnash,383,rogue,subtlety,6,4,2
38410,Vanishdotcom,blackrock,383,rogue,subtlety,6,4,2
38411,Alovina,stormscale,383,rogue,subtlety,6,4,2
38412,Бекро,gordunni,383,rogue,subtlety,6,4,2
38413,Nomota,sanguino,383,rogue,subtlety,12,4,8
38414,Helsperd,draenor,383,rogue,subtlety,12,4,8
38415,Delenor,stormscale,383,rogue,subtlety,18,4,14
38416,Niceplan,frostmane,382,rogue,subtlety,7,6,1
38417,Belina,draenor,382,rogue,subtlety,6,4,2
38418,Ashâa,hyjal,382,rogue,subtlety,6,4,2
38419,Madnessbg,tarren-mill,382,rogue,subtlety,6,4,2
38420,Adelr,onyxia,382,rogue,subtlety,12,4,8
38421,Rookierook,draenor,382,rogue,subtlety,12,4,8
38422,Gobygoby,naxxramas,382,rogue,subtlety,12,4,8
38423,Ergaviota,colinas-pardas,381,rogue,subtlety,30,4,26
38424,Nekros,chromaggus,379,rogue,subtlety,12,4,8
38425,Xeløe,hyjal,330,rogue,subtlety,14,5,9
38426,Opiïum,ysondre,303,rogue,subtlety,7,4,3
38427,Checkormate,aegwynn,288,rogue,subtlety,6,3,3
38428,Cylizr,stormscale,288,rogue,subtlety,6,3,3
38429,Ragroh,burning-legion,288,rogue,subtlety,6,3,3
38430,Disembowel,ravencrest,288,rogue,subtlety,6,3,3
38431,Vexxey,magtheridon,288,rogue,subtlety,6,3,3
38432,Pøpsmoke,outland,288,rogue,subtlety,6,3,3
38433,Synergize,stormreaver,288,rogue,subtlety,6,3,3
38434,Skimpy,stormscale,288,rogue,subtlety,6,3,3
38435,Sethr,blackmoore,288,rogue,subtlety,6,3,3
38436,Natsukage,blackmoore,288,rogue,subtlety,6,3,3
38437,Peeon,drakthul,288,rogue,subtlety,6,3,3
38438,Royalflux,grim-batol,288,rogue,subtlety,6,3,3
38439,Bízkit,stormscale,288,rogue,subtlety,6,3,3
38440,Sáp,blackmoore,288,rogue,subtlety,6,3,3
38441,Gvcci,aegwynn,288,rogue,subtlety,6,3,3
38442,Roguanal,hyjal,288,rogue,subtlety,6,3,3
38443,Sutisong,dun-modr,288,rogue,subtlety,6,3,3
38444,Kaleigh,grim-batol,288,rogue,subtlety,6,3,3
38445,Nhèl,stormscale,288,rogue,subtlety,6,3,3
38446,Arydir,quelthalas,288,rogue,subtlety,6,3,3
38447,Pocketpaw,stormreaver,288,rogue,subtlety,6,3,3
38448,Garou,blackhand,288,rogue,subtlety,6,3,3
38449,Shadxwstep,ravencrest,288,rogue,subtlety,6,3,3
38450,Skrbke,tarren-mill,288,rogue,subtlety,6,3,3
38451,Buffassa,ravencrest,288,rogue,subtlety,6,3,3
38452,Nezukóchan,ravencrest,288,rogue,subtlety,6,3,3
38453,Horvathzu,ravencrest,288,rogue,subtlety,6,3,3
38454,Sâitama,zuljin,288,rogue,subtlety,6,3,3
38455,Ezk,eredar,288,rogue,subtlety,6,3,3
38456,Akamee,temple-noir,288,rogue,subtlety,6,3,3
38457,Finanzamtlg,blackrock,288,rogue,subtlety,6,3,3
38458,Jøwy,archimonde,288,rogue,subtlety,6,3,3
38459,Baradiir,defias-brotherhood,288,rogue,subtlety,6,3,3
38460,Qira,burning-blade,288,rogue,subtlety,6,3,3
38461,Vultzy,draenor,288,rogue,subtlety,6,3,3
38462,Пупичудо,howling-fjord,288,rogue,subtlety,6,3,3
38463,Sweetcc,amanthul,288,rogue,subtlety,6,3,3
38464,Seregolas,argent-dawn,288,rogue,subtlety,6,3,3
38465,Sshaka,tarren-mill,288,rogue,subtlety,6,3,3
38466,Кверест,howling-fjord,288,rogue,subtlety,6,3,3
38467,Shythairogue,area-52,288,rogue,subtlety,6,3,3
38468,Vanisshh,hyjal,288,rogue,subtlety,6,3,3
38469,Candyshot,thrall,288,rogue,subtlety,6,3,3
38470,Mekóz,draenor,288,rogue,subtlety,6,3,3
38471,Jeanklanche,archimonde,288,rogue,subtlety,6,3,3
38472,Pretylo,marécage-de-zangar,288,rogue,subtlety,6,3,3
38473,Zenone,marécage-de-zangar,288,rogue,subtlety,6,3,3
38474,Sadgexd,draenor,288,rogue,subtlety,6,3,3
38475,Synthaetic,draenor,288,rogue,subtlety,6,3,3
38476,Røguøross,archimonde,288,rogue,subtlety,6,3,3
38477,Nerica,kazzak,288,rogue,subtlety,6,3,3
38478,Waakie,frostmane,288,rogue,subtlety,6,3,3
38479,Jáckz,twisting-nether,288,rogue,subtlety,6,3,3
38480,Xhemil,tarren-mill,288,rogue,subtlety,6,3,3
38481,Viiltäjäjack,stormscale,288,rogue,subtlety,6,3,3
38482,Jechijr,silvermoon,288,rogue,subtlety,6,3,3
38483,Элисандресса,gordunni,288,rogue,subtlety,6,3,3
38484,Swiftyfan,silvermoon,288,rogue,subtlety,6,3,3
38485,Кеспул,soulflayer,288,rogue,subtlety,6,3,3
38486,Iöny,silvermoon,288,rogue,subtlety,6,3,3
38487,Jawen,silvermoon,288,rogue,subtlety,6,3,3
38488,Читэри,soulflayer,288,rogue,subtlety,6,3,3
38489,Izzyb,auchindoun,288,rogue,subtlety,6,3,3
38490,Стэйм,gordunni,288,rogue,subtlety,6,3,3
38491,Hallogenic,silvermoon,288,rogue,subtlety,6,3,3
38492,Кейнилин,gordunni,288,rogue,subtlety,6,3,3
38493,Uareincombat,drakthul,288,rogue,subtlety,11,3,8
38494,Chililôl,dun-modr,288,rogue,subtlety,12,3,9
38495,Nohks,blackmoore,288,rogue,subtlety,12,3,9
38496,Bîgbîzeps,thrall,288,rogue,subtlety,12,3,9
38497,Snøv,outland,288,rogue,subtlety,12,3,9
38498,Bú,nemesis,288,rogue,subtlety,12,3,9
38499,Hikorust,drakthul,288,rogue,subtlety,12,3,9
38500,Girlname,the-maelstrom,288,rogue,subtlety,12,3,9
38501,Kongnognog,ragnaros,288,rogue,subtlety,12,3,9
38502,Skíll,sanguino,288,rogue,subtlety,12,3,9
38503,Faded,terokkar,288,rogue,subtlety,12,3,9
38504,Zappdead,frostwolf,288,rogue,subtlety,12,3,9
38505,Cbrook,sylvanas,288,rogue,subtlety,12,3,9
38506,Vancleéf,sylvanas,288,rogue,subtlety,12,3,9
38507,Rufinol,twisting-nether,288,rogue,subtlety,12,3,9
38508,Kïbs,dalaran,288,rogue,subtlety,12,3,9
38509,Donchichi,archimonde,288,rogue,subtlety,12,3,9
38510,Тарний,gordunni,288,rogue,subtlety,12,3,9
38511,Воробнальщик,soulflayer,288,rogue,subtlety,12,3,9
38512,Izame,archimonde,288,rogue,subtlety,12,3,9
38513,Byaow,ravencrest,288,rogue,subtlety,12,3,9
38514,Ñú,ravencrest,288,rogue,subtlety,12,3,9
38515,Zoldyck,bloodhoof,288,rogue,subtlety,12,3,9
38516,Ристоврация,gordunni,288,rogue,subtlety,12,3,9
38517,Pestctrl,argent-dawn,288,rogue,subtlety,12,3,9
38518,Kiksi,ravencrest,288,rogue,subtlety,12,3,9
38519,Nÿst,khaz-modan,288,rogue,subtlety,12,3,9
38520,Xéshon,tarren-mill,288,rogue,subtlety,12,3,9
38521,Envenoman,ravencrest,288,rogue,subtlety,12,3,9
38522,Kenchio,elune,288,rogue,subtlety,12,3,9
38523,Liirja,twisting-nether,288,rogue,subtlety,18,3,15
38524,Sinxgødx,outland,288,rogue,subtlety,18,3,15
38525,Grris,stormscale,288,rogue,subtlety,18,3,15
38526,Leukhra,dun-modr,287,rogue,subtlety,6,3,3
38527,Shåkø,tarren-mill,287,rogue,subtlety,6,3,3
38528,Téhashcéé,archimonde,287,rogue,subtlety,6,3,3
38529,Pummra,kul-tiras,287,rogue,subtlety,6,3,3
38530,Styggvanas,tarren-mill,287,rogue,subtlety,15,4,11
38531,Djsapblindx,archimonde,287,rogue,subtlety,12,3,9
38532,Skeeto,blackmoore,287,rogue,subtlety,12,3,9
38533,Котуй,borean-tundra,287,rogue,subtlety,12,3,9
38534,Боузи,howling-fjord,287,rogue,subtlety,12,3,9
38535,Darkolive,defias-brotherhood,287,rogue,subtlety,13,3,10
38536,Furrooscuro,sanguino,287,rogue,subtlety,18,3,15
38537,Celenium,chogall,287,rogue,subtlety,24,3,21
38538,Ракельяр,blackscar,286,rogue,subtlety,6,3,3
38539,Cesar,blackhand,286,rogue,subtlety,6,3,3
38540,Jontor,deathwing,286,rogue,subtlety,12,3,9
38541,Raneya,antonidas,286,rogue,subtlety,18,3,15
38542,Pis,nagrand,255,rogue,subtlety,8,4,4
38543,Madlain,jaedenar,255,rogue,subtlety,8,4,4
38544,Шмарамышь,soulflayer,255,rogue,subtlety,8,4,4
38545,Machmacan,thrall,239,rogue,subtlety,5,3,2
38546,Trinketeflag,archimonde,239,rogue,subtlety,5,3,2
38547,Juuzou,outland,239,rogue,subtlety,5,3,2
38548,Boornys,burning-legion,224,rogue,subtlety,10,3,7
38549,Piperx,ravencrest,223,rogue,subtlety,8,3,5
38550,Loom,sylvanas,192,rogue,subtlety,9,3,6
38551,Imnotnice,terenas,192,rogue,subtlety,9,3,6
38552,Zte,frostmane,192,rogue,subtlety,6,2,4
38553,Медиивэл,deepholm,192,rogue,subtlety,6,2,4
38554,Knezr,silvermoon,192,rogue,subtlety,6,2,4
38555,Breuss,elune,192,rogue,subtlety,6,2,4
38556,Brinvilliers,aegwynn,192,rogue,subtlety,6,2,4
38557,Mècr,outland,192,rogue,subtlety,6,2,4
38558,Illmindofboo,twisting-nether,192,rogue,subtlety,6,2,4
38559,Botsrogue,kazzak,192,rogue,subtlety,6,2,4
38560,Stigh,twisting-nether,192,rogue,subtlety,6,2,4
38561,Pottomzola,ragnaros,192,rogue,subtlety,6,2,4
38562,Azkiel,archimonde,192,rogue,subtlety,6,2,4
38563,Кеонетво,howling-fjord,192,rogue,subtlety,6,2,4
38564,Kìnsley,archimonde,192,rogue,subtlety,6,2,4
38565,Колстар,howling-fjord,192,rogue,subtlety,6,2,4
38566,Рогаупорога,howling-fjord,192,rogue,subtlety,6,2,4
38567,Ksunq,hyjal,192,rogue,subtlety,6,2,4
38568,Bananashow,aegwynn,192,rogue,subtlety,6,2,4
38569,Giftknirps,silvermoon,192,rogue,subtlety,6,2,4
38570,Kyupi,hyjal,192,rogue,subtlety,6,2,4
38571,Steálth,silvermoon,192,rogue,subtlety,6,2,4
38572,Ayatsuji,nemesis,192,rogue,subtlety,6,2,4
38573,Katara,antonidas,192,rogue,subtlety,6,2,4
38574,Elthalulz,illidan,192,rogue,subtlety,6,2,4
38575,Yulitz,dun-modr,192,rogue,subtlety,6,2,4
38576,Voices,dentarg,192,rogue,subtlety,6,2,4
38577,Kylìemirogue,blackrock,192,rogue,subtlety,6,2,4
38578,Caská,blackhand,192,rogue,subtlety,6,2,4
38579,Chokee,blackrock,192,rogue,subtlety,6,2,4
38580,Evilbiscuit,quelthalas,192,rogue,subtlety,6,2,4
38581,Malvaxxs,tarren-mill,192,rogue,subtlety,6,2,4
38582,Recondite,doomhammer,192,rogue,subtlety,6,2,4
38583,Skaterboy,stormscale,192,rogue,subtlety,6,2,4
38584,Вэндиго,deathweaver,192,rogue,subtlety,6,2,4
38585,Stealthyist,darkmoon-faire,192,rogue,subtlety,6,2,4
38586,Blóodless,stormscale,192,rogue,subtlety,6,2,4
38587,Gameøvr,sanguino,192,rogue,subtlety,6,2,4
38588,Røxxilly,blackmoore,192,rogue,subtlety,6,2,4
38589,Nefqq,stormscale,192,rogue,subtlety,6,2,4
38590,Thriva,blackmoore,192,rogue,subtlety,6,2,4
38591,Epidemic,stormscale,192,rogue,subtlety,6,2,4
38592,Ggyoulowbro,blackmoore,192,rogue,subtlety,6,2,4
38593,Ît,stormscale,192,rogue,subtlety,6,2,4
38594,Gosleep,stormscale,192,rogue,subtlety,6,2,4
38595,Aikaza,blackmoore,192,rogue,subtlety,6,2,4
38596,Trytocapnoob,stormscale,192,rogue,subtlety,6,2,4
38597,Hade,stormscale,192,rogue,subtlety,6,2,4
38598,Rbgdowngrade,ravencrest,192,rogue,subtlety,6,2,4
38599,Jæto,ravencrest,192,rogue,subtlety,6,2,4
38600,Выебузадницу,soulflayer,192,rogue,subtlety,6,2,4
38601,Ноумингод,gordunni,192,rogue,subtlety,6,2,4
38602,Reyzumi,antonidas,192,rogue,subtlety,6,2,4
38603,Грустныйрог,gordunni,192,rogue,subtlety,6,2,4
38604,Pøggerhontas,antonidas,192,rogue,subtlety,6,2,4
38605,Muzkek,argent-dawn,192,rogue,subtlety,6,2,4
38606,Wrathed,stormreaver,192,rogue,subtlety,6,2,4
38607,Enoìla,blackmoore,192,rogue,subtlety,6,2,4
38608,Renyth,argent-dawn,192,rogue,subtlety,6,2,4
38609,Subaslaw,ravencrest,192,rogue,subtlety,6,2,4
38610,Fumai,blackmoore,192,rogue,subtlety,6,2,4
38611,Lenây,blackmoore,192,rogue,subtlety,6,2,4
38612,Canelitae,minahonda,192,rogue,subtlety,6,2,4
38613,Deadchivalry,argent-dawn,192,rogue,subtlety,6,2,4
38614,Дзендэр,soulflayer,192,rogue,subtlety,6,2,4
38615,Navaton,sanguino,192,rogue,subtlety,6,2,4
38616,Рикимартини,gordunni,192,rogue,subtlety,6,2,4
38617,Sqc,ravencrest,192,rogue,subtlety,6,2,4
38618,Aëlynn,la-croisade-écarlate,192,rogue,subtlety,6,2,4
38619,Lilsalad,ravencrest,192,rogue,subtlety,6,2,4
38620,Скиррона,gordunni,192,rogue,subtlety,6,2,4
38621,Insidióus,sylvanas,192,rogue,subtlety,6,2,4
38622,Sohnisch,azshara,192,rogue,subtlety,6,2,4
38623,Le,stormreaver,192,rogue,subtlety,6,2,4
38624,Голадриель,gordunni,192,rogue,subtlety,6,2,4
38625,Feylia,terenas,192,rogue,subtlety,6,2,4
38626,Dhayna,shendralar,192,rogue,subtlety,6,2,4
38627,Sigleif,argent-dawn,192,rogue,subtlety,6,2,4
38628,Ежикх,soulflayer,192,rogue,subtlety,6,2,4
38629,Misimisi,sanguino,192,rogue,subtlety,6,2,4
38630,Leviathann,doomhammer,192,rogue,subtlety,6,2,4
38631,Ackyrogue,ysondre,192,rogue,subtlety,6,2,4
38632,Inviscuz,draenor,192,rogue,subtlety,6,2,4
38633,Selecta,bloodhoof,192,rogue,subtlety,6,2,4
38634,Rehab,draenor,192,rogue,subtlety,6,2,4
38635,Cälisto,drakthul,192,rogue,subtlety,6,2,4
38636,Nïhal,suramar,192,rogue,subtlety,6,2,4
38637,Isteria,sylvanas,192,rogue,subtlety,6,2,4
38638,Гамбиит,gordunni,192,rogue,subtlety,6,2,4
38639,Sykin,eredar,192,rogue,subtlety,6,2,4
38640,Fatnutsac,eredar,192,rogue,subtlety,6,2,4
38641,Isseen,burning-legion,192,rogue,subtlety,6,2,4
38642,Greiskull,cthun,192,rogue,subtlety,15,3,12
38643,Падинайди,howling-fjord,192,rogue,subtlety,12,2,10
38644,Tàazz,archimonde,192,rogue,subtlety,12,2,10
38645,Килрилон,lich-king,192,rogue,subtlety,12,2,10
38646,Acheravar,antonidas,192,rogue,subtlety,12,2,10
38647,Кингксу,gordunni,192,rogue,subtlety,12,2,10
38648,Deróthus,arathor,192,rogue,subtlety,12,2,10
38649,Destrektor,kazzak,192,rogue,subtlety,12,2,10
38650,Pandagonstab,shadowsong,192,rogue,subtlety,12,2,10
38651,Кизо,blackscar,192,rogue,subtlety,12,2,10
38652,Thurgodd,silvermoon,192,rogue,subtlety,12,2,10
38653,Bauwten,ravencrest,192,rogue,subtlety,12,2,10
38654,Zappdaddy,frostwolf,192,rogue,subtlety,12,2,10
38655,Erèlenn,draenor,192,rogue,subtlety,12,2,10
38656,Shacopaco,zuljin,192,rogue,subtlety,12,2,10
38657,Goldenblitz,blackmoore,192,rogue,subtlety,12,2,10
38658,Бигсмурф,gordunni,192,rogue,subtlety,12,2,10
38659,Nomad,sylvanas,192,rogue,subtlety,12,2,10
38660,Shaklyn,antonidas,192,rogue,subtlety,12,2,10
38661,Refundlands,kazzak,192,rogue,subtlety,12,2,10
38662,Cramzes,defias-brotherhood,192,rogue,subtlety,12,2,10
38663,Verstopt,azjolnerub,192,rogue,subtlety,12,2,10
38664,Shènzo,tarren-mill,192,rogue,subtlety,12,2,10
38665,Cøsmøz,dalaran,192,rogue,subtlety,12,2,10
38666,Surinamort,voljin,192,rogue,subtlety,12,2,10
38667,Мутина,galakrond,192,rogue,subtlety,12,2,10
38668,Jackpot,sargeras,192,rogue,subtlety,12,2,10
38669,Grogun,tyrande,192,rogue,subtlety,14,2,12
38670,Afrodittan,dun-modr,192,rogue,subtlety,16,2,14
38671,Kaynasi,hyjal,192,rogue,subtlety,24,2,22
38672,Injux,blackmoore,191,rogue,subtlety,6,2,4
38673,Mamus,tarren-mill,191,rogue,subtlety,6,2,4
38674,Scratcheye,twisting-nether,191,rogue,subtlety,12,2,10
38675,Røsenstërn,ravencrest,191,rogue,subtlety,12,2,10
38676,Killboom,rexxar,191,rogue,subtlety,12,2,10
38677,Roxley,der-mithrilorden,191,rogue,subtlety,12,2,10
38678,Sephika,chants-éternels,180,rogue,subtlety,20,5,15
38679,Cutscene,argent-dawn,159,rogue,subtlety,5,2,3
38680,Maitrefurtif,argent-dawn,159,rogue,subtlety,5,2,3
38681,Гароона,blackscar,159,rogue,subtlety,5,2,3
38682,Julekos,ravenholdt,159,rogue,subtlety,5,2,3
38683,Kidneyqt,thrall,159,rogue,subtlety,5,2,3
38684,Biggut,khadgar,144,rogue,subtlety,3,3,0
38685,Paranoiaqt,outland,144,rogue,subtlety,9,2,7
38686,Sicu,malganis,138,rogue,subtlety,10,4,6
38687,Projectindex,malganis,138,rogue,subtlety,10,4,6
38688,Macon,arthas,138,rogue,subtlety,18,4,14
38689,Fatzaky,turalyon,138,rogue,subtlety,14,3,11
38690,Núb,burning-blade,138,rogue,subtlety,15,3,12
38691,Earnedblood,kazzak,128,rogue,subtlety,4,2,2
38692,Pzylol,anetheron,96,rogue,subtlety,3,2,1
38693,Songoro,tirion,96,rogue,subtlety,3,2,1
38694,Nixze,tarren-mill,96,rogue,subtlety,6,1,5
38695,Schleichor,aegwynn,96,rogue,subtlety,6,1,5
38696,Qikerip,drekthar,96,rogue,subtlety,6,1,5
38697,Faso,thunderhorn,96,rogue,subtlety,6,1,5
38698,Genesiz,sylvanas,96,rogue,subtlety,6,1,5
38699,Dáydreamín,draenor,96,rogue,subtlety,6,1,5
38700,Retaya,draenor,96,rogue,subtlety,6,1,5
38701,Aasy,silvermoon,96,rogue,subtlety,6,1,5
38702,Carnagè,dentarg,96,rogue,subtlety,6,1,5
38703,Cabbagerolls,argent-dawn,96,rogue,subtlety,6,1,5
38704,Гламурятина,gordunni,96,rogue,subtlety,6,1,5
38705,Yaelynn,argent-dawn,96,rogue,subtlety,6,1,5
38706,Trxë,twisting-nether,96,rogue,subtlety,6,1,5
38707,Imbazed,azshara,96,rogue,subtlety,6,1,5
38708,Intrix,draenor,96,rogue,subtlety,6,1,5
38709,Neskagrall,aegwynn,96,rogue,subtlety,6,1,5
38710,Verk,twilights-hammer,96,rogue,subtlety,6,1,5
38711,Senzus,twisting-nether,96,rogue,subtlety,6,1,5
38712,Элонли,gordunni,96,rogue,subtlety,6,1,5
38713,Invisage,grim-batol,96,rogue,subtlety,6,1,5
38714,Kkraken,dalaran,96,rogue,subtlety,6,1,5
38715,Twinkyzzö,archimonde,96,rogue,subtlety,6,1,5
38716,Menzo,ravencrest,96,rogue,subtlety,6,1,5
38717,Настябэкстаб,gordunni,96,rogue,subtlety,6,1,5
38718,Malborko,ravencrest,96,rogue,subtlety,6,1,5
38719,Darkkstep,blackmoore,96,rogue,subtlety,6,1,5
38720,Kødäy,hyjal,96,rogue,subtlety,6,1,5
38721,Klingo,defias-brotherhood,96,rogue,subtlety,6,1,5
38722,Kunigunde,shattered-hand,96,rogue,subtlety,6,1,5
38723,Førtñîtégøðx,eredar,96,rogue,subtlety,6,1,5
38724,Synsinte,silvermoon,96,rogue,subtlety,6,1,5
38725,Àrléngødx,kazzak,96,rogue,subtlety,6,1,5
38726,Тимкок,soulflayer,96,rogue,subtlety,6,1,5
38727,Jokis,uldum,96,rogue,subtlety,6,1,5
38728,Razcallz,arthas,96,rogue,subtlety,6,1,5
38729,Daunt,antonidas,96,rogue,subtlety,6,1,5
38730,Könän,dalaran,96,rogue,subtlety,6,1,5
38731,Стронг,soulflayer,96,rogue,subtlety,6,1,5
38732,Loulina,outland,96,rogue,subtlety,6,1,5
38733,Sumcrit,ravencrest,96,rogue,subtlety,6,1,5
38734,Outride,outland,96,rogue,subtlety,6,1,5
38735,Nerkmind,ragnaros,96,rogue,subtlety,6,1,5
38736,Shrèéd,blackmoore,96,rogue,subtlety,6,1,5
38737,Proesis,ravencrest,96,rogue,subtlety,6,1,5
38738,Slashendash,outland,96,rogue,subtlety,6,1,5
38739,Sørä,ragnaros,96,rogue,subtlety,6,1,5
38740,Depleter,outland,96,rogue,subtlety,6,1,5
38741,Letheus,stormscale,96,rogue,subtlety,6,1,5
38742,Мадарец,howling-fjord,96,rogue,subtlety,6,1,5
38743,Deccosneak,defias-brotherhood,96,rogue,subtlety,6,1,5
38744,Ðarkbleeds,ravencrest,96,rogue,subtlety,6,1,5
38745,Tebzr,ravencrest,96,rogue,subtlety,6,1,5
38746,Аквик,howling-fjord,96,rogue,subtlety,6,1,5
38747,Øpti,ravencrest,96,rogue,subtlety,6,1,5
38748,Clownsap,blackhand,96,rogue,subtlety,6,1,5
38749,Ótsutsukí,kazzak,96,rogue,subtlety,6,1,5
38750,Fintex,ravencrest,96,rogue,subtlety,6,1,5
38751,Chøsen,stormscale,96,rogue,subtlety,6,1,5
38752,Vellira,khaz-modan,96,rogue,subtlety,6,1,5
38753,Lookbehindu,stormscale,96,rogue,subtlety,6,1,5
38754,Щасбудетвайп,howling-fjord,96,rogue,subtlety,6,1,5
38755,Tyranoxoth,stormscale,96,rogue,subtlety,6,1,5
38756,Korteina,darkmoon-faire,96,rogue,subtlety,6,1,5
38757,Тварьебаная,howling-fjord,96,rogue,subtlety,6,1,5
38758,Stepbaack,silvermoon,96,rogue,subtlety,8,1,7
38759,Nønchalan,twisting-nether,96,rogue,subtlety,12,1,11
38760,Critneyspear,runetotem,96,rogue,subtlety,12,1,11
38761,Gífti,norgannon,96,rogue,subtlety,12,1,11
38762,Stabie,twisting-nether,96,rogue,subtlety,12,1,11
38763,Calmrusgirl,ravenholdt,96,rogue,subtlety,12,1,11
38764,Azzineth,silvermoon,96,rogue,subtlety,12,1,11
38765,Rnghero,blackmoore,96,rogue,subtlety,12,1,11
38766,Альдинг,howling-fjord,96,rogue,subtlety,12,1,11
38767,Subzhero,draenor,96,rogue,subtlety,12,1,11
38768,Nullname,ragnaros,96,rogue,subtlety,12,1,11
38769,Xý,ysondre,96,rogue,subtlety,18,1,17
38770,Swexlairone,outland,95,rogue,subtlety,12,1,11
38771,Maláika,silvermoon,89,rogue,subtlety,8,3,5
38772,Digmorre,drakthul,79,rogue,subtlety,5,1,4
38773,Nesth,silvermoon,79,rogue,subtlety,5,1,4
38774,Deadlybrew,twisting-nether,79,rogue,subtlety,5,1,4
38775,Domiqs,blackhand,63,rogue,subtlety,2,2,0
38776,Rylie,garona,63,rogue,subtlety,2,2,0
38777,Ридлли,soulflayer,48,rogue,subtlety,3,1,2
38778,Alvoriace,hyjal,48,rogue,subtlety,3,1,2
38779,Ddlcmg,drakthul,48,rogue,subtlety,3,1,2
38780,Shadowhelm,silvermoon,31,rogue,subtlety,8,1,7
38781,Vlkyria,silvermoon,16,rogue,subtlety,13,1,12
38782,Bestjkbetter,ravencrest,2155,rogue,assassination,111,57,54
38783,Shadenax,ravencrest,2149,rogue,assassination,78,42,36
38784,Shadeniz,ravencrest,2137,rogue,assassination,113,57,56
38785,Heavý,argent-dawn,2135,rogue,assassination,133,71,62
38786,Sub,kazzak,2117,rogue,assassination,114,56,58
38787,Aæ,stormscale,2112,rogue,assassination,125,65,60
38788,Rightplay,outland,2112,rogue,assassination,90,45,45
38789,Naláa,ravencrest,2107,rogue,assassination,88,45,43
38790,Shadenox,ravencrest,2104,rogue,assassination,329,164,165
38791,Ewyna,silvermoon,2103,rogue,assassination,93,49,44
38792,Fánsly,silvermoon,2102,rogue,assassination,78,40,38
38793,Mortecieca,ravencrest,2050,rogue,assassination,131,63,68
38794,Mentol,stormscale,2025,rogue,assassination,65,48,17
38795,Vayyel,silvermoon,2021,rogue,assassination,284,143,141
38796,Visuáls,antonidas,1950,rogue,assassination,81,38,43
38797,Stepchildx,uldum,1939,rogue,assassination,146,101,45
38798,Chínerox,thunderhorn,1938,rogue,assassination,252,127,125
38799,Watchmeyoe,ravencrest,1904,rogue,assassination,78,44,34
38800,Vulrin,argent-dawn,1899,rogue,assassination,77,44,33
38801,Buffassa,ravencrest,1887,rogue,assassination,143,81,62
38802,Shadeco,ravencrest,1887,rogue,assassination,66,33,33
38803,Shadekin,ravencrest,1880,rogue,assassination,75,38,37
38804,Stråt,ysondre,1879,rogue,assassination,66,30,36
38805,Tyreall,drakthul,1878,rogue,assassination,167,80,87
38806,Venomblood,sanguino,1872,rogue,assassination,65,29,36
38807,Изифаза,deathguard,1858,rogue,assassination,61,33,28
38808,Ålùnæh,azjolnerub,1849,rogue,assassination,54,28,26
38809,Babøønx,burning-legion,1848,rogue,assassination,89,41,48
38810,Asàd,draenor,1841,rogue,assassination,47,30,17
38811,Prei,hyjal,1839,rogue,assassination,96,49,47
38812,Baboonx,burning-legion,1839,rogue,assassination,72,31,41
38813,Oggish,tarren-mill,1831,rogue,assassination,84,32,52
38814,Aknana,vashj,1828,rogue,assassination,60,28,32
38815,Snøv,outland,1825,rogue,assassination,132,56,76
38816,Inly,ysondre,1823,rogue,assassination,110,58,52
38817,Скварлет,howling-fjord,1818,rogue,assassination,66,30,36
38818,Kidneyou,ragnaros,1816,rogue,assassination,48,31,17
38819,Bytoku,chants-éternels,1816,rogue,assassination,44,24,20
38820,Botsrogue,kazzak,1814,rogue,assassination,36,20,16
38821,Sadgexd,draenor,1814,rogue,assassination,52,26,26
38822,Grøax,ragnaros,1812,rogue,assassination,60,30,30
38823,Пожилойпуп,gordunni,1811,rogue,assassination,54,26,28
38824,Pyridoxin,blackmoore,1810,rogue,assassination,60,29,31
38825,Shipshot,blackrock,1809,rogue,assassination,62,37,25
38826,Çhïñêsémøñkè,argent-dawn,1808,rogue,assassination,238,128,110
38827,Civarea,blackrock,1808,rogue,assassination,57,26,31
38828,Lookåtme,ravencrest,1808,rogue,assassination,48,20,28
38829,Eiscreme,blackmoore,1802,rogue,assassination,95,50,45
38830,Lastsight,burning-legion,1798,rogue,assassination,65,35,30
38831,Ohdaesu,aegwynn,1798,rogue,assassination,114,49,65
38832,Ридлли,soulflayer,1783,rogue,assassination,59,29,30
38833,Fíìp,drakthul,1778,rogue,assassination,234,113,121
38834,Dáydreamín,draenor,1772,rogue,assassination,60,27,33
38835,Иллвилл,soulflayer,1769,rogue,assassination,42,23,19
38836,Семёнтус,gordunni,1767,rogue,assassination,54,30,24
38837,Pheq,ravencrest,1765,rogue,assassination,83,33,50
38838,Blindlol,emerald-dream,1762,rogue,assassination,149,77,72
38839,Zlah,ravencrest,1752,rogue,assassination,54,22,32
38840,Naiikaii,antonidas,1751,rogue,assassination,54,23,31
38841,Cntrlld,ravencrest,1750,rogue,assassination,54,26,28
38842,Goshîmoshî,stormscale,1747,rogue,assassination,70,29,41
38843,Lacusdark,draenor,1738,rogue,assassination,65,33,32
38844,Limítless,tarren-mill,1737,rogue,assassination,48,31,17
38845,Пашавернись,gordunni,1728,rogue,assassination,71,25,46
38846,Riskyx,draenor,1727,rogue,assassination,49,19,30
38847,Rajigagi,silvermoon,1717,rogue,assassination,61,33,28
38848,Винестрий,soulflayer,1715,rogue,assassination,42,23,19
38849,Youcrymydear,outland,1711,rogue,assassination,66,31,35
38850,Слаадкий,gordunni,1708,rogue,assassination,123,57,66
38851,Awaaylol,stormscale,1701,rogue,assassination,172,82,90
38852,Afto,argent-dawn,1695,rogue,assassination,54,21,33
38853,Kreamy,tarren-mill,1694,rogue,assassination,95,42,53
38854,Røler,ravencrest,1693,rogue,assassination,42,18,24
38855,Rinj,antonidas,1693,rogue,assassination,89,37,52
38856,Акиоми,gordunni,1691,rogue,assassination,102,57,45
38857,Precious,sylvanas,1690,rogue,assassination,318,156,162
38858,Mazeken,kazzak,1688,rogue,assassination,53,21,32
38859,Играючестно,howling-fjord,1686,rogue,assassination,30,19,11
38860,Gøldzahn,antonidas,1670,rogue,assassination,136,61,75
38861,Vâleera,kazzak,1667,rogue,assassination,48,23,25
38862,Twitchful,kazzak,1665,rogue,assassination,54,25,29
38863,Trollmeat,twisting-nether,1663,rogue,assassination,66,25,41
38864,Deadlybrew,twisting-nether,1662,rogue,assassination,54,23,31
38865,Brunhityx,ravencrest,1661,rogue,assassination,29,18,11
38866,Peeon,drakthul,1659,rogue,assassination,73,26,47
38867,Йа,gordunni,1658,rogue,assassination,63,33,30
38868,Awakeaf,outland,1658,rogue,assassination,48,23,25
38869,Ândrey,ravencrest,1657,rogue,assassination,54,31,23
38870,Dnee,ravencrest,1654,rogue,assassination,23,18,5
38871,Richï,outland,1654,rogue,assassination,104,44,60
38872,Yopti,tarren-mill,1647,rogue,assassination,90,32,58
38873,Justkiddning,blackmoore,1641,rogue,assassination,102,60,42
38874,Ockzy,archimonde,1639,rogue,assassination,105,56,49
38875,Skali,tarren-mill,1639,rogue,assassination,92,45,47
38876,Ocklol,archimonde,1637,rogue,assassination,99,55,44
38877,Drenched,turalyon,1636,rogue,assassination,234,113,121
38878,Juxtapose,ravencrest,1634,rogue,assassination,48,20,28
38879,Ваася,gordunni,1632,rogue,assassination,60,25,35
38880,Monski,ravencrest,1631,rogue,assassination,54,21,33
38881,Кэпс,blackscar,1625,rogue,assassination,66,39,27
38882,Howfastiam,ravencrest,1624,rogue,assassination,108,55,53
38883,Icdeadpixelz,ysondre,1624,rogue,assassination,42,17,25
38884,Мистеркрэпс,howling-fjord,1624,rogue,assassination,47,19,28
38885,Костялом,howling-fjord,1623,rogue,assassination,36,17,19
38886,Кайсити,gordunni,1619,rogue,assassination,42,23,19
38887,Keeke,outland,1619,rogue,assassination,60,31,29
38888,Shikamouflé,archimonde,1619,rogue,assassination,148,74,74
38889,Shookyz,zuljin,1615,rogue,assassination,54,27,27
38890,Iwillcapyou,twisting-nether,1614,rogue,assassination,54,25,29
38891,Únk,dalaran,1611,rogue,assassination,63,32,31
38892,Ру,galakrond,1610,rogue,assassination,42,22,20
38893,Войенх,gordunni,1610,rogue,assassination,242,116,126
38894,Amý,grim-batol,1610,rogue,assassination,57,27,30
38895,Гесху,eversong,1608,rogue,assassination,41,23,18
38896,Cander,kazzak,1607,rogue,assassination,107,49,58
38897,Warbell,ravencrest,1606,rogue,assassination,96,35,61
38898,Lelíth,ravencrest,1602,rogue,assassination,107,61,46
38899,Ач,gordunni,1602,rogue,assassination,78,37,41
38900,Fatnutsac,eredar,1602,rogue,assassination,54,21,33
38901,Sumiftw,drakthul,1601,rogue,assassination,48,18,30
38902,Moneylake,stormscale,1600,rogue,assassination,30,18,12
38903,ßênz,archimonde,1600,rogue,assassination,120,63,57
38904,Nîllá,blackmoore,1600,rogue,assassination,42,18,24
38905,Sotro,dun-modr,1600,rogue,assassination,84,32,52
38906,Загляденье,gordunni,1598,rogue,assassination,54,21,33
38907,Wâter,silvermoon,1593,rogue,assassination,54,20,34
38908,Hoodrogue,blackrock,1580,rogue,assassination,53,29,24
38909,Misttrogue,hyjal,1576,rogue,assassination,72,33,39
38910,Soxo,dun-modr,1576,rogue,assassination,59,27,32
38911,Мастдаггер,goldrinn,1575,rogue,assassination,184,94,90
38912,Shøz,kazzak,1574,rogue,assassination,138,62,76
38913,Стеллакокс,howling-fjord,1571,rogue,assassination,80,38,42
38914,Kãlí,blackmoore,1570,rogue,assassination,271,135,136
38915,Liøø,antonidas,1565,rogue,assassination,41,21,20
38916,Sadìra,echsenkessel,1560,rogue,assassination,53,22,31
38917,Kannibalex,blackrock,1560,rogue,assassination,51,21,30
38918,Miiløx,silvermoon,1558,rogue,assassination,54,30,24
38919,Lannon,sylvanas,1552,rogue,assassination,93,41,52
38920,Sid,dentarg,1539,rogue,assassination,62,31,31
38921,Silesi,kazzak,1538,rogue,assassination,154,81,73
38922,Stunco,ravencrest,1529,rogue,assassination,30,16,14
38923,Knutten,wildhammer,1526,rogue,assassination,102,47,55
38924,Зоти,lich-king,1525,rogue,assassination,56,27,29
38925,Shaokiz,sylvanas,1523,rogue,assassination,54,29,25
38926,Асиксх,blackscar,1520,rogue,assassination,125,67,58
38927,Npkx,outland,1519,rogue,assassination,60,26,34
38928,Lildretch,dun-morogh,1517,rogue,assassination,33,17,16
38929,Ilrunne,silvermoon,1515,rogue,assassination,132,62,70
38930,Flogue,area-52,1514,rogue,assassination,79,30,49
38931,Hopejé,ravencrest,1511,rogue,assassination,62,34,28
38932,Tez,malganis,1511,rogue,assassination,59,29,30
38933,Weakrat,kult-der-verdammten,1508,rogue,assassination,36,22,14
38934,Ñerøblacks,dun-modr,1507,rogue,assassination,30,16,14
38935,Effectz,ravencrest,1505,rogue,assassination,77,46,31
38936,Argapu,stormscale,1503,rogue,assassination,78,32,46
38937,Artésia,archimonde,1502,rogue,assassination,54,30,24
38938,Xeeana,ravencrest,1500,rogue,assassination,95,51,44
38939,Zaintsas,tarren-mill,1500,rogue,assassination,62,31,31
38940,Nùgz,area-52,1498,rogue,assassination,119,65,54
38941,Пусякиллерх,gordunni,1497,rogue,assassination,127,54,73
38942,Somaliapirat,eredar,1490,rogue,assassination,30,16,14
38943,Reyzumi,antonidas,1488,rogue,assassination,54,27,27
38944,Hidinginash,twisting-nether,1486,rogue,assassination,56,31,25
38945,Vanisha,outland,1484,rogue,assassination,91,48,43
38946,Søsaboy,nemesis,1483,rogue,assassination,60,29,31
38947,Варэль,borean-tundra,1482,rogue,assassination,227,108,119
38948,Synergize,stormreaver,1481,rogue,assassination,127,59,68
38949,Элирэй,fordragon,1480,rogue,assassination,69,33,36
38950,Eizan,outland,1478,rogue,assassination,48,27,21
38951,Ритор,deathguard,1477,rogue,assassination,48,22,26
38952,Candycc,burning-legion,1475,rogue,assassination,67,38,29
38953,Intecto,twisting-nether,1473,rogue,assassination,82,47,35
38954,Erion,silvermoon,1473,rogue,assassination,114,54,60
38955,Diazz,aegwynn,1473,rogue,assassination,119,56,63
38956,Poughkeepsie,outland,1464,rogue,assassination,60,32,28
38957,Vennomous,darkspear,1463,rogue,assassination,225,114,111
38958,Arkblenderx,silvermoon,1455,rogue,assassination,106,55,51
38959,Шмарамышь,soulflayer,1454,rogue,assassination,95,45,50
38960,Ethèrnal,twisting-nether,1454,rogue,assassination,72,31,41
38961,Minjeaca,silvermoon,1453,rogue,assassination,96,42,54
38962,Волнорес,eversong,1451,rogue,assassination,100,50,50
38963,Ynohtna,blackhand,1445,rogue,assassination,86,43,43
38964,Grzech,burning-legion,1443,rogue,assassination,82,44,38
38965,Intrix,draenor,1438,rogue,assassination,48,16,32
38966,Alnaddafrog,outland,1433,rogue,assassination,58,36,22
38967,Axoic,ravencrest,1433,rogue,assassination,48,23,25
38968,Tmpkboo,stormscale,1433,rogue,assassination,36,15,21
38969,Dé,ragnaros,1432,rogue,assassination,36,16,20
38970,Negrim,dun-modr,1431,rogue,assassination,143,68,75
38971,Ppollito,hyjal,1429,rogue,assassination,102,52,50
38972,Nìghtwalker,ravencrest,1426,rogue,assassination,70,34,36
38973,Luftpumpe,blackrock,1425,rogue,assassination,63,35,28
38974,Редфилд,blackscar,1425,rogue,assassination,48,24,24
38975,Teseiga,aegwynn,1425,rogue,assassination,134,58,76
38976,Лёнтролль,blackscar,1424,rogue,assassination,81,38,43
38977,Belsazar,azshara,1418,rogue,assassination,138,67,71
38978,Pieksig,blackmoore,1417,rogue,assassination,96,44,52
38979,Ropedrink,stormscale,1409,rogue,assassination,36,22,14
38980,Koreanrogue,archimonde,1406,rogue,assassination,24,15,9
38981,Yokze,ravencrest,1403,rogue,assassination,139,69,70
38982,Аренамастерх,blackscar,1402,rogue,assassination,24,15,9
38983,Synthaetic,draenor,1401,rogue,assassination,130,69,61
38984,Ванэйти,gordunni,1401,rogue,assassination,84,42,42
38985,Ambushgirl,ravencrest,1395,rogue,assassination,50,19,31
38986,Freemmr,draenor,1391,rogue,assassination,118,61,57
38987,Watodoo,kazzak,1388,rogue,assassination,62,31,31
38988,Caská,blackhand,1388,rogue,assassination,78,33,45
38989,Yassu,archimonde,1385,rogue,assassination,36,18,18
38990,Umciz,archimonde,1381,rogue,assassination,42,15,27
38991,Roguening,tarren-mill,1381,rogue,assassination,65,23,42
38992,Piñotxo,sanguino,1377,rogue,assassination,41,17,24
38993,Pizzayamyam,aegwynn,1373,rogue,assassination,42,18,24
38994,Ciaordel,sylvanas,1372,rogue,assassination,75,36,39
38995,Unshaken,dun-modr,1370,rogue,assassination,42,15,27
38996,Crípplé,ravencrest,1369,rogue,assassination,30,15,15
38997,Nællya,archimonde,1367,rogue,assassination,36,23,13
38998,Raiyqyu,archimonde,1362,rogue,assassination,117,59,58
38999,Hanzo,vashj,1361,rogue,assassination,53,15,38
39000,Nuguri,blackrock,1359,rogue,assassination,45,23,22
39001,Givewallet,ravencrest,1359,rogue,assassination,36,18,18
39002,Recondite,doomhammer,1358,rogue,assassination,59,32,27
39003,Orcrogue,khadgar,1356,rogue,assassination,29,15,14
39004,Haikyu,blackhand,1354,rogue,assassination,72,31,41
39005,Синигурай,soulflayer,1353,rogue,assassination,36,18,18
39006,Dreathefox,drakthul,1352,rogue,assassination,48,20,28
39007,Yvÿ,archimonde,1351,rogue,assassination,100,54,46
39008,Dirtyz,dun-modr,1351,rogue,assassination,67,35,32
39009,Cýphia,amanthul,1351,rogue,assassination,69,32,37
39010,Эксплис,ashenvale,1350,rogue,assassination,29,16,13
39011,Education,aegwynn,1350,rogue,assassination,48,18,30
39012,Batsu,alleria,1346,rogue,assassination,42,18,24
39013,Djnelly,stormreaver,1345,rogue,assassination,81,48,33
39014,Роземсти,gordunni,1345,rogue,assassination,116,62,54
39015,Томасмразь,blackscar,1343,rogue,assassination,30,14,16
39016,Lixht,the-maelstrom,1332,rogue,assassination,54,30,24
39017,Stabbinu,burning-legion,1332,rogue,assassination,30,14,16
39018,Nightnelly,archimonde,1331,rogue,assassination,30,14,16
39019,Винерджи,gordunni,1329,rogue,assassination,50,23,27
39020,Markø,twisting-nether,1329,rogue,assassination,94,42,52
39021,Finanzamtlg,blackrock,1328,rogue,assassination,36,19,17
39022,Совечица,gordunni,1327,rogue,assassination,30,14,16
39023,Stôrpîx,drakthul,1323,rogue,assassination,36,17,19
39024,Кайдарра,eversong,1317,rogue,assassination,54,26,28
39025,Zobrak,twisting-nether,1315,rogue,assassination,92,44,48
39026,Jaxck,sylvanas,1314,rogue,assassination,24,14,10
39027,Dîspatchx,defias-brotherhood,1313,rogue,assassination,36,15,21
39028,Траста,fordragon,1310,rogue,assassination,78,25,53
39029,Sigleif,argent-dawn,1309,rogue,assassination,61,28,33
39030,Lírìa,argent-dawn,1306,rogue,assassination,30,14,16
39031,Sneakysloth,ravencrest,1300,rogue,assassination,57,21,36
39032,Имилиона,blackscar,1298,rogue,assassination,31,18,13
39033,Pathicus,stormreaver,1297,rogue,assassination,64,32,32
39034,Gadûz,kazzak,1295,rogue,assassination,44,17,27
39035,Flawlesser,kazzak,1294,rogue,assassination,39,19,20
39036,Патайчик,soulflayer,1294,rogue,assassination,91,44,47
39037,Анми,gordunni,1288,rogue,assassination,35,14,21
39038,Röllz,ysondre,1286,rogue,assassination,54,22,32
39039,Nojdobra,tarren-mill,1284,rogue,assassination,55,23,32
39040,Petsakos,ravencrest,1279,rogue,assassination,47,16,31
39041,Zizmo,deathwing,1278,rogue,assassination,72,26,46
39042,Trollohlol,malganis,1276,rogue,assassination,54,27,27
39043,Фикция,greymane,1270,rogue,assassination,37,15,22
39044,Менрэйз,gordunni,1267,rogue,assassination,36,15,21
39045,Izze,thrall,1265,rogue,assassination,48,17,31
39046,Shadôwcraft,outland,1263,rogue,assassination,39,19,20
39047,Akira,outland,1262,rogue,assassination,69,34,35
39048,Келгар,soulflayer,1261,rogue,assassination,30,14,16
39049,Veronkierto,stormreaver,1259,rogue,assassination,78,42,36
39050,Snulle,ravencrest,1248,rogue,assassination,24,13,11
39051,Сайгакк,galakrond,1248,rogue,assassination,58,30,28
39052,Евгенийильич,gordunni,1247,rogue,assassination,24,13,11
39053,Rubberducky,argent-dawn,1245,rogue,assassination,18,13,5
39054,Mtb,ravencrest,1245,rogue,assassination,30,13,17
39055,Stabdbyvegan,ragnaros,1245,rogue,assassination,79,31,48
39056,Freijasap,ravencrest,1243,rogue,assassination,30,13,17
39057,Satiiva,terokkar,1242,rogue,assassination,66,29,37
39058,Droomprins,stormscale,1242,rogue,assassination,36,13,23
39059,Zerocell,kazzak,1240,rogue,assassination,66,32,34
39060,Mexxn,antonidas,1240,rogue,assassination,43,20,23
39061,Dime,silvermoon,1239,rogue,assassination,90,47,43
39062,Mewen,sanguino,1233,rogue,assassination,30,13,17
39063,Sáinz,malganis,1233,rogue,assassination,35,15,20
39064,Raetoc,turalyon,1230,rogue,assassination,30,15,15
39065,Gankbang,frostmane,1225,rogue,assassination,54,21,33
39066,Nukubu,draenor,1224,rogue,assassination,88,35,53
39067,Nàrutò,thrall,1223,rogue,assassination,62,21,41
39068,Mystykal,twisting-nether,1221,rogue,assassination,48,19,29
39069,Behörnchen,eredar,1218,rogue,assassination,53,23,30
39070,Sneakypeeki,sylvanas,1217,rogue,assassination,29,13,16
39071,Ocktwo,archimonde,1213,rogue,assassination,35,13,22
39072,Kronin,arakarahm,1213,rogue,assassination,42,15,27
39073,Streetx,nethersturm,1211,rogue,assassination,42,21,21
39074,Свёклапро,gordunni,1210,rogue,assassination,118,60,58
39075,Ripgore,sylvanas,1210,rogue,assassination,35,13,22
39076,Pitøu,outland,1205,rogue,assassination,48,23,25
39077,Kariinthuul,aegwynn,1205,rogue,assassination,48,20,28
39078,Bennyweth,argent-dawn,1205,rogue,assassination,42,16,26
39079,Nargun,archimonde,1204,rogue,assassination,30,18,12
39080,Тимкок,soulflayer,1203,rogue,assassination,75,33,42
39081,Килларан,howling-fjord,1200,rogue,assassination,29,16,13
39082,Nopz,outland,1199,rogue,assassination,36,21,15
39083,Maelithas,archimonde,1197,rogue,assassination,83,38,45
39084,Lovetospoon,ravencrest,1196,rogue,assassination,90,51,39
39085,Næylá,kult-der-verdammten,1195,rogue,assassination,24,13,11
39086,Narsoule,ysondre,1194,rogue,assassination,30,16,14
39087,Фуллблайнд,gordunni,1194,rogue,assassination,33,13,20
39088,Nitröx,tarren-mill,1194,rogue,assassination,35,13,22
39089,Sùbzerø,archimonde,1186,rogue,assassination,23,13,10
39090,Skrbke,tarren-mill,1186,rogue,assassination,102,51,51
39091,Noxxra,blackhand,1181,rogue,assassination,59,21,38
39092,Gigarogue,defias-brotherhood,1179,rogue,assassination,47,23,24
39093,Экичу,howling-fjord,1177,rogue,assassination,48,28,20
39094,Azovrouge,terokkar,1172,rogue,assassination,30,18,12
39095,Jupitor,argent-dawn,1172,rogue,assassination,72,39,33
39096,Цилана,gordunni,1161,rogue,assassination,45,25,20
39097,Jeruna,veklor,1152,rogue,assassination,24,12,12
39098,Emergence,ravencrest,1151,rogue,assassination,24,12,12
39099,Unterweger,die-aldor,1145,rogue,assassination,23,13,10
39100,Поздоровайся,howling-fjord,1139,rogue,assassination,54,26,28
39101,Bonejaw,tarren-mill,1137,rogue,assassination,30,14,16
39102,Kuttunga,ravencrest,1136,rogue,assassination,73,33,40
39103,Zokush,archimonde,1134,rogue,assassination,39,15,24
39104,Tootskie,outland,1128,rogue,assassination,126,59,67
39105,Скулипёс,howling-fjord,1124,rogue,assassination,23,15,8
39106,Phaîne,outland,1124,rogue,assassination,24,12,12
39107,Ingesa,blackhand,1120,rogue,assassination,68,32,36
39108,Krimos,archimonde,1119,rogue,assassination,54,30,24
39109,Missesinvis,blackmoore,1118,rogue,assassination,25,14,11
39110,Elysm,stormscale,1112,rogue,assassination,41,21,20
39111,Jæto,ravencrest,1110,rogue,assassination,33,17,16
39112,Sênsus,antonidas,1110,rogue,assassination,54,21,33
39113,Edaniel,draenor,1109,rogue,assassination,24,12,12
39114,Дисхар,soulflayer,1103,rogue,assassination,28,15,13
39115,Oshä,dalaran,1102,rogue,assassination,30,13,17
39116,Elûnè,silvermoon,1097,rogue,assassination,30,14,16
39117,Swarge,silvermoon,1088,rogue,assassination,318,152,166
39118,Gravestam,sunstrider,1085,rogue,assassination,36,17,19
39119,Davotroz,dun-modr,1084,rogue,assassination,26,13,13
39120,Носопыра,blackscar,1082,rogue,assassination,53,25,28
39121,Undîsputed,blackmoore,1074,rogue,assassination,45,15,30
39122,Mol,defias-brotherhood,1070,rogue,assassination,38,12,26
39123,Лунари,blackscar,1068,rogue,assassination,48,19,29
39124,Nighteshift,silvermoon,1064,rogue,assassination,36,14,22
39125,Gamôra,arygos,1061,rogue,assassination,30,13,17
39126,Dalailamer,gorgonnash,1060,rogue,assassination,38,12,26
39127,Azonaticus,hyjal,1059,rogue,assassination,28,13,15
39128,Undxrwrld,sylvanas,1055,rogue,assassination,18,11,7
39129,Бонасера,blackscar,1052,rogue,assassination,24,11,13
39130,Jimaal,stormscale,1051,rogue,assassination,30,11,19
39131,Zélla,twisting-nether,1044,rogue,assassination,24,11,13
39132,Pasarelo,dun-modr,1041,rogue,assassination,95,45,50
39133,Madlain,jaedenar,1041,rogue,assassination,24,11,13
39134,Кэйлфрут,gordunni,1040,rogue,assassination,18,11,7
39135,Sæqq,blackmoore,1038,rogue,assassination,54,22,32
39136,Subyo,eredar,1038,rogue,assassination,30,11,19
39137,Chiàntì,blackrock,1037,rogue,assassination,185,88,97
39138,Alpinestars,dun-modr,1037,rogue,assassination,29,12,17
39139,Stonecold,twilights-hammer,1037,rogue,assassination,36,11,25
39140,Alltaïr,ravencrest,1035,rogue,assassination,145,74,71
39141,Sladen,ghostlands,1032,rogue,assassination,24,11,13
39142,Julyshadows,kazzak,1031,rogue,assassination,36,15,21
39143,Chalkbag,blackrock,1031,rogue,assassination,35,12,23
39144,Tre,eredar,1030,rogue,assassination,47,22,25
39145,Оскархартман,gordunni,1027,rogue,assassination,24,12,12
39146,Seleyese,draenor,1027,rogue,assassination,36,15,21
39147,Imissmop,darkspear,1026,rogue,assassination,30,11,19
39148,Мяуровани,eversong,1025,rogue,assassination,30,16,14
39149,Modulok,ulduar,1025,rogue,assassination,36,19,17
39150,Dmfd,darksorrow,1022,rogue,assassination,182,88,94
39151,Rogunelf,stormreaver,1021,rogue,assassination,56,28,28
39152,Dykumah,sanguino,1016,rogue,assassination,24,11,13
39153,Maroshko,argent-dawn,1015,rogue,assassination,23,11,12
39154,Epidemic,stormscale,1013,rogue,assassination,133,54,79
39155,Griveous,kazzak,1007,rogue,assassination,20,12,8
39156,Lesale,turalyon,1005,rogue,assassination,48,22,26
39157,Nevelon,chogall,1005,rogue,assassination,90,38,52
39158,Sïdr,marécage-de-zangar,1003,rogue,assassination,47,25,22
39159,Dezxxyox,dun-modr,1001,rogue,assassination,68,35,33
39160,Boskönigt,ragnaros,998,rogue,assassination,46,20,26
39161,Raikyo,argent-dawn,994,rogue,assassination,35,21,14
39162,Чернаясоска,eversong,994,rogue,assassination,95,50,45
39163,Imdma,defias-brotherhood,991,rogue,assassination,60,29,31
39164,Майндтрикс,blackscar,991,rogue,assassination,26,11,15
39165,Sorea,twisting-nether,987,rogue,assassination,75,32,43
39166,Zzippi,blackmoore,987,rogue,assassination,49,20,29
39167,Veliza,twisting-nether,962,rogue,assassination,91,37,54
39168,Deceptio,gilneas,960,rogue,assassination,46,22,24
39169,Gorgeousred,aegwynn,960,rogue,assassination,24,10,14
39170,Ежикх,soulflayer,960,rogue,assassination,30,10,20
39171,Madisonivyqt,blackmoore,960,rogue,assassination,30,10,20
39172,Blawann,argent-dawn,959,rogue,assassination,18,10,8
39173,Czêro,grim-batol,959,rogue,assassination,18,10,8
39174,Ладжо,gordunni,959,rogue,assassination,30,10,20
39175,Miistermaen,outland,959,rogue,assassination,30,10,20
39176,Koopa,argent-dawn,959,rogue,assassination,42,10,32
39177,Xalupa,dun-modr,957,rogue,assassination,24,10,14
39178,Gârrík,blackhand,954,rogue,assassination,18,10,8
39179,Eightball,frostmane,954,rogue,assassination,18,10,8
39180,Szabina,outland,953,rogue,assassination,18,10,8
39181,Finisher,sanguino,952,rogue,assassination,12,10,2
39182,Skids,ravencrest,952,rogue,assassination,18,10,8
39183,Tarox,eredar,952,rogue,assassination,24,10,14
39184,Джэкман,soulflayer,950,rogue,assassination,12,10,2
39185,Mahistt,archimonde,947,rogue,assassination,18,10,8
39186,Tirgo,aegwynn,946,rogue,assassination,138,67,71
39187,Zeduxino,outland,945,rogue,assassination,12,10,2
39188,Havox,darksorrow,945,rogue,assassination,18,10,8
39189,Джоннималыш,eversong,942,rogue,assassination,18,10,8
39190,Прнхабочка,gordunni,941,rogue,assassination,36,20,16
39191,Myk,xavius,928,rogue,assassination,22,11,11
39192,Eniyah,tarren-mill,927,rogue,assassination,17,10,7
39193,Практикиней,grom,925,rogue,assassination,30,10,20
39194,Mythicog,twisting-nether,924,rogue,assassination,48,19,29
39195,Cbrook,sylvanas,920,rogue,assassination,29,10,19
39196,Snakeshiv,ravenholdt,919,rogue,assassination,24,12,12
39197,Dredge,kaelthas,919,rogue,assassination,43,14,29
39198,Tranxéne,hyjal,913,rogue,assassination,30,15,15
39199,Heartripper,ravencrest,910,rogue,assassination,27,10,17
39200,Zeuzo,xavius,907,rogue,assassination,17,10,7
39201,Макггара,soulflayer,907,rogue,assassination,170,78,92
39202,Tubes,dun-morogh,904,rogue,assassination,15,12,3
39203,Lilze,ravencrest,897,rogue,assassination,72,33,39
39204,Jústina,die-aldor,897,rogue,assassination,66,28,38
39205,Márto,archimonde,896,rogue,assassination,22,10,12
39206,Ороти,greymane,891,rogue,assassination,20,12,8
39207,Darkkstep,blackmoore,890,rogue,assassination,24,11,13
39208,Jacktripper,blackrock,885,rogue,assassination,38,11,27
39209,Pinchoto,sanguino,883,rogue,assassination,60,27,33
39210,Blackone,nemesis,883,rogue,assassination,24,10,14
39211,Coastguard,twisting-nether,881,rogue,assassination,50,23,27
39212,Løuvees,archimonde,881,rogue,assassination,64,29,35
39213,Kaigodd,twisting-nether,879,rogue,assassination,38,20,18
39214,Haregan,gorgonnash,876,rogue,assassination,18,10,8
39215,Dallrend,stormscale,875,rogue,assassination,60,22,38
39216,Bauwten,ravencrest,866,rogue,assassination,24,12,12
39217,Skýhigh,ravencrest,864,rogue,assassination,12,9,3
39218,Watergirlx,ravencrest,864,rogue,assassination,18,9,9
39219,Sotri,dun-modr,864,rogue,assassination,24,9,15
39220,Angeldarky,silvermoon,864,rogue,assassination,24,9,15
39221,Аязлаая,blackscar,864,rogue,assassination,24,9,15
39222,Moratz,blackmoore,864,rogue,assassination,30,9,21
39223,Stepbrogue,tarren-mill,863,rogue,assassination,18,9,9
39224,Gutter,sylvanas,863,rogue,assassination,18,9,9
39225,Cloak,blackrock,863,rogue,assassination,18,9,9
39226,Uzrigu,tarren-mill,863,rogue,assassination,18,9,9
39227,Tiazx,outland,863,rogue,assassination,18,9,9
39228,Леронда,deepholm,863,rogue,assassination,36,17,19
39229,Fálke,dun-modr,863,rogue,assassination,30,9,21
39230,Фанфистинга,gordunni,863,rogue,assassination,36,9,27
39231,Жесть,howling-fjord,862,rogue,assassination,18,9,9
39232,Йоио,howling-fjord,862,rogue,assassination,18,9,9
39233,Purplereign,frostmane,860,rogue,assassination,84,40,44
39234,Daggerz,outland,859,rogue,assassination,18,9,9
39235,Вальпургина,borean-tundra,859,rogue,assassination,42,19,23
39236,Sisoi,kazzak,859,rogue,assassination,24,9,15
39237,Norlix,ravencrest,856,rogue,assassination,18,9,9
39238,Babysteps,the-maelstrom,856,rogue,assassination,18,9,9
39239,Silksneak,kazzak,856,rogue,assassination,18,9,9
39240,Kampon,sanguino,855,rogue,assassination,18,9,9
39241,Felvengeance,stormscale,855,rogue,assassination,30,9,21
39242,Reginlief,argent-dawn,852,rogue,assassination,56,28,28
39243,Вотымразь,howling-fjord,849,rogue,assassination,47,19,28
39244,Scorpionkk,blackrock,848,rogue,assassination,162,77,85
39245,Kuxion,zuljin,847,rogue,assassination,24,10,14
39246,Madita,frostmourne,844,rogue,assassination,36,9,27
39247,Ressputini,emeriss,841,rogue,assassination,17,9,8
39248,Паштетмашин,booty-bay,841,rogue,assassination,18,9,9
39249,Knockyz,khaz-modan,838,rogue,assassination,37,16,21
39250,Dæadly,archimonde,828,rogue,assassination,23,9,14
39251,Mackíe,antonidas,828,rogue,assassination,27,10,17
39252,Lorena,ravencrest,826,rogue,assassination,17,9,8
39253,Tc,doomhammer,824,rogue,assassination,18,9,9
39254,Îlihad,zuljin,824,rogue,assassination,42,16,26
39255,Yuffi,ysondre,803,rogue,assassination,29,11,18
39256,Hadúr,stormscale,802,rogue,assassination,28,11,17
39257,Areldis,drakthul,800,rogue,assassination,20,10,10
39258,Folzen,archimonde,799,rogue,assassination,22,9,13
39259,Jumbovanish,tarren-mill,796,rogue,assassination,21,11,10
39260,Elfikill,elune,794,rogue,assassination,25,11,14
39261,Fumai,blackmoore,790,rogue,assassination,30,11,19
39262,Mores,anetheron,781,rogue,assassination,24,9,15
39263,Sospiro,nemesis,779,rogue,assassination,22,9,13
39264,Jamesdarmody,twisting-nether,775,rogue,assassination,27,9,18
39265,Gillette,guldan,773,rogue,assassination,78,29,49
39266,Myk,frostmane,768,rogue,assassination,12,8,4
39267,Axelaz,ravencrest,768,rogue,assassination,12,8,4
39268,Tallac,drekthar,768,rogue,assassination,18,8,10
39269,Attylaria,rexxar,768,rogue,assassination,18,8,10
39270,Фешнподпивом,gordunni,768,rogue,assassination,21,8,13
39271,Саэрас,howling-fjord,768,rogue,assassination,24,8,16
39272,Lipschitz,outland,768,rogue,assassination,24,8,16
39273,Onlyluvhurt,dun-modr,768,rogue,assassination,24,8,16
39274,Мелеша,blackscar,768,rogue,assassination,24,8,16
39275,Lôre,blackrock,768,rogue,assassination,30,8,22
39276,Piperx,ravencrest,768,rogue,assassination,30,8,22
39277,Bläde,outland,767,rogue,assassination,12,8,4
39278,Babouill,ysondre,767,rogue,assassination,12,8,4
39279,Nevagonagiv,archimonde,767,rogue,assassination,18,8,10
39280,Shadowcralls,blackmoore,767,rogue,assassination,18,8,10
39281,Skiff,argent-dawn,767,rogue,assassination,18,8,10
39282,Milenia,thrall,767,rogue,assassination,18,8,10
39283,Röguelol,outland,767,rogue,assassination,18,8,10
39284,Meldee,burning-legion,767,rogue,assassination,18,8,10
39285,Serpez,anachronos,766,rogue,assassination,12,8,4
39286,Bronxbomber,tarren-mill,766,rogue,assassination,18,8,10
39287,Nhonhonho,silvermoon,766,rogue,assassination,18,8,10
39288,Flaskan,tarren-mill,766,rogue,assassination,18,8,10
39289,Obsçuritý,ragnaros,765,rogue,assassination,16,9,7
39290,Revelith,nemesis,764,rogue,assassination,17,8,9
39291,Jimzopf,eredar,762,rogue,assassination,18,8,10
39292,Horvathzu,ravencrest,762,rogue,assassination,24,8,16
39293,Giftknirps,silvermoon,758,rogue,assassination,18,8,10
39294,Parker,frostmane,758,rogue,assassination,24,8,16
39295,Куррвабобер,borean-tundra,756,rogue,assassination,18,8,10
39296,Thedarkness,sylvanas,755,rogue,assassination,18,8,10
39297,Энвитио,gordunni,751,rogue,assassination,18,8,10
39298,Matarocho,ravencrest,751,rogue,assassination,24,8,16
39299,Кейтллинн,galakrond,738,rogue,assassination,42,16,26
39300,Медиивэл,deepholm,737,rogue,assassination,23,8,15
39301,Deragur,antonidas,733,rogue,assassination,18,8,10
39302,Rahes,stormscale,731,rogue,assassination,35,8,27
39303,Fìíp,drakthul,720,rogue,assassination,21,8,13
39304,Ghøßt,outland,714,rogue,assassination,23,10,13
39305,Ninieu,kirin-tor,686,rogue,assassination,13,8,5
39306,Ghøstkid,blackrock,686,rogue,assassination,22,8,14
39307,Silass,marécage-de-zangar,672,rogue,assassination,12,7,5
39308,Bluntyblades,silvermoon,672,rogue,assassination,12,7,5
39309,Лиринэлла,soulflayer,672,rogue,assassination,12,7,5
39310,Nightyx,blackmoore,672,rogue,assassination,12,7,5
39311,Djpiglet,outland,672,rogue,assassination,12,7,5
39312,Zwarciowa,burning-legion,672,rogue,assassination,18,7,11
39313,Eeros,kazzak,672,rogue,assassination,18,7,11
39314,Köna,archimonde,672,rogue,assassination,18,7,11
39315,Jáckz,twisting-nether,672,rogue,assassination,18,7,11
39316,Styxro,blackhand,672,rogue,assassination,18,7,11
39317,Zilemjr,stormscale,672,rogue,assassination,18,7,11
39318,Soulriver,kelthuzad,672,rogue,assassination,18,7,11
39319,Scørp,ravencrest,672,rogue,assassination,18,7,11
39320,Ogc,draenor,672,rogue,assassination,18,7,11
39321,Like,aegwynn,672,rogue,assassination,18,7,11
39322,Patryk,silvermoon,672,rogue,assassination,21,8,13
39323,Jaqenhghar,pozzo-delleternità,672,rogue,assassination,24,7,17
39324,Chokee,blackrock,672,rogue,assassination,24,7,17
39325,Luketherogue,twisting-nether,672,rogue,assassination,24,7,17
39326,Saboteur,antonidas,672,rogue,assassination,24,7,17
39327,Featfawkes,ragnaros,672,rogue,assassination,24,7,17
39328,Ámbush,sylvanas,672,rogue,assassination,30,7,23
39329,Rikdy,kazzak,672,rogue,assassination,30,7,23
39330,Jupezii,stormreaver,671,rogue,assassination,12,7,5
39331,Роггбог,howling-fjord,671,rogue,assassination,12,7,5
39332,Renaai,defias-brotherhood,671,rogue,assassination,18,7,11
39333,Brazi,dalaran,671,rogue,assassination,18,7,11
39334,Rîg,draenor,671,rogue,assassination,18,7,11
39335,Friter,stormscale,671,rogue,assassination,18,7,11
39336,Kuzmin,die-aldor,671,rogue,assassination,18,7,11
39337,Shadowspike,sanguino,670,rogue,assassination,18,7,11
39338,Barkai,kazzak,670,rogue,assassination,18,7,11
39339,Valdengard,antonidas,669,rogue,assassination,12,7,5
39340,Shinigamî,nemesis,668,rogue,assassination,12,7,5
39341,Fizzkhalifa,zuljin,667,rogue,assassination,25,9,16
39342,Ashami,genjuros,666,rogue,assassination,18,7,11
39343,Rwaphou,ysondre,664,rogue,assassination,12,7,5
39344,Azkiel,archimonde,660,rogue,assassination,12,7,5
39345,Azotix,archimonde,659,rogue,assassination,18,7,11
39346,Twotimess,stormscale,658,rogue,assassination,12,7,5
39347,Onetwo,aggra-português,655,rogue,assassination,18,7,11
39348,Sessanali,silvermoon,655,rogue,assassination,30,7,23
39349,Niapro,dun-morogh,653,rogue,assassination,17,7,10
39350,Rêdbello,dun-morogh,651,rogue,assassination,18,7,11
39351,Якунька,soulflayer,637,rogue,assassination,17,7,10
39352,Rossaporcona,nemesis,637,rogue,assassination,36,7,29
39353,Mozenn,draenor,622,rogue,assassination,15,7,8
39354,Bensollo,tarren-mill,622,rogue,assassination,17,7,10
39355,Suley,blackrock,616,rogue,assassination,17,7,10
39356,Лиргенвард,deathguard,576,rogue,assassination,12,6,6
39357,Diagnoze,silvermoon,576,rogue,assassination,12,6,6
39358,Flopsy,archimonde,576,rogue,assassination,12,6,6
39359,Myk,ravencrest,576,rogue,assassination,12,6,6
39360,Voetdown,blackmoore,576,rogue,assassination,12,6,6
39361,Nekhâ,hyjal,576,rogue,assassination,12,6,6
39362,Sussulto,nemesis,576,rogue,assassination,12,6,6
39363,Blade,stormscale,576,rogue,assassination,12,6,6
39364,Бейнс,howling-fjord,576,rogue,assassination,12,6,6
39365,Necroli,kazzak,576,rogue,assassination,12,6,6
39366,Wrestlér,sylvanas,576,rogue,assassination,12,6,6
39367,Parawietje,twilights-hammer,576,rogue,assassination,12,6,6
39368,Remindful,ravencrest,576,rogue,assassination,12,6,6
39369,Schníttchen,antonidas,576,rogue,assassination,12,6,6
39370,Sachsun,outland,576,rogue,assassination,12,6,6
39371,Grimv,frostmane,576,rogue,assassination,12,6,6
39372,Mollyperph,ravencrest,576,rogue,assassination,12,6,6
39373,Tyranoxoth,stormscale,576,rogue,assassination,12,6,6
39374,Blooddance,ragnaros,576,rogue,assassination,18,6,12
39375,Dnw,ravencrest,576,rogue,assassination,18,6,12
39376,Shredbull,ravencrest,576,rogue,assassination,18,6,12
39377,Zte,frostmane,576,rogue,assassination,18,6,12
39378,Liraia,eredar,576,rogue,assassination,18,6,12
39379,Hmwow,kazzak,575,rogue,assassination,12,6,6
39380,Ноубрэйкс,blackscar,575,rogue,assassination,12,6,6
39381,Malvaxxs,tarren-mill,575,rogue,assassination,12,6,6
39382,Blackmøré,argent-dawn,575,rogue,assassination,12,6,6
39383,Rbgdowngrade,ravencrest,575,rogue,assassination,12,6,6
39384,Peqpen,ravencrest,575,rogue,assassination,12,6,6
39385,Zyrogue,silvermoon,575,rogue,assassination,12,6,6
39386,Bambush,bronze-dragonflight,575,rogue,assassination,12,6,6
39387,Shènz,ysondre,575,rogue,assassination,18,6,12
39388,Fkuwu,dalaran,575,rogue,assassination,24,6,18
39389,Davosslol,outland,575,rogue,assassination,24,6,18
39390,Drillss,ravencrest,575,rogue,assassination,34,7,27
39391,Жинпес,gordunni,574,rogue,assassination,12,6,6
39392,Yasmineskye,silvermoon,574,rogue,assassination,12,6,6
39393,Колдрейдж,soulflayer,574,rogue,assassination,12,6,6
39394,Outofstuns,earthen-ring,574,rogue,assassination,18,7,11
39395,Dahlinska,ravencrest,574,rogue,assassination,18,6,12
39396,Whiss,blackmoore,573,rogue,assassination,12,6,6
39397,Letheus,stormscale,573,rogue,assassination,18,6,12
39398,Whiz,alexstrasza,572,rogue,assassination,21,7,14
39399,Ranjual,blackhand,571,rogue,assassination,12,6,6
39400,Xlongman,blackhand,571,rogue,assassination,24,6,18
39401,Kahsorog,draenor,569,rogue,assassination,12,6,6
39402,Симус,lich-king,568,rogue,assassination,12,6,6
39403,Dimah,blackmoore,563,rogue,assassination,18,6,12
39404,Наджийа,lich-king,560,rogue,assassination,18,6,12
39405,Breattick,blackmoore,554,rogue,assassination,30,6,24
39406,Givilwtf,eredar,543,rogue,assassination,17,6,11
39407,Nÿst,khaz-modan,543,rogue,assassination,17,6,11
39408,Stælf,argent-dawn,543,rogue,assassination,22,6,16
39409,Ûltraaxx,ysondre,528,rogue,assassination,15,6,9
39410,Stonyhavana,ravencrest,527,rogue,assassination,11,6,5
39411,Vaeira,ravencrest,527,rogue,assassination,17,6,11
39412,Bamboozledx,draenor,511,rogue,assassination,11,6,5
39413,Стронг,soulflayer,511,rogue,assassination,15,6,9
39414,Blueberry,sargeras,505,rogue,assassination,19,7,12
39415,Ticklzepickl,silvermoon,480,rogue,assassination,6,5,1
39416,Ðescartes,antonidas,480,rogue,assassination,6,5,1
39417,Psychoxygen,nemesis,480,rogue,assassination,12,5,7
39418,Кишмякх,howling-fjord,480,rogue,assassination,12,5,7
39419,Рэкрейвон,gordunni,480,rogue,assassination,12,5,7
39420,Sholace,blackrock,480,rogue,assassination,12,5,7
39421,Kidalica,auchindoun,480,rogue,assassination,12,5,7
39422,Мечтавелена,howling-fjord,480,rogue,assassination,12,5,7
39423,Эрихард,howling-fjord,480,rogue,assassination,12,5,7
39424,Zajii,eredar,480,rogue,assassination,12,5,7
39425,Fixsap,aegwynn,480,rogue,assassination,12,5,7
39426,Exiv,ragnaros,480,rogue,assassination,12,5,7
39427,Anhduy,blackrock,480,rogue,assassination,12,5,7
39428,Engetiran,defias-brotherhood,480,rogue,assassination,12,5,7
39429,Gögel,draenor,480,rogue,assassination,12,5,7
39430,Gðrdø,blackrock,480,rogue,assassination,12,5,7
39431,Kendyx,kirin-tor,480,rogue,assassination,12,5,7
39432,Aikaza,blackmoore,480,rogue,assassination,12,5,7
39433,Backstabjr,blackmoore,480,rogue,assassination,12,5,7
39434,Psg,argent-dawn,480,rogue,assassination,12,5,7
39435,Shabakftw,twisting-nether,480,rogue,assassination,12,5,7
39436,Ghðst,stormscale,480,rogue,assassination,12,5,7
39437,Rylie,garona,480,rogue,assassination,12,5,7
39438,Calve,tarren-mill,480,rogue,assassination,12,5,7
39439,Nippzy,twisting-nether,480,rogue,assassination,12,5,7
39440,Qwneêr,tarren-mill,480,rogue,assassination,12,5,7
39441,Ридх,soulflayer,480,rogue,assassination,12,5,7
39442,Morgan,argent-dawn,480,rogue,assassination,12,5,7
39443,Hì,bronzebeard,480,rogue,assassination,12,5,7
39444,Злобность,gordunni,480,rogue,assassination,12,5,7
39445,Lämä,stormreaver,480,rogue,assassination,12,5,7
39446,Trickfulz,stormscale,480,rogue,assassination,12,5,7
39447,Malatang,thrall,480,rogue,assassination,12,5,7
39448,Snurry,tarren-mill,480,rogue,assassination,12,5,7
39449,Wrathed,stormreaver,480,rogue,assassination,18,5,13
39450,Kenjí,silvermoon,480,rogue,assassination,18,5,13
39451,Exanimu,ravencrest,480,rogue,assassination,18,5,13
39452,Republicano,cthun,480,rogue,assassination,18,5,13
39453,Ykw,tarren-mill,480,rogue,assassination,18,5,13
39454,Stealthi,stormscale,480,rogue,assassination,18,5,13
39455,Fawkkes,la-croisade-écarlate,480,rogue,assassination,18,5,13
39456,Vizifyx,ravencrest,480,rogue,assassination,24,5,19
39457,Waltër,tyrande,480,rogue,assassination,24,5,19
39458,Noxxy,archimonde,480,rogue,assassination,24,5,19
39459,Saptember,blackhand,479,rogue,assassination,6,5,1
39460,Хэресс,soulflayer,479,rogue,assassination,6,5,1
39461,Ganzord,dun-modr,479,rogue,assassination,12,5,7
39462,Дамид,gordunni,479,rogue,assassination,12,5,7
39463,Tossmysaladx,silvermoon,479,rogue,assassination,12,5,7
39464,Shadowfangs,ravencrest,479,rogue,assassination,12,5,7
39465,Jaymo,saurfang,479,rogue,assassination,12,5,7
39466,Leÿji,archimonde,479,rogue,assassination,12,5,7
39467,Dahlin,stormscale,479,rogue,assassination,12,5,7
39468,Lescud,illidan,479,rogue,assassination,12,5,7
39469,Некролз,gordunni,479,rogue,assassination,13,5,8
39470,Hallogenic,silvermoon,479,rogue,assassination,18,5,13
39471,Astefion,dalaran,479,rogue,assassination,24,5,19
39472,Runár,proudmoore,478,rogue,assassination,10,6,4
39473,Dravenfoot,defias-brotherhood,477,rogue,assassination,12,5,7
39474,Jacksoon,dun-morogh,477,rogue,assassination,18,5,13
39475,Lubor,thrall,476,rogue,assassination,12,5,7
39476,Owlcat,argent-dawn,475,rogue,assassination,12,5,7
39477,Razboy,dun-morogh,475,rogue,assassination,12,5,7
39478,Eljana,amanthul,472,rogue,assassination,20,7,13
39479,Рогнарек,blackscar,468,rogue,assassination,18,5,13
39480,Getownédyo,aggramar,463,rogue,assassination,21,6,15
39481,Síns,runetotem,448,rogue,assassination,10,5,5
39482,Deevoll,tarren-mill,447,rogue,assassination,20,6,14
39483,Элиссенда,deathguard,446,rogue,assassination,11,5,6
39484,Sørä,ragnaros,444,rogue,assassination,10,5,5
39485,Bhabì,uldaman,431,rogue,assassination,11,5,6
39486,Rhâpsødýx,twisting-nether,426,rogue,assassination,14,6,8
39487,Refundlands,kazzak,426,rogue,assassination,15,6,9
39488,Mâêl,blackmoore,426,rogue,assassination,16,6,10
39489,Rohalds,silvermoon,426,rogue,assassination,20,6,14
39490,Bluehell,sanguino,415,rogue,assassination,10,5,5
39491,Horóz,antonidas,400,rogue,assassination,7,5,2
39492,Døpegame,ravencrest,400,rogue,assassination,13,5,8
39493,Биокарлик,soulflayer,384,rogue,assassination,6,4,2
39494,Hasansabbah,twisting-nether,384,rogue,assassination,6,4,2
39495,Tebzr,ravencrest,384,rogue,assassination,6,4,2
39496,Nineball,frostmane,384,rogue,assassination,6,4,2
39497,Fûckínggød,outland,384,rogue,assassination,6,4,2
39498,Obstechhawi,argent-dawn,384,rogue,assassination,6,4,2
39499,Whosmanz,ragnaros,384,rogue,assassination,6,4,2
39500,Путьказаха,gordunni,384,rogue,assassination,6,4,2
39501,Mouchess,hyjal,384,rogue,assassination,6,4,2
39502,Mïkasa,ysondre,384,rogue,assassination,6,4,2
39503,Vögue,burning-legion,384,rogue,assassination,6,4,2
39504,Brñ,ravencrest,384,rogue,assassination,6,4,2
39505,Meldbroken,tarren-mill,384,rogue,assassination,6,4,2
39506,Красаа,soulflayer,384,rogue,assassination,6,4,2
39507,Sayianwho,ravencrest,384,rogue,assassination,6,4,2
39508,Yoruichì,kazzak,384,rogue,assassination,6,4,2
39509,Spolly,frostwolf,384,rogue,assassination,6,4,2
39510,Gâla,elune,384,rogue,assassination,6,4,2
39511,Eltitoedu,dun-modr,384,rogue,assassination,6,4,2
39512,Sparv,jaedenar,384,rogue,assassination,6,4,2
39513,Yuunr,kazzak,384,rogue,assassination,6,4,2
39514,Mâriejânee,nozdormu,384,rogue,assassination,6,4,2
39515,Mituxararr,blackrock,384,rogue,assassination,6,4,2
39516,Ebayscammer,ravencrest,384,rogue,assassination,6,4,2
39517,Ðoppex,blackmoore,384,rogue,assassination,6,4,2
39518,Sîccarîus,ravencrest,384,rogue,assassination,6,4,2
39519,Meccura,silvermoon,384,rogue,assassination,6,4,2
39520,Painkeeper,stormscale,384,rogue,assassination,6,4,2
39521,Synsinte,silvermoon,384,rogue,assassination,6,4,2
39522,Leviathann,doomhammer,384,rogue,assassination,6,4,2
39523,Дикийминус,howling-fjord,384,rogue,assassination,6,4,2
39524,Мёртвыйанарх,soulflayer,384,rogue,assassination,6,4,2
39525,Ddhelpra,blackrock,384,rogue,assassination,12,4,8
39526,Wayñe,ravencrest,384,rogue,assassination,12,4,8
39527,Артфулр,howling-fjord,384,rogue,assassination,12,4,8
39528,Ксяосупдупао,howling-fjord,384,rogue,assassination,12,4,8
39529,Галиновна,soulflayer,384,rogue,assassination,12,4,8
39530,Honeycakes,ravencrest,384,rogue,assassination,12,4,8
39531,Níterush,eredar,384,rogue,assassination,12,4,8
39532,Röguetönerö,dun-modr,384,rogue,assassination,12,4,8
39533,Zerfex,eredar,384,rogue,assassination,12,4,8
39534,Bijâ,aegwynn,384,rogue,assassination,12,4,8
39535,Redcutter,silvermoon,384,rogue,assassination,12,4,8
39536,Ра,gordunni,384,rogue,assassination,12,4,8
39537,Achterom,tarren-mill,384,rogue,assassination,12,4,8
39538,Ланароудсс,gordunni,384,rogue,assassination,12,4,8
39539,Kïdney,stormscale,384,rogue,assassination,12,4,8
39540,Wickness,dun-modr,384,rogue,assassination,12,4,8
39541,Lilrookie,argent-dawn,384,rogue,assassination,12,4,8
39542,Doomdagger,chamber-of-aspects,384,rogue,assassination,12,4,8
39543,Ryxon,arathor,384,rogue,assassination,12,4,8
39544,Wééselby,blackrock,384,rogue,assassination,12,4,8
39545,Obernik,draenor,384,rogue,assassination,12,4,8
39546,Darkchomeur,archimonde,384,rogue,assassination,12,4,8
39547,Sharkøo,eredar,384,rogue,assassination,12,4,8
39548,Гранетанцор,blackscar,384,rogue,assassination,12,4,8
39549,Gämèøvërkíd,archimonde,384,rogue,assassination,12,4,8
39550,Izzyb,auchindoun,384,rogue,assassination,12,4,8
39551,Jevo,kazzak,384,rogue,assassination,12,4,8
39552,Paidaki,kazzak,384,rogue,assassination,12,4,8
39553,Feucht,argent-dawn,384,rogue,assassination,12,4,8
39554,Meimei,sanguino,384,rogue,assassination,12,4,8
39555,Norpz,aggra-português,384,rogue,assassination,12,4,8
39556,Нарежудольки,howling-fjord,384,rogue,assassination,12,4,8
39557,Yakii,eredar,384,rogue,assassination,12,4,8
39558,Kallelelel,tarren-mill,384,rogue,assassination,12,4,8
39559,Stepkickgodx,blackmoore,384,rogue,assassination,12,4,8
39560,Crimatoria,rajaxx,384,rogue,assassination,12,4,8
39561,Gorgeousréd,aegwynn,384,rogue,assassination,18,4,14
39562,Sythex,archimonde,384,rogue,assassination,18,4,14
39563,Zerö,tarren-mill,384,rogue,assassination,18,4,14
39564,Ристоврация,gordunni,384,rogue,assassination,18,4,14
39565,Ibizà,ravencrest,384,rogue,assassination,18,4,14
39566,Елианора,gordunni,384,rogue,assassination,18,4,14
39567,Lïke,frostwolf,384,rogue,assassination,18,4,14
39568,Лайнэл,deathweaver,384,rogue,assassination,18,4,14
39569,Mindset,eredar,384,rogue,assassination,18,4,14
39570,Ноумингод,gordunni,384,rogue,assassination,24,4,20
39571,Opiïum,ysondre,383,rogue,assassination,6,4,2
39572,Vexedancer,stormscale,383,rogue,assassination,6,4,2
39573,Tedko,dun-modr,383,rogue,assassination,6,4,2
39574,Horrogue,aggramar,383,rogue,assassination,6,4,2
39575,Kyzzo,dalaran,383,rogue,assassination,12,4,8
39576,Ppogg,pozzo-delleternità,383,rogue,assassination,12,4,8
39577,Obbexd,outland,383,rogue,assassination,12,4,8
39578,Töbïï,sylvanas,383,rogue,assassination,12,4,8
39579,Algopyrin,ragnaros,383,rogue,assassination,12,4,8
39580,Twinkyzzö,archimonde,382,rogue,assassination,12,4,8
39581,Némésiss,archimonde,381,rogue,assassination,12,4,8
39582,Pumpy,blades-edge,381,rogue,assassination,12,4,8
39583,Møkkagnom,darkspear,381,rogue,assassination,12,4,8
39584,Easy,kult-der-verdammten,376,rogue,assassination,18,4,14
39585,Stealtheous,arathor,367,rogue,assassination,11,4,7
39586,Firekry,stormscale,366,rogue,assassination,12,4,8
39587,Lilbubblegum,emerald-dream,351,rogue,assassination,11,4,7
39588,Gereon,drakthul,351,rogue,assassination,11,4,7
39589,Морзо,howling-fjord,351,rogue,assassination,17,4,13
39590,Клозо,galakrond,351,rogue,assassination,17,4,13
39591,Voraq,blackhand,350,rogue,assassination,11,4,7
39592,Háshírama,ravencrest,335,rogue,assassination,11,4,7
39593,Arathir,ravencrest,330,rogue,assassination,15,5,10
39594,Benh,ysondre,319,rogue,assassination,8,4,4
39595,Fz,chants-éternels,319,rogue,assassination,16,5,11
39596,Smorcoolio,stormscale,288,rogue,assassination,6,3,3
39597,Ximenidriel,ravencrest,288,rogue,assassination,6,3,3
39598,Luciferx,stormscale,288,rogue,assassination,6,3,3
39599,Myxx,ravencrest,288,rogue,assassination,6,3,3
39600,Nezukóchan,ravencrest,288,rogue,assassination,6,3,3
39601,Langneurr,archimonde,288,rogue,assassination,6,3,3
39602,Sâtýr,ravencrest,288,rogue,assassination,6,3,3
39603,Jsprxo,stormscale,288,rogue,assassination,6,3,3
39604,Reaventis,ravencrest,288,rogue,assassination,6,3,3
39605,Zigaretz,ravencrest,288,rogue,assassination,6,3,3
39606,Mordred,stormscale,288,rogue,assassination,6,3,3
39607,Erdin,ravencrest,288,rogue,assassination,6,3,3
39608,Steálth,silvermoon,288,rogue,assassination,6,3,3
39609,Lïhtêñßërg,ravencrest,288,rogue,assassination,6,3,3
39610,Keexy,ravencrest,288,rogue,assassination,6,3,3
39611,Darák,thrall,288,rogue,assassination,6,3,3
39612,Artyzoo,tarren-mill,288,rogue,assassination,6,3,3
39613,Aska,antonidas,288,rogue,assassination,6,3,3
39614,Tasster,frostwolf,288,rogue,assassination,6,3,3
39615,Sît,twisting-nether,288,rogue,assassination,6,3,3
39616,Зорго,deathguard,288,rogue,assassination,6,3,3
39617,Jackpackáge,sylvanas,288,rogue,assassination,6,3,3
39618,Labronka,sanguino,288,rogue,assassination,6,3,3
39619,Kaylí,kazzak,288,rogue,assassination,6,3,3
39620,Ultraxette,ysondre,288,rogue,assassination,6,3,3
39621,Stroògz,ysondre,288,rogue,assassination,6,3,3
39622,Heftychonk,doomhammer,288,rogue,assassination,6,3,3
39623,Lättja,hyjal,288,rogue,assassination,6,3,3
39624,Rodént,argent-dawn,288,rogue,assassination,6,3,3
39625,Ацилия,galakrond,288,rogue,assassination,6,3,3
39626,Олддеадроб,soulflayer,288,rogue,assassination,6,3,3
39627,Gitguduwu,tarren-mill,288,rogue,assassination,6,3,3
39628,Laojin,kiljaeden,288,rogue,assassination,6,3,3
39629,Ракфорн,howling-fjord,288,rogue,assassination,6,3,3
39630,Sorashna,agamaggan,288,rogue,assassination,6,3,3
39631,Blades,blackmoore,288,rogue,assassination,6,3,3
39632,Stealthyist,darkmoon-faire,288,rogue,assassination,6,3,3
39633,Batta,drakthul,288,rogue,assassination,6,3,3
39634,Котянкахд,howling-fjord,288,rogue,assassination,6,3,3
39635,Охотникведьм,soulflayer,288,rogue,assassination,6,3,3
39636,Illmindofboo,twisting-nether,288,rogue,assassination,6,3,3
39637,Nevazutu,twisting-nether,288,rogue,assassination,6,3,3
39638,Xãwé,kazzak,288,rogue,assassination,6,3,3
39639,Ðaemøn,archimonde,288,rogue,assassination,12,4,8
39640,Shadowprank,ravencrest,288,rogue,assassination,9,3,6
39641,Vyllaftw,hyjal,288,rogue,assassination,10,3,7
39642,Psybelette,khaz-modan,288,rogue,assassination,15,4,11
39643,Rôst,ravencrest,288,rogue,assassination,12,3,9
39644,Poerta,burning-blade,288,rogue,assassination,12,3,9
39645,Hamer,eredar,288,rogue,assassination,12,3,9
39646,Kyropth,eredar,288,rogue,assassination,12,3,9
39647,Mxrbid,defias-brotherhood,288,rogue,assassination,12,3,9
39648,Kylìemirogue,blackrock,288,rogue,assassination,12,3,9
39649,Persës,outland,288,rogue,assassination,12,3,9
39650,Søtez,ravencrest,288,rogue,assassination,12,3,9
39651,Eriksonn,drakthul,288,rogue,assassination,12,3,9
39652,Terya,ragnaros,288,rogue,assassination,12,3,9
39653,Smokeyx,outland,288,rogue,assassination,12,3,9
39654,Vessel,tarren-mill,288,rogue,assassination,12,3,9
39655,Turbocandle,ravencrest,288,rogue,assassination,12,3,9
39656,Teldã,archimonde,288,rogue,assassination,12,3,9
39657,Fushimi,ravencrest,288,rogue,assassination,12,3,9
39658,Курога,howling-fjord,288,rogue,assassination,12,3,9
39659,Zip,alleria,288,rogue,assassination,12,3,9
39660,Gløck,die-aldor,288,rogue,assassination,12,3,9
39661,Howhigh,stormscale,288,rogue,assassination,12,3,9
39662,Bumaqt,silvermoon,288,rogue,assassination,12,3,9
39663,Redork,twisting-nether,288,rogue,assassination,12,3,9
39664,Sickko,stormscale,288,rogue,assassination,12,3,9
39665,Nezuko,gilneas,288,rogue,assassination,12,3,9
39666,Ryurfy,archimonde,288,rogue,assassination,12,3,9
39667,Hersuub,blackmoore,288,rogue,assassination,12,3,9
39668,Netreck,dun-modr,288,rogue,assassination,12,3,9
39669,Zeiden,sanguino,288,rogue,assassination,12,3,9
39670,Bakalan,dun-modr,288,rogue,assassination,12,3,9
39671,Onedance,blackrock,288,rogue,assassination,14,3,11
39672,Altaár,dun-modr,288,rogue,assassination,18,3,15
39673,Crittylohan,blackrock,288,rogue,assassination,18,3,15
39674,Memphismp,drakthul,288,rogue,assassination,18,3,15
39675,Jáyjay,antonidas,288,rogue,assassination,18,3,15
39676,Killboom,rexxar,287,rogue,assassination,6,3,3
39677,Умбрен,lich-king,287,rogue,assassination,6,3,3
39678,Гламурятина,gordunni,287,rogue,assassination,6,3,3
39679,Willin,kazzak,287,rogue,assassination,6,3,3
39680,Yubleeding,kazzak,287,rogue,assassination,6,3,3
39681,Vv,terokkar,287,rogue,assassination,6,3,3
39682,Saleanos,die-aldor,287,rogue,assassination,12,3,9
39683,Nastyrogue,burning-legion,287,rogue,assassination,12,3,9
39684,Vendox,defias-brotherhood,287,rogue,assassination,12,3,9
39685,Krymziàâ,hyjal,287,rogue,assassination,18,3,15
39686,Bondina,nemesis,286,rogue,assassination,6,3,3
39687,Фоксивнир,soulflayer,286,rogue,assassination,6,3,3
39688,Clapslap,blackmoore,286,rogue,assassination,6,3,3
39689,Ecilaa,conseil-des-ombres,285,rogue,assassination,12,3,9
39690,Derrieretoî,archimonde,285,rogue,assassination,12,3,9
39691,Bobydrift,khaz-modan,284,rogue,assassination,12,3,9
39692,Verbb,turalyon,284,rogue,assassination,12,3,9
39693,Layson,les-clairvoyants,271,rogue,assassination,11,3,8
39694,Bloodhand,blackmoore,255,rogue,assassination,11,3,8
39695,Candise,ysondre,253,rogue,assassination,11,3,8
39696,Blckrogue,bloodfeather,240,rogue,assassination,9,3,6
39697,Jimmybrä,draenor,239,rogue,assassination,5,3,2
39698,Starkad,archimonde,239,rogue,assassination,5,3,2
39699,Kebabgodx,sanguino,223,rogue,assassination,8,3,5
39700,Goldenblitz,blackmoore,192,rogue,assassination,6,2,4
39701,Кашеварить,gordunni,192,rogue,assassination,6,2,4
39702,Сильфитт,gordunni,192,rogue,assassination,6,2,4
39703,Weird,blackmoore,192,rogue,assassination,6,2,4
39704,Shúrae,blackmoore,192,rogue,assassination,6,2,4
39705,Killnoobs,kazzak,192,rogue,assassination,6,2,4
39706,Saix,blackrock,192,rogue,assassination,6,2,4
39707,Maedyv,magtheridon,192,rogue,assassination,6,2,4
39708,Sêrgi,minahonda,192,rogue,assassination,6,2,4
39709,Zhafira,magtheridon,192,rogue,assassination,6,2,4
39710,Robtherobber,kazzak,192,rogue,assassination,6,2,4
39711,Zømbië,kazzak,192,rogue,assassination,6,2,4
39712,Redrumx,outland,192,rogue,assassination,6,2,4
39713,Bórgós,blackrock,192,rogue,assassination,6,2,4
39714,Garou,blackhand,192,rogue,assassination,6,2,4
39715,Kersatos,silvermoon,192,rogue,assassination,6,2,4
39716,Fälke,dun-modr,192,rogue,assassination,6,2,4
39717,Bloodwraith,stormscale,192,rogue,assassination,6,2,4
39718,Rãz,stormscale,192,rogue,assassination,6,2,4
39719,Warbell,stormscale,192,rogue,assassination,6,2,4
39720,Venom,stormscale,192,rogue,assassination,6,2,4
39721,Syrn,ravencrest,192,rogue,assassination,6,2,4
39722,Nudelholz,blackrock,192,rogue,assassination,6,2,4
39723,Althieves,ravencrest,192,rogue,assassination,6,2,4
39724,Maxrizzx,ravencrest,192,rogue,assassination,6,2,4
39725,Niagram,dun-modr,192,rogue,assassination,6,2,4
39726,Kikitaklk,uldum,192,rogue,assassination,6,2,4
39727,Naí,zuljin,192,rogue,assassination,6,2,4
39728,Hideout,ravencrest,192,rogue,assassination,6,2,4
39729,Windhawkz,silvermoon,192,rogue,assassination,6,2,4
39730,Sokillu,silvermoon,192,rogue,assassination,6,2,4
39731,Sanzsa,ravencrest,192,rogue,assassination,6,2,4
39732,Нойсеен,gordunni,192,rogue,assassination,6,2,4
39733,Новиччокк,gordunni,192,rogue,assassination,6,2,4
39734,Mobrac,silvermoon,192,rogue,assassination,6,2,4
39735,Аренатрюки,soulflayer,192,rogue,assassination,6,2,4
39736,Jonewrld,ravencrest,192,rogue,assassination,6,2,4
39737,Хемофилия,grom,192,rogue,assassination,6,2,4
39738,Katara,antonidas,192,rogue,assassination,6,2,4
39739,Fîst,antonidas,192,rogue,assassination,6,2,4
39740,Eazmode,outland,192,rogue,assassination,6,2,4
39741,Brazzersx,antonidas,192,rogue,assassination,6,2,4
39742,Reáper,frostwolf,192,rogue,assassination,6,2,4
39743,Ikaze,kazzak,192,rogue,assassination,6,2,4
39744,Gane,sanguino,192,rogue,assassination,6,2,4
39745,Саулите,deathguard,192,rogue,assassination,6,2,4
39746,Highz,zenedar,192,rogue,assassination,6,2,4
39747,Hardkølle,ravencrest,192,rogue,assassination,6,2,4
39748,Китей,howling-fjord,192,rogue,assassination,6,2,4
39749,Xanyy,bloodfeather,192,rogue,assassination,6,2,4
39750,Сабстрайк,soulflayer,192,rogue,assassination,6,2,4
39751,Yanlu,ysondre,192,rogue,assassination,6,2,4
39752,Xanders,draenor,192,rogue,assassination,6,2,4
39753,Nïhal,suramar,192,rogue,assassination,6,2,4
39754,Isucu,burning-legion,192,rogue,assassination,6,2,4
39755,Oczku,burning-legion,192,rogue,assassination,6,2,4
39756,Rearmer,burning-legion,192,rogue,assassination,6,2,4
39757,Henlh,turalyon,192,rogue,assassination,6,2,4
39758,Sycko,alakir,192,rogue,assassination,6,2,4
39759,Helcof,emerald-dream,192,rogue,assassination,6,2,4
39760,Grüeßseebach,todeswache,192,rogue,assassination,6,2,4
39761,Díddz,tarren-mill,192,rogue,assassination,6,2,4
39762,Habba,dragonblight,192,rogue,assassination,6,2,4
39763,Tofix,tarren-mill,192,rogue,assassination,6,2,4
39764,Ðelvin,dalaran,192,rogue,assassination,6,2,4
39765,Diliu,doomhammer,192,rogue,assassination,6,2,4
39766,Xeggy,turalyon,192,rogue,assassination,6,2,4
39767,Хулиганнчег,galakrond,192,rogue,assassination,6,2,4
39768,Аутянин,soulflayer,192,rogue,assassination,6,2,4
39769,Люняшка,booty-bay,192,rogue,assassination,6,2,4
39770,Mallaurya,dalaran,192,rogue,assassination,6,2,4
39771,Zyphion,ragnaros,192,rogue,assassination,6,2,4
39772,Noilek,sylvanas,192,rogue,assassination,6,2,4
39773,Ichiegoichie,draenor,192,rogue,assassination,6,2,4
39774,Warrdenn,draenor,192,rogue,assassination,6,2,4
39775,Bangerstab,draenor,192,rogue,assassination,6,2,4
39776,Synexo,sylvanas,192,rogue,assassination,6,2,4
39777,Tinta,aszune,192,rogue,assassination,6,2,4
39778,Totentánz,silvermoon,192,rogue,assassination,15,3,12
39779,Hitogoroshi,hyjal,192,rogue,assassination,12,2,10
39780,Yüm,burning-blade,192,rogue,assassination,12,2,10
39781,Ayatsuji,nemesis,192,rogue,assassination,12,2,10
39782,Neirdà,hyjal,192,rogue,assassination,12,2,10
39783,Sylvanshadow,nemesis,192,rogue,assassination,12,2,10
39784,Rasponi,ragnaros,192,rogue,assassination,12,2,10
39785,Azzmodia,aegwynn,192,rogue,assassination,12,2,10
39786,Vezinia,ravencrest,192,rogue,assassination,12,2,10
39787,Romiel,ravencrest,192,rogue,assassination,12,2,10
39788,Ôrígìnälnezo,drakthul,192,rogue,assassination,12,2,10
39789,Sheyrrà,aegwynn,192,rogue,assassination,12,2,10
39790,Withoutlove,drakthul,192,rogue,assassination,12,2,10
39791,Nesä,hyjal,192,rogue,assassination,12,2,10
39792,Mingzhu,ravencrest,192,rogue,assassination,12,2,10
39793,Cacucoxpahu,kazzak,192,rogue,assassination,12,2,10
39794,Skuggdunkarn,draenor,192,rogue,assassination,12,2,10
39795,Hanteran,magtheridon,192,rogue,assassination,12,2,10
39796,Лэйкиро,gordunni,192,rogue,assassination,12,2,10
39797,Bolesnirogue,draenor,192,rogue,assassination,12,2,10
39798,Rnghero,blackmoore,192,rogue,assassination,12,2,10
39799,Sneakzy,sylvanas,192,rogue,assassination,12,2,10
39800,Skilz,sylvanas,192,rogue,assassination,12,2,10
39801,Coopér,argent-dawn,192,rogue,assassination,18,2,16
39802,Nhot,kazzak,191,rogue,assassination,6,2,4
39803,Токссиси,gordunni,191,rogue,assassination,6,2,4
39804,Drexxo,drakthul,191,rogue,assassination,6,2,4
39805,Thugore,thunderhorn,191,rogue,assassination,6,2,4
39806,Вангельм,gordunni,191,rogue,assassination,12,2,10
39807,Midô,dun-morogh,191,rogue,assassination,12,2,10
39808,Snikrot,karazhan,190,rogue,assassination,12,2,10
39809,Murant,twisting-nether,190,rogue,assassination,12,2,10
39810,Icyicé,kazzak,175,rogue,assassination,11,2,9
39811,Sanzoo,blackmoore,175,rogue,assassination,11,2,9
39812,Зайт,howling-fjord,173,rogue,assassination,11,3,8
39813,Nià,argent-dawn,158,rogue,assassination,10,2,8
39814,Rascall,anetheron,138,rogue,assassination,8,3,5
39815,Shâdowfreeze,onyxia,138,rogue,assassination,22,4,18
39816,Ravenom,sylvanas,96,rogue,assassination,6,1,5
39817,Stealthaldo,sylvanas,96,rogue,assassination,6,1,5
39818,Hallowéén,turalyon,96,rogue,assassination,6,1,5
39819,Kilabre,twisting-nether,96,rogue,assassination,6,1,5
39820,Shåkø,tarren-mill,96,rogue,assassination,6,1,5
39821,Helax,turalyon,96,rogue,assassination,6,1,5
39822,Jamzyrogue,emerald-dream,96,rogue,assassination,6,1,5
39823,Sly,emerald-dream,96,rogue,assassination,6,1,5
39824,Bizzarerogue,tarren-mill,96,rogue,assassination,6,1,5
39825,Tsoupoma,tarren-mill,96,rogue,assassination,6,1,5
39826,Lefthook,argent-dawn,96,rogue,assassination,6,1,5
39827,Møtivate,ragnaros,96,rogue,assassination,6,1,5
39828,Lorinthel,argent-dawn,96,rogue,assassination,6,1,5
39829,Рестинписер,soulflayer,96,rogue,assassination,6,1,5
39830,Guzirogue,azshara,96,rogue,assassination,6,1,5
39831,Pfaded,steamwheedle-cartel,96,rogue,assassination,6,1,5
39832,Dachdagger,malfurion,96,rogue,assassination,6,1,5
39833,Mortdorei,argent-dawn,96,rogue,assassination,6,1,5
39834,Бларефул,eversong,96,rogue,assassination,6,1,5
39835,Takiya,ysondre,96,rogue,assassination,6,1,5
39836,Дизелюжн,howling-fjord,96,rogue,assassination,6,1,5
39837,Salitra,die-aldor,96,rogue,assassination,6,1,5
39838,Трисися,gordunni,96,rogue,assassination,6,1,5
39839,Метаболикх,gordunni,96,rogue,assassination,6,1,5
39840,Yörgs,eredar,96,rogue,assassination,6,1,5
39841,Penetrantos,eredar,96,rogue,assassination,6,1,5
39842,Roronao,sanguino,96,rogue,assassination,6,1,5
39843,Yamoshí,sanguino,96,rogue,assassination,6,1,5
39844,Msrogue,eredar,96,rogue,assassination,6,1,5
39845,Flêxô,antonidas,96,rogue,assassination,6,1,5
39846,Deceptionz,ravencrest,96,rogue,assassination,6,1,5
39847,Tokyotears,ravencrest,96,rogue,assassination,6,1,5
39848,Frequenzalfa,silvermoon,96,rogue,assassination,6,1,5
39849,Natkatje,azjolnerub,96,rogue,assassination,6,1,5
39850,Natillaa,dun-modr,96,rogue,assassination,6,1,5
39851,Nexieane,ravencrest,96,rogue,assassination,6,1,5
39852,Thiranor,cthun,96,rogue,assassination,6,1,5
39853,Chøsen,stormscale,96,rogue,assassination,6,1,5
39854,Mekóz,draenor,96,rogue,assassination,6,1,5
39855,Vexior,argent-dawn,96,rogue,assassination,6,1,5
39856,Barisso,burning-legion,96,rogue,assassination,6,1,5
39857,Sbx,alakir,96,rogue,assassination,6,1,5
39858,Faso,thunderhorn,96,rogue,assassination,6,1,5
39859,Roguy,wildhammer,96,rogue,assassination,6,1,5
39860,Janx,aegwynn,96,rogue,assassination,6,1,5
39861,Finfcyn,burning-legion,96,rogue,assassination,6,1,5
39862,Royalflüx,grim-batol,96,rogue,assassination,6,1,5
39863,Dayanir,aggra-português,96,rogue,assassination,6,1,5
39864,Invisage,grim-batol,96,rogue,assassination,6,1,5
39865,Ðiè,frostmane,96,rogue,assassination,6,1,5
39866,Nelji,archimonde,96,rogue,assassination,6,1,5
39867,Expositiv,blackmoore,96,rogue,assassination,6,1,5
39868,Ñavy,archimonde,96,rogue,assassination,6,1,5
39869,Hendrikske,aggramar,96,rogue,assassination,6,1,5
39870,Кейнилин,gordunni,96,rogue,assassination,6,1,5
39871,Ohmydotz,archimonde,96,rogue,assassination,6,1,5
39872,Wøølfgang,archimonde,96,rogue,assassination,6,1,5
39873,Tyzla,blackrock,96,rogue,assassination,6,1,5
39874,Missàh,archimonde,96,rogue,assassination,6,1,5
39875,Miamalkova,zuluhed,96,rogue,assassination,6,1,5
39876,Kenko,aerie-peak,96,rogue,assassination,6,1,5
39877,Иордани,gordunni,96,rogue,assassination,6,1,5
39878,Азунайт,ashenvale,96,rogue,assassination,6,1,5
39879,Vanisshh,hyjal,96,rogue,assassination,6,1,5
39880,Asmodal,antonidas,96,rogue,assassination,6,1,5
39881,Роудхог,blackscar,96,rogue,assassination,6,1,5
39882,Эстанга,grom,96,rogue,assassination,6,1,5
39883,Куллтро,blackscar,96,rogue,assassination,6,1,5
39884,Распяздяй,gordunni,96,rogue,assassination,7,1,6
39885,Proilas,draenor,96,rogue,assassination,11,1,10
39886,Kyoukaî,archimonde,96,rogue,assassination,12,1,11
39887,Tybiereus,argent-dawn,96,rogue,assassination,12,1,11
39888,Роророл,gordunni,96,rogue,assassination,12,1,11
39889,Триплсап,howling-fjord,96,rogue,assassination,12,1,11
39890,Jawen,silvermoon,96,rogue,assassination,12,1,11
39891,Diededlmao,ragnaros,96,rogue,assassination,12,1,11
39892,Engles,twisting-nether,96,rogue,assassination,12,1,11
39893,Ønlylovcindy,drekthar,96,rogue,assassination,12,1,11
39894,Barbuniarz,shadowsong,96,rogue,assassination,12,1,11
39895,Calyon,hyjal,96,rogue,assassination,18,1,17
39896,Crispflake,frostwolf,96,rogue,assassination,18,1,17
39897,Ravéñ,silvermoon,96,rogue,assassination,24,1,23
39898,Vicenzo,archimonde,95,rogue,assassination,3,2,1
39899,Belina,draenor,95,rogue,assassination,6,1,5
39900,Elvís,chamber-of-aspects,95,rogue,assassination,6,1,5
39901,Trashcarlitâ,eredar,79,rogue,assassination,5,1,4
39902,Vound,tarren-mill,64,rogue,assassination,4,1,3
39903,Elgande,stormrage,63,rogue,assassination,2,2,0
39904,Vanquishz,arathor,48,rogue,assassination,3,1,2
39905,Rûzk,frostwolf,48,rogue,assassination,3,1,2
39906,Latscholol,malorne,42,rogue,assassination,12,3,9
39907,Kkraken,dalaran,41,rogue,assassination,10,2,8
39908,Hímars,ragnaros,2151,shaman,restoration,101,52,49
39909,Мефодийшаман,howling-fjord,2126,shaman,restoration,142,88,54
39910,Shadrak,eredar,2123,shaman,restoration,84,46,38
39911,Mininini,ravencrest,2120,shaman,restoration,133,70,63
39912,Josë,twisting-nether,2119,shaman,restoration,137,73,64
39913,Терату,howling-fjord,2118,shaman,restoration,84,46,38
39914,Crnine,pozzo-delleternità,2112,shaman,restoration,75,49,26
39915,Jackypink,ragnaros,2083,shaman,restoration,261,135,126
39916,Benpai,eredar,2076,shaman,restoration,72,36,36
39917,Ultrahound,twisting-nether,2057,shaman,restoration,48,39,9
39918,Trashgame,kazzak,2050,shaman,restoration,66,36,30
39919,Jelincic,ravencrest,2027,shaman,restoration,96,52,44
39920,Chäväman,archimonde,2025,shaman,restoration,150,72,78
39921,Unbrokeñ,stormscale,2024,shaman,restoration,93,45,48
39922,Ggnore,kazzak,2017,shaman,restoration,176,107,69
39923,Вишняблэйз,soulflayer,2007,shaman,restoration,77,44,33
39924,Nickygodx,stormscale,2007,shaman,restoration,77,40,37
39925,Libanô,archimonde,2002,shaman,restoration,859,421,438
39926,Rogerscruton,blades-edge,2001,shaman,restoration,60,32,28
39927,Yararsiz,twisting-nether,2001,shaman,restoration,249,132,117
39928,Keenxd,burning-legion,2000,shaman,restoration,101,55,46
39929,Carlpeant,drakthul,1998,shaman,restoration,191,100,91
39930,Daretodream,blackrock,1996,shaman,restoration,53,29,24
39931,Lavalavalava,blackrock,1993,shaman,restoration,447,244,203
39932,Драгенхз,gordunni,1983,shaman,restoration,387,195,192
39933,Frshprn,hyjal,1982,shaman,restoration,90,51,39
39934,Кодитян,gordunni,1981,shaman,restoration,72,38,34
39935,Swineflowing,ysondre,1974,shaman,restoration,96,50,46
39936,Kisshots,the-maelstrom,1960,shaman,restoration,162,87,75
39937,Дольчих,deathguard,1956,shaman,restoration,302,144,158
39938,Deepwithyou,blackhand,1953,shaman,restoration,153,83,70
39939,Epsylone,kazzak,1953,shaman,restoration,101,51,50
39940,Ripperdoc,stormreaver,1950,shaman,restoration,78,38,40
39941,Linkx,stormscale,1948,shaman,restoration,40,22,18
39942,Трс,razuvious,1947,shaman,restoration,158,90,68
39943,Fotmherøqtx,ravencrest,1946,shaman,restoration,132,75,57
39944,Bobanrajovic,silvermoon,1943,shaman,restoration,48,31,17
39945,Söd,dun-morogh,1943,shaman,restoration,84,42,42
39946,Tallyx,ravencrest,1940,shaman,restoration,119,60,59
39947,Adroda,kazzak,1939,shaman,restoration,117,66,51
39948,Valko,hellfire,1931,shaman,restoration,42,27,15
39949,Lavelover,tarren-mill,1927,shaman,restoration,66,41,25
39950,Zhull,ravencrest,1927,shaman,restoration,400,197,203
39951,Цукерок,soulflayer,1922,shaman,restoration,119,72,47
39952,Skreewu,outland,1922,shaman,restoration,90,44,46
39953,Señordoge,kazzak,1917,shaman,restoration,54,28,26
39954,Shamidrak,eredar,1914,shaman,restoration,66,34,32
39955,Милфшама,blackscar,1910,shaman,restoration,263,140,123
39956,Lunarsloths,hyjal,1907,shaman,restoration,54,33,21
39957,Greggyb,twisting-nether,1904,shaman,restoration,48,27,21
39958,Vivaldi,varimathras,1899,shaman,restoration,56,29,27
39959,Carlitosham,eredar,1899,shaman,restoration,68,33,35
39960,Котенокмур,soulflayer,1899,shaman,restoration,48,20,28
39961,Stensham,stormreaver,1896,shaman,restoration,66,37,29
39962,Мефодийшама,howling-fjord,1893,shaman,restoration,132,63,69
39963,Hugox,outland,1889,shaman,restoration,566,278,288
39964,Izir,archimonde,1885,shaman,restoration,234,120,114
39965,Bmbx,archimonde,1885,shaman,restoration,604,304,300
39966,Fufupartyxx,blackrock,1883,shaman,restoration,60,37,23
39967,Chokelord,archimonde,1882,shaman,restoration,36,22,14
39968,Somethingnew,azuremyst,1882,shaman,restoration,64,32,32
39969,Thunderrock,stormreaver,1880,shaman,restoration,211,102,109
39970,Sèfìx,tarren-mill,1879,shaman,restoration,38,21,17
39971,Natasz,burning-legion,1874,shaman,restoration,206,114,92
39972,Kïllard,archimonde,1872,shaman,restoration,80,40,40
39973,Кенкерх,gordunni,1871,shaman,restoration,84,38,46
39974,Timide,ravencrest,1870,shaman,restoration,48,28,20
39975,Killrogge,kazzak,1869,shaman,restoration,34,29,5
39976,Iloveléa,ravencrest,1868,shaman,restoration,78,44,34
39977,Rheax,tarren-mill,1868,shaman,restoration,60,27,33
39978,Owrly,stormscale,1866,shaman,restoration,136,65,71
39979,Keén,burning-legion,1865,shaman,restoration,51,29,22
39980,Вавувоух,howling-fjord,1863,shaman,restoration,54,27,27
39981,Teldathree,archimonde,1862,shaman,restoration,118,63,55
39982,Онеоне,deathweaver,1861,shaman,restoration,71,41,30
39983,Эоя,howling-fjord,1861,shaman,restoration,230,121,109
39984,Louler,ragnaros,1860,shaman,restoration,124,69,55
39985,Kalypsø,arthas,1858,shaman,restoration,77,44,33
39986,Wíllz,ravencrest,1858,shaman,restoration,54,29,25
39987,Yachiru,sylvanas,1854,shaman,restoration,73,59,14
39988,Ghettero,ragnaros,1851,shaman,restoration,39,25,14
39989,Иними,soulflayer,1851,shaman,restoration,258,125,133
39990,Sugarfreé,ragnaros,1848,shaman,restoration,48,26,22
39991,Zaru,sanguino,1846,shaman,restoration,63,31,32
39992,Finaltotem,draenor,1844,shaman,restoration,60,28,32
39993,Cæsífer,blackrock,1844,shaman,restoration,72,32,40
39994,Shiranoye,blackrock,1842,shaman,restoration,144,77,67
39995,Sentûn,blackrock,1842,shaman,restoration,138,68,70
39996,Cylantarus,blackrock,1838,shaman,restoration,179,94,85
39997,Cherepaha,stormscale,1838,shaman,restoration,70,32,38
39998,Cellfury,kazzak,1837,shaman,restoration,46,36,10
39999,Wernøz,archimonde,1837,shaman,restoration,80,37,43
40000,Johncoltrane,archimonde,1835,shaman,restoration,132,84,48
40001,Epsy,magtheridon,1834,shaman,restoration,66,46,20
40002,Shockmelone,blackrock,1834,shaman,restoration,103,55,48
40003,Inspektør,kazzak,1833,shaman,restoration,59,37,22
40004,Swkx,dun-modr,1832,shaman,restoration,88,48,40
40005,Alanus,draenor,1831,shaman,restoration,63,33,30
40006,Sinzzu,ragnaros,1831,shaman,restoration,241,123,118
40007,Gargro,kazzak,1831,shaman,restoration,109,54,55
40008,Jawje,tarren-mill,1831,shaman,restoration,102,49,53
40009,Westide,conseil-des-ombres,1830,shaman,restoration,48,26,22
40010,Shamuunn,ravencrest,1830,shaman,restoration,54,28,26
40011,Sethrøllins,hyjal,1829,shaman,restoration,114,53,61
40012,Domo,stormscale,1827,shaman,restoration,60,29,31
40013,Fitnessdavid,ravencrest,1826,shaman,restoration,53,29,24
40014,Hexe,kazzak,1826,shaman,restoration,81,37,44
40015,Askagain,sylvanas,1825,shaman,restoration,52,28,24
40016,Zergønk,ravencrest,1824,shaman,restoration,42,28,14
40017,Asynchund,ravencrest,1821,shaman,restoration,42,26,16
40018,Centralc,twisting-nether,1820,shaman,restoration,47,28,19
40019,Árés,sanguino,1820,shaman,restoration,63,34,29
40020,Светшамка,howling-fjord,1817,shaman,restoration,30,19,11
40021,Shamrockx,outland,1816,shaman,restoration,83,42,41
40022,Sûckmytotem,ragnaros,1815,shaman,restoration,72,35,37
40023,Arathoir,ravencrest,1814,shaman,restoration,36,23,13
40024,Bladeyx,ragnaros,1813,shaman,restoration,231,129,102
40025,Ixxmre,blackrock,1813,shaman,restoration,189,104,85
40026,Meöw,nemesis,1813,shaman,restoration,232,120,112
40027,Bunyie,ragnaros,1812,shaman,restoration,90,48,42
40028,Carpetmaster,ragnaros,1812,shaman,restoration,51,27,24
40029,Нойзблок,gordunni,1811,shaman,restoration,36,19,17
40030,Ghostlights,doomhammer,1811,shaman,restoration,68,31,37
40031,Reidzls,kazzak,1810,shaman,restoration,36,22,14
40032,Awcchampion,stormscale,1810,shaman,restoration,287,160,127
40033,Tidepog,ravencrest,1810,shaman,restoration,60,28,32
40034,Rexatar,blackrock,1809,shaman,restoration,201,113,88
40035,Triplewhoppa,thrall,1809,shaman,restoration,76,40,36
40036,Remony,pozzo-delleternità,1808,shaman,restoration,128,83,45
40037,Fuzzynuts,ravencrest,1808,shaman,restoration,132,74,58
40038,Yannkee,ravencrest,1808,shaman,restoration,48,24,24
40039,Tùiðhânâ,ravencrest,1807,shaman,restoration,197,107,90
40040,Xelgrin,silvermoon,1807,shaman,restoration,66,30,36
40041,Nokster,twisting-nether,1806,shaman,restoration,84,60,24
40042,Voodoonerd,twisting-nether,1803,shaman,restoration,47,24,23
40043,Neou,archimonde,1803,shaman,restoration,54,27,27
40044,Viinny,dun-modr,1803,shaman,restoration,102,48,54
40045,Luckymê,blackrock,1802,shaman,restoration,51,27,24
40046,Bytheway,aegwynn,1802,shaman,restoration,127,56,71
40047,Мимигор,razuvious,1801,shaman,restoration,35,27,8
40048,Eras,ragnaros,1801,shaman,restoration,30,19,11
40049,Kiansham,silvermoon,1801,shaman,restoration,47,26,21
40050,Rckfeller,burning-legion,1801,shaman,restoration,60,31,29
40051,Squixi,tarren-mill,1799,shaman,restoration,60,33,27
40052,Hexewar,kazzak,1789,shaman,restoration,89,47,42
40053,Harmony,outland,1785,shaman,restoration,42,30,12
40054,Sprühkot,aegwynn,1781,shaman,restoration,46,28,18
40055,Kreamcake,bladefist,1780,shaman,restoration,156,72,84
40056,Holytidezx,aegwynn,1775,shaman,restoration,40,26,14
40057,Moistpuss,kazzak,1773,shaman,restoration,78,49,29
40058,Orcshaman,khadgar,1771,shaman,restoration,48,24,24
40059,Palfe,khaz-modan,1769,shaman,restoration,142,72,70
40060,Szellento,darksorrow,1769,shaman,restoration,96,47,49
40061,Nübs,aegwynn,1769,shaman,restoration,101,47,54
40062,Ize,sylvanas,1768,shaman,restoration,94,61,33
40063,Чинанрук,howling-fjord,1767,shaman,restoration,119,61,58
40064,Дыркавауре,soulflayer,1764,shaman,restoration,54,23,31
40065,Daubidaubi,kazzak,1763,shaman,restoration,140,87,53
40066,Bezixx,ravencrest,1763,shaman,restoration,198,111,87
40067,Bstr,frostmane,1763,shaman,restoration,60,30,30
40068,Ihealbro,blackrock,1762,shaman,restoration,66,41,25
40069,Crymemore,stormscale,1760,shaman,restoration,47,24,23
40070,Windfúhrèr,tarren-mill,1759,shaman,restoration,60,26,34
40071,Eurocad,draenor,1758,shaman,restoration,42,22,20
40072,Learningsham,destromath,1749,shaman,restoration,48,29,19
40073,Machmacan,argent-dawn,1749,shaman,restoration,110,60,50
40074,Variablelol,outland,1746,shaman,restoration,64,43,21
40075,Kraksham,ravencrest,1745,shaman,restoration,112,60,52
40076,Nestre,kazzak,1745,shaman,restoration,42,21,21
40077,Karakoram,ysondre,1741,shaman,restoration,155,82,73
40078,Midgetfizzle,kazzak,1741,shaman,restoration,314,153,161
40079,Phaynozx,cthun,1741,shaman,restoration,96,39,57
40080,Donv,blackmoore,1739,shaman,restoration,42,26,16
40081,Helloiamdoni,ravencrest,1739,shaman,restoration,125,71,54
40082,Rottulos,stormrage,1739,shaman,restoration,65,35,30
40083,Squixi,ravencrest,1738,shaman,restoration,59,33,26
40084,Waramors,eredar,1738,shaman,restoration,131,65,66
40085,Purgeluxe,aegwynn,1733,shaman,restoration,125,65,60
40086,Jíkkz,aegwynn,1729,shaman,restoration,66,32,34
40087,Stylia,twisting-nether,1727,shaman,restoration,42,25,17
40088,Darnast,draenor,1727,shaman,restoration,70,31,39
40089,Агентхолинки,gordunni,1726,shaman,restoration,24,18,6
40090,Tentacruel,sylvanas,1726,shaman,restoration,91,56,35
40091,Bullezno,kazzak,1725,shaman,restoration,111,66,45
40092,Arslos,twisting-nether,1723,shaman,restoration,30,24,6
40093,Sheargodx,blackmoore,1723,shaman,restoration,42,21,21
40094,Agnøt,khaz-modan,1722,shaman,restoration,120,70,50
40095,Snusy,stormscale,1722,shaman,restoration,36,18,18
40096,Wess,archimonde,1722,shaman,restoration,36,18,18
40097,Morkyy,thrall,1721,shaman,restoration,38,19,19
40098,Torxii,antonidas,1720,shaman,restoration,177,100,77
40099,Слишкомплох,howling-fjord,1715,shaman,restoration,48,24,24
40100,Светшам,howling-fjord,1715,shaman,restoration,47,23,24
40101,Mltx,twilights-hammer,1714,shaman,restoration,44,19,25
40102,Shamolili,stormscale,1713,shaman,restoration,108,52,56
40103,Dmgaddict,kazzak,1712,shaman,restoration,54,32,22
40104,Есперадох,blackscar,1712,shaman,restoration,41,19,22
40105,Lahey,draenor,1711,shaman,restoration,140,73,67
40106,Тафельшпиц,soulflayer,1710,shaman,restoration,58,27,31
40107,Totembaws,blackmoore,1708,shaman,restoration,54,26,28
40108,Holytidez,aegwynn,1707,shaman,restoration,48,24,24
40109,Lsdhero,stormscale,1706,shaman,restoration,24,18,6
40110,Nizzarrathur,argent-dawn,1706,shaman,restoration,30,18,12
40111,Mamacitá,eredar,1706,shaman,restoration,500,242,258
40112,Hydrolîc,blackrock,1705,shaman,restoration,66,36,30
40113,Earthhulk,thrall,1704,shaman,restoration,104,64,40
40114,Thyroideus,argent-dawn,1704,shaman,restoration,228,130,98
40115,Connecting,hyjal,1704,shaman,restoration,39,21,18
40116,Vajaele,twisting-nether,1703,shaman,restoration,113,56,57
40117,Incase,burning-legion,1701,shaman,restoration,53,30,23
40118,Ларкуш,howling-fjord,1701,shaman,restoration,118,61,57
40119,Мвнз,soulflayer,1700,shaman,restoration,54,22,32
40120,Garuga,dun-morogh,1699,shaman,restoration,36,18,18
40121,Hexur,archimonde,1698,shaman,restoration,29,19,10
40122,Bâbbub,tarren-mill,1697,shaman,restoration,45,27,18
40123,Wawawoowee,archimonde,1696,shaman,restoration,54,27,27
40124,Djtidex,conseil-des-ombres,1696,shaman,restoration,48,24,24
40125,Bloodvaron,zuljin,1696,shaman,restoration,95,46,49
40126,Ганинапална,soulflayer,1696,shaman,restoration,60,24,36
40127,Nêmônin,perenolde,1694,shaman,restoration,44,28,16
40128,Turboeddy,blackmoore,1694,shaman,restoration,105,60,45
40129,Igly,antonidas,1694,shaman,restoration,42,21,21
40130,Dóómhammer,jaedenar,1693,shaman,restoration,142,74,68
40131,Сорит,blackscar,1692,shaman,restoration,57,34,23
40132,Wacomtablet,kazzak,1690,shaman,restoration,24,18,6
40133,Redomsh,stormreaver,1689,shaman,restoration,54,28,26
40134,Скарфэйсх,soulflayer,1688,shaman,restoration,36,18,18
40135,Googleme,veklor,1688,shaman,restoration,64,30,34
40136,Goeller,stormscale,1687,shaman,restoration,54,29,25
40137,Nellytko,aegwynn,1686,shaman,restoration,81,44,37
40138,Виелетта,gordunni,1684,shaman,restoration,30,18,12
40139,Itselectric,ravencrest,1683,shaman,restoration,136,77,59
40140,Lexos,ravencrest,1682,shaman,restoration,54,32,22
40141,Reäz,archimonde,1680,shaman,restoration,48,22,26
40142,Simiann,outland,1678,shaman,restoration,30,22,8
40143,Shoqt,les-sentinelles,1678,shaman,restoration,30,18,12
40144,Lexxthree,blackrock,1677,shaman,restoration,36,23,13
40145,Teldatwo,archimonde,1676,shaman,restoration,29,19,10
40146,Fapmasterz,eredar,1675,shaman,restoration,60,29,31
40147,Mbembe,blackhand,1674,shaman,restoration,48,26,22
40148,Keisser,ravencrest,1674,shaman,restoration,48,26,22
40149,Yakee,doomhammer,1674,shaman,restoration,56,28,28
40150,Apexe,outland,1673,shaman,restoration,52,18,34
40151,Wyrt,burning-legion,1672,shaman,restoration,48,24,24
40152,Skrewu,stormscale,1671,shaman,restoration,79,39,40
40153,Snickersx,blackrock,1670,shaman,restoration,78,46,32
40154,Кикподхвост,soulflayer,1670,shaman,restoration,54,26,28
40155,Wotan,ysondre,1669,shaman,restoration,54,32,22
40156,Pakxø,malganis,1669,shaman,restoration,108,54,54
40157,Loltotem,outland,1666,shaman,restoration,42,26,16
40158,Sanamaxx,colinas-pardas,1666,shaman,restoration,62,36,26
40159,Littletrall,outland,1666,shaman,restoration,60,34,26
40160,Mishoshamana,tarren-mill,1664,shaman,restoration,30,20,10
40161,Rapedtide,thrall,1664,shaman,restoration,136,63,73
40162,Atwâ,ravencrest,1663,shaman,restoration,51,31,20
40163,Brandiløve,nemesis,1663,shaman,restoration,36,19,17
40164,Лехадабстеп,deathguard,1662,shaman,restoration,42,23,19
40165,Gønuts,sylvanas,1660,shaman,restoration,48,26,22
40166,Bombasthicc,ravencrest,1660,shaman,restoration,48,24,24
40167,Questionable,antonidas,1660,shaman,restoration,54,24,30
40168,Phoenííx,twisting-nether,1657,shaman,restoration,353,171,182
40169,Мвнзх,gordunni,1656,shaman,restoration,54,24,30
40170,Faridstreng,blackmoore,1655,shaman,restoration,99,54,45
40171,Рамаксбосс,gordunni,1651,shaman,restoration,36,22,14
40172,Levarázsol,outland,1648,shaman,restoration,48,27,21
40173,Porkzzila,aggra-português,1647,shaman,restoration,66,36,30
40174,Prizærn,tarren-mill,1647,shaman,restoration,96,44,52
40175,Héxdóctór,ravencrest,1644,shaman,restoration,92,50,42
40176,Shamandoino,wildhammer,1644,shaman,restoration,198,91,107
40177,Reitar,burning-blade,1643,shaman,restoration,108,48,60
40178,Allysidewtf,archimonde,1642,shaman,restoration,34,23,11
40179,Trbhlk,blackrock,1642,shaman,restoration,42,21,21
40180,Bonshaman,ahnqiraj,1642,shaman,restoration,120,55,65
40181,Coöld,archimonde,1640,shaman,restoration,36,19,17
40182,Kyogre,auchindoun,1640,shaman,restoration,72,36,36
40183,Lavjar,stormscale,1640,shaman,restoration,58,26,32
40184,Maestralink,aegwynn,1638,shaman,restoration,47,24,23
40185,Jps,gorgonnash,1638,shaman,restoration,89,42,47
40186,Jenkem,hyjal,1638,shaman,restoration,54,25,29
40187,Octon,dun-modr,1637,shaman,restoration,46,23,23
40188,Indeed,frostmourne,1635,shaman,restoration,48,28,20
40189,Rxs,thunderhorn,1635,shaman,restoration,54,28,26
40190,Aioñ,kazzak,1635,shaman,restoration,51,22,29
40191,Velkin,thrall,1634,shaman,restoration,153,83,70
40192,Kharvo,draenor,1633,shaman,restoration,70,34,36
40193,Reinu,ragnaros,1632,shaman,restoration,42,21,21
40194,Сладкийстас,soulflayer,1632,shaman,restoration,54,21,33
40195,Nexian,kazzak,1631,shaman,restoration,71,41,30
40196,Oldandslow,sylvanas,1631,shaman,restoration,42,21,21
40197,Invadé,stormscale,1630,shaman,restoration,30,17,13
40198,Batmanmain,twisting-nether,1629,shaman,restoration,34,21,13
40199,Elmie,outland,1629,shaman,restoration,30,17,13
40200,Pøwertoto,dalaran,1629,shaman,restoration,78,36,42
40201,Draáx,ravencrest,1628,shaman,restoration,30,19,11
40202,Elmezz,aggra-português,1628,shaman,restoration,30,17,13
40203,Averya,blackmoore,1628,shaman,restoration,52,27,25
40204,Yomuchacha,dun-modr,1628,shaman,restoration,112,57,55
40205,Søtêx,ravencrest,1627,shaman,restoration,35,23,12
40206,Zorcs,silvermoon,1627,shaman,restoration,183,93,90
40207,Xclusiveqt,archimonde,1626,shaman,restoration,30,17,13
40208,Putzè,blackrock,1625,shaman,restoration,61,38,23
40209,Shamimüll,twisting-nether,1624,shaman,restoration,42,29,13
40210,Urshak,alleria,1624,shaman,restoration,30,20,10
40211,Xhanon,kazzak,1624,shaman,restoration,36,20,16
40212,Fersok,zuljin,1624,shaman,restoration,36,17,19
40213,Labûche,chogall,1623,shaman,restoration,36,24,12
40214,Hexbeforesex,kazzak,1623,shaman,restoration,269,143,126
40215,Shocklet,twisting-nether,1622,shaman,restoration,36,29,7
40216,Shman,blackrock,1621,shaman,restoration,64,42,22
40217,Atomstrom,frostwolf,1621,shaman,restoration,62,34,28
40218,Ðenlos,destromath,1620,shaman,restoration,186,92,94
40219,Hexmeqt,frostwolf,1619,shaman,restoration,113,63,50
40220,Tether,twisting-nether,1619,shaman,restoration,48,26,22
40221,Тубалкайн,soulflayer,1619,shaman,restoration,36,17,19
40222,Tupato,kazzak,1618,shaman,restoration,110,57,53
40223,Shamansh,draenor,1617,shaman,restoration,70,44,26
40224,Пекубулких,soulflayer,1615,shaman,restoration,42,25,17
40225,Maelynda,argent-dawn,1614,shaman,restoration,42,18,24
40226,Urzza,stormscale,1611,shaman,restoration,24,20,4
40227,Shoxý,draenor,1611,shaman,restoration,42,21,21
40228,Djosershamy,draenor,1611,shaman,restoration,111,53,58
40229,Koruga,frostwolf,1610,shaman,restoration,48,26,22
40230,Makkalisse,kazzak,1609,shaman,restoration,24,17,7
40231,Awumbahway,outland,1609,shaman,restoration,36,18,18
40232,Blowlips,argent-dawn,1609,shaman,restoration,42,17,25
40233,Jenyo,alakir,1608,shaman,restoration,54,30,24
40234,Niesel,ravencrest,1608,shaman,restoration,72,38,34
40235,Инкуль,howling-fjord,1608,shaman,restoration,60,28,32
40236,Kardris,nemesis,1607,shaman,restoration,52,25,27
40237,Prîce,blackmoore,1606,shaman,restoration,30,20,10
40238,Ezilol,blackhand,1606,shaman,restoration,77,46,31
40239,Wåvex,archimonde,1606,shaman,restoration,140,69,71
40240,Bullfox,aszune,1606,shaman,restoration,90,42,48
40241,Greenswag,drakthul,1605,shaman,restoration,48,31,17
40242,Hypéra,kazzak,1605,shaman,restoration,216,112,104
40243,Skanda,frostwolf,1604,shaman,restoration,24,17,7
40244,Хужик,gordunni,1604,shaman,restoration,36,21,15
40245,Blowxd,aegwynn,1604,shaman,restoration,134,75,59
40246,Xtremeshaman,blackmoore,1604,shaman,restoration,42,22,20
40247,Schamaster,antonidas,1604,shaman,restoration,120,59,61
40248,Tôrcal,hyjal,1604,shaman,restoration,42,18,24
40249,Turbobaboon,hyjal,1602,shaman,restoration,121,74,47
40250,Lebis,outland,1602,shaman,restoration,60,35,25
40251,Wíwi,kazzak,1602,shaman,restoration,36,20,16
40252,Khroni,tarren-mill,1602,shaman,restoration,66,35,31
40253,Upisi,burning-legion,1601,shaman,restoration,126,63,63
40254,Whiskiy,kazzak,1598,shaman,restoration,26,18,8
40255,Martuscielöl,drakthul,1598,shaman,restoration,88,32,56
40256,Jawj,tarren-mill,1597,shaman,restoration,53,19,34
40257,Startdie,kazzak,1595,shaman,restoration,143,64,79
40258,Incredibade,stormscale,1594,shaman,restoration,42,20,22
40259,Laskopivo,doomhammer,1593,shaman,restoration,60,37,23
40260,Murmaiderz,draenor,1593,shaman,restoration,144,81,63
40261,Mydpsrbad,stormscale,1592,shaman,restoration,160,89,71
40262,Splashgodx,frostwolf,1590,shaman,restoration,41,22,19
40263,Bîlunder,arygos,1590,shaman,restoration,83,37,46
40264,Thorenal,blackmoore,1588,shaman,restoration,67,41,26
40265,Discoranger,ravencrest,1588,shaman,restoration,306,154,152
40266,Bezixx,argent-dawn,1587,shaman,restoration,126,58,68
40267,Superthomas,archimonde,1587,shaman,restoration,65,29,36
40268,Nêôô,blackrock,1587,shaman,restoration,47,19,28
40269,Firenanajkm,dun-modr,1586,shaman,restoration,48,28,20
40270,Paidactor,kazzak,1586,shaman,restoration,239,126,113
40271,Arshak,stormscale,1586,shaman,restoration,45,21,24
40272,Zetricek,drakthul,1585,shaman,restoration,42,20,22
40273,Soffsittaren,kazzak,1584,shaman,restoration,34,17,17
40274,Vioception,blackrock,1584,shaman,restoration,48,19,29
40275,Mìcrøs,thrall,1581,shaman,restoration,59,33,26
40276,Évileye,silvermoon,1580,shaman,restoration,42,20,22
40277,Lustmasterx,grim-batol,1579,shaman,restoration,227,122,105
40278,Zinjk,nemesis,1579,shaman,restoration,332,170,162
40279,Juyina,ravencrest,1579,shaman,restoration,44,22,22
40280,Yzeldan,hyjal,1578,shaman,restoration,248,142,106
40281,Sérx,sanguino,1578,shaman,restoration,95,41,54
40282,Dmgccbot,outland,1576,shaman,restoration,42,17,25
40283,Melàniewalsh,archimonde,1575,shaman,restoration,96,52,44
40284,Mjukiz,tarren-mill,1572,shaman,restoration,333,184,149
40285,Sixtyone,stormscale,1569,shaman,restoration,75,42,33
40286,Totoswich,tarren-mill,1567,shaman,restoration,30,19,11
40287,Сёмабро,ashenvale,1567,shaman,restoration,468,253,215
40288,Hjod,outland,1567,shaman,restoration,108,56,52
40289,Bahane,frostwolf,1567,shaman,restoration,108,53,55
40290,Шсаваннх,blackscar,1566,shaman,restoration,165,83,82
40291,Shockair,frostwolf,1566,shaman,restoration,115,54,61
40292,Zwergmann,blackrock,1565,shaman,restoration,60,37,23
40293,Thald,ragnaros,1565,shaman,restoration,120,68,52
40294,Tommin,silvermoon,1565,shaman,restoration,36,18,18
40295,Madytz,eredar,1564,shaman,restoration,36,21,15
40296,Jarona,twisting-nether,1564,shaman,restoration,93,45,48
40297,Kuis,sanguino,1563,shaman,restoration,72,33,39
40298,Pacho,alakir,1563,shaman,restoration,48,21,27
40299,Foxy,alakir,1561,shaman,restoration,78,39,39
40300,Koraél,dun-modr,1561,shaman,restoration,84,33,51
40301,Tarchoanvahg,ragnaros,1560,shaman,restoration,53,28,25
40302,Radrizzle,tichondrius,1559,shaman,restoration,66,36,30
40303,Exolnard,twisting-nether,1558,shaman,restoration,119,59,60
40304,Xintenggege,silvermoon,1557,shaman,restoration,40,24,16
40305,Cobbel,argent-dawn,1557,shaman,restoration,168,92,76
40306,Lechii,stormscale,1557,shaman,restoration,107,55,52
40307,Lazerboy,twisting-nether,1557,shaman,restoration,47,22,25
40308,Lzzo,ravencrest,1555,shaman,restoration,42,24,18
40309,Nqz,ysondre,1553,shaman,restoration,43,26,17
40310,Zimoneris,blackmoore,1551,shaman,restoration,36,17,19
40311,Sêrø,eredar,1550,shaman,restoration,48,23,25
40312,Cuzzer,drakthul,1548,shaman,restoration,109,59,50
40313,Beastmodex,eredar,1548,shaman,restoration,263,134,129
40314,Seasick,frostmane,1548,shaman,restoration,112,56,56
40315,Noneedshaman,stormscale,1547,shaman,restoration,35,18,17
40316,Ninetzj,tarren-mill,1547,shaman,restoration,54,26,28
40317,Zanezu,stormscale,1547,shaman,restoration,102,45,57
40318,Apocadwarf,auchindoun,1546,shaman,restoration,45,27,18
40319,Lilcake,ravencrest,1546,shaman,restoration,60,31,29
40320,Reilah,drakthul,1546,shaman,restoration,66,33,33
40321,Märthalouise,twisting-nether,1546,shaman,restoration,43,18,25
40322,Defibrillata,blackrock,1545,shaman,restoration,77,38,39
40323,Craisaz,nemesis,1545,shaman,restoration,72,26,46
40324,Korvsnärten,outland,1544,shaman,restoration,237,109,128
40325,Zilheal,ysondre,1542,shaman,restoration,106,41,65
40326,Кичисанчик,howling-fjord,1541,shaman,restoration,126,57,69
40327,Nonotsikaan,blackhand,1540,shaman,restoration,42,24,18
40328,Vallhur,burning-legion,1539,shaman,restoration,84,46,38
40329,Denastyo,nemesis,1539,shaman,restoration,89,44,45
40330,Mypakypa,outland,1539,shaman,restoration,58,25,33
40331,Optitem,hyjal,1538,shaman,restoration,83,57,26
40332,Charquanda,argent-dawn,1538,shaman,restoration,60,26,34
40333,Отчима,howling-fjord,1537,shaman,restoration,125,67,58
40334,Grumhild,blackmoore,1537,shaman,restoration,62,28,34
40335,Banilikum,tarren-mill,1537,shaman,restoration,58,25,33
40336,Багсбанних,soulflayer,1537,shaman,restoration,84,35,49
40337,Louiesham,outland,1535,shaman,restoration,30,17,13
40338,Horokeu,blackrock,1535,shaman,restoration,77,40,37
40339,Coldlean,haomarush,1535,shaman,restoration,200,98,102
40340,Cakedeux,grim-batol,1534,shaman,restoration,69,40,29
40341,Uzze,drakthul,1534,shaman,restoration,90,39,51
40342,Xerinas,eredar,1534,shaman,restoration,63,20,43
40343,Soger,mannoroth,1533,shaman,restoration,36,18,18
40344,Shamins,outland,1532,shaman,restoration,148,86,62
40345,Ugard,burning-legion,1532,shaman,restoration,73,36,37
40346,Reezex,silvermoon,1531,shaman,restoration,86,45,41
40347,Jochenzulauf,blackrock,1530,shaman,restoration,42,27,15
40348,Collînna,aegwynn,1529,shaman,restoration,62,34,28
40349,Kacamaz,twisting-nether,1529,shaman,restoration,75,34,41
40350,Linknvm,thrall,1528,shaman,restoration,105,71,34
40351,Pädagogeig,antonidas,1528,shaman,restoration,66,36,30
40352,Redoms,stormreaver,1527,shaman,restoration,105,55,50
40353,Bumblebeec,tarren-mill,1526,shaman,restoration,60,32,28
40354,Nassîî,antonidas,1526,shaman,restoration,140,59,81
40355,Psychototem,twisting-nether,1526,shaman,restoration,84,27,57
40356,Bordellgast,thrall,1525,shaman,restoration,95,50,45
40357,Bzglsnkh,ravencrest,1525,shaman,restoration,36,16,20
40358,Bénathon,ravencrest,1524,shaman,restoration,51,35,16
40359,Yarali,argent-dawn,1524,shaman,restoration,30,16,14
40360,Kuxoriu,stormscale,1524,shaman,restoration,84,44,40
40361,Gjernhard,stormreaver,1524,shaman,restoration,78,38,40
40362,Bumbersham,stormscale,1523,shaman,restoration,66,34,32
40363,Remkoo,blackrock,1522,shaman,restoration,30,20,10
40364,Ilovejamie,sylvanas,1522,shaman,restoration,54,30,24
40365,Monstacookie,stormreaver,1520,shaman,restoration,72,32,40
40366,Sixinchwilly,outland,1519,shaman,restoration,36,25,11
40367,Lilililil,sanguino,1519,shaman,restoration,36,19,17
40368,Schain,eredar,1518,shaman,restoration,36,24,12
40369,Kuhnedy,blackrock,1517,shaman,restoration,118,60,58
40370,Bomjspomoiki,outland,1516,shaman,restoration,35,16,19
40371,Thecallviper,blackmoore,1515,shaman,restoration,55,30,25
40372,Costakislolz,twisting-nether,1511,shaman,restoration,24,18,6
40373,Bloodseeker,tarren-mill,1511,shaman,restoration,53,29,24
40374,Тагхорн,soulflayer,1511,shaman,restoration,43,23,20
40375,Pacio,alakir,1511,shaman,restoration,111,58,53
40376,Ebøbøla,terokkar,1511,shaman,restoration,187,84,103
40377,Mvvp,stormscale,1510,shaman,restoration,47,26,21
40378,Gronash,sunstrider,1507,shaman,restoration,30,23,7
40379,Nogag,kazzak,1507,shaman,restoration,72,35,37
40380,Huux,blackmoore,1507,shaman,restoration,54,24,30
40381,Enzopotenzo,blackrock,1506,shaman,restoration,42,22,20
40382,Vaizii,silvermoon,1505,shaman,restoration,53,26,27
40383,Miesepeter,mannoroth,1504,shaman,restoration,63,38,25
40384,Jazzrod,stormscale,1503,shaman,restoration,234,120,114
40385,Духсалата,grom,1503,shaman,restoration,59,29,30
40386,Yemo,alonsus,1502,shaman,restoration,93,56,37
40387,Biggiebig,ravencrest,1502,shaman,restoration,60,32,28
40388,Vemvardetsom,stormreaver,1501,shaman,restoration,59,32,27
40389,Нитрочка,soulflayer,1501,shaman,restoration,51,27,24
40390,Skullår,tarren-mill,1500,shaman,restoration,48,25,23
40391,Cannotdoit,burning-legion,1499,shaman,restoration,59,32,27
40392,Vaweñ,ravencrest,1499,shaman,restoration,42,17,25
40393,Anöuchkâ,ysondre,1498,shaman,restoration,174,84,90
40394,Eksi,ahnqiraj,1496,shaman,restoration,30,16,14
40395,Fridafrog,malganis,1495,shaman,restoration,131,71,60
40396,Mcktavish,silvermoon,1495,shaman,restoration,89,46,43
40397,Crmx,blackrock,1494,shaman,restoration,72,31,41
40398,Хэйзл,ashenvale,1492,shaman,restoration,74,32,42
40399,Cuchullaín,blackmoore,1491,shaman,restoration,24,17,7
40400,Иоч,soulflayer,1491,shaman,restoration,35,18,17
40401,Daykên,kazzak,1490,shaman,restoration,62,25,37
40402,Чанголист,soulflayer,1489,shaman,restoration,65,28,37
40403,Crasherz,sanguino,1488,shaman,restoration,91,51,40
40404,Kalaris,stormscale,1488,shaman,restoration,36,20,16
40405,Hopper,sylvanas,1488,shaman,restoration,61,30,31
40406,Neovim,trollbane,1488,shaman,restoration,62,28,34
40407,Tartorno,antonidas,1485,shaman,restoration,71,26,45
40408,Pilinham,aggra-português,1485,shaman,restoration,48,17,31
40409,Exhale,archimonde,1484,shaman,restoration,42,25,17
40410,Hexoffender,alakir,1483,shaman,restoration,112,54,58
40411,Flowèn,twisting-nether,1482,shaman,restoration,111,60,51
40412,Dremlok,burning-legion,1480,shaman,restoration,24,16,8
40413,Firestormx,drakthul,1480,shaman,restoration,47,28,19
40414,Drumx,aegwynn,1478,shaman,restoration,30,17,13
40415,Kaminarí,antonidas,1478,shaman,restoration,42,18,24
40416,Kataclysm,nemesis,1477,shaman,restoration,71,35,36
40417,Meneswave,blackhand,1475,shaman,restoration,48,16,32
40418,Gützli,blackmoore,1474,shaman,restoration,93,35,58
40419,Criæ,blackrock,1472,shaman,restoration,24,17,7
40420,Orcshaman,the-maelstrom,1472,shaman,restoration,68,39,29
40421,Cleptocracy,draenor,1472,shaman,restoration,35,18,17
40422,Schamazon,tarren-mill,1471,shaman,restoration,57,32,25
40423,Diix,archimonde,1471,shaman,restoration,84,35,49
40424,Tow,der-rat-von-dalaran,1470,shaman,restoration,24,17,7
40425,Shuzman,emeriss,1470,shaman,restoration,103,49,54
40426,Enïgma,sylvanas,1469,shaman,restoration,94,54,40
40427,Kêêqo,blackrock,1468,shaman,restoration,48,23,25
40428,Ivøryz,arthas,1467,shaman,restoration,42,24,18
40429,Eisei,stormscale,1467,shaman,restoration,42,23,19
40430,Greenfatding,kazzak,1467,shaman,restoration,36,19,17
40431,Andról,stormscale,1467,shaman,restoration,54,25,29
40432,Smørbar,kazzak,1465,shaman,restoration,72,49,23
40433,Crymere,chamber-of-aspects,1464,shaman,restoration,209,112,97
40434,Ünknownz,archimonde,1464,shaman,restoration,71,37,34
40435,Antey,ravencrest,1463,shaman,restoration,156,83,73
40436,Sebubu,twisting-nether,1463,shaman,restoration,68,34,34
40437,Apaorkaxyz,ragnaros,1462,shaman,restoration,231,111,120
40438,Courtney,sylvanas,1462,shaman,restoration,240,114,126
40439,Theshammy,vashj,1459,shaman,restoration,60,32,28
40440,Yasharshammy,tarren-mill,1459,shaman,restoration,60,28,32
40441,Diosberi,tichondrius,1458,shaman,restoration,24,18,6
40442,Skrimisher,draenor,1456,shaman,restoration,65,37,28
40443,Nøný,gorgonnash,1456,shaman,restoration,60,31,29
40444,Schamfxx,blackrock,1456,shaman,restoration,96,49,47
40445,Шарюпокд,soulflayer,1455,shaman,restoration,48,24,24
40446,Xánin,thrall,1455,shaman,restoration,42,21,21
40447,Zlingx,auchindoun,1454,shaman,restoration,48,22,26
40448,Ларисашерсть,blackscar,1452,shaman,restoration,47,26,21
40449,Ronell,argent-dawn,1451,shaman,restoration,120,63,57
40450,Артёмлобов,gordunni,1450,shaman,restoration,77,37,40
40451,Waterboi,blackmoore,1449,shaman,restoration,56,22,34
40452,Mcbloob,kazzak,1448,shaman,restoration,68,33,35
40453,Gspót,twisting-nether,1447,shaman,restoration,98,47,51
40454,Djxyoloswag,silvermoon,1445,shaman,restoration,99,44,55
40455,Tjpimp,draenor,1444,shaman,restoration,29,17,12
40456,Fluuges,tarren-mill,1444,shaman,restoration,30,16,14
40457,Sucøre,die-nachtwache,1444,shaman,restoration,52,27,25
40458,Jimtrespies,dun-modr,1443,shaman,restoration,42,21,21
40459,Bonraptor,kirin-tor,1443,shaman,restoration,41,20,21
40460,Nonnative,stormscale,1442,shaman,restoration,53,21,32
40461,Тирануксис,blackscar,1441,shaman,restoration,35,22,13
40462,Schweízer,blackrock,1441,shaman,restoration,102,45,57
40463,Бомжмувис,howling-fjord,1440,shaman,restoration,24,15,9
40464,Helloitsmee,thrall,1439,shaman,restoration,40,20,20
40465,Nyzo,tarren-mill,1438,shaman,restoration,30,15,15
40466,Боунсе,howling-fjord,1438,shaman,restoration,36,15,21
40467,Shamhingo,stormscale,1438,shaman,restoration,48,19,29
40468,Vioceptîon,blackrock,1437,shaman,restoration,30,22,8
40469,Kunsum,twisting-nether,1437,shaman,restoration,87,37,50
40470,Roineé,draenor,1436,shaman,restoration,30,15,15
40471,Electrífied,outland,1436,shaman,restoration,54,26,28
40472,Амальтейх,soulflayer,1436,shaman,restoration,54,23,31
40473,Okdar,stormscale,1435,shaman,restoration,54,34,20
40474,Shamnox,blackrock,1435,shaman,restoration,57,34,23
40475,Emochka,ravencrest,1435,shaman,restoration,130,60,70
40476,Strïvïse,ysondre,1434,shaman,restoration,47,22,25
40477,Мокос,howling-fjord,1434,shaman,restoration,42,16,26
40478,Kataretic,kazzak,1433,shaman,restoration,24,17,7
40479,Cleansing,nemesis,1433,shaman,restoration,30,21,9
40480,Enharvest,stormscale,1433,shaman,restoration,28,18,10
40481,Htagagain,archimonde,1433,shaman,restoration,24,15,9
40482,Zaiyoxgodx,thrall,1433,shaman,restoration,49,26,23
40483,Odiuum,draenor,1432,shaman,restoration,87,46,41
40484,Mestgonee,draenor,1432,shaman,restoration,36,19,17
40485,Sadfemecraft,aggramar,1432,shaman,restoration,165,74,91
40486,Hexalicius,sylvanas,1432,shaman,restoration,36,15,21
40487,Threnesham,kazzak,1432,shaman,restoration,42,15,27
40488,Gards,sylvanas,1431,shaman,restoration,61,29,32
40489,Kaptt,twisting-nether,1431,shaman,restoration,36,15,21
40490,Kickmeheal,dalaran,1430,shaman,restoration,30,18,12
40491,Wylly,aegwynn,1430,shaman,restoration,131,73,58
40492,Umbraverfaa,twisting-nether,1430,shaman,restoration,54,30,24
40493,Назульчике,razuvious,1430,shaman,restoration,59,30,29
40494,Дагод,booty-bay,1427,shaman,restoration,48,32,16
40495,Шоплифтер,gordunni,1427,shaman,restoration,48,27,21
40496,Pcr,archimonde,1427,shaman,restoration,105,50,55
40497,Stòrmbreakèr,nemesis,1427,shaman,restoration,91,42,49
40498,Mightgethexd,tarren-mill,1426,shaman,restoration,39,21,18
40499,Vickeshaman,stormreaver,1426,shaman,restoration,55,23,32
40500,Малекулакота,soulflayer,1425,shaman,restoration,53,25,28
40501,Amaizin,stormscale,1424,shaman,restoration,32,19,13
40502,Ptiloup,varimathras,1423,shaman,restoration,48,22,26
40503,Кислаябуба,howling-fjord,1420,shaman,restoration,172,81,91
40504,Ripstorm,sylvanas,1420,shaman,restoration,37,16,21
40505,Lyricks,outland,1418,shaman,restoration,36,15,21
40506,Венжии,soulflayer,1418,shaman,restoration,54,18,36
40507,Winøxiide,archimonde,1415,shaman,restoration,29,16,13
40508,Goldhand,ravencrest,1415,shaman,restoration,69,24,45
40509,Onkens,ravencrest,1414,shaman,restoration,57,29,28
40510,Diya,karazhan,1414,shaman,restoration,84,39,45
40511,Straehne,malganis,1414,shaman,restoration,94,43,51
40512,Imshocky,burning-legion,1413,shaman,restoration,83,47,36
40513,Виспепешам,gordunni,1413,shaman,restoration,194,94,100
40514,Deadstill,ysondre,1412,shaman,restoration,24,15,9
40515,Dergat,pozzo-delleternità,1412,shaman,restoration,44,21,23
40516,Wôdân,blackrock,1412,shaman,restoration,54,21,33
40517,Начилибосе,gordunni,1411,shaman,restoration,144,78,66
40518,Dewasham,blackrock,1411,shaman,restoration,48,22,26
40519,Fuzzywaagh,silvermoon,1411,shaman,restoration,58,26,32
40520,Smukkere,twisting-nether,1410,shaman,restoration,24,15,9
40521,Patuljak,outland,1409,shaman,restoration,91,48,43
40522,Zhulnaar,hyjal,1409,shaman,restoration,42,21,21
40523,Rawillman,kazzak,1408,shaman,restoration,24,16,8
40524,Goodieesham,burning-blade,1408,shaman,restoration,30,18,12
40525,Mouraïne,eredar,1403,shaman,restoration,29,20,9
40526,Дердан,soulflayer,1402,shaman,restoration,30,17,13
40527,Gaelic,frostmourne,1402,shaman,restoration,84,43,41
40528,Tèysh,ysondre,1402,shaman,restoration,126,64,62
40529,Mclóvín,twisting-nether,1401,shaman,restoration,42,21,21
40530,Тандерфак,ashenvale,1401,shaman,restoration,38,18,20
40531,Grende,sylvanas,1401,shaman,restoration,41,15,26
40532,Shambulancex,tarren-mill,1400,shaman,restoration,30,15,15
40533,Trustlemac,onyxia,1399,shaman,restoration,50,30,20
40534,Beyp,sylvanas,1399,shaman,restoration,67,38,29
40535,Greatørc,tarren-mill,1399,shaman,restoration,35,17,18
40536,Linkedink,tarren-mill,1395,shaman,restoration,26,17,9
40537,Shemanrolf,outland,1395,shaman,restoration,99,46,53
40538,Pocahøntas,archimonde,1395,shaman,restoration,56,22,34
40539,Swahilishock,the-maelstrom,1394,shaman,restoration,36,15,21
40540,Yois,nemesis,1393,shaman,restoration,66,37,29
40541,Гвинневра,azuregos,1392,shaman,restoration,125,74,51
40542,Sjamanisme,silvermoon,1390,shaman,restoration,114,60,54
40543,Qjie,argent-dawn,1389,shaman,restoration,206,117,89
40544,Captaínduck,garrosh,1388,shaman,restoration,88,49,39
40545,Elombrion,destromath,1387,shaman,restoration,42,21,21
40546,Ярусскийй,howling-fjord,1387,shaman,restoration,247,118,129
40547,Karlurban,outland,1387,shaman,restoration,39,15,24
40548,Geneazytwo,silvermoon,1384,shaman,restoration,32,19,13
40549,Фридомх,gordunni,1383,shaman,restoration,35,17,18
40550,Gnackbretzn,eredar,1383,shaman,restoration,95,46,49
40551,Vengatrox,antonidas,1381,shaman,restoration,59,30,29
40552,Джонпсинаа,gordunni,1379,shaman,restoration,36,18,18
40553,Saamira,pozzo-delleternità,1377,shaman,restoration,66,32,34
40554,Ironkraw,stormscale,1377,shaman,restoration,90,33,57
40555,Tonifo,nemesis,1376,shaman,restoration,23,18,5
40556,Brigantino,burning-legion,1376,shaman,restoration,49,26,23
40557,Axemodels,archimonde,1376,shaman,restoration,32,16,16
40558,Roverlos,blackrock,1375,shaman,restoration,129,70,59
40559,Warianis,ravencrest,1374,shaman,restoration,51,27,24
40560,Damex,thunderhorn,1374,shaman,restoration,143,56,87
40561,Alishie,outland,1373,shaman,restoration,117,64,53
40562,Elamentaly,draenor,1371,shaman,restoration,54,29,25
40563,Phêbz,archimonde,1371,shaman,restoration,48,25,23
40564,Johnblånn,stormscale,1369,shaman,restoration,63,35,28
40565,Xoxoheal,eredar,1368,shaman,restoration,36,15,21
40566,Lupisregina,silvermoon,1365,shaman,restoration,41,19,22
40567,Hulcky,grim-batol,1363,shaman,restoration,48,27,21
40568,Acidtrip,hyjal,1363,shaman,restoration,48,24,24
40569,Glopper,ravencrest,1363,shaman,restoration,89,40,49
40570,Vorkanyx,ysondre,1362,shaman,restoration,106,51,55
40571,Shimmyja,draenor,1362,shaman,restoration,36,17,19
40572,Orcinterface,tarren-mill,1360,shaman,restoration,92,46,46
40573,Akrobata,silvermoon,1360,shaman,restoration,180,83,97
40574,Gunhyld,hyjal,1359,shaman,restoration,47,20,27
40575,Kneggebrot,blackmoore,1359,shaman,restoration,78,33,45
40576,Bíìerlip,twisting-nether,1357,shaman,restoration,35,20,15
40577,Shinds,archimonde,1356,shaman,restoration,48,21,27
40578,Subaki,die-aldor,1355,shaman,restoration,34,20,14
40579,Ruvxy,twisting-nether,1354,shaman,restoration,65,38,27
40580,Slowtem,draenor,1354,shaman,restoration,101,52,49
40581,Vanquïsh,archimonde,1353,shaman,restoration,48,21,27
40582,Ketzersend,alleria,1351,shaman,restoration,30,18,12
40583,Krovogor,silvermoon,1351,shaman,restoration,60,34,26
40584,Nosql,draenor,1351,shaman,restoration,28,15,13
40585,Daboó,vashj,1350,shaman,restoration,115,63,52
40586,Эрутеон,deathguard,1349,shaman,restoration,108,49,59
40587,Panicsc,twisting-nether,1348,shaman,restoration,219,109,110
40588,Stylix,tarren-mill,1347,shaman,restoration,93,44,49
40589,Zevissh,outland,1346,shaman,restoration,54,28,26
40590,Шиока,borean-tundra,1345,shaman,restoration,47,26,21
40591,Purgerkìng,tarren-mill,1344,shaman,restoration,18,14,4
40592,Mjahex,stormscale,1344,shaman,restoration,54,26,28
40593,Сновидений,soulflayer,1344,shaman,restoration,49,23,26
40594,Invade,darkspear,1343,shaman,restoration,18,14,4
40595,Zenzua,twisting-nether,1343,shaman,restoration,35,24,11
40596,Intoxed,sylvanas,1343,shaman,restoration,48,27,21
40597,Фоэксген,deathguard,1342,shaman,restoration,20,15,5
40598,Shrekcho,twisting-nether,1342,shaman,restoration,36,25,11
40599,Henchtotem,draenor,1342,shaman,restoration,56,31,25
40600,Dàazle,ravencrest,1342,shaman,restoration,36,14,22
40601,Schïps,kirin-tor,1339,shaman,restoration,54,31,23
40602,Maburst,silvermoon,1339,shaman,restoration,30,17,13
40603,Teckan,tarren-mill,1339,shaman,restoration,30,14,16
40604,Amrgl,earthen-ring,1339,shaman,restoration,36,15,21
40605,Sørum,grim-batol,1339,shaman,restoration,36,14,22
40606,Fußpilzmann,blackmoore,1338,shaman,restoration,139,76,63
40607,Thunderson,daggerspine,1338,shaman,restoration,104,45,59
40608,Brokgar,ragnaros,1337,shaman,restoration,24,14,10
40609,Abx,draenor,1337,shaman,restoration,42,21,21
40610,Shapperdin,darksorrow,1336,shaman,restoration,24,14,10
40611,Chamika,dentarg,1336,shaman,restoration,60,24,36
40612,Freizeitler,antonidas,1335,shaman,restoration,78,37,41
40613,Shamanash,kazzak,1335,shaman,restoration,30,14,16
40614,Flikus,aggra-português,1335,shaman,restoration,42,16,26
40615,Bresidendo,frostwhisper,1334,shaman,restoration,95,39,56
40616,Ongewasgone,defias-brotherhood,1333,shaman,restoration,30,16,14
40617,Bloodburst,stormscale,1332,shaman,restoration,48,29,19
40618,Lariralol,malorne,1332,shaman,restoration,67,37,30
40619,Ксмо,gordunni,1331,shaman,restoration,24,14,10
40620,Хотдевил,gordunni,1331,shaman,restoration,59,32,27
40621,Beardling,auchindoun,1329,shaman,restoration,24,15,9
40622,Powerhq,thrall,1329,shaman,restoration,24,14,10
40623,Alàstor,kazzak,1329,shaman,restoration,55,24,31
40624,Iamnyka,blackrock,1328,shaman,restoration,66,40,26
40625,Drohx,ysondre,1327,shaman,restoration,24,14,10
40626,Братишкапинг,soulflayer,1327,shaman,restoration,110,56,54
40627,Vodoochild,hyjal,1327,shaman,restoration,55,23,32
40628,Jarvís,gilneas,1327,shaman,restoration,50,19,31
40629,Vuls,blackmoore,1323,shaman,restoration,123,66,57
40630,Schaname,rajaxx,1323,shaman,restoration,30,14,16
40631,Sdkpwns,draenor,1322,shaman,restoration,36,16,20
40632,Georgieboi,sylvanas,1321,shaman,restoration,24,14,10
40633,Bedouín,draenor,1321,shaman,restoration,91,51,40
40634,Lerosh,twisting-nether,1321,shaman,restoration,54,30,24
40635,Littledorf,ravencrest,1321,shaman,restoration,96,51,45
40636,Mjöllnir,blackrock,1321,shaman,restoration,108,56,52
40637,Breadtotem,tarren-mill,1321,shaman,restoration,30,14,16
40638,Vaaggu,stormreaver,1321,shaman,restoration,36,14,22
40639,Yegera,stormscale,1320,shaman,restoration,30,14,16
40640,Роджермур,howling-fjord,1319,shaman,restoration,30,14,16
40641,Götveren,eredar,1319,shaman,restoration,36,15,21
40642,Swedishmeat,kazzak,1317,shaman,restoration,156,80,76
40643,Corintho,blackmoore,1316,shaman,restoration,46,25,21
40644,Threshðld,dun-modr,1316,shaman,restoration,30,14,16
40645,Boneyka,ragnaros,1316,shaman,restoration,110,44,66
40646,Lickmytôtem,frostmane,1314,shaman,restoration,30,14,16
40647,Виртуосгодх,soulflayer,1313,shaman,restoration,54,25,29
40648,Жижелье,howling-fjord,1312,shaman,restoration,128,68,60
40649,Kbakasham,ravencrest,1312,shaman,restoration,50,24,26
40650,Var,varimathras,1312,shaman,restoration,30,14,16
40651,Keräx,cthun,1311,shaman,restoration,24,14,10
40652,Awwey,stormscale,1310,shaman,restoration,18,14,4
40653,Navezi,twisting-nether,1310,shaman,restoration,72,41,31
40654,Шаманутый,gordunni,1308,shaman,restoration,73,40,33
40655,Düsterlotus,dalvengyr,1308,shaman,restoration,196,106,90
40656,Крэгнор,gordunni,1308,shaman,restoration,135,70,65
40657,Shamingu,arathor,1308,shaman,restoration,152,77,75
40658,Aceofraphy,thrall,1308,shaman,restoration,125,53,72
40659,Eniesz,archimonde,1307,shaman,restoration,26,15,11
40660,Thaarley,blackmoore,1305,shaman,restoration,34,22,12
40661,Shafallen,tarren-mill,1305,shaman,restoration,40,24,16
40662,Durek,aerie-peak,1304,shaman,restoration,24,14,10
40663,Canhealu,nemesis,1303,shaman,restoration,169,85,84
40664,Mandoloriana,sylvanas,1303,shaman,restoration,96,47,49
40665,Санрэйн,soulflayer,1302,shaman,restoration,54,32,22
40666,Samantouz,archimonde,1302,shaman,restoration,132,62,70
40667,Monstermunch,ravencrest,1301,shaman,restoration,110,50,60
40668,Ironmack,outland,1301,shaman,restoration,36,16,20
40669,Quiec,kazzak,1300,shaman,restoration,60,21,39
40670,Marrakei,aegwynn,1300,shaman,restoration,44,15,29
40671,Panicblast,stormscale,1299,shaman,restoration,44,27,17
40672,Nybz,sylvanas,1299,shaman,restoration,108,54,54
40673,Шаеман,soulflayer,1298,shaman,restoration,36,20,16
40674,Ærthgød,stormscale,1297,shaman,restoration,24,17,7
40675,Kìra,darkmoon-faire,1296,shaman,restoration,51,28,23
40676,Bluefacebaby,nemesis,1296,shaman,restoration,155,74,81
40677,Harptwo,eredar,1295,shaman,restoration,47,28,19
40678,Rhakhatheckh,nemesis,1295,shaman,restoration,58,26,32
40679,Fernashaman,aggra-português,1295,shaman,restoration,42,18,24
40680,Heyzal,aegwynn,1295,shaman,restoration,38,14,24
40681,Fünkchn,zuluhed,1293,shaman,restoration,46,24,22
40682,Shamanmode,twisting-nether,1292,shaman,restoration,42,17,25
40683,Eduorde,silvermoon,1290,shaman,restoration,37,22,15
40684,Kryuxs,blackrock,1290,shaman,restoration,48,24,24
40685,Onlytides,doomhammer,1290,shaman,restoration,36,14,22
40686,Stivishamy,blackmoore,1289,shaman,restoration,34,21,13
40687,Lilshamano,ravencrest,1289,shaman,restoration,222,124,98
40688,Zujaz,stormscale,1289,shaman,restoration,30,14,16
40689,Xamic,twisting-nether,1287,shaman,restoration,47,21,26
40690,Mêkyra,blackmoore,1286,shaman,restoration,58,27,31
40691,Obêlixx,blackmoore,1284,shaman,restoration,42,20,22
40692,Deadwoodz,tarren-mill,1284,shaman,restoration,124,59,65
40693,Chadshaman,antonidas,1284,shaman,restoration,55,24,31
40694,Chilliajin,tarren-mill,1284,shaman,restoration,59,25,34
40695,Cudntreskobe,kazzak,1283,shaman,restoration,40,20,20
40696,Nwäar,archimonde,1283,shaman,restoration,144,71,73
40697,Gigawashed,archimonde,1279,shaman,restoration,23,14,9
40698,Rokatotem,ysondre,1279,shaman,restoration,27,14,13
40699,Morty,tarren-mill,1279,shaman,restoration,59,27,32
40700,Akwa,stormscale,1278,shaman,restoration,32,14,18
40701,Îolar,aegwynn,1277,shaman,restoration,72,28,44
40702,Asaakira,blackmoore,1276,shaman,restoration,51,32,19
40703,Deaslow,hyjal,1276,shaman,restoration,40,25,15
40704,Shago,archimonde,1276,shaman,restoration,124,54,70
40705,Tenny,haomarush,1276,shaman,restoration,54,20,34
40706,Foximus,blackhand,1275,shaman,restoration,42,20,22
40707,Alisàn,teldrassil,1272,shaman,restoration,163,77,86
40708,Shôk,ravencrest,1271,shaman,restoration,74,37,37
40709,Kivra,burning-legion,1271,shaman,restoration,107,46,61
40710,Шайнинлайт,soulflayer,1271,shaman,restoration,107,42,65
40711,Ishkadar,twisting-nether,1270,shaman,restoration,33,15,18
40712,Stormcaster,argent-dawn,1267,shaman,restoration,70,34,36
40713,Asumix,illidan,1263,shaman,restoration,89,44,45
40714,Yuliy,arathor,1263,shaman,restoration,108,50,58
40715,Størmbølt,draenor,1263,shaman,restoration,54,24,30
40716,Ríko,argent-dawn,1262,shaman,restoration,64,33,31
40717,Kelshaj,thrall,1262,shaman,restoration,33,15,18
40718,Dregú,draenor,1261,shaman,restoration,81,44,37
40719,Alakan,saurfang,1261,shaman,restoration,137,65,72
40720,Zoolza,kirin-tor,1261,shaman,restoration,41,14,27
40721,Azifox,hyjal,1260,shaman,restoration,25,14,11
40722,Кразтор,howling-fjord,1259,shaman,restoration,161,71,90
40723,Xerijan,pozzo-delleternità,1257,shaman,restoration,36,17,19
40724,Дрекрош,howling-fjord,1257,shaman,restoration,71,28,43
40725,Aldron,tirion,1256,shaman,restoration,42,21,21
40726,Flambusier,hyjal,1253,shaman,restoration,175,102,73
40727,Cømedian,ragnaros,1252,shaman,restoration,27,15,12
40728,Ogrilza,uldaman,1252,shaman,restoration,136,74,62
40729,Ðøminantx,stormscale,1249,shaman,restoration,55,28,27
40730,Viallinen,stormreaver,1249,shaman,restoration,37,15,22
40731,Navajito,tarren-mill,1248,shaman,restoration,18,13,5
40732,Jävlajävel,draenor,1248,shaman,restoration,76,45,31
40733,Chävaman,archimonde,1248,shaman,restoration,24,13,11
40734,Shamtrix,drakthul,1248,shaman,restoration,77,34,43
40735,Reparagos,sanguino,1246,shaman,restoration,25,14,11
40736,Puffeh,emeriss,1246,shaman,restoration,30,13,17
40737,Руикси,howling-fjord,1246,shaman,restoration,30,13,17
40738,Велоун,soulflayer,1246,shaman,restoration,32,13,19
40739,Bioleta,twisting-nether,1246,shaman,restoration,36,13,23
40740,Cynthila,stormreaver,1245,shaman,restoration,18,13,5
40741,Wernøzer,archimonde,1245,shaman,restoration,18,13,5
40742,Shamiinn,ravencrest,1245,shaman,restoration,24,13,11
40743,Smøul,sanguino,1245,shaman,restoration,30,13,17
40744,Shamdude,archimonde,1243,shaman,restoration,24,13,11
40745,Watashij,outland,1243,shaman,restoration,69,36,33
40746,Kvolt,ysondre,1243,shaman,restoration,30,13,17
40747,Nabo,archimonde,1243,shaman,restoration,40,16,24
40748,Dgshîtdwarf,ravencrest,1242,shaman,restoration,30,13,17
40749,Anlaki,silvermoon,1241,shaman,restoration,18,13,5
40750,Leunam,draenor,1241,shaman,restoration,52,26,26
40751,Djschamihaar,blackrock,1240,shaman,restoration,18,13,5
40752,Spitta,ysondre,1240,shaman,restoration,24,13,11
40753,Manitus,sylvanas,1240,shaman,restoration,64,33,31
40754,Elijaá,nordrassil,1239,shaman,restoration,77,42,35
40755,Skenflewds,alakir,1239,shaman,restoration,88,35,53
40756,Zakuun,kazzak,1239,shaman,restoration,36,13,23
40757,Bufuxx,kazzak,1238,shaman,restoration,18,13,5
40758,Sîggý,eredar,1237,shaman,restoration,24,13,11
40759,Woade,silvermoon,1236,shaman,restoration,60,28,32
40760,Kèlls,la-croisade-écarlate,1236,shaman,restoration,54,25,29
40761,Перегной,ashenvale,1236,shaman,restoration,99,43,56
40762,Abercrômbx,blackmoore,1235,shaman,restoration,24,13,11
40763,Эртирон,howling-fjord,1235,shaman,restoration,144,73,71
40764,Semrix,blackhand,1235,shaman,restoration,110,48,62
40765,Læh,archimonde,1235,shaman,restoration,48,14,34
40766,Shameari,sylvanas,1234,shaman,restoration,18,13,5
40767,Корольшомен,gordunni,1234,shaman,restoration,24,14,10
40768,Thog,drakthul,1234,shaman,restoration,30,13,17
40769,Energised,alonsus,1234,shaman,restoration,36,14,22
40770,Kaletore,ragnaros,1233,shaman,restoration,60,34,26
40771,Формацепт,ashenvale,1233,shaman,restoration,60,29,31
40772,Aébi,dalaran,1232,shaman,restoration,24,13,11
40773,Blackone,destromath,1232,shaman,restoration,24,13,11
40774,Althayr,blackmoore,1232,shaman,restoration,28,14,14
40775,Carnágé,blackrock,1230,shaman,restoration,42,24,18
40776,Anakkynu,sylvanas,1230,shaman,restoration,31,14,17
40777,Doriana,dalaran,1229,shaman,restoration,66,26,40
40778,Sugardad,khaz-modan,1228,shaman,restoration,189,90,99
40779,Shyrel,burning-legion,1228,shaman,restoration,136,61,75
40780,Makaria,emerald-dream,1227,shaman,restoration,212,101,111
40781,Alexmiamosch,thrall,1226,shaman,restoration,78,48,30
40782,Clearwaters,tarren-mill,1225,shaman,restoration,40,14,26
40783,Kavyzyoyo,twisting-nether,1222,shaman,restoration,71,31,40
40784,Fulminare,ravencrest,1221,shaman,restoration,78,39,39
40785,Energized,twilights-hammer,1221,shaman,restoration,30,15,15
40786,Murmelï,stormreaver,1220,shaman,restoration,99,46,53
40787,Schnessert,silvermoon,1220,shaman,restoration,30,13,17
40788,Ошибся,deathguard,1219,shaman,restoration,36,19,17
40789,Shioni,ravencrest,1219,shaman,restoration,104,44,60
40790,Bigrambo,draenor,1218,shaman,restoration,65,37,28
40791,Юляукраинка,gordunni,1216,shaman,restoration,55,24,31
40792,Sickbrain,silvermoon,1216,shaman,restoration,45,19,26
40793,Showman,archimonde,1215,shaman,restoration,287,138,149
40794,Sizzurp,mugthol,1214,shaman,restoration,24,13,11
40795,Merkàba,pozzo-delleternità,1214,shaman,restoration,37,19,18
40796,Suze,hellfire,1214,shaman,restoration,60,25,35
40797,Wieszcz,kazzak,1212,shaman,restoration,51,21,30
40798,Thuknala,tarren-mill,1210,shaman,restoration,46,26,20
40799,Goodmañ,eonar,1210,shaman,restoration,110,48,62
40800,Sorcerus,burning-legion,1210,shaman,restoration,72,27,45
40801,Kickvando,blackmoore,1209,shaman,restoration,44,22,22
40802,Shèshe,uldaman,1208,shaman,restoration,36,20,16
40803,Tilixs,draenor,1207,shaman,restoration,81,27,54
40804,Ephase,burning-blade,1207,shaman,restoration,55,16,39
40805,Loppish,silvermoon,1206,shaman,restoration,24,16,8
40806,Xetri,ragnaros,1206,shaman,restoration,41,22,19
40807,Morttes,burning-legion,1205,shaman,restoration,27,14,13
40808,Kuddjah,twisting-nether,1205,shaman,restoration,36,17,19
40809,Nakenfeigy,stormreaver,1204,shaman,restoration,29,16,13
40810,Бичпак,howling-fjord,1203,shaman,restoration,56,25,31
40811,Huldi,kazzak,1202,shaman,restoration,48,28,20
40812,Icozy,stormscale,1202,shaman,restoration,51,27,24
40813,Roxxo,frostwolf,1200,shaman,restoration,30,16,14
40814,Blöödfist,drakthul,1200,shaman,restoration,35,14,21
40815,Thundersioux,ravencrest,1198,shaman,restoration,63,33,30
40816,Teccatwo,outland,1198,shaman,restoration,100,48,52
40817,Snobas,kazzak,1198,shaman,restoration,29,13,16
40818,Chamon,grim-batol,1195,shaman,restoration,42,19,23
40819,Lolafløres,dun-modr,1194,shaman,restoration,53,37,16
40820,Gauss,agamaggan,1192,shaman,restoration,31,14,17
40821,Silko,wrathbringer,1189,shaman,restoration,63,24,39
40822,Buzzingsham,tarren-mill,1188,shaman,restoration,42,23,19
40823,Shockjob,kazzak,1188,shaman,restoration,32,14,18
40824,Hunorth,stormscale,1185,shaman,restoration,40,20,20
40825,Jimmybuffett,kazzak,1184,shaman,restoration,98,47,51
40826,Oldrym,blackrock,1183,shaman,restoration,64,25,39
40827,Târrocke,nethersturm,1181,shaman,restoration,54,24,30
40828,Bigschamlipp,blackhand,1180,shaman,restoration,23,13,10
40829,Biztor,jaedenar,1178,shaman,restoration,48,26,22
40830,Weraeth,drakthul,1178,shaman,restoration,72,38,34
40831,Thundrkrakn,blackhand,1177,shaman,restoration,77,39,38
40832,Egí,azshara,1177,shaman,restoration,38,14,24
40833,Mwnci,anachronos,1176,shaman,restoration,141,72,69
40834,Kvekkis,argent-dawn,1175,shaman,restoration,30,17,13
40835,Darnok,quelthalas,1173,shaman,restoration,60,29,31
40836,Praise,auchindoun,1172,shaman,restoration,35,14,21
40837,Kuiji,stormreaver,1168,shaman,restoration,94,55,39
40838,Tegellera,ravencrest,1168,shaman,restoration,53,27,26
40839,Ibkdalen,stormscale,1167,shaman,restoration,48,26,22
40840,Dwarfofwar,ravencrest,1165,shaman,restoration,80,43,37
40841,Быковат,booty-bay,1164,shaman,restoration,146,73,73
40842,Bèx,twisting-nether,1159,shaman,restoration,30,13,17
40843,Pituu,tarren-mill,1158,shaman,restoration,36,15,21
40844,Shinui,twisting-nether,1157,shaman,restoration,51,26,25
40845,Lechirurgien,elune,1157,shaman,restoration,121,59,62
40846,Knasta,malygos,1156,shaman,restoration,42,20,22
40847,Iltis,nazjatar,1156,shaman,restoration,36,14,22
40848,Дисмон,ashenvale,1155,shaman,restoration,48,24,24
40849,Mostachin,dun-modr,1155,shaman,restoration,64,28,36
40850,Undin,burning-legion,1154,shaman,restoration,90,50,40
40851,Alcam,twisting-nether,1154,shaman,restoration,77,33,44
40852,Saviothewise,aggra-português,1153,shaman,restoration,24,15,9
40853,Кодишам,howling-fjord,1152,shaman,restoration,18,12,6
40854,Rostislav,ravencrest,1152,shaman,restoration,18,12,6
40855,Olînours,archimonde,1152,shaman,restoration,36,20,16
40856,Kalhoznik,ravencrest,1152,shaman,restoration,24,12,12
40857,Терату,gordunni,1152,shaman,restoration,24,12,12
40858,Pepegahex,blackmoore,1152,shaman,restoration,24,12,12
40859,Snovii,drakthul,1152,shaman,restoration,30,12,18
40860,Totembeard,frostmourne,1151,shaman,restoration,18,12,6
40861,Snackerella,blackrock,1151,shaman,restoration,18,12,6
40862,Dêblâzê,thrall,1151,shaman,restoration,24,12,12
40863,Scriptx,blackmoore,1151,shaman,restoration,24,12,12
40864,Ridemytotem,blackrock,1151,shaman,restoration,24,12,12
40865,Ønepåc,hyjal,1151,shaman,restoration,24,12,12
40866,Teldarian,archimonde,1151,shaman,restoration,24,12,12
40867,Numbs,tarren-mill,1151,shaman,restoration,30,12,18
40868,Souqixo,drakthul,1150,shaman,restoration,18,12,6
40869,Zelent,thrall,1150,shaman,restoration,18,12,6
40870,Sparkygrill,eredar,1150,shaman,restoration,24,12,12
40871,Holyshamixz,dun-modr,1150,shaman,restoration,24,12,12
40872,Lolalovexo,kazzak,1150,shaman,restoration,30,14,16
40873,Poggsham,twisting-nether,1150,shaman,restoration,63,29,34
40874,Killatotem,kazzak,1150,shaman,restoration,30,12,18
40875,Balthasa,blackhand,1149,shaman,restoration,18,12,6
40876,Rëazx,archimonde,1149,shaman,restoration,24,12,12
40877,Mefl,tarren-mill,1148,shaman,restoration,24,12,12
40878,Kaherad,antonidas,1148,shaman,restoration,72,33,39
40879,Enzymex,sanguino,1148,shaman,restoration,36,12,24
40880,Aviearn,ragnaros,1147,shaman,restoration,24,15,9
40881,Kärríegold,blackrock,1146,shaman,restoration,18,12,6
40882,Wibra,nagrand,1146,shaman,restoration,30,12,18
40883,Kemh,nemesis,1146,shaman,restoration,30,12,18
40884,Tvättpåse,tarren-mill,1144,shaman,restoration,18,12,6
40885,Кайрн,gordunni,1144,shaman,restoration,30,12,18
40886,Drman,shattered-hand,1143,shaman,restoration,60,33,27
40887,Gehrké,silvermoon,1142,shaman,restoration,18,12,6
40888,Trixsham,ragnaros,1140,shaman,restoration,25,13,12
40889,Rêêza,blackhand,1140,shaman,restoration,54,28,26
40890,Nafay,lordaeron,1140,shaman,restoration,78,39,39
40891,Shadî,kiljaeden,1139,shaman,restoration,30,14,16
40892,Guayotta,sanguino,1139,shaman,restoration,30,12,18
40893,Macchiavelli,blades-edge,1137,shaman,restoration,131,57,74
40894,Nephylim,grim-batol,1136,shaman,restoration,24,12,12
40895,Laïnàà,archimonde,1136,shaman,restoration,65,27,38
40896,Mosterx,stormscale,1135,shaman,restoration,75,41,34
40897,Nftkal,emerald-dream,1134,shaman,restoration,24,13,11
40898,Croku,thrall,1134,shaman,restoration,66,34,32
40899,Spaceboy,archimonde,1133,shaman,restoration,30,12,18
40900,Максибончик,soulflayer,1133,shaman,restoration,36,13,23
40901,Cloovster,magtheridon,1132,shaman,restoration,24,12,12
40902,Nextlvlplz,draenor,1132,shaman,restoration,79,38,41
40903,Omgodofwar,burning-blade,1132,shaman,restoration,90,33,57
40904,Suntpraf,kazzak,1131,shaman,restoration,35,14,21
40905,Arabesk,arygos,1130,shaman,restoration,108,50,58
40906,Áchilleus,kazzak,1129,shaman,restoration,42,13,29
40907,Sarenity,hellfire,1127,shaman,restoration,29,16,13
40908,Jéhil,hyjal,1127,shaman,restoration,24,12,12
40909,Holshammy,nemesis,1127,shaman,restoration,90,39,51
40910,Bruhin,ravencrest,1127,shaman,restoration,36,13,23
40911,Anyxxia,aegwynn,1126,shaman,restoration,30,12,18
40912,Bullit,zuljin,1125,shaman,restoration,36,13,23
40913,Jimkopf,eredar,1122,shaman,restoration,34,17,17
40914,Bendimina,chogall,1120,shaman,restoration,18,12,6
40915,Nesjâ,blackhand,1120,shaman,restoration,30,12,18
40916,Ulfom,silvermoon,1118,shaman,restoration,58,27,31
40917,Khanokekw,twisting-nether,1116,shaman,restoration,118,64,54
40918,Smyke,magtheridon,1116,shaman,restoration,96,51,45
40919,Raincaller,archimonde,1115,shaman,restoration,35,12,23
40920,Понбарон,gordunni,1113,shaman,restoration,46,19,27
40921,Lemontea,burning-blade,1107,shaman,restoration,60,24,36
40922,Säphïr,hyjal,1105,shaman,restoration,22,13,9
40923,Polystrath,silvermoon,1104,shaman,restoration,48,22,26
40924,Sáltý,ravencrest,1103,shaman,restoration,21,12,9
40925,Lanzatotems,dun-modr,1102,shaman,restoration,84,39,45
40926,Dubìff,hyjal,1101,shaman,restoration,15,13,2
40927,Ivaccineyou,blackmoore,1099,shaman,restoration,24,12,12
40928,Thenasil,stormscale,1097,shaman,restoration,64,28,36
40929,Èxé,stormscale,1095,shaman,restoration,20,13,7
40930,Sanktyx,blackhand,1094,shaman,restoration,28,13,15
40931,Yasunari,sanguino,1094,shaman,restoration,30,12,18
40932,Rusbeermen,silvermoon,1094,shaman,restoration,47,13,34
40933,Thuns,stormscale,1093,shaman,restoration,29,14,15
40934,Corbo,ysondre,1092,shaman,restoration,75,42,33
40935,Badkidney,alakir,1092,shaman,restoration,24,12,12
40936,Hayvack,hyjal,1091,shaman,restoration,50,24,26
40937,Waskoelement,archimonde,1090,shaman,restoration,48,27,21
40938,Hazufel,kaelthas,1090,shaman,restoration,50,23,27
40939,Moonbotico,blackrock,1090,shaman,restoration,115,52,63
40940,Cromosoma,dun-modr,1085,shaman,restoration,44,26,18
40941,Baelee,sylvanas,1085,shaman,restoration,108,47,61
40942,Purgérkíng,silvermoon,1084,shaman,restoration,27,13,14
40943,Spartecøbra,dalaran,1083,shaman,restoration,36,16,20
40944,Arienus,turalyon,1081,shaman,restoration,22,12,10
40945,Vulkan,kirin-tor,1081,shaman,restoration,42,20,22
40946,Bennycooch,silvermoon,1081,shaman,restoration,107,42,65
40947,Shamandeadly,aggra-português,1075,shaman,restoration,24,12,12
40948,Hephaisto,defias-brotherhood,1072,shaman,restoration,24,12,12
40949,Shamone,stormreaver,1070,shaman,restoration,35,16,19
40950,Totemkin,stormscale,1069,shaman,restoration,60,13,47
40951,Xoxoxoxoa,twisting-nether,1068,shaman,restoration,71,22,49
40952,Quîn,defias-brotherhood,1066,shaman,restoration,102,48,54
40953,Ominouslove,twisting-nether,1066,shaman,restoration,105,49,56
40954,Zuggerberg,defias-brotherhood,1063,shaman,restoration,33,12,21
40955,Garifus,dun-modr,1062,shaman,restoration,162,84,78
40956,Hikigane,marécage-de-zangar,1061,shaman,restoration,48,17,31
40957,Thunderjax,laughing-skull,1057,shaman,restoration,34,19,15
40958,Чоколав,howling-fjord,1057,shaman,restoration,60,32,28
40959,Слишкомпох,howling-fjord,1056,shaman,restoration,18,11,7
40960,Socialfailur,archimonde,1056,shaman,restoration,18,11,7
40961,Elmezz,outland,1056,shaman,restoration,18,11,7
40962,Wisplola,ravencrest,1056,shaman,restoration,24,11,13
40963,Rôwdy,kazzak,1056,shaman,restoration,24,11,13
40964,Magmera,argent-dawn,1056,shaman,restoration,138,58,80
40965,Alnaddaf,outland,1055,shaman,restoration,18,11,7
40966,Zuly,grim-batol,1055,shaman,restoration,18,11,7
40967,Yashëa,ysondre,1055,shaman,restoration,18,11,7
40968,Drmanathan,garona,1055,shaman,restoration,18,11,7
40969,Alëxx,hyjal,1055,shaman,restoration,18,11,7
40970,Lòómit,anetheron,1055,shaman,restoration,71,35,36
40971,Blipster,tarren-mill,1055,shaman,restoration,24,11,13
40972,Бунтх,howling-fjord,1055,shaman,restoration,24,11,13
40973,Icecold,grim-batol,1055,shaman,restoration,24,11,13
40974,Krolhok,hyjal,1055,shaman,restoration,24,11,13
40975,Átòmíc,eredar,1055,shaman,restoration,24,11,13
40976,Vælcya,archimonde,1054,shaman,restoration,18,11,7
40977,Quòr,antonidas,1054,shaman,restoration,59,34,25
40978,Shakgor,draenor,1054,shaman,restoration,48,27,21
40979,Ehrling,ysondre,1054,shaman,restoration,30,16,14
40980,Mêrowinger,blackhand,1054,shaman,restoration,24,11,13
40981,Blóúb,blackmoore,1054,shaman,restoration,24,11,13
40982,Ixthus,varimathras,1054,shaman,restoration,24,11,13
40983,Nyfario,marécage-de-zangar,1054,shaman,restoration,24,11,13
40984,Elshamino,ravencrest,1054,shaman,restoration,24,11,13
40985,Protv,ravencrest,1053,shaman,restoration,24,18,6
40986,Tiddles,arathor,1053,shaman,restoration,18,11,7
40987,Emika,archimonde,1053,shaman,restoration,24,11,13
40988,Тотембот,soulflayer,1053,shaman,restoration,24,11,13
40989,Sarkathi,kazzak,1053,shaman,restoration,24,11,13
40990,Begeshaman,sylvanas,1053,shaman,restoration,270,120,150
40991,Salatmayoo,alakir,1053,shaman,restoration,27,12,15
40992,Zerwurster,thrall,1053,shaman,restoration,30,13,17
40993,Hyflex,alakir,1053,shaman,restoration,30,11,19
40994,Manush,aszune,1052,shaman,restoration,36,16,20
40995,Muril,argent-dawn,1052,shaman,restoration,30,11,19
40996,Rouwa,korgall,1051,shaman,restoration,18,11,7
40997,Kelvok,silvermoon,1051,shaman,restoration,18,11,7
40998,Zackboing,thrall,1051,shaman,restoration,75,38,37
40999,Ðevi,ravencrest,1051,shaman,restoration,24,11,13
41000,Aliates,sanguino,1051,shaman,restoration,24,11,13
41001,Tingyspanky,twisting-nether,1051,shaman,restoration,33,12,21
41002,Kíkjo,aegwynn,1050,shaman,restoration,18,11,7
41003,Quizx,blackrock,1050,shaman,restoration,24,11,13
41004,Оперочек,howling-fjord,1050,shaman,restoration,42,12,30
41005,Fatotato,outland,1049,shaman,restoration,24,11,13
41006,Riverwin,silvermoon,1048,shaman,restoration,30,14,16
41007,Slingz,auchindoun,1048,shaman,restoration,24,11,13
41008,Zahké,stormscale,1048,shaman,restoration,24,11,13
41009,Bakuga,ragnaros,1047,shaman,restoration,18,11,7
41010,Oscar,khaz-modan,1046,shaman,restoration,18,11,7
41011,Tyralià,draenor,1046,shaman,restoration,18,11,7
41012,Chokeonme,blackrock,1046,shaman,restoration,63,37,26
41013,Анашишка,borean-tundra,1046,shaman,restoration,30,11,19
41014,Megumín,darksorrow,1045,shaman,restoration,18,11,7
41015,Towokk,kazzak,1045,shaman,restoration,54,31,23
41016,Adubsham,tarren-mill,1043,shaman,restoration,12,11,1
41017,Tosaá,antonidas,1042,shaman,restoration,18,11,7
41018,Grîzzou,les-clairvoyants,1042,shaman,restoration,42,25,17
41019,Munjar,korgall,1039,shaman,restoration,24,11,13
41020,Idkteam,stormscale,1037,shaman,restoration,24,11,13
41021,Slutie,stormscale,1036,shaman,restoration,23,11,12
41022,Gushgush,draenor,1032,shaman,restoration,18,11,7
41023,Moglibard,grim-batol,1028,shaman,restoration,18,11,7
41024,Silktotems,kazzak,1028,shaman,restoration,30,11,19
41025,Jeezy,blackhand,1027,shaman,restoration,30,11,19
41026,Лялори,gordunni,1025,shaman,restoration,60,28,32
41027,Jazzcore,twisting-nether,1023,shaman,restoration,17,11,6
41028,Pstpstpsst,azjolnerub,1022,shaman,restoration,29,11,18
41029,Daseus,malygos,1021,shaman,restoration,30,14,16
41030,Рёнтар,howling-fjord,1021,shaman,restoration,30,13,17
41031,Hexinreflect,silvermoon,1021,shaman,restoration,96,41,55
41032,Вашнюхтоптал,howling-fjord,1018,shaman,restoration,30,17,13
41033,Магмарончик,gordunni,1017,shaman,restoration,60,24,36
41034,Akimboo,kilrogg,1017,shaman,restoration,36,11,25
41035,Сорнинай,soulflayer,1013,shaman,restoration,65,28,37
41036,Mantoon,doomhammer,1013,shaman,restoration,30,12,18
41037,Jhaky,dun-modr,1013,shaman,restoration,30,11,19
41038,Paniio,stormscale,1013,shaman,restoration,36,11,25
41039,Cukkerberg,ragnaros,1010,shaman,restoration,48,19,29
41040,Blainehammer,arathor,1006,shaman,restoration,30,12,18
41041,Saamjai,turalyon,1005,shaman,restoration,30,17,13
41042,Mendiing,kazzak,1005,shaman,restoration,21,11,10
41043,Noulol,aegwynn,1005,shaman,restoration,23,12,11
41044,Bluelasso,ysondre,1002,shaman,restoration,35,11,24
41045,Darkkshammy,silvermoon,1001,shaman,restoration,24,12,12
41046,Broner,ravencrest,999,shaman,restoration,44,20,24
41047,Skunazo,sanguino,995,shaman,restoration,18,14,4
41048,Jänis,ragnaros,995,shaman,restoration,22,12,10
41049,Shinigamy,kazzak,995,shaman,restoration,68,35,33
41050,Мезонет,soulflayer,992,shaman,restoration,24,13,11
41051,Haginathor,twisting-nether,989,shaman,restoration,78,41,37
41052,Checkpoint,defias-brotherhood,988,shaman,restoration,42,18,24
41053,Kéimohansio,draenor,988,shaman,restoration,168,64,104
41054,Mearu,bronze-dragonflight,987,shaman,restoration,42,25,17
41055,Nozer,arathor,987,shaman,restoration,39,21,18
41056,Demelena,silvermoon,985,shaman,restoration,67,35,32
41057,Teada,aegwynn,980,shaman,restoration,34,12,22
41058,Bomboclat,azjolnerub,977,shaman,restoration,29,11,18
41059,Ambrosioss,kazzak,975,shaman,restoration,30,17,13
41060,Patites,twisting-nether,974,shaman,restoration,36,20,16
41061,Thaun,blackrock,971,shaman,restoration,30,12,18
41062,Schamannen,outland,970,shaman,restoration,43,23,20
41063,Xenda,blackrock,970,shaman,restoration,30,13,17
41064,Maflas,dun-modr,967,shaman,restoration,25,16,9
41065,Tomtefaan,sylvanas,963,shaman,restoration,24,13,11
41066,Snidge,kazzak,961,shaman,restoration,30,18,12
41067,Милжон,soulflayer,961,shaman,restoration,31,17,14
41068,Dasce,sylvanas,961,shaman,restoration,36,15,21
41069,Qobq,ravencrest,960,shaman,restoration,12,10,2
41070,Çare,drakthul,960,shaman,restoration,18,10,8
41071,Снупдоггидог,howling-fjord,960,shaman,restoration,24,10,14
41072,Còób,ravencrest,960,shaman,restoration,27,10,17
41073,Sunjay,frostwolf,959,shaman,restoration,12,10,2
41074,Aylookitsgam,magtheridon,959,shaman,restoration,12,10,2
41075,Hyperieon,antonidas,959,shaman,restoration,12,10,2
41076,Kaátori,eredar,959,shaman,restoration,12,10,2
41077,Fourtwogodx,kazzak,959,shaman,restoration,12,10,2
41078,Ðtxkeks,onyxia,959,shaman,restoration,13,10,3
41079,Bananis,outland,959,shaman,restoration,18,10,8
41080,Crysisx,sanguino,959,shaman,restoration,18,10,8
41081,Cahyr,ravencrest,959,shaman,restoration,18,10,8
41082,Ånny,blackmoore,959,shaman,restoration,18,10,8
41083,Qoleck,aegwynn,959,shaman,restoration,18,10,8
41084,Friski,silvermoon,959,shaman,restoration,18,10,8
41085,Kilazz,twisting-nether,959,shaman,restoration,18,10,8
41086,Frise,archimonde,959,shaman,restoration,24,12,12
41087,Shivanea,blackrock,959,shaman,restoration,24,10,14
41088,Loay,blackrock,959,shaman,restoration,24,10,14
41089,Amnéshaman,ysondre,959,shaman,restoration,24,10,14
41090,Ugáa,malganis,959,shaman,restoration,24,10,14
41091,Páracetamol,blackmoore,958,shaman,restoration,18,10,8
41092,Bosskwtt,kazzak,958,shaman,restoration,18,10,8
41093,Jilyu,blackmoore,958,shaman,restoration,18,10,8
41094,Prøxxy,ravencrest,958,shaman,restoration,18,10,8
41095,Shamanistick,grim-batol,958,shaman,restoration,18,10,8
41096,Bliksem,tarren-mill,958,shaman,restoration,18,10,8
41097,Чаиро,howling-fjord,958,shaman,restoration,24,10,14
41098,Neejtjak,ravencrest,958,shaman,restoration,24,10,14
41099,Nerdshammyx,tarren-mill,957,shaman,restoration,12,10,2
41100,Samant,neptulon,957,shaman,restoration,36,17,19
41101,Гарантийный,lich-king,957,shaman,restoration,24,10,14
41102,Drakahaar,burning-blade,956,shaman,restoration,30,10,20
41103,Durekk,tarren-mill,955,shaman,restoration,18,10,8
41104,Chaminoune,sargeras,955,shaman,restoration,18,10,8
41105,Nøxylol,veklor,955,shaman,restoration,24,10,14
41106,Zulwin,hyjal,954,shaman,restoration,18,10,8
41107,Rhun,garona,954,shaman,restoration,18,10,8
41108,Kasjer,ravencrest,953,shaman,restoration,24,10,14
41109,Tauridus,blackrock,951,shaman,restoration,24,10,14
41110,Shámpain,antonidas,950,shaman,restoration,18,10,8
41111,Hacyria,archimonde,949,shaman,restoration,36,20,16
41112,Mcdz,blackrock,948,shaman,restoration,24,13,11
41113,Эйвуа,gordunni,947,shaman,restoration,28,13,15
41114,Outerspace,silvermoon,947,shaman,restoration,24,10,14
41115,Дартарион,gordunni,947,shaman,restoration,38,14,24
41116,Avattar,twisting-nether,942,shaman,restoration,18,10,8
41117,Xilquid,darksorrow,941,shaman,restoration,24,10,14
41118,Эрэвия,gordunni,939,shaman,restoration,24,13,11
41119,Bullvai,dun-morogh,929,shaman,restoration,74,34,40
41120,Goldva,outland,928,shaman,restoration,79,42,37
41121,Fivezax,tarren-mill,924,shaman,restoration,18,10,8
41122,Zeidek,nemesis,922,shaman,restoration,60,33,27
41123,Valdraxx,ravencrest,922,shaman,restoration,195,95,100
41124,Killeras,deathwing,920,shaman,restoration,37,18,19
41125,Bluesteel,bladefist,919,shaman,restoration,41,10,31
41126,Asashi,blackhand,917,shaman,restoration,23,12,11
41127,Selrin,blackrock,915,shaman,restoration,84,30,54
41128,Xpone,blackrock,914,shaman,restoration,24,12,12
41129,Xogor,kazzak,911,shaman,restoration,27,10,17
41130,Jabena,draenor,910,shaman,restoration,106,48,58
41131,Kircos,blackrock,904,shaman,restoration,27,11,16
41132,Quigon,burning-legion,902,shaman,restoration,42,22,20
41133,Suculenta,zuljin,902,shaman,restoration,35,16,19
41134,Georgianaa,skullcrusher,900,shaman,restoration,84,40,44
41135,Nîckîî,aegwynn,899,shaman,restoration,17,10,7
41136,Nexolok,alleria,899,shaman,restoration,60,32,28
41137,Алимика,deathguard,899,shaman,restoration,24,12,12
41138,Thunderberg,antonidas,896,shaman,restoration,30,12,18
41139,Notlinus,argent-dawn,895,shaman,restoration,14,10,4
41140,Foxfyre,tarren-mill,893,shaman,restoration,18,10,8
41141,Ухмылк,azuregos,892,shaman,restoration,201,106,95
41142,Whatsup,aggramar,892,shaman,restoration,28,11,17
41143,Isìs,norgannon,891,shaman,restoration,100,39,61
41144,Kwitnac,silvermoon,889,shaman,restoration,20,10,10
41145,Seyfüce,archimonde,885,shaman,restoration,23,10,13
41146,Deesham,blackmoore,885,shaman,restoration,26,10,16
41147,Vukroth,argent-dawn,879,shaman,restoration,72,34,38
41148,Fashess,sunstrider,875,shaman,restoration,18,10,8
41149,Mysterqt,nemesis,864,shaman,restoration,12,9,3
41150,Shiliwhip,the-maelstrom,864,shaman,restoration,12,9,3
41151,Enviø,sylvanas,864,shaman,restoration,12,9,3
41152,Фатнир,soulflayer,864,shaman,restoration,18,9,9
41153,Defonceboby,archimonde,864,shaman,restoration,18,9,9
41154,Nothexy,stormscale,864,shaman,restoration,18,9,9
41155,Феанорситх,gordunni,864,shaman,restoration,18,9,9
41156,Dimront,gorgonnash,864,shaman,restoration,18,9,9
41157,Shounx,hyjal,864,shaman,restoration,18,9,9
41158,Beoka,dun-modr,864,shaman,restoration,21,10,11
41159,Bigdamshear,outland,864,shaman,restoration,24,9,15
41160,Jkoreanx,archimonde,864,shaman,restoration,24,9,15
41161,Thefirebird,blackhand,864,shaman,restoration,24,9,15
41162,Geminate,stormscale,863,shaman,restoration,12,9,3
41163,Gorrissen,sylvanas,863,shaman,restoration,12,9,3
41164,Blamy,auchindoun,863,shaman,restoration,12,9,3
41165,Есю,howling-fjord,863,shaman,restoration,12,9,3
41166,Shamantistik,ravencrest,863,shaman,restoration,12,9,3
41167,Dréa,draenor,863,shaman,restoration,18,9,9
41168,Alroq,blackrock,863,shaman,restoration,18,9,9
41169,Bobaléh,ravencrest,863,shaman,restoration,18,9,9
41170,Stormfreg,quelthalas,863,shaman,restoration,18,9,9
41171,Loktarogar,sunstrider,863,shaman,restoration,24,9,15
41172,Floki,emerald-dream,863,shaman,restoration,24,9,15
41173,Thanasiss,kazzak,863,shaman,restoration,24,9,15
41174,Fatmikex,stormreaver,863,shaman,restoration,30,9,21
41175,Naphe,ysondre,863,shaman,restoration,30,9,21
41176,Милыйдед,gordunni,863,shaman,restoration,36,9,27
41177,Rugludalli,dragonblight,862,shaman,restoration,12,9,3
41178,Бронепароход,soulflayer,862,shaman,restoration,12,9,3
41179,Spammail,argent-dawn,862,shaman,restoration,12,9,3
41180,Aredin,ysera,862,shaman,restoration,12,9,3
41181,Pprx,tarren-mill,862,shaman,restoration,24,9,15
41182,Salmôn,twisting-nether,862,shaman,restoration,24,9,15
41183,Дрфэка,soulflayer,862,shaman,restoration,51,14,37
41184,Cjay,dunemaul,861,shaman,restoration,12,9,3
41185,Yánux,aegwynn,861,shaman,restoration,12,9,3
41186,Эндипёсель,ashenvale,861,shaman,restoration,12,9,3
41187,Shamanopaf,tarren-mill,861,shaman,restoration,18,9,9
41188,Matsudah,ragnaros,861,shaman,restoration,18,9,9
41189,Lindemánn,blackhand,861,shaman,restoration,24,9,15
41190,Honollulu,drakthul,860,shaman,restoration,12,9,3
41191,Amu,ravencrest,860,shaman,restoration,18,9,9
41192,Mansquidgoat,darksorrow,859,shaman,restoration,15,10,5
41193,Kosur,kazzak,859,shaman,restoration,18,9,9
41194,Orchal,defias-brotherhood,859,shaman,restoration,18,9,9
41195,Stkk,ravencrest,859,shaman,restoration,98,46,52
41196,Sunsham,illidan,858,shaman,restoration,18,9,9
41197,Proxysham,the-maelstrom,857,shaman,restoration,12,9,3
41198,Shamanaman,stormscale,857,shaman,restoration,18,9,9
41199,Kamichami,sanguino,857,shaman,restoration,24,9,15
41200,Wayoa,defias-brotherhood,856,shaman,restoration,12,9,3
41201,Chartersham,silvermoon,856,shaman,restoration,12,9,3
41202,Wakka,wildhammer,856,shaman,restoration,42,12,30
41203,Gleggy,turalyon,854,shaman,restoration,12,9,3
41204,Zendrox,aegwynn,854,shaman,restoration,18,9,9
41205,Picklechris,tarren-mill,851,shaman,restoration,24,10,14
41206,Psyforce,argent-dawn,850,shaman,restoration,12,9,3
41207,Temeres,drakthul,849,shaman,restoration,18,9,9
41208,Qusek,turalyon,847,shaman,restoration,79,34,45
41209,Lillitthya,elune,845,shaman,restoration,33,13,20
41210,Gerlo,thrall,838,shaman,restoration,30,13,17
41211,Yàra,throkferoth,834,shaman,restoration,54,24,30
41212,Robgon,aggra-português,833,shaman,restoration,41,15,26
41213,Numdog,stormreaver,831,shaman,restoration,17,9,8
41214,Ayesapik,dalaran,831,shaman,restoration,46,21,25
41215,Jeqs,twisting-nether,830,shaman,restoration,14,10,4
41216,Soramat,aegwynn,830,shaman,restoration,23,9,14
41217,Stormzug,twisting-nether,826,shaman,restoration,20,10,10
41218,Lk,twilights-hammer,815,shaman,restoration,15,10,5
41219,Kuubskii,ravencrest,815,shaman,restoration,17,9,8
41220,Aspên,archimonde,815,shaman,restoration,17,9,8
41221,Bountiti,dun-modr,810,shaman,restoration,18,10,8
41222,Crixuss,argent-dawn,809,shaman,restoration,17,9,8
41223,Pvegame,tarren-mill,809,shaman,restoration,20,10,10
41224,Feizhousa,outland,799,shaman,restoration,26,9,17
41225,Smugleaf,frostmane,793,shaman,restoration,30,9,21
41226,Shàwyn,sylvanas,782,shaman,restoration,17,9,8
41227,Vërÿßåðxd,silvermoon,768,shaman,restoration,12,8,4
41228,Öyama,sinstralis,768,shaman,restoration,12,8,4
41229,Cgjúng,ravencrest,768,shaman,restoration,12,8,4
41230,Lontarita,tarren-mill,768,shaman,restoration,12,8,4
41231,Enchancement,ragnaros,768,shaman,restoration,12,8,4
41232,Vibesham,outland,768,shaman,restoration,12,8,4
41233,Wolkî,aegwynn,768,shaman,restoration,12,8,4
41234,Leykosh,ravencrest,768,shaman,restoration,12,8,4
41235,Ivnashaman,drakthul,768,shaman,restoration,12,8,4
41236,Mustabrutus,tarren-mill,768,shaman,restoration,16,9,7
41237,Lorko,twisting-nether,768,shaman,restoration,18,8,10
41238,Chimey,frostmane,768,shaman,restoration,18,8,10
41239,Tâvôry,aegwynn,768,shaman,restoration,18,8,10
41240,Papaver,zirkel-des-cenarius,768,shaman,restoration,18,8,10
41241,Sehn,arathor,768,shaman,restoration,18,8,10
41242,Qoekke,uldum,768,shaman,restoration,18,8,10
41243,Infinitetide,doomhammer,768,shaman,restoration,18,8,10
41244,Nøraa,ravencrest,768,shaman,restoration,18,8,10
41245,Iphosham,twisting-nether,768,shaman,restoration,18,8,10
41246,Зачикинимся,howling-fjord,768,shaman,restoration,18,8,10
41247,Djtomp,kazzak,768,shaman,restoration,18,8,10
41248,Dapawz,defias-brotherhood,767,shaman,restoration,12,8,4
41249,Хъюстэн,gordunni,767,shaman,restoration,12,8,4
41250,Кураж,howling-fjord,767,shaman,restoration,12,8,4
41251,Berasham,dalaran,767,shaman,restoration,12,8,4
41252,Magma,kazzak,767,shaman,restoration,12,8,4
41253,Айскримтрак,gordunni,767,shaman,restoration,12,8,4
41254,Karezza,azjolnerub,767,shaman,restoration,12,8,4
41255,Mentaldead,draenor,767,shaman,restoration,12,8,4
41256,Aeldrid,argent-dawn,767,shaman,restoration,12,8,4
41257,Setac,stormscale,767,shaman,restoration,15,9,6
41258,Quinlàn,ravencrest,767,shaman,restoration,18,8,10
41259,Aliatës,sanguino,767,shaman,restoration,18,8,10
41260,Zeewzblast,silvermoon,767,shaman,restoration,18,8,10
41261,Gungo,deathwing,767,shaman,restoration,18,8,10
41262,Iwaa,dalaran,767,shaman,restoration,18,8,10
41263,Hàrdstûkgødx,uldaman,767,shaman,restoration,18,8,10
41264,Lycburst,twisting-nether,767,shaman,restoration,24,8,16
41265,Zìik,draenor,767,shaman,restoration,24,8,16
41266,Sniipy,blackmoore,767,shaman,restoration,24,8,16
41267,Rakân,ysondre,767,shaman,restoration,24,8,16
41268,Pòcho,kazzak,767,shaman,restoration,29,8,21
41269,Eero,darksorrow,766,shaman,restoration,12,8,4
41270,Robbie,dentarg,766,shaman,restoration,12,8,4
41271,Джоукх,howling-fjord,766,shaman,restoration,12,8,4
41272,Schläck,outland,766,shaman,restoration,18,8,10
41273,Binslagala,zuljin,765,shaman,restoration,12,8,4
41274,Naargie,outland,765,shaman,restoration,20,8,12
41275,Ironspine,sylvanas,764,shaman,restoration,18,8,10
41276,Khattla,outland,763,shaman,restoration,12,8,4
41277,Eveeöe,outland,763,shaman,restoration,18,8,10
41278,Gundersen,stormscale,763,shaman,restoration,18,8,10
41279,Mcslammer,kazzak,763,shaman,restoration,24,8,16
41280,Arles,dun-modr,762,shaman,restoration,18,8,10
41281,Rórekk,aegwynn,761,shaman,restoration,18,8,10
41282,Greenguard,argent-dawn,759,shaman,restoration,59,17,42
41283,Syreer,silvermoon,758,shaman,restoration,26,11,15
41284,Mysapphie,kazzak,751,shaman,restoration,17,9,8
41285,Sakoon,twisting-nether,751,shaman,restoration,18,8,10
41286,Øzy,sanguino,749,shaman,restoration,14,8,6
41287,Amarök,nerzhul,749,shaman,restoration,18,8,10
41288,Дарьюша,fordragon,744,shaman,restoration,12,8,4
41289,Muntark,thrall,719,shaman,restoration,27,8,19
41290,Razeroø,ysondre,717,shaman,restoration,23,8,15
41291,Scàráth,eredar,717,shaman,restoration,27,8,19
41292,Агмень,howling-fjord,717,shaman,restoration,39,8,31
41293,Katzubushi,pozzo-delleternità,715,shaman,restoration,38,11,27
41294,Shäman,burning-blade,714,shaman,restoration,21,9,12
41295,Stolen,skullcrusher,712,shaman,restoration,15,9,6
41296,Флафен,howling-fjord,712,shaman,restoration,19,9,10
41297,Lauree,terokkar,710,shaman,restoration,23,9,14
41298,Thangog,ragnaros,703,shaman,restoration,16,8,8
41299,Карбонатрикс,soulflayer,703,shaman,restoration,16,8,8
41300,Тотемвуман,soulflayer,703,shaman,restoration,22,8,14
41301,Грейсаша,howling-fjord,695,shaman,restoration,22,8,14
41302,Turbohulk,blackrock,688,shaman,restoration,13,8,5
41303,Cumulichan,ragnaros,687,shaman,restoration,11,8,3
41304,Blackbeardxd,stormscale,672,shaman,restoration,12,7,5
41305,Clickmeh,runetotem,672,shaman,restoration,12,7,5
41306,Tjocknacke,tarren-mill,672,shaman,restoration,12,7,5
41307,Teldariane,archimonde,672,shaman,restoration,12,7,5
41308,Winshear,twisting-nether,672,shaman,restoration,12,7,5
41309,Dôppel,archimonde,672,shaman,restoration,12,7,5
41310,Qicholardon,archimonde,672,shaman,restoration,12,7,5
41311,Healeugene,ravencrest,672,shaman,restoration,12,7,5
41312,Berly,stormscale,672,shaman,restoration,12,7,5
41313,Iamshamon,kazzak,672,shaman,restoration,12,7,5
41314,Lêêmo,outland,672,shaman,restoration,12,7,5
41315,Fupx,the-maelstrom,672,shaman,restoration,12,7,5
41316,Pogchampz,nemesis,672,shaman,restoration,12,7,5
41317,Esher,frostwolf,672,shaman,restoration,12,7,5
41318,Nosno,ravencrest,672,shaman,restoration,12,7,5
41319,Nansmasher,draenor,672,shaman,restoration,12,7,5
41320,Popopopopor,archimonde,672,shaman,restoration,12,7,5
41321,Boltkesh,draenor,672,shaman,restoration,12,7,5
41322,Spiirit,tarren-mill,672,shaman,restoration,12,7,5
41323,Nezug,ysondre,672,shaman,restoration,12,7,5
41324,Raintlordx,twisting-nether,672,shaman,restoration,12,7,5
41325,Doubleshamz,the-maelstrom,672,shaman,restoration,12,7,5
41326,Shamounf,archimonde,672,shaman,restoration,12,7,5
41327,Horcsog,ravencrest,672,shaman,restoration,18,7,11
41328,Zulylol,outland,672,shaman,restoration,18,7,11
41329,Sháme,azjolnerub,672,shaman,restoration,18,7,11
41330,Reticlol,kazzak,672,shaman,restoration,18,7,11
41331,Horkxina,frostmourne,672,shaman,restoration,18,7,11
41332,Oningodx,drakthul,672,shaman,restoration,18,7,11
41333,Kimsshaman,ragnaros,672,shaman,restoration,18,7,11
41334,Agrok,jaedenar,672,shaman,restoration,18,7,11
41335,Raiden,aegwynn,672,shaman,restoration,18,7,11
41336,Barbebiendur,archimonde,672,shaman,restoration,18,7,11
41337,Papskalla,ravencrest,672,shaman,restoration,18,7,11
41338,Крэйвхх,howling-fjord,672,shaman,restoration,18,7,11
41339,Horiq,kazzak,672,shaman,restoration,18,7,11
41340,Arîya,blackrock,672,shaman,restoration,18,7,11
41341,Çøynx,aegwynn,672,shaman,restoration,20,7,13
41342,Recov,draenor,672,shaman,restoration,22,7,15
41343,Rejax,blackmoore,672,shaman,restoration,24,7,17
41344,Ådrixon,burning-legion,672,shaman,restoration,30,7,23
41345,Ricid,nerathor,671,shaman,restoration,12,7,5
41346,Gimzx,magtheridon,671,shaman,restoration,12,7,5
41347,Bbc,dalaran,671,shaman,restoration,12,7,5
41348,Räyznx,nozdormu,671,shaman,restoration,12,7,5
41349,Lingz,auchindoun,671,shaman,restoration,12,7,5
41350,Elshimano,ravencrest,671,shaman,restoration,12,7,5
41351,Grosgourdin,la-croisade-écarlate,671,shaman,restoration,12,7,5
41352,Cred,the-venture-co,671,shaman,restoration,12,7,5
41353,Rooske,draenor,671,shaman,restoration,12,7,5
41354,Bajslys,kazzak,671,shaman,restoration,12,7,5
41355,Dominatorix,xavius,671,shaman,restoration,13,7,6
41356,Brocksamson,dentarg,671,shaman,restoration,14,7,7
41357,Nïshä,twisting-nether,671,shaman,restoration,18,7,11
41358,Shâdôwlîght,antonidas,671,shaman,restoration,18,7,11
41359,Flameshock,tarren-mill,671,shaman,restoration,18,7,11
41360,Deadshammyx,ravencrest,671,shaman,restoration,18,7,11
41361,Maab,arathor,671,shaman,restoration,18,7,11
41362,Xentic,kazzak,671,shaman,restoration,18,7,11
41363,Zippidizap,ulduar,671,shaman,restoration,18,7,11
41364,Indennacken,blackmoore,671,shaman,restoration,18,7,11
41365,Jedsham,stormscale,671,shaman,restoration,18,7,11
41366,Skullføck,argent-dawn,671,shaman,restoration,21,8,13
41367,Eaglesteaam,silvermoon,671,shaman,restoration,20,7,13
41368,Mòónz,kazzak,671,shaman,restoration,24,7,17
41369,Инкарнатор,deathguard,670,shaman,restoration,12,7,5
41370,Aiuto,archimonde,670,shaman,restoration,12,7,5
41371,Bjorhuk,ravencrest,670,shaman,restoration,12,7,5
41372,Tidors,burning-legion,670,shaman,restoration,12,7,5
41373,Plùx,antonidas,670,shaman,restoration,12,7,5
41374,Bandyy,magtheridon,670,shaman,restoration,18,7,11
41375,Irachal,rexxar,670,shaman,restoration,18,7,11
41376,Aluweckerl,eredar,670,shaman,restoration,24,7,17
41377,Kledorchick,twisting-nether,670,shaman,restoration,33,7,26
41378,Shamaxwell,blackhand,669,shaman,restoration,12,7,5
41379,Woew,tarren-mill,669,shaman,restoration,12,7,5
41380,Линчон,soulflayer,669,shaman,restoration,18,7,11
41381,Simph,uldum,669,shaman,restoration,24,7,17
41382,Shacharcaspi,blackmoore,669,shaman,restoration,24,7,17
41383,Brutalxl,tarren-mill,669,shaman,restoration,24,7,17
41384,Marranota,cthun,668,shaman,restoration,12,7,5
41385,Bloggurt,tarren-mill,668,shaman,restoration,18,7,11
41386,Sorontar,twisting-nether,668,shaman,restoration,18,7,11
41387,Raikage,elune,668,shaman,restoration,18,7,11
41388,Aveet,kazzak,667,shaman,restoration,18,7,11
41389,Millacki,blackrock,667,shaman,restoration,18,7,11
41390,Omeletteoeuf,silvermoon,666,shaman,restoration,12,7,5
41391,Zelgore,frostwhisper,666,shaman,restoration,18,7,11
41392,Briindead,archimonde,665,shaman,restoration,12,7,5
41393,Sneggels,wrathbringer,665,shaman,restoration,21,8,13
41394,Jøw,dun-modr,661,shaman,restoration,12,7,5
41395,Raketenrieke,blackrock,659,shaman,restoration,25,12,13
41396,Bogmagnus,the-maelstrom,659,shaman,restoration,39,13,26
41397,Lillink,stormscale,655,shaman,restoration,9,9,0
41398,Draredemolen,archimonde,655,shaman,restoration,17,7,10
41399,Mjollnier,stormscale,640,shaman,restoration,10,8,2
41400,Eddiemorphin,kazzak,639,shaman,restoration,11,7,4
41401,Неерззул,soulflayer,639,shaman,restoration,17,7,10
41402,Nojiko,blackrock,638,shaman,restoration,17,7,10
41403,Altesh,die-todeskrallen,634,shaman,restoration,16,7,9
41404,Realiz,ysondre,622,shaman,restoration,16,7,9
41405,Енотикусь,soulflayer,618,shaman,restoration,12,8,4
41406,Chîllkrötè,blackmoore,618,shaman,restoration,12,8,4
41407,Disharmony,outland,618,shaman,restoration,12,8,4
41408,Mambokïngs,sanguino,617,shaman,restoration,16,8,8
41409,Aesa,dun-modr,617,shaman,restoration,18,8,10
41410,Randomuwu,stormscale,616,shaman,restoration,22,8,14
41411,Мке,howling-fjord,615,shaman,restoration,29,11,18
41412,Martiinii,dragonmaw,606,shaman,restoration,11,7,4
41413,Amatero,drakthul,591,shaman,restoration,13,7,6
41414,Zhead,aggramar,584,shaman,restoration,16,9,7
41415,Ethixx,outland,576,shaman,restoration,6,6,0
41416,Lerra,zirkel-des-cenarius,576,shaman,restoration,6,6,0
41417,Bauch,tichondrius,576,shaman,restoration,6,6,0
41418,Yacuzwerg,blackrock,576,shaman,restoration,6,6,0
41419,Imdarat,hyjal,576,shaman,restoration,6,6,0
41420,Oldveteran,eredar,576,shaman,restoration,6,6,0
41421,Groquick,dalaran,576,shaman,restoration,12,6,6
41422,Bigdaddyxo,tarren-mill,576,shaman,restoration,12,6,6
41423,Wintradezki,tarren-mill,576,shaman,restoration,12,6,6
41424,Jodel,tarren-mill,576,shaman,restoration,12,6,6
41425,Канамаш,borean-tundra,576,shaman,restoration,12,6,6
41426,Artîe,archimonde,576,shaman,restoration,12,6,6
41427,Juicyy,ravencrest,576,shaman,restoration,12,6,6
41428,Тирона,howling-fjord,576,shaman,restoration,12,6,6
41429,Runbrorun,hyjal,576,shaman,restoration,12,6,6
41430,Гоэл,ashenvale,576,shaman,restoration,12,6,6
41431,Thaw,sylvanas,576,shaman,restoration,12,6,6
41432,Dreamon,culte-de-la-rive-noire,576,shaman,restoration,12,6,6
41433,Thatstheswag,blackmoore,576,shaman,restoration,12,6,6
41434,Embodiment,blackrock,576,shaman,restoration,12,6,6
41435,Kaluna,outland,576,shaman,restoration,12,6,6
41436,Erepmad,ravencrest,576,shaman,restoration,12,6,6
41437,Холинкаалло,deathguard,576,shaman,restoration,12,6,6
41438,Komodski,kazzak,576,shaman,restoration,12,6,6
41439,Mýthaz,archimonde,576,shaman,restoration,12,6,6
41440,Chamanox,dalaran,576,shaman,restoration,12,6,6
41441,Tsugu,kazzak,576,shaman,restoration,12,6,6
41442,Chudygôdx,drakthul,576,shaman,restoration,12,6,6
41443,Ruffin,stormscale,576,shaman,restoration,12,6,6
41444,Lmnn,ravencrest,576,shaman,restoration,12,6,6
41445,Tusseladden,tarren-mill,576,shaman,restoration,12,6,6
41446,Gromaburst,stormscale,576,shaman,restoration,12,6,6
41447,Брайбах,howling-fjord,576,shaman,restoration,12,6,6
41448,Heatti,doomhammer,576,shaman,restoration,12,6,6
41449,Oroastbeef,archimonde,576,shaman,restoration,12,6,6
41450,Lortihalsen,outland,576,shaman,restoration,12,6,6
41451,Gamixyx,magtheridon,576,shaman,restoration,12,6,6
41452,Absot,dun-morogh,576,shaman,restoration,12,6,6
41453,Алтезка,blackscar,576,shaman,restoration,12,6,6
41454,Чиллаут,howling-fjord,576,shaman,restoration,12,6,6
41455,Hamgroof,blackrock,576,shaman,restoration,12,6,6
41456,Djsheargødx,twisting-nether,576,shaman,restoration,12,6,6
41457,Hablibubli,kazzak,576,shaman,restoration,12,6,6
41458,Gamixy,magtheridon,576,shaman,restoration,12,6,6
41459,Enoughh,the-maelstrom,576,shaman,restoration,12,6,6
41460,Neverqueue,defias-brotherhood,576,shaman,restoration,12,6,6
41461,Ambuu,kazzak,576,shaman,restoration,12,6,6
41462,Zûgzûg,ragnaros,576,shaman,restoration,12,6,6
41463,Monamour,twisting-nether,576,shaman,restoration,12,6,6
41464,Nimbs,tarren-mill,576,shaman,restoration,12,6,6
41465,Rhêz,kazzak,576,shaman,restoration,12,6,6
41466,Goodevening,tarren-mill,576,shaman,restoration,12,6,6
41467,Khidon,silvermoon,576,shaman,restoration,12,6,6
41468,Skottkärrà,ravencrest,576,shaman,restoration,12,6,6
41469,Kilninshape,archimonde,576,shaman,restoration,12,6,6
41470,Артэкриошам,soulflayer,576,shaman,restoration,12,6,6
41471,Zalamlól,kazzak,576,shaman,restoration,12,6,6
41472,Cardeâ,blackhand,576,shaman,restoration,12,6,6
41473,Хоупосх,gordunni,576,shaman,restoration,12,6,6
41474,Annoying,archimonde,576,shaman,restoration,12,6,6
41475,Gotta,dethecus,576,shaman,restoration,12,6,6
41476,Purgecleave,dalvengyr,576,shaman,restoration,12,6,6
41477,Løktarøgàr,archimonde,576,shaman,restoration,12,6,6
41478,Qwázú,silvermoon,576,shaman,restoration,12,6,6
41479,Lågertha,sanguino,576,shaman,restoration,12,6,6
41480,Tuorak,eredar,576,shaman,restoration,12,6,6
41481,Modder,ragnaros,576,shaman,restoration,12,6,6
41482,Kocaina,kazzak,576,shaman,restoration,12,6,6
41483,Glücksbarren,die-aldor,576,shaman,restoration,12,6,6
41484,Kameltotem,balnazzar,576,shaman,restoration,12,6,6
41485,Shmøn,outland,576,shaman,restoration,12,6,6
41486,Katwio,hyjal,576,shaman,restoration,12,6,6
41487,Pjotrasmus,mannoroth,576,shaman,restoration,18,6,12
41488,Embèr,silvermoon,576,shaman,restoration,18,6,12
41489,Lifestorm,hyjal,576,shaman,restoration,18,6,12
41490,Kioterasham,conseil-des-ombres,576,shaman,restoration,18,6,12
41491,Tâkeda,blackmoore,576,shaman,restoration,18,6,12
41492,Patsham,wildhammer,576,shaman,restoration,18,6,12
41493,Боргирх,soulflayer,576,shaman,restoration,24,6,18
41494,Aboveaverage,stormscale,576,shaman,restoration,30,6,24
41495,Brandbombe,frostwolf,575,shaman,restoration,12,6,6
41496,Sikro,frostwolf,575,shaman,restoration,12,6,6
41497,Sjearthen,defias-brotherhood,575,shaman,restoration,12,6,6
41498,Conor,kult-der-verdammten,575,shaman,restoration,12,6,6
41499,Qona,emerald-dream,575,shaman,restoration,12,6,6
41500,Flurpz,outland,575,shaman,restoration,12,6,6
41501,Shazefin,twisting-nether,575,shaman,restoration,12,6,6
41502,Kraugug,archimonde,575,shaman,restoration,12,6,6
41503,Ghoraddu,drakthul,575,shaman,restoration,12,6,6
41504,Pakasschami,frostwolf,575,shaman,restoration,12,6,6
41505,Vascodagama,twisting-nether,575,shaman,restoration,12,6,6
41506,Cadierno,argent-dawn,575,shaman,restoration,12,6,6
41507,Cristhor,nemesis,575,shaman,restoration,12,6,6
41508,Bíllý,onyxia,575,shaman,restoration,12,6,6
41509,Pyxton,kazzak,575,shaman,restoration,12,6,6
41510,Stortvloed,twisting-nether,575,shaman,restoration,12,6,6
41511,Kyaz,ravencrest,575,shaman,restoration,12,6,6
41512,Безрукан,howling-fjord,575,shaman,restoration,12,6,6
41513,Aesonis,kazzak,575,shaman,restoration,14,6,8
41514,Дохаку,booty-bay,575,shaman,restoration,17,6,11
41515,Джусипуси,gordunni,575,shaman,restoration,18,6,12
41516,Турелька,blackscar,575,shaman,restoration,18,6,12
41517,Mystico,sanguino,575,shaman,restoration,18,6,12
41518,Liferqt,nemesis,575,shaman,restoration,18,6,12
41519,Аскирия,soulflayer,575,shaman,restoration,18,6,12
41520,Kalvei,draenor,575,shaman,restoration,18,6,12
41521,Lorthargol,chamber-of-aspects,575,shaman,restoration,18,6,12
41522,Laftershamy,cthun,575,shaman,restoration,24,6,18
41523,Tidushears,thrall,574,shaman,restoration,12,6,6
41524,Kongapenes,tarren-mill,574,shaman,restoration,12,6,6
41525,Turbokrapka,tarren-mill,574,shaman,restoration,12,6,6
41526,Notwhoheals,executus,574,shaman,restoration,18,6,12
41527,Ftsckpower,blackhand,574,shaman,restoration,18,6,12
41528,Pépón,dun-modr,574,shaman,restoration,18,6,12
41529,Bolski,stormreaver,573,shaman,restoration,12,6,6
41530,Dobbi,dethecus,573,shaman,restoration,12,6,6
41531,Muschi,culte-de-la-rive-noire,573,shaman,restoration,16,7,9
41532,Horiun,sanguino,573,shaman,restoration,19,6,13
41533,Shammzy,mannoroth,573,shaman,restoration,24,6,18
41534,Морпат,soulflayer,571,shaman,restoration,10,7,3
41535,Alïsyo,nemesis,570,shaman,restoration,18,6,12
41536,Bunnîe,kazzak,565,shaman,restoration,18,6,12
41537,Ongedierte,tarren-mill,543,shaman,restoration,11,6,5
41538,Groundcslol,kazzak,543,shaman,restoration,14,7,7
41539,Cotêaz,thrall,541,shaman,restoration,16,6,10
41540,Totemglad,drakthul,528,shaman,restoration,9,7,2
41541,Whibbler,ravencrest,528,shaman,restoration,21,7,14
41542,Randomshamx,ravencrest,527,shaman,restoration,11,6,5
41543,Télapou,ragnaros,527,shaman,restoration,11,6,5
41544,Манрото,soulflayer,526,shaman,restoration,9,6,3
41545,Glak,draenor,521,shaman,restoration,21,7,14
41546,Elwynnpolice,argent-dawn,512,shaman,restoration,16,6,10
41547,Arigolds,twilights-hammer,511,shaman,restoration,11,6,5
41548,Zordox,zirkel-des-cenarius,511,shaman,restoration,16,6,10
41549,Mynutz,outland,480,shaman,restoration,6,5,1
41550,Keiro,burning-blade,480,shaman,restoration,6,5,1
41551,Helloimblue,blackmoore,480,shaman,restoration,6,5,1
41552,Bummexx,twisting-nether,480,shaman,restoration,6,5,1
41553,Gadula,burning-legion,480,shaman,restoration,6,5,1
41554,Ub,garona,480,shaman,restoration,6,5,1
41555,Meeq,deathwing,480,shaman,restoration,6,5,1
41556,Ranenmuija,outland,480,shaman,restoration,6,5,1
41557,Joeexotictv,tarren-mill,480,shaman,restoration,6,5,1
41558,Shamsteaks,thrall,480,shaman,restoration,6,5,1
41559,Antikahraman,blackrock,480,shaman,restoration,6,5,1
41560,Qwauzinator,silvermoon,480,shaman,restoration,6,5,1
41561,Xêra,burning-legion,480,shaman,restoration,10,6,4
41562,Styllz,uldaman,480,shaman,restoration,12,5,7
41563,Nùggets,garona,480,shaman,restoration,12,5,7
41564,Hexftw,khaz-modan,480,shaman,restoration,12,5,7
41565,Sliiderr,draenor,480,shaman,restoration,12,5,7
41566,Asschick,outland,480,shaman,restoration,12,5,7
41567,Kïtten,tarren-mill,480,shaman,restoration,12,5,7
41568,Kemmi,dalaran,480,shaman,restoration,12,5,7
41569,Ghorall,ragnaros,480,shaman,restoration,12,5,7
41570,Hogmodig,tarren-mill,480,shaman,restoration,12,5,7
41571,Maybeyes,twisting-nether,480,shaman,restoration,12,5,7
41572,Kfcmanagerzz,archimonde,480,shaman,restoration,12,5,7
41573,Zougzy,uldaman,480,shaman,restoration,12,5,7
41574,Volwerin,blackhand,480,shaman,restoration,12,5,7
41575,Medistød,draenor,480,shaman,restoration,12,5,7
41576,Zæus,ragnaros,480,shaman,restoration,12,5,7
41577,Evííl,tarren-mill,480,shaman,restoration,12,5,7
41578,Tobbey,tarren-mill,480,shaman,restoration,12,5,7
41579,Adzkímo,tarren-mill,480,shaman,restoration,12,5,7
41580,Maïtregïms,archimonde,480,shaman,restoration,12,5,7
41581,Tigo,tarren-mill,480,shaman,restoration,12,5,7
41582,Libano,archimonde,480,shaman,restoration,12,5,7
41583,Zappyhog,turalyon,480,shaman,restoration,12,5,7
41584,Daboo,the-venture-co,480,shaman,restoration,12,5,7
41585,Caliqueños,sanguino,480,shaman,restoration,12,5,7
41586,Nakertaako,kazzak,480,shaman,restoration,12,5,7
41587,Cheerz,ravencrest,480,shaman,restoration,12,5,7
41588,Shamania,grim-batol,480,shaman,restoration,12,5,7
41589,Sojee,ysondre,480,shaman,restoration,12,5,7
41590,Shadowmove,bronzebeard,480,shaman,restoration,12,5,7
41591,Kempfer,blackrock,480,shaman,restoration,12,5,7
41592,Egor,alakir,480,shaman,restoration,12,5,7
41593,Mbx,ravencrest,480,shaman,restoration,12,5,7
41594,Flandersx,ravencrest,480,shaman,restoration,12,5,7
41595,Riptidegodx,archimonde,480,shaman,restoration,12,5,7
41596,Uanl,stormscale,480,shaman,restoration,12,5,7
41597,Lumière,alonsus,480,shaman,restoration,12,5,7
41598,Biçi,steamwheedle-cartel,480,shaman,restoration,12,5,7
41599,Markboymint,earthen-ring,480,shaman,restoration,12,5,7
41600,Thyeori,stormscale,480,shaman,restoration,12,5,7
41601,Windie,drakthul,480,shaman,restoration,12,5,7
41602,Lontarsdaddy,twisting-nether,480,shaman,restoration,12,5,7
41603,Totemiclol,aegwynn,480,shaman,restoration,12,5,7
41604,Demeri,blackrock,480,shaman,restoration,12,5,7
41605,Aeknor,ravencrest,480,shaman,restoration,12,5,7
41606,Burrowabuser,nemesis,480,shaman,restoration,12,5,7
41607,Qishwilu,ravencrest,480,shaman,restoration,12,5,7
41608,Вардоус,soulflayer,480,shaman,restoration,12,5,7
41609,Leafplsx,blackrock,480,shaman,restoration,12,5,7
41610,Nevagonalink,archimonde,480,shaman,restoration,12,5,7
41611,Бьерн,deepholm,480,shaman,restoration,12,5,7
41612,Hakunax,twisting-nether,480,shaman,restoration,12,5,7
41613,Jakeir,auchindoun,480,shaman,restoration,12,5,7
41614,Tooltip,tarren-mill,480,shaman,restoration,12,5,7
41615,Ravenshock,bloodfeather,480,shaman,restoration,12,5,7
41616,Shamarco,nemesis,480,shaman,restoration,12,5,7
41617,Unleashme,sylvanas,480,shaman,restoration,12,5,7
41618,Селфлессх,soulflayer,480,shaman,restoration,18,5,13
41619,Slasket,bloodscalp,480,shaman,restoration,18,5,13
41620,Peremptor,alleria,480,shaman,restoration,18,5,13
41621,Колбаскофф,gordunni,480,shaman,restoration,18,5,13
41622,Кенниарт,howling-fjord,480,shaman,restoration,18,5,13
41623,Krayton,tarren-mill,480,shaman,restoration,18,5,13
41624,Bruho,mazrigos,480,shaman,restoration,18,5,13
41625,Elepumper,outland,480,shaman,restoration,18,5,13
41626,Nêgan,ravencrest,480,shaman,restoration,22,5,17
41627,Savan,darkspear,480,shaman,restoration,24,5,19
41628,Rawtex,draenor,480,shaman,restoration,26,5,21
41629,Iebaznis,draenor,479,shaman,restoration,6,5,1
41630,Tllz,kargath,479,shaman,restoration,6,5,1
41631,Scamander,draenor,479,shaman,restoration,8,5,3
41632,Sakar,auchindoun,479,shaman,restoration,12,5,7
41633,Manolaz,kazzak,479,shaman,restoration,12,5,7
41634,Bloodfist,drakthul,479,shaman,restoration,12,5,7
41635,Amnistia,ragnaros,479,shaman,restoration,12,5,7
41636,Hydrototem,archimonde,479,shaman,restoration,12,5,7
41637,Donnerbubele,aegwynn,479,shaman,restoration,12,5,7
41638,Gelaende,thrall,479,shaman,restoration,12,5,7
41639,Róbbàn,agamaggan,479,shaman,restoration,12,5,7
41640,Axéron,blackhand,479,shaman,restoration,12,5,7
41641,Babyboomz,bronze-dragonflight,479,shaman,restoration,12,5,7
41642,Weho,kazzak,479,shaman,restoration,12,5,7
41643,Earthliving,zuljin,479,shaman,restoration,12,5,7
41644,Joaléine,khaz-modan,479,shaman,restoration,12,5,7
41645,Kyousek,drakthul,479,shaman,restoration,12,5,7
41646,Scoobsz,thrall,479,shaman,restoration,15,5,10
41647,Darthshox,outland,478,shaman,restoration,16,6,10
41648,Jotuna,argent-dawn,478,shaman,restoration,18,5,13
41649,Кезара,razuvious,478,shaman,restoration,18,5,13
41650,Rixxa,stormscale,478,shaman,restoration,18,5,13
41651,Darkstrong,alakir,477,shaman,restoration,12,5,7
41652,Thrallallero,pozzo-delleternità,477,shaman,restoration,12,5,7
41653,Porch,doomhammer,476,shaman,restoration,12,5,7
41654,Killhorn,malganis,474,shaman,restoration,12,5,7
41655,Wanryoku,kaelthas,472,shaman,restoration,12,5,7
41656,Shamanarama,sylvanas,463,shaman,restoration,23,5,18
41657,Tøøpåc,hyjal,462,shaman,restoration,13,6,7
41658,Kortgat,kilrogg,431,shaman,restoration,17,5,12
41659,Shamakerr,tarren-mill,426,shaman,restoration,17,7,10
41660,Äppelpaj,earthen-ring,426,shaman,restoration,15,6,9
41661,Etabeta,shattered-hand,415,shaman,restoration,8,5,3
41662,Ulrichh,twisting-nether,415,shaman,restoration,8,5,3
41663,Blixtlasse,magtheridon,400,shaman,restoration,13,5,8
41664,Abøriginal,kazzak,399,shaman,restoration,5,5,0
41665,Доргорн,grom,396,shaman,restoration,11,5,6
41666,Sakulis,ravencrest,384,shaman,restoration,6,4,2
41667,Bluetide,ravencrest,384,shaman,restoration,6,4,2
41668,Volvíc,tichondrius,384,shaman,restoration,6,4,2
41669,Grimdonut,argent-dawn,384,shaman,restoration,6,4,2
41670,Idroptotems,drakthul,384,shaman,restoration,6,4,2
41671,Hexyasf,ravencrest,384,shaman,restoration,6,4,2
41672,Glóbal,sylvanas,384,shaman,restoration,6,4,2
41673,Førcemajeure,kazzak,384,shaman,restoration,6,4,2
41674,Chiio,draenor,384,shaman,restoration,6,4,2
41675,Фредуизли,howling-fjord,384,shaman,restoration,6,4,2
41676,Onionz,stormreaver,384,shaman,restoration,6,4,2
41677,Thriveqt,nemesis,384,shaman,restoration,6,4,2
41678,Laserra,sylvanas,384,shaman,restoration,6,4,2
41679,Mole,jaedenar,384,shaman,restoration,6,4,2
41680,Громкеш,howling-fjord,384,shaman,restoration,6,4,2
41681,Karlsensham,stormscale,384,shaman,restoration,6,4,2
41682,Fapwap,sylvanas,384,shaman,restoration,6,4,2
41683,Амг,booty-bay,384,shaman,restoration,6,4,2
41684,Zyrou,arthas,384,shaman,restoration,6,4,2
41685,Chadhealer,thrall,384,shaman,restoration,6,4,2
41686,Flùffy,nemesis,384,shaman,restoration,6,4,2
41687,Xabat,nemesis,384,shaman,restoration,6,4,2
41688,Blyxuhm,argent-dawn,384,shaman,restoration,6,4,2
41689,Waterboy,tarren-mill,384,shaman,restoration,6,4,2
41690,Bandulski,twisting-nether,384,shaman,restoration,6,4,2
41691,Kekke,uldum,384,shaman,restoration,6,4,2
41692,Стамма,borean-tundra,384,shaman,restoration,6,4,2
41693,Ophís,ambossar,384,shaman,restoration,6,4,2
41694,Тимтярра,gordunni,384,shaman,restoration,6,4,2
41695,Yozgatlilan,aegwynn,384,shaman,restoration,6,4,2
41696,Ravd,outland,384,shaman,restoration,6,4,2
41697,Grimn,burning-legion,384,shaman,restoration,6,4,2
41698,Johnnysîns,blackhand,384,shaman,restoration,6,4,2
41699,Hamuksha,nerathor,384,shaman,restoration,6,4,2
41700,Toasterbread,kazzak,384,shaman,restoration,6,4,2
41701,Пакни,gordunni,384,shaman,restoration,6,4,2
41702,Stormjvj,twisting-nether,384,shaman,restoration,6,4,2
41703,Ысч,ashenvale,384,shaman,restoration,6,4,2
41704,Shàyâ,ysondre,384,shaman,restoration,6,4,2
41705,Снобу,gordunni,384,shaman,restoration,6,4,2
41706,Prup,tarren-mill,384,shaman,restoration,6,4,2
41707,Irônmaxx,antonidas,384,shaman,restoration,6,4,2
41708,Pank,kazzak,384,shaman,restoration,6,4,2
41709,Phobophobia,archimonde,384,shaman,restoration,6,4,2
41710,Электро,thermaplugg,384,shaman,restoration,6,4,2
41711,Imdax,hyjal,384,shaman,restoration,6,4,2
41712,Eaglhex,silvermoon,384,shaman,restoration,6,4,2
41713,Salsissimous,azjolnerub,384,shaman,restoration,6,4,2
41714,Kundt,dalaran,384,shaman,restoration,6,4,2
41715,Leyliner,blackhand,384,shaman,restoration,6,4,2
41716,Criticalx,eredar,384,shaman,restoration,15,5,10
41717,Porke,moonglade,384,shaman,restoration,12,4,8
41718,Меготип,deathweaver,384,shaman,restoration,12,4,8
41719,Cottoneyejoe,alexstrasza,384,shaman,restoration,12,4,8
41720,Bigfatjay,stormscale,384,shaman,restoration,12,4,8
41721,Daklickshamy,blackmoore,384,shaman,restoration,12,4,8
41722,Smahamtwo,stormscale,384,shaman,restoration,12,4,8
41723,Lanze,blackrock,384,shaman,restoration,12,4,8
41724,Faìnt,stormscale,384,shaman,restoration,12,4,8
41725,Serasol,sylvanas,384,shaman,restoration,12,4,8
41726,Pasjeop,ravencrest,384,shaman,restoration,12,4,8
41727,Shamdren,outland,384,shaman,restoration,12,4,8
41728,Guccishadezz,blackmoore,384,shaman,restoration,12,4,8
41729,Bolg,veklor,384,shaman,restoration,12,4,8
41730,Kaffekask,stormscale,384,shaman,restoration,12,4,8
41731,Insanebölt,ravencrest,384,shaman,restoration,12,4,8
41732,Drakamaa,ravencrest,384,shaman,restoration,12,4,8
41733,Lavababe,blackmoore,384,shaman,restoration,12,4,8
41734,Sempaihentai,draenor,384,shaman,restoration,12,4,8
41735,Zyphiz,twisting-nether,384,shaman,restoration,12,4,8
41736,ßiggie,garona,384,shaman,restoration,12,4,8
41737,Wagaluu,ravencrest,384,shaman,restoration,12,4,8
41738,Râpzz,aegwynn,384,shaman,restoration,12,4,8
41739,Kuyamii,blackrock,384,shaman,restoration,12,4,8
41740,Enkou,blackmoore,384,shaman,restoration,12,4,8
41741,Staxoman,daggerspine,384,shaman,restoration,12,4,8
41742,Ранняяпташка,soulflayer,384,shaman,restoration,12,4,8
41743,Энхай,azuregos,384,shaman,restoration,12,4,8
41744,Девлиниум,fordragon,384,shaman,restoration,12,4,8
41745,Nonie,arthas,384,shaman,restoration,12,4,8
41746,Joeashock,ragnaros,384,shaman,restoration,12,4,8
41747,Kerfo,ragnaros,384,shaman,restoration,12,4,8
41748,Zídané,antonidas,384,shaman,restoration,12,4,8
41749,Kashnar,tarren-mill,384,shaman,restoration,12,4,8
41750,Voodz,nathrezim,384,shaman,restoration,12,4,8
41751,Pyrotoad,blackmoore,384,shaman,restoration,12,4,8
41752,Abdegor,burning-legion,384,shaman,restoration,12,4,8
41753,Vey,hyjal,384,shaman,restoration,12,4,8
41754,Tteïl,archimonde,384,shaman,restoration,12,4,8
41755,Maluch,burning-legion,384,shaman,restoration,12,4,8
41756,Gharn,sanguino,384,shaman,restoration,12,4,8
41757,Saksyl,zuljin,384,shaman,restoration,12,4,8
41758,Archsha,burning-legion,384,shaman,restoration,12,4,8
41759,Theodorix,silvermoon,384,shaman,restoration,18,4,14
41760,Ohheck,outland,384,shaman,restoration,18,4,14
41761,Mauî,twisting-nether,384,shaman,restoration,18,4,14
41762,Wtbtoes,ravencrest,384,shaman,restoration,18,4,14
41763,Cølo,ravencrest,384,shaman,restoration,18,4,14
41764,Shøckz,azjolnerub,383,shaman,restoration,6,4,2
41765,Frosthamer,ragnaros,383,shaman,restoration,6,4,2
41766,Abuzay,medivh,383,shaman,restoration,6,4,2
41767,Duodin,defias-brotherhood,383,shaman,restoration,6,4,2
41768,Grøzel,illidan,383,shaman,restoration,6,4,2
41769,Sleyvarian,chamber-of-aspects,383,shaman,restoration,12,4,8
41770,Cisd,tarren-mill,383,shaman,restoration,12,4,8
41771,Rayitoss,tyrande,383,shaman,restoration,16,4,12
41772,Shamanet,kazzak,383,shaman,restoration,18,4,14
41773,Raiñdrops,silvermoon,382,shaman,restoration,6,4,2
41774,Slippyjim,azshara,382,shaman,restoration,12,4,8
41775,Avatarroku,blackhand,382,shaman,restoration,12,4,8
41776,Koko,frostwhisper,382,shaman,restoration,12,4,8
41777,Fessel,auchindoun,379,shaman,restoration,12,4,8
41778,Icytide,kazzak,378,shaman,restoration,18,7,11
41779,Mycameltotem,ravencrest,372,shaman,restoration,26,8,18
41780,Фистинктотем,soulflayer,351,shaman,restoration,16,4,12
41781,Zboubii,archimonde,351,shaman,restoration,17,4,13
41782,Drakhrar,pozzo-delleternità,350,shaman,restoration,8,5,3
41783,Jakesmistake,stormscale,344,shaman,restoration,11,7,4
41784,Grübxxgg,frostmane,335,shaman,restoration,17,4,13
41785,Agatiø,dun-modr,330,shaman,restoration,7,5,2
41786,Arigato,eonar,330,shaman,restoration,16,5,11
41787,Schamitwo,twisting-nether,319,shaman,restoration,5,4,1
41788,Murog,dalaran,319,shaman,restoration,8,4,4
41789,Ticutashaman,argent-dawn,288,shaman,restoration,6,3,3
41790,Muddy,argent-dawn,288,shaman,restoration,6,3,3
41791,Toteemikylpy,argent-dawn,288,shaman,restoration,6,3,3
41792,Shamamamin,argent-dawn,288,shaman,restoration,6,3,3
41793,Votie,tarren-mill,288,shaman,restoration,6,3,3
41794,Bûttâ,archimonde,288,shaman,restoration,6,3,3
41795,Surge,darksorrow,288,shaman,restoration,6,3,3
41796,Tezeret,silvermoon,288,shaman,restoration,6,3,3
41797,Rndshaman,thrall,288,shaman,restoration,6,3,3
41798,Bandiitti,darksorrow,288,shaman,restoration,6,3,3
41799,Tenror,ragnaros,288,shaman,restoration,6,3,3
41800,Hyamala,chamber-of-aspects,288,shaman,restoration,6,3,3
41801,Balúr,thrall,288,shaman,restoration,6,3,3
41802,Tarzh,dalaran,288,shaman,restoration,6,3,3
41803,Jogabonita,kaelthas,288,shaman,restoration,6,3,3
41804,Corlysvelary,doomhammer,288,shaman,restoration,6,3,3
41805,Søljar,draenor,288,shaman,restoration,6,3,3
41806,Stinkyfînger,draenor,288,shaman,restoration,6,3,3
41807,Ikeadamen,alakir,288,shaman,restoration,6,3,3
41808,Yarvin,draenor,288,shaman,restoration,6,3,3
41809,Richtigfies,kazzak,288,shaman,restoration,6,3,3
41810,Kimunamatata,draenor,288,shaman,restoration,6,3,3
41811,Blboz,grim-batol,288,shaman,restoration,6,3,3
41812,Vaîjîn,aegwynn,288,shaman,restoration,6,3,3
41813,Jäckö,archimonde,288,shaman,restoration,6,3,3
41814,Eslu,blackhand,288,shaman,restoration,6,3,3
41815,Rokxa,burning-legion,288,shaman,restoration,6,3,3
41816,Shamoobob,archimonde,288,shaman,restoration,6,3,3
41817,Soulsh,die-ewige-wacht,288,shaman,restoration,6,3,3
41818,Ishin,burning-legion,288,shaman,restoration,6,3,3
41819,Mikesinatra,tarren-mill,288,shaman,restoration,6,3,3
41820,Bingo,tarren-mill,288,shaman,restoration,6,3,3
41821,Rna,ragnaros,288,shaman,restoration,6,3,3
41822,Аалрия,goldrinn,288,shaman,restoration,6,3,3
41823,Totemboyuk,tarren-mill,288,shaman,restoration,6,3,3
41824,Новогор,soulflayer,288,shaman,restoration,6,3,3
41825,Abalenn,kazzak,288,shaman,restoration,6,3,3
41826,Shamatto,nemesis,288,shaman,restoration,6,3,3
41827,Туурукк,soulflayer,288,shaman,restoration,6,3,3
41828,Ранкодин,soulflayer,288,shaman,restoration,6,3,3
41829,Видсон,soulflayer,288,shaman,restoration,6,3,3
41830,Nohealtilt,stormscale,288,shaman,restoration,6,3,3
41831,Oldmanrena,stormscale,288,shaman,restoration,6,3,3
41832,Origins,archimonde,288,shaman,restoration,6,3,3
41833,Klösbräda,stormscale,288,shaman,restoration,6,3,3
41834,Kalinn,sylvanas,288,shaman,restoration,6,3,3
41835,Stibs,silvermoon,288,shaman,restoration,6,3,3
41836,Twkupe,tarren-mill,288,shaman,restoration,6,3,3
41837,Вэллкомм,gordunni,288,shaman,restoration,6,3,3
41838,Ñx,ravencrest,288,shaman,restoration,6,3,3
41839,Ампулаикс,gordunni,288,shaman,restoration,6,3,3
41840,Wealey,drakthul,288,shaman,restoration,6,3,3
41841,Ragnesch,aegwynn,288,shaman,restoration,6,3,3
41842,Елемчикх,gordunni,288,shaman,restoration,6,3,3
41843,Asstroy,sanguino,288,shaman,restoration,6,3,3
41844,Ïllïïllïï,shadowsong,288,shaman,restoration,6,3,3
41845,Testoshaman,ravencrest,288,shaman,restoration,6,3,3
41846,Shohmon,silvermoon,288,shaman,restoration,6,3,3
41847,Goldou,archimonde,288,shaman,restoration,6,3,3
41848,Шамкасамка,gordunni,288,shaman,restoration,6,3,3
41849,Crazywitcho,archimonde,288,shaman,restoration,6,3,3
41850,Бриз,blackscar,288,shaman,restoration,6,3,3
41851,Кхуздуфар,blackscar,288,shaman,restoration,6,3,3
41852,Pokspoks,stormscale,288,shaman,restoration,6,3,3
41853,Ханикс,blackscar,288,shaman,restoration,6,3,3
41854,Моралсидней,blackscar,288,shaman,restoration,6,3,3
41855,Zapyboye,grim-batol,288,shaman,restoration,6,3,3
41856,Mya,frostwolf,288,shaman,restoration,6,3,3
41857,Majinbeb,hyjal,288,shaman,restoration,6,3,3
41858,Гарантииный,lich-king,288,shaman,restoration,6,3,3
41859,Solotov,bronzebeard,288,shaman,restoration,6,3,3
41860,Bharudor,antonidas,288,shaman,restoration,6,3,3
41861,Драмкул,soulflayer,288,shaman,restoration,6,3,3
41862,Diffrinity,tarren-mill,288,shaman,restoration,6,3,3
41863,Ýípìÿøû,dun-modr,288,shaman,restoration,6,3,3
41864,Shànnón,kazzak,288,shaman,restoration,6,3,3
41865,Lvj,blackrock,288,shaman,restoration,6,3,3
41866,Gemexi,kazzak,288,shaman,restoration,6,3,3
41867,Rkeev,blackrock,288,shaman,restoration,6,3,3
41868,Snakeeyéss,kazzak,288,shaman,restoration,6,3,3
41869,Downiesham,kazzak,288,shaman,restoration,6,3,3
41870,Cøkka,hyjal,288,shaman,restoration,6,3,3
41871,Shagrax,anubarak,288,shaman,restoration,6,3,3
41872,Robcurly,blackmoore,288,shaman,restoration,6,3,3
41873,Prepegahex,blackmoore,288,shaman,restoration,6,3,3
41874,Chainbeef,blackmoore,288,shaman,restoration,6,3,3
41875,Misstremmers,outland,288,shaman,restoration,6,3,3
41876,Haract,outland,288,shaman,restoration,6,3,3
41877,Healhooper,hyjal,288,shaman,restoration,6,3,3
41878,Jellyg,outland,288,shaman,restoration,11,3,8
41879,ßasìkz,hyjal,288,shaman,restoration,12,3,9
41880,Flameshock,area-52,288,shaman,restoration,12,3,9
41881,Happyjuice,silvermoon,288,shaman,restoration,12,3,9
41882,Lamarrus,malganis,288,shaman,restoration,12,3,9
41883,Thísisrestø,sanguino,288,shaman,restoration,12,3,9
41884,Magicflames,draenor,288,shaman,restoration,12,3,9
41885,Бэкдафакапп,blackscar,288,shaman,restoration,12,3,9
41886,Sörén,lothar,288,shaman,restoration,12,3,9
41887,Nixxy,magtheridon,288,shaman,restoration,12,3,9
41888,Cpthex,draenor,288,shaman,restoration,12,3,9
41889,Thrallotido,sanguino,288,shaman,restoration,12,3,9
41890,Shamgott,silvermoon,288,shaman,restoration,12,3,9
41891,Kuzsham,archimonde,288,shaman,restoration,12,3,9
41892,Hastabasta,sylvanas,288,shaman,restoration,12,3,9
41893,Carthis,silvermoon,288,shaman,restoration,12,3,9
41894,Keb,gorgonnash,288,shaman,restoration,12,3,9
41895,Fee,silvermoon,288,shaman,restoration,12,3,9
41896,Shammychris,argent-dawn,288,shaman,restoration,12,3,9
41897,Hagelbrakan,stormscale,288,shaman,restoration,12,3,9
41898,Афтршок,soulflayer,288,shaman,restoration,12,3,9
41899,Shamerific,magtheridon,288,shaman,restoration,12,3,9
41900,Shammyenh,burning-legion,288,shaman,restoration,12,3,9
41901,Hobblefoot,stormscale,288,shaman,restoration,12,3,9
41902,Ghanex,tarren-mill,288,shaman,restoration,12,3,9
41903,Mazu,spinebreaker,288,shaman,restoration,12,3,9
41904,Krugx,draenor,288,shaman,restoration,12,3,9
41905,Kandrox,blackmoore,288,shaman,restoration,12,3,9
41906,Ríleyx,twisting-nether,288,shaman,restoration,12,3,9
41907,Thundertail,ragnaros,288,shaman,restoration,12,3,9
41908,Billburr,aegwynn,288,shaman,restoration,12,3,9
41909,Madrävëngodx,ragnaros,288,shaman,restoration,12,3,9
41910,Cragouz,archimonde,288,shaman,restoration,18,3,15
41911,Shankka,ragnaros,288,shaman,restoration,18,3,15
41912,Oggyoggyoggy,outland,288,shaman,restoration,18,3,15
41913,Zeiger,minahonda,287,shaman,restoration,12,3,9
41914,Deeblu,nemesis,287,shaman,restoration,12,3,9
41915,Emansh,twisting-nether,287,shaman,restoration,18,3,15
41916,Rbghêâl,blackrock,287,shaman,restoration,18,3,15
41917,Mimsy,hyjal,285,shaman,restoration,12,3,9
41918,Mitica,ravencrest,276,shaman,restoration,16,7,9
41919,Shamtime,aegwynn,275,shaman,restoration,18,6,12
41920,Shâm,kazzak,271,shaman,restoration,11,3,8
41921,Tonda,stormscale,256,shaman,restoration,4,4,0
41922,Localicious,ragnaros,255,shaman,restoration,11,3,8
41923,Crazypurgeqt,arathor,255,shaman,restoration,17,3,14
41924,Yang,der-rat-von-dalaran,240,shaman,restoration,9,4,5
41925,Kongx,blackhand,239,shaman,restoration,5,3,2
41926,Elliesham,kazzak,239,shaman,restoration,5,3,2
41927,Skoddy,blackmoore,234,shaman,restoration,8,5,3
41928,Silden,thrall,234,shaman,restoration,10,5,5
41929,Æxs,archimonde,234,shaman,restoration,8,4,4
41930,Soyungordoqt,sanguino,234,shaman,restoration,8,4,4
41931,Yukîmøn,hyjal,234,shaman,restoration,11,4,7
41932,Ikó,kazzak,234,shaman,restoration,22,6,16
41933,Drøgøs,dun-modr,234,shaman,restoration,18,4,14
41934,Zinlay,tarren-mill,192,shaman,restoration,6,2,4
41935,Joshan,frostmourne,192,shaman,restoration,6,2,4
41936,Elektrikci,silvermoon,192,shaman,restoration,6,2,4
41937,Noriqt,kazzak,192,shaman,restoration,6,2,4
41938,Pip,outland,192,shaman,restoration,6,2,4
41939,Agatons,twisting-nether,192,shaman,restoration,6,2,4
41940,Hóonda,twisting-nether,192,shaman,restoration,6,2,4
41941,Bumbummann,blackmoore,192,shaman,restoration,6,2,4
41942,Okrall,twisting-nether,192,shaman,restoration,6,2,4
41943,Rihi,twisting-nether,192,shaman,restoration,6,2,4
41944,Booga,tarren-mill,192,shaman,restoration,6,2,4
41945,Pûrge,tarren-mill,192,shaman,restoration,6,2,4
41946,Tonnii,tarren-mill,192,shaman,restoration,6,2,4
41947,Palarins,dalaran,192,shaman,restoration,6,2,4
41948,Marjorie,archimonde,192,shaman,restoration,6,2,4
41949,Huibäm,eredar,192,shaman,restoration,6,2,4
41950,Thornyberrý,outland,192,shaman,restoration,6,2,4
41951,Mitochondria,drakthul,192,shaman,restoration,6,2,4
41952,Renátosz,ragnaros,192,shaman,restoration,6,2,4
41953,Berascendz,argent-dawn,192,shaman,restoration,6,2,4
41954,Lexus,nordrassil,192,shaman,restoration,6,2,4
41955,Kärmá,lightbringer,192,shaman,restoration,6,2,4
41956,Vyrá,onyxia,192,shaman,restoration,6,2,4
41957,Iziisham,outland,192,shaman,restoration,6,2,4
41958,Schmamane,blutkessel,192,shaman,restoration,6,2,4
41959,Hagridheals,silvermoon,192,shaman,restoration,6,2,4
41960,Mëowth,ragnaros,192,shaman,restoration,6,2,4
41961,Baboss,blutkessel,192,shaman,restoration,6,2,4
41962,Wåe,outland,192,shaman,restoration,6,2,4
41963,Oladoda,archimonde,192,shaman,restoration,6,2,4
41964,Pumanii,silvermoon,192,shaman,restoration,6,2,4
41965,Bavalurst,doomhammer,192,shaman,restoration,6,2,4
41966,Cynmaticsx,kargath,192,shaman,restoration,6,2,4
41967,Proccazu,draenor,192,shaman,restoration,6,2,4
41968,Agorasiya,frostwolf,192,shaman,restoration,6,2,4
41969,Sëídhr,arathi,192,shaman,restoration,6,2,4
41970,Fuchserl,aegwynn,192,shaman,restoration,6,2,4
41971,Kevox,malganis,192,shaman,restoration,6,2,4
41972,Doflamingo,aszune,192,shaman,restoration,6,2,4
41973,Nassîî,blackhand,192,shaman,restoration,6,2,4
41974,Kossborax,blackhand,192,shaman,restoration,6,2,4
41975,Imbahlink,draenor,192,shaman,restoration,6,2,4
41976,Chatbanned,blackmoore,192,shaman,restoration,6,2,4
41977,Totemino,silvermoon,192,shaman,restoration,6,2,4
41978,Ludiböris,kazzak,192,shaman,restoration,6,2,4
41979,Sablolix,ravencrest,192,shaman,restoration,6,2,4
41980,Jacquisham,archimonde,192,shaman,restoration,6,2,4
41981,Ünnä,sanguino,192,shaman,restoration,6,2,4
41982,Jsham,blackmoore,192,shaman,restoration,6,2,4
41983,Matsish,sylvanas,192,shaman,restoration,6,2,4
41984,Lêss,ysondre,192,shaman,restoration,6,2,4
41985,Элементаликс,ashenvale,192,shaman,restoration,6,2,4
41986,Smightys,kazzak,192,shaman,restoration,6,2,4
41987,Smorclelx,khadgar,192,shaman,restoration,6,2,4
41988,Демианна,eversong,192,shaman,restoration,6,2,4
41989,Kàji,ravencrest,192,shaman,restoration,6,2,4
41990,Урахарочка,soulflayer,192,shaman,restoration,6,2,4
41991,Тотемо,gordunni,192,shaman,restoration,6,2,4
41992,Southpaw,kult-der-verdammten,192,shaman,restoration,6,2,4
41993,Wahya,stormscale,192,shaman,restoration,6,2,4
41994,Buchânan,archimonde,192,shaman,restoration,6,2,4
41995,Джейджона,soulflayer,192,shaman,restoration,6,2,4
41996,Пучмек,gordunni,192,shaman,restoration,6,2,4
41997,Lausimhaus,blackrock,192,shaman,restoration,6,2,4
41998,Брбртолетчик,soulflayer,192,shaman,restoration,6,2,4
41999,Sàs,zuljin,192,shaman,restoration,6,2,4
42000,Chêlëx,silvermoon,192,shaman,restoration,6,2,4
42001,Rhastasha,archimonde,192,shaman,restoration,6,2,4
42002,Shupp,stormscale,192,shaman,restoration,6,2,4
42003,Nuarishaman,kazzak,192,shaman,restoration,6,2,4
42004,Linkxz,sylvanas,192,shaman,restoration,6,2,4
42005,Gevitomeraw,sylvanas,192,shaman,restoration,6,2,4
42006,Olmaz,ravencrest,192,shaman,restoration,6,2,4
42007,Naneunsanai,jaedenar,192,shaman,restoration,6,2,4
42008,Biggucci,sylvanas,192,shaman,restoration,6,2,4
42009,Pebble,blackrock,192,shaman,restoration,6,2,4
42010,Herru,blackrock,192,shaman,restoration,6,2,4
42011,Nailos,dun-modr,192,shaman,restoration,6,2,4
42012,Reinssay,ysondre,192,shaman,restoration,6,2,4
42013,Ðiezz,ysondre,192,shaman,restoration,6,2,4
42014,Srøgg,archimonde,192,shaman,restoration,6,2,4
42015,Sanxon,blackrock,192,shaman,restoration,6,2,4
42016,Khayac,ravencrest,192,shaman,restoration,6,2,4
42017,Voodude,blackrock,192,shaman,restoration,6,2,4
42018,Anteja,kazzak,192,shaman,restoration,6,2,4
42019,Narevoqi,madmortem,192,shaman,restoration,6,2,4
42020,Noxl,gorgonnash,192,shaman,restoration,6,2,4
42021,Hìrnfrost,blackrock,192,shaman,restoration,6,2,4
42022,Mikhey,archimonde,192,shaman,restoration,6,2,4
42023,Basegrandpa,ravencrest,192,shaman,restoration,6,2,4
42024,Brâshô,frostwolf,192,shaman,restoration,9,2,7
42025,Ninffø,dun-modr,192,shaman,restoration,20,4,16
42026,Dvärgenkajsa,stormreaver,192,shaman,restoration,10,2,8
42027,Saarroo,ravencrest,192,shaman,restoration,12,2,10
42028,Ibicc,twisting-nether,192,shaman,restoration,12,2,10
42029,Ekxr,kazzak,192,shaman,restoration,12,2,10
42030,Zarschu,burning-legion,192,shaman,restoration,12,2,10
42031,Delvanjus,blackrock,192,shaman,restoration,12,2,10
42032,Zeltron,grim-batol,192,shaman,restoration,12,2,10
42033,Thunderjudge,twisting-nether,192,shaman,restoration,12,2,10
42034,Gïzmö,tarren-mill,192,shaman,restoration,12,2,10
42035,Samisu,blackmoore,192,shaman,restoration,12,2,10
42036,Fatflop,sylvanas,192,shaman,restoration,12,2,10
42037,Barean,ravencrest,192,shaman,restoration,12,2,10
42038,Masham,darkspear,192,shaman,restoration,12,2,10
42039,Nashashuk,runetotem,192,shaman,restoration,12,2,10
42040,Nuekx,sanguino,192,shaman,restoration,12,2,10
42041,Otuschsham,blackmoore,192,shaman,restoration,12,2,10
42042,Cptnkirby,malganis,192,shaman,restoration,12,2,10
42043,Soyun,frostwhisper,192,shaman,restoration,12,2,10
42044,Epicoverlord,tarren-mill,192,shaman,restoration,12,2,10
42045,Ezpz,frostmourne,192,shaman,restoration,12,2,10
42046,Ozzlac,thrall,192,shaman,restoration,12,2,10
42047,Zënga,kazzak,192,shaman,restoration,12,2,10
42048,Wuchtzwerg,terrordar,192,shaman,restoration,18,2,16
42049,Kanuw,kilrogg,191,shaman,restoration,6,2,4
42050,Valuriya,blackhand,191,shaman,restoration,6,2,4
42051,Koothe,dun-modr,191,shaman,restoration,6,2,4
42052,Geishablue,defias-brotherhood,191,shaman,restoration,12,2,10
42053,Penumbrah,kazzak,191,shaman,restoration,26,2,24
42054,Андумиэль,soulflayer,190,shaman,restoration,12,2,10
42055,Chaotikos,ravencrest,178,shaman,restoration,12,8,4
42056,Krootox,sunstrider,170,shaman,restoration,18,4,14
42057,Zhangliyi,ravencrest,169,shaman,restoration,9,5,4
42058,Divazena,drakthul,159,shaman,restoration,5,2,3
42059,Ghafo,norgannon,159,shaman,restoration,5,2,3
42060,Nockedly,ragnaros,144,shaman,restoration,9,3,6
42061,Jecastyle,sanguino,138,shaman,restoration,8,3,5
42062,Ruzgork,nerzhul,138,shaman,restoration,9,3,6
42063,Mcgrêgor,aegwynn,138,shaman,restoration,15,4,11
42064,Volstorm,ysondre,138,shaman,restoration,12,3,9
42065,Elunaxcc,eredar,137,shaman,restoration,11,4,7
42066,Kswíss,outland,137,shaman,restoration,9,3,6
42067,Cardenus,los-errantes,137,shaman,restoration,15,3,12
42068,Belldandý,archimonde,128,shaman,restoration,4,2,2
42069,Feetsniffax,outland,128,shaman,restoration,4,2,2
42070,Shamaray,stormscale,127,shaman,restoration,8,2,6
42071,Reflux,outland,96,shaman,restoration,6,1,5
42072,Try,zuluhed,96,shaman,restoration,6,1,5
42073,Swepx,ravencrest,96,shaman,restoration,6,1,5
42074,Hotstorm,bronzebeard,96,shaman,restoration,6,1,5
42075,Poliez,outland,96,shaman,restoration,6,1,5
42076,Sërka,cthun,96,shaman,restoration,6,1,5
42077,Efdemin,blackmoore,96,shaman,restoration,6,1,5
42078,Rahuna,darksorrow,96,shaman,restoration,6,1,5
42079,Fuchifu,eredar,96,shaman,restoration,6,1,5
42080,Cirøsham,ravencrest,96,shaman,restoration,6,1,5
42081,Kostex,rexxar,96,shaman,restoration,6,1,5
42082,Lunarsloth,hyjal,96,shaman,restoration,6,1,5
42083,Kimpa,minahonda,96,shaman,restoration,6,1,5
42084,Cy,aszune,96,shaman,restoration,6,1,5
42085,Moonlanced,aegwynn,96,shaman,restoration,6,1,5
42086,Aguero,aegwynn,96,shaman,restoration,6,1,5
42087,Trymytotems,drakthul,96,shaman,restoration,6,1,5
42088,Justweirdaf,blackmoore,96,shaman,restoration,6,1,5
42089,Andrewbéelko,drakthul,96,shaman,restoration,6,1,5
42090,Radjus,kazzak,96,shaman,restoration,6,1,5
42091,Greenbo,burning-blade,96,shaman,restoration,6,1,5
42092,Cptcutíe,antonidas,96,shaman,restoration,6,1,5
42093,Zethh,antonidas,96,shaman,restoration,6,1,5
42094,Apolomaeuz,frostwolf,96,shaman,restoration,6,1,5
42095,Shoar,twisting-nether,96,shaman,restoration,6,1,5
42096,Jaeslin,tarren-mill,96,shaman,restoration,6,1,5
42097,Zimzalabling,kazzak,96,shaman,restoration,6,1,5
42098,Майайс,gordunni,96,shaman,restoration,6,1,5
42099,Таззикшок,soulflayer,96,shaman,restoration,6,1,5
42100,Geifmeat,kazzak,96,shaman,restoration,6,1,5
42101,Proxjj,stormscale,96,shaman,restoration,6,1,5
42102,Jawoburst,antonidas,96,shaman,restoration,6,1,5
42103,Smorcxx,kazzak,96,shaman,restoration,6,1,5
42104,Elchivo,blackrock,96,shaman,restoration,6,1,5
42105,Chênoya,blackrock,96,shaman,restoration,6,1,5
42106,Dälon,thrall,96,shaman,restoration,6,1,5
42107,Dashakk,frostwhisper,96,shaman,restoration,6,1,5
42108,Stormreach,ragnaros,96,shaman,restoration,6,1,5
42109,Eclaîr,thrall,96,shaman,restoration,6,1,5
42110,Металорд,howling-fjord,96,shaman,restoration,6,1,5
42111,Dvrg,antonidas,96,shaman,restoration,6,1,5
42112,Касьянкочка,blackscar,96,shaman,restoration,6,1,5
42113,Сатангодхх,howling-fjord,96,shaman,restoration,6,1,5
42114,Diabolous,drakthul,96,shaman,restoration,6,1,5
42115,Getahex,draenor,96,shaman,restoration,6,1,5
42116,Cupído,malganis,96,shaman,restoration,6,1,5
42117,Ulfuz,silvermoon,96,shaman,restoration,6,1,5
42118,Shammynox,draenor,96,shaman,restoration,6,1,5
42119,Anieszka,malganis,96,shaman,restoration,6,1,5
42120,Ниарата,greymane,96,shaman,restoration,6,1,5
42121,Tinyboiler,stormscale,96,shaman,restoration,6,1,5
42122,Кермдрог,gordunni,96,shaman,restoration,6,1,5
42123,Yuimhi,sanguino,96,shaman,restoration,7,1,6
42124,Yolototem,drakthul,96,shaman,restoration,9,1,8
42125,Garulf,twisting-nether,96,shaman,restoration,12,1,11
42126,Tiamât,culte-de-la-rive-noire,96,shaman,restoration,12,1,11
42127,Chunkss,argent-dawn,96,shaman,restoration,12,1,11
42128,Freeleys,silvermoon,96,shaman,restoration,12,1,11
42129,Nizty,tarren-mill,96,shaman,restoration,12,1,11
42130,Топмахвелл,soulflayer,96,shaman,restoration,12,1,11
42131,Porre,zuljin,96,shaman,restoration,12,1,11
42132,Íss,cthun,96,shaman,restoration,12,1,11
42133,Akuha,dun-modr,96,shaman,restoration,12,1,11
42134,Anstra,colinas-pardas,96,shaman,restoration,12,1,11
42135,Hugzy,argent-dawn,96,shaman,restoration,12,1,11
42136,Ikeaboy,eredar,96,shaman,restoration,12,1,11
42137,Kvelertak,guldan,96,shaman,restoration,18,1,17
42138,Hairball,turalyon,95,shaman,restoration,6,2,4
42139,Twotwozero,defias-brotherhood,95,shaman,restoration,6,1,5
42140,Taiki,sylvanas,90,shaman,restoration,13,4,9
42141,Jamienisme,ravencrest,79,shaman,restoration,5,1,4
42142,Kungachunga,pozzo-delleternità,79,shaman,restoration,5,1,4
42143,Bursthand,sanguino,79,shaman,restoration,11,1,10
42144,Destrosoul,kazzak,64,shaman,restoration,4,1,3
42145,Nowái,tarren-mill,64,shaman,restoration,4,1,3
42146,Drê,daggerspine,64,shaman,restoration,4,1,3
42147,Rookwave,eredar,64,shaman,restoration,4,1,3
42148,Zourhia,garona,48,shaman,restoration,3,1,2
42149,Oyuun,rajaxx,42,shaman,restoration,11,3,8
42150,Ånný,blackmoore,42,shaman,restoration,11,3,8
42151,Icanbreathe,ravencrest,42,shaman,restoration,9,2,7
42152,Pandatrials,turalyon,42,shaman,restoration,10,2,8
42153,Strikerz,aggra-português,42,shaman,restoration,11,2,9
42154,Shammez,ravencrest,42,shaman,restoration,11,2,9
42155,Søpse,stormscale,42,shaman,restoration,15,2,13
42156,Rngo,blackrock,2366,shaman,elemental,120,73,47
42157,Silden,thrall,2303,shaman,elemental,121,72,49
42158,Mcmxcvi,ravencrest,2293,shaman,elemental,131,81,50
42159,Reibanit,twisting-nether,2284,shaman,elemental,147,86,61
42160,Rungõo,blackrock,2281,shaman,elemental,174,101,73
42161,Eupra,archimonde,2277,shaman,elemental,138,75,63
42162,Shiggenbasta,kazzak,2255,shaman,elemental,90,52,38
42163,Proccit,blackrock,2226,shaman,elemental,90,50,40
42164,Drshock,blackmoore,2220,shaman,elemental,107,56,51
42165,Ghostwolfgg,archimonde,2205,shaman,elemental,132,72,60
42166,Маигваза,soulflayer,2198,shaman,elemental,66,46,20
42167,Lexila,doomhammer,2194,shaman,elemental,394,211,183
42168,Lavaole,blackrock,2185,shaman,elemental,78,42,36
42169,Nyed,hyjal,2183,shaman,elemental,90,50,40
42170,Connecting,hyjal,2171,shaman,elemental,108,56,52
42171,Bärtigeberta,aegwynn,2170,shaman,elemental,102,54,48
42172,Tommybanger,kazzak,2158,shaman,elemental,75,49,26
42173,Shamanazor,twisting-nether,2153,shaman,elemental,66,41,25
42174,Baldcreep,blackrock,2147,shaman,elemental,54,35,19
42175,Space,stormscale,2144,shaman,elemental,126,66,60
42176,Båkka,ysondre,2142,shaman,elemental,60,37,23
42177,Trickful,kazzak,2136,shaman,elemental,60,42,18
42178,Uselesslaso,sanguino,2136,shaman,elemental,117,59,58
42179,Edshearen,stormscale,2127,shaman,elemental,68,42,26
42180,Blyatifulday,malganis,2127,shaman,elemental,96,53,43
42181,Theglue,kilrogg,2124,shaman,elemental,60,36,24
42182,Matmodir,hyjal,2119,shaman,elemental,96,48,48
42183,Autopanne,malganis,2117,shaman,elemental,78,48,30
42184,Guzzelinare,tarren-mill,2115,shaman,elemental,48,30,18
42185,Smorchamp,sanguino,2110,shaman,elemental,84,44,40
42186,Jøhnnwick,archimonde,2106,shaman,elemental,83,47,36
42187,Jøhnwick,ysondre,2103,shaman,elemental,72,39,33
42188,Wisplol,ravencrest,2100,shaman,elemental,255,133,122
42189,Langedinho,stormscale,2091,shaman,elemental,108,57,51
42190,Ìløvêxÿú,ravencrest,2071,shaman,elemental,125,71,54
42191,Pleasehealme,ravencrest,2067,shaman,elemental,42,33,9
42192,Woof,culte-de-la-rive-noire,2037,shaman,elemental,60,32,28
42193,Nokster,twisting-nether,2030,shaman,elemental,110,68,42
42194,Lavayoshi,kazzak,2026,shaman,elemental,72,48,24
42195,Mjorè,twisting-nether,2025,shaman,elemental,97,51,46
42196,Iavalavalava,tarren-mill,2025,shaman,elemental,96,46,50
42197,Satisfya,ambossar,2006,shaman,elemental,286,150,136
42198,Eyi,ambossar,2005,shaman,elemental,92,50,42
42199,Punished,blackrock,2000,shaman,elemental,107,62,45
42200,Rottulos,stormrage,2000,shaman,elemental,60,33,27
42201,Murdá,ravencrest,1999,shaman,elemental,90,43,47
42202,Kärríegold,blackrock,1987,shaman,elemental,285,151,134
42203,Onceinalife,ambossar,1978,shaman,elemental,155,83,72
42204,Raintlordx,twisting-nether,1971,shaman,elemental,36,30,6
42205,Бпокбастэр,gordunni,1970,shaman,elemental,69,40,29
42206,Blackyx,cthun,1969,shaman,elemental,60,39,21
42207,Thyeori,stormscale,1969,shaman,elemental,54,29,25
42208,Shrmful,dun-modr,1964,shaman,elemental,47,32,15
42209,Euprâ,archimonde,1964,shaman,elemental,53,31,22
42210,Suldaro,aegwynn,1964,shaman,elemental,73,39,34
42211,Jelvin,tarren-mill,1963,shaman,elemental,84,43,41
42212,Houmpf,hyjal,1962,shaman,elemental,60,33,27
42213,Pipousham,blackhand,1954,shaman,elemental,47,26,21
42214,Pheazka,outland,1950,shaman,elemental,71,37,34
42215,Élé,twisting-nether,1950,shaman,elemental,72,37,35
42216,Elejizz,kazzak,1948,shaman,elemental,42,22,20
42217,Kenaz,outland,1943,shaman,elemental,55,29,26
42218,Haumx,blackrock,1938,shaman,elemental,102,51,51
42219,Starelement,draenor,1938,shaman,elemental,72,30,42
42220,Mèåtbåll,ravencrest,1935,shaman,elemental,59,36,23
42221,Nevershearx,blackrock,1934,shaman,elemental,54,28,26
42222,Nekhros,sargeras,1931,shaman,elemental,193,104,89
42223,Teslashock,outland,1929,shaman,elemental,48,29,19
42224,Штормкрашер,howling-fjord,1910,shaman,elemental,90,50,40
42225,Anqe,twisting-nether,1910,shaman,elemental,114,62,52
42226,Çð,ravencrest,1909,shaman,elemental,36,20,16
42227,Matmonai,hyjal,1908,shaman,elemental,72,34,38
42228,Dakyele,ravencrest,1902,shaman,elemental,59,32,27
42229,Agrero,auchindoun,1897,shaman,elemental,108,52,56
42230,Totemlié,ravencrest,1887,shaman,elemental,42,27,15
42231,Elegodx,ravencrest,1885,shaman,elemental,59,34,25
42232,Healyoa,blackmoore,1882,shaman,elemental,189,95,94
42233,Gungo,deathwing,1880,shaman,elemental,36,20,16
42234,Obryss,tarren-mill,1876,shaman,elemental,36,20,16
42235,Psyku,outland,1875,shaman,elemental,42,20,22
42236,Хеллбат,howling-fjord,1869,shaman,elemental,36,24,12
42237,Paulbaniel,alonsus,1868,shaman,elemental,72,34,38
42238,Midgetnatty,ravencrest,1867,shaman,elemental,70,39,31
42239,Jacklupin,ravencrest,1867,shaman,elemental,48,25,23
42240,Pxsquals,ravencrest,1863,shaman,elemental,72,40,32
42241,Naskezz,kazzak,1863,shaman,elemental,131,66,65
42242,Cïgänää,archimonde,1862,shaman,elemental,44,26,18
42243,Monsuunibaba,tarren-mill,1861,shaman,elemental,57,31,26
42244,Borbor,argent-dawn,1858,shaman,elemental,46,23,23
42245,Flanax,hyjal,1852,shaman,elemental,78,44,34
42246,Tellý,blackmoore,1846,shaman,elemental,53,31,22
42247,Dretch,dun-morogh,1844,shaman,elemental,42,22,20
42248,Eppîx,lightnings-blade,1844,shaman,elemental,58,29,29
42249,Georgewhat,defias-brotherhood,1843,shaman,elemental,75,39,36
42250,Lilmarco,stormreaver,1843,shaman,elemental,72,35,37
42251,Sajma,silvermoon,1842,shaman,elemental,57,40,17
42252,Eledelede,blackhand,1842,shaman,elemental,54,30,24
42253,Owrly,stormscale,1841,shaman,elemental,185,92,93
42254,Tasoro,sanguino,1840,shaman,elemental,71,34,37
42255,Preshear,twisting-nether,1835,shaman,elemental,35,26,9
42256,Doyah,eredar,1834,shaman,elemental,54,33,21
42257,Bambustic,kazzak,1833,shaman,elemental,41,25,16
42258,Dräpàrn,sylvanas,1833,shaman,elemental,60,32,28
42259,Crazyshaman,ravencrest,1829,shaman,elemental,53,26,27
42260,Hugebuttman,silvermoon,1829,shaman,elemental,78,37,41
42261,Slogic,tarren-mill,1828,shaman,elemental,71,34,37
42262,Crespó,alakir,1827,shaman,elemental,54,25,29
42263,Transcendent,malorne,1826,shaman,elemental,84,63,21
42264,Hazardhenry,argent-dawn,1826,shaman,elemental,42,30,12
42265,Sourens,twisting-nether,1826,shaman,elemental,92,48,44
42266,Kæzx,blackrock,1822,shaman,elemental,78,45,33
42267,Ejx,arthas,1821,shaman,elemental,52,30,22
42268,Novoz,ysondre,1819,shaman,elemental,59,31,28
42269,Lavaproc,burning-legion,1817,shaman,elemental,48,28,20
42270,Инимал,deathweaver,1817,shaman,elemental,36,21,15
42271,Raknoxye,blackrock,1816,shaman,elemental,36,28,8
42272,Achtungblitz,blackrock,1813,shaman,elemental,42,33,9
42273,Stickix,malganis,1812,shaman,elemental,54,32,22
42274,Chamel,draenor,1808,shaman,elemental,30,19,11
42275,Kailash,defias-brotherhood,1808,shaman,elemental,54,26,28
42276,Procc,nordrassil,1807,shaman,elemental,42,28,14
42277,Faridstreng,blackmoore,1807,shaman,elemental,60,39,21
42278,Smorclelx,khadgar,1807,shaman,elemental,158,83,75
42279,Nykhara,sanguino,1805,shaman,elemental,54,30,24
42280,Valgø,twisting-nether,1802,shaman,elemental,180,102,78
42281,Barbarra,stormscale,1802,shaman,elemental,54,28,26
42282,Lianitus,tarren-mill,1802,shaman,elemental,58,30,28
42283,Nyzo,tarren-mill,1802,shaman,elemental,48,23,25
42284,Burstraze,tarren-mill,1801,shaman,elemental,58,32,26
42285,Nowmack,archimonde,1800,shaman,elemental,30,22,8
42286,Spajry,drakthul,1800,shaman,elemental,48,32,16
42287,Nalaadu,stormscale,1800,shaman,elemental,42,26,16
42288,Йодаримару,howling-fjord,1796,shaman,elemental,42,22,20
42289,Psÿkz,kazzak,1790,shaman,elemental,57,25,32
42290,ßakingsoda,tarren-mill,1788,shaman,elemental,48,30,18
42291,Thriveqt,nemesis,1787,shaman,elemental,60,28,32
42292,Pitsamestari,frostmane,1780,shaman,elemental,122,68,54
42293,Suirz,dun-modr,1774,shaman,elemental,59,40,19
42294,Zaledria,argent-dawn,1770,shaman,elemental,54,35,19
42295,Hothand,thrall,1764,shaman,elemental,42,21,21
42296,Volcanò,outland,1763,shaman,elemental,193,95,98
42297,Sunsong,twisting-nether,1757,shaman,elemental,84,49,35
42298,Bûsta,ravencrest,1754,shaman,elemental,36,19,17
42299,Шумноватт,howling-fjord,1753,shaman,elemental,48,23,25
42300,Voydetesto,sanguino,1753,shaman,elemental,84,39,45
42301,Ryysham,ravencrest,1749,shaman,elemental,98,51,47
42302,Rungozvs,blackrock,1745,shaman,elemental,42,25,17
42303,Korvsnärten,outland,1745,shaman,elemental,42,21,21
42304,Seriux,twisting-nether,1744,shaman,elemental,60,40,20
42305,Feetenjoyerx,kazzak,1740,shaman,elemental,50,27,23
42306,Earthhulk,thrall,1739,shaman,elemental,42,27,15
42307,Earthtjockis,ragnaros,1739,shaman,elemental,41,20,21
42308,Prêxy,kazzak,1737,shaman,elemental,49,22,27
42309,Карбонатрикс,soulflayer,1736,shaman,elemental,53,30,23
42310,Mishoshamana,tarren-mill,1733,shaman,elemental,95,54,41
42311,Lsdx,silvermoon,1731,shaman,elemental,42,25,17
42312,Yiiro,argent-dawn,1730,shaman,elemental,48,26,22
42313,Ungabungha,stormscale,1728,shaman,elemental,145,82,63
42314,Hanatopikeur,grim-batol,1728,shaman,elemental,35,19,16
42315,Djlavaburst,malganis,1728,shaman,elemental,263,129,134
42316,Firella,the-maelstrom,1727,shaman,elemental,34,19,15
42317,Daubidaubi,kazzak,1722,shaman,elemental,39,26,13
42318,Matmons,hyjal,1721,shaman,elemental,37,18,19
42319,Starpior,stormscale,1721,shaman,elemental,65,30,35
42320,Ronfroggo,kazzak,1716,shaman,elemental,46,25,21
42321,Fabslx,archimonde,1715,shaman,elemental,117,50,67
42322,Jamzyshaman,emerald-dream,1713,shaman,elemental,30,19,11
42323,Totemlyhot,blackrock,1713,shaman,elemental,48,28,20
42324,Nöyrä,argent-dawn,1710,shaman,elemental,36,25,11
42325,Xtremeshaman,blackmoore,1709,shaman,elemental,24,18,6
42326,Sheamanus,ravencrest,1706,shaman,elemental,48,29,19
42327,Cylantarus,blackrock,1705,shaman,elemental,36,25,11
42328,Дашажмихекс,howling-fjord,1704,shaman,elemental,42,24,18
42329,Чойсе,deathguard,1704,shaman,elemental,102,50,52
42330,Lantbruk,twisting-nether,1703,shaman,elemental,49,28,21
42331,Зэстус,soulflayer,1702,shaman,elemental,83,47,36
42332,Farùk,ravencrest,1701,shaman,elemental,39,24,15
42333,Obesisham,outland,1699,shaman,elemental,60,24,36
42334,Horizons,the-maelstrom,1692,shaman,elemental,30,18,12
42335,Cismine,twisting-nether,1690,shaman,elemental,42,28,14
42336,Lavatherapy,grim-batol,1689,shaman,elemental,66,37,29
42337,Braíntas,norgannon,1686,shaman,elemental,84,39,45
42338,Ogrodi,burning-legion,1685,shaman,elemental,54,31,23
42339,Ðreamz,kaelthas,1685,shaman,elemental,48,23,25
42340,Chênoya,blackrock,1684,shaman,elemental,73,30,43
42341,Adamyo,stormscale,1683,shaman,elemental,48,23,25
42342,Sáàd,ravencrest,1681,shaman,elemental,42,20,22
42343,Xorron,archimonde,1680,shaman,elemental,131,61,70
42344,Nëllaqt,archimonde,1678,shaman,elemental,36,18,18
42345,Kohnân,hyjal,1675,shaman,elemental,78,39,39
42346,Wylly,aegwynn,1672,shaman,elemental,134,71,63
42347,Xelphia,frostmane,1670,shaman,elemental,53,22,31
42348,Vanrake,ravencrest,1669,shaman,elemental,109,62,47
42349,Milotem,ysondre,1669,shaman,elemental,48,26,22
42350,Mércander,kazzak,1668,shaman,elemental,36,23,13
42351,Козаностро,howling-fjord,1668,shaman,elemental,30,19,11
42352,Targoel,blackmoore,1668,shaman,elemental,109,54,55
42353,Mezzoblu,sanguino,1667,shaman,elemental,210,110,100
42354,Regnever,draenor,1667,shaman,elemental,125,53,72
42355,Esal,blackrock,1665,shaman,elemental,31,21,10
42356,Fellatia,baelgun,1665,shaman,elemental,54,36,18
42357,Çð,twisting-nether,1661,shaman,elemental,41,23,18
42358,Smashz,stormscale,1661,shaman,elemental,81,44,37
42359,Elrayitos,shendralar,1659,shaman,elemental,114,63,51
42360,Daemp,draenor,1658,shaman,elemental,24,18,6
42361,Agreró,auchindoun,1658,shaman,elemental,27,19,8
42362,Solosüper,ravencrest,1657,shaman,elemental,48,24,24
42363,Kapïtão,aggra-português,1656,shaman,elemental,48,27,21
42364,Lavalava,blackmoore,1656,shaman,elemental,60,33,27
42365,Shamatto,nemesis,1654,shaman,elemental,64,42,22
42366,Мэморисс,gordunni,1652,shaman,elemental,44,23,21
42367,Hotsincezero,archimonde,1651,shaman,elemental,53,36,17
42368,Deeck,ravencrest,1651,shaman,elemental,83,53,30
42369,Malybou,ysondre,1651,shaman,elemental,36,18,18
42370,Электро,thermaplugg,1648,shaman,elemental,47,24,23
42371,Aureo,dun-modr,1644,shaman,elemental,34,20,14
42372,Милфшама,blackscar,1643,shaman,elemental,47,26,21
42373,Афтршок,soulflayer,1643,shaman,elemental,51,26,25
42374,Zest,hyjal,1643,shaman,elemental,59,28,31
42375,Axahavregryn,kazzak,1640,shaman,elemental,66,40,26
42376,Urshak,alleria,1639,shaman,elemental,36,24,12
42377,Zaarok,voljin,1639,shaman,elemental,91,41,50
42378,Liluzivert,mannoroth,1638,shaman,elemental,77,40,37
42379,Reignisover,silvermoon,1637,shaman,elemental,51,32,19
42380,Кирагаз,gordunni,1637,shaman,elemental,64,32,32
42381,Thorleíf,silvermoon,1636,shaman,elemental,90,42,48
42382,Proccq,twisting-nether,1632,shaman,elemental,34,18,16
42383,Qualitydoge,kazzak,1631,shaman,elemental,24,17,7
42384,Shocknrun,sylvanas,1630,shaman,elemental,48,22,26
42385,Tteïl,archimonde,1629,shaman,elemental,54,30,24
42386,Hotis,onyxia,1629,shaman,elemental,88,43,45
42387,Rrtyui,twisting-nether,1628,shaman,elemental,30,17,13
42388,Shåmssagat,kazzak,1627,shaman,elemental,36,17,19
42389,Huyø,stormscale,1625,shaman,elemental,90,40,50
42390,Davinshhe,kazzak,1623,shaman,elemental,48,21,27
42391,Testpapi,twisting-nether,1618,shaman,elemental,75,42,33
42392,Løun,archimonde,1618,shaman,elemental,72,40,32
42393,Vivaldi,varimathras,1618,shaman,elemental,96,42,54
42394,Microb,blackmoore,1617,shaman,elemental,54,29,25
42395,Vamali,draenor,1614,shaman,elemental,48,23,25
42396,Basiletta,hyjal,1613,shaman,elemental,49,34,15
42397,Zengã,kazzak,1613,shaman,elemental,71,30,41
42398,Ânuk,blackrock,1612,shaman,elemental,162,78,84
42399,Wàve,stormscale,1611,shaman,elemental,60,29,31
42400,Ангустиа,galakrond,1610,shaman,elemental,29,20,9
42401,Kemurus,kazzak,1610,shaman,elemental,77,42,35
42402,Gammeldunder,shattered-hand,1610,shaman,elemental,53,22,31
42403,Oneßuttøn,ravencrest,1609,shaman,elemental,42,20,22
42404,Exxco,aegwynn,1606,shaman,elemental,29,20,9
42405,Sházz,dun-modr,1606,shaman,elemental,47,25,22
42406,Кислаябуба,howling-fjord,1606,shaman,elemental,36,17,19
42407,Bigfrigid,outland,1606,shaman,elemental,54,24,30
42408,Aviciix,sanguino,1605,shaman,elemental,84,36,48
42409,Muscade,silvermoon,1604,shaman,elemental,30,22,8
42410,Drainergødx,ragnaros,1604,shaman,elemental,54,29,25
42411,Зиленый,soulflayer,1604,shaman,elemental,42,22,20
42412,Vorteas,burning-blade,1603,shaman,elemental,36,20,16
42413,Mcbloob,kazzak,1602,shaman,elemental,70,36,34
42414,Naphe,ysondre,1602,shaman,elemental,59,27,32
42415,Kilazz,twisting-nether,1598,shaman,elemental,36,19,17
42416,Murmelï,stormreaver,1597,shaman,elemental,24,18,6
42417,Neotrax,outland,1597,shaman,elemental,78,41,37
42418,Elektron,malganis,1597,shaman,elemental,90,46,44
42419,Jâydizzle,draenor,1594,shaman,elemental,101,42,59
42420,Gúîtårgøð,sanguino,1592,shaman,elemental,42,21,21
42421,Mariomental,draenor,1591,shaman,elemental,42,20,22
42422,Johncoltrane,archimonde,1589,shaman,elemental,30,23,7
42423,Ryhèn,stormscale,1586,shaman,elemental,54,30,24
42424,Zðhan,azshara,1586,shaman,elemental,55,27,28
42425,Гудлаик,soulflayer,1584,shaman,elemental,64,35,29
42426,Essneces,burning-legion,1583,shaman,elemental,42,23,19
42427,Porthex,kazzak,1582,shaman,elemental,30,18,12
42428,Zoomar,tarren-mill,1582,shaman,elemental,60,29,31
42429,Kankxx,stormscale,1580,shaman,elemental,30,18,12
42430,Мистеркутёж,gordunni,1580,shaman,elemental,88,46,42
42431,Baarona,neptulon,1577,shaman,elemental,51,30,21
42432,Headthirst,ragnaros,1576,shaman,elemental,44,24,20
42433,Anøüchkä,ysondre,1575,shaman,elemental,48,24,24
42434,Shibol,ravencrest,1575,shaman,elemental,61,29,32
42435,Brugdar,tarren-mill,1574,shaman,elemental,30,22,8
42436,Shammyammy,tarren-mill,1574,shaman,elemental,111,61,50
42437,Twiva,silvermoon,1572,shaman,elemental,76,45,31
42438,Blízzilassø,malygos,1572,shaman,elemental,179,93,86
42439,Ezala,blackhand,1571,shaman,elemental,48,26,22
42440,Гивми,blackscar,1567,shaman,elemental,40,21,19
42441,Тмх,ashenvale,1566,shaman,elemental,94,52,42
42442,Qwilfish,blackmoore,1566,shaman,elemental,65,34,31
42443,Valunii,lordaeron,1566,shaman,elemental,279,136,143
42444,Fakehex,blackrock,1565,shaman,elemental,59,32,27
42445,Robofat,ravencrest,1564,shaman,elemental,36,21,15
42446,Magnetoe,ravencrest,1564,shaman,elemental,105,57,48
42447,Тессельхоф,howling-fjord,1564,shaman,elemental,46,23,23
42448,Naorgot,uldaman,1563,shaman,elemental,138,61,77
42449,Ласара,eversong,1562,shaman,elemental,48,22,26
42450,Grende,sylvanas,1561,shaman,elemental,63,35,28
42451,Òoòoòoòoòoòo,silvermoon,1559,shaman,elemental,54,24,30
42452,Harod,suramar,1558,shaman,elemental,72,37,35
42453,Hapkin,defias-brotherhood,1558,shaman,elemental,54,27,27
42454,Ринфан,fordragon,1558,shaman,elemental,40,20,20
42455,Canjo,aegwynn,1557,shaman,elemental,69,36,33
42456,Chinozukems,sanguino,1555,shaman,elemental,54,27,27
42457,Jímmy,frostwhisper,1548,shaman,elemental,54,34,20
42458,Fattmorte,hyjal,1547,shaman,elemental,27,19,8
42459,Waaghbozz,eredar,1547,shaman,elemental,66,38,28
42460,Nachtary,blackmoore,1544,shaman,elemental,59,32,27
42461,Incredibade,stormscale,1542,shaman,elemental,36,20,16
42462,Acces,stormscale,1541,shaman,elemental,36,23,13
42463,Batan,kazzak,1535,shaman,elemental,71,31,40
42464,Дестройбэйби,gordunni,1533,shaman,elemental,102,58,44
42465,Zimtmann,teldrassil,1521,shaman,elemental,36,22,14
42466,Cloony,khaz-modan,1519,shaman,elemental,33,21,12
42467,Máui,korgall,1518,shaman,elemental,96,49,47
42468,Fúth,ysondre,1516,shaman,elemental,64,34,30
42469,Zna,archimonde,1513,shaman,elemental,94,48,46
42470,Касикандрэра,soulflayer,1512,shaman,elemental,284,148,136
42471,Belsazar,frostwolf,1511,shaman,elemental,48,20,28
42472,Тыщатристах,howling-fjord,1505,shaman,elemental,56,38,18
42473,Sgf,stormscale,1504,shaman,elemental,65,36,29
42474,Crysenshocks,blackrock,1504,shaman,elemental,60,30,30
42475,Diaba,sylvanas,1499,shaman,elemental,30,16,14
42476,Cracklord,outland,1496,shaman,elemental,36,21,15
42477,Naturexz,silvermoon,1495,shaman,elemental,32,18,14
42478,Gorpdorp,ravencrest,1491,shaman,elemental,183,97,86
42479,Voltyum,zuljin,1490,shaman,elemental,93,38,55
42480,Думсия,gordunni,1489,shaman,elemental,48,23,25
42481,Thebomber,guldan,1488,shaman,elemental,48,17,31
42482,Sniffix,ysondre,1482,shaman,elemental,139,68,71
42483,Rennji,argent-dawn,1482,shaman,elemental,84,40,44
42484,Haasshaman,ravencrest,1480,shaman,elemental,121,50,71
42485,Thazra,zirkel-des-cenarius,1478,shaman,elemental,47,24,23
42486,Shaakez,kazzak,1476,shaman,elemental,35,17,18
42487,Mö,ragnaros,1473,shaman,elemental,189,104,85
42488,Oldaang,ravencrest,1470,shaman,elemental,30,23,7
42489,Ralokar,blackrock,1465,shaman,elemental,48,25,23
42490,Хэйзл,ashenvale,1463,shaman,elemental,74,39,35
42491,Yang,der-rat-von-dalaran,1462,shaman,elemental,30,19,11
42492,Pórçé,shattered-hand,1462,shaman,elemental,149,80,69
42493,Smort,frostwolf,1462,shaman,elemental,36,17,19
42494,Dzielnysham,silvermoon,1461,shaman,elemental,32,19,13
42495,Vulcainn,marécage-de-zangar,1460,shaman,elemental,105,68,37
42496,Bigrambo,draenor,1460,shaman,elemental,41,20,21
42497,Faydasizsham,twisting-nether,1459,shaman,elemental,62,33,29
42498,Teccatwo,outland,1458,shaman,elemental,52,28,24
42499,Гексанол,soulflayer,1457,shaman,elemental,58,30,28
42500,Шамвкроксах,gordunni,1456,shaman,elemental,36,19,17
42501,Grimtol,magtheridon,1455,shaman,elemental,47,20,27
42502,Mikecrybaby,tarren-mill,1454,shaman,elemental,36,16,20
42503,Alwaysangry,silvermoon,1453,shaman,elemental,84,41,43
42504,Fotmglad,blackrock,1452,shaman,elemental,34,16,18
42505,Томёрк,gordunni,1448,shaman,elemental,118,55,63
42506,Dawzed,hyjal,1443,shaman,elemental,36,21,15
42507,Lizoo,ravencrest,1439,shaman,elemental,18,15,3
42508,Hemradi,blackmoore,1438,shaman,elemental,48,28,20
42509,Flubberman,blackrock,1438,shaman,elemental,51,28,23
42510,Экслайнер,deathweaver,1438,shaman,elemental,47,19,28
42511,Thëtis,chogall,1434,shaman,elemental,28,16,12
42512,Ædshearan,blackmoore,1434,shaman,elemental,60,30,30
42513,Tukino,burning-legion,1433,shaman,elemental,24,15,9
42514,Ашьф,gordunni,1433,shaman,elemental,39,17,22
42515,Anubisll,hyjal,1431,shaman,elemental,46,24,22
42516,Chøurøx,hyjal,1430,shaman,elemental,49,30,19
42517,Rekhtar,burning-legion,1430,shaman,elemental,145,81,64
42518,Skrbkic,tarren-mill,1429,shaman,elemental,91,48,43
42519,Lêmberger,eredar,1429,shaman,elemental,42,22,20
42520,Amanishama,twisting-nether,1426,shaman,elemental,84,46,38
42521,Aspên,archimonde,1426,shaman,elemental,30,15,15
42522,Тагтар,howling-fjord,1426,shaman,elemental,45,19,26
42523,Lafia,blackrock,1425,shaman,elemental,90,36,54
42524,Aylar,zenedar,1424,shaman,elemental,24,15,9
42525,Ulfuz,silvermoon,1424,shaman,elemental,28,17,11
42526,Ríleyx,twisting-nether,1423,shaman,elemental,83,53,30
42527,Ogkûshgödx,sylvanas,1423,shaman,elemental,24,15,9
42528,Alèks,forscherliga,1418,shaman,elemental,107,62,45
42529,Лартисс,howling-fjord,1417,shaman,elemental,30,15,15
42530,Elexuz,blackrock,1416,shaman,elemental,24,15,9
42531,Xesti,twisting-nether,1414,shaman,elemental,75,39,36
42532,Shôcopan,los-errantes,1412,shaman,elemental,61,24,37
42533,Elemefayo,outland,1410,shaman,elemental,54,28,26
42534,Tvådje,silvermoon,1407,shaman,elemental,29,16,13
42535,Gensehaut,aegwynn,1407,shaman,elemental,48,22,26
42536,Ulfax,argent-dawn,1401,shaman,elemental,66,27,39
42537,Støya,archimonde,1400,shaman,elemental,48,18,30
42538,Athul,theradras,1399,shaman,elemental,49,24,25
42539,Ðãvê,veknilash,1399,shaman,elemental,42,17,25
42540,Kimpa,minahonda,1393,shaman,elemental,78,44,34
42541,Torouk,rashgarroth,1393,shaman,elemental,30,16,14
42542,Rharhahra,archimonde,1393,shaman,elemental,66,23,43
42543,Coñfrico,tarren-mill,1391,shaman,elemental,48,22,26
42544,Сепич,gordunni,1389,shaman,elemental,54,32,22
42545,Apolomaeuz,frostwolf,1388,shaman,elemental,83,45,38
42546,Couldar,stormscale,1386,shaman,elemental,42,23,19
42547,Kirak,anetheron,1385,shaman,elemental,177,90,87
42548,Spruehkot,aegwynn,1382,shaman,elemental,27,16,11
42549,Furrymane,blackmoore,1382,shaman,elemental,51,27,24
42550,Whome,aegwynn,1377,shaman,elemental,42,22,20
42551,Rohknar,ragnaros,1374,shaman,elemental,30,17,13
42552,Superkee,kazzak,1374,shaman,elemental,203,111,92
42553,Novka,eredar,1374,shaman,elemental,47,22,25
42554,Carusø,thrall,1373,shaman,elemental,61,39,22
42555,Alfang,turalyon,1373,shaman,elemental,81,38,43
42556,Vladraxes,draenor,1372,shaman,elemental,30,20,10
42557,Xhahal,hyjal,1364,shaman,elemental,30,21,9
42558,Teslasenpai,outland,1361,shaman,elemental,48,16,32
42559,Lavabelly,twisting-nether,1359,shaman,elemental,42,16,26
42560,Sojee,ysondre,1356,shaman,elemental,48,21,27
42561,Urinja,outland,1354,shaman,elemental,36,20,16
42562,Yezu,medivh,1354,shaman,elemental,60,28,32
42563,Raigetsu,kazzak,1352,shaman,elemental,56,31,25
42564,Sunraiser,blackmoore,1349,shaman,elemental,67,36,31
42565,Rawside,thrall,1349,shaman,elemental,34,16,18
42566,Руннольв,galakrond,1347,shaman,elemental,36,17,19
42567,Tempest,kul-tiras,1346,shaman,elemental,41,23,18
42568,Blancc,kazzak,1346,shaman,elemental,84,47,37
42569,Bangou,archimonde,1344,shaman,elemental,79,38,41
42570,Tâsty,blackmoore,1343,shaman,elemental,24,14,10
42571,Volhalo,blackmoore,1343,shaman,elemental,24,14,10
42572,Шутках,gordunni,1343,shaman,elemental,30,14,16
42573,Херург,soulflayer,1342,shaman,elemental,30,14,16
42574,Iraterrørist,kazzak,1340,shaman,elemental,30,14,16
42575,Флоррэт,gordunni,1338,shaman,elemental,126,57,69
42576,Sshaasam,tarren-mill,1337,shaman,elemental,24,14,10
42577,Альтегро,blackscar,1337,shaman,elemental,55,29,26
42578,Bâllz,anetheron,1335,shaman,elemental,135,64,71
42579,Fâro,dun-modr,1335,shaman,elemental,41,18,23
42580,Rakzhaza,blackmoore,1331,shaman,elemental,42,20,22
42581,Saqerr,kazzak,1330,shaman,elemental,53,20,33
42582,Крто,thermaplugg,1329,shaman,elemental,161,87,74
42583,Olawizard,draenor,1328,shaman,elemental,49,22,27
42584,Nerekiclej,ravencrest,1327,shaman,elemental,47,23,24
42585,Voymir,kazzak,1323,shaman,elemental,24,15,9
42586,Screwz,archimonde,1322,shaman,elemental,79,38,41
42587,Faeldar,sanguino,1318,shaman,elemental,30,14,16
42588,Талиесин,grom,1317,shaman,elemental,32,19,13
42589,Краоми,soulflayer,1312,shaman,elemental,24,15,9
42590,Nolawii,ragnaros,1312,shaman,elemental,24,14,10
42591,Navyblue,sylvanas,1311,shaman,elemental,30,14,16
42592,Doneteasy,blackrock,1310,shaman,elemental,52,24,28
42593,Сосмыслом,howling-fjord,1310,shaman,elemental,48,20,28
42594,Lavastriker,archimonde,1307,shaman,elemental,36,18,18
42595,Pakwa,drakthul,1306,shaman,elemental,34,15,19
42596,Klicken,tarren-mill,1302,shaman,elemental,23,14,9
42597,Lavamann,blackmoore,1295,shaman,elemental,42,20,22
42598,Enamo,blackrock,1293,shaman,elemental,23,14,9
42599,Elshifotrem,throkferoth,1293,shaman,elemental,58,31,27
42600,Dropdattotem,stormscale,1292,shaman,elemental,54,23,31
42601,Griins,ravencrest,1289,shaman,elemental,36,20,16
42602,Hatyatya,ragnaros,1284,shaman,elemental,30,16,14
42603,Snusyy,ravencrest,1279,shaman,elemental,26,14,12
42604,Xfiles,garona,1278,shaman,elemental,48,24,24
42605,Onlyfansmod,uldum,1278,shaman,elemental,65,28,37
42606,Tiqle,blackmoore,1277,shaman,elemental,65,31,34
42607,Ankzul,exodar,1273,shaman,elemental,62,24,38
42608,Destructør,norgannon,1268,shaman,elemental,42,20,22
42609,Dëlkö,ravencrest,1267,shaman,elemental,80,37,43
42610,Lechirurgien,elune,1264,shaman,elemental,159,79,80
42611,Zbysiu,ravencrest,1258,shaman,elemental,51,28,23
42612,Élémentyum,archimonde,1258,shaman,elemental,66,28,38
42613,Leash,blackmoore,1257,shaman,elemental,30,14,16
42614,Zapper,blackrock,1256,shaman,elemental,36,15,21
42615,Zanyun,burning-legion,1256,shaman,elemental,38,14,24
42616,Цет,soulflayer,1255,shaman,elemental,23,15,8
42617,Mynutz,outland,1255,shaman,elemental,54,18,36
42618,Noyá,argent-dawn,1252,shaman,elemental,57,27,30
42619,Blackyx,dun-modr,1247,shaman,elemental,18,13,5
42620,Сарцек,howling-fjord,1247,shaman,elemental,60,35,25
42621,Plazmorc,stormscale,1247,shaman,elemental,24,13,11
42622,Bloodseeker,tarren-mill,1247,shaman,elemental,24,13,11
42623,Shiranoye,blackrock,1247,shaman,elemental,30,13,17
42624,Blush,blackhand,1247,shaman,elemental,33,14,19
42625,Rolftheswine,defias-brotherhood,1246,shaman,elemental,18,13,5
42626,Ludo,lothar,1246,shaman,elemental,22,14,8
42627,Kelvok,silvermoon,1246,shaman,elemental,24,13,11
42628,Xiomora,argent-dawn,1246,shaman,elemental,27,14,13
42629,Quizx,blackrock,1245,shaman,elemental,60,25,35
42630,Fullavaids,grim-batol,1243,shaman,elemental,24,13,11
42631,Xereús,kazzak,1243,shaman,elemental,34,14,20
42632,Maggoshishi,blackmoore,1242,shaman,elemental,126,65,61
42633,Djogg,sunstrider,1241,shaman,elemental,30,13,17
42634,Gagné,hyjal,1239,shaman,elemental,24,13,11
42635,Pawsh,dun-modr,1238,shaman,elemental,51,24,27
42636,Makgoa,ysondre,1237,shaman,elemental,18,13,5
42637,Лукаджун,howling-fjord,1231,shaman,elemental,18,13,5
42638,Denadrios,blackhand,1228,shaman,elemental,82,34,48
42639,Sniffa,ysondre,1226,shaman,elemental,30,16,14
42640,Бумбумпаузр,borean-tundra,1226,shaman,elemental,42,13,29
42641,Bigheal,quelthalas,1222,shaman,elemental,30,13,17
42642,Shamíz,draenor,1219,shaman,elemental,36,21,15
42643,Waterboi,blackmoore,1219,shaman,elemental,24,13,11
42644,Aldonatello,blackrock,1219,shaman,elemental,82,40,42
42645,Foxxyluv,stormscale,1215,shaman,elemental,20,14,6
42646,Tiamât,culte-de-la-rive-noire,1215,shaman,elemental,66,34,32
42647,Champïx,archimonde,1212,shaman,elemental,51,16,35
42648,Tehpielover,bladefist,1211,shaman,elemental,28,15,13
42649,Меменосный,gordunni,1211,shaman,elemental,42,20,22
42650,Saarroo,ravencrest,1210,shaman,elemental,48,22,26
42651,Skeiilz,hyjal,1208,shaman,elemental,36,13,23
42652,Roxìe,blackmoore,1207,shaman,elemental,18,13,5
42653,Bigboisham,outland,1202,shaman,elemental,65,28,37
42654,Shamanns,lordaeron,1198,shaman,elemental,60,19,41
42655,Pvpshaman,aszune,1195,shaman,elemental,29,13,16
42656,Märthalouise,twisting-nether,1191,shaman,elemental,29,15,14
42657,Scot,blackhand,1191,shaman,elemental,29,13,16
42658,Charliiejoh,stormscale,1190,shaman,elemental,86,39,47
42659,Valdera,dun-morogh,1189,shaman,elemental,24,14,10
42660,Magath,nethersturm,1188,shaman,elemental,36,17,19
42661,Chispa,darkmoon-faire,1187,shaman,elemental,23,13,10
42662,Zalitz,sanguino,1186,shaman,elemental,24,13,11
42663,Mòra,silvermoon,1183,shaman,elemental,68,32,36
42664,Boiblaster,argent-dawn,1182,shaman,elemental,17,13,4
42665,Zerodown,outland,1181,shaman,elemental,84,38,46
42666,Scurvy,malganis,1179,shaman,elemental,128,66,62
42667,Amarök,nerzhul,1177,shaman,elemental,65,30,35
42668,Blackmuamba,tarren-mill,1173,shaman,elemental,120,60,60
42669,Szvapotluk,ravencrest,1173,shaman,elemental,30,14,16
42670,Nabo,archimonde,1173,shaman,elemental,32,13,19
42671,Kungfuali,antonidas,1168,shaman,elemental,34,14,20
42672,Zhinjo,kazzak,1166,shaman,elemental,36,19,17
42673,Фистинктотем,soulflayer,1162,shaman,elemental,35,16,19
42674,Амброски,gordunni,1161,shaman,elemental,42,28,14
42675,Велгур,soulflayer,1161,shaman,elemental,50,23,27
42676,Эфирад,blackscar,1157,shaman,elemental,133,64,69
42677,Shellex,kazzak,1153,shaman,elemental,74,40,34
42678,Azmerloth,outland,1152,shaman,elemental,18,12,6
42679,Luchø,drakthul,1151,shaman,elemental,18,12,6
42680,Дудивтф,soulflayer,1151,shaman,elemental,24,12,12
42681,Neverplayele,kazzak,1151,shaman,elemental,24,12,12
42682,Nobrac,rajaxx,1150,shaman,elemental,24,12,12
42683,Stromdi,azshara,1149,shaman,elemental,22,13,9
42684,Haarold,sylvanas,1149,shaman,elemental,24,12,12
42685,Gojõ,dun-modr,1149,shaman,elemental,30,12,18
42686,Justweirdaf,blackmoore,1148,shaman,elemental,45,20,25
42687,Eðualc,hyjal,1147,shaman,elemental,18,12,6
42688,Legended,tarren-mill,1147,shaman,elemental,24,12,12
42689,Beefnale,bladefist,1147,shaman,elemental,42,14,28
42690,Дзод,deathweaver,1146,shaman,elemental,24,12,12
42691,Дваллинн,gordunni,1142,shaman,elemental,30,12,18
42692,Unding,azshara,1138,shaman,elemental,42,12,30
42693,Boxo,frostwolf,1137,shaman,elemental,70,38,32
42694,Bahuq,antonidas,1134,shaman,elemental,18,12,6
42695,Djent,outland,1133,shaman,elemental,24,12,12
42696,Смоуктли,howling-fjord,1125,shaman,elemental,24,12,12
42697,Bowtenstorm,ravencrest,1120,shaman,elemental,25,16,9
42698,Peaksh,stormscale,1118,shaman,elemental,30,12,18
42699,Mohàwk,eredar,1114,shaman,elemental,36,17,19
42700,Homesickx,blackrock,1109,shaman,elemental,23,12,11
42701,Gnark,dun-modr,1105,shaman,elemental,59,32,27
42702,Бвансамдив,gordunni,1093,shaman,elemental,54,24,30
42703,Озверею,goldrinn,1090,shaman,elemental,24,14,10
42704,Kneggebrot,blackmoore,1090,shaman,elemental,27,13,14
42705,Jagblade,neptulon,1089,shaman,elemental,46,23,23
42706,Pedrototem,silvermoon,1071,shaman,elemental,30,19,11
42707,Fàkecast,outland,1064,shaman,elemental,34,12,22
42708,Cleandann,stormscale,1063,shaman,elemental,27,12,15
42709,Procdaddy,eredar,1063,shaman,elemental,56,15,41
42710,Nïà,kaelthas,1062,shaman,elemental,38,15,23
42711,Thunderrbob,darkspear,1059,shaman,elemental,24,14,10
42712,Trixxsham,twisting-nether,1056,shaman,elemental,18,11,7
42713,Dòrfy,silvermoon,1056,shaman,elemental,18,11,7
42714,Replicusele,doomhammer,1056,shaman,elemental,18,11,7
42715,Tornado,ravencrest,1056,shaman,elemental,18,11,7
42716,Øwlïshâm,archimonde,1056,shaman,elemental,18,11,7
42717,Garythos,drakthul,1056,shaman,elemental,18,11,7
42718,Loserlol,das-syndikat,1056,shaman,elemental,48,24,24
42719,Retuu,uldaman,1056,shaman,elemental,24,11,13
42720,Mehboul,hyjal,1055,shaman,elemental,24,11,13
42721,Sayokô,grim-batol,1055,shaman,elemental,24,11,13
42722,Furthehorde,frostmane,1054,shaman,elemental,18,11,7
42723,Wlãdoo,archimonde,1054,shaman,elemental,18,11,7
42724,Yraxara,draenor,1053,shaman,elemental,18,11,7
42725,Èrò,blackhand,1053,shaman,elemental,24,11,13
42726,Manaphi,arthas,1052,shaman,elemental,24,11,13
42727,Elkyrie,alakir,1052,shaman,elemental,24,11,13
42728,Whizjy,sanguino,1051,shaman,elemental,18,11,7
42729,Tiji,eredar,1051,shaman,elemental,19,11,8
42730,Chrached,kargath,1051,shaman,elemental,24,11,13
42731,Louler,ragnaros,1049,shaman,elemental,24,11,13
42732,Kylas,die-ewige-wacht,1047,shaman,elemental,18,11,7
42733,Hugzy,argent-dawn,1046,shaman,elemental,53,31,22
42734,Eleurii,burning-blade,1046,shaman,elemental,36,11,25
42735,Эртирон,howling-fjord,1044,shaman,elemental,24,11,13
42736,Tpainx,kazzak,1043,shaman,elemental,24,11,13
42737,Djbruggìe,bloodhoof,1043,shaman,elemental,30,11,19
42738,Дрекрош,howling-fjord,1042,shaman,elemental,91,36,55
42739,Totempoo,the-maelstrom,1041,shaman,elemental,18,11,7
42740,Ananasen,eonar,1041,shaman,elemental,24,11,13
42741,Kapplos,gorgonnash,1039,shaman,elemental,23,11,12
42742,Thrallotido,sanguino,1037,shaman,elemental,36,11,25
42743,Laquium,blackmoore,1032,shaman,elemental,37,15,22
42744,Oddsocks,stormscale,1032,shaman,elemental,61,21,40
42745,Ormanthep,hyjal,1029,shaman,elemental,18,11,7
42746,Flochy,argent-dawn,1027,shaman,elemental,53,31,22
42747,Zjindi,shattered-hand,1027,shaman,elemental,24,11,13
42748,Jumbototem,tarren-mill,1026,shaman,elemental,18,11,7
42749,Avarela,argent-dawn,1023,shaman,elemental,42,12,30
42750,Thunderstryk,sylvanas,1021,shaman,elemental,60,30,30
42751,Treizelol,ysondre,1014,shaman,elemental,24,11,13
42752,Goromar,kirin-tor,1012,shaman,elemental,91,36,55
42753,Ximid,doomhammer,1008,shaman,elemental,170,85,85
42754,Магмарончик,gordunni,1005,shaman,elemental,66,23,43
42755,Demelena,silvermoon,1003,shaman,elemental,18,11,7
42756,Ragnadim,silvermoon,1003,shaman,elemental,30,11,19
42757,Bluéshirtguy,blackhand,994,shaman,elemental,48,22,26
42758,Kobeye,thrall,982,shaman,elemental,58,31,27
42759,Thatamazing,korgall,979,shaman,elemental,32,15,17
42760,Pararrayøs,sanguino,975,shaman,elemental,29,11,18
42761,Aslakki,turalyon,975,shaman,elemental,42,11,31
42762,Dðt,stormscale,973,shaman,elemental,41,17,24
42763,Lavadrak,eredar,960,shaman,elemental,12,10,2
42764,Elemayó,tarren-mill,960,shaman,elemental,18,10,8
42765,Strór,twisting-nether,960,shaman,elemental,18,10,8
42766,Dshaman,aegwynn,960,shaman,elemental,24,10,14
42767,Theodorix,silvermoon,960,shaman,elemental,24,10,14
42768,Dumpaman,frostmane,959,shaman,elemental,18,10,8
42769,Biccon,silvermoon,959,shaman,elemental,18,10,8
42770,Namè,kazzak,959,shaman,elemental,18,10,8
42771,Akukuu,kazzak,959,shaman,elemental,24,10,14
42772,Blover,drakthul,958,shaman,elemental,12,10,2
42773,Trastamar,dun-modr,958,shaman,elemental,12,10,2
42774,Rokils,silvermoon,958,shaman,elemental,18,10,8
42775,Rockstéady,outland,958,shaman,elemental,18,10,8
42776,Naathir,magtheridon,958,shaman,elemental,18,10,8
42777,Kønat,blackmoore,958,shaman,elemental,24,10,14
42778,Леланай,blackscar,958,shaman,elemental,24,10,14
42779,Minasa,saurfang,958,shaman,elemental,30,10,20
42780,Raïgo,hyjal,957,shaman,elemental,18,10,8
42781,Jazzrod,stormscale,957,shaman,elemental,24,10,14
42782,Atuaßëlha,grim-batol,957,shaman,elemental,24,10,14
42783,Elevlach,drakthul,957,shaman,elemental,30,10,20
42784,Гидрокорыто,gordunni,956,shaman,elemental,18,10,8
42785,Klunkespiser,stormscale,955,shaman,elemental,24,10,14
42786,Dando,silvermoon,952,shaman,elemental,24,10,14
42787,Unangemessen,silvermoon,951,shaman,elemental,18,10,8
42788,Джанндис,booty-bay,951,shaman,elemental,24,10,14
42789,Chilliajin,tarren-mill,950,shaman,elemental,24,10,14
42790,Babathar,ysondre,949,shaman,elemental,24,10,14
42791,Eustodia,minahonda,948,shaman,elemental,12,10,2
42792,Блэкмаршал,howling-fjord,948,shaman,elemental,30,10,20
42793,Ххенеси,soulflayer,947,shaman,elemental,24,10,14
42794,Камам,gordunni,947,shaman,elemental,30,10,20
42795,Шейпан,gordunni,940,shaman,elemental,42,20,22
42796,Smorcxx,kazzak,934,shaman,elemental,30,10,20
42797,Orishimaru,blackrock,932,shaman,elemental,23,10,13
42798,Kiirø,ysondre,929,shaman,elemental,18,10,8
42799,Kortgat,kilrogg,924,shaman,elemental,48,23,25
42800,Федосик,galakrond,922,shaman,elemental,36,15,21
42801,Lavalampa,magtheridon,920,shaman,elemental,18,10,8
42802,Шоу,gordunni,906,shaman,elemental,27,11,16
42803,Monstermunch,ravencrest,903,shaman,elemental,34,11,23
42804,Lokasakke,tarren-mill,895,shaman,elemental,14,10,4
42805,Lighttfeet,hyjal,864,shaman,elemental,12,9,3
42806,Jeelypink,dalaran,864,shaman,elemental,12,9,3
42807,Captaînhuge,dunemaul,864,shaman,elemental,12,9,3
42808,Dwarfracial,blackrock,864,shaman,elemental,12,9,3
42809,ßaraky,kazzak,864,shaman,elemental,12,9,3
42810,Elvalya,archimonde,864,shaman,elemental,18,9,9
42811,Kwanah,kaelthas,864,shaman,elemental,18,9,9
42812,Suntaria,stormscale,864,shaman,elemental,18,9,9
42813,Terobux,culte-de-la-rive-noire,864,shaman,elemental,24,9,15
42814,Nitronigi,malganis,864,shaman,elemental,24,9,15
42815,Krahg,garona,863,shaman,elemental,16,10,6
42816,Blastersondy,outland,863,shaman,elemental,18,9,9
42817,Luzzilol,garrosh,863,shaman,elemental,18,9,9
42818,Dûmah,sanguino,863,shaman,elemental,25,10,15
42819,Pomegranate,arthas,863,shaman,elemental,24,9,15
42820,Pvegame,tarren-mill,863,shaman,elemental,24,9,15
42821,Healocalypse,azuremyst,862,shaman,elemental,12,9,3
42822,Gomoth,kazzak,862,shaman,elemental,18,9,9
42823,Рэйвантотем,soulflayer,862,shaman,elemental,18,9,9
42824,Shkook,archimonde,862,shaman,elemental,24,9,15
42825,Bunnz,kazzak,861,shaman,elemental,12,9,3
42826,Drækthør,thrall,860,shaman,elemental,19,11,8
42827,Штормбайт,azuregos,858,shaman,elemental,12,9,3
42828,Naix,silvermoon,858,shaman,elemental,24,9,15
42829,Бронзород,grom,840,shaman,elemental,12,9,3
42830,Незнаком,booty-bay,811,shaman,elemental,30,12,18
42831,Lavaburstx,antonidas,810,shaman,elemental,28,10,18
42832,Holdafstand,tarren-mill,798,shaman,elemental,14,9,5
42833,Pappashaman,tarren-mill,768,shaman,elemental,10,9,1
42834,Jåime,ravencrest,768,shaman,elemental,12,8,4
42835,Grapefruit,blackmoore,768,shaman,elemental,12,8,4
42836,Visboer,stormscale,768,shaman,elemental,12,8,4
42837,Vygak,tarren-mill,768,shaman,elemental,12,8,4
42838,Flam,outland,768,shaman,elemental,12,8,4
42839,Wátermélon,stormscale,768,shaman,elemental,12,8,4
42840,Rokils,tarren-mill,768,shaman,elemental,12,8,4
42841,Palpazerr,archimonde,768,shaman,elemental,12,8,4
42842,Atiix,eredar,768,shaman,elemental,12,8,4
42843,Pieski,stormscale,768,shaman,elemental,12,8,4
42844,Windspêaker,outland,768,shaman,elemental,18,8,10
42845,Kronoxd,tarren-mill,768,shaman,elemental,18,8,10
42846,Thundergødx,nemesis,768,shaman,elemental,18,8,10
42847,Totemly,alakir,768,shaman,elemental,18,8,10
42848,Nerdshockz,blackhand,768,shaman,elemental,18,8,10
42849,Breezzkingg,twisting-nether,768,shaman,elemental,18,8,10
42850,Lathisi,zenedar,768,shaman,elemental,19,8,11
42851,Thorunir,sylvanas,768,shaman,elemental,24,8,16
42852,Hobblefoot,stormscale,767,shaman,elemental,12,8,4
42853,Brassefrasse,shattered-hand,767,shaman,elemental,12,8,4
42854,Bourdieu,thrall,767,shaman,elemental,12,8,4
42855,Sinirli,ravencrest,767,shaman,elemental,18,8,10
42856,Beven,stormscale,767,shaman,elemental,18,8,10
42857,Freizeitler,antonidas,767,shaman,elemental,18,8,10
42858,Gaerth,aggramar,766,shaman,elemental,12,8,4
42859,Runetera,ravencrest,765,shaman,elemental,12,8,4
42860,Grambozz,blackrock,765,shaman,elemental,12,8,4
42861,Umbraverfaa,twisting-nether,765,shaman,elemental,12,8,4
42862,Parthon,ravencrest,765,shaman,elemental,12,8,4
42863,Формацепт,ashenvale,763,shaman,elemental,24,8,16
42864,Zham,kul-tiras,763,shaman,elemental,30,8,22
42865,Itsnasty,blackmoore,753,shaman,elemental,18,8,10
42866,Arabesk,arygos,748,shaman,elemental,23,8,15
42867,Соленый,booty-bay,744,shaman,elemental,110,45,65
42868,Wacomtablet,kazzak,703,shaman,elemental,11,8,3
42869,Baschúrr,blackrock,702,shaman,elemental,17,9,8
42870,Шиока,borean-tundra,685,shaman,elemental,13,9,4
42871,Dócshock,blackmoore,672,shaman,elemental,12,7,5
42872,Dynamodanny,blackmoore,672,shaman,elemental,12,7,5
42873,Hekzen,tarren-mill,672,shaman,elemental,12,7,5
42874,Reburdacoxis,sanguino,672,shaman,elemental,12,7,5
42875,Guccifootjob,defias-brotherhood,672,shaman,elemental,12,7,5
42876,Rokils,ravencrest,672,shaman,elemental,12,7,5
42877,Cuddleball,moonglade,672,shaman,elemental,12,7,5
42878,Eneru,nemesis,672,shaman,elemental,12,7,5
42879,Labûche,chogall,672,shaman,elemental,12,7,5
42880,Wamah,sargeras,672,shaman,elemental,12,7,5
42881,Hanakokô,grim-batol,672,shaman,elemental,12,7,5
42882,Bigblué,tarren-mill,672,shaman,elemental,12,7,5
42883,Deepdamp,blackrock,672,shaman,elemental,12,7,5
42884,Preciousxo,auchindoun,672,shaman,elemental,12,7,5
42885,Kiirín,drakthul,672,shaman,elemental,12,7,5
42886,Bhargonen,silvermoon,672,shaman,elemental,12,7,5
42887,Shamandoino,wildhammer,672,shaman,elemental,12,7,5
42888,Шамвкроксах,howling-fjord,672,shaman,elemental,12,7,5
42889,Bosslikex,ravencrest,672,shaman,elemental,12,7,5
42890,Glibbins,sylvanas,672,shaman,elemental,12,7,5
42891,Ehlaina,outland,672,shaman,elemental,12,7,5
42892,Jehae,archimonde,672,shaman,elemental,12,7,5
42893,Isvk,ravencrest,672,shaman,elemental,12,7,5
42894,Гарбаджи,galakrond,672,shaman,elemental,12,7,5
42895,Koífish,ravencrest,672,shaman,elemental,12,7,5
42896,Kæde,dun-morogh,672,shaman,elemental,12,7,5
42897,Экспатриот,greymane,672,shaman,elemental,12,7,5
42898,Thordes,forscherliga,672,shaman,elemental,12,7,5
42899,Shammehboi,auchindoun,672,shaman,elemental,15,8,7
42900,Caro,tarren-mill,672,shaman,elemental,18,7,11
42901,Крушам,gordunni,672,shaman,elemental,18,7,11
42902,Velkin,thrall,672,shaman,elemental,18,7,11
42903,Боузета,soulflayer,672,shaman,elemental,18,7,11
42904,Турелька,blackscar,672,shaman,elemental,18,7,11
42905,Endry,elune,672,shaman,elemental,18,7,11
42906,Paidactor,kazzak,672,shaman,elemental,18,7,11
42907,Rexonaone,silvermoon,672,shaman,elemental,18,7,11
42908,Феномх,deathguard,671,shaman,elemental,12,7,5
42909,Ruvxy,twisting-nether,671,shaman,elemental,12,7,5
42910,Pandamoniumm,moonglade,671,shaman,elemental,12,7,5
42911,Zëngä,outland,671,shaman,elemental,12,7,5
42912,Dogfrog,silvermoon,671,shaman,elemental,18,7,11
42913,Drahka,kazzak,671,shaman,elemental,18,7,11
42914,Schockbunny,blackrock,671,shaman,elemental,18,7,11
42915,Рокутаро,gordunni,670,shaman,elemental,12,7,5
42916,Raoult,ravencrest,670,shaman,elemental,18,7,11
42917,Layonne,ysondre,670,shaman,elemental,18,7,11
42918,Fosterzz,ravencrest,668,shaman,elemental,21,8,13
42919,Coton,grim-batol,667,shaman,elemental,12,7,5
42920,Eratore,xavius,666,shaman,elemental,18,7,11
42921,Zarakuda,magtheridon,663,shaman,elemental,34,9,25
42922,Aljorf,dun-modr,662,shaman,elemental,12,7,5
42923,Watson,conseil-des-ombres,660,shaman,elemental,18,7,11
42924,Kíá,silvermoon,660,shaman,elemental,18,7,11
42925,Takkenuma,hyjal,640,shaman,elemental,22,7,15
42926,Ztraz,blackhand,639,shaman,elemental,8,8,0
42927,Blyátmán,twisting-nether,638,shaman,elemental,14,8,6
42928,Yalac,archimonde,637,shaman,elemental,14,8,6
42929,Айвимэдисон,howling-fjord,623,shaman,elemental,17,7,10
42930,Вудвин,soulflayer,621,shaman,elemental,26,7,19
42931,Easyplay,kazzak,607,shaman,elemental,14,7,7
42932,Wurstblinker,ravencrest,606,shaman,elemental,11,7,4
42933,Lavelover,tarren-mill,576,shaman,elemental,6,6,0
42934,Elfenomeno,archimonde,576,shaman,elemental,6,6,0
42935,Zimoneris,blackmoore,576,shaman,elemental,6,6,0
42936,Shayal,defias-brotherhood,576,shaman,elemental,12,6,6
42937,Jíkkz,aegwynn,576,shaman,elemental,12,6,6
42938,Лучшийшаман,soulflayer,576,shaman,elemental,12,6,6
42939,Ugáa,malganis,576,shaman,elemental,12,6,6
42940,Kärdyo,archimonde,576,shaman,elemental,12,6,6
42941,Totemkahmun,kazzak,576,shaman,elemental,12,6,6
42942,Vix,argent-dawn,576,shaman,elemental,12,6,6
42943,Electronova,magtheridon,576,shaman,elemental,12,6,6
42944,Eddiemorphin,kazzak,576,shaman,elemental,12,6,6
42945,Реалайзер,blackscar,576,shaman,elemental,12,6,6
42946,Fholst,draenor,576,shaman,elemental,12,6,6
42947,Localicious,ragnaros,576,shaman,elemental,12,6,6
42948,Шлолка,gordunni,576,shaman,elemental,12,6,6
42949,Yzeldan,hyjal,576,shaman,elemental,12,6,6
42950,Windfúhrèr,tarren-mill,576,shaman,elemental,12,6,6
42951,Forrak,argent-dawn,576,shaman,elemental,12,6,6
42952,Дагод,booty-bay,576,shaman,elemental,12,6,6
42953,Linshock,tarren-mill,576,shaman,elemental,12,6,6
42954,Simppe,stormreaver,576,shaman,elemental,12,6,6
42955,Zënga,kazzak,576,shaman,elemental,12,6,6
42956,Веег,deathweaver,576,shaman,elemental,12,6,6
42957,Хыйь,howling-fjord,576,shaman,elemental,18,6,12
42958,Inyra,eredar,576,shaman,elemental,18,6,12
42959,Тайорн,howling-fjord,576,shaman,elemental,18,6,12
42960,Dsgrc,tarren-mill,576,shaman,elemental,18,6,12
42961,Mûhzala,blackmoore,576,shaman,elemental,18,6,12
42962,Chenoyaa,blackrock,576,shaman,elemental,18,6,12
42963,Sheherezeday,aegwynn,576,shaman,elemental,18,6,12
42964,Krakatoa,dunemaul,576,shaman,elemental,24,6,18
42965,Shlby,blackrock,575,shaman,elemental,12,6,6
42966,Syndia,das-konsortium,575,shaman,elemental,12,6,6
42967,Dobär,madmortem,575,shaman,elemental,12,6,6
42968,Бурехлест,howling-fjord,575,shaman,elemental,12,6,6
42969,Helloitsmee,thrall,575,shaman,elemental,12,6,6
42970,Lampard,magtheridon,575,shaman,elemental,17,6,11
42971,Derblitz,baelgun,574,shaman,elemental,12,6,6
42972,Fimir,archimonde,573,shaman,elemental,12,6,6
42973,Zuman,the-maelstrom,573,shaman,elemental,12,6,6
42974,Louisvgaal,kazzak,572,shaman,elemental,12,6,6
42975,Attm,twisting-nether,570,shaman,elemental,20,10,10
42976,Encourager,daggerspine,568,shaman,elemental,12,6,6
42977,Disharmony,outland,554,shaman,elemental,17,8,9
42978,Isheartears,outland,543,shaman,elemental,11,6,5
42979,Trosy,burning-blade,540,shaman,elemental,14,7,7
42980,Rezervoir,bladefist,522,shaman,elemental,15,9,6
42981,Turbokrapka,tarren-mill,522,shaman,elemental,17,8,9
42982,Squixi,tarren-mill,480,shaman,elemental,6,5,1
42983,Shambulançe,silvermoon,480,shaman,elemental,6,5,1
42984,Minimalist,stormscale,480,shaman,elemental,6,5,1
42985,Rhonix,blackmoore,480,shaman,elemental,6,5,1
42986,Phobiatics,thrall,480,shaman,elemental,6,5,1
42987,Roskan,archimonde,480,shaman,elemental,6,5,1
42988,Twists,sylvanas,480,shaman,elemental,6,5,1
42989,Efdemin,blackmoore,480,shaman,elemental,6,5,1
42990,Shaggé,tarren-mill,480,shaman,elemental,6,5,1
42991,Zujaz,stormscale,480,shaman,elemental,6,5,1
42992,Plsdontpress,stormscale,480,shaman,elemental,6,5,1
42993,Hexina,ragnaros,480,shaman,elemental,6,5,1
42994,Jarreau,turalyon,480,shaman,elemental,6,5,1
42995,Ggnore,kazzak,480,shaman,elemental,6,5,1
42996,Тандерхх,howling-fjord,480,shaman,elemental,6,5,1
42997,Elemane,kazzak,480,shaman,elemental,6,5,1
42998,Highfaî,tarren-mill,480,shaman,elemental,6,5,1
42999,Izosha,hyjal,480,shaman,elemental,6,5,1
43000,Bumstead,ragnaros,480,shaman,elemental,6,5,1
43001,Lovelyshaman,silvermoon,480,shaman,elemental,7,5,2
43002,Утебяпожар,blackscar,480,shaman,elemental,12,5,7
43003,Végàs,ysondre,480,shaman,elemental,12,5,7
43004,Dregú,draenor,480,shaman,elemental,12,5,7
43005,Cptcutíe,antonidas,480,shaman,elemental,12,5,7
43006,Синнити,blackscar,480,shaman,elemental,12,5,7
43007,Rykarn,eredar,480,shaman,elemental,12,5,7
43008,Havoc,boulderfist,480,shaman,elemental,12,5,7
43009,Swapxy,outland,480,shaman,elemental,12,5,7
43010,Наладчик,gordunni,480,shaman,elemental,12,5,7
43011,Loshohealva,stormscale,480,shaman,elemental,12,5,7
43012,Amcin,stormreaver,480,shaman,elemental,12,5,7
43013,Cloovster,magtheridon,480,shaman,elemental,12,5,7
43014,Flaskmus,haomarush,480,shaman,elemental,12,5,7
43015,Skullføck,argent-dawn,480,shaman,elemental,12,5,7
43016,Stòrm,ravencrest,480,shaman,elemental,12,5,7
43017,Shockleted,stormscale,480,shaman,elemental,12,5,7
43018,Wûcs,silvermoon,480,shaman,elemental,12,5,7
43019,Raaborio,blackmoore,480,shaman,elemental,12,5,7
43020,Neystee,archimonde,480,shaman,elemental,12,5,7
43021,Bahane,frostwolf,480,shaman,elemental,15,6,9
43022,Talg,defias-brotherhood,480,shaman,elemental,15,5,10
43023,Clickerboy,ravencrest,480,shaman,elemental,18,5,13
43024,Квелси,gordunni,480,shaman,elemental,18,5,13
43025,Fûchsí,blackhand,479,shaman,elemental,6,5,1
43026,Apád,ragnaros,479,shaman,elemental,12,5,7
43027,Burnprof,nethersturm,479,shaman,elemental,12,5,7
43028,Zaappyboii,azjolnerub,479,shaman,elemental,20,5,15
43029,Sinwithin,ravencrest,478,shaman,elemental,12,5,7
43030,Rayitoss,tyrande,456,shaman,elemental,18,7,11
43031,Skengshammy,ragnaros,446,shaman,elemental,11,5,6
43032,Kbds,outland,431,shaman,elemental,11,5,6
43033,Charth,ravencrest,428,shaman,elemental,9,5,4
43034,Envergur,eitrigg,417,shaman,elemental,13,6,7
43035,Obêlixx,blackmoore,415,shaman,elemental,8,5,3
43036,Stoned,sporeggar,415,shaman,elemental,10,5,5
43037,Bèx,twisting-nether,400,shaman,elemental,13,5,8
43038,Blùé,tarren-mill,399,shaman,elemental,5,5,0
43039,Вашнюхтоптал,howling-fjord,384,shaman,elemental,6,4,2
43040,Yerlas,burning-legion,384,shaman,elemental,6,4,2
43041,Pvpmax,blackhand,384,shaman,elemental,6,4,2
43042,Jacc,sunstrider,384,shaman,elemental,6,4,2
43043,Euprathree,archimonde,384,shaman,elemental,6,4,2
43044,Shamurky,kazzak,384,shaman,elemental,6,4,2
43045,Greenswag,drakthul,384,shaman,elemental,6,4,2
43046,Trustlemac,onyxia,384,shaman,elemental,6,4,2
43047,Bkdgoodz,aegwynn,384,shaman,elemental,6,4,2
43048,Sebubu,twisting-nether,384,shaman,elemental,6,4,2
43049,Schamîx,blackrock,384,shaman,elemental,6,4,2
43050,Finpower,kul-tiras,384,shaman,elemental,6,4,2
43051,Xatis,aegwynn,384,shaman,elemental,6,4,2
43052,Thunderman,the-maelstrom,384,shaman,elemental,6,4,2
43053,Tóuka,uldum,384,shaman,elemental,6,4,2
43054,Kévinn,draenor,384,shaman,elemental,6,4,2
43055,Yacuzwerg,blackrock,384,shaman,elemental,6,4,2
43056,Zippidizap,ulduar,384,shaman,elemental,6,4,2
43057,Selonthyx,ravencrest,384,shaman,elemental,6,4,2
43058,Føxï,pozzo-delleternità,384,shaman,elemental,6,4,2
43059,Rahuna,darksorrow,384,shaman,elemental,6,4,2
43060,Chocshock,tarren-mill,384,shaman,elemental,6,4,2
43061,Shafallen,tarren-mill,384,shaman,elemental,6,4,2
43062,Kraksham,ravencrest,384,shaman,elemental,6,4,2
43063,Windberg,ysondre,384,shaman,elemental,6,4,2
43064,Teckan,tarren-mill,384,shaman,elemental,6,4,2
43065,Tonifo,nemesis,384,shaman,elemental,6,4,2
43066,Alëxx,hyjal,384,shaman,elemental,6,4,2
43067,Bumblebetuna,stormscale,384,shaman,elemental,6,4,2
43068,Hispanoxd,sanguino,384,shaman,elemental,6,4,2
43069,Апинсмок,soulflayer,384,shaman,elemental,12,4,8
43070,Cùn,blackmoore,384,shaman,elemental,12,4,8
43071,Rocktopus,outland,384,shaman,elemental,12,4,8
43072,Karissah,silvermoon,384,shaman,elemental,12,4,8
43073,Hí,bronzebeard,384,shaman,elemental,12,4,8
43074,Вензеро,howling-fjord,384,shaman,elemental,12,4,8
43075,Magicmekoz,draenor,384,shaman,elemental,12,4,8
43076,Rompelukt,auchindoun,384,shaman,elemental,12,4,8
43077,Jäck,ravencrest,384,shaman,elemental,12,4,8
43078,Swart,hyjal,384,shaman,elemental,12,4,8
43079,Réläx,kazzak,384,shaman,elemental,12,4,8
43080,Setac,stormscale,384,shaman,elemental,12,4,8
43081,Mawae,thrall,384,shaman,elemental,12,4,8
43082,Xyckas,terrordar,384,shaman,elemental,12,4,8
43083,Zoolza,kirin-tor,384,shaman,elemental,12,4,8
43084,Maruno,stormscale,384,shaman,elemental,12,4,8
43085,Tism,stormscale,384,shaman,elemental,12,4,8
43086,Stlakañ,chants-éternels,384,shaman,elemental,12,4,8
43087,Eskìmo,malganis,384,shaman,elemental,12,4,8
43088,Nùrsegemy,nemesis,384,shaman,elemental,12,4,8
43089,Totemtilda,tarren-mill,384,shaman,elemental,12,4,8
43090,Ogmehu,stormreaver,384,shaman,elemental,12,4,8
43091,Momine,stormscale,384,shaman,elemental,12,4,8
43092,Goitbate,azuremyst,384,shaman,elemental,12,4,8
43093,Kookaboo,blackrock,384,shaman,elemental,12,4,8
43094,Boomfanboy,tarren-mill,384,shaman,elemental,12,4,8
43095,Elothar,earthen-ring,384,shaman,elemental,12,4,8
43096,Saggrox,kazzak,384,shaman,elemental,12,4,8
43097,Snusy,stormscale,384,shaman,elemental,12,4,8
43098,Zandali,tarren-mill,383,shaman,elemental,6,4,2
43099,Zokah,emeriss,383,shaman,elemental,6,4,2
43100,Slk,blackrock,383,shaman,elemental,6,4,2
43101,Разодран,gordunni,383,shaman,elemental,6,4,2
43102,Dudoras,doomhammer,383,shaman,elemental,18,4,14
43103,Kennyo,uldum,379,shaman,elemental,12,4,8
43104,Santy,silvermoon,352,shaman,elemental,10,4,6
43105,Schamaster,antonidas,336,shaman,elemental,9,4,5
43106,Khalamity,ravencrest,330,shaman,elemental,14,6,8
43107,ßaßystärz,hyjal,319,shaman,elemental,5,4,1
43108,Gigawats,sylvanas,319,shaman,elemental,5,4,1
43109,Yasaburo,silvermoon,319,shaman,elemental,5,4,1
43110,Gravépàct,blackrock,288,shaman,elemental,6,3,3
43111,Symy,draenor,288,shaman,elemental,6,3,3
43112,Kaptt,twisting-nether,288,shaman,elemental,6,3,3
43113,Фарраон,deathguard,288,shaman,elemental,6,3,3
43114,Neirdae,thunderhorn,288,shaman,elemental,6,3,3
43115,Wilson,twisting-nether,288,shaman,elemental,6,3,3
43116,Dünnbier,blackhand,288,shaman,elemental,6,3,3
43117,Царьбер,soulflayer,288,shaman,elemental,6,3,3
43118,Тотемныйчад,gordunni,288,shaman,elemental,6,3,3
43119,Херургх,soulflayer,288,shaman,elemental,6,3,3
43120,Sëídhr,arathi,288,shaman,elemental,6,3,3
43121,Shamuzan,malfurion,288,shaman,elemental,6,3,3
43122,Peneapunta,nemesis,288,shaman,elemental,6,3,3
43123,Fufupartyxx,blackrock,288,shaman,elemental,6,3,3
43124,Penesecco,nemesis,288,shaman,elemental,6,3,3
43125,Энхай,azuregos,288,shaman,elemental,6,3,3
43126,Yashëa,ysondre,288,shaman,elemental,6,3,3
43127,Natureabuser,kazzak,288,shaman,elemental,6,3,3
43128,Bas,nagrand,288,shaman,elemental,6,3,3
43129,Фанковарнесы,gordunni,288,shaman,elemental,6,3,3
43130,Санрэйн,soulflayer,288,shaman,elemental,6,3,3
43131,Dagra,twisting-nether,288,shaman,elemental,6,3,3
43132,Exolnard,twisting-nether,288,shaman,elemental,6,3,3
43133,Hethne,kazzak,288,shaman,elemental,6,3,3
43134,Gissary,drakthul,288,shaman,elemental,6,3,3
43135,Whyisitspicy,kazzak,288,shaman,elemental,6,3,3
43136,Styxsm,blackhand,288,shaman,elemental,6,3,3
43137,Родохрозид,blackscar,288,shaman,elemental,6,3,3
43138,Ghettero,ragnaros,288,shaman,elemental,6,3,3
43139,Qenninka,drakthul,288,shaman,elemental,6,3,3
43140,Cloudborne,draenor,288,shaman,elemental,6,3,3
43141,Filigran,ragnaros,288,shaman,elemental,6,3,3
43142,Begeshaman,sylvanas,288,shaman,elemental,6,3,3
43143,Estexxsham,kazzak,288,shaman,elemental,6,3,3
43144,Lefita,drakthul,288,shaman,elemental,6,3,3
43145,Bharudor,antonidas,288,shaman,elemental,6,3,3
43146,Asiorr,silvermoon,288,shaman,elemental,6,3,3
43147,Shoewalker,ragnaros,288,shaman,elemental,6,3,3
43148,Nurychic,twisting-nether,288,shaman,elemental,6,3,3
43149,Shamanmans,grim-batol,288,shaman,elemental,6,3,3
43150,Oroastbeef,archimonde,288,shaman,elemental,6,3,3
43151,Dareos,anetheron,288,shaman,elemental,6,3,3
43152,Rhastafarian,stormscale,288,shaman,elemental,6,3,3
43153,Nightingäle,silvermoon,288,shaman,elemental,6,3,3
43154,Khaleeya,blackmoore,288,shaman,elemental,6,3,3
43155,Vukroth,argent-dawn,288,shaman,elemental,6,3,3
43156,Bammë,archimonde,288,shaman,elemental,6,3,3
43157,Whatsup,aggramar,288,shaman,elemental,6,3,3
43158,Another,hakkar,288,shaman,elemental,6,3,3
43159,Hotstorm,bronzebeard,288,shaman,elemental,6,3,3
43160,Susais,outland,288,shaman,elemental,6,3,3
43161,Shamanshow,eredar,288,shaman,elemental,6,3,3
43162,Tiâna,archimonde,288,shaman,elemental,6,3,3
43163,Joeyexe,outland,288,shaman,elemental,6,3,3
43164,Volvíc,tichondrius,288,shaman,elemental,6,3,3
43165,Brandbombe,frostwolf,288,shaman,elemental,6,3,3
43166,Kapristylez,outland,288,shaman,elemental,6,3,3
43167,Shaulic,ravencrest,288,shaman,elemental,6,3,3
43168,Mogzu,blackmoore,288,shaman,elemental,6,3,3
43169,Voodoodoouu,stormscale,288,shaman,elemental,6,3,3
43170,Disneyplus,tarren-mill,288,shaman,elemental,6,3,3
43171,Rokxa,burning-legion,288,shaman,elemental,6,3,3
43172,Weåfy,outland,288,shaman,elemental,6,3,3
43173,Peaktrim,tarren-mill,288,shaman,elemental,6,3,3
43174,Kónjo,kazzak,288,shaman,elemental,6,3,3
43175,Lunarsloth,hyjal,288,shaman,elemental,6,3,3
43176,Crysham,tarren-mill,288,shaman,elemental,6,3,3
43177,Pooch,archimonde,288,shaman,elemental,6,3,3
43178,Mjukiz,tarren-mill,288,shaman,elemental,6,3,3
43179,Amu,ravencrest,288,shaman,elemental,6,3,3
43180,Jinbao,ravencrest,288,shaman,elemental,6,3,3
43181,Putrìfy,ravencrest,288,shaman,elemental,6,3,3
43182,Sykx,hyjal,288,shaman,elemental,6,3,3
43183,Ironbuttrfly,magtheridon,288,shaman,elemental,6,3,3
43184,Beastee,blackmoore,288,shaman,elemental,6,3,3
43185,Faroh,ravencrest,288,shaman,elemental,6,3,3
43186,Terranator,sanguino,288,shaman,elemental,6,3,3
43187,Bigpinkpig,thunderhorn,288,shaman,elemental,7,3,4
43188,Jaeslin,tarren-mill,288,shaman,elemental,12,3,9
43189,Corlysvelary,doomhammer,288,shaman,elemental,12,3,9
43190,Hboni,chamber-of-aspects,288,shaman,elemental,12,3,9
43191,Berith,spinebreaker,288,shaman,elemental,12,3,9
43192,Gethrok,rajaxx,288,shaman,elemental,12,3,9
43193,Samlik,antonidas,288,shaman,elemental,12,3,9
43194,Elemania,mugthol,288,shaman,elemental,12,3,9
43195,Iceshockz,sylvanas,288,shaman,elemental,12,3,9
43196,Renegad,archimonde,288,shaman,elemental,12,3,9
43197,Qwunjin,ragnaros,288,shaman,elemental,12,3,9
43198,Shourx,ravencrest,288,shaman,elemental,12,3,9
43199,Mélb,eredar,288,shaman,elemental,12,3,9
43200,Woolysocks,draenor,288,shaman,elemental,12,3,9
43201,Allfathêr,ragnaros,288,shaman,elemental,12,3,9
43202,Fouchin,outland,288,shaman,elemental,12,3,9
43203,Practicetwo,argent-dawn,288,shaman,elemental,12,3,9
43204,Tir,auchindoun,288,shaman,elemental,12,3,9
43205,Bónkas,kazzak,288,shaman,elemental,12,3,9
43206,Tonto,frostmane,288,shaman,elemental,12,3,9
43207,Joeculdacier,hyjal,288,shaman,elemental,12,3,9
43208,Fatyoe,eredar,288,shaman,elemental,12,3,9
43209,Ронхот,soulflayer,288,shaman,elemental,18,3,15
43210,Kcarlina,uldum,287,shaman,elemental,6,3,3
43211,Megaherz,sanguino,287,shaman,elemental,6,3,3
43212,Bogatyrk,twisting-nether,287,shaman,elemental,6,3,3
43213,Óõ,dun-modr,287,shaman,elemental,6,3,3
43214,Twotwozero,defias-brotherhood,286,shaman,elemental,6,3,3
43215,Zalacrass,sanguino,286,shaman,elemental,6,3,3
43216,Вещун,deathguard,284,shaman,elemental,12,3,9
43217,Mareaspibas,zuljin,239,shaman,elemental,5,3,2
43218,Plebzgodxkto,nemesis,239,shaman,elemental,7,4,3
43219,Stíckíx,malganis,192,shaman,elemental,4,3,1
43220,Zackyboi,tarren-mill,192,shaman,elemental,6,2,4
43221,Hexlettin,twisting-nether,192,shaman,elemental,6,2,4
43222,Präsi,die-aldor,192,shaman,elemental,6,2,4
43223,Vandouille,archimonde,192,shaman,elemental,6,2,4
43224,Dormido,sanguino,192,shaman,elemental,6,2,4
43225,Димасечка,galakrond,192,shaman,elemental,6,2,4
43226,Nuekx,sanguino,192,shaman,elemental,6,2,4
43227,Exílium,tarren-mill,192,shaman,elemental,6,2,4
43228,Лаваяшка,gordunni,192,shaman,elemental,6,2,4
43229,Lethal,darksorrow,192,shaman,elemental,6,2,4
43230,Smashsmash,the-maelstrom,192,shaman,elemental,6,2,4
43231,Tuksy,darkspear,192,shaman,elemental,6,2,4
43232,Shamanirl,tarren-mill,192,shaman,elemental,6,2,4
43233,Тандерхем,gordunni,192,shaman,elemental,6,2,4
43234,Rakermän,dun-modr,192,shaman,elemental,6,2,4
43235,Seyumi,draenor,192,shaman,elemental,6,2,4
43236,Quartodebue,nemesis,192,shaman,elemental,6,2,4
43237,Zinlay,tarren-mill,192,shaman,elemental,6,2,4
43238,Зуфар,howling-fjord,192,shaman,elemental,6,2,4
43239,Шаеман,soulflayer,192,shaman,elemental,6,2,4
43240,Ishkadar,twisting-nether,192,shaman,elemental,6,2,4
43241,Cöökiekeeper,twisting-nether,192,shaman,elemental,6,2,4
43242,Mehex,tarren-mill,192,shaman,elemental,6,2,4
43243,Oldbuttgold,archimonde,192,shaman,elemental,6,2,4
43244,Bjerknes,draenor,192,shaman,elemental,6,2,4
43245,Stormzug,twisting-nether,192,shaman,elemental,6,2,4
43246,Nnekalol,twisting-nether,192,shaman,elemental,6,2,4
43247,Сновидений,soulflayer,192,shaman,elemental,6,2,4
43248,Kolchidyalah,la-croisade-écarlate,192,shaman,elemental,6,2,4
43249,Undae,ravencrest,192,shaman,elemental,6,2,4
43250,Yiyi,boulderfist,192,shaman,elemental,6,2,4
43251,Beletili,chogall,192,shaman,elemental,6,2,4
43252,Squixi,ravencrest,192,shaman,elemental,6,2,4
43253,Rindenmulch,eredar,192,shaman,elemental,6,2,4
43254,Tigro,burning-legion,192,shaman,elemental,6,2,4
43255,Purgegødxx,aegwynn,192,shaman,elemental,6,2,4
43256,Garakh,argent-dawn,192,shaman,elemental,6,2,4
43257,Ratatakéas,archimonde,192,shaman,elemental,6,2,4
43258,Wawawoowee,archimonde,192,shaman,elemental,6,2,4
43259,Драгенхз,gordunni,192,shaman,elemental,6,2,4
43260,Éàsy,blackmoore,192,shaman,elemental,6,2,4
43261,Firsttime,alakir,192,shaman,elemental,6,2,4
43262,Amonshokz,tarren-mill,192,shaman,elemental,6,2,4
43263,Ahrim,argent-dawn,192,shaman,elemental,6,2,4
43264,Dodododfewal,stormscale,192,shaman,elemental,6,2,4
43265,Thomz,aggra-português,192,shaman,elemental,6,2,4
43266,Schockolade,blackmoore,192,shaman,elemental,6,2,4
43267,Shàmeonyou,dun-morogh,192,shaman,elemental,6,2,4
43268,Nuvet,argent-dawn,192,shaman,elemental,6,2,4
43269,Makaria,emerald-dream,192,shaman,elemental,6,2,4
43270,Hanakô,grim-batol,192,shaman,elemental,6,2,4
43271,Macetoyaface,darksorrow,192,shaman,elemental,6,2,4
43272,Rok,darkspear,192,shaman,elemental,6,2,4
43273,Wulkanus,drakthul,192,shaman,elemental,6,2,4
43274,Tates,jaedenar,192,shaman,elemental,6,2,4
43275,Téwa,hyjal,192,shaman,elemental,6,2,4
43276,Albatroz,the-maelstrom,192,shaman,elemental,6,2,4
43277,Zulululul,burning-blade,192,shaman,elemental,6,2,4
43278,Stivishamy,blackmoore,192,shaman,elemental,6,2,4
43279,Гленкуллен,blackscar,192,shaman,elemental,6,2,4
43280,Девлиниум,fordragon,192,shaman,elemental,6,2,4
43281,Fuzzbolt,silvermoon,192,shaman,elemental,6,2,4
43282,Casterzajx,kazzak,192,shaman,elemental,6,2,4
43283,Cptsham,blackrock,192,shaman,elemental,6,2,4
43284,Kappatotem,silvermoon,192,shaman,elemental,6,2,4
43285,Krovogor,silvermoon,192,shaman,elemental,6,2,4
43286,Remkoo,blackrock,192,shaman,elemental,6,2,4
43287,Keisys,kazzak,192,shaman,elemental,6,2,4
43288,Djxyoloswag,silvermoon,192,shaman,elemental,6,2,4
43289,Melliska,silvermoon,192,shaman,elemental,6,2,4
43290,Motorbreath,silvermoon,192,shaman,elemental,6,2,4
43291,Shockbestie,eredar,192,shaman,elemental,7,2,5
43292,Hogmodig,tarren-mill,192,shaman,elemental,7,2,5
43293,Lycburst,twisting-nether,192,shaman,elemental,12,2,10
43294,Неерззул,soulflayer,192,shaman,elemental,12,2,10
43295,Zíp,archimonde,192,shaman,elemental,12,2,10
43296,Kossborax,blackhand,192,shaman,elemental,12,2,10
43297,Thornyberrý,outland,192,shaman,elemental,12,2,10
43298,Nakenfeigy,stormreaver,192,shaman,elemental,12,2,10
43299,Ærö,outland,192,shaman,elemental,12,2,10
43300,Zæus,ragnaros,192,shaman,elemental,12,2,10
43301,Максобман,howling-fjord,192,shaman,elemental,12,2,10
43302,Виспепешам,gordunni,192,shaman,elemental,12,2,10
43303,Sweetcåndy,stormscale,192,shaman,elemental,12,2,10
43304,Ghostx,nemesis,192,shaman,elemental,18,2,16
43305,Zeiger,minahonda,192,shaman,elemental,18,2,16
43306,Aspirio,ravencrest,175,shaman,elemental,11,2,9
43307,Thalgryn,twisting-nether,159,shaman,elemental,8,3,5
43308,Kortën,khaz-modan,159,shaman,elemental,10,2,8
43309,Amiashaman,stormscale,138,shaman,elemental,16,3,13
43310,Корсика,gordunni,128,shaman,elemental,4,2,2
43311,Shakgor,draenor,128,shaman,elemental,4,2,2
43312,Thorcasso,azuremyst,96,shaman,elemental,3,2,1
43313,Bram,aggra-português,96,shaman,elemental,3,2,1
43314,Simpledream,tarren-mill,96,shaman,elemental,3,2,1
43315,Zadrams,argent-dawn,96,shaman,elemental,3,2,1
43316,Nopivøt,hyjal,96,shaman,elemental,7,2,5
43317,Freexx,aegwynn,96,shaman,elemental,6,1,5
43318,Papaver,zirkel-des-cenarius,96,shaman,elemental,6,1,5
43319,Пэппивкашке,howling-fjord,96,shaman,elemental,6,1,5
43320,Aguero,aegwynn,96,shaman,elemental,6,1,5
43321,Moglibard,grim-batol,96,shaman,elemental,6,1,5
43322,Dergat,pozzo-delleternità,96,shaman,elemental,6,1,5
43323,Mittyzap,kazzak,96,shaman,elemental,6,1,5
43324,Izir,archimonde,96,shaman,elemental,6,1,5
43325,Korbas,burning-legion,96,shaman,elemental,6,1,5
43326,Newÿorc,dalaran,96,shaman,elemental,6,1,5
43327,Dizhkameduu,terokkar,96,shaman,elemental,6,1,5
43328,Fatflop,sylvanas,96,shaman,elemental,6,1,5
43329,Nìtratx,archimonde,96,shaman,elemental,6,1,5
43330,Reäz,archimonde,96,shaman,elemental,6,1,5
43331,Сентес,soulflayer,96,shaman,elemental,6,1,5
43332,Growlêy,draenor,96,shaman,elemental,6,1,5
43333,Ânne,blackrock,96,shaman,elemental,6,1,5
43334,Hästdvärg,the-maelstrom,96,shaman,elemental,6,1,5
43335,Ämbientador,sanguino,96,shaman,elemental,6,1,5
43336,Skailzcham,hyjal,96,shaman,elemental,6,1,5
43337,Châmanco,dun-modr,96,shaman,elemental,6,1,5
43338,Vodoochild,hyjal,96,shaman,elemental,6,1,5
43339,Flurpz,outland,96,shaman,elemental,6,1,5
43340,Монамур,deathguard,96,shaman,elemental,6,1,5
43341,Killhorn,malganis,96,shaman,elemental,6,1,5
43342,Shamsteaks,ysera,96,shaman,elemental,6,1,5
43343,Brryantblaks,colinas-pardas,96,shaman,elemental,6,1,5
43344,Zerim,taerar,96,shaman,elemental,6,1,5
43345,Elijaá,nordrassil,96,shaman,elemental,6,1,5
43346,Samisu,blackmoore,96,shaman,elemental,6,1,5
43347,Shamwowpow,stormscale,96,shaman,elemental,6,1,5
43348,Bonestompamc,blackmoore,96,shaman,elemental,6,1,5
43349,Jabena,draenor,96,shaman,elemental,6,1,5
43350,Zaffyboi,draenor,96,shaman,elemental,6,1,5
43351,Rakat,twisting-nether,96,shaman,elemental,6,1,5
43352,Felcrushed,stormscale,96,shaman,elemental,6,1,5
43353,Noru,ravencrest,96,shaman,elemental,6,1,5
43354,Hagelbrakan,stormscale,96,shaman,elemental,6,1,5
43355,Depucova,silvermoon,96,shaman,elemental,6,1,5
43356,Vorkanyx,ysondre,96,shaman,elemental,6,1,5
43357,Bärtigbaron,thrall,96,shaman,elemental,6,1,5
43358,Cazzari,thrall,96,shaman,elemental,6,1,5
43359,Pasjeop,ravencrest,96,shaman,elemental,6,1,5
43360,Kilruk,ravencrest,96,shaman,elemental,6,1,5
43361,Stiflersmôm,antonidas,96,shaman,elemental,6,1,5
43362,Heheheyup,ravencrest,96,shaman,elemental,6,1,5
43363,Dwarfofwar,ravencrest,96,shaman,elemental,6,1,5
43364,Shamira,nethersturm,96,shaman,elemental,6,1,5
43365,Shaminista,ravencrest,96,shaman,elemental,6,1,5
43366,Magmamartin,antonidas,96,shaman,elemental,6,1,5
43367,Zappypewpew,drakthul,96,shaman,elemental,12,1,11
43368,Amaizin,stormscale,96,shaman,elemental,12,1,11
43369,Äijä,chromaggus,96,shaman,elemental,12,1,11
43370,Kyst,elune,95,shaman,elemental,6,1,5
43371,Torxii,antonidas,79,shaman,elemental,5,1,4
43372,Torepåsporet,deathwing,79,shaman,elemental,5,1,4
43373,Rãgnãr,frostwolf,64,shaman,elemental,4,1,3
43374,Tarzh,dalaran,63,shaman,elemental,2,2,0
43375,Yukîmøn,hyjal,63,shaman,elemental,2,2,0
43376,Agnøt,khaz-modan,63,shaman,elemental,2,2,0
43377,Realiz,ysondre,48,shaman,elemental,4,1,3
43378,Shammolino,nemesis,41,shaman,elemental,7,3,4
43379,Gushgush,draenor,31,shaman,elemental,2,1,1
43380,Memourian,drakthul,16,shaman,elemental,7,1,6
43381,Bredare,ravencrest,2406,shaman,enhancement,136,104,32
43382,Blaukraut,stormscale,2375,shaman,enhancement,115,75,40
43383,Mûnch,kazzak,2369,shaman,enhancement,110,73,37
43384,Дудивтф,soulflayer,2244,shaman,enhancement,194,105,89
43385,Китрасст,soulflayer,2239,shaman,enhancement,78,43,35
43386,Strippzz,stormscale,2238,shaman,enhancement,102,62,40
43387,Fatpig,stormscale,2238,shaman,enhancement,83,47,36
43388,Крааули,soulflayer,2231,shaman,enhancement,335,173,162
43389,Axdn,ravencrest,2229,shaman,enhancement,80,47,33
43390,Avines,twisting-nether,2211,shaman,enhancement,206,106,100
43391,Kweng,stormreaver,2208,shaman,enhancement,193,109,84
43392,Hermerejildo,stormscale,2200,shaman,enhancement,126,66,60
43393,Dennismanone,tarren-mill,2195,shaman,enhancement,102,53,49
43394,Azifox,hyjal,2183,shaman,enhancement,132,67,65
43395,Buffdraventy,archimonde,2176,shaman,enhancement,90,53,37
43396,Treyway,dun-modr,2174,shaman,enhancement,96,64,32
43397,Lizoo,ravencrest,2169,shaman,enhancement,102,66,36
43398,Stribbzz,stormscale,2149,shaman,enhancement,274,156,118
43399,Baconbazooka,tarren-mill,2147,shaman,enhancement,101,60,41
43400,Áä,stormscale,2146,shaman,enhancement,48,42,6
43401,Joeyexe,outland,2133,shaman,enhancement,95,54,41
43402,Qnanen,blackmoore,2131,shaman,enhancement,104,68,36
43403,Shïnnkøk,stormscale,2130,shaman,enhancement,72,43,29
43404,Mustakrakish,terokkar,2127,shaman,enhancement,78,53,25
43405,Møldør,tarren-mill,2127,shaman,enhancement,126,82,44
43406,Smorcshamyy,kazzak,2127,shaman,enhancement,111,63,48
43407,Æerømachine,outland,2125,shaman,enhancement,81,42,39
43408,Chancè,tarren-mill,2124,shaman,enhancement,84,50,34
43409,Fckumen,blackmoore,2124,shaman,enhancement,106,61,45
43410,Shadi,stormscale,2119,shaman,enhancement,84,44,40
43411,Feetaddict,kazzak,2117,shaman,enhancement,112,67,45
43412,Maelstrom,eredar,2113,shaman,enhancement,300,167,133
43413,Lovèless,stormscale,2111,shaman,enhancement,36,26,10
43414,Syllaas,ysondre,2109,shaman,enhancement,114,59,55
43415,Бафамет,blackscar,2108,shaman,enhancement,66,39,27
43416,Sparkygødx,twisting-nether,2104,shaman,enhancement,54,33,21
43417,Автозакзак,soulflayer,2104,shaman,enhancement,89,45,44
43418,Sparkyxd,twisting-nether,2102,shaman,enhancement,84,40,44
43419,Etox,darksorrow,2101,shaman,enhancement,108,57,51
43420,Zró,blackrock,2098,shaman,enhancement,144,78,66
43421,Trulylove,tarren-mill,2085,shaman,enhancement,66,34,32
43422,Swapxy,ravencrest,2084,shaman,enhancement,54,33,21
43423,Voodoodoouu,stormscale,2079,shaman,enhancement,155,83,72
43424,Shamanyxx,tarren-mill,2071,shaman,enhancement,155,83,72
43425,Yashëa,ysondre,2069,shaman,enhancement,73,59,14
43426,Ruffepuffe,twisting-nether,2047,shaman,enhancement,222,119,103
43427,Shukhevych,kazzak,2043,shaman,enhancement,95,57,38
43428,Wóllff,archimonde,2043,shaman,enhancement,72,42,30
43429,Myguns,silvermoon,2043,shaman,enhancement,176,92,84
43430,Shambolicc,kazzak,2042,shaman,enhancement,120,62,58
43431,Читорра,gordunni,2038,shaman,enhancement,96,51,45
43432,Китраст,soulflayer,2034,shaman,enhancement,63,33,30
43433,Plsdontpress,stormscale,2029,shaman,enhancement,121,70,51
43434,Critonian,twisting-nether,2026,shaman,enhancement,69,39,30
43435,Sillaas,ysondre,2020,shaman,enhancement,120,55,65
43436,Asaakira,blackmoore,2018,shaman,enhancement,211,112,99
43437,Hexmex,stormreaver,2015,shaman,enhancement,142,77,65
43438,Uhøfligeulf,draenor,2013,shaman,enhancement,65,35,30
43439,Milheroj,tarren-mill,2013,shaman,enhancement,153,82,71
43440,Gúîtårgøð,sanguino,2012,shaman,enhancement,83,42,41
43441,Arslos,twisting-nether,2010,shaman,enhancement,50,39,11
43442,Нарленд,gordunni,2003,shaman,enhancement,114,61,53
43443,Yüri,stormscale,1998,shaman,enhancement,265,132,133
43444,Lokes,drakthul,1996,shaman,enhancement,214,116,98
43445,Horelio,sanguino,1995,shaman,enhancement,159,94,65
43446,Nuarishaman,kazzak,1993,shaman,enhancement,48,33,15
43447,Stensham,stormreaver,1989,shaman,enhancement,59,37,22
43448,Chakafuyo,dun-modr,1986,shaman,enhancement,62,37,25
43449,Acidtrips,thrall,1985,shaman,enhancement,54,30,24
43450,Инсэйнгод,soulflayer,1983,shaman,enhancement,63,32,31
43451,Viablous,ravencrest,1981,shaman,enhancement,154,99,55
43452,Testosterone,dun-modr,1980,shaman,enhancement,71,44,27
43453,Shadiqt,stormscale,1978,shaman,enhancement,66,33,33
43454,Turbostruck,ravencrest,1977,shaman,enhancement,102,46,56
43455,Wishsteen,stormscale,1973,shaman,enhancement,95,52,43
43456,Nopre,blackrock,1973,shaman,enhancement,208,113,95
43457,Babalahziz,ysondre,1972,shaman,enhancement,101,70,31
43458,Karpsham,stormscale,1972,shaman,enhancement,133,64,69
43459,Oldveteran,eredar,1968,shaman,enhancement,90,56,34
43460,Hermerejildo,tarren-mill,1965,shaman,enhancement,60,35,25
43461,Shambolicc,ravencrest,1963,shaman,enhancement,82,39,43
43462,Noboorst,stormscale,1961,shaman,enhancement,66,36,30
43463,Shadijr,stormscale,1956,shaman,enhancement,54,32,22
43464,Ниу,thermaplugg,1949,shaman,enhancement,54,32,22
43465,Pusspatrol,kazzak,1949,shaman,enhancement,72,35,37
43466,Deaslow,hyjal,1946,shaman,enhancement,142,81,61
43467,Skullstorm,talnivarr,1945,shaman,enhancement,73,44,29
43468,Frankone,outland,1941,shaman,enhancement,186,106,80
43469,Alterem,kazzak,1941,shaman,enhancement,144,79,65
43470,Tosemist,stormscale,1932,shaman,enhancement,64,38,26
43471,Shamarach,sylvanas,1931,shaman,enhancement,60,38,22
43472,Nnele,sanguino,1925,shaman,enhancement,71,36,35
43473,Brokenguyman,defias-brotherhood,1924,shaman,enhancement,52,31,21
43474,Zulmalis,twisting-nether,1920,shaman,enhancement,94,56,38
43475,Trulylove,outland,1913,shaman,enhancement,77,36,41
43476,Shïnnøk,stormscale,1909,shaman,enhancement,460,230,230
43477,Тандервульф,howling-fjord,1905,shaman,enhancement,125,68,57
43478,Тиидишам,blackscar,1905,shaman,enhancement,143,72,71
43479,Arhitopg,silvermoon,1903,shaman,enhancement,120,64,56
43480,Curioustowel,kazzak,1902,shaman,enhancement,42,26,16
43481,Taktouka,archimonde,1902,shaman,enhancement,65,31,34
43482,Daybidaybi,stormscale,1898,shaman,enhancement,94,48,46
43483,Panzarkamp,stormscale,1894,shaman,enhancement,95,58,37
43484,Gottiy,blackhand,1893,shaman,enhancement,102,50,52
43485,Gromzog,twisting-nether,1890,shaman,enhancement,48,31,17
43486,Enhshamanop,draenor,1883,shaman,enhancement,204,102,102
43487,Morguk,zuljin,1882,shaman,enhancement,97,54,43
43488,Yombaï,archimonde,1880,shaman,enhancement,138,65,73
43489,Blitzmann,outland,1879,shaman,enhancement,54,30,24
43490,Spaltbart,blackmoore,1878,shaman,enhancement,96,58,38
43491,Altarian,nemesis,1878,shaman,enhancement,76,43,33
43492,Mëditåtïøñ,blackrock,1878,shaman,enhancement,42,22,20
43493,Matchstíck,draenor,1875,shaman,enhancement,60,31,29
43494,Вацунвец,goldrinn,1874,shaman,enhancement,163,86,77
43495,Badmojø,silvermoon,1874,shaman,enhancement,76,36,40
43496,Toteemikylpy,argent-dawn,1871,shaman,enhancement,78,51,27
43497,Dhedge,draenor,1870,shaman,enhancement,90,54,36
43498,Jtouni,outland,1869,shaman,enhancement,72,37,35
43499,Херургх,soulflayer,1868,shaman,enhancement,80,52,28
43500,Ятебясмету,gordunni,1867,shaman,enhancement,48,32,16
43501,Jäy,twisting-nether,1867,shaman,enhancement,58,31,27
43502,Ниокумибейт,soulflayer,1866,shaman,enhancement,52,34,18
43503,Вудумастер,gordunni,1866,shaman,enhancement,107,62,45
43504,Бренненд,howling-fjord,1865,shaman,enhancement,128,71,57
43505,Falseshepard,kazzak,1863,shaman,enhancement,54,29,25
43506,Disciplé,blackmoore,1862,shaman,enhancement,65,34,31
43507,Turbostuck,ravencrest,1860,shaman,enhancement,54,28,26
43508,Пеклоь,soulflayer,1860,shaman,enhancement,177,87,90
43509,Ázøk,stormscale,1859,shaman,enhancement,190,99,91
43510,Ganachimby,zuljin,1858,shaman,enhancement,47,34,13
43511,Naochí,silvermoon,1857,shaman,enhancement,35,23,12
43512,Hanrej,draenor,1856,shaman,enhancement,60,37,23
43513,Shamhaár,blackmoore,1856,shaman,enhancement,100,61,39
43514,Radåhn,outland,1854,shaman,enhancement,72,44,28
43515,Løne,sylvanas,1853,shaman,enhancement,48,36,12
43516,Zarkab,ysondre,1852,shaman,enhancement,70,50,20
43517,Chatbanned,blackmoore,1849,shaman,enhancement,42,25,17
43518,Boombastíc,ravencrest,1845,shaman,enhancement,106,53,53
43519,Рэггдолл,soulflayer,1845,shaman,enhancement,102,47,55
43520,Bullx,magtheridon,1843,shaman,enhancement,84,47,37
43521,Totemofgreed,rexxar,1843,shaman,enhancement,84,40,44
43522,Mittyzap,kazzak,1842,shaman,enhancement,72,43,29
43523,Мсет,soulflayer,1841,shaman,enhancement,35,23,12
43524,Сахарокь,soulflayer,1840,shaman,enhancement,42,27,15
43525,Барракудах,razuvious,1840,shaman,enhancement,114,58,56
43526,Shrektar,outland,1839,shaman,enhancement,36,22,14
43527,Androck,tarren-mill,1839,shaman,enhancement,64,36,28
43528,Stormlash,shattered-halls,1838,shaman,enhancement,48,36,12
43529,Kulefesk,grim-batol,1837,shaman,enhancement,66,33,33
43530,Jamdah,stormscale,1835,shaman,enhancement,43,32,11
43531,Xa,blackrock,1835,shaman,enhancement,78,42,36
43532,Actionhank,area-52,1834,shaman,enhancement,57,30,27
43533,Zetorgg,burning-legion,1832,shaman,enhancement,71,36,35
43534,Wacomtablet,kazzak,1830,shaman,enhancement,42,24,18
43535,Друггрумилей,soulflayer,1828,shaman,enhancement,42,24,18
43536,Mírídíuss,silvermoon,1827,shaman,enhancement,35,25,10
43537,Rëalg,zuljin,1827,shaman,enhancement,90,59,31
43538,Salvadr,zuljin,1827,shaman,enhancement,70,39,31
43539,Stormkiler,defias-brotherhood,1826,shaman,enhancement,83,36,47
43540,Шаманмиша,gordunni,1825,shaman,enhancement,36,25,11
43541,Lavadelrey,drakthul,1824,shaman,enhancement,48,25,23
43542,Moini,eredar,1824,shaman,enhancement,60,31,29
43543,Shamflurry,ravencrest,1823,shaman,enhancement,48,33,15
43544,Ananasanax,twisting-nether,1823,shaman,enhancement,114,63,51
43545,Floorislava,culte-de-la-rive-noire,1822,shaman,enhancement,84,43,41
43546,Høwlstørmx,ravencrest,1820,shaman,enhancement,43,31,12
43547,Agathoulis,burning-legion,1820,shaman,enhancement,48,33,15
43548,Phobiatics,thrall,1820,shaman,enhancement,41,28,13
43549,Senroxx,blackrock,1818,shaman,enhancement,48,32,16
43550,Пэппивкашке,howling-fjord,1818,shaman,enhancement,38,23,15
43551,Argotan,drakthul,1817,shaman,enhancement,71,43,28
43552,Thunberg,ravencrest,1817,shaman,enhancement,107,61,46
43553,Mckoy,kazzak,1816,shaman,enhancement,40,27,13
43554,Чаапалах,blackscar,1816,shaman,enhancement,174,87,87
43555,Marohk,uldum,1815,shaman,enhancement,42,22,20
43556,Вандерласт,howling-fjord,1814,shaman,enhancement,90,54,36
43557,Meatballspam,stormscale,1814,shaman,enhancement,71,35,36
43558,Слакербэдбой,gordunni,1814,shaman,enhancement,78,35,43
43559,Stormasaurus,anachronos,1813,shaman,enhancement,52,34,18
43560,Bikdig,dun-modr,1812,shaman,enhancement,78,47,31
43561,Mèátßãllgøðx,kazzak,1812,shaman,enhancement,129,65,64
43562,Medistød,draenor,1811,shaman,enhancement,131,82,49
43563,Eysns,blackrock,1811,shaman,enhancement,70,42,28
43564,Zulren,draenor,1811,shaman,enhancement,42,23,19
43565,Вацустайл,goldrinn,1810,shaman,enhancement,48,32,16
43566,Dshaman,aegwynn,1810,shaman,enhancement,36,23,13
43567,Sangoma,frostmane,1810,shaman,enhancement,196,96,100
43568,Wishstêên,stormscale,1809,shaman,enhancement,64,29,35
43569,Pumpzuat,khadgar,1808,shaman,enhancement,24,20,4
43570,Roxâm,hyjal,1808,shaman,enhancement,34,20,14
43571,Xestil,blackmoore,1808,shaman,enhancement,67,36,31
43572,Blastoiselol,ragnaros,1807,shaman,enhancement,52,34,18
43573,Teknorave,dun-modr,1807,shaman,enhancement,54,29,25
43574,Flappey,stormscale,1805,shaman,enhancement,54,33,21
43575,Реактиватор,soulflayer,1803,shaman,enhancement,47,27,20
43576,Raidwhipper,twisting-nether,1802,shaman,enhancement,84,57,27
43577,Spicemélange,archimonde,1802,shaman,enhancement,64,37,27
43578,Krónm,dun-modr,1801,shaman,enhancement,41,28,13
43579,Sozetwo,tarren-mill,1801,shaman,enhancement,40,24,16
43580,Sybred,twisting-nether,1800,shaman,enhancement,126,76,50
43581,Calvey,magtheridon,1799,shaman,enhancement,82,37,45
43582,Xôàrqt,eredar,1798,shaman,enhancement,262,139,123
43583,Proccq,twisting-nether,1795,shaman,enhancement,48,24,24
43584,Azrs,ravencrest,1794,shaman,enhancement,102,57,45
43585,Veloudinos,twisting-nether,1793,shaman,enhancement,107,71,36
43586,Kishock,tarren-mill,1793,shaman,enhancement,30,19,11
43587,Acivich,frostmane,1793,shaman,enhancement,84,50,34
43588,Shammyenh,burning-legion,1792,shaman,enhancement,48,31,17
43589,Shockxy,norgannon,1792,shaman,enhancement,46,23,23
43590,Talrall,twisting-nether,1790,shaman,enhancement,78,40,38
43591,Shamtard,frostwhisper,1790,shaman,enhancement,169,85,84
43592,Yacu,blackrock,1786,shaman,enhancement,77,43,34
43593,Gelthan,zuljin,1785,shaman,enhancement,206,112,94
43594,Schoølbøyq,blackrock,1784,shaman,enhancement,30,19,11
43595,Pontifhkas,ragnaros,1783,shaman,enhancement,87,55,32
43596,Purgerooni,haomarush,1781,shaman,enhancement,64,41,23
43597,Basz,aegwynn,1781,shaman,enhancement,58,33,25
43598,Ozilie,khaz-modan,1780,shaman,enhancement,71,45,26
43599,Calveyy,magtheridon,1780,shaman,enhancement,45,28,17
43600,Satanloveme,stormscale,1777,shaman,enhancement,42,22,20
43601,Nevergroundx,perenolde,1776,shaman,enhancement,42,27,15
43602,Corvux,tarren-mill,1776,shaman,enhancement,54,26,28
43603,Wúh,twisting-nether,1775,shaman,enhancement,102,59,43
43604,Pumpcok,durotan,1774,shaman,enhancement,42,30,12
43605,Dóómd,kazzak,1772,shaman,enhancement,78,41,37
43606,Pýthøn,silvermoon,1772,shaman,enhancement,54,27,27
43607,Dzandell,silvermoon,1772,shaman,enhancement,68,32,36
43608,Одтагад,gordunni,1771,shaman,enhancement,132,76,56
43609,Vayshibro,turalyon,1770,shaman,enhancement,66,36,30
43610,Rabalalaha,twisting-nether,1770,shaman,enhancement,170,89,81
43611,Ryhèn,stormscale,1769,shaman,enhancement,186,105,81
43612,Obrijames,tarren-mill,1765,shaman,enhancement,94,55,39
43613,Sígrun,aegwynn,1758,shaman,enhancement,42,28,14
43614,Ðrshock,blackmoore,1758,shaman,enhancement,48,28,20
43615,Видарх,soulflayer,1756,shaman,enhancement,42,20,22
43616,Hezdnalien,aegwynn,1750,shaman,enhancement,95,53,42
43617,Ñøs,blackrock,1749,shaman,enhancement,102,55,47
43618,Recaim,outland,1748,shaman,enhancement,47,24,23
43619,Echoingshock,argent-dawn,1746,shaman,enhancement,48,32,16
43620,Stormdrak,eredar,1741,shaman,enhancement,42,29,13
43621,Максобман,howling-fjord,1741,shaman,enhancement,48,27,21
43622,Narevoqi,madmortem,1736,shaman,enhancement,40,28,12
43623,Экспл,ashenvale,1736,shaman,enhancement,48,21,27
43624,Getahex,ravencrest,1735,shaman,enhancement,23,19,4
43625,Tâktoukâ,archimonde,1734,shaman,enhancement,112,59,53
43626,Shds,blackmoore,1733,shaman,enhancement,69,40,29
43627,Totemilokum,stormscale,1732,shaman,enhancement,48,28,20
43628,Tobanga,malganis,1730,shaman,enhancement,48,29,19
43629,Kynaz,sanguino,1730,shaman,enhancement,147,71,76
43630,Халльбьерн,howling-fjord,1726,shaman,enhancement,60,36,24
43631,Sswf,kazzak,1725,shaman,enhancement,24,18,6
43632,Obryss,tarren-mill,1725,shaman,enhancement,29,19,10
43633,Madboys,kazzak,1723,shaman,enhancement,72,39,33
43634,Dalgia,tarren-mill,1722,shaman,enhancement,42,25,17
43635,Lersham,the-maelstrom,1721,shaman,enhancement,65,38,27
43636,Grende,sylvanas,1721,shaman,enhancement,114,58,56
43637,Painshock,outland,1720,shaman,enhancement,93,52,41
43638,Шаманутый,soulflayer,1719,shaman,enhancement,129,62,67
43639,Snëakyboom,stormscale,1717,shaman,enhancement,96,46,50
43640,Nachosauce,tarren-mill,1716,shaman,enhancement,30,18,12
43641,Ваншотстайлз,soulflayer,1716,shaman,enhancement,64,34,30
43642,Jaimæ,ravencrest,1715,shaman,enhancement,24,18,6
43643,Тралси,howling-fjord,1715,shaman,enhancement,24,18,6
43644,Lavarage,kazzak,1715,shaman,enhancement,39,27,12
43645,Yogan,dun-modr,1714,shaman,enhancement,68,38,30
43646,Stormbreáker,twisting-nether,1711,shaman,enhancement,172,101,71
43647,Ludwigson,tarren-mill,1709,shaman,enhancement,104,62,42
43648,Tito,stormscale,1708,shaman,enhancement,66,28,38
43649,Enhx,ravencrest,1707,shaman,enhancement,36,23,13
43650,Joanna,frostwolf,1705,shaman,enhancement,66,31,35
43651,Groyaboý,blackrock,1704,shaman,enhancement,24,18,6
43652,Fotmburstwin,blackmoore,1704,shaman,enhancement,42,27,15
43653,Fözk,outland,1704,shaman,enhancement,42,24,18
43654,Stormfíst,tarren-mill,1703,shaman,enhancement,48,28,20
43655,Mulf,darksorrow,1703,shaman,enhancement,70,36,34
43656,Khamo,twisting-nether,1702,shaman,enhancement,47,25,22
43657,Сидог,soulflayer,1701,shaman,enhancement,24,18,6
43658,Маелштромс,soulflayer,1699,shaman,enhancement,54,26,28
43659,Caelx,ragnaros,1698,shaman,enhancement,24,18,6
43660,Monamour,twisting-nether,1698,shaman,enhancement,66,40,26
43661,Enhahaha,tarren-mill,1697,shaman,enhancement,36,23,13
43662,Javaburst,ragnaros,1697,shaman,enhancement,102,55,47
43663,Nerfrets,malganis,1696,shaman,enhancement,72,46,26
43664,Aswøg,kazzak,1695,shaman,enhancement,30,21,9
43665,Skilltissue,executus,1694,shaman,enhancement,78,42,36
43666,Khrin,blackmoore,1693,shaman,enhancement,42,27,15
43667,Kaimountain,defias-brotherhood,1693,shaman,enhancement,42,26,16
43668,Typhoön,sanguino,1691,shaman,enhancement,253,131,122
43669,Халльбиорн,gordunni,1691,shaman,enhancement,67,32,35
43670,Царьбер,soulflayer,1690,shaman,enhancement,80,45,35
43671,Volvíc,tichondrius,1687,shaman,enhancement,42,22,20
43672,Vartarius,arthas,1687,shaman,enhancement,102,53,49
43673,Láynert,dun-modr,1685,shaman,enhancement,300,150,150
43674,Ripstorm,sylvanas,1685,shaman,enhancement,48,24,24
43675,Mehex,tarren-mill,1685,shaman,enhancement,54,26,28
43676,Chêlëx,silvermoon,1684,shaman,enhancement,188,101,87
43677,Thorâ,frostmane,1683,shaman,enhancement,65,48,17
43678,Skyróxx,blackrock,1682,shaman,enhancement,51,30,21
43679,Шанья,gordunni,1682,shaman,enhancement,108,52,56
43680,Tinysalmon,hyjal,1681,shaman,enhancement,30,18,12
43681,Взалходил,soulflayer,1680,shaman,enhancement,41,21,20
43682,Hassebolt,draenor,1678,shaman,enhancement,42,25,17
43683,Voodoohexman,kazzak,1678,shaman,enhancement,130,74,56
43684,Naïda,conseil-des-ombres,1678,shaman,enhancement,216,108,108
43685,Spetsnazz,archimonde,1678,shaman,enhancement,230,114,116
43686,Кинговели,soulflayer,1677,shaman,enhancement,197,103,94
43687,Wheygodx,ravencrest,1677,shaman,enhancement,111,58,53
43688,Kedall,archimonde,1676,shaman,enhancement,66,32,34
43689,Doomëd,drakthul,1675,shaman,enhancement,48,24,24
43690,Ашхикиган,howling-fjord,1675,shaman,enhancement,144,67,77
43691,Ewion,dalvengyr,1674,shaman,enhancement,54,40,14
43692,Пойдипокури,howling-fjord,1674,shaman,enhancement,126,72,54
43693,Matrixxer,aegwynn,1672,shaman,enhancement,27,19,8
43694,Greythunda,archimonde,1672,shaman,enhancement,36,23,13
43695,Гоэл,ashenvale,1672,shaman,enhancement,42,26,16
43696,Bluetide,ravencrest,1671,shaman,enhancement,51,34,17
43697,Shamerific,magtheridon,1671,shaman,enhancement,60,39,21
43698,Pumanii,silvermoon,1669,shaman,enhancement,60,32,28
43699,Lurkmon,twisting-nether,1669,shaman,enhancement,118,62,56
43700,Чифсоса,soulflayer,1668,shaman,enhancement,54,26,28
43701,Jabaraklol,stormscale,1665,shaman,enhancement,103,64,39
43702,Isucklasso,aegwynn,1664,shaman,enhancement,54,32,22
43703,Cåmilis,archimonde,1664,shaman,enhancement,60,33,27
43704,Voodoodocter,kazzak,1664,shaman,enhancement,113,56,57
43705,Neurax,sanguino,1663,shaman,enhancement,88,47,41
43706,Grytkungen,daggerspine,1662,shaman,enhancement,56,34,22
43707,Khelyyn,tarren-mill,1662,shaman,enhancement,76,39,37
43708,Rayoton,burning-legion,1662,shaman,enhancement,72,35,37
43709,Darkning,kazzak,1661,shaman,enhancement,48,29,19
43710,Nibblez,aegwynn,1659,shaman,enhancement,78,50,28
43711,Nînadobrevx,stormscale,1658,shaman,enhancement,141,80,61
43712,Wafflë,ragnaros,1658,shaman,enhancement,69,37,32
43713,Chehkhan,archimonde,1657,shaman,enhancement,40,19,21
43714,Vargen,arygos,1655,shaman,enhancement,30,20,10
43715,Элементи,gordunni,1655,shaman,enhancement,219,120,99
43716,Athe,conseil-des-ombres,1654,shaman,enhancement,65,35,30
43717,Faxsham,draenor,1652,shaman,enhancement,48,29,19
43718,Лолимин,borean-tundra,1651,shaman,enhancement,51,33,18
43719,Lekthar,draenor,1651,shaman,enhancement,67,38,29
43720,Kilomanjaro,bloodfeather,1651,shaman,enhancement,60,32,28
43721,Funkins,hyjal,1651,shaman,enhancement,55,29,26
43722,Tdogfx,blackhand,1650,shaman,enhancement,42,26,16
43723,Purgelord,tarren-mill,1650,shaman,enhancement,80,49,31
43724,Trenhard,wildhammer,1648,shaman,enhancement,65,46,19
43725,Groumgard,hyjal,1648,shaman,enhancement,50,30,20
43726,Akhlýzz,ysondre,1647,shaman,enhancement,39,24,15
43727,Testogodx,defias-brotherhood,1646,shaman,enhancement,87,48,39
43728,Turbopuddi,kazzak,1646,shaman,enhancement,89,45,44
43729,Plockepinn,ravencrest,1646,shaman,enhancement,84,38,46
43730,Griins,ravencrest,1645,shaman,enhancement,87,53,34
43731,Onebutton,archimonde,1644,shaman,enhancement,30,21,9
43732,Ecclîpce,archimonde,1643,shaman,enhancement,84,49,35
43733,Hayvaan,blackrock,1643,shaman,enhancement,192,110,82
43734,Makaar,blackrock,1643,shaman,enhancement,54,28,26
43735,Defiaz,stormscale,1642,shaman,enhancement,52,38,14
43736,Stalkun,elune,1642,shaman,enhancement,54,29,25
43737,Spacelazers,twisting-nether,1641,shaman,enhancement,29,19,10
43738,Yobro,archimonde,1641,shaman,enhancement,60,36,24
43739,Энха,howling-fjord,1641,shaman,enhancement,36,21,15
43740,Порнёреф,howling-fjord,1638,shaman,enhancement,165,98,67
43741,Shambamm,stormscale,1637,shaman,enhancement,54,31,23
43742,Tornis,terokkar,1637,shaman,enhancement,102,55,47
43743,Чесп,ashenvale,1636,shaman,enhancement,66,36,30
43744,Elemoont,tarren-mill,1633,shaman,enhancement,48,28,20
43745,Paintball,kazzak,1633,shaman,enhancement,132,71,61
43746,Legitbro,ravencrest,1633,shaman,enhancement,48,22,26
43747,Vforvendeta,defias-brotherhood,1632,shaman,enhancement,66,38,28
43748,Botism,draenor,1631,shaman,enhancement,66,37,29
43749,Argarok,argent-dawn,1630,shaman,enhancement,36,22,14
43750,Sswfx,kazzak,1630,shaman,enhancement,30,17,13
43751,Shamrún,sylvanas,1629,shaman,enhancement,60,37,23
43752,Lilmozart,twisting-nether,1628,shaman,enhancement,35,18,17
43753,Tartakos,ravencrest,1627,shaman,enhancement,73,41,32
43754,Pvegame,tarren-mill,1627,shaman,enhancement,108,58,50
43755,Djimin,sanguino,1627,shaman,enhancement,42,22,20
43756,Johncoltrane,archimonde,1626,shaman,enhancement,54,36,18
43757,Ùseless,archimonde,1626,shaman,enhancement,36,20,16
43758,Traktorchox,draenor,1626,shaman,enhancement,45,24,21
43759,Эбгерсон,soulflayer,1625,shaman,enhancement,222,119,103
43760,Канамаш,borean-tundra,1624,shaman,enhancement,42,27,15
43761,Ойрхин,greymane,1624,shaman,enhancement,48,24,24
43762,Chamkalix,sanguino,1623,shaman,enhancement,72,37,35
43763,Reparagos,sanguino,1622,shaman,enhancement,47,27,20
43764,Secramas,ragnaros,1622,shaman,enhancement,145,80,65
43765,Úpli,blackmoore,1621,shaman,enhancement,30,18,12
43766,Twists,sylvanas,1621,shaman,enhancement,36,21,15
43767,Hailele,argent-dawn,1620,shaman,enhancement,38,25,13
43768,Zutemaster,stormscale,1619,shaman,enhancement,52,27,25
43769,Ferconex,kazzak,1619,shaman,enhancement,136,70,66
43770,Пучмек,gordunni,1618,shaman,enhancement,48,35,13
43771,Зэбой,howling-fjord,1616,shaman,enhancement,50,33,17
43772,Kæzx,blackrock,1616,shaman,enhancement,66,34,32
43773,Commadore,korgall,1616,shaman,enhancement,42,20,22
43774,Werdup,sunstrider,1616,shaman,enhancement,44,19,25
43775,Kagurja,blackmoore,1614,shaman,enhancement,30,21,9
43776,Kilnih,archimonde,1614,shaman,enhancement,30,20,10
43777,Иннреи,howling-fjord,1614,shaman,enhancement,75,46,29
43778,Björnbritta,outland,1614,shaman,enhancement,41,23,18
43779,Царьколтрэйн,blackscar,1613,shaman,enhancement,107,56,51
43780,Lassolasse,sylvanas,1612,shaman,enhancement,24,17,7
43781,Sonnestorm,tarren-mill,1612,shaman,enhancement,30,20,10
43782,Boltar,die-aldor,1612,shaman,enhancement,36,19,17
43783,Ореганно,howling-fjord,1611,shaman,enhancement,72,40,32
43784,Jondil,das-syndikat,1611,shaman,enhancement,71,37,34
43785,Smozze,grim-batol,1611,shaman,enhancement,177,90,87
43786,Toxicnux,nemesis,1610,shaman,enhancement,48,28,20
43787,Чухансмент,gordunni,1610,shaman,enhancement,63,33,30
43788,Лапища,soulflayer,1609,shaman,enhancement,103,62,41
43789,Selticxz,blackrock,1609,shaman,enhancement,30,17,13
43790,Benderbub,blackhand,1609,shaman,enhancement,130,70,60
43791,Totemticks,aegwynn,1609,shaman,enhancement,48,25,23
43792,Шокмужик,gordunni,1608,shaman,enhancement,60,28,32
43793,Voodooms,laughing-skull,1607,shaman,enhancement,77,47,30
43794,Cealdlynn,blackmoore,1607,shaman,enhancement,41,24,17
43795,Elémenta,turalyon,1607,shaman,enhancement,54,30,24
43796,Mõrax,ysondre,1607,shaman,enhancement,163,82,81
43797,Reisti,stormscale,1606,shaman,enhancement,36,26,10
43798,Ancestro,kazzak,1606,shaman,enhancement,60,32,28
43799,Palmalecki,ravencrest,1605,shaman,enhancement,60,27,33
43800,Grrud,draenor,1604,shaman,enhancement,42,23,19
43801,Sêarix,aegwynn,1603,shaman,enhancement,48,31,17
43802,Shocktopussi,stormscale,1603,shaman,enhancement,51,32,19
43803,Bourdieu,thrall,1602,shaman,enhancement,75,45,30
43804,Moaxtyr,blackmoore,1601,shaman,enhancement,42,29,13
43805,Boradinn,hyjal,1601,shaman,enhancement,36,21,15
43806,Vulkân,silvermoon,1601,shaman,enhancement,176,97,79
43807,Venomos,kazzak,1601,shaman,enhancement,39,18,21
43808,Tijae,ravencrest,1600,shaman,enhancement,24,19,5
43809,Buuddha,drakthul,1600,shaman,enhancement,71,39,32
43810,Mmsalatik,nemesis,1600,shaman,enhancement,36,19,17
43811,Ïï,archimonde,1600,shaman,enhancement,195,102,93
43812,Amelie,burning-steppes,1597,shaman,enhancement,42,24,18
43813,Kosface,tarren-mill,1597,shaman,enhancement,160,85,75
43814,Sndheal,kazzak,1596,shaman,enhancement,24,19,5
43815,Loshohealva,stormscale,1596,shaman,enhancement,48,26,22
43816,Patsham,wildhammer,1595,shaman,enhancement,125,72,53
43817,Zakgar,ysondre,1594,shaman,enhancement,78,41,37
43818,Ekinoz,outland,1593,shaman,enhancement,38,20,18
43819,Elèon,blackrock,1593,shaman,enhancement,125,59,66
43820,Galthazar,silvermoon,1591,shaman,enhancement,58,31,27
43821,Belroc,ravencrest,1591,shaman,enhancement,36,19,17
43822,Ðreamz,kaelthas,1588,shaman,enhancement,91,45,46
43823,Joanno,aegwynn,1587,shaman,enhancement,24,19,5
43824,Kammek,tarren-mill,1583,shaman,enhancement,81,48,33
43825,Krassus,drakthul,1583,shaman,enhancement,53,31,22
43826,Xxloon,blackrock,1583,shaman,enhancement,126,73,53
43827,Äijä,chromaggus,1582,shaman,enhancement,96,51,45
43828,Kachori,eredar,1581,shaman,enhancement,78,35,43
43829,Цс,azuregos,1579,shaman,enhancement,116,63,53
43830,Arkîmonde,silvermoon,1579,shaman,enhancement,47,23,24
43831,Brenhilda,blackmoore,1578,shaman,enhancement,78,49,29
43832,Razzuan,kazzak,1577,shaman,enhancement,36,20,16
43833,Kættmæck,tarren-mill,1576,shaman,enhancement,72,37,35
43834,Îzanami,ravencrest,1573,shaman,enhancement,138,77,61
43835,Ubies,silvermoon,1573,shaman,enhancement,81,45,36
43836,Madmadbro,tarren-mill,1572,shaman,enhancement,204,107,97
43837,Wertih,burning-legion,1570,shaman,enhancement,56,35,21
43838,Kijin,kirin-tor,1569,shaman,enhancement,108,56,52
43839,Juniyaa,blackrock,1566,shaman,enhancement,53,29,24
43840,Людоед,thermaplugg,1566,shaman,enhancement,108,58,50
43841,Azzizael,argent-dawn,1566,shaman,enhancement,108,55,53
43842,Earthhulk,thrall,1564,shaman,enhancement,40,21,19
43843,Thrâwl,kazzak,1563,shaman,enhancement,24,19,5
43844,Tescriamelio,ysondre,1561,shaman,enhancement,30,19,11
43845,Ubramovitch,hyjal,1561,shaman,enhancement,48,25,23
43846,Sûmmêrz,ravencrest,1560,shaman,enhancement,36,22,14
43847,Pyrabolt,ravencrest,1560,shaman,enhancement,51,25,26
43848,Ромчи,gordunni,1559,shaman,enhancement,30,17,13
43849,Epicenter,bloodscalp,1559,shaman,enhancement,60,29,31
43850,Элетеми,soulflayer,1558,shaman,enhancement,83,45,38
43851,Bumbummann,blackmoore,1558,shaman,enhancement,112,55,57
43852,Ghobi,blackrock,1557,shaman,enhancement,48,24,24
43853,Gnubbzer,antonidas,1556,shaman,enhancement,48,24,24
43854,Jameo,drakthul,1553,shaman,enhancement,66,30,36
43855,Tiuzzo,alakir,1552,shaman,enhancement,42,23,19
43856,Shawck,ravencrest,1552,shaman,enhancement,46,25,21
43857,Alethea,frostmane,1552,shaman,enhancement,84,44,40
43858,Jeki,ysondre,1552,shaman,enhancement,168,81,87
43859,Juicewillis,defias-brotherhood,1551,shaman,enhancement,66,43,23
43860,Тандеркок,soulflayer,1551,shaman,enhancement,68,33,35
43861,Alwaysangry,silvermoon,1548,shaman,enhancement,33,18,15
43862,Megazz,drakthul,1548,shaman,enhancement,48,26,22
43863,Estasham,stormscale,1548,shaman,enhancement,150,81,69
43864,Zayliha,ravencrest,1547,shaman,enhancement,36,20,16
43865,Nuclearjohny,eredar,1547,shaman,enhancement,36,18,18
43866,Apexpredlol,blackmoore,1546,shaman,enhancement,96,45,51
43867,Garulf,twisting-nether,1541,shaman,enhancement,57,27,30
43868,Soomx,hyjal,1539,shaman,enhancement,86,45,41
43869,Explôsive,silvermoon,1539,shaman,enhancement,90,45,45
43870,Heeze,doomhammer,1538,shaman,enhancement,190,102,88
43871,Shaakez,kazzak,1538,shaman,enhancement,42,22,20
43872,Kutipaperi,stormscale,1537,shaman,enhancement,60,33,27
43873,Mesrines,archimonde,1536,shaman,enhancement,42,22,20
43874,Kuzsham,archimonde,1534,shaman,enhancement,39,18,21
43875,Politemanner,stormscale,1532,shaman,enhancement,30,16,14
43876,Онеоне,deathweaver,1530,shaman,enhancement,36,17,19
43877,Дефибо,howling-fjord,1529,shaman,enhancement,204,105,99
43878,Mcbloob,kazzak,1529,shaman,enhancement,99,50,49
43879,Шампуньхан,blackscar,1527,shaman,enhancement,76,33,43
43880,Tóyzz,ravencrest,1526,shaman,enhancement,42,27,15
43881,Yelawolf,shattered-hand,1526,shaman,enhancement,36,22,14
43882,Thalir,aegwynn,1526,shaman,enhancement,67,30,37
43883,Depucova,silvermoon,1525,shaman,enhancement,36,24,12
43884,Axilary,tarren-mill,1525,shaman,enhancement,24,16,8
43885,Kurdhran,blackmoore,1525,shaman,enhancement,75,42,33
43886,Cripxo,sanguino,1523,shaman,enhancement,18,16,2
43887,Szublime,stormscale,1523,shaman,enhancement,66,35,31
43888,Gandy,the-maelstrom,1522,shaman,enhancement,114,55,59
43889,Rehgar,frostwhisper,1522,shaman,enhancement,54,26,28
43890,Raveell,defias-brotherhood,1522,shaman,enhancement,100,46,54
43891,Robzn,blackrock,1521,shaman,enhancement,24,16,8
43892,Sitkosham,burning-blade,1521,shaman,enhancement,47,28,19
43893,Krovn,aszune,1521,shaman,enhancement,60,27,33
43894,Thralgr,sylvanas,1521,shaman,enhancement,42,18,24
43895,Флэшмэн,blackscar,1520,shaman,enhancement,24,19,5
43896,Dunî,tarren-mill,1517,shaman,enhancement,48,32,16
43897,Lupisregina,silvermoon,1517,shaman,enhancement,24,16,8
43898,Puumbaa,defias-brotherhood,1517,shaman,enhancement,54,28,26
43899,Pepernootje,sylvanas,1517,shaman,enhancement,70,34,36
43900,Crowness,ragnaros,1516,shaman,enhancement,36,22,14
43901,Veteroth,argent-dawn,1516,shaman,enhancement,54,25,29
43902,Irønythar,drakthul,1514,shaman,enhancement,53,27,26
43903,Cheetooth,ragnaros,1514,shaman,enhancement,48,24,24
43904,Filiduttsham,ravencrest,1513,shaman,enhancement,24,16,8
43905,Cowfeelings,ravencrest,1513,shaman,enhancement,30,16,14
43906,Silden,thrall,1511,shaman,enhancement,18,16,2
43907,Kuubskii,ravencrest,1511,shaman,enhancement,24,16,8
43908,Romacherry,aegwynn,1511,shaman,enhancement,125,69,56
43909,Духсалата,grom,1511,shaman,enhancement,36,16,20
43910,Totemlover,draenor,1510,shaman,enhancement,100,59,41
43911,Tarantan,eredar,1510,shaman,enhancement,61,32,29
43912,Жуксик,greymane,1509,shaman,enhancement,66,31,35
43913,Gøretterøg,ysondre,1507,shaman,enhancement,25,16,9
43914,Miriam,stormreaver,1507,shaman,enhancement,48,28,20
43915,Плаглорд,howling-fjord,1501,shaman,enhancement,72,40,32
43916,Oronakgladx,ravencrest,1500,shaman,enhancement,90,46,44
43917,Bolgrath,blackmoore,1500,shaman,enhancement,115,58,57
43918,Hexwife,archimonde,1500,shaman,enhancement,121,59,62
43919,Гексанол,soulflayer,1499,shaman,enhancement,66,36,30
43920,Xilz,twisting-nether,1498,shaman,enhancement,89,47,42
43921,Arkaos,exodar,1495,shaman,enhancement,49,29,20
43922,Deathshamãn,stormscale,1495,shaman,enhancement,42,20,22
43923,Earthshot,magtheridon,1494,shaman,enhancement,52,25,27
43924,Sházam,destromath,1493,shaman,enhancement,24,16,8
43925,Chendra,scarshield-legion,1493,shaman,enhancement,125,59,66
43926,Пивототем,gordunni,1492,shaman,enhancement,44,25,19
43927,Faltygo,drakthul,1492,shaman,enhancement,36,17,19
43928,Freadorn,uldaman,1491,shaman,enhancement,24,16,8
43929,Kanaky,hyjal,1491,shaman,enhancement,79,36,43
43930,Nargrul,tarren-mill,1490,shaman,enhancement,50,31,19
43931,Nexdown,archimonde,1490,shaman,enhancement,57,28,29
43932,Atée,silvermoon,1490,shaman,enhancement,87,42,45
43933,Electrify,aegwynn,1489,shaman,enhancement,30,21,9
43934,Yasaburo,silvermoon,1488,shaman,enhancement,30,18,12
43935,Vascodagama,twisting-nether,1488,shaman,enhancement,48,28,20
43936,Stromkek,eredar,1488,shaman,enhancement,59,33,26
43937,Proccazu,draenor,1487,shaman,enhancement,60,37,23
43938,Fatflop,sylvanas,1486,shaman,enhancement,96,51,45
43939,Kazing,outland,1485,shaman,enhancement,29,16,13
43940,Boulggour,chogall,1485,shaman,enhancement,48,26,22
43941,Shyne,vashj,1485,shaman,enhancement,30,16,14
43942,Arashi,rashgarroth,1484,shaman,enhancement,60,32,28
43943,Nyxoqtx,draenor,1481,shaman,enhancement,30,25,5
43944,Rakermän,dun-modr,1480,shaman,enhancement,40,21,19
43945,Convîcted,grim-batol,1479,shaman,enhancement,28,18,10
43946,Hulcky,grim-batol,1479,shaman,enhancement,60,32,28
43947,Bozzclqwnx,aegwynn,1478,shaman,enhancement,38,22,16
43948,Shyrion,onyxia,1478,shaman,enhancement,72,33,39
43949,Skut,zuljin,1476,shaman,enhancement,36,18,18
43950,Opráwindfury,stormscale,1475,shaman,enhancement,44,27,17
43951,Trendsetter,frostmane,1475,shaman,enhancement,44,26,18
43952,Chimp,lightnings-blade,1475,shaman,enhancement,36,21,15
43953,Rutil,blackhand,1475,shaman,enhancement,30,17,13
43954,Justweirdaf,blackmoore,1475,shaman,enhancement,83,44,39
43955,Rocktopus,outland,1475,shaman,enhancement,57,27,30
43956,Filigran,ragnaros,1472,shaman,enhancement,83,46,37
43957,Mjjx,blackrock,1471,shaman,enhancement,36,24,12
43958,Enigmar,stormscale,1471,shaman,enhancement,93,43,50
43959,Otacboziji,sylvanas,1470,shaman,enhancement,54,23,31
43960,Ashmantle,twisting-nether,1469,shaman,enhancement,30,18,12
43961,Vrontes,kazzak,1468,shaman,enhancement,48,29,19
43962,Axahavregryn,kazzak,1467,shaman,enhancement,36,17,19
43963,Shamãn,draenor,1467,shaman,enhancement,42,19,23
43964,Tanjîrø,archimonde,1466,shaman,enhancement,36,20,16
43965,Raíndra,twisting-nether,1466,shaman,enhancement,36,16,20
43966,Амг,booty-bay,1465,shaman,enhancement,74,45,29
43967,Дромгрон,howling-fjord,1463,shaman,enhancement,42,22,20
43968,Apekeeper,silvermoon,1461,shaman,enhancement,66,29,37
43969,Nubokesel,ragnaros,1460,shaman,enhancement,107,56,51
43970,Itswoland,tarren-mill,1459,shaman,enhancement,40,21,19
43971,Ðelenis,dun-modr,1459,shaman,enhancement,60,27,33
43972,Masztaar,ragnaros,1458,shaman,enhancement,122,60,62
43973,Pilcosham,frostwhisper,1453,shaman,enhancement,71,32,39
43974,Рокмару,soulflayer,1453,shaman,enhancement,41,18,23
43975,Chaeemerok,dun-modr,1453,shaman,enhancement,42,16,26
43976,Шторсонг,gordunni,1451,shaman,enhancement,74,48,26
43977,Моктрогтар,ashenvale,1449,shaman,enhancement,54,32,22
43978,Løktarøgàr,archimonde,1448,shaman,enhancement,47,25,22
43979,Gerethor,burning-legion,1448,shaman,enhancement,87,39,48
43980,Naturfury,ravencrest,1447,shaman,enhancement,30,21,9
43981,Yaar,alleria,1446,shaman,enhancement,88,51,37
43982,Alphas,draenor,1445,shaman,enhancement,44,26,18
43983,Lexyiasz,kazzak,1444,shaman,enhancement,28,22,6
43984,Lokresh,azjolnerub,1444,shaman,enhancement,54,30,24
43985,Xwitchdoctor,draenor,1444,shaman,enhancement,36,17,19
43986,Dirtymiké,tarren-mill,1444,shaman,enhancement,41,16,25
43987,Exolnard,twisting-nether,1442,shaman,enhancement,73,42,31
43988,Jawoburst,antonidas,1442,shaman,enhancement,65,31,34
43989,Furrymane,blackmoore,1439,shaman,enhancement,36,24,12
43990,Shamxd,kazzak,1439,shaman,enhancement,71,35,36
43991,Perunya,tarren-mill,1438,shaman,enhancement,53,27,26
43992,Jasnäh,ysondre,1437,shaman,enhancement,72,33,39
43993,Valaya,archimonde,1436,shaman,enhancement,128,72,56
43994,Kyshka,tarren-mill,1436,shaman,enhancement,30,15,15
43995,Shámi,gilneas,1435,shaman,enhancement,30,15,15
43996,Stratholmee,drakthul,1432,shaman,enhancement,48,27,21
43997,Roovenhance,aegwynn,1431,shaman,enhancement,34,23,11
43998,Klintxbob,hyjal,1431,shaman,enhancement,30,15,15
43999,Blackibird,garona,1431,shaman,enhancement,69,32,37
44000,Лаваяшка,gordunni,1430,shaman,enhancement,48,19,29
44001,Axemodels,archimonde,1429,shaman,enhancement,30,15,15
44002,Dcanne,outland,1428,shaman,enhancement,99,52,47
44003,Yurkën,uldum,1428,shaman,enhancement,60,29,31
44004,Rockjuices,twisting-nether,1427,shaman,enhancement,72,42,30
44005,Mcslammer,kazzak,1427,shaman,enhancement,114,54,60
44006,Wolfwesti,outland,1426,shaman,enhancement,42,28,14
44007,Джаабб,booty-bay,1426,shaman,enhancement,85,38,47
44008,Twam,outland,1425,shaman,enhancement,30,19,11
44009,Jarrek,draenor,1425,shaman,enhancement,42,20,22
44010,Durek,sylvanas,1424,shaman,enhancement,47,30,17
44011,Lehit,outland,1424,shaman,enhancement,30,15,15
44012,Rether,nemesis,1424,shaman,enhancement,83,38,45
44013,Reverbx,outland,1423,shaman,enhancement,24,15,9
44014,Shockthat,draenor,1423,shaman,enhancement,124,69,55
44015,Nwäar,archimonde,1423,shaman,enhancement,42,18,24
44016,Kezron,aegwynn,1422,shaman,enhancement,24,15,9
44017,Lëvi,archimonde,1421,shaman,enhancement,24,15,9
44018,Ðezûga,antonidas,1421,shaman,enhancement,113,57,56
44019,Vann,the-shatar,1421,shaman,enhancement,30,15,15
44020,Procctor,kazzak,1420,shaman,enhancement,18,15,3
44021,Zuvx,ravencrest,1420,shaman,enhancement,66,38,28
44022,Mèshuggáh,ravencrest,1419,shaman,enhancement,36,17,19
44023,Барракудах,gordunni,1418,shaman,enhancement,170,76,94
44024,Nejbegrov,ravencrest,1417,shaman,enhancement,66,29,37
44025,Гусан,booty-bay,1416,shaman,enhancement,80,36,44
44026,Tyrox,kirin-tor,1413,shaman,enhancement,72,38,34
44027,Hanumanas,kazzak,1412,shaman,enhancement,25,18,7
44028,Атл,deathguard,1411,shaman,enhancement,74,46,28
44029,Propanengtmr,stormscale,1406,shaman,enhancement,29,15,14
44030,Фарраон,deathguard,1405,shaman,enhancement,54,29,25
44031,Язма,grom,1404,shaman,enhancement,54,31,23
44032,Курси,gordunni,1403,shaman,enhancement,198,95,103
44033,Noiduttu,tarren-mill,1401,shaman,enhancement,88,55,33
44034,Kpåshaman,tarren-mill,1400,shaman,enhancement,30,17,13
44035,Arabesk,arygos,1399,shaman,enhancement,84,51,33
44036,Lumii,azshara,1399,shaman,enhancement,48,21,27
44037,Ghostkod,burning-legion,1396,shaman,enhancement,64,36,28
44038,Bobonbu,forscherliga,1396,shaman,enhancement,29,15,14
44039,Procdaddy,eredar,1396,shaman,enhancement,54,25,29
44040,Kohnân,hyjal,1395,shaman,enhancement,36,23,13
44041,Экспатриот,greymane,1395,shaman,enhancement,60,31,29
44042,Frostýx,draenor,1394,shaman,enhancement,33,16,17
44043,Argonautt,drakthul,1394,shaman,enhancement,119,52,67
44044,Neptun,twisting-nether,1393,shaman,enhancement,107,53,54
44045,Laix,khaz-modan,1392,shaman,enhancement,36,17,19
44046,Kenseienh,kazzak,1391,shaman,enhancement,231,121,110
44047,Shockbot,blackmoore,1388,shaman,enhancement,30,20,10
44048,Kïngmuntje,sylvanas,1388,shaman,enhancement,60,32,28
44049,Priora,argent-dawn,1383,shaman,enhancement,52,33,19
44050,Лайтхальзен,howling-fjord,1383,shaman,enhancement,36,16,20
44051,Rodneymullen,tarren-mill,1381,shaman,enhancement,35,17,18
44052,Хрофайс,soulflayer,1379,shaman,enhancement,30,20,10
44053,Mazokuu,ragnaros,1379,shaman,enhancement,139,74,65
44054,Igniis,frostmane,1374,shaman,enhancement,42,28,14
44055,Tahsus,blackmoore,1372,shaman,enhancement,42,20,22
44056,Твалор,soulflayer,1371,shaman,enhancement,50,26,24
44057,Cahuna,stormscale,1371,shaman,enhancement,63,24,39
44058,Капарис,deathweaver,1369,shaman,enhancement,39,21,18
44059,Enormo,eredar,1368,shaman,enhancement,30,16,14
44060,Watzocham,archimonde,1366,shaman,enhancement,48,22,26
44061,Panicblast,stormscale,1366,shaman,enhancement,35,15,20
44062,Nøve,nemesis,1365,shaman,enhancement,24,16,8
44063,Notoxus,antonidas,1364,shaman,enhancement,78,39,39
44064,Elektrikci,silvermoon,1362,shaman,enhancement,66,30,36
44065,Trîkill,hyjal,1360,shaman,enhancement,60,28,32
44066,Басари,gordunni,1357,shaman,enhancement,41,20,21
44067,Shaayys,archimonde,1356,shaman,enhancement,102,44,58
44068,Chämalö,archimonde,1354,shaman,enhancement,151,78,73
44069,Lavashnikov,burning-legion,1353,shaman,enhancement,150,79,71
44070,Тленозавр,gordunni,1352,shaman,enhancement,93,46,47
44071,Darhgan,argent-dawn,1350,shaman,enhancement,30,16,14
44072,Nakenfeigy,stormreaver,1349,shaman,enhancement,54,32,22
44073,Рыргаск,howling-fjord,1349,shaman,enhancement,28,16,12
44074,Chamirox,ysondre,1348,shaman,enhancement,42,17,25
44075,Exysen,kazzak,1344,shaman,enhancement,24,14,10
44076,Enh,archimonde,1343,shaman,enhancement,24,14,10
44077,Faydé,stormscale,1343,shaman,enhancement,30,14,16
44078,Даблпамп,howling-fjord,1343,shaman,enhancement,35,16,19
44079,Кгб,greymane,1341,shaman,enhancement,72,33,39
44080,Дрегтан,howling-fjord,1341,shaman,enhancement,71,28,43
44081,Akimó,ravencrest,1340,shaman,enhancement,18,14,4
44082,Casualhex,argent-dawn,1340,shaman,enhancement,155,71,84
44083,Hatchum,les-sentinelles,1339,shaman,enhancement,60,24,36
44084,Chamel,draenor,1337,shaman,enhancement,30,14,16
44085,Залатар,howling-fjord,1337,shaman,enhancement,63,26,37
44086,Fingor,tarren-mill,1336,shaman,enhancement,24,17,7
44087,Gurtok,drakthul,1336,shaman,enhancement,36,22,14
44088,Bacheebg,darksorrow,1333,shaman,enhancement,101,54,47
44089,Éàsy,blackmoore,1333,shaman,enhancement,38,20,18
44090,Fotmglad,blackrock,1332,shaman,enhancement,24,14,10
44091,Boidarbre,sargeras,1331,shaman,enhancement,42,15,27
44092,Реалайзер,blackscar,1330,shaman,enhancement,24,14,10
44093,Shreks,frostmane,1330,shaman,enhancement,48,26,22
44094,Палачок,eversong,1328,shaman,enhancement,78,40,38
44095,Moodoo,antonidas,1328,shaman,enhancement,53,20,33
44096,Duhrak,argent-dawn,1327,shaman,enhancement,54,30,24
44097,Shamanite,drakthul,1326,shaman,enhancement,42,22,20
44098,Mhoriaak,stormscale,1326,shaman,enhancement,30,15,15
44099,Magmamonster,tarren-mill,1326,shaman,enhancement,30,14,16
44100,Akimboo,kilrogg,1324,shaman,enhancement,60,27,33
44101,Iicks,blackrock,1323,shaman,enhancement,48,21,27
44102,Kanabi,darkspear,1322,shaman,enhancement,30,14,16
44103,Бигмамуля,booty-bay,1321,shaman,enhancement,36,18,18
44104,Ошиндра,gordunni,1320,shaman,enhancement,28,15,13
44105,Clembute,cthun,1319,shaman,enhancement,48,28,20
44106,Hopefully,eredar,1316,shaman,enhancement,24,14,10
44107,Другалёк,howling-fjord,1314,shaman,enhancement,52,30,22
44108,Шабыч,deathguard,1312,shaman,enhancement,60,25,35
44109,Агмень,howling-fjord,1310,shaman,enhancement,127,56,71
44110,Outerspace,silvermoon,1309,shaman,enhancement,24,15,9
44111,Persaunne,archimonde,1309,shaman,enhancement,42,23,19
44112,Maajo,tarren-mill,1309,shaman,enhancement,54,21,33
44113,Relampago,eredar,1307,shaman,enhancement,36,16,20
44114,Lahur,blackmoore,1306,shaman,enhancement,30,19,11
44115,Qauter,hellfire,1305,shaman,enhancement,30,14,16
44116,Holten,outland,1302,shaman,enhancement,60,30,30
44117,Blautorkel,amanthul,1302,shaman,enhancement,65,31,34
44118,Groundead,alakir,1300,shaman,enhancement,40,16,24
44119,Shamaray,stormscale,1299,shaman,enhancement,96,52,44
44120,Rhastasho,archimonde,1299,shaman,enhancement,84,45,39
44121,Wedís,outland,1299,shaman,enhancement,42,22,20
44122,Barbebiendur,archimonde,1299,shaman,enhancement,36,16,20
44123,Thormarg,archimonde,1296,shaman,enhancement,60,29,31
44124,Kardyo,archimonde,1295,shaman,enhancement,21,14,7
44125,Sunetee,kazzak,1294,shaman,enhancement,54,23,31
44126,Verlas,kazzak,1293,shaman,enhancement,52,26,26
44127,Апинсмок,soulflayer,1292,shaman,enhancement,75,36,39
44128,Hexd,defias-brotherhood,1291,shaman,enhancement,66,28,38
44129,Kunancementa,ravencrest,1289,shaman,enhancement,75,32,43
44130,Shambambum,blackrock,1289,shaman,enhancement,113,48,65
44131,Goatsandoats,doomhammer,1287,shaman,enhancement,24,15,9
44132,Trollomatic,das-syndikat,1286,shaman,enhancement,54,28,26
44133,Haldrim,blackmoore,1284,shaman,enhancement,27,15,12
44134,Киллдрак,howling-fjord,1283,shaman,enhancement,36,19,17
44135,Срувтапкии,deathguard,1282,shaman,enhancement,54,29,25
44136,Juliaroberts,ragnaros,1282,shaman,enhancement,93,46,47
44137,Zandali,tarren-mill,1280,shaman,enhancement,78,44,34
44138,Idxbi,kazzak,1279,shaman,enhancement,114,63,51
44139,Manrod,tarren-mill,1279,shaman,enhancement,66,34,32
44140,Лэнгипас,gordunni,1278,shaman,enhancement,155,79,76
44141,Shamomo,hyjal,1278,shaman,enhancement,85,38,47
44142,Шрамуля,soulflayer,1277,shaman,enhancement,23,15,8
44143,Броаркар,razuvious,1277,shaman,enhancement,106,56,50
44144,Амфеминка,gordunni,1275,shaman,enhancement,28,14,14
44145,Tzaish,blackmoore,1271,shaman,enhancement,28,14,14
44146,Delgagalduos,kazzak,1267,shaman,enhancement,48,25,23
44147,Vukroth,argent-dawn,1266,shaman,enhancement,48,25,23
44148,Ørgus,aegwynn,1265,shaman,enhancement,274,146,128
44149,Tornadozzer,burning-legion,1263,shaman,enhancement,54,29,25
44150,Prømetheüs,sanguino,1262,shaman,enhancement,58,35,23
44151,Shamaneo,outland,1260,shaman,enhancement,39,26,13
44152,Чернышус,soulflayer,1259,shaman,enhancement,44,20,24
44153,Baineoof,tarren-mill,1259,shaman,enhancement,41,18,23
44154,Psychobarbie,outland,1255,shaman,enhancement,23,14,9
44155,Адичал,soulflayer,1253,shaman,enhancement,36,20,16
44156,Gõðzilla,blackmoore,1253,shaman,enhancement,34,17,17
44157,Simularcum,kazzak,1252,shaman,enhancement,36,18,18
44158,Тоннимонтана,howling-fjord,1250,shaman,enhancement,26,15,11
44159,Тенав,blackscar,1249,shaman,enhancement,54,28,26
44160,Darkstrong,alakir,1248,shaman,enhancement,30,17,13
44161,Ostosmvp,ravencrest,1248,shaman,enhancement,24,13,11
44162,Arcura,twisting-nether,1247,shaman,enhancement,36,21,15
44163,Guqin,ravencrest,1247,shaman,enhancement,40,19,21
44164,Eclaîr,thrall,1247,shaman,enhancement,30,13,17
44165,Worstshamy,sanguino,1246,shaman,enhancement,18,13,5
44166,Wylly,aegwynn,1246,shaman,enhancement,18,13,5
44167,Purada,blackrock,1246,shaman,enhancement,24,13,11
44168,Dumbasha,ravencrest,1245,shaman,enhancement,24,13,11
44169,Ishokyou,thrall,1245,shaman,enhancement,55,24,31
44170,Tauridus,blackrock,1244,shaman,enhancement,18,13,5
44171,Murdá,ravencrest,1244,shaman,enhancement,24,13,11
44172,Архивоитель,soulflayer,1243,shaman,enhancement,24,13,11
44173,Windstørm,tarren-mill,1242,shaman,enhancement,21,14,7
44174,Громовойбро,blackscar,1242,shaman,enhancement,24,13,11
44175,Lavalordd,tarren-mill,1242,shaman,enhancement,24,13,11
44176,Tryor,darksorrow,1242,shaman,enhancement,24,13,11
44177,Виндфуриа,gordunni,1242,shaman,enhancement,72,36,36
44178,Hichibane,archimonde,1242,shaman,enhancement,30,13,17
44179,Krishun,blackmoore,1242,shaman,enhancement,30,13,17
44180,Dropbax,khaz-modan,1242,shaman,enhancement,48,19,29
44181,Nêmônin,perenolde,1241,shaman,enhancement,18,13,5
44182,Morkyy,thrall,1241,shaman,enhancement,18,13,5
44183,Katastrofuss,stormscale,1241,shaman,enhancement,53,29,24
44184,Enoughh,the-maelstrom,1241,shaman,enhancement,24,13,11
44185,Ql,twisting-nether,1241,shaman,enhancement,24,13,11
44186,Noxstorm,frostwolf,1241,shaman,enhancement,48,23,25
44187,Roastbeef,blackrock,1240,shaman,enhancement,38,21,17
44188,Lava,haomarush,1240,shaman,enhancement,24,13,11
44189,Beletili,chogall,1240,shaman,enhancement,65,27,38
44190,Trollden,silvermoon,1239,shaman,enhancement,24,13,11
44191,Níkíta,hyjal,1237,shaman,enhancement,18,13,5
44192,Чёкнутое,soulflayer,1236,shaman,enhancement,45,26,19
44193,Kolbászlelkü,ragnaros,1236,shaman,enhancement,24,13,11
44194,Hodir,bronzebeard,1236,shaman,enhancement,40,20,20
44195,Movex,arathor,1235,shaman,enhancement,24,13,11
44196,Enkzäm,archimonde,1235,shaman,enhancement,47,23,24
44197,Volltinus,tarren-mill,1235,shaman,enhancement,36,13,23
44198,Видсон,soulflayer,1234,shaman,enhancement,30,14,16
44199,Kargos,stormscale,1234,shaman,enhancement,30,13,17
44200,Yasan,kazzak,1230,shaman,enhancement,49,23,26
44201,Cowkiller,minahonda,1229,shaman,enhancement,30,17,13
44202,Элетар,gordunni,1228,shaman,enhancement,60,26,34
44203,Treizelol,ysondre,1227,shaman,enhancement,35,17,18
44204,Elesilf,sanguino,1226,shaman,enhancement,24,13,11
44205,Blitzviech,aegwynn,1226,shaman,enhancement,29,14,15
44206,Эйнхарий,howling-fjord,1226,shaman,enhancement,30,13,17
44207,Slaphappy,hellscream,1221,shaman,enhancement,27,14,13
44208,Bachetobg,darksorrow,1220,shaman,enhancement,59,30,29
44209,Thossa,draenor,1219,shaman,enhancement,88,48,40
44210,Patites,twisting-nether,1217,shaman,enhancement,60,31,29
44211,Ulvur,blackhand,1216,shaman,enhancement,30,13,17
44212,Тандерхем,gordunni,1215,shaman,enhancement,30,15,15
44213,Dendyre,outland,1214,shaman,enhancement,29,13,16
44214,Théar,ravencrest,1212,shaman,enhancement,30,15,15
44215,Rhakhatheckh,nemesis,1208,shaman,enhancement,30,13,17
44216,Yeemayne,outland,1206,shaman,enhancement,18,13,5
44217,Sg,la-croisade-écarlate,1203,shaman,enhancement,55,30,25
44218,Литлсмурф,gordunni,1200,shaman,enhancement,51,21,30
44219,Шамяра,blackscar,1199,shaman,enhancement,18,13,5
44220,Tremuchamy,tyrande,1198,shaman,enhancement,39,23,16
44221,Tashunka,twisting-nether,1198,shaman,enhancement,118,54,64
44222,Saduria,antonidas,1194,shaman,enhancement,78,44,34
44223,Gárrok,nerathor,1193,shaman,enhancement,24,13,11
44224,Mahlga,argent-dawn,1192,shaman,enhancement,114,55,59
44225,Sinkero,hellscream,1192,shaman,enhancement,44,17,27
44226,Korzo,amanthul,1190,shaman,enhancement,28,19,9
44227,Allakbarz,stormscale,1190,shaman,enhancement,94,39,55
44228,Hyamala,chamber-of-aspects,1189,shaman,enhancement,30,18,12
44229,Hedjin,argent-dawn,1187,shaman,enhancement,66,35,31
44230,Humming,sanguino,1187,shaman,enhancement,63,33,30
44231,Talf,tarren-mill,1186,shaman,enhancement,23,13,10
44232,Ponzu,silvermoon,1184,shaman,enhancement,24,14,10
44233,Mudwalker,ravencrest,1177,shaman,enhancement,27,13,14
44234,Быковат,booty-bay,1176,shaman,enhancement,42,16,26
44235,Grimtøtem,defias-brotherhood,1173,shaman,enhancement,42,18,24
44236,Wolfshade,aggra-português,1172,shaman,enhancement,23,13,10
44237,Vàlentina,blackmoore,1170,shaman,enhancement,41,24,17
44238,Maulstrom,pozzo-delleternità,1169,shaman,enhancement,26,17,9
44239,Exinos,sylvanas,1169,shaman,enhancement,35,15,20
44240,Sounoukfrit,dalaran,1168,shaman,enhancement,45,22,23
44241,Nòrgan,die-aldor,1167,shaman,enhancement,13,13,0
44242,Skólt,blackrock,1166,shaman,enhancement,56,25,31
44243,Veronikka,dalaran,1163,shaman,enhancement,31,14,17
44244,Quartodebue,nemesis,1162,shaman,enhancement,24,13,11
44245,Crespouu,doomhammer,1162,shaman,enhancement,56,30,26
44246,Свистт,fordragon,1156,shaman,enhancement,76,31,45
44247,Волкк,soulflayer,1154,shaman,enhancement,37,18,19
44248,Nurychic,twisting-nether,1154,shaman,enhancement,63,24,39
44249,Ипа,thermaplugg,1153,shaman,enhancement,48,26,22
44250,Zerocarè,tarren-mill,1152,shaman,enhancement,18,12,6
44251,Fyrkaz,aegwynn,1152,shaman,enhancement,18,12,6
44252,Gorogoró,kazzak,1152,shaman,enhancement,18,12,6
44253,Uselesstwo,archimonde,1152,shaman,enhancement,24,12,12
44254,Тыпроиграл,gordunni,1152,shaman,enhancement,24,12,12
44255,Shootinguard,kazzak,1151,shaman,enhancement,18,12,6
44256,Cløke,stormscale,1151,shaman,enhancement,18,12,6
44257,Seçretweapøn,kazzak,1151,shaman,enhancement,18,12,6
44258,Gønêxt,ravencrest,1151,shaman,enhancement,18,12,6
44259,Blyxuhm,argent-dawn,1151,shaman,enhancement,18,12,6
44260,Buzz,stormscale,1151,shaman,enhancement,24,12,12
44261,Sangvinus,outland,1151,shaman,enhancement,56,22,34
44262,Altotem,blackmoore,1150,shaman,enhancement,18,12,6
44263,Brotein,blackmoore,1150,shaman,enhancement,18,12,6
44264,Scherolol,aegwynn,1149,shaman,enhancement,18,12,6
44265,Litenrolixd,tarren-mill,1149,shaman,enhancement,18,12,6
44266,Dmgaddict,kazzak,1149,shaman,enhancement,24,12,12
44267,Магмарончик,gordunni,1149,shaman,enhancement,56,26,30
44268,Onepatchman,silvermoon,1148,shaman,enhancement,24,12,12
44269,Shamira,nethersturm,1148,shaman,enhancement,30,12,18
44270,Porphy,kazzak,1147,shaman,enhancement,18,12,6
44271,Famepolîce,blackrock,1147,shaman,enhancement,18,12,6
44272,Kirtach,dun-modr,1146,shaman,enhancement,18,12,6
44273,Bærserker,blackmoore,1146,shaman,enhancement,22,13,9
44274,Дректаш,soulflayer,1146,shaman,enhancement,24,12,12
44275,Ibicc,twisting-nether,1146,shaman,enhancement,24,12,12
44276,Lilbantu,ravencrest,1145,shaman,enhancement,24,15,9
44277,Zevissh,outland,1144,shaman,enhancement,24,12,12
44278,Greatthrall,kazzak,1144,shaman,enhancement,30,14,16
44279,Cillysha,ravencrest,1143,shaman,enhancement,18,12,6
44280,Maurrigan,rashgarroth,1142,shaman,enhancement,18,12,6
44281,Ðexx,stormscale,1141,shaman,enhancement,18,12,6
44282,Shock,magtheridon,1140,shaman,enhancement,29,17,12
44283,Brooce,sylvanas,1140,shaman,enhancement,30,12,18
44284,Barthølømew,kazzak,1139,shaman,enhancement,24,12,12
44285,Ipbar,blackrock,1137,shaman,enhancement,24,13,11
44286,Cementatar,burning-blade,1136,shaman,enhancement,30,15,15
44287,Zzadoxor,doomhammer,1134,shaman,enhancement,24,12,12
44288,Pøllemodex,frostwhisper,1132,shaman,enhancement,25,13,12
44289,Vaesk,auchindoun,1131,shaman,enhancement,30,15,15
44290,Mustang,twilights-hammer,1131,shaman,enhancement,48,16,32
44291,Madbud,stormscale,1129,shaman,enhancement,23,12,11
44292,Cool,tarren-mill,1129,shaman,enhancement,33,13,20
44293,Плюжка,greymane,1127,shaman,enhancement,122,62,60
44294,Philcallings,tarren-mill,1127,shaman,enhancement,27,13,14
44295,Даркгрон,thermaplugg,1126,shaman,enhancement,42,17,25
44296,Stormrex,magtheridon,1124,shaman,enhancement,60,31,29
44297,Namrdak,quelthalas,1123,shaman,enhancement,48,25,23
44298,Ðragaø,kazzak,1122,shaman,enhancement,24,12,12
44299,Draugrinns,tarren-mill,1121,shaman,enhancement,24,12,12
44300,Jaykezap,kazzak,1118,shaman,enhancement,23,12,11
44301,Precíous,sporeggar,1115,shaman,enhancement,34,19,15
44302,Bumm,twisting-nether,1115,shaman,enhancement,36,15,21
44303,Welgor,kult-der-verdammten,1112,shaman,enhancement,18,12,6
44304,Акер,deathguard,1108,shaman,enhancement,24,14,10
44305,Тотемныйчад,gordunni,1104,shaman,enhancement,28,13,15
44306,Боргрим,eversong,1104,shaman,enhancement,46,17,29
44307,Biglynx,sanguino,1103,shaman,enhancement,108,60,48
44308,Dakotasham,ravencrest,1102,shaman,enhancement,17,12,5
44309,Eneruswag,draenor,1098,shaman,enhancement,29,14,15
44310,Kireekoura,tarren-mill,1097,shaman,enhancement,33,14,19
44311,Isladinks,draenor,1096,shaman,enhancement,81,35,46
44312,Windfury,sylvanas,1095,shaman,enhancement,51,23,28
44313,Бойкийкот,gordunni,1094,shaman,enhancement,36,16,20
44314,Janserey,burning-legion,1090,shaman,enhancement,30,12,18
44315,Kertunsisko,emeriss,1089,shaman,enhancement,48,18,30
44316,Varagun,argent-dawn,1088,shaman,enhancement,31,13,18
44317,Kringspierce,twisting-nether,1086,shaman,enhancement,55,34,21
44318,Eleboss,frostwolf,1082,shaman,enhancement,42,24,18
44319,Oddsocks,stormscale,1082,shaman,enhancement,54,23,31
44320,Интендо,soulflayer,1079,shaman,enhancement,21,12,9
44321,Эсфира,ashenvale,1079,shaman,enhancement,41,20,21
44322,Snoc,guldan,1077,shaman,enhancement,57,26,31
44323,Bábbajaggí,blackrock,1077,shaman,enhancement,30,13,17
44324,Esciamano,nemesis,1074,shaman,enhancement,41,27,14
44325,Xarozz,blackmoore,1071,shaman,enhancement,42,20,22
44326,Анашишка,borean-tundra,1069,shaman,enhancement,42,16,26
44327,Zmech,chamber-of-aspects,1068,shaman,enhancement,25,12,13
44328,Blutschrei,tarren-mill,1063,shaman,enhancement,75,26,49
44329,Харрум,soulflayer,1061,shaman,enhancement,56,29,27
44330,Rorenth,blackhand,1061,shaman,enhancement,74,38,36
44331,Daelements,shadowsong,1059,shaman,enhancement,27,13,14
44332,Kärmá,stormscale,1056,shaman,enhancement,18,11,7
44333,Axiiom,draenor,1056,shaman,enhancement,18,11,7
44334,Fòóxi,ravencrest,1056,shaman,enhancement,156,82,74
44335,Юрахафанбой,blackscar,1055,shaman,enhancement,18,11,7
44336,Kelvok,silvermoon,1055,shaman,enhancement,18,11,7
44337,Pay,stormscale,1055,shaman,enhancement,18,11,7
44338,Иллюминэйшн,soulflayer,1055,shaman,enhancement,24,11,13
44339,Trobø,ravencrest,1055,shaman,enhancement,33,12,21
44340,Cch,kazzak,1054,shaman,enhancement,18,11,7
44341,Berserked,emeriss,1054,shaman,enhancement,18,11,7
44342,Eliaap,antonidas,1054,shaman,enhancement,153,71,82
44343,Kral,defias-brotherhood,1053,shaman,enhancement,18,11,7
44344,Razush,draenor,1053,shaman,enhancement,18,11,7
44345,Electricgødx,tarren-mill,1053,shaman,enhancement,18,11,7
44346,Drexx,thrall,1053,shaman,enhancement,18,11,7
44347,Hitmeagain,blackhand,1053,shaman,enhancement,24,11,13
44348,Othu,ragnaros,1053,shaman,enhancement,24,11,13
44349,Хмелецкий,soulflayer,1052,shaman,enhancement,42,23,19
44350,Onefurall,ragnaros,1052,shaman,enhancement,24,11,13
44351,Swooch,shattered-hand,1051,shaman,enhancement,12,11,1
44352,Satisfya,ambossar,1051,shaman,enhancement,18,11,7
44353,Foulecamp,archimonde,1050,shaman,enhancement,24,11,13
44354,Apócalypsee,ravencrest,1050,shaman,enhancement,24,11,13
44355,Splat,burning-blade,1049,shaman,enhancement,18,11,7
44356,Andrewbéelko,drakthul,1049,shaman,enhancement,18,11,7
44357,Erupted,draenor,1049,shaman,enhancement,30,11,19
44358,Кесмар,soulflayer,1048,shaman,enhancement,18,11,7
44359,Щцц,soulflayer,1047,shaman,enhancement,18,11,7
44360,Burstorama,alleria,1047,shaman,enhancement,18,11,7
44361,Navy,frostwolf,1046,shaman,enhancement,18,11,7
44362,Aquæ,suramar,1045,shaman,enhancement,156,83,73
44363,Shamrøck,archimonde,1045,shaman,enhancement,36,18,18
44364,Tênzo,ysondre,1043,shaman,enhancement,24,11,13
44365,Шамвкроксах,gordunni,1043,shaman,enhancement,24,11,13
44366,Wargriman,kelthuzad,1042,shaman,enhancement,29,16,13
44367,Puncochar,zuljin,1042,shaman,enhancement,24,11,13
44368,Burghezu,magtheridon,1038,shaman,enhancement,36,20,16
44369,Murog,dalaran,1035,shaman,enhancement,19,12,7
44370,Wioda,silvermoon,1025,shaman,enhancement,47,27,20
44371,Pïdòrás,kazzak,1023,shaman,enhancement,17,11,6
44372,Шалман,thermaplugg,1023,shaman,enhancement,257,120,137
44373,Åkra,kazzak,1021,shaman,enhancement,22,11,11
44374,Øzy,sanguino,1020,shaman,enhancement,24,15,9
44375,Zugzie,draenor,1016,shaman,enhancement,36,14,22
44376,Kushme,silvermoon,1014,shaman,enhancement,84,36,48
44377,Totkodem,twisting-nether,1013,shaman,enhancement,32,14,18
44378,Pelorta,zuljin,1004,shaman,enhancement,17,11,6
44379,Chamtroulku,ysondre,1001,shaman,enhancement,23,11,12
44380,Vegà,thrall,1000,shaman,enhancement,21,13,8
44381,Tism,stormscale,999,shaman,enhancement,22,11,11
44382,Whizjy,sanguino,993,shaman,enhancement,34,14,20
44383,Freizeitler,antonidas,988,shaman,enhancement,17,11,6
44384,Izaarleus,argent-dawn,986,shaman,enhancement,29,11,18
44385,Yunero,argent-dawn,975,shaman,enhancement,19,11,8
44386,Gixor,silvermoon,960,shaman,enhancement,12,10,2
44387,Tätschentim,blackrock,960,shaman,enhancement,12,10,2
44388,Miøn,kazzak,960,shaman,enhancement,12,10,2
44389,Dumhuvud,stormscale,960,shaman,enhancement,12,10,2
44390,Billburr,aegwynn,960,shaman,enhancement,12,10,2
44391,Shaddoo,stormscale,960,shaman,enhancement,12,10,2
44392,Биттерлинкс,blackscar,960,shaman,enhancement,18,10,8
44393,Crysis,sanguino,960,shaman,enhancement,18,10,8
44394,Bullet,blackmoore,960,shaman,enhancement,18,10,8
44395,Dwarfstil,blackmoore,960,shaman,enhancement,21,11,10
44396,Рыганский,blackscar,960,shaman,enhancement,30,10,20
44397,Ræi,drakthul,959,shaman,enhancement,12,10,2
44398,Акаварри,gordunni,959,shaman,enhancement,12,10,2
44399,Flameshock,stormreaver,959,shaman,enhancement,12,10,2
44400,Майндшторм,blackscar,959,shaman,enhancement,18,10,8
44401,Hariboo,arthas,959,shaman,enhancement,18,10,8
44402,Asçele,kazzak,959,shaman,enhancement,18,10,8
44403,Atis,the-maelstrom,959,shaman,enhancement,18,10,8
44404,Sûckmytotem,ragnaros,959,shaman,enhancement,18,10,8
44405,Windypops,tarren-mill,959,shaman,enhancement,18,10,8
44406,Evííl,tarren-mill,958,shaman,enhancement,12,10,2
44407,Numeschnäu,eredar,958,shaman,enhancement,12,10,2
44408,Ugory,die-aldor,958,shaman,enhancement,12,10,2
44409,Myngo,thrall,958,shaman,enhancement,18,10,8
44410,Hurb,malorne,958,shaman,enhancement,18,10,8
44411,Таиров,soulflayer,956,shaman,enhancement,12,10,2
44412,Shockndawe,kazzak,956,shaman,enhancement,18,10,8
44413,Pushs,archimonde,956,shaman,enhancement,18,10,8
44414,Towi,krasus,955,shaman,enhancement,12,10,2
44415,Stlakañ,chants-éternels,955,shaman,enhancement,12,10,2
44416,Krakennm,dalaran,955,shaman,enhancement,61,28,33
44417,Nâs,kazzak,955,shaman,enhancement,24,10,14
44418,Pureflame,silvermoon,955,shaman,enhancement,24,10,14
44419,Tufftnamn,frostmane,955,shaman,enhancement,24,10,14
44420,Promethxis,silvermoon,955,shaman,enhancement,24,10,14
44421,Charth,ravencrest,954,shaman,enhancement,49,18,31
44422,Carcksn,nerathor,951,shaman,enhancement,18,10,8
44423,Nazma,blackhand,949,shaman,enhancement,12,10,2
44424,Rushfabi,aegwynn,948,shaman,enhancement,24,10,14
44425,Wuchtzwerg,terrordar,945,shaman,enhancement,12,10,2
44426,Xakum,stormscale,944,shaman,enhancement,12,10,2
44427,Nezuka,turalyon,944,shaman,enhancement,22,11,11
44428,Ogmehu,stormreaver,944,shaman,enhancement,33,10,23
44429,Chronochrome,chamber-of-aspects,939,shaman,enhancement,75,38,37
44430,Zerandolix,blackrock,936,shaman,enhancement,26,10,16
44431,Чухмандос,gordunni,932,shaman,enhancement,23,11,12
44432,Nethershock,blackmoore,928,shaman,enhancement,84,44,40
44433,Elrayitos,shendralar,927,shaman,enhancement,22,10,12
44434,Practicetwo,argent-dawn,924,shaman,enhancement,23,10,13
44435,Rylidare,khaz-modan,921,shaman,enhancement,53,24,29
44436,Ryujìñjakka,culte-de-la-rive-noire,919,shaman,enhancement,24,12,12
44437,Gruldo,tarren-mill,915,shaman,enhancement,35,10,25
44438,Sardemar,defias-brotherhood,914,shaman,enhancement,24,13,11
44439,Cimer,sargeras,914,shaman,enhancement,87,37,50
44440,Hellskon,silvermoon,909,shaman,enhancement,17,10,7
44441,Twotwozero,defias-brotherhood,908,shaman,enhancement,35,14,21
44442,Тыщатристах,howling-fjord,903,shaman,enhancement,18,11,7
44443,Stubby,nagrand,903,shaman,enhancement,31,14,17
44444,Stormkëëpër,stormscale,897,shaman,enhancement,33,11,22
44445,Cràfty,blackrock,893,shaman,enhancement,20,10,10
44446,Awsomo,ravencrest,891,shaman,enhancement,29,10,19
44447,Mimsy,hyjal,876,shaman,enhancement,53,21,32
44448,Mendoz,nazjatar,875,shaman,enhancement,74,35,39
44449,Йодаримару,howling-fjord,864,shaman,enhancement,12,9,3
44450,Khylejenner,kazzak,864,shaman,enhancement,12,9,3
44451,Alainralso,archimonde,864,shaman,enhancement,12,9,3
44452,Turbothea,blackmoore,864,shaman,enhancement,12,9,3
44453,Blackyx,dun-modr,864,shaman,enhancement,12,9,3
44454,Faroh,ravencrest,864,shaman,enhancement,12,9,3
44455,Martini,tichondrius,864,shaman,enhancement,15,10,5
44456,Tswiftx,tarren-mill,864,shaman,enhancement,18,9,9
44457,Dwarfovic,ravencrest,864,shaman,enhancement,18,9,9
44458,Шамунчез,gordunni,863,shaman,enhancement,12,9,3
44459,Maddogxz,frostwolf,863,shaman,enhancement,12,9,3
44460,Keisys,kazzak,863,shaman,enhancement,18,9,9
44461,Nëÿrën,drakthul,863,shaman,enhancement,18,9,9
44462,Réläx,kazzak,863,shaman,enhancement,18,9,9
44463,Purgey,ravencrest,863,shaman,enhancement,18,9,9
44464,Taraesh,blackhand,863,shaman,enhancement,18,9,9
44465,Jhagy,archimonde,863,shaman,enhancement,18,9,9
44466,Хаммерн,gordunni,863,shaman,enhancement,18,9,9
44467,Nìno,azshara,863,shaman,enhancement,18,9,9
44468,Zðhan,azshara,863,shaman,enhancement,18,9,9
44469,Khanaky,hyjal,863,shaman,enhancement,18,9,9
44470,Shockrates,pozzo-delleternità,863,shaman,enhancement,18,9,9
44471,Sgtspyke,ragnaros,863,shaman,enhancement,24,9,15
44472,Jabja,antonidas,862,shaman,enhancement,18,9,9
44473,Brigantino,burning-legion,862,shaman,enhancement,18,9,9
44474,Tuncha,runetotem,862,shaman,enhancement,18,9,9
44475,Shoockwave,twisting-nether,862,shaman,enhancement,18,9,9
44476,Pissluffer,tarren-mill,862,shaman,enhancement,18,9,9
44477,Azrodas,defias-brotherhood,862,shaman,enhancement,18,9,9
44478,Gagné,hyjal,862,shaman,enhancement,18,9,9
44479,Айбывайбы,howling-fjord,862,shaman,enhancement,18,9,9
44480,Tunae,azjolnerub,862,shaman,enhancement,23,11,12
44481,Jaydc,silvermoon,862,shaman,enhancement,22,9,13
44482,Ордосус,gordunni,862,shaman,enhancement,24,9,15
44483,Yabadabadoo,burning-legion,861,shaman,enhancement,18,9,9
44484,Seriux,twisting-nether,860,shaman,enhancement,15,10,5
44485,Lottery,ragnaros,860,shaman,enhancement,18,9,9
44486,Rashtar,ravencrest,860,shaman,enhancement,18,9,9
44487,Ягном,soulflayer,860,shaman,enhancement,24,9,15
44488,Jockin,tarren-mill,860,shaman,enhancement,24,9,15
44489,Gälädhan,ysondre,859,shaman,enhancement,24,12,12
44490,Doclava,twisting-nether,859,shaman,enhancement,18,9,9
44491,Hexrated,draenor,859,shaman,enhancement,21,10,11
44492,Shockaibo,drakthul,859,shaman,enhancement,24,9,15
44493,Furioous,ravencrest,857,shaman,enhancement,18,9,9
44494,Yzeed,argent-dawn,856,shaman,enhancement,18,9,9
44495,Shamsterr,karazhan,852,shaman,enhancement,18,9,9
44496,Shamaniak,tarren-mill,851,shaman,enhancement,30,9,21
44497,Рэйпушка,gordunni,847,shaman,enhancement,23,9,14
44498,Fika,the-venture-co,845,shaman,enhancement,18,9,9
44499,Biphrost,nemesis,837,shaman,enhancement,30,12,18
44500,Shaminista,ravencrest,836,shaman,enhancement,18,9,9
44501,Мигнтз,soulflayer,831,shaman,enhancement,17,9,8
44502,Deeblu,nemesis,821,shaman,enhancement,24,9,15
44503,Draabada,stormscale,816,shaman,enhancement,15,9,6
44504,Paschol,aegwynn,816,shaman,enhancement,21,9,12
44505,Pocahøntas,archimonde,810,shaman,enhancement,27,10,17
44506,Мамонтшам,howling-fjord,808,shaman,enhancement,17,9,8
44507,Ìkarus,eredar,804,shaman,enhancement,40,17,23
44508,Elcoustillou,throkferoth,800,shaman,enhancement,52,16,36
44509,Vix,argent-dawn,799,shaman,enhancement,14,9,5
44510,Nuluadroguri,twisting-nether,793,shaman,enhancement,22,9,13
44511,Hamstéole,hyjal,784,shaman,enhancement,16,9,7
44512,Razgriz,confrérie-du-thorium,784,shaman,enhancement,19,9,10
44513,Koiru,argent-dawn,782,shaman,enhancement,19,9,10
44514,Achtungblitz,blackrock,768,shaman,enhancement,12,8,4
44515,Драгенхз,gordunni,768,shaman,enhancement,12,8,4
44516,Khorgam,twisting-nether,768,shaman,enhancement,12,8,4
44517,Sleven,twisting-nether,768,shaman,enhancement,12,8,4
44518,Махош,blackscar,768,shaman,enhancement,12,8,4
44519,Thunderdøme,stormscale,768,shaman,enhancement,12,8,4
44520,Dêblâzê,thrall,768,shaman,enhancement,12,8,4
44521,Cocolopez,tichondrius,768,shaman,enhancement,12,8,4
44522,Maksimon,blackrock,768,shaman,enhancement,12,8,4
44523,Trulor,stormscale,768,shaman,enhancement,12,8,4
44524,Бурапи,howling-fjord,768,shaman,enhancement,12,8,4
44525,Flamii,burning-legion,768,shaman,enhancement,12,8,4
44526,Bufalan,uldum,768,shaman,enhancement,12,8,4
44527,Qätär,ravencrest,768,shaman,enhancement,12,8,4
44528,Healníx,ravencrest,768,shaman,enhancement,12,8,4
44529,Kuse,blackmoore,768,shaman,enhancement,12,8,4
44530,Lytningx,ravencrest,768,shaman,enhancement,12,8,4
44531,Kwengi,stormreaver,768,shaman,enhancement,12,8,4
44532,Drade,aegwynn,768,shaman,enhancement,14,8,6
44533,Gnomecake,vashj,768,shaman,enhancement,18,8,10
44534,Bmtotem,twisting-nether,768,shaman,enhancement,18,8,10
44535,Toobiib,culte-de-la-rive-noire,768,shaman,enhancement,18,8,10
44536,Kàffkalafká,blackrock,768,shaman,enhancement,18,8,10
44537,Babal,outland,768,shaman,enhancement,24,8,16
44538,Айспик,ashenvale,768,shaman,enhancement,24,8,16
44539,Naahma,hyjal,768,shaman,enhancement,24,8,16
44540,Windshockah,tarren-mill,767,shaman,enhancement,12,8,4
44541,Complete,hyjal,767,shaman,enhancement,12,8,4
44542,Wawawoowee,archimonde,767,shaman,enhancement,12,8,4
44543,Wonderman,jaedenar,767,shaman,enhancement,12,8,4
44544,Ericlomax,frostwhisper,767,shaman,enhancement,12,8,4
44545,Ichboxdich,madmortem,767,shaman,enhancement,12,8,4
44546,Bantzer,twisting-nether,767,shaman,enhancement,15,8,7
44547,Pinkylol,stormscale,767,shaman,enhancement,18,8,10
44548,Tonifo,nemesis,767,shaman,enhancement,18,8,10
44549,Rázzìm,eredar,767,shaman,enhancement,18,8,10
44550,Szamanito,turalyon,767,shaman,enhancement,18,8,10
44551,Neroty,blackmoore,767,shaman,enhancement,18,8,10
44552,Carlos,magtheridon,767,shaman,enhancement,18,8,10
44553,Tschacô,malganis,767,shaman,enhancement,18,8,10
44554,Nínive,zuljin,767,shaman,enhancement,18,8,10
44555,Zaappyboii,azjolnerub,767,shaman,enhancement,18,8,10
44556,Икзок,soulflayer,766,shaman,enhancement,18,8,10
44557,Târu,blackrock,766,shaman,enhancement,24,8,16
44558,Niveamann,eredar,765,shaman,enhancement,12,8,4
44559,Runeksham,tarren-mill,765,shaman,enhancement,18,8,10
44560,Lôù,archimonde,765,shaman,enhancement,18,8,10
44561,Энхким,soulflayer,765,shaman,enhancement,32,8,24
44562,Ronctaha,blackrock,764,shaman,enhancement,12,8,4
44563,Carusø,thrall,764,shaman,enhancement,18,8,10
44564,Strygwyrl,doomhammer,764,shaman,enhancement,18,8,10
44565,Hectoraïus,ysondre,763,shaman,enhancement,18,8,10
44566,Зулкунд,soulflayer,763,shaman,enhancement,18,8,10
44567,Fourbevent,archimonde,762,shaman,enhancement,12,8,4
44568,Gibspark,twisting-nether,762,shaman,enhancement,12,8,4
44569,Jangal,die-nachtwache,762,shaman,enhancement,13,8,5
44570,Màverìck,nemesis,761,shaman,enhancement,12,8,4
44571,Sifu,ragnaros,761,shaman,enhancement,12,8,4
44572,Грейсаша,howling-fjord,760,shaman,enhancement,12,8,4
44573,Ironsidé,ragnaros,760,shaman,enhancement,24,8,16
44574,Шамблабла,soulflayer,756,shaman,enhancement,30,8,22
44575,Нуишам,soulflayer,755,shaman,enhancement,12,8,4
44576,Fotmslave,laughing-skull,749,shaman,enhancement,15,10,5
44577,Ластыч,borean-tundra,744,shaman,enhancement,18,8,10
44578,Asogg,archimonde,743,shaman,enhancement,24,9,15
44579,Залазани,soulflayer,735,shaman,enhancement,18,8,10
44580,Argueaner,eonar,721,shaman,enhancement,28,9,19
44581,Negårn,tarren-mill,719,shaman,enhancement,11,8,3
44582,Glibnica,draenor,718,shaman,enhancement,15,8,7
44583,Xereús,kazzak,718,shaman,enhancement,23,8,15
44584,Ihealbro,blackrock,714,shaman,enhancement,16,11,5
44585,Slímshámmy,twisting-nether,714,shaman,enhancement,20,10,10
44586,Pospodrol,ragnaros,704,shaman,enhancement,16,8,8
44587,Faridstreng,blackmoore,703,shaman,enhancement,11,8,3
44588,Spajry,drakthul,702,shaman,enhancement,14,8,6
44589,Lavashock,tarren-mill,700,shaman,enhancement,28,8,20
44590,Chàrlord,twisting-nether,688,shaman,enhancement,19,8,11
44591,Jeppoh,tarren-mill,686,shaman,enhancement,13,8,5
44592,Tiamât,culte-de-la-rive-noire,685,shaman,enhancement,19,8,11
44593,Bärtigeberta,aegwynn,672,shaman,enhancement,10,8,2
44594,Djonebutton,kazzak,672,shaman,enhancement,12,7,5
44595,Raketsven,dentarg,672,shaman,enhancement,12,7,5
44596,Vutututututu,ragnaros,672,shaman,enhancement,12,7,5
44597,Sìberiano,pozzo-delleternità,672,shaman,enhancement,12,7,5
44598,Инсэйнгодх,soulflayer,672,shaman,enhancement,12,7,5
44599,Trixey,mazrigos,672,shaman,enhancement,12,7,5
44600,Roineé,draenor,672,shaman,enhancement,12,7,5
44601,Aspên,archimonde,672,shaman,enhancement,12,7,5
44602,Relentlessqt,aegwynn,672,shaman,enhancement,12,7,5
44603,Eomsham,magtheridon,672,shaman,enhancement,12,7,5
44604,Runè,azjolnerub,672,shaman,enhancement,12,7,5
44605,Metalbeef,xavius,672,shaman,enhancement,12,7,5
44606,Preams,blackrock,672,shaman,enhancement,12,7,5
44607,Virrogs,argent-dawn,672,shaman,enhancement,12,7,5
44608,Эоя,howling-fjord,672,shaman,enhancement,12,7,5
44609,Fernik,sanguino,672,shaman,enhancement,12,7,5
44610,Proper,tichondrius,672,shaman,enhancement,12,7,5
44611,Primez,twilights-hammer,672,shaman,enhancement,12,7,5
44612,Akatuseiwah,blackrock,672,shaman,enhancement,12,7,5
44613,Oneshotunía,burning-legion,672,shaman,enhancement,12,7,5
44614,Jaszczurka,stormrage,672,shaman,enhancement,12,7,5
44615,Likê,aegwynn,672,shaman,enhancement,12,7,5
44616,Lightning,aszune,672,shaman,enhancement,18,7,11
44617,Tzivati,draenor,672,shaman,enhancement,18,7,11
44618,Shougaku,blackrock,672,shaman,enhancement,18,7,11
44619,Ghettocheff,blackmoore,672,shaman,enhancement,18,7,11
44620,Boulestraan,silvermoon,672,shaman,enhancement,18,7,11
44621,Horiq,kazzak,672,shaman,enhancement,18,7,11
44622,Irmax,stormscale,672,shaman,enhancement,18,7,11
44623,Élisabethtwo,culte-de-la-rive-noire,672,shaman,enhancement,18,7,11
44624,Нерезшок,soulflayer,672,shaman,enhancement,18,7,11
44625,Swoltz,argent-dawn,672,shaman,enhancement,24,7,17
44626,Dwarfofwar,ravencrest,671,shaman,enhancement,12,7,5
44627,Meangreen,stormscale,671,shaman,enhancement,12,7,5
44628,Kejazal,blackrock,671,shaman,enhancement,12,7,5
44629,Okmogar,khaz-modan,671,shaman,enhancement,12,7,5
44630,Жезуш,galakrond,671,shaman,enhancement,12,7,5
44631,Outhell,sylvanas,671,shaman,enhancement,12,7,5
44632,Stormfury,balnazzar,671,shaman,enhancement,12,7,5
44633,Dénekha,zuljin,671,shaman,enhancement,12,7,5
44634,Джоннси,howling-fjord,671,shaman,enhancement,12,7,5
44635,Birnenpfeffi,malfurion,671,shaman,enhancement,12,7,5
44636,Thalmorius,argent-dawn,671,shaman,enhancement,12,7,5
44637,Gyuksz,arathor,671,shaman,enhancement,15,7,8
44638,Bigmassage,blackmoore,671,shaman,enhancement,18,7,11
44639,Götveren,eredar,671,shaman,enhancement,18,7,11
44640,Sajma,silvermoon,671,shaman,enhancement,18,7,11
44641,Cbshaman,sylvanas,671,shaman,enhancement,18,7,11
44642,Teenx,auchindoun,671,shaman,enhancement,18,7,11
44643,Fanatroka,ravencrest,671,shaman,enhancement,18,7,11
44644,Lumpp,kazzak,671,shaman,enhancement,24,7,17
44645,Florgegoyd,eredar,670,shaman,enhancement,12,7,5
44646,Silko,wrathbringer,670,shaman,enhancement,18,7,11
44647,Shockýbalboa,ragnaros,670,shaman,enhancement,18,7,11
44648,Phizzik,ravencrest,670,shaman,enhancement,18,7,11
44649,Elijaá,nordrassil,670,shaman,enhancement,18,7,11
44650,Sacrx,dalaran,670,shaman,enhancement,24,7,17
44651,Munnar,dalaran,669,shaman,enhancement,12,7,5
44652,Slavazsu,draenor,668,shaman,enhancement,12,7,5
44653,Spirites,drakthul,667,shaman,enhancement,12,7,5
44654,Viandehachee,dalaran,667,shaman,enhancement,12,7,5
44655,Wartay,doomhammer,667,shaman,enhancement,12,7,5
44656,Zoghzog,elune,667,shaman,enhancement,18,7,11
44657,Weaslêy,frostwolf,660,shaman,enhancement,18,7,11
44658,Shelara,drakthul,658,shaman,enhancement,12,7,5
44659,Фролыч,deathguard,645,shaman,enhancement,23,9,14
44660,Tacøshock,ravencrest,639,shaman,enhancement,8,8,0
44661,Maskiimon,blackrock,639,shaman,enhancement,14,8,6
44662,Hemradi,blackmoore,638,shaman,enhancement,11,7,4
44663,Tianoele,drakthul,624,shaman,enhancement,9,8,1
44664,Ивми,gordunni,623,shaman,enhancement,11,7,4
44665,Oldstorm,ravencrest,618,shaman,enhancement,22,10,12
44666,Zerodown,outland,614,shaman,enhancement,20,8,12
44667,Skillxdxdxd,outland,608,shaman,enhancement,16,7,9
44668,Перегной,ashenvale,607,shaman,enhancement,22,7,15
44669,Buffmepls,sanguino,607,shaman,enhancement,24,7,17
44670,Mowjo,la-croisade-écarlate,576,shaman,enhancement,6,6,0
44671,Thunderwill,sanguino,576,shaman,enhancement,12,6,6
44672,ßaßystärz,hyjal,576,shaman,enhancement,12,6,6
44673,Thëhêxfäçtør,tarren-mill,576,shaman,enhancement,12,6,6
44674,Szelenamoonx,outland,576,shaman,enhancement,12,6,6
44675,Jmpapa,tarren-mill,576,shaman,enhancement,12,6,6
44676,Lurtax,outland,576,shaman,enhancement,12,6,6
44677,Биттерлинкс,soulflayer,576,shaman,enhancement,12,6,6
44678,Вайгачи,soulflayer,576,shaman,enhancement,12,6,6
44679,Lafia,blackrock,576,shaman,enhancement,12,6,6
44680,Gruggosh,argent-dawn,576,shaman,enhancement,12,6,6
44681,Noneedshaman,stormscale,576,shaman,enhancement,12,6,6
44682,Searfang,korgall,576,shaman,enhancement,12,6,6
44683,Рскувосемь,soulflayer,576,shaman,enhancement,12,6,6
44684,Imotii,burning-legion,576,shaman,enhancement,12,6,6
44685,Bichîk,archimonde,576,shaman,enhancement,12,6,6
44686,Detestable,eredar,576,shaman,enhancement,12,6,6
44687,Degstaerian,ysera,576,shaman,enhancement,12,6,6
44688,Dami,die-aldor,576,shaman,enhancement,12,6,6
44689,Sherlokholms,ravencrest,576,shaman,enhancement,12,6,6
44690,Elemefayoh,tarren-mill,576,shaman,enhancement,12,6,6
44691,Tharma,blackmoore,576,shaman,enhancement,12,6,6
44692,Barneyflight,ravencrest,576,shaman,enhancement,12,6,6
44693,Zerak,twisting-nether,576,shaman,enhancement,15,7,8
44694,Bloodlusts,archimonde,576,shaman,enhancement,13,6,7
44695,Deadwölf,outland,576,shaman,enhancement,18,6,12
44696,Haasshaman,ravencrest,576,shaman,enhancement,18,6,12
44697,Dagoahgra,sanguino,576,shaman,enhancement,18,6,12
44698,Elektekk,blackrock,575,shaman,enhancement,10,7,3
44699,Fashess,sunstrider,575,shaman,enhancement,12,6,6
44700,Apolomaeuz,frostwolf,575,shaman,enhancement,12,6,6
44701,Rink,frostmane,575,shaman,enhancement,12,6,6
44702,Dergat,pozzo-delleternità,575,shaman,enhancement,12,6,6
44703,Tatyabis,drekthar,575,shaman,enhancement,12,6,6
44704,Finni,hyjal,575,shaman,enhancement,12,6,6
44705,Rykarn,eredar,575,shaman,enhancement,15,7,8
44706,Shawnmendes,kazzak,575,shaman,enhancement,15,7,8
44707,Saulty,archimonde,575,shaman,enhancement,18,6,12
44708,Ashgar,drakthul,575,shaman,enhancement,18,6,12
44709,Shockybalbóa,blackmoore,575,shaman,enhancement,18,6,12
44710,Tholatir,silvermoon,575,shaman,enhancement,24,6,18
44711,Jorny,burning-legion,575,shaman,enhancement,24,6,18
44712,Chamaiko,kaelthas,574,shaman,enhancement,18,6,12
44713,Zuziki,argent-dawn,573,shaman,enhancement,12,6,6
44714,Дядяшаман,gordunni,573,shaman,enhancement,24,6,18
44715,Vainerish,malygos,571,shaman,enhancement,12,6,6
44716,Laghärta,dun-modr,566,shaman,enhancement,12,6,6
44717,Агирук,goldrinn,564,shaman,enhancement,13,6,7
44718,Hurtigtotem,ravencrest,558,shaman,enhancement,15,7,8
44719,Teyshtwö,archimonde,522,shaman,enhancement,14,7,7
44720,Xhahal,hyjal,521,shaman,enhancement,19,7,12
44721,Тмх,ashenvale,512,shaman,enhancement,16,6,10
44722,Guzguzguz,blackhand,511,shaman,enhancement,14,6,8
44723,Ruintotems,twisting-nether,510,shaman,enhancement,11,7,4
44724,Svetosham,wildhammer,480,shaman,enhancement,6,5,1
44725,Ðevi,ravencrest,480,shaman,enhancement,6,5,1
44726,Ybbarcs,eredar,480,shaman,enhancement,6,5,1
44727,Synergizer,kazzak,480,shaman,enhancement,6,5,1
44728,Genrok,burning-blade,480,shaman,enhancement,6,5,1
44729,Magharro,kazzak,480,shaman,enhancement,6,5,1
44730,Nargaz,burning-legion,480,shaman,enhancement,6,5,1
44731,Bârtmân,blackmoore,480,shaman,enhancement,6,5,1
44732,Wooyoungsham,sylvanas,480,shaman,enhancement,6,5,1
44733,Earthquaker,the-maelstrom,480,shaman,enhancement,6,5,1
44734,Øutfox,silvermoon,480,shaman,enhancement,6,5,1
44735,Podoroschnik,blackmoore,480,shaman,enhancement,6,5,1
44736,Jumborumbo,quelthalas,480,shaman,enhancement,6,5,1
44737,Windsòng,stormscale,480,shaman,enhancement,6,5,1
44738,Velkin,thrall,480,shaman,enhancement,6,5,1
44739,Medoje,argent-dawn,480,shaman,enhancement,6,5,1
44740,Seaview,silvermoon,480,shaman,enhancement,6,5,1
44741,Deådwolf,stormscale,480,shaman,enhancement,11,6,5
44742,Thunderpath,ragnaros,480,shaman,enhancement,12,5,7
44743,Hobblefoot,stormscale,480,shaman,enhancement,12,5,7
44744,Madzÿ,archimonde,480,shaman,enhancement,12,5,7
44745,Rahtafary,sanguino,480,shaman,enhancement,12,5,7
44746,Duhdelido,ravencrest,480,shaman,enhancement,12,5,7
44747,Ñax,silvermoon,480,shaman,enhancement,12,5,7
44748,Эрхус,soulflayer,480,shaman,enhancement,12,5,7
44749,Xoul,aegwynn,480,shaman,enhancement,12,5,7
44750,Rejrax,ravencrest,480,shaman,enhancement,12,5,7
44751,Jonnykaye,outland,480,shaman,enhancement,12,5,7
44752,Kabard,silvermoon,480,shaman,enhancement,12,5,7
44753,Teaboï,hyjal,480,shaman,enhancement,12,5,7
44754,Btray,ravencrest,480,shaman,enhancement,12,5,7
44755,Tholdrin,outland,480,shaman,enhancement,12,5,7
44756,Sinwithin,ravencrest,480,shaman,enhancement,12,5,7
44757,Batan,kazzak,480,shaman,enhancement,12,5,7
44758,Xelphia,frostmane,480,shaman,enhancement,12,5,7
44759,Skrewu,stormscale,480,shaman,enhancement,12,5,7
44760,Feetsniffax,outland,480,shaman,enhancement,12,5,7
44761,Дротчим,soulflayer,480,shaman,enhancement,12,5,7
44762,Guzz,cthun,480,shaman,enhancement,12,5,7
44763,Fiden,drakthul,480,shaman,enhancement,12,5,7
44764,Shuyö,kazzak,480,shaman,enhancement,12,5,7
44765,Neystee,archimonde,480,shaman,enhancement,12,5,7
44766,Bowtenstorm,ravencrest,480,shaman,enhancement,12,5,7
44767,Volcanò,outland,480,shaman,enhancement,12,5,7
44768,Shooktide,blackrock,480,shaman,enhancement,12,5,7
44769,Åkee,kazzak,480,shaman,enhancement,12,5,7
44770,Xssanimo,draenor,480,shaman,enhancement,12,5,7
44771,Lilmarco,stormreaver,480,shaman,enhancement,12,5,7
44772,Djsnéak,blackrock,480,shaman,enhancement,12,5,7
44773,Zarosh,los-errantes,480,shaman,enhancement,12,5,7
44774,Grosgourdin,la-croisade-écarlate,480,shaman,enhancement,12,5,7
44775,Mistahbeard,stormscale,480,shaman,enhancement,12,5,7
44776,Grolifer,archimonde,480,shaman,enhancement,12,5,7
44777,Getahex,draenor,480,shaman,enhancement,12,5,7
44778,Thorcc,kazzak,480,shaman,enhancement,12,5,7
44779,Pank,kazzak,480,shaman,enhancement,12,5,7
44780,Смокдог,razuvious,480,shaman,enhancement,12,5,7
44781,Tempóralex,blackhand,480,shaman,enhancement,12,5,7
44782,Tordenlars,ragnaros,480,shaman,enhancement,12,5,7
44783,Bananaspliit,stormscale,480,shaman,enhancement,12,5,7
44784,Djosershamy,draenor,480,shaman,enhancement,12,5,7
44785,Hurik,sylvanas,480,shaman,enhancement,12,5,7
44786,Crilath,ysondre,480,shaman,enhancement,18,5,13
44787,Hiron,sylvanas,480,shaman,enhancement,18,5,13
44788,Halliane,ysondre,480,shaman,enhancement,24,5,19
44789,Brassefrasse,shattered-hand,479,shaman,enhancement,6,5,1
44790,Durotansan,ragnaros,479,shaman,enhancement,12,5,7
44791,Chamrøck,hyjal,479,shaman,enhancement,12,5,7
44792,Loko,terokkar,479,shaman,enhancement,12,5,7
44793,Aznan,burning-legion,479,shaman,enhancement,12,5,7
44794,Shamananas,antonidas,479,shaman,enhancement,18,5,13
44795,Electricmon,stormscale,478,shaman,enhancement,6,5,1
44796,Kaybiel,magtheridon,478,shaman,enhancement,12,5,7
44797,Rockymarciia,dalaran,477,shaman,enhancement,6,5,1
44798,Asstroy,sanguino,477,shaman,enhancement,6,5,1
44799,Shockdx,dun-modr,463,shaman,enhancement,11,5,6
44800,Zaffyboi,draenor,448,shaman,enhancement,16,5,11
44801,Buldozar,blackmoore,448,shaman,enhancement,16,5,11
44802,Ayrá,ulduar,447,shaman,enhancement,8,6,2
44803,Vicinitysham,twisting-nether,447,shaman,enhancement,11,5,6
44804,Bigpapi,azjolnerub,447,shaman,enhancement,11,5,6
44805,Tookaageeroo,burning-legion,446,shaman,enhancement,14,6,8
44806,Macoox,drakthul,432,shaman,enhancement,9,5,4
44807,Monstermunch,ravencrest,432,shaman,enhancement,15,5,10
44808,Warjuice,stormscale,430,shaman,enhancement,11,5,6
44809,Electrical,kazzak,426,shaman,enhancement,15,6,9
44810,Gigamuscle,ravencrest,400,shaman,enhancement,13,5,8
44811,Thoshir,silvermoon,399,shaman,enhancement,5,5,0
44812,Shamanman,kazzak,384,shaman,enhancement,6,4,2
44813,Mustabrutus,tarren-mill,384,shaman,enhancement,6,4,2
44814,Totems,the-venture-co,384,shaman,enhancement,6,4,2
44815,Nøxz,blackmoore,384,shaman,enhancement,6,4,2
44816,Aloeverayo,defias-brotherhood,384,shaman,enhancement,6,4,2
44817,Raindx,draenor,384,shaman,enhancement,6,4,2
44818,Piripolkka,defias-brotherhood,384,shaman,enhancement,6,4,2
44819,Gameblast,thunderhorn,384,shaman,enhancement,6,4,2
44820,Ilkim,hyjal,384,shaman,enhancement,6,4,2
44821,Kaingar,ravencrest,384,shaman,enhancement,6,4,2
44822,Thundersioux,ravencrest,384,shaman,enhancement,6,4,2
44823,Taroc,nethersturm,384,shaman,enhancement,6,4,2
44824,Baldurr,sylvanas,384,shaman,enhancement,6,4,2
44825,Нийрагонго,gordunni,384,shaman,enhancement,6,4,2
44826,Алимика,deathguard,384,shaman,enhancement,6,4,2
44827,Isogrind,archimonde,384,shaman,enhancement,6,4,2
44828,Abdegor,burning-legion,384,shaman,enhancement,6,4,2
44829,Mikesinatra,tarren-mill,384,shaman,enhancement,6,4,2
44830,Hextazy,archimonde,384,shaman,enhancement,6,4,2
44831,Procbly,tarren-mill,384,shaman,enhancement,6,4,2
44832,Richtigfies,kazzak,384,shaman,enhancement,6,4,2
44833,Vallchan,kazzak,384,shaman,enhancement,6,4,2
44834,Proccity,stormscale,384,shaman,enhancement,6,4,2
44835,Xalta,eldrethalas,384,shaman,enhancement,6,4,2
44836,Нэдсон,greymane,384,shaman,enhancement,6,4,2
44837,Alexmahone,dun-morogh,384,shaman,enhancement,6,4,2
44838,Олешао,howling-fjord,384,shaman,enhancement,6,4,2
44839,Tonitøtem,onyxia,384,shaman,enhancement,6,4,2
44840,Rèxxar,stormscale,384,shaman,enhancement,6,4,2
44841,Abordoga,twisting-nether,384,shaman,enhancement,6,4,2
44842,Nabq,hyjal,384,shaman,enhancement,6,4,2
44843,Krytonian,twisting-nether,384,shaman,enhancement,6,4,2
44844,Aitch,blackmoore,384,shaman,enhancement,6,4,2
44845,Yeruna,arthas,384,shaman,enhancement,6,4,2
44846,Россаврн,galakrond,384,shaman,enhancement,6,4,2
44847,Lethz,hyjal,384,shaman,enhancement,6,4,2
44848,Tàvèrnellø,nemesis,384,shaman,enhancement,6,4,2
44849,Zenzua,twisting-nether,384,shaman,enhancement,6,4,2
44850,Frrostshockk,outland,384,shaman,enhancement,6,4,2
44851,Thornaim,hyjal,384,shaman,enhancement,6,4,2
44852,Weåfy,outland,384,shaman,enhancement,6,4,2
44853,Мистерэнх,soulflayer,384,shaman,enhancement,6,4,2
44854,Элемуэль,soulflayer,384,shaman,enhancement,6,4,2
44855,Kärmá,lightbringer,384,shaman,enhancement,6,4,2
44856,Tornado,ravencrest,384,shaman,enhancement,6,4,2
44857,Vønhørk,dalaran,384,shaman,enhancement,6,4,2
44858,Claodze,stormscale,384,shaman,enhancement,12,4,8
44859,Ennuii,blackrock,384,shaman,enhancement,12,4,8
44860,Дюнволкер,razuvious,384,shaman,enhancement,12,4,8
44861,Votie,tarren-mill,384,shaman,enhancement,12,4,8
44862,Johnisplay,tarren-mill,384,shaman,enhancement,12,4,8
44863,Discoshort,kazzak,384,shaman,enhancement,12,4,8
44864,Kiwanuká,draenor,384,shaman,enhancement,12,4,8
44865,Shôcopan,los-errantes,384,shaman,enhancement,12,4,8
44866,Limech,dalaran,384,shaman,enhancement,12,4,8
44867,Waterboi,blackmoore,384,shaman,enhancement,12,4,8
44868,Yasunari,sanguino,384,shaman,enhancement,12,4,8
44869,Powder,tichondrius,384,shaman,enhancement,12,4,8
44870,Cptcutíe,antonidas,384,shaman,enhancement,12,4,8
44871,Purgérkíng,silvermoon,384,shaman,enhancement,12,4,8
44872,Kayalii,silvermoon,384,shaman,enhancement,12,4,8
44873,Türak,tarren-mill,384,shaman,enhancement,12,4,8
44874,Rykon,teldrassil,384,shaman,enhancement,12,4,8
44875,Courtney,sylvanas,384,shaman,enhancement,12,4,8
44876,Blixtnedslag,shattered-hand,384,shaman,enhancement,12,4,8
44877,Sourens,twisting-nether,384,shaman,enhancement,12,4,8
44878,Крепуксх,soulflayer,384,shaman,enhancement,12,4,8
44879,Ódicen,dun-modr,384,shaman,enhancement,12,4,8
44880,Jaéto,ravencrest,384,shaman,enhancement,12,4,8
44881,Zabojad,stormscale,384,shaman,enhancement,12,4,8
44882,Domiro,ravencrest,384,shaman,enhancement,18,4,14
44883,Derryo,silvermoon,384,shaman,enhancement,18,4,14
44884,Wkretarka,burning-legion,384,shaman,enhancement,18,4,14
44885,Скерлайн,blackscar,384,shaman,enhancement,18,4,14
44886,Fàkecast,outland,384,shaman,enhancement,18,4,14
44887,Bubbschock,antonidas,383,shaman,enhancement,6,4,2
44888,Shafallen,tarren-mill,383,shaman,enhancement,6,4,2
44889,Goblaman,pozzo-delleternità,383,shaman,enhancement,6,4,2
44890,Йовва,soulflayer,383,shaman,enhancement,6,4,2
44891,Wolkano,zuljin,383,shaman,enhancement,10,5,5
44892,Châmanco,dun-modr,383,shaman,enhancement,12,4,8
44893,Hightotem,sanguino,383,shaman,enhancement,12,4,8
44894,Аеесо,gordunni,383,shaman,enhancement,12,4,8
44895,Джусипуси,gordunni,383,shaman,enhancement,12,4,8
44896,Blutshock,zuluhed,382,shaman,enhancement,12,4,8
44897,Nalàar,hyjal,368,shaman,enhancement,11,6,5
44898,Lamoulastorm,chogall,351,shaman,enhancement,11,4,7
44899,Kpvn,blackrock,351,shaman,enhancement,17,4,13
44900,Piaoliang,ravencrest,336,shaman,enhancement,9,4,5
44901,Akash,culte-de-la-rive-noire,336,shaman,enhancement,15,4,11
44902,Johnyexe,drakthul,328,shaman,enhancement,8,5,3
44903,Zaeh,antonidas,319,shaman,enhancement,5,4,1
44904,Macchiavelli,blades-edge,319,shaman,enhancement,8,4,4
44905,Trent,tarren-mill,288,shaman,enhancement,6,3,3
44906,Làvagdx,archimonde,288,shaman,enhancement,6,3,3
44907,Vaexi,doomhammer,288,shaman,enhancement,6,3,3
44908,Xfiles,garona,288,shaman,enhancement,6,3,3
44909,Borbor,argent-dawn,288,shaman,enhancement,6,3,3
44910,Renjín,tarren-mill,288,shaman,enhancement,6,3,3
44911,Håõkåh,hyjal,288,shaman,enhancement,6,3,3
44912,Moebius,hellscream,288,shaman,enhancement,6,3,3
44913,Karazrok,draenor,288,shaman,enhancement,6,3,3
44914,Ostbumsdirne,stormscale,288,shaman,enhancement,6,3,3
44915,Ednard,silvermoon,288,shaman,enhancement,6,3,3
44916,Malcolmhex,ysondre,288,shaman,enhancement,6,3,3
44917,Qzaah,garona,288,shaman,enhancement,6,3,3
44918,Danthesham,draenor,288,shaman,enhancement,6,3,3
44919,Venterlofeu,archimonde,288,shaman,enhancement,6,3,3
44920,Chrisbrownx,outland,288,shaman,enhancement,6,3,3
44921,Mefhaman,tarren-mill,288,shaman,enhancement,6,3,3
44922,Reggard,drakthul,288,shaman,enhancement,6,3,3
44923,Yerlas,burning-legion,288,shaman,enhancement,6,3,3
44924,Kemurus,kazzak,288,shaman,enhancement,6,3,3
44925,Kafese,uldaman,288,shaman,enhancement,6,3,3
44926,Mørwayn,ysondre,288,shaman,enhancement,6,3,3
44927,Neterö,la-croisade-écarlate,288,shaman,enhancement,6,3,3
44928,Olej,burning-legion,288,shaman,enhancement,6,3,3
44929,Whyisitspicy,kazzak,288,shaman,enhancement,6,3,3
44930,Shoewalker,ragnaros,288,shaman,enhancement,6,3,3
44931,Blazingfiré,tarren-mill,288,shaman,enhancement,6,3,3
44932,Ønlýsîn,eredar,288,shaman,enhancement,6,3,3
44933,Tidalflow,stormscale,288,shaman,enhancement,6,3,3
44934,Daubidaubi,kazzak,288,shaman,enhancement,6,3,3
44935,Buffresto,kazzak,288,shaman,enhancement,6,3,3
44936,Totoostoy,burning-legion,288,shaman,enhancement,6,3,3
44937,Zokah,emeriss,288,shaman,enhancement,6,3,3
44938,Millesabords,dun-morogh,288,shaman,enhancement,6,3,3
44939,Bluemyst,outland,288,shaman,enhancement,6,3,3
44940,Surge,darksorrow,288,shaman,enhancement,6,3,3
44941,Рокутаро,gordunni,288,shaman,enhancement,6,3,3
44942,Xélania,argent-dawn,288,shaman,enhancement,6,3,3
44943,Мэлик,howling-fjord,288,shaman,enhancement,6,3,3
44944,Odelagga,sylvanas,288,shaman,enhancement,6,3,3
44945,Hansdieter,antonidas,288,shaman,enhancement,6,3,3
44946,Ccedtodeath,sylvanas,288,shaman,enhancement,6,3,3
44947,Varion,tichondrius,288,shaman,enhancement,6,3,3
44948,Fattywopwop,alakir,288,shaman,enhancement,6,3,3
44949,Yacuzwerg,blackrock,288,shaman,enhancement,6,3,3
44950,Айбьорн,gordunni,288,shaman,enhancement,6,3,3
44951,Weltr,drakthul,288,shaman,enhancement,6,3,3
44952,Âlphan,silvermoon,288,shaman,enhancement,6,3,3
44953,Remkoo,blackrock,288,shaman,enhancement,6,3,3
44954,Deadwôlf,stormscale,288,shaman,enhancement,6,3,3
44955,Magosh,blackmoore,288,shaman,enhancement,6,3,3
44956,Sodor,laughing-skull,288,shaman,enhancement,6,3,3
44957,Zahadumia,blackrock,288,shaman,enhancement,6,3,3
44958,Wiev,blackmoore,288,shaman,enhancement,6,3,3
44959,Шамвкроксах,howling-fjord,288,shaman,enhancement,6,3,3
44960,Ric,nemesis,288,shaman,enhancement,6,3,3
44961,Nojiko,blackrock,288,shaman,enhancement,6,3,3
44962,Kulho,stormscale,288,shaman,enhancement,6,3,3
44963,Зуфар,howling-fjord,288,shaman,enhancement,6,3,3
44964,Vainzxsham,ravencrest,288,shaman,enhancement,6,3,3
44965,Saro,destromath,288,shaman,enhancement,6,3,3
44966,Wakoteh,quelthalas,288,shaman,enhancement,6,3,3
44967,Нерфшок,gordunni,288,shaman,enhancement,6,3,3
44968,Kaareh,frostmourne,288,shaman,enhancement,6,3,3
44969,Миддей,blackscar,288,shaman,enhancement,6,3,3
44970,Freekster,die-ewige-wacht,288,shaman,enhancement,6,3,3
44971,Ñtk,dun-modr,288,shaman,enhancement,6,3,3
44972,Uomae,dun-modr,288,shaman,enhancement,6,3,3
44973,Рэкквием,howling-fjord,288,shaman,enhancement,6,3,3
44974,Lilkazamm,blackrock,288,shaman,enhancement,6,3,3
44975,Имфеллиар,howling-fjord,288,shaman,enhancement,6,3,3
44976,Сюсуй,blackscar,288,shaman,enhancement,6,3,3
44977,Läzy,sanguino,288,shaman,enhancement,6,3,3
44978,Pelicius,sanguino,288,shaman,enhancement,6,3,3
44979,Xesti,twisting-nether,288,shaman,enhancement,6,3,3
44980,Неутолимыйх,blackscar,288,shaman,enhancement,6,3,3
44981,Shambamty,thrall,288,shaman,enhancement,12,3,9
44982,Æskalatiøn,aegwynn,288,shaman,enhancement,12,3,9
44983,Сторниер,howling-fjord,288,shaman,enhancement,12,3,9
44984,Kappatotem,silvermoon,288,shaman,enhancement,12,3,9
44985,Dastarus,archimonde,288,shaman,enhancement,12,3,9
44986,Hurbi,twisting-nether,288,shaman,enhancement,12,3,9
44987,Teldathree,archimonde,288,shaman,enhancement,12,3,9
44988,Bonestompamc,blackmoore,288,shaman,enhancement,12,3,9
44989,Avattar,twisting-nether,288,shaman,enhancement,12,3,9
44990,Indan,kazzak,288,shaman,enhancement,12,3,9
44991,Brunütansol,sylvanas,288,shaman,enhancement,12,3,9
44992,Drshockit,blackrock,288,shaman,enhancement,12,3,9
44993,Занги,soulflayer,288,shaman,enhancement,12,3,9
44994,Maybeyes,twisting-nether,288,shaman,enhancement,12,3,9
44995,Darkcleaver,drakthul,288,shaman,enhancement,12,3,9
44996,Georgewhat,defias-brotherhood,288,shaman,enhancement,12,3,9
44997,Kobzol,draenor,288,shaman,enhancement,12,3,9
44998,Garash,draenor,288,shaman,enhancement,12,3,9
44999,Amonshokz,tarren-mill,288,shaman,enhancement,12,3,9
45000,Titiprosop,stormscale,288,shaman,enhancement,12,3,9
45001,Lorthargol,chamber-of-aspects,288,shaman,enhancement,12,3,9
45002,Лорикок,grom,288,shaman,enhancement,18,3,15
45003,Dökowski,nemesis,288,shaman,enhancement,18,3,15
45004,Ultaz,ravencrest,288,shaman,enhancement,18,3,15
45005,Slappybag,ravencrest,287,shaman,enhancement,6,3,3
45006,Стакок,soulflayer,287,shaman,enhancement,6,3,3
45007,Trotzig,aegwynn,287,shaman,enhancement,6,3,3
45008,Sshaasam,tarren-mill,287,shaman,enhancement,6,3,3
45009,Nothìnto,pozzo-delleternità,287,shaman,enhancement,6,3,3
45010,Heálmaster,sanguino,255,shaman,enhancement,11,3,8
45011,Jehae,archimonde,239,shaman,enhancement,5,3,2
45012,Kaátori,eredar,239,shaman,enhancement,5,3,2
45013,Буряя,blackscar,234,shaman,enhancement,12,4,8
45014,Nefasti,stormscale,223,shaman,enhancement,8,3,5
45015,Mooshock,balnazzar,223,shaman,enhancement,8,3,5
45016,Gaerth,aggramar,192,shaman,enhancement,6,2,4
45017,Urshak,alleria,192,shaman,enhancement,6,2,4
45018,Bloodfist,drakthul,192,shaman,enhancement,6,2,4
45019,Shiggenbasta,kazzak,192,shaman,enhancement,6,2,4
45020,Dalgorr,magtheridon,192,shaman,enhancement,6,2,4
45021,Pulvêrizêr,agamaggan,192,shaman,enhancement,6,2,4
45022,Sgf,stormscale,192,shaman,enhancement,6,2,4
45023,Diya,karazhan,192,shaman,enhancement,6,2,4
45024,Holybrolyy,malfurion,192,shaman,enhancement,6,2,4
45025,Какашисан,howling-fjord,192,shaman,enhancement,6,2,4
45026,Azzizael,chamber-of-aspects,192,shaman,enhancement,6,2,4
45027,Yompo,archimonde,192,shaman,enhancement,6,2,4
45028,Shamohd,ravencrest,192,shaman,enhancement,6,2,4
45029,Haugren,eredar,192,shaman,enhancement,6,2,4
45030,Schamikraut,silvermoon,192,shaman,enhancement,6,2,4
45031,Bennycooch,silvermoon,192,shaman,enhancement,6,2,4
45032,Starik,ravencrest,192,shaman,enhancement,6,2,4
45033,Cptnbbl,blackmoore,192,shaman,enhancement,6,2,4
45034,Eshami,tarren-mill,192,shaman,enhancement,6,2,4
45035,Wòóshy,ravencrest,192,shaman,enhancement,6,2,4
45036,Turbinká,burning-legion,192,shaman,enhancement,6,2,4
45037,Cuchullaín,blackmoore,192,shaman,enhancement,6,2,4
45038,Elementhor,archimonde,192,shaman,enhancement,6,2,4
45039,Bonethugdex,bladefist,192,shaman,enhancement,6,2,4
45040,Golfrick,hyjal,192,shaman,enhancement,6,2,4
45041,Savan,darkspear,192,shaman,enhancement,6,2,4
45042,Shalý,antonidas,192,shaman,enhancement,6,2,4
45043,Shamalamadi,ragnaros,192,shaman,enhancement,6,2,4
45044,Бьерн,deepholm,192,shaman,enhancement,6,2,4
45045,Stub,nemesis,192,shaman,enhancement,6,2,4
45046,Dogfrog,silvermoon,192,shaman,enhancement,6,2,4
45047,Snapbábe,blackmoore,192,shaman,enhancement,6,2,4
45048,Restmuell,blackmoore,192,shaman,enhancement,6,2,4
45049,Santy,silvermoon,192,shaman,enhancement,6,2,4
45050,Rodfrugten,draenor,192,shaman,enhancement,6,2,4
45051,Shámyé,silvermoon,192,shaman,enhancement,6,2,4
45052,Stiflersmôm,antonidas,192,shaman,enhancement,6,2,4
45053,Layonne,ysondre,192,shaman,enhancement,6,2,4
45054,Tâw,blackhand,192,shaman,enhancement,6,2,4
45055,Suicidesheep,grim-batol,192,shaman,enhancement,6,2,4
45056,Трупелмен,soulflayer,192,shaman,enhancement,6,2,4
45057,Bram,aggra-português,192,shaman,enhancement,6,2,4
45058,Kwitnac,silvermoon,192,shaman,enhancement,6,2,4
45059,Rûngard,aegwynn,192,shaman,enhancement,6,2,4
45060,Iloveléa,ravencrest,192,shaman,enhancement,6,2,4
45061,Khon,eredar,192,shaman,enhancement,6,2,4
45062,Pakasschami,frostwolf,192,shaman,enhancement,6,2,4
45063,Lovros,kazzak,192,shaman,enhancement,6,2,4
45064,Louvreparis,frostwolf,192,shaman,enhancement,6,2,4
45065,Yezu,medivh,192,shaman,enhancement,6,2,4
45066,Wertu,ragnaros,192,shaman,enhancement,6,2,4
45067,Zows,kazzak,192,shaman,enhancement,6,2,4
45068,Shoar,twisting-nether,192,shaman,enhancement,6,2,4
45069,Volkar,auchindoun,192,shaman,enhancement,6,2,4
45070,Kohzen,outland,192,shaman,enhancement,6,2,4
45071,Ogshaman,archimonde,192,shaman,enhancement,6,2,4
45072,Shocknrun,sylvanas,192,shaman,enhancement,6,2,4
45073,Aubesombre,dalaran,192,shaman,enhancement,6,2,4
45074,Palarins,dalaran,192,shaman,enhancement,6,2,4
45075,Thunderstørm,chogall,192,shaman,enhancement,6,2,4
45076,Родохрозид,blackscar,192,shaman,enhancement,6,2,4
45077,Destroilleur,archimonde,192,shaman,enhancement,6,2,4
45078,Mycameltotem,ravencrest,192,shaman,enhancement,6,2,4
45079,Kassyoh,hyjal,192,shaman,enhancement,6,2,4
45080,Штурвальный,blackscar,192,shaman,enhancement,6,2,4
45081,Türzumachen,outland,192,shaman,enhancement,6,2,4
45082,Bladeyx,ragnaros,192,shaman,enhancement,6,2,4
45083,Саксаул,fordragon,192,shaman,enhancement,6,2,4
45084,Søló,stormscale,192,shaman,enhancement,6,2,4
45085,Laserra,sylvanas,192,shaman,enhancement,6,2,4
45086,Peaksh,stormscale,192,shaman,enhancement,6,2,4
45087,Shockinghell,sylvanas,192,shaman,enhancement,6,2,4
45088,Fufupartyxx,blackrock,192,shaman,enhancement,6,2,4
45089,Thoráck,stormscale,192,shaman,enhancement,6,2,4
45090,Kaptt,twisting-nether,192,shaman,enhancement,6,2,4
45091,Spiritualx,argent-dawn,192,shaman,enhancement,6,2,4
45092,Пакни,gordunni,192,shaman,enhancement,6,2,4
45093,Elé,ravenholdt,192,shaman,enhancement,6,2,4
45094,Nìtratx,archimonde,192,shaman,enhancement,6,2,4
45095,Acces,stormscale,192,shaman,enhancement,6,2,4
45096,Gundsthunder,ravencrest,192,shaman,enhancement,6,2,4
45097,Xharnel,defias-brotherhood,192,shaman,enhancement,6,2,4
45098,Locosonik,kazzak,192,shaman,enhancement,6,2,4
45099,Ðøminantx,stormscale,192,shaman,enhancement,6,2,4
45100,Råkk,argent-dawn,192,shaman,enhancement,6,2,4
45101,Hugzy,argent-dawn,192,shaman,enhancement,6,2,4
45102,Cleptocracy,draenor,192,shaman,enhancement,6,2,4
45103,Lokkrag,archimonde,192,shaman,enhancement,6,2,4
45104,Crazo,tarren-mill,192,shaman,enhancement,6,2,4
45105,Skullføck,argent-dawn,192,shaman,enhancement,6,2,4
45106,Дортманшам,gordunni,192,shaman,enhancement,6,2,4
45107,Vorkanyx,ysondre,192,shaman,enhancement,7,2,5
45108,Vollt,kazzak,192,shaman,enhancement,9,2,7
45109,Elementarxss,blackmoore,192,shaman,enhancement,12,2,10
45110,Khakazis,ravencrest,192,shaman,enhancement,12,2,10
45111,Stormstriker,arathor,192,shaman,enhancement,12,2,10
45112,Zarakuda,magtheridon,192,shaman,enhancement,12,2,10
45113,Sïlvek,sanguino,192,shaman,enhancement,12,2,10
45114,Shÿmä,dalaran,192,shaman,enhancement,12,2,10
45115,Borindor,silvermoon,192,shaman,enhancement,12,2,10
45116,Pachamane,archimonde,192,shaman,enhancement,12,2,10
45117,Lavalew,lightbringer,192,shaman,enhancement,12,2,10
45118,Elsassi,ravencrest,192,shaman,enhancement,12,2,10
45119,Nuao,perenolde,138,shaman,enhancement,9,3,6
45120,Theshame,ravencrest,128,shaman,enhancement,4,2,2
45121,Bux,khaz-modan,127,shaman,enhancement,10,2,8
45122,Bambustic,kazzak,96,shaman,enhancement,6,1,5
45123,Epicoverlord,tarren-mill,96,shaman,enhancement,6,1,5
45124,Porthex,kazzak,96,shaman,enhancement,6,1,5
45125,Fiskätarn,kazzak,96,shaman,enhancement,6,1,5
45126,Hóonda,twisting-nether,96,shaman,enhancement,6,1,5
45127,Ghaargrim,tarren-mill,96,shaman,enhancement,6,1,5
45128,Mikecrybaby,tarren-mill,96,shaman,enhancement,6,1,5
45129,Lawdjeezes,draenor,96,shaman,enhancement,6,1,5
45130,Malvik,tarren-mill,96,shaman,enhancement,6,1,5
45131,Agrok,jaedenar,96,shaman,enhancement,6,1,5
45132,Cryptotem,ragnaros,96,shaman,enhancement,6,1,5
45133,Разодран,gordunni,96,shaman,enhancement,6,1,5
45134,Keräx,cthun,96,shaman,enhancement,6,1,5
45135,Rækwon,tarren-mill,96,shaman,enhancement,6,1,5
45136,Élémentyum,archimonde,96,shaman,enhancement,6,1,5
45137,Ацитра,gordunni,96,shaman,enhancement,6,1,5
45138,Stòrm,ravencrest,96,shaman,enhancement,6,1,5
45139,Цукерок,soulflayer,96,shaman,enhancement,6,1,5
45140,Urubus,kazzak,96,shaman,enhancement,6,1,5
45141,Shøckz,azjolnerub,96,shaman,enhancement,6,1,5
45142,Hazles,ragnaros,96,shaman,enhancement,6,1,5
45143,Maskinett,stormscale,96,shaman,enhancement,6,1,5
45144,Shaamz,tarren-mill,96,shaman,enhancement,6,1,5
45145,Malabestia,archimonde,96,shaman,enhancement,6,1,5
45146,Baaruch,kazzak,96,shaman,enhancement,6,1,5
45147,Grabmytotemz,tarren-mill,96,shaman,enhancement,6,1,5
45148,Xhøxy,outland,96,shaman,enhancement,6,1,5
45149,Thoreign,burning-legion,96,shaman,enhancement,6,1,5
45150,Preshear,twisting-nether,96,shaman,enhancement,6,1,5
45151,Amarök,nerzhul,96,shaman,enhancement,6,1,5
45152,Criæ,blackrock,96,shaman,enhancement,6,1,5
45153,Afterlife,alakir,96,shaman,enhancement,6,1,5
45154,Vilberoo,ravencrest,96,shaman,enhancement,6,1,5
45155,Hí,bronzebeard,96,shaman,enhancement,6,1,5
45156,Zoélement,nerzhul,96,shaman,enhancement,6,1,5
45157,Thormyr,dalaran,96,shaman,enhancement,6,1,5
45158,Shåmssagat,kazzak,96,shaman,enhancement,6,1,5
45159,Gewieft,azshara,96,shaman,enhancement,6,1,5
45160,Zoogang,ragnaros,96,shaman,enhancement,6,1,5
45161,Mástà,onyxia,96,shaman,enhancement,6,1,5
45162,Ragnadim,silvermoon,96,shaman,enhancement,6,1,5
45163,Sekane,archimonde,96,shaman,enhancement,6,1,5
45164,Eneel,blackmoore,96,shaman,enhancement,6,1,5
45165,Goldhand,ravencrest,96,shaman,enhancement,6,1,5
45166,Thoranis,kazzak,96,shaman,enhancement,6,1,5
45167,Casarú,arthas,96,shaman,enhancement,6,1,5
45168,Vladraxes,draenor,96,shaman,enhancement,6,1,5
45169,Winiepuuh,antonidas,96,shaman,enhancement,6,1,5
45170,Freexx,aegwynn,96,shaman,enhancement,8,1,7
45171,Хэллшам,howling-fjord,96,shaman,enhancement,12,1,11
45172,Xzan,tarren-mill,96,shaman,enhancement,12,1,11
45173,Ymiras,argent-dawn,96,shaman,enhancement,12,1,11
45174,Sycophant,stormscale,96,shaman,enhancement,12,1,11
45175,Reyax,aegwynn,96,shaman,enhancement,12,1,11
45176,Volgue,kaelthas,96,shaman,enhancement,12,1,11
45177,Эншам,blackscar,96,shaman,enhancement,12,1,11
45178,Jacklupin,ravencrest,79,shaman,enhancement,5,1,4
45179,Choltaj,burning-legion,79,shaman,enhancement,7,1,6
45180,Sìrenia,tarren-mill,63,shaman,enhancement,2,2,0
45181,Daboo,the-venture-co,48,shaman,enhancement,3,1,2
45182,Biggie,pozzo-delleternità,48,shaman,enhancement,3,1,2
45183,Rký,outland,48,shaman,enhancement,3,1,2
45184,Wenesday,ysondre,48,shaman,enhancement,3,1,2
45185,Адскийсон,gordunni,42,shaman,enhancement,9,2,7
45186,Lesnitt,kazzak,42,shaman,enhancement,9,2,7
45187,Aleshade,argent-dawn,31,shaman,enhancement,2,1,1
45188,Kimkold,twisting-nether,2247,warlock,demonology,144,84,60
45189,Pogbõss,kazzak,2221,warlock,demonology,183,96,87
45190,Rikkërt,draenor,2207,warlock,demonology,89,49,40
45191,Dotjürgen,blackrock,2205,warlock,demonology,84,48,36
45192,Ambitions,hyjal,2182,warlock,demonology,106,59,47
45193,Амеаль,eversong,2181,warlock,demonology,363,190,173
45194,Млечный,blackscar,2177,warlock,demonology,189,103,86
45195,Whøknøws,twisting-nether,2176,warlock,demonology,84,45,39
45196,Cònq,tarren-mill,2175,warlock,demonology,90,50,40
45197,Setyouinfear,ravencrest,2174,warlock,demonology,106,63,43
45198,Dæhli,argent-dawn,2166,warlock,demonology,102,56,46
45199,Tuskawl,stormreaver,2154,warlock,demonology,91,51,40
45200,Nayolana,argent-dawn,2150,warlock,demonology,72,46,26
45201,Firochektro,ravencrest,2141,warlock,demonology,69,42,27
45202,Sad,lightnings-blade,2134,warlock,demonology,178,97,81
45203,Maintarget,blackrock,2131,warlock,demonology,159,85,74
45204,Favorizlmp,archimonde,2123,warlock,demonology,107,74,33
45205,Lankycheese,kazzak,2121,warlock,demonology,83,46,37
45206,Syntaxzwo,blackmoore,2116,warlock,demonology,78,44,34
45207,Dotyboi,tarren-mill,2115,warlock,demonology,72,44,28
45208,Rumour,sunstrider,2115,warlock,demonology,72,39,33
45209,Jimboneutron,stormscale,2113,warlock,demonology,53,30,23
45210,Supergeîl,blackrock,2112,warlock,demonology,71,38,33
45211,Xerkh,thrall,2111,warlock,demonology,78,43,35
45212,Malddog,turalyon,2103,warlock,demonology,108,61,47
45213,Britneÿ,stormscale,2096,warlock,demonology,90,46,44
45214,Neverfearjk,aegwynn,2085,warlock,demonology,53,39,14
45215,Voldby,kazzak,2083,warlock,demonology,55,34,21
45216,Droguri,darkspear,2079,warlock,demonology,96,64,32
45217,Anthh,doomhammer,2076,warlock,demonology,66,36,30
45218,Purplemonkey,burning-blade,2058,warlock,demonology,68,37,31
45219,Nyotu,antonidas,2058,warlock,demonology,72,39,33
45220,Smaúg,archimonde,2058,warlock,demonology,126,63,63
45221,Firochek,ravencrest,2052,warlock,demonology,84,44,40
45222,Smdtwo,drakthul,2050,warlock,demonology,53,31,22
45223,Wspolnax,ravencrest,2050,warlock,demonology,60,34,26
45224,Locktrainer,tarren-mill,2040,warlock,demonology,212,104,108
45225,Thardik,azuremyst,2037,warlock,demonology,84,42,42
45226,Krøl,nemesis,2036,warlock,demonology,54,35,19
45227,Zerulian,ragnaros,2035,warlock,demonology,78,48,30
45228,Onlylock,outland,2034,warlock,demonology,60,38,22
45229,Shablagoo,twisting-nether,2032,warlock,demonology,90,51,39
45230,Ffpiiras,dunemaul,2023,warlock,demonology,95,50,45
45231,Capsloq,la-croisade-écarlate,2017,warlock,demonology,90,48,42
45232,Ðïÿëñbïëñfüû,suramar,2014,warlock,demonology,147,75,72
45233,Cørpse,burning-legion,2012,warlock,demonology,100,55,45
45234,Bibiflexberg,eredar,2011,warlock,demonology,47,30,17
45235,Britneý,stormscale,2008,warlock,demonology,118,58,60
45236,Ogrez,nemesis,2006,warlock,demonology,77,38,39
45237,Хаосболик,gordunni,2002,warlock,demonology,84,45,39
45238,Raspalakuja,kazzak,2002,warlock,demonology,66,32,34
45239,Synthiax,silvermoon,1986,warlock,demonology,66,39,27
45240,Dabezdwl,outland,1973,warlock,demonology,78,45,33
45241,Badapow,stormscale,1971,warlock,demonology,54,29,25
45242,Адво,howling-fjord,1968,warlock,demonology,71,37,34
45243,Rïñ,ravencrest,1968,warlock,demonology,60,28,32
45244,Аоепампгодх,howling-fjord,1967,warlock,demonology,36,24,12
45245,Тёмабиль,gordunni,1967,warlock,demonology,343,184,159
45246,Ишла,gordunni,1959,warlock,demonology,77,41,36
45247,Zàk,twisting-nether,1956,warlock,demonology,60,41,19
45248,Конидэмико,blackscar,1954,warlock,demonology,83,38,45
45249,Онлидемон,gordunni,1946,warlock,demonology,56,33,23
45250,Alotami,frostwolf,1942,warlock,demonology,48,30,18
45251,Døwz,ysondre,1932,warlock,demonology,60,30,30
45252,Xenastro,silvermoon,1931,warlock,demonology,54,30,24
45253,Apple,scarshield-legion,1930,warlock,demonology,133,69,64
45254,Khavar,antonidas,1926,warlock,demonology,82,46,36
45255,Lokmonji,perenolde,1923,warlock,demonology,60,34,26
45256,Фламмэнх,soulflayer,1920,warlock,demonology,49,28,21
45257,Vultzbolt,draenor,1920,warlock,demonology,66,36,30
45258,Juicybolt,chogall,1917,warlock,demonology,76,43,33
45259,Kamorilock,blackhand,1912,warlock,demonology,36,20,16
45260,Skillførçé,kazzak,1911,warlock,demonology,36,26,10
45261,Demoner,tarren-mill,1910,warlock,demonology,108,52,56
45262,Blacklock,argent-dawn,1908,warlock,demonology,54,34,20
45263,Shadowvirus,auchindoun,1908,warlock,demonology,41,23,18
45264,Тьмазвёздная,gordunni,1907,warlock,demonology,93,51,42
45265,Годнодх,gordunni,1902,warlock,demonology,54,29,25
45266,Anúki,kazzak,1900,warlock,demonology,25,21,4
45267,Ravendoor,grim-batol,1900,warlock,demonology,76,39,37
45268,Indrâxx,hyjal,1899,warlock,demonology,36,31,5
45269,Keybump,outland,1899,warlock,demonology,72,48,24
45270,Neinbosa,tarren-mill,1899,warlock,demonology,60,30,30
45271,Bonnieparkêr,onyxia,1898,warlock,demonology,48,26,22
45272,Désolaté,kazzak,1893,warlock,demonology,47,29,18
45273,Stafar,kazzak,1891,warlock,demonology,66,34,32
45274,Дёмын,howling-fjord,1890,warlock,demonology,96,46,50
45275,Makkez,outland,1876,warlock,demonology,30,20,10
45276,Шекигами,gordunni,1874,warlock,demonology,48,33,15
45277,Höfmänn,kazzak,1865,warlock,demonology,39,25,14
45278,Dispeluapls,blackmoore,1865,warlock,demonology,54,28,26
45279,Zouglougou,archimonde,1864,warlock,demonology,78,37,41
45280,Delius,eitrigg,1863,warlock,demonology,67,47,20
45281,Tyrantlol,sylvanas,1862,warlock,demonology,54,32,22
45282,Bluh,twisting-nether,1860,warlock,demonology,36,22,14
45283,Weso,grim-batol,1859,warlock,demonology,60,31,29
45284,Fearrari,ragnaros,1857,warlock,demonology,108,59,49
45285,Stankaemayne,blackhand,1856,warlock,demonology,55,31,24
45286,Оброссыш,gordunni,1855,warlock,demonology,60,34,26
45287,Dhärc,sanguino,1854,warlock,demonology,54,31,23
45288,Infïnitýx,silvermoon,1851,warlock,demonology,38,25,13
45289,Stalowwy,silvermoon,1849,warlock,demonology,108,59,49
45290,Ägony,blackrock,1848,warlock,demonology,54,31,23
45291,Jopasiski,draenor,1848,warlock,demonology,54,28,26
45292,Höfmänn,grim-batol,1847,warlock,demonology,48,31,17
45293,Shakuroz,frostwolf,1847,warlock,demonology,68,41,27
45294,Динодотз,howling-fjord,1847,warlock,demonology,54,27,27
45295,Immaginare,sylvanas,1845,warlock,demonology,60,29,31
45296,Артисона,gordunni,1842,warlock,demonology,48,27,21
45297,Attritiona,stormscale,1838,warlock,demonology,60,32,28
45298,Инфезиус,deathweaver,1834,warlock,demonology,59,33,26
45299,Purplereîgn,stormscale,1834,warlock,demonology,57,31,26
45300,Outofcurses,earthen-ring,1834,warlock,demonology,83,42,41
45301,Djmäkish,outland,1828,warlock,demonology,42,23,19
45302,Санявахтовик,blackscar,1827,warlock,demonology,72,39,33
45303,Benne,stormscale,1825,warlock,demonology,49,31,18
45304,Арон,soulflayer,1824,warlock,demonology,47,25,22
45305,Malificus,silvermoon,1823,warlock,demonology,114,67,47
45306,Kennyfõx,ysondre,1819,warlock,demonology,24,19,5
45307,Ismenia,silvermoon,1819,warlock,demonology,60,39,21
45308,Cellfear,kazzak,1818,warlock,demonology,42,24,18
45309,Skrana,kazzak,1818,warlock,demonology,47,25,22
45310,Musallat,argent-dawn,1818,warlock,demonology,65,34,31
45311,Fiveyearque,sylvanas,1817,warlock,demonology,54,33,21
45312,Hellguards,silvermoon,1817,warlock,demonology,60,33,27
45313,Ravenglass,argent-dawn,1817,warlock,demonology,54,25,29
45314,Warth,silvermoon,1816,warlock,demonology,42,28,14
45315,Painowgee,kazzak,1816,warlock,demonology,36,20,16
45316,Crathar,kazzak,1816,warlock,demonology,76,38,38
45317,Jackyfalls,blackmoore,1815,warlock,demonology,42,27,15
45318,Bualock,tarren-mill,1815,warlock,demonology,36,22,14
45319,Devilfluffy,blackhand,1815,warlock,demonology,59,35,24
45320,Cigänä,archimonde,1815,warlock,demonology,36,19,17
45321,Blackdog,argent-dawn,1814,warlock,demonology,48,23,25
45322,Malzeva,ravencrest,1813,warlock,demonology,71,33,38
45323,Zypzanti,antonidas,1810,warlock,demonology,155,97,58
45324,Kopfkissen,azshara,1810,warlock,demonology,51,29,22
45325,Кварий,howling-fjord,1810,warlock,demonology,401,200,201
45326,Tagzi,ravencrest,1809,warlock,demonology,47,29,18
45327,Cuteyess,shadowsong,1808,warlock,demonology,30,19,11
45328,Smâûhg,blackrock,1807,warlock,demonology,42,28,14
45329,Nécron,ysondre,1806,warlock,demonology,59,32,27
45330,Lúcìfér,stormscale,1806,warlock,demonology,66,34,32
45331,Фэлмор,howling-fjord,1805,warlock,demonology,54,33,21
45332,Thugsupreme,ravencrest,1805,warlock,demonology,65,36,29
45333,Nerigo,senjin,1805,warlock,demonology,48,24,24
45334,Dontargetme,draenor,1804,warlock,demonology,38,26,12
45335,Nemwl,draenor,1804,warlock,demonology,66,36,30
45336,Splicer,eredar,1803,warlock,demonology,49,29,20
45337,Киёкка,howling-fjord,1803,warlock,demonology,90,53,37
45338,Arkanyks,dalaran,1802,warlock,demonology,72,32,40
45339,Htaedfo,tarren-mill,1802,warlock,demonology,74,32,42
45340,Мутгодх,soulflayer,1800,warlock,demonology,30,19,11
45341,Кайзершлафен,fordragon,1800,warlock,demonology,58,28,30
45342,Gv,ragnaros,1795,warlock,demonology,36,19,17
45343,Sanguinis,theradras,1794,warlock,demonology,106,57,49
45344,Dâedra,argent-dawn,1793,warlock,demonology,54,31,23
45345,Дьяволзаплач,howling-fjord,1793,warlock,demonology,48,26,22
45346,Lïñglïñg,twisting-nether,1791,warlock,demonology,36,25,11
45347,Mustasheen,stormscale,1790,warlock,demonology,36,21,15
45348,Äåäåäåäåäåäå,ravencrest,1789,warlock,demonology,47,26,21
45349,Tamaduitoru,dragonblight,1782,warlock,demonology,66,43,23
45350,Proßlock,kazzak,1780,warlock,demonology,123,73,50
45351,Shadowflamez,argent-dawn,1771,warlock,demonology,30,27,3
45352,Glavy,burning-legion,1765,warlock,demonology,131,71,60
45353,Zehirisalari,twisting-nether,1761,warlock,demonology,42,24,18
45354,Omnípotens,silvermoon,1755,warlock,demonology,60,33,27
45355,Егосяхаос,soulflayer,1755,warlock,demonology,144,78,66
45356,Alphalock,mannoroth,1755,warlock,demonology,72,35,37
45357,Catchlock,tarren-mill,1752,warlock,demonology,36,20,16
45358,Císuh,stormreaver,1747,warlock,demonology,56,30,26
45359,Пухи,blackscar,1741,warlock,demonology,55,23,32
45360,Kolskegg,doomhammer,1740,warlock,demonology,90,48,42
45361,Этожедру,howling-fjord,1734,warlock,demonology,47,32,15
45362,Kennÿfõx,ysondre,1732,warlock,demonology,24,19,5
45363,Zezo,stormscale,1731,warlock,demonology,29,21,8
45364,Naarnust,defias-brotherhood,1727,warlock,demonology,42,28,14
45365,Adafbhf,tichondrius,1723,warlock,demonology,41,22,19
45366,Помечте,soulflayer,1723,warlock,demonology,94,41,53
45367,Dalamon,draenor,1721,warlock,demonology,48,24,24
45368,Храбзар,gordunni,1721,warlock,demonology,112,51,61
45369,Dadcrush,antonidas,1720,warlock,demonology,84,42,42
45370,Moffguldan,sanguino,1719,warlock,demonology,48,28,20
45371,Louên,dun-modr,1715,warlock,demonology,48,24,24
45372,Zelieknight,ysondre,1711,warlock,demonology,60,28,32
45373,Synlockiax,silvermoon,1709,warlock,demonology,56,38,18
45374,Despépêche,garona,1709,warlock,demonology,42,24,18
45375,Зажиженный,soulflayer,1707,warlock,demonology,40,26,14
45376,Izhi,ragnaros,1705,warlock,demonology,66,38,28
45377,Фортэр,ashenvale,1705,warlock,demonology,60,31,29
45378,Scaevóla,ravencrest,1703,warlock,demonology,233,125,108
45379,Nâzgrel,tarren-mill,1703,warlock,demonology,72,35,37
45380,Zezca,draenor,1702,warlock,demonology,48,27,21
45381,Gazdruul,culte-de-la-rive-noire,1701,warlock,demonology,30,20,10
45382,Hexdrix,thrall,1701,warlock,demonology,45,20,25
45383,Slockoló,ragnaros,1701,warlock,demonology,54,21,33
45384,Drerlord,tarren-mill,1699,warlock,demonology,48,21,27
45385,Kuloo,blackmoore,1698,warlock,demonology,30,18,12
45386,Totephia,kazzak,1696,warlock,demonology,72,33,39
45387,Rune,aegwynn,1695,warlock,demonology,52,29,23
45388,Tjockoloco,tarren-mill,1695,warlock,demonology,164,89,75
45389,Kazzy,grim-batol,1693,warlock,demonology,30,21,9
45390,Zatella,ravencrest,1693,warlock,demonology,84,45,39
45391,Malowix,outland,1690,warlock,demonology,42,20,22
45392,Zoreck,uldum,1689,warlock,demonology,36,20,16
45393,Бриант,gordunni,1689,warlock,demonology,47,19,28
45394,Yamadea,stormscale,1686,warlock,demonology,48,25,23
45395,Grimmwald,stormreaver,1685,warlock,demonology,46,22,24
45396,Eluinees,silvermoon,1684,warlock,demonology,36,25,11
45397,Jinusek,burning-legion,1682,warlock,demonology,43,23,20
45398,Grêenbull,eredar,1680,warlock,demonology,49,27,22
45399,Варикай,gordunni,1678,warlock,demonology,42,27,15
45400,Жериновсский,gordunni,1677,warlock,demonology,36,18,18
45401,Terrorrize,draenor,1673,warlock,demonology,36,21,15
45402,Fandirxd,draenor,1672,warlock,demonology,120,57,63
45403,Iskieel,ravencrest,1671,warlock,demonology,44,26,18
45404,Bloodlock,onyxia,1670,warlock,demonology,42,22,20
45405,Osbaa,bladefist,1668,warlock,demonology,42,22,20
45406,Snackstickz,twisting-nether,1665,warlock,demonology,54,33,21
45407,Impaler,tarren-mill,1664,warlock,demonology,188,91,97
45408,Lottopallo,arathor,1663,warlock,demonology,121,77,44
45409,Анрали,soulflayer,1662,warlock,demonology,41,23,18
45410,Xtyran,blackmoore,1661,warlock,demonology,42,20,22
45411,Lockmex,outland,1658,warlock,demonology,42,26,16
45412,Kemel,thrall,1655,warlock,demonology,30,21,9
45413,Нафлэпил,gordunni,1655,warlock,demonology,54,31,23
45414,Гурджес,soulflayer,1655,warlock,demonology,98,52,46
45415,Niyyu,blackmoore,1654,warlock,demonology,48,22,26
45416,Shugglock,draenor,1653,warlock,demonology,42,23,19
45417,Deamonsmith,silvermoon,1652,warlock,demonology,58,36,22
45418,Mjor,twisting-nether,1650,warlock,demonology,30,18,12
45419,Chromagnus,drakthul,1649,warlock,demonology,36,21,15
45420,Utsus,tarren-mill,1645,warlock,demonology,36,23,13
45421,Hypotax,ragnaros,1644,warlock,demonology,54,33,21
45422,Môrgán,draenor,1640,warlock,demonology,180,91,89
45423,Tekron,blackhand,1639,warlock,demonology,54,36,18
45424,Requeims,outland,1638,warlock,demonology,48,22,26
45425,Fîgøk,conseil-des-ombres,1638,warlock,demonology,48,21,27
45426,Tiffyilock,blackrock,1637,warlock,demonology,42,20,22
45427,Scottware,draenor,1635,warlock,demonology,38,23,15
45428,Darcîa,destromath,1633,warlock,demonology,100,56,44
45429,Règis,antonidas,1633,warlock,demonology,42,22,20
45430,Tenshirou,blackrock,1631,warlock,demonology,35,21,14
45431,Zzooxx,silvermoon,1631,warlock,demonology,30,17,13
45432,Лвнг,gordunni,1628,warlock,demonology,48,29,19
45433,Dimmybyrger,stormreaver,1627,warlock,demonology,30,17,13
45434,Abdelkarime,khaz-modan,1627,warlock,demonology,42,23,19
45435,Summonit,blackmoore,1627,warlock,demonology,54,29,25
45436,Interceptêr,blackrock,1627,warlock,demonology,42,22,20
45437,Neuth,draenor,1627,warlock,demonology,50,21,29
45438,Erkai,kazzak,1624,warlock,demonology,45,24,21
45439,Dasda,defias-brotherhood,1623,warlock,demonology,89,49,40
45440,Мешшугга,howling-fjord,1623,warlock,demonology,38,20,18
45441,Dualla,aegwynn,1623,warlock,demonology,36,17,19
45442,Элси,howling-fjord,1622,warlock,demonology,30,17,13
45443,Capsloq,sargeras,1622,warlock,demonology,33,18,15
45444,Нэкрил,howling-fjord,1621,warlock,demonology,35,22,13
45445,Xanatas,nemesis,1620,warlock,demonology,42,25,17
45446,Icò,ravencrest,1620,warlock,demonology,36,17,19
45447,Fedpikkefar,kazzak,1619,warlock,demonology,36,17,19
45448,Golborg,draenor,1619,warlock,demonology,75,33,42
45449,Kûraiko,blackrock,1614,warlock,demonology,30,17,13
45450,Vêzor,twisting-nether,1612,warlock,demonology,34,19,15
45451,Eroszakolock,ragnaros,1611,warlock,demonology,24,17,7
45452,Kody,blackmoore,1609,warlock,demonology,24,17,7
45453,Mendozaah,kazzak,1607,warlock,demonology,188,92,96
45454,Ahollic,frostwolf,1606,warlock,demonology,30,19,11
45455,Shuggul,draenor,1606,warlock,demonology,37,22,15
45456,Hellbboy,azjolnerub,1605,warlock,demonology,79,45,34
45457,Darkenlock,burning-legion,1605,warlock,demonology,42,22,20
45458,Tamatóax,tarren-mill,1605,warlock,demonology,51,26,25
45459,Demonjoker,blackhand,1604,warlock,demonology,51,31,20
45460,Deaddydoo,kazzak,1604,warlock,demonology,42,20,22
45461,Havexis,tichondrius,1602,warlock,demonology,42,32,10
45462,Prekt,ragnaros,1601,warlock,demonology,36,19,17
45463,Positivitywl,stormscale,1600,warlock,demonology,24,17,7
45464,Zzooxxie,silvermoon,1600,warlock,demonology,42,19,23
45465,Djshyasiañ,perenolde,1599,warlock,demonology,176,90,86
45466,Гвоздяшка,blackscar,1597,warlock,demonology,47,22,25
45467,Nàughty,ragnaros,1594,warlock,demonology,33,17,16
45468,Sokyra,tarren-mill,1594,warlock,demonology,54,25,29
45469,Eleriya,argent-dawn,1591,warlock,demonology,92,45,47
45470,Yumiblood,tarren-mill,1589,warlock,demonology,47,25,22
45471,Malumbra,argent-dawn,1589,warlock,demonology,40,19,21
45472,Филоняша,gordunni,1583,warlock,demonology,42,25,17
45473,Sublînê,blackmoore,1582,warlock,demonology,82,41,41
45474,Potatowl,ravencrest,1582,warlock,demonology,36,18,18
45475,Míkæ,ravencrest,1582,warlock,demonology,72,34,38
45476,Tonin,antonidas,1581,warlock,demonology,53,33,20
45477,Longdickie,ravencrest,1581,warlock,demonology,36,20,16
45478,Insídíous,tarren-mill,1581,warlock,demonology,36,19,17
45479,Felsturm,twisting-nether,1579,warlock,demonology,42,30,12
45480,Мамхаус,howling-fjord,1579,warlock,demonology,36,22,14
45481,Endherkonk,sanguino,1578,warlock,demonology,60,31,29
45482,Sörlewiis,the-maelstrom,1576,warlock,demonology,48,29,19
45483,Gulzot,turalyon,1575,warlock,demonology,42,28,14
45484,Kalinowa,burning-legion,1573,warlock,demonology,95,53,42
45485,Erøne,archimonde,1569,warlock,demonology,217,111,106
45486,Шэдоубёрн,soulflayer,1567,warlock,demonology,101,58,43
45487,Iovol,korgall,1566,warlock,demonology,60,36,24
45488,Azthral,nemesis,1566,warlock,demonology,141,73,68
45489,Agâshh,blackrock,1565,warlock,demonology,32,20,12
45490,Silenozz,ragnaros,1564,warlock,demonology,91,49,42
45491,Gemors,ravenholdt,1562,warlock,demonology,83,42,41
45492,Зарлог,soulflayer,1560,warlock,demonology,42,22,20
45493,Чернаяскала,howling-fjord,1560,warlock,demonology,78,40,38
45494,Dotsyoudown,kelthuzad,1560,warlock,demonology,36,18,18
45495,Itspoint,draenor,1558,warlock,demonology,65,33,32
45496,Hâres,anetheron,1550,warlock,demonology,241,116,125
45497,Sedryn,turalyon,1547,warlock,demonology,660,337,323
45498,Костикк,howling-fjord,1546,warlock,demonology,37,21,16
45499,Hamnam,blackrock,1543,warlock,demonology,42,23,19
45500,Nerzhull,stormscale,1539,warlock,demonology,87,44,43
45501,Stormytrumpy,twisting-nether,1537,warlock,demonology,33,18,15
45502,Redshíne,hyjal,1537,warlock,demonology,54,24,30
45503,Solitariøus,arathi,1536,warlock,demonology,60,30,30
45504,Nuwdles,tarren-mill,1535,warlock,demonology,42,23,19
45505,Repah,doomhammer,1534,warlock,demonology,30,17,13
45506,Fsandtwo,ravencrest,1534,warlock,demonology,30,16,14
45507,Kaamosliha,frostwhisper,1532,warlock,demonology,101,51,50
45508,Харакула,fordragon,1531,warlock,demonology,24,17,7
45509,Altffeer,blackmoore,1531,warlock,demonology,47,27,20
45510,Wëndigo,stormscale,1530,warlock,demonology,41,19,22
45511,Tochka,archimonde,1523,warlock,demonology,36,18,18
45512,Bunne,twisting-nether,1523,warlock,demonology,36,16,20
45513,Sïlïthuss,ravencrest,1522,warlock,demonology,111,58,53
45514,Indiasummerx,turalyon,1521,warlock,demonology,46,26,20
45515,Lockaria,zuljin,1519,warlock,demonology,42,24,18
45516,Benzakenta,sylvanas,1518,warlock,demonology,36,22,14
45517,Skitless,blackmoore,1514,warlock,demonology,39,19,20
45518,Ájszmen,ravencrest,1512,warlock,demonology,99,48,51
45519,Seriasa,blackmoore,1511,warlock,demonology,66,27,39
45520,Грешъник,gordunni,1508,warlock,demonology,37,19,18
45521,Theolock,ragnaros,1508,warlock,demonology,60,28,32
45522,Ayóó,doomhammer,1504,warlock,demonology,302,155,147
45523,Rafael,stormscale,1503,warlock,demonology,60,33,27
45524,Bß,argent-dawn,1495,warlock,demonology,47,28,19
45525,Srhal,blackmoore,1492,warlock,demonology,96,53,43
45526,Morgan,jaedenar,1491,warlock,demonology,66,28,38
45527,Dabulock,blackmoore,1487,warlock,demonology,33,17,16
45528,Beloezoloto,deathwing,1484,warlock,demonology,36,16,20
45529,Эволюционист,gordunni,1483,warlock,demonology,42,22,20
45530,Absúrd,turalyon,1481,warlock,demonology,228,127,101
45531,Khalkazar,darkspear,1477,warlock,demonology,30,16,14
45532,Roedin,tarren-mill,1477,warlock,demonology,112,43,69
45533,Felburrn,twisting-nether,1475,warlock,demonology,83,40,43
45534,Мормир,deathguard,1473,warlock,demonology,46,23,23
45535,Béastmodex,eredar,1470,warlock,demonology,33,18,15
45536,Иллугис,gordunni,1468,warlock,demonology,36,17,19
45537,Паникс,gordunni,1463,warlock,demonology,42,18,24
45538,Mephysteroth,dalaran,1462,warlock,demonology,30,16,14
45539,Enviroq,burning-legion,1454,warlock,demonology,36,22,14
45540,Deprecated,burning-blade,1453,warlock,demonology,29,17,12
45541,Валентинчик,galakrond,1452,warlock,demonology,57,32,25
45542,Jondi,blackmoore,1452,warlock,demonology,43,23,20
45543,Rpez,archimonde,1451,warlock,demonology,202,107,95
45544,Нгага,howling-fjord,1443,warlock,demonology,227,111,116
45545,Esgül,draenor,1442,warlock,demonology,76,40,36
45546,Igõr,draenor,1439,warlock,demonology,24,15,9
45547,Razzguul,blackmoore,1439,warlock,demonology,34,19,15
45548,Nachtreich,thrall,1438,warlock,demonology,24,15,9
45549,Priszcilla,twisting-nether,1438,warlock,demonology,108,59,49
45550,Benvyx,twisting-nether,1438,warlock,demonology,30,15,15
45551,Rektube,sanguino,1437,warlock,demonology,18,15,3
45552,Easycheasy,ravencrest,1437,warlock,demonology,30,15,15
45553,Jesez,aegwynn,1436,warlock,demonology,24,15,9
45554,Чутьчутьзлая,gordunni,1436,warlock,demonology,54,25,29
45555,Æternallock,nemesis,1433,warlock,demonology,42,26,16
45556,Ganjubass,tarren-mill,1432,warlock,demonology,24,15,9
45557,Kukcaryfuk,drakthul,1431,warlock,demonology,54,27,27
45558,Dhraven,thrall,1427,warlock,demonology,42,21,21
45559,Lockned,outland,1426,warlock,demonology,24,15,9
45560,Corbiejr,tarren-mill,1425,warlock,demonology,70,29,41
45561,Algolagniac,stormscale,1424,warlock,demonology,24,15,9
45562,Hyphonos,blackmoore,1422,warlock,demonology,30,15,15
45563,Ruinovino,outland,1422,warlock,demonology,42,18,24
45564,Джердхаус,fordragon,1419,warlock,demonology,30,15,15
45565,Épidémie,outland,1419,warlock,demonology,47,18,29
45566,Stormblast,azshara,1417,warlock,demonology,42,27,15
45567,Carlss,sanguino,1416,warlock,demonology,24,15,9
45568,Nattû,outland,1415,warlock,demonology,30,15,15
45569,Lunden,drakthul,1414,warlock,demonology,46,22,24
45570,Malganas,sylvanas,1414,warlock,demonology,95,42,53
45571,Smallpee,kazzak,1413,warlock,demonology,36,17,19
45572,Shalazar,dun-modr,1412,warlock,demonology,60,36,24
45573,Героуд,howling-fjord,1407,warlock,demonology,30,15,15
45574,Qullnius,kazzak,1402,warlock,demonology,42,24,18
45575,Tudii,frostwolf,1401,warlock,demonology,54,32,22
45576,Morgána,outland,1401,warlock,demonology,30,15,15
45577,Søcraqt,blackrock,1399,warlock,demonology,31,15,16
45578,Profylaxis,arathor,1396,warlock,demonology,46,23,23
45579,Bonemetz,blackmoore,1393,warlock,demonology,30,16,14
45580,Peremi,grim-batol,1388,warlock,demonology,30,15,15
45581,Бельведерчи,blackscar,1388,warlock,demonology,132,65,67
45582,Panic,stormrage,1384,warlock,demonology,132,69,63
45583,Кайрана,blackscar,1376,warlock,demonology,36,20,16
45584,Расмурът,soulflayer,1375,warlock,demonology,42,23,19
45585,Nagash,zuljin,1370,warlock,demonology,23,16,7
45586,Wítchær,blackhand,1370,warlock,demonology,48,28,20
45587,Dedalus,zuluhed,1367,warlock,demonology,148,85,63
45588,Wåfa,kazzak,1364,warlock,demonology,60,34,26
45589,Sevastus,argent-dawn,1363,warlock,demonology,96,48,48
45590,Гулдарий,howling-fjord,1362,warlock,demonology,219,112,107
45591,Ädarä,cthun,1359,warlock,demonology,60,30,30
45592,Ilarizium,ysondre,1359,warlock,demonology,83,41,42
45593,Tsumde,dalaran,1358,warlock,demonology,60,27,33
45594,Чингинсхан,howling-fjord,1357,warlock,demonology,35,25,10
45595,Камнилока,booty-bay,1355,warlock,demonology,41,24,17
45596,Mesîkatayut,outland,1351,warlock,demonology,75,43,32
45597,Cahoa,archimonde,1349,warlock,demonology,24,15,9
45598,Olsel,draenor,1349,warlock,demonology,36,16,20
45599,Сладкийпир,soulflayer,1346,warlock,demonology,30,15,15
45600,Scallington,shattered-hand,1344,warlock,demonology,24,14,10
45601,Malkoran,sylvanas,1344,warlock,demonology,24,14,10
45602,Афинц,deathguard,1343,warlock,demonology,24,14,10
45603,Quadraxer,antonidas,1342,warlock,demonology,24,14,10
45604,Lacape,dalaran,1340,warlock,demonology,28,15,13
45605,Thorash,moonglade,1339,warlock,demonology,24,16,8
45606,Gattlingan,eredar,1337,warlock,demonology,24,14,10
45607,Evilbuba,burning-legion,1337,warlock,demonology,58,30,28
45608,Nimh,azjolnerub,1336,warlock,demonology,63,33,30
45609,Tomlingen,terenas,1335,warlock,demonology,48,25,23
45610,Kosoki,burning-legion,1335,warlock,demonology,30,14,16
45611,Darkdagor,blackrock,1334,warlock,demonology,24,14,10
45612,Vanskor,argent-dawn,1331,warlock,demonology,100,42,58
45613,Ппинг,soulflayer,1328,warlock,demonology,30,14,16
45614,Letzman,ravencrest,1321,warlock,demonology,25,16,9
45615,Kwanzaa,ravencrest,1319,warlock,demonology,24,14,10
45616,Fujiitøra,ysondre,1319,warlock,demonology,61,34,27
45617,Sineko,twisting-nether,1319,warlock,demonology,172,80,92
45618,Gulldan,bloodfeather,1315,warlock,demonology,54,27,27
45619,Дуклок,howling-fjord,1313,warlock,demonology,70,37,33
45620,Forthewin,stormreaver,1313,warlock,demonology,30,15,15
45621,Auxi,the-maelstrom,1310,warlock,demonology,87,48,39
45622,Waltrude,conseil-des-ombres,1310,warlock,demonology,60,23,37
45623,Dominvs,silvermoon,1306,warlock,demonology,162,80,82
45624,Valadair,sanguino,1286,warlock,demonology,168,87,81
45625,Cmzdalock,ravencrest,1279,warlock,demonology,36,23,13
45626,Void,pozzo-delleternità,1273,warlock,demonology,52,24,28
45627,Инсип,blackscar,1256,warlock,demonology,42,18,24
45628,Eatherial,twilights-hammer,1255,warlock,demonology,30,18,12
45629,Trellaras,bloodfeather,1249,warlock,demonology,29,14,15
45630,Rikkért,draenor,1248,warlock,demonology,24,13,11
45631,Smadrekas,ravencrest,1247,warlock,demonology,18,13,5
45632,Déus,forscherliga,1245,warlock,demonology,155,70,85
45633,Greeylock,blackhand,1243,warlock,demonology,24,13,11
45634,Æyna,thrall,1242,warlock,demonology,24,13,11
45635,Tarilinwelli,les-sentinelles,1242,warlock,demonology,24,13,11
45636,Стокыч,soulflayer,1241,warlock,demonology,36,13,23
45637,Icq,ravencrest,1240,warlock,demonology,27,14,13
45638,Chedipes,stormscale,1240,warlock,demonology,33,14,19
45639,Thralka,burning-legion,1237,warlock,demonology,24,13,11
45640,Lokko,nemesis,1237,warlock,demonology,65,26,39
45641,Áutísm,silvermoon,1235,warlock,demonology,18,13,5
45642,Andid,frostwolf,1231,warlock,demonology,38,18,20
45643,Sargaerot,draenor,1230,warlock,demonology,72,33,39
45644,Truckpunch,defias-brotherhood,1228,warlock,demonology,42,18,24
45645,Dernaxz,argent-dawn,1225,warlock,demonology,26,15,11
45646,Honetia,ravencrest,1225,warlock,demonology,29,13,16
45647,Mefistosx,draenor,1224,warlock,demonology,30,13,17
45648,Армдэд,galakrond,1222,warlock,demonology,30,13,17
45649,Bíü,tarren-mill,1219,warlock,demonology,30,13,17
45650,Gnometefurax,hyjal,1218,warlock,demonology,30,14,16
45651,Jag,neptulon,1214,warlock,demonology,32,19,13
45652,Rüwel,mannoroth,1214,warlock,demonology,47,20,27
45653,Tunrîda,illidan,1206,warlock,demonology,33,14,19
45654,Netcownt,silvermoon,1199,warlock,demonology,31,15,16
45655,Шимара,eversong,1198,warlock,demonology,21,14,7
45656,Lugdan,blackmoore,1198,warlock,demonology,36,13,23
45657,Kharless,kazzak,1197,warlock,demonology,32,15,17
45658,Lifesteal,auchindoun,1196,warlock,demonology,42,18,24
45659,Azraëlle,drekthar,1195,warlock,demonology,21,14,7
45660,Vreyax,aegwynn,1195,warlock,demonology,29,13,16
45661,Nekrosd,tarren-mill,1193,warlock,demonology,27,14,13
45662,Силаскверна,deathguard,1185,warlock,demonology,30,14,16
45663,Rngmåchinêx,ravencrest,1183,warlock,demonology,22,13,9
45664,Vorgoth,argent-dawn,1179,warlock,demonology,28,13,15
45665,Filø,dalaran,1173,warlock,demonology,47,14,33
45666,Decayez,thrall,1168,warlock,demonology,19,13,6
45667,Mundunugu,sanguino,1160,warlock,demonology,19,13,6
45668,Jomitoisback,nemesis,1152,warlock,demonology,12,12,0
45669,Lyndi,nerathor,1152,warlock,demonology,18,12,6
45670,Syntax,blackmoore,1152,warlock,demonology,18,12,6
45671,Ðåñtåy,ravencrest,1152,warlock,demonology,18,12,6
45672,Gyzmo,outland,1152,warlock,demonology,24,12,12
45673,Glooness,burning-legion,1152,warlock,demonology,24,12,12
45674,Инфес,deathweaver,1151,warlock,demonology,18,12,6
45675,Парачо,eversong,1151,warlock,demonology,24,12,12
45676,Nargøf,outland,1151,warlock,demonology,24,12,12
45677,Topmodelx,eredar,1150,warlock,demonology,18,12,6
45678,Майдум,soulflayer,1150,warlock,demonology,18,12,6
45679,Нистл,gordunni,1149,warlock,demonology,18,12,6
45680,Desolador,tyrande,1148,warlock,demonology,30,12,18
45681,Sizezero,tarren-mill,1147,warlock,demonology,18,12,6
45682,Ashzu,quelthalas,1145,warlock,demonology,24,12,12
45683,Penske,sanguino,1143,warlock,demonology,30,12,18
45684,Brryant,colinas-pardas,1141,warlock,demonology,18,12,6
45685,Szetbaszlock,ragnaros,1137,warlock,demonology,18,12,6
45686,Rövsmärta,ragnaros,1135,warlock,demonology,21,13,8
45687,Aldhelm,draenor,1130,warlock,demonology,28,13,15
45688,Warlockyo,blackrock,1118,warlock,demonology,23,12,11
45689,Erwynna,conseil-des-ombres,1118,warlock,demonology,30,12,18
45690,Scarly,nordrassil,1103,warlock,demonology,41,21,20
45691,Tripleshache,elune,1101,warlock,demonology,66,33,33
45692,Cwyn,ravencrest,1088,warlock,demonology,30,13,17
45693,Flocca,archimonde,1085,warlock,demonology,26,12,14
45694,Evanore,burning-legion,1083,warlock,demonology,26,12,14
45695,Sipsirica,ragnaros,1061,warlock,demonology,42,15,27
45696,Bicuriousdad,tarren-mill,1056,warlock,demonology,12,11,1
45697,Absurdity,twisting-nether,1056,warlock,demonology,16,12,4
45698,Dotosgyörgy,ragnaros,1056,warlock,demonology,18,11,7
45699,Bigbagelbob,archimonde,1056,warlock,demonology,18,11,7
45700,Ahkan,argent-dawn,1056,warlock,demonology,18,11,7
45701,Adellara,draenor,1056,warlock,demonology,18,11,7
45702,ßualock,sylvanas,1056,warlock,demonology,18,11,7
45703,Nazw,ravencrest,1056,warlock,demonology,24,11,13
45704,Dirtytyrant,sanguino,1055,warlock,demonology,18,11,7
45705,Tiendi,blackhand,1055,warlock,demonology,24,11,13
45706,Lonelock,blackrock,1055,warlock,demonology,24,11,13
45707,Tìdùs,nethersturm,1054,warlock,demonology,12,11,1
45708,Idezis,ragnaros,1054,warlock,demonology,18,11,7
45709,Froschhaxen,blackhand,1054,warlock,demonology,18,11,7
45710,Dàrksoul,thrall,1054,warlock,demonology,18,11,7
45711,Thorky,blackrock,1054,warlock,demonology,24,11,13
45712,Katâra,tarren-mill,1054,warlock,demonology,24,11,13
45713,Shînîgamî,draenor,1053,warlock,demonology,18,11,7
45714,Agathaharkne,minahonda,1053,warlock,demonology,24,11,13
45715,Fenrixlol,zuljin,1052,warlock,demonology,18,11,7
45716,Törtidotcom,blackrock,1051,warlock,demonology,24,11,13
45717,Емс,gordunni,1051,warlock,demonology,24,11,13
45718,Remthorn,frostmane,1050,warlock,demonology,65,35,30
45719,Zanzarismo,nemesis,1049,warlock,demonology,21,12,9
45720,Ambralia,blackmoore,1048,warlock,demonology,24,12,12
45721,Дулаан,blackscar,1042,warlock,demonology,18,11,7
45722,Themengh,stormscale,1038,warlock,demonology,45,14,31
45723,Sabiocalvo,dun-modr,1036,warlock,demonology,64,29,35
45724,Imadovich,silvermoon,1029,warlock,demonology,41,20,21
45725,Krushell,sanguino,1021,warlock,demonology,18,11,7
45726,Shadowppl,outland,1021,warlock,demonology,26,12,14
45727,Demonfaris,turalyon,1007,warlock,demonology,21,11,10
45728,Dreamnyâsha,tarren-mill,1002,warlock,demonology,21,13,8
45729,Discomugg,stormscale,991,warlock,demonology,17,11,6
45730,Мембер,thermaplugg,990,warlock,demonology,26,11,15
45731,Veganlifter,ravencrest,960,warlock,demonology,12,10,2
45732,Syñdrome,ragnaros,960,warlock,demonology,12,10,2
45733,Демоник,deathguard,960,warlock,demonology,18,10,8
45734,Oggelock,tarren-mill,960,warlock,demonology,18,10,8
45735,Sêrø,aegwynn,960,warlock,demonology,18,10,8
45736,Jegfaller,wildhammer,960,warlock,demonology,24,10,14
45737,Кьютсанни,howling-fjord,960,warlock,demonology,24,10,14
45738,Velativ,silvermoon,959,warlock,demonology,12,10,2
45739,Xartul,tarren-mill,959,warlock,demonology,12,10,2
45740,Oozi,tarren-mill,959,warlock,demonology,12,10,2
45741,Нэваблэйз,howling-fjord,959,warlock,demonology,18,10,8
45742,Nainbusdemil,dalaran,959,warlock,demonology,18,10,8
45743,Bigballerguy,sylvanas,959,warlock,demonology,18,10,8
45744,Ipetsincl,kazzak,958,warlock,demonology,18,10,8
45745,Astéfion,dalaran,958,warlock,demonology,18,10,8
45746,Davyjonessx,twisting-nether,958,warlock,demonology,18,10,8
45747,Pipoûc,archimonde,958,warlock,demonology,24,10,14
45748,Güulran,les-clairvoyants,954,warlock,demonology,18,10,8
45749,Degdeehei,draenor,953,warlock,demonology,12,10,2
45750,Kalhija,medivh,953,warlock,demonology,18,10,8
45751,Kawapow,azjolnerub,952,warlock,demonology,18,10,8
45752,Ablas,bladefist,940,warlock,demonology,35,10,25
45753,Thyron,gorgonnash,938,warlock,demonology,24,10,14
45754,Fearmydear,alleria,926,warlock,demonology,17,10,7
45755,Agonyzed,argent-dawn,923,warlock,demonology,16,11,5
45756,Migyardondup,exodar,916,warlock,demonology,75,41,34
45757,Ixal,hyjal,914,warlock,demonology,36,17,19
45758,Zaross,khaz-modan,910,warlock,demonology,26,13,13
45759,Acuacx,drakthul,909,warlock,demonology,17,10,7
45760,Djadizpunish,stormscale,894,warlock,demonology,15,11,4
45761,Snoggä,antonidas,885,warlock,demonology,36,17,19
45762,Öbsury,hyjal,864,warlock,demonology,12,9,3
45763,Yazurí,ravencrest,864,warlock,demonology,12,9,3
45764,Stafar,outland,864,warlock,demonology,12,9,3
45765,Ooroothothz,frostwolf,864,warlock,demonology,12,9,3
45766,Aladèèn,tarren-mill,864,warlock,demonology,12,9,3
45767,Простохаос,howling-fjord,864,warlock,demonology,12,9,3
45768,Dogdrakex,tarren-mill,864,warlock,demonology,12,9,3
45769,Dadylock,silvermoon,864,warlock,demonology,12,9,3
45770,Youseenbølt,veklor,864,warlock,demonology,12,9,3
45771,Demosteaks,thrall,864,warlock,demonology,12,9,3
45772,Boomlok,tarren-mill,864,warlock,demonology,18,9,9
45773,Nekrofille,outland,864,warlock,demonology,18,9,9
45774,Nunhesh,defias-brotherhood,864,warlock,demonology,18,9,9
45775,Rikmeyzter,burning-blade,864,warlock,demonology,18,9,9
45776,Darksoll,hyjal,864,warlock,demonology,24,9,15
45777,Nastýføxÿ,ysondre,863,warlock,demonology,12,9,3
45778,Zèlêph,archimonde,863,warlock,demonology,12,9,3
45779,Kritrouilles,sargeras,863,warlock,demonology,18,9,9
45780,Cardinall,drakthul,863,warlock,demonology,18,9,9
45781,Nosoulnoprob,sylvanas,863,warlock,demonology,24,9,15
45782,Édøras,archimonde,863,warlock,demonology,24,9,15
45783,Nomakqlock,dun-modr,862,warlock,demonology,15,10,5
45784,Mmorgana,sanguino,862,warlock,demonology,24,9,15
45785,Xoky,argent-dawn,861,warlock,demonology,18,9,9
45786,Allotropìa,ravencrest,861,warlock,demonology,24,9,15
45787,Kazzulina,ravenholdt,861,warlock,demonology,24,9,15
45788,Haitech,dalaran,858,warlock,demonology,12,9,3
45789,Nikhusadark,draenor,856,warlock,demonology,19,9,10
45790,Диффиндо,galakrond,854,warlock,demonology,12,9,3
45791,Screamo,sylvanas,844,warlock,demonology,18,9,9
45792,Аттропа,gordunni,840,warlock,demonology,30,15,15
45793,Jendzababa,burning-legion,827,warlock,demonology,17,9,8
45794,Дакиса,gordunni,815,warlock,demonology,17,9,8
45795,Гупперлок,howling-fjord,810,warlock,demonology,27,12,15
45796,Бирел,soulflayer,799,warlock,demonology,16,9,7
45797,Fuark,teldrassil,798,warlock,demonology,11,9,2
45798,Простоседой,gordunni,798,warlock,demonology,23,9,14
45799,Йотунхейм,ashenvale,792,warlock,demonology,20,9,11
45800,Devildodo,elune,768,warlock,demonology,12,8,4
45801,Hannen,blackrock,768,warlock,demonology,12,8,4
45802,Xjms,darksorrow,768,warlock,demonology,12,8,4
45803,Аскамардва,gordunni,768,warlock,demonology,12,8,4
45804,Azaêl,azshara,768,warlock,demonology,12,8,4
45805,Cappaoow,ravencrest,768,warlock,demonology,12,8,4
45806,Котрх,gordunni,768,warlock,demonology,12,8,4
45807,Lywov,stormscale,768,warlock,demonology,12,8,4
45808,Hyöká,kazzak,768,warlock,demonology,12,8,4
45809,Killning,medivh,768,warlock,demonology,12,8,4
45810,Hyòkà,kazzak,768,warlock,demonology,12,8,4
45811,Rozn,ravencrest,768,warlock,demonology,12,8,4
45812,Boltimoore,magtheridon,768,warlock,demonology,12,8,4
45813,Gilfhaunter,malganis,768,warlock,demonology,12,8,4
45814,Staenkymayne,blackhand,768,warlock,demonology,12,8,4
45815,Døtzz,blackmoore,768,warlock,demonology,12,8,4
45816,Maevoni,blackmoore,768,warlock,demonology,12,8,4
45817,Idkdot,ravencrest,768,warlock,demonology,18,8,10
45818,Koldarr,blackmoore,768,warlock,demonology,18,8,10
45819,Ívânguldán,twisting-nether,768,warlock,demonology,18,8,10
45820,Biest,drakthul,768,warlock,demonology,18,8,10
45821,Jarodshadow,stormscale,768,warlock,demonology,18,8,10
45822,Djezzick,stormscale,768,warlock,demonology,18,8,10
45823,Noytan,nemesis,768,warlock,demonology,18,8,10
45824,Dryaxc,frostwolf,768,warlock,demonology,18,8,10
45825,Narsok,blackrock,768,warlock,demonology,18,8,10
45826,Øupas,ysondre,768,warlock,demonology,18,8,10
45827,Sovrìn,blackrock,767,warlock,demonology,12,8,4
45828,Ðelðish,draenor,767,warlock,demonology,12,8,4
45829,Eizon,tarren-mill,767,warlock,demonology,12,8,4
45830,Tojezlo,drakthul,767,warlock,demonology,12,8,4
45831,Евнухоидизм,gordunni,767,warlock,demonology,14,8,6
45832,Alotadot,ravencrest,767,warlock,demonology,18,8,10
45833,Chimera,mugthol,767,warlock,demonology,18,8,10
45834,Xanatar,blackhand,767,warlock,demonology,24,8,16
45835,Otemlock,sanguino,766,warlock,demonology,12,8,4
45836,Lethellin,antonidas,766,warlock,demonology,12,8,4
45837,Guccie,ravencrest,766,warlock,demonology,17,10,7
45838,Zeddy,draenor,766,warlock,demonology,18,8,10
45839,Britneyféars,emeriss,766,warlock,demonology,18,8,10
45840,Merzavka,kazzak,765,warlock,demonology,12,8,4
45841,Njutbar,ragnaros,765,warlock,demonology,18,8,10
45842,Bachmut,ravencrest,765,warlock,demonology,18,8,10
45843,Gúldn,outland,763,warlock,demonology,30,8,22
45844,Ясяшотлав,soulflayer,761,warlock,demonology,22,11,11
45845,Wanderingowl,blackmoore,760,warlock,demonology,12,8,4
45846,Lokisi,die-aldor,752,warlock,demonology,24,8,16
45847,Nedivh,stormscale,751,warlock,demonology,23,8,15
45848,Dotwhat,ravencrest,719,warlock,demonology,17,8,9
45849,Ромаколдун,howling-fjord,704,warlock,demonology,16,8,8
45850,Lifetap,tarren-mill,703,warlock,demonology,14,8,6
45851,Ponçeur,ysondre,687,warlock,demonology,19,9,10
45852,Papilena,turalyon,687,warlock,demonology,19,8,11
45853,Eviloverlord,silvermoon,672,warlock,demonology,12,7,5
45854,Thereya,dun-morogh,672,warlock,demonology,12,7,5
45855,Kosfáce,tarren-mill,672,warlock,demonology,12,7,5
45856,Immolleria,frostmane,672,warlock,demonology,12,7,5
45857,Flamidien,archimonde,672,warlock,demonology,12,7,5
45858,Plâytïmè,stormscale,672,warlock,demonology,12,7,5
45859,Кале,goldrinn,672,warlock,demonology,12,7,5
45860,Styxwl,blackhand,672,warlock,demonology,12,7,5
45861,Spongebobx,kazzak,672,warlock,demonology,12,7,5
45862,Ruhuen,stormscale,672,warlock,demonology,12,7,5
45863,Ballerlock,ravencrest,672,warlock,demonology,12,7,5
45864,Fearfearfear,archimonde,672,warlock,demonology,12,7,5
45865,Circe,draenor,672,warlock,demonology,12,7,5
45866,Likilaka,draenor,672,warlock,demonology,12,7,5
45867,Dzodeep,kazzak,672,warlock,demonology,12,7,5
45868,Blekspel,outland,672,warlock,demonology,12,7,5
45869,Framelock,draenor,672,warlock,demonology,12,7,5
45870,Hannens,blackrock,672,warlock,demonology,12,7,5
45871,Mythoman,ravencrest,672,warlock,demonology,12,7,5
45872,Slurvefar,kazzak,672,warlock,demonology,12,7,5
45873,Kerídiin,twisting-nether,672,warlock,demonology,12,7,5
45874,Marador,drakthul,672,warlock,demonology,12,7,5
45875,Zagreos,tarren-mill,672,warlock,demonology,12,7,5
45876,Wiitchdoktor,twisting-nether,672,warlock,demonology,12,7,5
45877,Dwoorf,ravencrest,672,warlock,demonology,12,7,5
45878,Guldchan,drakthul,672,warlock,demonology,12,7,5
45879,Khaleth,dun-modr,672,warlock,demonology,12,7,5
45880,Líí,burning-blade,672,warlock,demonology,12,7,5
45881,Cringetamer,silvermoon,672,warlock,demonology,18,7,11
45882,Fearu,kazzak,672,warlock,demonology,18,7,11
45883,Shortyi,thrall,672,warlock,demonology,18,7,11
45884,Xfz,stormscale,672,warlock,demonology,18,7,11
45885,Baldazar,dun-modr,672,warlock,demonology,18,7,11
45886,Klaab,hyjal,672,warlock,demonology,18,7,11
45887,Сч,ashenvale,671,warlock,demonology,12,7,5
45888,Dedobozhe,ravencrest,671,warlock,demonology,12,7,5
45889,Адилея,howling-fjord,671,warlock,demonology,12,7,5
45890,Pestilus,thrall,671,warlock,demonology,18,7,11
45891,Indifférence,archimonde,671,warlock,demonology,18,7,11
45892,Bewbys,draenor,671,warlock,demonology,24,7,17
45893,Баммес,galakrond,671,warlock,demonology,24,7,17
45894,Williamford,dun-modr,669,warlock,demonology,18,7,11
45895,Darlanis,draenor,668,warlock,demonology,12,7,5
45896,Farasuflet,burning-steppes,658,warlock,demonology,12,7,5
45897,Raez,burning-blade,654,warlock,demonology,23,7,16
45898,Ryks,terrordar,624,warlock,demonology,15,7,8
45899,Kavalierr,stormscale,624,warlock,demonology,21,8,13
45900,Kïng,elune,622,warlock,demonology,15,8,7
45901,Warlockxx,ravencrest,607,warlock,demonology,11,7,4
45902,Sethtarr,draenor,607,warlock,demonology,14,7,7
45903,Solidwarlock,archimonde,576,warlock,demonology,6,6,0
45904,Onewarlock,kazzak,576,warlock,demonology,6,6,0
45905,Labreego,aggra-português,576,warlock,demonology,6,6,0
45906,Boldielocks,tarren-mill,576,warlock,demonology,6,6,0
45907,Тапкидеда,gordunni,576,warlock,demonology,6,6,0
45908,Beebs,aegwynn,576,warlock,demonology,6,6,0
45909,Werzel,frostmane,576,warlock,demonology,6,6,0
45910,Kasztyk,grim-batol,576,warlock,demonology,12,6,6
45911,Darcol,archimonde,576,warlock,demonology,12,6,6
45912,Тевон,gordunni,576,warlock,demonology,12,6,6
45913,Deflagrate,kazzak,576,warlock,demonology,12,6,6
45914,Malathrom,garona,576,warlock,demonology,12,6,6
45915,Wacamolymojo,tarren-mill,576,warlock,demonology,12,6,6
45916,Rivmuu,argent-dawn,576,warlock,demonology,12,6,6
45917,Mombo,the-maelstrom,576,warlock,demonology,12,6,6
45918,Gruldran,khaz-modan,576,warlock,demonology,12,6,6
45919,Líely,ravencrest,576,warlock,demonology,12,6,6
45920,Ilovebronko,blackrock,576,warlock,demonology,12,6,6
45921,Ðêmøñîc,ravencrest,576,warlock,demonology,12,6,6
45922,Cresen,tarren-mill,576,warlock,demonology,12,6,6
45923,Hyóká,kazzak,576,warlock,demonology,12,6,6
45924,Zerx,malganis,576,warlock,demonology,12,6,6
45925,Teflondione,stormreaver,576,warlock,demonology,12,6,6
45926,Dracsu,dun-modr,576,warlock,demonology,12,6,6
45927,Lifedriller,drakthul,576,warlock,demonology,12,6,6
45928,Øbéydêmøn,silvermoon,576,warlock,demonology,12,6,6
45929,Rîas,hyjal,576,warlock,demonology,12,6,6
45930,Lamboo,tarren-mill,576,warlock,demonology,12,6,6
45931,Vîmø,antonidas,576,warlock,demonology,12,6,6
45932,Devour,magtheridon,576,warlock,demonology,12,6,6
45933,Nephystø,archimonde,576,warlock,demonology,12,6,6
45934,Lacus,voljin,576,warlock,demonology,18,6,12
45935,Morwëk,ysondre,576,warlock,demonology,18,6,12
45936,Yeatso,blackmoore,576,warlock,demonology,18,6,12
45937,Oldasianman,blackrock,576,warlock,demonology,18,6,12
45938,Фэлдред,soulflayer,576,warlock,demonology,18,6,12
45939,Haillun,twisting-nether,576,warlock,demonology,18,6,12
45940,Deadleth,blackrock,575,warlock,demonology,10,7,3
45941,Сквордин,gordunni,575,warlock,demonology,12,6,6
45942,Kropi,blackhand,575,warlock,demonology,12,6,6
45943,Факлок,gordunni,575,warlock,demonology,12,6,6
45944,Heximexi,malganis,575,warlock,demonology,18,6,12
45945,Xerxia,blackrock,575,warlock,demonology,18,6,12
45946,Ахпорбес,gordunni,574,warlock,demonology,10,7,3
45947,Ragedrop,malygos,574,warlock,demonology,12,6,6
45948,Methmuncher,twisting-nether,574,warlock,demonology,24,6,18
45949,Petrosk,sanguino,569,warlock,demonology,12,6,6
45950,Absurdd,turalyon,568,warlock,demonology,14,9,5
45951,Кхадгард,howling-fjord,544,warlock,demonology,16,6,10
45952,Sourpatchkid,the-maelstrom,543,warlock,demonology,11,6,5
45953,Gutras,ragnaros,527,warlock,demonology,11,6,5
45954,Tvmpzwl,ravencrest,527,warlock,demonology,17,6,11
45955,Shazem,tarren-mill,522,warlock,demonology,12,7,5
45956,Mércé,stormscale,480,warlock,demonology,6,5,1
45957,Racursed,outland,480,warlock,demonology,6,5,1
45958,Joinx,tarren-mill,480,warlock,demonology,6,5,1
45959,Олимта,blackscar,480,warlock,demonology,6,5,1
45960,Felgødx,nemesis,480,warlock,demonology,6,5,1
45961,Уанбаттон,gordunni,480,warlock,demonology,6,5,1
45962,Jinxme,tarren-mill,480,warlock,demonology,6,5,1
45963,Гнильсен,borean-tundra,480,warlock,demonology,6,5,1
45964,Saganelle,hyjal,480,warlock,demonology,6,5,1
45965,Miauwu,stormscale,480,warlock,demonology,6,5,1
45966,Vitalyk,sanguino,480,warlock,demonology,6,5,1
45967,Boomloc,tarren-mill,480,warlock,demonology,6,5,1
45968,Evalin,aggra-português,480,warlock,demonology,6,5,1
45969,Köftemec,blackrock,480,warlock,demonology,6,5,1
45970,Hiloqtlock,blackmoore,480,warlock,demonology,6,5,1
45971,Bibilockbert,aegwynn,480,warlock,demonology,6,5,1
45972,Cazul,archimonde,480,warlock,demonology,6,5,1
45973,Chromex,dentarg,480,warlock,demonology,6,5,1
45974,Mudwalkin,ravencrest,480,warlock,demonology,6,5,1
45975,Xarica,garona,480,warlock,demonology,6,5,1
45976,Voídzero,hyjal,480,warlock,demonology,6,5,1
45977,Deadmanwlkin,aggra-português,480,warlock,demonology,6,5,1
45978,Baloc,kirin-tor,480,warlock,demonology,6,5,1
45979,Фирвебало,soulflayer,480,warlock,demonology,6,5,1
45980,Swagzz,silvermoon,480,warlock,demonology,6,5,1
45981,Лираума,howling-fjord,480,warlock,demonology,9,6,3
45982,Durátor,ravencrest,480,warlock,demonology,12,5,7
45983,Tepelkwastje,twisting-nether,480,warlock,demonology,12,5,7
45984,Morshax,ysondre,480,warlock,demonology,12,5,7
45985,Landii,ragnaros,480,warlock,demonology,12,5,7
45986,Agaton,twisting-nether,480,warlock,demonology,12,5,7
45987,Nastychâtøn,ysondre,480,warlock,demonology,12,5,7
45988,Векстах,gordunni,480,warlock,demonology,12,5,7
45989,Zoodaddy,grim-batol,480,warlock,demonology,12,5,7
45990,Destroc,blackrock,480,warlock,demonology,12,5,7
45991,Msßeckinsale,tarren-mill,480,warlock,demonology,12,5,7
45992,Anturia,garona,480,warlock,demonology,12,5,7
45993,Purepkbob,quelthalas,480,warlock,demonology,12,5,7
45994,Mty,bronze-dragonflight,480,warlock,demonology,12,5,7
45995,Hogheru,kazzak,480,warlock,demonology,12,5,7
45996,Gulderrf,kirin-tor,480,warlock,demonology,12,5,7
45997,Khâmélÿa,culte-de-la-rive-noire,480,warlock,demonology,12,5,7
45998,Irnx,tarren-mill,480,warlock,demonology,12,5,7
45999,Moslock,kazzak,480,warlock,demonology,12,5,7
46000,Nécromancér,doomhammer,480,warlock,demonology,12,5,7
46001,Rushkush,ravencrest,480,warlock,demonology,13,5,8
46002,Vanmorgoth,nazjatar,480,warlock,demonology,18,5,13
46003,Zartax,kazzak,480,warlock,demonology,18,5,13
46004,Déemón,draenor,480,warlock,demonology,18,5,13
46005,Brodoh,dun-modr,480,warlock,demonology,18,5,13
46006,Acererak,thunderhorn,480,warlock,demonology,18,5,13
46007,Ascètic,kazzak,480,warlock,demonology,18,5,13
46008,Délidumrul,stormscale,480,warlock,demonology,18,5,13
46009,Ezekîél,blackhand,479,warlock,demonology,6,5,1
46010,Limfus,terokkar,479,warlock,demonology,6,5,1
46011,Aluy,blackmoore,479,warlock,demonology,12,5,7
46012,Gunca,sylvanas,479,warlock,demonology,12,5,7
46013,Lewd,dragonblight,479,warlock,demonology,12,5,7
46014,Oblutak,draenor,479,warlock,demonology,12,5,7
46015,Cròwly,area-52,416,warlock,demonology,10,5,5
46016,Broxsz,blackrock,415,warlock,demonology,8,5,3
46017,Zàkx,silvermoon,384,warlock,demonology,6,4,2
46018,Gigoberto,kazzak,384,warlock,demonology,6,4,2
46019,Dèsaad,stormscale,384,warlock,demonology,6,4,2
46020,Cosec,silvermoon,384,warlock,demonology,6,4,2
46021,Cleyandra,arathor,384,warlock,demonology,6,4,2
46022,Fredé,kazzak,384,warlock,demonology,6,4,2
46023,Незерлок,soulflayer,384,warlock,demonology,6,4,2
46024,Felhaen,silvermoon,384,warlock,demonology,6,4,2
46025,Náwwk,blackmoore,384,warlock,demonology,6,4,2
46026,Llilithh,draenor,384,warlock,demonology,6,4,2
46027,Колмидедди,gordunni,384,warlock,demonology,6,4,2
46028,Imissbolt,outland,384,warlock,demonology,6,4,2
46029,Bankstair,stormscale,384,warlock,demonology,6,4,2
46030,Likeqtz,thrall,384,warlock,demonology,6,4,2
46031,Kikeriki,blackhand,384,warlock,demonology,6,4,2
46032,Slerpmami,ragnaros,384,warlock,demonology,6,4,2
46033,Flxzshort,kazzak,384,warlock,demonology,6,4,2
46034,Lémonz,stormscale,384,warlock,demonology,6,4,2
46035,Maleficious,silvermoon,384,warlock,demonology,6,4,2
46036,Ôlo,rajaxx,384,warlock,demonology,6,4,2
46037,Exitlock,thrall,384,warlock,demonology,6,4,2
46038,Mayden,uldum,384,warlock,demonology,6,4,2
46039,Gödisdëäd,sanguino,384,warlock,demonology,6,4,2
46040,Mindzsonghó,ragnaros,384,warlock,demonology,6,4,2
46041,Vornex,sporeggar,384,warlock,demonology,6,4,2
46042,Absoul,defias-brotherhood,384,warlock,demonology,6,4,2
46043,Tropìcal,grim-batol,384,warlock,demonology,6,4,2
46044,Bitshlog,draenor,384,warlock,demonology,6,4,2
46045,Xuloth,ravencrest,384,warlock,demonology,6,4,2
46046,Gryme,dalaran,384,warlock,demonology,6,4,2
46047,Zakuri,blackmoore,384,warlock,demonology,6,4,2
46048,Sep,aegwynn,384,warlock,demonology,6,4,2
46049,Itrix,aegwynn,384,warlock,demonology,6,4,2
46050,Lockmybllz,baelgun,384,warlock,demonology,6,4,2
46051,Bluenote,colinas-pardas,384,warlock,demonology,6,4,2
46052,Cardyw,ravencrest,384,warlock,demonology,6,4,2
46053,Nekhar,twisting-nether,384,warlock,demonology,6,4,2
46054,Keibo,drakthul,384,warlock,demonology,6,4,2
46055,Freyzul,twisting-nether,384,warlock,demonology,6,4,2
46056,Ahollic,antonidas,384,warlock,demonology,6,4,2
46057,Aniq,eredar,384,warlock,demonology,6,4,2
46058,Roglash,eredar,384,warlock,demonology,6,4,2
46059,Куськысь,gordunni,384,warlock,demonology,9,5,4
46060,Muninnus,archimonde,384,warlock,demonology,15,5,10
46061,Focalorx,tarren-mill,384,warlock,demonology,12,4,8
46062,Vextos,draenor,384,warlock,demonology,12,4,8
46063,Xvron,tarren-mill,384,warlock,demonology,12,4,8
46064,Tolgaa,draenor,384,warlock,demonology,12,4,8
46065,Graveshaker,quelthalas,384,warlock,demonology,12,4,8
46066,Tuz,blackrock,384,warlock,demonology,12,4,8
46067,Lagyna,wildhammer,384,warlock,demonology,12,4,8
46068,Hsp,dun-modr,384,warlock,demonology,12,4,8
46069,Babayagâ,sanguino,384,warlock,demonology,12,4,8
46070,Heexmex,blackmoore,384,warlock,demonology,12,4,8
46071,Nulo,aggra-português,384,warlock,demonology,12,4,8
46072,Prestoc,wrathbringer,384,warlock,demonology,12,4,8
46073,Kfo,ragnaros,384,warlock,demonology,12,4,8
46074,Alucena,silvermoon,384,warlock,demonology,18,4,14
46075,Millhaus,gorgonnash,384,warlock,demonology,18,4,14
46076,Denzeal,argent-dawn,384,warlock,demonology,24,4,20
46077,Myxâ,tarren-mill,383,warlock,demonology,6,4,2
46078,Кингпинг,soulflayer,367,warlock,demonology,11,4,7
46079,Monroé,hellfire,367,warlock,demonology,11,4,7
46080,Nili,dethecus,351,warlock,demonology,11,4,7
46081,Hadrianor,sanguino,336,warlock,demonology,9,4,5
46082,Amrafel,draenor,335,warlock,demonology,15,5,10
46083,Floriae,silvermoon,329,warlock,demonology,13,5,8
46084,Ghachi,draenor,319,warlock,demonology,5,4,1
46085,Shadaw,kilrogg,319,warlock,demonology,5,4,1
46086,Sleethy,destromath,288,warlock,demonology,6,3,3
46087,Сантизи,gordunni,288,warlock,demonology,6,3,3
46088,Yerslock,twisting-nether,288,warlock,demonology,6,3,3
46089,Bionic,eredar,288,warlock,demonology,6,3,3
46090,Wendetta,stormreaver,288,warlock,demonology,6,3,3
46091,Legiozock,draenor,288,warlock,demonology,6,3,3
46092,Рашчер,gordunni,288,warlock,demonology,6,3,3
46093,Дядяджонн,gordunni,288,warlock,demonology,6,3,3
46094,Cthxil,frostwolf,288,warlock,demonology,6,3,3
46095,Theronas,tarren-mill,288,warlock,demonology,6,3,3
46096,Pidka,drakthul,288,warlock,demonology,6,3,3
46097,Журанайсбой,blackscar,288,warlock,demonology,6,3,3
46098,Osyx,ravencrest,288,warlock,demonology,6,3,3
46099,Nineinchlock,silvermoon,288,warlock,demonology,6,3,3
46100,Buserella,eredar,288,warlock,demonology,6,3,3
46101,Yoplen,drakthul,288,warlock,demonology,6,3,3
46102,Askanios,twisting-nether,288,warlock,demonology,6,3,3
46103,Xiraq,nathrezim,288,warlock,demonology,6,3,3
46104,Xenq,ravencrest,288,warlock,demonology,6,3,3
46105,Локистраик,borean-tundra,288,warlock,demonology,6,3,3
46106,Sofias,tarren-mill,288,warlock,demonology,6,3,3
46107,Дотботх,howling-fjord,288,warlock,demonology,6,3,3
46108,Plague,twisting-nether,288,warlock,demonology,6,3,3
46109,Afflimoomoo,tarren-mill,288,warlock,demonology,6,3,3
46110,Sidragasoss,drakthul,288,warlock,demonology,6,3,3
46111,Ronniee,moonglade,288,warlock,demonology,6,3,3
46112,Lebaa,burning-steppes,288,warlock,demonology,6,3,3
46113,Akumako,stormscale,288,warlock,demonology,6,3,3
46114,Elmîr,blackmoore,288,warlock,demonology,6,3,3
46115,Ezy,auchindoun,288,warlock,demonology,6,3,3
46116,Zeromaker,kazzak,288,warlock,demonology,6,3,3
46117,Slytofhandio,silvermoon,288,warlock,demonology,6,3,3
46118,Ilililii,ravencrest,288,warlock,demonology,6,3,3
46119,Väladar,sanguino,288,warlock,demonology,6,3,3
46120,Alcringe,kazzak,288,warlock,demonology,6,3,3
46121,Cptdotalot,tarren-mill,288,warlock,demonology,6,3,3
46122,Drogoon,blackmoore,288,warlock,demonology,6,3,3
46123,Áiram,the-maelstrom,288,warlock,demonology,6,3,3
46124,Myliege,kilrogg,288,warlock,demonology,6,3,3
46125,Hasselbalch,azshara,288,warlock,demonology,6,3,3
46126,Plocke,aegwynn,288,warlock,demonology,6,3,3
46127,Hotdogvendor,kazzak,288,warlock,demonology,6,3,3
46128,Комочеро,soulflayer,288,warlock,demonology,6,3,3
46129,Darkpush,outland,288,warlock,demonology,6,3,3
46130,Drarken,sylvanas,288,warlock,demonology,6,3,3
46131,Dispelpls,dun-morogh,288,warlock,demonology,6,3,3
46132,Zloezlo,ravencrest,288,warlock,demonology,6,3,3
46133,Mattihoh,rexxar,288,warlock,demonology,6,3,3
46134,Tathyanna,archimonde,288,warlock,demonology,6,3,3
46135,Moelock,frostmane,288,warlock,demonology,6,3,3
46136,Karädoc,chogall,288,warlock,demonology,6,3,3
46137,Zìì,silvermoon,288,warlock,demonology,6,3,3
46138,Cainn,kilrogg,288,warlock,demonology,6,3,3
46139,Waîdo,blackhand,288,warlock,demonology,6,3,3
46140,Shjzzkl,blackmoore,288,warlock,demonology,6,3,3
46141,Лысыйлокоть,soulflayer,288,warlock,demonology,6,3,3
46142,Wombsa,blackmoore,288,warlock,demonology,6,3,3
46143,Mingingclass,stormscale,288,warlock,demonology,6,3,3
46144,Suucc,draenor,288,warlock,demonology,6,3,3
46145,Infernion,stormscale,288,warlock,demonology,6,3,3
46146,Silås,hyjal,288,warlock,demonology,6,3,3
46147,Matheus,zenedar,288,warlock,demonology,6,3,3
46148,Drainurlife,zenedar,288,warlock,demonology,6,3,3
46149,Nürgle,stormscale,288,warlock,demonology,6,3,3
46150,Gyroib,stormscale,288,warlock,demonology,6,3,3
46151,Xalé,blackrock,288,warlock,demonology,6,3,3
46152,Noobgg,kazzak,288,warlock,demonology,6,3,3
46153,Antuan,sanguino,288,warlock,demonology,6,3,3
46154,Opiumers,kazzak,288,warlock,demonology,6,3,3
46155,Evalya,archimonde,288,warlock,demonology,6,3,3
46156,Vladov,ravencrest,288,warlock,demonology,6,3,3
46157,Evilonion,outland,288,warlock,demonology,6,3,3
46158,Ноанс,howling-fjord,288,warlock,demonology,6,3,3
46159,Nerdbane,blackrock,288,warlock,demonology,6,3,3
46160,Гвадривер,howling-fjord,288,warlock,demonology,6,3,3
46161,Bono,frostwhisper,288,warlock,demonology,6,3,3
46162,Sánas,blackhand,288,warlock,demonology,6,3,3
46163,Talindra,stormscale,288,warlock,demonology,6,3,3
46164,Horststenzl,blackrock,288,warlock,demonology,6,3,3
46165,Эссминет,soulflayer,288,warlock,demonology,12,3,9
46166,Laveau,outland,288,warlock,demonology,12,3,9
46167,Jkz,blackrock,288,warlock,demonology,12,3,9
46168,Ftpete,argent-dawn,288,warlock,demonology,12,3,9
46169,Cassen,outland,288,warlock,demonology,12,3,9
46170,Surgelock,draenor,288,warlock,demonology,12,3,9
46171,Ohnoitsnepss,chamber-of-aspects,288,warlock,demonology,12,3,9
46172,Kamí,sanguino,288,warlock,demonology,12,3,9
46173,Ønyzukral,hyjal,288,warlock,demonology,12,3,9
46174,Ïvar,ysondre,288,warlock,demonology,12,3,9
46175,Dardec,hyjal,288,warlock,demonology,12,3,9
46176,Chaosbolts,balnazzar,288,warlock,demonology,12,3,9
46177,Ydidntuwait,ragnaros,288,warlock,demonology,18,3,15
46178,Hartee,argent-dawn,288,warlock,demonology,18,3,15
46179,Lìlitu,malfurion,287,warlock,demonology,6,3,3
46180,Dust,argent-dawn,287,warlock,demonology,12,3,9
46181,Hasla,stormreaver,256,warlock,demonology,10,3,7
46182,Calypso,korgall,239,warlock,demonology,5,3,2
46183,Ánderx,dun-modr,239,warlock,demonology,5,3,2
46184,Hokoreuw,echsenkessel,234,warlock,demonology,9,4,5
46185,Watii,stormscale,234,warlock,demonology,10,4,6
46186,Никошо,gordunni,223,warlock,demonology,8,3,5
46187,Streganni,nemesis,192,warlock,demonology,4,3,1
46188,Fatkkroth,ravencrest,192,warlock,demonology,6,2,4
46189,Zyréx,eredar,192,warlock,demonology,6,2,4
46190,Retrosatanas,archimonde,192,warlock,demonology,6,2,4
46191,Azurma,tarren-mill,192,warlock,demonology,6,2,4
46192,Vitrolizz,twilights-hammer,192,warlock,demonology,6,2,4
46193,Händerå,ragnaros,192,warlock,demonology,6,2,4
46194,Morgainé,arygos,192,warlock,demonology,6,2,4
46195,Branduir,ragnaros,192,warlock,demonology,6,2,4
46196,Fortheend,twisting-nether,192,warlock,demonology,6,2,4
46197,Baradür,sanguino,192,warlock,demonology,6,2,4
46198,Fearlessgødx,ravencrest,192,warlock,demonology,6,2,4
46199,Sneptics,draenor,192,warlock,demonology,6,2,4
46200,Yôi,nemesis,192,warlock,demonology,6,2,4
46201,Bowti,ravencrest,192,warlock,demonology,6,2,4
46202,Hodille,argent-dawn,192,warlock,demonology,6,2,4
46203,Telyfol,ragnaros,192,warlock,demonology,6,2,4
46204,Хэлласс,blackscar,192,warlock,demonology,6,2,4
46205,Kaobolt,archimonde,192,warlock,demonology,6,2,4
46206,Democraft,the-maelstrom,192,warlock,demonology,6,2,4
46207,Surfingbirdz,ragnaros,192,warlock,demonology,6,2,4
46208,Médeâ,ravencrest,192,warlock,demonology,6,2,4
46209,Анрали,deathguard,192,warlock,demonology,6,2,4
46210,Incesticide,ragnaros,192,warlock,demonology,6,2,4
46211,Slowfatlock,ravencrest,192,warlock,demonology,6,2,4
46212,Salvatoríy,outland,192,warlock,demonology,6,2,4
46213,Ukjjkhj,frostmane,192,warlock,demonology,6,2,4
46214,Darkdax,dethecus,192,warlock,demonology,6,2,4
46215,Tàkaz,drekthar,192,warlock,demonology,6,2,4
46216,Nastychãtøn,ysondre,192,warlock,demonology,6,2,4
46217,Andrealphus,outland,192,warlock,demonology,6,2,4
46218,Prestige,nemesis,192,warlock,demonology,6,2,4
46219,Iblis,grim-batol,192,warlock,demonology,6,2,4
46220,Ribbed,frostmane,192,warlock,demonology,6,2,4
46221,Cräwley,ragnaros,192,warlock,demonology,6,2,4
46222,Gammalgubbe,stormscale,192,warlock,demonology,6,2,4
46223,Кощун,goldrinn,192,warlock,demonology,6,2,4
46224,Nerfwarriors,stormscale,192,warlock,demonology,6,2,4
46225,Minidiction,ravencrest,192,warlock,demonology,6,2,4
46226,Kumamoto,tarren-mill,192,warlock,demonology,6,2,4
46227,Ekispekis,tarren-mill,192,warlock,demonology,6,2,4
46228,Fløkee,blackmoore,192,warlock,demonology,6,2,4
46229,Dotcha,ravencrest,192,warlock,demonology,6,2,4
46230,Artys,tarren-mill,192,warlock,demonology,6,2,4
46231,Бешентумай,goldrinn,192,warlock,demonology,6,2,4
46232,Liwerno,dunemaul,192,warlock,demonology,6,2,4
46233,Luckylocked,kazzak,192,warlock,demonology,6,2,4
46234,Вериберри,gordunni,192,warlock,demonology,6,2,4
46235,Nècrøphila,kazzak,192,warlock,demonology,6,2,4
46236,Àbraxàs,nemesis,192,warlock,demonology,6,2,4
46237,Amerihell,pozzo-delleternità,192,warlock,demonology,6,2,4
46238,Seldonn,pozzo-delleternità,192,warlock,demonology,6,2,4
46239,Lokelicious,ragnaros,192,warlock,demonology,6,2,4
46240,Jiy,senjin,192,warlock,demonology,6,2,4
46241,Pablø,silvermoon,192,warlock,demonology,6,2,4
46242,Bu,zirkel-des-cenarius,192,warlock,demonology,6,2,4
46243,Belzedan,blackrock,192,warlock,demonology,6,2,4
46244,Oldasiangirl,blackrock,192,warlock,demonology,6,2,4
46245,Flatwolenzy,blackrock,192,warlock,demonology,6,2,4
46246,Epoku,stormscale,192,warlock,demonology,6,2,4
46247,Azgaroth,kazzak,192,warlock,demonology,6,2,4
46248,Neijihbolt,blackrock,192,warlock,demonology,6,2,4
46249,Drith,blades-edge,192,warlock,demonology,6,2,4
46250,Omegachad,draenor,192,warlock,demonology,6,2,4
46251,Gtxtreme,kazzak,192,warlock,demonology,6,2,4
46252,Isanê,blackrock,192,warlock,demonology,6,2,4
46253,Cali,ahnqiraj,192,warlock,demonology,6,2,4
46254,Stromzii,silvermoon,192,warlock,demonology,6,2,4
46255,Скверногрик,fordragon,192,warlock,demonology,6,2,4
46256,Chram,uldum,192,warlock,demonology,7,2,5
46257,Манапчик,soulflayer,192,warlock,demonology,12,2,10
46258,Henriett,ravencrest,192,warlock,demonology,12,2,10
46259,Saruna,azshara,192,warlock,demonology,12,2,10
46260,Etherbit,burning-legion,192,warlock,demonology,12,2,10
46261,Déadwish,ravencrest,192,warlock,demonology,12,2,10
46262,Arciam,kazzak,192,warlock,demonology,12,2,10
46263,Rayanna,twisting-nether,192,warlock,demonology,18,2,16
46264,Letzterlude,thrall,159,warlock,demonology,5,2,3
46265,Myskul,burning-legion,138,warlock,demonology,10,4,6
46266,Omaleinfluch,antonidas,138,warlock,demonology,9,3,6
46267,Commas,outland,128,warlock,demonology,4,2,2
46268,Happycadaver,blackrock,96,warlock,demonology,3,2,1
46269,Myristica,die-todeskrallen,96,warlock,demonology,3,2,1
46270,Utuklululu,archimonde,96,warlock,demonology,6,1,5
46271,Melfos,blackmoore,96,warlock,demonology,6,1,5
46272,Bolt,stormscale,96,warlock,demonology,6,1,5
46273,Аффликатор,soulflayer,96,warlock,demonology,6,1,5
46274,Militianu,sylvanas,96,warlock,demonology,6,1,5
46275,Emethia,darksorrow,96,warlock,demonology,6,1,5
46276,Catherine,garrosh,96,warlock,demonology,6,1,5
46277,Marann,dun-morogh,96,warlock,demonology,6,1,5
46278,Diseased,darksorrow,96,warlock,demonology,6,1,5
46279,Messire,ragnaros,96,warlock,demonology,6,1,5
46280,Krútéús,perenolde,96,warlock,demonology,6,1,5
46281,Elyraah,hyjal,96,warlock,demonology,6,1,5
46282,Nethros,ragnaros,96,warlock,demonology,6,1,5
46283,Lovromalt,kazzak,96,warlock,demonology,6,1,5
46284,Ðßøhßäøùí,blackmoore,96,warlock,demonology,6,1,5
46285,Yourdeaath,ravencrest,96,warlock,demonology,6,1,5
46286,Ароматныйх,howling-fjord,96,warlock,demonology,6,1,5
46287,Tid,burning-legion,96,warlock,demonology,6,1,5
46288,Darkbazul,burning-legion,96,warlock,demonology,6,1,5
46289,Маверрикк,gordunni,96,warlock,demonology,6,1,5
46290,Бестий,fordragon,96,warlock,demonology,6,1,5
46291,Jawoxoxo,rexxar,96,warlock,demonology,6,1,5
46292,Necroless,shadowsong,96,warlock,demonology,6,1,5
46293,Chuntlock,shadowsong,96,warlock,demonology,6,1,5
46294,Árkan,thrall,96,warlock,demonology,6,1,5
46295,Burzak,azshara,96,warlock,demonology,6,1,5
46296,Divvaa,tarren-mill,96,warlock,demonology,6,1,5
46297,Méetoo,thrall,96,warlock,demonology,6,1,5
46298,Zebauron,twisting-nether,96,warlock,demonology,6,1,5
46299,Ruvy,twisting-nether,96,warlock,demonology,6,1,5
46300,Wolramir,thrall,96,warlock,demonology,12,1,11
46301,Kàiser,sanguino,96,warlock,demonology,12,1,11
46302,Tchytcha,archimonde,79,warlock,demonology,5,1,4
46303,Waryald,dun-modr,64,warlock,demonology,4,1,3
46304,Boccu,magtheridon,64,warlock,demonology,4,1,3
46305,Кусокплети,grom,63,warlock,demonology,2,2,0
46306,Tequendama,ysera,42,warlock,demonology,10,3,7
46307,Xydar,stormscale,42,warlock,demonology,10,2,8
46308,Berris,argent-dawn,31,warlock,demonology,2,1,1
46309,Агрессивная,soulflayer,31,warlock,demonology,2,1,1
46310,Lollock,teldrassil,31,warlock,demonology,2,1,1
46311,Ravenmore,kazzak,16,warlock,demonology,1,1,0
46312,Loghit,ravencrest,16,warlock,demonology,1,1,0
46313,Creatúre,drakthul,2446,warlock,destruction,66,53,13
46314,Inferniøn,ravencrest,2422,warlock,destruction,93,68,25
46315,Erutaerc,drakthul,2379,warlock,destruction,102,65,37
46316,Фаерморн,blackscar,2345,warlock,destruction,132,83,49
46317,Infý,ravencrest,2332,warlock,destruction,130,83,47
46318,Jâzggz,twisting-nether,2317,warlock,destruction,78,51,27
46319,Tjl,kazzak,2302,warlock,destruction,185,107,78
46320,Anihli,kazzak,2298,warlock,destruction,197,109,88
46321,Canabolic,stormscale,2288,warlock,destruction,102,63,39
46322,Geluwu,tarren-mill,2284,warlock,destruction,90,52,38
46323,Тагочи,gordunni,2281,warlock,destruction,110,62,48
46324,Steckenpferd,blackmoore,2277,warlock,destruction,60,42,18
46325,Snapperz,stormscale,2277,warlock,destruction,150,84,66
46326,Lopari,aegwynn,2275,warlock,destruction,106,65,41
46327,Indraxx,hyjal,2266,warlock,destruction,110,60,50
46328,Acentro,stormscale,2246,warlock,destruction,77,47,30
46329,Lhestér,outland,2243,warlock,destruction,87,56,31
46330,Боуман,howling-fjord,2243,warlock,destruction,96,56,40
46331,Xeremas,blackrock,2237,warlock,destruction,83,62,21
46332,Umbraz,blackmoore,2236,warlock,destruction,84,49,35
46333,Zélroth,argent-dawn,2230,warlock,destruction,192,111,81
46334,Azurma,tarren-mill,2211,warlock,destruction,78,47,31
46335,Yùna,frostwolf,2209,warlock,destruction,72,48,24
46336,Dæhli,argent-dawn,2204,warlock,destruction,102,56,46
46337,Brokenearman,defias-brotherhood,2199,warlock,destruction,41,36,5
46338,Rootzlx,ravencrest,2197,warlock,destruction,120,70,50
46339,Fsandtwo,ravencrest,2195,warlock,destruction,114,74,40
46340,Bualock,stormscale,2193,warlock,destruction,71,41,30
46341,Amdead,sylvanas,2186,warlock,destruction,114,77,37
46342,Zèlêph,archimonde,2185,warlock,destruction,186,118,68
46343,Ìpen,bloodfeather,2179,warlock,destruction,89,52,37
46344,Фримех,soulflayer,2167,warlock,destruction,65,51,14
46345,Handicapped,burning-legion,2158,warlock,destruction,78,47,31
46346,Kuckacocucka,outland,2156,warlock,destruction,113,70,43
46347,Voldby,kazzak,2155,warlock,destruction,196,102,94
46348,Veganlifter,ravencrest,2151,warlock,destruction,48,38,10
46349,Glooness,burning-legion,2151,warlock,destruction,78,43,35
46350,Djdampening,bloodhoof,2150,warlock,destruction,172,106,66
46351,Bäle,stormreaver,2150,warlock,destruction,107,64,43
46352,Chromosomex,dentarg,2149,warlock,destruction,54,41,13
46353,Yúnalesca,aegwynn,2148,warlock,destruction,89,60,29
46354,Johanan,ravencrest,2148,warlock,destruction,53,35,18
46355,Absurdity,twisting-nether,2148,warlock,destruction,102,53,49
46356,Varaxxis,twisting-nether,2147,warlock,destruction,120,70,50
46357,Tekrowdy,blackmoore,2144,warlock,destruction,48,33,15
46358,Ilovemimi,hyjal,2144,warlock,destruction,65,38,27
46359,Soulboltx,ragnaros,2144,warlock,destruction,84,46,38
46360,Kimkold,twisting-nether,2144,warlock,destruction,96,50,46
46361,Koisk,tarren-mill,2142,warlock,destruction,82,47,35
46362,Телола,gordunni,2141,warlock,destruction,102,61,41
46363,Tópdogg,twisting-nether,2140,warlock,destruction,54,43,11
46364,Боумонн,howling-fjord,2140,warlock,destruction,54,40,14
46365,Velv,nagrand,2138,warlock,destruction,114,58,56
46366,Veganlifter,blackhand,2136,warlock,destruction,72,45,27
46367,Dogdrakex,tarren-mill,2133,warlock,destruction,81,47,34
46368,Císuh,stormreaver,2133,warlock,destruction,120,69,51
46369,Lockisbadx,draenor,2132,warlock,destruction,72,43,29
46370,Эвилакс,gordunni,2131,warlock,destruction,78,50,28
46371,Fyxs,talnivarr,2129,warlock,destruction,60,42,18
46372,Tàkaz,drekthar,2129,warlock,destruction,130,80,50
46373,Zila,sylvanas,2129,warlock,destruction,89,49,40
46374,Legionlockxd,twisting-nether,2129,warlock,destruction,88,48,40
46375,Xxjz,ravencrest,2128,warlock,destruction,150,86,64
46376,Шархихохо,gordunni,2125,warlock,destruction,102,53,49
46377,Nògg,frostwhisper,2120,warlock,destruction,66,42,24
46378,Gulwer,blackmoore,2120,warlock,destruction,66,40,26
46379,Vîmø,antonidas,2120,warlock,destruction,203,123,80
46380,Djwarlock,kazzak,2119,warlock,destruction,100,55,45
46381,Rune,aegwynn,2118,warlock,destruction,72,51,21
46382,Dayken,silvermoon,2117,warlock,destruction,63,44,19
46383,Boltilicious,kazzak,2117,warlock,destruction,90,52,38
46384,Блакхен,blackscar,2117,warlock,destruction,66,38,28
46385,Рашчер,gordunni,2116,warlock,destruction,101,58,43
46386,Lyâ,ravencrest,2116,warlock,destruction,66,35,31
46387,Onekxz,blackrock,2115,warlock,destruction,56,45,11
46388,Djmcwarlock,kazzak,2115,warlock,destruction,68,40,28
46389,Alphazero,zuluhed,2112,warlock,destruction,112,63,49
46390,Bluefungirl,stormscale,2111,warlock,destruction,120,73,47
46391,Рауваскх,howling-fjord,2110,warlock,destruction,53,31,22
46392,Motcha,kazzak,2110,warlock,destruction,66,38,28
46393,Cryzzbad,stormscale,2109,warlock,destruction,36,29,7
46394,Nellyvato,eredar,2109,warlock,destruction,90,53,37
46395,Drdoit,blackrock,2109,warlock,destruction,84,46,38
46396,Силорий,howling-fjord,2108,warlock,destruction,85,54,31
46397,Инферналках,gordunni,2106,warlock,destruction,71,48,23
46398,Nògg,kazzak,2106,warlock,destruction,66,35,31
46399,Bankstair,stormscale,2105,warlock,destruction,66,44,22
46400,Hladankurac,twisting-nether,2105,warlock,destruction,60,35,25
46401,Drainsouls,stormscale,2105,warlock,destruction,189,105,84
46402,Lywov,stormscale,2103,warlock,destruction,60,34,26
46403,Skillførçé,kazzak,2102,warlock,destruction,54,41,13
46404,Wldot,ravencrest,2102,warlock,destruction,84,53,31
46405,Kerídiin,twisting-nether,2102,warlock,destruction,108,61,47
46406,Wester,blackmoore,2102,warlock,destruction,108,61,47
46407,Артик,gordunni,2101,warlock,destruction,48,37,11
46408,Kamoriwl,blackhand,2101,warlock,destruction,78,45,33
46409,Gorillabolts,tarren-mill,2101,warlock,destruction,102,51,51
46410,Zilalol,sylvanas,2100,warlock,destruction,90,51,39
46411,Bfaexpert,ravencrest,2099,warlock,destruction,48,29,19
46412,Sterlock,sylvanas,2093,warlock,destruction,73,40,33
46413,Sehk,stormreaver,2077,warlock,destruction,60,43,17
46414,Dabzw,twisting-nether,2075,warlock,destruction,67,43,24
46415,Паилка,galakrond,2075,warlock,destruction,135,74,61
46416,Chaosbuster,magtheridon,2069,warlock,destruction,114,72,42
46417,Påsqúåls,ravencrest,2069,warlock,destruction,96,56,40
46418,Haedache,tarren-mill,2069,warlock,destruction,101,57,44
46419,Xesh,kiljaeden,2069,warlock,destruction,150,81,69
46420,Panda,aegwynn,2068,warlock,destruction,54,34,20
46421,Bualock,sylvanas,2068,warlock,destruction,60,33,27
46422,Vileclass,ravencrest,2066,warlock,destruction,92,51,41
46423,Ánderxyo,dun-modr,2065,warlock,destruction,42,32,10
46424,Arfdispo,hyjal,2064,warlock,destruction,149,77,72
46425,Блудгэнг,blackscar,2062,warlock,destruction,90,60,30
46426,Bewegen,frostwolf,2061,warlock,destruction,90,50,40
46427,Якурюимнепох,gordunni,2060,warlock,destruction,217,123,94
46428,Osîrîs,aegwynn,2058,warlock,destruction,90,47,43
46429,Válýrá,blackhand,2057,warlock,destruction,65,43,22
46430,Malddog,turalyon,2056,warlock,destruction,126,72,54
46431,Кериген,gordunni,2053,warlock,destruction,66,34,32
46432,Простишутках,gordunni,2051,warlock,destruction,48,30,18
46433,Rhüd,twisting-nether,2050,warlock,destruction,95,54,41
46434,Omegazero,zuluhed,2048,warlock,destruction,72,43,29
46435,Rexløck,nozdormu,2048,warlock,destruction,183,108,75
46436,Faermorn,kazzak,2046,warlock,destruction,66,39,27
46437,Мспечень,howling-fjord,2044,warlock,destruction,60,41,19
46438,Héffer,outland,2044,warlock,destruction,121,80,41
46439,Ez,emeriss,2042,warlock,destruction,61,45,16
46440,Èlton,tarren-mill,2041,warlock,destruction,168,100,68
46441,Whatamellown,aegwynn,2037,warlock,destruction,60,37,23
46442,Anniefuchsia,ravencrest,2036,warlock,destruction,81,45,36
46443,Deßra,stormscale,2033,warlock,destruction,72,42,30
46444,Кириланскил,gordunni,2031,warlock,destruction,54,33,21
46445,Bóbtown,stormscale,2030,warlock,destruction,270,148,122
46446,Necromanya,ravencrest,2029,warlock,destruction,192,108,84
46447,Онлидемон,gordunni,2028,warlock,destruction,159,84,75
46448,Corbbolt,drakthul,2027,warlock,destruction,90,51,39
46449,Чудастрх,azuregos,2025,warlock,destruction,96,53,43
46450,Mangolicious,twisting-nether,2025,warlock,destruction,164,88,76
46451,Jadesud,archimonde,2024,warlock,destruction,48,33,15
46452,Кишмякхб,howling-fjord,2024,warlock,destruction,91,47,44
46453,Влицотьмой,gordunni,2023,warlock,destruction,66,37,29
46454,Superlocken,ragnaros,2022,warlock,destruction,65,37,28
46455,Nëismz,hyjal,2019,warlock,destruction,54,32,22
46456,Кенгарь,howling-fjord,2019,warlock,destruction,132,72,60
46457,Felcamino,outland,2019,warlock,destruction,72,36,36
46458,Avenueat,kazzak,2018,warlock,destruction,63,35,28
46459,Тевон,gordunni,2017,warlock,destruction,72,50,22
46460,Bigbolt,arathor,2017,warlock,destruction,113,61,52
46461,Ryûsuke,dun-modr,2015,warlock,destruction,96,55,41
46462,Xiraq,nathrezim,2014,warlock,destruction,66,39,27
46463,Кобре,howling-fjord,2010,warlock,destruction,72,42,30
46464,Epzi,outland,2008,warlock,destruction,47,27,20
46465,Stefcheto,twilights-hammer,2008,warlock,destruction,96,54,42
46466,Portlock,kazzak,2008,warlock,destruction,78,43,35
46467,Achluophobiå,ravencrest,2007,warlock,destruction,67,41,26
46468,Жасминдос,blackscar,2006,warlock,destruction,63,42,21
46469,Decimus,darkspear,2006,warlock,destruction,138,81,57
46470,Bryanz,sanguino,2000,warlock,destruction,100,50,50
46471,Boltzer,archimonde,1996,warlock,destruction,96,58,38
46472,Salvabolter,outland,1994,warlock,destruction,66,42,24
46473,Isuckwarlock,aegwynn,1994,warlock,destruction,66,34,32
46474,Rockbèll,blackmoore,1992,warlock,destruction,48,36,12
46475,Dsï,outland,1991,warlock,destruction,77,38,39
46476,Nyotu,antonidas,1988,warlock,destruction,131,73,58
46477,Gøzù,antonidas,1985,warlock,destruction,54,32,22
46478,Andtheysay,outland,1985,warlock,destruction,254,142,112
46479,Kwoleriker,norgannon,1985,warlock,destruction,70,39,31
46480,Logicdotexé,tarren-mill,1983,warlock,destruction,67,42,25
46481,Onuurbro,kult-der-verdammten,1982,warlock,destruction,60,41,19
46482,Shangalar,burning-legion,1980,warlock,destruction,90,51,39
46483,Supergeîl,blackrock,1980,warlock,destruction,84,46,38
46484,Tuplajekku,sylvanas,1980,warlock,destruction,77,37,40
46485,Sqx,veklor,1978,warlock,destruction,60,39,21
46486,Beebs,aegwynn,1977,warlock,destruction,58,40,18
46487,Laedreth,argent-dawn,1977,warlock,destruction,212,115,97
46488,Rmpfarmer,kazzak,1976,warlock,destruction,36,23,13
46489,Wällaar,ragnaros,1976,warlock,destruction,84,50,34
46490,Vitus,malganis,1976,warlock,destruction,180,98,82
46491,Sjödin,tarren-mill,1975,warlock,destruction,36,27,9
46492,Klnr,ravencrest,1975,warlock,destruction,116,70,46
46493,Блейдап,razuvious,1975,warlock,destruction,66,37,29
46494,Hotdoghomie,tarren-mill,1974,warlock,destruction,36,28,8
46495,Xwíng,stormscale,1974,warlock,destruction,48,35,13
46496,Acanthis,outland,1974,warlock,destruction,66,34,32
46497,Wotlkenjoyer,ravencrest,1973,warlock,destruction,48,32,16
46498,Gnargamehl,nemesis,1973,warlock,destruction,66,39,27
46499,Ffpiiras,dunemaul,1972,warlock,destruction,63,37,26
46500,Noomaca,drakthul,1972,warlock,destruction,143,80,63
46501,Garlan,dun-modr,1972,warlock,destruction,232,126,106
46502,Whakkx,blackrock,1969,warlock,destruction,90,49,41
46503,Rohyna,archimonde,1968,warlock,destruction,48,34,14
46504,Bladey,ragnaros,1968,warlock,destruction,149,86,63
46505,Asáel,blackrock,1968,warlock,destruction,84,47,37
46506,Exhäle,archimonde,1966,warlock,destruction,59,37,22
46507,Balding,blackhand,1966,warlock,destruction,42,25,17
46508,Pørtal,aggra-português,1964,warlock,destruction,107,57,50
46509,Conditions,tarren-mill,1963,warlock,destruction,213,109,104
46510,Avogeiñ,tarren-mill,1963,warlock,destruction,59,29,30
46511,Miauwu,stormscale,1961,warlock,destruction,47,33,14
46512,Zarisya,blackmoore,1961,warlock,destruction,48,29,19
46513,Drowlý,twisting-nether,1961,warlock,destruction,54,32,22
46514,Guciflipflop,twisting-nether,1961,warlock,destruction,72,40,32
46515,Suprezz,sylvanas,1958,warlock,destruction,72,43,29
46516,Sëngir,drakthul,1958,warlock,destruction,140,72,68
46517,Benne,stormscale,1957,warlock,destruction,54,35,19
46518,Взорг,soulflayer,1957,warlock,destruction,114,62,52
46519,Madridistaß,outland,1957,warlock,destruction,164,82,82
46520,Тьмазвёздная,gordunni,1956,warlock,destruction,96,63,33
46521,Looneytoonz,blackrock,1956,warlock,destruction,84,50,34
46522,Malgarøth,tarren-mill,1955,warlock,destruction,60,28,32
46523,Сумракк,gordunni,1954,warlock,destruction,66,35,31
46524,Nayolana,argent-dawn,1954,warlock,destruction,87,45,42
46525,Freddaxd,outland,1953,warlock,destruction,76,48,28
46526,Hømïcîðæl,ravencrest,1953,warlock,destruction,72,45,27
46527,Tikondrus,ravencrest,1952,warlock,destruction,42,28,14
46528,Ashlÿn,draenor,1952,warlock,destruction,47,31,16
46529,Davyjonessx,twisting-nether,1951,warlock,destruction,110,52,58
46530,Kumamoto,tarren-mill,1950,warlock,destruction,48,32,16
46531,Mxdojsrvqxzq,ravencrest,1949,warlock,destruction,183,97,86
46532,Tschapatalpi,blackhand,1947,warlock,destruction,70,35,35
46533,Exitlock,thrall,1945,warlock,destruction,78,46,32
46534,Rabasta,blackmoore,1945,warlock,destruction,60,33,27
46535,Jøkèr,stormscale,1943,warlock,destruction,30,21,9
46536,Сильвиос,howling-fjord,1943,warlock,destruction,100,49,51
46537,Smaúg,archimonde,1942,warlock,destruction,111,58,53
46538,Brødo,dun-modr,1941,warlock,destruction,57,34,23
46539,Fearo,kazzak,1937,warlock,destruction,82,48,34
46540,Ashmodéus,defias-brotherhood,1935,warlock,destruction,53,32,21
46541,Obrusik,burning-legion,1933,warlock,destruction,83,38,45
46542,Gregwyn,hellscream,1931,warlock,destruction,36,26,10
46543,Kenachaos,twisting-nether,1931,warlock,destruction,155,92,63
46544,Vvj,ravencrest,1929,warlock,destruction,144,74,70
46545,Staenkymayne,blackhand,1927,warlock,destruction,28,21,7
46546,Fornaio,nemesis,1927,warlock,destruction,36,24,12
46547,Cujo,draenor,1927,warlock,destruction,120,60,60
46548,Kitchiarû,uldaman,1925,warlock,destruction,48,30,18
46549,Ethiq,blackrock,1925,warlock,destruction,42,24,18
46550,Macchíato,ragnaros,1925,warlock,destruction,84,44,40
46551,Isodjdojk,ravencrest,1924,warlock,destruction,41,33,8
46552,Yukokotier,archimonde,1924,warlock,destruction,179,103,76
46553,Dersdog,twisting-nether,1924,warlock,destruction,51,29,22
46554,Габана,gordunni,1923,warlock,destruction,48,33,15
46555,Fîgøk,conseil-des-ombres,1923,warlock,destruction,108,63,45
46556,Гивмисоул,soulflayer,1918,warlock,destruction,60,36,24
46557,Deezbolts,kazzak,1917,warlock,destruction,60,33,27
46558,Blakstorm,archimonde,1915,warlock,destruction,60,35,25
46559,Magonyth,ravencrest,1914,warlock,destruction,153,81,72
46560,Doturanal,blackmoore,1913,warlock,destruction,66,36,30
46561,Zàkx,silvermoon,1913,warlock,destruction,313,168,145
46562,Wewondak,drakthul,1912,warlock,destruction,190,111,79
46563,Lsr,argent-dawn,1912,warlock,destruction,77,44,33
46564,Wäisted,ravencrest,1911,warlock,destruction,42,26,16
46565,Drututt,the-maelstrom,1910,warlock,destruction,54,30,24
46566,Mohihi,ravencrest,1910,warlock,destruction,60,31,29
46567,Mýlìfêbélike,kazzak,1909,warlock,destruction,40,29,11
46568,Necorinexx,silvermoon,1909,warlock,destruction,30,20,10
46569,Sarthrax,argent-dawn,1907,warlock,destruction,60,38,22
46570,Djhanzó,outland,1907,warlock,destruction,45,28,17
46571,Xfz,stormscale,1906,warlock,destruction,54,30,24
46572,Спаводах,soulflayer,1905,warlock,destruction,35,25,10
46573,Raepist,terokkar,1905,warlock,destruction,78,46,32
46574,Zoodíac,blackrock,1904,warlock,destruction,48,32,16
46575,Carelock,chamber-of-aspects,1904,warlock,destruction,60,36,24
46576,Healylockx,stormscale,1904,warlock,destruction,48,28,20
46577,Mafteryo,blackrock,1901,warlock,destruction,84,45,39
46578,Xunzu,drakthul,1901,warlock,destruction,60,30,30
46579,Buâlock,stormscale,1900,warlock,destruction,24,20,4
46580,Nineinchlock,silvermoon,1900,warlock,destruction,72,33,39
46581,Файрик,blackscar,1897,warlock,destruction,42,26,16
46582,Rúbs,sylvanas,1897,warlock,destruction,102,55,47
46583,Mxxmmllm,kargath,1896,warlock,destruction,101,62,39
46584,Хауда,gordunni,1895,warlock,destruction,136,77,59
46585,Kikeri,blackhand,1895,warlock,destruction,66,37,29
46586,Kaktakto,ravencrest,1895,warlock,destruction,54,30,24
46587,Бжк,gordunni,1895,warlock,destruction,210,115,95
46588,Tarilinwelli,les-sentinelles,1894,warlock,destruction,40,36,4
46589,Kurono,silvermoon,1894,warlock,destruction,78,41,37
46590,Зеленаямразь,soulflayer,1894,warlock,destruction,55,26,29
46591,Kelthedral,tarren-mill,1893,warlock,destruction,73,36,37
46592,Vregor,twisting-nether,1892,warlock,destruction,36,26,10
46593,Fakegodx,ravencrest,1892,warlock,destruction,42,29,13
46594,Hellíc,kazzak,1892,warlock,destruction,48,30,18
46595,Laokoon,blackmoore,1891,warlock,destruction,66,42,24
46596,Sad,lightnings-blade,1891,warlock,destruction,96,57,39
46597,Twisted,malganis,1891,warlock,destruction,90,51,39
46598,Aestheatic,draenor,1890,warlock,destruction,293,151,142
46599,Stankaemayne,blackhand,1889,warlock,destruction,48,29,19
46600,Armellixd,dun-modr,1888,warlock,destruction,62,34,28
46601,Juhpz,blackrock,1888,warlock,destruction,52,24,28
46602,Djfearbot,kazzak,1887,warlock,destruction,84,53,31
46603,Deadpapi,outland,1886,warlock,destruction,53,35,18
46604,Feardotbye,stormscale,1886,warlock,destruction,49,30,19
46605,Bambkin,twisting-nether,1884,warlock,destruction,78,46,32
46606,Whøîäm,kazzak,1883,warlock,destruction,42,31,11
46607,Hânex,ravencrest,1883,warlock,destruction,42,28,14
46608,Immaginare,sylvanas,1883,warlock,destruction,114,66,48
46609,Zelieknight,ysondre,1883,warlock,destruction,168,96,72
46610,Someonepro,tarren-mill,1882,warlock,destruction,89,41,48
46611,Shadowrey,blackrock,1881,warlock,destruction,52,29,23
46612,Laolife,twisting-nether,1880,warlock,destruction,72,35,37
46613,Deathfløw,draenor,1879,warlock,destruction,90,58,32
46614,Henmur,stormscale,1879,warlock,destruction,64,37,27
46615,Badloljk,stormscale,1878,warlock,destruction,40,26,14
46616,Theronas,tarren-mill,1878,warlock,destruction,54,34,20
46617,Bónz,outland,1877,warlock,destruction,54,28,26
46618,Alphå,blackmoore,1875,warlock,destruction,36,28,8
46619,Eboyclass,twisting-nether,1875,warlock,destruction,33,23,10
46620,Ulora,zirkel-des-cenarius,1875,warlock,destruction,59,33,26
46621,Deadlyrust,ragnaros,1875,warlock,destruction,117,56,61
46622,Lifetapped,tarren-mill,1874,warlock,destruction,47,25,22
46623,Habdruck,blackmoore,1873,warlock,destruction,249,146,103
46624,Raverboyy,blackrock,1873,warlock,destruction,60,34,26
46625,Brodoh,dun-modr,1871,warlock,destruction,42,22,20
46626,Twork,tarren-mill,1871,warlock,destruction,54,28,26
46627,Ðènnis,tarren-mill,1870,warlock,destruction,42,28,14
46628,Èmøgøðqt,ravencrest,1870,warlock,destruction,54,28,26
46629,Tokodi,ragnaros,1869,warlock,destruction,60,34,26
46630,Dooms,antonidas,1868,warlock,destruction,42,31,11
46631,Аоепампгодх,howling-fjord,1866,warlock,destruction,82,58,24
46632,Limoges,archimonde,1865,warlock,destruction,35,26,9
46633,Extingul,tarren-mill,1865,warlock,destruction,59,38,21
46634,Plâytïmè,stormscale,1865,warlock,destruction,78,39,39
46635,Spookytouch,draenor,1864,warlock,destruction,94,47,47
46636,Sheitana,ysondre,1863,warlock,destruction,60,39,21
46637,Rokkarn,kazzak,1863,warlock,destruction,48,29,19
46638,Osbaa,darksorrow,1861,warlock,destruction,50,31,19
46639,Исверон,howling-fjord,1861,warlock,destruction,60,34,26
46640,Stopdaddyplz,ravencrest,1860,warlock,destruction,36,24,12
46641,Silmerion,twilights-hammer,1860,warlock,destruction,85,52,33
46642,Xarfoul,grim-batol,1859,warlock,destruction,48,33,15
46643,Phoyk,blackmoore,1859,warlock,destruction,48,29,19
46644,Шрэкс,blackscar,1859,warlock,destruction,48,25,23
46645,Nekrosd,tarren-mill,1858,warlock,destruction,141,76,65
46646,Homerbamboom,hyjal,1857,warlock,destruction,41,32,9
46647,Kayloo,archimonde,1856,warlock,destruction,54,34,20
46648,Holiax,archimonde,1856,warlock,destruction,48,29,19
46649,Zâyo,ravencrest,1856,warlock,destruction,54,31,23
46650,Cmdxo,malganis,1856,warlock,destruction,71,38,33
46651,Sluba,stormscale,1855,warlock,destruction,109,59,50
46652,Pôhzz,archimonde,1854,warlock,destruction,30,21,9
46653,Aniq,eredar,1854,warlock,destruction,60,29,31
46654,Darksoll,hyjal,1853,warlock,destruction,41,31,10
46655,Junakot,silvermoon,1852,warlock,destruction,54,30,24
46656,Johnylock,draenor,1850,warlock,destruction,116,71,45
46657,Debbskidjur,tarren-mill,1850,warlock,destruction,85,49,36
46658,Depressedkid,ravencrest,1850,warlock,destruction,60,30,30
46659,Likeqtz,thrall,1849,warlock,destruction,74,41,33
46660,Chaoscrit,eredar,1848,warlock,destruction,85,48,37
46661,Visceris,ravencrest,1848,warlock,destruction,66,29,37
46662,Руктал,howling-fjord,1847,warlock,destruction,54,34,20
46663,Ayperos,tyrande,1847,warlock,destruction,72,38,34
46664,Gis,laughing-skull,1843,warlock,destruction,54,31,23
46665,Rumour,sunstrider,1843,warlock,destruction,54,30,24
46666,Dogoon,sylvanas,1842,warlock,destruction,185,103,82
46667,Артисона,gordunni,1842,warlock,destruction,54,27,27
46668,Ràzek,kazzak,1841,warlock,destruction,95,52,43
46669,Andrewdaniel,twisting-nether,1841,warlock,destruction,60,31,29
46670,Lzoo,ravencrest,1840,warlock,destruction,36,29,7
46671,Kalaslars,draenor,1840,warlock,destruction,60,34,26
46672,Attilergg,stormscale,1839,warlock,destruction,32,23,9
46673,Ecoxx,aegwynn,1839,warlock,destruction,48,34,14
46674,Fiddyp,kazzak,1839,warlock,destruction,42,28,14
46675,Ñila,ravencrest,1839,warlock,destruction,36,23,13
46676,Ripnsew,ravencrest,1839,warlock,destruction,41,26,15
46677,Syviwl,outland,1839,warlock,destruction,53,30,23
46678,Ty,earthen-ring,1838,warlock,destruction,60,41,19
46679,Nutyx,twisting-nether,1838,warlock,destruction,78,40,38
46680,Tharaqt,kazzak,1837,warlock,destruction,41,26,15
46681,Angst,tarren-mill,1836,warlock,destruction,42,30,12
46682,Ispankmysuc,korgall,1836,warlock,destruction,69,42,27
46683,Bloodworth,arathor,1836,warlock,destruction,114,64,50
46684,Sharhý,kazzak,1835,warlock,destruction,40,24,16
46685,Belial,minahonda,1835,warlock,destruction,63,36,27
46686,Bobop,sanguino,1834,warlock,destruction,106,60,46
46687,Médeâ,ravencrest,1834,warlock,destruction,76,42,34
46688,Кром,howling-fjord,1834,warlock,destruction,48,26,22
46689,Drerlord,tarren-mill,1833,warlock,destruction,53,34,19
46690,Asyncbuddy,azjolnerub,1832,warlock,destruction,48,32,16
46691,Oldasianman,blackrock,1832,warlock,destruction,30,20,10
46692,Kiwibob,defias-brotherhood,1832,warlock,destruction,65,41,24
46693,Skarløck,blackmoore,1832,warlock,destruction,42,26,16
46694,Temnamagna,silvermoon,1832,warlock,destruction,147,80,67
46695,Ftpete,argent-dawn,1831,warlock,destruction,98,58,40
46696,Lémonz,stormscale,1831,warlock,destruction,52,26,26
46697,Worgonzolâ,madmortem,1830,warlock,destruction,221,134,87
46698,Shadöwmäre,draenor,1830,warlock,destruction,54,31,23
46699,Ðeface,nefarian,1830,warlock,destruction,54,31,23
46700,Veríty,kazzak,1829,warlock,destruction,30,20,10
46701,Trainindummy,ravencrest,1828,warlock,destruction,83,61,22
46702,Ícekíss,hyjal,1828,warlock,destruction,48,33,15
46703,Pepitogodx,khaz-modan,1828,warlock,destruction,48,33,15
46704,Pprwl,tarren-mill,1828,warlock,destruction,126,77,49
46705,Latia,argent-dawn,1828,warlock,destruction,46,28,18
46706,Хэлмок,howling-fjord,1827,warlock,destruction,42,31,11
46707,Coilxo,ravencrest,1827,warlock,destruction,52,36,16
46708,Plaguee,outland,1827,warlock,destruction,68,40,28
46709,Envizer,ravencrest,1827,warlock,destruction,42,24,18
46710,Gogmorok,dunemaul,1827,warlock,destruction,257,127,130
46711,Brainac,blackrock,1826,warlock,destruction,36,24,12
46712,Véstheim,saurfang,1825,warlock,destruction,72,46,26
46713,Oggelock,tarren-mill,1825,warlock,destruction,79,45,34
46714,Соргосор,gordunni,1825,warlock,destruction,53,30,23
46715,Saffíe,ravencrest,1825,warlock,destruction,70,39,31
46716,Imforcedtowl,aegwynn,1824,warlock,destruction,42,31,11
46717,Asilock,eredar,1824,warlock,destruction,48,32,16
46718,Ìambottger,silvermoon,1824,warlock,destruction,48,30,18
46719,Tôpsecret,aegwynn,1823,warlock,destruction,36,29,7
46720,Worse,kazzak,1823,warlock,destruction,48,29,19
46721,Coeurnichon,archimonde,1823,warlock,destruction,58,32,26
46722,Maderto,burning-legion,1823,warlock,destruction,185,101,84
46723,Watchdots,blackrock,1822,warlock,destruction,66,37,29
46724,Røiheenøk,archimonde,1822,warlock,destruction,156,80,76
46725,Kalagorn,azshara,1821,warlock,destruction,36,27,9
46726,Кале,goldrinn,1821,warlock,destruction,136,87,49
46727,Killáksi,ravencrest,1821,warlock,destruction,42,26,16
46728,Juïcylucy,kazzak,1821,warlock,destruction,122,74,48
46729,Atmosfèar,silvermoon,1821,warlock,destruction,66,37,29
46730,Stepwarlock,kazzak,1821,warlock,destruction,81,42,39
46731,Framelock,draenor,1820,warlock,destruction,48,37,11
46732,Hauntit,chogall,1820,warlock,destruction,36,21,15
46733,Korupcijax,kazzak,1820,warlock,destruction,36,21,15
46734,Merçedesa,tarren-mill,1820,warlock,destruction,35,20,15
46735,Qaripidia,ravencrest,1820,warlock,destruction,46,26,20
46736,Koldarr,blackmoore,1820,warlock,destruction,160,90,70
46737,Gorthunz,kazzak,1820,warlock,destruction,59,28,31
46738,Trashløckx,blackrock,1819,warlock,destruction,42,30,12
46739,Howtofake,doomhammer,1819,warlock,destruction,42,29,13
46740,Mocha,ravencrest,1819,warlock,destruction,48,31,17
46741,Reznör,archimonde,1819,warlock,destruction,30,19,11
46742,Incesticide,ragnaros,1819,warlock,destruction,60,37,23
46743,Juppi,blackrock,1819,warlock,destruction,138,82,56
46744,Ôlo,rajaxx,1819,warlock,destruction,54,30,24
46745,Fearing,malganis,1819,warlock,destruction,101,51,50
46746,Fizzydark,malganis,1819,warlock,destruction,60,30,30
46747,Selassie,blackmoore,1818,warlock,destruction,78,48,30
46748,Кюратор,howling-fjord,1818,warlock,destruction,57,30,27
46749,Lockróck,silvermoon,1817,warlock,destruction,30,22,8
46750,Ziigouigouii,archimonde,1817,warlock,destruction,42,28,14
46751,Jupp,blackrock,1817,warlock,destruction,48,29,19
46752,Хастла,ashenvale,1817,warlock,destruction,54,32,22
46753,Richerdgir,ravencrest,1817,warlock,destruction,45,26,19
46754,Srkzlol,durotan,1817,warlock,destruction,66,35,31
46755,Alcringe,kazzak,1816,warlock,destruction,158,90,68
46756,Porchpirate,draenor,1816,warlock,destruction,72,41,31
46757,Empra,stormscale,1816,warlock,destruction,54,28,26
46758,Matsuei,tarren-mill,1816,warlock,destruction,48,23,25
46759,Barneyboi,tarren-mill,1815,warlock,destruction,87,59,28
46760,Louloudots,ragnaros,1815,warlock,destruction,36,22,14
46761,Kivilock,dun-modr,1815,warlock,destruction,79,48,31
46762,Tehkorrum,archimonde,1815,warlock,destruction,53,30,23
46763,Kerway,outland,1815,warlock,destruction,96,54,42
46764,Magicsin,aerie-peak,1814,warlock,destruction,36,31,5
46765,Jappér,silvermoon,1814,warlock,destruction,36,30,6
46766,Olsel,draenor,1814,warlock,destruction,47,30,17
46767,Manhart,burning-legion,1814,warlock,destruction,58,33,25
46768,Nemwl,draenor,1814,warlock,destruction,66,31,35
46769,Doodle,the-maelstrom,1813,warlock,destruction,66,38,28
46770,Фейкгодх,soulflayer,1813,warlock,destruction,54,30,24
46771,Neoe,stormscale,1813,warlock,destruction,76,40,36
46772,Tbs,blackhand,1813,warlock,destruction,54,25,29
46773,Slytherim,stormscale,1812,warlock,destruction,87,57,30
46774,Todesgurke,alleria,1812,warlock,destruction,36,22,14
46775,Whisperer,defias-brotherhood,1812,warlock,destruction,54,29,25
46776,Linuviel,argent-dawn,1811,warlock,destruction,41,29,12
46777,Bono,frostwhisper,1811,warlock,destruction,86,54,32
46778,Araqt,thrall,1810,warlock,destruction,35,26,9
46779,Jaimstar,ravencrest,1810,warlock,destruction,35,25,10
46780,Noobgg,kazzak,1810,warlock,destruction,90,53,37
46781,Makîø,hyjal,1810,warlock,destruction,136,65,71
46782,Boterham,kilrogg,1809,warlock,destruction,54,38,16
46783,Fiearstyle,tarren-mill,1808,warlock,destruction,30,23,7
46784,Senbolts,tarren-mill,1808,warlock,destruction,42,27,15
46785,Pederpan,stormscale,1808,warlock,destruction,30,19,11
46786,Чупачупакаб,soulflayer,1808,warlock,destruction,59,34,25
46787,Darkleci,archimonde,1808,warlock,destruction,60,34,26
46788,Purexlock,dragonblight,1807,warlock,destruction,53,34,19
46789,Бауглирх,howling-fjord,1807,warlock,destruction,71,38,33
46790,Titimon,tarren-mill,1806,warlock,destruction,94,52,42
46791,Abbzey,tarren-mill,1806,warlock,destruction,132,70,62
46792,Rûttna,kazzak,1806,warlock,destruction,53,27,26
46793,Pumpelumpe,twisting-nether,1806,warlock,destruction,45,20,25
46794,Yøshinø,wildhammer,1805,warlock,destruction,48,36,12
46795,Justfamous,archimonde,1805,warlock,destruction,60,41,19
46796,Lockchonk,kazzak,1805,warlock,destruction,84,52,32
46797,Rivmuu,argent-dawn,1805,warlock,destruction,130,78,52
46798,Delumia,tarren-mill,1805,warlock,destruction,113,64,49
46799,Osbaa,bladefist,1804,warlock,destruction,48,31,17
46800,Sïeur,archimonde,1804,warlock,destruction,113,69,44
46801,Kasualdot,stormscale,1804,warlock,destruction,42,25,17
46802,Фирбог,soulflayer,1804,warlock,destruction,60,31,29
46803,Ниезвестнно,soulflayer,1804,warlock,destruction,47,24,23
46804,Vøid,hellscream,1803,warlock,destruction,89,40,49
46805,Ertogrul,draenor,1802,warlock,destruction,24,19,5
46806,Loel,blackrock,1802,warlock,destruction,36,23,13
46807,Pornhubx,stormscale,1802,warlock,destruction,48,30,18
46808,Pilock,stormscale,1802,warlock,destruction,36,22,14
46809,Morcey,sylvanas,1801,warlock,destruction,79,49,30
46810,Alxor,archimonde,1801,warlock,destruction,78,44,34
46811,Tuskawl,stormreaver,1800,warlock,destruction,36,22,14
46812,Skrana,kazzak,1800,warlock,destruction,65,39,26
46813,Lashyra,aszune,1800,warlock,destruction,48,24,24
46814,Anabolicbaby,draenor,1799,warlock,destruction,30,23,7
46815,Бонибеннет,gordunni,1799,warlock,destruction,56,35,21
46816,Аймох,gordunni,1798,warlock,destruction,48,29,19
46817,Jamb,bloodfeather,1796,warlock,destruction,24,19,5
46818,Daubi,ravencrest,1796,warlock,destruction,48,28,20
46819,Dualla,aegwynn,1796,warlock,destruction,108,61,47
46820,Wankdiesel,der-rat-von-dalaran,1796,warlock,destruction,156,77,79
46821,Hachishaku,ravencrest,1794,warlock,destruction,82,50,32
46822,Eltharis,burning-legion,1794,warlock,destruction,60,33,27
46823,Bàbyløck,archimonde,1792,warlock,destruction,78,44,34
46824,Robertóó,burning-legion,1792,warlock,destruction,64,34,30
46825,Slipx,aegwynn,1791,warlock,destruction,60,34,26
46826,Rotangel,ragnaros,1791,warlock,destruction,60,33,27
46827,Bianchii,stormscale,1790,warlock,destruction,38,27,11
46828,Høliax,archimonde,1790,warlock,destruction,48,33,15
46829,Warlockoloco,blackmoore,1788,warlock,destruction,114,70,44
46830,Uddze,pozzo-delleternità,1787,warlock,destruction,71,38,33
46831,Whøknøws,twisting-nether,1786,warlock,destruction,36,25,11
46832,Çamille,ulduar,1786,warlock,destruction,97,53,44
46833,Elyö,dalaran,1786,warlock,destruction,269,132,137
46834,Ërîkå,ravencrest,1785,warlock,destruction,99,59,40
46835,Marador,drakthul,1785,warlock,destruction,83,43,40
46836,Keybump,outland,1784,warlock,destruction,146,83,63
46837,Wlistoohard,stormscale,1784,warlock,destruction,53,30,23
46838,Кейкегенкай,gordunni,1783,warlock,destruction,135,72,63
46839,Corano,ravencrest,1782,warlock,destruction,36,23,13
46840,Vankraken,silvermoon,1782,warlock,destruction,66,40,26
46841,Knoxwhite,stormscale,1781,warlock,destruction,42,28,14
46842,Felerok,drakthul,1780,warlock,destruction,30,22,8
46843,Nunomendes,archimonde,1780,warlock,destruction,48,28,20
46844,Rêctûmsêêkêr,ravencrest,1780,warlock,destruction,48,25,23
46845,Cwz,ysondre,1775,warlock,destruction,26,20,6
46846,Xerxeus,drakthul,1775,warlock,destruction,36,27,9
46847,Themut,draenor,1775,warlock,destruction,82,49,33
46848,Diablist,kazzak,1775,warlock,destruction,118,64,54
46849,Halaïa,outland,1773,warlock,destruction,40,27,13
46850,Vultzbolt,draenor,1773,warlock,destruction,165,93,72
46851,Tajit,eredar,1773,warlock,destruction,66,32,34
46852,Sunjal,stormscale,1772,warlock,destruction,36,24,12
46853,Crse,antonidas,1772,warlock,destruction,79,52,27
46854,Zxò,twisting-nether,1771,warlock,destruction,135,71,64
46855,Veridy,kazzak,1771,warlock,destruction,82,43,39
46856,Fredé,kazzak,1770,warlock,destruction,59,28,31
46857,Demoner,tarren-mill,1769,warlock,destruction,156,90,66
46858,Kmeta,twilights-hammer,1769,warlock,destruction,54,27,27
46859,Ondarian,grim-batol,1768,warlock,destruction,56,37,19
46860,Ragdoll,twisting-nether,1768,warlock,destruction,46,28,18
46861,Fluugew,tarren-mill,1768,warlock,destruction,54,27,27
46862,Gigachaos,outland,1766,warlock,destruction,107,69,38
46863,Hebbxw,kazzak,1766,warlock,destruction,146,80,66
46864,Онлифан,soulflayer,1765,warlock,destruction,64,40,24
46865,Pöhz,archimonde,1764,warlock,destruction,48,27,21
46866,Olympïe,archimonde,1763,warlock,destruction,70,44,26
46867,Демоник,deathguard,1763,warlock,destruction,42,24,18
46868,Autocannon,stormscale,1763,warlock,destruction,60,32,28
46869,Helldoom,drakthul,1763,warlock,destruction,247,122,125
46870,Sololock,ravencrest,1762,warlock,destruction,76,46,30
46871,Ceu,tarren-mill,1762,warlock,destruction,129,70,59
46872,Nëismz,ravencrest,1761,warlock,destruction,37,23,14
46873,Løckwood,blackrock,1761,warlock,destruction,34,21,13
46874,Jegfaller,wildhammer,1761,warlock,destruction,242,123,119
46875,Xuthil,korgall,1760,warlock,destruction,78,45,33
46876,Мишастрах,gordunni,1756,warlock,destruction,36,24,12
46877,Razek,eredar,1754,warlock,destruction,47,27,20
46878,Brainwashed,the-maelstrom,1753,warlock,destruction,57,33,24
46879,Artys,tarren-mill,1752,warlock,destruction,36,25,11
46880,Warlockery,argent-dawn,1750,warlock,destruction,84,48,36
46881,Хирацука,howling-fjord,1749,warlock,destruction,45,31,14
46882,Valthorion,arthas,1749,warlock,destruction,42,23,19
46883,Рипхард,soulflayer,1749,warlock,destruction,57,31,26
46884,Mércé,stormscale,1748,warlock,destruction,30,22,8
46885,Kalwyn,stormscale,1748,warlock,destruction,30,22,8
46886,Hydrôlîc,blackrock,1748,warlock,destruction,36,20,16
46887,Kaijim,aegwynn,1747,warlock,destruction,121,78,43
46888,Шеизла,borean-tundra,1747,warlock,destruction,90,57,33
46889,Хйу,galakrond,1747,warlock,destruction,42,20,22
46890,Lugnalennart,tarren-mill,1746,warlock,destruction,132,73,59
46891,Muleerox,kazzak,1745,warlock,destruction,48,27,21
46892,Nyiks,blackhand,1743,warlock,destruction,34,19,15
46893,Nqa,outland,1743,warlock,destruction,41,22,19
46894,Fearfearfear,archimonde,1743,warlock,destruction,84,41,43
46895,Belastiz,blackmoore,1742,warlock,destruction,60,37,23
46896,Gjallarbrù,archimonde,1742,warlock,destruction,51,29,22
46897,Spectarlock,tarren-mill,1742,warlock,destruction,48,25,23
46898,Guldån,twisting-nether,1741,warlock,destruction,42,24,18
46899,Kasualix,ravencrest,1740,warlock,destruction,52,33,19
46900,Shadeisblack,tarren-mill,1740,warlock,destruction,36,22,14
46901,Бриант,gordunni,1740,warlock,destruction,42,24,18
46902,Ketzu,hyjal,1739,warlock,destruction,36,21,15
46903,Limity,nozdormu,1739,warlock,destruction,78,45,33
46904,Боуманн,howling-fjord,1738,warlock,destruction,42,22,20
46905,Flatwolenzy,blackrock,1736,warlock,destruction,30,19,11
46906,Сумракз,soulflayer,1736,warlock,destruction,36,19,17
46907,Ghachi,draenor,1735,warlock,destruction,72,33,39
46908,Wintheirl,argent-dawn,1734,warlock,destruction,124,67,57
46909,Dotalike,kazzak,1734,warlock,destruction,42,22,20
46910,Ditàà,archimonde,1733,warlock,destruction,41,26,15
46911,Dótstuff,draenor,1733,warlock,destruction,36,22,14
46912,Моргоника,howling-fjord,1733,warlock,destruction,91,48,43
46913,Plsbuffme,ravencrest,1731,warlock,destruction,39,27,12
46914,Десло,thermaplugg,1731,warlock,destruction,42,25,17
46915,Daeyon,ravencrest,1731,warlock,destruction,38,19,19
46916,Wismer,kazzak,1730,warlock,destruction,30,20,10
46917,Acrion,blackrock,1730,warlock,destruction,39,20,19
46918,Asbest,blackrock,1730,warlock,destruction,82,42,40
46919,Upsahl,twisting-nether,1729,warlock,destruction,110,61,49
46920,Vmorghuliss,sanguino,1729,warlock,destruction,114,52,62
46921,Imbalockzwei,aegwynn,1728,warlock,destruction,36,25,11
46922,Entropyboost,stormscale,1728,warlock,destruction,42,21,21
46923,Jûgøbænned,aegwynn,1727,warlock,destruction,45,33,12
46924,Тумнуктхай,gordunni,1727,warlock,destruction,42,27,15
46925,Depressor,ragnaros,1727,warlock,destruction,90,44,46
46926,Жизньтлён,gordunni,1726,warlock,destruction,60,35,25
46927,Pixelz,twisting-nether,1725,warlock,destruction,72,35,37
46928,Boccebelle,pozzo-delleternità,1724,warlock,destruction,24,18,6
46929,Айхопъюдай,blackscar,1724,warlock,destruction,30,18,12
46930,Senkai,kelthuzad,1723,warlock,destruction,36,24,12
46931,Мерседэсс,gordunni,1723,warlock,destruction,48,30,18
46932,Äåäåäåäåäåäå,ravencrest,1723,warlock,destruction,30,18,12
46933,Spõk,ysondre,1722,warlock,destruction,226,125,101
46934,Orgebixx,blackmoore,1722,warlock,destruction,60,33,27
46935,Ñøêssä,outland,1721,warlock,destruction,36,22,14
46936,Sznyes,ragnaros,1721,warlock,destruction,36,19,17
46937,Jawoxoxo,rexxar,1721,warlock,destruction,60,21,39
46938,Killerbolt,blackmoore,1720,warlock,destruction,42,28,14
46939,Лордандрюха,soulflayer,1719,warlock,destruction,36,23,13
46940,Nekrofille,outland,1719,warlock,destruction,30,18,12
46941,Ganjubass,tarren-mill,1718,warlock,destruction,91,54,37
46942,Lockostock,kazzak,1718,warlock,destruction,71,34,37
46943,Fiddlestickz,gilneas,1716,warlock,destruction,71,41,30
46944,Urururustyle,hyjal,1715,warlock,destruction,48,27,21
46945,Öbsury,hyjal,1715,warlock,destruction,49,26,23
46946,Precogdiet,draenor,1714,warlock,destruction,24,18,6
46947,Acilock,outland,1714,warlock,destruction,42,23,19
46948,Nybbx,frostmane,1714,warlock,destruction,201,100,101
46949,Ignittes,ragnaros,1713,warlock,destruction,42,29,13
46950,Блэклаш,soulflayer,1713,warlock,destruction,30,18,12
46951,Reidonk,blackrock,1713,warlock,destruction,30,18,12
46952,Mekanix,kazzak,1712,warlock,destruction,36,21,15
46953,Korbendallas,anubarak,1711,warlock,destruction,30,21,9
46954,Soundmagic,silvermoon,1711,warlock,destruction,36,22,14
46955,Fatburner,draenor,1710,warlock,destruction,42,26,16
46956,Amited,drakthul,1710,warlock,destruction,59,35,24
46957,Berkobaggins,ravencrest,1710,warlock,destruction,70,38,32
46958,Fløkee,blackmoore,1710,warlock,destruction,36,19,17
46959,Tierzxc,ravencrest,1709,warlock,destruction,42,24,18
46960,Габаныч,soulflayer,1708,warlock,destruction,24,18,6
46961,Cetreros,minahonda,1708,warlock,destruction,24,18,6
46962,Cørpse,burning-legion,1708,warlock,destruction,46,33,13
46963,Stickdüse,eredar,1708,warlock,destruction,54,29,25
46964,Boumbye,ysondre,1707,warlock,destruction,38,23,15
46965,Precogbtw,ravencrest,1707,warlock,destruction,30,18,12
46966,Trîppîn,blackrock,1707,warlock,destruction,36,20,16
46967,Uzzi,dun-modr,1707,warlock,destruction,141,77,64
46968,Shádóws,nagrand,1707,warlock,destruction,173,93,80
46969,Hairyporta,blackmoore,1707,warlock,destruction,162,84,78
46970,Læsy,archimonde,1706,warlock,destruction,24,18,6
46971,Lokmonji,perenolde,1706,warlock,destruction,45,27,18
46972,Mallevs,outland,1705,warlock,destruction,84,48,36
46973,Коилсестры,blackscar,1702,warlock,destruction,39,24,15
46974,Isata,ravencrest,1702,warlock,destruction,96,58,38
46975,Nëismz,azuremyst,1700,warlock,destruction,30,20,10
46976,Kavalierr,stormscale,1699,warlock,destruction,38,25,13
46977,Ðemonsoul,stormscale,1699,warlock,destruction,285,141,144
46978,Tîllz,kargath,1698,warlock,destruction,24,22,2
46979,Djfearfullx,archimonde,1698,warlock,destruction,54,30,24
46980,Алистрен,fordragon,1698,warlock,destruction,125,67,58
46981,Märtas,burning-blade,1698,warlock,destruction,89,47,42
46982,Æhtrex,blackrock,1697,warlock,destruction,69,44,25
46983,Twiseqtt,stormscale,1697,warlock,destruction,30,18,12
46984,Чернокок,blackscar,1697,warlock,destruction,48,24,24
46985,Brútality,nethersturm,1696,warlock,destruction,90,41,49
46986,Gloon,burning-legion,1695,warlock,destruction,42,23,19
46987,Âkâl,ravencrest,1694,warlock,destruction,63,40,23
46988,Limecqt,dun-morogh,1694,warlock,destruction,40,19,21
46989,Lichlolock,outland,1693,warlock,destruction,64,39,25
46990,Juanwick,grim-batol,1692,warlock,destruction,31,24,7
46991,Døtàndrun,archimonde,1692,warlock,destruction,48,28,20
46992,Destinyz,dun-modr,1691,warlock,destruction,36,27,9
46993,Marti,blackrock,1691,warlock,destruction,42,27,15
46994,Domdon,stormscale,1691,warlock,destruction,48,26,22
46995,Ødräcïe,twisting-nether,1691,warlock,destruction,36,18,18
46996,Ðôtgøðx,ravencrest,1691,warlock,destruction,60,28,32
46997,Ekispekis,tarren-mill,1690,warlock,destruction,36,22,14
46998,Väladar,sanguino,1690,warlock,destruction,47,23,24
46999,Shutupkid,ravencrest,1689,warlock,destruction,48,29,19
47000,Variu,blackhand,1689,warlock,destruction,158,90,68
47001,Wilog,silvermoon,1688,warlock,destruction,43,27,16
47002,Boyyano,tarren-mill,1688,warlock,destruction,30,18,12
47003,Инфезиус,deathweaver,1686,warlock,destruction,30,18,12
47004,Strikeførce,ravencrest,1686,warlock,destruction,81,46,35
47005,Rénio,stormrage,1685,warlock,destruction,32,22,10
47006,Worro,eredar,1685,warlock,destruction,48,27,21
47007,Ilovebronko,blackrock,1685,warlock,destruction,101,53,48
47008,Krestox,blackmoore,1684,warlock,destruction,77,44,33
47009,Opiumers,kazzak,1684,warlock,destruction,119,61,58
47010,Kêkèkékêk,kazzak,1683,warlock,destruction,31,25,6
47011,Инсинирейтх,gordunni,1682,warlock,destruction,36,24,12
47012,Critchlock,tarren-mill,1682,warlock,destruction,53,29,24
47013,Lolock,archimonde,1681,warlock,destruction,32,19,13
47014,Ludé,eredar,1680,warlock,destruction,105,54,51
47015,Mizxxta,zuljin,1679,warlock,destruction,35,23,12
47016,Tanón,sanguino,1679,warlock,destruction,73,45,28
47017,Redshíne,hyjal,1678,warlock,destruction,30,20,10
47018,Óop,outland,1678,warlock,destruction,54,28,26
47019,Fulcanelli,sargeras,1678,warlock,destruction,39,20,19
47020,Loulou,nagrand,1678,warlock,destruction,42,20,22
47021,Darlih,ravencrest,1678,warlock,destruction,192,90,102
47022,Pinacholadá,norgannon,1678,warlock,destruction,78,35,43
47023,Whiteðevil,draenor,1677,warlock,destruction,36,21,15
47024,Exorbïtant,blackrock,1677,warlock,destruction,226,120,106
47025,Morathy,drekthar,1676,warlock,destruction,28,19,9
47026,Testoorc,frostwolf,1676,warlock,destruction,104,55,49
47027,Acidmvp,ravencrest,1676,warlock,destruction,72,38,34
47028,Danidelarge,aegwynn,1676,warlock,destruction,70,36,34
47029,Шедон,soulflayer,1675,warlock,destruction,30,22,8
47030,Exephia,laughing-skull,1675,warlock,destruction,36,22,14
47031,Rádiz,blackhand,1674,warlock,destruction,48,25,23
47032,Wåfa,kazzak,1673,warlock,destruction,24,18,6
47033,Babáyàgá,blackhand,1673,warlock,destruction,128,80,48
47034,Lockdest,outland,1673,warlock,destruction,71,39,32
47035,Neirah,stormscale,1672,warlock,destruction,47,26,21
47036,Нгага,howling-fjord,1672,warlock,destruction,279,148,131
47037,Boomsparkle,blackrock,1671,warlock,destruction,36,23,13
47038,Гвоздяшка,blackscar,1670,warlock,destruction,54,27,27
47039,Gogonash,ravencrest,1670,warlock,destruction,48,20,28
47040,Curzed,emerald-dream,1669,warlock,destruction,50,29,21
47041,Колодун,gordunni,1669,warlock,destruction,36,20,16
47042,Mønarch,argent-dawn,1669,warlock,destruction,85,46,39
47043,Ванадий,soulflayer,1667,warlock,destruction,59,26,33
47044,Pelea,silvermoon,1666,warlock,destruction,48,27,21
47045,Lokic,draenor,1665,warlock,destruction,52,24,28
47046,Shadock,scarshield-legion,1664,warlock,destruction,30,20,10
47047,Orcwarlock,khadgar,1664,warlock,destruction,66,35,31
47048,Dotshok,aegwynn,1664,warlock,destruction,42,22,20
47049,Dotsfired,aegwynn,1664,warlock,destruction,72,34,38
47050,Sargus,drakthul,1664,warlock,destruction,146,68,78
47051,Aajora,malganis,1662,warlock,destruction,84,53,31
47052,Danidelarge,kazzak,1662,warlock,destruction,38,23,15
47053,Mayev,garrosh,1662,warlock,destruction,76,37,39
47054,Беллулар,howling-fjord,1660,warlock,destruction,36,22,14
47055,Palihatschi,eredar,1660,warlock,destruction,59,24,35
47056,Síggýy,eredar,1659,warlock,destruction,41,21,20
47057,Chaosxd,outland,1658,warlock,destruction,30,20,10
47058,Eviil,tarren-mill,1658,warlock,destruction,36,22,14
47059,Pestílentía,silvermoon,1657,warlock,destruction,60,39,21
47060,Chaozvx,kazzak,1656,warlock,destruction,71,41,30
47061,Avogein,tarren-mill,1656,warlock,destruction,36,19,17
47062,Miller,stormscale,1655,warlock,destruction,48,29,19
47063,Enyras,nemesis,1655,warlock,destruction,42,22,20
47064,Rustos,ravencrest,1654,warlock,destruction,36,21,15
47065,Sneptics,draenor,1654,warlock,destruction,163,94,69
47066,Büm,kazzak,1654,warlock,destruction,90,43,47
47067,Badguldan,blackmoore,1653,warlock,destruction,57,30,27
47068,Despayr,tarren-mill,1653,warlock,destruction,72,36,36
47069,Nijva,silvermoon,1653,warlock,destruction,60,29,31
47070,Jïñ,ravencrest,1652,warlock,destruction,27,24,3
47071,Peacedust,grim-batol,1652,warlock,destruction,36,28,8
47072,Magonyth,tarren-mill,1652,warlock,destruction,31,22,9
47073,Kärme,archimonde,1652,warlock,destruction,30,19,11
47074,Pelkopeelo,tarren-mill,1652,warlock,destruction,65,38,27
47075,Saloninus,argent-dawn,1652,warlock,destruction,54,31,23
47076,Finsterfluch,conseil-des-ombres,1652,warlock,destruction,54,30,24
47077,Deathcoîl,the-maelstrom,1652,warlock,destruction,42,22,20
47078,Sleethy,destromath,1651,warlock,destruction,54,27,27
47079,Koffey,twisting-nether,1650,warlock,destruction,36,25,11
47080,Kaspersdame,ravencrest,1650,warlock,destruction,47,24,23
47081,Profesorr,defias-brotherhood,1650,warlock,destruction,42,21,21
47082,Murdee,kazzak,1650,warlock,destruction,54,22,32
47083,Søulcä,uldum,1649,warlock,destruction,30,23,7
47084,Паинбрингер,soulflayer,1649,warlock,destruction,30,18,12
47085,Quarimathras,antonidas,1649,warlock,destruction,66,34,32
47086,Lichlolocked,outland,1649,warlock,destruction,78,40,38
47087,Fatzké,kargath,1649,warlock,destruction,101,49,52
47088,Psýcholoc,kazzak,1648,warlock,destruction,38,25,13
47089,Jawdrop,blackrock,1648,warlock,destruction,51,31,20
47090,Schrimz,blackrock,1648,warlock,destruction,57,26,31
47091,Oldasiangirl,blackrock,1647,warlock,destruction,30,20,10
47092,Willthehoe,alonsus,1647,warlock,destruction,35,20,15
47093,Bh,ragnaros,1647,warlock,destruction,81,43,38
47094,Marieejoana,nozdormu,1646,warlock,destruction,72,41,31
47095,Ðemise,antonidas,1646,warlock,destruction,54,29,25
47096,Fearlessgødx,ravencrest,1646,warlock,destruction,88,46,42
47097,Zekarat,blackrock,1646,warlock,destruction,60,30,30
47098,Nøl,sargeras,1645,warlock,destruction,339,172,167
47099,Pumpfake,ravencrest,1644,warlock,destruction,23,18,5
47100,Spcnz,stormscale,1644,warlock,destruction,57,29,28
47101,Jetsetmehmet,aegwynn,1644,warlock,destruction,60,29,31
47102,Slf,the-maelstrom,1644,warlock,destruction,54,23,31
47103,Yoplen,drakthul,1643,warlock,destruction,104,61,43
47104,Cigarrette,draenor,1642,warlock,destruction,42,21,21
47105,Skyamino,hyjal,1641,warlock,destruction,42,27,15
47106,Lovromalt,kazzak,1641,warlock,destruction,48,29,19
47107,Shérlock,ravencrest,1640,warlock,destruction,42,22,20
47108,Муза,gordunni,1639,warlock,destruction,42,26,16
47109,Nøxxlock,blackhand,1639,warlock,destruction,95,55,40
47110,Forcas,archimonde,1638,warlock,destruction,142,78,64
47111,Evylock,draenor,1638,warlock,destruction,36,18,18
47112,Tóuché,aegwynn,1637,warlock,destruction,84,46,38
47113,Flawzo,blackmoore,1636,warlock,destruction,48,29,19
47114,Shugglock,draenor,1636,warlock,destruction,42,23,19
47115,Nerfmebro,tarren-mill,1635,warlock,destruction,24,19,5
47116,Enragelock,tarren-mill,1634,warlock,destruction,59,39,20
47117,Dotrulez,nemesis,1634,warlock,destruction,31,18,13
47118,Warlololock,malganis,1634,warlock,destruction,42,24,18
47119,Elvània,eredar,1633,warlock,destruction,54,31,23
47120,Lókkíi,silvermoon,1633,warlock,destruction,157,89,68
47121,Brodir,aszune,1633,warlock,destruction,36,19,17
47122,Lonelock,blackrock,1632,warlock,destruction,50,32,18
47123,Кишмякхб,gordunni,1632,warlock,destruction,47,21,26
47124,Kaeb,archimonde,1631,warlock,destruction,24,17,7
47125,Gruggenbach,twisting-nether,1630,warlock,destruction,24,17,7
47126,Lockukaracha,malganis,1630,warlock,destruction,51,34,17
47127,Augge,tarren-mill,1630,warlock,destruction,58,33,25
47128,Mihø,hyjal,1630,warlock,destruction,80,42,38
47129,Таксидермия,gordunni,1630,warlock,destruction,180,92,88
47130,Funcky,terokkar,1630,warlock,destruction,48,19,29
47131,Verixdots,antonidas,1629,warlock,destruction,38,25,13
47132,Telodotto,nemesis,1629,warlock,destruction,30,17,13
47133,Invoke,burning-blade,1628,warlock,destruction,24,20,4
47134,Wreky,thrall,1628,warlock,destruction,24,17,7
47135,Raxan,stormscale,1628,warlock,destruction,29,19,10
47136,Порртвейн,howling-fjord,1628,warlock,destruction,29,18,11
47137,Aspas,outland,1628,warlock,destruction,77,43,34
47138,Salvatoríy,outland,1628,warlock,destruction,41,21,20
47139,Nherthul,sanguino,1628,warlock,destruction,261,133,128
47140,Woòkz,argent-dawn,1627,warlock,destruction,148,84,64
47141,Flyingjakob,argent-dawn,1627,warlock,destruction,30,17,13
47142,Hepheisto,blackmoore,1627,warlock,destruction,37,20,17
47143,Kigro,burning-legion,1627,warlock,destruction,72,38,34
47144,Litox,twisting-nether,1627,warlock,destruction,63,32,31
47145,Kyliân,blackmoore,1627,warlock,destruction,36,18,18
47146,Edrahil,lordaeron,1626,warlock,destruction,66,37,29
47147,Fluch,area-52,1626,warlock,destruction,60,26,34
47148,Соикулейн,gordunni,1625,warlock,destruction,29,23,6
47149,Mobikagodx,drakthul,1625,warlock,destruction,27,19,8
47150,Luwuock,twisting-nether,1625,warlock,destruction,30,21,9
47151,Wryy,nemesis,1624,warlock,destruction,44,29,15
47152,Bmblockerina,blackrock,1624,warlock,destruction,54,35,19
47153,Khoug,blackmoore,1624,warlock,destruction,60,27,33
47154,Анрали,deathguard,1623,warlock,destruction,24,17,7
47155,Nekros,archimonde,1623,warlock,destruction,54,34,20
47156,Stazox,drakthul,1623,warlock,destruction,30,18,12
47157,Quickccast,draenor,1623,warlock,destruction,97,58,39
47158,Thebigsuck,tarren-mill,1623,warlock,destruction,96,53,43
47159,Weso,grim-batol,1623,warlock,destruction,55,28,27
47160,Isata,blackhand,1622,warlock,destruction,36,20,16
47161,Killning,medivh,1622,warlock,destruction,186,94,92
47162,Kasztyk,grim-batol,1621,warlock,destruction,47,27,20
47163,Essealaes,stormscale,1621,warlock,destruction,35,18,17
47164,Ayrefik,kazzak,1621,warlock,destruction,72,36,36
47165,Мураса,grom,1620,warlock,destruction,35,22,13
47166,Smegwlock,tarren-mill,1620,warlock,destruction,48,28,20
47167,Nimbin,taerar,1620,warlock,destruction,165,92,73
47168,Zebauron,twisting-nether,1620,warlock,destruction,36,20,16
47169,Kìmar,amanthul,1620,warlock,destruction,78,42,36
47170,Neburlock,dun-modr,1620,warlock,destruction,42,21,21
47171,Beåtrìce,archimonde,1620,warlock,destruction,57,28,29
47172,Reeween,argent-dawn,1619,warlock,destruction,30,18,12
47173,Надсх,soulflayer,1619,warlock,destruction,30,17,13
47174,Whitebøy,hyjal,1619,warlock,destruction,45,25,20
47175,Delru,aegwynn,1618,warlock,destruction,30,20,10
47176,Zikozor,ravencrest,1618,warlock,destruction,28,18,10
47177,Dzey,drakthul,1618,warlock,destruction,69,41,28
47178,Stavrogina,ravencrest,1618,warlock,destruction,30,17,13
47179,Börsenborisq,aegwynn,1618,warlock,destruction,35,19,16
47180,Локдлячепухи,soulflayer,1617,warlock,destruction,30,19,11
47181,Aspass,kazzak,1617,warlock,destruction,83,44,39
47182,Husaì,laughing-skull,1616,warlock,destruction,88,58,30
47183,Nerfbolts,archimonde,1615,warlock,destruction,24,17,7
47184,Turbonion,archimonde,1615,warlock,destruction,72,40,32
47185,Laciewaifu,silvermoon,1615,warlock,destruction,36,20,16
47186,Biest,drakthul,1615,warlock,destruction,36,17,19
47187,Anomen,sanguino,1615,warlock,destruction,53,24,29
47188,Ltheory,aegwynn,1614,warlock,destruction,60,34,26
47189,Malame,hyjal,1614,warlock,destruction,118,64,54
47190,Jisera,kiljaeden,1614,warlock,destruction,36,17,19
47191,Uralya,kazzak,1613,warlock,destruction,36,20,16
47192,Smíkz,blackhand,1612,warlock,destruction,53,32,21
47193,Gusvitori,sanguino,1612,warlock,destruction,36,20,16
47194,Meatbot,tarren-mill,1609,warlock,destruction,46,31,15
47195,Lockyswag,draenor,1609,warlock,destruction,66,37,29
47196,Nitmoredots,dun-modr,1609,warlock,destruction,48,24,24
47197,Skrabblel,tarren-mill,1609,warlock,destruction,36,18,18
47198,Boltonez,outland,1609,warlock,destruction,66,29,37
47199,Shaterz,dun-modr,1608,warlock,destruction,27,21,6
47200,Ryssäbotti,stormscale,1608,warlock,destruction,31,23,8
47201,Esmuel,argent-dawn,1608,warlock,destruction,71,43,28
47202,Spykoosi,stormscale,1608,warlock,destruction,40,24,16
47203,Xenq,ravencrest,1608,warlock,destruction,42,25,17
47204,Ketamol,ravencrest,1608,warlock,destruction,57,32,25
47205,Селикта,gordunni,1607,warlock,destruction,30,17,13
47206,Maxlox,tarren-mill,1607,warlock,destruction,35,17,18
47207,Kognah,defias-brotherhood,1606,warlock,destruction,30,21,9
47208,Гурджес,soulflayer,1606,warlock,destruction,42,29,13
47209,Zoradiale,twisting-nether,1606,warlock,destruction,36,24,12
47210,Мицуру,howling-fjord,1606,warlock,destruction,100,59,41
47211,Ðêmøñîc,ravencrest,1606,warlock,destruction,30,17,13
47212,Märkähuikka,stormreaver,1605,warlock,destruction,24,17,7
47213,Холичорт,howling-fjord,1605,warlock,destruction,69,37,32
47214,Felttofel,stormscale,1604,warlock,destruction,49,28,21
47215,Garbageclass,outland,1604,warlock,destruction,36,20,16
47216,Moelock,frostmane,1604,warlock,destruction,135,74,61
47217,Zeinth,sanguino,1603,warlock,destruction,36,23,13
47218,Sotapen,ragnaros,1603,warlock,destruction,92,56,36
47219,Дэнаа,fordragon,1603,warlock,destruction,167,85,82
47220,Dreamnyâsha,tarren-mill,1603,warlock,destruction,42,19,23
47221,Gishor,burning-legion,1602,warlock,destruction,24,19,5
47222,Xtleonidas,uldum,1602,warlock,destruction,78,41,37
47223,Bufflockspls,outland,1601,warlock,destruction,24,17,7
47224,Sickening,twilights-hammer,1601,warlock,destruction,55,38,17
47225,Skrikipanik,kazzak,1601,warlock,destruction,36,21,15
47226,Wumz,sylvanas,1601,warlock,destruction,53,27,26
47227,Dastey,stormscale,1601,warlock,destruction,36,18,18
47228,Rensayy,ysondre,1600,warlock,destruction,30,21,9
47229,Øßey,magtheridon,1600,warlock,destruction,30,19,11
47230,Letswreck,outland,1600,warlock,destruction,84,43,41
47231,Gash,malganis,1599,warlock,destruction,37,22,15
47232,Kenthal,nemesis,1599,warlock,destruction,57,28,29
47233,Bazoo,nathrezim,1597,warlock,destruction,135,68,67
47234,Golgir,draenor,1596,warlock,destruction,106,59,47
47235,Schøkøbasher,blackrock,1596,warlock,destruction,36,20,16
47236,Napoloen,kazzak,1596,warlock,destruction,36,19,17
47237,Blackiouz,stormscale,1596,warlock,destruction,167,83,84
47238,Zetsubo,drakthul,1595,warlock,destruction,55,34,21
47239,Sibora,eredar,1594,warlock,destruction,42,23,19
47240,Liqûid,destromath,1593,warlock,destruction,118,69,49
47241,Ðîâblô,silvermoon,1593,warlock,destruction,80,41,39
47242,Enzyw,drakthul,1591,warlock,destruction,36,27,9
47243,Bolt,stormscale,1591,warlock,destruction,82,50,32
47244,Nerfwarriors,stormscale,1587,warlock,destruction,52,30,22
47245,Craynos,die-arguswacht,1587,warlock,destruction,56,32,24
47246,Plamena,neptulon,1586,warlock,destruction,55,36,19
47247,Réxz,ravencrest,1586,warlock,destruction,72,36,36
47248,Hexdoctor,ravencrest,1586,warlock,destruction,48,18,30
47249,Dödkärringx,auchindoun,1585,warlock,destruction,30,19,11
47250,Грань,ashenvale,1585,warlock,destruction,212,115,97
47251,Zoh,archimonde,1585,warlock,destruction,72,38,34
47252,Uneedtherapy,silvermoon,1584,warlock,destruction,54,33,21
47253,Gimlidota,tarren-mill,1584,warlock,destruction,83,48,35
47254,Kenjix,blackrock,1584,warlock,destruction,54,23,31
47255,Chaosbolt,kelthuzad,1583,warlock,destruction,24,18,6
47256,Brugo,zuljin,1583,warlock,destruction,36,20,16
47257,Unethicalx,ragnaros,1583,warlock,destruction,36,20,16
47258,Banishedone,stormreaver,1583,warlock,destruction,92,51,41
47259,Voidzero,hyjal,1583,warlock,destruction,41,19,22
47260,Hellguards,silvermoon,1583,warlock,destruction,83,38,45
47261,Scallington,shattered-hand,1582,warlock,destruction,30,18,12
47262,Aloof,outland,1582,warlock,destruction,201,105,96
47263,Icritmore,stormscale,1582,warlock,destruction,72,37,35
47264,Flocca,archimonde,1582,warlock,destruction,41,21,20
47265,Oz,uldum,1581,warlock,destruction,78,49,29
47266,Mogwaï,blackhand,1581,warlock,destruction,51,27,24
47267,Иренхх,gordunni,1581,warlock,destruction,72,34,38
47268,Idfearthat,ragnaros,1580,warlock,destruction,48,28,20
47269,Грэтиэн,howling-fjord,1580,warlock,destruction,54,31,23
47270,Marenov,kazzak,1580,warlock,destruction,60,33,27
47271,Stromzii,silvermoon,1579,warlock,destruction,120,58,62
47272,Ìzanamí,archimonde,1578,warlock,destruction,72,44,28
47273,Simony,ravencrest,1578,warlock,destruction,30,18,12
47274,Verson,silvermoon,1578,warlock,destruction,97,53,44
47275,Хеельхейм,gordunni,1577,warlock,destruction,54,31,23
47276,Bonemetz,blackmoore,1577,warlock,destruction,142,75,67
47277,Blackmagic,stormscale,1577,warlock,destruction,170,88,82
47278,Htaedfo,tarren-mill,1576,warlock,destruction,102,45,57
47279,Mariahscary,auchindoun,1575,warlock,destruction,36,21,15
47280,Babakrake,alleria,1573,warlock,destruction,36,22,14
47281,Hongkonger,kazzak,1573,warlock,destruction,296,154,142
47282,Nàchtt,archimonde,1572,warlock,destruction,36,20,16
47283,Ánárchy,stormscale,1572,warlock,destruction,42,22,20
47284,Sûdh,sanguino,1571,warlock,destruction,60,37,23
47285,Spoíl,tarren-mill,1571,warlock,destruction,48,27,21
47286,Rakshazza,eredar,1571,warlock,destruction,102,53,49
47287,Hellfire,haomarush,1570,warlock,destruction,30,18,12
47288,Sxtynine,outland,1570,warlock,destruction,42,24,18
47289,Áutísm,silvermoon,1570,warlock,destruction,138,71,67
47290,Fandirxd,draenor,1569,warlock,destruction,71,39,32
47291,Dotsyoudown,kelthuzad,1568,warlock,destruction,97,52,45
47292,Visable,kazzak,1568,warlock,destruction,36,19,17
47293,Noahh,kazzak,1567,warlock,destruction,107,63,44
47294,Fatkkroth,ravencrest,1565,warlock,destruction,49,30,19
47295,Акэти,borean-tundra,1565,warlock,destruction,42,21,21
47296,Necrobtch,quelthalas,1564,warlock,destruction,30,19,11
47297,Konradcurz,silvermoon,1562,warlock,destruction,45,20,25
47298,Аркейнмизери,howling-fjord,1561,warlock,destruction,34,23,11
47299,Shóx,blackmoore,1561,warlock,destruction,30,18,12
47300,Drakedoge,draenor,1561,warlock,destruction,82,45,37
47301,Striks,ragnaros,1561,warlock,destruction,64,33,31
47302,Nagassh,arathor,1560,warlock,destruction,23,17,6
47303,Contemtus,frostwhisper,1559,warlock,destruction,30,19,11
47304,Azthral,nemesis,1558,warlock,destruction,259,129,130
47305,Morgan,jaedenar,1557,warlock,destruction,90,51,39
47306,Rackare,darksorrow,1556,warlock,destruction,27,19,8
47307,Baz,frostmane,1556,warlock,destruction,102,56,46
47308,Wisdomness,aszune,1556,warlock,destruction,72,36,36
47309,Britneyfears,burning-legion,1556,warlock,destruction,36,18,18
47310,Beepbepp,grim-batol,1555,warlock,destruction,52,37,15
47311,Ajgreedyy,grim-batol,1555,warlock,destruction,60,30,30
47312,Chaøs,thrall,1554,warlock,destruction,30,22,8
47313,Славеномен,howling-fjord,1554,warlock,destruction,174,89,85
47314,Atraped,zuljin,1553,warlock,destruction,126,68,58
47315,Articfox,outland,1553,warlock,destruction,104,54,50
47316,Joemontana,blackrock,1552,warlock,destruction,36,17,19
47317,Vicktorious,stormscale,1551,warlock,destruction,102,59,43
47318,Afflimoomoo,tarren-mill,1549,warlock,destruction,78,37,41
47319,Päwzy,kazzak,1548,warlock,destruction,66,34,32
47320,Chaosboltlol,ravencrest,1547,warlock,destruction,36,22,14
47321,Zarastro,sunstrider,1547,warlock,destruction,147,73,74
47322,Lysanruth,la-croisade-écarlate,1547,warlock,destruction,96,47,49
47323,Slàsh,hyjal,1546,warlock,destruction,42,29,13
47324,Necradin,defias-brotherhood,1546,warlock,destruction,45,25,20
47325,Salazaros,die-silberne-hand,1545,warlock,destruction,66,37,29
47326,Chubson,tarren-mill,1545,warlock,destruction,50,23,27
47327,Gulleigh,draenor,1543,warlock,destruction,40,19,21
47328,Rawsauce,outland,1542,warlock,destruction,20,17,3
47329,Beerdurschd,antonidas,1541,warlock,destruction,35,24,11
47330,Wÿvërnn,archimonde,1540,warlock,destruction,33,17,16
47331,Frilante,terokkar,1537,warlock,destruction,86,55,31
47332,Deathscréam,burning-legion,1537,warlock,destruction,96,48,48
47333,Banelock,dentarg,1536,warlock,destruction,36,17,19
47334,Alucena,silvermoon,1536,warlock,destruction,46,21,25
47335,Anderxyo,sanguino,1535,warlock,destruction,24,16,8
47336,Nkwango,blackmoore,1535,warlock,destruction,24,16,8
47337,Cronice,ravencrest,1535,warlock,destruction,80,37,43
47338,Bustabrinka,aggra-português,1534,warlock,destruction,18,16,2
47339,Potatowl,ravencrest,1534,warlock,destruction,18,16,2
47340,Dslap,grim-batol,1534,warlock,destruction,24,16,8
47341,Михасяпевпев,gordunni,1534,warlock,destruction,27,17,10
47342,Akumako,stormscale,1533,warlock,destruction,24,16,8
47343,Shortyi,thrall,1533,warlock,destruction,24,16,8
47344,Zloezlo,ravencrest,1533,warlock,destruction,124,63,61
47345,Zamahell,marécage-de-zangar,1532,warlock,destruction,24,17,7
47346,Höfmänn,kazzak,1532,warlock,destruction,55,35,20
47347,Debz,twisting-nether,1531,warlock,destruction,25,16,9
47348,Unrealia,hyjal,1530,warlock,destruction,126,68,58
47349,Kvanmor,kaelthas,1530,warlock,destruction,60,29,31
47350,Notben,outland,1529,warlock,destruction,18,16,2
47351,Felcollíns,ravencrest,1529,warlock,destruction,24,16,8
47352,Aoea,draenor,1529,warlock,destruction,24,16,8
47353,Chyther,ragnaros,1528,warlock,destruction,42,26,16
47354,Slëydark,sanguino,1528,warlock,destruction,32,17,15
47355,Merdotz,outland,1527,warlock,destruction,28,19,9
47356,Kerthan,malorne,1527,warlock,destruction,131,73,58
47357,Jinxme,tarren-mill,1527,warlock,destruction,101,54,47
47358,Cursedotexe,ragnaros,1527,warlock,destruction,60,32,28
47359,Nospamcliqu,ysondre,1527,warlock,destruction,30,16,14
47360,Dotxalot,blackrock,1526,warlock,destruction,40,27,13
47361,Kiros,ravencrest,1526,warlock,destruction,24,16,8
47362,Fullxlock,hyjal,1526,warlock,destruction,24,16,8
47363,Шекигами,gordunni,1526,warlock,destruction,30,16,14
47364,Kaedinx,twisting-nether,1524,warlock,destruction,365,188,177
47365,Zéphon,blades-edge,1524,warlock,destruction,82,37,45
47366,Nÿhf,kirin-tor,1523,warlock,destruction,47,21,26
47367,Nebulus,lightnings-blade,1522,warlock,destruction,79,41,38
47368,Sadixxqt,ravencrest,1521,warlock,destruction,24,16,8
47369,Инкубычь,gordunni,1521,warlock,destruction,24,16,8
47370,Nitecro,blackmoore,1521,warlock,destruction,43,23,20
47371,Bisacodyl,outland,1521,warlock,destruction,101,53,48
47372,Сорзи,thermaplugg,1521,warlock,destruction,41,20,21
47373,Malinki,silvermoon,1521,warlock,destruction,42,20,22
47374,Proßlock,kazzak,1521,warlock,destruction,116,54,62
47375,Rohlikov,drakthul,1520,warlock,destruction,24,16,8
47376,Zombpunk,sanguino,1520,warlock,destruction,45,28,17
47377,Cencible,twisting-nether,1520,warlock,destruction,91,49,42
47378,Exiled,dragonblight,1519,warlock,destruction,28,17,11
47379,Героуд,howling-fjord,1519,warlock,destruction,141,75,66
47380,Fatbëlly,argent-dawn,1518,warlock,destruction,97,47,50
47381,Doomwrath,tarren-mill,1518,warlock,destruction,36,16,20
47382,Perius,zuluhed,1518,warlock,destruction,42,18,24
47383,Rozibolt,draenor,1517,warlock,destruction,24,16,8
47384,Hasibe,ravencrest,1516,warlock,destruction,36,24,12
47385,Vegetita,stormscale,1515,warlock,destruction,179,100,79
47386,Robertóoo,burning-legion,1514,warlock,destruction,65,35,30
47387,Lottopallo,arathor,1514,warlock,destruction,30,16,14
47388,Lockteb,tarren-mill,1513,warlock,destruction,29,18,11
47389,Usianbølts,blackmoore,1513,warlock,destruction,30,16,14
47390,Маларгас,soulflayer,1512,warlock,destruction,132,72,60
47391,Mellisandre,hellfire,1510,warlock,destruction,42,25,17
47392,Artannas,elune,1508,warlock,destruction,31,19,12
47393,Pipêz,blackmoore,1508,warlock,destruction,83,50,33
47394,Darcîa,destromath,1507,warlock,destruction,30,19,11
47395,Sertdene,ravencrest,1507,warlock,destruction,54,31,23
47396,Пъё,howling-fjord,1507,warlock,destruction,101,46,55
47397,Kasuni,sanguino,1507,warlock,destruction,72,30,42
47398,Sylvxgodx,kazzak,1506,warlock,destruction,60,37,23
47399,Чернокнжник,soulflayer,1506,warlock,destruction,42,22,20
47400,Boccu,magtheridon,1504,warlock,destruction,66,37,29
47401,Ностра,gordunni,1504,warlock,destruction,66,34,32
47402,Hipiwl,silvermoon,1504,warlock,destruction,72,37,35
47403,Abnørmus,tarren-mill,1503,warlock,destruction,78,46,32
47404,Deruud,defias-brotherhood,1503,warlock,destruction,92,46,46
47405,Alexutzu,sylvanas,1501,warlock,destruction,36,22,14
47406,Enei,drakthul,1501,warlock,destruction,30,17,13
47407,Tzeeñtch,tarren-mill,1501,warlock,destruction,65,31,34
47408,Azaêl,azshara,1501,warlock,destruction,54,23,31
47409,Auxi,the-maelstrom,1499,warlock,destruction,40,27,13
47410,Dôtski,kazzak,1499,warlock,destruction,72,48,24
47411,Voidislife,alakir,1499,warlock,destruction,201,104,97
47412,Gillgarres,twisting-nether,1498,warlock,destruction,96,52,44
47413,Nicodemo,tarren-mill,1498,warlock,destruction,30,16,14
47414,Hokmor,blutkessel,1497,warlock,destruction,42,21,21
47415,Lînden,magtheridon,1496,warlock,destruction,30,16,14
47416,Interceptêr,blackrock,1496,warlock,destruction,36,18,18
47417,Dxfive,tarren-mill,1495,warlock,destruction,30,19,11
47418,Naemys,archimonde,1495,warlock,destruction,57,36,21
47419,Marklock,drakthul,1495,warlock,destruction,62,38,24
47420,Diåbló,stormscale,1495,warlock,destruction,126,72,54
47421,Kïng,elune,1494,warlock,destruction,66,34,32
47422,Balgo,blackmoore,1493,warlock,destruction,54,30,24
47423,Mazaear,stormscale,1493,warlock,destruction,51,28,23
47424,Jumbodot,tarren-mill,1493,warlock,destruction,44,23,21
47425,Dotzéro,ravencrest,1493,warlock,destruction,42,21,21
47426,Warlocat,the-maelstrom,1493,warlock,destruction,72,34,38
47427,Белвет,blackscar,1493,warlock,destruction,63,29,34
47428,Falel,das-konsortium,1492,warlock,destruction,24,19,5
47429,Ноубрейкс,blackscar,1491,warlock,destruction,52,33,19
47430,Ketriicken,argent-dawn,1490,warlock,destruction,96,51,45
47431,Колдунишка,fordragon,1490,warlock,destruction,117,62,55
47432,Chaosprophet,argent-dawn,1489,warlock,destruction,50,28,22
47433,Brokengodx,dun-modr,1489,warlock,destruction,30,16,14
47434,Fiveyearque,sylvanas,1489,warlock,destruction,36,16,20
47435,Fêâr,dun-modr,1488,warlock,destruction,22,17,5
47436,Zerøskil,blackrock,1488,warlock,destruction,24,16,8
47437,Valcan,ragnaros,1488,warlock,destruction,85,49,36
47438,Onetwobolt,archimonde,1487,warlock,destruction,133,68,65
47439,Magicstick,eredar,1487,warlock,destruction,77,36,41
47440,Kamí,sanguino,1487,warlock,destruction,65,30,35
47441,Кулутха,soulflayer,1486,warlock,destruction,31,19,12
47442,Scaevóla,ravencrest,1486,warlock,destruction,252,129,123
47443,Diabló,outland,1485,warlock,destruction,36,18,18
47444,Jaimê,thrall,1484,warlock,destruction,88,48,40
47445,Asmonmald,stormscale,1484,warlock,destruction,178,93,85
47446,Fearster,twisting-nether,1483,warlock,destruction,71,42,29
47447,Xârtôr,blackrock,1482,warlock,destruction,176,96,80
47448,Cronai,silvermoon,1482,warlock,destruction,33,18,15
47449,Czx,twisting-nether,1479,warlock,destruction,36,22,14
47450,Ammathrel,moonglade,1479,warlock,destruction,48,24,24
47451,Inoculum,xavius,1478,warlock,destruction,30,16,14
47452,Kiritsugi,aszune,1476,warlock,destruction,65,38,27
47453,Иванфаков,soulflayer,1475,warlock,destruction,29,17,12
47454,Zeddy,draenor,1475,warlock,destruction,120,67,53
47455,Farlier,draenor,1474,warlock,destruction,95,47,48
47456,Samyoung,kazzak,1472,warlock,destruction,66,38,28
47457,Pufulet,sylvanas,1472,warlock,destruction,54,31,23
47458,Егосяхаос,soulflayer,1472,warlock,destruction,84,42,42
47459,Törtidotcom,blackrock,1472,warlock,destruction,42,20,22
47460,Раздирающая,gordunni,1471,warlock,destruction,46,30,16
47461,Èrmes,eldrethalas,1469,warlock,destruction,59,31,28
47462,Бомбшелл,soulflayer,1469,warlock,destruction,38,17,21
47463,Onono,eredar,1468,warlock,destruction,30,16,14
47464,Lobotomic,argent-dawn,1467,warlock,destruction,33,21,12
47465,Kartanos,stormscale,1466,warlock,destruction,23,16,7
47466,Адоха,howling-fjord,1466,warlock,destruction,66,34,32
47467,Сайзэр,soulflayer,1466,warlock,destruction,117,58,59
47468,Wedlock,stormscale,1465,warlock,destruction,60,36,24
47469,Bivör,blackmoore,1465,warlock,destruction,50,20,30
47470,Holaw,tarren-mill,1464,warlock,destruction,84,41,43
47471,Mvpðøtx,ravencrest,1463,warlock,destruction,45,28,17
47472,Cørleen,eredar,1462,warlock,destruction,88,36,52
47473,Snackstickz,twisting-nether,1461,warlock,destruction,48,25,23
47474,Гуслин,soulflayer,1458,warlock,destruction,30,19,11
47475,Spaså,kazzak,1458,warlock,destruction,42,23,19
47476,Моориус,soulflayer,1458,warlock,destruction,48,23,25
47477,Nedivh,stormscale,1458,warlock,destruction,47,22,25
47478,Nokickplz,nemesis,1457,warlock,destruction,42,22,20
47479,Wurdulock,silvermoon,1457,warlock,destruction,48,24,24
47480,Horsewarlock,stormscale,1457,warlock,destruction,95,44,51
47481,Sirmic,hyjal,1457,warlock,destruction,90,41,49
47482,Aleê,twisting-nether,1454,warlock,destruction,47,23,24
47483,Lockybàlboa,tarren-mill,1453,warlock,destruction,48,29,19
47484,Moonpoxlock,nerathor,1453,warlock,destruction,38,20,18
47485,Shaxlock,draenor,1451,warlock,destruction,82,43,39
47486,Геролин,goldrinn,1451,warlock,destruction,61,30,31
47487,Wicherson,burning-legion,1451,warlock,destruction,37,18,19
47488,Banshore,ysondre,1450,warlock,destruction,47,29,18
47489,Nerzhull,stormscale,1449,warlock,destruction,188,92,96
47490,Алхун,razuvious,1447,warlock,destruction,72,36,36
47491,Cazzo,burning-blade,1446,warlock,destruction,42,20,22
47492,Shêrlöck,stormscale,1446,warlock,destruction,42,20,22
47493,Nèrfxløl,ragnaros,1444,warlock,destruction,30,22,8
47494,Trickyy,azjolnerub,1444,warlock,destruction,39,25,14
47495,Helkásh,tarren-mill,1443,warlock,destruction,66,31,35
47496,Stürmer,thrall,1442,warlock,destruction,60,32,28
47497,Birimbau,outland,1442,warlock,destruction,67,32,35
47498,Scrim,laughing-skull,1441,warlock,destruction,50,34,16
47499,Smoudini,blackrock,1439,warlock,destruction,24,15,9
47500,Простишуткаь,gordunni,1439,warlock,destruction,24,15,9
47501,Fearbeachx,ravencrest,1438,warlock,destruction,24,15,9
47502,Mowxll,blackrock,1438,warlock,destruction,24,15,9
47503,Dzimmi,kazzak,1438,warlock,destruction,42,22,20
47504,Ignorantduck,sunstrider,1438,warlock,destruction,51,25,26
47505,Навидд,howling-fjord,1437,warlock,destruction,24,15,9
47506,Igneutz,twisting-nether,1437,warlock,destruction,24,15,9
47507,Nádjá,ravencrest,1437,warlock,destruction,24,15,9
47508,Thugsupreme,ravencrest,1437,warlock,destruction,78,41,37
47509,Veoxohr,argent-dawn,1436,warlock,destruction,99,60,39
47510,Iriepathie,nozdormu,1436,warlock,destruction,30,16,14
47511,Holeraa,stormscale,1436,warlock,destruction,110,58,52
47512,Rhss,stormscale,1436,warlock,destruction,30,15,15
47513,Elldialock,draenor,1436,warlock,destruction,30,15,15
47514,Fearoclock,nemesis,1435,warlock,destruction,30,15,15
47515,Fynxo,blackmoore,1433,warlock,destruction,24,16,8
47516,Noxsix,gorgonnash,1433,warlock,destruction,54,28,26
47517,Vulluin,blackrock,1433,warlock,destruction,30,15,15
47518,Calli,blackrock,1432,warlock,destruction,22,16,6
47519,Datendariza,kazzak,1432,warlock,destruction,104,53,51
47520,Horridum,draenor,1432,warlock,destruction,42,16,26
47521,Flockyy,draenor,1431,warlock,destruction,28,16,12
47522,Pouletmicuie,archimonde,1431,warlock,destruction,50,26,24
47523,Slavecry,silvermoon,1430,warlock,destruction,24,15,9
47524,Trâsto,cthun,1430,warlock,destruction,24,15,9
47525,Softcøre,blackmoore,1430,warlock,destruction,48,29,19
47526,Cráxx,onyxia,1430,warlock,destruction,175,89,86
47527,Peardrax,draenor,1430,warlock,destruction,67,34,33
47528,Blackwizard,theradras,1429,warlock,destruction,81,42,39
47529,Antoniolm,cthun,1429,warlock,destruction,54,27,27
47530,Kwoh,saurfang,1429,warlock,destruction,30,15,15
47531,Koonlock,kazzak,1428,warlock,destruction,43,22,21
47532,Misscringe,silvermoon,1428,warlock,destruction,54,23,31
47533,Micheller,ravencrest,1427,warlock,destruction,24,15,9
47534,Xoraith,runetotem,1426,warlock,destruction,24,15,9
47535,Gango,outland,1426,warlock,destruction,29,18,11
47536,Gigabolt,turalyon,1426,warlock,destruction,30,17,13
47537,Lewdrumpslap,kazzak,1425,warlock,destruction,48,31,17
47538,Gengada,blackhand,1425,warlock,destruction,48,26,22
47539,Nosoulnoprob,sylvanas,1425,warlock,destruction,48,24,24
47540,Puppylover,outland,1424,warlock,destruction,30,21,9
47541,Shufflous,ghostlands,1424,warlock,destruction,28,16,12
47542,Bte,draenor,1424,warlock,destruction,34,19,15
47543,Krukke,tarren-mill,1424,warlock,destruction,54,28,26
47544,Sesoumaru,azshara,1424,warlock,destruction,42,16,26
47545,Vimb,archimonde,1423,warlock,destruction,30,15,15
47546,Danishpistol,draenor,1423,warlock,destruction,30,15,15
47547,Belnea,draenor,1421,warlock,destruction,24,15,9
47548,Nibblez,shadowsong,1421,warlock,destruction,119,65,54
47549,Ablas,bladefist,1421,warlock,destruction,118,53,65
47550,Míkæ,ravencrest,1420,warlock,destruction,90,49,41
47551,Demonkïng,archimonde,1420,warlock,destruction,60,32,28
47552,Сатенекс,soulflayer,1419,warlock,destruction,59,36,23
47553,Diablotiin,hyjal,1419,warlock,destruction,239,122,117
47554,Eatmabolt,alleria,1417,warlock,destruction,30,18,12
47555,Mty,bronze-dragonflight,1417,warlock,destruction,53,28,25
47556,Bruzzlbube,blackhand,1417,warlock,destruction,30,15,15
47557,Diablesse,dun-modr,1417,warlock,destruction,62,30,32
47558,Rakoru,blackmoore,1416,warlock,destruction,30,15,15
47559,Waandi,ravencrest,1415,warlock,destruction,34,20,14
47560,Wauwish,stormscale,1415,warlock,destruction,47,27,20
47561,Zöyarüm,outland,1414,warlock,destruction,30,16,14
47562,Мирмех,gordunni,1414,warlock,destruction,42,21,21
47563,Sublînê,blackmoore,1413,warlock,destruction,99,58,41
47564,Barro,das-syndikat,1410,warlock,destruction,32,17,15
47565,Holodream,stormreaver,1410,warlock,destruction,78,38,40
47566,Бирел,soulflayer,1409,warlock,destruction,24,15,9
47567,Azzoaa,defias-brotherhood,1408,warlock,destruction,60,29,31
47568,Chroll,nerathor,1407,warlock,destruction,46,32,14
47569,Naavii,bloodscalp,1407,warlock,destruction,42,21,21
47570,Natsume,ragnaros,1407,warlock,destruction,43,21,22
47571,Backdrip,ragnaros,1406,warlock,destruction,37,21,16
47572,Kumas,hyjal,1406,warlock,destruction,30,16,14
47573,Xârdâs,blackrock,1406,warlock,destruction,30,15,15
47574,Zlohell,drakthul,1405,warlock,destruction,48,30,18
47575,Kospar,dun-morogh,1405,warlock,destruction,93,50,43
47576,Evaksiá,draenor,1405,warlock,destruction,48,23,25
47577,Smadrekas,ravencrest,1404,warlock,destruction,58,25,33
47578,Enydible,frostmane,1403,warlock,destruction,24,15,9
47579,Proctolock,garona,1403,warlock,destruction,34,20,14
47580,Skruios,anetheron,1403,warlock,destruction,64,35,29
47581,Азерок,howling-fjord,1403,warlock,destruction,42,21,21
47582,Zeelotko,drakthul,1401,warlock,destruction,54,32,22
47583,Dotacy,kazzak,1400,warlock,destruction,30,15,15
47584,Гупперлок,howling-fjord,1400,warlock,destruction,48,21,27
47585,Faro,trollbane,1398,warlock,destruction,98,42,56
47586,Kar,haomarush,1398,warlock,destruction,42,17,25
47587,Nomakqlock,dun-modr,1397,warlock,destruction,36,23,13
47588,Вроман,fordragon,1397,warlock,destruction,80,47,33
47589,Dhraven,thrall,1395,warlock,destruction,96,53,43
47590,Dobonard,sylvanas,1395,warlock,destruction,38,19,19
47591,Rhaelgar,kazzak,1395,warlock,destruction,30,15,15
47592,Tomiaa,burning-legion,1395,warlock,destruction,36,15,21
47593,Fandusttwo,drakthul,1394,warlock,destruction,30,16,14
47594,Satanizm,silvermoon,1393,warlock,destruction,95,46,49
47595,Kolosh,twisting-nether,1392,warlock,destruction,24,15,9
47596,Ghostflame,tarren-mill,1392,warlock,destruction,34,19,15
47597,Çhãøsførÿã,blackmoore,1392,warlock,destruction,90,43,47
47598,Warlockholms,archimonde,1391,warlock,destruction,24,15,9
47599,Pogrom,burning-legion,1391,warlock,destruction,36,21,15
47600,Chaoxz,outland,1391,warlock,destruction,54,31,23
47601,Шелруа,howling-fjord,1390,warlock,destruction,52,31,21
47602,Pommeslock,blackmoore,1390,warlock,destruction,42,20,22
47603,Seagelock,silvermoon,1390,warlock,destruction,78,36,42
47604,Zollon,norgannon,1389,warlock,destruction,23,17,6
47605,Corbiejr,tarren-mill,1389,warlock,destruction,98,62,36
47606,Zivalelia,silvermoon,1389,warlock,destruction,102,49,53
47607,Яжбатько,howling-fjord,1389,warlock,destruction,36,15,21
47608,Lynchian,draenor,1387,warlock,destruction,49,26,23
47609,Gehirnwäsche,frostwolf,1385,warlock,destruction,28,18,10
47610,Dracsu,dun-modr,1383,warlock,destruction,49,26,23
47611,Unkash,zuljin,1382,warlock,destruction,102,57,45
47612,Boomlock,dun-morogh,1382,warlock,destruction,42,17,25
47613,Калестонх,soulflayer,1380,warlock,destruction,42,25,17
47614,Dreadnogg,tarren-mill,1380,warlock,destruction,100,50,50
47615,Kosfáce,tarren-mill,1377,warlock,destruction,77,35,42
47616,Adoy,tarren-mill,1375,warlock,destruction,54,31,23
47617,Galardodric,outland,1373,warlock,destruction,30,16,14
47618,Lucifa,arthas,1371,warlock,destruction,36,17,19
47619,Pookabee,ravencrest,1369,warlock,destruction,36,19,17
47620,Sidragasoss,drakthul,1369,warlock,destruction,30,15,15
47621,Cahetel,nemesis,1368,warlock,destruction,47,24,23
47622,Kaamosliha,frostwhisper,1367,warlock,destruction,52,29,23
47623,Biotic,dun-modr,1366,warlock,destruction,36,16,20
47624,Эот,soulflayer,1365,warlock,destruction,27,16,11
47625,Vakgu,blackmoore,1362,warlock,destruction,47,28,19
47626,Hamskurken,silvermoon,1362,warlock,destruction,28,15,13
47627,Nyriat,tarren-mill,1361,warlock,destruction,24,16,8
47628,Quasimodó,aegwynn,1361,warlock,destruction,48,29,19
47629,Salastro,ragnaros,1361,warlock,destruction,27,15,12
47630,Gricorby,drakthul,1360,warlock,destruction,23,16,7
47631,Uelimueli,onyxia,1360,warlock,destruction,53,23,30
47632,Lockedaway,ravencrest,1359,warlock,destruction,42,22,20
47633,Noctiz,pozzo-delleternità,1358,warlock,destruction,73,36,37
47634,Islazoldyck,draenor,1356,warlock,destruction,78,33,45
47635,Demoz,sanguino,1354,warlock,destruction,70,40,30
47636,Voltadol,dun-modr,1353,warlock,destruction,126,65,61
47637,Emalk,tarren-mill,1353,warlock,destruction,36,15,21
47638,Boltexpert,twisting-nether,1351,warlock,destruction,30,15,15
47639,Zzombie,sylvanas,1350,warlock,destruction,38,17,21
47640,Mîjagî,blackhand,1349,warlock,destruction,60,36,24
47641,Zesekk,blackmoore,1349,warlock,destruction,54,20,34
47642,Soulgünter,blackmoore,1348,warlock,destruction,40,27,13
47643,Disrupted,blackmoore,1348,warlock,destruction,30,16,14
47644,Hell,twisting-nether,1347,warlock,destruction,54,22,32
47645,Bankley,khaz-modan,1346,warlock,destruction,42,21,21
47646,Talindra,stormscale,1345,warlock,destruction,50,28,22
47647,Warlockgødx,silvermoon,1345,warlock,destruction,66,36,30
47648,Простшутка,gordunni,1344,warlock,destruction,18,14,4
47649,Nerokin,blackrock,1344,warlock,destruction,60,41,19
47650,Plocke,aegwynn,1344,warlock,destruction,24,14,10
47651,Potatowl,ragnaros,1344,warlock,destruction,24,14,10
47652,Maxiabe,hyjal,1344,warlock,destruction,54,27,27
47653,Kokainas,dun-modr,1344,warlock,destruction,36,18,18
47654,Dotloca,draenor,1344,warlock,destruction,30,15,15
47655,Freshademic,tarren-mill,1343,warlock,destruction,18,14,4
47656,Bowti,ravencrest,1343,warlock,destruction,64,40,24
47657,Anthraxus,argent-dawn,1343,warlock,destruction,24,14,10
47658,Setyouinfear,ravencrest,1343,warlock,destruction,30,14,16
47659,Mudwalkin,ravencrest,1343,warlock,destruction,30,14,16
47660,Britnèyfears,twisting-nether,1343,warlock,destruction,30,14,16
47661,Happsõr,eredar,1342,warlock,destruction,18,14,4
47662,Ghastlyy,aggra-português,1342,warlock,destruction,18,14,4
47663,Odenbest,silvermoon,1342,warlock,destruction,24,14,10
47664,Badapow,stormscale,1342,warlock,destruction,24,14,10
47665,Nanotrik,draenor,1342,warlock,destruction,24,14,10
47666,Cigänä,archimonde,1342,warlock,destruction,24,14,10
47667,Verderbnis,malganis,1341,warlock,destruction,53,31,22
47668,Haltros,stormscale,1341,warlock,destruction,24,14,10
47669,Gravemxney,tarren-mill,1341,warlock,destruction,24,14,10
47670,Mompets,stormscale,1341,warlock,destruction,36,14,22
47671,Fearu,kazzak,1340,warlock,destruction,18,14,4
47672,Zacurse,kazzak,1340,warlock,destruction,48,28,20
47673,Khano,twisting-nether,1340,warlock,destruction,75,38,37
47674,Love,alexstrasza,1339,warlock,destruction,30,18,12
47675,Flaming,ravencrest,1339,warlock,destruction,24,14,10
47676,Dimmybyrger,stormreaver,1339,warlock,destruction,30,14,16
47677,Wazze,azuremyst,1338,warlock,destruction,23,15,8
47678,Ryurans,cthun,1338,warlock,destruction,98,49,49
47679,Кварий,howling-fjord,1337,warlock,destruction,36,14,22
47680,Gyroib,stormscale,1335,warlock,destruction,23,15,8
47681,Cyanur,silvermoon,1335,warlock,destruction,24,14,10
47682,Póssiblyreef,silvermoon,1334,warlock,destruction,24,14,10
47683,Rúbedo,thrall,1334,warlock,destruction,24,14,10
47684,Boglock,argent-dawn,1333,warlock,destruction,24,14,10
47685,Fivestars,tarren-mill,1332,warlock,destruction,40,20,20
47686,Vincewl,ravencrest,1330,warlock,destruction,36,16,20
47687,Talriun,kazzak,1330,warlock,destruction,38,16,22
47688,Mooncrushed,stormscale,1329,warlock,destruction,18,14,4
47689,Ínsidióus,tarren-mill,1329,warlock,destruction,24,14,10
47690,Lyconidas,magtheridon,1329,warlock,destruction,24,14,10
47691,Dieger,thunderhorn,1328,warlock,destruction,24,14,10
47692,Äsmødée,dalaran,1328,warlock,destruction,54,31,23
47693,Nàughty,ragnaros,1328,warlock,destruction,67,28,39
47694,Stonysalami,turalyon,1327,warlock,destruction,41,28,13
47695,Benzakenta,sylvanas,1327,warlock,destruction,24,14,10
47696,Кискатёмная,blackscar,1327,warlock,destruction,60,30,30
47697,Problemchild,sunstrider,1324,warlock,destruction,30,19,11
47698,Carthagî,blackmoore,1324,warlock,destruction,48,30,18
47699,Xshay,dun-modr,1324,warlock,destruction,45,16,29
47700,Sneps,azshara,1323,warlock,destruction,24,14,10
47701,Melow,sanguino,1323,warlock,destruction,44,21,23
47702,Микурочка,gordunni,1323,warlock,destruction,59,25,34
47703,Xtkeks,blackmoore,1322,warlock,destruction,24,14,10
47704,Эннинотбэд,howling-fjord,1322,warlock,destruction,29,14,15
47705,Kromosonen,ravencrest,1322,warlock,destruction,36,15,21
47706,Арцах,soulflayer,1321,warlock,destruction,36,16,20
47707,Elhäbedehä,blackrock,1319,warlock,destruction,18,14,4
47708,Nhéon,archimonde,1319,warlock,destruction,24,14,10
47709,Ymersai,stormscale,1318,warlock,destruction,71,36,35
47710,Mempricious,ravencrest,1318,warlock,destruction,30,14,16
47711,Exitumos,eredar,1316,warlock,destruction,24,14,10
47712,Mohawkyz,chamber-of-aspects,1316,warlock,destruction,32,17,15
47713,Tuz,blackrock,1316,warlock,destruction,90,40,50
47714,Plööp,malganis,1315,warlock,destruction,92,47,45
47715,Олдхалапеньо,soulflayer,1314,warlock,destruction,54,24,30
47716,Ghostfiend,tarren-mill,1313,warlock,destruction,21,15,6
47717,Baalthazar,jaedenar,1312,warlock,destruction,24,15,9
47718,Demirchayan,twisting-nether,1312,warlock,destruction,66,41,25
47719,Dìablò,sylvanas,1312,warlock,destruction,60,35,25
47720,Chram,uldum,1311,warlock,destruction,53,33,20
47721,Starlok,nemesis,1309,warlock,destruction,23,14,9
47722,Somanydots,twisting-nether,1309,warlock,destruction,90,44,46
47723,Rotinhell,kazzak,1309,warlock,destruction,123,57,66
47724,Divvaa,tarren-mill,1308,warlock,destruction,94,45,49
47725,Altffeer,blackmoore,1307,warlock,destruction,30,14,16
47726,Блэкмайндер,howling-fjord,1306,warlock,destruction,38,23,15
47727,Kìnvaras,tarren-mill,1305,warlock,destruction,22,15,7
47728,Sinsemilla,turalyon,1305,warlock,destruction,47,24,23
47729,Лоредо,howling-fjord,1304,warlock,destruction,38,15,23
47730,Shadeshanox,blackmoore,1302,warlock,destruction,36,23,13
47731,Lokajci,outland,1302,warlock,destruction,37,22,15
47732,Øpaco,khazgoroth,1302,warlock,destruction,42,17,25
47733,Covariance,nemesis,1302,warlock,destruction,36,14,22
47734,Janemba,ysondre,1300,warlock,destruction,30,14,16
47735,Fêars,blackrock,1299,warlock,destruction,62,34,28
47736,Kïrah,ysondre,1299,warlock,destruction,62,24,38
47737,Lodem,darksorrow,1298,warlock,destruction,36,15,21
47738,Sîlverdîze,thrall,1297,warlock,destruction,53,29,24
47739,Pensiblesie,runetotem,1297,warlock,destruction,456,224,232
47740,Мамкадгара,howling-fjord,1297,warlock,destruction,29,14,15
47741,Dexterr,sylvanas,1295,warlock,destruction,110,55,55
47742,Cardinall,drakthul,1295,warlock,destruction,48,24,24
47743,Ädarä,cthun,1294,warlock,destruction,60,30,30
47744,Arnoediad,twisting-nether,1291,warlock,destruction,39,18,21
47745,Azrail,anubarak,1290,warlock,destruction,66,31,35
47746,Биохозард,deathguard,1289,warlock,destruction,81,41,40
47747,Galath,wrathbringer,1289,warlock,destruction,64,32,32
47748,Sorxez,thrall,1287,warlock,destruction,54,25,29
47749,Drillingsdad,dun-morogh,1282,warlock,destruction,42,20,22
47750,Парачо,eversong,1280,warlock,destruction,34,15,19
47751,Patirass,sanguino,1279,warlock,destruction,36,20,16
47752,Sylrathas,burning-legion,1279,warlock,destruction,75,41,34
47753,Docik,kazzak,1279,warlock,destruction,31,15,16
47754,Southylol,stormscale,1278,warlock,destruction,17,14,3
47755,Terris,khaz-modan,1278,warlock,destruction,81,40,41
47756,Nopower,dun-morogh,1277,warlock,destruction,35,20,15
47757,Denasty,nemesis,1277,warlock,destruction,28,14,14
47758,Demohoror,stormscale,1276,warlock,destruction,42,20,22
47759,Felbunni,silvermoon,1276,warlock,destruction,69,31,38
47760,Easybolt,blackrock,1276,warlock,destruction,32,14,18
47761,Chaotìc,nemesis,1275,warlock,destruction,24,18,6
47762,Ocaya,kazzak,1275,warlock,destruction,30,16,14
47763,Гринлайм,howling-fjord,1274,warlock,destruction,33,19,14
47764,Dreamage,exodar,1274,warlock,destruction,54,27,27
47765,Делегент,deathguard,1272,warlock,destruction,84,34,50
47766,Shinamna,tarren-mill,1270,warlock,destruction,30,15,15
47767,Mavelya,blackmoore,1266,warlock,destruction,40,17,23
47768,Чиназис,gordunni,1265,warlock,destruction,102,49,53
47769,Sovrìn,blackrock,1264,warlock,destruction,20,14,6
47770,Tsumde,dalaran,1264,warlock,destruction,86,43,43
47771,Proflock,drakthul,1264,warlock,destruction,36,18,18
47772,Tabarnak,archimonde,1264,warlock,destruction,30,14,16
47773,Jossim,outland,1263,warlock,destruction,66,38,28
47774,Necrolock,tarren-mill,1263,warlock,destruction,47,23,24
47775,Гангстахохо,soulflayer,1263,warlock,destruction,40,16,24
47776,Voiyane,silvermoon,1261,warlock,destruction,30,14,16
47777,Xoram,kult-der-verdammten,1260,warlock,destruction,24,15,9
47778,Хиёрис,eversong,1260,warlock,destruction,51,29,22
47779,Symbiosis,kazzak,1260,warlock,destruction,102,50,52
47780,Julsey,kazzak,1259,warlock,destruction,17,14,3
47781,Дольпико,howling-fjord,1259,warlock,destruction,30,16,14
47782,Üserper,chamber-of-aspects,1259,warlock,destruction,143,64,79
47783,Mefistto,drakthul,1258,warlock,destruction,24,14,10
47784,Zuyox,silvermoon,1256,warlock,destruction,53,22,31
47785,Blackjackk,tarren-mill,1256,warlock,destruction,72,27,45
47786,Вешка,azuregos,1254,warlock,destruction,21,14,7
47787,Maveri,tarren-mill,1254,warlock,destruction,33,16,17
47788,Untactful,tarren-mill,1253,warlock,destruction,53,31,22
47789,Hárdí,tarren-mill,1252,warlock,destruction,18,14,4
47790,Jobbymancer,twisting-nether,1252,warlock,destruction,42,25,17
47791,Askanios,twisting-nether,1252,warlock,destruction,61,34,27
47792,Oxsen,hyjal,1249,warlock,destruction,54,26,28
47793,Scherzinger,archimonde,1248,warlock,destruction,18,13,5
47794,Thesnakë,ravencrest,1248,warlock,destruction,18,13,5
47795,Calypso,korgall,1248,warlock,destruction,24,13,11
47796,Dotg,blackrock,1247,warlock,destruction,24,13,11
47797,Dobromír,kazzak,1247,warlock,destruction,24,13,11
47798,Shiammetrý,kazzak,1247,warlock,destruction,24,13,11
47799,Rizzbolt,ravencrest,1247,warlock,destruction,99,49,50
47800,Lokibra,antonidas,1247,warlock,destruction,90,42,48
47801,Kresyda,dun-modr,1247,warlock,destruction,30,13,17
47802,Thorolock,blackhand,1246,warlock,destruction,18,13,5
47803,Osyx,ravencrest,1246,warlock,destruction,28,15,13
47804,Hardnes,kazzak,1246,warlock,destruction,30,13,17
47805,Rünek,tarren-mill,1245,warlock,destruction,18,13,5
47806,Morrowgleam,outland,1245,warlock,destruction,18,13,5
47807,Shutdown,sylvanas,1245,warlock,destruction,42,26,16
47808,Pherlet,sylvanas,1245,warlock,destruction,24,13,11
47809,Boltgodx,thrall,1245,warlock,destruction,24,13,11
47810,Zuldanius,stormscale,1245,warlock,destruction,24,13,11
47811,Withered,nagrand,1244,warlock,destruction,18,13,5
47812,Bellicus,tarren-mill,1244,warlock,destruction,18,13,5
47813,Krachol,emeriss,1244,warlock,destruction,24,13,11
47814,Fidlesticks,ragnaros,1244,warlock,destruction,33,15,18
47815,Dreggsow,blackmoore,1243,warlock,destruction,18,13,5
47816,Hannahowo,garona,1243,warlock,destruction,24,13,11
47817,Cajnik,sylvanas,1242,warlock,destruction,24,13,11
47818,Filianore,azjolnerub,1242,warlock,destruction,61,28,33
47819,Salouppio,archimonde,1242,warlock,destruction,30,13,17
47820,Lacape,dalaran,1241,warlock,destruction,18,13,5
47821,Cursecannon,outland,1241,warlock,destruction,18,13,5
47822,Pyroplasmic,tarren-mill,1241,warlock,destruction,65,40,25
47823,Dreameater,twilights-hammer,1240,warlock,destruction,24,13,11
47824,Drfóx,draenor,1240,warlock,destruction,41,16,25
47825,Запрещаю,galakrond,1239,warlock,destruction,66,30,36
47826,Ragequit,xavius,1238,warlock,destruction,24,13,11
47827,Unstablemind,nemesis,1238,warlock,destruction,27,14,13
47828,Mootay,drekthar,1237,warlock,destruction,24,13,11
47829,Sepulturá,thrall,1237,warlock,destruction,24,13,11
47830,Darkeds,dun-modr,1237,warlock,destruction,24,13,11
47831,Локкрис,blackscar,1237,warlock,destruction,74,38,36
47832,Møärdötd,aggra-português,1236,warlock,destruction,18,13,5
47833,Thorenss,medivh,1235,warlock,destruction,72,35,37
47834,Siyruz,eredar,1234,warlock,destruction,24,13,11
47835,Apôpis,archimonde,1233,warlock,destruction,30,17,13
47836,Demojun,silvermoon,1233,warlock,destruction,30,13,17
47837,Zhoxx,outland,1233,warlock,destruction,30,13,17
47838,Oloki,kazzak,1232,warlock,destruction,56,29,27
47839,Asmodaî,anubarak,1232,warlock,destruction,71,36,35
47840,Crysy,confrérie-du-thorium,1232,warlock,destruction,30,13,17
47841,Bottmbolt,blackhand,1231,warlock,destruction,25,13,12
47842,Инсип,blackscar,1230,warlock,destruction,24,14,10
47843,Левсекси,eversong,1230,warlock,destruction,27,14,13
47844,Карьерщица,booty-bay,1230,warlock,destruction,79,40,39
47845,Keibo,drakthul,1228,warlock,destruction,30,13,17
47846,Rottend,aggra-português,1228,warlock,destruction,81,35,46
47847,Wolferand,argent-dawn,1228,warlock,destruction,42,17,25
47848,Trollgubbe,twilights-hammer,1225,warlock,destruction,18,13,5
47849,Dubbzy,outland,1223,warlock,destruction,32,15,17
47850,Eotlid,shattered-hand,1221,warlock,destruction,24,13,11
47851,Гулдас,thermaplugg,1221,warlock,destruction,42,21,21
47852,Diseased,darksorrow,1219,warlock,destruction,96,57,39
47853,Chickoz,eredar,1219,warlock,destruction,103,54,49
47854,Babayagâ,sanguino,1218,warlock,destruction,24,14,10
47855,Stunspectoo,turalyon,1217,warlock,destruction,24,17,7
47856,Westfaliu,blackhand,1217,warlock,destruction,66,24,42
47857,Borrìs,blackhand,1216,warlock,destruction,160,83,77
47858,Oldemoilépti,hyjal,1216,warlock,destruction,30,14,16
47859,Gigoberto,kazzak,1214,warlock,destruction,23,13,10
47860,Эктос,soulflayer,1213,warlock,destruction,18,13,5
47861,Puiia,draenor,1212,warlock,destruction,33,20,13
47862,Artyrus,burning-legion,1212,warlock,destruction,96,49,47
47863,Guntok,tarren-mill,1211,warlock,destruction,37,22,15
47864,Senaida,sylvanas,1211,warlock,destruction,70,40,30
47865,Dominvs,silvermoon,1211,warlock,destruction,42,17,25
47866,Vulgrim,kirin-tor,1208,warlock,destruction,57,27,30
47867,Oxypvp,ravencrest,1207,warlock,destruction,51,19,32
47868,Fredysimo,silvermoon,1206,warlock,destruction,18,13,5
47869,Sargal,sylvanas,1206,warlock,destruction,30,13,17
47870,Lokko,nemesis,1205,warlock,destruction,42,23,19
47871,Xhartus,argent-dawn,1205,warlock,destruction,30,13,17
47872,Valkiá,earthen-ring,1203,warlock,destruction,42,20,22
47873,Ayóó,doomhammer,1202,warlock,destruction,107,58,49
47874,Pekkoperkele,ravenholdt,1202,warlock,destruction,66,29,37
47875,Aurelíá,ravencrest,1201,warlock,destruction,29,13,16
47876,Hyphonos,blackmoore,1199,warlock,destruction,26,14,12
47877,Bløødwins,burning-legion,1198,warlock,destruction,17,13,4
47878,Íntikam,blackrock,1198,warlock,destruction,30,15,15
47879,Kneereap,antonidas,1197,warlock,destruction,30,17,13
47880,Nicolino,doomhammer,1196,warlock,destruction,48,27,21
47881,Zenondoros,arthas,1195,warlock,destruction,21,13,8
47882,Зюзерг,soulflayer,1195,warlock,destruction,30,14,16
47883,Dededimons,stormscale,1193,warlock,destruction,68,32,36
47884,Maxxilla,twisting-nether,1191,warlock,destruction,173,84,89
47885,Emoriy,blackmoore,1190,warlock,destruction,64,34,30
47886,Binkybabes,outland,1190,warlock,destruction,39,18,21
47887,Plague,twisting-nether,1188,warlock,destruction,27,14,13
47888,Neffy,sinstralis,1188,warlock,destruction,76,31,45
47889,Neetlock,suramar,1185,warlock,destruction,30,14,16
47890,Idleglance,outland,1181,warlock,destruction,17,13,4
47891,Vitrolizz,twilights-hammer,1181,warlock,destruction,32,13,19
47892,Присесть,razuvious,1180,warlock,destruction,27,15,12
47893,Insanely,kazzak,1179,warlock,destruction,81,45,36
47894,Kääk,sylvanas,1178,warlock,destruction,60,29,31
47895,Kaeos,ravencrest,1176,warlock,destruction,24,15,9
47896,Niszoght,dun-modr,1172,warlock,destruction,65,40,25
47897,Lovrog,twisting-nether,1169,warlock,destruction,21,13,8
47898,Wildo,grim-batol,1169,warlock,destruction,24,14,10
47899,Arkatraz,blackhand,1165,warlock,destruction,42,19,23
47900,Loptous,dunemaul,1160,warlock,destruction,25,14,11
47901,Saereda,kazzak,1160,warlock,destruction,42,20,22
47902,Kritcheq,alakir,1156,warlock,destruction,98,48,50
47903,Modzal,kazzak,1155,warlock,destruction,24,13,11
47904,Hulagirl,ravencrest,1152,warlock,destruction,18,12,6
47905,Dotjürgen,blackrock,1152,warlock,destruction,18,12,6
47906,Youngtyrant,blackrock,1152,warlock,destruction,18,12,6
47907,Noskillfox,outland,1152,warlock,destruction,18,12,6
47908,Ekàti,ravencrest,1152,warlock,destruction,24,12,12
47909,Purplemafia,burning-blade,1152,warlock,destruction,24,12,12
47910,Ánderx,dun-modr,1152,warlock,destruction,24,12,12
47911,Teiser,nemesis,1152,warlock,destruction,24,12,12
47912,Вайнпрессх,gordunni,1152,warlock,destruction,30,12,18
47913,Консидёро,gordunni,1152,warlock,destruction,30,12,18
47914,Hifiz,grim-batol,1151,warlock,destruction,18,12,6
47915,Hasselbalch,azshara,1151,warlock,destruction,18,12,6
47916,Элси,howling-fjord,1151,warlock,destruction,18,12,6
47917,Leman,sylvanas,1151,warlock,destruction,18,12,6
47918,Cloud,kazzak,1151,warlock,destruction,18,12,6
47919,Jkz,blackrock,1151,warlock,destruction,21,13,8
47920,Wspolnax,ravencrest,1151,warlock,destruction,24,12,12
47921,Wìtçhßlåðes,ysondre,1151,warlock,destruction,24,12,12
47922,Nightìngale,silvermoon,1151,warlock,destruction,24,12,12
47923,Kikaikek,stormscale,1150,warlock,destruction,18,12,6
47924,Zenii,nemesis,1150,warlock,destruction,18,12,6
47925,Shazem,tarren-mill,1150,warlock,destruction,18,12,6
47926,Estefanía,tarren-mill,1150,warlock,destruction,18,12,6
47927,Scadar,kazzak,1149,warlock,destruction,18,12,6
47928,Steelock,kazzak,1149,warlock,destruction,21,13,8
47929,Gravedîgger,aggra-português,1149,warlock,destruction,24,12,12
47930,Мегаклещ,soulflayer,1149,warlock,destruction,24,12,12
47931,Felgød,ravencrest,1149,warlock,destruction,24,12,12
47932,Maikus,stormscale,1148,warlock,destruction,18,12,6
47933,Mignetto,nemesis,1148,warlock,destruction,18,12,6
47934,Aljohno,twisting-nether,1148,warlock,destruction,24,12,12
47935,Sushilock,stormrage,1147,warlock,destruction,18,12,6
47936,Felhaen,silvermoon,1147,warlock,destruction,24,12,12
47937,Sædotern,stormscale,1147,warlock,destruction,24,12,12
47938,Flumez,stormscale,1146,warlock,destruction,12,12,0
47939,Favorizlmp,archimonde,1146,warlock,destruction,24,12,12
47940,Solomohn,steamwheedle-cartel,1145,warlock,destruction,18,13,5
47941,Postymalony,kazzak,1145,warlock,destruction,18,12,6
47942,Falock,tarren-mill,1145,warlock,destruction,18,12,6
47943,Sippe,laughing-skull,1145,warlock,destruction,24,12,12
47944,Ezdotggwp,stormscale,1145,warlock,destruction,24,12,12
47945,Puujäbäxd,stormscale,1145,warlock,destruction,30,12,18
47946,Mortuáry,drakthul,1144,warlock,destruction,24,12,12
47947,Jinxzed,frostwhisper,1143,warlock,destruction,18,12,6
47948,Гулдарий,howling-fjord,1143,warlock,destruction,136,72,64
47949,Smileyfacè,silvermoon,1143,warlock,destruction,42,12,30
47950,Toliver,drakthul,1142,warlock,destruction,18,12,6
47951,Зажиженный,soulflayer,1142,warlock,destruction,21,12,9
47952,Воттоваара,azuregos,1142,warlock,destruction,24,12,12
47953,Línkéd,blackmoore,1142,warlock,destruction,30,12,18
47954,Хубаскис,soulflayer,1141,warlock,destruction,24,12,12
47955,Orisess,bronze-dragonflight,1140,warlock,destruction,95,53,42
47956,Hymirr,arathor,1140,warlock,destruction,31,12,19
47957,Trivalis,frostwolf,1139,warlock,destruction,24,12,12
47958,Fathernurgle,hellfire,1138,warlock,destruction,79,42,37
47959,Parley,frostmane,1138,warlock,destruction,30,12,18
47960,Halacska,arathor,1137,warlock,destruction,24,12,12
47961,Скул,soulflayer,1137,warlock,destruction,30,12,18
47962,Kamehamehaa,stormscale,1136,warlock,destruction,18,12,6
47963,Féar,doomhammer,1136,warlock,destruction,24,12,12
47964,Pcbbwarlock,sylvanas,1136,warlock,destruction,30,12,18
47965,Rampelnicka,burning-blade,1135,warlock,destruction,24,12,12
47966,Mîtskî,argent-dawn,1132,warlock,destruction,38,17,21
47967,Harrykan,blackrock,1130,warlock,destruction,18,12,6
47968,Kresnyk,kazzak,1130,warlock,destruction,23,12,11
47969,Toffifae,argent-dawn,1129,warlock,destruction,18,12,6
47970,Fiendy,tarren-mill,1129,warlock,destruction,24,12,12
47971,Riitaall,khaz-modan,1125,warlock,destruction,49,18,31
47972,Marann,dun-morogh,1122,warlock,destruction,38,25,13
47973,Darkà,rexxar,1121,warlock,destruction,24,13,11
47974,Soultwist,twisting-nether,1120,warlock,destruction,30,12,18
47975,Shagrab,nemesis,1119,warlock,destruction,33,17,16
47976,Paranoid,sylvanas,1119,warlock,destruction,24,12,12
47977,Fiddlock,draenor,1117,warlock,destruction,22,13,9
47978,Lánfeár,draenor,1114,warlock,destruction,29,12,17
47979,Yhwäch,archimonde,1114,warlock,destruction,30,12,18
47980,Shadowbolt,outland,1104,warlock,destruction,27,12,15
47981,Règis,antonidas,1102,warlock,destruction,21,13,8
47982,Schöp,der-rat-von-dalaran,1101,warlock,destruction,34,16,18
47983,Sicktir,aerie-peak,1101,warlock,destruction,34,14,20
47984,Fromfuneral,anetheron,1093,warlock,destruction,107,60,47
47985,Cozyboi,thrall,1091,warlock,destruction,165,82,83
47986,Buserella,eredar,1085,warlock,destruction,30,12,18
47987,Atruruz,antonidas,1084,warlock,destruction,65,32,33
47988,Öyo,outland,1084,warlock,destruction,132,64,68
47989,Vendømlørd,archimonde,1083,warlock,destruction,36,12,24
47990,Бигтедок,gordunni,1079,warlock,destruction,158,80,78
47991,Ruul,sanguino,1079,warlock,destruction,50,20,30
47992,Tchytcha,archimonde,1078,warlock,destruction,30,17,13
47993,Makaspam,stormscale,1074,warlock,destruction,34,12,22
47994,Pff,emeriss,1073,warlock,destruction,29,16,13
47995,Jinckslock,anachronos,1072,warlock,destruction,13,12,1
47996,Wuhdun,burning-legion,1072,warlock,destruction,29,12,17
47997,Thicklock,twisting-nether,1071,warlock,destruction,24,12,12
47998,Whitebanshee,turalyon,1069,warlock,destruction,36,21,15
47999,Jimbrown,eredar,1066,warlock,destruction,22,12,10
48000,Batráz,tarren-mill,1059,warlock,destruction,78,31,47
48001,Bk,alexstrasza,1056,warlock,destruction,12,11,1
48002,Datty,grim-batol,1056,warlock,destruction,12,11,1
48003,Hexiønløck,archimonde,1056,warlock,destruction,12,11,1
48004,Oarz,blackrock,1056,warlock,destruction,18,11,7
48005,Catchlock,tarren-mill,1056,warlock,destruction,18,11,7
48006,Tessalizz,aegwynn,1056,warlock,destruction,18,11,7
48007,Secretx,kazzak,1056,warlock,destruction,18,11,7
48008,Незерлок,soulflayer,1056,warlock,destruction,18,11,7
48009,Dotbotx,grim-batol,1056,warlock,destruction,18,11,7
48010,Кремация,blackscar,1056,warlock,destruction,18,11,7
48011,Fjutta,outland,1056,warlock,destruction,18,11,7
48012,Flayør,ravencrest,1056,warlock,destruction,18,11,7
48013,Sizexl,silvermoon,1056,warlock,destruction,18,11,7
48014,Rénna,twisting-nether,1056,warlock,destruction,18,11,7
48015,Rüjï,sanguino,1056,warlock,destruction,54,19,35
48016,Deadmoneyz,twisting-nether,1055,warlock,destruction,12,11,1
48017,Kawanoski,kazzak,1055,warlock,destruction,12,11,1
48018,Trooverx,ravencrest,1055,warlock,destruction,12,11,1
48019,Resterx,blackhand,1055,warlock,destruction,12,11,1
48020,Веберх,howling-fjord,1055,warlock,destruction,18,11,7
48021,Razzalock,eredar,1055,warlock,destruction,18,11,7
48022,Collectiòn,kazzak,1055,warlock,destruction,18,11,7
48023,Raknoxyeyeye,blackrock,1055,warlock,destruction,18,11,7
48024,Лешабетон,gordunni,1055,warlock,destruction,18,11,7
48025,Krøl,nemesis,1055,warlock,destruction,18,11,7
48026,Shena,chogall,1055,warlock,destruction,24,11,13
48027,Dalyvan,blackrock,1055,warlock,destruction,24,11,13
48028,Блэкфлэймх,gordunni,1055,warlock,destruction,30,11,19
48029,Kieman,tarren-mill,1055,warlock,destruction,30,11,19
48030,Drarken,sylvanas,1054,warlock,destruction,12,11,1
48031,Naniika,blackmoore,1054,warlock,destruction,36,24,12
48032,Highimhi,kazzak,1054,warlock,destruction,18,11,7
48033,Коломо,soulflayer,1054,warlock,destruction,18,11,7
48034,Archí,twisting-nether,1054,warlock,destruction,18,11,7
48035,Jørdanna,blackrock,1054,warlock,destruction,18,11,7
48036,Ronniee,moonglade,1054,warlock,destruction,18,11,7
48037,Анкхзул,howling-fjord,1054,warlock,destruction,18,11,7
48038,Ileeo,kazzak,1054,warlock,destruction,42,23,19
48039,Helvetica,darksorrow,1054,warlock,destruction,24,11,13
48040,Xydar,stormscale,1054,warlock,destruction,30,12,18
48041,Trickslock,kazzak,1053,warlock,destruction,18,11,7
48042,Shadowthrone,ragnaros,1053,warlock,destruction,24,11,13
48043,Yenex,blackhand,1053,warlock,destruction,32,14,18
48044,Костикк,howling-fjord,1052,warlock,destruction,18,11,7
48045,Gentoo,xavius,1052,warlock,destruction,18,11,7
48046,Бигбрейн,soulflayer,1051,warlock,destruction,18,11,7
48047,Hejhana,drakthul,1051,warlock,destruction,102,39,63
48048,Katâra,tarren-mill,1051,warlock,destruction,30,11,19
48049,Peterpaîn,blackmoore,1050,warlock,destruction,22,14,8
48050,Sopingsop,chants-éternels,1050,warlock,destruction,18,11,7
48051,Willibolt,blackhand,1050,warlock,destruction,24,11,13
48052,Gâlvâtorix,frostmourne,1050,warlock,destruction,58,26,32
48053,Whine,uldum,1050,warlock,destruction,54,24,30
48054,Gåylørd,ravencrest,1050,warlock,destruction,30,11,19
48055,Setta,argent-dawn,1050,warlock,destruction,36,11,25
48056,Bangbrös,stormscale,1049,warlock,destruction,18,11,7
48057,Gdkw,tarren-mill,1049,warlock,destruction,24,11,13
48058,Margincalled,kazzak,1048,warlock,destruction,24,11,13
48059,Jpjpjp,gorgonnash,1046,warlock,destruction,18,11,7
48060,Faitless,stormscale,1046,warlock,destruction,18,11,7
48061,Yénnéfér,ravencrest,1046,warlock,destruction,33,11,22
48062,Quentex,antonidas,1045,warlock,destruction,24,11,13
48063,Cängrë,dun-modr,1042,warlock,destruction,18,11,7
48064,Surfot,kazzak,1041,warlock,destruction,30,11,19
48065,Sindown,the-maelstrom,1041,warlock,destruction,30,11,19
48066,Тарналор,gordunni,1032,warlock,destruction,24,11,13
48067,Heximexi,malganis,1029,warlock,destruction,24,11,13
48068,Demonoulis,bloodhoof,1026,warlock,destruction,18,11,7
48069,Woudstok,ysondre,1026,warlock,destruction,23,12,11
48070,Nava,stormscale,1024,warlock,destruction,28,12,16
48071,Vinilio,kazzak,1019,warlock,destruction,56,21,35
48072,Avati,sargeras,1018,warlock,destruction,30,14,16
48073,Klasikas,kazzak,1016,warlock,destruction,27,12,15
48074,Kharzug,alakir,1015,warlock,destruction,27,12,15
48075,Àtreyù,daggerspine,1015,warlock,destruction,71,27,44
48076,Amon,suramar,1011,warlock,destruction,25,13,12
48077,Omnigul,grim-batol,1010,warlock,destruction,36,14,22
48078,Zardøx,khaz-modan,1009,warlock,destruction,18,12,6
48079,Gødprotøtýpe,ragnaros,1008,warlock,destruction,25,13,12
48080,Ðæthpäct,dalaran,1007,warlock,destruction,23,11,12
48081,Satyrilian,tarren-mill,1006,warlock,destruction,17,11,6
48082,Esthrella,thrall,1006,warlock,destruction,25,14,11
48083,Jaqqy,blackmoore,1005,warlock,destruction,18,12,6
48084,Lazyblue,hyjal,1004,warlock,destruction,43,12,31
48085,Babayagaa,drakthul,1002,warlock,destruction,26,11,15
48086,Baskakov,zuljin,1001,warlock,destruction,21,11,10
48087,Iltharian,die-todeskrallen,1000,warlock,destruction,17,11,6
48088,Архидрако,gordunni,997,warlock,destruction,36,16,20
48089,Чпокерша,deepholm,994,warlock,destruction,29,11,18
48090,Loveløck,blackrock,991,warlock,destruction,29,11,18
48091,Rasputia,thunderhorn,989,warlock,destruction,22,12,10
48092,Yudy,burning-legion,987,warlock,destruction,20,11,9
48093,Lynchéd,argent-dawn,986,warlock,destruction,17,11,6
48094,Líok,eredar,982,warlock,destruction,29,11,18
48095,Шайтанарба,blackscar,977,warlock,destruction,42,17,25
48096,Шейп,fordragon,977,warlock,destruction,36,11,25
48097,Scrabblee,dun-morogh,976,warlock,destruction,30,11,19
48098,Thorins,sinstralis,972,warlock,destruction,30,12,18
48099,Demox,arathor,962,warlock,destruction,26,11,15
48100,Gilfhaunter,malganis,960,warlock,destruction,12,10,2
48101,Graystache,blackhand,960,warlock,destruction,12,10,2
48102,Nerfmeplz,archimonde,960,warlock,destruction,12,10,2
48103,Nefariousz,bloodfeather,960,warlock,destruction,12,10,2
48104,Jamuhlee,der-abyssische-rat,960,warlock,destruction,12,10,2
48105,Sakkrethxd,hyjal,960,warlock,destruction,12,10,2
48106,Ñia,ravencrest,960,warlock,destruction,12,10,2
48107,Aritrosyo,ravencrest,960,warlock,destruction,12,10,2
48108,Kozaras,tarren-mill,960,warlock,destruction,12,10,2
48109,Stecksen,blackmoore,960,warlock,destruction,12,10,2
48110,Jazggzkxx,twisting-nether,960,warlock,destruction,12,10,2
48111,Flxzshort,kazzak,960,warlock,destruction,12,10,2
48112,Joinx,tarren-mill,960,warlock,destruction,12,10,2
48113,Slomg,sylvanas,960,warlock,destruction,12,10,2
48114,Isco,ysondre,960,warlock,destruction,12,10,2
48115,Garb,stormreaver,960,warlock,destruction,12,10,2
48116,Korialstraz,sylvanas,960,warlock,destruction,12,10,2
48117,Harefrøken,ravencrest,960,warlock,destruction,12,10,2
48118,Hopéléss,aggra-português,960,warlock,destruction,12,10,2
48119,Destrolockz,tarren-mill,960,warlock,destruction,16,11,5
48120,Imissbfa,stormscale,960,warlock,destruction,16,11,5
48121,Teezeye,ragnaros,960,warlock,destruction,17,10,7
48122,Blazed,dentarg,960,warlock,destruction,18,10,8
48123,Chaotick,burning-legion,960,warlock,destruction,18,10,8
48124,Lìmè,silvermoon,960,warlock,destruction,18,10,8
48125,Trickytée,tarren-mill,960,warlock,destruction,18,10,8
48126,Mirenli,kazzak,960,warlock,destruction,18,10,8
48127,Meepx,nordrassil,960,warlock,destruction,18,10,8
48128,Adoxilock,twisting-nether,960,warlock,destruction,18,10,8
48129,Britneÿ,stormscale,960,warlock,destruction,18,10,8
48130,Abuu,ravencrest,960,warlock,destruction,18,10,8
48131,Lillemarkus,tarren-mill,960,warlock,destruction,18,10,8
48132,Turdy,sylvanas,960,warlock,destruction,18,10,8
48133,Ммоохх,gordunni,960,warlock,destruction,18,10,8
48134,Gödisdëäd,sanguino,960,warlock,destruction,18,10,8
48135,Хихихи,blackscar,960,warlock,destruction,18,10,8
48136,Kyiüû,archimonde,960,warlock,destruction,22,12,10
48137,Jopil,stormreaver,960,warlock,destruction,22,11,11
48138,Flatulenzus,blackrock,960,warlock,destruction,24,10,14
48139,Tentigo,blackmoore,960,warlock,destruction,24,10,14
48140,Bailerlock,antonidas,960,warlock,destruction,24,10,14
48141,Zízýéró,sylvanas,959,warlock,destruction,12,10,2
48142,Demonqueens,kazzak,959,warlock,destruction,12,10,2
48143,Cringelord,vashj,959,warlock,destruction,12,10,2
48144,Ammilock,aszune,959,warlock,destruction,12,10,2
48145,Hellraiserir,twisting-nether,959,warlock,destruction,12,10,2
48146,Melyagang,hyjal,959,warlock,destruction,12,10,2
48147,Hajslaktarn,twisting-nether,959,warlock,destruction,18,10,8
48148,Helgorak,ragnaros,959,warlock,destruction,18,10,8
48149,Kekbólt,twisting-nether,959,warlock,destruction,18,10,8
48150,Vät,kirin-tor,959,warlock,destruction,18,10,8
48151,Positivitywl,stormscale,959,warlock,destruction,18,10,8
48152,Dotáhoe,twisting-nether,959,warlock,destruction,18,10,8
48153,Deathpoid,draenor,959,warlock,destruction,18,10,8
48154,Alexindorf,silvermoon,959,warlock,destruction,18,10,8
48155,Chaosborn,ravencrest,959,warlock,destruction,24,10,14
48156,Adipure,blackrock,959,warlock,destruction,24,10,14
48157,Колмидедди,gordunni,959,warlock,destruction,24,10,14
48158,Slâyâ,blackrock,958,warlock,destruction,12,10,2
48159,Shadaw,kilrogg,958,warlock,destruction,12,10,2
48160,Dotys,sanguino,958,warlock,destruction,12,10,2
48161,Drainurlife,zenedar,958,warlock,destruction,18,10,8
48162,Phît,kilrogg,958,warlock,destruction,18,10,8
48163,Kenybalajze,the-maelstrom,958,warlock,destruction,18,10,8
48164,Vanmorgoth,nazjatar,958,warlock,destruction,18,10,8
48165,Numidia,tarren-mill,958,warlock,destruction,18,10,8
48166,Annihilatîon,aegwynn,958,warlock,destruction,18,10,8
48167,Адво,howling-fjord,958,warlock,destruction,18,10,8
48168,Kwei,nemesis,958,warlock,destruction,18,10,8
48169,Ottu,thrall,958,warlock,destruction,18,10,8
48170,Cryks,blackmoore,958,warlock,destruction,21,11,10
48171,Dèv,draenor,958,warlock,destruction,24,10,14
48172,Zorlon,frostmane,957,warlock,destruction,12,10,2
48173,Troyana,chants-éternels,957,warlock,destruction,56,35,21
48174,Inhúman,kazzak,957,warlock,destruction,18,10,8
48175,Klimsonxd,burning-legion,957,warlock,destruction,18,10,8
48176,Hexdoc,alakir,957,warlock,destruction,18,10,8
48177,Schmexer,blutkessel,957,warlock,destruction,18,10,8
48178,Baloc,kirin-tor,957,warlock,destruction,18,10,8
48179,Allêgrâ,blackrock,957,warlock,destruction,20,10,10
48180,Absurdd,turalyon,955,warlock,destruction,16,11,5
48181,Seymor,amanthul,955,warlock,destruction,18,10,8
48182,Банкапевка,howling-fjord,955,warlock,destruction,24,10,14
48183,Thranerm,ravencrest,955,warlock,destruction,24,10,14
48184,Vâgg,blackmoore,955,warlock,destruction,30,10,20
48185,Firinmalazor,blackrock,954,warlock,destruction,18,10,8
48186,Realshady,kazzak,954,warlock,destruction,18,10,8
48187,Chlöê,hyjal,954,warlock,destruction,18,10,8
48188,Panicbolt,ravencrest,954,warlock,destruction,18,10,8
48189,Izhi,ragnaros,954,warlock,destruction,21,10,11
48190,Kriplock,twisting-nether,954,warlock,destruction,24,10,14
48191,Sehere,ragnaros,953,warlock,destruction,18,10,8
48192,Gerart,tarren-mill,953,warlock,destruction,18,10,8
48193,Scandalfogel,frostmane,952,warlock,destruction,18,10,8
48194,Millhaus,gorgonnash,952,warlock,destruction,18,10,8
48195,Tzimice,hyjal,952,warlock,destruction,24,10,14
48196,Aftxrlife,arathor,951,warlock,destruction,16,11,5
48197,Zow,dun-modr,950,warlock,destruction,24,10,14
48198,Drthc,kazzak,949,warlock,destruction,18,10,8
48199,Synnox,blackrock,949,warlock,destruction,24,11,13
48200,Fbomber,ravencrest,948,warlock,destruction,12,10,2
48201,Rikkai,anubarak,948,warlock,destruction,18,10,8
48202,Nirây,thrall,945,warlock,destruction,37,10,27
48203,Vraduk,malygos,944,warlock,destruction,20,11,9
48204,Крутизол,fordragon,944,warlock,destruction,25,11,14
48205,Hyòx,aegwynn,939,warlock,destruction,23,10,13
48206,Äzarel,khaz-modan,933,warlock,destruction,12,10,2
48207,Silkgates,kazzak,933,warlock,destruction,29,10,19
48208,Eisenkiefer,thrall,933,warlock,destruction,71,24,47
48209,Boltgodx,blackrock,930,warlock,destruction,24,10,14
48210,Zøhaz,burning-legion,929,warlock,destruction,60,24,36
48211,Racursed,outland,927,warlock,destruction,16,10,6
48212,Wizdoom,outland,924,warlock,destruction,22,11,11
48213,Dotcha,ravencrest,921,warlock,destruction,18,10,8
48214,Arlu,blackrock,920,warlock,destruction,58,28,30
48215,Фламмэнх,soulflayer,911,warlock,destruction,23,10,13
48216,Cruckz,nathrezim,910,warlock,destruction,15,10,5
48217,Jamzywarlock,kazzak,910,warlock,destruction,23,10,13
48218,Demowlition,archimonde,908,warlock,destruction,24,10,14
48219,Telaldrah,argent-dawn,906,warlock,destruction,17,10,7
48220,Реалсамка,gordunni,895,warlock,destruction,17,10,7
48221,Bèkshà,blackrock,894,warlock,destruction,20,10,10
48222,Buddyparty,blackrock,892,warlock,destruction,14,10,4
48223,Felcollins,sylvanas,892,warlock,destruction,20,10,10
48224,Blâckmagíc,thrall,887,warlock,destruction,16,10,6
48225,Äbsalom,hyjal,882,warlock,destruction,80,39,41
48226,Charmine,tarren-mill,877,warlock,destruction,13,10,3
48227,Oddchap,magtheridon,875,warlock,destruction,53,21,32
48228,Narkstzhki,kazzak,866,warlock,destruction,20,11,9
48229,Projectlock,draenor,864,warlock,destruction,12,9,3
48230,Watchmecutt,terenas,864,warlock,destruction,12,9,3
48231,Niiaa,archimonde,864,warlock,destruction,12,9,3
48232,Веномхх,lich-king,864,warlock,destruction,12,9,3
48233,Boltmaster,burning-legion,864,warlock,destruction,12,9,3
48234,Vamanos,stormscale,864,warlock,destruction,12,9,3
48235,Trimar,archimonde,864,warlock,destruction,12,9,3
48236,Lcollector,outland,864,warlock,destruction,12,9,3
48237,Trashxø,tarren-mill,864,warlock,destruction,12,9,3
48238,Ahollic,frostwolf,864,warlock,destruction,12,9,3
48239,Ilbidello,nemesis,864,warlock,destruction,12,9,3
48240,Chàsx,archimonde,864,warlock,destruction,12,9,3
48241,Elmáestro,aegwynn,864,warlock,destruction,12,9,3
48242,Kaakmasta,der-abyssische-rat,864,warlock,destruction,12,9,3
48243,Dst,ravencrest,864,warlock,destruction,12,9,3
48244,Chaosboba,silvermoon,864,warlock,destruction,12,9,3
48245,Letmecast,sylvanas,864,warlock,destruction,12,9,3
48246,Peon,blackrock,864,warlock,destruction,12,9,3
48247,Qwyncess,archimonde,864,warlock,destruction,12,9,3
48248,Menocast,archimonde,864,warlock,destruction,12,9,3
48249,Zakazal,argent-dawn,864,warlock,destruction,12,9,3
48250,Predlocktwo,twisting-nether,864,warlock,destruction,12,9,3
48251,Mêgasn,blackhand,864,warlock,destruction,12,9,3
48252,Darkwíngduck,aegwynn,864,warlock,destruction,12,9,3
48253,Reizouka,twisting-nether,864,warlock,destruction,12,9,3
48254,Chãn,ravencrest,864,warlock,destruction,12,9,3
48255,Hupet,ragnaros,864,warlock,destruction,12,9,3
48256,Aggressivé,twisting-nether,864,warlock,destruction,17,9,8
48257,Царьдарк,soulflayer,864,warlock,destruction,18,9,9
48258,Fearfearfear,blackhand,864,warlock,destruction,18,9,9
48259,Köftemec,blackrock,864,warlock,destruction,18,9,9
48260,Mcdonkus,chamber-of-aspects,864,warlock,destruction,18,9,9
48261,Southylolz,stormscale,864,warlock,destruction,18,9,9
48262,Bionic,eredar,864,warlock,destruction,18,9,9
48263,Ashh,ravencrest,864,warlock,destruction,18,9,9
48264,Gulzot,turalyon,864,warlock,destruction,18,9,9
48265,Joleptem,outland,864,warlock,destruction,18,9,9
48266,Gremmus,outland,864,warlock,destruction,18,9,9
48267,Voukserys,tarren-mill,863,warlock,destruction,12,9,3
48268,Narzok,kazzak,863,warlock,destruction,12,9,3
48269,Höglund,twisting-nether,863,warlock,destruction,12,9,3
48270,Phicon,silvermoon,863,warlock,destruction,12,9,3
48271,Bergerac,archimonde,863,warlock,destruction,12,9,3
48272,Psykokwette,kirin-tor,863,warlock,destruction,12,9,3
48273,Zelyx,archimonde,863,warlock,destruction,12,9,3
48274,Locque,kazzak,863,warlock,destruction,12,9,3
48275,Elerodril,ysondre,863,warlock,destruction,12,9,3
48276,Elissa,skullcrusher,863,warlock,destruction,12,9,3
48277,Chaosbørn,twisting-nether,863,warlock,destruction,16,10,6
48278,Demoslik,hyjal,863,warlock,destruction,18,9,9
48279,Nobodyknows,outland,863,warlock,destruction,18,9,9
48280,Mjuklock,ravencrest,863,warlock,destruction,18,9,9
48281,Furchtnervt,dun-morogh,863,warlock,destruction,18,9,9
48282,Andrealphus,outland,863,warlock,destruction,18,9,9
48283,Байронет,gordunni,863,warlock,destruction,18,9,9
48284,Nazrõth,stormscale,863,warlock,destruction,18,9,9
48285,Uezzalock,nemesis,863,warlock,destruction,18,9,9
48286,Burningdemon,kazzak,863,warlock,destruction,18,9,9
48287,Moardotts,ravencrest,863,warlock,destruction,19,9,10
48288,Meningitis,tyrande,863,warlock,destruction,24,9,15
48289,Getfeared,draenor,863,warlock,destruction,24,9,15
48290,Krastey,malfurion,862,warlock,destruction,12,9,3
48291,Miltuast,blackrock,862,warlock,destruction,12,9,3
48292,Kirillkaá,blackhand,862,warlock,destruction,12,9,3
48293,Bíggun,outland,862,warlock,destruction,12,9,3
48294,Wormies,doomhammer,862,warlock,destruction,18,9,9
48295,Sateerik,draenor,862,warlock,destruction,18,9,9
48296,Deamions,ravencrest,862,warlock,destruction,18,9,9
48297,Otemlock,sanguino,862,warlock,destruction,18,9,9
48298,Palmangel,draenor,862,warlock,destruction,24,9,15
48299,Girldoom,silvermoon,862,warlock,destruction,24,9,15
48300,Grolder,terokkar,861,warlock,destruction,18,11,7
48301,Сеннир,ashenvale,861,warlock,destruction,18,9,9
48302,Darkremorsez,alakir,861,warlock,destruction,24,9,15
48303,Adafbhf,tichondrius,859,warlock,destruction,18,9,9
48304,Zakuri,blackmoore,859,warlock,destruction,18,9,9
48305,Глянемче,deathguard,859,warlock,destruction,18,9,9
48306,Hôjâm,twisting-nether,858,warlock,destruction,18,9,9
48307,Castingsmth,draenor,855,warlock,destruction,15,11,4
48308,Müdür,burning-legion,854,warlock,destruction,18,9,9
48309,Fearmex,turalyon,854,warlock,destruction,18,9,9
48310,Llilith,bronzebeard,853,warlock,destruction,18,9,9
48311,Joopz,ravencrest,847,warlock,destruction,22,12,10
48312,Ternisia,draenor,846,warlock,destruction,20,10,10
48313,Tid,burning-legion,830,warlock,destruction,17,9,8
48314,Lokelicious,ragnaros,829,warlock,destruction,23,9,14
48315,Dÿf,kazzak,828,warlock,destruction,16,9,7
48316,Smithlock,blackrock,816,warlock,destruction,15,10,5
48317,Zengrow,ravencrest,815,warlock,destruction,15,10,5
48318,Indynamo,blackrock,815,warlock,destruction,17,9,8
48319,Kkomradee,kazzak,815,warlock,destruction,21,9,12
48320,Shakuroz,frostwolf,815,warlock,destruction,27,10,17
48321,Merloc,magtheridon,801,warlock,destruction,20,10,10
48322,Châmp,stormscale,799,warlock,destruction,11,9,2
48323,Slerpmami,ragnaros,799,warlock,destruction,14,10,4
48324,Infernion,stormscale,768,warlock,destruction,10,9,1
48325,Dadylock,silvermoon,768,warlock,destruction,12,8,4
48326,Ullalol,magtheridon,768,warlock,destruction,12,8,4
48327,Квейдсан,howling-fjord,768,warlock,destruction,12,8,4
48328,Gebkan,hyjal,768,warlock,destruction,12,8,4
48329,Detoxa,outland,768,warlock,destruction,12,8,4
48330,Maenas,ravencrest,768,warlock,destruction,12,8,4
48331,Trembly,alakir,768,warlock,destruction,12,8,4
48332,Tharaya,ravencrest,768,warlock,destruction,12,8,4
48333,Gravewatcher,twisting-nether,768,warlock,destruction,12,8,4
48334,Dbwl,kazzak,768,warlock,destruction,12,8,4
48335,Wårlørd,ragnaros,768,warlock,destruction,12,8,4
48336,Dejin,tarren-mill,768,warlock,destruction,12,8,4
48337,Emolord,ravencrest,768,warlock,destruction,12,8,4
48338,Bigpoodleman,twisting-nether,768,warlock,destruction,12,8,4
48339,Sniffy,stormreaver,768,warlock,destruction,12,8,4
48340,Topmidbusta,draenor,768,warlock,destruction,12,8,4
48341,Firecast,kazzak,768,warlock,destruction,12,8,4
48342,Dmonlock,hyjal,768,warlock,destruction,12,8,4
48343,Straydots,grim-batol,768,warlock,destruction,12,8,4
48344,Supermaus,blackrock,768,warlock,destruction,12,8,4
48345,Overbuffed,wildhammer,768,warlock,destruction,12,8,4
48346,Namarin,die-aldor,768,warlock,destruction,12,8,4
48347,Aket,kazzak,768,warlock,destruction,12,8,4
48348,Миражлок,gordunni,768,warlock,destruction,12,8,4
48349,Шархилол,gordunni,768,warlock,destruction,12,8,4
48350,Benafflock,veknilash,768,warlock,destruction,12,8,4
48351,Vezmollo,stormscale,768,warlock,destruction,12,8,4
48352,Nephystø,archimonde,768,warlock,destruction,12,8,4
48353,Psychoduck,stormscale,768,warlock,destruction,12,8,4
48354,Чернокай,gordunni,768,warlock,destruction,12,8,4
48355,Gambos,kazzak,768,warlock,destruction,12,8,4
48356,Traicklock,eredar,768,warlock,destruction,12,8,4
48357,Nodavé,stormscale,768,warlock,destruction,12,8,4
48358,Crunel,ragnaros,768,warlock,destruction,12,8,4
48359,Doublebolt,the-maelstrom,768,warlock,destruction,12,8,4
48360,Ламэ,gordunni,768,warlock,destruction,12,8,4
48361,Ogiez,draenor,768,warlock,destruction,12,8,4
48362,Фаердирка,blackscar,768,warlock,destruction,12,8,4
48363,Phobilock,guldan,768,warlock,destruction,12,8,4
48364,Kàjah,outland,768,warlock,destruction,12,8,4
48365,Inagony,twisting-nether,768,warlock,destruction,12,8,4
48366,Maedx,outland,768,warlock,destruction,15,9,6
48367,Mosskok,kazzak,768,warlock,destruction,16,9,7
48368,Dirtyjoe,doomhammer,768,warlock,destruction,18,8,10
48369,Стоишьвфире,gordunni,768,warlock,destruction,18,8,10
48370,Horststenzl,blackrock,768,warlock,destruction,18,8,10
48371,Némésiø,archimonde,768,warlock,destruction,18,8,10
48372,Xarica,garona,768,warlock,destruction,18,8,10
48373,Melforius,tarren-mill,768,warlock,destruction,18,8,10
48374,Tseva,aggra-português,768,warlock,destruction,18,8,10
48375,ßenäfflock,ragnaros,768,warlock,destruction,18,8,10
48376,Unkid,tarren-mill,767,warlock,destruction,12,8,4
48377,Goodclass,tarren-mill,767,warlock,destruction,12,8,4
48378,Экспло,ashenvale,767,warlock,destruction,12,8,4
48379,Gimmê,dun-morogh,767,warlock,destruction,12,8,4
48380,Palatical,terokkar,767,warlock,destruction,12,8,4
48381,Stopfëar,ysondre,767,warlock,destruction,12,8,4
48382,Яичнаялапша,soulflayer,767,warlock,destruction,12,8,4
48383,Azaïdun,khaz-modan,767,warlock,destruction,12,8,4
48384,Mentaldeadw,draenor,767,warlock,destruction,12,8,4
48385,Ромзесхх,howling-fjord,767,warlock,destruction,12,8,4
48386,Chía,thunderhorn,767,warlock,destruction,12,8,4
48387,Xoregar,nemesis,767,warlock,destruction,12,8,4
48388,Nili,dethecus,767,warlock,destruction,12,8,4
48389,Redroach,doomhammer,767,warlock,destruction,12,8,4
48390,Lorelèi,silvermoon,767,warlock,destruction,12,8,4
48391,Aribethion,draenor,767,warlock,destruction,12,8,4
48392,Ragïa,archimonde,767,warlock,destruction,12,8,4
48393,Wushi,aggra-português,767,warlock,destruction,12,8,4
48394,Shadowburst,outland,767,warlock,destruction,12,8,4
48395,Murishani,durotan,767,warlock,destruction,12,8,4
48396,Finlock,kult-der-verdammten,767,warlock,destruction,15,9,6
48397,Toryon,archimonde,767,warlock,destruction,17,8,9
48398,Chochliko,silvermoon,767,warlock,destruction,18,8,10
48399,Debex,ravencrest,767,warlock,destruction,18,8,10
48400,Ráklock,ragnaros,767,warlock,destruction,18,8,10
48401,Wichtl,die-ewige-wacht,767,warlock,destruction,18,8,10
48402,Ebolara,aegwynn,767,warlock,destruction,18,8,10
48403,Donmajor,amanthul,767,warlock,destruction,24,8,16
48404,Légréy,blackmoore,766,warlock,destruction,12,8,4
48405,Келебрах,howling-fjord,766,warlock,destruction,12,8,4
48406,Lowkeyfed,stormscale,766,warlock,destruction,12,8,4
48407,Hydrochloric,emerald-dream,766,warlock,destruction,12,8,4
48408,Discordîân,twisting-nether,766,warlock,destruction,12,8,4
48409,Yôi,nemesis,766,warlock,destruction,18,8,10
48410,Jillyãen,hyjal,766,warlock,destruction,18,8,10
48411,Devoto,stormscale,766,warlock,destruction,22,9,13
48412,Рисли,deathweaver,765,warlock,destruction,12,8,4
48413,Bravehearrt,burning-legion,765,warlock,destruction,12,8,4
48414,Dregx,twisting-nether,765,warlock,destruction,12,8,4
48415,Soldmygranny,kazzak,765,warlock,destruction,15,9,6
48416,Drestan,twisting-nether,765,warlock,destruction,18,8,10
48417,Hexahydraten,draenor,764,warlock,destruction,18,8,10
48418,Ezekîél,blackhand,764,warlock,destruction,24,8,16
48419,Luckynòób,ravencrest,764,warlock,destruction,24,8,16
48420,Xfear,blackrock,763,warlock,destruction,12,8,4
48421,Staynecro,malfurion,763,warlock,destruction,18,8,10
48422,Юникна,gordunni,763,warlock,destruction,24,8,16
48423,Hurn,thunderhorn,762,warlock,destruction,12,8,4
48424,Nuckki,antonidas,761,warlock,destruction,30,8,22
48425,Bloodyknight,draenor,759,warlock,destruction,12,8,4
48426,Oonz,sylvanas,759,warlock,destruction,24,8,16
48427,Petrosk,sanguino,757,warlock,destruction,18,8,10
48428,Happysrme,thrall,756,warlock,destruction,36,8,28
48429,Sweetlõck,ravencrest,750,warlock,destruction,17,8,9
48430,Веномзхх,lich-king,735,warlock,destruction,17,8,9
48431,Shaodul,stormscale,735,warlock,destruction,17,8,9
48432,Шадофлок,deathweaver,735,warlock,destruction,17,8,9
48433,Xaok,dun-modr,732,warlock,destruction,23,8,15
48434,Kárdur,blackmoore,731,warlock,destruction,14,9,5
48435,Sladurana,eredar,721,warlock,destruction,18,8,10
48436,Salvatoriy,outland,719,warlock,destruction,11,8,3
48437,Кореопсис,azuregos,718,warlock,destruction,11,8,3
48438,Kelek,anachronos,718,warlock,destruction,11,8,3
48439,Mïllâïneeqtx,archimonde,714,warlock,destruction,13,10,3
48440,Ironserious,blackrock,714,warlock,destruction,16,9,7
48441,Тёмабиль,gordunni,714,warlock,destruction,23,10,13
48442,Warlocklordx,ravencrest,713,warlock,destruction,22,9,13
48443,Amyw,magtheridon,712,warlock,destruction,20,9,11
48444,Rikta,stormscale,703,warlock,destruction,11,8,3
48445,Джастсак,gordunni,703,warlock,destruction,11,8,3
48446,Kycknosa,archimonde,703,warlock,destruction,20,8,12
48447,Saleus,argent-dawn,701,warlock,destruction,16,8,8
48448,Wacastwo,tarren-mill,672,warlock,destruction,12,7,5
48449,Scud,frostwolf,672,warlock,destruction,12,7,5
48450,Filippö,eredar,672,warlock,destruction,12,7,5
48451,Kashdrakor,twisting-nether,672,warlock,destruction,12,7,5
48452,Numlockz,jaedenar,672,warlock,destruction,12,7,5
48453,Sötsugen,argent-dawn,672,warlock,destruction,12,7,5
48454,Lilbolty,outland,672,warlock,destruction,12,7,5
48455,Kronesx,tarren-mill,672,warlock,destruction,12,7,5
48456,Frèija,ravencrest,672,warlock,destruction,12,7,5
48457,Pukemistress,tarren-mill,672,warlock,destruction,12,7,5
48458,Reuhn,kazzak,672,warlock,destruction,12,7,5
48459,Vilenia,doomhammer,672,warlock,destruction,12,7,5
48460,Itiswhatitis,ravencrest,672,warlock,destruction,12,7,5
48461,Archimitros,blackmoore,672,warlock,destruction,12,7,5
48462,Aoeenjoer,tarren-mill,672,warlock,destruction,12,7,5
48463,Lockismymain,eredar,672,warlock,destruction,12,7,5
48464,Anicetuslol,lightnings-blade,672,warlock,destruction,12,7,5
48465,Skipperw,blackmoore,672,warlock,destruction,12,7,5
48466,Irwene,argent-dawn,672,warlock,destruction,12,7,5
48467,Galeriana,twilights-hammer,672,warlock,destruction,12,7,5
48468,Qumbaja,alleria,672,warlock,destruction,12,7,5
48469,Demodan,aegwynn,672,warlock,destruction,12,7,5
48470,Psykøø,shendralar,672,warlock,destruction,12,7,5
48471,Purplemonkey,burning-blade,672,warlock,destruction,12,7,5
48472,Тарои,howling-fjord,672,warlock,destruction,12,7,5
48473,Монтадон,howling-fjord,672,warlock,destruction,12,7,5
48474,Aunsá,archimonde,672,warlock,destruction,12,7,5
48475,Fraky,frostwhisper,672,warlock,destruction,12,7,5
48476,Misleev,pozzo-delleternità,672,warlock,destruction,12,7,5
48477,Nmmnmmnnmnmm,blackmoore,672,warlock,destruction,12,7,5
48478,Jaleels,kazzak,672,warlock,destruction,12,7,5
48479,Inflicts,frostmane,672,warlock,destruction,12,7,5
48480,Çüñ,shattered-hand,672,warlock,destruction,12,7,5
48481,Hehexd,steamwheedle-cartel,672,warlock,destruction,12,7,5
48482,Nürgle,stormscale,672,warlock,destruction,12,7,5
48483,Xjay,malorne,672,warlock,destruction,12,7,5
48484,Sneltjej,draenor,672,warlock,destruction,12,7,5
48485,Midnigthh,sanguino,672,warlock,destruction,12,7,5
48486,Abdulrahim,archimonde,672,warlock,destruction,12,7,5
48487,Fellord,chants-éternels,672,warlock,destruction,12,7,5
48488,Мэрджис,soulflayer,672,warlock,destruction,12,7,5
48489,Chapo,alleria,672,warlock,destruction,12,7,5
48490,Gruldran,khaz-modan,672,warlock,destruction,12,7,5
48491,Lúcìfér,stormscale,672,warlock,destruction,12,7,5
48492,Demonälskare,kazzak,672,warlock,destruction,12,7,5
48493,Numwiki,draenor,672,warlock,destruction,12,7,5
48494,Матрикспз,soulflayer,672,warlock,destruction,12,7,5
48495,Vixlock,tarren-mill,672,warlock,destruction,15,8,7
48496,Skali,stormrage,672,warlock,destruction,18,7,11
48497,Smallpee,kazzak,672,warlock,destruction,18,7,11
48498,Геоматика,gordunni,672,warlock,destruction,18,7,11
48499,Argenus,khazgoroth,672,warlock,destruction,18,7,11
48500,Mocfernando,ravencrest,672,warlock,destruction,18,7,11
48501,Mewarlock,bronze-dragonflight,672,warlock,destruction,18,7,11
48502,Topmodelx,eredar,672,warlock,destruction,18,7,11
48503,Lêxia,shattrath,672,warlock,destruction,18,7,11
48504,Haedri,kazzak,672,warlock,destruction,18,7,11
48505,Apokalyps,eldrethalas,672,warlock,destruction,18,7,11
48506,Локизло,gordunni,672,warlock,destruction,18,7,11
48507,Milfhaunter,aegwynn,672,warlock,destruction,18,7,11
48508,Chromagnus,drakthul,672,warlock,destruction,18,7,11
48509,Belakh,draenor,672,warlock,destruction,18,7,11
48510,Hædês,antonidas,672,warlock,destruction,18,7,11
48511,Haccu,ragnaros,672,warlock,destruction,18,7,11
48512,Mixu,hakkar,672,warlock,destruction,21,8,13
48513,Marripa,sanguino,672,warlock,destruction,24,7,17
48514,Spikemasterd,doomhammer,672,warlock,destruction,24,7,17
48515,Barbyqueue,kazzak,671,warlock,destruction,10,8,2
48516,Amadéth,twisting-nether,671,warlock,destruction,12,7,5
48517,Baladas,nemesis,671,warlock,destruction,12,7,5
48518,Hampter,blackmoore,671,warlock,destruction,12,7,5
48519,Skitless,blackmoore,671,warlock,destruction,12,7,5
48520,Bkp,dun-modr,671,warlock,destruction,12,7,5
48521,Saadq,draenor,671,warlock,destruction,12,7,5
48522,Xlara,argent-dawn,671,warlock,destruction,12,7,5
48523,Zaruman,turalyon,671,warlock,destruction,12,7,5
48524,Quebone,tarren-mill,671,warlock,destruction,12,7,5
48525,Afflicted,trollbane,671,warlock,destruction,12,7,5
48526,Poulebar,ysondre,671,warlock,destruction,12,7,5
48527,Cømps,blackrock,671,warlock,destruction,12,7,5
48528,Fireburner,der-mithrilorden,671,warlock,destruction,12,7,5
48529,Drexo,drakthul,671,warlock,destruction,12,7,5
48530,Regularbag,ravencrest,671,warlock,destruction,12,7,5
48531,Raddock,ysondre,671,warlock,destruction,12,7,5
48532,Fauxshow,ravencrest,671,warlock,destruction,12,7,5
48533,Mystereo,bloodscalp,671,warlock,destruction,12,7,5
48534,Zillinzy,frostmane,671,warlock,destruction,12,7,5
48535,Leídernein,blutkessel,671,warlock,destruction,18,7,11
48536,Tce,ravencrest,671,warlock,destruction,18,7,11
48537,Vengidotcom,outland,671,warlock,destruction,18,7,11
48538,Nexpoze,drakthul,671,warlock,destruction,18,7,11
48539,Ziloc,silvermoon,671,warlock,destruction,18,7,11
48540,Гнумосятина,booty-bay,671,warlock,destruction,18,7,11
48541,Cancerdotcom,kazzak,671,warlock,destruction,18,7,11
48542,Kàiser,sanguino,671,warlock,destruction,23,7,16
48543,Eriken,tarren-mill,671,warlock,destruction,24,7,17
48544,Нафлэпил,gordunni,670,warlock,destruction,12,7,5
48545,Qloss,burning-legion,670,warlock,destruction,12,7,5
48546,Зародыш,razuvious,670,warlock,destruction,18,7,11
48547,Mângo,thunderhorn,669,warlock,destruction,12,7,5
48548,Samigina,argent-dawn,669,warlock,destruction,24,7,17
48549,Sheshii,argent-dawn,669,warlock,destruction,24,7,17
48550,Mortori,tarren-mill,668,warlock,destruction,12,7,5
48551,Сатаната,deepholm,668,warlock,destruction,12,7,5
48552,Подликерная,howling-fjord,668,warlock,destruction,12,7,5
48553,Hodille,argent-dawn,668,warlock,destruction,18,7,11
48554,Мракодел,deathguard,668,warlock,destruction,18,7,11
48555,Buzztoon,doomhammer,668,warlock,destruction,24,7,17
48556,Johntrabolta,chogall,667,warlock,destruction,12,7,5
48557,Vladlevad,argent-dawn,667,warlock,destruction,12,7,5
48558,Garbagebarge,krasus,666,warlock,destruction,12,7,5
48559,Bësly,khaz-modan,665,warlock,destruction,12,7,5
48560,Lefttorot,garrosh,665,warlock,destruction,16,8,8
48561,Мааверш,soulflayer,665,warlock,destruction,24,7,17
48562,Ахпорбес,gordunni,661,warlock,destruction,12,7,5
48563,Destri,blackmoore,660,warlock,destruction,12,7,5
48564,Janneraut,terokkar,660,warlock,destruction,18,7,11
48565,Dorothy,steamwheedle-cartel,658,warlock,destruction,12,7,5
48566,Vinet,burning-legion,657,warlock,destruction,12,7,5
48567,Bowhite,silvermoon,655,warlock,destruction,15,8,7
48568,Alsseharr,blackhand,623,warlock,destruction,11,7,4
48569,Tydra,die-aldor,618,warlock,destruction,20,8,12
48570,Garimberas,silvermoon,618,warlock,destruction,20,8,12
48571,Delen,ravencrest,608,warlock,destruction,16,7,9
48572,Würrzag,kazzak,607,warlock,destruction,11,7,4
48573,Érunali,archimonde,607,warlock,destruction,11,7,4
48574,Shadowppl,outland,606,warlock,destruction,20,7,13
48575,Krokator,draenor,605,warlock,destruction,11,7,4
48576,Какойтолок,blackscar,591,warlock,destruction,13,7,6
48577,Lomis,wrathbringer,588,warlock,destruction,19,7,12
48578,Bedep,sanguino,576,warlock,destruction,6,6,0
48579,Sinofbum,stormscale,576,warlock,destruction,6,6,0
48580,Hibachi,twisting-nether,576,warlock,destruction,6,6,0
48581,Sulnar,burning-legion,576,warlock,destruction,6,6,0
48582,Whaii,ravencrest,576,warlock,destruction,6,6,0
48583,Solosuperr,ravencrest,576,warlock,destruction,6,6,0
48584,Cafardcancer,archimonde,576,warlock,destruction,6,6,0
48585,Dahisx,ravencrest,576,warlock,destruction,6,6,0
48586,Baked,outland,576,warlock,destruction,6,6,0
48587,Nighttusk,burning-legion,576,warlock,destruction,6,6,0
48588,Popecandy,archimonde,576,warlock,destruction,6,6,0
48589,Felgibson,destromath,576,warlock,destruction,6,6,0
48590,Xute,ragnaros,576,warlock,destruction,6,6,0
48591,Adellaragg,draenor,576,warlock,destruction,6,6,0
48592,Agonymaster,twisting-nether,576,warlock,destruction,6,6,0
48593,Skuvee,archimonde,576,warlock,destruction,6,6,0
48594,Ceryss,argent-dawn,576,warlock,destruction,6,6,0
48595,Дуэлистка,soulflayer,576,warlock,destruction,6,6,0
48596,Menescurse,blackhand,576,warlock,destruction,6,6,0
48597,Zìì,silvermoon,576,warlock,destruction,6,6,0
48598,Greeylock,blackhand,576,warlock,destruction,6,6,0
48599,Kennyfõx,ysondre,576,warlock,destruction,6,6,0
48600,Zevranøss,dalaran,576,warlock,destruction,6,6,0
48601,Yamadea,stormscale,576,warlock,destruction,6,6,0
48602,Klaier,dun-modr,576,warlock,destruction,9,7,2
48603,Silenozz,ragnaros,576,warlock,destruction,12,6,6
48604,Noobtamer,kazzak,576,warlock,destruction,12,6,6
48605,Maevax,stormscale,576,warlock,destruction,12,6,6
48606,Avoidsun,kazzak,576,warlock,destruction,12,6,6
48607,Irukandji,chants-éternels,576,warlock,destruction,12,6,6
48608,Boltyboi,chamber-of-aspects,576,warlock,destruction,12,6,6
48609,Tøtøf,sargeras,576,warlock,destruction,12,6,6
48610,Tropìcal,grim-batol,576,warlock,destruction,12,6,6
48611,Chaostrain,sylvanas,576,warlock,destruction,12,6,6
48612,Voidstim,stormscale,576,warlock,destruction,12,6,6
48613,Mothor,blackrock,576,warlock,destruction,12,6,6
48614,Erimdur,sanguino,576,warlock,destruction,12,6,6
48615,Koramu,blackrock,576,warlock,destruction,12,6,6
48616,Jjejo,ragnaros,576,warlock,destruction,12,6,6
48617,Herador,draenor,576,warlock,destruction,12,6,6
48618,Mayden,uldum,576,warlock,destruction,12,6,6
48619,Депрессыш,gordunni,576,warlock,destruction,12,6,6
48620,Hasigome,blackmoore,576,warlock,destruction,12,6,6
48621,Issyl,kazzak,576,warlock,destruction,12,6,6
48622,Fearbót,kazzak,576,warlock,destruction,12,6,6
48623,Ðåñtåy,ravencrest,576,warlock,destruction,12,6,6
48624,Felrazer,silvermoon,576,warlock,destruction,12,6,6
48625,Forgepower,ghostlands,576,warlock,destruction,12,6,6
48626,Bitshlog,draenor,576,warlock,destruction,12,6,6
48627,Seya,azuremyst,576,warlock,destruction,12,6,6
48628,Ralyz,archimonde,576,warlock,destruction,12,6,6
48629,Sécret,blackmoore,576,warlock,destruction,12,6,6
48630,Cokelight,thrall,576,warlock,destruction,12,6,6
48631,Gatewatcher,argent-dawn,576,warlock,destruction,12,6,6
48632,Chafir,kazzak,576,warlock,destruction,12,6,6
48633,Embercurse,ravencrest,576,warlock,destruction,12,6,6
48634,Teemzen,tarren-mill,576,warlock,destruction,12,6,6
48635,Staudi,eredar,576,warlock,destruction,12,6,6
48636,Goosebumps,aggramar,576,warlock,destruction,12,6,6
48637,Slonertw,ragnaros,576,warlock,destruction,12,6,6
48638,Shlipshlap,ravencrest,576,warlock,destruction,12,6,6
48639,Nutopia,stormreaver,576,warlock,destruction,12,6,6
48640,Edgyrpname,argent-dawn,576,warlock,destruction,12,6,6
48641,Rylewl,draenor,576,warlock,destruction,12,6,6
48642,Laanik,twisting-nether,576,warlock,destruction,12,6,6
48643,Diabolics,twisting-nether,576,warlock,destruction,12,6,6
48644,Мерзея,soulflayer,576,warlock,destruction,12,6,6
48645,Mosslock,silvermoon,576,warlock,destruction,12,6,6
48646,Petitcayou,archimonde,576,warlock,destruction,12,6,6
48647,Mozo,stormscale,576,warlock,destruction,12,6,6
48648,Súícìdèbøy,colinas-pardas,576,warlock,destruction,12,6,6
48649,Ilikebolts,blackmoore,576,warlock,destruction,12,6,6
48650,Liwerno,dunemaul,576,warlock,destruction,12,6,6
48651,Cali,ahnqiraj,576,warlock,destruction,12,6,6
48652,Drainforlife,blackrock,576,warlock,destruction,12,6,6
48653,Jasdemonly,stormscale,576,warlock,destruction,12,6,6
48654,Bountyqt,outland,576,warlock,destruction,12,6,6
48655,Jazggzkekw,twisting-nether,576,warlock,destruction,12,6,6
48656,Chaudor,archimonde,576,warlock,destruction,12,6,6
48657,Enaio,mannoroth,576,warlock,destruction,12,6,6
48658,Dmnw,antonidas,576,warlock,destruction,12,6,6
48659,Ðuß,nemesis,576,warlock,destruction,12,6,6
48660,Warlockxx,ravencrest,576,warlock,destruction,12,6,6
48661,Aranax,thrall,576,warlock,destruction,12,6,6
48662,Ooze,kazzak,576,warlock,destruction,12,6,6
48663,Ðiavel,kazzak,576,warlock,destruction,12,6,6
48664,Kukkojapallo,ravencrest,576,warlock,destruction,12,6,6
48665,Нежныйафлик,gordunni,576,warlock,destruction,12,6,6
48666,Ilovethena,hyjal,576,warlock,destruction,12,6,6
48667,Krebares,draenor,576,warlock,destruction,12,6,6
48668,Warlockyo,blackrock,576,warlock,destruction,12,6,6
48669,Gangleader,ravencrest,576,warlock,destruction,12,6,6
48670,Спанчгэри,soulflayer,576,warlock,destruction,15,7,8
48671,Телкадрейнх,gordunni,576,warlock,destruction,15,7,8
48672,Azmondan,ahnqiraj,576,warlock,destruction,18,6,12
48673,Kriemias,malygos,576,warlock,destruction,18,6,12
48674,Naitix,argent-dawn,576,warlock,destruction,18,6,12
48675,Icq,ravencrest,576,warlock,destruction,18,6,12
48676,Zartax,kazzak,576,warlock,destruction,18,6,12
48677,Pämppää,stormscale,576,warlock,destruction,18,6,12
48678,Morwëk,ysondre,576,warlock,destruction,18,6,12
48679,Alexcurse,draenor,576,warlock,destruction,18,6,12
48680,Tartaros,bronzebeard,576,warlock,destruction,18,6,12
48681,Zerx,malganis,576,warlock,destruction,18,6,12
48682,Shreedlock,blackmoore,576,warlock,destruction,18,6,12
48683,Мглавечная,soulflayer,576,warlock,destruction,25,6,19
48684,Huaraches,stormscale,575,warlock,destruction,12,6,6
48685,Brarvile,zuljin,575,warlock,destruction,12,6,6
48686,Sweetfire,ragnaros,575,warlock,destruction,12,6,6
48687,Warlockzor,auchindoun,575,warlock,destruction,12,6,6
48688,Swagzz,silvermoon,575,warlock,destruction,12,6,6
48689,Yumala,frostmourne,575,warlock,destruction,12,6,6
48690,Lisànna,nemesis,575,warlock,destruction,12,6,6
48691,Dottad,silvermoon,575,warlock,destruction,12,6,6
48692,Rhaznor,frostwolf,575,warlock,destruction,12,6,6
48693,Cocottee,la-croisade-écarlate,575,warlock,destruction,12,6,6
48694,Дракшара,soulflayer,575,warlock,destruction,12,6,6
48695,Zevil,emerald-dream,575,warlock,destruction,12,6,6
48696,Nemssy,dun-modr,575,warlock,destruction,18,6,12
48697,Mÿxin,blackhand,575,warlock,destruction,18,6,12
48698,Ramurox,rexxar,575,warlock,destruction,18,6,12
48699,Klone,die-todeskrallen,575,warlock,destruction,18,6,12
48700,Евнухоидизм,gordunni,575,warlock,destruction,18,6,12
48701,Yasagoth,chamber-of-aspects,575,warlock,destruction,24,6,18
48702,Pederlock,defias-brotherhood,575,warlock,destruction,24,6,18
48703,Tommies,die-nachtwache,574,warlock,destruction,12,6,6
48704,Ванфирмен,gordunni,574,warlock,destruction,12,6,6
48705,Валак,greymane,574,warlock,destruction,15,7,8
48706,Haysang,khaz-modan,574,warlock,destruction,18,6,12
48707,Nathgar,drakthul,574,warlock,destruction,18,6,12
48708,Taxalias,draenor,572,warlock,destruction,12,6,6
48709,Sitosa,todeswache,572,warlock,destruction,12,6,6
48710,Nizha,sanguino,566,warlock,destruction,12,6,6
48711,Олимта,blackscar,558,warlock,destruction,23,6,17
48712,Weexi,kazzak,543,warlock,destruction,8,7,1
48713,Hasábqtja,ragnaros,543,warlock,destruction,11,6,5
48714,Amakusa,archimonde,543,warlock,destruction,16,6,10
48715,Srbritoboy,burning-legion,540,warlock,destruction,11,6,5
48716,Rozn,ravencrest,527,warlock,destruction,11,6,5
48717,Стафилокок,deepholm,527,warlock,destruction,11,6,5
48718,Tarhatar,tarren-mill,527,warlock,destruction,11,6,5
48719,Yasa,khaz-modan,526,warlock,destruction,23,6,17
48720,Брузир,gordunni,522,warlock,destruction,15,7,8
48721,Тива,lich-king,522,warlock,destruction,21,7,14
48722,Llilithh,draenor,511,warlock,destruction,10,6,4
48723,Wanhëda,tarren-mill,511,warlock,destruction,11,6,5
48724,Evilhippie,kazzak,511,warlock,destruction,11,6,5
48725,Diddia,malganis,511,warlock,destruction,11,6,5
48726,Baxiaz,kazzak,511,warlock,destruction,11,6,5
48727,Noskillclass,stormscale,511,warlock,destruction,14,6,8
48728,Watchlock,burning-legion,488,warlock,destruction,19,6,13
48729,Doomdog,hyjal,480,warlock,destruction,6,5,1
48730,Saganelle,hyjal,480,warlock,destruction,6,5,1
48731,Mellown,blackrock,480,warlock,destruction,6,5,1
48732,Hotdogvendor,kazzak,480,warlock,destruction,6,5,1
48733,Verminosiss,stormscale,480,warlock,destruction,6,5,1
48734,Failtráin,blackhand,480,warlock,destruction,6,5,1
48735,Ionesdot,ravencrest,480,warlock,destruction,6,5,1
48736,Sep,aegwynn,480,warlock,destruction,6,5,1
48737,Sumstone,kazzak,480,warlock,destruction,6,5,1
48738,Yzzie,drakthul,480,warlock,destruction,6,5,1
48739,Xeró,quelthalas,480,warlock,destruction,6,5,1
48740,Destrodmitri,blackmoore,480,warlock,destruction,6,5,1
48741,Höfmänn,grim-batol,480,warlock,destruction,6,5,1
48742,Nerdlockx,tarren-mill,480,warlock,destruction,6,5,1
48743,Журанайсбой,blackscar,480,warlock,destruction,6,5,1
48744,Sgaitxd,ravencrest,480,warlock,destruction,6,5,1
48745,Fearpuss,dun-modr,480,warlock,destruction,6,5,1
48746,Sgait,ravencrest,480,warlock,destruction,6,5,1
48747,Zurael,mannoroth,480,warlock,destruction,6,5,1
48748,Lyndi,nerathor,480,warlock,destruction,6,5,1
48749,Demonmilf,ysondre,480,warlock,destruction,6,5,1
48750,Chibbe,twisting-nether,480,warlock,destruction,6,5,1
48751,Avadakèdavra,kazzak,480,warlock,destruction,6,5,1
48752,ßualock,sylvanas,480,warlock,destruction,6,5,1
48753,Lazytown,silvermoon,480,warlock,destruction,6,5,1
48754,Disgraced,stormscale,480,warlock,destruction,6,5,1
48755,Sizezero,tarren-mill,480,warlock,destruction,6,5,1
48756,Buffdemolock,executus,480,warlock,destruction,6,5,1
48757,Файрусх,soulflayer,480,warlock,destruction,6,5,1
48758,Shoøt,dalaran,480,warlock,destruction,6,5,1
48759,Kevinbolter,kult-der-verdammten,480,warlock,destruction,6,5,1
48760,Селфдестракт,howling-fjord,480,warlock,destruction,6,5,1
48761,Djløckgødx,ravencrest,480,warlock,destruction,6,5,1
48762,Levinbrz,ravencrest,480,warlock,destruction,6,5,1
48763,Sénsemann,madmortem,480,warlock,destruction,6,5,1
48764,Beltazhor,kazzak,480,warlock,destruction,6,5,1
48765,Xtasyslock,archimonde,480,warlock,destruction,6,5,1
48766,Lísbeth,sylvanas,480,warlock,destruction,6,5,1
48767,Asreaël,uldum,480,warlock,destruction,6,5,1
48768,Kirtaçh,dun-modr,480,warlock,destruction,6,5,1
48769,Garbrandt,tarren-mill,480,warlock,destruction,6,5,1
48770,Darkbasilet,hyjal,480,warlock,destruction,6,5,1
48771,Måracujå,kazzak,480,warlock,destruction,6,5,1
48772,Mazuto,outland,480,warlock,destruction,6,5,1
48773,Djolagourde,archimonde,480,warlock,destruction,6,5,1
48774,Hinsu,the-maelstrom,480,warlock,destruction,6,5,1
48775,Náwwk,blackmoore,480,warlock,destruction,6,5,1
48776,Bánánbánd,draenor,480,warlock,destruction,6,5,1
48777,Luccifer,ravencrest,480,warlock,destruction,6,5,1
48778,Jûnkz,ysondre,480,warlock,destruction,6,5,1
48779,Altfdrölf,blackhand,480,warlock,destruction,6,5,1
48780,Hydock,twisting-nether,480,warlock,destruction,6,5,1
48781,Sâlty,stormscale,480,warlock,destruction,6,5,1
48782,Севербрянск,soulflayer,480,warlock,destruction,6,5,1
48783,Ashid,chamber-of-aspects,480,warlock,destruction,6,5,1
48784,Ампе,blackscar,480,warlock,destruction,6,5,1
48785,Андаинг,soulflayer,480,warlock,destruction,6,5,1
48786,Hargart,ysondre,480,warlock,destruction,6,5,1
48787,Хэлласс,blackscar,480,warlock,destruction,6,5,1
48788,Hannens,blackrock,480,warlock,destruction,6,5,1
48789,Mannemus,tarren-mill,480,warlock,destruction,6,5,1
48790,Dogbolt,stormscale,480,warlock,destruction,6,5,1
48791,Vyku,burning-legion,480,warlock,destruction,12,5,7
48792,Graveshaker,quelthalas,480,warlock,destruction,12,5,7
48793,Axapnon,ragnaros,480,warlock,destruction,12,5,7
48794,Phántom,frostmane,480,warlock,destruction,12,5,7
48795,Rikudoua,malfurion,480,warlock,destruction,12,5,7
48796,Sadisticlól,burning-legion,480,warlock,destruction,12,5,7
48797,Boohyakka,tarren-mill,480,warlock,destruction,12,5,7
48798,Zerozwolf,tarren-mill,480,warlock,destruction,12,5,7
48799,Käristäjä,outland,480,warlock,destruction,12,5,7
48800,Sidius,archimonde,480,warlock,destruction,12,5,7
48801,Yokûjin,twisting-nether,480,warlock,destruction,12,5,7
48802,Ratnu,ragnaros,480,warlock,destruction,12,5,7
48803,Facépalm,draenor,480,warlock,destruction,12,5,7
48804,Toutseul,eitrigg,480,warlock,destruction,12,5,7
48805,Kimwexler,ravencrest,480,warlock,destruction,12,5,7
48806,Pewmlock,antonidas,480,warlock,destruction,12,5,7
48807,Sokyra,tarren-mill,480,warlock,destruction,12,5,7
48808,Pliagaa,drakthul,480,warlock,destruction,12,5,7
48809,Arthesia,archimonde,480,warlock,destruction,12,5,7
48810,Icony,blackhand,480,warlock,destruction,12,5,7
48811,Zeanort,zuljin,480,warlock,destruction,12,5,7
48812,Tiwtera,draenor,480,warlock,destruction,12,5,7
48813,Branduir,ragnaros,480,warlock,destruction,12,5,7
48814,Динодотз,howling-fjord,480,warlock,destruction,12,5,7
48815,Fluxlight,frostmourne,480,warlock,destruction,12,5,7
48816,Cerberus,anetheron,480,warlock,destruction,12,5,7
48817,Feardotfive,frostwolf,480,warlock,destruction,12,5,7
48818,Cursè,stormscale,480,warlock,destruction,12,5,7
48819,Меркус,howling-fjord,480,warlock,destruction,12,5,7
48820,Snoreghast,tarren-mill,480,warlock,destruction,12,5,7
48821,Bricktot,ragnaros,480,warlock,destruction,12,5,7
48822,Кайдзуки,howling-fjord,480,warlock,destruction,12,5,7
48823,Braegnok,ravencrest,480,warlock,destruction,12,5,7
48824,Nefalya,hyjal,480,warlock,destruction,12,5,7
48825,Corruptcoil,argent-dawn,480,warlock,destruction,12,5,7
48826,Lyleath,ravencrest,480,warlock,destruction,12,5,7
48827,Thorky,blackrock,480,warlock,destruction,12,5,7
48828,Asper,ragnaros,480,warlock,destruction,12,5,7
48829,Crokorc,ysondre,480,warlock,destruction,12,5,7
48830,Yeluna,alleria,480,warlock,destruction,12,5,7
48831,Kontanthjælp,tarren-mill,480,warlock,destruction,12,5,7
48832,Bajsibyx,tarren-mill,480,warlock,destruction,12,5,7
48833,Elmetro,ragnaros,480,warlock,destruction,12,5,7
48834,Dabolt,archimonde,480,warlock,destruction,12,5,7
48835,Southyx,stormscale,480,warlock,destruction,12,5,7
48836,Zlok,silvermoon,480,warlock,destruction,12,5,7
48837,Zêngâ,kazzak,480,warlock,destruction,12,5,7
48838,Shadowscurse,sylvanas,480,warlock,destruction,12,5,7
48839,Claralock,silvermoon,480,warlock,destruction,12,5,7
48840,Жижакабра,soulflayer,480,warlock,destruction,12,5,7
48841,Вериберри,gordunni,480,warlock,destruction,12,5,7
48842,Infïnitýx,silvermoon,480,warlock,destruction,12,5,7
48843,Danzil,silvermoon,480,warlock,destruction,12,5,7
48844,Voodooskull,kazzak,480,warlock,destruction,12,5,7
48845,Rhev,trollbane,480,warlock,destruction,14,5,9
48846,Händerå,ragnaros,480,warlock,destruction,18,5,13
48847,Lockned,outland,480,warlock,destruction,18,5,13
48848,Maledictio,blackrock,480,warlock,destruction,18,5,13
48849,Infectius,kazzak,480,warlock,destruction,18,5,13
48850,Fujiitøra,ysondre,479,warlock,destruction,9,5,4
48851,Сенсация,ashenvale,479,warlock,destruction,12,5,7
48852,Rumpelelse,blackrock,479,warlock,destruction,12,5,7
48853,Kokonix,defias-brotherhood,479,warlock,destruction,12,5,7
48854,Archélion,silvermoon,479,warlock,destruction,12,5,7
48855,Chaosboltfm,silvermoon,479,warlock,destruction,17,5,12
48856,Intina,dragonblight,479,warlock,destruction,18,5,13
48857,Bope,the-maelstrom,479,warlock,destruction,18,5,13
48858,Yenkorov,blackmoore,479,warlock,destruction,18,5,13
48859,Fesse,draenor,479,warlock,destruction,18,5,13
48860,Слававдвх,blackscar,478,warlock,destruction,6,5,1
48861,Лавамес,eversong,478,warlock,destruction,10,6,4
48862,Soulsdeads,sylvanas,478,warlock,destruction,12,5,7
48863,Yourdeaath,ravencrest,478,warlock,destruction,18,5,13
48864,Safirae,blackmoore,478,warlock,destruction,19,5,14
48865,Espilocka,dun-modr,477,warlock,destruction,6,5,1
48866,Grumrah,argent-dawn,468,warlock,destruction,30,10,20
48867,Helikopter,shattered-hand,463,warlock,destruction,12,6,6
48868,Góblér,blackrock,463,warlock,destruction,11,5,6
48869,Снчч,soulflayer,463,warlock,destruction,11,5,6
48870,Lokicica,karazhan,463,warlock,destruction,17,5,12
48871,Winterx,argent-dawn,447,warlock,destruction,11,5,6
48872,Favris,antonidas,447,warlock,destruction,11,5,6
48873,Hahahahah,draenor,447,warlock,destruction,11,5,6
48874,Даркинсоул,soulflayer,432,warlock,destruction,9,6,3
48875,Силксонг,soulflayer,431,warlock,destruction,11,5,6
48876,Chornota,ravencrest,431,warlock,destruction,17,5,12
48877,Cooldowns,ravencrest,424,warlock,destruction,19,7,12
48878,Skadz,blackmoore,416,warlock,destruction,10,5,5
48879,Hønneyjckk,hyjal,415,warlock,destruction,8,5,3
48880,Fearylia,aegwynn,393,warlock,destruction,11,8,3
48881,Hirasawa,archimonde,384,warlock,destruction,6,4,2
48882,Zéik,archimonde,384,warlock,destruction,6,4,2
48883,Spacecarry,archimonde,384,warlock,destruction,6,4,2
48884,Ineri,hyjal,384,warlock,destruction,6,4,2
48885,Azae,outland,384,warlock,destruction,6,4,2
48886,Anyfears,outland,384,warlock,destruction,6,4,2
48887,Raddikal,archimonde,384,warlock,destruction,6,4,2
48888,Voídzero,hyjal,384,warlock,destruction,6,4,2
48889,Nilsa,eredar,384,warlock,destruction,6,4,2
48890,Onyw,onyxia,384,warlock,destruction,6,4,2
48891,Kankbae,stormscale,384,warlock,destruction,6,4,2
48892,Gemja,onyxia,384,warlock,destruction,6,4,2
48893,Dübêl,gorgonnash,384,warlock,destruction,6,4,2
48894,Nosferatia,kult-der-verdammten,384,warlock,destruction,6,4,2
48895,Mcdotnálds,thrall,384,warlock,destruction,6,4,2
48896,Cokkà,dalaran,384,warlock,destruction,6,4,2
48897,Ez,frostmane,384,warlock,destruction,6,4,2
48898,Døxz,blackrock,384,warlock,destruction,6,4,2
48899,Shaarak,blackrock,384,warlock,destruction,6,4,2
48900,Shindubelore,aggra-português,384,warlock,destruction,6,4,2
48901,Darklobos,aggra-português,384,warlock,destruction,6,4,2
48902,Schluépfêr,blackrock,384,warlock,destruction,6,4,2
48903,Vae,doomhammer,384,warlock,destruction,6,4,2
48904,Äri,blackmoore,384,warlock,destruction,6,4,2
48905,Ðotbot,grim-batol,384,warlock,destruction,6,4,2
48906,Hiloqtlock,blackmoore,384,warlock,destruction,6,4,2
48907,Fatbaldold,ravencrest,384,warlock,destruction,6,4,2
48908,Sêro,aegwynn,384,warlock,destruction,6,4,2
48909,Bwc,aegwynn,384,warlock,destruction,6,4,2
48910,Feyreah,blackmoore,384,warlock,destruction,6,4,2
48911,Aldiac,aegwynn,384,warlock,destruction,6,4,2
48912,Xskyrov,blackmoore,384,warlock,destruction,6,4,2
48913,Острогриф,gordunni,384,warlock,destruction,6,4,2
48914,Трудзастафф,gordunni,384,warlock,destruction,6,4,2
48915,Cursier,blackmoore,384,warlock,destruction,6,4,2
48916,Анрали,soulflayer,384,warlock,destruction,6,4,2
48917,Кичи,gordunni,384,warlock,destruction,6,4,2
48918,Zzooxxie,silvermoon,384,warlock,destruction,6,4,2
48919,Dikkdickens,ravencrest,384,warlock,destruction,6,4,2
48920,Anicetus,ravencrest,384,warlock,destruction,6,4,2
48921,Mikthelock,nemesis,384,warlock,destruction,6,4,2
48922,Cappaoow,ravencrest,384,warlock,destruction,6,4,2
48923,Дыханиетени,soulflayer,384,warlock,destruction,6,4,2
48924,Sunlicht,kazzak,384,warlock,destruction,6,4,2
48925,Penorr,silvermoon,384,warlock,destruction,6,4,2
48926,Unfeared,blackhand,384,warlock,destruction,6,4,2
48927,Xenastro,silvermoon,384,warlock,destruction,6,4,2
48928,Taon,ravencrest,384,warlock,destruction,6,4,2
48929,Rngmåchinêx,ravencrest,384,warlock,destruction,6,4,2
48930,Yifu,ravencrest,384,warlock,destruction,6,4,2
48931,Cadrega,nemesis,384,warlock,destruction,6,4,2
48932,Darkwìngduck,ravencrest,384,warlock,destruction,6,4,2
48933,Drshegs,darkspear,384,warlock,destruction,6,4,2
48934,Droguri,darkspear,384,warlock,destruction,6,4,2
48935,Destroylol,draenor,384,warlock,destruction,6,4,2
48936,Egiriefo,twisting-nether,384,warlock,destruction,6,4,2
48937,Malthiria,silvermoon,384,warlock,destruction,6,4,2
48938,Iulu,sylvanas,384,warlock,destruction,6,4,2
48939,Xolìe,azshara,384,warlock,destruction,6,4,2
48940,Jägerlock,draenor,384,warlock,destruction,6,4,2
48941,Dashirø,drakthul,384,warlock,destruction,6,4,2
48942,Zexan,drakthul,384,warlock,destruction,6,4,2
48943,Nechli,malganis,384,warlock,destruction,6,4,2
48944,Vêzor,twisting-nether,384,warlock,destruction,6,4,2
48945,Shreklock,burning-blade,384,warlock,destruction,6,4,2
48946,Sïlïthuss,ravencrest,384,warlock,destruction,6,4,2
48947,Sfwicked,tarren-mill,384,warlock,destruction,6,4,2
48948,Côr,twisting-nether,384,warlock,destruction,6,4,2
48949,Pujatia,tarren-mill,384,warlock,destruction,6,4,2
48950,Dotritos,tarren-mill,384,warlock,destruction,6,4,2
48951,Skâald,senjin,384,warlock,destruction,6,4,2
48952,Elayjalock,twisting-nether,384,warlock,destruction,6,4,2
48953,Boltsofdoom,kazzak,384,warlock,destruction,6,4,2
48954,Пчелокнижник,howling-fjord,384,warlock,destruction,6,4,2
48955,Pantry,tarren-mill,384,warlock,destruction,6,4,2
48956,Bellatrìxx,madmortem,384,warlock,destruction,6,4,2
48957,Ðênnis,tarren-mill,384,warlock,destruction,6,4,2
48958,Критокнижник,lich-king,384,warlock,destruction,6,4,2
48959,Uqrlock,twisting-nether,384,warlock,destruction,6,4,2
48960,Deathmahed,kazzak,384,warlock,destruction,6,4,2
48961,Grixius,argent-dawn,384,warlock,destruction,6,4,2
48962,Warchilly,twisting-nether,384,warlock,destruction,6,4,2
48963,Blyskawicar,silvermoon,384,warlock,destruction,6,4,2
48964,Хелентесс,goldrinn,384,warlock,destruction,6,4,2
48965,Auchaos,argent-dawn,384,warlock,destruction,6,4,2
48966,Nãshor,kazzak,384,warlock,destruction,6,4,2
48967,Fearlólz,stormscale,384,warlock,destruction,6,4,2
48968,Zilthon,dragonblight,384,warlock,destruction,6,4,2
48969,Элнуар,soulflayer,384,warlock,destruction,6,4,2
48970,Watchmecut,terenas,384,warlock,destruction,6,4,2
48971,Siyaa,eredar,384,warlock,destruction,6,4,2
48972,Чернаяскала,howling-fjord,384,warlock,destruction,6,4,2
48973,Notloveless,stormscale,384,warlock,destruction,6,4,2
48974,Apeliction,eredar,384,warlock,destruction,6,4,2
48975,Krekk,ragnaros,384,warlock,destruction,6,4,2
48976,Biihz,ysondre,384,warlock,destruction,6,4,2
48977,Dampini,ravencrest,384,warlock,destruction,6,4,2
48978,Suicidekings,draenor,384,warlock,destruction,6,4,2
48979,Déemón,draenor,384,warlock,destruction,6,4,2
48980,Rayfears,draenor,384,warlock,destruction,6,4,2
48981,Candleburner,khaz-modan,384,warlock,destruction,6,4,2
48982,Traickolock,antonidas,384,warlock,destruction,6,4,2
48983,Cräwley,ragnaros,384,warlock,destruction,6,4,2
48984,Born,ravencrest,384,warlock,destruction,6,4,2
48985,Ahylleslook,antonidas,384,warlock,destruction,6,4,2
48986,Harrydóttár,draenor,384,warlock,destruction,6,4,2
48987,Mèsmerize,tarren-mill,384,warlock,destruction,9,5,4
48988,Рыжевласочка,eversong,384,warlock,destruction,9,5,4
48989,Omnípotens,silvermoon,384,warlock,destruction,12,6,6
48990,Lockpup,draenor,384,warlock,destruction,12,4,8
48991,Ieatfel,archimonde,384,warlock,destruction,12,4,8
48992,Atúm,auchindoun,384,warlock,destruction,12,4,8
48993,Closetlock,the-maelstrom,384,warlock,destruction,12,4,8
48994,Darkmaw,drakthul,384,warlock,destruction,12,4,8
48995,Darthvder,sylvanas,384,warlock,destruction,12,4,8
48996,Lilkit,kazzak,384,warlock,destruction,12,4,8
48997,Chäös,outland,384,warlock,destruction,12,4,8
48998,Lîlu,hyjal,384,warlock,destruction,12,4,8
48999,Zvinto,the-maelstrom,384,warlock,destruction,12,4,8
49000,Waryald,dun-modr,384,warlock,destruction,12,4,8
49001,Tdoggydog,ragnaros,384,warlock,destruction,12,4,8
49002,Yandihimir,silvermoon,384,warlock,destruction,12,4,8
49003,Lünatix,archimonde,384,warlock,destruction,12,4,8
49004,Nicetime,nefarian,384,warlock,destruction,12,4,8
49005,Kaobolt,archimonde,384,warlock,destruction,12,4,8
49006,Novkan,eredar,384,warlock,destruction,12,4,8
49007,Cirihexer,area-52,384,warlock,destruction,12,4,8
49008,Марэд,howling-fjord,384,warlock,destruction,12,4,8
49009,Чиззихаос,soulflayer,384,warlock,destruction,12,4,8
49010,Бешентумай,goldrinn,384,warlock,destruction,12,4,8
49011,Vanskor,argent-dawn,384,warlock,destruction,12,4,8
49012,Impvader,argent-dawn,384,warlock,destruction,12,4,8
49013,Oimera,frostwolf,384,warlock,destruction,12,4,8
49014,Roedin,tarren-mill,384,warlock,destruction,12,4,8
49015,Hheavens,ragnaros,384,warlock,destruction,12,4,8
49016,Nahamma,tarren-mill,384,warlock,destruction,12,4,8
49017,Ksenìa,khaz-modan,384,warlock,destruction,12,4,8
49018,Scheprick,twisting-nether,384,warlock,destruction,12,4,8
49019,Vextalock,drakthul,384,warlock,destruction,12,4,8
49020,Harrydotterx,alakir,384,warlock,destruction,12,4,8
49021,Andrewtaint,twisting-nether,384,warlock,destruction,12,4,8
49022,Falakros,ravencrest,384,warlock,destruction,12,4,8
49023,Legiozock,draenor,384,warlock,destruction,12,4,8
49024,Waîdo,blackhand,384,warlock,destruction,12,4,8
49025,Vsmna,ragnaros,384,warlock,destruction,12,4,8
49026,Tekron,blackhand,384,warlock,destruction,12,4,8
49027,Thigh,burning-legion,384,warlock,destruction,12,4,8
49028,Wajiggity,ravencrest,384,warlock,destruction,12,4,8
49029,Mustalol,outland,384,warlock,destruction,12,4,8
49030,Мазаффак,gordunni,384,warlock,destruction,12,4,8
49031,Hòbó,outland,384,warlock,destruction,12,4,8
49032,Gacknur,zuljin,384,warlock,destruction,12,4,8
49033,Lonestar,sanguino,384,warlock,destruction,12,4,8
49034,Лоллиторпеда,gordunni,384,warlock,destruction,12,4,8
49035,Sellinia,culte-de-la-rive-noire,384,warlock,destruction,12,4,8
49036,Axy,dun-modr,384,warlock,destruction,12,4,8
49037,Demoncius,dun-modr,384,warlock,destruction,12,4,8
49038,Tiitz,blackmoore,384,warlock,destruction,12,4,8
49039,Muninnus,archimonde,384,warlock,destruction,12,4,8
49040,Shadowflare,blackmoore,384,warlock,destruction,12,4,8
49041,Уфц,grom,384,warlock,destruction,12,4,8
49042,Стокыч,soulflayer,384,warlock,destruction,12,4,8
49043,Narstia,archimonde,384,warlock,destruction,12,4,8
49044,Nazmordith,argent-dawn,384,warlock,destruction,18,4,14
49045,Thinio,argent-dawn,384,warlock,destruction,18,4,14
49046,Korne,nemesis,384,warlock,destruction,18,4,14
49047,Okulus,quelthalas,383,warlock,destruction,6,4,2
49048,Angrynoob,silvermoon,383,warlock,destruction,6,4,2
49049,Injecter,stormscale,383,warlock,destruction,6,4,2
49050,Avel,dun-morogh,383,warlock,destruction,15,5,10
49051,Dathos,ragnaros,383,warlock,destruction,12,4,8
49052,Lagoren,draenor,383,warlock,destruction,12,4,8
49053,Olympos,draenor,383,warlock,destruction,12,4,8
49054,Orcboltz,tarren-mill,383,warlock,destruction,12,4,8
49055,Pidka,drakthul,382,warlock,destruction,6,4,2
49056,Сатари,blackscar,378,warlock,destruction,20,9,11
49057,Драуктар,eversong,365,warlock,destruction,11,4,7
49058,Tolgaa,draenor,352,warlock,destruction,17,4,13
49059,Britneyfear,aegwynn,351,warlock,destruction,8,5,3
49060,Damßalla,cthun,330,warlock,destruction,11,8,3
49061,Destroc,blackrock,330,warlock,destruction,11,5,6
49062,Рейнджр,eversong,330,warlock,destruction,15,6,9
49063,Velativ,silvermoon,330,warlock,destruction,16,5,11
49064,Lockpz,sylvanas,330,warlock,destruction,18,5,13
49065,Gomezz,dalaran,320,warlock,destruction,10,4,6
49066,Лвнг,gordunni,320,warlock,destruction,10,4,6
49067,Malganas,sylvanas,320,warlock,destruction,16,4,12
49068,Sapheâ,burning-legion,319,warlock,destruction,5,4,1
49069,Chev,nemesis,319,warlock,destruction,5,4,1
49070,Tibzx,stormscale,288,warlock,destruction,6,3,3
49071,Ghosthound,stormscale,288,warlock,destruction,6,3,3
49072,Palmtri,stormscale,288,warlock,destruction,6,3,3
49073,Marakh,stormscale,288,warlock,destruction,6,3,3
49074,Goatpuss,stormrage,288,warlock,destruction,6,3,3
49075,Hazzikosby,ravencrest,288,warlock,destruction,6,3,3
49076,Epoku,stormscale,288,warlock,destruction,6,3,3
49077,Drith,blades-edge,288,warlock,destruction,6,3,3
49078,Bestwarlock,ravencrest,288,warlock,destruction,6,3,3
49079,Neveah,festung-der-stürme,288,warlock,destruction,6,3,3
49080,Brambam,stormrage,288,warlock,destruction,6,3,3
49081,Maevex,stormscale,288,warlock,destruction,6,3,3
49082,Bribon,sanguino,288,warlock,destruction,6,3,3
49083,Vaimex,stormscale,288,warlock,destruction,6,3,3
49084,Chedipes,stormscale,288,warlock,destruction,6,3,3
49085,Belite,archimonde,288,warlock,destruction,6,3,3
49086,Rokudaime,stormscale,288,warlock,destruction,6,3,3
49087,Zabani,das-syndikat,288,warlock,destruction,6,3,3
49088,Kaîdö,archimonde,288,warlock,destruction,6,3,3
49089,Slem,aerie-peak,288,warlock,destruction,6,3,3
49090,Demonologyz,ravencrest,288,warlock,destruction,6,3,3
49091,Akdan,ragnaros,288,warlock,destruction,6,3,3
49092,Nargøf,outland,288,warlock,destruction,6,3,3
49093,Nêstêe,archimonde,288,warlock,destruction,6,3,3
49094,Hammern,haomarush,288,warlock,destruction,6,3,3
49095,Винстролман,blackscar,288,warlock,destruction,6,3,3
49096,Dekawa,ravencrest,288,warlock,destruction,6,3,3
49097,Besthun,drakthul,288,warlock,destruction,6,3,3
49098,Ðanilock,dun-modr,288,warlock,destruction,6,3,3
49099,Løvesøsa,ravencrest,288,warlock,destruction,6,3,3
49100,Lotud,drakthul,288,warlock,destruction,6,3,3
49101,Oldefar,ravencrest,288,warlock,destruction,6,3,3
49102,Рипхард,gordunni,288,warlock,destruction,6,3,3
49103,Bluh,twisting-nether,288,warlock,destruction,6,3,3
49104,Rindo,conseil-des-ombres,288,warlock,destruction,6,3,3
49105,Ascètic,kazzak,288,warlock,destruction,6,3,3
49106,Cálamity,magtheridon,288,warlock,destruction,6,3,3
49107,Gïzzmo,tarren-mill,288,warlock,destruction,6,3,3
49108,Volontáry,stormscale,288,warlock,destruction,6,3,3
49109,Arakaali,dentarg,288,warlock,destruction,6,3,3
49110,Jeepsee,outland,288,warlock,destruction,6,3,3
49111,Sleive,ravencrest,288,warlock,destruction,6,3,3
49112,Zzooxx,silvermoon,288,warlock,destruction,6,3,3
49113,Lockskalle,tarren-mill,288,warlock,destruction,6,3,3
49114,Raggnarlock,ravencrest,288,warlock,destruction,6,3,3
49115,Tschiko,blackrock,288,warlock,destruction,6,3,3
49116,Frankieboi,drakthul,288,warlock,destruction,6,3,3
49117,Widot,ravencrest,288,warlock,destruction,6,3,3
49118,Vladov,ravencrest,288,warlock,destruction,6,3,3
49119,Mentalx,outland,288,warlock,destruction,6,3,3
49120,Deamheòlas,ravencrest,288,warlock,destruction,6,3,3
49121,Флорэтт,gordunni,288,warlock,destruction,6,3,3
49122,Darkspiros,tarren-mill,288,warlock,destruction,6,3,3
49123,Aghmar,ravencrest,288,warlock,destruction,6,3,3
49124,Jiruga,blackrock,288,warlock,destruction,6,3,3
49125,Hiroyukí,frostmane,288,warlock,destruction,6,3,3
49126,Ромаколдун,howling-fjord,288,warlock,destruction,6,3,3
49127,Lamboo,tarren-mill,288,warlock,destruction,6,3,3
49128,Dragmetohêll,blackhand,288,warlock,destruction,6,3,3
49129,Amdownbad,kazzak,288,warlock,destruction,6,3,3
49130,Demónfire,sylvanas,288,warlock,destruction,6,3,3
49131,Anniemoon,silvermoon,288,warlock,destruction,6,3,3
49132,Brolter,blackhand,288,warlock,destruction,6,3,3
49133,Useidûm,ravencrest,288,warlock,destruction,6,3,3
49134,Impsgalore,ravencrest,288,warlock,destruction,6,3,3
49135,Jörd,ravencrest,288,warlock,destruction,6,3,3
49136,Truckpunch,defias-brotherhood,288,warlock,destruction,6,3,3
49137,Mightnáré,tarren-mill,288,warlock,destruction,6,3,3
49138,Исусилок,deathguard,288,warlock,destruction,6,3,3
49139,Пачимучка,gordunni,288,warlock,destruction,6,3,3
49140,Boltez,twisting-nether,288,warlock,destruction,6,3,3
49141,Pekenina,outland,288,warlock,destruction,6,3,3
49142,Vech,blackmoore,288,warlock,destruction,6,3,3
49143,Shayexen,tarren-mill,288,warlock,destruction,6,3,3
49144,Omaleinfluch,antonidas,288,warlock,destruction,6,3,3
49145,Húxy,silvermoon,288,warlock,destruction,6,3,3
49146,Yippz,kazzak,288,warlock,destruction,6,3,3
49147,Ремайка,gordunni,288,warlock,destruction,6,3,3
49148,Dexterlol,blackmoore,288,warlock,destruction,6,3,3
49149,Soulslugger,twisting-nether,288,warlock,destruction,6,3,3
49150,Silås,hyjal,288,warlock,destruction,6,3,3
49151,Toutanpapier,ysondre,288,warlock,destruction,6,3,3
49152,Elmîr,blackmoore,288,warlock,destruction,6,3,3
49153,Ruinovino,outland,288,warlock,destruction,6,3,3
49154,Дядяджонн,gordunni,288,warlock,destruction,6,3,3
49155,Celphboss,twisting-nether,288,warlock,destruction,6,3,3
49156,Maquan,blackmoore,288,warlock,destruction,6,3,3
49157,Saymore,ragnaros,288,warlock,destruction,6,3,3
49158,Brudergottes,blackmoore,288,warlock,destruction,6,3,3
49159,Ubinaz,blackmoore,288,warlock,destruction,6,3,3
49160,Fearylicious,burning-legion,288,warlock,destruction,6,3,3
49161,Seldonn,pozzo-delleternità,288,warlock,destruction,6,3,3
49162,Adreal,burning-legion,288,warlock,destruction,6,3,3
49163,Dement,sanguino,288,warlock,destruction,6,3,3
49164,Ogrez,nemesis,288,warlock,destruction,6,3,3
49165,Snowflakesxs,draenor,288,warlock,destruction,6,3,3
49166,Динодотх,gordunni,288,warlock,destruction,6,3,3
49167,Kírth,blackmoore,288,warlock,destruction,6,3,3
49168,Hairylock,outland,288,warlock,destruction,6,3,3
49169,Kradrog,nemesis,288,warlock,destruction,6,3,3
49170,Уанбаттон,gordunni,288,warlock,destruction,6,3,3
49171,Adacheezzee,tyrande,288,warlock,destruction,6,3,3
49172,Skizofrenia,zuljin,288,warlock,destruction,6,3,3
49173,Глотающий,gordunni,288,warlock,destruction,6,3,3
49174,Zozano,draenor,288,warlock,destruction,6,3,3
49175,Cpump,twisting-nether,288,warlock,destruction,6,3,3
49176,Гвадривер,howling-fjord,288,warlock,destruction,6,3,3
49177,Talt,dalaran,288,warlock,destruction,6,3,3
49178,Seyzz,eredar,288,warlock,destruction,6,3,3
49179,Nethros,ragnaros,288,warlock,destruction,6,3,3
49180,Drozhna,kaelthas,288,warlock,destruction,6,3,3
49181,Нэрфир,soulflayer,288,warlock,destruction,6,3,3
49182,Huaian,darksorrow,288,warlock,destruction,6,3,3
49183,Lokdok,draenor,288,warlock,destruction,6,3,3
49184,Djshyasiañ,perenolde,288,warlock,destruction,6,3,3
49185,Biancalawson,argent-dawn,288,warlock,destruction,6,3,3
49186,Fazol,terokkar,288,warlock,destruction,6,3,3
49187,Gharloch,argent-dawn,288,warlock,destruction,6,3,3
49188,Zizzbrah,ragnaros,288,warlock,destruction,6,3,3
49189,Dmger,twisting-nether,288,warlock,destruction,6,3,3
49190,Sodadogpìn,nemesis,288,warlock,destruction,6,3,3
49191,Læssêkøñgð,twisting-nether,288,warlock,destruction,6,3,3
49192,Некусайсасай,galakrond,288,warlock,destruction,6,3,3
49193,Jabalock,mazrigos,288,warlock,destruction,6,3,3
49194,Toskanoamani,blackmoore,288,warlock,destruction,6,3,3
49195,Kuntdotz,draenor,288,warlock,destruction,6,3,3
49196,Lubomirek,turalyon,288,warlock,destruction,6,3,3
49197,Demofox,ragnaros,288,warlock,destruction,6,3,3
49198,Aches,sylvanas,288,warlock,destruction,6,3,3
49199,Taylorg,blackmoore,288,warlock,destruction,6,3,3
49200,Данябандит,soulflayer,288,warlock,destruction,6,3,3
49201,Fearhealer,blackmoore,288,warlock,destruction,6,3,3
49202,Jazggzgirl,blackmoore,288,warlock,destruction,6,3,3
49203,Пучкова,azuregos,288,warlock,destruction,12,3,9
49204,Киёкка,howling-fjord,288,warlock,destruction,12,3,9
49205,Nímdaa,stormscale,288,warlock,destruction,12,3,9
49206,Quief,silvermoon,288,warlock,destruction,12,3,9
49207,Ladodida,darkspear,288,warlock,destruction,12,3,9
49208,Daeneerys,skullcrusher,288,warlock,destruction,12,3,9
49209,Dreadbøt,blackrock,288,warlock,destruction,12,3,9
49210,Dotzillâ,blackhand,288,warlock,destruction,12,3,9
49211,Phéar,deathwing,288,warlock,destruction,12,3,9
49212,Mitrela,ravencrest,288,warlock,destruction,12,3,9
49213,Tepelkwastje,twisting-nether,288,warlock,destruction,12,3,9
49214,Svartalfen,outland,288,warlock,destruction,12,3,9
49215,Matheus,zenedar,288,warlock,destruction,12,3,9
49216,Варикай,gordunni,288,warlock,destruction,12,3,9
49217,Jaines,forscherliga,288,warlock,destruction,12,3,9
49218,Merelock,eonar,288,warlock,destruction,12,3,9
49219,Shelbys,tyrande,288,warlock,destruction,12,3,9
49220,Valgg,tarren-mill,288,warlock,destruction,12,3,9
49221,Leatherfvce,blackmoore,288,warlock,destruction,12,3,9
49222,Voib,silvermoon,288,warlock,destruction,12,3,9
49223,Swoksáar,blackmoore,288,warlock,destruction,12,3,9
49224,Gooey,magtheridon,288,warlock,destruction,12,3,9
49225,Killerbeez,burning-blade,288,warlock,destruction,12,3,9
49226,Werlock,sanguino,288,warlock,destruction,12,3,9
49227,Xrathis,thunderhorn,288,warlock,destruction,12,3,9
49228,Адомать,lich-king,288,warlock,destruction,12,3,9
49229,Tiffyilock,blackrock,288,warlock,destruction,12,3,9
49230,Skyrender,argent-dawn,288,warlock,destruction,12,3,9
49231,Arizyoxot,twisting-nether,288,warlock,destruction,12,3,9
49232,Sebi,kirin-tor,288,warlock,destruction,12,3,9
49233,Peggybrown,turalyon,288,warlock,destruction,12,3,9
49234,Aloxer,sanguino,288,warlock,destruction,12,3,9
49235,Jaír,turalyon,288,warlock,destruction,12,3,9
49236,Нагибатель,howling-fjord,288,warlock,destruction,18,3,15
49237,Fewton,eonar,288,warlock,destruction,18,3,15
49238,Wegart,sylvanas,287,warlock,destruction,6,3,3
49239,Грашек,soulflayer,287,warlock,destruction,6,3,3
49240,Lárgo,chamber-of-aspects,271,warlock,destruction,11,3,8
49241,Dollmak,hyjal,270,warlock,destruction,11,4,7
49242,Армдэд,galakrond,255,warlock,destruction,11,3,8
49243,Absúrd,turalyon,240,warlock,destruction,9,3,6
49244,Insertchaos,draenor,239,warlock,destruction,5,3,2
49245,Brushiè,kazzak,239,warlock,destruction,5,3,2
49246,Darthdotz,outland,234,warlock,destruction,7,4,3
49247,Diemilch,blackmoore,234,warlock,destruction,8,4,4
49248,Тиранчухан,howling-fjord,234,warlock,destruction,15,4,11
49249,Sineko,twisting-nether,233,warlock,destruction,11,6,5
49250,Ðankan,aegwynn,192,warlock,destruction,4,3,1
49251,Vexsir,kazzak,192,warlock,destruction,9,3,6
49252,Vortëxx,tarren-mill,192,warlock,destruction,9,3,6
49253,Хоратхе,soulflayer,192,warlock,destruction,6,2,4
49254,Ralys,draenor,192,warlock,destruction,6,2,4
49255,Angrythots,draenor,192,warlock,destruction,6,2,4
49256,Degdeehei,draenor,192,warlock,destruction,6,2,4
49257,Майдум,soulflayer,192,warlock,destruction,6,2,4
49258,Elfex,ragnaros,192,warlock,destruction,6,2,4
49259,Haxs,ravencrest,192,warlock,destruction,6,2,4
49260,Mákas,draenor,192,warlock,destruction,6,2,4
49261,Saabnoolock,ragnaros,192,warlock,destruction,6,2,4
49262,Selur,ragnaros,192,warlock,destruction,6,2,4
49263,Sherrÿ,ragnaros,192,warlock,destruction,6,2,4
49264,Piouturass,hyjal,192,warlock,destruction,6,2,4
49265,Vextos,draenor,192,warlock,destruction,6,2,4
49266,Whórélóck,ravencrest,192,warlock,destruction,6,2,4
49267,Øupas,ysondre,192,warlock,destruction,6,2,4
49268,Cindela,eredar,192,warlock,destruction,6,2,4
49269,Tragus,ghostlands,192,warlock,destruction,6,2,4
49270,Splojf,the-maelstrom,192,warlock,destruction,6,2,4
49271,Levitibus,argent-dawn,192,warlock,destruction,6,2,4
49272,Kleing,dragonblight,192,warlock,destruction,6,2,4
49273,Шэдоубёрн,soulflayer,192,warlock,destruction,6,2,4
49274,Ðaddyy,stormscale,192,warlock,destruction,6,2,4
49275,Shuggul,draenor,192,warlock,destruction,6,2,4
49276,Meapx,ragnaros,192,warlock,destruction,6,2,4
49277,Purplehelmet,argent-dawn,192,warlock,destruction,6,2,4
49278,Nazw,ravencrest,192,warlock,destruction,6,2,4
49279,Efekentli,frostwolf,192,warlock,destruction,6,2,4
49280,Zòóf,stormscale,192,warlock,destruction,6,2,4
49281,Nasiegboch,frostwolf,192,warlock,destruction,6,2,4
49282,Ангебор,howling-fjord,192,warlock,destruction,6,2,4
49283,Zkrwl,kazzak,192,warlock,destruction,6,2,4
49284,Guldãn,silvermoon,192,warlock,destruction,6,2,4
49285,Somalidog,ravencrest,192,warlock,destruction,6,2,4
49286,Lightswitchz,ravencrest,192,warlock,destruction,6,2,4
49287,Zenaidaa,doomhammer,192,warlock,destruction,6,2,4
49288,Dinolock,antonidas,192,warlock,destruction,6,2,4
49289,Zmataryn,doomhammer,192,warlock,destruction,6,2,4
49290,Turbofamilly,hyjal,192,warlock,destruction,6,2,4
49291,Snoggä,antonidas,192,warlock,destruction,6,2,4
49292,Локеда,deathguard,192,warlock,destruction,6,2,4
49293,Kedrat,die-aldor,192,warlock,destruction,6,2,4
49294,Ainzlok,tarren-mill,192,warlock,destruction,6,2,4
49295,Caiiden,kazzak,192,warlock,destruction,6,2,4
49296,Agonux,twisting-nether,192,warlock,destruction,6,2,4
49297,Kabowie,twisting-nether,192,warlock,destruction,6,2,4
49298,Revvolt,tarren-mill,192,warlock,destruction,6,2,4
49299,Bulgyeøng,archimonde,192,warlock,destruction,6,2,4
49300,Grandulf,ravencrest,192,warlock,destruction,6,2,4
49301,Werkx,archimonde,192,warlock,destruction,6,2,4
49302,Ashhlock,silvermoon,192,warlock,destruction,6,2,4
49303,Nâzgrel,tarren-mill,192,warlock,destruction,6,2,4
49304,Prydzor,archimonde,192,warlock,destruction,6,2,4
49305,Sinlockz,tarren-mill,192,warlock,destruction,6,2,4
49306,Creamcleaner,tarren-mill,192,warlock,destruction,6,2,4
49307,Dødheim,malganis,192,warlock,destruction,6,2,4
49308,Incubith,ravencrest,192,warlock,destruction,6,2,4
49309,Wezen,stormscale,192,warlock,destruction,6,2,4
49310,Cosec,silvermoon,192,warlock,destruction,6,2,4
49311,Benztruck,blackhand,192,warlock,destruction,6,2,4
49312,Whydidudotha,ravencrest,192,warlock,destruction,6,2,4
49313,Jöhanan,twisting-nether,192,warlock,destruction,6,2,4
49314,Durátor,ravencrest,192,warlock,destruction,6,2,4
49315,Necrochiller,tarren-mill,192,warlock,destruction,6,2,4
49316,Semhein,twisting-nether,192,warlock,destruction,6,2,4
49317,Qullnius,kazzak,192,warlock,destruction,6,2,4
49318,Уставок,soulflayer,192,warlock,destruction,6,2,4
49319,Zhulthan,ravencrest,192,warlock,destruction,6,2,4
49320,Cptdotalot,tarren-mill,192,warlock,destruction,6,2,4
49321,Longchamp,stormscale,192,warlock,destruction,6,2,4
49322,Ght,outland,192,warlock,destruction,6,2,4
49323,Siìre,ravencrest,192,warlock,destruction,6,2,4
49324,Cuufi,silvermoon,192,warlock,destruction,6,2,4
49325,Necrofearz,sylvanas,192,warlock,destruction,6,2,4
49326,Rojas,trollbane,192,warlock,destruction,6,2,4
49327,Fixwarlock,blackmoore,192,warlock,destruction,6,2,4
49328,Ravendoor,grim-batol,192,warlock,destruction,6,2,4
49329,Ívânguldán,twisting-nether,192,warlock,destruction,6,2,4
49330,Locknroll,terokkar,192,warlock,destruction,6,2,4
49331,Sôshy,thrall,192,warlock,destruction,6,2,4
49332,Kemel,thrall,192,warlock,destruction,6,2,4
49333,Jaliyah,outland,192,warlock,destruction,6,2,4
49334,Nedhriix,drakthul,192,warlock,destruction,6,2,4
49335,Æyna,thrall,192,warlock,destruction,6,2,4
49336,Aváne,outland,192,warlock,destruction,6,2,4
49337,Nerflocks,aggra-português,192,warlock,destruction,6,2,4
49338,Bigusdicus,aszune,192,warlock,destruction,6,2,4
49339,Belzedan,blackrock,192,warlock,destruction,6,2,4
49340,Atomik,drakthul,192,warlock,destruction,6,2,4
49341,Grilljédén,blackrock,192,warlock,destruction,6,2,4
49342,Öhö,blackrock,192,warlock,destruction,6,2,4
49343,Laynih,blackrock,192,warlock,destruction,6,2,4
49344,Kuzimu,aerie-peak,192,warlock,destruction,6,2,4
49345,Houndread,kazzak,192,warlock,destruction,6,2,4
49346,Negoda,defias-brotherhood,192,warlock,destruction,6,2,4
49347,Astralvoid,outland,192,warlock,destruction,6,2,4
49348,Toshiku,aggra-português,192,warlock,destruction,6,2,4
49349,Sôlon,azshara,192,warlock,destruction,6,2,4
49350,Zigfipszen,blackmoore,192,warlock,destruction,6,2,4
49351,Smoulville,sanguino,192,warlock,destruction,6,2,4
49352,Chuntlock,shadowsong,192,warlock,destruction,6,2,4
49353,Guldän,quelthalas,192,warlock,destruction,6,2,4
49354,Zagana,neptulon,192,warlock,destruction,6,2,4
49355,Malfari,zuljin,192,warlock,destruction,6,2,4
49356,Merengue,uldum,192,warlock,destruction,6,2,4
49357,Prestige,nemesis,192,warlock,destruction,6,2,4
49358,Hacknator,aegwynn,192,warlock,destruction,6,2,4
49359,Faustes,alakir,192,warlock,destruction,6,2,4
49360,Lockerby,kazzak,192,warlock,destruction,6,2,4
49361,Емс,gordunni,192,warlock,destruction,6,2,4
49362,Хашонмвп,gordunni,192,warlock,destruction,6,2,4
49363,Bloodysûgar,blackmoore,192,warlock,destruction,6,2,4
49364,Thîras,tarren-mill,192,warlock,destruction,7,2,5
49365,Xjms,darksorrow,192,warlock,destruction,9,2,7
49366,Kiriforce,blackmoore,192,warlock,destruction,12,2,10
49367,Srhal,blackmoore,192,warlock,destruction,12,2,10
49368,Agathaharkne,minahonda,192,warlock,destruction,12,2,10
49369,Themits,executus,192,warlock,destruction,12,2,10
49370,Skratti,lightnings-blade,192,warlock,destruction,12,2,10
49371,Shallän,dun-modr,192,warlock,destruction,12,2,10
49372,Nimwyn,argent-dawn,192,warlock,destruction,12,2,10
49373,Punishteens,blackmoore,192,warlock,destruction,12,2,10
49374,Àbraxàs,nemesis,192,warlock,destruction,12,2,10
49375,Naginii,sanguino,192,warlock,destruction,12,2,10
49376,Kopfkissen,azshara,192,warlock,destruction,12,2,10
49377,Titoss,archimonde,192,warlock,destruction,12,2,10
49378,Amnésïa,eldrethalas,192,warlock,destruction,12,2,10
49379,Mambra,sylvanas,192,warlock,destruction,12,2,10
49380,Нэйрокризиз,howling-fjord,192,warlock,destruction,12,2,10
49381,Michtv,hyjal,192,warlock,destruction,12,2,10
49382,Sarómán,ravencrest,192,warlock,destruction,12,2,10
49383,Rafael,stormscale,192,warlock,destruction,13,2,11
49384,Zùrghan,elune,191,warlock,destruction,4,3,1
49385,Flisiakm,exodar,191,warlock,destruction,6,2,4
49386,Karjarock,hyjal,191,warlock,destruction,12,2,10
49387,Gaios,skullcrusher,191,warlock,destruction,18,2,16
49388,Lockbubs,draenor,175,warlock,destruction,11,2,9
49389,Pewnedmpx,archimonde,159,warlock,destruction,5,2,3
49390,Jiltoks,blackmoore,159,warlock,destruction,5,2,3
49391,Grimlòck,antonidas,159,warlock,destruction,5,2,3
49392,Dony,dun-morogh,159,warlock,destruction,5,2,3
49393,Neg,sylvanas,159,warlock,destruction,5,2,3
49394,Hp,ysondre,159,warlock,destruction,5,2,3
49395,Lemonzx,stormscale,159,warlock,destruction,5,2,3
49396,Smolpussgodx,ragnaros,144,warlock,destruction,3,3,0
49397,Lockki,blades-edge,138,warlock,destruction,7,3,4
49398,Vahk,uldum,138,warlock,destruction,7,3,4
49399,Rb,anachronos,138,warlock,destruction,8,3,5
49400,Wdauwg,nazjatar,138,warlock,destruction,9,3,6
49401,Hhogyoku,dentarg,138,warlock,destruction,10,3,7
49402,Belzzebuth,silvermoon,128,warlock,destruction,10,2,8
49403,Перегном,blackscar,127,warlock,destruction,8,2,6
49404,Mqsxw,stormscale,112,warlock,destruction,7,2,5
49405,Neijihbolt,blackrock,112,warlock,destruction,7,2,5
49406,Mergon,ravencrest,96,warlock,destruction,3,2,1
49407,Dannyboi,drakthul,96,warlock,destruction,3,2,1
49408,Áéé,kazzak,96,warlock,destruction,3,2,1
49409,Mulimarus,die-todeskrallen,96,warlock,destruction,3,2,1
49410,Ozzycrøwly,illidan,96,warlock,destruction,9,2,7
49411,Feliciousx,draenor,96,warlock,destruction,6,1,5
49412,Dabezdwl,outland,96,warlock,destruction,6,1,5
49413,Pichwise,draenor,96,warlock,destruction,6,1,5
49414,Daemonic,shattered-hand,96,warlock,destruction,6,1,5
49415,Xanth,eldrethalas,96,warlock,destruction,6,1,5
49416,Aenygma,jaedenar,96,warlock,destruction,6,1,5
49417,Empod,ragnaros,96,warlock,destruction,6,1,5
49418,Eleriya,argent-dawn,96,warlock,destruction,6,1,5
49419,Chaotick,bronze-dragonflight,96,warlock,destruction,6,1,5
49420,Raest,arygos,96,warlock,destruction,6,1,5
49421,Wt,twisting-nether,96,warlock,destruction,6,1,5
49422,Xuloth,ravencrest,96,warlock,destruction,6,1,5
49423,Neuth,draenor,96,warlock,destruction,6,1,5
49424,Redî,kazzak,96,warlock,destruction,6,1,5
49425,Gothgul,sanguino,96,warlock,destruction,6,1,5
49426,Deathdawning,draenor,96,warlock,destruction,6,1,5
49427,Omnath,alakir,96,warlock,destruction,6,1,5
49428,Gutras,ragnaros,96,warlock,destruction,6,1,5
49429,Musallat,argent-dawn,96,warlock,destruction,6,1,5
49430,Trinox,teldrassil,96,warlock,destruction,6,1,5
49431,Cleoputra,sylvanas,96,warlock,destruction,6,1,5
49432,Chaostheory,stormscale,96,warlock,destruction,6,1,5
49433,Löck,kirin-tor,96,warlock,destruction,6,1,5
49434,Lilskunk,draenor,96,warlock,destruction,6,1,5
49435,Elnïa,conseil-des-ombres,96,warlock,destruction,6,1,5
49436,Dalfgan,wildhammer,96,warlock,destruction,6,1,5
49437,Язлаякиска,soulflayer,96,warlock,destruction,6,1,5
49438,Mattihoh,rexxar,96,warlock,destruction,6,1,5
49439,Ariyala,alleria,96,warlock,destruction,6,1,5
49440,Fuglylock,the-maelstrom,96,warlock,destruction,6,1,5
49441,Gulzgan,kazzak,96,warlock,destruction,6,1,5
49442,Mortvivants,kirin-tor,96,warlock,destruction,6,1,5
49443,Azgaroth,kazzak,96,warlock,destruction,6,1,5
49444,Krabauf,eredar,96,warlock,destruction,6,1,5
49445,Reiukh,frostwolf,96,warlock,destruction,6,1,5
49446,Utuklululu,archimonde,96,warlock,destruction,6,1,5
49447,Kærastan,sylvanas,96,warlock,destruction,6,1,5
49448,Selok,outland,96,warlock,destruction,6,1,5
49449,Нотимба,gordunni,96,warlock,destruction,6,1,5
49450,Satânius,les-sentinelles,96,warlock,destruction,6,1,5
49451,Walchia,kazzak,96,warlock,destruction,6,1,5
49452,Shompaqzan,kazzak,96,warlock,destruction,6,1,5
49453,Маверрикк,gordunni,96,warlock,destruction,6,1,5
49454,Növnöv,madmortem,96,warlock,destruction,6,1,5
49455,Désolaté,kazzak,96,warlock,destruction,6,1,5
49456,Seriasa,blackmoore,96,warlock,destruction,6,1,5
49457,Сквиртонитх,howling-fjord,96,warlock,destruction,6,1,5
49458,Cruello,ragnaros,96,warlock,destruction,6,1,5
49459,Lomendro,blackmoore,96,warlock,destruction,6,1,5
49460,Ramuhn,antonidas,96,warlock,destruction,6,1,5
49461,Kathuum,outland,96,warlock,destruction,6,1,5
49462,Fell,outland,96,warlock,destruction,6,1,5
49463,Bytethisx,aggra-português,96,warlock,destruction,6,1,5
49464,Fearmighty,kazzak,96,warlock,destruction,6,1,5
49465,Gendo,twisting-nether,96,warlock,destruction,6,1,5
49466,Zeirat,tarren-mill,96,warlock,destruction,6,1,5
49467,Hørcrux,ravencrest,96,warlock,destruction,6,1,5
49468,Dadcrush,antonidas,96,warlock,destruction,6,1,5
49469,Ackorax,kilrogg,96,warlock,destruction,6,1,5
49470,Tyranuzz,norgannon,96,warlock,destruction,6,1,5
49471,Snollerboy,antonidas,96,warlock,destruction,6,1,5
49472,Infinitefire,ravencrest,96,warlock,destruction,6,1,5
49473,Иммолэйтх,gordunni,96,warlock,destruction,6,1,5
49474,Discolocken,outland,96,warlock,destruction,6,1,5
49475,Indifférence,archimonde,96,warlock,destruction,6,1,5
49476,Jynni,blackhand,96,warlock,destruction,6,1,5
49477,Whiskeycola,blackmoore,96,warlock,destruction,6,1,5
49478,Камнилока,booty-bay,96,warlock,destruction,6,1,5
49479,Bigbabalock,frostwolf,96,warlock,destruction,6,1,5
49480,Meisterhexe,taerar,96,warlock,destruction,6,1,5
49481,Czteryka,silvermoon,96,warlock,destruction,6,1,5
49482,Jujalari,stormscale,96,warlock,destruction,6,1,5
49483,Thaliä,tarren-mill,96,warlock,destruction,6,1,5
49484,Maidson,blackrock,96,warlock,destruction,6,1,5
49485,Darkironhuan,blackrock,96,warlock,destruction,6,1,5
49486,Rigour,silvermoon,96,warlock,destruction,6,1,5
49487,Mursha,auchindoun,96,warlock,destruction,6,1,5
49488,Mahishi,ravencrest,96,warlock,destruction,6,1,5
49489,Nulo,aggra-português,96,warlock,destruction,6,1,5
49490,Tiig,blackrock,96,warlock,destruction,6,1,5
49491,Pablø,silvermoon,96,warlock,destruction,6,1,5
49492,Znaj,tarren-mill,96,warlock,destruction,6,1,5
49493,Nècrøphila,kazzak,96,warlock,destruction,6,1,5
49494,Enmakorogi,twisting-nether,96,warlock,destruction,6,1,5
49495,Isanê,blackrock,96,warlock,destruction,6,1,5
49496,Buyala,stormscale,96,warlock,destruction,6,1,5
49497,Vîerdotcom,blackrock,96,warlock,destruction,6,1,5
49498,Tanatos,tarren-mill,96,warlock,destruction,6,1,5
49499,Yerslock,twisting-nether,96,warlock,destruction,6,1,5
49500,Methmuncher,twisting-nether,96,warlock,destruction,8,1,7
49501,Gainel,exodar,96,warlock,destruction,12,1,11
49502,Alithia,sylvanas,96,warlock,destruction,12,1,11
49503,Keilahkang,aerie-peak,96,warlock,destruction,12,1,11
49504,Реймей,blackscar,96,warlock,destruction,12,1,11
49505,Democraft,the-maelstrom,96,warlock,destruction,12,1,11
49506,Malagate,sylvanas,96,warlock,destruction,12,1,11
49507,Wuahlock,doomhammer,96,warlock,destruction,12,1,11
49508,Grêenbull,eredar,96,warlock,destruction,15,1,14
49509,Magosnik,archimonde,79,warlock,destruction,5,1,4
49510,Mesîkatayut,outland,79,warlock,destruction,11,1,10
49511,Néca,blackmoore,64,warlock,destruction,4,1,3
49512,Tranas,ragnaros,64,warlock,destruction,4,1,3
49513,Malariaa,defias-brotherhood,63,warlock,destruction,2,2,0
49514,Ruvy,twisting-nether,48,warlock,destruction,3,1,2
49515,Coblac,outland,48,warlock,destruction,3,1,2
49516,Colevid,blackmoore,42,warlock,destruction,6,2,4
49517,Anthor,tarren-mill,42,warlock,destruction,8,2,6
49518,Stonedup,alonsus,42,warlock,destruction,8,2,6
49519,Obichamcici,tarren-mill,42,warlock,destruction,8,2,6
49520,Rockstarr,dalaran,42,warlock,destruction,10,2,8
49521,Kotihoitaja,stormreaver,42,warlock,destruction,10,2,8
49522,Zuldiá,stormscale,32,warlock,destruction,2,2,0
49523,Chandelierh,kazzak,31,warlock,destruction,2,1,1
49524,Reconnected,drakthul,31,warlock,destruction,2,1,1
49525,Kemmler,steamwheedle-cartel,16,warlock,destruction,1,1,0
49526,Níkâ,aegwynn,16,warlock,destruction,1,1,0
49527,Orkamorfin,silvermoon,16,warlock,destruction,1,1,0
49528,Langneur,ysondre,2225,warlock,affliction,102,56,46
49529,Bualock,sylvanas,2167,warlock,affliction,84,52,32
49530,Tágsy,ravencrest,2130,warlock,affliction,90,47,43
49531,Fruits,ysondre,2108,warlock,affliction,89,44,45
49532,Micol,doomhammer,2091,warlock,affliction,90,44,46
49533,Kärme,archimonde,2066,warlock,affliction,305,158,147
49534,Arukekz,blackmoore,2058,warlock,affliction,84,43,41
49535,Boogeyboyx,stormscale,2056,warlock,affliction,101,59,42
49536,Southylolz,stormscale,2015,warlock,affliction,71,36,35
49537,Härèsß,dun-modr,1997,warlock,affliction,96,53,43
49538,Nickrosh,terokkar,1989,warlock,affliction,66,39,27
49539,Darksooul,xavius,1987,warlock,affliction,72,44,28
49540,Arussj,blackrock,1984,warlock,affliction,62,33,29
49541,Chobitas,ravencrest,1978,warlock,affliction,120,60,60
49542,Hædês,antonidas,1972,warlock,affliction,102,51,51
49543,Magonyth,tarren-mill,1963,warlock,affliction,71,41,30
49544,Celebí,blackmoore,1959,warlock,affliction,66,40,26
49545,Southyx,stormscale,1928,warlock,affliction,77,40,37
49546,Kaspersdame,ravencrest,1927,warlock,affliction,201,100,101
49547,Steckenpferd,blackmoore,1924,warlock,affliction,48,27,21
49548,Qyburn,drekthar,1923,warlock,affliction,66,40,26
49549,Southy,stormscale,1918,warlock,affliction,48,25,23
49550,Rutena,ravencrest,1918,warlock,affliction,72,37,35
49551,Mïta,hyjal,1904,warlock,affliction,48,27,21
49552,Kasoy,doomhammer,1894,warlock,affliction,139,75,64
49553,Infernion,stormscale,1891,warlock,affliction,51,33,18
49554,Nesme,sylvanas,1890,warlock,affliction,59,28,31
49555,Gezer,tarren-mill,1880,warlock,affliction,98,54,44
49556,Skrumpis,draenor,1880,warlock,affliction,209,106,103
49557,Garebigger,blackrock,1880,warlock,affliction,132,62,70
49558,Тагочи,gordunni,1876,warlock,affliction,53,28,25
49559,Gulzot,turalyon,1866,warlock,affliction,71,37,34
49560,Debz,twisting-nether,1864,warlock,affliction,118,71,47
49561,Plsdîe,twisting-nether,1862,warlock,affliction,65,37,28
49562,Southylol,stormscale,1858,warlock,affliction,90,45,45
49563,Perpetual,eredar,1857,warlock,affliction,42,23,19
49564,Fsandtwo,ravencrest,1848,warlock,affliction,62,33,29
49565,Блудгэнг,blackscar,1847,warlock,affliction,48,21,27
49566,Xfz,stormscale,1835,warlock,affliction,102,57,45
49567,Cassen,outland,1833,warlock,affliction,60,31,29
49568,Getfaked,nordrassil,1832,warlock,affliction,54,28,26
49569,Bäle,stormreaver,1831,warlock,affliction,48,29,19
49570,Пчелокнижник,howling-fjord,1831,warlock,affliction,42,25,17
49571,Mediumpotato,blackhand,1824,warlock,affliction,48,26,22
49572,Sad,lightnings-blade,1821,warlock,affliction,82,32,50
49573,Xvq,twisting-nether,1819,warlock,affliction,106,67,39
49574,Malddog,turalyon,1813,warlock,affliction,131,75,56
49575,Angryfránk,outland,1811,warlock,affliction,161,77,84
49576,Limoges,archimonde,1809,warlock,affliction,66,41,25
49577,Nightìngale,silvermoon,1808,warlock,affliction,92,51,41
49578,Nêverse,archimonde,1805,warlock,affliction,30,19,11
49579,Мрорбит,howling-fjord,1804,warlock,affliction,42,19,23
49580,Wldot,ravencrest,1802,warlock,affliction,42,24,18
49581,Monsterz,archimonde,1801,warlock,affliction,88,47,41
49582,Alliyâh,archimonde,1795,warlock,affliction,118,54,64
49583,Bankstair,stormscale,1779,warlock,affliction,105,58,47
49584,Oldboy,auchindoun,1771,warlock,affliction,36,24,12
49585,Infïnitýx,silvermoon,1732,warlock,affliction,89,46,43
49586,Zodiiacc,ravencrest,1723,warlock,affliction,66,32,34
49587,Demonkïng,archimonde,1722,warlock,affliction,54,29,25
49588,Trâshxd,sanguino,1719,warlock,affliction,66,42,24
49589,Kajanova,stormscale,1717,warlock,affliction,66,40,26
49590,Baz,anubarak,1717,warlock,affliction,56,24,32
49591,Neoe,stormscale,1705,warlock,affliction,108,54,54
49592,Архкингсдум,galakrond,1704,warlock,affliction,58,27,31
49593,Hladankurac,twisting-nether,1700,warlock,affliction,38,22,16
49594,Graveflesh,burning-blade,1700,warlock,affliction,191,93,98
49595,Methroz,burning-legion,1680,warlock,affliction,48,25,23
49596,Oarz,blackrock,1678,warlock,affliction,59,35,24
49597,Fear,auchindoun,1676,warlock,affliction,41,22,19
49598,Vîmø,antonidas,1658,warlock,affliction,96,53,43
49599,Emreys,argent-dawn,1656,warlock,affliction,139,73,66
49600,Yokûjin,twisting-nether,1650,warlock,affliction,49,22,27
49601,Nekrosd,tarren-mill,1646,warlock,affliction,84,46,38
49602,Локбезног,soulflayer,1639,warlock,affliction,48,30,18
49603,Zeinth,sanguino,1636,warlock,affliction,78,43,35
49604,Dondot,frostmane,1630,warlock,affliction,66,39,27
49605,Ketzu,hyjal,1626,warlock,affliction,118,59,59
49606,Rottndot,stormscale,1624,warlock,affliction,72,40,32
49607,Termss,ravencrest,1622,warlock,affliction,286,147,139
49608,Prelest,arathor,1620,warlock,affliction,24,17,7
49609,Ржоммба,soulflayer,1618,warlock,affliction,66,38,28
49610,Brainsoup,burning-blade,1616,warlock,affliction,66,31,35
49611,Acentro,stormscale,1615,warlock,affliction,51,32,19
49612,Ashhlock,silvermoon,1613,warlock,affliction,42,24,18
49613,Htaedfo,tarren-mill,1612,warlock,affliction,60,34,26
49614,Сзот,howling-fjord,1612,warlock,affliction,42,22,20
49615,Mortvivants,kirin-tor,1610,warlock,affliction,79,43,36
49616,Orsoyopoyo,nemesis,1607,warlock,affliction,30,20,10
49617,Mîná,ravencrest,1607,warlock,affliction,51,30,21
49618,Фламмэнх,soulflayer,1604,warlock,affliction,36,21,15
49619,Ремайка,gordunni,1603,warlock,affliction,134,68,66
49620,Magonyth,ravencrest,1600,warlock,affliction,30,19,11
49621,Асальвэйд,gordunni,1600,warlock,affliction,58,32,26
49622,Нэрфир,soulflayer,1600,warlock,affliction,42,22,20
49623,Журанайсбой,blackscar,1598,warlock,affliction,30,21,9
49624,Shayexen,tarren-mill,1596,warlock,affliction,47,28,19
49625,Smøkê,tarren-mill,1596,warlock,affliction,308,165,143
49626,Corbbolt,drakthul,1586,warlock,affliction,44,24,20
49627,Винстролман,blackscar,1576,warlock,affliction,90,59,31
49628,Modernmisery,kazzak,1574,warlock,affliction,186,93,93
49629,Müdür,burning-legion,1573,warlock,affliction,154,90,64
49630,Ascètic,kazzak,1572,warlock,affliction,78,41,37
49631,Auxi,the-maelstrom,1568,warlock,affliction,43,29,14
49632,Jlcreverso,eredar,1563,warlock,affliction,28,18,10
49633,Trevium,nemesis,1555,warlock,affliction,76,43,33
49634,Soezzlock,archimonde,1551,warlock,affliction,141,77,64
49635,Lollock,teldrassil,1549,warlock,affliction,24,17,7
49636,Farzokonan,archimonde,1549,warlock,affliction,138,75,63
49637,Yosiya,draenor,1546,warlock,affliction,69,34,35
49638,Waatschnbaam,eredar,1540,warlock,affliction,48,22,26
49639,Gneticz,aegwynn,1534,warlock,affliction,42,24,18
49640,Сентимент,gordunni,1534,warlock,affliction,59,29,30
49641,Osyx,ravencrest,1534,warlock,affliction,36,16,20
49642,Slf,the-maelstrom,1533,warlock,affliction,52,32,20
49643,Itiswhatitis,ravencrest,1532,warlock,affliction,36,16,20
49644,Vregor,twisting-nether,1527,warlock,affliction,28,17,11
49645,Nightsnake,deathwing,1516,warlock,affliction,114,50,64
49646,Dezznut,blackhand,1513,warlock,affliction,65,36,29
49647,Сайденас,gordunni,1508,warlock,affliction,59,26,33
49648,Nerfwarriors,stormscale,1505,warlock,affliction,36,24,12
49649,Robertóoo,burning-legion,1505,warlock,affliction,56,31,25
49650,Katâra,tarren-mill,1505,warlock,affliction,80,36,44
49651,Soffie,blackrock,1501,warlock,affliction,48,23,25
49652,Soulslugger,twisting-nether,1500,warlock,affliction,36,17,19
49653,Olympïe,archimonde,1500,warlock,affliction,42,17,25
49654,Kayako,kul-tiras,1499,warlock,affliction,68,28,40
49655,Drekkrog,chogall,1490,warlock,affliction,30,16,14
49656,Franta,chromaggus,1488,warlock,affliction,35,21,14
49657,Cringetamer,silvermoon,1488,warlock,affliction,36,17,19
49658,Боризыч,gordunni,1487,warlock,affliction,125,67,58
49659,Tøpdmg,die-aldor,1486,warlock,affliction,41,21,20
49660,Saraconnor,burning-legion,1482,warlock,affliction,60,34,26
49661,Разъелвал,blackscar,1478,warlock,affliction,90,53,37
49662,Exorbïtant,blackrock,1477,warlock,affliction,150,76,74
49663,Лысыйлокоть,soulflayer,1475,warlock,affliction,36,18,18
49664,Mty,bronze-dragonflight,1475,warlock,affliction,105,51,54
49665,Belíos,stormscale,1469,warlock,affliction,51,31,20
49666,Spiritawayx,lightbringer,1467,warlock,affliction,24,18,6
49667,Floron,silvermoon,1465,warlock,affliction,67,33,34
49668,Lánfeár,draenor,1464,warlock,affliction,275,138,137
49669,Depresive,aggra-português,1463,warlock,affliction,119,66,53
49670,Влицотьмой,gordunni,1462,warlock,affliction,43,23,20
49671,Олимта,blackscar,1461,warlock,affliction,94,45,49
49672,Адоха,howling-fjord,1460,warlock,affliction,42,22,20
49673,Yôi,nemesis,1457,warlock,affliction,36,19,17
49674,Zèlêph,archimonde,1456,warlock,affliction,36,24,12
49675,Zakuri,blackmoore,1452,warlock,affliction,48,32,16
49676,Titoss,archimonde,1451,warlock,affliction,78,40,38
49677,Potterhotter,outland,1446,warlock,affliction,57,30,27
49678,Äsmødée,dalaran,1440,warlock,affliction,157,79,78
49679,Azurma,tarren-mill,1439,warlock,affliction,24,15,9
49680,Hivxherpes,ravencrest,1439,warlock,affliction,121,57,64
49681,Dispellthat,burning-legion,1438,warlock,affliction,31,16,15
49682,Прогнившая,blackscar,1437,warlock,affliction,111,63,48
49683,Dracsu,dun-modr,1436,warlock,affliction,160,82,78
49684,Wezen,stormscale,1435,warlock,affliction,95,50,45
49685,Kakiamagisa,twisting-nether,1431,warlock,affliction,52,35,17
49686,Ebolara,aegwynn,1427,warlock,affliction,47,23,24
49687,Нафлэпил,gordunni,1425,warlock,affliction,59,32,27
49688,Candyman,bronze-dragonflight,1424,warlock,affliction,92,44,48
49689,Zêngâ,kazzak,1422,warlock,affliction,42,23,19
49690,Demonologyz,ravencrest,1416,warlock,affliction,24,19,5
49691,Marklock,drakthul,1412,warlock,affliction,60,37,23
49692,Lockwkrok,burning-legion,1407,warlock,affliction,92,44,48
49693,Talt,dalaran,1406,warlock,affliction,56,34,22
49694,Brustlino,nemesis,1405,warlock,affliction,24,15,9
49695,Шизуи,borean-tundra,1403,warlock,affliction,55,34,21
49696,Axapnon,ragnaros,1403,warlock,affliction,207,100,107
49697,Tarilinwelli,les-sentinelles,1401,warlock,affliction,116,65,51
49698,Apokalyps,eldrethalas,1401,warlock,affliction,250,130,120
49699,Nate,stormscale,1399,warlock,affliction,64,30,34
49700,Mendozaah,kazzak,1397,warlock,affliction,48,20,28
49701,Dannyel,mazrigos,1395,warlock,affliction,147,75,72
49702,Murua,silvermoon,1387,warlock,affliction,30,15,15
49703,Dondada,aggra-português,1386,warlock,affliction,55,27,28
49704,Gaminex,kazzak,1386,warlock,affliction,90,43,47
49705,Phelola,sylvanas,1384,warlock,affliction,63,33,30
49706,Сартеккс,gordunni,1382,warlock,affliction,59,34,25
49707,Dropxpvp,blackrock,1381,warlock,affliction,54,26,28
49708,Pcbbwarlock,sylvanas,1380,warlock,affliction,180,100,80
49709,Kavalierr,stormscale,1377,warlock,affliction,70,35,35
49710,Teddyruineur,khaz-modan,1376,warlock,affliction,42,25,17
49711,Pokifanone,tarren-mill,1376,warlock,affliction,29,16,13
49712,Rottenbooty,argent-dawn,1374,warlock,affliction,30,15,15
49713,Balgo,blackmoore,1372,warlock,affliction,30,17,13
49714,Киёкка,howling-fjord,1371,warlock,affliction,48,29,19
49715,Infectius,kazzak,1367,warlock,affliction,61,30,31
49716,Délidumrul,stormscale,1364,warlock,affliction,30,20,10
49717,Øprøx,sanguino,1356,warlock,affliction,17,15,2
49718,Nîghtmare,outland,1353,warlock,affliction,35,20,15
49719,Hòbó,outland,1353,warlock,affliction,51,28,23
49720,Gash,malganis,1353,warlock,affliction,168,86,82
49721,Akdan,ragnaros,1351,warlock,affliction,50,21,29
49722,Hathatchi,sylvanas,1343,warlock,affliction,52,29,23
49723,Hirasawa,archimonde,1343,warlock,affliction,40,15,25
49724,Ммоохх,gordunni,1340,warlock,affliction,30,14,16
49725,Whaii,ravencrest,1339,warlock,affliction,24,14,10
49726,Anabolicbaby,draenor,1339,warlock,affliction,27,15,12
49727,Degdeehei,draenor,1339,warlock,affliction,58,30,28
49728,Дестроварлок,blackscar,1337,warlock,affliction,24,14,10
49729,Itsfiftycent,outland,1337,warlock,affliction,66,36,30
49730,Primdåhl,ravencrest,1335,warlock,affliction,64,34,30
49731,Gryme,dalaran,1333,warlock,affliction,72,30,42
49732,Vivek,grim-batol,1328,warlock,affliction,72,28,44
49733,Assuz,eredar,1327,warlock,affliction,36,19,17
49734,Лейссина,eversong,1327,warlock,affliction,89,43,46
49735,Sublînê,blackmoore,1326,warlock,affliction,54,21,33
49736,Maidson,blackrock,1325,warlock,affliction,24,14,10
49737,Trythislock,crushridge,1325,warlock,affliction,29,16,13
49738,Mayline,kult-der-verdammten,1322,warlock,affliction,30,17,13
49739,Sánas,blackhand,1322,warlock,affliction,54,26,28
49740,Grimus,azuremyst,1322,warlock,affliction,30,14,16
49741,Warlokk,tarren-mill,1318,warlock,affliction,90,45,45
49742,Cgane,archimonde,1317,warlock,affliction,34,20,14
49743,Themits,executus,1314,warlock,affliction,34,15,19
49744,Перегном,blackscar,1311,warlock,affliction,60,28,32
49745,Getfeared,stormscale,1308,warlock,affliction,36,14,22
49746,Deathpoid,draenor,1307,warlock,affliction,45,17,28
49747,Sleethy,destromath,1306,warlock,affliction,36,18,18
49748,Roglash,eredar,1304,warlock,affliction,92,50,42
49749,Nihale,arakarahm,1304,warlock,affliction,64,29,35
49750,Колдунишка,fordragon,1299,warlock,affliction,209,112,97
49751,Jegfaller,wildhammer,1299,warlock,affliction,78,39,39
49752,Scaevóla,ravencrest,1297,warlock,affliction,42,24,18
49753,Bästkusten,kazzak,1294,warlock,affliction,28,16,12
49754,Nesveti,kazzak,1290,warlock,affliction,18,14,4
49755,Ketem,zuljin,1279,warlock,affliction,84,43,41
49756,Lokic,draenor,1278,warlock,affliction,36,14,22
49757,Izyguldamn,blackmoore,1276,warlock,affliction,48,16,32
49758,Voost,aegwynn,1275,warlock,affliction,43,15,28
49759,Zetsubo,drakthul,1270,warlock,affliction,105,55,50
49760,Ukicha,burning-blade,1268,warlock,affliction,48,22,26
49761,Hatenkou,silvermoon,1263,warlock,affliction,60,30,30
49762,Diseez,bronzebeard,1262,warlock,affliction,45,24,21
49763,Mooncrásh,blackrock,1261,warlock,affliction,66,32,34
49764,Самантаглу,blackscar,1260,warlock,affliction,58,33,25
49765,Датри,grom,1254,warlock,affliction,48,25,23
49766,Tiwtera,draenor,1252,warlock,affliction,36,14,22
49767,Стафилокок,deepholm,1248,warlock,affliction,36,19,17
49768,Kitingguru,stormscale,1247,warlock,affliction,24,13,11
49769,ßualock,sylvanas,1247,warlock,affliction,24,13,11
49770,Рашчер,gordunni,1247,warlock,affliction,30,13,17
49771,Yamadea,stormscale,1246,warlock,affliction,24,13,11
49772,Apathia,stormscale,1245,warlock,affliction,18,13,5
49773,Nhw,archimonde,1245,warlock,affliction,24,14,10
49774,Shannzo,stormscale,1245,warlock,affliction,24,13,11
49775,Hiimsûso,dun-modr,1240,warlock,affliction,41,21,20
49776,Крэдоу,soulflayer,1239,warlock,affliction,24,13,11
49777,Fearing,malganis,1239,warlock,affliction,30,13,17
49778,Sïeur,archimonde,1238,warlock,affliction,24,13,11
49779,Оксси,fordragon,1238,warlock,affliction,24,13,11
49780,Kerthan,malorne,1237,warlock,affliction,68,31,37
49781,Actelia,the-venture-co,1237,warlock,affliction,38,15,23
49782,Yowifeinmedm,draenor,1234,warlock,affliction,36,13,23
49783,Irnx,tarren-mill,1232,warlock,affliction,32,16,16
49784,Shakuroz,frostwolf,1229,warlock,affliction,28,14,14
49785,Dotieks,draenor,1228,warlock,affliction,114,58,56
49786,Solitariøus,arathi,1227,warlock,affliction,36,17,19
49787,Soultire,ravencrest,1227,warlock,affliction,66,29,37
49788,Лютыйглад,blackscar,1226,warlock,affliction,31,16,15
49789,Бенлоел,borean-tundra,1220,warlock,affliction,36,13,23
49790,Томрэдл,howling-fjord,1218,warlock,affliction,236,120,116
49791,Vîerdotcom,blackrock,1215,warlock,affliction,18,13,5
49792,Локистраик,borean-tundra,1214,warlock,affliction,47,19,28
49793,Lockinasock,stormscale,1208,warlock,affliction,18,13,5
49794,Tsumde,dalaran,1207,warlock,affliction,44,16,28
49795,Yasa,khaz-modan,1205,warlock,affliction,30,23,7
49796,Xerxia,blackrock,1205,warlock,affliction,42,25,17
49797,Etsanctum,blackmoore,1204,warlock,affliction,48,17,31
49798,Draklack,turalyon,1202,warlock,affliction,66,34,32
49799,Âkâl,ravencrest,1194,warlock,affliction,23,13,10
49800,Kyiüû,archimonde,1194,warlock,affliction,27,14,13
49801,Nexyra,silvermoon,1194,warlock,affliction,195,95,100
49802,Vaukras,stormscale,1194,warlock,affliction,62,29,33
49803,Qena,outland,1194,warlock,affliction,42,18,24
49804,Malagate,sylvanas,1190,warlock,affliction,48,20,28
49805,Swagzz,silvermoon,1185,warlock,affliction,60,33,27
49806,Sunetta,silvermoon,1182,warlock,affliction,68,34,34
49807,Gamunkul,destromath,1179,warlock,affliction,55,21,34
49808,Ainos,twisting-nether,1178,warlock,affliction,35,18,17
49809,Nydek,cthun,1178,warlock,affliction,36,16,20
49810,Luzi,arthas,1172,warlock,affliction,30,14,16
49811,Wedlock,stormscale,1171,warlock,affliction,29,19,10
49812,Huaian,darksorrow,1170,warlock,affliction,56,26,30
49813,Blackmagic,stormscale,1168,warlock,affliction,72,36,36
49814,Robodot,eredar,1166,warlock,affliction,42,17,25
49815,Sluba,stormscale,1155,warlock,affliction,24,14,10
49816,Toppluva,shattered-hand,1151,warlock,affliction,21,13,8
49817,Xskyrov,blackmoore,1151,warlock,affliction,24,12,12
49818,Sehk,stormreaver,1151,warlock,affliction,24,12,12
49819,Dhraven,thrall,1151,warlock,affliction,87,41,46
49820,Thereya,dun-morogh,1150,warlock,affliction,24,12,12
49821,Darkrorr,drakthul,1150,warlock,affliction,24,12,12
49822,Cdztuwu,outland,1147,warlock,affliction,18,12,6
49823,Walchia,kazzak,1147,warlock,affliction,83,44,39
49824,Trinox,teldrassil,1144,warlock,affliction,24,15,9
49825,Suskive,kaelthas,1141,warlock,affliction,24,12,12
49826,Asmonmald,stormscale,1139,warlock,affliction,120,52,68
49827,Zeotrixie,stormscale,1138,warlock,affliction,24,12,12
49828,Whocarezlock,stormscale,1135,warlock,affliction,27,13,14
49829,Requeims,outland,1119,warlock,affliction,22,12,10
49830,Squadala,kaelthas,1115,warlock,affliction,30,15,15
49831,Slowfatlock,ravencrest,1115,warlock,affliction,24,12,12
49832,Felboar,quelthalas,1113,warlock,affliction,24,15,9
49833,Hacklock,silvermoon,1110,warlock,affliction,78,34,44
49834,Cokoladuocka,silvermoon,1107,warlock,affliction,48,21,27
49835,Toké,blackmoore,1106,warlock,affliction,28,14,14
49836,Yahata,nethersturm,1104,warlock,affliction,36,20,16
49837,Dótcom,draenor,1104,warlock,affliction,42,21,21
49838,Vahgaz,burning-legion,1103,warlock,affliction,121,62,59
49839,Nicetime,nefarian,1102,warlock,affliction,24,13,11
49840,Araphel,twisting-nether,1101,warlock,affliction,30,16,14
49841,Favris,antonidas,1101,warlock,affliction,128,66,62
49842,Cahoa,archimonde,1093,warlock,affliction,39,17,22
49843,Горенджо,eversong,1092,warlock,affliction,26,13,13
49844,Fraky,frostwhisper,1087,warlock,affliction,23,16,7
49845,Консидёро,gordunni,1086,warlock,affliction,26,12,14
49846,Modéus,ysondre,1086,warlock,affliction,36,16,20
49847,Mæphysto,blackrock,1083,warlock,affliction,109,53,56
49848,Сувала,soulflayer,1082,warlock,affliction,17,12,5
49849,Ladodida,darkspear,1081,warlock,affliction,30,17,13
49850,Diegomojes,silvermoon,1080,warlock,affliction,98,53,45
49851,Аксиманд,howling-fjord,1069,warlock,affliction,35,17,18
49852,Fealer,magtheridon,1065,warlock,affliction,198,101,97
49853,Rhyana,sylvanas,1065,warlock,affliction,28,12,16
49854,Mowxll,blackrock,1056,warlock,affliction,24,11,13
49855,Fräddan,draenor,1054,warlock,affliction,12,11,1
49856,Mjabowf,outland,1054,warlock,affliction,18,11,7
49857,Bigdamndots,twisting-nether,1054,warlock,affliction,18,11,7
49858,Císuh,stormreaver,1053,warlock,affliction,24,11,13
49859,Мокито,grom,1052,warlock,affliction,24,11,13
49860,Дотдозор,howling-fjord,1051,warlock,affliction,24,11,13
49861,Zevil,emerald-dream,1047,warlock,affliction,24,11,13
49862,Vladov,ravencrest,1045,warlock,affliction,24,11,13
49863,Møärdötd,aggra-português,1044,warlock,affliction,24,11,13
49864,Глянемче,deathguard,1040,warlock,affliction,27,14,13
49865,Urssul,kazzak,1038,warlock,affliction,18,11,7
49866,Blaizen,outland,1038,warlock,affliction,22,12,10
49867,Тафуби,deathweaver,1037,warlock,affliction,18,11,7
49868,Selenene,norgannon,1036,warlock,affliction,51,25,26
49869,Nerdbane,blackrock,1033,warlock,affliction,18,11,7
49870,Klone,die-todeskrallen,1026,warlock,affliction,27,12,15
49871,Шайтанарба,blackscar,1025,warlock,affliction,42,25,17
49872,Øzze,ysondre,1025,warlock,affliction,24,11,13
49873,Gate,blackrock,1022,warlock,affliction,17,11,6
49874,Бауглирх,howling-fjord,1019,warlock,affliction,23,11,12
49875,Cutt,chogall,1018,warlock,affliction,53,23,30
49876,Bësly,khaz-modan,1013,warlock,affliction,18,12,6
49877,Олдриг,ashenvale,1013,warlock,affliction,39,18,21
49878,Xlara,argent-dawn,1010,warlock,affliction,100,47,53
49879,Venoc,kazzak,1007,warlock,affliction,108,54,54
49880,Oonz,sylvanas,1006,warlock,affliction,56,28,28
49881,Skufi,uldum,1004,warlock,affliction,42,20,22
49882,Vendømlørd,archimonde,1003,warlock,affliction,31,17,14
49883,Bluenote,colinas-pardas,1002,warlock,affliction,48,24,24
49884,Sovrìn,blackrock,1002,warlock,affliction,23,11,12
49885,Prekt,ragnaros,1001,warlock,affliction,17,11,6
49886,Навидд,howling-fjord,995,warlock,affliction,30,15,15
49887,Бестий,fordragon,989,warlock,affliction,14,11,3
49888,Brítneyfears,azjolnerub,986,warlock,affliction,17,11,6
49889,Bu,zirkel-des-cenarius,982,warlock,affliction,17,11,6
49890,Qullnius,kazzak,971,warlock,affliction,34,12,22
49891,Principle,dunemaul,965,warlock,affliction,36,21,15
49892,Peonpedro,malganis,960,warlock,affliction,12,10,2
49893,Murdee,kazzak,960,warlock,affliction,18,10,8
49894,Dreamnyâsha,tarren-mill,960,warlock,affliction,18,10,8
49895,Likee,eredar,960,warlock,affliction,30,10,20
49896,Дагира,booty-bay,959,warlock,affliction,12,10,2
49897,Pinacholadá,norgannon,959,warlock,affliction,12,10,2
49898,Hannen,blackrock,959,warlock,affliction,24,10,14
49899,Drstyx,anetheron,959,warlock,affliction,30,10,20
49900,Azaïdun,khaz-modan,958,warlock,affliction,18,10,8
49901,Коплюнапони,blackscar,958,warlock,affliction,18,10,8
49902,Flyps,stormscale,958,warlock,affliction,18,10,8
49903,Bowti,ravencrest,957,warlock,affliction,30,10,20
49904,Снэйк,deathguard,956,warlock,affliction,18,10,8
49905,Kyyuss,burning-legion,956,warlock,affliction,24,10,14
49906,Dxz,silvermoon,956,warlock,affliction,30,10,20
49907,Omnath,alakir,955,warlock,affliction,24,10,14
49908,Sylrathas,burning-legion,953,warlock,affliction,24,10,14
49909,Prickster,kazzak,952,warlock,affliction,18,10,8
49910,Grimréaper,outland,950,warlock,affliction,24,10,14
49911,Waryald,dun-modr,945,warlock,affliction,30,10,20
49912,Carlman,hyjal,940,warlock,affliction,18,10,8
49913,Darkháte,blackhand,936,warlock,affliction,18,10,8
49914,Uthdae,archimonde,933,warlock,affliction,36,13,23
49915,Дакиса,gordunni,925,warlock,affliction,35,10,25
49916,Richrichy,outland,921,warlock,affliction,36,15,21
49917,Слававдвх,blackscar,914,warlock,affliction,53,25,28
49918,Ashgron,burning-legion,909,warlock,affliction,18,10,8
49919,Rasputia,thunderhorn,906,warlock,affliction,45,24,21
49920,Letoupet,la-croisade-écarlate,904,warlock,affliction,42,21,21
49921,Murphloc,silvermoon,888,warlock,affliction,26,10,16
49922,Artyrus,burning-legion,875,warlock,affliction,24,12,12
49923,Мракодел,deathguard,872,warlock,affliction,21,11,10
49924,Nukeem,karazhan,869,warlock,affliction,109,50,59
49925,Парачо,eversong,864,warlock,affliction,12,9,3
49926,Abinsur,drakthul,864,warlock,affliction,12,9,3
49927,Gøzù,antonidas,864,warlock,affliction,18,9,9
49928,Marcoil,kazzak,863,warlock,affliction,12,9,3
49929,Boglock,argent-dawn,863,warlock,affliction,18,9,9
49930,Mundunugu,sanguino,863,warlock,affliction,18,9,9
49931,Mykóla,terokkar,863,warlock,affliction,18,9,9
49932,Gaargamelo,blackmoore,863,warlock,affliction,24,9,15
49933,Bh,ragnaros,862,warlock,affliction,18,9,9
49934,Esmuel,argent-dawn,862,warlock,affliction,18,9,9
49935,Aagon,antonidas,862,warlock,affliction,24,9,15
49936,Tolgaa,draenor,862,warlock,affliction,28,10,18
49937,Hitomitanaká,kazzak,862,warlock,affliction,28,9,19
49938,Ívânguldán,twisting-nether,861,warlock,affliction,12,9,3
49939,Darkwootex,draenor,861,warlock,affliction,15,10,5
49940,Zelhala,draenor,861,warlock,affliction,18,9,9
49941,Clungesuck,argent-dawn,861,warlock,affliction,18,9,9
49942,Graell,drakthul,860,warlock,affliction,12,9,3
49943,Mumutoaster,blackrock,860,warlock,affliction,12,9,3
49944,Iml,grim-batol,859,warlock,affliction,28,10,18
49945,Локомания,gordunni,859,warlock,affliction,30,9,21
49946,Twnia,the-maelstrom,858,warlock,affliction,18,9,9
49947,Ностра,gordunni,856,warlock,affliction,12,9,3
49948,Цзинкэ,gordunni,855,warlock,affliction,18,9,9
49949,Gulgash,blackrock,854,warlock,affliction,18,9,9
49950,Iyna,blackmoore,853,warlock,affliction,18,9,9
49951,Alithia,sylvanas,851,warlock,affliction,12,9,3
49952,Sinsemilla,kazzak,846,warlock,affliction,18,9,9
49953,Lemuriel,arthas,846,warlock,affliction,22,9,13
49954,Luckriel,draenor,839,warlock,affliction,18,9,9
49955,Shazem,tarren-mill,830,warlock,affliction,23,9,14
49956,Pøzzi,hyjal,807,warlock,affliction,22,10,12
49957,Pipêz,blackmoore,795,warlock,affliction,28,9,19
49958,Sakkrethxd,hyjal,768,warlock,affliction,12,8,4
49959,Zlomozg,laughing-skull,768,warlock,affliction,12,8,4
49960,Noxtarius,thrall,768,warlock,affliction,12,8,4
49961,Cârmondai,alleria,768,warlock,affliction,12,8,4
49962,Bwc,aegwynn,768,warlock,affliction,18,8,10
49963,Rudikiaz,sanguino,768,warlock,affliction,18,8,10
49964,Демонтёлка,grom,767,warlock,affliction,14,10,4
49965,Heavylock,sylvanas,767,warlock,affliction,12,8,4
49966,Avoidsun,kazzak,767,warlock,affliction,18,8,10
49967,Jinchi,outland,767,warlock,affliction,18,8,10
49968,Dreggsow,blackmoore,767,warlock,affliction,24,8,16
49969,Cêebêry,frostwolf,765,warlock,affliction,12,8,4
49970,Deamheòlas,ravencrest,765,warlock,affliction,18,8,10
49971,Promethazine,nemesis,764,warlock,affliction,18,8,10
49972,Matheus,zenedar,763,warlock,affliction,18,8,10
49973,Tzimice,hyjal,763,warlock,affliction,18,8,10
49974,Diablotiin,hyjal,763,warlock,affliction,18,8,10
49975,Smuutil,drakthul,762,warlock,affliction,12,8,4
49976,Samigina,argent-dawn,762,warlock,affliction,24,8,16
49977,Warlocker,anachronos,745,warlock,affliction,18,8,10
49978,Hellseven,emeriss,735,warlock,affliction,23,8,15
49979,Savith,defias-brotherhood,721,warlock,affliction,24,8,16
49980,Friendlylock,quelthalas,720,warlock,affliction,15,8,7
49981,Diwi,area-52,720,warlock,affliction,102,35,67
49982,Öxygen,outland,672,warlock,affliction,12,7,5
49983,Purplemafia,burning-blade,672,warlock,affliction,12,7,5
49984,Turdy,sylvanas,672,warlock,affliction,12,7,5
49985,Мануил,eversong,672,warlock,affliction,12,7,5
49986,Kimkold,twisting-nether,672,warlock,affliction,12,7,5
49987,Elleanor,los-errantes,672,warlock,affliction,12,7,5
49988,Tôpsecret,aegwynn,672,warlock,affliction,12,7,5
49989,Gnargamehl,nemesis,672,warlock,affliction,12,7,5
49990,Hazelock,draenor,672,warlock,affliction,12,7,5
49991,Langneur,archimonde,672,warlock,affliction,12,7,5
49992,Йоранс,gordunni,672,warlock,affliction,12,7,5
49993,Ilikebolts,blackmoore,672,warlock,affliction,12,7,5
49994,Chaostrain,sylvanas,672,warlock,affliction,16,8,8
49995,Tanón,sanguino,672,warlock,affliction,18,7,11
49996,Кокобан,howling-fjord,672,warlock,affliction,18,7,11
49997,Venaarus,antonidas,672,warlock,affliction,18,7,11
49998,Lurkkis,ravencrest,672,warlock,affliction,18,7,11
49999,Муза,gordunni,672,warlock,affliction,18,7,11
50000,Beleghost,sylvanas,672,warlock,affliction,18,7,11
50001,Mønarch,argent-dawn,672,warlock,affliction,18,7,11
50002,Äri,blackmoore,671,warlock,affliction,12,7,5
50003,Azalock,ragnaros,671,warlock,affliction,12,7,5
50004,Drozhna,kaelthas,671,warlock,affliction,24,7,17
50005,Моргррет,soulflayer,670,warlock,affliction,12,7,5
50006,Proctolock,garona,670,warlock,affliction,12,7,5
50007,Lockgamerx,ravencrest,670,warlock,affliction,12,7,5
50008,Bakal,vashj,670,warlock,affliction,18,7,11
50009,Sesshouin,alakir,670,warlock,affliction,18,7,11
50010,Eveline,onyxia,670,warlock,affliction,28,8,20
50011,Алануэйк,deathguard,669,warlock,affliction,12,7,5
50012,Greenlock,la-croisade-écarlate,668,warlock,affliction,12,7,5
50013,Нэйрокризиз,howling-fjord,668,warlock,affliction,12,7,5
50014,Juod,frostmane,667,warlock,affliction,12,7,5
50015,Дольпико,howling-fjord,665,warlock,affliction,12,7,5
50016,Vinilio,kazzak,660,warlock,affliction,18,7,11
50017,Morgan,jaedenar,659,warlock,affliction,18,7,11
50018,Тэйлок,gordunni,658,warlock,affliction,12,7,5
50019,Arlu,blackrock,645,warlock,affliction,18,7,11
50020,Krismer,silvermoon,618,warlock,affliction,19,8,11
50021,Bäcck,silvermoon,607,warlock,affliction,17,7,10
50022,Dimmybyrger,stormreaver,576,warlock,affliction,12,6,6
50023,Nicker,antonidas,576,warlock,affliction,12,6,6
50024,Boonzor,ravencrest,576,warlock,affliction,12,6,6
50025,Multibuyer,tarren-mill,576,warlock,affliction,12,6,6
50026,Alcringe,kazzak,576,warlock,affliction,12,6,6
50027,Ackorax,kilrogg,576,warlock,affliction,12,6,6
50028,Dededot,ysondre,576,warlock,affliction,12,6,6
50029,Demónfire,sylvanas,576,warlock,affliction,12,6,6
50030,Hasla,stormreaver,576,warlock,affliction,12,6,6
50031,Christoph,tichondrius,576,warlock,affliction,12,6,6
50032,Plâytïmè,stormscale,576,warlock,affliction,12,6,6
50033,Çüñ,shattered-hand,576,warlock,affliction,12,6,6
50034,Nineinchlock,silvermoon,576,warlock,affliction,12,6,6
50035,Shaarak,blackrock,576,warlock,affliction,12,6,6
50036,Keybump,outland,576,warlock,affliction,12,6,6
50037,Зензирил,galakrond,576,warlock,affliction,12,6,6
50038,Skuvee,archimonde,576,warlock,affliction,12,6,6
50039,Smaúg,archimonde,576,warlock,affliction,12,6,6
50040,Snackstickz,twisting-nether,576,warlock,affliction,12,6,6
50041,Aches,sylvanas,576,warlock,affliction,15,7,8
50042,Kresyda,dun-modr,576,warlock,affliction,18,6,12
50043,Solomohn,steamwheedle-cartel,575,warlock,affliction,12,6,6
50044,Demonoulis,bloodhoof,575,warlock,affliction,12,6,6
50045,Talindra,stormscale,575,warlock,affliction,12,6,6
50046,Raggnarlock,ravencrest,575,warlock,affliction,12,6,6
50047,Tedor,ysondre,575,warlock,affliction,12,6,6
50048,Guccie,ravencrest,575,warlock,affliction,12,6,6
50049,Hodille,argent-dawn,575,warlock,affliction,12,6,6
50050,Phenolock,blackhand,575,warlock,affliction,12,6,6
50051,Toskanoamani,blackmoore,575,warlock,affliction,18,6,12
50052,Lulokko,nemesis,574,warlock,affliction,18,6,12
50053,Consfearacy,executus,574,warlock,affliction,24,6,18
50054,Lökjävel,twisting-nether,572,warlock,affliction,12,6,6
50055,ßatt,dalaran,571,warlock,affliction,12,6,6
50056,Цветника,deathguard,569,warlock,affliction,12,6,6
50057,Cencible,twisting-nether,564,warlock,affliction,16,9,7
50058,Lockyy,karazhan,543,warlock,affliction,14,7,7
50059,Parley,frostmane,542,warlock,affliction,16,6,10
50060,Saymore,ragnaros,522,warlock,affliction,13,7,6
50061,Бриант,gordunni,512,warlock,affliction,22,6,16
50062,Скверногрик,fordragon,511,warlock,affliction,10,6,4
50063,Muc,sanguino,511,warlock,affliction,11,6,5
50064,Díablø,blackmoore,480,warlock,affliction,6,5,1
50065,Faermorn,kazzak,480,warlock,affliction,6,5,1
50066,Kopfschmerz,twisting-nether,480,warlock,affliction,6,5,1
50067,Upsahl,twisting-nether,480,warlock,affliction,6,5,1
50068,Passwoord,kazzak,480,warlock,affliction,6,5,1
50069,Kazyn,archimonde,480,warlock,affliction,6,5,1
50070,Uqrlock,twisting-nether,480,warlock,affliction,6,5,1
50071,Wäisted,ravencrest,480,warlock,affliction,6,5,1
50072,Ranchiëk,ravencrest,480,warlock,affliction,6,5,1
50073,Lolock,archimonde,480,warlock,affliction,6,5,1
50074,Веномхх,lich-king,480,warlock,affliction,6,5,1
50075,Dualla,aegwynn,480,warlock,affliction,6,5,1
50076,Azkarr,defias-brotherhood,480,warlock,affliction,12,5,7
50077,Wällaar,ragnaros,480,warlock,affliction,12,5,7
50078,Covidbolt,outland,480,warlock,affliction,12,5,7
50079,Druno,archimonde,480,warlock,affliction,12,5,7
50080,Zukau,argent-dawn,480,warlock,affliction,12,5,7
50081,Hyøsei,hyjal,480,warlock,affliction,12,5,7
50082,Werkx,archimonde,480,warlock,affliction,12,5,7
50083,Daubi,ravencrest,480,warlock,affliction,12,5,7
50084,Golhok,archimonde,480,warlock,affliction,12,5,7
50085,Rtsnmt,alakir,480,warlock,affliction,12,5,7
50086,Chaøsbølt,archimonde,480,warlock,affliction,12,5,7
50087,Chaozvx,kazzak,480,warlock,affliction,12,5,7
50088,Kwoleriker,norgannon,480,warlock,affliction,12,5,7
50089,Nybbx,frostmane,480,warlock,affliction,12,5,7
50090,Exerji,twisting-nether,480,warlock,affliction,12,5,7
50091,Iatedora,ahnqiraj,480,warlock,affliction,12,5,7
50092,Ethiq,blackrock,480,warlock,affliction,12,5,7
50093,Pumpfake,ravencrest,480,warlock,affliction,12,5,7
50094,Enzyw,drakthul,480,warlock,affliction,12,5,7
50095,Moredøts,blackrock,480,warlock,affliction,14,5,9
50096,Dráintráin,burning-blade,480,warlock,affliction,18,5,13
50097,Affllction,auchindoun,480,warlock,affliction,18,5,13
50098,Wumz,sylvanas,480,warlock,affliction,24,5,19
50099,Lókí,nagrand,479,warlock,affliction,6,5,1
50100,Silås,hyjal,479,warlock,affliction,9,6,3
50101,Trickyy,azjolnerub,479,warlock,affliction,12,5,7
50102,Kiégetlek,ragnaros,479,warlock,affliction,12,5,7
50103,Demonflickan,silvermoon,479,warlock,affliction,12,5,7
50104,Dreamage,exodar,479,warlock,affliction,12,5,7
50105,Jacobí,defias-brotherhood,479,warlock,affliction,12,5,7
50106,Üserper,chamber-of-aspects,478,warlock,affliction,30,5,25
50107,Hunbeliever,ragnaros,477,warlock,affliction,6,5,1
50108,Guttate,chamber-of-aspects,476,warlock,affliction,12,5,7
50109,Dóni,chamber-of-aspects,447,warlock,affliction,11,5,6
50110,Garbrandt,tarren-mill,432,warlock,affliction,9,6,3
50111,Danidelarge,blackmoore,426,warlock,affliction,21,6,15
50112,Migyardondup,exodar,416,warlock,affliction,14,6,8
50113,Lazyblue,hyjal,415,warlock,affliction,14,5,9
50114,Stromzii,silvermoon,400,warlock,affliction,7,5,2
50115,Ariyasuke,drakthul,399,warlock,affliction,7,5,2
50116,Deathfløw,draenor,384,warlock,affliction,6,4,2
50117,Lopari,aegwynn,384,warlock,affliction,6,4,2
50118,Enyras,nemesis,384,warlock,affliction,6,4,2
50119,Jujalari,stormscale,384,warlock,affliction,6,4,2
50120,Thesnakë,ravencrest,384,warlock,affliction,6,4,2
50121,Tøtøf,sargeras,384,warlock,affliction,6,4,2
50122,Benafflockk,kirin-tor,384,warlock,affliction,6,4,2
50123,Noemia,defias-brotherhood,384,warlock,affliction,6,4,2
50124,Tekrowdy,blackmoore,384,warlock,affliction,6,4,2
50125,Turbonion,archimonde,384,warlock,affliction,6,4,2
50126,Dotritos,tarren-mill,384,warlock,affliction,6,4,2
50127,Патокдрысни,howling-fjord,384,warlock,affliction,6,4,2
50128,Hopéléss,aggra-português,384,warlock,affliction,6,4,2
50129,Hacknator,aegwynn,384,warlock,affliction,6,4,2
50130,Arizyoxot,twisting-nether,384,warlock,affliction,6,4,2
50131,Aljonah,antonidas,384,warlock,affliction,6,4,2
50132,Adotroz,magtheridon,384,warlock,affliction,6,4,2
50133,Discordîân,twisting-nether,384,warlock,affliction,6,4,2
50134,Фейкгодх,soulflayer,384,warlock,affliction,6,4,2
50135,Uselèss,die-arguswacht,384,warlock,affliction,6,4,2
50136,Pablø,silvermoon,384,warlock,affliction,6,4,2
50137,Zerøskil,blackrock,384,warlock,affliction,6,4,2
50138,Векста,gordunni,384,warlock,affliction,6,4,2
50139,Брилс,grom,384,warlock,affliction,6,4,2
50140,Felrazer,silvermoon,384,warlock,affliction,6,4,2
50141,Ашимал,soulflayer,384,warlock,affliction,6,4,2
50142,Helventti,sylvanas,384,warlock,affliction,6,4,2
50143,Wizdoom,outland,384,warlock,affliction,6,4,2
50144,Psychoduck,stormscale,384,warlock,affliction,7,4,3
50145,Djhanzó,outland,384,warlock,affliction,7,4,3
50146,Freshplanga,kazzak,384,warlock,affliction,10,5,5
50147,Eleriya,argent-dawn,384,warlock,affliction,12,4,8
50148,Thepureone,blades-edge,384,warlock,affliction,12,4,8
50149,Doomkicksin,haomarush,384,warlock,affliction,12,4,8
50150,Purplemonkey,burning-blade,384,warlock,affliction,12,4,8
50151,Bobleechaos,darkspear,384,warlock,affliction,12,4,8
50152,Zoh,archimonde,384,warlock,affliction,12,4,8
50153,Сатенекс,soulflayer,384,warlock,affliction,12,4,8
50154,Zeddy,draenor,384,warlock,affliction,12,4,8
50155,Braneiotqq,kazzak,384,warlock,affliction,12,4,8
50156,Славеномен,howling-fjord,384,warlock,affliction,12,4,8
50157,Náwwk,blackmoore,384,warlock,affliction,12,4,8
50158,Shazes,blutkessel,384,warlock,affliction,12,4,8
50159,Mortibal,dalvengyr,384,warlock,affliction,12,4,8
50160,Xyzzy,silvermoon,384,warlock,affliction,12,4,8
50161,Zatella,ravencrest,384,warlock,affliction,12,4,8
50162,Muninnus,archimonde,384,warlock,affliction,12,4,8
50163,Slàsh,hyjal,384,warlock,affliction,12,4,8
50164,Filianore,azjolnerub,384,warlock,affliction,12,4,8
50165,Roedin,tarren-mill,384,warlock,affliction,18,4,14
50166,Nokzhul,blackrock,384,warlock,affliction,18,4,14
50167,Sanas,blackhand,384,warlock,affliction,18,4,14
50168,Backblech,wrathbringer,383,warlock,affliction,6,4,2
50169,Whisperswerd,blackrock,383,warlock,affliction,6,4,2
50170,Phéar,deathwing,383,warlock,affliction,6,4,2
50171,Divvaa,tarren-mill,383,warlock,affliction,12,4,8
50172,Lünatix,archimonde,383,warlock,affliction,18,4,14
50173,Аннирина,eversong,382,warlock,affliction,6,4,2
50174,Sladurana,eredar,379,warlock,affliction,12,4,8
50175,Gonzoqt,tarren-mill,352,warlock,affliction,10,5,5
50176,Dotyboi,tarren-mill,351,warlock,affliction,8,5,3
50177,Disrupted,blackmoore,351,warlock,affliction,11,4,7
50178,Fearu,kazzak,336,warlock,affliction,15,4,11
50179,Marakh,stormscale,320,warlock,affliction,10,4,6
50180,Shalazar,dun-modr,319,warlock,affliction,8,4,4
50181,Mjuklock,ravencrest,319,warlock,affliction,14,4,10
50182,Mordonna,blades-edge,304,warlock,affliction,13,4,9
50183,Nainbusdemil,dalaran,304,warlock,affliction,19,4,15
50184,Nøx,quelthalas,297,warlock,affliction,11,6,5
50185,Lubomirek,turalyon,288,warlock,affliction,8,4,4
50186,Darksoll,hyjal,288,warlock,affliction,6,3,3
50187,Kenthal,nemesis,288,warlock,affliction,6,3,3
50188,Feyreah,blackmoore,288,warlock,affliction,6,3,3
50189,Damira,blackmoore,288,warlock,affliction,6,3,3
50190,Retrosatanas,archimonde,288,warlock,affliction,6,3,3
50191,Dubbzy,outland,288,warlock,affliction,6,3,3
50192,Dabolt,archimonde,288,warlock,affliction,6,3,3
50193,Clonia,nemesis,288,warlock,affliction,6,3,3
50194,Madridistaß,outland,288,warlock,affliction,6,3,3
50195,Eldrinar,twisting-nether,288,warlock,affliction,6,3,3
50196,Ðæthpäct,dalaran,288,warlock,affliction,6,3,3
50197,Imphugger,kazzak,288,warlock,affliction,6,3,3
50198,Xristianos,ravencrest,288,warlock,affliction,6,3,3
50199,Databricks,kazzak,288,warlock,affliction,6,3,3
50200,Vigget,burning-legion,288,warlock,affliction,6,3,3
50201,Babayagâ,sanguino,288,warlock,affliction,6,3,3
50202,Darkgrave,the-maelstrom,288,warlock,affliction,6,3,3
50203,Zagren,antonidas,288,warlock,affliction,6,3,3
50204,Ethanolix,burning-blade,288,warlock,affliction,6,3,3
50205,Decayez,thrall,288,warlock,affliction,6,3,3
50206,Môzoc,frostwolf,288,warlock,affliction,6,3,3
50207,Siyaa,eredar,288,warlock,affliction,6,3,3
50208,Полтарашкаа,blackscar,288,warlock,affliction,6,3,3
50209,Zélroth,argent-dawn,288,warlock,affliction,6,3,3
50210,Фримех,soulflayer,288,warlock,affliction,6,3,3
50211,Ooze,kazzak,288,warlock,affliction,6,3,3
50212,Marenov,kazzak,288,warlock,affliction,6,3,3
50213,Twisted,malganis,288,warlock,affliction,6,3,3
50214,Smoulville,sanguino,288,warlock,affliction,6,3,3
50215,Sazamia,ravencrest,288,warlock,affliction,6,3,3
50216,Шрэкс,blackscar,288,warlock,affliction,6,3,3
50217,Kumamoto,tarren-mill,288,warlock,affliction,6,3,3
50218,Демоник,deathguard,288,warlock,affliction,6,3,3
50219,Dontargetme,draenor,288,warlock,affliction,6,3,3
50220,Azmondan,ahnqiraj,288,warlock,affliction,6,3,3
50221,Raevax,ravencrest,288,warlock,affliction,6,3,3
50222,Dxfive,tarren-mill,288,warlock,affliction,6,3,3
50223,Drainsouls,stormscale,288,warlock,affliction,6,3,3
50224,Anthh,doomhammer,288,warlock,affliction,6,3,3
50225,Manikalinka,stormscale,288,warlock,affliction,6,3,3
50226,Nayolana,argent-dawn,288,warlock,affliction,6,3,3
50227,Veoxohr,argent-dawn,288,warlock,affliction,6,3,3
50228,Джастсак,gordunni,288,warlock,affliction,6,3,3
50229,Gigabolt,turalyon,288,warlock,affliction,6,3,3
50230,Nachtreich,thrall,288,warlock,affliction,6,3,3
50231,Zzooxx,silvermoon,288,warlock,affliction,6,3,3
50232,Absúrd,turalyon,288,warlock,affliction,6,3,3
50233,Slavecry,silvermoon,288,warlock,affliction,6,3,3
50234,Mariahscary,auchindoun,288,warlock,affliction,6,3,3
50235,Bixik,ravencrest,288,warlock,affliction,8,3,5
50236,Lifedriller,drakthul,288,warlock,affliction,10,3,7
50237,Ymersai,stormscale,288,warlock,affliction,12,3,9
50238,Этожедру,howling-fjord,288,warlock,affliction,12,3,9
50239,Zìì,silvermoon,288,warlock,affliction,12,3,9
50240,Zdrac,stormscale,288,warlock,affliction,12,3,9
50241,Сварожевич,galakrond,288,warlock,affliction,12,3,9
50242,Lifesteal,auchindoun,287,warlock,affliction,6,3,3
50243,Priszcilla,twisting-nether,287,warlock,affliction,6,3,3
50244,Korlox,antonidas,287,warlock,affliction,6,3,3
50245,Lewdrumpslap,kazzak,287,warlock,affliction,9,4,5
50246,Márinho,aggra-português,276,warlock,affliction,16,6,10
50247,Alarmlock,silvermoon,233,warlock,affliction,6,4,2
50248,Snaga,culte-de-la-rive-noire,233,warlock,affliction,15,5,10
50249,Lockas,ravencrest,222,warlock,affliction,8,3,5
50250,Shore,ragnaros,192,warlock,affliction,6,2,4
50251,Soundmagic,silvermoon,192,warlock,affliction,6,2,4
50252,Bowhite,silvermoon,192,warlock,affliction,6,2,4
50253,Lacruum,ragnaros,192,warlock,affliction,6,2,4
50254,Berkobaggins,ravencrest,192,warlock,affliction,6,2,4
50255,Kivilock,dun-modr,192,warlock,affliction,6,2,4
50256,Kortsoet,silvermoon,192,warlock,affliction,6,2,4
50257,Désolaté,kazzak,192,warlock,affliction,6,2,4
50258,Vibori,twisting-nether,192,warlock,affliction,6,2,4
50259,Kastón,dun-modr,192,warlock,affliction,6,2,4
50260,Meisterhexe,taerar,192,warlock,affliction,6,2,4
50261,Potatowl,ravencrest,192,warlock,affliction,6,2,4
50262,Ruvy,twisting-nether,192,warlock,affliction,6,2,4
50263,Хастла,ashenvale,192,warlock,affliction,6,2,4
50264,Supergeîl,blackrock,192,warlock,affliction,6,2,4
50265,Vhordrai,kazzak,192,warlock,affliction,6,2,4
50266,Midgetlockx,ravencrest,192,warlock,affliction,6,2,4
50267,Therelda,sanguino,192,warlock,affliction,6,2,4
50268,Мамхаус,howling-fjord,192,warlock,affliction,6,2,4
50269,Marroux,malganis,192,warlock,affliction,6,2,4
50270,Гумал,howling-fjord,192,warlock,affliction,6,2,4
50271,Born,ravencrest,192,warlock,affliction,6,2,4
50272,Zartax,kazzak,192,warlock,affliction,6,2,4
50273,ßatocko,kazzak,192,warlock,affliction,6,2,4
50274,Fredé,kazzak,192,warlock,affliction,6,2,4
50275,Сатаната,deepholm,192,warlock,affliction,6,2,4
50276,Imatión,sylvanas,192,warlock,affliction,6,2,4
50277,Recko,zuljin,192,warlock,affliction,6,2,4
50278,Necroless,shadowsong,192,warlock,affliction,6,2,4
50279,Freyjå,confrérie-du-thorium,192,warlock,affliction,6,2,4
50280,Tørcal,hyjal,192,warlock,affliction,6,2,4
50281,Hellcatherin,ghostlands,192,warlock,affliction,6,2,4
50282,Funcky,terokkar,192,warlock,affliction,6,2,4
50283,Cptdotalot,tarren-mill,192,warlock,affliction,6,2,4
50284,Norgebrur,draenor,192,warlock,affliction,6,2,4
50285,Endherkonk,sanguino,192,warlock,affliction,6,2,4
50286,Жериновсский,gordunni,192,warlock,affliction,6,2,4
50287,Enviroq,burning-legion,192,warlock,affliction,6,2,4
50288,Setharon,burning-legion,192,warlock,affliction,6,2,4
50289,Маларгас,soulflayer,192,warlock,affliction,6,2,4
50290,Shreklock,burning-blade,192,warlock,affliction,6,2,4
50291,Weedmaniac,kazzak,192,warlock,affliction,6,2,4
50292,Wutili,dun-morogh,192,warlock,affliction,6,2,4
50293,Flockyy,draenor,192,warlock,affliction,6,2,4
50294,Healél,sanguino,192,warlock,affliction,6,2,4
50295,Бирел,soulflayer,192,warlock,affliction,6,2,4
50296,Чернокнжник,soulflayer,192,warlock,affliction,6,2,4
50297,Cafardcancer,archimonde,192,warlock,affliction,6,2,4
50298,Dotsfired,aegwynn,192,warlock,affliction,6,2,4
50299,Necrolon,senjin,192,warlock,affliction,6,2,4
50300,Elvània,eredar,192,warlock,affliction,6,2,4
50301,Legend,trollbane,192,warlock,affliction,6,2,4
50302,Lakasytos,sanguino,192,warlock,affliction,6,2,4
50303,Скверножмых,gordunni,192,warlock,affliction,6,2,4
50304,Армдэд,galakrond,192,warlock,affliction,6,2,4
50305,Millhaus,gorgonnash,192,warlock,affliction,6,2,4
50306,Ðankan,aegwynn,192,warlock,affliction,6,2,4
50307,Bigbagelbob,archimonde,192,warlock,affliction,6,2,4
50308,Saltybagel,draenor,192,warlock,affliction,6,2,4
50309,Twistedfate,norgannon,192,warlock,affliction,6,2,4
50310,Myristica,die-todeskrallen,192,warlock,affliction,6,2,4
50311,Pichwise,draenor,192,warlock,affliction,6,2,4
50312,Lockingcute,tarren-mill,192,warlock,affliction,6,2,4
50313,Razkann,confrérie-du-thorium,192,warlock,affliction,6,2,4
50314,Kotihoitaja,stormreaver,192,warlock,affliction,6,2,4
50315,Tokarrus,blackmoore,192,warlock,affliction,6,2,4
50316,Portyx,archimonde,192,warlock,affliction,6,2,4
50317,Yhazel,archimonde,192,warlock,affliction,6,2,4
50318,Ozax,doomhammer,192,warlock,affliction,6,2,4
50319,Adafbhf,tichondrius,192,warlock,affliction,8,2,6
50320,Djadizpunish,stormscale,192,warlock,affliction,12,2,10
50321,Баммес,galakrond,192,warlock,affliction,12,2,10
50322,Pøx,nemesis,192,warlock,affliction,12,2,10
50323,Рыжевласочка,eversong,192,warlock,affliction,12,2,10
50324,Müsli,kiljaeden,192,warlock,affliction,12,2,10
50325,Nozzos,zuluhed,192,warlock,affliction,12,2,10
50326,Dupony,antonidas,192,warlock,affliction,12,2,10
50327,Trinxs,blackmoore,191,warlock,affliction,12,2,10
50328,Ryurans,cthun,159,warlock,affliction,5,2,3
50329,Overbuffed,wildhammer,159,warlock,affliction,5,2,3
50330,Аоепампгодх,howling-fjord,159,warlock,affliction,11,2,9
50331,Nürgle,stormscale,138,warlock,affliction,8,3,5
50332,Ghachi,draenor,138,warlock,affliction,15,3,12
50333,Paveru,tarren-mill,128,warlock,affliction,4,2,2
50334,Malariaa,defias-brotherhood,128,warlock,affliction,4,2,2
50335,Hokoreuw,echsenkessel,112,warlock,affliction,7,2,5
50336,Mergon,ravencrest,96,warlock,affliction,3,2,1
50337,Carelock,chamber-of-aspects,96,warlock,affliction,3,2,1
50338,Infernó,aerie-peak,96,warlock,affliction,3,2,1
50339,Laokoon,blackmoore,96,warlock,affliction,3,2,1
50340,Gemja,onyxia,96,warlock,affliction,6,1,5
50341,Blackwizard,theradras,96,warlock,affliction,6,1,5
50342,Branduir,ragnaros,96,warlock,affliction,6,1,5
50343,Jagerlock,doomhammer,96,warlock,affliction,6,1,5
50344,Kretuss,silvermoon,96,warlock,affliction,6,1,5
50345,Nevergladtra,darksorrow,96,warlock,affliction,6,1,5
50346,Tyranuzz,norgannon,96,warlock,affliction,6,1,5
50347,Дарунг,greymane,96,warlock,affliction,6,1,5
50348,Fearrari,ragnaros,96,warlock,affliction,6,1,5
50349,Fêâr,dun-modr,96,warlock,affliction,6,1,5
50350,Noahh,kazzak,96,warlock,affliction,6,1,5
50351,Icritmore,stormscale,96,warlock,affliction,6,1,5
50352,Händerå,ragnaros,96,warlock,affliction,6,1,5
50353,Ottu,thrall,96,warlock,affliction,6,1,5
50354,Doturanal,blackmoore,96,warlock,affliction,6,1,5
50355,Coilxo,ravencrest,96,warlock,affliction,6,1,5
50356,Robertóó,burning-legion,96,warlock,affliction,6,1,5
50357,Ðemise,antonidas,96,warlock,affliction,6,1,5
50358,Zozano,draenor,96,warlock,affliction,6,1,5
50359,Усубени,greymane,96,warlock,affliction,6,1,5
50360,Werzel,frostmane,96,warlock,affliction,6,1,5
50361,Belial,minahonda,96,warlock,affliction,6,1,5
50362,Vicktorious,stormscale,96,warlock,affliction,6,1,5
50363,Pederlock,defias-brotherhood,96,warlock,affliction,6,1,5
50364,Goefaz,blackrock,96,warlock,affliction,6,1,5
50365,Бигсмоук,howling-fjord,96,warlock,affliction,6,1,5
50366,Veridy,kazzak,96,warlock,affliction,6,1,5
50367,Merelock,eonar,96,warlock,affliction,6,1,5
50368,Killerbeez,burning-blade,96,warlock,affliction,6,1,5
50369,Mîjagî,blackhand,96,warlock,affliction,6,1,5
50370,Zxò,twisting-nether,96,warlock,affliction,8,1,7
50371,Adøume,ysondre,96,warlock,affliction,15,1,14
50372,Guldauni,tarren-mill,96,warlock,affliction,18,1,17
50373,Warlockholms,archimonde,79,warlock,affliction,5,1,4
50374,Poulebar,ysondre,64,warlock,affliction,4,1,3
50375,Natpoesje,azjolnerub,64,warlock,affliction,4,1,3
50376,Nedivh,stormscale,48,warlock,affliction,3,1,2
50377,Araqt,thrall,48,warlock,affliction,3,1,2
50378,Petrosk,sanguino,42,warlock,affliction,6,2,4
50379,Omegachad,draenor,31,warlock,affliction,2,1,1
50380,Dailylock,kazzak,31,warlock,affliction,2,1,1
50381,Tepelkwastje,twisting-nether,31,warlock,affliction,8,1,7
50382,Хичхкок,gordunni,16,warlock,affliction,1,1,0
50383,Dyingdog,kazzak,2231,warrior,fury,79,45,34
50384,Wodwod,kazzak,2203,warrior,fury,66,51,15
50385,Syltetballe,kazzak,2203,warrior,fury,84,56,28
50386,Dõxlol,kazzak,2179,warrior,fury,72,45,27
50387,Corvínus,blackrock,2137,warrior,fury,170,93,77
50388,Vitezandro,stormscale,2131,warrior,fury,66,47,19
50389,Gottdustin,lothar,2124,warrior,fury,143,78,65
50390,Uretirips,archimonde,2115,warrior,fury,168,101,67
50391,Thorana,twisting-nether,2108,warrior,fury,424,213,211
50392,Joeférnandes,ragnaros,2107,warrior,fury,72,43,29
50393,Quanny,die-aldor,2102,warrior,fury,114,67,47
50394,Níghtfúry,ravencrest,2102,warrior,fury,84,43,41
50395,Ðunhammer,blackmoore,2100,warrior,fury,114,67,47
50396,Dyingdogs,kazzak,2071,warrior,fury,72,39,33
50397,Dõxqt,kazzak,2067,warrior,fury,78,46,32
50398,Stephabibi,kazzak,2052,warrior,fury,94,55,39
50399,Blîxtgordon,tarren-mill,2045,warrior,fury,66,40,26
50400,Sockerbagarn,zenedar,2038,warrior,fury,196,105,91
50401,Nodrip,stormscale,2002,warrior,fury,114,70,44
50402,Sporctaco,nemesis,1983,warrior,fury,160,87,73
50403,Elsensor,sylvanas,1974,warrior,fury,107,49,58
50404,Gregorez,silvermoon,1937,warrior,fury,102,57,45
50405,Elsensør,thrall,1937,warrior,fury,75,38,37
50406,Thezug,blackmoore,1935,warrior,fury,96,48,48
50407,Sublex,blackrock,1933,warrior,fury,60,34,26
50408,Shinychan,silvermoon,1913,warrior,fury,48,30,18
50409,Богвойны,razuvious,1909,warrior,fury,108,58,50
50410,Robycoleman,nemesis,1895,warrior,fury,277,146,131
50411,Plackø,draenor,1890,warrior,fury,162,88,74
50412,Faraam,sunstrider,1886,warrior,fury,51,25,26
50413,Picciocino,nemesis,1877,warrior,fury,107,58,49
50414,Варплеер,gordunni,1875,warrior,fury,76,39,37
50415,Schultze,kazzak,1875,warrior,fury,166,73,93
50416,Schlauberg,azshara,1871,warrior,fury,72,42,30
50417,Дахирарг,fordragon,1871,warrior,fury,90,46,44
50418,Insanedmg,dun-modr,1864,warrior,fury,72,40,32
50419,Dwarfsteel,stormscale,1864,warrior,fury,42,23,19
50420,Émalkay,tarren-mill,1863,warrior,fury,48,26,22
50421,Релайк,gordunni,1860,warrior,fury,60,33,27
50422,Bloodhorn,blackhand,1857,warrior,fury,54,36,18
50423,Brythwyn,blackrock,1856,warrior,fury,54,30,24
50424,Wruxar,bronzebeard,1856,warrior,fury,54,29,25
50425,Ironbound,silvermoon,1853,warrior,fury,36,25,11
50426,Pflanzling,nozdormu,1851,warrior,fury,106,52,54
50427,Kwesta,kazzak,1850,warrior,fury,60,34,26
50428,Morganãrogán,ragnaros,1850,warrior,fury,42,23,19
50429,Yaler,alakir,1847,warrior,fury,48,33,15
50430,Cesr,bloodhoof,1847,warrior,fury,126,71,55
50431,Jeco,tarren-mill,1846,warrior,fury,66,39,27
50432,Ørìgíñälgøðx,archimonde,1845,warrior,fury,48,32,16
50433,Yawalad,stormscale,1845,warrior,fury,66,35,31
50434,Анжинерх,gordunni,1843,warrior,fury,66,39,27
50435,Oneoneseven,archimonde,1841,warrior,fury,78,49,29
50436,Sublex,aegwynn,1838,warrior,fury,60,36,24
50437,Frozenliøn,twisting-nether,1836,warrior,fury,48,32,16
50438,Ibunnyone,blackrock,1836,warrior,fury,60,32,28
50439,Lair,zuljin,1835,warrior,fury,106,67,39
50440,Elian,ragnaros,1835,warrior,fury,72,36,36
50441,Méido,argent-dawn,1833,warrior,fury,325,172,153
50442,Imolderthenu,blackrock,1825,warrior,fury,166,91,75
50443,Zidbi,argent-dawn,1825,warrior,fury,126,68,58
50444,Kenryu,argent-dawn,1825,warrior,fury,60,32,28
50445,Dronikos,ravencrest,1824,warrior,fury,54,35,19
50446,Köftemecx,blackrock,1824,warrior,fury,127,82,45
50447,Sonnyzz,sanguino,1824,warrior,fury,36,21,15
50448,Timewarrior,ravencrest,1824,warrior,fury,54,30,24
50449,Xark,drakthul,1824,warrior,fury,90,49,41
50450,Deatheart,ysondre,1824,warrior,fury,76,41,35
50451,Трэйдар,blackscar,1823,warrior,fury,48,27,21
50452,Gladius,blutkessel,1819,warrior,fury,156,80,76
50453,Тиран,howling-fjord,1817,warrior,fury,48,27,21
50454,Letiis,blackrock,1816,warrior,fury,105,57,48
50455,Jaý,draenor,1815,warrior,fury,56,35,21
50456,Adian,ravencrest,1813,warrior,fury,42,26,16
50457,Badon,burning-legion,1812,warrior,fury,60,39,21
50458,Zednos,twilights-hammer,1812,warrior,fury,184,102,82
50459,Arthoc,sanguino,1811,warrior,fury,60,36,24
50460,Злопиканка,gordunni,1811,warrior,fury,67,34,33
50461,Xzwarr,silvermoon,1810,warrior,fury,38,21,17
50462,Мигнт,howling-fjord,1810,warrior,fury,42,23,19
50463,Hawkman,outland,1809,warrior,fury,41,25,16
50464,Cuzyxtwo,blackrock,1809,warrior,fury,60,35,25
50465,Capitalista,das-konsortium,1809,warrior,fury,90,51,39
50466,Clellin,silvermoon,1807,warrior,fury,139,80,59
50467,Leelazero,argent-dawn,1807,warrior,fury,78,44,34
50468,Späns,ragnaros,1807,warrior,fury,71,34,37
50469,Zyalen,stormscale,1806,warrior,fury,60,32,28
50470,Beasterbunny,outland,1804,warrior,fury,109,63,46
50471,Kizzyo,draenor,1804,warrior,fury,96,51,45
50472,Nóvamh,draenor,1802,warrior,fury,42,24,18
50473,Kocmochka,tarren-mill,1802,warrior,fury,60,32,28
50474,Heartmemphis,stormscale,1801,warrior,fury,41,24,17
50475,Dreams,auchindoun,1801,warrior,fury,48,28,20
50476,Vykoz,sylvanas,1800,warrior,fury,42,24,18
50477,Sonnylolxd,dun-modr,1800,warrior,fury,54,29,25
50478,Дестингл,gordunni,1797,warrior,fury,42,26,16
50479,Grulbash,stormscale,1792,warrior,fury,42,22,20
50480,Apacolata,outland,1790,warrior,fury,36,19,17
50481,Basiletha,hyjal,1788,warrior,fury,41,20,21
50482,Geez,burning-blade,1787,warrior,fury,42,23,19
50483,Budgetassa,stormscale,1784,warrior,fury,42,23,19
50484,Castlevania,ravencrest,1784,warrior,fury,73,38,35
50485,Goorila,kazzak,1776,warrior,fury,48,28,20
50486,Âshnâzgðûr,burning-blade,1776,warrior,fury,99,48,51
50487,Yserá,auchindoun,1775,warrior,fury,58,27,31
50488,Zadirich,burning-blade,1774,warrior,fury,66,35,31
50489,Tóffèl,thrall,1773,warrior,fury,48,32,16
50490,Rïmxøxø,haomarush,1773,warrior,fury,48,32,16
50491,Warrez,azuremyst,1773,warrior,fury,125,72,53
50492,Ryonâgai,aegwynn,1773,warrior,fury,54,30,24
50493,Luxurious,argent-dawn,1770,warrior,fury,72,40,32
50494,Stansmash,kazzak,1768,warrior,fury,36,22,14
50495,Tanja,bronzebeard,1767,warrior,fury,48,28,20
50496,Футжисубо,razuvious,1760,warrior,fury,126,65,61
50497,Nozuki,archimonde,1751,warrior,fury,172,98,74
50498,Rocketx,blackrock,1750,warrior,fury,36,19,17
50499,Løktær,blackmoore,1747,warrior,fury,60,27,33
50500,Rãzmø,hyjal,1744,warrior,fury,78,42,36
50501,Rhynot,argent-dawn,1741,warrior,fury,42,32,10
50502,Thundersword,sylvanas,1741,warrior,fury,92,50,42
50503,Ðønøvan,sanguino,1733,warrior,fury,106,60,46
50504,Джакир,howling-fjord,1733,warrior,fury,54,29,25
50505,Luigistar,naxxramas,1733,warrior,fury,144,73,71
50506,Едигейй,gordunni,1732,warrior,fury,96,58,38
50507,Рыгатрон,galakrond,1732,warrior,fury,36,19,17
50508,Çon,ravencrest,1731,warrior,fury,60,35,25
50509,Propanex,kazzak,1729,warrior,fury,54,33,21
50510,Gatts,krasus,1729,warrior,fury,66,39,27
50511,Eddíemòrphin,kazzak,1728,warrior,fury,58,34,24
50512,Irontouch,draenor,1728,warrior,fury,75,42,33
50513,Хенгард,gordunni,1727,warrior,fury,72,41,31
50514,Pouckette,hyjal,1726,warrior,fury,84,46,38
50515,Wgdx,ravencrest,1726,warrior,fury,54,28,26
50516,Juna,hellscream,1726,warrior,fury,91,47,44
50517,Даймонддогс,gordunni,1725,warrior,fury,64,36,28
50518,Biturboo,blackrock,1725,warrior,fury,73,35,38
50519,Agrias,burning-legion,1722,warrior,fury,60,35,25
50520,Honzakesl,drakthul,1721,warrior,fury,63,37,26
50521,Risara,outland,1720,warrior,fury,49,31,18
50522,Грамол,soulflayer,1719,warrior,fury,66,36,30
50523,Кавайтити,blackscar,1718,warrior,fury,39,19,20
50524,Варынеопэ,gordunni,1717,warrior,fury,65,35,30
50525,Koljach,sylvanas,1717,warrior,fury,162,87,75
50526,Soakmybeet,archimonde,1716,warrior,fury,71,37,34
50527,Ironmásk,tarren-mill,1716,warrior,fury,42,21,21
50528,Silq,zuljin,1713,warrior,fury,36,18,18
50529,Тьмасвятая,gordunni,1710,warrior,fury,42,22,20
50530,Ampw,ravencrest,1707,warrior,fury,36,24,12
50531,Osha,hyjal,1707,warrior,fury,326,166,160
50532,Tooski,sylvanas,1707,warrior,fury,65,31,34
50533,Wismerx,kazzak,1706,warrior,fury,30,19,11
50534,Читора,blackscar,1702,warrior,fury,65,35,30
50535,Дарккардинал,deathguard,1699,warrior,fury,76,38,38
50536,Oldcockball,argent-dawn,1698,warrior,fury,90,51,39
50537,Bigbugatti,draenor,1698,warrior,fury,71,32,39
50538,Durif,argent-dawn,1697,warrior,fury,36,24,12
50539,Violentfunky,ravencrest,1697,warrior,fury,84,40,44
50540,Discoklaus,blackmoore,1696,warrior,fury,282,144,138
50541,Kiha,argent-dawn,1695,warrior,fury,42,24,18
50542,Margon,aegwynn,1692,warrior,fury,48,29,19
50543,Bananapower,aszune,1692,warrior,fury,54,30,24
50544,Bözzy,stormreaver,1690,warrior,fury,192,103,89
50545,Yodabär,blackmoore,1690,warrior,fury,120,62,58
50546,Jinrok,turalyon,1685,warrior,fury,114,69,45
50547,Dödgrävarn,stormscale,1685,warrior,fury,102,57,45
50548,Hangart,argent-dawn,1683,warrior,fury,36,20,16
50549,Дейдулус,soulflayer,1682,warrior,fury,42,23,19
50550,Oogaboogadps,silvermoon,1682,warrior,fury,175,93,82
50551,Vesnãpusic,draenor,1680,warrior,fury,63,39,24
50552,Slaycon,sanguino,1680,warrior,fury,69,29,40
50553,Эйримор,gordunni,1679,warrior,fury,161,83,78
50554,Kibb,sylvanas,1678,warrior,fury,56,35,21
50555,Galenthor,ravencrest,1678,warrior,fury,42,24,18
50556,Байсал,gordunni,1677,warrior,fury,127,68,59
50557,Gôrilla,kazzak,1674,warrior,fury,32,19,13
50558,Даркслеерх,howling-fjord,1674,warrior,fury,36,18,18
50559,Бубаигавар,gordunni,1673,warrior,fury,42,22,20
50560,Протектор,soulflayer,1673,warrior,fury,160,79,81
50561,Neopronouns,stormscale,1672,warrior,fury,36,22,14
50562,Råzor,blackhand,1672,warrior,fury,215,117,98
50563,Gewyon,ragnaros,1669,warrior,fury,29,18,11
50564,Decapitatëd,outland,1668,warrior,fury,36,19,17
50565,Walexmaryk,ragnaros,1666,warrior,fury,161,87,74
50566,Telrion,silvermoon,1666,warrior,fury,48,24,24
50567,Ranmaru,kazzak,1665,warrior,fury,97,46,51
50568,Aleextrasza,silvermoon,1664,warrior,fury,43,24,19
50569,Xeraaya,kirin-tor,1664,warrior,fury,96,45,51
50570,Níká,bronzebeard,1663,warrior,fury,52,30,22
50571,Берззлой,gordunni,1661,warrior,fury,52,30,22
50572,Gigatscheb,eredar,1659,warrior,fury,78,41,37
50573,Averenx,frostwolf,1659,warrior,fury,110,57,53
50574,Titza,silvermoon,1659,warrior,fury,68,31,37
50575,Iagô,argent-dawn,1655,warrior,fury,60,35,25
50576,Jetman,ravencrest,1654,warrior,fury,58,29,29
50577,Toptier,drakthul,1653,warrior,fury,53,30,23
50578,Pizdatos,ravencrest,1653,warrior,fury,54,30,24
50579,Очепенец,soulflayer,1652,warrior,fury,129,66,63
50580,Noproblem,ragnaros,1650,warrior,fury,65,34,31
50581,Мамкингерой,howling-fjord,1649,warrior,fury,54,32,22
50582,Xzurgster,twisting-nether,1649,warrior,fury,52,23,29
50583,Harbee,stormscale,1647,warrior,fury,170,96,74
50584,Dangeruos,ragnaros,1646,warrior,fury,36,20,16
50585,Antismoke,silvermoon,1645,warrior,fury,105,59,46
50586,Zerberos,drakthul,1645,warrior,fury,131,69,62
50587,Swayzze,frostwolf,1642,warrior,fury,48,27,21
50588,Unstopablle,twisting-nether,1638,warrior,fury,96,52,44
50589,Темнозорь,ashenvale,1638,warrior,fury,61,31,30
50590,Mybigcow,darkspear,1638,warrior,fury,53,25,28
50591,Боссберс,soulflayer,1636,warrior,fury,78,44,34
50592,Хуфхорнс,soulflayer,1636,warrior,fury,39,21,18
50593,Элинглир,gordunni,1635,warrior,fury,69,37,32
50594,Вадло,soulflayer,1635,warrior,fury,54,27,27
50595,Bastquirage,dalaran,1633,warrior,fury,42,24,18
50596,Ðènlos,destromath,1632,warrior,fury,84,43,41
50597,Кладбошаа,gordunni,1632,warrior,fury,133,66,67
50598,Ifir,hyjal,1632,warrior,fury,70,33,37
50599,Susugar,ysondre,1631,warrior,fury,72,35,37
50600,Sanngridr,defias-brotherhood,1629,warrior,fury,66,32,34
50601,Pòóòóòóòópz,dun-modr,1628,warrior,fury,30,17,13
50602,Peli,burning-blade,1628,warrior,fury,228,114,114
50603,Nerfrend,stormscale,1627,warrior,fury,30,17,13
50604,Broley,blackhand,1627,warrior,fury,76,43,33
50605,Vágópityu,ragnaros,1627,warrior,fury,48,24,24
50606,Megalann,silvermoon,1627,warrior,fury,84,41,43
50607,Ананаслорд,blackscar,1625,warrior,fury,36,25,11
50608,Azazelslayer,dethecus,1625,warrior,fury,66,43,23
50609,Вимор,soulflayer,1624,warrior,fury,36,19,17
50610,Skylexs,burning-legion,1624,warrior,fury,48,22,26
50611,Swofty,arygos,1622,warrior,fury,24,17,7
50612,Raoh,archimonde,1621,warrior,fury,48,34,14
50613,Металлие,howling-fjord,1621,warrior,fury,48,21,27
50614,Aramý,argent-dawn,1620,warrior,fury,24,17,7
50615,Vulcán,aerie-peak,1620,warrior,fury,36,21,15
50616,Shhimbanned,doomhammer,1619,warrior,fury,30,21,9
50617,Jésusiskíng,amanthul,1619,warrior,fury,31,18,13
50618,Котаче,soulflayer,1619,warrior,fury,130,65,65
50619,Savarøx,blackmoore,1618,warrior,fury,42,26,16
50620,Flexbot,blackmoore,1617,warrior,fury,38,23,15
50621,Poggsaron,kazzak,1617,warrior,fury,105,52,53
50622,Shilix,twisting-nether,1616,warrior,fury,30,20,10
50623,Borndet,eredar,1616,warrior,fury,63,37,26
50624,Nobodyx,tarren-mill,1616,warrior,fury,120,69,51
50625,Vegilhenvin,stormscale,1616,warrior,fury,111,62,49
50626,Discølove,frostwolf,1615,warrior,fury,35,19,16
50627,Êssâ,stormscale,1612,warrior,fury,30,17,13
50628,Vÿnk,ysondre,1611,warrior,fury,116,61,55
50629,Dracømort,dalaran,1610,warrior,fury,42,24,18
50630,Monbun,silvermoon,1610,warrior,fury,43,24,19
50631,Mezen,stormscale,1609,warrior,fury,69,41,28
50632,Шлифую,howling-fjord,1609,warrior,fury,72,35,37
50633,Celn,silvermoon,1608,warrior,fury,145,80,65
50634,Неуно,howling-fjord,1607,warrior,fury,66,41,25
50635,Хёда,eversong,1607,warrior,fury,60,32,28
50636,Wabisabì,silvermoon,1607,warrior,fury,63,33,30
50637,Ёнморт,gordunni,1606,warrior,fury,30,20,10
50638,Джоулирэдблу,howling-fjord,1606,warrior,fury,42,22,20
50639,Notvisionary,ravencrest,1606,warrior,fury,36,17,19
50640,Eekz,haomarush,1605,warrior,fury,30,19,11
50641,Boos,burning-legion,1605,warrior,fury,30,17,13
50642,Radamantys,drakthul,1603,warrior,fury,63,34,29
50643,Halalmeat,minahonda,1603,warrior,fury,59,29,30
50644,Гронвер,soulflayer,1601,warrior,fury,134,75,59
50645,Явараа,howling-fjord,1600,warrior,fury,72,41,31
50646,Bourbimrgllr,hyjal,1600,warrior,fury,45,25,20
50647,Halfbroken,moonglade,1600,warrior,fury,78,37,41
50648,Littlebugger,ravencrest,1599,warrior,fury,30,17,13
50649,Ebonheart,argent-dawn,1599,warrior,fury,59,32,27
50650,Hanìbal,ravencrest,1599,warrior,fury,177,89,88
50651,Høvdingen,outland,1598,warrior,fury,30,19,11
50652,Rofos,hellscream,1597,warrior,fury,55,29,26
50653,Гринфинч,galakrond,1597,warrior,fury,130,66,64
50654,Abnôrmus,tarren-mill,1594,warrior,fury,114,53,61
50655,Dasdabane,twisting-nether,1593,warrior,fury,64,38,26
50656,Lífelover,tarren-mill,1593,warrior,fury,66,30,36
50657,Gantór,blackrock,1593,warrior,fury,48,21,27
50658,Roxxyy,stormreaver,1592,warrior,fury,59,33,26
50659,Sköldpaddor,tarren-mill,1592,warrior,fury,40,22,18
50660,Methodxd,outland,1592,warrior,fury,78,38,40
50661,Hynish,doomhammer,1589,warrior,fury,82,44,38
50662,Zbra,draenor,1588,warrior,fury,47,23,24
50663,Zupkaztrópka,burning-legion,1587,warrior,fury,89,47,42
50664,Jeepzinc,blackmoore,1587,warrior,fury,36,19,17
50665,Gromex,stormscale,1587,warrior,fury,75,31,44
50666,Тралмош,razuvious,1581,warrior,fury,57,35,22
50667,Bursch,ravencrest,1580,warrior,fury,42,21,21
50668,Илийя,razuvious,1579,warrior,fury,48,21,27
50669,Wornag,argent-dawn,1578,warrior,fury,83,40,43
50670,Тактоядобрый,ashenvale,1578,warrior,fury,47,20,27
50671,Yousainsbolt,blackrock,1577,warrior,fury,68,35,33
50672,Xåb,dun-morogh,1577,warrior,fury,44,17,27
50673,Dizzyndumb,draenor,1575,warrior,fury,165,93,72
50674,Латахо,gordunni,1574,warrior,fury,54,27,27
50675,Asmoche,archimonde,1571,warrior,fury,60,29,31
50676,Uwuwarrior,alleria,1570,warrior,fury,64,35,29
50677,Pepegle,argent-dawn,1569,warrior,fury,36,21,15
50678,Garlogar,twisting-nether,1569,warrior,fury,108,59,49
50679,Криккс,greymane,1568,warrior,fury,72,33,39
50680,Narukeratnik,draenor,1567,warrior,fury,66,38,28
50681,Иктиннос,gordunni,1565,warrior,fury,57,21,36
50682,Stahlhund,silvermoon,1564,warrior,fury,87,47,40
50683,Lyrv,ravencrest,1563,warrior,fury,30,17,13
50684,Wøokz,argent-dawn,1563,warrior,fury,172,87,85
50685,Касюлин,gordunni,1562,warrior,fury,53,31,22
50686,Æç,argent-dawn,1562,warrior,fury,36,19,17
50687,Alexandrrior,rexxar,1561,warrior,fury,69,41,28
50688,Senshin,sanguino,1561,warrior,fury,92,46,46
50689,Flippingout,stormscale,1560,warrior,fury,60,27,33
50690,Нордгаар,howling-fjord,1559,warrior,fury,42,27,15
50691,Bønecleaver,blackrock,1558,warrior,fury,110,56,54
50692,Thorken,ragnaros,1557,warrior,fury,59,29,30
50693,Сариату,soulflayer,1556,warrior,fury,72,34,38
50694,Monnee,silvermoon,1555,warrior,fury,42,26,16
50695,Вундеркитти,soulflayer,1555,warrior,fury,86,43,43
50696,Mikogød,ravencrest,1553,warrior,fury,54,31,23
50697,Waralert,kazzak,1553,warrior,fury,36,19,17
50698,Bartins,magtheridon,1550,warrior,fury,66,39,27
50699,Груббоб,booty-bay,1548,warrior,fury,102,53,49
50700,Zwareboy,frostmane,1546,warrior,fury,48,20,28
50701,Zhenshii,blackmoore,1544,warrior,fury,71,36,35
50702,Goomby,argent-dawn,1544,warrior,fury,48,22,26
50703,Dævedoff,sanguino,1543,warrior,fury,65,35,30
50704,Horovoko,kazzak,1541,warrior,fury,24,18,6
50705,Karentneuf,khaz-modan,1541,warrior,fury,35,23,12
50706,Baldemort,antonidas,1541,warrior,fury,105,57,48
50707,Владикчардж,gordunni,1535,warrior,fury,41,22,19
50708,Hejduk,frostmane,1533,warrior,fury,30,20,10
50709,Вменяемый,gordunni,1533,warrior,fury,88,44,44
50710,Белославный,gordunni,1532,warrior,fury,55,38,17
50711,ßbç,ysondre,1532,warrior,fury,84,41,43
50712,Anakhas,archimonde,1531,warrior,fury,30,16,14
50713,Альмас,galakrond,1531,warrior,fury,59,29,30
50714,Féélmyfury,tarren-mill,1528,warrior,fury,23,16,7
50715,Erosdulko,silvermoon,1528,warrior,fury,54,24,30
50716,Spokowar,hyjal,1527,warrior,fury,47,23,24
50717,Тегриско,goldrinn,1527,warrior,fury,72,34,38
50718,Grâkul,twisting-nether,1526,warrior,fury,263,134,129
50719,Bigbibbs,tarren-mill,1526,warrior,fury,68,32,36
50720,Certavus,antonidas,1525,warrior,fury,60,31,29
50721,Indicaflower,ahnqiraj,1525,warrior,fury,101,51,50
50722,Stérkkû,stormscale,1525,warrior,fury,102,46,56
50723,Linzao,archimonde,1524,warrior,fury,30,16,14
50724,Bobitybob,ravencrest,1520,warrior,fury,60,36,24
50725,Jeronimoe,blackmoore,1520,warrior,fury,41,24,17
50726,Inconcussae,drakthul,1519,warrior,fury,30,19,11
50727,Mirpz,doomhammer,1519,warrior,fury,47,24,23
50728,Berré,ragnaros,1518,warrior,fury,48,23,25
50729,Hemèra,hyjal,1517,warrior,fury,62,33,29
50730,Oravedenes,draenor,1514,warrior,fury,110,66,44
50731,Zwecko,malganis,1513,warrior,fury,30,16,14
50732,Pokopo,blackrock,1510,warrior,fury,42,23,19
50733,Bleaja,tarren-mill,1509,warrior,fury,24,16,8
50734,Wärlør,ravencrest,1509,warrior,fury,78,49,29
50735,Slidmacka,twisting-nether,1509,warrior,fury,42,26,16
50736,Втораянатура,howling-fjord,1508,warrior,fury,36,22,14
50737,Gids,silvermoon,1506,warrior,fury,34,21,13
50738,Xiny,blackrock,1506,warrior,fury,42,24,18
50739,Craghak,twisting-nether,1506,warrior,fury,100,52,48
50740,Truckfury,ravencrest,1504,warrior,fury,88,46,42
50741,Gronos,silvermoon,1504,warrior,fury,74,38,36
50742,Thrallhall,kazzak,1503,warrior,fury,131,59,72
50743,Мурмадонио,soulflayer,1503,warrior,fury,78,35,43
50744,Арристокррат,soulflayer,1501,warrior,fury,42,23,19
50745,Jarggyül,culte-de-la-rive-noire,1500,warrior,fury,36,21,15
50746,Crriminal,ravencrest,1498,warrior,fury,24,16,8
50747,Sebastian,ravencrest,1498,warrior,fury,60,29,31
50748,Bäiley,drakthul,1497,warrior,fury,54,18,36
50749,Магрейн,grom,1496,warrior,fury,110,54,56
50750,Gely,silvermoon,1495,warrior,fury,30,16,14
50751,Cortix,blackmoore,1493,warrior,fury,34,20,14
50752,Лазба,gordunni,1493,warrior,fury,58,31,27
50753,Enzja,nazjatar,1492,warrior,fury,31,18,13
50754,Evrybodydown,draenor,1492,warrior,fury,148,77,71
50755,Bloodmyst,kazzak,1489,warrior,fury,60,33,27
50756,Nemecic,arathor,1489,warrior,fury,36,18,18
50757,Zaximos,twisting-nether,1488,warrior,fury,62,30,32
50758,Fizzywarrior,blackmoore,1488,warrior,fury,60,29,31
50759,Лимор,howling-fjord,1488,warrior,fury,42,16,26
50760,Ärmodäuss,norgannon,1486,warrior,fury,69,34,35
50761,Чиллх,gordunni,1485,warrior,fury,58,33,25
50762,Corrin,frostmourne,1485,warrior,fury,122,68,54
50763,Ууша,soulflayer,1485,warrior,fury,59,29,30
50764,Rimvar,alleria,1484,warrior,fury,60,28,32
50765,Жироштемп,gordunni,1483,warrior,fury,58,30,28
50766,Варрвик,howling-fjord,1483,warrior,fury,57,28,29
50767,Perinel,draenor,1483,warrior,fury,82,32,50
50768,Blaktarr,dunemaul,1482,warrior,fury,51,28,23
50769,Jorund,archimonde,1482,warrior,fury,54,26,28
50770,Чпонькмашина,soulflayer,1474,warrior,fury,92,53,39
50771,Roidspam,outland,1471,warrior,fury,71,28,43
50772,Broksigarr,ragnaros,1470,warrior,fury,30,17,13
50773,Auglok,twisting-nether,1468,warrior,fury,120,61,59
50774,Мундэфэндэр,lich-king,1467,warrior,fury,46,18,28
50775,Cocojumbo,azuremyst,1466,warrior,fury,42,23,19
50776,Nurti,silvermoon,1465,warrior,fury,36,21,15
50777,Straya,malorne,1463,warrior,fury,60,30,30
50778,Chrissey,argent-dawn,1462,warrior,fury,45,21,24
50779,Анакронокс,howling-fjord,1461,warrior,fury,58,29,29
50780,Hrodulf,moonglade,1461,warrior,fury,83,38,45
50781,Gozgu,stormscale,1460,warrior,fury,26,16,10
50782,Tweegles,argent-dawn,1460,warrior,fury,71,35,36
50783,Grubshak,burning-legion,1460,warrior,fury,47,22,25
50784,Kobeni,ysondre,1457,warrior,fury,50,30,20
50785,Mustar,alexstrasza,1457,warrior,fury,77,45,32
50786,Stratoz,ragnaros,1457,warrior,fury,61,27,34
50787,Bluemango,ragnaros,1454,warrior,fury,36,19,17
50788,Èscøbar,dalaran,1454,warrior,fury,49,23,26
50789,Zugbro,stormscale,1452,warrior,fury,48,25,23
50790,Скехит,blackscar,1449,warrior,fury,66,32,34
50791,Aeyon,burning-blade,1449,warrior,fury,37,17,20
50792,Tyrâdus,kiljaeden,1445,warrior,fury,36,22,14
50793,Добиватель,howling-fjord,1445,warrior,fury,72,37,35
50794,Eygón,silvermoon,1445,warrior,fury,66,28,38
50795,Gìlgamesh,dun-modr,1444,warrior,fury,55,30,25
50796,Rîiper,ysondre,1444,warrior,fury,42,22,20
50797,Toundrâa,archimonde,1444,warrior,fury,169,86,83
50798,Vandalismee,draenor,1443,warrior,fury,28,19,9
50799,Старопрамен,thermaplugg,1443,warrior,fury,225,119,106
50800,Krigarjag,kazzak,1442,warrior,fury,42,28,14
50801,Syfér,grim-batol,1441,warrior,fury,34,20,14
50802,Dragão,kazzak,1440,warrior,fury,60,28,32
50803,Golias,argent-dawn,1439,warrior,fury,48,30,18
50804,Tatabaf,ysondre,1437,warrior,fury,42,23,19
50805,Bukisan,sylvanas,1437,warrior,fury,107,53,54
50806,Rëvenge,burning-legion,1437,warrior,fury,90,44,46
50807,Floppikatten,kazzak,1432,warrior,fury,24,17,7
50808,Спайкуссь,goldrinn,1431,warrior,fury,78,42,36
50809,Wätras,drakthul,1431,warrior,fury,30,16,14
50810,Xalont,doomhammer,1431,warrior,fury,36,17,19
50811,Borntothis,zuljin,1430,warrior,fury,92,53,39
50812,Honör,sylvanas,1430,warrior,fury,48,23,25
50813,Pinkíe,blackmoore,1428,warrior,fury,30,15,15
50814,Shadroq,auchindoun,1427,warrior,fury,24,15,9
50815,Fridaax,lightbringer,1427,warrior,fury,24,15,9
50816,Akînos,kazzak,1427,warrior,fury,69,34,35
50817,Shadowcacau,aggra-português,1426,warrior,fury,59,29,30
50818,Faylania,tarren-mill,1425,warrior,fury,42,25,17
50819,Dajnatarcze,burning-legion,1425,warrior,fury,36,19,17
50820,Emcix,aszune,1425,warrior,fury,30,15,15
50821,Лаинвуд,soulflayer,1425,warrior,fury,51,25,26
50822,Reidunøks,kazzak,1422,warrior,fury,83,44,39
50823,Touguro,aggra-português,1422,warrior,fury,57,26,31
50824,Madaxe,kazzak,1421,warrior,fury,24,15,9
50825,Profär,archimonde,1419,warrior,fury,30,16,14
50826,Alexdgreat,tarren-mill,1418,warrior,fury,26,15,11
50827,Divyx,tarren-mill,1417,warrior,fury,42,21,21
50828,Flexecutie,silvermoon,1414,warrior,fury,30,17,13
50829,Bravestarrz,ungoro,1414,warrior,fury,92,43,49
50830,Hervor,les-sentinelles,1413,warrior,fury,78,44,34
50831,Æsterius,blackmoore,1411,warrior,fury,95,47,48
50832,Overgear,twisting-nether,1410,warrior,fury,30,15,15
50833,Артен,ashenvale,1407,warrior,fury,32,15,17
50834,Voffsen,tarren-mill,1407,warrior,fury,54,24,30
50835,Sonyd,tarren-mill,1405,warrior,fury,36,22,14
50836,Zeliøn,elune,1405,warrior,fury,90,51,39
50837,Varyian,sporeggar,1405,warrior,fury,98,53,45
50838,Terisá,blackmoore,1405,warrior,fury,46,24,22
50839,Rìsàs,draenor,1405,warrior,fury,150,74,76
50840,Gamepresa,silvermoon,1404,warrior,fury,61,30,31
50841,Torok,antonidas,1402,warrior,fury,36,25,11
50842,Борзило,howling-fjord,1402,warrior,fury,36,21,15
50843,Каган,gordunni,1402,warrior,fury,45,26,19
50844,Krauus,silvermoon,1402,warrior,fury,109,59,50
50845,Raoh,blackrock,1400,warrior,fury,24,15,9
50846,Realz,malganis,1400,warrior,fury,90,49,41
50847,Ikkr,kazzak,1400,warrior,fury,72,39,33
50848,Hidaykus,bronzebeard,1399,warrior,fury,70,35,35
50849,Imora,silvermoon,1398,warrior,fury,36,21,15
50850,Botgrinder,blackhand,1396,warrior,fury,95,54,41
50851,Нириэла,howling-fjord,1396,warrior,fury,66,31,35
50852,Prîde,kazzak,1394,warrior,fury,36,22,14
50853,Kwedrowar,burning-legion,1393,warrior,fury,133,61,72
50854,Keriane,garona,1389,warrior,fury,65,33,32
50855,Dríppy,aegwynn,1388,warrior,fury,33,20,13
50856,Штормскейл,soulflayer,1388,warrior,fury,30,16,14
50857,Дралк,gordunni,1384,warrior,fury,34,16,18
50858,Skefe,archimonde,1383,warrior,fury,46,29,17
50859,Reccey,blackrock,1379,warrior,fury,30,16,14
50860,Ligthblâd,hyjal,1378,warrior,fury,57,31,26
50861,Rèckless,argent-dawn,1377,warrior,fury,24,18,6
50862,Tigron,burning-legion,1377,warrior,fury,54,33,21
50863,Антурим,howling-fjord,1377,warrior,fury,32,17,15
50864,Warrouner,khaz-modan,1377,warrior,fury,48,22,26
50865,Rakherus,silvermoon,1376,warrior,fury,30,16,14
50866,Shán,defias-brotherhood,1375,warrior,fury,60,33,27
50867,Unchåined,burning-legion,1372,warrior,fury,69,34,35
50868,Rommick,guldan,1372,warrior,fury,60,27,33
50869,Thagzar,burning-legion,1371,warrior,fury,162,76,86
50870,Whimbux,stormscale,1371,warrior,fury,51,23,28
50871,Ralzung,twisting-nether,1370,warrior,fury,54,26,28
50872,Васильна,soulflayer,1369,warrior,fury,36,21,15
50873,Чюнилингус,soulflayer,1369,warrior,fury,43,15,28
50874,Enderyx,blackhand,1363,warrior,fury,30,15,15
50875,Gruttak,aegwynn,1361,warrior,fury,24,16,8
50876,Diioxyde,temple-noir,1360,warrior,fury,30,17,13
50877,Килджаеден,deathguard,1358,warrior,fury,34,17,17
50878,Èrzà,sanguino,1358,warrior,fury,76,35,41
50879,Wärfäcë,blades-edge,1357,warrior,fury,40,23,17
50880,Ribastur,blackmoore,1355,warrior,fury,168,89,79
50881,Hagoxfit,los-errantes,1355,warrior,fury,41,19,22
50882,Midvînter,silvermoon,1354,warrior,fury,45,19,26
50883,Gromrigg,draenor,1348,warrior,fury,95,41,54
50884,Somalisktjur,tarren-mill,1347,warrior,fury,60,31,29
50885,Habaneroo,zuljin,1345,warrior,fury,36,15,21
50886,Bráïnléss,silvermoon,1343,warrior,fury,32,15,17
50887,Zêke,thrall,1342,warrior,fury,24,18,6
50888,Stretch,thrall,1341,warrior,fury,31,15,16
50889,Hatenest,argent-dawn,1341,warrior,fury,198,94,104
50890,Krieg,garrosh,1341,warrior,fury,61,21,40
50891,Mitu,sanguino,1338,warrior,fury,24,14,10
50892,Brigitá,argent-dawn,1338,warrior,fury,30,14,16
50893,Raynhorn,silvermoon,1337,warrior,fury,24,14,10
50894,Jisoowar,blackhand,1337,warrior,fury,36,15,21
50895,Moggorr,nemesis,1334,warrior,fury,46,24,22
50896,Màrduk,pozzo-delleternità,1333,warrior,fury,36,19,17
50897,Hirbz,silvermoon,1333,warrior,fury,66,34,32
50898,Schuy,silvermoon,1333,warrior,fury,78,40,38
50899,Taoke,ravencrest,1333,warrior,fury,30,14,16
50900,Hobbó,draenor,1333,warrior,fury,78,31,47
50901,Killhound,argent-dawn,1332,warrior,fury,24,14,10
50902,Акози,fordragon,1332,warrior,fury,60,33,27
50903,Nmwar,turalyon,1332,warrior,fury,39,20,19
50904,Üzzy,dun-modr,1331,warrior,fury,78,46,32
50905,Вардеспетчер,razuvious,1331,warrior,fury,36,19,17
50906,Thaddaus,ravencrest,1331,warrior,fury,123,58,65
50907,Kundrak,blackhand,1330,warrior,fury,55,28,27
50908,Kragar,anetheron,1329,warrior,fury,45,25,20
50909,Skaurmosh,argent-dawn,1329,warrior,fury,60,31,29
50910,Luunk,ravencrest,1329,warrior,fury,72,36,36
50911,Ganaroth,tarren-mill,1328,warrior,fury,42,21,21
50912,Роконишу,gordunni,1326,warrior,fury,30,18,12
50913,Джелорд,howling-fjord,1326,warrior,fury,30,14,16
50914,Tweran,drakthul,1323,warrior,fury,29,14,15
50915,Gudvin,terokkar,1322,warrior,fury,47,29,18
50916,Imorphius,silvermoon,1321,warrior,fury,30,14,16
50917,Кроуфури,gordunni,1318,warrior,fury,54,31,23
50918,Ðèxs,ravencrest,1318,warrior,fury,30,17,13
50919,Buzzingwarr,tarren-mill,1318,warrior,fury,60,29,31
50920,Usz,thunderhorn,1317,warrior,fury,48,29,19
50921,Svênsk,argent-dawn,1317,warrior,fury,32,17,15
50922,Achonar,draenor,1317,warrior,fury,29,15,14
50923,Xsasuke,ragnaros,1317,warrior,fury,36,17,19
50924,Nighat,sanguino,1316,warrior,fury,23,18,5
50925,Temprament,ravencrest,1316,warrior,fury,54,31,23
50926,Hellguarrd,silvermoon,1316,warrior,fury,65,29,36
50927,Fortësque,uldaman,1315,warrior,fury,59,22,37
50928,Sway,eonar,1314,warrior,fury,42,23,19
50929,Zíreael,ravencrest,1314,warrior,fury,72,34,38
50930,Chidòri,tarren-mill,1314,warrior,fury,33,14,19
50931,Вархаус,blackscar,1313,warrior,fury,39,21,18
50932,Offpants,drakthul,1313,warrior,fury,48,22,26
50933,Dírectdash,draenor,1313,warrior,fury,33,15,18
50934,Ælvstan,argent-dawn,1310,warrior,fury,59,30,29
50935,Ryù,dun-modr,1310,warrior,fury,30,14,16
50936,Optimai,kazzak,1309,warrior,fury,86,41,45
50937,Painswift,blackhand,1309,warrior,fury,30,14,16
50938,Bigmercy,ragnaros,1305,warrior,fury,41,23,18
50939,Gèrralt,hyjal,1305,warrior,fury,47,18,29
50940,Гаррим,blackscar,1304,warrior,fury,28,14,14
50941,Xugzug,blackmoore,1304,warrior,fury,30,14,16
50942,Grimli,burning-legion,1303,warrior,fury,42,24,18
50943,Bigrooster,argent-dawn,1303,warrior,fury,102,52,50
50944,Меняло,fordragon,1302,warrior,fury,41,20,21
50945,Кровостокхх,gordunni,1301,warrior,fury,42,17,25
50946,Reckless,tarren-mill,1300,warrior,fury,42,22,20
50947,Tragix,hyjal,1300,warrior,fury,42,18,24
50948,Умфи,howling-fjord,1299,warrior,fury,83,46,37
50949,Warinator,ravencrest,1297,warrior,fury,49,28,21
50950,Kastraveci,outland,1295,warrior,fury,78,32,46
50951,Арестант,soulflayer,1291,warrior,fury,137,69,68
50952,Машамеч,blackscar,1289,warrior,fury,84,42,42
50953,Reylanor,argent-dawn,1288,warrior,fury,34,19,15
50954,Kllinac,kazzak,1288,warrior,fury,60,32,28
50955,Ninja,bronze-dragonflight,1288,warrior,fury,93,44,49
50956,Roxxón,teldrassil,1285,warrior,fury,23,14,9
50957,Buzzingorc,tarren-mill,1285,warrior,fury,60,32,28
50958,Sammäel,eldrethalas,1281,warrior,fury,36,19,17
50959,Haewon,burning-legion,1280,warrior,fury,53,25,28
50960,Andij,blackmoore,1278,warrior,fury,48,24,24
50961,Trollboii,ravencrest,1274,warrior,fury,27,14,13
50962,Fîlzlaus,area-52,1274,warrior,fury,89,38,51
50963,Exeldians,burning-legion,1273,warrior,fury,20,14,6
50964,Барабумм,soulflayer,1273,warrior,fury,107,55,52
50965,Tarrior,shattered-halls,1273,warrior,fury,65,32,33
50966,Fenr,sanguino,1272,warrior,fury,52,34,18
50967,Wariio,khaz-modan,1272,warrior,fury,47,27,20
50968,Runkkusukka,defias-brotherhood,1271,warrior,fury,65,36,29
50969,Furyre,ysondre,1271,warrior,fury,37,17,20
50970,Honeymew,draenor,1271,warrior,fury,66,27,39
50971,Dènethor,draenor,1269,warrior,fury,78,39,39
50972,Kerando,tirion,1269,warrior,fury,29,14,15
50973,Watntietnn,burning-blade,1268,warrior,fury,49,24,25
50974,Осгаард,gordunni,1268,warrior,fury,45,21,24
50975,Akkamagosh,argent-dawn,1266,warrior,fury,68,30,38
50976,Deusi,garrosh,1265,warrior,fury,60,32,28
50977,Cokeaddict,argent-dawn,1265,warrior,fury,48,20,28
50978,Azzog,archimonde,1264,warrior,fury,86,48,38
50979,Grák,bronze-dragonflight,1263,warrior,fury,24,14,10
50980,Zerm,draenor,1262,warrior,fury,24,15,9
50981,Gritzi,dragonblight,1262,warrior,fury,60,29,31
50982,Wilæm,argent-dawn,1261,warrior,fury,71,34,37
50983,Бормормуш,gordunni,1261,warrior,fury,73,30,43
50984,Taurenboii,ravencrest,1259,warrior,fury,25,14,11
50985,Федорссумкин,gordunni,1258,warrior,fury,50,23,27
50986,Hangovar,thrall,1257,warrior,fury,33,18,15
50987,Mortalclaw,kazzak,1256,warrior,fury,63,27,36
50988,Drswing,kazzak,1255,warrior,fury,33,15,18
50989,Dundulinka,outland,1255,warrior,fury,46,17,29
50990,Kurko,blackmoore,1254,warrior,fury,29,14,15
50991,Toughwar,tarren-mill,1253,warrior,fury,66,35,31
50992,Unn,ragnaros,1250,warrior,fury,75,36,39
50993,Аштау,howling-fjord,1250,warrior,fury,154,71,83
50994,Oughn,silvermoon,1248,warrior,fury,68,31,37
50995,Immørtálx,tarren-mill,1248,warrior,fury,30,13,17
50996,Рагнарульв,gordunni,1248,warrior,fury,36,15,21
50997,Мигнт,blackscar,1247,warrior,fury,18,13,5
50998,Фктп,blackscar,1247,warrior,fury,24,13,11
50999,Stóna,blackmoore,1247,warrior,fury,36,13,23
51000,Agitoyami,defias-brotherhood,1246,warrior,fury,115,62,53
51001,Warrzor,auchindoun,1246,warrior,fury,30,13,17
51002,Moknar,alonsus,1246,warrior,fury,53,22,31
51003,Tidarius,twisting-nether,1245,warrior,fury,24,13,11
51004,Crandalius,kazzak,1245,warrior,fury,24,13,11
51005,Balltas,drakthul,1243,warrior,fury,30,13,17
51006,Divinvibra,dalaran,1242,warrior,fury,25,13,12
51007,Ragnurk,draenor,1242,warrior,fury,60,20,40
51008,Tàuruss,blackhand,1241,warrior,fury,34,18,16
51009,Рсдрпб,eversong,1241,warrior,fury,30,15,15
51010,Timidman,kazzak,1240,warrior,fury,24,13,11
51011,Lâmy,khaz-modan,1240,warrior,fury,60,26,34
51012,Astreimehns,sanguino,1239,warrior,fury,18,13,5
51013,Слайдус,gordunni,1239,warrior,fury,62,31,31
51014,Ipes,blackmoore,1237,warrior,fury,33,17,16
51015,Lepetitwar,hyjal,1237,warrior,fury,30,13,17
51016,Mamox,archimonde,1236,warrior,fury,25,14,11
51017,Рекиро,blackscar,1236,warrior,fury,24,13,11
51018,Alevucerdaa,draenor,1236,warrior,fury,36,15,21
51019,Goldenarm,doomhammer,1234,warrior,fury,26,15,11
51020,Насувака,deathguard,1231,warrior,fury,47,22,25
51021,Larvalis,blackmoore,1229,warrior,fury,37,15,22
51022,Кимиюки,gordunni,1228,warrior,fury,30,13,17
51023,Ffrostwolff,azjolnerub,1227,warrior,fury,18,13,5
51024,Skullfondler,argent-dawn,1226,warrior,fury,24,13,11
51025,Quigatron,frostmane,1225,warrior,fury,42,25,17
51026,Säl,ragnaros,1225,warrior,fury,67,36,31
51027,Schmetterina,proudmoore,1223,warrior,fury,49,28,21
51028,Warrmax,darksorrow,1223,warrior,fury,78,41,37
51029,Rayeron,sanguino,1221,warrior,fury,95,47,48
51030,Anubisra,alakir,1220,warrior,fury,26,16,10
51031,Kebra,blackmoore,1220,warrior,fury,87,49,38
51032,Toecutter,defias-brotherhood,1220,warrior,fury,27,14,13
51033,Izmadfurax,archimonde,1218,warrior,fury,77,41,36
51034,Shieldlord,kazzak,1218,warrior,fury,129,59,70
51035,Ouryuu,hyjal,1218,warrior,fury,56,25,31
51036,Nubá,burning-legion,1213,warrior,fury,48,31,17
51037,Atrôcithy,silvermoon,1211,warrior,fury,22,14,8
51038,Coyle,eredar,1207,warrior,fury,146,65,81
51039,Warriorc,hellfire,1205,warrior,fury,48,26,22
51040,Yildiz,kargath,1204,warrior,fury,103,57,46
51041,Vivaladirt,argent-dawn,1203,warrior,fury,30,13,17
51042,Larrydankin,draenor,1201,warrior,fury,35,21,14
51043,Vhy,antonidas,1201,warrior,fury,48,22,26
51044,Toporceanul,kazzak,1201,warrior,fury,41,14,27
51045,Barsok,sanguino,1198,warrior,fury,36,16,20
51046,Отнулядоста,gordunni,1198,warrior,fury,61,25,36
51047,Жужащий,howling-fjord,1197,warrior,fury,74,31,43
51048,Marklarstar,ragnaros,1195,warrior,fury,36,16,20
51049,Andjuu,doomhammer,1193,warrior,fury,29,13,16
51050,Antraex,zuljin,1193,warrior,fury,36,15,21
51051,Blaying,ravencrest,1192,warrior,fury,23,13,10
51052,Kirkwood,terokkar,1192,warrior,fury,71,34,37
51053,Номер,eversong,1192,warrior,fury,139,64,75
51054,Moustachu,kirin-tor,1189,warrior,fury,33,18,15
51055,Bolss,silvermoon,1188,warrior,fury,73,28,45
51056,Gardom,doomhammer,1187,warrior,fury,70,41,29
51057,Азктор,soulflayer,1186,warrior,fury,35,15,20
51058,Delinde,cthun,1180,warrior,fury,105,50,55
51059,Saey,malorne,1174,warrior,fury,56,25,31
51060,Flaggerware,stormscale,1171,warrior,fury,30,13,17
51061,Суммрак,grom,1166,warrior,fury,38,16,22
51062,Tato,frostmourne,1165,warrior,fury,23,13,10
51063,Дедсдрыном,howling-fjord,1162,warrior,fury,140,68,72
51064,Варёнок,soulflayer,1160,warrior,fury,51,25,26
51065,Gorgulg,stormscale,1159,warrior,fury,30,15,15
51066,Saîx,garrosh,1159,warrior,fury,175,85,90
51067,Drolaret,zuljin,1155,warrior,fury,39,16,23
51068,Dreasus,ragnaros,1151,warrior,fury,18,12,6
51069,Krazosh,die-aldor,1151,warrior,fury,24,12,12
51070,Исскатель,gordunni,1150,warrior,fury,12,12,0
51071,Slamborghini,twisting-nether,1150,warrior,fury,18,12,6
51072,Miko,ysondre,1148,warrior,fury,24,12,12
51073,Spitonem,blackrock,1148,warrior,fury,24,12,12
51074,Баджераа,soulflayer,1147,warrior,fury,18,12,6
51075,Wotulko,blackrock,1147,warrior,fury,23,13,10
51076,Neoballâc,uldum,1144,warrior,fury,24,12,12
51077,Baoni,hyjal,1144,warrior,fury,30,12,18
51078,Yopa,draenor,1143,warrior,fury,33,13,20
51079,Inflacija,grim-batol,1143,warrior,fury,36,12,24
51080,Shadowfiend,argent-dawn,1142,warrior,fury,24,12,12
51081,Waroworgen,terokkar,1142,warrior,fury,26,12,14
51082,Ragecap,rexxar,1142,warrior,fury,44,18,26
51083,Армсец,howling-fjord,1141,warrior,fury,24,12,12
51084,Инфиль,howling-fjord,1140,warrior,fury,30,12,18
51085,Bouafia,archimonde,1138,warrior,fury,24,12,12
51086,Itchiiz,alonsus,1138,warrior,fury,24,12,12
51087,Андервульф,booty-bay,1137,warrior,fury,30,12,18
51088,Exhumator,blackhand,1135,warrior,fury,36,12,24
51089,Madhardy,chamber-of-aspects,1133,warrior,fury,24,12,12
51090,Hazarku,colinas-pardas,1133,warrior,fury,24,12,12
51091,Illydan,turalyon,1132,warrior,fury,18,12,6
51092,Thors,deathwing,1131,warrior,fury,154,75,79
51093,Oxascand,kazzak,1131,warrior,fury,87,36,51
51094,Armirtile,twisting-nether,1130,warrior,fury,24,12,12
51095,Ranndall,blackrock,1129,warrior,fury,48,23,25
51096,Sekecmazec,turalyon,1129,warrior,fury,63,22,41
51097,Pybal,stormscale,1128,warrior,fury,18,12,6
51098,Thibow,hyjal,1127,warrior,fury,24,14,10
51099,Rudor,la-croisade-écarlate,1127,warrior,fury,24,12,12
51100,Berseak,dalaran,1125,warrior,fury,31,15,16
51101,Sadjoke,draenor,1125,warrior,fury,30,13,17
51102,Damonx,draenor,1123,warrior,fury,54,25,29
51103,Cuuz,outland,1122,warrior,fury,30,12,18
51104,Well,kult-der-verdammten,1121,warrior,fury,24,12,12
51105,Nykyro,draenor,1119,warrior,fury,66,29,37
51106,Téldrus,blackrock,1116,warrior,fury,18,12,6
51107,Ульданианин,gordunni,1115,warrior,fury,24,12,12
51108,Pahanâ,arygos,1111,warrior,fury,24,12,12
51109,Иллидансер,howling-fjord,1110,warrior,fury,24,12,12
51110,Gabbz,aggra-português,1109,warrior,fury,33,13,20
51111,Zetsurin,sylvanas,1105,warrior,fury,66,23,43
51112,Ragedotcom,archimonde,1104,warrior,fury,46,20,26
51113,Красемир,deepholm,1097,warrior,fury,47,23,24
51114,Sabrewølf,blackmoore,1096,warrior,fury,48,24,24
51115,Killpieric,krasus,1095,warrior,fury,36,13,23
51116,Shalren,nordrassil,1092,warrior,fury,44,23,21
51117,Джэкмен,soulflayer,1091,warrior,fury,28,16,12
51118,Grobler,blackhand,1091,warrior,fury,42,16,26
51119,Mistawolf,ravencrest,1090,warrior,fury,30,16,14
51120,Аесоо,gordunni,1090,warrior,fury,243,113,130
51121,Moonkak,hyjal,1090,warrior,fury,30,13,17
51122,Копенгаген,ashenvale,1087,warrior,fury,30,16,14
51123,Dramiél,tarren-mill,1083,warrior,fury,23,13,10
51124,Draxxann,ravencrest,1077,warrior,fury,18,13,5
51125,Wrathchild,blackrock,1069,warrior,fury,35,14,21
51126,Justviktor,ravencrest,1068,warrior,fury,47,17,30
51127,Селттик,grom,1064,warrior,fury,47,24,23
51128,Giimlii,hyjal,1060,warrior,fury,36,12,24
51129,Eidzo,tarren-mill,1056,warrior,fury,12,11,1
51130,Luphrek,ysondre,1056,warrior,fury,30,11,19
51131,Зенобий,gordunni,1055,warrior,fury,12,11,1
51132,Sparkzu,twisting-nether,1055,warrior,fury,18,11,7
51133,Эпитафорх,blackscar,1055,warrior,fury,18,11,7
51134,Maroux,malganis,1055,warrior,fury,18,11,7
51135,Кофесмолоком,ashenvale,1055,warrior,fury,18,11,7
51136,Prixor,grim-batol,1055,warrior,fury,24,11,13
51137,Ntouziera,silvermoon,1055,warrior,fury,30,11,19
51138,Izurritea,tarren-mill,1054,warrior,fury,18,11,7
51139,Ciuez,tarren-mill,1054,warrior,fury,18,11,7
51140,Мастерион,soulflayer,1054,warrior,fury,18,11,7
51141,Circumcist,dragonblight,1053,warrior,fury,18,11,7
51142,Snuzzygeezer,ravencrest,1053,warrior,fury,18,11,7
51143,Лордэнгри,howling-fjord,1053,warrior,fury,22,12,10
51144,Byedriver,kazzak,1053,warrior,fury,24,11,13
51145,Oksimbillah,blackrock,1053,warrior,fury,24,11,13
51146,Bloodwatchêr,kazzak,1051,warrior,fury,24,11,13
51147,Amagaddon,draenor,1050,warrior,fury,28,12,16
51148,Rum,talnivarr,1049,warrior,fury,18,11,7
51149,Vazzile,silvermoon,1049,warrior,fury,23,13,10
51150,Драмур,gordunni,1049,warrior,fury,30,11,19
51151,Obox,ravencrest,1048,warrior,fury,18,11,7
51152,Wowbert,frostwolf,1048,warrior,fury,24,11,13
51153,Baluste,culte-de-la-rive-noire,1047,warrior,fury,30,11,19
51154,Buffury,twisting-nether,1045,warrior,fury,18,11,7
51155,Whysospicey,lightbringer,1043,warrior,fury,21,12,9
51156,Ragnòk,eredar,1043,warrior,fury,54,20,34
51157,Tiapollo,dun-modr,1043,warrior,fury,40,12,28
51158,Romanondo,doomhammer,1039,warrior,fury,18,11,7
51159,Эфириад,soulflayer,1036,warrior,fury,24,11,13
51160,Златоцветта,gordunni,1034,warrior,fury,24,11,13
51161,Tdanielt,burning-legion,1032,warrior,fury,18,11,7
51162,Anastor,ragnaros,1026,warrior,fury,24,11,13
51163,Valhrann,dalaran,1024,warrior,fury,24,11,13
51164,Orcgrim,nozdormu,1019,warrior,fury,42,20,22
51165,Громорашман,grom,1017,warrior,fury,20,12,8
51166,Жиестьдон,soulflayer,1015,warrior,fury,38,17,21
51167,Sairos,kirin-tor,1014,warrior,fury,90,47,43
51168,Whiteebeardd,draenor,1014,warrior,fury,72,34,38
51169,Hazl,balnazzar,1009,warrior,fury,44,27,17
51170,Sperta,frostmourne,1009,warrior,fury,47,25,22
51171,Kungeen,silvermoon,1008,warrior,fury,132,58,74
51172,Grimic,quelthalas,1004,warrior,fury,27,11,16
51173,Рыджеральд,howling-fjord,1003,warrior,fury,37,17,20
51174,Macgull,ysondre,1003,warrior,fury,66,27,39
51175,Zhear,kazzak,999,warrior,fury,29,11,18
51176,Fknmoo,kazzak,997,warrior,fury,78,39,39
51177,Edwsan,cthun,990,warrior,fury,42,20,22
51178,Fatspacka,argent-dawn,989,warrior,fury,20,11,9
51179,Solatika,alexstrasza,985,warrior,fury,183,95,88
51180,Dolora,ragnaros,984,warrior,fury,30,15,15
51181,Nicperh,dun-modr,984,warrior,fury,29,12,17
51182,Lobotomywar,drakthul,981,warrior,fury,18,12,6
51183,Niozihex,the-maelstrom,981,warrior,fury,39,16,23
51184,Krlebajker,tarren-mill,977,warrior,fury,27,14,13
51185,Nogo,nagrand,975,warrior,fury,50,29,21
51186,Seka,nozdormu,975,warrior,fury,186,93,93
51187,Falaliss,elune,975,warrior,fury,56,26,30
51188,Snoopdad,ravencrest,966,warrior,fury,27,15,12
51189,Эребб,howling-fjord,966,warrior,fury,60,29,31
51190,Помойник,gordunni,965,warrior,fury,175,91,84
51191,Торакусу,gordunni,963,warrior,fury,48,24,24
51192,Inexo,blackrock,961,warrior,fury,24,11,13
51193,Pj,sanguino,960,warrior,fury,12,10,2
51194,Ástriax,ravencrest,960,warrior,fury,18,10,8
51195,Kût,les-sentinelles,959,warrior,fury,12,10,2
51196,Emune,blackhand,959,warrior,fury,15,11,4
51197,Galatan,kazzak,959,warrior,fury,18,10,8
51198,Unqlolz,kazzak,959,warrior,fury,18,10,8
51199,Tenicx,ravencrest,959,warrior,fury,18,10,8
51200,Solaje,dun-modr,959,warrior,fury,18,10,8
51201,Cøbain,eredar,959,warrior,fury,18,10,8
51202,Highoverlord,aggra-português,959,warrior,fury,18,10,8
51203,Oowar,burning-legion,959,warrior,fury,18,10,8
51204,Raicho,dentarg,959,warrior,fury,18,10,8
51205,Scelletonx,silvermoon,959,warrior,fury,18,10,8
51206,Theolcostaud,archimonde,959,warrior,fury,24,10,14
51207,Sumis,stormreaver,959,warrior,fury,36,10,26
51208,Xurainlol,eredar,958,warrior,fury,12,10,2
51209,Agoobagoo,alakir,958,warrior,fury,12,10,2
51210,Svënja,ysondre,958,warrior,fury,18,10,8
51211,Punks,ravencrest,958,warrior,fury,18,10,8
51212,Søil,tarren-mill,958,warrior,fury,18,10,8
51213,Achérus,varimathras,958,warrior,fury,23,10,13
51214,Taaø,ravencrest,958,warrior,fury,24,10,14
51215,Razoo,stormscale,958,warrior,fury,30,10,20
51216,Rarrio,kazzak,957,warrior,fury,18,10,8
51217,Budwise,stormscale,957,warrior,fury,18,10,8
51218,Youups,twisting-nether,957,warrior,fury,18,10,8
51219,Etelä,stormreaver,957,warrior,fury,18,10,8
51220,Hellocritty,blackmoore,957,warrior,fury,18,10,8
51221,Orcarinté,draenor,957,warrior,fury,27,11,16
51222,Fortressa,ravencrest,957,warrior,fury,30,10,20
51223,Bördz,blackhand,956,warrior,fury,18,10,8
51224,Settin,silvermoon,956,warrior,fury,18,10,8
51225,Рэкла,grom,956,warrior,fury,18,10,8
51226,Янесними,soulflayer,956,warrior,fury,18,10,8
51227,Thodak,blackrock,956,warrior,fury,30,10,20
51228,Kurenn,tarren-mill,956,warrior,fury,30,10,20
51229,Razza,ravencrest,955,warrior,fury,18,10,8
51230,Zeppek,dalaran,955,warrior,fury,94,49,45
51231,Onga,frostwolf,954,warrior,fury,18,10,8
51232,Merdé,blackhand,954,warrior,fury,60,32,28
51233,Murgrimm,die-silberne-hand,954,warrior,fury,93,47,46
51234,Ампутиль,gordunni,953,warrior,fury,18,10,8
51235,Xonnico,ravencrest,953,warrior,fury,30,11,19
51236,Taurras,nathrezim,952,warrior,fury,86,45,41
51237,Darriuso,kazzak,952,warrior,fury,24,10,14
51238,Exsomnis,outland,951,warrior,fury,18,10,8
51239,Thebiggreen,twisting-nether,951,warrior,fury,18,10,8
51240,Фейловый,gordunni,951,warrior,fury,24,10,14
51241,Madfu,draenor,950,warrior,fury,18,10,8
51242,Лизерус,eversong,949,warrior,fury,12,10,2
51243,Gahal,tyrande,948,warrior,fury,24,10,14
51244,Morishcrak,kazzak,948,warrior,fury,33,11,22
51245,Prime,outland,946,warrior,fury,24,10,14
51246,Erenowski,twisting-nether,945,warrior,fury,24,10,14
51247,Xaturesw,twisting-nether,943,warrior,fury,12,10,2
51248,Solidier,archimonde,931,warrior,fury,24,10,14
51249,Pufy,ravencrest,930,warrior,fury,23,10,13
51250,Асау,ashenvale,924,warrior,fury,17,10,7
51251,Kratosz,bloodscalp,920,warrior,fury,56,29,27
51252,Arzes,draenor,920,warrior,fury,29,10,19
51253,Sonnyammo,turalyon,917,warrior,fury,38,13,25
51254,Dirtybugga,nagrand,916,warrior,fury,16,11,5
51255,Nukêr,dun-modr,915,warrior,fury,35,10,25
51256,Дерзкаяфурия,gordunni,913,warrior,fury,23,10,13
51257,Ranyl,blackmoore,911,warrior,fury,23,10,13
51258,Rédsonja,chamber-of-aspects,909,warrior,fury,52,25,27
51259,Noseringer,frostwolf,902,warrior,fury,15,10,5
51260,Ogerit,blackmoore,898,warrior,fury,30,14,16
51261,Суферна,howling-fjord,894,warrior,fury,27,13,14
51262,Gnompower,archimonde,892,warrior,fury,17,10,7
51263,Bëlzé,les-clairvoyants,887,warrior,fury,38,14,24
51264,Mélin,ravencrest,876,warrior,fury,19,10,9
51265,Лилслайм,gordunni,875,warrior,fury,30,15,15
51266,Jâbs,hyjal,875,warrior,fury,36,11,25
51267,Kabbuki,die-aldor,871,warrior,fury,24,12,12
51268,Stroj,aerie-peak,868,warrior,fury,65,32,33
51269,Granlach,sunstrider,864,warrior,fury,12,9,3
51270,Kihili,twisting-nether,864,warrior,fury,12,9,3
51271,Studzianki,argent-dawn,864,warrior,fury,12,9,3
51272,Брокскрим,soulflayer,864,warrior,fury,12,9,3
51273,Licious,outland,864,warrior,fury,12,9,3
51274,Føxis,aegwynn,864,warrior,fury,12,9,3
51275,Lzdmfckmeazy,blackmoore,864,warrior,fury,15,10,5
51276,Warzzor,auchindoun,864,warrior,fury,18,9,9
51277,Рэйвисмашина,gordunni,864,warrior,fury,24,9,15
51278,Веоленс,gordunni,863,warrior,fury,12,9,3
51279,Discordîan,twisting-nether,863,warrior,fury,12,9,3
51280,Therealskull,grim-batol,863,warrior,fury,18,9,9
51281,Bxnx,aegwynn,863,warrior,fury,18,9,9
51282,Showerfresh,silvermoon,863,warrior,fury,18,9,9
51283,Lunätic,sylvanas,863,warrior,fury,18,9,9
51284,Нейв,blackscar,863,warrior,fury,18,9,9
51285,Dontrundie,kazzak,863,warrior,fury,18,9,9
51286,Zyzie,argent-dawn,863,warrior,fury,24,9,15
51287,Chadgarrosh,tarren-mill,863,warrior,fury,24,9,15
51288,Синнэр,blackscar,863,warrior,fury,24,9,15
51289,Sodium,pozzo-delleternità,863,warrior,fury,24,9,15
51290,Tandrall,rexxar,863,warrior,fury,24,9,15
51291,Bigpapapap,kazzak,863,warrior,fury,28,9,19
51292,Cianna,silvermoon,862,warrior,fury,12,9,3
51293,Exzecute,outland,862,warrior,fury,12,9,3
51294,Claptheheal,silvermoon,862,warrior,fury,18,9,9
51295,Gypsykìng,darksorrow,862,warrior,fury,18,9,9
51296,Cemule,doomhammer,862,warrior,fury,18,9,9
51297,Grimleaper,twisting-nether,862,warrior,fury,18,9,9
51298,Vìbe,archimonde,862,warrior,fury,24,9,15
51299,Denshyel,dun-modr,861,warrior,fury,15,10,5
51300,Throck,drakthul,861,warrior,fury,18,9,9
51301,Свободатоп,howling-fjord,859,warrior,fury,18,9,9
51302,Valkirya,arthas,859,warrior,fury,24,9,15
51303,Ragecrit,ragnaros,859,warrior,fury,24,9,15
51304,Tharokk,blackmoore,858,warrior,fury,18,9,9
51305,Zalumorth,magtheridon,856,warrior,fury,26,13,13
51306,Rqyz,tarren-mill,856,warrior,fury,18,9,9
51307,Saykage,blackhand,854,warrior,fury,18,9,9
51308,Mocagressiva,draenor,854,warrior,fury,18,9,9
51309,Warfield,draenor,853,warrior,fury,24,9,15
51310,Блиблоб,eversong,852,warrior,fury,18,9,9
51311,Pollverizer,ghostlands,851,warrior,fury,36,16,20
51312,Manneen,outland,851,warrior,fury,30,9,21
51313,Sparkss,sylvanas,850,warrior,fury,18,9,9
51314,Kharzak,ungoro,849,warrior,fury,18,9,9
51315,Спунжио,ashenvale,848,warrior,fury,18,9,9
51316,Tiscanno,nemesis,842,warrior,fury,49,24,25
51317,Amsti,doomhammer,839,warrior,fury,12,9,3
51318,Ânaxi,silvermoon,831,warrior,fury,14,10,4
51319,Warallari,khaz-modan,829,warrior,fury,18,9,9
51320,Evasni,magtheridon,823,warrior,fury,14,10,4
51321,Incense,silvermoon,816,warrior,fury,15,9,6
51322,Børomir,silvermoon,815,warrior,fury,15,9,6
51323,Jøtawarrior,sanguino,815,warrior,fury,17,9,8
51324,Варриорнир,howling-fjord,814,warrior,fury,14,10,4
51325,Miina,blutkessel,802,warrior,fury,18,9,9
51326,Ocelote,elune,794,warrior,fury,18,9,9
51327,Guinnasse,khaz-modan,794,warrior,fury,21,9,12
51328,Ironfangs,argent-dawn,768,warrior,fury,12,8,4
51329,Crîxús,silvermoon,768,warrior,fury,12,8,4
51330,Jengaa,draenor,768,warrior,fury,12,8,4
51331,Aléxsandra,ravencrest,768,warrior,fury,12,8,4
51332,Blizo,tarren-mill,768,warrior,fury,12,8,4
51333,Cathériné,drakthul,768,warrior,fury,12,8,4
51334,Projectchad,draenor,768,warrior,fury,12,8,4
51335,Jokkul,tarren-mill,768,warrior,fury,12,8,4
51336,Нарезаю,blackscar,768,warrior,fury,12,8,4
51337,Connorzqt,ravencrest,768,warrior,fury,12,8,4
51338,Zern,draenor,768,warrior,fury,12,8,4
51339,Уэсгар,blackscar,768,warrior,fury,12,8,4
51340,Chelby,argent-dawn,768,warrior,fury,12,8,4
51341,Untiltèd,ravencrest,768,warrior,fury,18,8,10
51342,Immørtalx,area-52,768,warrior,fury,18,8,10
51343,Krathox,kazzak,768,warrior,fury,18,8,10
51344,Zimbabakunda,ravencrest,768,warrior,fury,18,8,10
51345,Joéfernandés,sylvanas,768,warrior,fury,18,8,10
51346,Xguildone,magtheridon,768,warrior,fury,38,14,24
51347,Alpairx,aegwynn,768,warrior,fury,24,8,16
51348,Мастерпве,blackscar,767,warrior,fury,12,8,4
51349,Largeblade,kazzak,767,warrior,fury,12,8,4
51350,Míngxuan,tarren-mill,767,warrior,fury,12,8,4
51351,Rooflolly,argent-dawn,767,warrior,fury,12,8,4
51352,Schmackes,terrordar,767,warrior,fury,12,8,4
51353,Báshx,outland,767,warrior,fury,12,8,4
51354,Skeptikal,argent-dawn,767,warrior,fury,12,8,4
51355,Skillclapped,ravencrest,767,warrior,fury,15,9,6
51356,Онатолька,eversong,767,warrior,fury,16,9,7
51357,Ðíscøwârrìør,nethersturm,767,warrior,fury,18,8,10
51358,Elainax,eredar,767,warrior,fury,18,8,10
51359,Rowr,argent-dawn,767,warrior,fury,18,8,10
51360,Thørïn,dun-modr,767,warrior,fury,18,8,10
51361,Philatou,antonidas,767,warrior,fury,18,8,10
51362,Warthur,silvermoon,767,warrior,fury,18,8,10
51363,Rndname,malganis,767,warrior,fury,18,8,10
51364,Cyruk,blackmoore,767,warrior,fury,18,8,10
51365,Dallion,azjolnerub,767,warrior,fury,18,8,10
51366,Ødên,frostmane,767,warrior,fury,18,8,10
51367,Глинм,gordunni,767,warrior,fury,24,8,16
51368,Algethar,archimonde,766,warrior,fury,12,8,4
51369,Fivejee,ravencrest,766,warrior,fury,12,8,4
51370,Warriur,silvermoon,766,warrior,fury,12,8,4
51371,Himä,burning-legion,766,warrior,fury,12,8,4
51372,Deadwaifu,ragnaros,766,warrior,fury,18,8,10
51373,Развалочка,howling-fjord,766,warrior,fury,18,8,10
51374,Arlan,dragonblight,766,warrior,fury,30,8,22
51375,Сэч,gordunni,765,warrior,fury,12,8,4
51376,Knussnacker,sanguino,765,warrior,fury,12,8,4
51377,Blairne,burning-blade,765,warrior,fury,24,8,16
51378,Malasortë,sylvanas,764,warrior,fury,18,8,10
51379,Furginox,argent-dawn,764,warrior,fury,24,8,16
51380,Greatsword,turalyon,763,warrior,fury,12,8,4
51381,Cazzpowa,frostmane,762,warrior,fury,12,8,4
51382,Motorhead,tirion,762,warrior,fury,18,8,10
51383,Kaerz,ysondre,762,warrior,fury,18,8,10
51384,Giemb,doomhammer,761,warrior,fury,60,17,43
51385,Khaalo,blackhand,760,warrior,fury,12,8,4
51386,Czarian,ragnaros,759,warrior,fury,36,8,28
51387,Солоовей,gordunni,758,warrior,fury,18,8,10
51388,Ошинай,gordunni,756,warrior,fury,18,8,10
51389,Uleixoshark,argent-dawn,754,warrior,fury,18,8,10
51390,Zarkos,onyxia,754,warrior,fury,24,8,16
51391,Destrzadora,exodar,750,warrior,fury,18,8,10
51392,Aedin,ravencrest,734,warrior,fury,17,8,9
51393,Арнвальд,galakrond,728,warrior,fury,18,8,10
51394,Вагранна,soulflayer,719,warrior,fury,17,8,9
51395,Bragush,shattrath,718,warrior,fury,11,8,3
51396,Dranosha,nemesis,718,warrior,fury,17,8,9
51397,Стано,booty-bay,715,warrior,fury,14,9,5
51398,Jakedo,outland,703,warrior,fury,17,8,9
51399,Kilkov,emeriss,701,warrior,fury,16,8,8
51400,Grekowar,dalaran,700,warrior,fury,17,8,9
51401,Amédé,ysondre,697,warrior,fury,17,8,9
51402,Bubbsi,turalyon,674,warrior,fury,24,8,16
51403,Дмидрашх,howling-fjord,672,warrior,fury,10,8,2
51404,Googas,aegwynn,672,warrior,fury,12,7,5
51405,Orwarrio,thrall,672,warrior,fury,12,7,5
51406,Осадчийофдес,soulflayer,672,warrior,fury,12,7,5
51407,Фомори,howling-fjord,672,warrior,fury,12,7,5
51408,Ðeadyet,mugthol,672,warrior,fury,12,7,5
51409,Brbtoilet,kazzak,672,warrior,fury,12,7,5
51410,Xurainzone,eredar,672,warrior,fury,12,7,5
51411,Quadfather,kazzak,672,warrior,fury,12,7,5
51412,Paynzx,blackrock,672,warrior,fury,12,7,5
51413,Деимосин,howling-fjord,672,warrior,fury,12,7,5
51414,Fraq,tarren-mill,672,warrior,fury,12,7,5
51415,Alkuwaity,outland,672,warrior,fury,12,7,5
51416,Doronas,der-rat-von-dalaran,672,warrior,fury,12,7,5
51417,Седунг,gordunni,672,warrior,fury,12,7,5
51418,Где,blackscar,672,warrior,fury,12,7,5
51419,Yuuta,ravencrest,672,warrior,fury,12,7,5
51420,Khrtw,silvermoon,672,warrior,fury,12,7,5
51421,Инкула,gordunni,672,warrior,fury,12,7,5
51422,Hàssard,outland,672,warrior,fury,12,7,5
51423,Avgorcgodx,stormscale,672,warrior,fury,12,7,5
51424,Xxeqtr,kazzak,672,warrior,fury,12,7,5
51425,Seraphys,ravencrest,672,warrior,fury,12,7,5
51426,Duarel,blackmoore,672,warrior,fury,12,7,5
51427,Lildaddypump,ravencrest,672,warrior,fury,12,7,5
51428,Nerfslam,stormscale,672,warrior,fury,17,8,9
51429,Gramrosh,eredar,672,warrior,fury,18,7,11
51430,Omcat,dun-modr,672,warrior,fury,18,7,11
51431,Szpindah,ragnaros,672,warrior,fury,18,7,11
51432,Foboa,archimonde,672,warrior,fury,18,7,11
51433,Учихагодх,howling-fjord,672,warrior,fury,18,7,11
51434,Кэйкан,gordunni,672,warrior,fury,18,7,11
51435,Shintuargar,blackrock,672,warrior,fury,18,7,11
51436,Stormíe,outland,671,warrior,fury,12,7,5
51437,Теокрафт,howling-fjord,671,warrior,fury,12,7,5
51438,Dgyfh,dun-morogh,671,warrior,fury,12,7,5
51439,Zehirjin,sargeras,671,warrior,fury,12,7,5
51440,Rryba,blackrock,671,warrior,fury,12,7,5
51441,Bruxus,blackhand,671,warrior,fury,12,7,5
51442,Sargonas,burning-blade,671,warrior,fury,12,7,5
51443,Pépêloup,archimonde,671,warrior,fury,12,7,5
51444,Broknagar,draenor,671,warrior,fury,12,7,5
51445,Sniperwølf,tyrande,671,warrior,fury,12,7,5
51446,Timmyda,dalaran,671,warrior,fury,12,7,5
51447,Arturdayne,sanguino,671,warrior,fury,12,7,5
51448,Septymyya,eredar,671,warrior,fury,15,8,7
51449,Jaowa,blackmoore,671,warrior,fury,18,7,11
51450,Sunzí,alakir,671,warrior,fury,18,7,11
51451,Kolxoz,doomhammer,671,warrior,fury,18,7,11
51452,Мембершримп,howling-fjord,671,warrior,fury,18,7,11
51453,Têtebruler,archimonde,671,warrior,fury,18,7,11
51454,Bonnejournée,stormscale,671,warrior,fury,18,7,11
51455,Bwonsàmdí,ragnaros,671,warrior,fury,18,7,11
51456,Vagor,draenor,670,warrior,fury,12,7,5
51457,Thunderage,stormscale,670,warrior,fury,12,7,5
51458,Drexx,ragnaros,670,warrior,fury,12,7,5
51459,Chadchadsson,ravencrest,670,warrior,fury,12,7,5
51460,Izrael,alakir,670,warrior,fury,12,7,5
51461,Напутанность,soulflayer,670,warrior,fury,18,7,11
51462,Mouliard,archimonde,670,warrior,fury,18,7,11
51463,Grahatia,magtheridon,670,warrior,fury,18,7,11
51464,Dabliu,burning-legion,670,warrior,fury,18,7,11
51465,Djiozz,khaz-modan,669,warrior,fury,18,7,11
51466,Bankaju,burning-legion,669,warrior,fury,18,7,11
51467,Orengo,blackrock,668,warrior,fury,12,7,5
51468,Ganian,stormscale,668,warrior,fury,18,7,11
51469,Garosh,drakthul,666,warrior,fury,12,7,5
51470,Titanhaut,frostwolf,666,warrior,fury,12,7,5
51471,Telamonas,haomarush,665,warrior,fury,12,7,5
51472,Dj,ragnaros,664,warrior,fury,12,7,5
51473,Onslaught,pozzo-delleternità,663,warrior,fury,24,7,17
51474,Horymir,ravencrest,655,warrior,fury,17,7,10
51475,Albabhaltair,quelthalas,654,warrior,fury,18,7,11
51476,Shedzo,tarren-mill,639,warrior,fury,14,8,6
51477,Thezug,twisting-nether,639,warrior,fury,17,7,10
51478,Pitii,burning-legion,638,warrior,fury,14,8,6
51479,Ентил,gordunni,623,warrior,fury,17,7,10
51480,Autümn,argent-dawn,618,warrior,fury,21,8,13
51481,Djranji,kazzak,607,warrior,fury,16,7,9
51482,Scofiéld,lordaeron,601,warrior,fury,11,7,4
51483,Parteyunques,sanguino,592,warrior,fury,13,7,6
51484,Quarantino,ysondre,590,warrior,fury,23,7,16
51485,Thomasman,nerathor,576,warrior,fury,6,6,0
51486,Dimethefoxx,argent-dawn,576,warrior,fury,6,6,0
51487,Каосвар,howling-fjord,576,warrior,fury,6,6,0
51488,Артэкриогг,soulflayer,576,warrior,fury,6,6,0
51489,Âshkä,ysondre,576,warrior,fury,6,6,0
51490,Cêlty,aegwynn,576,warrior,fury,6,6,0
51491,Dhloos,kazzak,576,warrior,fury,12,6,6
51492,Bloodyedge,sanguino,576,warrior,fury,12,6,6
51493,Bstgame,frostmane,576,warrior,fury,12,6,6
51494,Zkb,zuljin,576,warrior,fury,12,6,6
51495,Yenkonov,blackmoore,576,warrior,fury,12,6,6
51496,Bulgrash,blackmoore,576,warrior,fury,12,6,6
51497,Rylbrah,blackmoore,576,warrior,fury,12,6,6
51498,Palmexwar,drakthul,576,warrior,fury,12,6,6
51499,Ellissari,tirion,576,warrior,fury,12,6,6
51500,Gnomet,auchindoun,576,warrior,fury,12,6,6
51501,Aurélus,rexxar,576,warrior,fury,12,6,6
51502,Роудс,soulflayer,576,warrior,fury,12,6,6
51503,Виттурус,howling-fjord,576,warrior,fury,12,6,6
51504,Thogrêy,archimonde,576,warrior,fury,12,6,6
51505,Änvil,tarren-mill,576,warrior,fury,12,6,6
51506,Stanfury,sylvanas,576,warrior,fury,12,6,6
51507,Àlexander,ravencrest,576,warrior,fury,12,6,6
51508,Lathsmash,zenedar,576,warrior,fury,12,6,6
51509,Engalxsol,tarren-mill,576,warrior,fury,12,6,6
51510,Timagno,nemesis,576,warrior,fury,12,6,6
51511,Lecorrecteur,archimonde,576,warrior,fury,12,6,6
51512,Kalakalle,twisting-nether,576,warrior,fury,12,6,6
51513,Rândy,confrérie-du-thorium,576,warrior,fury,12,6,6
51514,Obitron,argent-dawn,576,warrior,fury,12,6,6
51515,Humanboi,ravencrest,576,warrior,fury,12,6,6
51516,Shurubel,outland,576,warrior,fury,12,6,6
51517,Broxshar,shendralar,576,warrior,fury,12,6,6
51518,Redwraith,stormscale,576,warrior,fury,12,6,6
51519,Waterquéen,outland,576,warrior,fury,12,6,6
51520,Асгинор,gordunni,576,warrior,fury,12,6,6
51521,Вульрайс,deepholm,576,warrior,fury,12,6,6
51522,Faithless,azshara,576,warrior,fury,12,6,6
51523,Sakumo,sylvanas,576,warrior,fury,12,6,6
51524,Nallepúh,silvermoon,576,warrior,fury,12,6,6
51525,Фелёр,gordunni,576,warrior,fury,12,6,6
51526,Vatolocoese,dun-morogh,576,warrior,fury,12,6,6
51527,Rudvard,hyjal,576,warrior,fury,12,6,6
51528,Rarcus,chamber-of-aspects,576,warrior,fury,12,6,6
51529,Kristinas,tarren-mill,576,warrior,fury,12,6,6
51530,Рэйлет,gordunni,576,warrior,fury,12,6,6
51531,Sêrên,dun-modr,576,warrior,fury,12,6,6
51532,Cleaner,blackmoore,576,warrior,fury,12,6,6
51533,Эксихард,gordunni,576,warrior,fury,18,6,12
51534,Massiveape,argent-dawn,576,warrior,fury,18,6,12
51535,Prettyangel,aegwynn,576,warrior,fury,18,6,12
51536,Mazzkze,silvermoon,576,warrior,fury,18,6,12
51537,Сталиран,gordunni,576,warrior,fury,18,6,12
51538,Hulkzmash,tarren-mill,576,warrior,fury,18,6,12
51539,Getonxnxx,quelthalas,576,warrior,fury,18,6,12
51540,Килоагр,gordunni,576,warrior,fury,18,6,12
51541,Durrüti,sanguino,575,warrior,fury,12,6,6
51542,Roninwar,the-maelstrom,575,warrior,fury,12,6,6
51543,Моргаур,howling-fjord,575,warrior,fury,12,6,6
51544,Xenesthis,dun-morogh,575,warrior,fury,12,6,6
51545,Esegryel,argent-dawn,575,warrior,fury,12,6,6
51546,Bloódángel,frostwolf,575,warrior,fury,12,6,6
51547,Nihroxis,blackrock,575,warrior,fury,12,6,6
51548,Djayson,hyjal,575,warrior,fury,12,6,6
51549,Daramir,turalyon,575,warrior,fury,12,6,6
51550,Конвержн,howling-fjord,575,warrior,fury,12,6,6
51551,Vmnbgh,aszune,575,warrior,fury,12,6,6
51552,Jâmâli,malganis,575,warrior,fury,12,6,6
51553,Happyhour,sargeras,575,warrior,fury,12,6,6
51554,Zulien,sanguino,575,warrior,fury,12,6,6
51555,Leorx,draenor,575,warrior,fury,12,6,6
51556,Дизроуз,gordunni,575,warrior,fury,12,6,6
51557,Tsu,karazhan,575,warrior,fury,12,6,6
51558,Fightinghell,stormrage,575,warrior,fury,12,6,6
51559,Йомхар,howling-fjord,575,warrior,fury,12,6,6
51560,Ffrancis,eldrethalas,575,warrior,fury,12,6,6
51561,Richymorty,los-errantes,575,warrior,fury,12,6,6
51562,Akäme,ysondre,575,warrior,fury,18,6,12
51563,Argomor,stormscale,575,warrior,fury,18,6,12
51564,Juanvaco,tarren-mill,575,warrior,fury,18,6,12
51565,Вкусныисыр,soulflayer,574,warrior,fury,12,6,6
51566,Bruko,silvermoon,574,warrior,fury,12,6,6
51567,Exødiä,hyjal,574,warrior,fury,12,6,6
51568,Kvintor,bloodscalp,574,warrior,fury,12,6,6
51569,Admiràl,azuremyst,573,warrior,fury,12,6,6
51570,Зарган,howling-fjord,573,warrior,fury,24,6,18
51571,Waltharius,das-syndikat,572,warrior,fury,12,6,6
51572,Джомалкович,deathweaver,572,warrior,fury,12,6,6
51573,Deushill,sylvanas,570,warrior,fury,12,6,6
51574,Khrund,burning-legion,566,warrior,fury,14,6,8
51575,Mokwo,chogall,543,warrior,fury,14,7,7
51576,Zionto,draenor,543,warrior,fury,23,6,17
51577,Piinte,naxxramas,536,warrior,fury,14,7,7
51578,Pinkvae,doomhammer,527,warrior,fury,11,6,5
51579,Мегамегаогр,howling-fjord,527,warrior,fury,11,6,5
51580,Skeptikal,tarren-mill,527,warrior,fury,11,6,5
51581,Narkololzz,marécage-de-zangar,527,warrior,fury,15,6,9
51582,Balsor,frostmane,526,warrior,fury,11,6,5
51583,Ausrastus,blackhand,522,warrior,fury,16,7,9
51584,Retmain,draenor,522,warrior,fury,20,8,12
51585,Boxersene,blackmoore,516,warrior,fury,22,7,15
51586,Xienia,dun-morogh,510,warrior,fury,22,6,16
51587,Blutwar,kazzak,499,warrior,fury,25,11,14
51588,Ishbosheth,stormscale,480,warrior,fury,6,5,1
51589,Warsteng,ragnaros,480,warrior,fury,6,5,1
51590,Ptp,argent-dawn,480,warrior,fury,6,5,1
51591,Дайбек,howling-fjord,480,warrior,fury,6,5,1
51592,Griswarr,draenor,480,warrior,fury,6,5,1
51593,Easypoîntsx,tarren-mill,480,warrior,fury,6,5,1
51594,Melted,ravencrest,480,warrior,fury,6,5,1
51595,Röell,draenor,480,warrior,fury,6,5,1
51596,Вульфычч,gordunni,480,warrior,fury,6,5,1
51597,Megabrux,colinas-pardas,480,warrior,fury,6,5,1
51598,Gguts,archimonde,480,warrior,fury,6,5,1
51599,Ézélya,dalaran,480,warrior,fury,6,5,1
51600,Escapeartíst,ravencrest,480,warrior,fury,6,5,1
51601,Ravenpaw,burning-legion,480,warrior,fury,6,5,1
51602,Ганахан,soulflayer,480,warrior,fury,6,5,1
51603,Exeter,nagrand,480,warrior,fury,6,5,1
51604,Bârney,ravencrest,480,warrior,fury,6,5,1
51605,Xtu,kazzak,480,warrior,fury,6,5,1
51606,Obîwan,dalaran,480,warrior,fury,6,5,1
51607,Aldébbarann,archimonde,480,warrior,fury,8,6,2
51608,Pihvikostaja,stormreaver,480,warrior,fury,8,5,3
51609,Orkoje,argent-dawn,480,warrior,fury,12,5,7
51610,Nazdrago,draenor,480,warrior,fury,12,5,7
51611,Donvasto,sylvanas,480,warrior,fury,12,5,7
51612,Stkacha,sanguino,480,warrior,fury,12,5,7
51613,Ulthrak,archimonde,480,warrior,fury,12,5,7
51614,Jhoakim,argent-dawn,480,warrior,fury,12,5,7
51615,Darthmalgus,stormscale,480,warrior,fury,12,5,7
51616,Rohc,kazzak,480,warrior,fury,12,5,7
51617,Bøgatyr,draenor,480,warrior,fury,12,5,7
51618,Forerunner,silvermoon,480,warrior,fury,12,5,7
51619,Suknur,silvermoon,480,warrior,fury,12,5,7
51620,Beznacaj,outland,480,warrior,fury,12,5,7
51621,Punahabe,draenor,480,warrior,fury,12,5,7
51622,Daymio,twisting-nether,480,warrior,fury,12,5,7
51623,Petrixens,drakthul,480,warrior,fury,12,5,7
51624,Лысыч,gordunni,480,warrior,fury,12,5,7
51625,Kagsteelfist,twisting-nether,480,warrior,fury,12,5,7
51626,Helleon,twisting-nether,480,warrior,fury,12,5,7
51627,Bløckqt,archimonde,480,warrior,fury,12,5,7
51628,Lánse,ravencrest,480,warrior,fury,12,5,7
51629,Chrobochrot,burning-blade,480,warrior,fury,12,5,7
51630,Dauderup,aerie-peak,480,warrior,fury,12,5,7
51631,Léonie,arakarahm,480,warrior,fury,12,5,7
51632,Eiche,kazzak,480,warrior,fury,12,5,7
51633,Bîmbämboom,blackmoore,480,warrior,fury,12,5,7
51634,Wallach,darkspear,480,warrior,fury,12,5,7
51635,Трис,fordragon,480,warrior,fury,12,5,7
51636,Dyspó,sanguino,480,warrior,fury,12,5,7
51637,Riac,lothar,480,warrior,fury,12,5,7
51638,Soullmike,drakthul,480,warrior,fury,12,5,7
51639,Friendlytwo,quelthalas,480,warrior,fury,12,5,7
51640,Jugg,emerald-dream,480,warrior,fury,12,5,7
51641,Eliyahu,ghostlands,480,warrior,fury,12,5,7
51642,Гатал,howling-fjord,480,warrior,fury,12,5,7
51643,Kondomi,stormreaver,480,warrior,fury,12,5,7
51644,Ruixxted,stormreaver,480,warrior,fury,12,5,7
51645,Arthayl,eredar,480,warrior,fury,12,5,7
51646,Dayz,draenor,480,warrior,fury,12,5,7
51647,Damáge,doomhammer,480,warrior,fury,12,5,7
51648,Кэфтэмэ,soulflayer,480,warrior,fury,12,5,7
51649,Rageaholic,blackmoore,480,warrior,fury,12,5,7
51650,Corlo,uldaman,480,warrior,fury,12,5,7
51651,Axamo,ragnaros,480,warrior,fury,12,5,7
51652,Gagatchar,die-silberne-hand,480,warrior,fury,12,5,7
51653,Mouldyclunge,argent-dawn,480,warrior,fury,17,5,12
51654,Nightmareb,magtheridon,480,warrior,fury,18,5,13
51655,Bindera,silvermoon,480,warrior,fury,18,5,13
51656,Delonathor,drakthul,480,warrior,fury,18,5,13
51657,Ukloth,sanguino,480,warrior,fury,18,5,13
51658,Artheim,silvermoon,480,warrior,fury,18,5,13
51659,Sambucá,blackmoore,480,warrior,fury,18,5,13
51660,Лимэй,blackscar,480,warrior,fury,18,5,13
51661,Fluffeh,argent-dawn,480,warrior,fury,18,5,13
51662,Murotan,dalaran,480,warrior,fury,18,5,13
51663,Porrter,silvermoon,479,warrior,fury,6,5,1
51664,Galdir,ravencrest,479,warrior,fury,6,5,1
51665,Haregos,gorgonnash,479,warrior,fury,6,5,1
51666,Cosmoses,mazrigos,479,warrior,fury,12,5,7
51667,Maidenless,quelthalas,479,warrior,fury,12,5,7
51668,Miotyz,ahnqiraj,479,warrior,fury,12,5,7
51669,Hynekiller,silvermoon,479,warrior,fury,12,5,7
51670,Brutalz,kazzak,479,warrior,fury,12,5,7
51671,Pipsysimp,ragnaros,479,warrior,fury,12,5,7
51672,Wilmazutschn,nethersturm,479,warrior,fury,12,5,7
51673,Элейд,thermaplugg,479,warrior,fury,12,5,7
51674,Granrubin,dun-modr,479,warrior,fury,12,5,7
51675,Чорныгвард,gordunni,479,warrior,fury,12,5,7
51676,Keaile,tarren-mill,479,warrior,fury,12,5,7
51677,Luciferkhan,twisting-nether,479,warrior,fury,12,5,7
51678,Zenìa,argent-dawn,479,warrior,fury,12,5,7
51679,Jeembo,blackmoore,479,warrior,fury,18,5,13
51680,Мутобой,soulflayer,479,warrior,fury,18,5,13
51681,Harny,silvermoon,477,warrior,fury,10,6,4
51682,Roostai,shattered-hand,476,warrior,fury,12,5,7
51683,Mane,thunderhorn,475,warrior,fury,12,5,7
51684,Iæ,perenolde,472,warrior,fury,12,5,7
51685,Workout,nemesis,447,warrior,fury,11,5,6
51686,Branzei,darkspear,447,warrior,fury,16,5,11
51687,Greensmash,hyjal,447,warrior,fury,20,6,14
51688,Autumnfálls,kazzak,446,warrior,fury,10,6,4
51689,Valrathion,ravencrest,426,warrior,fury,17,8,9
51690,Yugoslav,argent-dawn,426,warrior,fury,16,6,10
51691,Lykevil,medivh,414,warrior,fury,14,5,9
51692,Famous,argent-dawn,400,warrior,fury,7,5,2
51693,Kurzen,voljin,384,warrior,fury,6,4,2
51694,Айфилшок,gordunni,384,warrior,fury,6,4,2
51695,Gotnuub,tarren-mill,384,warrior,fury,6,4,2
51696,Devìlscandy,stormscale,384,warrior,fury,6,4,2
51697,Infernall,burning-legion,384,warrior,fury,6,4,2
51698,Имбасенпай,howling-fjord,384,warrior,fury,6,4,2
51699,Dominikhasek,stormscale,384,warrior,fury,6,4,2
51700,Нерморрог,howling-fjord,384,warrior,fury,6,4,2
51701,Nobelisarius,norgannon,384,warrior,fury,6,4,2
51702,Extasceh,turalyon,384,warrior,fury,6,4,2
51703,Daldiee,ravencrest,384,warrior,fury,6,4,2
51704,Viqi,alleria,384,warrior,fury,6,4,2
51705,Дугмар,gordunni,384,warrior,fury,6,4,2
51706,Drittsekken,sylvanas,384,warrior,fury,6,4,2
51707,Warbigboss,draenor,384,warrior,fury,6,4,2
51708,Bersurker,draenor,384,warrior,fury,6,4,2
51709,Tweaked,argent-dawn,384,warrior,fury,6,4,2
51710,Ronipickerin,stormscale,384,warrior,fury,6,4,2
51711,Gonutz,sylvanas,384,warrior,fury,6,4,2
51712,Впижаме,gordunni,384,warrior,fury,6,4,2
51713,Strähne,malganis,384,warrior,fury,6,4,2
51714,Orkboii,ravencrest,384,warrior,fury,6,4,2
51715,Dominow,ysondre,384,warrior,fury,6,4,2
51716,Mornog,blackhand,384,warrior,fury,6,4,2
51717,Chipstjuven,tarren-mill,384,warrior,fury,6,4,2
51718,Ymaa,argent-dawn,384,warrior,fury,6,4,2
51719,Oluwafunmila,tarren-mill,384,warrior,fury,6,4,2
51720,Lôreex,ravencrest,384,warrior,fury,6,4,2
51721,Axislips,draenor,384,warrior,fury,6,4,2
51722,Evilez,ravencrest,384,warrior,fury,6,4,2
51723,Hofftor,eredar,384,warrior,fury,6,4,2
51724,Даювзадницу,soulflayer,384,warrior,fury,6,4,2
51725,Shará,eredar,384,warrior,fury,6,4,2
51726,Zeldius,ravencrest,384,warrior,fury,6,4,2
51727,Кайзерчиф,soulflayer,384,warrior,fury,6,4,2
51728,Executte,zuljin,384,warrior,fury,6,4,2
51729,Zoink,burning-blade,384,warrior,fury,6,4,2
51730,Craíne,antonidas,384,warrior,fury,6,4,2
51731,Geckoo,emerald-dream,384,warrior,fury,6,4,2
51732,Cleavnseagal,ravencrest,384,warrior,fury,6,4,2
51733,Ränchiëk,ravencrest,384,warrior,fury,6,4,2
51734,Stickifrån,darkspear,384,warrior,fury,6,4,2
51735,Korghar,xavius,384,warrior,fury,6,4,2
51736,Dollystyle,kazzak,384,warrior,fury,6,4,2
51737,Histe,thrall,384,warrior,fury,6,4,2
51738,Mórdér,blackmoore,384,warrior,fury,6,4,2
51739,Suzzon,hyjal,384,warrior,fury,6,4,2
51740,Mvi,frostmane,384,warrior,fury,6,4,2
51741,Madvlad,twisting-nether,384,warrior,fury,6,4,2
51742,Roadsick,outland,384,warrior,fury,6,4,2
51743,Bravest,ragnaros,384,warrior,fury,6,4,2
51744,Asuross,dalaran,384,warrior,fury,6,4,2
51745,Ryghar,silvermoon,384,warrior,fury,6,4,2
51746,Irondahr,silvermoon,384,warrior,fury,6,4,2
51747,Zillrog,kazzak,384,warrior,fury,6,4,2
51748,Razzani,nathrezim,384,warrior,fury,6,4,2
51749,Vullgrîm,blackmoore,384,warrior,fury,6,4,2
51750,Thôras,anetheron,384,warrior,fury,6,4,2
51751,Humanoç,dun-modr,384,warrior,fury,6,4,2
51752,Shuriká,blackmoore,384,warrior,fury,6,4,2
51753,Lôcutus,thrall,384,warrior,fury,6,4,2
51754,Чосо,razuvious,384,warrior,fury,6,4,2
51755,Beached,outland,384,warrior,fury,6,4,2
51756,Gandosh,blackmoore,384,warrior,fury,6,4,2
51757,Satabasse,marécage-de-zangar,384,warrior,fury,6,4,2
51758,Shalahed,outland,384,warrior,fury,6,4,2
51759,Pierøne,nemesis,384,warrior,fury,6,4,2
51760,Eliyel,silvermoon,384,warrior,fury,6,4,2
51761,Truepassion,outland,384,warrior,fury,6,4,2
51762,Svinarghulk,twisting-nether,384,warrior,fury,6,4,2
51763,Saurens,twisting-nether,384,warrior,fury,6,4,2
51764,Deamonn,kazzak,384,warrior,fury,6,4,2
51765,Swàck,mazrigos,384,warrior,fury,6,4,2
51766,Trôth,kazzak,384,warrior,fury,6,4,2
51767,Sanhaevel,ravencrest,384,warrior,fury,10,4,6
51768,Golward,grim-batol,384,warrior,fury,11,4,7
51769,Slaktârn,ragnaros,384,warrior,fury,12,4,8
51770,Tanalias,outland,384,warrior,fury,12,4,8
51771,Аркашевич,gordunni,384,warrior,fury,12,4,8
51772,Katmos,baelgun,384,warrior,fury,12,4,8
51773,Sabak,archimonde,384,warrior,fury,12,4,8
51774,Bealin,the-venture-co,384,warrior,fury,12,4,8
51775,Барнетт,gordunni,384,warrior,fury,12,4,8
51776,Цикламея,blackscar,384,warrior,fury,12,4,8
51777,Garstus,die-silberne-hand,384,warrior,fury,12,4,8
51778,Yaune,ravencrest,384,warrior,fury,12,4,8
51779,Zargala,stormscale,384,warrior,fury,12,4,8
51780,Shabir,sylvanas,384,warrior,fury,12,4,8
51781,Bastrick,argent-dawn,384,warrior,fury,12,4,8
51782,Neekero,burning-legion,384,warrior,fury,12,4,8
51783,Grisettê,archimonde,384,warrior,fury,12,4,8
51784,Изберг,soulflayer,384,warrior,fury,12,4,8
51785,Ñegan,proudmoore,384,warrior,fury,12,4,8
51786,Деспазитыч,fordragon,384,warrior,fury,12,4,8
51787,Aynerin,silvermoon,384,warrior,fury,12,4,8
51788,Thorgaz,blackmoore,384,warrior,fury,12,4,8
51789,Scrin,ravenholdt,384,warrior,fury,12,4,8
51790,Himarsenko,silvermoon,384,warrior,fury,12,4,8
51791,Fistawarrior,nemesis,384,warrior,fury,12,4,8
51792,Колобочек,eversong,384,warrior,fury,12,4,8
51793,Suichôken,archimonde,384,warrior,fury,12,4,8
51794,Aprilis,thrall,384,warrior,fury,12,4,8
51795,Poniroula,burning-legion,384,warrior,fury,12,4,8
51796,Bulletpants,argent-dawn,384,warrior,fury,12,4,8
51797,Råkeff,tarren-mill,384,warrior,fury,12,4,8
51798,Betonica,burning-legion,384,warrior,fury,12,4,8
51799,Potátonerd,kazzak,384,warrior,fury,12,4,8
51800,Ganzaésábi,aggra-português,384,warrior,fury,12,4,8
51801,Tagavaga,tarren-mill,384,warrior,fury,12,4,8
51802,Agnetta,burning-legion,384,warrior,fury,12,4,8
51803,Garradoom,stormscale,384,warrior,fury,17,5,12
51804,Siltiel,marécage-de-zangar,383,warrior,fury,6,4,2
51805,Arta,arthas,383,warrior,fury,6,4,2
51806,Bulbumbo,twisting-nether,383,warrior,fury,6,4,2
51807,Ronda,nemesis,383,warrior,fury,6,4,2
51808,Voa,stormscale,383,warrior,fury,6,4,2
51809,Dullegriet,veknilash,383,warrior,fury,12,4,8
51810,Xhasan,sylvanas,383,warrior,fury,12,4,8
51811,Basingaa,pozzo-delleternità,383,warrior,fury,12,4,8
51812,Jún,dun-modr,383,warrior,fury,12,4,8
51813,Grenad,kazzak,383,warrior,fury,12,4,8
51814,Ruuddy,draenor,382,warrior,fury,12,4,8
51815,Colliderbody,dun-modr,367,warrior,fury,9,5,4
51816,Beogor,grim-batol,367,warrior,fury,11,4,7
51817,Toxîn,dalaran,351,warrior,fury,11,4,7
51818,Hembränt,hellfire,351,warrior,fury,17,4,13
51819,Bossít,doomhammer,336,warrior,fury,9,4,5
51820,Blackseven,ravencrest,330,warrior,fury,9,6,3
51821,Skillissues,argent-dawn,330,warrior,fury,11,7,4
51822,Fleshwerk,silvermoon,320,warrior,fury,10,4,6
51823,Zazate,archimonde,319,warrior,fury,5,4,1
51824,Manelar,draenor,319,warrior,fury,8,4,4
51825,Хоркан,blackscar,319,warrior,fury,8,4,4
51826,Phòbos,stormrage,319,warrior,fury,11,4,7
51827,Groullomus,archimonde,318,warrior,fury,10,4,6
51828,Anaba,voljin,318,warrior,fury,10,4,6
51829,Padzwarr,kazzak,288,warrior,fury,6,3,3
51830,Zarrgash,blackhand,288,warrior,fury,6,3,3
51831,Kapuchino,twisting-nether,288,warrior,fury,6,3,3
51832,Skullsmasher,stormscale,288,warrior,fury,6,3,3
51833,Hayahol,kazzak,288,warrior,fury,6,3,3
51834,Haryssa,blackhand,288,warrior,fury,6,3,3
51835,Гацс,soulflayer,288,warrior,fury,6,3,3
51836,Jasperr,nemesis,288,warrior,fury,6,3,3
51837,Auauau,arthas,288,warrior,fury,6,3,3
51838,Wunderwaffle,xavius,288,warrior,fury,6,3,3
51839,Грош,deepholm,288,warrior,fury,6,3,3
51840,Trìnítÿ,anubarak,288,warrior,fury,6,3,3
51841,Arnoldalois,neptulon,288,warrior,fury,6,3,3
51842,Nifrediel,trollbane,288,warrior,fury,6,3,3
51843,Imabeatyoass,kazzak,288,warrior,fury,6,3,3
51844,Rägnât,dun-modr,288,warrior,fury,6,3,3
51845,Wärlight,nemesis,288,warrior,fury,6,3,3
51846,Зандур,eversong,288,warrior,fury,6,3,3
51847,Previse,argent-dawn,288,warrior,fury,6,3,3
51848,Griffar,malorne,288,warrior,fury,6,3,3
51849,Mïîäm,archimonde,288,warrior,fury,6,3,3
51850,Lilenrage,stormscale,288,warrior,fury,6,3,3
51851,Neíd,malganis,288,warrior,fury,6,3,3
51852,Kopfnusskali,thrall,288,warrior,fury,6,3,3
51853,Zilg,twisting-nether,288,warrior,fury,6,3,3
51854,Васяжелезо,gordunni,288,warrior,fury,6,3,3
51855,Taeshalach,der-abyssische-rat,288,warrior,fury,6,3,3
51856,Blackwólf,bloodhoof,288,warrior,fury,6,3,3
51857,Tabboonishka,draenor,288,warrior,fury,6,3,3
51858,Schildwall,aegwynn,288,warrior,fury,6,3,3
51859,Dorya,aegwynn,288,warrior,fury,6,3,3
51860,Sørêy,aegwynn,288,warrior,fury,6,3,3
51861,Marlßørø,twisting-nether,288,warrior,fury,6,3,3
51862,Barrocket,aegwynn,288,warrior,fury,6,3,3
51863,Sulemanslay,silvermoon,288,warrior,fury,6,3,3
51864,Ivailowar,ravencrest,288,warrior,fury,6,3,3
51865,Dollybúrster,aegwynn,288,warrior,fury,6,3,3
51866,Manký,kazzak,288,warrior,fury,6,3,3
51867,Immera,silvermoon,288,warrior,fury,6,3,3
51868,Kronmw,dun-modr,288,warrior,fury,6,3,3
51869,Vory,ravencrest,288,warrior,fury,6,3,3
51870,Cryze,ravencrest,288,warrior,fury,6,3,3
51871,Ijzerekast,sylvanas,288,warrior,fury,6,3,3
51872,Cleavyera,tarren-mill,288,warrior,fury,6,3,3
51873,Nightmareowl,tarren-mill,288,warrior,fury,6,3,3
51874,Bernieboi,tarren-mill,288,warrior,fury,6,3,3
51875,Smâllpackage,silvermoon,288,warrior,fury,6,3,3
51876,Xerone,doomhammer,288,warrior,fury,6,3,3
51877,Grinrok,thrall,288,warrior,fury,6,3,3
51878,Whàtsup,stormscale,288,warrior,fury,6,3,3
51879,Mfdoöm,draenor,288,warrior,fury,6,3,3
51880,Feydal,thrall,288,warrior,fury,6,3,3
51881,Keffboi,draenor,288,warrior,fury,6,3,3
51882,Drfeelgud,twisting-nether,288,warrior,fury,6,3,3
51883,Ölaff,ravencrest,288,warrior,fury,6,3,3
51884,Shaxov,draenor,288,warrior,fury,6,3,3
51885,Slg,tarren-mill,288,warrior,fury,6,3,3
51886,Döömed,drakthul,288,warrior,fury,6,3,3
51887,Ironlol,ravencrest,288,warrior,fury,6,3,3
51888,Corychase,ravencrest,288,warrior,fury,6,3,3
51889,Uncledazzo,quelthalas,288,warrior,fury,6,3,3
51890,Arachnoyd,drakthul,288,warrior,fury,6,3,3
51891,Oombac,lordaeron,288,warrior,fury,6,3,3
51892,Nitheriá,draenor,288,warrior,fury,6,3,3
51893,Priceswex,ravencrest,288,warrior,fury,6,3,3
51894,Iwts,archimonde,288,warrior,fury,6,3,3
51895,Xial,ravencrest,288,warrior,fury,6,3,3
51896,Kåïdø,ravencrest,288,warrior,fury,6,3,3
51897,Geicoo,dalaran,288,warrior,fury,6,3,3
51898,Berzzerker,tarren-mill,288,warrior,fury,6,3,3
51899,Wåks,dalaran,288,warrior,fury,6,3,3
51900,Peon,eredar,288,warrior,fury,6,3,3
51901,Nèssa,outland,288,warrior,fury,6,3,3
51902,Aìrwave,blackmoore,288,warrior,fury,6,3,3
51903,Снакихснаки,gordunni,288,warrior,fury,6,3,3
51904,Jamiex,marécage-de-zangar,288,warrior,fury,6,3,3
51905,Eleborn,tarren-mill,288,warrior,fury,6,3,3
51906,Frankytank,antonidas,288,warrior,fury,6,3,3
51907,Elyozz,silvermoon,288,warrior,fury,6,3,3
51908,Hortswarr,drakthul,288,warrior,fury,6,3,3
51909,Lâppön,blackmoore,288,warrior,fury,6,3,3
51910,Sathom,hyjal,288,warrior,fury,6,3,3
51911,Tidùs,nethersturm,288,warrior,fury,6,3,3
51912,Didgedelik,archimonde,288,warrior,fury,6,3,3
51913,Sargul,ragnaros,288,warrior,fury,6,3,3
51914,Harimà,antonidas,288,warrior,fury,6,3,3
51915,Wárríor,ragnaros,288,warrior,fury,6,3,3
51916,Shaanks,archimonde,288,warrior,fury,6,3,3
51917,Afk,emeriss,288,warrior,fury,6,3,3
51918,Mumbojumbo,uldum,288,warrior,fury,6,3,3
51919,Lundehund,dalaran,288,warrior,fury,6,3,3
51920,Gnarrwarr,eredar,288,warrior,fury,6,3,3
51921,Uthric,azuremyst,288,warrior,fury,6,3,3
51922,Azotz,archimonde,288,warrior,fury,6,3,3
51923,Arthagore,archimonde,288,warrior,fury,6,3,3
51924,Rangnarr,doomhammer,288,warrior,fury,6,3,3
51925,Bobshaggins,stormscale,288,warrior,fury,12,3,9
51926,Urabrask,stormscale,288,warrior,fury,12,3,9
51927,Gorkill,bladefist,288,warrior,fury,12,3,9
51928,Phovoss,stormscale,288,warrior,fury,12,3,9
51929,Hördê,zuljin,288,warrior,fury,12,3,9
51930,Devso,ravencrest,288,warrior,fury,12,3,9
51931,Naspy,stormscale,288,warrior,fury,12,3,9
51932,Nightvision,skullcrusher,288,warrior,fury,12,3,9
51933,Гхазгхкалл,howling-fjord,288,warrior,fury,12,3,9
51934,Ôrcboi,tarren-mill,288,warrior,fury,12,3,9
51935,Confliction,outland,288,warrior,fury,12,3,9
51936,Lyfttokyo,tarren-mill,288,warrior,fury,12,3,9
51937,Malvred,eredar,288,warrior,fury,12,3,9
51938,Zyn,outland,288,warrior,fury,12,3,9
51939,Xeonair,kazzak,288,warrior,fury,12,3,9
51940,Skykrow,ysondre,288,warrior,fury,12,3,9
51941,Valldi,argent-dawn,288,warrior,fury,12,3,9
51942,Zercher,tarren-mill,288,warrior,fury,12,3,9
51943,Waríos,blackrock,288,warrior,fury,12,3,9
51944,Ireincarnate,argent-dawn,288,warrior,fury,12,3,9
51945,Conânan,blackrock,288,warrior,fury,12,3,9
51946,Pamila,outland,288,warrior,fury,12,3,9
51947,Aphae,defias-brotherhood,288,warrior,fury,12,3,9
51948,Slayfox,dun-morogh,288,warrior,fury,12,3,9
51949,Xanatos,khazgoroth,288,warrior,fury,12,3,9
51950,Daye,zuluhed,288,warrior,fury,12,3,9
51951,Pekknekck,outland,288,warrior,fury,12,3,9
51952,Kiryn,draenor,288,warrior,fury,12,3,9
51953,Theunknown,eonar,288,warrior,fury,12,3,9
51954,Mash,hyjal,288,warrior,fury,12,3,9
51955,Джондо,gordunni,288,warrior,fury,12,3,9
51956,Grommer,dentarg,288,warrior,fury,12,3,9
51957,Zwheind,silvermoon,288,warrior,fury,12,3,9
51958,Jasonnes,argent-dawn,288,warrior,fury,17,3,14
51959,Tbones,kazzak,288,warrior,fury,18,3,15
51960,Gartenzwerge,kelthuzad,287,warrior,fury,6,3,3
51961,Atelier,magtheridon,287,warrior,fury,6,3,3
51962,Arnnau,dun-modr,287,warrior,fury,6,3,3
51963,Luw,twisting-nether,287,warrior,fury,12,3,9
51964,Ragghatt,draenor,287,warrior,fury,12,3,9
51965,Xentos,kirin-tor,286,warrior,fury,10,5,5
51966,Agunnai,karazhan,286,warrior,fury,6,3,3
51967,Raffael,pozzo-delleternità,286,warrior,fury,12,3,9
51968,Kilsorrow,silvermoon,240,warrior,fury,9,4,5
51969,Execute,sanguino,239,warrior,fury,5,3,2
51970,Xgs,archimonde,234,warrior,fury,9,5,4
51971,Zeldaixi,twisting-nether,234,warrior,fury,10,5,5
51972,Xqt,laughing-skull,234,warrior,fury,9,4,5
51973,Fetidoman,zuljin,224,warrior,fury,10,3,7
51974,Iarsonn,drakthul,223,warrior,fury,8,3,5
51975,Флокт,howling-fjord,208,warrior,fury,7,3,4
51976,Цезарь,greymane,192,warrior,fury,4,3,1
51977,Mudryk,burning-blade,192,warrior,fury,4,3,1
51978,Имбанутыйвар,soulflayer,192,warrior,fury,4,3,1
51979,Балласёж,gordunni,192,warrior,fury,9,3,6
51980,Themachine,burning-blade,192,warrior,fury,9,3,6
51981,Elendurel,outland,192,warrior,fury,6,2,4
51982,Gregórry,eredar,192,warrior,fury,6,2,4
51983,Wembley,proudmoore,192,warrior,fury,6,2,4
51984,Гудмунт,borean-tundra,192,warrior,fury,6,2,4
51985,Bruks,antonidas,192,warrior,fury,6,2,4
51986,Врэкклив,gordunni,192,warrior,fury,6,2,4
51987,Shreedshot,blackmoore,192,warrior,fury,6,2,4
51988,Dorwarhoof,ravencrest,192,warrior,fury,6,2,4
51989,Kennzz,ravencrest,192,warrior,fury,6,2,4
51990,Boostbywar,archimonde,192,warrior,fury,6,2,4
51991,Piixxz,hyjal,192,warrior,fury,6,2,4
51992,Gomblin,blackmoore,192,warrior,fury,6,2,4
51993,Армгрид,gordunni,192,warrior,fury,6,2,4
51994,Raizy,frostwolf,192,warrior,fury,6,2,4
51995,Zirvey,tarren-mill,192,warrior,fury,6,2,4
51996,Kmag,ravencrest,192,warrior,fury,6,2,4
51997,Suduri,drakthul,192,warrior,fury,6,2,4
51998,Трапсир,gordunni,192,warrior,fury,6,2,4
51999,Alxqt,outland,192,warrior,fury,6,2,4
52000,Ellchefe,aggra-português,192,warrior,fury,6,2,4
52001,Mîcî,tarren-mill,192,warrior,fury,6,2,4
52002,Singekipu,hyjal,192,warrior,fury,6,2,4
52003,Crocbait,ravencrest,192,warrior,fury,6,2,4
52004,Ruz,defias-brotherhood,192,warrior,fury,6,2,4
52005,Wlâdimir,eredar,192,warrior,fury,6,2,4
52006,Jambaz,ravencrest,192,warrior,fury,6,2,4
52007,Pappasmurfy,outland,192,warrior,fury,6,2,4
52008,Raksor,hyjal,192,warrior,fury,6,2,4
52009,Jriddyzug,ravencrest,192,warrior,fury,6,2,4
52010,Sefty,tarren-mill,192,warrior,fury,6,2,4
52011,Grimdur,kirin-tor,192,warrior,fury,6,2,4
52012,Walkers,frostmane,192,warrior,fury,6,2,4
52013,Oxxi,outland,192,warrior,fury,6,2,4
52014,Shownomercy,blackrock,192,warrior,fury,6,2,4
52015,Pemex,stormreaver,192,warrior,fury,6,2,4
52016,Kaveli,tarren-mill,192,warrior,fury,6,2,4
52017,Onykat,aegwynn,192,warrior,fury,6,2,4
52018,Velgur,ravencrest,192,warrior,fury,6,2,4
52019,Malalulu,burning-legion,192,warrior,fury,6,2,4
52020,Xiiver,burning-legion,192,warrior,fury,6,2,4
52021,Кунгфурик,soulflayer,192,warrior,fury,6,2,4
52022,Kímbo,tarren-mill,192,warrior,fury,6,2,4
52023,Siuzy,blackrock,192,warrior,fury,6,2,4
52024,Freddie,baelgun,192,warrior,fury,6,2,4
52025,Skullxy,talnivarr,192,warrior,fury,6,2,4
52026,Rayyes,stormscale,192,warrior,fury,6,2,4
52027,Даммодар,howling-fjord,192,warrior,fury,6,2,4
52028,Oueban,doomhammer,192,warrior,fury,6,2,4
52029,Glupakrava,sylvanas,192,warrior,fury,6,2,4
52030,Khòrne,sanguino,192,warrior,fury,6,2,4
52031,Evilweraz,turalyon,192,warrior,fury,6,2,4
52032,Fookyoup,stormscale,192,warrior,fury,6,2,4
52033,Queak,kazzak,192,warrior,fury,6,2,4
52034,Holdemhammer,sanguino,192,warrior,fury,6,2,4
52035,Eyolf,thunderhorn,192,warrior,fury,6,2,4
52036,Искристый,howling-fjord,192,warrior,fury,6,2,4
52037,Qiz,silvermoon,192,warrior,fury,6,2,4
52038,Karkun,gilneas,192,warrior,fury,6,2,4
52039,Picklejuicer,argent-dawn,192,warrior,fury,6,2,4
52040,Maniaco,kazzak,192,warrior,fury,6,2,4
52041,Whitescale,silvermoon,192,warrior,fury,6,2,4
52042,Dieselengine,draenor,192,warrior,fury,6,2,4
52043,Lianore,sanguino,192,warrior,fury,6,2,4
52044,Саркон,ashenvale,192,warrior,fury,6,2,4
52045,Martins,doomhammer,192,warrior,fury,6,2,4
52046,Optitt,dethecus,192,warrior,fury,6,2,4
52047,Vikiox,das-konsortium,192,warrior,fury,6,2,4
52048,Троммтар,howling-fjord,192,warrior,fury,6,2,4
52049,Like,blackrock,192,warrior,fury,6,2,4
52050,Versionx,stormscale,192,warrior,fury,6,2,4
52051,Tyranitar,pozzo-delleternità,192,warrior,fury,6,2,4
52052,Fuwy,argent-dawn,192,warrior,fury,6,2,4
52053,Akril,kelthuzad,192,warrior,fury,6,2,4
52054,Zugzugcleave,blackrock,192,warrior,fury,6,2,4
52055,Sgàthach,silvermoon,192,warrior,fury,6,2,4
52056,Dupnica,kazzak,192,warrior,fury,6,2,4
52057,Aler,alakir,192,warrior,fury,6,2,4
52058,Nabucadnozor,illidan,192,warrior,fury,6,2,4
52059,Nokturnâl,silvermoon,192,warrior,fury,6,2,4
52060,Chrymiiee,blutkessel,192,warrior,fury,6,2,4
52061,Ragelust,twisting-nether,192,warrior,fury,6,2,4
52062,Raoh,malganis,192,warrior,fury,6,2,4
52063,Zalazain,burning-legion,192,warrior,fury,6,2,4
52064,Korama,emerald-dream,192,warrior,fury,6,2,4
52065,Sertigan,dun-modr,192,warrior,fury,6,2,4
52066,Deathrazór,stormscale,192,warrior,fury,6,2,4
52067,Азаргатан,soulflayer,192,warrior,fury,6,2,4
52068,Falnah,sargeras,192,warrior,fury,6,2,4
52069,Nexyycleave,kazzak,192,warrior,fury,6,2,4
52070,Souler,burning-legion,192,warrior,fury,6,2,4
52071,Cesaro,blackhand,192,warrior,fury,6,2,4
52072,Buntstift,thrall,192,warrior,fury,6,2,4
52073,Ezlx,stormscale,192,warrior,fury,6,2,4
52074,Кентафурик,soulflayer,192,warrior,fury,6,2,4
52075,Shíranuí,blackhand,192,warrior,fury,10,3,7
52076,Karmok,hyjal,192,warrior,fury,7,2,5
52077,Ochocinco,quelthalas,192,warrior,fury,7,2,5
52078,Schneklinge,blutkessel,192,warrior,fury,8,2,6
52079,Ikaroshi,silvermoon,192,warrior,fury,9,2,7
52080,Thordis,sylvanas,192,warrior,fury,11,2,9
52081,Korova,blackrock,192,warrior,fury,12,2,10
52082,Sycon,chamber-of-aspects,192,warrior,fury,12,2,10
52083,Stonlocked,blackhand,192,warrior,fury,12,2,10
52084,Pakusrage,defias-brotherhood,192,warrior,fury,12,2,10
52085,Rageside,draenor,192,warrior,fury,12,2,10
52086,Minotaureeni,silvermoon,192,warrior,fury,12,2,10
52087,Boofhoof,nordrassil,192,warrior,fury,12,2,10
52088,Сажень,blackscar,192,warrior,fury,12,2,10
52089,Altroox,malorne,192,warrior,fury,12,2,10
52090,Davetsiz,burning-legion,192,warrior,fury,12,2,10
52091,Angrethar,tarren-mill,192,warrior,fury,12,2,10
52092,Andrjuscha,blackrock,192,warrior,fury,12,2,10
52093,Frowenn,ravencrest,192,warrior,fury,12,2,10
52094,Tömahawk,defias-brotherhood,191,warrior,fury,6,2,4
52095,Dorinaz,die-aldor,191,warrior,fury,6,2,4
52096,Omosha,burning-legion,191,warrior,fury,6,2,4
52097,Sakaî,temple-noir,191,warrior,fury,6,2,4
52098,Alvis,nathrezim,191,warrior,fury,6,2,4
52099,Loty,drakthul,175,warrior,fury,11,2,9
52100,Кереешка,howling-fjord,175,warrior,fury,11,2,9
52101,Limejuicer,argent-dawn,169,warrior,fury,12,5,7
52102,Marranu,cthun,159,warrior,fury,5,2,3
52103,Brülldozer,kargath,159,warrior,fury,5,2,3
52104,Vlaax,ravencrest,138,warrior,fury,14,3,11
52105,Æxcoast,ravencrest,128,warrior,fury,4,2,2
52106,Pivcuga,kazzak,128,warrior,fury,4,2,2
52107,Ög,archimonde,96,warrior,fury,3,2,1
52108,Текайко,eversong,96,warrior,fury,3,2,1
52109,Krunchä,ragnaros,96,warrior,fury,3,2,1
52110,Ларджсворд,eversong,96,warrior,fury,11,2,9
52111,Модныйклык,eversong,96,warrior,fury,6,1,5
52112,Kerpi,silvermoon,96,warrior,fury,6,1,5
52113,Riptide,aggra-português,96,warrior,fury,6,1,5
52114,Swordluw,argent-dawn,96,warrior,fury,6,1,5
52115,Greekazi,kazzak,96,warrior,fury,6,1,5
52116,Høxy,outland,96,warrior,fury,6,1,5
52117,Stratic,blackmoore,96,warrior,fury,6,1,5
52118,Dp,area-52,96,warrior,fury,6,1,5
52119,Woghard,drakthul,96,warrior,fury,6,1,5
52120,Спаццифика,soulflayer,96,warrior,fury,6,1,5
52121,Fraeydís,silvermoon,96,warrior,fury,6,1,5
52122,Kronstris,veklor,96,warrior,fury,6,1,5
52123,Marícan,blackmoore,96,warrior,fury,6,1,5
52124,Mot,terenas,96,warrior,fury,6,1,5
52125,Azrail,xavius,96,warrior,fury,6,1,5
52126,Malebolia,mugthol,96,warrior,fury,6,1,5
52127,Sagethi,blackrock,96,warrior,fury,6,1,5
52128,Misiaczek,the-maelstrom,96,warrior,fury,6,1,5
52129,Znorro,trollbane,96,warrior,fury,6,1,5
52130,Stromzy,silvermoon,96,warrior,fury,6,1,5
52131,Анстасмэш,soulflayer,96,warrior,fury,6,1,5
52132,Feltias,drakthul,96,warrior,fury,6,1,5
52133,Фиббоначи,deathguard,96,warrior,fury,6,1,5
52134,Oxandrolona,argent-dawn,96,warrior,fury,6,1,5
52135,Армапипец,soulflayer,96,warrior,fury,6,1,5
52136,Bladewound,draenor,96,warrior,fury,6,1,5
52137,Skîêl,archimonde,96,warrior,fury,6,1,5
52138,Furyfame,darksorrow,96,warrior,fury,6,1,5
52139,Spacemachine,kazzak,96,warrior,fury,6,1,5
52140,Киссмиплис,gordunni,96,warrior,fury,6,1,5
52141,Karreg,hyjal,96,warrior,fury,6,1,5
52142,Moldamis,blackhand,96,warrior,fury,6,1,5
52143,Coldstory,draenor,96,warrior,fury,6,1,5
52144,Kaij,draenor,96,warrior,fury,6,1,5
52145,Дуухаст,gordunni,96,warrior,fury,6,1,5
52146,Rammaxx,tarren-mill,96,warrior,fury,6,1,5
52147,Xenowarr,tarren-mill,96,warrior,fury,6,1,5
52148,Narkzsthki,kazzak,96,warrior,fury,6,1,5
52149,Callipsa,argent-dawn,96,warrior,fury,6,1,5
52150,Grimmrock,gorgonnash,96,warrior,fury,6,1,5
52151,Raakalainen,vashj,96,warrior,fury,6,1,5
52152,Wardruine,dun-modr,96,warrior,fury,6,1,5
52153,Gameera,aerie-peak,96,warrior,fury,6,1,5
52154,Bokth,archimonde,96,warrior,fury,6,1,5
52155,Hordox,archimonde,96,warrior,fury,6,1,5
52156,Xirár,sylvanas,96,warrior,fury,6,1,5
52157,Utharis,stormscale,96,warrior,fury,6,1,5
52158,Денеур,gordunni,96,warrior,fury,6,1,5
52159,Рагкар,gordunni,96,warrior,fury,6,1,5
52160,Wanzzeur,hyjal,96,warrior,fury,6,1,5
52161,Sorkk,kazzak,96,warrior,fury,6,1,5
52162,Elesharde,sanguino,96,warrior,fury,6,1,5
52163,Ðý,silvermoon,96,warrior,fury,6,1,5
52164,Wiliamwalace,zuljin,96,warrior,fury,6,1,5
52165,Rawne,kirin-tor,96,warrior,fury,6,1,5
52166,Batourga,marécage-de-zangar,96,warrior,fury,6,1,5
52167,Savedsky,zuljin,96,warrior,fury,6,1,5
52168,Hammerfall,uldum,96,warrior,fury,6,1,5
52169,Jessepinkman,kirin-tor,96,warrior,fury,6,1,5
52170,Corpsecount,stormrage,96,warrior,fury,6,1,5
52171,Wifioffline,silvermoon,96,warrior,fury,6,1,5
52172,Raixxon,ragnaros,96,warrior,fury,6,1,5
52173,Quandaledngl,silvermoon,96,warrior,fury,12,1,11
52174,Анури,eversong,96,warrior,fury,12,1,11
52175,Hágríd,ragnaros,96,warrior,fury,12,1,11
52176,Zarolk,rashgarroth,96,warrior,fury,12,1,11
52177,Kaodes,outland,96,warrior,fury,17,1,16
52178,Bladewolf,khadgar,95,warrior,fury,12,1,11
52179,Krachz,draenor,63,warrior,fury,2,2,0
52180,Elkatar,stormscale,46,warrior,fury,23,6,17
52181,Hurlcroc,silvermoon,41,warrior,fury,9,2,7
52182,Vivrya,silvermoon,31,warrior,fury,2,1,1
52183,Olriksen,dentarg,31,warrior,fury,2,1,1
52184,Dreyker,sanguino,31,warrior,fury,2,1,1
52185,Kiljhimari,twisting-nether,31,warrior,fury,2,1,1
52186,Giltiné,runetotem,16,warrior,fury,1,1,0
52187,Marcus,ravencrest,2254,warrior,arms,150,79,71
52188,Réckx,twisting-nether,2233,warrior,arms,93,52,41
52189,Dõxqt,kazzak,2204,warrior,arms,86,49,37
52190,Scardrex,defias-brotherhood,2172,warrior,arms,94,49,45
52191,Sickjackenn,executus,2166,warrior,arms,111,58,53
52192,Midgetdamis,blackhand,2147,warrior,arms,137,87,50
52193,Gewyon,ragnaros,2137,warrior,arms,66,40,26
52194,Blîxtgordon,tarren-mill,2133,warrior,arms,78,42,36
52195,Elwarroo,dun-modr,2125,warrior,arms,166,93,73
52196,Palianytsia,ravencrest,2125,warrior,arms,77,40,37
52197,Sharpen,chamber-of-aspects,2116,warrior,arms,116,60,56
52198,Noragrets,stormscale,2116,warrior,arms,80,41,39
52199,Tpyñåöädxzd,the-maelstrom,2116,warrior,arms,82,42,40
52200,Mastodøntes,hyjal,2115,warrior,arms,91,50,41
52201,Кокдиллак,soulflayer,2113,warrior,arms,160,82,78
52202,Скварх,howling-fjord,2112,warrior,arms,120,74,46
52203,Yorgal,arakarahm,2106,warrior,arms,96,47,49
52204,Grkpwh,silvermoon,2105,warrior,arms,88,48,40
52205,Immørtálx,tarren-mill,2102,warrior,arms,72,38,34
52206,Лёшавор,howling-fjord,2096,warrior,arms,108,55,53
52207,Regnarok,sylvanas,2086,warrior,arms,208,116,92
52208,Savesta,dalaran,2085,warrior,arms,186,96,90
52209,Zugzugcleave,blackrock,2084,warrior,arms,84,48,36
52210,Nikkí,naxxramas,2074,warrior,arms,96,50,46
52211,Thomasman,nerathor,2073,warrior,arms,102,48,54
52212,Gabrijel,draenor,2071,warrior,arms,174,86,88
52213,Ðênnis,ravencrest,2062,warrior,arms,54,31,23
52214,Seifcham,ragnaros,2052,warrior,arms,221,108,113
52215,Zhrey,stormscale,2048,warrior,arms,137,67,70
52216,Dunecrab,tarren-mill,2042,warrior,arms,113,63,50
52217,Оркабал,howling-fjord,2038,warrior,arms,142,77,65
52218,Semmino,nemesis,2030,warrior,arms,72,39,33
52219,Cerry,ravencrest,2016,warrior,arms,123,63,60
52220,Wingüi,dun-modr,2006,warrior,arms,84,40,44
52221,Соджиро,howling-fjord,2004,warrior,arms,72,36,36
52222,Karny,ravencrest,2002,warrior,arms,108,61,47
52223,Quotx,stormscale,2001,warrior,arms,129,61,68
52224,Ässholedamis,blackhand,1999,warrior,arms,60,46,14
52225,Trâshwarriør,blackhand,1998,warrior,arms,62,27,35
52226,Ulrid,draenor,1996,warrior,arms,108,55,53
52227,Joeférnandes,ragnaros,1996,warrior,arms,77,38,39
52228,Wràthfúl,kazzak,1995,warrior,arms,143,74,69
52229,Galeron,kazzak,1992,warrior,arms,90,42,48
52230,Sickjackenx,executus,1990,warrior,arms,150,76,74
52231,Therealman,kazzak,1986,warrior,arms,68,36,32
52232,Вэшикх,soulflayer,1984,warrior,arms,89,48,41
52233,Zak,stormscale,1980,warrior,arms,96,43,53
52234,Emix,arygos,1975,warrior,arms,72,39,33
52235,Wargoth,draenor,1971,warrior,arms,87,51,36
52236,Qtcockxx,stormscale,1969,warrior,arms,66,33,33
52237,Schaufelørc,blackrock,1966,warrior,arms,72,40,32
52238,Kartha,stormscale,1964,warrior,arms,66,34,32
52239,Pürporc,archimonde,1963,warrior,arms,76,40,36
52240,Mitu,sanguino,1959,warrior,arms,239,120,119
52241,Alegral,ravencrest,1958,warrior,arms,265,131,134
52242,Merked,kazzak,1958,warrior,arms,72,34,38
52243,Shilix,twisting-nether,1956,warrior,arms,139,65,74
52244,Pentagramlol,twisting-nether,1955,warrior,arms,64,34,30
52245,Palmexwar,drakthul,1954,warrior,arms,150,76,74
52246,Hasbullá,kazzak,1953,warrior,arms,278,147,131
52247,Purporcc,archimonde,1950,warrior,arms,63,32,31
52248,Bàrbandit,archimonde,1946,warrior,arms,102,52,50
52249,Disarmed,auchindoun,1945,warrior,arms,54,31,23
52250,Schwän,twisting-nether,1943,warrior,arms,60,32,28
52251,Myonmyonmyon,blackmoore,1937,warrior,arms,68,41,27
52252,Markers,twisting-nether,1937,warrior,arms,109,49,60
52253,Manaskhan,tarren-mill,1936,warrior,arms,195,100,95
52254,Джерамин,blackscar,1934,warrior,arms,77,35,42
52255,Dabr,stormscale,1933,warrior,arms,54,29,25
52256,Kwasimodo,blackmoore,1933,warrior,arms,70,30,40
52257,Bigboyx,kazzak,1932,warrior,arms,116,56,60
52258,Velcorn,ravencrest,1931,warrior,arms,54,26,28
52259,Infernion,jaedenar,1930,warrior,arms,48,30,18
52260,Belver,argent-dawn,1929,warrior,arms,38,22,16
52261,Jenkinzz,stormscale,1928,warrior,arms,102,59,43
52262,Thenx,tarren-mill,1926,warrior,arms,159,78,81
52263,Hulksmsh,hyjal,1925,warrior,arms,71,32,39
52264,Kapuchino,twisting-nether,1921,warrior,arms,48,27,21
52265,Ønogal,archimonde,1919,warrior,arms,84,40,44
52266,Комочекгнева,howling-fjord,1912,warrior,arms,139,70,69
52267,Timpey,kazzak,1911,warrior,arms,54,30,24
52268,Sagethi,blackrock,1911,warrior,arms,83,41,42
52269,Whýsøsîleñt,ragnaros,1909,warrior,arms,40,29,11
52270,Theryk,sanguino,1909,warrior,arms,171,80,91
52271,Böggzbunny,tarren-mill,1908,warrior,arms,54,32,22
52272,Ragestarved,ragnaros,1908,warrior,arms,83,40,43
52273,Apacolata,outland,1903,warrior,arms,57,29,28
52274,Длоордпро,soulflayer,1900,warrior,arms,65,29,36
52275,Wasro,norgannon,1897,warrior,arms,106,55,51
52276,Nedåh,blackrock,1896,warrior,arms,90,47,43
52277,Banîsher,drakthul,1896,warrior,arms,140,70,70
52278,Çatàclysmíc,kazzak,1896,warrior,arms,138,69,69
52279,Rhâpsodyw,ravencrest,1895,warrior,arms,82,44,38
52280,Фокатоп,blackscar,1895,warrior,arms,54,28,26
52281,Saurens,twisting-nether,1895,warrior,arms,84,38,46
52282,Julololo,archimonde,1893,warrior,arms,72,40,32
52283,Benzemá,sanguino,1892,warrior,arms,82,50,32
52284,Otp,ravencrest,1890,warrior,arms,108,54,54
52285,Courageous,ravencrest,1889,warrior,arms,66,39,27
52286,Tsuperman,tarren-mill,1888,warrior,arms,72,37,35
52287,Notthateasy,blackrock,1887,warrior,arms,42,24,18
52288,Лилиофаныч,soulflayer,1886,warrior,arms,53,29,24
52289,Tozzhug,ragnaros,1885,warrior,arms,54,31,23
52290,Drclapit,blackrock,1884,warrior,arms,42,23,19
52291,Aerês,tarren-mill,1884,warrior,arms,174,89,85
52292,Liptonxecute,blackhand,1883,warrior,arms,59,32,27
52293,Naronnas,drakthul,1883,warrior,arms,140,75,65
52294,Аэска,deathweaver,1881,warrior,arms,66,31,35
52295,Куесэс,howling-fjord,1880,warrior,arms,36,20,16
52296,Compétiteub,archimonde,1879,warrior,arms,84,38,46
52297,Gnømércy,stormscale,1878,warrior,arms,42,22,20
52298,Gulläx,burning-legion,1878,warrior,arms,42,20,22
52299,Флагмэн,gordunni,1876,warrior,arms,89,50,39
52300,Cathériné,drakthul,1875,warrior,arms,48,27,21
52301,Purpórc,archimonde,1875,warrior,arms,54,30,24
52302,Бэнчпресс,soulflayer,1875,warrior,arms,60,29,31
52303,Oswáld,defias-brotherhood,1874,warrior,arms,50,37,13
52304,Downpippuri,silvermoon,1874,warrior,arms,84,58,26
52305,Фрейз,blackscar,1874,warrior,arms,70,34,36
52306,Mckinseybcg,outland,1873,warrior,arms,107,67,40
52307,Doomqt,terokkar,1873,warrior,arms,47,27,20
52308,Hellguard,archimonde,1872,warrior,arms,84,47,37
52309,Endagon,ravencrest,1871,warrior,arms,103,49,54
52310,Nukerz,kirin-tor,1870,warrior,arms,72,39,33
52311,Хиро,deathweaver,1870,warrior,arms,72,37,35
52312,Nipes,nozdormu,1870,warrior,arms,78,38,40
52313,Regnarøk,sylvanas,1869,warrior,arms,71,44,27
52314,Daredevìl,eredar,1869,warrior,arms,107,53,54
52315,Gguts,archimonde,1867,warrior,arms,97,53,44
52316,Zhoti,outland,1866,warrior,arms,64,33,31
52317,Xvlanter,silvermoon,1865,warrior,arms,127,65,62
52318,Mercey,stormscale,1865,warrior,arms,47,24,23
52319,Stupidz,hyjal,1865,warrior,arms,54,26,28
52320,Рвбстох,blackscar,1864,warrior,arms,72,38,34
52321,Irherklek,stormscale,1863,warrior,arms,47,28,19
52322,Екзобайт,gordunni,1862,warrior,arms,95,52,43
52323,Xåb,dun-morogh,1862,warrior,arms,66,28,38
52324,Брокскрим,soulflayer,1861,warrior,arms,60,30,30
52325,Summerkarma,wildhammer,1860,warrior,arms,132,68,64
52326,Lostday,blackrock,1858,warrior,arms,174,87,87
52327,Sekwar,twisting-nether,1858,warrior,arms,42,21,21
52328,Grimogør,stormscale,1857,warrior,arms,48,27,21
52329,Pivcuga,kazzak,1857,warrior,arms,307,155,152
52330,Europ,silvermoon,1857,warrior,arms,162,78,84
52331,Mirageous,tarren-mill,1854,warrior,arms,83,46,37
52332,Mômsboy,tarren-mill,1853,warrior,arms,64,33,31
52333,Ланро,gordunni,1853,warrior,arms,65,33,32
52334,Prymebeevz,blackmoore,1852,warrior,arms,53,36,17
52335,Àlexander,ravencrest,1852,warrior,arms,35,20,15
52336,Reacôn,twisting-nether,1851,warrior,arms,52,28,24
52337,Balthew,defias-brotherhood,1851,warrior,arms,48,24,24
52338,Skorm,mugthol,1849,warrior,arms,36,27,9
52339,Reckqtw,eredar,1849,warrior,arms,92,50,42
52340,Xxeqtr,kazzak,1849,warrior,arms,95,45,50
52341,Аоетакси,soulflayer,1848,warrior,arms,104,59,45
52342,Valoo,malganis,1847,warrior,arms,92,47,45
52343,Krônm,dun-modr,1847,warrior,arms,78,33,45
52344,Connorzw,blackmoore,1846,warrior,arms,42,25,17
52345,Nihe,stormreaver,1846,warrior,arms,66,30,36
52346,Goatie,frostwhisper,1844,warrior,arms,42,30,12
52347,Kaieh,argent-dawn,1844,warrior,arms,48,31,17
52348,Messermozart,blackmoore,1844,warrior,arms,48,25,23
52349,Civok,kult-der-verdammten,1844,warrior,arms,66,31,35
52350,Jessicaday,archimonde,1843,warrior,arms,42,21,21
52351,Крипочёк,gordunni,1842,warrior,arms,42,25,17
52352,Istyos,hyjal,1842,warrior,arms,89,44,45
52353,Zéox,baelgun,1840,warrior,arms,53,30,23
52354,Jriddyzug,ravencrest,1840,warrior,arms,62,33,29
52355,Enøt,kazzak,1839,warrior,arms,53,25,28
52356,Xiro,hellscream,1838,warrior,arms,70,45,25
52357,Орданис,deathguard,1838,warrior,arms,66,33,33
52358,Демолишеер,howling-fjord,1838,warrior,arms,77,37,40
52359,Hitt,ysondre,1838,warrior,arms,102,49,53
52360,Rhagnok,archimonde,1838,warrior,arms,84,39,45
52361,Dominikhasek,stormscale,1837,warrior,arms,52,33,19
52362,Sneakydrm,kazzak,1837,warrior,arms,40,23,17
52363,Eidzo,tarren-mill,1837,warrior,arms,84,45,39
52364,Kanté,burning-blade,1834,warrior,arms,41,24,17
52365,Æriø,dalaran,1833,warrior,arms,48,27,21
52366,Purporcfr,archimonde,1833,warrior,arms,64,32,32
52367,Karpzug,stormscale,1832,warrior,arms,39,22,17
52368,Pawnerlol,mannoroth,1832,warrior,arms,59,28,31
52369,Trapoulas,kazzak,1832,warrior,arms,107,48,59
52370,Blåvingad,kazzak,1831,warrior,arms,56,34,22
52371,Боссберс,soulflayer,1831,warrior,arms,89,44,45
52372,Watrux,outland,1831,warrior,arms,66,31,35
52373,Воинлета,howling-fjord,1830,warrior,arms,101,60,41
52374,Brogre,stormrage,1830,warrior,arms,77,40,37
52375,Qapper,kazzak,1830,warrior,arms,57,28,29
52376,Khÿze,ysondre,1829,warrior,arms,58,39,19
52377,Mirpz,doomhammer,1829,warrior,arms,48,31,17
52378,Klearr,silvermoon,1829,warrior,arms,91,56,35
52379,Läerezh,ysondre,1829,warrior,arms,54,32,22
52380,Вуриор,howling-fjord,1829,warrior,arms,114,64,50
52381,Nelios,sylvanas,1829,warrior,arms,60,33,27
52382,Njn,argent-dawn,1829,warrior,arms,48,23,25
52383,Kamked,burning-legion,1828,warrior,arms,107,50,57
52384,Nightmareowl,tarren-mill,1827,warrior,arms,136,76,60
52385,Blazefüry,ravencrest,1827,warrior,arms,61,33,28
52386,Rînus,aegwynn,1827,warrior,arms,54,26,28
52387,Wuifly,dun-modr,1826,warrior,arms,69,35,34
52388,Варбоссец,soulflayer,1825,warrior,arms,66,35,31
52389,Nurekin,argent-dawn,1825,warrior,arms,66,32,34
52390,Javakt,stormscale,1825,warrior,arms,218,103,115
52391,Rivah,tarren-mill,1824,warrior,arms,63,34,29
52392,Crawly,aegwynn,1824,warrior,arms,177,95,82
52393,Reysleys,mazrigos,1823,warrior,arms,69,32,37
52394,Ðior,bronze-dragonflight,1822,warrior,arms,53,29,24
52395,Марльин,howling-fjord,1822,warrior,arms,59,29,30
52396,Crîxús,silvermoon,1822,warrior,arms,60,25,35
52397,Seifchamqt,ragnaros,1821,warrior,arms,52,31,21
52398,Escapematrix,kazzak,1821,warrior,arms,95,48,47
52399,Asçrðth,kazzak,1821,warrior,arms,54,26,28
52400,Dortenz,ragnaros,1821,warrior,arms,54,24,30
52401,Куртфорренс,gordunni,1821,warrior,arms,79,31,48
52402,Urmack,ravencrest,1820,warrior,arms,48,37,11
52403,Rngmonster,kazzak,1820,warrior,arms,100,68,32
52404,Uzamaki,bronzebeard,1820,warrior,arms,48,32,16
52405,Knutrex,tarren-mill,1820,warrior,arms,61,35,26
52406,Drahkor,baelgun,1819,warrior,arms,60,39,21
52407,Лимпс,gordunni,1819,warrior,arms,30,19,11
52408,Flinta,blackmoore,1819,warrior,arms,90,51,39
52409,Maarshl,ysondre,1819,warrior,arms,225,121,104
52410,Pürporcc,archimonde,1818,warrior,arms,97,48,49
52411,Hunkz,sylvanas,1818,warrior,arms,65,32,33
52412,Имеравета,gordunni,1818,warrior,arms,150,71,79
52413,Мелькорт,gordunni,1817,warrior,arms,48,29,19
52414,Chaddimus,draenor,1817,warrior,arms,63,36,27
52415,Поршекаен,howling-fjord,1817,warrior,arms,101,50,51
52416,Liferuiner,rexxar,1816,warrior,arms,133,73,60
52417,Kiyomaro,stormscale,1816,warrior,arms,66,36,30
52418,Экзекьютлол,soulflayer,1816,warrior,arms,47,25,22
52419,Joéfernandés,sylvanas,1816,warrior,arms,36,19,17
52420,Klonyarik,ravencrest,1815,warrior,arms,36,19,17
52421,Шурпач,deathguard,1815,warrior,arms,72,37,35
52422,Dnoire,ravencrest,1815,warrior,arms,60,28,32
52423,Nelthôr,alleria,1814,warrior,arms,156,94,62
52424,Aeyon,burning-blade,1814,warrior,arms,45,27,18
52425,Thorana,twisting-nether,1814,warrior,arms,59,32,27
52426,Naskez,kazzak,1814,warrior,arms,81,41,40
52427,Darshan,grim-batol,1814,warrior,arms,66,33,33
52428,Leethal,outland,1814,warrior,arms,60,27,33
52429,Juank,minahonda,1814,warrior,arms,48,21,27
52430,Арма,howling-fjord,1813,warrior,arms,54,39,15
52431,Doloresvp,zuljin,1813,warrior,arms,66,36,30
52432,Mtc,blackrock,1813,warrior,arms,68,34,34
52433,Pummelthru,burning-legion,1813,warrior,arms,65,32,33
52434,Vic,tarren-mill,1813,warrior,arms,47,20,27
52435,Zcell,kazzak,1812,warrior,arms,36,23,13
52436,Xurainzone,eredar,1812,warrior,arms,48,27,21
52437,Mystylez,silvermoon,1812,warrior,arms,60,28,32
52438,Gucciwarrior,blackhand,1812,warrior,arms,90,41,49
52439,Vvulf,eredar,1812,warrior,arms,60,25,35
52440,Axinit,blackrock,1811,warrior,arms,42,23,19
52441,Стефанидзе,soulflayer,1811,warrior,arms,42,22,20
52442,Ozrenac,kazzak,1811,warrior,arms,196,100,96
52443,Idiotplay,drekthar,1811,warrior,arms,42,19,23
52444,Johnmeadows,ravencrest,1810,warrior,arms,36,23,13
52445,Artøria,archimonde,1810,warrior,arms,96,54,42
52446,Ðiscordia,blackhand,1810,warrior,arms,84,43,41
52447,Оксенфурт,soulflayer,1810,warrior,arms,140,70,70
52448,Kragrâu,kazzak,1810,warrior,arms,71,33,38
52449,Jínro,draenor,1810,warrior,arms,48,22,26
52450,Jokkul,tarren-mill,1810,warrior,arms,46,21,25
52451,Cherserker,ragnaros,1809,warrior,arms,69,41,28
52452,Yarilolx,outland,1808,warrior,arms,49,28,21
52453,Drilley,blackmoore,1807,warrior,arms,50,34,16
52454,Oldchap,nordrassil,1807,warrior,arms,48,31,17
52455,Олдборовс,soulflayer,1807,warrior,arms,53,29,24
52456,Zeddone,drakthul,1807,warrior,arms,90,46,44
52457,Bloodhorn,blackhand,1807,warrior,arms,107,54,53
52458,Варзила,blackscar,1807,warrior,arms,53,22,31
52459,Nìmera,nemesis,1806,warrior,arms,36,26,10
52460,Yelanx,twisting-nether,1806,warrior,arms,48,34,14
52461,Ðennis,argent-dawn,1806,warrior,arms,48,33,15
52462,Juggernãut,ravencrest,1806,warrior,arms,102,58,44
52463,Гатсберсерк,gordunni,1806,warrior,arms,167,91,76
52464,Wayneson,tarren-mill,1806,warrior,arms,108,58,50
52465,Книфэк,howling-fjord,1806,warrior,arms,76,40,36
52466,Brutilda,antonidas,1806,warrior,arms,53,25,28
52467,Дуглимон,gordunni,1805,warrior,arms,65,37,28
52468,Toscothegoat,ravencrest,1804,warrior,arms,36,24,12
52469,Greenblób,kazzak,1804,warrior,arms,66,27,39
52470,Hanìbal,ravencrest,1803,warrior,arms,60,32,28
52471,Gigadot,arathor,1803,warrior,arms,186,97,89
52472,Nazrihk,ravencrest,1803,warrior,arms,49,25,24
52473,Ghakra,kazzak,1802,warrior,arms,36,25,11
52474,Westwyde,hyjal,1802,warrior,arms,48,30,18
52475,Drittsekken,sylvanas,1802,warrior,arms,105,60,45
52476,Thyréc,blackmoore,1802,warrior,arms,60,34,26
52477,Fràgile,ravencrest,1802,warrior,arms,113,61,52
52478,Мопк,howling-fjord,1801,warrior,arms,84,48,36
52479,Элетий,soulflayer,1801,warrior,arms,36,19,17
52480,Shortcvnt,ravencrest,1800,warrior,arms,48,28,20
52481,Phalek,argent-dawn,1800,warrior,arms,48,28,20
52482,Azudaddy,blackmoore,1800,warrior,arms,59,34,25
52483,Dairøx,blackrock,1800,warrior,arms,60,31,29
52484,Ástriax,ravencrest,1799,warrior,arms,159,77,82
52485,Cerßere,archimonde,1798,warrior,arms,120,61,59
52486,Беренса,howling-fjord,1796,warrior,arms,107,63,44
52487,Kamatâ,kazzak,1796,warrior,arms,60,32,28
52488,Nitheriá,draenor,1796,warrior,arms,355,180,175
52489,Хэйре,howling-fjord,1795,warrior,arms,172,88,84
52490,Злопиканка,gordunni,1794,warrior,arms,58,29,29
52491,Стилерин,gordunni,1794,warrior,arms,48,22,26
52492,Заликмортал,soulflayer,1793,warrior,arms,186,100,86
52493,Blademir,aegwynn,1793,warrior,arms,70,31,39
52494,Atrôcithy,silvermoon,1791,warrior,arms,48,25,23
52495,Perinel,draenor,1789,warrior,arms,147,80,67
52496,Kënnyföx,ysondre,1789,warrior,arms,36,19,17
52497,Røidrage,stormscale,1789,warrior,arms,96,45,51
52498,Nímera,nemesis,1788,warrior,arms,36,19,17
52499,Фрейз,deathweaver,1785,warrior,arms,48,29,19
52500,Zheaks,kazzak,1785,warrior,arms,95,45,50
52501,Древилгод,gordunni,1783,warrior,arms,57,31,26
52502,Kennyföx,ysondre,1782,warrior,arms,38,24,14
52503,Khalimov,tarren-mill,1781,warrior,arms,102,52,50
52504,Бодибилдерыч,gordunni,1779,warrior,arms,113,60,53
52505,Selenez,outland,1779,warrior,arms,67,30,37
52506,Venres,blackhand,1777,warrior,arms,88,47,41
52507,Damagz,tarren-mill,1776,warrior,arms,89,44,45
52508,Shookyx,ravencrest,1775,warrior,arms,42,24,18
52509,Троммтар,howling-fjord,1774,warrior,arms,100,44,56
52510,Raley,ragnaros,1773,warrior,arms,166,93,73
52511,Zombossio,tarren-mill,1773,warrior,arms,74,38,36
52512,Dõxlol,kazzak,1771,warrior,arms,36,20,16
52513,Jackyred,silvermoon,1771,warrior,arms,71,31,40
52514,Drxeqtit,blackrock,1770,warrior,arms,53,29,24
52515,Kurbá,stormscale,1768,warrior,arms,42,26,16
52516,Ändrow,dalaran,1768,warrior,arms,54,33,21
52517,Lyriae,argent-dawn,1768,warrior,arms,66,39,27
52518,Jengaa,draenor,1768,warrior,arms,126,65,61
52519,Prøject,archimonde,1768,warrior,arms,54,27,27
52520,Bravopla,silvermoon,1767,warrior,arms,54,28,26
52521,Komissarecks,aegwynn,1767,warrior,arms,63,31,32
52522,Pangowar,elune,1766,warrior,arms,69,38,31
52523,Ехрерау,gordunni,1765,warrior,arms,66,27,39
52524,Loty,drakthul,1764,warrior,arms,113,49,64
52525,Craanked,aegwynn,1763,warrior,arms,58,25,33
52526,Chucho,argent-dawn,1761,warrior,arms,48,26,22
52527,Kûrûmî,blackmoore,1760,warrior,arms,55,36,19
52528,Wardruine,dun-modr,1760,warrior,arms,179,90,89
52529,Saidi,outland,1760,warrior,arms,174,80,94
52530,Okcool,twisting-nether,1757,warrior,arms,42,26,16
52531,Downpipe,twisting-nether,1757,warrior,arms,125,62,63
52532,Nassir,stormscale,1756,warrior,arms,96,47,49
52533,Grimlok,sylvanas,1756,warrior,arms,99,44,55
52534,Konebankærn,ravencrest,1756,warrior,arms,60,24,36
52535,Allthèwayup,kazzak,1755,warrior,arms,35,19,16
52536,Nonow,silvermoon,1755,warrior,arms,48,24,24
52537,Yellowjuice,stormscale,1754,warrior,arms,144,85,59
52538,Warounet,hyjal,1753,warrior,arms,54,26,28
52539,Cleaver,tarren-mill,1752,warrior,arms,54,29,25
52540,Asenine,sylvanas,1752,warrior,arms,391,195,196
52541,Pathocend,kazzak,1752,warrior,arms,59,29,30
52542,Ущипнузатитю,deathguard,1752,warrior,arms,66,29,37
52543,Yosiwa,draenor,1751,warrior,arms,78,45,33
52544,Хенеар,howling-fjord,1751,warrior,arms,62,30,32
52545,Trôth,kazzak,1750,warrior,arms,36,23,13
52546,Skylåw,archimonde,1750,warrior,arms,109,52,57
52547,Pj,sanguino,1750,warrior,arms,68,30,38
52548,Роули,blackscar,1747,warrior,arms,81,46,35
52549,Everdipper,outland,1742,warrior,arms,70,31,39
52550,Lanstus,silvermoon,1740,warrior,arms,102,54,48
52551,Blademir,blackrock,1739,warrior,arms,41,26,15
52552,Mojotsche,taerar,1738,warrior,arms,64,36,28
52553,Hulkensmash,kazzak,1738,warrior,arms,175,87,88
52554,Cesr,bloodhoof,1738,warrior,arms,106,47,59
52555,Klynd,nemesis,1738,warrior,arms,54,22,32
52556,Cisataker,hyjal,1737,warrior,arms,24,20,4
52557,Rageco,ravencrest,1737,warrior,arms,48,31,17
52558,Raidek,dragonmaw,1737,warrior,arms,82,46,36
52559,Ðezia,tarren-mill,1737,warrior,arms,144,79,65
52560,Даскул,gordunni,1737,warrior,arms,66,28,38
52561,Augustus,runetotem,1736,warrior,arms,138,76,62
52562,Chargeyou,ragnaros,1734,warrior,arms,48,28,20
52563,Dragondeznut,ravencrest,1734,warrior,arms,54,26,28
52564,Oktharu,silvermoon,1734,warrior,arms,48,23,25
52565,Wrecktal,eredar,1733,warrior,arms,54,32,22
52566,Pazùzu,twisting-nether,1733,warrior,arms,60,27,33
52567,Bôlufonâ,dun-modr,1732,warrior,arms,101,52,49
52568,ßloodz,hyjal,1732,warrior,arms,102,51,51
52569,Bigboomer,frostmane,1732,warrior,arms,192,86,106
52570,Wake,eredar,1731,warrior,arms,42,23,19
52571,Magnî,auchindoun,1731,warrior,arms,54,29,25
52572,Døkidøki,silvermoon,1731,warrior,arms,80,40,40
52573,Fruiittyy,ravencrest,1730,warrior,arms,114,58,56
52574,Ezøn,aegwynn,1730,warrior,arms,65,32,33
52575,Маклецкий,gordunni,1730,warrior,arms,150,68,82
52576,Kelhim,blackrock,1728,warrior,arms,108,57,51
52577,Reccey,blackrock,1728,warrior,arms,140,69,71
52578,Thafold,eredar,1727,warrior,arms,36,19,17
52579,Vathaleron,alakir,1727,warrior,arms,63,33,30
52580,Zhangbeihai,ravencrest,1726,warrior,arms,132,65,67
52581,Oluwafunmila,tarren-mill,1726,warrior,arms,68,33,35
52582,Штурмгешутц,deathweaver,1723,warrior,arms,138,76,62
52583,Brunodressed,aegwynn,1723,warrior,arms,60,31,29
52584,Fosler,frostmane,1723,warrior,arms,48,22,26
52585,Oplarxigos,kazzak,1723,warrior,arms,48,20,28
52586,Dannyp,twisting-nether,1722,warrior,arms,36,18,18
52587,Shchoor,ravencrest,1722,warrior,arms,36,18,18
52588,Bigdamtosco,ravencrest,1721,warrior,arms,30,18,12
52589,Rexonawarr,kazzak,1720,warrior,arms,30,18,12
52590,Naskwar,archimonde,1720,warrior,arms,48,24,24
52591,Skädy,dun-modr,1720,warrior,arms,60,29,31
52592,Fantasý,burning-legion,1720,warrior,arms,71,28,43
52593,Bordi,nemesis,1719,warrior,arms,235,110,125
52594,Mortalfist,stormscale,1718,warrior,arms,67,33,34
52595,Urasli,doomhammer,1717,warrior,arms,42,24,18
52596,Getsmokedjr,ravencrest,1717,warrior,arms,44,22,22
52597,Барсток,soulflayer,1716,warrior,arms,107,53,54
52598,Криккс,greymane,1714,warrior,arms,45,25,20
52599,Виттурус,howling-fjord,1714,warrior,arms,48,25,23
52600,Apacho,outland,1714,warrior,arms,42,21,21
52601,Malebolia,mugthol,1713,warrior,arms,247,128,119
52602,Cazaril,kazzak,1712,warrior,arms,166,84,82
52603,Ogurok,frostwolf,1712,warrior,arms,63,29,34
52604,Badgenius,nemesis,1711,warrior,arms,24,18,6
52605,Maldark,scarshield-legion,1711,warrior,arms,141,68,73
52606,Quetrax,chogall,1711,warrior,arms,60,22,38
52607,Dógmòdex,stormscale,1710,warrior,arms,48,30,18
52608,Mertik,twisting-nether,1710,warrior,arms,48,28,20
52609,Mintys,sylvanas,1710,warrior,arms,62,33,29
52610,Fulgrimu,archimonde,1710,warrior,arms,45,23,22
52611,Brizeis,malganis,1710,warrior,arms,145,74,71
52612,Palmsweaty,stormrage,1710,warrior,arms,72,31,41
52613,Karuck,tarren-mill,1709,warrior,arms,30,19,11
52614,Raikaz,ravencrest,1709,warrior,arms,72,32,40
52615,Фктпх,blackscar,1708,warrior,arms,48,29,19
52616,Karkatoes,twisting-nether,1708,warrior,arms,50,26,24
52617,Saetásh,argent-dawn,1708,warrior,arms,72,34,38
52618,Ðöç,argent-dawn,1708,warrior,arms,42,18,24
52619,Anthalar,argent-dawn,1707,warrior,arms,108,53,55
52620,Avalinqt,blackrock,1706,warrior,arms,44,32,12
52621,Goorila,kazzak,1706,warrior,arms,36,18,18
52622,Кхаррнн,gordunni,1705,warrior,arms,99,49,50
52623,Креспекс,soulflayer,1705,warrior,arms,91,36,55
52624,Poolboyx,tarren-mill,1704,warrior,arms,123,63,60
52625,Вандэрбой,howling-fjord,1703,warrior,arms,222,103,119
52626,Feckdech,blackrock,1702,warrior,arms,36,22,14
52627,Thebigshow,the-maelstrom,1702,warrior,arms,94,41,53
52628,Corvy,ravencrest,1702,warrior,arms,42,18,24
52629,Киссмиплис,gordunni,1701,warrior,arms,117,61,56
52630,Туранк,howling-fjord,1701,warrior,arms,181,93,88
52631,Хеликат,soulflayer,1701,warrior,arms,60,27,33
52632,Louana,outland,1700,warrior,arms,24,18,6
52633,Robou,hyjal,1700,warrior,arms,186,86,100
52634,Klonyarika,ravencrest,1699,warrior,arms,36,20,16
52635,Гримг,lich-king,1699,warrior,arms,69,37,32
52636,Oldcockball,argent-dawn,1699,warrior,arms,89,47,42
52637,Aemox,silvermoon,1697,warrior,arms,77,43,34
52638,Luphrek,ysondre,1697,warrior,arms,36,20,16
52639,Nerfmyrage,hyjal,1697,warrior,arms,96,49,47
52640,Ахиллслэм,howling-fjord,1697,warrior,arms,83,35,48
52641,Lexiliuz,twisting-nether,1696,warrior,arms,36,22,14
52642,Incendix,stormscale,1696,warrior,arms,99,56,43
52643,Shiqo,ravencrest,1696,warrior,arms,109,54,55
52644,Ijzerekast,sylvanas,1696,warrior,arms,67,31,36
52645,Veav,norgannon,1696,warrior,arms,60,25,35
52646,Shaked,dun-modr,1696,warrior,arms,47,19,28
52647,Трешконтент,gordunni,1695,warrior,arms,102,54,48
52648,Sepuko,stormscale,1695,warrior,arms,78,41,37
52649,Reìvah,silvermoon,1695,warrior,arms,63,32,31
52650,Secondwarri,frostwolf,1694,warrior,arms,66,37,29
52651,Sorkk,kazzak,1694,warrior,arms,86,47,39
52652,Noxeeql,tarren-mill,1693,warrior,arms,113,67,46
52653,Kalacher,draenor,1693,warrior,arms,68,30,38
52654,Donquiexote,ravencrest,1692,warrior,arms,90,49,41
52655,Брок,soulflayer,1692,warrior,arms,96,39,57
52656,Snðw,outland,1692,warrior,arms,73,29,44
52657,Odenscolddry,kazzak,1691,warrior,arms,173,87,86
52658,Дайбайхенд,howling-fjord,1691,warrior,arms,60,30,30
52659,Zexa,tarren-mill,1690,warrior,arms,42,21,21
52660,Mazaharine,archimonde,1690,warrior,arms,69,33,36
52661,Vayné,ravencrest,1690,warrior,arms,78,35,43
52662,Randomdmg,stormscale,1689,warrior,arms,24,18,6
52663,Slowann,argent-dawn,1689,warrior,arms,102,51,51
52664,Cassândrä,dalaran,1689,warrior,arms,66,28,38
52665,Hangart,argent-dawn,1687,warrior,arms,48,20,28
52666,Preliator,outland,1686,warrior,arms,24,18,6
52667,Вокилог,soulflayer,1686,warrior,arms,559,276,283
52668,Æç,argent-dawn,1686,warrior,arms,72,35,37
52669,Spártacus,kazzak,1686,warrior,arms,88,40,48
52670,Xgs,archimonde,1685,warrior,arms,279,142,137
52671,Rolo,antonidas,1684,warrior,arms,69,35,34
52672,Makgorei,outland,1684,warrior,arms,129,64,65
52673,Nozuki,archimonde,1684,warrior,arms,243,120,123
52674,Азктор,soulflayer,1683,warrior,arms,34,19,15
52675,Nargez,outland,1682,warrior,arms,36,22,14
52676,Rbbx,tarren-mill,1682,warrior,arms,44,24,20
52677,Huyer,stormscale,1682,warrior,arms,36,18,18
52678,Shooky,blackrock,1681,warrior,arms,41,22,19
52679,Tyrasîà,hyjal,1680,warrior,arms,54,24,30
52680,Kronmw,dun-modr,1680,warrior,arms,54,20,34
52681,Blackbiird,blackmoore,1679,warrior,arms,53,27,26
52682,Zoefernandes,kazzak,1679,warrior,arms,66,28,38
52683,Ридиусх,gordunni,1678,warrior,arms,43,24,19
52684,Воованыч,gordunni,1678,warrior,arms,48,22,26
52685,Bronn,defias-brotherhood,1676,warrior,arms,51,31,20
52686,Сажень,blackscar,1675,warrior,arms,74,34,40
52687,Krigipigi,antonidas,1675,warrior,arms,78,34,44
52688,Yandan,ysondre,1674,warrior,arms,48,24,24
52689,Planina,ravencrest,1673,warrior,arms,77,38,39
52690,Woobaby,outland,1672,warrior,arms,54,30,24
52691,Gatts,krasus,1671,warrior,arms,282,134,148
52692,Amokdamis,blackhand,1671,warrior,arms,51,23,28
52693,Nîmera,nemesis,1670,warrior,arms,24,19,5
52694,Бисовыйармен,soulflayer,1670,warrior,arms,42,23,19
52695,Lîlsaint,dun-morogh,1670,warrior,arms,36,19,17
52696,Chromoly,aegwynn,1670,warrior,arms,90,43,47
52697,Лилиофанныч,soulflayer,1670,warrior,arms,66,25,41
52698,Dríx,hyjal,1669,warrior,arms,66,34,32
52699,Riyan,lothar,1668,warrior,arms,48,28,20
52700,Shhimbanned,doomhammer,1668,warrior,arms,85,43,42
52701,Nikoma,silvermoon,1667,warrior,arms,36,20,16
52702,Дугмар,gordunni,1667,warrior,arms,205,102,103
52703,Bruxus,blackhand,1665,warrior,arms,208,108,100
52704,Геркавоин,eversong,1665,warrior,arms,96,45,51
52705,Krionos,ravencrest,1665,warrior,arms,66,30,36
52706,Иктиннос,gordunni,1664,warrior,arms,78,41,37
52707,Cyruk,blackmoore,1664,warrior,arms,147,75,72
52708,Ignyz,stormscale,1663,warrior,arms,48,27,21
52709,Learningwarr,eredar,1663,warrior,arms,50,26,24
52710,Màkáveli,stormscale,1662,warrior,arms,83,46,37
52711,Kotechnik,ysondre,1661,warrior,arms,42,25,17
52712,Bronix,blackrock,1661,warrior,arms,100,52,48
52713,Дроктул,howling-fjord,1661,warrior,arms,340,169,171
52714,Arms,earthen-ring,1661,warrior,arms,86,41,45
52715,Jaythegodx,blackrock,1661,warrior,arms,60,22,38
52716,Reapersrage,twisting-nether,1660,warrior,arms,45,22,23
52717,Huscar,thrall,1659,warrior,arms,58,31,27
52718,Erikeverhard,nathrezim,1659,warrior,arms,42,20,22
52719,Xendyo,frostmourne,1659,warrior,arms,125,58,67
52720,Velgrim,ravencrest,1659,warrior,arms,54,25,29
52721,Nalx,tarren-mill,1658,warrior,arms,87,47,40
52722,Bastrick,argent-dawn,1658,warrior,arms,116,62,54
52723,Zugstorm,outland,1658,warrior,arms,46,23,23
52724,Cyanerd,bronzebeard,1658,warrior,arms,42,21,21
52725,Béastmødexz,eredar,1657,warrior,arms,53,25,28
52726,Кибервайфу,howling-fjord,1656,warrior,arms,36,22,14
52727,Crandalius,kazzak,1656,warrior,arms,87,51,36
52728,Mazutov,outland,1655,warrior,arms,36,25,11
52729,Wasdwarr,aegwynn,1655,warrior,arms,50,31,19
52730,Asquare,stormscale,1655,warrior,arms,40,18,22
52731,Луновоин,gordunni,1654,warrior,arms,54,35,19
52732,Facestomper,onyxia,1654,warrior,arms,78,44,34
52733,Шагах,soulflayer,1654,warrior,arms,164,81,83
52734,Skillissues,argent-dawn,1653,warrior,arms,48,26,22
52735,Vôx,sylvanas,1653,warrior,arms,120,55,65
52736,Dragnil,twisting-nether,1653,warrior,arms,48,22,26
52737,Romanul,terokkar,1652,warrior,arms,114,61,53
52738,Зотлолпромвп,booty-bay,1652,warrior,arms,47,21,26
52739,Prestà,archimonde,1651,warrior,arms,75,41,34
52740,Linkx,lightnings-blade,1651,warrior,arms,36,19,17
52741,Донтрелиз,howling-fjord,1651,warrior,arms,64,30,34
52742,Chádtóurps,drakthul,1651,warrior,arms,41,19,22
52743,Rhinobob,kazzak,1651,warrior,arms,50,22,28
52744,Anakhas,archimonde,1651,warrior,arms,48,21,27
52745,Hli,tarren-mill,1650,warrior,arms,42,24,18
52746,Skrawarr,das-syndikat,1650,warrior,arms,156,82,74
52747,Sørêy,aegwynn,1650,warrior,arms,78,39,39
52748,Smkms,kazzak,1649,warrior,arms,54,26,28
52749,Asç,kazzak,1647,warrior,arms,42,21,21
52750,Blizo,tarren-mill,1646,warrior,arms,42,21,21
52751,Nardoch,archimonde,1646,warrior,arms,162,80,82
52752,Martins,doomhammer,1644,warrior,arms,50,28,22
52753,Fruitdealer,shattrath,1644,warrior,arms,70,30,40
52754,Morbaac,archimonde,1644,warrior,arms,54,22,32
52755,Нифро,fordragon,1643,warrior,arms,48,29,19
52756,Doksziqqt,ragnaros,1642,warrior,arms,36,22,14
52757,Ckz,ysondre,1641,warrior,arms,36,26,10
52758,Remen,archimonde,1641,warrior,arms,84,37,47
52759,Bîmbämboom,blackmoore,1640,warrior,arms,106,67,39
52760,Diamonddogs,draenor,1640,warrior,arms,52,32,20
52761,Renwíck,burning-legion,1639,warrior,arms,35,18,17
52762,Bamme,archimonde,1639,warrior,arms,47,24,23
52763,Фенилэфрин,gordunni,1639,warrior,arms,140,71,69
52764,Voxz,stormscale,1639,warrior,arms,195,93,102
52765,Paranoiás,ragnaros,1639,warrior,arms,50,22,28
52766,Ironbutter,ravencrest,1638,warrior,arms,80,51,29
52767,Samîr,arthas,1638,warrior,arms,36,21,15
52768,Sonnethrash,tarren-mill,1638,warrior,arms,49,22,27
52769,Витодпс,howling-fjord,1638,warrior,arms,54,24,30
52770,Sefty,tarren-mill,1638,warrior,arms,46,18,28
52771,Pachipachi,blackmoore,1637,warrior,arms,44,23,21
52772,Babovic,aegwynn,1636,warrior,arms,42,29,13
52773,Lizzybigtits,kazzak,1636,warrior,arms,60,40,20
52774,Jøtawarrior,sanguino,1636,warrior,arms,48,27,21
52775,Blackfrosty,stormscale,1636,warrior,arms,74,41,33
52776,Hatestørm,kazzak,1636,warrior,arms,42,22,20
52777,Garthock,stormscale,1636,warrior,arms,42,20,22
52778,Ítikovan,aegwynn,1636,warrior,arms,156,73,83
52779,Тролльвоен,gordunni,1635,warrior,arms,51,31,20
52780,Sydian,burning-legion,1635,warrior,arms,36,21,15
52781,Ryofu,stormscale,1635,warrior,arms,42,22,20
52782,Омепразол,gordunni,1635,warrior,arms,250,125,125
52783,Килафх,blackscar,1635,warrior,arms,84,41,43
52784,Off,archimonde,1634,warrior,arms,30,18,12
52785,Олдизаер,soulflayer,1634,warrior,arms,42,23,19
52786,Meistersykes,silvermoon,1634,warrior,arms,44,21,23
52787,Fattysw,argent-dawn,1634,warrior,arms,61,29,32
52788,Старварлорд,soulflayer,1634,warrior,arms,41,18,23
52789,Nazhar,kult-der-verdammten,1633,warrior,arms,54,27,27
52790,Lyroe,blackrock,1633,warrior,arms,42,21,21
52791,Capigo,tarren-mill,1632,warrior,arms,30,19,11
52792,Atlizz,twisting-nether,1632,warrior,arms,90,47,43
52793,Psychlolz,burning-legion,1632,warrior,arms,48,24,24
52794,Reapo,blackhand,1632,warrior,arms,137,67,70
52795,Yaune,ravencrest,1632,warrior,arms,42,19,23
52796,Orn,tarren-mill,1632,warrior,arms,54,24,30
52797,Zijsûû,chogall,1632,warrior,arms,55,23,32
52798,Zëhef,hyjal,1631,warrior,arms,108,59,49
52799,Bélløne,dalaran,1631,warrior,arms,96,46,50
52800,Naait,draenor,1630,warrior,arms,51,28,23
52801,Çon,ravencrest,1630,warrior,arms,121,63,58
52802,Acaleus,the-maelstrom,1630,warrior,arms,66,31,35
52803,Aestheticon,burning-blade,1629,warrior,arms,36,21,15
52804,Furanos,blackrock,1629,warrior,arms,65,34,31
52805,Estarotte,ravencrest,1629,warrior,arms,37,19,18
52806,Puremëtal,silvermoon,1629,warrior,arms,54,25,29
52807,Wismerx,kazzak,1629,warrior,arms,48,21,27
52808,Darksídex,silvermoon,1628,warrior,arms,339,176,163
52809,Watashilfy,ravencrest,1628,warrior,arms,72,36,36
52810,Thrux,dalaran,1628,warrior,arms,119,59,60
52811,Кимлий,deathweaver,1628,warrior,arms,36,17,19
52812,Mellîødas,blackmoore,1627,warrior,arms,48,27,21
52813,Gonutz,sylvanas,1627,warrior,arms,36,20,16
52814,Belattor,silvermoon,1627,warrior,arms,36,17,19
52815,Iameconomist,twisting-nether,1627,warrior,arms,36,17,19
52816,Klinga,bladefist,1626,warrior,arms,42,24,18
52817,Trust,darksorrow,1626,warrior,arms,54,30,24
52818,Xzm,stormscale,1626,warrior,arms,33,18,15
52819,Chadsmorc,twisting-nether,1626,warrior,arms,149,78,71
52820,Agoobagoo,alakir,1626,warrior,arms,41,20,21
52821,Ebonheart,argent-dawn,1626,warrior,arms,104,50,54
52822,Rootmagnet,twisting-nether,1625,warrior,arms,30,20,10
52823,Asipositas,eredar,1625,warrior,arms,42,19,23
52824,Beevzyn,blackmoore,1624,warrior,arms,24,17,7
52825,Zufzuf,twisting-nether,1624,warrior,arms,36,22,14
52826,Xiiver,burning-legion,1624,warrior,arms,131,71,60
52827,Wlãð,archimonde,1624,warrior,arms,48,23,25
52828,Frozenliøn,twisting-nether,1624,warrior,arms,42,19,23
52829,Xurainlol,eredar,1623,warrior,arms,30,17,13
52830,Жестокус,gordunni,1623,warrior,arms,42,22,20
52831,Lusan,sylvanas,1623,warrior,arms,42,21,21
52832,Айфилшок,gordunni,1623,warrior,arms,42,20,22
52833,Høtsky,twisting-nether,1622,warrior,arms,30,18,12
52834,Nstx,dun-modr,1622,warrior,arms,30,17,13
52835,Methodxd,outland,1622,warrior,arms,72,36,36
52836,Letmeteachya,kazzak,1622,warrior,arms,72,36,36
52837,Basemode,twisting-nether,1622,warrior,arms,58,29,29
52838,Фурианка,galakrond,1622,warrior,arms,63,31,32
52839,Spartaz,eredar,1622,warrior,arms,66,30,36
52840,Salpaaja,frostwhisper,1622,warrior,arms,42,17,25
52841,Solaje,dun-modr,1621,warrior,arms,39,22,17
52842,Kût,les-sentinelles,1621,warrior,arms,41,22,19
52843,Оргрриммар,soulflayer,1621,warrior,arms,339,169,170
52844,Blayr,tarren-mill,1621,warrior,arms,122,58,64
52845,Wigsplitterx,twisting-nether,1620,warrior,arms,150,70,80
52846,Rumer,tarren-mill,1620,warrior,arms,83,38,45
52847,Takatoa,argent-dawn,1620,warrior,arms,48,21,27
52848,Scherø,aegwynn,1619,warrior,arms,24,17,7
52849,Nyxz,blackhand,1619,warrior,arms,77,39,38
52850,Sickslamzyø,ravencrest,1619,warrior,arms,42,17,25
52851,Mxrdvr,kazzak,1618,warrior,arms,54,35,19
52852,Hasmocaru,silvermoon,1618,warrior,arms,66,33,33
52853,Белхэнд,soulflayer,1618,warrior,arms,169,80,89
52854,Bj,blackrock,1617,warrior,arms,36,21,15
52855,Thundranium,kazzak,1616,warrior,arms,37,22,15
52856,Liper,silvermoon,1616,warrior,arms,103,56,47
52857,Shavoi,die-aldor,1616,warrior,arms,47,21,26
52858,Borthuk,tarren-mill,1616,warrior,arms,107,45,62
52859,Khireebonk,hyjal,1615,warrior,arms,36,24,12
52860,Рекиро,blackscar,1615,warrior,arms,40,21,19
52861,Gladius,ysera,1615,warrior,arms,86,43,43
52862,Manoito,argent-dawn,1615,warrior,arms,48,22,26
52863,Lyarinsky,tyrande,1614,warrior,arms,96,58,38
52864,Daigoro,ravencrest,1614,warrior,arms,30,17,13
52865,Untiltèd,ravencrest,1613,warrior,arms,89,60,29
52866,Extazsion,stormscale,1613,warrior,arms,35,20,15
52867,Фелпир,soulflayer,1613,warrior,arms,179,95,84
52868,Hamez,thunderhorn,1613,warrior,arms,70,34,36
52869,Kwaiha,kazzak,1613,warrior,arms,80,37,43
52870,Vandarms,archimonde,1612,warrior,arms,36,18,18
52871,Maikouyes,archimonde,1612,warrior,arms,125,62,63
52872,Pyrul,antonidas,1612,warrior,arms,42,18,24
52873,Termonsa,stormscale,1611,warrior,arms,42,25,17
52874,Ïnahö,hyjal,1611,warrior,arms,36,19,17
52875,Surthur,magtheridon,1611,warrior,arms,48,24,24
52876,Lockmagewar,burning-legion,1611,warrior,arms,45,22,23
52877,Cráft,silvermoon,1611,warrior,arms,48,23,25
52878,Куэсес,howling-fjord,1610,warrior,arms,39,19,20
52879,Strife,ravencrest,1609,warrior,arms,81,51,30
52880,Ranoth,hellfire,1609,warrior,arms,30,17,13
52881,Enzja,nazjatar,1609,warrior,arms,54,25,29
52882,Biscuitoliva,hyjal,1608,warrior,arms,31,17,14
52883,Whoosah,ragnaros,1608,warrior,arms,105,54,51
52884,Guts,frostwhisper,1608,warrior,arms,173,83,90
52885,Caméltoe,frostwolf,1608,warrior,arms,143,67,76
52886,Sjozug,tarren-mill,1608,warrior,arms,42,17,25
52887,Кофесмолоком,ashenvale,1608,warrior,arms,53,20,33
52888,Diz,terokkar,1607,warrior,arms,103,64,39
52889,Únkqt,dalaran,1607,warrior,arms,63,35,28
52890,Bursch,ravencrest,1607,warrior,arms,137,69,68
52891,Хоркан,blackscar,1607,warrior,arms,60,30,30
52892,Jambaz,ravencrest,1607,warrior,arms,47,23,24
52893,Krew,drakthul,1607,warrior,arms,78,38,40
52894,Bigdstance,outland,1607,warrior,arms,72,33,39
52895,Убитаякорова,soulflayer,1606,warrior,arms,36,20,16
52896,Oppressíon,silvermoon,1606,warrior,arms,46,22,24
52897,Golmmash,draenor,1606,warrior,arms,64,25,39
52898,Orcassmus,blackrock,1605,warrior,arms,36,23,13
52899,Nameless,ysondre,1605,warrior,arms,72,41,31
52900,Unbrauchbar,silvermoon,1605,warrior,arms,94,53,41
52901,Напутанность,soulflayer,1605,warrior,arms,371,194,177
52902,Haraldjuhnke,frostwolf,1605,warrior,arms,53,27,26
52903,Giannizugzug,nemesis,1605,warrior,arms,129,65,64
52904,Arnoldr,ysondre,1605,warrior,arms,48,24,24
52905,Nakro,hyjal,1604,warrior,arms,30,21,9
52906,Ayraw,eredar,1604,warrior,arms,36,20,16
52907,Ronoh,kazzak,1604,warrior,arms,42,23,19
52908,Jakim,tarren-mill,1604,warrior,arms,154,77,77
52909,Lazytowl,outland,1604,warrior,arms,130,65,65
52910,Exoblade,silvermoon,1604,warrior,arms,76,35,41
52911,Bloodx,archimonde,1603,warrior,arms,36,20,16
52912,Màb,antonidas,1603,warrior,arms,72,38,34
52913,Андреевич,blackscar,1603,warrior,arms,146,74,72
52914,Седлайккеану,howling-fjord,1603,warrior,arms,87,44,43
52915,Атаир,deathweaver,1603,warrior,arms,64,32,32
52916,Mypzo,kazzak,1603,warrior,arms,90,44,46
52917,Buckiesøde,twisting-nether,1603,warrior,arms,36,17,19
52918,Eskiler,burning-legion,1603,warrior,arms,54,23,31
52919,Deadlyanger,kazzak,1602,warrior,arms,42,24,18
52920,Oweiko,blackrock,1602,warrior,arms,72,39,33
52921,Eselhirte,blackmoore,1602,warrior,arms,85,46,39
52922,Freelongx,stormscale,1602,warrior,arms,42,17,25
52923,Wítts,ravencrest,1601,warrior,arms,30,20,10
52924,Kupr,outland,1601,warrior,arms,40,21,19
52925,Khanox,twisting-nether,1601,warrior,arms,148,74,74
52926,Crystallake,blackrock,1601,warrior,arms,114,52,62
52927,Wtchmyblade,blackmoore,1600,warrior,arms,94,56,38
52928,Sumprunkare,stormscale,1599,warrior,arms,52,29,23
52929,Breaken,silvermoon,1599,warrior,arms,54,30,24
52930,Армсег,soulflayer,1599,warrior,arms,50,26,24
52931,Shadokaa,stormscale,1598,warrior,arms,59,35,24
52932,Вагранна,soulflayer,1597,warrior,arms,54,26,28
52933,Морнстар,gordunni,1597,warrior,arms,115,55,60
52934,Jumpilawl,khaz-modan,1597,warrior,arms,104,46,58
52935,Кладбошаа,gordunni,1596,warrior,arms,138,70,68
52936,Земибор,soulflayer,1596,warrior,arms,48,20,28
52937,Arandyr,archimonde,1596,warrior,arms,60,24,36
52938,Kobeni,ysondre,1595,warrior,arms,85,40,45
52939,Каниме,howling-fjord,1594,warrior,arms,24,18,6
52940,Renbaka,marécage-de-zangar,1594,warrior,arms,30,19,11
52941,Бурчун,deathguard,1594,warrior,arms,54,34,20
52942,Aranill,tarren-mill,1593,warrior,arms,44,22,22
52943,Phóó,thrall,1593,warrior,arms,72,32,40
52944,Gargaflike,aggra-português,1593,warrior,arms,72,30,42
52945,Haanok,ravencrest,1591,warrior,arms,59,34,25
52946,Capitalista,das-konsortium,1591,warrior,arms,42,20,22
52947,Troma,archimonde,1591,warrior,arms,53,22,31
52948,Neoballac,uldum,1590,warrior,arms,54,24,30
52949,Rilor,burning-legion,1589,warrior,arms,124,53,71
52950,Noitoved,outland,1589,warrior,arms,44,18,26
52951,Thundersword,sylvanas,1589,warrior,arms,84,30,54
52952,Balltas,drakthul,1588,warrior,arms,116,54,62
52953,Btr,archimonde,1588,warrior,arms,42,19,23
52954,Gailko,sanguino,1587,warrior,arms,40,18,22
52955,Héda,tarren-mill,1587,warrior,arms,49,22,27
52956,Aeldran,argent-dawn,1586,warrior,arms,48,25,23
52957,Shwreck,kazzak,1586,warrior,arms,50,25,25
52958,Blondboomer,neptulon,1586,warrior,arms,48,21,27
52959,Biggerer,blackrock,1586,warrior,arms,54,23,31
52960,Aizy,blackhand,1585,warrior,arms,36,21,15
52961,Bufdefstance,kazzak,1584,warrior,arms,86,43,43
52962,Bérsérk,blackmoore,1583,warrior,arms,34,20,14
52963,Hortswarr,drakthul,1582,warrior,arms,37,24,13
52964,Fragmeista,ragnaros,1582,warrior,arms,36,17,19
52965,Ragëë,tarren-mill,1581,warrior,arms,78,42,36
52966,Lilgozga,stormscale,1581,warrior,arms,48,20,28
52967,Rogersrage,ragnaros,1580,warrior,arms,72,40,32
52968,Архиватор,gordunni,1580,warrior,arms,114,60,54
52969,Каосвар,howling-fjord,1579,warrior,arms,30,19,11
52970,Solezte,tarren-mill,1579,warrior,arms,102,56,46
52971,Kamilfury,burning-legion,1579,warrior,arms,46,18,28
52972,Cãngo,die-todeskrallen,1578,warrior,arms,42,26,16
52973,Grántor,eredar,1578,warrior,arms,60,34,26
52974,Mävïs,ravencrest,1578,warrior,arms,78,42,36
52975,Tiwâz,eredar,1578,warrior,arms,93,50,43
52976,Денеур,gordunni,1577,warrior,arms,128,52,76
52977,Sýkz,exodar,1577,warrior,arms,53,19,34
52978,Vullgrîm,blackmoore,1576,warrior,arms,102,51,51
52979,Taistelumage,stormreaver,1576,warrior,arms,35,17,18
52980,Furukawa,ravencrest,1575,warrior,arms,51,24,27
52981,Oxay,alakir,1575,warrior,arms,70,30,40
52982,Erotixboi,blackrock,1573,warrior,arms,48,29,19
52983,Оргнар,ashenvale,1573,warrior,arms,48,27,21
52984,Lpa,stormscale,1573,warrior,arms,71,37,34
52985,Batïk,blackmoore,1573,warrior,arms,83,36,47
52986,Endeawour,ravencrest,1572,warrior,arms,201,114,87
52987,Jailapatate,khaz-modan,1572,warrior,arms,36,20,16
52988,Анакронокс,howling-fjord,1572,warrior,arms,38,20,18
52989,Reider,twisting-nether,1571,warrior,arms,149,63,86
52990,Monbun,silvermoon,1570,warrior,arms,101,51,50
52991,Мастерион,soulflayer,1570,warrior,arms,78,38,40
52992,Lewh,blackmoore,1570,warrior,arms,67,32,35
52993,Natis,drakthul,1570,warrior,arms,78,28,50
52994,Celphboss,tarren-mill,1569,warrior,arms,63,36,27
52995,Rîdler,ravencrest,1569,warrior,arms,193,97,96
52996,Xanco,ravencrest,1569,warrior,arms,54,26,28
52997,Devidz,outland,1569,warrior,arms,48,18,30
52998,Skorz,kazzak,1568,warrior,arms,42,20,22
52999,Zaedt,tarren-mill,1568,warrior,arms,41,19,22
53000,Ganzaésábi,aggra-português,1567,warrior,arms,108,57,51
53001,Zeepp,ravencrest,1567,warrior,arms,60,25,35
53002,Pra,antonidas,1566,warrior,arms,60,38,22
53003,Gely,silvermoon,1566,warrior,arms,119,59,60
53004,Гуорг,howling-fjord,1566,warrior,arms,87,39,48
53005,Дейдулус,soulflayer,1566,warrior,arms,78,33,45
53006,Serastul,rajaxx,1565,warrior,arms,86,42,44
53007,Ansi,argent-dawn,1565,warrior,arms,60,28,32
53008,Giganza,outland,1565,warrior,arms,66,29,37
53009,Едигейй,gordunni,1564,warrior,arms,58,32,26
53010,Ajax,defias-brotherhood,1564,warrior,arms,95,46,49
53011,Abrash,ysondre,1564,warrior,arms,78,36,42
53012,Ssnakeess,silvermoon,1563,warrior,arms,54,32,22
53013,Sobii,ravencrest,1563,warrior,arms,53,28,25
53014,Evrybodydown,draenor,1563,warrior,arms,172,87,85
53015,Tarkosha,terokkar,1563,warrior,arms,502,253,249
53016,Gaisorg,die-aldor,1562,warrior,arms,31,20,11
53017,Stepa,sylvanas,1562,warrior,arms,54,28,26
53018,Lyes,uldaman,1562,warrior,arms,256,127,129
53019,Eggsecutor,stormscale,1562,warrior,arms,47,22,25
53020,Cleopatra,frostwhisper,1561,warrior,arms,36,22,14
53021,Pepegle,argent-dawn,1561,warrior,arms,54,31,23
53022,Rongh,saurfang,1561,warrior,arms,36,17,19
53023,Néxtlølz,twisting-nether,1561,warrior,arms,62,29,33
53024,Айсиёу,howling-fjord,1561,warrior,arms,50,21,29
53025,Daýz,draenor,1561,warrior,arms,48,18,30
53026,Greenpanzer,archimonde,1560,warrior,arms,51,28,23
53027,Krîspie,archimonde,1560,warrior,arms,71,38,33
53028,Miz,dun-modr,1560,warrior,arms,33,17,16
53029,Протектор,soulflayer,1560,warrior,arms,60,29,31
53030,Хэлслэйтэр,gordunni,1559,warrior,arms,130,65,65
53031,Арткес,gordunni,1558,warrior,arms,176,91,85
53032,Malgár,argent-dawn,1558,warrior,arms,59,30,29
53033,Imfiñe,outland,1558,warrior,arms,107,51,56
53034,Vizn,emerald-dream,1558,warrior,arms,47,17,30
53035,Тише,deathweaver,1557,warrior,arms,60,29,31
53036,Corlo,uldaman,1557,warrior,arms,92,40,52
53037,Spijkerbroek,alakir,1555,warrior,arms,287,146,141
53038,Люцц,gordunni,1555,warrior,arms,176,85,91
53039,Phovoss,stormscale,1555,warrior,arms,72,31,41
53040,Gravityfalls,blackmoore,1554,warrior,arms,84,43,41
53041,Nyokosuzi,grim-batol,1554,warrior,arms,60,28,32
53042,Mélindà,silvermoon,1553,warrior,arms,63,38,25
53043,Xecutie,antonidas,1553,warrior,arms,77,40,37
53044,Cirenax,draenor,1551,warrior,arms,48,23,25
53045,Skokuxx,silvermoon,1551,warrior,arms,90,41,49
53046,Shirøx,blackrock,1550,warrior,arms,78,42,36
53047,Kfc,chamber-of-aspects,1549,warrior,arms,30,17,13
53048,Philatou,antonidas,1549,warrior,arms,53,29,24
53049,Wanzzeur,hyjal,1549,warrior,arms,91,47,44
53050,Wazraf,khaz-modan,1549,warrior,arms,144,73,71
53051,Jake,rajaxx,1549,warrior,arms,42,18,24
53052,Genjutsubeat,blackmoore,1548,warrior,arms,54,31,23
53053,Arcreign,kazzak,1547,warrior,arms,96,47,49
53054,Conanh,pozzo-delleternità,1546,warrior,arms,140,75,65
53055,Trenôdeca,stormscale,1546,warrior,arms,48,23,25
53056,Alexandrrior,rexxar,1546,warrior,arms,114,53,61
53057,Herigan,burning-legion,1546,warrior,arms,45,20,25
53058,Sahl,sylvanas,1545,warrior,arms,172,85,87
53059,Morthôr,grim-batol,1545,warrior,arms,69,34,35
53060,Maniackz,tarren-mill,1544,warrior,arms,36,19,17
53061,Massiveape,argent-dawn,1544,warrior,arms,69,35,34
53062,Мираксус,soulflayer,1544,warrior,arms,36,18,18
53063,Warmâchine,burning-legion,1544,warrior,arms,207,95,112
53064,Huullkk,nazjatar,1543,warrior,arms,60,28,32
53065,Lücifer,dun-modr,1542,warrior,arms,48,34,14
53066,Cryhoof,ragnaros,1542,warrior,arms,106,54,52
53067,Fatmikez,aggra-português,1541,warrior,arms,48,26,22
53068,Малаятварь,gordunni,1541,warrior,arms,34,17,17
53069,Wrynir,archimonde,1541,warrior,arms,78,38,40
53070,Dragoons,tyrande,1541,warrior,arms,68,30,38
53071,Rakuna,tarren-mill,1540,warrior,arms,114,55,59
53072,Jeonsoyeon,argent-dawn,1540,warrior,arms,36,17,19
53073,Ayasana,argent-dawn,1539,warrior,arms,30,18,12
53074,Kleidaria,stormscale,1539,warrior,arms,36,19,17
53075,Crissx,silvermoon,1538,warrior,arms,127,66,61
53076,Farrusco,nemesis,1538,warrior,arms,107,55,52
53077,ßamßam,draenor,1538,warrior,arms,58,29,29
53078,Riann,silvermoon,1538,warrior,arms,42,20,22
53079,Alexamazing,lordaeron,1538,warrior,arms,79,37,42
53080,Boldinq,ravencrest,1538,warrior,arms,117,51,66
53081,Zhulgar,azjolnerub,1537,warrior,arms,60,32,28
53082,Stancenation,draenor,1537,warrior,arms,70,31,39
53083,Èzekiel,dalaran,1536,warrior,arms,90,46,44
53084,Armsbull,twisting-nether,1536,warrior,arms,66,32,34
53085,Gantsrip,stormscale,1536,warrior,arms,46,22,24
53086,Billorc,twisting-nether,1536,warrior,arms,75,35,40
53087,Bstgame,frostmane,1535,warrior,arms,36,17,19
53088,Hobo,ravencrest,1535,warrior,arms,71,32,39
53089,Luffydono,stormscale,1535,warrior,arms,66,28,38
53090,Zyzy,arathor,1533,warrior,arms,42,23,19
53091,Riptack,anetheron,1533,warrior,arms,160,84,76
53092,Gigasmash,pozzo-delleternità,1533,warrior,arms,144,67,77
53093,Micromachine,argent-dawn,1533,warrior,arms,54,20,34
53094,Hollydeffs,blackmoore,1532,warrior,arms,66,29,37
53095,Тэйкмисофтли,blackscar,1531,warrior,arms,48,26,22
53096,Trashman,bronzebeard,1531,warrior,arms,114,55,59
53097,Rabaozi,blackhand,1530,warrior,arms,95,45,50
53098,Áäáäáäáä,aegwynn,1529,warrior,arms,30,16,14
53099,Toroespaña,draenor,1529,warrior,arms,139,67,72
53100,Громпузан,galakrond,1529,warrior,arms,60,27,33
53101,Proxxyyqt,blackrock,1529,warrior,arms,68,30,38
53102,Bullrug,blackrock,1528,warrior,arms,36,18,18
53103,Vallahan,argent-dawn,1528,warrior,arms,267,131,136
53104,Waf,hakkar,1527,warrior,arms,108,61,47
53105,Leeches,aggramar,1527,warrior,arms,30,16,14
53106,Eren,todeswache,1527,warrior,arms,54,28,26
53107,Mentôr,sargeras,1527,warrior,arms,41,21,20
53108,Nexpwns,blackhand,1527,warrior,arms,153,78,75
53109,Zirêael,kazzak,1527,warrior,arms,42,16,26
53110,Lollydhur,nemesis,1526,warrior,arms,66,34,32
53111,Bumoletroll,draenor,1526,warrior,arms,33,17,16
53112,Grimzot,ragnaros,1525,warrior,arms,60,30,30
53113,Zarakï,zuljin,1525,warrior,arms,60,30,30
53114,Icekissx,hyjal,1524,warrior,arms,135,69,66
53115,Lrb,tarren-mill,1524,warrior,arms,109,52,57
53116,Абырабыр,howling-fjord,1523,warrior,arms,24,16,8
53117,Vilass,silvermoon,1523,warrior,arms,36,19,17
53118,Skullrage,tarren-mill,1523,warrior,arms,53,22,31
53119,Zheq,ragnaros,1522,warrior,arms,30,16,14
53120,Shrekwarr,kazzak,1522,warrior,arms,137,67,70
53121,Stormcoil,stormscale,1521,warrior,arms,47,24,23
53122,Norwegian,silvermoon,1521,warrior,arms,80,37,43
53123,Xorlog,thrall,1520,warrior,arms,41,24,17
53124,Devilpanic,outland,1520,warrior,arms,30,16,14
53125,Gervvand,burning-legion,1519,warrior,arms,48,26,22
53126,Мэйрил,lich-king,1519,warrior,arms,190,99,91
53127,Nighat,sanguino,1519,warrior,arms,162,83,79
53128,Shownomercy,blackrock,1519,warrior,arms,48,23,25
53129,Стенденсх,howling-fjord,1519,warrior,arms,41,19,22
53130,Authar,tarren-mill,1518,warrior,arms,61,33,28
53131,Yukizz,ravencrest,1518,warrior,arms,30,16,14
53132,Адво,gordunni,1517,warrior,arms,96,50,46
53133,Savedsky,zuljin,1517,warrior,arms,48,16,32
53134,Vauster,draenor,1516,warrior,arms,62,35,27
53135,Trilon,blackrock,1516,warrior,arms,50,21,29
53136,Vory,ravencrest,1515,warrior,arms,24,16,8
53137,Spärtan,dun-modr,1515,warrior,arms,66,34,32
53138,Skeletor,draenor,1515,warrior,arms,61,30,31
53139,Gipsyjoe,ragnaros,1515,warrior,arms,82,39,43
53140,Vayndral,kazzak,1514,warrior,arms,78,39,39
53141,Laavapoeg,outland,1514,warrior,arms,48,23,25
53142,Execútioner,sylvanas,1513,warrior,arms,35,19,16
53143,Dárkhammer,tarren-mill,1513,warrior,arms,72,35,37
53144,Heltslut,tarren-mill,1513,warrior,arms,66,26,40
53145,Mezugzugyou,draenor,1512,warrior,arms,44,23,21
53146,Velinde,outland,1512,warrior,arms,46,23,23
53147,Thaldrys,blackhand,1512,warrior,arms,167,81,86
53148,Скрежет,gordunni,1512,warrior,arms,66,32,34
53149,Elder,darkmoon-faire,1512,warrior,arms,137,66,71
53150,Ødên,frostmane,1511,warrior,arms,30,16,14
53151,Duncán,auchindoun,1511,warrior,arms,53,27,26
53152,Ilovealma,kiljaeden,1511,warrior,arms,65,29,36
53153,Scormash,burning-legion,1510,warrior,arms,36,16,20
53154,Mazzkze,silvermoon,1509,warrior,arms,237,122,115
53155,Grumpy,lightbringer,1509,warrior,arms,64,30,34
53156,Tinkaton,sylvanas,1509,warrior,arms,36,16,20
53157,Geforce,hellscream,1508,warrior,arms,178,88,90
53158,Nøsyo,blackrock,1507,warrior,arms,30,18,12
53159,Üs,ravencrest,1507,warrior,arms,65,35,30
53160,Garwarr,twisting-nether,1507,warrior,arms,43,22,21
53161,Kestialezin,archimonde,1506,warrior,arms,72,46,26
53162,Sonìe,kazzak,1506,warrior,arms,89,51,38
53163,Notinfa,draenor,1506,warrior,arms,138,73,65
53164,Bloodbrother,blackmoore,1506,warrior,arms,79,40,39
53165,Zergalot,stormscale,1505,warrior,arms,35,17,18
53166,Otzi,sargeras,1505,warrior,arms,65,24,41
53167,Tweran,drakthul,1504,warrior,arms,30,16,14
53168,Pied,krasus,1504,warrior,arms,36,19,17
53169,Волрок,howling-fjord,1504,warrior,arms,67,34,33
53170,Pptickler,argent-dawn,1504,warrior,arms,83,41,42
53171,Raakalainen,vashj,1504,warrior,arms,59,29,30
53172,Melliug,ysondre,1504,warrior,arms,46,19,27
53173,Savh,silvermoon,1503,warrior,arms,48,28,20
53174,Bävling,kazzak,1503,warrior,arms,37,20,17
53175,Craghak,twisting-nether,1502,warrior,arms,175,88,87
53176,Alyx,mugthol,1501,warrior,arms,104,54,50
53177,Crayz,twisting-nether,1501,warrior,arms,54,26,28
53178,Агрегат,goldrinn,1501,warrior,arms,77,34,43
53179,Räzorleaf,kul-tiras,1500,warrior,arms,96,50,46
53180,Рыгулька,gordunni,1500,warrior,arms,198,96,102
53181,Asuramaru,aegwynn,1499,warrior,arms,89,47,42
53182,Battlemaster,die-aldor,1499,warrior,arms,34,17,17
53183,Грэйм,gordunni,1498,warrior,arms,64,33,31
53184,Tgabor,ragnaros,1498,warrior,arms,35,18,17
53185,Ragnou,tarren-mill,1498,warrior,arms,82,38,44
53186,Crriminal,ravencrest,1498,warrior,arms,48,20,28
53187,Marcnky,stormscale,1497,warrior,arms,145,75,70
53188,Дозен,soulflayer,1496,warrior,arms,46,26,20
53189,Arktharion,antonidas,1495,warrior,arms,60,28,32
53190,Киллдекс,gordunni,1495,warrior,arms,96,43,53
53191,Slidmacka,twisting-nether,1495,warrior,arms,97,42,55
53192,Думхаммер,howling-fjord,1494,warrior,arms,77,44,33
53193,Рэмпи,soulflayer,1494,warrior,arms,32,17,15
53194,Thiccbra,burning-legion,1494,warrior,arms,66,34,32
53195,Shadowbôxer,onyxia,1494,warrior,arms,68,35,33
53196,Whátsup,stormscale,1494,warrior,arms,48,24,24
53197,Rohc,kazzak,1494,warrior,arms,64,30,34
53198,Fáro,ravencrest,1494,warrior,arms,46,19,27
53199,Aurélus,rexxar,1493,warrior,arms,36,22,14
53200,Ardmoo,burning-legion,1493,warrior,arms,59,31,28
53201,Jonukas,argent-dawn,1493,warrior,arms,54,23,31
53202,Ммайдаен,goldrinn,1492,warrior,arms,66,32,34
53203,Bladrun,frostmane,1492,warrior,arms,36,16,20
53204,Starscourge,tarren-mill,1491,warrior,arms,53,43,10
53205,Kímó,silvermoon,1491,warrior,arms,48,24,24
53206,Pumpadzhîja,outland,1491,warrior,arms,66,32,34
53207,Séphi,archimonde,1491,warrior,arms,54,24,30
53208,Picciocino,nemesis,1491,warrior,arms,88,36,52
53209,Hùmøngöúslåm,ravencrest,1490,warrior,arms,30,19,11
53210,Gozga,twisting-nether,1490,warrior,arms,159,79,80
53211,Blackwólf,bloodhoof,1490,warrior,arms,154,72,82
53212,Vohnkar,emeriss,1490,warrior,arms,60,26,34
53213,Bucketheadde,thrall,1490,warrior,arms,42,16,26
53214,Шлифую,howling-fjord,1489,warrior,arms,43,26,17
53215,Calmdownbrú,frostmane,1489,warrior,arms,65,33,32
53216,Succel,drakthul,1489,warrior,arms,36,18,18
53217,Crangle,draenor,1489,warrior,arms,45,21,24
53218,Hefthyn,sanguino,1488,warrior,arms,36,20,16
53219,Khemen,kazzak,1488,warrior,arms,42,22,20
53220,Gorocpt,doomhammer,1488,warrior,arms,44,20,24
53221,Teronth,burning-legion,1488,warrior,arms,48,17,31
53222,Hindbærsaft,stormscale,1487,warrior,arms,55,32,23
53223,Bloodrain,twilights-hammer,1487,warrior,arms,68,34,34
53224,Zaurzyfang,burning-legion,1487,warrior,arms,36,18,18
53225,Paow,tarren-mill,1487,warrior,arms,41,19,22
53226,Сика,blackscar,1487,warrior,arms,66,30,36
53227,Cryonix,drakthul,1486,warrior,arms,49,27,22
53228,Jimei,temple-noir,1486,warrior,arms,30,16,14
53229,Голдибитч,gordunni,1486,warrior,arms,84,41,43
53230,Mfdoöm,draenor,1485,warrior,arms,149,73,76
53231,Omgihithard,draenor,1484,warrior,arms,57,28,29
53232,Audítóre,proudmoore,1484,warrior,arms,36,17,19
53233,Fizzywarrior,blackmoore,1484,warrior,arms,63,29,34
53234,Lortèn,stormscale,1482,warrior,arms,48,24,24
53235,Stormfist,tarren-mill,1481,warrior,arms,60,33,27
53236,Runhex,veknilash,1481,warrior,arms,53,26,27
53237,Daelator,ravencrest,1480,warrior,arms,56,30,26
53238,Gramr,silvermoon,1480,warrior,arms,71,36,35
53239,Nurfbolt,kazzak,1480,warrior,arms,41,19,22
53240,Nàsher,frostwolf,1480,warrior,arms,89,40,49
53241,Altimáte,antonidas,1479,warrior,arms,30,18,12
53242,Dariman,aegwynn,1479,warrior,arms,72,32,40
53243,Gromkarg,draenor,1479,warrior,arms,66,24,42
53244,Lezgar,ragnaros,1477,warrior,arms,24,18,6
53245,Boshim,ravencrest,1477,warrior,arms,36,20,16
53246,Нетконечно,howling-fjord,1477,warrior,arms,38,19,19
53247,Bracki,ysondre,1477,warrior,arms,46,21,25
53248,Ollyaa,ravencrest,1476,warrior,arms,24,16,8
53249,Trenbullone,kazzak,1476,warrior,arms,51,32,19
53250,Джасткипинг,gordunni,1476,warrior,arms,221,118,103
53251,Ràkar,stormscale,1476,warrior,arms,66,32,34
53252,Pajalousta,elune,1476,warrior,arms,102,47,55
53253,Vegilhenvin,stormscale,1476,warrior,arms,57,24,33
53254,Valíon,outland,1475,warrior,arms,94,53,41
53255,Medaur,frostmane,1475,warrior,arms,73,40,33
53256,Dagouor,twisting-nether,1474,warrior,arms,73,35,38
53257,Leomance,hyjal,1473,warrior,arms,30,18,12
53258,Melfis,aegwynn,1471,warrior,arms,40,21,19
53259,Malalulu,burning-legion,1471,warrior,arms,143,72,71
53260,Hazzael,ravencrest,1471,warrior,arms,66,31,35
53261,Divyx,tarren-mill,1470,warrior,arms,66,33,33
53262,Gíu,blackhand,1469,warrior,arms,29,17,12
53263,Clellin,silvermoon,1469,warrior,arms,75,37,38
53264,Hellzint,sanguino,1468,warrior,arms,303,146,157
53265,Heubba,hyjal,1467,warrior,arms,42,16,26
53266,Богадорога,howling-fjord,1465,warrior,arms,33,19,14
53267,Dafrang,kazzak,1465,warrior,arms,54,23,31
53268,Заверчу,soulflayer,1464,warrior,arms,66,34,32
53269,Keksspec,ungoro,1464,warrior,arms,48,20,28
53270,Hellespont,hellscream,1464,warrior,arms,101,37,64
53271,Grroom,tarren-mill,1463,warrior,arms,51,24,27
53272,Svënja,ysondre,1463,warrior,arms,144,66,78
53273,Grezlyk,drakthul,1463,warrior,arms,95,42,53
53274,Thâarnar,frostwolf,1463,warrior,arms,48,21,27
53275,Сеш,lich-king,1462,warrior,arms,116,54,62
53276,Nukebomb,dun-modr,1462,warrior,arms,54,25,29
53277,Nèssa,outland,1462,warrior,arms,41,16,25
53278,Gorejaws,draenor,1461,warrior,arms,30,19,11
53279,Hôrn,stormscale,1461,warrior,arms,66,37,29
53280,Juoppó,tarren-mill,1461,warrior,arms,128,67,61
53281,Reider,kazzak,1460,warrior,arms,57,29,28
53282,Азаргатан,soulflayer,1460,warrior,arms,62,31,31
53283,Brutøs,conseil-des-ombres,1460,warrior,arms,36,18,18
53284,Lachandrius,blackhand,1460,warrior,arms,90,43,47
53285,Trajkovic,ravencrest,1459,warrior,arms,200,108,92
53286,Togas,silvermoon,1459,warrior,arms,182,93,89
53287,Кефтеме,fordragon,1459,warrior,arms,141,69,72
53288,Pakusrage,defias-brotherhood,1459,warrior,arms,80,38,42
53289,Kèrrysmâsh,blackrock,1457,warrior,arms,54,31,23
53290,Drushíí,shattrath,1457,warrior,arms,71,35,36
53291,Ènteqt,antonidas,1456,warrior,arms,61,39,22
53292,Настрамо,gordunni,1456,warrior,arms,30,16,14
53293,Phenowarri,blackhand,1456,warrior,arms,115,60,55
53294,Лисерк,howling-fjord,1456,warrior,arms,42,16,26
53295,Weareinspace,stormscale,1455,warrior,arms,75,44,31
53296,Golonko,burning-legion,1455,warrior,arms,36,21,15
53297,Ordwinz,silvermoon,1455,warrior,arms,74,39,35
53298,Bluto,dunemaul,1455,warrior,arms,227,113,114
53299,Ladoz,ragnaros,1454,warrior,arms,48,22,26
53300,Кизуми,gordunni,1454,warrior,arms,63,27,36
53301,Meistarinn,draenor,1454,warrior,arms,60,22,38
53302,Onee,terrordar,1453,warrior,arms,55,30,25
53303,Dundulinka,outland,1453,warrior,arms,93,47,46
53304,Yeahq,kazzak,1453,warrior,arms,144,65,79
53305,Гардринг,howling-fjord,1450,warrior,arms,102,59,43
53306,Scarloc,archimonde,1450,warrior,arms,92,42,50
53307,Mordeukay,hyjal,1450,warrior,arms,42,18,24
53308,Peack,ravencrest,1449,warrior,arms,166,87,79
53309,Miko,ysondre,1449,warrior,arms,120,56,64
53310,Alborozie,archimonde,1448,warrior,arms,54,25,29
53311,Norinhell,ravencrest,1448,warrior,arms,48,20,28
53312,Jigsar,argent-dawn,1447,warrior,arms,111,63,48
53313,Gakgora,twisting-nether,1447,warrior,arms,36,18,18
53314,Endan,kelthuzad,1446,warrior,arms,66,37,29
53315,Dokô,twisting-nether,1446,warrior,arms,72,36,36
53316,Derentis,echsenkessel,1446,warrior,arms,198,94,104
53317,Argaskurken,ravencrest,1446,warrior,arms,42,19,23
53318,Informatica,doomhammer,1445,warrior,arms,48,25,23
53319,Megtorló,ragnaros,1445,warrior,arms,80,40,40
53320,Мерсилессх,gordunni,1445,warrior,arms,90,43,47
53321,Zhadsnark,blackrock,1444,warrior,arms,26,16,10
53322,Разрубателл,soulflayer,1444,warrior,arms,60,27,33
53323,Дообрыйшмель,soulflayer,1443,warrior,arms,51,32,19
53324,Рагаксес,blackscar,1443,warrior,arms,82,36,46
53325,Акумираг,soulflayer,1443,warrior,arms,72,31,41
53326,Arriess,drakthul,1441,warrior,arms,48,27,21
53327,Jumbodolmen,tarren-mill,1441,warrior,arms,48,26,22
53328,Gnomop,ravencrest,1441,warrior,arms,42,20,22
53329,Эпитафорх,blackscar,1440,warrior,arms,29,16,13
53330,Karimlebrave,hyjal,1440,warrior,arms,68,33,35
53331,Tucomessuelo,cthun,1439,warrior,arms,53,29,24
53332,Greekazi,kazzak,1439,warrior,arms,75,39,36
53333,Tmp,blackrock,1439,warrior,arms,60,30,30
53334,Ricssonz,burning-legion,1439,warrior,arms,60,29,31
53335,Makerrw,ravencrest,1438,warrior,arms,50,26,24
53336,Чпокерз,gordunni,1438,warrior,arms,88,43,45
53337,Sebeastian,ravencrest,1438,warrior,arms,48,23,25
53338,Мадс,howling-fjord,1437,warrior,arms,18,15,3
53339,Garouzo,hellfire,1437,warrior,arms,64,32,32
53340,Mtctwo,blackrock,1437,warrior,arms,30,15,15
53341,Gìlgamesh,dun-modr,1437,warrior,arms,121,59,62
53342,Ryle,anubarak,1437,warrior,arms,136,60,76
53343,Josgrout,silvermoon,1437,warrior,arms,64,28,36
53344,Нунара,eversong,1437,warrior,arms,47,19,28
53345,Anarki,kaelthas,1437,warrior,arms,50,19,31
53346,Banshe,ragnaros,1437,warrior,arms,48,16,32
53347,Мираккл,borean-tundra,1436,warrior,arms,24,15,9
53348,Aza,burning-blade,1436,warrior,arms,42,23,19
53349,Kaîsaschnitt,malganis,1436,warrior,arms,94,47,47
53350,Pokopo,blackrock,1436,warrior,arms,217,107,110
53351,Goldins,drakthul,1436,warrior,arms,53,26,27
53352,Friskos,dalaran,1436,warrior,arms,118,55,63
53353,Varyian,sporeggar,1436,warrior,arms,131,59,72
53354,Vrykhul,silvermoon,1436,warrior,arms,58,22,36
53355,Сладкаяхурма,howling-fjord,1436,warrior,arms,42,15,27
53356,Andzone,alakir,1435,warrior,arms,30,15,15
53357,Bigboibeeper,draenor,1435,warrior,arms,72,35,37
53358,Hackamore,suramar,1435,warrior,arms,102,49,53
53359,Mograinê,blackmoore,1434,warrior,arms,126,66,60
53360,Dzvenyhora,darkspear,1434,warrior,arms,96,44,52
53361,Dafok,rashgarroth,1434,warrior,arms,42,19,23
53362,Гопниг,deepholm,1433,warrior,arms,89,40,49
53363,Slunecniq,azjolnerub,1433,warrior,arms,63,28,35
53364,Илди,soulflayer,1433,warrior,arms,36,15,21
53365,Shoesmith,outland,1432,warrior,arms,92,36,56
53366,Pelicos,grim-batol,1431,warrior,arms,30,17,13
53367,Yayoflauta,sanguino,1431,warrior,arms,54,28,26
53368,Luküs,dun-modr,1431,warrior,arms,76,36,40
53369,Dragão,kazzak,1431,warrior,arms,42,17,25
53370,Otiep,blackmoore,1430,warrior,arms,36,24,12
53371,Dataçasé,silvermoon,1430,warrior,arms,24,15,9
53372,Wolvéshôwl,aegwynn,1430,warrior,arms,79,33,46
53373,Hellrokk,drakthul,1429,warrior,arms,30,18,12
53374,Architectman,twisting-nether,1429,warrior,arms,131,63,68
53375,Irén,hellfire,1429,warrior,arms,69,32,37
53376,Gorzan,dragonmaw,1429,warrior,arms,71,31,40
53377,Ormert,sylvanas,1429,warrior,arms,42,18,24
53378,Garroxx,blackrock,1429,warrior,arms,42,15,27
53379,Niiol,burning-blade,1428,warrior,arms,30,15,15
53380,Spridan,ravencrest,1428,warrior,arms,42,15,27
53381,Alinash,aegwynn,1427,warrior,arms,51,24,27
53382,Arreat,chogall,1427,warrior,arms,130,59,71
53383,Elbutanero,tarren-mill,1427,warrior,arms,36,15,21
53384,Farianna,burning-legion,1426,warrior,arms,87,43,44
53385,Bráïnléss,silvermoon,1426,warrior,arms,36,17,19
53386,Rightversion,sylvanas,1425,warrior,arms,30,15,15
53387,Zerberos,drakthul,1425,warrior,arms,76,37,39
53388,Alpairx,aegwynn,1425,warrior,arms,50,18,32
53389,Raizy,frostwolf,1424,warrior,arms,126,67,59
53390,Ahzrok,draenor,1424,warrior,arms,48,25,23
53391,Thickslam,argent-dawn,1424,warrior,arms,64,29,35
53392,Lostbull,kazzak,1424,warrior,arms,42,18,24
53393,Инелутабл,eversong,1423,warrior,arms,29,19,10
53394,Kriegernuss,blackmoore,1423,warrior,arms,48,27,21
53395,Murandin,outland,1423,warrior,arms,36,19,17
53396,Ball,zirkel-des-cenarius,1423,warrior,arms,131,67,64
53397,Уэсгар,blackscar,1423,warrior,arms,48,15,33
53398,Petrixens,drakthul,1422,warrior,arms,48,26,22
53399,Doba,madmortem,1422,warrior,arms,71,32,39
53400,Zkou,wrathbringer,1422,warrior,arms,42,15,27
53401,Smoothbrian,ravencrest,1421,warrior,arms,24,15,9
53402,Трафалльгар,gordunni,1421,warrior,arms,142,77,65
53403,Judditsbx,draenor,1421,warrior,arms,41,22,19
53404,Tarbhfathach,draenor,1421,warrior,arms,48,25,23
53405,Зеленыйжмых,thermaplugg,1421,warrior,arms,57,28,29
53406,Skumslag,blackmoore,1421,warrior,arms,42,15,27
53407,Mljecho,kazzak,1420,warrior,arms,155,79,76
53408,Pishpy,sylvanas,1420,warrior,arms,32,16,16
53409,Jáson,kazzak,1420,warrior,arms,71,33,38
53410,Dargonedt,blackrock,1420,warrior,arms,42,18,24
53411,Maxxiwumms,amanthul,1420,warrior,arms,36,15,21
53412,Ähäkutti,frostmane,1419,warrior,arms,77,44,33
53413,Zellxd,stormscale,1418,warrior,arms,36,20,16
53414,Madkill,twisting-nether,1418,warrior,arms,30,16,14
53415,Avelyr,pozzo-delleternità,1418,warrior,arms,30,15,15
53416,Nyamnyamnyam,blackmoore,1418,warrior,arms,35,15,20
53417,Josem,sanguino,1418,warrior,arms,39,16,23
53418,Gridra,dun-morogh,1417,warrior,arms,60,28,32
53419,Hoomeer,sylvanas,1417,warrior,arms,78,36,42
53420,Nuahka,blackmoore,1416,warrior,arms,28,17,11
53421,Leroxius,ragnaros,1416,warrior,arms,168,86,82
53422,Llestatl,hyjal,1416,warrior,arms,83,42,41
53423,Ciocaboca,draenor,1415,warrior,arms,30,17,13
53424,Markorok,kazzak,1415,warrior,arms,30,15,15
53425,Zugzugernaut,stormscale,1415,warrior,arms,36,16,20
53426,Flurie,sylvanas,1415,warrior,arms,46,20,26
53427,Madaxe,kazzak,1414,warrior,arms,24,20,4
53428,Størpïx,drakthul,1414,warrior,arms,60,34,26
53429,Berzzerker,tarren-mill,1414,warrior,arms,66,35,31
53430,Shïn,kaelthas,1414,warrior,arms,66,26,40
53431,Nøcturnaqq,silvermoon,1413,warrior,arms,72,34,38
53432,Lahzar,krasus,1413,warrior,arms,36,15,21
53433,Oruka,mannoroth,1412,warrior,arms,48,27,21
53434,Ugardosh,burning-legion,1412,warrior,arms,40,16,24
53435,Гетрайт,galakrond,1411,warrior,arms,38,21,17
53436,Vratranzhul,kirin-tor,1411,warrior,arms,229,108,121
53437,Латексник,booty-bay,1411,warrior,arms,63,26,37
53438,Kantarion,stormscale,1411,warrior,arms,54,22,32
53439,Hamonbophis,kirin-tor,1410,warrior,arms,30,17,13
53440,Абабоба,gordunni,1410,warrior,arms,100,50,50
53441,Паракур,soulflayer,1410,warrior,arms,84,40,44
53442,Эксихард,gordunni,1409,warrior,arms,78,34,44
53443,Ferpylél,ragnaros,1408,warrior,arms,31,17,14
53444,Deadyet,mugthol,1407,warrior,arms,24,15,9
53445,Yuriko,onyxia,1407,warrior,arms,48,25,23
53446,Taylorswifty,twisting-nether,1406,warrior,arms,96,52,44
53447,Nocton,blackhand,1406,warrior,arms,72,35,37
53448,Chaosedge,terokkar,1406,warrior,arms,36,16,20
53449,Spargebuci,draenor,1406,warrior,arms,48,17,31
53450,Esegryel,argent-dawn,1405,warrior,arms,65,26,39
53451,Gritch,ysondre,1404,warrior,arms,30,15,15
53452,Неосим,gordunni,1403,warrior,arms,48,29,19
53453,Beelzebuu,blackhand,1403,warrior,arms,85,45,40
53454,Bjösk,stormscale,1403,warrior,arms,45,23,22
53455,Raznon,magtheridon,1403,warrior,arms,42,17,25
53456,Mgw,blackrock,1402,warrior,arms,30,17,13
53457,Chakrator,la-croisade-écarlate,1402,warrior,arms,96,47,49
53458,Cutting,burning-legion,1402,warrior,arms,61,29,32
53459,Fraggiz,auchindoun,1402,warrior,arms,36,16,20
53460,Hílfiger,kazzak,1402,warrior,arms,71,29,42
53461,Befit,quelthalas,1401,warrior,arms,36,19,17
53462,Saofang,twisting-nether,1401,warrior,arms,30,15,15
53463,Андэрс,gordunni,1401,warrior,arms,124,59,65
53464,Северот,deepholm,1401,warrior,arms,35,16,19
53465,Bloodmyst,kazzak,1401,warrior,arms,60,27,33
53466,Strapnslap,argent-dawn,1401,warrior,arms,107,48,59
53467,Tamesulo,silvermoon,1401,warrior,arms,59,26,33
53468,Peldreas,silvermoon,1400,warrior,arms,64,31,33
53469,Казгримм,howling-fjord,1400,warrior,arms,48,23,25
53470,Caelgarn,twisting-nether,1399,warrior,arms,45,27,18
53471,Synrosh,hyjal,1399,warrior,arms,39,23,16
53472,Grimoire,drakthul,1399,warrior,arms,32,17,15
53473,Sidiøøus,hyjal,1399,warrior,arms,66,31,35
53474,Zíreael,ravencrest,1399,warrior,arms,53,22,31
53475,Zaatar,draenor,1398,warrior,arms,184,97,87
53476,Qvate,twisting-nether,1398,warrior,arms,65,33,32
53477,Moowar,defias-brotherhood,1398,warrior,arms,36,17,19
53478,Atälànte,ysondre,1397,warrior,arms,42,25,17
53479,Garrodan,doomhammer,1397,warrior,arms,36,15,21
53480,Doxinator,silvermoon,1396,warrior,arms,81,33,48
53481,Nevergladx,kazzak,1396,warrior,arms,57,23,34
53482,ßladex,azshara,1395,warrior,arms,47,27,20
53483,Rodenet,dun-modr,1395,warrior,arms,66,33,33
53484,Mortalgrim,ravencrest,1395,warrior,arms,58,29,29
53485,Zbra,draenor,1395,warrior,arms,65,32,33
53486,Bládez,ravencrest,1394,warrior,arms,66,36,30
53487,Dolphini,argent-dawn,1394,warrior,arms,52,23,29
53488,Akenrun,eredar,1394,warrior,arms,64,28,36
53489,Royoxo,blackrock,1393,warrior,arms,59,31,28
53490,Deadlycalm,blackrock,1393,warrior,arms,120,54,66
53491,Hørror,nemesis,1392,warrior,arms,60,30,30
53492,Алексвайтт,gordunni,1391,warrior,arms,47,23,24
53493,Folsack,sanguino,1391,warrior,arms,66,31,35
53494,Elyozz,silvermoon,1391,warrior,arms,49,23,26
53495,Hradball,twilights-hammer,1390,warrior,arms,60,28,32
53496,Glakias,silvermoon,1390,warrior,arms,36,16,20
53497,Okoru,stormscale,1390,warrior,arms,57,22,35
53498,Fokra,draenor,1389,warrior,arms,42,25,17
53499,Nuclearrage,outland,1389,warrior,arms,61,28,33
53500,Ordovis,silvermoon,1388,warrior,arms,30,15,15
53501,Антурим,howling-fjord,1388,warrior,arms,42,20,22
53502,Nabul,thunderhorn,1387,warrior,arms,48,26,22
53503,Binsaueramk,ravencrest,1387,warrior,arms,48,20,28
53504,Icybladez,kazzak,1386,warrior,arms,106,55,51
53505,Matti,magtheridon,1386,warrior,arms,29,15,14
53506,Rumbldore,ragnaros,1386,warrior,arms,54,22,32
53507,Prolyx,doomhammer,1385,warrior,arms,24,15,9
53508,Tolga,draenor,1385,warrior,arms,42,19,23
53509,Sokarbey,twisting-nether,1384,warrior,arms,30,17,13
53510,Дикийппц,gordunni,1384,warrior,arms,54,30,24
53511,Diástasi,twisting-nether,1384,warrior,arms,90,48,42
53512,Казньшалав,gordunni,1384,warrior,arms,111,54,57
53513,Éls,argent-dawn,1383,warrior,arms,46,22,24
53514,Keshâr,blackhand,1383,warrior,arms,42,20,22
53515,Einherjer,burning-legion,1382,warrior,arms,103,56,47
53516,Adzipotlewap,burning-legion,1382,warrior,arms,48,23,25
53517,Zetorc,burning-legion,1382,warrior,arms,129,61,68
53518,Cêlty,aegwynn,1382,warrior,arms,100,41,59
53519,Alopunch,kazzak,1381,warrior,arms,33,17,16
53520,Мастхэв,gordunni,1381,warrior,arms,42,21,21
53521,Reidunøks,kazzak,1381,warrior,arms,113,53,60
53522,Niouswar,kazzak,1381,warrior,arms,42,19,23
53523,Gëaldýr,kazzak,1381,warrior,arms,88,39,49
53524,Faugh,tarren-mill,1380,warrior,arms,54,32,22
53525,Ingensan,lightbringer,1379,warrior,arms,86,43,43
53526,Orgazam,xavius,1379,warrior,arms,41,20,21
53527,Pikkemaát,stormscale,1377,warrior,arms,27,15,12
53528,Warrouner,khaz-modan,1377,warrior,arms,151,74,77
53529,Shagara,defias-brotherhood,1377,warrior,arms,36,15,21
53530,Xaheld,blackrock,1376,warrior,arms,30,16,14
53531,Temprament,ravencrest,1375,warrior,arms,36,21,15
53532,Давилкагеев,howling-fjord,1375,warrior,arms,49,23,26
53533,Варгана,soulflayer,1375,warrior,arms,88,41,47
53534,Nezruslone,dun-modr,1374,warrior,arms,35,26,9
53535,Zargor,kazzak,1374,warrior,arms,58,35,23
53536,Booj,silvermoon,1374,warrior,arms,66,32,34
53537,Hitmanler,frostmane,1374,warrior,arms,36,17,19
53538,Cléàvage,silvermoon,1374,warrior,arms,81,32,49
53539,Dødsdonny,draenor,1373,warrior,arms,30,19,11
53540,Iljaana,blackrock,1373,warrior,arms,60,30,30
53541,Hogu,nemesis,1373,warrior,arms,54,21,33
53542,Раздолбатель,razuvious,1372,warrior,arms,37,21,16
53543,Srbinator,turalyon,1371,warrior,arms,131,64,67
53544,Lexras,blackhand,1371,warrior,arms,56,27,29
53545,Dixo,nathrezim,1370,warrior,arms,18,15,3
53546,Морталвлицо,gordunni,1370,warrior,arms,23,15,8
53547,Mercedesamg,blackmoore,1370,warrior,arms,56,28,28
53548,Shædøw,archimonde,1370,warrior,arms,30,15,15
53549,Sorosterv,twisting-nether,1370,warrior,arms,59,29,30
53550,Ayelsyssup,silvermoon,1370,warrior,arms,139,67,72
53551,Bellator,arakarahm,1370,warrior,arms,59,27,32
53552,Rakwarrior,blackhand,1369,warrior,arms,30,20,10
53553,Mëc,twisting-nether,1369,warrior,arms,88,47,41
53554,Leonidæs,frostwolf,1369,warrior,arms,87,42,45
53555,Tyrax,blackrock,1368,warrior,arms,29,15,14
53556,Matchoo,archimonde,1367,warrior,arms,59,27,32
53557,Drekh,kazzak,1367,warrior,arms,36,16,20
53558,Luusto,stormscale,1366,warrior,arms,42,16,26
53559,Erzotz,kazzak,1365,warrior,arms,33,20,13
53560,Lægend,hyjal,1365,warrior,arms,74,37,37
53561,Lyfttokyo,tarren-mill,1365,warrior,arms,90,43,47
53562,Xmartha,tarren-mill,1364,warrior,arms,36,22,14
53563,Nobelisarius,norgannon,1364,warrior,arms,53,27,26
53564,Gacel,dun-modr,1364,warrior,arms,54,24,30
53565,Qweoamsd,sylvanas,1363,warrior,arms,30,15,15
53566,Ragestick,stormscale,1363,warrior,arms,42,20,22
53567,Rázgriz,argent-dawn,1363,warrior,arms,76,31,45
53568,Qiz,silvermoon,1362,warrior,arms,140,71,69
53569,Lomu,bloodscalp,1362,warrior,arms,44,22,22
53570,Propanex,kazzak,1361,warrior,arms,42,26,16
53571,Youokhun,kazzak,1361,warrior,arms,72,38,34
53572,Кэфтэмэ,soulflayer,1361,warrior,arms,85,41,44
53573,Hatefury,twisting-nether,1361,warrior,arms,102,48,54
53574,Vølverinwar,thrall,1361,warrior,arms,82,37,45
53575,Bulwrak,eredar,1359,warrior,arms,132,65,67
53576,Kosttya,argent-dawn,1359,warrior,arms,71,33,38
53577,Panggy,ragnaros,1359,warrior,arms,36,15,21
53578,Grahatia,magtheridon,1358,warrior,arms,99,54,45
53579,Газрош,howling-fjord,1358,warrior,arms,76,35,41
53580,Kymari,sanguino,1358,warrior,arms,63,28,35
53581,Nucleargrab,twilights-hammer,1356,warrior,arms,145,70,75
53582,Sinbuay,malygos,1356,warrior,arms,36,16,20
53583,Banshor,ysondre,1355,warrior,arms,38,18,20
53584,Xanatos,khazgoroth,1355,warrior,arms,56,19,37
53585,Агтеррокк,deathweaver,1353,warrior,arms,60,30,30
53586,Duce,kirin-tor,1353,warrior,arms,43,18,25
53587,Eyesonly,blackmoore,1352,warrior,arms,52,28,24
53588,Kioskmupp,ravencrest,1352,warrior,arms,102,50,52
53589,Авентадорх,deathguard,1352,warrior,arms,89,35,54
53590,Tedbuckland,blackrock,1351,warrior,arms,30,19,11
53591,Espröc,kazzak,1350,warrior,arms,198,101,97
53592,Mogolaki,twilights-hammer,1349,warrior,arms,126,60,66
53593,Pavard,arakarahm,1349,warrior,arms,36,16,20
53594,Bumbx,kazzak,1348,warrior,arms,44,23,21
53595,Grolbein,blackhand,1348,warrior,arms,71,35,36
53596,Toxicmade,drakthul,1347,warrior,arms,48,22,26
53597,Брозя,gordunni,1347,warrior,arms,42,19,23
53598,Èscøbar,dalaran,1347,warrior,arms,45,17,28
53599,Tazkax,archimonde,1346,warrior,arms,52,23,29
53600,Blackblades,defias-brotherhood,1345,warrior,arms,54,33,21
53601,Мускулатор,soulflayer,1345,warrior,arms,126,58,68
53602,Imondiet,ragnaros,1344,warrior,arms,18,14,4
53603,Pummelpete,grim-batol,1344,warrior,arms,24,14,10
53604,Jasperr,nemesis,1344,warrior,arms,127,69,58
53605,Pazl,outland,1344,warrior,arms,36,17,19
53606,Скользкийбро,gordunni,1343,warrior,arms,139,67,72
53607,Tyëlin,elune,1343,warrior,arms,107,50,57
53608,Whýsøsîlêñt,ragnaros,1343,warrior,arms,30,14,16
53609,Colard,ravencrest,1343,warrior,arms,30,14,16
53610,Marex,grim-batol,1343,warrior,arms,30,14,16
53611,Ysgrammorr,magtheridon,1343,warrior,arms,36,16,20
53612,Galganiec,burning-legion,1342,warrior,arms,30,20,10
53613,Buyya,ravencrest,1342,warrior,arms,58,31,27
53614,Carras,confrérie-du-thorium,1342,warrior,arms,222,106,116
53615,Anahkas,archimonde,1342,warrior,arms,30,14,16
53616,Germantank,ravencrest,1341,warrior,arms,24,14,10
53617,Хазгора,howling-fjord,1341,warrior,arms,106,58,48
53618,Zzeed,auchindoun,1341,warrior,arms,48,19,29
53619,Elénir,dalaran,1340,warrior,arms,30,18,12
53620,Pag,hyjal,1339,warrior,arms,23,15,8
53621,Gnarok,archimonde,1339,warrior,arms,69,41,28
53622,Norganw,die-aldor,1339,warrior,arms,24,14,10
53623,Hoxxywar,drakthul,1339,warrior,arms,59,33,26
53624,Dranush,onyxia,1339,warrior,arms,253,127,126
53625,Kaliroll,ysondre,1339,warrior,arms,104,51,53
53626,Голдфингер,gordunni,1339,warrior,arms,130,62,68
53627,Nylseana,turalyon,1339,warrior,arms,60,26,34
53628,Pinkblast,sylvanas,1339,warrior,arms,36,14,22
53629,Hundar,archimonde,1338,warrior,arms,54,29,25
53630,Палачубийца,deathguard,1338,warrior,arms,97,51,46
53631,Cássándráh,argent-dawn,1338,warrior,arms,97,47,50
53632,Kimura,archimonde,1338,warrior,arms,30,14,16
53633,Тритиан,soulflayer,1338,warrior,arms,34,15,19
53634,Toby,rexxar,1337,warrior,arms,33,19,14
53635,Lågærtha,blackmoore,1337,warrior,arms,53,28,25
53636,Puurplecloud,kazzak,1337,warrior,arms,66,28,38
53637,Littlebugger,ravencrest,1336,warrior,arms,24,14,10
53638,Neverkind,twisting-nether,1336,warrior,arms,84,47,37
53639,Фикпопадешь,lich-king,1336,warrior,arms,69,30,39
53640,Iluwar,ragnaros,1335,warrior,arms,397,193,204
53641,Bonesz,jaedenar,1334,warrior,arms,141,71,70
53642,Dirtyjoe,khaz-modan,1333,warrior,arms,246,124,122
53643,Isenstrider,burning-legion,1333,warrior,arms,30,14,16
53644,Critwar,silvermoon,1333,warrior,arms,54,25,29
53645,Brokenqt,ravencrest,1332,warrior,arms,27,16,11
53646,Шизам,howling-fjord,1332,warrior,arms,54,20,34
53647,Флэксик,soulflayer,1331,warrior,arms,24,14,10
53648,Carljøhnson,dalaran,1331,warrior,arms,290,136,154
53649,Rutch,hyjal,1331,warrior,arms,42,18,24
53650,Kalregg,outland,1331,warrior,arms,48,19,29
53651,Bovingus,tarren-mill,1330,warrior,arms,24,16,8
53652,Aiarm,twisting-nether,1330,warrior,arms,192,104,88
53653,Pezuñaloca,shendralar,1330,warrior,arms,60,31,29
53654,Sugmanutz,argent-dawn,1329,warrior,arms,24,14,10
53655,Agamemnon,frostmane,1328,warrior,arms,32,19,13
53656,Shádówfáxí,outland,1328,warrior,arms,30,14,16
53657,Haewon,burning-legion,1328,warrior,arms,42,16,26
53658,Behemothwr,kazzak,1327,warrior,arms,75,37,38
53659,Leopoldx,outland,1326,warrior,arms,40,21,19
53660,Oneshót,norgannon,1326,warrior,arms,71,36,35
53661,Flawla,blackmoore,1326,warrior,arms,30,14,16
53662,Wargak,stormscale,1326,warrior,arms,30,14,16
53663,Maidenlless,ravencrest,1326,warrior,arms,134,61,73
53664,Swefy,sanguino,1326,warrior,arms,139,62,77
53665,Xsann,argent-dawn,1326,warrior,arms,36,16,20
53666,Smashtv,ragnaros,1326,warrior,arms,36,15,21
53667,Vagor,aegwynn,1325,warrior,arms,102,49,53
53668,Iuska,malganis,1325,warrior,arms,54,21,33
53669,Zuchtrind,blackrock,1324,warrior,arms,48,29,19
53670,Bxnx,aegwynn,1324,warrior,arms,42,23,19
53671,Äzathoth,silvermoon,1324,warrior,arms,30,14,16
53672,Mortalik,silvermoon,1324,warrior,arms,166,77,89
53673,Highz,grim-batol,1323,warrior,arms,36,18,18
53674,Безбожник,eversong,1322,warrior,arms,60,33,27
53675,Franzbardon,archimonde,1322,warrior,arms,196,95,101
53676,Лютобор,gordunni,1322,warrior,arms,39,16,23
53677,Frankius,ravencrest,1321,warrior,arms,30,14,16
53678,Raixxon,ragnaros,1321,warrior,arms,109,49,60
53679,Ashiku,zuljin,1321,warrior,arms,54,23,31
53680,Throck,drakthul,1320,warrior,arms,41,18,23
53681,Мобсто,soulflayer,1320,warrior,arms,53,23,30
53682,Swaxx,ravencrest,1320,warrior,arms,36,14,22
53683,Tealbell,chamber-of-aspects,1319,warrior,arms,143,71,72
53684,Razoo,stormscale,1319,warrior,arms,60,23,37
53685,Kianit,ravencrest,1318,warrior,arms,231,110,121
53686,Krigarjag,kazzak,1317,warrior,arms,35,20,15
53687,Martøswarr,uldum,1317,warrior,arms,30,14,16
53688,Narkololzz,marécage-de-zangar,1317,warrior,arms,80,37,43
53689,Grimhew,argent-dawn,1317,warrior,arms,42,17,25
53690,Kilsorrow,silvermoon,1317,warrior,arms,42,14,28
53691,Dreamkil,archimonde,1316,warrior,arms,205,106,99
53692,Zhenshii,blackmoore,1316,warrior,arms,42,21,21
53693,Gintonnic,sanguino,1316,warrior,arms,36,18,18
53694,Papipulki,zuljin,1316,warrior,arms,86,35,51
53695,Astven,blackmoore,1316,warrior,arms,40,16,24
53696,Ральдвин,gordunni,1315,warrior,arms,77,43,34
53697,Guruntar,kirin-tor,1315,warrior,arms,62,29,33
53698,Ríta,silvermoon,1315,warrior,arms,30,14,16
53699,Chrekk,khaz-modan,1315,warrior,arms,30,14,16
53700,Ангрол,grom,1315,warrior,arms,47,20,27
53701,Ràgnarok,chogall,1314,warrior,arms,72,39,33
53702,Ragark,quelthalas,1314,warrior,arms,111,59,52
53703,Bleckwarrior,ravencrest,1314,warrior,arms,96,46,50
53704,Kmica,khadgar,1314,warrior,arms,61,27,34
53705,Equality,ragnaros,1314,warrior,arms,58,25,33
53706,Дагмар,howling-fjord,1314,warrior,arms,36,14,22
53707,Blitz,archimonde,1313,warrior,arms,24,14,10
53708,Eekz,haomarush,1313,warrior,arms,36,19,17
53709,Lácrima,dun-modr,1313,warrior,arms,36,18,18
53710,Oceangg,silvermoon,1312,warrior,arms,39,16,23
53711,Evilrage,ravencrest,1311,warrior,arms,41,25,16
53712,Ankzz,archimonde,1311,warrior,arms,36,21,15
53713,Кентаныч,howling-fjord,1311,warrior,arms,56,28,28
53714,Deckluhm,sinstralis,1311,warrior,arms,36,17,19
53715,Оморальный,soulflayer,1311,warrior,arms,88,39,49
53716,Nicperh,dun-modr,1310,warrior,arms,72,32,40
53717,Тандэр,borean-tundra,1310,warrior,arms,36,15,21
53718,Megatronman,ravencrest,1309,warrior,arms,24,14,10
53719,Tyragon,thrall,1309,warrior,arms,40,23,17
53720,Roctah,auchindoun,1309,warrior,arms,46,24,22
53721,Матумбо,gordunni,1309,warrior,arms,38,16,22
53722,Сырилисуп,soulflayer,1308,warrior,arms,68,37,31
53723,Lø,chogall,1308,warrior,arms,65,32,33
53724,Yolal,twisting-nether,1308,warrior,arms,72,34,38
53725,Kronstris,veklor,1308,warrior,arms,36,16,20
53726,Gamöra,kirin-tor,1307,warrior,arms,60,28,32
53727,Aomen,ravencrest,1306,warrior,arms,24,15,9
53728,Rajä,anubarak,1306,warrior,arms,36,15,21
53729,Lûckystríké,blackmoore,1305,warrior,arms,52,25,27
53730,Thisguyfax,the-venture-co,1304,warrior,arms,66,34,32
53731,Foxaz,burning-legion,1304,warrior,arms,66,33,33
53732,Ludjack,tarren-mill,1304,warrior,arms,39,18,21
53733,Мэднас,howling-fjord,1304,warrior,arms,66,28,38
53734,Sixteen,darkmoon-faire,1303,warrior,arms,24,14,10
53735,Glørïn,hyjal,1303,warrior,arms,66,32,34
53736,Zosska,burning-legion,1302,warrior,arms,81,36,45
53737,Fàlconry,kazzak,1302,warrior,arms,120,51,69
53738,Halsandre,hyjal,1302,warrior,arms,60,23,37
53739,Jastreb,blackrock,1302,warrior,arms,48,14,34
53740,Bossít,doomhammer,1301,warrior,arms,80,44,36
53741,Ragnacore,ravencrest,1301,warrior,arms,53,29,24
53742,Geraltf,tarren-mill,1301,warrior,arms,137,65,72
53743,Tazdingowar,antonidas,1301,warrior,arms,58,23,35
53744,Zeldaixi,twisting-nether,1300,warrior,arms,34,19,15
53745,Katxirulo,tyrande,1300,warrior,arms,72,34,38
53746,Staribrko,outland,1300,warrior,arms,236,111,125
53747,Lepka,drakthul,1300,warrior,arms,30,14,16
53748,Kaidewarr,kazzak,1299,warrior,arms,24,16,8
53749,Bolski,ravencrest,1299,warrior,arms,70,38,32
53750,Shuraj,hyjal,1299,warrior,arms,46,24,22
53751,Neekero,burning-legion,1299,warrior,arms,82,38,44
53752,Borga,blackrock,1297,warrior,arms,42,19,23
53753,Atlantia,ravencrest,1297,warrior,arms,42,15,27
53754,Cárbo,silvermoon,1296,warrior,arms,73,40,33
53755,Рестат,soulflayer,1296,warrior,arms,143,61,82
53756,Sertigan,dun-modr,1296,warrior,arms,44,17,27
53757,Армсец,howling-fjord,1296,warrior,arms,42,16,26
53758,Seliasbro,kazzak,1295,warrior,arms,30,15,15
53759,Arithael,dun-modr,1295,warrior,arms,240,118,122
53760,Сэлфиш,lich-king,1295,warrior,arms,29,14,15
53761,Bobloblaww,doomhammer,1295,warrior,arms,30,14,16
53762,Knussnacker,sanguino,1295,warrior,arms,67,25,42
53763,Chippéd,draenor,1294,warrior,arms,23,14,9
53764,Kalarar,blackrock,1294,warrior,arms,56,19,37
53765,Wolfgladius,cthun,1293,warrior,arms,30,15,15
53766,Oyv,tarren-mill,1293,warrior,arms,30,15,15
53767,Шпингалетыч,howling-fjord,1293,warrior,arms,36,14,22
53768,Faløn,archimonde,1293,warrior,arms,62,24,38
53769,Koliastra,magtheridon,1292,warrior,arms,48,29,19
53770,Donátos,aegwynn,1292,warrior,arms,92,44,48
53771,Semanor,aegwynn,1291,warrior,arms,30,16,14
53772,Zeroskllz,outland,1291,warrior,arms,76,36,40
53773,Iarsonn,drakthul,1291,warrior,arms,42,18,24
53774,Inelegant,tarren-mill,1290,warrior,arms,60,32,28
53775,Issatank,frostmane,1290,warrior,arms,60,30,30
53776,Ghorglukk,lightnings-blade,1290,warrior,arms,60,28,32
53777,Garganelli,tarren-mill,1290,warrior,arms,68,30,38
53778,Elyrax,dun-modr,1290,warrior,arms,36,15,21
53779,Брэмбур,goldrinn,1290,warrior,arms,35,14,21
53780,Piksitron,silvermoon,1289,warrior,arms,66,40,26
53781,Xraider,ragnaros,1289,warrior,arms,60,27,33
53782,Euforija,kazzak,1289,warrior,arms,36,16,20
53783,Степанычь,gordunni,1288,warrior,arms,41,22,19
53784,Anaxiam,drakthul,1288,warrior,arms,39,17,22
53785,Вениамин,deathweaver,1288,warrior,arms,47,15,32
53786,Ninebites,chamber-of-aspects,1287,warrior,arms,125,63,62
53787,Taikyokuken,hyjal,1287,warrior,arms,66,29,37
53788,Olesbawro,ragnaros,1287,warrior,arms,90,34,56
53789,Treze,sanguino,1287,warrior,arms,68,23,45
53790,Gorchak,blackmoore,1286,warrior,arms,194,92,102
53791,Vegäpunk,nemesis,1286,warrior,arms,42,19,23
53792,Gantór,blackrock,1286,warrior,arms,54,23,31
53793,Minoke,antonidas,1286,warrior,arms,36,15,21
53794,Daddie,silvermoon,1286,warrior,arms,39,15,24
53795,Unarde,silvermoon,1285,warrior,arms,227,113,114
53796,Perkoulator,archimonde,1285,warrior,arms,93,42,51
53797,Rayguerrero,blackrock,1285,warrior,arms,42,14,28
53798,Soulcleaver,stormreaver,1284,warrior,arms,68,36,32
53799,Bonnaventure,hyjal,1284,warrior,arms,102,50,52
53800,Klanky,draenor,1284,warrior,arms,68,33,35
53801,Dutteh,tarren-mill,1283,warrior,arms,24,15,9
53802,Tíabeanie,silvermoon,1283,warrior,arms,30,14,16
53803,Ylana,eldrethalas,1283,warrior,arms,111,48,63
53804,Bluntsword,twisting-nether,1282,warrior,arms,36,17,19
53805,Почтитайсон,howling-fjord,1282,warrior,arms,32,15,17
53806,Brabüs,kazzak,1282,warrior,arms,56,26,30
53807,Hatethisgame,frostwolf,1282,warrior,arms,93,42,51
53808,Tonifox,nemesis,1281,warrior,arms,42,14,28
53809,Fedevalverde,sanguino,1280,warrior,arms,49,32,17
53810,Wørgenn,hyjal,1280,warrior,arms,44,23,21
53811,Kirowarrior,silvermoon,1280,warrior,arms,72,35,37
53812,Kloppnîx,blackmoore,1279,warrior,arms,56,34,22
53813,Гогрикк,ashenvale,1279,warrior,arms,72,35,37
53814,Malevolént,silvermoon,1279,warrior,arms,66,31,35
53815,Drbanner,hyjal,1278,warrior,arms,28,16,12
53816,Колятурбо,gordunni,1278,warrior,arms,36,19,17
53817,Silabozija,ravencrest,1278,warrior,arms,82,41,41
53818,Ovcharq,steamwheedle-cartel,1278,warrior,arms,73,36,37
53819,Geckoo,emerald-dream,1278,warrior,arms,143,62,81
53820,Lëime,ravencrest,1277,warrior,arms,48,25,23
53821,Colosius,stormscale,1275,warrior,arms,60,36,24
53822,Reichas,ragnaros,1275,warrior,arms,61,31,30
53823,Pacosky,burning-legion,1275,warrior,arms,57,28,29
53824,Kultigin,ravencrest,1275,warrior,arms,122,53,69
53825,Dodgeslam,eredar,1275,warrior,arms,58,23,35
53826,Contrariety,ravencrest,1274,warrior,arms,53,30,23
53827,Mödhan,archimonde,1274,warrior,arms,88,43,45
53828,Bhallts,tarren-mill,1274,warrior,arms,32,14,18
53829,Xunaakt,nemesis,1273,warrior,arms,69,34,35
53830,Kolxoz,doomhammer,1273,warrior,arms,36,15,21
53831,Sunney,tarren-mill,1272,warrior,arms,23,14,9
53832,Taurosk,burning-legion,1272,warrior,arms,66,31,35
53833,Rahaaxhia,kaelthas,1271,warrior,arms,24,15,9
53834,Nakkelam,twisting-nether,1270,warrior,arms,24,14,10
53835,Sigmundsdotr,outland,1270,warrior,arms,54,28,26
53836,Zøom,ysondre,1269,warrior,arms,88,46,42
53837,Джондо,gordunni,1269,warrior,arms,30,14,16
53838,Nårgaí,kargath,1269,warrior,arms,78,36,42
53839,Mfull,tarren-mill,1268,warrior,arms,66,31,35
53840,Kravaiski,argent-dawn,1267,warrior,arms,170,82,88
53841,Âdept,tarren-mill,1267,warrior,arms,72,27,45
53842,Погоныч,soulflayer,1264,warrior,arms,42,21,21
53843,Дрейсен,gordunni,1264,warrior,arms,48,23,25
53844,Aliasus,outland,1264,warrior,arms,36,16,20
53845,Ranran,emerald-dream,1264,warrior,arms,32,14,18
53846,Abnôrmus,tarren-mill,1262,warrior,arms,48,25,23
53847,Rochful,frostwolf,1260,warrior,arms,42,23,19
53848,Tozz,azuremyst,1260,warrior,arms,48,26,22
53849,Vagor,draenor,1260,warrior,arms,46,22,24
53850,Zool,madmortem,1260,warrior,arms,113,54,59
53851,Téldrus,blackrock,1260,warrior,arms,42,16,26
53852,Démigodx,stormscale,1259,warrior,arms,40,15,25
53853,Plt,talnivarr,1258,warrior,arms,47,29,18
53854,Razzimak,eredar,1257,warrior,arms,22,17,5
53855,Matrafox,stormscale,1257,warrior,arms,73,34,39
53856,Balyndâ,aegwynn,1256,warrior,arms,44,25,19
53857,Xaqt,die-nachtwache,1255,warrior,arms,29,14,15
53858,Maraximus,ragnaros,1255,warrior,arms,29,14,15
53859,Narox,arathor,1255,warrior,arms,56,26,30
53860,Buntstift,thrall,1254,warrior,arms,42,14,28
53861,Morrzerk,sylvanas,1253,warrior,arms,35,20,15
53862,Orcanism,nozdormu,1253,warrior,arms,65,32,33
53863,Рейнджровер,howling-fjord,1252,warrior,arms,40,17,23
53864,Kirus,ravencrest,1252,warrior,arms,75,31,44
53865,Lebronjones,sylvanas,1251,warrior,arms,72,34,38
53866,Ðræms,eldrethalas,1251,warrior,arms,89,42,47
53867,Dicaprios,silvermoon,1250,warrior,arms,72,36,36
53868,Phantastix,dun-modr,1249,warrior,arms,42,25,17
53869,Фоссбро,gordunni,1249,warrior,arms,39,15,24
53870,Бигдэмс,soulflayer,1248,warrior,arms,30,13,17
53871,Wetrx,stormscale,1247,warrior,arms,18,13,5
53872,Midnightrain,archimonde,1247,warrior,arms,24,13,11
53873,Daymio,twisting-nether,1247,warrior,arms,30,13,17
53874,Kásúxøxøw,ravencrest,1247,warrior,arms,30,13,17
53875,Aixer,archimonde,1247,warrior,arms,30,13,17
53876,Hellspin,argent-dawn,1247,warrior,arms,42,18,24
53877,Sfarpi,burning-legion,1246,warrior,arms,66,38,28
53878,Aggamemnus,ravencrest,1246,warrior,arms,68,38,30
53879,Hirurg,thrall,1246,warrior,arms,24,13,11
53880,Бигдэм,howling-fjord,1246,warrior,arms,24,13,11
53881,Kardinell,blackhand,1246,warrior,arms,66,30,36
53882,Cavo,drakthul,1246,warrior,arms,30,13,17
53883,Sponkss,tarren-mill,1246,warrior,arms,30,13,17
53884,Shará,eredar,1246,warrior,arms,114,49,65
53885,Luunk,ravencrest,1245,warrior,arms,78,43,35
53886,Atus,dun-modr,1245,warrior,arms,77,38,39
53887,Grinrok,thrall,1245,warrior,arms,78,36,42
53888,Ken,twisting-nether,1245,warrior,arms,46,14,32
53889,Джагенвард,soulflayer,1244,warrior,arms,42,22,20
53890,Garosh,drakthul,1244,warrior,arms,66,33,33
53891,Weezing,argent-dawn,1244,warrior,arms,48,18,30
53892,Nazgrosh,burning-legion,1244,warrior,arms,36,13,23
53893,Rhazeél,blackrock,1243,warrior,arms,18,13,5
53894,Kiriwarr,dun-modr,1243,warrior,arms,24,13,11
53895,Zaerna,draenor,1243,warrior,arms,24,13,11
53896,Кунгфурик,soulflayer,1243,warrior,arms,30,14,16
53897,Istenn,stormscale,1243,warrior,arms,30,13,17
53898,Rocktastic,blackrock,1243,warrior,arms,41,16,25
53899,Soundso,blackmoore,1242,warrior,arms,26,15,11
53900,Narcx,kazzak,1242,warrior,arms,24,13,11
53901,Холипротовар,fordragon,1242,warrior,arms,48,22,26
53902,Átlás,blackmoore,1242,warrior,arms,43,19,24
53903,Arowbaze,archimonde,1242,warrior,arms,30,13,17
53904,Akáme,frostwolf,1242,warrior,arms,66,24,42
53905,Bhallts,twisting-nether,1242,warrior,arms,36,13,23
53906,Notvisionary,ravencrest,1241,warrior,arms,24,13,11
53907,Kekrah,burning-legion,1241,warrior,arms,30,13,17
53908,Eyeslicer,quelthalas,1241,warrior,arms,30,13,17
53909,Cárlsberg,pozzo-delleternità,1241,warrior,arms,58,24,34
53910,Jaru,alleria,1240,warrior,arms,57,30,27
53911,Kookwr,aggra-português,1240,warrior,arms,36,13,23
53912,Отключатель,howling-fjord,1239,warrior,arms,23,14,9
53913,Donfidel,tarren-mill,1239,warrior,arms,24,13,11
53914,Zappstorm,frostwolf,1238,warrior,arms,31,17,14
53915,Fiveboy,tarren-mill,1238,warrior,arms,24,13,11
53916,Randix,antonidas,1238,warrior,arms,24,13,11
53917,Faustà,nemesis,1238,warrior,arms,102,40,62
53918,Xlings,auchindoun,1238,warrior,arms,48,15,33
53919,Jésusiskíng,amanthul,1237,warrior,arms,24,13,11
53920,Rorix,blackrock,1237,warrior,arms,24,13,11
53921,Redow,stormreaver,1237,warrior,arms,52,20,32
53922,Fractale,kirin-tor,1236,warrior,arms,22,14,8
53923,Smackaroon,draenor,1235,warrior,arms,24,13,11
53924,Krodunn,argent-dawn,1235,warrior,arms,29,13,16
53925,Earshy,ragnaros,1234,warrior,arms,24,13,11
53926,Serakhan,argent-dawn,1234,warrior,arms,90,46,44
53927,Братишкаа,gordunni,1234,warrior,arms,53,21,32
53928,Batalius,dalaran,1234,warrior,arms,36,14,22
53929,Imorphius,silvermoon,1234,warrior,arms,36,13,23
53930,Funknîco,wrathbringer,1233,warrior,arms,37,19,18
53931,Drahtalger,hyjal,1233,warrior,arms,30,13,17
53932,Joewahl,ragnaros,1233,warrior,arms,48,15,33
53933,Szelenamoon,outland,1232,warrior,arms,32,14,18
53934,Khilax,ragnaros,1231,warrior,arms,73,38,35
53935,Waegon,twisting-nether,1230,warrior,arms,30,13,17
53936,Vymd,archimonde,1230,warrior,arms,34,14,20
53937,Lûxn,silvermoon,1229,warrior,arms,187,93,94
53938,Xennor,argent-dawn,1229,warrior,arms,30,13,17
53939,Cramatao,shadowsong,1229,warrior,arms,59,25,34
53940,Huuln,outland,1229,warrior,arms,38,14,24
53941,Кимиюки,gordunni,1228,warrior,arms,62,28,34
53942,Thehans,grim-batol,1228,warrior,arms,44,18,26
53943,Gunga,ravenholdt,1227,warrior,arms,24,13,11
53944,Colq,doomhammer,1227,warrior,arms,41,18,23
53945,Leàn,nemesis,1226,warrior,arms,36,13,23
53946,Mifuune,argent-dawn,1225,warrior,arms,43,23,20
53947,Элейд,thermaplugg,1225,warrior,arms,47,23,24
53948,Синнэр,blackscar,1225,warrior,arms,36,13,23
53949,Izestyi,blackrock,1224,warrior,arms,90,39,51
53950,Larrydankin,draenor,1224,warrior,arms,78,30,48
53951,Sphínxx,malfurion,1223,warrior,arms,38,16,22
53952,Solaría,garona,1222,warrior,arms,30,15,15
53953,Mysteryman,defias-brotherhood,1222,warrior,arms,83,41,42
53954,Energo,drakthul,1222,warrior,arms,36,17,19
53955,Slaughteredd,kazzak,1222,warrior,arms,66,27,39
53956,Krigsdunken,draenor,1221,warrior,arms,87,40,47
53957,Orwêll,uldum,1221,warrior,arms,122,55,67
53958,Worstplàyer,tarren-mill,1221,warrior,arms,30,13,17
53959,Gachiwarri,blackhand,1221,warrior,arms,30,13,17
53960,Bulduzer,kazzak,1221,warrior,arms,71,30,41
53961,Gèrralt,hyjal,1221,warrior,arms,41,16,25
53962,Garthro,antonidas,1221,warrior,arms,36,14,22
53963,Reb,thunderhorn,1220,warrior,arms,24,13,11
53964,Goldenward,silvermoon,1220,warrior,arms,42,21,21
53965,Draleckx,sanguino,1220,warrior,arms,148,70,78
53966,Nixtor,defias-brotherhood,1220,warrior,arms,61,25,36
53967,Mesmash,uldum,1220,warrior,arms,36,13,23
53968,Клайминг,soulflayer,1219,warrior,arms,48,29,19
53969,Reezax,blackrock,1219,warrior,arms,24,14,10
53970,Maggisauce,aegwynn,1218,warrior,arms,100,54,46
53971,Bigtulipe,archimonde,1218,warrior,arms,59,30,29
53972,Jisoowar,blackhand,1217,warrior,arms,54,23,31
53973,Dianâ,der-abyssische-rat,1216,warrior,arms,30,16,14
53974,Lazaza,tarren-mill,1216,warrior,arms,30,13,17
53975,Ismellurfeet,ravencrest,1215,warrior,arms,24,14,10
53976,Zuggizug,draenor,1215,warrior,arms,60,30,30
53977,Ghostwarx,blackmoore,1215,warrior,arms,38,19,19
53978,Sudosolo,burning-blade,1215,warrior,arms,78,38,40
53979,Despacitus,burning-legion,1215,warrior,arms,53,20,33
53980,Kriticah,sanguino,1215,warrior,arms,36,13,23
53981,Crocbait,ravencrest,1214,warrior,arms,36,19,17
53982,Khalghara,dun-modr,1214,warrior,arms,36,14,22
53983,Gallows,blackmoore,1214,warrior,arms,36,13,23
53984,Ckx,kazzak,1213,warrior,arms,26,16,10
53985,Дрейтон,eversong,1213,warrior,arms,58,31,27
53986,Shihoh,blackhand,1213,warrior,arms,124,50,74
53987,Calel,ravencrest,1213,warrior,arms,38,14,24
53988,Киефси,howling-fjord,1212,warrior,arms,66,38,28
53989,Sway,eonar,1212,warrior,arms,120,57,63
53990,Ферхар,galakrond,1211,warrior,arms,30,18,12
53991,Бруталдэз,deathguard,1211,warrior,arms,36,13,23
53992,Voidteen,argent-dawn,1210,warrior,arms,30,13,17
53993,Robsuéy,blackmoore,1210,warrior,arms,72,23,49
53994,Tabboonishka,draenor,1209,warrior,arms,22,14,8
53995,Thunderage,stormscale,1209,warrior,arms,30,14,16
53996,Asmongnome,ravencrest,1208,warrior,arms,24,13,11
53997,Nurychïc,twisting-nether,1208,warrior,arms,45,24,21
53998,Рагнарг,goldrinn,1207,warrior,arms,48,26,22
53999,Donetenk,silvermoon,1206,warrior,arms,32,16,16
54000,Karden,doomhammer,1206,warrior,arms,68,29,39
54001,Delenia,twisting-nether,1205,warrior,arms,55,26,29
54002,Крешер,howling-fjord,1205,warrior,arms,93,43,50
54003,Crotoss,ravencrest,1205,warrior,arms,37,17,20
54004,Rhonack,ragnaros,1205,warrior,arms,50,20,30
54005,Pawn,twisting-nether,1204,warrior,arms,36,14,22
54006,Protecc,burning-legion,1203,warrior,arms,68,31,37
54007,Totalterror,ragnaros,1203,warrior,arms,72,31,41
54008,Frézzér,blackrock,1203,warrior,arms,33,14,19
54009,Excutíé,twisting-nether,1202,warrior,arms,30,18,12
54010,Cecill,silvermoon,1202,warrior,arms,29,17,12
54011,Крахгал,soulflayer,1201,warrior,arms,159,80,79
54012,Exot,eredar,1200,warrior,arms,60,30,30
54013,Rikistrike,tarren-mill,1200,warrior,arms,40,18,22
54014,Thylegorn,argent-dawn,1199,warrior,arms,25,16,9
54015,Skyowner,twisting-nether,1199,warrior,arms,27,14,13
54016,Mañtís,argent-dawn,1198,warrior,arms,80,41,39
54017,Clashblood,outland,1198,warrior,arms,27,13,14
54018,Данилатитич,howling-fjord,1198,warrior,arms,57,27,30
54019,Buffettleapx,kazzak,1198,warrior,arms,50,21,29
54020,Rayeron,sanguino,1198,warrior,arms,39,16,23
54021,Vlader,dun-modr,1198,warrior,arms,66,26,40
54022,Ксапур,soulflayer,1198,warrior,arms,36,14,22
54023,Tontonsmoky,hyjal,1197,warrior,arms,94,43,51
54024,Mozterwar,ravencrest,1197,warrior,arms,66,28,38
54025,Mllmmxxm,kargath,1197,warrior,arms,36,13,23
54026,Arouga,blackrock,1196,warrior,arms,21,13,8
54027,Brondir,archimonde,1196,warrior,arms,29,14,15
54028,Sandalwood,wildhammer,1195,warrior,arms,27,16,11
54029,Berserkpwnz,silvermoon,1194,warrior,arms,60,32,28
54030,Nøiir,malfurion,1194,warrior,arms,30,15,15
54031,Агамемнан,soulflayer,1194,warrior,arms,200,95,105
54032,Horsewarrior,stormscale,1194,warrior,arms,29,13,16
54033,Rèâpèr,kazzak,1193,warrior,arms,42,27,15
54034,Wutend,nemesis,1190,warrior,arms,23,13,10
54035,Opseagull,defias-brotherhood,1189,warrior,arms,30,15,15
54036,Kllinac,kazzak,1189,warrior,arms,71,33,38
54037,Anaerion,argent-dawn,1189,warrior,arms,29,13,16
54038,Kerisandra,silvermoon,1188,warrior,arms,37,22,15
54039,Лысыч,gordunni,1188,warrior,arms,33,17,16
54040,Korvjnus,burning-blade,1186,warrior,arms,42,20,22
54041,Pyret,outland,1185,warrior,arms,40,14,26
54042,Enface,ragnaros,1184,warrior,arms,28,14,14
54043,Epepseyer,sanguino,1184,warrior,arms,30,14,16
54044,Górut,zuljin,1184,warrior,arms,39,17,22
54045,Scrèàm,tarren-mill,1184,warrior,arms,67,29,38
54046,Gathika,arathor,1183,warrior,arms,24,14,10
54047,Pegazón,outland,1182,warrior,arms,45,18,27
54048,Kriegerkraut,silvermoon,1180,warrior,arms,28,21,7
54049,Neltharon,silvermoon,1179,warrior,arms,27,17,10
54050,Disturbance,eredar,1178,warrior,arms,36,17,19
54051,Chilp,archimonde,1178,warrior,arms,73,30,43
54052,Crook,doomhammer,1178,warrior,arms,72,28,44
54053,Radîtz,blackmoore,1177,warrior,arms,32,15,17
54054,Виднокрай,gordunni,1177,warrior,arms,36,13,23
54055,Аузерг,soulflayer,1175,warrior,arms,27,13,14
54056,Beans,argent-dawn,1175,warrior,arms,102,42,60
54057,Tempii,ragnaros,1175,warrior,arms,36,13,23
54058,Elyalol,ragnaros,1174,warrior,arms,33,15,18
54059,Etelä,stormreaver,1172,warrior,arms,37,17,20
54060,Harska,ragnaros,1171,warrior,arms,53,27,26
54061,Wyshh,silvermoon,1171,warrior,arms,119,57,62
54062,Wâtchmefear,blackrock,1171,warrior,arms,33,14,19
54063,Cremas,cthun,1171,warrior,arms,84,33,51
54064,Muetzchen,blackhand,1170,warrior,arms,48,27,21
54065,Wyes,kazzak,1170,warrior,arms,34,13,21
54066,Gilettepenge,draenor,1169,warrior,arms,121,59,62
54067,Warriornrv,ysondre,1169,warrior,arms,51,23,28
54068,Imora,silvermoon,1169,warrior,arms,54,22,32
54069,Белриэль,gordunni,1169,warrior,arms,66,24,42
54070,Бавовник,howling-fjord,1169,warrior,arms,38,13,25
54071,Роккар,gordunni,1168,warrior,arms,42,22,20
54072,Атон,gordunni,1168,warrior,arms,80,35,45
54073,Ordínaryname,blackrock,1166,warrior,arms,478,245,233
54074,Whàtsup,stormscale,1166,warrior,arms,36,17,19
54075,Sistabossen,magtheridon,1165,warrior,arms,24,13,11
54076,Галактозар,soulflayer,1165,warrior,arms,126,56,70
54077,Daguangming,outland,1165,warrior,arms,59,23,36
54078,Râsk,kazzak,1162,warrior,arms,26,15,11
54079,Parasite,the-maelstrom,1161,warrior,arms,36,19,17
54080,Mågne,tarren-mill,1160,warrior,arms,42,16,26
54081,Слуфен,galakrond,1158,warrior,arms,24,14,10
54082,Claytøn,khaz-modan,1158,warrior,arms,55,25,30
54083,Regna,eredar,1157,warrior,arms,90,42,48
54084,Rühlsbester,thrall,1154,warrior,arms,71,31,40
54085,Tommia,burning-legion,1154,warrior,arms,30,13,17
54086,Акнаранд,soulflayer,1152,warrior,arms,18,12,6
54087,Devìlscandy,stormscale,1152,warrior,arms,18,12,6
54088,Belfodiris,stormscale,1152,warrior,arms,18,12,6
54089,Azotz,archimonde,1152,warrior,arms,24,12,12
54090,Uselessblâme,archimonde,1152,warrior,arms,24,12,12
54091,Porsea,ravencrest,1152,warrior,arms,24,12,12
54092,Taÿ,stormscale,1152,warrior,arms,24,12,12
54093,Hellthõr,silvermoon,1152,warrior,arms,48,19,29
54094,Shinnok,stormreaver,1151,warrior,arms,48,33,15
54095,Jethiss,ravencrest,1151,warrior,arms,18,12,6
54096,Tranqtum,ravencrest,1151,warrior,arms,31,12,19
54097,Wutraa,kazzak,1150,warrior,arms,18,12,6
54098,Jackzx,twisting-nether,1150,warrior,arms,18,12,6
54099,Zidbi,argent-dawn,1150,warrior,arms,24,12,12
54100,Crazykind,kazzak,1150,warrior,arms,24,12,12
54101,Astrid,rajaxx,1150,warrior,arms,27,13,14
54102,Warmegedon,frostmane,1149,warrior,arms,18,12,6
54103,Hoggle,runetotem,1149,warrior,arms,76,43,33
54104,Crushonyou,aegwynn,1149,warrior,arms,24,12,12
54105,Azjolnerub,kazzak,1149,warrior,arms,30,12,18
54106,Kâine,blackmoore,1149,warrior,arms,68,27,41
54107,ßigarms,ravencrest,1148,warrior,arms,18,12,6
54108,Kampfente,blackrock,1148,warrior,arms,18,12,6
54109,Соловейч,howling-fjord,1148,warrior,arms,24,13,11
54110,Jonalina,gilneas,1148,warrior,arms,84,42,42
54111,Chillycheesy,blackmoore,1148,warrior,arms,42,12,30
54112,Razyk,zuljin,1147,warrior,arms,22,14,8
54113,Zwerk,rajaxx,1147,warrior,arms,24,12,12
54114,Хирошка,gordunni,1147,warrior,arms,30,12,18
54115,Neoh,onyxia,1146,warrior,arms,51,29,22
54116,Ragedotcom,archimonde,1146,warrior,arms,30,16,14
54117,Draemmer,minahonda,1146,warrior,arms,30,15,15
54118,Senshin,sanguino,1146,warrior,arms,24,12,12
54119,Ragetotem,doomhammer,1146,warrior,arms,24,12,12
54120,Ashecröft,sylvanas,1146,warrior,arms,30,12,18
54121,Rieku,kazzak,1146,warrior,arms,36,12,24
54122,Totenkrieger,draenor,1145,warrior,arms,24,12,12
54123,Gerrmund,silvermoon,1145,warrior,arms,24,12,12
54124,Argadea,archimonde,1145,warrior,arms,42,19,23
54125,Belzebud,kazzak,1145,warrior,arms,36,12,24
54126,Orgi,drakthul,1145,warrior,arms,36,12,24
54127,Aesiva,die-aldor,1144,warrior,arms,30,13,17
54128,Whimbux,stormscale,1144,warrior,arms,32,13,19
54129,Garodis,blackmoore,1144,warrior,arms,30,12,18
54130,Smashu,outland,1143,warrior,arms,18,12,6
54131,Karnacîer,archimonde,1143,warrior,arms,30,19,11
54132,Sephirotth,burning-legion,1142,warrior,arms,24,12,12
54133,Kurzen,voljin,1142,warrior,arms,65,28,37
54134,Brahlus,frostwolf,1142,warrior,arms,31,13,18
54135,Футжисубо,razuvious,1142,warrior,arms,30,12,18
54136,Monsterborn,bloodhoof,1142,warrior,arms,39,15,24
54137,Freestýlz,archimonde,1141,warrior,arms,18,13,5
54138,Auroree,ragnaros,1141,warrior,arms,30,12,18
54139,Онлихелл,howling-fjord,1140,warrior,arms,52,22,30
54140,Alphachadwar,azjolnerub,1140,warrior,arms,30,12,18
54141,Ironsteve,blackmoore,1139,warrior,arms,225,100,125
54142,Realstars,tichondrius,1139,warrior,arms,33,13,20
54143,Анманерка,ashenvale,1137,warrior,arms,30,12,18
54144,Баварриор,greymane,1137,warrior,arms,30,12,18
54145,Kromt,shendralar,1136,warrior,arms,24,15,9
54146,Dödslängtan,terokkar,1136,warrior,arms,46,25,21
54147,Azëlls,archimonde,1136,warrior,arms,100,48,52
54148,Mkazy,kirin-tor,1135,warrior,arms,24,12,12
54149,Addy,twisting-nether,1135,warrior,arms,24,12,12
54150,Shehalk,stormscale,1134,warrior,arms,18,12,6
54151,Xyum,pozzo-delleternità,1133,warrior,arms,72,40,32
54152,Vandnox,nozdormu,1133,warrior,arms,28,13,15
54153,Xensation,kult-der-verdammten,1131,warrior,arms,24,12,12
54154,Medov,outland,1131,warrior,arms,54,23,31
54155,Kratosgr,defias-brotherhood,1129,warrior,arms,24,12,12
54156,Cloudstomper,ravenholdt,1129,warrior,arms,53,23,30
54157,Kugghalfswor,doomhammer,1128,warrior,arms,352,169,183
54158,Katyparry,ragnaros,1127,warrior,arms,36,12,24
54159,Tajiri,alakir,1126,warrior,arms,64,32,32
54160,Gladiattus,drakthul,1126,warrior,arms,42,21,21
54161,Varzeluu,sylvanas,1126,warrior,arms,36,15,21
54162,Сифончик,ashenvale,1126,warrior,arms,30,12,18
54163,Methaniwths,twisting-nether,1125,warrior,arms,42,17,25
54164,Nøøbisator,archimonde,1123,warrior,arms,36,17,19
54165,Пифс,soulflayer,1122,warrior,arms,36,21,15
54166,Yüle,uldaman,1121,warrior,arms,30,15,15
54167,Piedbot,archimonde,1121,warrior,arms,51,18,33
54168,Pøps,hyjal,1120,warrior,arms,26,14,12
54169,Truxiw,silvermoon,1120,warrior,arms,42,19,23
54170,Infusione,nemesis,1119,warrior,arms,18,12,6
54171,Madsizen,ravencrest,1119,warrior,arms,30,12,18
54172,Satanås,silvermoon,1118,warrior,arms,48,25,23
54173,Hofftor,eredar,1118,warrior,arms,24,12,12
54174,Thiccrich,argent-dawn,1117,warrior,arms,48,25,23
54175,Hammerfall,uldum,1117,warrior,arms,54,23,31
54176,Creezê,blackmoore,1117,warrior,arms,30,12,18
54177,Draktul,aegwynn,1116,warrior,arms,24,14,10
54178,Мутобой,soulflayer,1116,warrior,arms,58,25,33
54179,Loosecanon,ravencrest,1116,warrior,arms,29,12,17
54180,Palthor,drakthul,1116,warrior,arms,101,39,62
54181,Vurux,blackrock,1114,warrior,arms,20,13,7
54182,Ärama,sanguino,1114,warrior,arms,30,16,14
54183,Thorkell,genjuros,1114,warrior,arms,30,15,15
54184,Arinator,les-sentinelles,1114,warrior,arms,39,13,26
54185,Diggawhat,antonidas,1109,warrior,arms,78,31,47
54186,Sûgma,blackhand,1108,warrior,arms,44,23,21
54187,Noomel,twisting-nether,1108,warrior,arms,96,48,48
54188,Nyu,kirin-tor,1106,warrior,arms,35,19,16
54189,Smeshh,burning-legion,1105,warrior,arms,42,22,20
54190,Quarantino,ysondre,1105,warrior,arms,110,49,61
54191,Doveloo,kazzak,1104,warrior,arms,31,16,15
54192,Ruppydeluxe,frostwolf,1104,warrior,arms,38,13,25
54193,Inticam,durotan,1103,warrior,arms,43,24,19
54194,Prs,defias-brotherhood,1103,warrior,arms,24,12,12
54195,Миранир,soulflayer,1102,warrior,arms,62,30,32
54196,Røiivar,hyjal,1102,warrior,arms,169,74,95
54197,Керсантус,gordunni,1101,warrior,arms,17,12,5
54198,Dübèl,blackrock,1100,warrior,arms,30,16,14
54199,Доминатори,grom,1100,warrior,arms,55,21,34
54200,Tiopollo,sanguino,1099,warrior,arms,30,12,18
54201,Rutrah,ysondre,1099,warrior,arms,30,12,18
54202,Фастод,greymane,1098,warrior,arms,66,30,36
54203,Zarad,stormreaver,1096,warrior,arms,23,12,11
54204,Crixusxx,sanguino,1096,warrior,arms,25,13,12
54205,Whitebêârd,antonidas,1096,warrior,arms,40,16,24
54206,Fdmachine,kazzak,1095,warrior,arms,48,21,27
54207,Набосуюногу,gordunni,1095,warrior,arms,29,12,17
54208,Vannié,blackhand,1094,warrior,arms,32,14,18
54209,Тонкрик,goldrinn,1093,warrior,arms,30,14,16
54210,Sloppychoppy,silvermoon,1093,warrior,arms,47,19,28
54211,Чухануспрайм,howling-fjord,1093,warrior,arms,34,13,21
54212,Crasher,dentarg,1091,warrior,arms,42,21,21
54213,Копенгаген,ashenvale,1091,warrior,arms,33,13,20
54214,Бижек,gordunni,1085,warrior,arms,20,12,8
54215,Krostapunk,colinas-pardas,1085,warrior,arms,30,13,17
54216,Бежа,gordunni,1083,warrior,arms,66,37,29
54217,Bullburzt,ragnaros,1083,warrior,arms,29,12,17
54218,Uclat,archimonde,1082,warrior,arms,96,42,54
54219,Zogyall,ysondre,1079,warrior,arms,30,12,18
54220,Ezsnacks,blackrock,1078,warrior,arms,62,32,30
54221,Áosr,ravencrest,1076,warrior,arms,82,42,40
54222,Stuble,blackhand,1076,warrior,arms,41,19,22
54223,Jebzmiecza,kazzak,1075,warrior,arms,30,13,17
54224,Chépérøs,kaelthas,1075,warrior,arms,36,13,23
54225,Корофер,galakrond,1072,warrior,arms,29,17,12
54226,Teraa,the-maelstrom,1072,warrior,arms,54,30,24
54227,Brandylover,outland,1071,warrior,arms,26,12,14
54228,Difalco,archimonde,1069,warrior,arms,89,43,46
54229,Joka,dun-modr,1069,warrior,arms,59,26,33
54230,Вилькария,eversong,1067,warrior,arms,28,12,16
54231,Optitt,dethecus,1066,warrior,arms,35,12,23
54232,Obscurìa,argent-dawn,1065,warrior,arms,198,93,105
54233,Diliul,doomhammer,1065,warrior,arms,40,18,22
54234,Endermite,magtheridon,1065,warrior,arms,59,26,33
54235,Дикийлёха,soulflayer,1064,warrior,arms,36,18,18
54236,Etharedon,kul-tiras,1062,warrior,arms,70,28,42
54237,Милославский,gordunni,1061,warrior,arms,52,25,27
54238,Katzz,dun-morogh,1061,warrior,arms,44,15,29
54239,Atelier,magtheridon,1059,warrior,arms,48,24,24
54240,Keksparrow,antonidas,1059,warrior,arms,36,16,20
54241,Рексторм,soulflayer,1056,warrior,arms,12,11,1
54242,Klnrk,ravencrest,1056,warrior,arms,18,11,7
54243,Proeliator,argent-dawn,1056,warrior,arms,24,11,13
54244,Magmos,terenas,1056,warrior,arms,24,11,13
54245,Êphêý,kazzak,1056,warrior,arms,24,11,13
54246,Tyrasia,hyjal,1056,warrior,arms,24,11,13
54247,Recklesnes,kazzak,1056,warrior,arms,30,11,19
54248,Gotural,ravencrest,1055,warrior,arms,12,11,1
54249,Ufu,outland,1055,warrior,arms,18,11,7
54250,Sanerion,antonidas,1055,warrior,arms,18,11,7
54251,Hannìbal,ravencrest,1055,warrior,arms,18,11,7
54252,Тарартзу,soulflayer,1055,warrior,arms,18,11,7
54253,Анархорок,howling-fjord,1055,warrior,arms,18,11,7
54254,Détaire,archimonde,1055,warrior,arms,18,11,7
54255,Maisner,stormscale,1055,warrior,arms,21,12,9
54256,Justyòqt,archimonde,1055,warrior,arms,24,11,13
54257,Quotxwar,stormscale,1055,warrior,arms,24,11,13
54258,Bikgusdickus,drakthul,1055,warrior,arms,24,11,13
54259,Лимор,howling-fjord,1055,warrior,arms,24,11,13
54260,Taoke,ravencrest,1055,warrior,arms,24,11,13
54261,Амаззони,howling-fjord,1055,warrior,arms,24,11,13
54262,Falconer,ravencrest,1055,warrior,arms,36,11,25
54263,Beanzz,blackmoore,1054,warrior,arms,18,11,7
54264,Ramlosa,stormscale,1054,warrior,arms,18,11,7
54265,Imglad,ragnaros,1054,warrior,arms,18,11,7
54266,Tiimbs,tarren-mill,1054,warrior,arms,18,11,7
54267,Gorelaw,turalyon,1054,warrior,arms,24,11,13
54268,Багрон,goldrinn,1054,warrior,arms,24,11,13
54269,Trohr,blackmoore,1054,warrior,arms,24,11,13
54270,Râmi,perenolde,1054,warrior,arms,24,11,13
54271,Chàrgex,blackrock,1054,warrior,arms,27,12,15
54272,Apollos,der-mithrilorden,1054,warrior,arms,30,11,19
54273,Guter,kazzak,1054,warrior,arms,30,11,19
54274,Сабствер,howling-fjord,1054,warrior,arms,30,11,19
54275,Vallenwar,twisting-nether,1053,warrior,arms,18,11,7
54276,Astost,silvermoon,1053,warrior,arms,18,11,7
54277,Fullkraft,tarren-mill,1053,warrior,arms,60,29,31
54278,Skaylulz,ragnaros,1053,warrior,arms,24,11,13
54279,Khoroc,die-aldor,1053,warrior,arms,30,11,19
54280,Scusi,burning-blade,1053,warrior,arms,30,11,19
54281,Amarthon,sylvanas,1053,warrior,arms,33,12,21
54282,Salamandar,zenedar,1053,warrior,arms,36,11,25
54283,Polak,tirion,1052,warrior,arms,24,11,13
54284,Каутто,howling-fjord,1052,warrior,arms,24,11,13
54285,Opticsynfel,argent-dawn,1052,warrior,arms,24,11,13
54286,Artheim,silvermoon,1052,warrior,arms,24,11,13
54287,Някитила,gordunni,1052,warrior,arms,43,18,25
54288,Gnomekek,sylvanas,1052,warrior,arms,30,11,19
54289,Swayzze,frostwolf,1052,warrior,arms,30,11,19
54290,Deathwingx,azuremyst,1052,warrior,arms,33,12,21
54291,Jamakun,magtheridon,1051,warrior,arms,18,11,7
54292,Blackaxe,sylvanas,1051,warrior,arms,18,11,7
54293,Deviousjr,ragnaros,1051,warrior,arms,18,11,7
54294,Ramhadat,hyjal,1051,warrior,arms,18,11,7
54295,Kundan,antonidas,1051,warrior,arms,24,14,10
54296,Hgfe,doomhammer,1051,warrior,arms,24,11,13
54297,Suksori,kazzak,1051,warrior,arms,24,11,13
54298,Bønecleaver,blackrock,1051,warrior,arms,24,11,13
54299,Шорпит,howling-fjord,1051,warrior,arms,66,26,40
54300,Pwettygal,tarren-mill,1051,warrior,arms,54,21,33
54301,Rebiy,ravencrest,1050,warrior,arms,24,11,13
54302,Grimarg,drakthul,1050,warrior,arms,24,11,13
54303,Chocoroko,draenor,1050,warrior,arms,48,21,27
54304,Ironsíde,alakir,1050,warrior,arms,30,11,19
54305,Ètc,ravencrest,1049,warrior,arms,18,11,7
54306,Blackin,blackmoore,1049,warrior,arms,18,11,7
54307,Bämoida,eredar,1049,warrior,arms,24,11,13
54308,Nêithan,dun-modr,1049,warrior,arms,30,12,18
54309,Warrmax,darksorrow,1048,warrior,arms,24,11,13
54310,Clukao,kazzak,1047,warrior,arms,30,11,19
54311,Darksworn,alleria,1046,warrior,arms,18,11,7
54312,Askawar,sylvanas,1046,warrior,arms,24,11,13
54313,Supersonîc,aegwynn,1046,warrior,arms,24,11,13
54314,Velikan,tarren-mill,1046,warrior,arms,30,11,19
54315,Sàt,kazzak,1045,warrior,arms,18,11,7
54316,Roponmatsu,draenor,1045,warrior,arms,24,11,13
54317,Ninja,bronze-dragonflight,1045,warrior,arms,24,11,13
54318,Orquewarrior,stormscale,1045,warrior,arms,30,11,19
54319,Perry,proudmoore,1044,warrior,arms,18,11,7
54320,Arkcules,ghostlands,1044,warrior,arms,24,11,13
54321,Darkwa,azjolnerub,1044,warrior,arms,24,11,13
54322,Pitii,burning-legion,1044,warrior,arms,26,11,15
54323,Тассэй,eversong,1044,warrior,arms,30,11,19
54324,Masster,argent-dawn,1043,warrior,arms,18,11,7
54325,Nocturia,archimonde,1043,warrior,arms,30,11,19
54326,Unstorm,drakthul,1043,warrior,arms,36,11,25
54327,Gpointt,lordaeron,1042,warrior,arms,54,19,35
54328,Ethem,twisting-nether,1041,warrior,arms,109,59,50
54329,Pips,minahonda,1041,warrior,arms,42,13,29
54330,Talaganos,twisting-nether,1040,warrior,arms,31,17,14
54331,Blufurys,nemesis,1040,warrior,arms,50,22,28
54332,Stweye,frostmane,1038,warrior,arms,24,11,13
54333,Nokturnâl,silvermoon,1037,warrior,arms,18,11,7
54334,Каргром,howling-fjord,1036,warrior,arms,23,11,12
54335,Stampsalot,deathwing,1036,warrior,arms,24,11,13
54336,Twinblyat,defias-brotherhood,1036,warrior,arms,24,11,13
54337,Koorkhan,outland,1036,warrior,arms,24,11,13
54338,Ariéz,tarren-mill,1035,warrior,arms,23,12,11
54339,Metawar,blackhand,1035,warrior,arms,30,11,19
54340,Kval,kazzak,1034,warrior,arms,24,11,13
54341,Ferrum,sunstrider,1033,warrior,arms,24,11,13
54342,Wargasm,burning-blade,1032,warrior,arms,18,11,7
54343,Глинм,gordunni,1032,warrior,arms,107,46,61
54344,Zugpump,tarren-mill,1031,warrior,arms,22,12,10
54345,Dardi,blackrock,1030,warrior,arms,24,11,13
54346,Raizø,aegwynn,1030,warrior,arms,31,13,18
54347,Brvbert,antonidas,1029,warrior,arms,24,11,13
54348,Téarz,blackrock,1029,warrior,arms,54,20,34
54349,Утонаган,fordragon,1029,warrior,arms,30,11,19
54350,Beserk,defias-brotherhood,1027,warrior,arms,46,28,18
54351,Merdé,blackhand,1027,warrior,arms,135,67,68
54352,Cliwar,ragnaros,1026,warrior,arms,30,17,13
54353,Fatbeard,twilights-hammer,1026,warrior,arms,24,11,13
54354,Dariusvolt,argent-dawn,1025,warrior,arms,65,33,32
54355,Tochka,kazzak,1024,warrior,arms,36,11,25
54356,Lanahan,argent-dawn,1023,warrior,arms,17,11,6
54357,Sanhaevel,ravencrest,1023,warrior,arms,33,15,18
54358,Lakes,eredar,1023,warrior,arms,35,11,24
54359,Carsannies,stormscale,1022,warrior,arms,121,53,68
54360,Acestrike,defias-brotherhood,1021,warrior,arms,18,11,7
54361,Matthaeos,nemesis,1019,warrior,arms,17,13,4
54362,Xxoorrwarr,tarren-mill,1018,warrior,arms,25,13,12
54363,Клавиатурный,soulflayer,1018,warrior,arms,29,11,18
54364,Oralinde,silvermoon,1017,warrior,arms,78,43,35
54365,Ironfists,kilrogg,1017,warrior,arms,24,11,13
54366,Тычо,soulflayer,1016,warrior,arms,48,20,28
54367,Troncodepino,nemesis,1016,warrior,arms,30,11,19
54368,Tercio,exodar,1015,warrior,arms,91,38,53
54369,Henzelhoff,stormreaver,1013,warrior,arms,16,11,5
54370,Rabiolika,sanguino,1012,warrior,arms,23,11,12
54371,Tobigforu,draenor,1012,warrior,arms,28,13,15
54372,Addicty,sylvanas,1012,warrior,arms,67,31,36
54373,Smkw,kazzak,1011,warrior,arms,30,19,11
54374,Raldjorn,hyjal,1010,warrior,arms,24,13,11
54375,Chatoon,elune,1010,warrior,arms,45,24,21
54376,Shinydjuwlz,turalyon,1008,warrior,arms,18,11,7
54377,Бейесличё,deathguard,1007,warrior,arms,27,12,15
54378,Зарган,howling-fjord,1007,warrior,arms,59,24,35
54379,Falcowar,minahonda,1006,warrior,arms,24,11,13
54380,Розети,gordunni,1005,warrior,arms,23,11,12
54381,Antraex,zuljin,1004,warrior,arms,30,13,17
54382,Gatlok,kazzak,1001,warrior,arms,24,11,13
54383,Dénis,onyxia,1000,warrior,arms,30,15,15
54384,Seraphys,ravencrest,998,warrior,arms,28,12,16
54385,Voltrim,blackmoore,995,warrior,arms,24,11,13
54386,Gunka,tarren-mill,995,warrior,arms,56,23,33
54387,Orchëstre,eitrigg,994,warrior,arms,155,82,73
54388,Adrï,draenor,993,warrior,arms,70,38,32
54389,Ezjau,blackmoore,993,warrior,arms,96,48,48
54390,Sepsys,eredar,991,warrior,arms,48,15,33
54391,Párta,ravencrest,990,warrior,arms,22,11,11
54392,Knotteddickk,teldrassil,989,warrior,arms,23,11,12
54393,Larkor,frostwolf,989,warrior,arms,79,31,48
54394,Geicoo,dalaran,988,warrior,arms,56,29,27
54395,Vyctimz,ravencrest,988,warrior,arms,22,11,11
54396,Lithanør,silvermoon,984,warrior,arms,32,11,21
54397,Odonko,blackmoore,982,warrior,arms,42,20,22
54398,Dazed,kazzak,981,warrior,arms,26,14,12
54399,Nélow,khaz-modan,980,warrior,arms,30,11,19
54400,Oldhatreds,twisting-nether,979,warrior,arms,22,11,11
54401,Fairly,burning-blade,977,warrior,arms,24,12,12
54402,Braûsepulver,guldan,970,warrior,arms,36,17,19
54403,Tinkley,quelthalas,969,warrior,arms,21,11,10
54404,Ruga,echsenkessel,969,warrior,arms,61,29,32
54405,Hammerfíst,kazzak,966,warrior,arms,83,40,43
54406,Chipstjuven,tarren-mill,963,warrior,arms,25,11,14
54407,Valtýr,skullcrusher,961,warrior,arms,29,17,12
54408,Dreadshanks,doomhammer,961,warrior,arms,60,31,29
54409,Executeme,sylvanas,961,warrior,arms,36,18,18
54410,Bigschnäbi,blackhand,960,warrior,arms,12,10,2
54411,Schero,aegwynn,960,warrior,arms,12,10,2
54412,Pyrit,blackhand,960,warrior,arms,12,10,2
54413,Wintertimex,stormscale,960,warrior,arms,12,10,2
54414,Каоссвар,howling-fjord,960,warrior,arms,18,10,8
54415,Broarextiger,ragnaros,960,warrior,arms,18,10,8
54416,Jà,kazzak,960,warrior,arms,18,10,8
54417,Milant,antonidas,960,warrior,arms,18,10,8
54418,Joelopes,archimonde,960,warrior,arms,18,10,8
54419,Фокатопх,blackscar,960,warrior,arms,18,10,8
54420,Andabad,silvermoon,960,warrior,arms,24,10,14
54421,Meovv,saurfang,960,warrior,arms,24,10,14
54422,Belfodil,outland,960,warrior,arms,24,10,14
54423,Trâshcârlitâ,eredar,960,warrior,arms,24,10,14
54424,Salpaaja,tarren-mill,960,warrior,arms,24,10,14
54425,Tomsom,sanguino,960,warrior,arms,24,10,14
54426,Sindrener,ysondre,960,warrior,arms,30,10,20
54427,Sereiz,tarren-mill,960,warrior,arms,30,10,20
54428,Anahkäs,archimonde,960,warrior,arms,30,10,20
54429,Mbappé,dragonblight,959,warrior,arms,12,10,2
54430,Bjergo,drakthul,959,warrior,arms,16,11,5
54431,Badwarr,blackhand,959,warrior,arms,18,10,8
54432,Экспла,ashenvale,959,warrior,arms,18,10,8
54433,Boonur,arthas,959,warrior,arms,18,10,8
54434,Fearmedear,sylvanas,959,warrior,arms,18,10,8
54435,Axxtm,ravencrest,959,warrior,arms,18,10,8
54436,Zdi,blackrock,959,warrior,arms,18,10,8
54437,Mocomomo,argent-dawn,959,warrior,arms,18,10,8
54438,Ym,twisting-nether,959,warrior,arms,18,10,8
54439,Chadgrave,argent-dawn,959,warrior,arms,18,10,8
54440,Брюслипве,gordunni,959,warrior,arms,18,10,8
54441,Yoñtuk,twisting-nether,959,warrior,arms,18,10,8
54442,Najjs,eredar,959,warrior,arms,18,10,8
54443,Duckyone,zenedar,959,warrior,arms,18,10,8
54444,Rookian,blackrock,959,warrior,arms,24,10,14
54445,Grdez,archimonde,959,warrior,arms,24,10,14
54446,Оманко,howling-fjord,959,warrior,arms,24,10,14
54447,Vlorgboi,drakthul,959,warrior,arms,24,10,14
54448,Warhero,burning-legion,959,warrior,arms,24,10,14
54449,Tenvee,outland,959,warrior,arms,24,10,14
54450,Creativenot,outland,959,warrior,arms,24,10,14
54451,Nolóve,archimonde,959,warrior,arms,24,10,14
54452,Kryszii,ragnaros,959,warrior,arms,24,10,14
54453,Carksn,blackmoore,959,warrior,arms,28,11,17
54454,Péridotruite,hyjal,959,warrior,arms,30,10,20
54455,Garou,uldum,958,warrior,arms,12,10,2
54456,Fiverare,stormscale,958,warrior,arms,18,10,8
54457,Shorrag,outland,958,warrior,arms,18,10,8
54458,Darlith,azshara,958,warrior,arms,18,10,8
54459,Hyogan,malganis,958,warrior,arms,18,10,8
54460,Nainculay,kaelthas,958,warrior,arms,18,10,8
54461,Rswar,archimonde,958,warrior,arms,18,10,8
54462,Gorlemar,blackmoore,958,warrior,arms,18,10,8
54463,Braindeady,burning-legion,958,warrior,arms,18,10,8
54464,Krônôs,thrall,958,warrior,arms,18,10,8
54465,Hanna,argent-dawn,958,warrior,arms,18,10,8
54466,Xilquib,darksorrow,958,warrior,arms,18,10,8
54467,Betonica,burning-legion,958,warrior,arms,18,10,8
54468,Hamilton,bronzebeard,958,warrior,arms,18,10,8
54469,Порицающий,soulflayer,958,warrior,arms,22,11,11
54470,Ghettogødx,outland,958,warrior,arms,24,10,14
54471,Warristyles,arygos,958,warrior,arms,24,10,14
54472,Gruxx,ragnaros,958,warrior,arms,24,10,14
54473,Yatõ,blackmoore,958,warrior,arms,24,10,14
54474,Onidrake,nemesis,958,warrior,arms,24,10,14
54475,Leapling,blackmoore,958,warrior,arms,24,10,14
54476,Хамерртайм,goldrinn,958,warrior,arms,24,10,14
54477,Geroldius,silvermoon,958,warrior,arms,30,10,20
54478,Rowr,argent-dawn,958,warrior,arms,30,10,20
54479,Adamchen,blackmoore,958,warrior,arms,30,10,20
54480,Teljii,blackmoore,957,warrior,arms,16,11,5
54481,Дотаветеран,soulflayer,957,warrior,arms,18,10,8
54482,Makote,uldum,957,warrior,arms,18,10,8
54483,Каштоуны,howling-fjord,957,warrior,arms,18,10,8
54484,Клоузер,blackscar,957,warrior,arms,23,11,12
54485,Draer,sanguino,957,warrior,arms,23,11,12
54486,Becca,rexxar,957,warrior,arms,24,10,14
54487,Grokalus,eredar,957,warrior,arms,24,10,14
54488,Ðam,kazzak,957,warrior,arms,24,10,14
54489,Testonator,outland,957,warrior,arms,24,10,14
54490,Sanguìnius,nemesis,957,warrior,arms,30,10,20
54491,Cucøriedka,burning-blade,957,warrior,arms,36,10,26
54492,Lucasqt,magtheridon,956,warrior,arms,18,10,8
54493,Roshas,twisting-nether,956,warrior,arms,18,10,8
54494,Quihc,outland,956,warrior,arms,24,10,14
54495,Utero,drakthul,956,warrior,arms,24,10,14
54496,Асхана,howling-fjord,955,warrior,arms,18,10,8
54497,Deanx,ragnaros,955,warrior,arms,18,10,8
54498,Nightbeard,twisting-nether,955,warrior,arms,18,10,8
54499,Gramrosh,eredar,955,warrior,arms,24,10,14
54500,Onefourthree,silvermoon,955,warrior,arms,24,10,14
54501,Xarmog,hyjal,955,warrior,arms,24,10,14
54502,Genç,ysondre,955,warrior,arms,24,10,14
54503,Scill,silvermoon,955,warrior,arms,30,11,19
54504,Neíd,malganis,955,warrior,arms,30,10,20
54505,Heavenheart,bronzebeard,954,warrior,arms,19,13,6
54506,Smob,ragnaros,954,warrior,arms,18,10,8
54507,Solle,blackrock,954,warrior,arms,18,10,8
54508,Brutalz,kazzak,954,warrior,arms,18,10,8
54509,Lapyy,drakthul,954,warrior,arms,30,16,14
54510,Труперсила,howling-fjord,954,warrior,arms,24,10,14
54511,Protecmoo,drakthul,954,warrior,arms,24,10,14
54512,Ôwndbylx,aegwynn,954,warrior,arms,27,11,16
54513,Vlajko,kazzak,954,warrior,arms,36,13,23
54514,Yngvar,darksorrow,954,warrior,arms,30,10,20
54515,Rukkeg,silvermoon,954,warrior,arms,30,10,20
54516,Zelwar,drakthul,953,warrior,arms,19,13,6
54517,Camaon,outland,953,warrior,arms,18,10,8
54518,Spaceløl,archimonde,953,warrior,arms,24,11,13
54519,Mangonneau,archimonde,953,warrior,arms,24,10,14
54520,Vrokoda,quelthalas,953,warrior,arms,24,10,14
54521,Blanchysnow,hyjal,952,warrior,arms,18,10,8
54522,Decreased,dun-modr,952,warrior,arms,18,10,8
54523,Ginò,stormscale,952,warrior,arms,18,10,8
54524,Unkmòr,pozzo-delleternità,952,warrior,arms,42,22,20
54525,Rayenna,dalaran,951,warrior,arms,12,10,2
54526,Zerm,draenor,949,warrior,arms,18,10,8
54527,Хьялдэргодр,deathguard,949,warrior,arms,24,10,14
54528,Zargala,stormscale,948,warrior,arms,18,10,8
54529,Зуботычник,gordunni,948,warrior,arms,18,10,8
54530,Qvil,sanguino,948,warrior,arms,93,31,62
54531,Obitron,argent-dawn,947,warrior,arms,24,10,14
54532,Omglolnoob,magtheridon,946,warrior,arms,26,10,16
54533,Mistawolf,ravencrest,946,warrior,arms,30,10,20
54534,Jackycoke,blackhand,943,warrior,arms,30,10,20
54535,Dorya,aegwynn,942,warrior,arms,23,10,13
54536,Arschal,khaz-modan,941,warrior,arms,20,12,8
54537,Pedergun,defias-brotherhood,940,warrior,arms,18,10,8
54538,Илийя,razuvious,940,warrior,arms,29,10,19
54539,Ugbruk,blackhand,938,warrior,arms,27,12,15
54540,Иалаи,howling-fjord,934,warrior,arms,20,10,10
54541,Pigleto,ravencrest,933,warrior,arms,45,20,25
54542,Vooice,sylvanas,933,warrior,arms,29,10,19
54543,Bubciu,burning-legion,932,warrior,arms,30,10,20
54544,Välkyries,archimonde,931,warrior,arms,16,11,5
54545,Йомхар,howling-fjord,931,warrior,arms,30,10,20
54546,Kvanyrius,archimonde,930,warrior,arms,36,10,26
54547,Bòónki,ravencrest,929,warrior,arms,84,38,46
54548,Thewitcher,stormscale,928,warrior,arms,24,10,14
54549,Ganik,malganis,927,warrior,arms,23,10,13
54550,Arowpoint,doomhammer,925,warrior,arms,23,10,13
54551,Тибат,howling-fjord,924,warrior,arms,23,10,13
54552,Léonie,arakarahm,924,warrior,arms,23,10,13
54553,Avïlîa,dalaran,922,warrior,arms,30,10,20
54554,Dearmooses,stormscale,920,warrior,arms,36,18,18
54555,Orcaz,eredar,920,warrior,arms,30,10,20
54556,Shãne,ysondre,918,warrior,arms,22,10,12
54557,Abelgf,exodar,918,warrior,arms,32,12,20
54558,Tengriy,wildhammer,915,warrior,arms,14,11,3
54559,Takashia,ravencrest,915,warrior,arms,22,11,11
54560,Midgardsormr,blackrock,913,warrior,arms,23,10,13
54561,Avgålöfvén,stormscale,912,warrior,arms,15,11,4
54562,Rejectofrage,ragnaros,912,warrior,arms,54,24,30
54563,Zouo,blackhand,911,warrior,arms,23,10,13
54564,Mölntuss,emeriss,911,warrior,arms,29,10,19
54565,Dolforden,burning-legion,907,warrior,arms,23,10,13
54566,Durmithor,silvermoon,906,warrior,arms,35,10,25
54567,Энлами,gordunni,905,warrior,arms,21,10,11
54568,Zêrklatscher,lordaeron,905,warrior,arms,48,12,36
54569,Искристый,howling-fjord,903,warrior,arms,18,11,7
54570,Cryze,ravencrest,903,warrior,arms,21,10,11
54571,Cowlunderowl,tarren-mill,900,warrior,arms,32,11,21
54572,Warsky,archimonde,898,warrior,arms,36,18,18
54573,Zalhym,archimonde,898,warrior,arms,33,10,23
54574,Брамон,gordunni,896,warrior,arms,16,10,6
54575,Manymen,outland,896,warrior,arms,66,27,39
54576,Dreadstyle,burning-legion,895,warrior,arms,21,10,11
54577,Razecraz,ysondre,894,warrior,arms,18,11,7
54578,Rapidinhas,aggra-português,890,warrior,arms,16,10,6
54579,Биграма,howling-fjord,890,warrior,arms,26,10,16
54580,Tynyas,dalaran,888,warrior,arms,36,18,18
54581,Perseó,minahonda,888,warrior,arms,54,16,38
54582,Рагнарульв,gordunni,885,warrior,arms,14,10,4
54583,Elendurel,outland,884,warrior,arms,17,10,7
54584,Дотрен,galakrond,883,warrior,arms,42,20,22
54585,Артэгиусх,blackscar,880,warrior,arms,51,19,32
54586,Lynton,sylvanas,879,warrior,arms,25,10,15
54587,Обиванкенобя,soulflayer,879,warrior,arms,32,10,22
54588,Ехасе,gordunni,875,warrior,arms,22,10,12
54589,Spartazo,turalyon,873,warrior,arms,48,18,30
54590,Авврорра,gordunni,871,warrior,arms,54,27,27
54591,Sangarane,archimonde,868,warrior,arms,27,14,13
54592,Bazsika,ragnaros,865,warrior,arms,66,23,43
54593,Warmupfirst,ravencrest,864,warrior,arms,12,9,3
54594,Zäløøpå,kazzak,864,warrior,arms,12,9,3
54595,Antìcìdè,ravencrest,864,warrior,arms,12,9,3
54596,Marqinios,archimonde,864,warrior,arms,12,9,3
54597,Jhoakim,argent-dawn,864,warrior,arms,12,9,3
54598,Naum,draenor,864,warrior,arms,12,9,3
54599,Drvx,twisting-nether,864,warrior,arms,12,9,3
54600,Тьмасвятая,gordunni,864,warrior,arms,18,9,9
54601,Precel,burning-legion,864,warrior,arms,18,9,9
54602,Легендор,howling-fjord,864,warrior,arms,18,9,9
54603,Melogranod,nemesis,864,warrior,arms,18,9,9
54604,Knoutt,burning-legion,864,warrior,arms,18,9,9
54605,Bonza,blackrock,864,warrior,arms,18,9,9
54606,Bâyer,burning-legion,864,warrior,arms,18,9,9
54607,Albwarr,kazzak,864,warrior,arms,18,9,9
54608,Джамалли,howling-fjord,864,warrior,arms,18,9,9
54609,Quadfather,kazzak,864,warrior,arms,18,9,9
54610,Jeax,rexxar,864,warrior,arms,18,9,9
54611,Данзетар,howling-fjord,864,warrior,arms,18,9,9
54612,Émalkay,tarren-mill,864,warrior,arms,18,9,9
54613,Firience,silvermoon,864,warrior,arms,18,9,9
54614,Necrio,kazzak,864,warrior,arms,18,9,9
54615,Donkeymeta,frostmane,864,warrior,arms,18,9,9
54616,Zorn,blackmoore,864,warrior,arms,18,9,9
54617,Vampviv,tarren-mill,864,warrior,arms,18,9,9
54618,Erickson,tarren-mill,864,warrior,arms,24,9,15
54619,Dmgsponge,stormscale,864,warrior,arms,24,9,15
54620,Yseras,aegwynn,864,warrior,arms,24,9,15
54621,Catrine,drakthul,864,warrior,arms,24,9,15
54622,Сетт,howling-fjord,864,warrior,arms,24,9,15
54623,Vikktor,doomhammer,864,warrior,arms,24,9,15
54624,Brigitá,argent-dawn,864,warrior,arms,24,9,15
54625,Vajira,blackrock,864,warrior,arms,24,9,15
54626,Tenthøusand,sylvanas,864,warrior,arms,24,9,15
54627,Спуллае,soulflayer,863,warrior,arms,12,9,3
54628,Пиапиа,gordunni,863,warrior,arms,12,9,3
54629,Bigbosscho,draenor,863,warrior,arms,12,9,3
54630,Ølolo,stormscale,863,warrior,arms,12,9,3
54631,Theolcostaud,archimonde,863,warrior,arms,18,9,9
54632,Warbigboss,draenor,863,warrior,arms,18,9,9
54633,Wisemanx,draenor,863,warrior,arms,18,9,9
54634,Дейниксис,howling-fjord,863,warrior,arms,18,9,9
54635,Bladesmiths,argent-dawn,863,warrior,arms,18,9,9
54636,Zuuk,malganis,863,warrior,arms,18,9,9
54637,Punisherhulk,stormscale,863,warrior,arms,18,9,9
54638,Elpap,draenor,863,warrior,arms,18,9,9
54639,Астерио,blackscar,863,warrior,arms,18,9,9
54640,Kaloche,hyjal,863,warrior,arms,18,9,9
54641,Pacheco,eredar,863,warrior,arms,21,10,11
54642,Ajhogan,ravencrest,863,warrior,arms,24,9,15
54643,Getjuiced,tarren-mill,863,warrior,arms,24,9,15
54644,Øzak,outland,863,warrior,arms,24,9,15
54645,Johnfogerty,twisting-nether,863,warrior,arms,24,9,15
54646,Belmont,doomhammer,863,warrior,arms,24,9,15
54647,Sanca,naxxramas,863,warrior,arms,24,9,15
54648,Nârmøra,thrall,863,warrior,arms,24,9,15
54649,Nyxo,argent-dawn,863,warrior,arms,30,9,21
54650,Mecaguarro,dun-modr,862,warrior,arms,12,9,3
54651,Adalyn,azjolnerub,862,warrior,arms,12,9,3
54652,Ratko,blackmoore,862,warrior,arms,20,12,8
54653,Prag,silvermoon,862,warrior,arms,22,11,11
54654,Bedryl,burning-legion,862,warrior,arms,18,9,9
54655,Манхув,gordunni,862,warrior,arms,18,9,9
54656,Veeg,blackmoore,862,warrior,arms,18,9,9
54657,Mòrdréd,kazzak,862,warrior,arms,18,9,9
54658,Onkra,malganis,862,warrior,arms,18,9,9
54659,Delarosa,drakthul,862,warrior,arms,18,9,9
54660,Bekkey,lightbringer,862,warrior,arms,24,9,15
54661,Fluffycute,blackhand,862,warrior,arms,24,9,15
54662,Realdrdob,kazzak,862,warrior,arms,24,9,15
54663,Vazzle,nethersturm,862,warrior,arms,30,9,21
54664,Diablozhørs,ysondre,861,warrior,arms,12,9,3
54665,Slowfeet,stormscale,861,warrior,arms,12,9,3
54666,Nêgan,stormscale,861,warrior,arms,18,9,9
54667,Legendfury,ravencrest,861,warrior,arms,18,9,9
54668,Sax,ravencrest,861,warrior,arms,18,9,9
54669,Axemurdererr,draenor,861,warrior,arms,18,9,9
54670,Santorro,drakthul,861,warrior,arms,24,9,15
54671,Amar,defias-brotherhood,861,warrior,arms,29,10,19
54672,Bigbaduglyy,twisting-nether,861,warrior,arms,30,9,21
54673,Bravest,ragnaros,860,warrior,arms,18,9,9
54674,Hexzo,ravencrest,860,warrior,arms,18,9,9
54675,Andoror,nemesis,860,warrior,arms,18,9,9
54676,Bezark,kazzak,860,warrior,arms,18,9,9
54677,Казырной,soulflayer,860,warrior,arms,24,9,15
54678,Gealt,outland,860,warrior,arms,24,9,15
54679,Woopzi,twisting-nether,860,warrior,arms,36,9,27
54680,Dautis,dun-modr,859,warrior,arms,15,10,5
54681,Stits,chromaggus,859,warrior,arms,18,9,9
54682,Фогивэн,gordunni,859,warrior,arms,18,9,9
54683,Маханхет,soulflayer,859,warrior,arms,24,9,15
54684,Brúgar,antonidas,859,warrior,arms,24,9,15
54685,Дрекзот,howling-fjord,858,warrior,arms,15,10,5
54686,Crud,die-silberne-hand,858,warrior,arms,18,9,9
54687,Ozok,blackrock,858,warrior,arms,24,9,15
54688,Radge,hyjal,858,warrior,arms,24,9,15
54689,Rojobull,stormscale,858,warrior,arms,24,9,15
54690,Kronnosh,tarren-mill,857,warrior,arms,12,9,3
54691,Варбыкмашина,howling-fjord,857,warrior,arms,18,9,9
54692,Marcusk,thunderhorn,857,warrior,arms,24,9,15
54693,Goragthor,thrall,856,warrior,arms,18,9,9
54694,Raivorouva,stormreaver,856,warrior,arms,18,9,9
54695,Chrimo,silvermoon,856,warrior,arms,30,9,21
54696,Бравурный,gordunni,855,warrior,arms,18,9,9
54697,Gucix,tarren-mill,855,warrior,arms,18,9,9
54698,Wfx,kazzak,855,warrior,arms,18,9,9
54699,Kixx,twisting-nether,855,warrior,arms,30,14,16
54700,Pvpstyle,bloodscalp,855,warrior,arms,24,9,15
54701,Lurádin,kargath,855,warrior,arms,24,9,15
54702,Kreaten,chamber-of-aspects,855,warrior,arms,66,18,48
54703,Demonraze,hyjal,854,warrior,arms,12,9,3
54704,Discogoon,twilights-hammer,854,warrior,arms,87,32,55
54705,Ruuster,norgannon,853,warrior,arms,30,9,21
54706,Janeu,nozdormu,852,warrior,arms,18,9,9
54707,Syforce,ravencrest,850,warrior,arms,18,9,9
54708,Nakroll,sanguino,850,warrior,arms,24,9,15
54709,Goodvibez,silvermoon,848,warrior,arms,30,9,21
54710,Owarr,grim-batol,847,warrior,arms,12,9,3
54711,Bashion,ghostlands,846,warrior,arms,30,10,20
54712,Aemirage,doomhammer,842,warrior,arms,54,27,27
54713,Badazz,thunderhorn,842,warrior,arms,24,9,15
54714,Xienia,dun-morogh,841,warrior,arms,30,10,20
54715,Îwar,ysondre,837,warrior,arms,42,9,33
54716,Marciano,dalaran,835,warrior,arms,18,9,9
54717,Discotrosan,outland,833,warrior,arms,25,9,16
54718,Takeashower,hyjal,831,warrior,arms,20,10,10
54719,Leesh,ravenholdt,830,warrior,arms,24,10,14
54720,Ajgreedy,grim-batol,829,warrior,arms,23,9,14
54721,Greeneroi,khaz-modan,829,warrior,arms,35,9,26
54722,Overdose,anetheron,827,warrior,arms,17,10,7
54723,Зед,blackscar,827,warrior,arms,25,13,12
54724,Nelfx,aggra-português,822,warrior,arms,48,21,27
54725,Рукзуф,razuvious,815,warrior,arms,11,9,2
54726,Rødprincê,ravencrest,815,warrior,arms,15,9,6
54727,Tanoras,kazzak,815,warrior,arms,17,9,8
54728,Airowar,drakthul,815,warrior,arms,17,9,8
54729,Madswarrior,tarren-mill,814,warrior,arms,17,9,8
54730,Athérøs,outland,814,warrior,arms,23,9,14
54731,Андервульф,booty-bay,814,warrior,arms,23,9,14
54732,Erenowski,twisting-nether,813,warrior,arms,18,9,9
54733,Математик,razuvious,802,warrior,arms,21,10,11
54734,Actuallyorc,twisting-nether,799,warrior,arms,14,9,5
54735,Слэймодх,howling-fjord,799,warrior,arms,17,9,8
54736,Skullhammer,burning-legion,799,warrior,arms,24,9,15
54737,Ahmedmohsen,kazzak,796,warrior,arms,20,9,11
54738,Scud,frostwhisper,796,warrior,arms,22,9,13
54739,Knego,ragnaros,793,warrior,arms,11,9,2
54740,Kallor,burning-legion,793,warrior,arms,17,9,8
54741,Fknmoo,kazzak,793,warrior,arms,24,9,15
54742,Кейнорин,howling-fjord,789,warrior,arms,28,9,19
54743,Finalsmasher,thrall,784,warrior,arms,42,16,26
54744,Diolucido,shattered-hand,782,warrior,arms,19,9,10
54745,Panduf,rashgarroth,781,warrior,arms,11,9,2
54746,Dlstroyer,eonar,776,warrior,arms,24,10,14
54747,Bulfwart,zuljin,768,warrior,arms,12,8,4
54748,Éliøkor,outland,768,warrior,arms,12,8,4
54749,Rageside,draenor,768,warrior,arms,12,8,4
54750,Curelia,malganis,768,warrior,arms,12,8,4
54751,Kultywator,silvermoon,768,warrior,arms,12,8,4
54752,Steelride,silvermoon,768,warrior,arms,12,8,4
54753,Sevenheavy,draenor,768,warrior,arms,12,8,4
54754,Bíanco,blackrock,768,warrior,arms,12,8,4
54755,Chíppéd,draenor,768,warrior,arms,12,8,4
54756,Muyubu,eredar,768,warrior,arms,12,8,4
54757,Piré,tarren-mill,768,warrior,arms,12,8,4
54758,Shreedshot,blackmoore,768,warrior,arms,12,8,4
54759,Отвечай,gordunni,768,warrior,arms,12,8,4
54760,Trensexual,twisting-nether,768,warrior,arms,12,8,4
54761,Fizé,blackmoore,768,warrior,arms,12,8,4
54762,Бигбэйбитейп,greymane,768,warrior,arms,12,8,4
54763,Epyøn,stormscale,768,warrior,arms,12,8,4
54764,Liked,tarren-mill,768,warrior,arms,12,8,4
54765,Mâlitek,archimonde,768,warrior,arms,12,8,4
54766,Psinovich,sylvanas,768,warrior,arms,12,8,4
54767,Bigdøngfur,archimonde,768,warrior,arms,12,8,4
54768,Rayner,illidan,768,warrior,arms,12,8,4
54769,Audrin,twisting-nether,768,warrior,arms,12,8,4
54770,Beebsy,aegwynn,768,warrior,arms,12,8,4
54771,Ballin,dragonblight,768,warrior,arms,12,8,4
54772,Doritoslove,sanguino,768,warrior,arms,12,8,4
54773,Эсфор,howling-fjord,768,warrior,arms,12,8,4
54774,Wardrior,stormscale,768,warrior,arms,12,8,4
54775,Zamorák,twisting-nether,768,warrior,arms,12,8,4
54776,Smorccroms,stormscale,768,warrior,arms,12,8,4
54777,Madßud,ravencrest,768,warrior,arms,14,8,6
54778,Xdpromtius,dun-modr,768,warrior,arms,18,8,10
54779,Hønks,antonidas,768,warrior,arms,18,8,10
54780,Dréngr,blackrock,768,warrior,arms,18,8,10
54781,Howdoyouløse,stormscale,768,warrior,arms,18,8,10
54782,Styxwr,blackhand,768,warrior,arms,18,8,10
54783,Kehnan,blackrock,768,warrior,arms,18,8,10
54784,Dedewawa,ysondre,768,warrior,arms,18,8,10
54785,Dreadbanga,blackmoore,768,warrior,arms,18,8,10
54786,Vermis,stormscale,768,warrior,arms,18,8,10
54787,Winabella,tarren-mill,768,warrior,arms,18,8,10
54788,Borndet,eredar,768,warrior,arms,18,8,10
54789,Arsinal,blackhand,768,warrior,arms,18,8,10
54790,Кисямур,soulflayer,768,warrior,arms,18,8,10
54791,Visari,kiljaeden,768,warrior,arms,18,8,10
54792,Määh,frostmane,768,warrior,arms,18,8,10
54793,Belmønt,archimonde,768,warrior,arms,18,8,10
54794,Aauv,twisting-nether,768,warrior,arms,18,8,10
54795,Груббоб,booty-bay,768,warrior,arms,18,8,10
54796,Ваншотч,blackscar,768,warrior,arms,18,8,10
54797,Гатсх,blackscar,768,warrior,arms,18,8,10
54798,Caffeinë,ravencrest,768,warrior,arms,24,8,16
54799,Elinyar,aegwynn,768,warrior,arms,24,8,16
54800,Пробуюстерву,soulflayer,768,warrior,arms,24,8,16
54801,Leavyu,silvermoon,768,warrior,arms,24,8,16
54802,Galiusx,malganis,768,warrior,arms,24,8,16
54803,Фуджитаку,gordunni,768,warrior,arms,36,8,28
54804,Anndersen,defias-brotherhood,767,warrior,arms,12,8,4
54805,Yoilenno,argent-dawn,767,warrior,arms,12,8,4
54806,Atzex,blackmoore,767,warrior,arms,12,8,4
54807,Sená,stormscale,767,warrior,arms,12,8,4
54808,Sankuto,kazzak,767,warrior,arms,12,8,4
54809,Pílot,ravencrest,767,warrior,arms,12,8,4
54810,Helenius,ravencrest,767,warrior,arms,12,8,4
54811,Kante,frostmane,767,warrior,arms,12,8,4
54812,Alexwar,draenor,767,warrior,arms,18,8,10
54813,Nadelicious,kazzak,767,warrior,arms,18,8,10
54814,Recklessness,drakthul,767,warrior,arms,18,8,10
54815,Hermosse,dalaran,767,warrior,arms,18,8,10
54816,Kunodontas,draenor,767,warrior,arms,18,8,10
54817,Whiteowlx,argent-dawn,767,warrior,arms,18,8,10
54818,Litlijón,ravencrest,767,warrior,arms,18,8,10
54819,Akim,ysondre,767,warrior,arms,18,8,10
54820,Craíne,antonidas,767,warrior,arms,18,8,10
54821,Warbringer,burning-blade,767,warrior,arms,18,8,10
54822,Dtraque,kaelthas,767,warrior,arms,18,8,10
54823,Барнаул,gordunni,767,warrior,arms,18,8,10
54824,Broxiw,darkspear,767,warrior,arms,18,8,10
54825,Frcwar,kazzak,767,warrior,arms,18,8,10
54826,Kàinen,nemesis,767,warrior,arms,18,8,10
54827,Horseye,eredar,767,warrior,arms,18,8,10
54828,Арбузикхаха,soulflayer,767,warrior,arms,18,8,10
54829,Jjokkerr,magtheridon,767,warrior,arms,18,8,10
54830,Ericmontana,draenor,767,warrior,arms,18,8,10
54831,Juicyglutes,turalyon,767,warrior,arms,18,8,10
54832,Tomhankz,ravencrest,767,warrior,arms,18,8,10
54833,Бокалпивка,soulflayer,767,warrior,arms,21,9,12
54834,Davari,ravencrest,767,warrior,arms,21,8,13
54835,Fullzugzug,kazzak,767,warrior,arms,24,8,16
54836,Øfè,ysondre,767,warrior,arms,24,8,16
54837,Crizby,twisting-nether,767,warrior,arms,24,8,16
54838,Bonkonator,stormscale,766,warrior,arms,12,8,4
54839,Newgáte,silvermoon,766,warrior,arms,12,8,4
54840,Celean,darksorrow,766,warrior,arms,12,8,4
54841,Brutalx,twisting-nether,766,warrior,arms,14,8,6
54842,Rageaholic,blackmoore,766,warrior,arms,18,8,10
54843,Lydianite,stormrage,766,warrior,arms,18,8,10
54844,Beamis,ragnaros,766,warrior,arms,18,8,10
54845,Romzz,malganis,766,warrior,arms,18,8,10
54846,Vohok,jaedenar,766,warrior,arms,18,8,10
54847,Хэлвид,soulflayer,766,warrior,arms,18,8,10
54848,Zerxees,tarren-mill,766,warrior,arms,18,8,10
54849,Gùts,stormreaver,766,warrior,arms,18,8,10
54850,Тевивар,gordunni,766,warrior,arms,18,8,10
54851,Jeronimoe,blackmoore,766,warrior,arms,19,8,11
54852,Tuskyr,silvermoon,766,warrior,arms,24,8,16
54853,Alkuwaity,outland,766,warrior,arms,24,8,16
54854,Нэиро,howling-fjord,766,warrior,arms,24,8,16
54855,Roykór,auchindoun,766,warrior,arms,30,8,22
54856,Lîliana,ysondre,765,warrior,arms,12,8,4
54857,Xongoku,blackrock,765,warrior,arms,12,8,4
54858,Bladestorm,dun-morogh,765,warrior,arms,18,8,10
54859,Rindermett,eredar,765,warrior,arms,18,8,10
54860,Smaxi,kazzak,765,warrior,arms,18,8,10
54861,Tidrick,argent-dawn,765,warrior,arms,18,8,10
54862,Exeqty,the-maelstrom,765,warrior,arms,18,8,10
54863,Wärfäcë,blades-edge,765,warrior,arms,18,8,10
54864,Fortësque,uldaman,765,warrior,arms,18,8,10
54865,Apashe,drakthul,765,warrior,arms,24,8,16
54866,Younes,ravencrest,765,warrior,arms,24,8,16
54867,Hirbus,ravencrest,765,warrior,arms,25,8,17
54868,Kotto,defias-brotherhood,765,warrior,arms,30,8,22
54869,Havooc,ragnaros,764,warrior,arms,12,8,4
54870,Lucciouss,sylvanas,764,warrior,arms,12,8,4
54871,Berree,outland,764,warrior,arms,18,8,10
54872,Lìón,blackhand,764,warrior,arms,24,8,16
54873,Bangbros,archimonde,763,warrior,arms,12,8,4
54874,Ireincarnate,argent-dawn,763,warrior,arms,18,8,10
54875,Darkchao,madmortem,763,warrior,arms,18,8,10
54876,Giggadaddy,tarren-mill,763,warrior,arms,18,8,10
54877,Ripper,scarshield-legion,763,warrior,arms,30,8,22
54878,Leyon,blades-edge,762,warrior,arms,12,8,4
54879,Rogirb,drakthul,762,warrior,arms,18,8,10
54880,Previse,argent-dawn,762,warrior,arms,18,8,10
54881,Даммодар,howling-fjord,762,warrior,arms,18,8,10
54882,Suolijumppa,stormreaver,762,warrior,arms,18,8,10
54883,Turmund,turalyon,762,warrior,arms,24,8,16
54884,Danoriix,drakthul,762,warrior,arms,24,8,16
54885,Øruch,draenor,761,warrior,arms,18,8,10
54886,Warbringer,ravencrest,761,warrior,arms,24,8,16
54887,Encounter,nefarian,760,warrior,arms,12,8,4
54888,Ríght,auchindoun,760,warrior,arms,13,8,5
54889,Gnuhl,eredar,760,warrior,arms,21,9,12
54890,Alysa,ravencrest,760,warrior,arms,24,8,16
54891,Glevran,turalyon,760,warrior,arms,24,8,16
54892,Грруд,galakrond,760,warrior,arms,24,8,16
54893,Машамеч,blackscar,760,warrior,arms,30,8,22
54894,Upturn,ravencrest,757,warrior,arms,24,8,16
54895,Pappkopf,rexxar,753,warrior,arms,24,8,16
54896,Jesperharle,ravencrest,751,warrior,arms,17,8,9
54897,Calipp,die-aldor,750,warrior,arms,24,8,16
54898,Ispor,shattered-halls,749,warrior,arms,104,46,58
54899,Batourga,marécage-de-zangar,749,warrior,arms,23,8,15
54900,Shadrassil,eonar,747,warrior,arms,18,8,10
54901,Дедсдрыном,howling-fjord,747,warrior,arms,23,8,15
54902,Рф,thermaplugg,745,warrior,arms,26,9,17
54903,Roninwar,the-maelstrom,742,warrior,arms,18,8,10
54904,Vcorvin,dun-modr,741,warrior,arms,24,8,16
54905,Alothar,khaz-modan,738,warrior,arms,60,24,36
54906,Furraxx,elune,736,warrior,arms,18,8,10
54907,Hazzaogx,draenor,735,warrior,arms,23,8,15
54908,Broarexlion,ragnaros,735,warrior,arms,23,8,15
54909,Gaarrossh,kazzak,735,warrior,arms,23,8,15
54910,Rawenz,drakthul,735,warrior,arms,23,8,15
54911,Eltaré,hyjal,734,warrior,arms,14,9,5
54912,Megaloddon,ravencrest,734,warrior,arms,17,8,9
54913,Grimsong,antonidas,733,warrior,arms,14,9,5
54914,Madict,outland,733,warrior,arms,18,8,10
54915,Jäime,dun-modr,732,warrior,arms,16,8,8
54916,Imbakarimbá,blackrock,732,warrior,arms,17,8,9
54917,Бургерс,soulflayer,720,warrior,arms,15,8,7
54918,Mugteef,der-rat-von-dalaran,719,warrior,arms,17,8,9
54919,Karbeg,ravencrest,718,warrior,arms,21,8,13
54920,Spoofie,doomhammer,718,warrior,arms,21,8,13
54921,Железныйбард,gordunni,717,warrior,arms,23,8,15
54922,Ahlda,hyjal,716,warrior,arms,27,8,19
54923,Patriotdk,runetotem,709,warrior,arms,42,11,31
54924,Ferv,tarren-mill,703,warrior,arms,17,8,9
54925,Fürchtenix,blackmoore,703,warrior,arms,20,8,12
54926,Goringbame,draenor,703,warrior,arms,20,8,12
54927,Kyösti,defias-brotherhood,702,warrior,arms,14,8,6
54928,Daxhter,sanguino,702,warrior,arms,20,8,12
54929,Isoton,kazzak,702,warrior,arms,20,8,12
54930,Màndø,archimonde,702,warrior,arms,21,8,13
54931,Bàhàmût,anetheron,701,warrior,arms,11,8,3
54932,Shieldwall,norgannon,701,warrior,arms,15,9,6
54933,Parabellum,dun-modr,701,warrior,arms,14,8,6
54934,Stratic,blackmoore,697,warrior,arms,26,8,18
54935,Melców,eredar,687,warrior,arms,11,8,3
54936,Zecelei,tarren-mill,687,warrior,arms,13,8,5
54937,Pemex,stormreaver,686,warrior,arms,13,8,5
54938,Xiennas,stormscale,679,warrior,arms,19,9,10
54939,Shînsø,dalaran,672,warrior,arms,12,7,5
54940,Ragelol,aegwynn,672,warrior,arms,12,7,5
54941,Roadsick,outland,672,warrior,arms,12,7,5
54942,Хашонвар,gordunni,672,warrior,arms,12,7,5
54943,Каррагор,howling-fjord,672,warrior,arms,12,7,5
54944,Бардеон,gordunni,672,warrior,arms,12,7,5
54945,Engalxsol,tarren-mill,672,warrior,arms,12,7,5
54946,Tandrak,ravencrest,672,warrior,arms,12,7,5
54947,Choklatballz,tarren-mill,672,warrior,arms,12,7,5
54948,Zøllka,dalaran,672,warrior,arms,12,7,5
54949,Bubawarrior,silvermoon,672,warrior,arms,12,7,5
54950,Bigbmh,tarren-mill,672,warrior,arms,12,7,5
54951,Ironmásk,tarren-mill,672,warrior,arms,12,7,5
54952,Hekkarí,kazzak,672,warrior,arms,12,7,5
54953,Garkathar,draenor,672,warrior,arms,12,7,5
54954,Cleppepx,blackmoore,672,warrior,arms,12,7,5
54955,Дуухаст,gordunni,672,warrior,arms,12,7,5
54956,Minimcgregor,sanguino,672,warrior,arms,12,7,5
54957,Трэйдар,blackscar,672,warrior,arms,12,7,5
54958,Creekwarrior,twisting-nether,672,warrior,arms,12,7,5
54959,Utz,blackrock,672,warrior,arms,12,7,5
54960,Trembolonio,sanguino,672,warrior,arms,12,7,5
54961,Фалькр,soulflayer,672,warrior,arms,12,7,5
54962,Андрюхабш,soulflayer,672,warrior,arms,12,7,5
54963,Динамикс,soulflayer,672,warrior,arms,12,7,5
54964,Ðalf,sargeras,672,warrior,arms,12,7,5
54965,Orelus,darkspear,672,warrior,arms,12,7,5
54966,Drøgma,tyrande,672,warrior,arms,12,7,5
54967,Tbomb,stormscale,672,warrior,arms,12,7,5
54968,Арсон,soulflayer,672,warrior,arms,12,7,5
54969,Dantius,nemesis,672,warrior,arms,12,7,5
54970,Mòrzàr,outland,672,warrior,arms,12,7,5
54971,Pexqt,blackmoore,672,warrior,arms,12,7,5
54972,Itsamewario,outland,672,warrior,arms,12,7,5
54973,Slâkkxz,outland,672,warrior,arms,12,7,5
54974,Zellóx,stormscale,672,warrior,arms,12,7,5
54975,Azarek,blackmoore,672,warrior,arms,12,7,5
54976,Cleavnseagal,ravencrest,672,warrior,arms,12,7,5
54977,Srambo,ragnaros,672,warrior,arms,12,7,5
54978,Ryse,nemesis,672,warrior,arms,12,7,5
54979,Iamouz,ravencrest,672,warrior,arms,12,7,5
54980,Джераса,borean-tundra,672,warrior,arms,12,7,5
54981,Warriovar,draenor,672,warrior,arms,12,7,5
54982,Neíd,antonidas,672,warrior,arms,12,7,5
54983,Faimy,tarren-mill,672,warrior,arms,12,7,5
54984,Yoz,uldaman,672,warrior,arms,12,7,5
54985,Deathgreyø,nemesis,672,warrior,arms,12,7,5
54986,Minitizzr,stormscale,672,warrior,arms,12,7,5
54987,Smèdbérg,ravencrest,672,warrior,arms,12,7,5
54988,Lisera,thrall,672,warrior,arms,12,7,5
54989,Sholong,antonidas,672,warrior,arms,12,7,5
54990,Unverbal,silvermoon,672,warrior,arms,12,7,5
54991,Morvar,sanguino,672,warrior,arms,12,7,5
54992,Jäky,ragnaros,672,warrior,arms,12,7,5
54993,Cruor,stormscale,672,warrior,arms,12,7,5
54994,Morkzul,sanguino,672,warrior,arms,12,7,5
54995,Fearmyrage,ragnaros,672,warrior,arms,12,7,5
54996,Antïsøcial,thrall,672,warrior,arms,12,7,5
54997,Crøwñd,twisting-nether,672,warrior,arms,12,7,5
54998,Sreym,dun-modr,672,warrior,arms,12,7,5
54999,Chazbo,arakarahm,672,warrior,arms,12,7,5
55000,Thomasw,argent-dawn,672,warrior,arms,12,7,5
55001,Masakerr,ragnaros,672,warrior,arms,12,7,5
55002,Thebigtosco,ravencrest,672,warrior,arms,12,7,5
55003,Кросвуд,gordunni,672,warrior,arms,12,7,5
55004,Proffsét,ravencrest,672,warrior,arms,12,7,5
55005,Tìera,ravencrest,672,warrior,arms,15,8,7
55006,Yakhshar,silvermoon,672,warrior,arms,18,7,11
55007,Warrieron,stormscale,672,warrior,arms,18,7,11
55008,Silencxý,blackrock,672,warrior,arms,18,7,11
55009,Manký,kazzak,672,warrior,arms,18,7,11
55010,Slappcuzz,blackrock,672,warrior,arms,18,7,11
55011,Warriorri,haomarush,672,warrior,arms,18,7,11
55012,Kåïdø,ravencrest,672,warrior,arms,18,7,11
55013,Rec,thrall,672,warrior,arms,18,7,11
55014,Delfrion,pozzo-delleternità,672,warrior,arms,18,7,11
55015,Kamapulya,ravencrest,672,warrior,arms,18,7,11
55016,Twoonewin,ragnaros,672,warrior,arms,18,7,11
55017,Karreg,hyjal,672,warrior,arms,18,7,11
55018,Rylbrah,blackmoore,672,warrior,arms,18,7,11
55019,Skullsmasher,stormscale,672,warrior,arms,18,7,11
55020,Marablind,drakthul,672,warrior,arms,18,7,11
55021,Kennzz,ravencrest,672,warrior,arms,18,7,11
55022,Swàck,mazrigos,672,warrior,arms,18,7,11
55023,Pända,archimonde,672,warrior,arms,18,7,11
55024,Ishi,archimonde,672,warrior,arms,18,7,11
55025,Lalilulelo,argent-dawn,672,warrior,arms,18,7,11
55026,Kiha,argent-dawn,672,warrior,arms,18,7,11
55027,Kieranx,silvermoon,672,warrior,arms,18,7,11
55028,Бизэмэйкер,gordunni,672,warrior,arms,18,7,11
55029,Luxurious,argent-dawn,672,warrior,arms,27,8,19
55030,Vøidwalker,ragnaros,672,warrior,arms,24,7,17
55031,Kaylì,ravencrest,672,warrior,arms,24,7,17
55032,Syfér,grim-batol,672,warrior,arms,24,7,17
55033,Izurritea,tarren-mill,672,warrior,arms,24,7,17
55034,Unßörn,archimonde,672,warrior,arms,24,7,17
55035,Gôrilla,kazzak,672,warrior,arms,30,7,23
55036,Stèalthy,stormscale,671,warrior,arms,12,7,5
55037,Когарт,gordunni,671,warrior,arms,12,7,5
55038,Zonash,kazzak,671,warrior,arms,12,7,5
55039,Dukhe,sanguino,671,warrior,arms,12,7,5
55040,Bootyclapper,runetotem,671,warrior,arms,12,7,5
55041,Greifax,eredar,671,warrior,arms,12,7,5
55042,Gamôrà,eitrigg,671,warrior,arms,12,7,5
55043,Ogvico,stormscale,671,warrior,arms,12,7,5
55044,Bendeur,ysondre,671,warrior,arms,12,7,5
55045,Kelmyst,ragnaros,671,warrior,arms,12,7,5
55046,Reykingar,outland,671,warrior,arms,12,7,5
55047,Fluxerella,azjolnerub,671,warrior,arms,12,7,5
55048,Schneklinge,blutkessel,671,warrior,arms,12,7,5
55049,Vez,arathor,671,warrior,arms,12,7,5
55050,Escà,archimonde,671,warrior,arms,12,7,5
55051,Dosenbier,gorgonnash,671,warrior,arms,12,7,5
55052,Aëne,kirin-tor,671,warrior,arms,12,7,5
55053,Сайлентлайтх,soulflayer,671,warrior,arms,12,7,5
55054,Wårlord,ragnaros,671,warrior,arms,12,7,5
55055,Shedzo,tarren-mill,671,warrior,arms,12,7,5
55056,Skullcrasher,draenor,671,warrior,arms,12,7,5
55057,Rawne,kirin-tor,671,warrior,arms,12,7,5
55058,Pihvikostaja,stormreaver,671,warrior,arms,12,7,5
55059,Valí,drakthul,671,warrior,arms,12,7,5
55060,Hades,kazzak,671,warrior,arms,12,7,5
55061,Schawar,draenor,671,warrior,arms,12,7,5
55062,Wvanp,tarren-mill,671,warrior,arms,12,7,5
55063,Grudu,la-croisade-écarlate,671,warrior,arms,12,7,5
55064,Altroox,malorne,671,warrior,arms,12,7,5
55065,Дисфория,soulflayer,671,warrior,arms,15,8,7
55066,Akorax,frostwolf,671,warrior,arms,16,8,8
55067,Zarolk,rashgarroth,671,warrior,arms,18,7,11
55068,Doragon,nemesis,671,warrior,arms,18,7,11
55069,Ayawa,silvermoon,671,warrior,arms,18,7,11
55070,Titanioa,draenor,671,warrior,arms,18,7,11
55071,Kattyparry,tarren-mill,671,warrior,arms,18,7,11
55072,Salsetti,nemesis,671,warrior,arms,18,7,11
55073,Sydre,nerathor,671,warrior,arms,18,7,11
55074,Donczaszka,turalyon,671,warrior,arms,18,7,11
55075,Schwarzkoviç,hyjal,671,warrior,arms,18,7,11
55076,Segovaxx,twisting-nether,671,warrior,arms,18,7,11
55077,Ruzbie,silvermoon,671,warrior,arms,18,7,11
55078,Текайко,eversong,671,warrior,arms,18,7,11
55079,Haris,malganis,671,warrior,arms,18,7,11
55080,Kekwd,burning-legion,671,warrior,arms,18,7,11
55081,Feydal,thrall,671,warrior,arms,18,7,11
55082,Kishkamen,ravencrest,671,warrior,arms,18,7,11
55083,Ishíì,twisting-nether,671,warrior,arms,18,7,11
55084,Jerololz,dun-modr,671,warrior,arms,24,7,17
55085,Bisuko,archimonde,671,warrior,arms,24,7,17
55086,Бубаигавар,gordunni,671,warrior,arms,24,7,17
55087,Williamx,archimonde,671,warrior,arms,24,7,17
55088,Sadex,blackmoore,671,warrior,arms,24,7,17
55089,Lightit,aegwynn,670,warrior,arms,12,7,5
55090,Haymaker,auchindoun,670,warrior,arms,12,7,5
55091,Eldfast,bladefist,670,warrior,arms,12,7,5
55092,Kilsera,blackmoore,670,warrior,arms,12,7,5
55093,Grunwi,burning-legion,670,warrior,arms,12,7,5
55094,Cortix,blackmoore,670,warrior,arms,16,8,8
55095,Grafted,argent-dawn,670,warrior,arms,18,7,11
55096,Høxy,outland,670,warrior,arms,18,7,11
55097,Therapyst,sylvanas,670,warrior,arms,18,7,11
55098,Tartadwarf,blackhand,670,warrior,arms,18,7,11
55099,Sibbo,destromath,670,warrior,arms,18,7,11
55100,Mortus,baelgun,670,warrior,arms,22,8,14
55101,Чсвпони,blackscar,670,warrior,arms,24,7,17
55102,Laude,ragnaros,669,warrior,arms,12,7,5
55103,Gakosh,sanguino,669,warrior,arms,12,7,5
55104,Pyxis,argent-dawn,669,warrior,arms,18,7,11
55105,Slappie,kiljaeden,669,warrior,arms,18,7,11
55106,Brisky,tarren-mill,669,warrior,arms,18,7,11
55107,Méfiat,hyjal,668,warrior,arms,12,7,5
55108,Árkantos,ravencrest,668,warrior,arms,12,7,5
55109,Warclone,ravencrest,668,warrior,arms,12,7,5
55110,Thok,blades-edge,668,warrior,arms,18,7,11
55111,Woukong,blackmoore,668,warrior,arms,18,7,11
55112,Releave,draenor,668,warrior,arms,18,7,11
55113,Director,aegwynn,667,warrior,arms,12,7,5
55114,Strânge,gorgonnash,667,warrior,arms,12,7,5
55115,Piixxz,hyjal,667,warrior,arms,12,7,5
55116,Láviana,aegwynn,667,warrior,arms,12,7,5
55117,Papati,twisting-nether,667,warrior,arms,18,7,11
55118,Rèlion,pozzo-delleternità,666,warrior,arms,15,8,7
55119,Djiozz,khaz-modan,666,warrior,arms,30,7,23
55120,Rimz,blackmoore,663,warrior,arms,18,7,11
55121,Buullz,twisting-nether,662,warrior,arms,18,7,11
55122,Robthebruce,ravencrest,660,warrior,arms,18,7,11
55123,Yuushi,doomhammer,656,warrior,arms,26,10,16
55124,Punishers,ysondre,656,warrior,arms,156,54,102
55125,Paaki,archimonde,655,warrior,arms,17,7,10
55126,Mocka,veknilash,640,warrior,arms,16,7,9
55127,Варбаул,soulflayer,639,warrior,arms,14,8,6
55128,Мегаяйца,gordunni,639,warrior,arms,23,7,16
55129,Xiny,blackrock,638,warrior,arms,17,7,10
55130,Dasbiest,malorne,638,warrior,arms,17,7,10
55131,Боевыещёчки,eversong,627,warrior,arms,22,11,11
55132,Schmelzlord,thrall,624,warrior,arms,15,7,8
55133,Knoxworth,kazzak,623,warrior,arms,11,7,4
55134,Bloodeater,sylvanas,623,warrior,arms,15,7,8
55135,Grunkor,eldrethalas,623,warrior,arms,17,7,10
55136,Ätreides,sanguino,622,warrior,arms,17,7,10
55137,Vaxillium,argent-dawn,621,warrior,arms,17,7,10
55138,Ragingqawk,outland,608,warrior,arms,16,7,9
55139,Kwesta,kazzak,607,warrior,arms,11,7,4
55140,Matatorero,uldum,607,warrior,arms,16,7,9
55141,Trundledaddy,silvermoon,607,warrior,arms,17,7,10
55142,Ðowman,blackrock,607,warrior,arms,20,7,13
55143,Cbahorde,outland,606,warrior,arms,14,7,7
55144,Arashicage,emeriss,606,warrior,arms,14,7,7
55145,Eragdagh,thrall,606,warrior,arms,20,7,13
55146,Rhxy,burning-legion,605,warrior,arms,16,7,9
55147,Kenzai,aegwynn,592,warrior,arms,13,7,6
55148,Nebezpeka,silvermoon,592,warrior,arms,13,7,6
55149,Olriksen,dentarg,590,warrior,arms,19,8,11
55150,Bavet,sylvanas,589,warrior,arms,19,7,12
55151,Dulex,draenor,576,warrior,arms,6,6,0
55152,Watergate,ysondre,576,warrior,arms,6,6,0
55153,Gidra,stormscale,576,warrior,arms,6,6,0
55154,Lubcifer,emeriss,576,warrior,arms,6,6,0
55155,Hornkesh,draenor,576,warrior,arms,6,6,0
55156,Neoballâc,uldum,576,warrior,arms,12,6,6
55157,Xqt,laughing-skull,576,warrior,arms,12,6,6
55158,Nørst,draenor,576,warrior,arms,12,6,6
55159,Kirmizikafa,twisting-nether,576,warrior,arms,12,6,6
55160,Fonky,sylvanas,576,warrior,arms,12,6,6
55161,Micromachìne,sanguino,576,warrior,arms,12,6,6
55162,Belov,hyjal,576,warrior,arms,12,6,6
55163,Deymio,defias-brotherhood,576,warrior,arms,12,6,6
55164,Psychðtïc,archimonde,576,warrior,arms,12,6,6
55165,Fookyoup,stormscale,576,warrior,arms,12,6,6
55166,Brutarius,scarshield-legion,576,warrior,arms,12,6,6
55167,Maheri,antonidas,576,warrior,arms,12,6,6
55168,Синглдем,gordunni,576,warrior,arms,12,6,6
55169,Brutalizar,draenor,576,warrior,arms,12,6,6
55170,Mîleycyrûs,stormscale,576,warrior,arms,12,6,6
55171,Moldamis,blackhand,576,warrior,arms,12,6,6
55172,Lucywar,ravencrest,576,warrior,arms,12,6,6
55173,Scràvity,blackhand,576,warrior,arms,12,6,6
55174,Thanâtøs,kazzak,576,warrior,arms,12,6,6
55175,Waranach,drakthul,576,warrior,arms,12,6,6
55176,Oneoneseven,archimonde,576,warrior,arms,12,6,6
55177,Dvigar,drakthul,576,warrior,arms,12,6,6
55178,Finmajor,frostwhisper,576,warrior,arms,12,6,6
55179,Wøokz,argent-dawn,576,warrior,arms,12,6,6
55180,Bllué,ravencrest,576,warrior,arms,12,6,6
55181,Qurujaa,kirin-tor,576,warrior,arms,12,6,6
55182,Phalekxox,twisting-nether,576,warrior,arms,12,6,6
55183,Радомель,gordunni,576,warrior,arms,12,6,6
55184,Reshnak,die-todeskrallen,576,warrior,arms,12,6,6
55185,Toqk,draenor,576,warrior,arms,12,6,6
55186,Màgh,ravencrest,576,warrior,arms,12,6,6
55187,Fankululu,kragjin,576,warrior,arms,12,6,6
55188,Rageover,outland,576,warrior,arms,12,6,6
55189,Vakios,confrérie-du-thorium,576,warrior,arms,12,6,6
55190,Ðrews,kazzak,576,warrior,arms,12,6,6
55191,Víoceptíon,blackrock,576,warrior,arms,12,6,6
55192,Iuliaa,ravencrest,576,warrior,arms,12,6,6
55193,Eyolf,thunderhorn,576,warrior,arms,12,6,6
55194,Darkseid,burning-legion,576,warrior,arms,12,6,6
55195,Earthshatter,emeriss,576,warrior,arms,12,6,6
55196,Leetzorz,aszune,576,warrior,arms,12,6,6
55197,Thegullet,draenor,576,warrior,arms,12,6,6
55198,Intíkam,alleria,576,warrior,arms,12,6,6
55199,Нерморрог,howling-fjord,576,warrior,arms,12,6,6
55200,Kleckzz,blackmoore,576,warrior,arms,12,6,6
55201,Krisusama,ravencrest,576,warrior,arms,12,6,6
55202,Urmankey,kazzak,576,warrior,arms,12,6,6
55203,Jayus,stormrage,576,warrior,arms,12,6,6
55204,Shorane,varimathras,576,warrior,arms,12,6,6
55205,Наомирассел,gordunni,576,warrior,arms,12,6,6
55206,Chargekanta,antonidas,576,warrior,arms,12,6,6
55207,Toscow,ravencrest,576,warrior,arms,12,6,6
55208,Tùcky,ysondre,576,warrior,arms,12,6,6
55209,Coolaa,kazzak,576,warrior,arms,12,6,6
55210,Hycate,blackrock,576,warrior,arms,12,6,6
55211,Skelash,blackhand,576,warrior,arms,12,6,6
55212,Bourbimrgllr,hyjal,576,warrior,arms,12,6,6
55213,Slám,burning-legion,576,warrior,arms,12,6,6
55214,Whatabeast,blackmoore,576,warrior,arms,12,6,6
55215,Rakhaldin,blackhand,576,warrior,arms,12,6,6
55216,Freddio,tarren-mill,576,warrior,arms,12,6,6
55217,Neverfear,aegwynn,576,warrior,arms,12,6,6
55218,Torgath,kirin-tor,576,warrior,arms,12,6,6
55219,Pryzinstyle,aegwynn,576,warrior,arms,12,6,6
55220,Yuuta,ravencrest,576,warrior,arms,12,6,6
55221,Долирия,gordunni,576,warrior,arms,12,6,6
55222,Хедтакер,gordunni,576,warrior,arms,12,6,6
55223,Rianhh,tarren-mill,576,warrior,arms,12,6,6
55224,Tddyy,silvermoon,576,warrior,arms,12,6,6
55225,Racore,aegwynn,576,warrior,arms,12,6,6
55226,Wärlør,ravencrest,576,warrior,arms,12,6,6
55227,Тягуч,howling-fjord,576,warrior,arms,12,6,6
55228,Majestatix,doomhammer,576,warrior,arms,12,6,6
55229,Lolpuîk,archimonde,576,warrior,arms,12,6,6
55230,Hacci,ragnaros,576,warrior,arms,12,6,6
55231,Ðjlækker,silvermoon,576,warrior,arms,12,6,6
55232,Poyraz,blackrock,576,warrior,arms,12,6,6
55233,Äsgeïr,archimonde,576,warrior,arms,12,6,6
55234,Terisá,blackmoore,576,warrior,arms,12,6,6
55235,Zabrona,turalyon,576,warrior,arms,12,6,6
55236,Juggawumba,kazzak,576,warrior,arms,12,6,6
55237,Teliese,argent-dawn,576,warrior,arms,12,6,6
55238,Madswarr,tarren-mill,576,warrior,arms,12,6,6
55239,Nakedwarrior,silvermoon,576,warrior,arms,12,6,6
55240,Fidicenz,ysondre,576,warrior,arms,12,6,6
55241,Tikej,silvermoon,576,warrior,arms,12,6,6
55242,Дестингл,gordunni,576,warrior,arms,15,7,8
55243,Chazeryu,stormreaver,576,warrior,arms,18,6,12
55244,Реклэсс,blackscar,576,warrior,arms,18,6,12
55245,Ezop,burning-blade,576,warrior,arms,18,6,12
55246,Ermòr,ravencrest,576,warrior,arms,18,6,12
55247,Kawaro,rajaxx,576,warrior,arms,18,6,12
55248,Повстер,howling-fjord,576,warrior,arms,18,6,12
55249,Ój,ravencrest,576,warrior,arms,18,6,12
55250,Kneecleaver,darksorrow,576,warrior,arms,18,6,12
55251,Foxxzorr,aszune,576,warrior,arms,18,6,12
55252,Debiljov,ahnqiraj,576,warrior,arms,18,6,12
55253,Kenet,tarren-mill,576,warrior,arms,18,6,12
55254,Repó,twisting-nether,576,warrior,arms,18,6,12
55255,Stillpetao,dun-modr,576,warrior,arms,18,6,12
55256,Ragoar,blackmoore,576,warrior,arms,18,6,12
55257,Duaig,pozzo-delleternità,576,warrior,arms,18,6,12
55258,Jeriko,archimonde,576,warrior,arms,18,6,12
55259,Shiikaa,hyjal,576,warrior,arms,18,6,12
55260,Huor,tarren-mill,576,warrior,arms,18,6,12
55261,Fracto,draenor,576,warrior,arms,18,6,12
55262,Leroyluca,gilneas,576,warrior,arms,18,6,12
55263,Gór,area-52,576,warrior,arms,18,6,12
55264,Erayu,outland,576,warrior,arms,18,6,12
55265,Cødi,antonidas,576,warrior,arms,18,6,12
55266,Autumnfálls,kazzak,576,warrior,arms,18,6,12
55267,Khagor,kazzak,576,warrior,arms,24,6,18
55268,Steroidkidx,stormscale,576,warrior,arms,24,6,18
55269,Luckysop,chants-éternels,576,warrior,arms,24,6,18
55270,Topozugzug,tarren-mill,576,warrior,arms,24,6,18
55271,Elsinner,ravencrest,576,warrior,arms,24,6,18
55272,Crocodìle,magtheridon,575,warrior,arms,6,6,0
55273,Pesroc,blackmoore,575,warrior,arms,9,7,2
55274,Беспонятия,blackscar,575,warrior,arms,10,7,3
55275,Arnnau,dun-modr,575,warrior,arms,12,6,6
55276,Thorast,argent-dawn,575,warrior,arms,12,6,6
55277,Wærriør,argent-dawn,575,warrior,arms,12,6,6
55278,Empero,draenor,575,warrior,arms,12,6,6
55279,Эсвексия,gordunni,575,warrior,arms,12,6,6
55280,Soofies,madmortem,575,warrior,arms,12,6,6
55281,Cyniczny,draenor,575,warrior,arms,12,6,6
55282,Brávéheart,ravencrest,575,warrior,arms,12,6,6
55283,Бэдбрэйнс,soulflayer,575,warrior,arms,12,6,6
55284,Bzezita,hyjal,575,warrior,arms,12,6,6
55285,Ràgnàmetàl,tarren-mill,575,warrior,arms,12,6,6
55286,Valus,earthen-ring,575,warrior,arms,12,6,6
55287,Demirkol,outland,575,warrior,arms,12,6,6
55288,Акози,fordragon,575,warrior,arms,12,6,6
55289,Cesaro,blackhand,575,warrior,arms,12,6,6
55290,Scârath,eredar,575,warrior,arms,12,6,6
55291,Thráll,aszune,575,warrior,arms,12,6,6
55292,Ghostlord,dunemaul,575,warrior,arms,12,6,6
55293,Bobleeragnar,ravencrest,575,warrior,arms,12,6,6
55294,Djpuggerino,outland,575,warrior,arms,12,6,6
55295,Cogne,illidan,575,warrior,arms,12,6,6
55296,Zutto,conseil-des-ombres,575,warrior,arms,12,6,6
55297,Mladris,outland,575,warrior,arms,12,6,6
55298,Думрайт,gordunni,575,warrior,arms,12,6,6
55299,Fótm,sylvanas,575,warrior,arms,12,6,6
55300,Тханирох,howling-fjord,575,warrior,arms,12,6,6
55301,Imafk,darksorrow,575,warrior,arms,12,6,6
55302,Dexter,outland,575,warrior,arms,12,6,6
55303,Lunath,stormscale,575,warrior,arms,12,6,6
55304,Lupacha,exodar,575,warrior,arms,12,6,6
55305,Uwazu,kazzak,575,warrior,arms,12,6,6
55306,Rawi,antonidas,575,warrior,arms,12,6,6
55307,Sombrenuit,kaelthas,575,warrior,arms,16,7,9
55308,Отнулядоста,gordunni,575,warrior,arms,18,6,12
55309,Кордупэль,gordunni,575,warrior,arms,18,6,12
55310,Redcloak,outland,575,warrior,arms,18,6,12
55311,Potatoslam,twisting-nether,575,warrior,arms,18,6,12
55312,Critycall,drakthul,575,warrior,arms,18,6,12
55313,Ruioz,draenor,575,warrior,arms,18,6,12
55314,Sabøtage,aggra-português,575,warrior,arms,18,6,12
55315,Vectus,zuljin,575,warrior,arms,18,6,12
55316,Awares,blackmoore,575,warrior,arms,18,6,12
55317,Pnizsz,draenor,575,warrior,arms,24,6,18
55318,Kydecnick,kazzak,575,warrior,arms,24,6,18
55319,Fugrim,draenor,574,warrior,arms,12,6,6
55320,Solatika,alexstrasza,574,warrior,arms,12,6,6
55321,Nostrawolf,sylvanas,574,warrior,arms,12,6,6
55322,Greensmash,hyjal,574,warrior,arms,12,6,6
55323,Rézinplin,archimonde,574,warrior,arms,12,6,6
55324,Xaah,dun-modr,574,warrior,arms,18,6,12
55325,Salom,illidan,574,warrior,arms,18,6,12
55326,Maxeyn,kazzak,574,warrior,arms,27,7,20
55327,Sztixi,silvermoon,574,warrior,arms,24,6,18
55328,Kaerz,ysondre,573,warrior,arms,12,6,6
55329,Prôtectore,hyjal,573,warrior,arms,12,6,6
55330,Sallcon,khaz-modan,573,warrior,arms,12,6,6
55331,Бачус,eversong,573,warrior,arms,18,6,12
55332,Ttz,tarren-mill,573,warrior,arms,18,6,12
55333,Haipaz,draenor,572,warrior,arms,12,6,6
55334,Årxex,stormscale,572,warrior,arms,12,6,6
55335,Oombac,lordaeron,572,warrior,arms,12,6,6
55336,Raduriel,antonidas,571,warrior,arms,12,6,6
55337,Ileei,kazzak,571,warrior,arms,18,6,12
55338,Thoròk,antonidas,571,warrior,arms,18,6,12
55339,Xavs,grim-batol,571,warrior,arms,18,6,12
55340,Бланкк,deathweaver,570,warrior,arms,12,6,6
55341,Dj,ragnaros,568,warrior,arms,12,6,6
55342,Wulfgâr,dun-modr,566,warrior,arms,12,6,6
55343,Gauklerbaron,blackmoore,566,warrior,arms,29,6,23
55344,Wïnqlùlz,archimonde,564,warrior,arms,36,6,30
55345,Rãgè,tarren-mill,559,warrior,arms,17,6,11
55346,Wahney,thrall,543,warrior,arms,8,7,1
55347,Randrion,blackrock,543,warrior,arms,11,6,5
55348,Omaahton,magtheridon,543,warrior,arms,11,6,5
55349,Krevó,ragnaros,543,warrior,arms,17,6,11
55350,Fion,kult-der-verdammten,543,warrior,arms,20,7,13
55351,Koruds,outland,528,warrior,arms,9,6,3
55352,Kåñéthy,outland,528,warrior,arms,15,7,8
55353,Warriotrix,tarren-mill,528,warrior,arms,15,6,9
55354,Nukefun,blackrock,527,warrior,arms,11,6,5
55355,Imabeatyoass,kazzak,527,warrior,arms,11,6,5
55356,Манндалорец,gordunni,527,warrior,arms,15,6,9
55357,Titanhaut,frostwolf,525,warrior,arms,11,6,5
55358,Smaugman,nemesis,523,warrior,arms,23,6,17
55359,Glut,drakthul,522,warrior,arms,18,7,11
55360,Nuckii,antonidas,521,warrior,arms,21,7,14
55361,Monifes,kazzak,520,warrior,arms,18,8,10
55362,Эсканорд,gordunni,513,warrior,arms,26,7,19
55363,Креспекс,gordunni,512,warrior,arms,16,6,10
55364,Bujax,onyxia,512,warrior,arms,16,6,10
55365,Dzamtule,ravencrest,511,warrior,arms,8,6,2
55366,Hasira,xavius,511,warrior,arms,10,6,4
55367,Sorô,antonidas,511,warrior,arms,16,6,10
55368,Мембершримп,howling-fjord,511,warrior,arms,20,6,14
55369,Myryna,exodar,510,warrior,arms,20,6,14
55370,Блэйзерх,gordunni,496,warrior,arms,19,6,13
55371,Serbia,blackrock,480,warrior,arms,6,5,1
55372,Гневныйвиги,howling-fjord,480,warrior,arms,6,5,1
55373,Murp,lightnings-blade,480,warrior,arms,6,5,1
55374,Saitäma,burning-legion,480,warrior,arms,6,5,1
55375,Karmaloop,stormscale,480,warrior,arms,6,5,1
55376,Sufentaniili,frostwhisper,480,warrior,arms,6,5,1
55377,Nalanis,stormreaver,480,warrior,arms,6,5,1
55378,Zodiac,aggra-português,480,warrior,arms,6,5,1
55379,Eysnwar,blackrock,480,warrior,arms,6,5,1
55380,Mumbojumbo,uldum,480,warrior,arms,6,5,1
55381,Chuck,ravencrest,480,warrior,arms,6,5,1
55382,Hubq,burning-legion,480,warrior,arms,6,5,1
55383,Himarsenko,silvermoon,480,warrior,arms,6,5,1
55384,Remylacroix,blackrock,480,warrior,arms,6,5,1
55385,Ocecute,tarren-mill,480,warrior,arms,6,5,1
55386,Grímgor,aegwynn,480,warrior,arms,6,5,1
55387,Angrytoddler,silvermoon,480,warrior,arms,6,5,1
55388,Bashuk,grim-batol,480,warrior,arms,6,5,1
55389,Tørrminator,stormscale,480,warrior,arms,6,5,1
55390,Quateh,silvermoon,480,warrior,arms,6,5,1
55391,Дядядмг,blackscar,480,warrior,arms,6,5,1
55392,Chargelife,sylvanas,480,warrior,arms,6,5,1
55393,Tekmali,archimonde,480,warrior,arms,6,5,1
55394,Sezomih,outland,480,warrior,arms,6,5,1
55395,Exether,auchindoun,480,warrior,arms,6,5,1
55396,Cuzyxtwo,blackrock,480,warrior,arms,6,5,1
55397,Asasius,ravencrest,480,warrior,arms,6,5,1
55398,Rockygifll,sinstralis,480,warrior,arms,6,5,1
55399,Chabonara,blackmoore,480,warrior,arms,6,5,1
55400,Dagreenjo,tarren-mill,480,warrior,arms,6,5,1
55401,Tørøg,eredar,480,warrior,arms,6,5,1
55402,Хэрест,gordunni,480,warrior,arms,6,5,1
55403,Slg,tarren-mill,480,warrior,arms,6,5,1
55404,Synix,stormreaver,480,warrior,arms,6,5,1
55405,Drragosh,tarren-mill,480,warrior,arms,6,5,1
55406,Revoidnvm,blackmoore,480,warrior,arms,6,5,1
55407,Hópbóp,magtheridon,480,warrior,arms,6,5,1
55408,Lurion,malganis,480,warrior,arms,6,5,1
55409,Tishues,kazzak,480,warrior,arms,8,5,3
55410,Vitezandro,stormscale,480,warrior,arms,12,5,7
55411,Balenciarmor,silvermoon,480,warrior,arms,12,5,7
55412,Budwise,stormscale,480,warrior,arms,12,5,7
55413,Снорре,soulflayer,480,warrior,arms,12,5,7
55414,Тэратос,soulflayer,480,warrior,arms,12,5,7
55415,Teramuhl,eredar,480,warrior,arms,12,5,7
55416,Hodenhugo,thrall,480,warrior,arms,12,5,7
55417,Xintha,frostwolf,480,warrior,arms,12,5,7
55418,Боадрог,soulflayer,480,warrior,arms,12,5,7
55419,Leelazero,argent-dawn,480,warrior,arms,12,5,7
55420,Plzdontkite,blackrock,480,warrior,arms,12,5,7
55421,Pourfendre,archimonde,480,warrior,arms,12,5,7
55422,Threnewar,kazzak,480,warrior,arms,12,5,7
55423,Gigantous,emerald-dream,480,warrior,arms,12,5,7
55424,Nings,rashgarroth,480,warrior,arms,12,5,7
55425,Drumsofwar,zuljin,480,warrior,arms,12,5,7
55426,Gorkta,uldaman,480,warrior,arms,12,5,7
55427,Khara,frostwolf,480,warrior,arms,12,5,7
55428,Thirtynine,daggerspine,480,warrior,arms,12,5,7
55429,Tyrag,eredar,480,warrior,arms,12,5,7
55430,Ràgê,silvermoon,480,warrior,arms,12,5,7
55431,Zeneve,auchindoun,480,warrior,arms,12,5,7
55432,Buffury,twisting-nether,480,warrior,arms,12,5,7
55433,Nomore,sylvanas,480,warrior,arms,12,5,7
55434,Wardoz,archimonde,480,warrior,arms,12,5,7
55435,Stepmomgodx,kazzak,480,warrior,arms,12,5,7
55436,Шифик,soulflayer,480,warrior,arms,12,5,7
55437,Tharokk,blackmoore,480,warrior,arms,12,5,7
55438,Oplix,antonidas,480,warrior,arms,12,5,7
55439,Zugzugsmash,thrall,480,warrior,arms,12,5,7
55440,Zonïa,ysondre,480,warrior,arms,12,5,7
55441,Câttiva,blackmoore,480,warrior,arms,12,5,7
55442,Agres,zuluhed,480,warrior,arms,12,5,7
55443,Бейлеор,gordunni,480,warrior,arms,12,5,7
55444,Garradoom,stormscale,480,warrior,arms,12,5,7
55445,Lïyah,eldrethalas,480,warrior,arms,12,5,7
55446,Matiasek,burning-legion,480,warrior,arms,12,5,7
55447,Horizonx,blackrock,480,warrior,arms,12,5,7
55448,Whysobold,quelthalas,480,warrior,arms,12,5,7
55449,Zuroq,antonidas,480,warrior,arms,12,5,7
55450,Wãrby,ravencrest,480,warrior,arms,12,5,7
55451,Zarrgash,blackhand,480,warrior,arms,12,5,7
55452,Schlierkamp,aegwynn,480,warrior,arms,12,5,7
55453,Steelian,kazzak,480,warrior,arms,12,5,7
55454,Deathbleeder,argent-dawn,480,warrior,arms,12,5,7
55455,Epicc,alleria,480,warrior,arms,12,5,7
55456,Kirzan,silvermoon,480,warrior,arms,12,5,7
55457,Klonyarikjr,ravencrest,480,warrior,arms,12,5,7
55458,Steelstormz,ravencrest,480,warrior,arms,12,5,7
55459,Zeryyo,blackrock,480,warrior,arms,12,5,7
55460,Adamastos,ragnaros,480,warrior,arms,12,5,7
55461,Matrixer,aegwynn,480,warrior,arms,12,5,7
55462,Sergra,ysondre,480,warrior,arms,12,5,7
55463,Møgwai,sanguino,480,warrior,arms,12,5,7
55464,Zion,zenedar,480,warrior,arms,12,5,7
55465,Loreven,silvermoon,480,warrior,arms,12,5,7
55466,Keäghan,kazzak,480,warrior,arms,12,5,7
55467,Warricious,outland,480,warrior,arms,12,5,7
55468,Rohäc,drakthul,480,warrior,arms,12,5,7
55469,Mokrakh,blackmoore,480,warrior,arms,12,5,7
55470,Victôr,silvermoon,480,warrior,arms,12,5,7
55471,Vulkân,aerie-peak,480,warrior,arms,12,5,7
55472,Loliclapper,grim-batol,480,warrior,arms,12,5,7
55473,Caltan,wildhammer,480,warrior,arms,12,5,7
55474,Pattrock,blackmoore,480,warrior,arms,12,5,7
55475,Ginjó,blackhand,480,warrior,arms,12,5,7
55476,Сашарбгх,soulflayer,480,warrior,arms,12,5,7
55477,Pablitø,silvermoon,480,warrior,arms,12,5,7
55478,Warclodo,la-croisade-écarlate,480,warrior,arms,12,5,7
55479,Zirriox,wildhammer,480,warrior,arms,12,5,7
55480,Brasta,malganis,480,warrior,arms,12,5,7
55481,Tryitmaxx,blackmoore,480,warrior,arms,12,5,7
55482,Bladestormxx,blackmoore,480,warrior,arms,12,5,7
55483,Lüund,ravencrest,480,warrior,arms,12,5,7
55484,Ernexpóc,silvermoon,480,warrior,arms,12,5,7
55485,Bigbanz,outland,480,warrior,arms,12,5,7
55486,Arakhu,blackmoore,480,warrior,arms,12,5,7
55487,Kalopsia,drakthul,480,warrior,arms,12,5,7
55488,Coko,kirin-tor,480,warrior,arms,12,5,7
55489,Бенчмаркпоу,gordunni,480,warrior,arms,12,5,7
55490,Strengjahz,ragnaros,480,warrior,arms,12,5,7
55491,Анжинерх,gordunni,480,warrior,arms,12,5,7
55492,Okke,thunderhorn,480,warrior,arms,12,5,7
55493,Baxyra,aegwynn,480,warrior,arms,12,5,7
55494,Purjon,twilights-hammer,480,warrior,arms,12,5,7
55495,Shanai,silvermoon,480,warrior,arms,12,5,7
55496,Humanoç,dun-modr,480,warrior,arms,12,5,7
55497,Huxies,draenor,480,warrior,arms,12,5,7
55498,Asintended,draenor,480,warrior,arms,12,5,7
55499,Thravaeg,draenor,480,warrior,arms,12,5,7
55500,Kramix,thrall,480,warrior,arms,12,5,7
55501,Mërkürÿ,draenor,480,warrior,arms,12,5,7
55502,Ffz,hyjal,480,warrior,arms,12,5,7
55503,Arsinal,destromath,480,warrior,arms,12,5,7
55504,Sidekick,earthen-ring,480,warrior,arms,12,5,7
55505,Oogaboogadps,silvermoon,480,warrior,arms,12,5,7
55506,Ragingclue,draenor,480,warrior,arms,12,5,7
55507,Síúkanto,blackrock,480,warrior,arms,12,5,7
55508,Рэйердан,howling-fjord,480,warrior,arms,12,5,7
55509,Dampbob,draenor,480,warrior,arms,12,5,7
55510,ßzv,veklor,480,warrior,arms,12,5,7
55511,Taskov,tarren-mill,480,warrior,arms,12,5,7
55512,Elesharde,sanguino,480,warrior,arms,15,6,9
55513,Vexxenn,outland,480,warrior,arms,16,6,10
55514,Развалочка,howling-fjord,480,warrior,arms,16,6,10
55515,Goldrage,archimonde,480,warrior,arms,16,5,11
55516,Takagødx,archimonde,480,warrior,arms,18,5,13
55517,Форгерон,howling-fjord,480,warrior,arms,18,5,13
55518,Чевчелиос,deathweaver,480,warrior,arms,18,5,13
55519,Heracles,jaedenar,480,warrior,arms,18,5,13
55520,Spacemachine,kazzak,480,warrior,arms,18,5,13
55521,Romic,guldan,480,warrior,arms,18,5,13
55522,Rhaegon,laughing-skull,480,warrior,arms,18,5,13
55523,Kundrakiz,kazzak,480,warrior,arms,18,5,13
55524,Solgud,bloodfeather,480,warrior,arms,18,5,13
55525,Æxcoast,ravencrest,480,warrior,arms,18,5,13
55526,Курящийпро,blackscar,480,warrior,arms,18,5,13
55527,Sheñ,antonidas,480,warrior,arms,18,5,13
55528,Mellvorr,malganis,480,warrior,arms,23,5,18
55529,Gnolimits,antonidas,480,warrior,arms,24,5,19
55530,Jorund,archimonde,480,warrior,arms,24,5,19
55531,Ludiboro,kazzak,480,warrior,arms,24,5,19
55532,Vhy,antonidas,480,warrior,arms,25,5,20
55533,Ceteris,eredar,479,warrior,arms,6,5,1
55534,Saey,malorne,479,warrior,arms,6,5,1
55535,Xtu,kazzak,479,warrior,arms,6,5,1
55536,Dêrion,blackmoore,479,warrior,arms,10,6,4
55537,Shpitzu,stormscale,479,warrior,arms,12,5,7
55538,Meresin,madmortem,479,warrior,arms,12,5,7
55539,Relüx,ragnaros,479,warrior,arms,12,5,7
55540,Joesalamanca,ragnaros,479,warrior,arms,12,5,7
55541,Tötø,archimonde,479,warrior,arms,12,5,7
55542,Maxilanthis,eonar,479,warrior,arms,12,5,7
55543,Grèèn,turalyon,479,warrior,arms,12,5,7
55544,Lanïmal,eitrigg,479,warrior,arms,12,5,7
55545,Caloomsa,hellfire,479,warrior,arms,12,5,7
55546,Спарттанка,gordunni,479,warrior,arms,12,5,7
55547,Fréyaá,blackrock,479,warrior,arms,12,5,7
55548,Dúg,tarren-mill,479,warrior,arms,12,5,7
55549,Svinks,sylvanas,479,warrior,arms,12,5,7
55550,Swtparanoid,sylvanas,479,warrior,arms,12,5,7
55551,Dragonforce,blackmoore,479,warrior,arms,12,5,7
55552,Voodoowarr,rexxar,479,warrior,arms,12,5,7
55553,Lezúziuszh,ragnaros,479,warrior,arms,17,7,10
55554,Skarnir,blackhand,479,warrior,arms,18,5,13
55555,Auggies,outland,479,warrior,arms,18,5,13
55556,Ravedeath,tarren-mill,479,warrior,arms,18,5,13
55557,Gids,silvermoon,479,warrior,arms,18,5,13
55558,Tinull,silvermoon,479,warrior,arms,18,5,13
55559,Hulkkis,outland,479,warrior,arms,24,5,19
55560,Konstantin,grim-batol,479,warrior,arms,24,5,19
55561,Nightmareb,magtheridon,478,warrior,arms,12,5,7
55562,Ghorinchai,khazgoroth,478,warrior,arms,12,5,7
55563,Aylîx,dun-modr,478,warrior,arms,12,5,7
55564,Nodance,doomhammer,478,warrior,arms,12,5,7
55565,Farxy,dun-modr,478,warrior,arms,12,5,7
55566,Sahaminho,draenor,478,warrior,arms,18,5,13
55567,Swordluw,argent-dawn,478,warrior,arms,18,5,13
55568,Нириэла,howling-fjord,478,warrior,arms,18,5,13
55569,Nierninwa,silvermoon,477,warrior,arms,12,5,7
55570,Лидоний,gordunni,477,warrior,arms,12,5,7
55571,Achsin,eredar,477,warrior,arms,15,6,9
55572,Olagkhan,minahonda,476,warrior,arms,10,6,4
55573,Àke,darksorrow,476,warrior,arms,18,5,13
55574,Sheriff,dragonblight,475,warrior,arms,12,5,7
55575,Короноварус,greymane,474,warrior,arms,12,5,7
55576,Pillu,stormscale,448,warrior,arms,10,5,5
55577,Duarel,blackmoore,448,warrior,arms,10,5,5
55578,Takethisduck,stormscale,447,warrior,arms,11,5,6
55579,Kviqr,auchindoun,447,warrior,arms,11,5,6
55580,Чпонькмашина,soulflayer,447,warrior,arms,17,5,12
55581,Kitano,garona,447,warrior,arms,23,5,18
55582,Orkyu,stormrage,444,warrior,arms,11,5,6
55583,Суицидгодх,howling-fjord,431,warrior,arms,11,5,6
55584,Turdgurgler,executus,431,warrior,arms,11,5,6
55585,Gramash,grim-batol,430,warrior,arms,17,5,12
55586,Warriar,sylvanas,426,warrior,arms,17,7,10
55587,Bismárck,nathrezim,426,warrior,arms,15,6,9
55588,Knî,archimonde,426,warrior,arms,15,6,9
55589,Leizey,stormscale,426,warrior,arms,15,6,9
55590,Goreksson,aegwynn,426,warrior,arms,15,6,9
55591,Rathis,arathor,426,warrior,arms,24,6,18
55592,Prime,outland,416,warrior,arms,16,5,11
55593,Ragnarr,ravencrest,416,warrior,arms,16,5,11
55594,Kìrìtosan,pozzo-delleternità,415,warrior,arms,8,5,3
55595,Kylian,aegwynn,415,warrior,arms,11,5,6
55596,Suduri,drakthul,415,warrior,arms,14,5,9
55597,Danx,culte-de-la-rive-noire,413,warrior,arms,16,5,11
55598,Varkoz,sylvanas,400,warrior,arms,7,5,2
55599,Жекабустер,borean-tundra,399,warrior,arms,7,5,2
55600,Xtazen,draenor,384,warrior,arms,6,4,2
55601,Howdoulose,dun-modr,384,warrior,arms,6,4,2
55602,Thuder,sylvanas,384,warrior,arms,6,4,2
55603,Voi,jaedenar,384,warrior,arms,6,4,2
55604,Alaerion,magtheridon,384,warrior,arms,6,4,2
55605,Delvirx,draenor,384,warrior,arms,6,4,2
55606,Pappyza,hyjal,384,warrior,arms,6,4,2
55607,Forsi,draenor,384,warrior,arms,6,4,2
55608,Ddfxz,draenor,384,warrior,arms,6,4,2
55609,Eseishard,hyjal,384,warrior,arms,6,4,2
55610,Spiokra,hellscream,384,warrior,arms,6,4,2
55611,Рандомвар,howling-fjord,384,warrior,arms,6,4,2
55612,Gipsylove,twisting-nether,384,warrior,arms,6,4,2
55613,Kayhw,stormscale,384,warrior,arms,6,4,2
55614,Sucemabanner,hyjal,384,warrior,arms,6,4,2
55615,Sveafy,ravencrest,384,warrior,arms,6,4,2
55616,Rëvenge,burning-legion,384,warrior,arms,6,4,2
55617,Baluste,culte-de-la-rive-noire,384,warrior,arms,6,4,2
55618,Bìgre,la-croisade-écarlate,384,warrior,arms,6,4,2
55619,Haikyuu,blackhand,384,warrior,arms,6,4,2
55620,Mashooxd,archimonde,384,warrior,arms,6,4,2
55621,Intrepid,dun-modr,384,warrior,arms,6,4,2
55622,Cebystance,kazzak,384,warrior,arms,6,4,2
55623,Thorbjør,silvermoon,384,warrior,arms,6,4,2
55624,Chmg,kirin-tor,384,warrior,arms,6,4,2
55625,Elsiâs,aegwynn,384,warrior,arms,6,4,2
55626,Qvicfrito,ravencrest,384,warrior,arms,6,4,2
55627,Fknslow,ravencrest,384,warrior,arms,6,4,2
55628,Akión,zuljin,384,warrior,arms,6,4,2
55629,Reckxpeep,twisting-nether,384,warrior,arms,6,4,2
55630,Tirex,stormscale,384,warrior,arms,6,4,2
55631,Kisoshi,tarren-mill,384,warrior,arms,6,4,2
55632,Dallion,azjolnerub,384,warrior,arms,6,4,2
55633,Wïn,silvermoon,384,warrior,arms,6,4,2
55634,Выбьюглазик,gordunni,384,warrior,arms,6,4,2
55635,Bandfør,archimonde,384,warrior,arms,6,4,2
55636,Abrogatio,emeriss,384,warrior,arms,6,4,2
55637,Ryuuzetsu,drakthul,384,warrior,arms,6,4,2
55638,Olfik,drakthul,384,warrior,arms,6,4,2
55639,Fleshwerk,silvermoon,384,warrior,arms,6,4,2
55640,Goretterog,ysondre,384,warrior,arms,6,4,2
55641,Mayback,pozzo-delleternità,384,warrior,arms,6,4,2
55642,Fløxswarri,blackmoore,384,warrior,arms,6,4,2
55643,Bjornn,azjolnerub,384,warrior,arms,6,4,2
55644,Лагалиер,borean-tundra,384,warrior,arms,6,4,2
55645,Måydåy,twisting-nether,384,warrior,arms,6,4,2
55646,Lakri,chants-éternels,384,warrior,arms,6,4,2
55647,Fîlzlaus,area-52,384,warrior,arms,6,4,2
55648,Rastaj,defias-brotherhood,384,warrior,arms,6,4,2
55649,Garad,frostmane,384,warrior,arms,6,4,2
55650,Имяужезанято,gordunni,384,warrior,arms,6,4,2
55651,Ricovega,kazzak,384,warrior,arms,6,4,2
55652,Kielon,kazzak,384,warrior,arms,6,4,2
55653,Swig,twisting-nether,384,warrior,arms,6,4,2
55654,Ansàvage,kazzak,384,warrior,arms,6,4,2
55655,Ðíñøðøng,ravencrest,384,warrior,arms,6,4,2
55656,Гигасмэш,gordunni,384,warrior,arms,6,4,2
55657,Ødräcîë,silvermoon,384,warrior,arms,6,4,2
55658,Haîltøkîng,alakir,384,warrior,arms,6,4,2
55659,Xladérz,ravencrest,384,warrior,arms,6,4,2
55660,Galous,burning-blade,384,warrior,arms,6,4,2
55661,Zeó,silvermoon,384,warrior,arms,6,4,2
55662,Dimitrow,frostmane,384,warrior,arms,6,4,2
55663,Susugar,ysondre,384,warrior,arms,6,4,2
55664,Кринжеверт,howling-fjord,384,warrior,arms,6,4,2
55665,Bindcry,ahnqiraj,384,warrior,arms,6,4,2
55666,Роудс,soulflayer,384,warrior,arms,6,4,2
55667,Kalym,malygos,384,warrior,arms,6,4,2
55668,Боссберс,howling-fjord,384,warrior,arms,6,4,2
55669,Фиббоначи,deathguard,384,warrior,arms,6,4,2
55670,Braveorc,kazzak,384,warrior,arms,6,4,2
55671,Màrv,ravencrest,384,warrior,arms,6,4,2
55672,Bjornska,defias-brotherhood,384,warrior,arms,6,4,2
55673,Swaàg,archimonde,384,warrior,arms,6,4,2
55674,Тандеракс,soulflayer,384,warrior,arms,6,4,2
55675,Achîlles,twisting-nether,384,warrior,arms,6,4,2
55676,Dräparren,ragnaros,384,warrior,arms,6,4,2
55677,Highbuffalo,kazzak,384,warrior,arms,6,4,2
55678,Ярыйваряг,soulflayer,384,warrior,arms,6,4,2
55679,Anubisra,alakir,384,warrior,arms,6,4,2
55680,Ceen,alakir,384,warrior,arms,6,4,2
55681,Warzër,archimonde,384,warrior,arms,6,4,2
55682,Slante,darksorrow,384,warrior,arms,6,4,2
55683,Kevlarsusan,the-maelstrom,384,warrior,arms,6,4,2
55684,Beznacaj,outland,384,warrior,arms,6,4,2
55685,Youstupide,drekthar,384,warrior,arms,6,4,2
55686,Cmonbrah,ravencrest,384,warrior,arms,6,4,2
55687,Aliyáhh,blackrock,384,warrior,arms,6,4,2
55688,Abunai,thrall,384,warrior,arms,6,4,2
55689,Ivâar,archimonde,384,warrior,arms,6,4,2
55690,Rimvar,alleria,384,warrior,arms,6,4,2
55691,Tejkopejko,kazzak,384,warrior,arms,6,4,2
55692,Unchåined,burning-legion,384,warrior,arms,6,4,2
55693,Ветросвист,gordunni,384,warrior,arms,6,4,2
55694,Syjin,antonidas,384,warrior,arms,6,4,2
55695,Besån,ragnaros,384,warrior,arms,7,4,3
55696,Sinimfzugzug,eredar,384,warrior,arms,10,5,5
55697,Tweener,azjolnerub,384,warrior,arms,8,4,4
55698,Merkakis,argent-dawn,384,warrior,arms,15,5,10
55699,Cøbe,arthas,384,warrior,arms,12,4,8
55700,Executorä,stormscale,384,warrior,arms,12,4,8
55701,Khvor,blackmoore,384,warrior,arms,12,4,8
55702,Арристокррат,soulflayer,384,warrior,arms,12,4,8
55703,Stuffed,blackrock,384,warrior,arms,12,4,8
55704,Анусбрейкер,soulflayer,384,warrior,arms,12,4,8
55705,Starkz,hellscream,384,warrior,arms,12,4,8
55706,Nerfslam,stormscale,384,warrior,arms,12,4,8
55707,Eýoe,ragnaros,384,warrior,arms,12,4,8
55708,Evermoon,sanguino,384,warrior,arms,12,4,8
55709,Gorok,culte-de-la-rive-noire,384,warrior,arms,12,4,8
55710,Oesche,frostmourne,384,warrior,arms,12,4,8
55711,Kussetrold,outland,384,warrior,arms,12,4,8
55712,Rïven,los-errantes,384,warrior,arms,12,4,8
55713,Deathrazór,stormscale,384,warrior,arms,12,4,8
55714,Лайонхартед,soulflayer,384,warrior,arms,12,4,8
55715,Farewe,lightbringer,384,warrior,arms,12,4,8
55716,Linberg,ysondre,384,warrior,arms,12,4,8
55717,Ellissari,tirion,384,warrior,arms,12,4,8
55718,Gkhan,draenor,384,warrior,arms,12,4,8
55719,Pillorrior,ambossar,384,warrior,arms,12,4,8
55720,Iiam,kilrogg,384,warrior,arms,12,4,8
55721,Фаллопиев,borean-tundra,384,warrior,arms,12,4,8
55722,Zersei,los-errantes,384,warrior,arms,12,4,8
55723,Cryos,destromath,384,warrior,arms,12,4,8
55724,Wilko,twisting-nether,384,warrior,arms,12,4,8
55725,Syel,sinstralis,384,warrior,arms,12,4,8
55726,Azdrubal,outland,384,warrior,arms,12,4,8
55727,Ambraxon,blackmoore,384,warrior,arms,12,4,8
55728,Dataproffs,outland,384,warrior,arms,12,4,8
55729,Péter,arathor,384,warrior,arms,12,4,8
55730,Джанобу,soulflayer,384,warrior,arms,12,4,8
55731,Skyrrskyr,blackrock,384,warrior,arms,12,4,8
55732,Dwarfdruine,dun-modr,384,warrior,arms,12,4,8
55733,Schjøtt,ravencrest,384,warrior,arms,12,4,8
55734,Sinkiss,archimonde,384,warrior,arms,12,4,8
55735,Brokenrage,twisting-nether,384,warrior,arms,12,4,8
55736,Xavari,twisting-nether,384,warrior,arms,12,4,8
55737,Pushh,dun-modr,384,warrior,arms,12,4,8
55738,Arrhennius,kazzak,384,warrior,arms,12,4,8
55739,Hubusan,blackmoore,384,warrior,arms,12,4,8
55740,Ryuma,lordaeron,384,warrior,arms,12,4,8
55741,Invictàs,hyjal,384,warrior,arms,12,4,8
55742,Gregórry,eredar,384,warrior,arms,12,4,8
55743,Sonyd,tarren-mill,384,warrior,arms,12,4,8
55744,Tenramar,silvermoon,384,warrior,arms,12,4,8
55745,Adorlyna,silvermoon,384,warrior,arms,12,4,8
55746,Jesuisgaydsl,archimonde,384,warrior,arms,12,4,8
55747,Woghard,drakthul,384,warrior,arms,12,4,8
55748,Arxnamus,silvermoon,384,warrior,arms,12,4,8
55749,Osteskanken,ravencrest,384,warrior,arms,12,4,8
55750,Xállek,veknilash,384,warrior,arms,12,4,8
55751,Rngcarrier,sylvanas,384,warrior,arms,12,4,8
55752,Stragga,eredar,384,warrior,arms,12,4,8
55753,Mickyrex,hyjal,384,warrior,arms,12,4,8
55754,Nameless,malganis,384,warrior,arms,12,4,8
55755,Borion,blackmoore,384,warrior,arms,12,4,8
55756,Whyduck,silvermoon,384,warrior,arms,12,4,8
55757,Слоз,gordunni,384,warrior,arms,12,4,8
55758,Ðræberen,kazzak,384,warrior,arms,12,4,8
55759,Ceojohnny,ravencrest,384,warrior,arms,12,4,8
55760,Mórghúlís,aegwynn,384,warrior,arms,12,4,8
55761,Mârcxb,antonidas,384,warrior,arms,12,4,8
55762,Jeyay,defias-brotherhood,384,warrior,arms,12,4,8
55763,Drazug,defias-brotherhood,384,warrior,arms,12,4,8
55764,Kasperw,kazzak,384,warrior,arms,12,4,8
55765,Testortv,twisting-nether,384,warrior,arms,12,4,8
55766,Fzit,kazzak,384,warrior,arms,12,4,8
55767,Heclatos,hyjal,384,warrior,arms,12,4,8
55768,Minetaur,burning-legion,384,warrior,arms,12,4,8
55769,Rastov,argent-dawn,384,warrior,arms,12,4,8
55770,Qwaggie,draenor,384,warrior,arms,12,4,8
55771,Stanislav,tarren-mill,384,warrior,arms,12,4,8
55772,Flugan,vashj,384,warrior,arms,12,4,8
55773,Фаталлес,galakrond,384,warrior,arms,12,4,8
55774,Sebotagelol,twisting-nether,384,warrior,arms,12,4,8
55775,Brrochacho,defias-brotherhood,384,warrior,arms,12,4,8
55776,Вамвоосна,gordunni,384,warrior,arms,12,4,8
55777,Sovax,ravencrest,384,warrior,arms,12,4,8
55778,Blackzor,ragnaros,384,warrior,arms,12,4,8
55779,Sveñor,the-maelstrom,384,warrior,arms,12,4,8
55780,Oglisten,archimonde,384,warrior,arms,12,4,8
55781,Apemonkeydk,kazzak,384,warrior,arms,12,4,8
55782,Gromock,the-maelstrom,384,warrior,arms,12,4,8
55783,Арбелоа,gordunni,384,warrior,arms,12,4,8
55784,Cyrø,blackmoore,384,warrior,arms,12,4,8
55785,Kgx,argent-dawn,384,warrior,arms,12,4,8
55786,Blaackbeard,blackmoore,384,warrior,arms,12,4,8
55787,Freutag,azshara,384,warrior,arms,12,4,8
55788,Raynorwarr,tarren-mill,384,warrior,arms,12,4,8
55789,Boomxi,burning-legion,384,warrior,arms,12,4,8
55790,Schultze,kazzak,384,warrior,arms,12,4,8
55791,Axero,drakthul,384,warrior,arms,12,4,8
55792,Auguston,argent-dawn,384,warrior,arms,12,4,8
55793,Hiraclès,archimonde,384,warrior,arms,12,4,8
55794,Веоленс,gordunni,384,warrior,arms,12,4,8
55795,Gigac,ragnaros,384,warrior,arms,12,4,8
55796,Альмас,galakrond,384,warrior,arms,12,4,8
55797,Дахирарг,fordragon,384,warrior,arms,12,4,8
55798,Zeover,ragnaros,384,warrior,arms,12,4,8
55799,Haldrium,malganis,384,warrior,arms,12,4,8
55800,Karadayii,blackmoore,384,warrior,arms,12,4,8
55801,Huihui,die-aldor,384,warrior,arms,12,4,8
55802,Модныйклык,eversong,384,warrior,arms,12,4,8
55803,Wildblow,ravencrest,384,warrior,arms,12,4,8
55804,Rfgpwhfgjawr,ravencrest,384,warrior,arms,12,4,8
55805,Ærion,die-aldor,384,warrior,arms,12,4,8
55806,Сэмвариор,gordunni,384,warrior,arms,12,4,8
55807,Kronner,blackmoore,384,warrior,arms,12,4,8
55808,Guarn,archimonde,384,warrior,arms,12,4,8
55809,Chrid,silvermoon,384,warrior,arms,12,4,8
55810,Ouryuu,hyjal,384,warrior,arms,12,4,8
55811,Chadgarrosh,tarren-mill,384,warrior,arms,12,4,8
55812,Craftorar,defias-brotherhood,384,warrior,arms,12,4,8
55813,Luciferkhan,twisting-nether,384,warrior,arms,12,4,8
55814,Willadimore,ravencrest,384,warrior,arms,12,4,8
55815,Phalek,ravencrest,384,warrior,arms,14,4,10
55816,Omcat,dun-modr,384,warrior,arms,27,6,21
55817,Erololi,sanguino,384,warrior,arms,18,4,14
55818,Маллал,soulflayer,384,warrior,arms,18,4,14
55819,Pantsupic,archimonde,384,warrior,arms,18,4,14
55820,Ganaroth,tarren-mill,384,warrior,arms,18,4,14
55821,Ceb,drakthul,384,warrior,arms,18,4,14
55822,Xxenaa,drakthul,384,warrior,arms,18,4,14
55823,Kaij,draenor,384,warrior,arms,18,4,14
55824,Moosewood,draenor,384,warrior,arms,18,4,14
55825,Wifioffline,silvermoon,384,warrior,arms,18,4,14
55826,Vanaxd,blackrock,384,warrior,arms,20,4,16
55827,Реф,gordunni,383,warrior,arms,6,4,2
55828,Ironstep,silvermoon,383,warrior,arms,6,4,2
55829,Adelphi,blackrock,383,warrior,arms,6,4,2
55830,Asurian,runetotem,383,warrior,arms,6,4,2
55831,Красаучик,razuvious,383,warrior,arms,6,4,2
55832,Kãzzgot,burning-legion,383,warrior,arms,6,4,2
55833,Димаджер,razuvious,383,warrior,arms,6,4,2
55834,Angrytmyself,silvermoon,383,warrior,arms,6,4,2
55835,Халиоссф,gordunni,383,warrior,arms,9,5,4
55836,Mashamasha,twisting-nether,383,warrior,arms,9,5,4
55837,Варинуб,soulflayer,383,warrior,arms,12,6,6
55838,Shimy,pozzo-delleternità,383,warrior,arms,12,4,8
55839,Meetto,argent-dawn,383,warrior,arms,12,4,8
55840,Bassenheim,deathwing,383,warrior,arms,12,4,8
55841,Brandox,defias-brotherhood,383,warrior,arms,12,4,8
55842,Варзибейра,blackscar,383,warrior,arms,12,4,8
55843,Familyguy,sylvanas,383,warrior,arms,12,4,8
55844,Alhexander,dun-modr,383,warrior,arms,12,4,8
55845,Алибастор,galakrond,383,warrior,arms,12,4,8
55846,Dundee,sanguino,383,warrior,arms,12,4,8
55847,Khaczer,thunderhorn,383,warrior,arms,18,4,14
55848,Dracos,mannoroth,383,warrior,arms,18,4,14
55849,Xonnico,ravencrest,383,warrior,arms,18,4,14
55850,Maxai,outland,382,warrior,arms,6,4,2
55851,Brindzema,doomhammer,382,warrior,arms,6,4,2
55852,Aethwa,stormscale,382,warrior,arms,6,4,2
55853,Fatbud,tarren-mill,382,warrior,arms,6,4,2
55854,Nuxx,tarren-mill,382,warrior,arms,12,4,8
55855,Epmeowpewpew,turalyon,382,warrior,arms,18,4,14
55856,Аскольд,deathguard,379,warrior,arms,12,4,8
55857,Асстероид,galakrond,379,warrior,arms,12,4,8
55858,Oxascand,kazzak,367,warrior,arms,17,4,13
55859,Отсекатель,howling-fjord,367,warrior,arms,17,4,13
55860,Свинореззка,howling-fjord,352,warrior,arms,10,4,6
55861,Mynoona,stormscale,351,warrior,arms,11,4,7
55862,Shînta,hyjal,351,warrior,arms,11,4,7
55863,Badroch,kazzak,351,warrior,arms,11,4,7
55864,Upholder,xavius,351,warrior,arms,11,4,7
55865,Лесковер,howling-fjord,351,warrior,arms,11,4,7
55866,Kriegerlutz,blackmoore,335,warrior,arms,11,4,7
55867,Steels,outland,331,warrior,arms,11,4,7
55868,Bêlier,hyjal,329,warrior,arms,16,6,10
55869,Dyingdog,kazzak,320,warrior,arms,10,4,6
55870,Scarlettjo,outland,320,warrior,arms,10,4,6
55871,Тоштайн,gordunni,319,warrior,arms,5,4,1
55872,Babb,kazzak,319,warrior,arms,5,4,1
55873,Kegslayer,darksorrow,319,warrior,arms,8,4,4
55874,Savaski,thrall,304,warrior,arms,7,4,3
55875,Lovehope,stormscale,304,warrior,arms,7,4,3
55876,Warrez,azuremyst,304,warrior,arms,7,4,3
55877,Dattebane,silvermoon,304,warrior,arms,13,4,9
55878,Spearmisser,argent-dawn,288,warrior,arms,6,3,3
55879,Klistertejp,argent-dawn,288,warrior,arms,6,3,3
55880,Кроуфури,gordunni,288,warrior,arms,6,3,3
55881,Klunkepumper,ravencrest,288,warrior,arms,6,3,3
55882,Skullbash,outland,288,warrior,arms,6,3,3
55883,Knubbz,ravencrest,288,warrior,arms,6,3,3
55884,Srbooty,kazzak,288,warrior,arms,6,3,3
55885,Imherhusband,ravencrest,288,warrior,arms,6,3,3
55886,Grók,outland,288,warrior,arms,6,3,3
55887,Goochi,turalyon,288,warrior,arms,6,3,3
55888,Smásher,thrall,288,warrior,arms,6,3,3
55889,Exy,kazzak,288,warrior,arms,6,3,3
55890,Rîiper,ysondre,288,warrior,arms,6,3,3
55891,Inflacija,grim-batol,288,warrior,arms,6,3,3
55892,Robitusin,ragnaros,288,warrior,arms,6,3,3
55893,Dðni,archimonde,288,warrior,arms,6,3,3
55894,Indiannaa,draenor,288,warrior,arms,6,3,3
55895,Moorgoth,ysondre,288,warrior,arms,6,3,3
55896,Rådne,argent-dawn,288,warrior,arms,6,3,3
55897,Ashkandur,antonidas,288,warrior,arms,6,3,3
55898,Hemèra,hyjal,288,warrior,arms,6,3,3
55899,Stãrscream,ysondre,288,warrior,arms,6,3,3
55900,Blinkcharge,frostmane,288,warrior,arms,6,3,3
55901,Suizix,blackrock,288,warrior,arms,6,3,3
55902,Contdem,kazzak,288,warrior,arms,6,3,3
55903,Afes,kazzak,288,warrior,arms,6,3,3
55904,Zleyni,blackrock,288,warrior,arms,6,3,3
55905,Instamerk,doomhammer,288,warrior,arms,6,3,3
55906,Critwar,draenor,288,warrior,arms,6,3,3
55907,Sentenzah,arakarahm,288,warrior,arms,6,3,3
55908,Pouckette,hyjal,288,warrior,arms,6,3,3
55909,Culwyn,frostmane,288,warrior,arms,6,3,3
55910,Raïgã,hyjal,288,warrior,arms,6,3,3
55911,Slayermaxx,kazzak,288,warrior,arms,6,3,3
55912,Mòóds,malganis,288,warrior,arms,6,3,3
55913,Féélmyfury,tarren-mill,288,warrior,arms,6,3,3
55914,Xaidos,antonidas,288,warrior,arms,6,3,3
55915,Pwncallxx,kazzak,288,warrior,arms,6,3,3
55916,Elainax,eredar,288,warrior,arms,6,3,3
55917,Neaka,archimonde,288,warrior,arms,6,3,3
55918,Cptwheelchr,blackmoore,288,warrior,arms,6,3,3
55919,Warriur,outland,288,warrior,arms,6,3,3
55920,Pector,grim-batol,288,warrior,arms,6,3,3
55921,Bundo,outland,288,warrior,arms,6,3,3
55922,Issus,aggra-português,288,warrior,arms,6,3,3
55923,Jammy,dentarg,288,warrior,arms,6,3,3
55924,Irastah,frostmane,288,warrior,arms,6,3,3
55925,Boig,ragnaros,288,warrior,arms,6,3,3
55926,Noriela,archimonde,288,warrior,arms,6,3,3
55927,Hatefull,onyxia,288,warrior,arms,6,3,3
55928,Юргоз,howling-fjord,288,warrior,arms,6,3,3
55929,Airethon,proudmoore,288,warrior,arms,6,3,3
55930,Risara,outland,288,warrior,arms,6,3,3
55931,Cerßêre,archimonde,288,warrior,arms,6,3,3
55932,Dekzu,stormscale,288,warrior,arms,6,3,3
55933,Topur,defias-brotherhood,288,warrior,arms,6,3,3
55934,Miniwitts,ravencrest,288,warrior,arms,6,3,3
55935,Thesituation,onyxia,288,warrior,arms,6,3,3
55936,Evís,ragnaros,288,warrior,arms,6,3,3
55937,Wárríor,ragnaros,288,warrior,arms,6,3,3
55938,Stompare,tarren-mill,288,warrior,arms,6,3,3
55939,Mightyrage,draenor,288,warrior,arms,6,3,3
55940,Xiom,blackrock,288,warrior,arms,6,3,3
55941,Exhumator,blackhand,288,warrior,arms,6,3,3
55942,Ragnärey,voljin,288,warrior,arms,6,3,3
55943,Суферна,howling-fjord,288,warrior,arms,6,3,3
55944,Alaë,archimonde,288,warrior,arms,6,3,3
55945,Vãnquish,archimonde,288,warrior,arms,6,3,3
55946,Топлюзаорду,borean-tundra,288,warrior,arms,6,3,3
55947,Alphyn,veknilash,288,warrior,arms,6,3,3
55948,Стальнойорех,gordunni,288,warrior,arms,6,3,3
55949,Lìcious,outland,288,warrior,arms,6,3,3
55950,Nofêar,anubarak,288,warrior,arms,6,3,3
55951,Kyraeth,defias-brotherhood,288,warrior,arms,6,3,3
55952,Flürix,outland,288,warrior,arms,6,3,3
55953,Hydracleave,ravencrest,288,warrior,arms,6,3,3
55954,Неомх,howling-fjord,288,warrior,arms,6,3,3
55955,Greatsword,turalyon,288,warrior,arms,6,3,3
55956,Koffìe,tarren-mill,288,warrior,arms,6,3,3
55957,Crimmwarr,aegwynn,288,warrior,arms,6,3,3
55958,Mønzie,outland,288,warrior,arms,6,3,3
55959,Gnarrwarr,eredar,288,warrior,arms,6,3,3
55960,Xsasuke,ragnaros,288,warrior,arms,6,3,3
55961,Tojaraa,kazzak,288,warrior,arms,6,3,3
55962,Drengr,blackhand,288,warrior,arms,6,3,3
55963,Изикол,blackscar,288,warrior,arms,6,3,3
55964,Дзертуф,fordragon,288,warrior,arms,6,3,3
55965,Møtomoto,defias-brotherhood,288,warrior,arms,6,3,3
55966,Warwarsat,ysondre,288,warrior,arms,6,3,3
55967,Hanibalbarca,tarren-mill,288,warrior,arms,6,3,3
55968,Farnorn,kazzak,288,warrior,arms,6,3,3
55969,Xiphiatwo,ravencrest,288,warrior,arms,6,3,3
55970,Toleck,aegwynn,288,warrior,arms,6,3,3
55971,Yotanwa,aegwynn,288,warrior,arms,6,3,3
55972,Mauser,thrall,288,warrior,arms,6,3,3
55973,Ragewin,kelthuzad,288,warrior,arms,6,3,3
55974,Hietfield,twisting-nether,288,warrior,arms,6,3,3
55975,Rasvamaksa,stormscale,288,warrior,arms,6,3,3
55976,Venturez,stormscale,288,warrior,arms,6,3,3
55977,Quáker,stormscale,288,warrior,arms,6,3,3
55978,Tinydik,stormscale,288,warrior,arms,6,3,3
55979,Somalisktjur,tarren-mill,288,warrior,arms,6,3,3
55980,Экзекуторх,gordunni,288,warrior,arms,6,3,3
55981,Shredded,stormscale,288,warrior,arms,6,3,3
55982,Bleedmuch,silvermoon,288,warrior,arms,6,3,3
55983,Mobyl,twisting-nether,288,warrior,arms,6,3,3
55984,Soulmatee,aegwynn,288,warrior,arms,6,3,3
55985,Baiganya,neptulon,288,warrior,arms,6,3,3
55986,Ididntbindit,stormscale,288,warrior,arms,6,3,3
55987,Nuhilug,tarren-mill,288,warrior,arms,6,3,3
55988,Tumuerte,dun-modr,288,warrior,arms,6,3,3
55989,Twelvearmsun,tarren-mill,288,warrior,arms,6,3,3
55990,Raistwar,magtheridon,288,warrior,arms,6,3,3
55991,Bânkai,aegwynn,288,warrior,arms,6,3,3
55992,Kazzuk,dentarg,288,warrior,arms,6,3,3
55993,Mukcho,sylvanas,288,warrior,arms,6,3,3
55994,Tommytorres,stormscale,288,warrior,arms,6,3,3
55995,Ranndall,blackrock,288,warrior,arms,6,3,3
55996,Mogguh,tarren-mill,288,warrior,arms,6,3,3
55997,Resttanis,arathor,288,warrior,arms,6,3,3
55998,Fnoon,taerar,288,warrior,arms,6,3,3
55999,Aestl,blackhand,288,warrior,arms,6,3,3
56000,Barbatos,saurfang,288,warrior,arms,6,3,3
56001,Sharn,emeriss,288,warrior,arms,6,3,3
56002,Köftemecx,blackrock,288,warrior,arms,6,3,3
56003,Karsul,shendralar,288,warrior,arms,6,3,3
56004,Чтота,gordunni,288,warrior,arms,6,3,3
56005,Sóuler,blackhand,288,warrior,arms,6,3,3
56006,Stahlhund,silvermoon,288,warrior,arms,6,3,3
56007,Béhrus,blackmoore,288,warrior,arms,6,3,3
56008,Byrnjolf,zuljin,288,warrior,arms,6,3,3
56009,Грассфеникс,gordunni,288,warrior,arms,6,3,3
56010,Îgris,sanguino,288,warrior,arms,6,3,3
56011,Flava,drakthul,288,warrior,arms,6,3,3
56012,Venomflex,sanguino,288,warrior,arms,6,3,3
56013,Fantawesome,ragnaros,288,warrior,arms,6,3,3
56014,Eradya,ravencrest,288,warrior,arms,6,3,3
56015,Waron,dalaran,288,warrior,arms,6,3,3
56016,Madbert,drakthul,288,warrior,arms,6,3,3
56017,Tankdepalo,sanguino,288,warrior,arms,6,3,3
56018,Frenzyqt,zuljin,288,warrior,arms,6,3,3
56019,Thebiggreen,twisting-nether,288,warrior,arms,6,3,3
56020,Waescanor,ragnaros,288,warrior,arms,6,3,3
56021,Luckyfelix,blackmoore,288,warrior,arms,6,3,3
56022,Citrok,dun-modr,288,warrior,arms,6,3,3
56023,Sïmstärxzy,hakkar,288,warrior,arms,6,3,3
56024,Whiskes,silvermoon,288,warrior,arms,6,3,3
56025,Инкула,gordunni,288,warrior,arms,6,3,3
56026,Тотбывалый,soulflayer,288,warrior,arms,6,3,3
56027,Enkö,twisting-nether,288,warrior,arms,6,3,3
56028,Stiefbrudah,blackmoore,288,warrior,arms,6,3,3
56029,Lawkh,sanguino,288,warrior,arms,6,3,3
56030,Bolss,silvermoon,288,warrior,arms,6,3,3
56031,Kampfrausch,blackmoore,288,warrior,arms,6,3,3
56032,Khorgash,ravencrest,288,warrior,arms,6,3,3
56033,Extrémex,stormscale,288,warrior,arms,6,3,3
56034,Onoclus,sylvanas,288,warrior,arms,6,3,3
56035,Kheiden,silvermoon,288,warrior,arms,6,3,3
56036,Razza,ravencrest,288,warrior,arms,6,3,3
56037,Xqty,ravencrest,288,warrior,arms,6,3,3
56038,Alvis,nathrezim,288,warrior,arms,6,3,3
56039,Gylfanders,the-maelstrom,288,warrior,arms,6,3,3
56040,Фэймстар,soulflayer,288,warrior,arms,6,3,3
56041,Vorri,ravencrest,288,warrior,arms,6,3,3
56042,Mauricet,elune,288,warrior,arms,6,3,3
56043,Доррин,deathguard,288,warrior,arms,6,3,3
56044,Aedin,ravencrest,288,warrior,arms,6,3,3
56045,Bigmalx,darkspear,288,warrior,arms,6,3,3
56046,Fotmheróqtxd,ravencrest,288,warrior,arms,6,3,3
56047,Lödbrök,dalaran,288,warrior,arms,6,3,3
56048,Wellus,silvermoon,288,warrior,arms,6,3,3
56049,Pioneer,blackhand,288,warrior,arms,6,3,3
56050,Doghxnterx,ravencrest,288,warrior,arms,6,3,3
56051,Träglik,thrall,288,warrior,arms,6,3,3
56052,Retter,ravencrest,288,warrior,arms,6,3,3
56053,Jimli,malygos,288,warrior,arms,6,3,3
56054,Meywara,blackhand,288,warrior,arms,6,3,3
56055,Nurfdw,ravencrest,288,warrior,arms,6,3,3
56056,Zalameh,sylvanas,288,warrior,arms,6,3,3
56057,Kindface,the-maelstrom,288,warrior,arms,6,3,3
56058,Mightyzuv,the-maelstrom,288,warrior,arms,6,3,3
56059,Deniosan,blackhand,288,warrior,arms,6,3,3
56060,Lacos,drakthul,288,warrior,arms,6,3,3
56061,Nahkampfnoob,blackmoore,288,warrior,arms,6,3,3
56062,Virginity,sylvanas,288,warrior,arms,6,3,3
56063,Morgendämeru,baelgun,288,warrior,arms,6,3,3
56064,Goinhamx,blackhand,288,warrior,arms,6,3,3
56065,Ахе,deathguard,288,warrior,arms,6,3,3
56066,Ликано,greymane,288,warrior,arms,6,3,3
56067,Дэйст,ashenvale,288,warrior,arms,6,3,3
56068,Willywolxx,silvermoon,288,warrior,arms,6,3,3
56069,Fargon,ravencrest,288,warrior,arms,6,3,3
56070,Гениауч,eversong,288,warrior,arms,6,3,3
56071,Arachnoyd,drakthul,288,warrior,arms,6,3,3
56072,Ланат,ashenvale,288,warrior,arms,6,3,3
56073,Sktnsilv,malfurion,288,warrior,arms,6,3,3
56074,Suwarri,antonidas,288,warrior,arms,9,4,5
56075,Ëlränger,dun-modr,288,warrior,arms,9,4,5
56076,Monforte,silvermoon,288,warrior,arms,9,3,6
56077,Elkatar,stormscale,288,warrior,arms,9,3,6
56078,Kuchîoff,uldaman,288,warrior,arms,10,3,7
56079,Balferenfgt,magtheridon,288,warrior,arms,15,4,11
56080,Leonídás,blackhand,288,warrior,arms,15,4,11
56081,Raithwall,stormreaver,288,warrior,arms,12,3,9
56082,Ivailowar,ravencrest,288,warrior,arms,12,3,9
56083,Warzaph,ravencrest,288,warrior,arms,12,3,9
56084,Awewar,crushridge,288,warrior,arms,12,3,9
56085,Aiwar,tarren-mill,288,warrior,arms,12,3,9
56086,Refl,kazzak,288,warrior,arms,12,3,9
56087,Burbidge,silvermoon,288,warrior,arms,12,3,9
56088,Telrion,silvermoon,288,warrior,arms,12,3,9
56089,Bozwa,silvermoon,288,warrior,arms,12,3,9
56090,Goroth,vashj,288,warrior,arms,12,3,9
56091,Smökey,silvermoon,288,warrior,arms,12,3,9
56092,Héraclès,ravencrest,288,warrior,arms,12,3,9
56093,Grodor,alakir,288,warrior,arms,12,3,9
56094,Амбробенне,soulflayer,288,warrior,arms,12,3,9
56095,Stoutsteel,kazzak,288,warrior,arms,12,3,9
56096,Mistafleex,hyjal,288,warrior,arms,12,3,9
56097,Willraxx,draenor,288,warrior,arms,12,3,9
56098,Allmight,gorgonnash,288,warrior,arms,12,3,9
56099,Pulx,dun-modr,288,warrior,arms,12,3,9
56100,Executioner,ravencrest,288,warrior,arms,12,3,9
56101,Gloindal,pozzo-delleternità,288,warrior,arms,12,3,9
56102,Xtylu,cthun,288,warrior,arms,12,3,9
56103,Lukkass,ravencrest,288,warrior,arms,12,3,9
56104,Renix,auchindoun,288,warrior,arms,12,3,9
56105,Algazarra,aggra-português,288,warrior,arms,12,3,9
56106,Jivua,blackrock,288,warrior,arms,12,3,9
56107,Acidumcremor,burning-legion,288,warrior,arms,12,3,9
56108,Тирхо,gordunni,288,warrior,arms,12,3,9
56109,Btkayy,tarren-mill,288,warrior,arms,12,3,9
56110,Оверфлок,howling-fjord,288,warrior,arms,12,3,9
56111,Брокксигарр,borean-tundra,288,warrior,arms,12,3,9
56112,Gabbz,aggra-português,288,warrior,arms,12,3,9
56113,Worcan,blackmoore,288,warrior,arms,12,3,9
56114,Rychu,hellfire,288,warrior,arms,12,3,9
56115,Nerdcorex,blackrock,288,warrior,arms,12,3,9
56116,Poluneikos,turalyon,288,warrior,arms,12,3,9
56117,Flexay,archimonde,288,warrior,arms,12,3,9
56118,Вениамин,fordragon,288,warrior,arms,12,3,9
56119,Варкрафтор,howling-fjord,288,warrior,arms,12,3,9
56120,Gnomeð,blackrock,288,warrior,arms,12,3,9
56121,Uthric,azuremyst,288,warrior,arms,12,3,9
56122,Brooktar,sanguino,288,warrior,arms,12,3,9
56123,Jimbock,eredar,288,warrior,arms,12,3,9
56124,Conarconarik,zuluhed,288,warrior,arms,12,3,9
56125,Simplyautism,silvermoon,288,warrior,arms,12,3,9
56126,Ysmay,dun-morogh,288,warrior,arms,12,3,9
56127,Danaüs,twisting-nether,288,warrior,arms,12,3,9
56128,Buncljin,draenor,288,warrior,arms,12,3,9
56129,Argean,argent-dawn,288,warrior,arms,12,3,9
56130,Blxxwar,blackmoore,288,warrior,arms,12,3,9
56131,Mino,theradras,288,warrior,arms,12,3,9
56132,Nolavvii,ragnaros,288,warrior,arms,12,3,9
56133,Zhodd,zuljin,288,warrior,arms,12,3,9
56134,Tøytank,twisting-nether,288,warrior,arms,12,3,9
56135,Роглум,blackscar,288,warrior,arms,12,3,9
56136,Mercûry,stormscale,288,warrior,arms,12,3,9
56137,Экзекутэр,soulflayer,288,warrior,arms,12,3,9
56138,Турбобулка,gordunni,288,warrior,arms,12,3,9
56139,Камрадшторм,borean-tundra,288,warrior,arms,12,3,9
56140,Thorgaz,blackmoore,288,warrior,arms,12,3,9
56141,Qdex,kazzak,288,warrior,arms,12,3,9
56142,Gladiatoor,terenas,288,warrior,arms,12,3,9
56143,Danrel,dalaran,288,warrior,arms,12,3,9
56144,Sorryforwhat,stormscale,288,warrior,arms,12,3,9
56145,Bolvarson,malganis,288,warrior,arms,12,3,9
56146,Syruz,malganis,288,warrior,arms,12,3,9
56147,Азизос,gordunni,288,warrior,arms,12,3,9
56148,Armsstrong,blackhand,288,warrior,arms,12,3,9
56149,Snissel,guldan,288,warrior,arms,12,3,9
56150,Баам,fordragon,288,warrior,arms,12,3,9
56151,Currarms,aegwynn,288,warrior,arms,13,3,10
56152,Ervanw,sylvanas,288,warrior,arms,17,3,14
56153,Старыйклоп,blackscar,288,warrior,arms,18,3,15
56154,Rimstealer,tarren-mill,288,warrior,arms,18,3,15
56155,Marax,spinebreaker,288,warrior,arms,18,3,15
56156,Cassetibiat,rashgarroth,288,warrior,arms,18,3,15
56157,Mercaderx,stormscale,287,warrior,arms,6,3,3
56158,Всемкуяолд,gordunni,287,warrior,arms,6,3,3
56159,Warrsong,dun-modr,287,warrior,arms,6,3,3
56160,Blainebonk,arathor,287,warrior,arms,6,3,3
56161,Ironkee,kazzak,287,warrior,arms,6,3,3
56162,Kaazzuraa,hyjal,287,warrior,arms,6,3,3
56163,Teñseî,archimonde,287,warrior,arms,6,3,3
56164,Хелледрин,azuregos,287,warrior,arms,6,3,3
56165,Falaliss,elune,287,warrior,arms,12,3,9
56166,Ymïrjar,sanguino,287,warrior,arms,12,3,9
56167,Freakzy,blackhand,287,warrior,arms,12,3,9
56168,Akawan,ravencrest,287,warrior,arms,12,3,9
56169,Ayatolah,kazzak,287,warrior,arms,12,3,9
56170,Себаст,galakrond,286,warrior,arms,12,3,9
56171,Пунишерс,howling-fjord,286,warrior,arms,12,3,9
56172,Újorcharcos,ragnaros,286,warrior,arms,12,3,9
56173,Thoon,teldrassil,284,warrior,arms,12,3,9
56174,Galidras,nemesis,271,warrior,arms,11,3,8
56175,Warbringér,ravencrest,271,warrior,arms,11,3,8
56176,Evèllon,blackmoore,271,warrior,arms,11,3,8
56177,Gwagonbrabus,twisting-nether,271,warrior,arms,17,3,14
56178,Kanyequest,bloodhoof,266,warrior,arms,15,5,10
56179,Brùtus,exodar,265,warrior,arms,14,5,9
56180,Deci,bronzebeard,256,warrior,arms,10,3,7
56181,Чикенсы,gordunni,256,warrior,arms,10,3,7
56182,Jvpx,silvermoon,256,warrior,arms,10,3,7
56183,Lokkara,blackrock,255,warrior,arms,8,4,4
56184,Angrethar,tarren-mill,255,warrior,arms,8,4,4
56185,Uki,kazzak,255,warrior,arms,11,3,8
56186,Aleksandar,ravencrest,255,warrior,arms,11,3,8
56187,Nurream,ravencrest,255,warrior,arms,11,3,8
56188,Ânaxi,silvermoon,255,warrior,arms,11,3,8
56189,Legharta,tarren-mill,240,warrior,arms,9,3,6
56190,Ntouziera,silvermoon,239,warrior,arms,5,3,2
56191,Sarma,trollbane,239,warrior,arms,5,3,2
56192,Inselmo,grim-batol,239,warrior,arms,5,3,2
56193,Keffboi,draenor,239,warrior,arms,5,3,2
56194,Renji,proudmoore,239,warrior,arms,5,3,2
56195,Dooguystyle,archimonde,239,warrior,arms,5,3,2
56196,Sloody,ravencrest,239,warrior,arms,5,3,2
56197,Bubidiblumxq,twisting-nether,239,warrior,arms,9,4,5
56198,Porthios,azshara,239,warrior,arms,9,3,6
56199,Xeonair,kazzak,234,warrior,arms,8,4,4
56200,Tstrike,silvermoon,234,warrior,arms,9,4,5
56201,Zyou,stormscale,234,warrior,arms,17,6,11
56202,Myshu,ravencrest,234,warrior,arms,14,4,10
56203,Bloodrâgê,silvermoon,224,warrior,arms,10,3,7
56204,Artaas,drakthul,223,warrior,arms,8,3,5
56205,Justah,silvermoon,208,warrior,arms,7,3,4
56206,Brutariz,silvermoon,208,warrior,arms,7,3,4
56207,Шрекинатор,soulflayer,208,warrior,arms,7,3,4
56208,Rhw,tarren-mill,208,warrior,arms,13,3,10
56209,Sargonas,burning-blade,192,warrior,arms,4,3,1
56210,Toptier,drakthul,192,warrior,arms,4,3,1
56211,Epimeno,tarren-mill,192,warrior,arms,4,3,1
56212,Scootter,ravencrest,192,warrior,arms,9,3,6
56213,Wowbert,frostwolf,192,warrior,arms,9,3,6
56214,Iclickbutton,kazzak,192,warrior,arms,9,3,6
56215,Connorzqt,ravencrest,192,warrior,arms,6,2,4
56216,Aedanath,dragonblight,192,warrior,arms,6,2,4
56217,Gergereja,argent-dawn,192,warrior,arms,6,2,4
56218,Råzor,blackhand,192,warrior,arms,6,2,4
56219,Dajnatarcze,burning-legion,192,warrior,arms,6,2,4
56220,Highoverlord,aggra-português,192,warrior,arms,6,2,4
56221,Tinker,crushridge,192,warrior,arms,6,2,4
56222,Byedriver,kazzak,192,warrior,arms,6,2,4
56223,Chargezon,drakthul,192,warrior,arms,6,2,4
56224,Shieldstand,kazzak,192,warrior,arms,6,2,4
56225,Chloade,burning-legion,192,warrior,arms,6,2,4
56226,Kerando,tirion,192,warrior,arms,6,2,4
56227,Кичисан,howling-fjord,192,warrior,arms,6,2,4
56228,Sxng,deathwing,192,warrior,arms,6,2,4
56229,Tigron,burning-legion,192,warrior,arms,6,2,4
56230,Akkamagosh,argent-dawn,192,warrior,arms,6,2,4
56231,Kíllguard,kazzak,192,warrior,arms,6,2,4
56232,Còle,blackrock,192,warrior,arms,6,2,4
56233,Бормормуш,gordunni,192,warrior,arms,6,2,4
56234,Lâppön,blackmoore,192,warrior,arms,6,2,4
56235,Artemiox,silvermoon,192,warrior,arms,6,2,4
56236,Apolyptica,blackmoore,192,warrior,arms,6,2,4
56237,Труска,ashenvale,192,warrior,arms,6,2,4
56238,Wilæm,argent-dawn,192,warrior,arms,6,2,4
56239,Кереешка,howling-fjord,192,warrior,arms,6,2,4
56240,Pumse,silvermoon,192,warrior,arms,6,2,4
56241,Jdcw,chamber-of-aspects,192,warrior,arms,6,2,4
56242,Toporceanul,kazzak,192,warrior,arms,6,2,4
56243,Darkbehemoth,kazzak,192,warrior,arms,6,2,4
56244,Speiker,blackhand,192,warrior,arms,6,2,4
56245,Апёхэндз,howling-fjord,192,warrior,arms,6,2,4
56246,Bitethedust,darkspear,192,warrior,arms,6,2,4
56247,Djarenn,defias-brotherhood,192,warrior,arms,6,2,4
56248,Loutreboite,archimonde,192,warrior,arms,6,2,4
56249,Rezn,kazzak,192,warrior,arms,6,2,4
56250,Acour,elune,192,warrior,arms,6,2,4
56251,Guttormur,dragonblight,192,warrior,arms,6,2,4
56252,ßandit,ravencrest,192,warrior,arms,6,2,4
56253,Lildiabeto,darkspear,192,warrior,arms,6,2,4
56254,Neozz,ravencrest,192,warrior,arms,6,2,4
56255,Touthi,archimonde,192,warrior,arms,6,2,4
56256,Kogän,ragnaros,192,warrior,arms,6,2,4
56257,Athrea,senjin,192,warrior,arms,6,2,4
56258,Xatit,ravencrest,192,warrior,arms,6,2,4
56259,Azurnok,argent-dawn,192,warrior,arms,6,2,4
56260,Vexari,twisting-nether,192,warrior,arms,6,2,4
56261,Spaiché,azshara,192,warrior,arms,6,2,4
56262,Stonlocked,blackhand,192,warrior,arms,6,2,4
56263,Shinychan,silvermoon,192,warrior,arms,6,2,4
56264,Warriorussy,ravencrest,192,warrior,arms,6,2,4
56265,Unehuitsept,eredar,192,warrior,arms,6,2,4
56266,Манарет,gordunni,192,warrior,arms,6,2,4
56267,Bulbasaur,twisting-nether,192,warrior,arms,6,2,4
56268,Weren,blackmoore,192,warrior,arms,6,2,4
56269,Очепенец,soulflayer,192,warrior,arms,6,2,4
56270,Kirîto,dalaran,192,warrior,arms,6,2,4
56271,Arthayl,eredar,192,warrior,arms,6,2,4
56272,Gothgirlgg,argent-dawn,192,warrior,arms,6,2,4
56273,Fastnfuryous,antonidas,192,warrior,arms,6,2,4
56274,Nînes,tarren-mill,192,warrior,arms,6,2,4
56275,Aeres,bladefist,192,warrior,arms,6,2,4
56276,Yumahee,kult-der-verdammten,192,warrior,arms,6,2,4
56277,Bromaz,blackmoore,192,warrior,arms,6,2,4
56278,Sashafierce,tarren-mill,192,warrior,arms,6,2,4
56279,Bennybryt,frostmane,192,warrior,arms,6,2,4
56280,Faláfel,zuljin,192,warrior,arms,6,2,4
56281,Baylis,kazzak,192,warrior,arms,6,2,4
56282,Jaés,kazzak,192,warrior,arms,6,2,4
56283,Ghorgutz,kazzak,192,warrior,arms,6,2,4
56284,Poronga,sanguino,192,warrior,arms,6,2,4
56285,Galenthor,ravencrest,192,warrior,arms,6,2,4
56286,Aléxsandra,ravencrest,192,warrior,arms,6,2,4
56287,Jares,argent-dawn,192,warrior,arms,6,2,4
56288,Kladers,ravencrest,192,warrior,arms,6,2,4
56289,Paralantius,kazzak,192,warrior,arms,6,2,4
56290,Cromix,blackrock,192,warrior,arms,6,2,4
56291,Greybâck,alleria,192,warrior,arms,6,2,4
56292,Ивантуз,gordunni,192,warrior,arms,6,2,4
56293,Gamedogo,silvermoon,192,warrior,arms,6,2,4
56294,Sambaswiss,kazzak,192,warrior,arms,6,2,4
56295,Gkavlaki,ravencrest,192,warrior,arms,6,2,4
56296,Progresslol,tarren-mill,192,warrior,arms,6,2,4
56297,Ratnìk,stormscale,192,warrior,arms,6,2,4
56298,Røcksteady,festung-der-stürme,192,warrior,arms,6,2,4
56299,Edurionw,kazzak,192,warrior,arms,6,2,4
56300,Gymhan,the-shatar,192,warrior,arms,6,2,4
56301,Sargul,ragnaros,192,warrior,arms,6,2,4
56302,Discoklaus,blackmoore,192,warrior,arms,6,2,4
56303,Vrii,eredar,192,warrior,arms,6,2,4
56304,Bigpressure,blackhand,192,warrior,arms,6,2,4
56305,Borntothis,zuljin,192,warrior,arms,6,2,4
56306,Laakes,eredar,192,warrior,arms,6,2,4
56307,Råkeff,tarren-mill,192,warrior,arms,6,2,4
56308,Cjak,pozzo-delleternità,192,warrior,arms,6,2,4
56309,Woximus,ravencrest,192,warrior,arms,6,2,4
56310,Poliam,blackmoore,192,warrior,arms,6,2,4
56311,Sibali,stormreaver,192,warrior,arms,6,2,4
56312,Iordmatesp,drakthul,192,warrior,arms,6,2,4
56313,Jatze,sanguino,192,warrior,arms,6,2,4
56314,Retwarbtw,ragnaros,192,warrior,arms,6,2,4
56315,Адамз,gordunni,192,warrior,arms,6,2,4
56316,Chickengodx,archimonde,192,warrior,arms,6,2,4
56317,Omgez,grim-batol,192,warrior,arms,6,2,4
56318,Realz,malganis,192,warrior,arms,6,2,4
56319,Boji,twisting-nether,192,warrior,arms,6,2,4
56320,Enzylolz,sanguino,192,warrior,arms,6,2,4
56321,Владикчардж,gordunni,192,warrior,arms,6,2,4
56322,Steggee,argent-dawn,192,warrior,arms,6,2,4
56323,Moolong,nozdormu,192,warrior,arms,6,2,4
56324,Seghrim,drakthul,192,warrior,arms,6,2,4
56325,Орвинг,soulflayer,192,warrior,arms,6,2,4
56326,Aliáto,sanguino,192,warrior,arms,6,2,4
56327,Guryn,sanguino,192,warrior,arms,6,2,4
56328,Арестант,soulflayer,192,warrior,arms,6,2,4
56329,Centuriôn,sanguino,192,warrior,arms,6,2,4
56330,Jaeru,archimonde,192,warrior,arms,6,2,4
56331,Watsabe,kazzak,192,warrior,arms,6,2,4
56332,Bicepss,blackhand,192,warrior,arms,6,2,4
56333,Tacco,ravencrest,192,warrior,arms,6,2,4
56334,Fistawarrior,nemesis,192,warrior,arms,6,2,4
56335,Athënã,archimonde,192,warrior,arms,6,2,4
56336,Gucchy,nemesis,192,warrior,arms,6,2,4
56337,Hittanebo,twisting-nether,192,warrior,arms,6,2,4
56338,Amazòn,stormscale,192,warrior,arms,6,2,4
56339,Ptp,argent-dawn,192,warrior,arms,6,2,4
56340,Эгнораш,soulflayer,192,warrior,arms,6,2,4
56341,Bloodparade,argent-dawn,192,warrior,arms,6,2,4
56342,Warrlee,ravencrest,192,warrior,arms,6,2,4
56343,Kharabik,silvermoon,192,warrior,arms,6,2,4
56344,Svepscumata,twisting-nether,192,warrior,arms,6,2,4
56345,Tekà,tarren-mill,192,warrior,arms,6,2,4
56346,Bonkors,bronzebeard,192,warrior,arms,6,2,4
56347,Pimagnum,stormscale,192,warrior,arms,6,2,4
56348,Havkon,twisting-nether,192,warrior,arms,6,2,4
56349,Amphie,silvermoon,192,warrior,arms,6,2,4
56350,Skalì,archimonde,192,warrior,arms,6,2,4
56351,Brutalizator,talnivarr,192,warrior,arms,6,2,4
56352,Audelia,sunstrider,192,warrior,arms,6,2,4
56353,Jaffacakes,kazzak,192,warrior,arms,6,2,4
56354,Miotyz,ahnqiraj,192,warrior,arms,6,2,4
56355,Scheroh,aegwynn,192,warrior,arms,6,2,4
56356,Yoruíchi,sunstrider,192,warrior,arms,6,2,4
56357,Syrebral,archimonde,192,warrior,arms,6,2,4
56358,Bigestdamugr,stormscale,192,warrior,arms,6,2,4
56359,Zenìa,argent-dawn,192,warrior,arms,6,2,4
56360,Einhérjer,thrall,192,warrior,arms,6,2,4
56361,Laßebluten,blackmoore,192,warrior,arms,6,2,4
56362,Leaply,kazzak,192,warrior,arms,6,2,4
56363,Longy,mazrigos,192,warrior,arms,6,2,4
56364,Redencounter,stormscale,192,warrior,arms,6,2,4
56365,Itchiiz,alonsus,192,warrior,arms,6,2,4
56366,Truepassion,outland,192,warrior,arms,6,2,4
56367,Diô,stormscale,192,warrior,arms,6,2,4
56368,Noflameøfc,stormscale,192,warrior,arms,6,2,4
56369,Gardom,doomhammer,192,warrior,arms,6,2,4
56370,Pépêloup,archimonde,192,warrior,arms,6,2,4
56371,Grimaced,tarren-mill,192,warrior,arms,6,2,4
56372,Payßack,drakthul,192,warrior,arms,6,2,4
56373,Meìlie,outland,192,warrior,arms,6,2,4
56374,Yìnkxx,blackmoore,192,warrior,arms,6,2,4
56375,Míngxuan,tarren-mill,192,warrior,arms,6,2,4
56376,Angusbully,doomhammer,192,warrior,arms,6,2,4
56377,Karkun,gilneas,192,warrior,arms,6,2,4
56378,Leazin,outland,192,warrior,arms,6,2,4
56379,Прикурил,gordunni,192,warrior,arms,6,2,4
56380,Eifachöppis,blackhand,192,warrior,arms,6,2,4
56381,Bukî,blackmoore,192,warrior,arms,6,2,4
56382,Menelol,ysondre,192,warrior,arms,6,2,4
56383,Octaniuz,silvermoon,192,warrior,arms,6,2,4
56384,Escånør,archimonde,192,warrior,arms,6,2,4
56385,Katypärry,outland,192,warrior,arms,6,2,4
56386,Ismashu,anubarak,192,warrior,arms,6,2,4
56387,Sancari,blackmoore,192,warrior,arms,6,2,4
56388,Abibe,aggra-português,192,warrior,arms,6,2,4
56389,Sxciestlsbin,stormscale,192,warrior,arms,6,2,4
56390,Luderyo,outland,192,warrior,arms,6,2,4
56391,Eleborn,tarren-mill,192,warrior,arms,6,2,4
56392,Monkaslam,tarren-mill,192,warrior,arms,6,2,4
56393,Raggnnar,blackrock,192,warrior,arms,6,2,4
56394,Дахаэрис,gordunni,192,warrior,arms,6,2,4
56395,Like,blackrock,192,warrior,arms,6,2,4
56396,Grimilax,hellscream,192,warrior,arms,6,2,4
56397,Thatsthepump,silvermoon,192,warrior,arms,6,2,4
56398,Siberianstag,ravencrest,192,warrior,arms,6,2,4
56399,Broley,blackhand,192,warrior,arms,6,2,4
56400,Niffen,stormscale,192,warrior,arms,6,2,4
56401,Ciuez,tarren-mill,192,warrior,arms,6,2,4
56402,Auriwariah,silvermoon,192,warrior,arms,6,2,4
56403,Mundigor,medivh,192,warrior,arms,6,2,4
56404,Därlara,amanthul,192,warrior,arms,6,2,4
56405,Æyra,durotan,192,warrior,arms,6,2,4
56406,Гудмунт,borean-tundra,192,warrior,arms,6,2,4
56407,Zaoclap,blackhand,192,warrior,arms,6,2,4
56408,Киллиаф,howling-fjord,192,warrior,arms,6,2,4
56409,Fitzer,ravencrest,192,warrior,arms,6,2,4
56410,Берззлой,gordunni,192,warrior,arms,6,2,4
56411,Granrubin,dun-modr,192,warrior,arms,6,2,4
56412,Burkek,hyjal,192,warrior,arms,6,2,4
56413,Hé,draenor,192,warrior,arms,6,2,4
56414,Vulcán,aerie-peak,192,warrior,arms,6,2,4
56415,Rastaboo,ravencrest,192,warrior,arms,6,2,4
56416,Vearpayne,silvermoon,192,warrior,arms,6,2,4
56417,Ratafya,hyjal,192,warrior,arms,6,2,4
56418,Skeyzêr,dun-modr,192,warrior,arms,6,2,4
56419,Snakééyés,kazzak,192,warrior,arms,6,2,4
56420,Varix,burning-blade,192,warrior,arms,6,2,4
56421,Ryonâgai,aegwynn,192,warrior,arms,6,2,4
56422,Shakz,argent-dawn,192,warrior,arms,6,2,4
56423,Spankyew,sylvanas,192,warrior,arms,6,2,4
56424,Xáníes,draenor,192,warrior,arms,6,2,4
56425,Hurricane,sylvanas,192,warrior,arms,6,2,4
56426,Марфитус,borean-tundra,192,warrior,arms,6,2,4
56427,Zigcc,draenor,192,warrior,arms,6,2,4
56428,Zanzagg,draenor,192,warrior,arms,6,2,4
56429,Vaaýzx,blackrock,192,warrior,arms,6,2,4
56430,Bêllator,stormscale,192,warrior,arms,6,2,4
56431,Gretathunb,twisting-nether,192,warrior,arms,6,2,4
56432,Maeselance,dun-modr,192,warrior,arms,6,2,4
56433,Mightywar,hyjal,192,warrior,arms,6,2,4
56434,Demolize,sylvanas,192,warrior,arms,6,2,4
56435,Xilthy,stormscale,192,warrior,arms,6,2,4
56436,Jamoo,magtheridon,192,warrior,arms,6,2,4
56437,Lepetitwar,hyjal,192,warrior,arms,6,2,4
56438,Jurge,twisting-nether,192,warrior,arms,6,2,4
56439,Cléveland,argent-dawn,192,warrior,arms,10,3,7
56440,Eriqua,archimonde,192,warrior,arms,8,2,6
56441,Sunzí,alakir,192,warrior,arms,8,2,6
56442,Waréx,ravencrest,192,warrior,arms,11,2,9
56443,Osrick,archimonde,192,warrior,arms,12,2,10
56444,Blackmoor,argent-dawn,192,warrior,arms,12,2,10
56445,Solidier,archimonde,192,warrior,arms,12,2,10
56446,Phanatic,draenor,192,warrior,arms,12,2,10
56447,Rokzor,anetheron,192,warrior,arms,12,2,10
56448,Battousai,sanguino,192,warrior,arms,12,2,10
56449,Gaav,burning-legion,192,warrior,arms,12,2,10
56450,Xail,rexxar,192,warrior,arms,12,2,10
56451,Actoni,sylvanas,192,warrior,arms,12,2,10
56452,Unhingéd,stormscale,192,warrior,arms,12,2,10
56453,Klm,stormscale,192,warrior,arms,12,2,10
56454,Adoum,ysondre,192,warrior,arms,12,2,10
56455,Antrøs,quelthalas,192,warrior,arms,12,2,10
56456,Slayerxz,aegwynn,192,warrior,arms,12,2,10
56457,Furybringer,silvermoon,192,warrior,arms,12,2,10
56458,Pøpeyo,hyjal,192,warrior,arms,12,2,10
56459,Aloia,stormscale,192,warrior,arms,12,2,10
56460,Caíne,drakthul,192,warrior,arms,12,2,10
56461,Tyranoth,defias-brotherhood,192,warrior,arms,12,2,10
56462,Qforína,stormscale,192,warrior,arms,12,2,10
56463,Хенминия,blackscar,192,warrior,arms,12,2,10
56464,Eumellin,blackmoore,192,warrior,arms,12,2,10
56465,Pwndrizle,blackmoore,192,warrior,arms,12,2,10
56466,Wargød,eldrethalas,192,warrior,arms,12,2,10
56467,Lzdmfckmeazy,blackmoore,192,warrior,arms,12,2,10
56468,Bigflo,illidan,192,warrior,arms,12,2,10
56469,Frozenevil,kazzak,192,warrior,arms,18,2,16
56470,Бларк,goldrinn,192,warrior,arms,18,2,16
56471,Hellis,frostmourne,191,warrior,arms,6,2,4
56472,Savagsh,blackmoore,191,warrior,arms,6,2,4
56473,Raufí,antonidas,191,warrior,arms,6,2,4
56474,Laeràzh,archimonde,191,warrior,arms,6,2,4
56475,Fitï,cthun,191,warrior,arms,6,2,4
56476,Mangore,tyrande,191,warrior,arms,12,2,10
56477,Касхо,gordunni,191,warrior,arms,12,2,10
56478,Tronhaur,stormscale,191,warrior,arms,18,2,16
56479,Waelkøh,hyjal,190,warrior,arms,7,3,4
56480,Hofmanntv,alakir,186,warrior,arms,19,5,14
56481,Eledryel,pozzo-delleternità,185,warrior,arms,15,4,11
56482,Номер,eversong,160,warrior,arms,10,2,8
56483,Broxugar,defias-brotherhood,159,warrior,arms,5,2,3
56484,Lêksi,frostwolf,159,warrior,arms,5,2,3
56485,Phenommenom,tarren-mill,159,warrior,arms,5,2,3
56486,Газкон,ashenvale,159,warrior,arms,5,2,3
56487,Празар,howling-fjord,159,warrior,arms,5,2,3
56488,Deadwily,twisting-nether,159,warrior,arms,5,2,3
56489,Pétin,kaelthas,159,warrior,arms,5,2,3
56490,Kibb,sylvanas,159,warrior,arms,5,2,3
56491,Bloodpyre,nemesis,159,warrior,arms,11,2,9
56492,Amystad,ahnqiraj,144,warrior,arms,9,2,7
56493,Gondyr,quelthalas,144,warrior,arms,15,2,13
56494,Suue,stormscale,143,warrior,arms,3,3,0
56495,Lilsib,outland,138,warrior,arms,7,3,4
56496,Killinstinct,zuluhed,137,warrior,arms,13,3,10
56497,Nacko,ravencrest,128,warrior,arms,4,2,2
56498,Алол,gordunni,128,warrior,arms,4,2,2
56499,Zhønya,aegwynn,128,warrior,arms,4,2,2
56500,Vorns,silvermoon,128,warrior,arms,4,2,2
56501,Ozymandyaz,hyjal,127,warrior,arms,8,2,6
56502,Bleaja,tarren-mill,112,warrior,arms,7,2,5
56503,Dreadoran,voljin,112,warrior,arms,7,2,5
56504,Kyraxe,silvermoon,96,warrior,arms,3,2,1
56505,Fridaax,lightbringer,96,warrior,arms,3,2,1
56506,Nekwar,ravencrest,96,warrior,arms,3,2,1
56507,Rdeniro,blackmoore,96,warrior,arms,3,2,1
56508,Lasttfallen,hyjal,96,warrior,arms,3,2,1
56509,Abhorrent,tarren-mill,96,warrior,arms,3,2,1
56510,Durrüti,sanguino,96,warrior,arms,6,1,5
56511,Squelch,blackrock,96,warrior,arms,6,1,5
56512,Arnowz,stormscale,96,warrior,arms,6,1,5
56513,Kalhmeras,twisting-nether,96,warrior,arms,6,1,5
56514,Томмч,soulflayer,96,warrior,arms,6,1,5
56515,Sebastian,ravencrest,96,warrior,arms,6,1,5
56516,Wardam,terokkar,96,warrior,arms,6,1,5
56517,Ytrox,twisting-nether,96,warrior,arms,6,1,5
56518,Soley,neptulon,96,warrior,arms,6,1,5
56519,Romppu,shattered-hand,96,warrior,arms,6,1,5
56520,Nacindaz,thrall,96,warrior,arms,6,1,5
56521,Headshot,zenedar,96,warrior,arms,6,1,5
56522,Skullxy,talnivarr,96,warrior,arms,6,1,5
56523,Hashyk,burning-legion,96,warrior,arms,6,1,5
56524,Letha,twisting-nether,96,warrior,arms,6,1,5
56525,Redjaw,twisting-nether,96,warrior,arms,6,1,5
56526,Whydeadbro,twisting-nether,96,warrior,arms,6,1,5
56527,Logmmar,sanguino,96,warrior,arms,6,1,5
56528,Püp,thrall,96,warrior,arms,6,1,5
56529,Gensur,skullcrusher,96,warrior,arms,6,1,5
56530,Wigman,shattered-hand,96,warrior,arms,6,1,5
56531,Bigk,burning-legion,96,warrior,arms,6,1,5
56532,Halalmeat,minahonda,96,warrior,arms,6,1,5
56533,Zaximos,twisting-nether,96,warrior,arms,6,1,5
56534,Jigs,twisting-nether,96,warrior,arms,6,1,5
56535,Naiph,blackmoore,96,warrior,arms,6,1,5
56536,Yoshimang,twisting-nether,96,warrior,arms,6,1,5
56537,Deauxa,twisting-nether,96,warrior,arms,6,1,5
56538,Eléndrèn,blackrock,96,warrior,arms,6,1,5
56539,Талейлан,gordunni,96,warrior,arms,6,1,5
56540,Pepao,zuljin,96,warrior,arms,6,1,5
56541,Nukêr,dun-modr,96,warrior,arms,6,1,5
56542,Угхпах,soulflayer,96,warrior,arms,6,1,5
56543,Рсдрпб,eversong,96,warrior,arms,6,1,5
56544,Leryswarro,sanguino,96,warrior,arms,6,1,5
56545,Дозикк,ashenvale,96,warrior,arms,6,1,5
56546,Stretch,thrall,96,warrior,arms,6,1,5
56547,Üzzy,dun-modr,96,warrior,arms,6,1,5
56548,Вевеллер,ashenvale,96,warrior,arms,6,1,5
56549,Jailbâit,baelgun,96,warrior,arms,6,1,5
56550,Meadivh,auchindoun,96,warrior,arms,6,1,5
56551,Guerrino,nemesis,96,warrior,arms,6,1,5
56552,Laceyiee,anubarak,96,warrior,arms,6,1,5
56553,Lincwar,stormscale,96,warrior,arms,6,1,5
56554,Poppeyex,silvermoon,96,warrior,arms,6,1,5
56555,Davidass,drakthul,96,warrior,arms,6,1,5
56556,Càvalry,nemesis,96,warrior,arms,6,1,5
56557,Truckfury,ravencrest,96,warrior,arms,6,1,5
56558,Feltias,drakthul,96,warrior,arms,6,1,5
56559,Keniny,drakthul,96,warrior,arms,6,1,5
56560,Trickzît,silvermoon,96,warrior,arms,6,1,5
56561,Acudam,stormscale,96,warrior,arms,6,1,5
56562,Sànkà,pozzo-delleternità,96,warrior,arms,6,1,5
56563,Sgtzmetek,drakthul,96,warrior,arms,6,1,5
56564,Gilgarez,twisting-nether,96,warrior,arms,6,1,5
56565,Winedru,bronzebeard,96,warrior,arms,6,1,5
56566,Woosaah,ravencrest,96,warrior,arms,6,1,5
56567,Beduin,twilights-hammer,96,warrior,arms,6,1,5
56568,Васяжелезо,gordunni,96,warrior,arms,6,1,5
56569,Gorroth,chamber-of-aspects,96,warrior,arms,6,1,5
56570,Belgabad,rexxar,96,warrior,arms,6,1,5
56571,Bjurkel,sylvanas,96,warrior,arms,6,1,5
56572,Sharrok,blackmoore,96,warrior,arms,6,1,5
56573,Âkbarrash,blackmoore,96,warrior,arms,6,1,5
56574,Elëndïl,dun-modr,96,warrior,arms,6,1,5
56575,Шапканауши,eversong,96,warrior,arms,6,1,5
56576,Funkyfresh,ravencrest,96,warrior,arms,6,1,5
56577,Rezail,silvermoon,96,warrior,arms,6,1,5
56578,Vexecute,rexxar,96,warrior,arms,6,1,5
56579,Brostorm,magtheridon,96,warrior,arms,6,1,5
56580,Тревзор,gordunni,96,warrior,arms,6,1,5
56581,Midvînter,silvermoon,96,warrior,arms,6,1,5
56582,Schuy,silvermoon,96,warrior,arms,6,1,5
56583,Spritekoppen,ravencrest,96,warrior,arms,6,1,5
56584,Whitebeardx,tarren-mill,96,warrior,arms,6,1,5
56585,Erosdulko,silvermoon,96,warrior,arms,6,1,5
56586,Humanboi,ravencrest,96,warrior,arms,6,1,5
56587,Wscieklosc,silvermoon,96,warrior,arms,6,1,5
56588,Rägnât,dun-modr,96,warrior,arms,6,1,5
56589,Siuzy,blackrock,96,warrior,arms,6,1,5
56590,Pwnwarri,aegwynn,96,warrior,arms,6,1,5
56591,Aemdall,chogall,96,warrior,arms,6,1,5
56592,Prettyangel,aegwynn,96,warrior,arms,6,1,5
56593,Kratosz,magtheridon,96,warrior,arms,6,1,5
56594,Snuusu,blackmoore,96,warrior,arms,6,1,5
56595,Ельмара,gordunni,96,warrior,arms,6,1,5
56596,Dakotafred,ravencrest,96,warrior,arms,6,1,5
56597,Darriuso,kazzak,96,warrior,arms,6,1,5
56598,Zillrog,kazzak,96,warrior,arms,6,1,5
56599,Evilez,ravencrest,96,warrior,arms,6,1,5
56600,Konoplja,blackmoore,96,warrior,arms,6,1,5
56601,Molløtov,sargeras,96,warrior,arms,6,1,5
56602,Kysse,hyjal,96,warrior,arms,6,1,5
56603,Chaohz,grim-batol,96,warrior,arms,6,1,5
56604,Sarkan,ravencrest,96,warrior,arms,6,1,5
56605,Wandore,grim-batol,96,warrior,arms,6,1,5
56606,Mæuzl,draenor,96,warrior,arms,6,1,5
56607,Kormazz,tarren-mill,96,warrior,arms,6,1,5
56608,Juanvaco,tarren-mill,96,warrior,arms,6,1,5
56609,Ragecrit,ragnaros,96,warrior,arms,6,1,5
56610,Orthoss,archimonde,96,warrior,arms,6,1,5
56611,Killávalon,kazzak,96,warrior,arms,6,1,5
56612,Снакихснаки,gordunni,96,warrior,arms,6,1,5
56613,Oksimbillah,blackrock,96,warrior,arms,6,1,5
56614,Фьордал,howling-fjord,96,warrior,arms,6,1,5
56615,Вульфычч,gordunni,96,warrior,arms,6,1,5
56616,Tenicx,ravencrest,96,warrior,arms,6,1,5
56617,Ifir,hyjal,96,warrior,arms,6,1,5
56618,Armyne,kazzak,96,warrior,arms,6,1,5
56619,Арленхейтлав,gordunni,96,warrior,arms,6,1,5
56620,Luntee,ragnaros,96,warrior,arms,6,1,5
56621,They,aggramar,96,warrior,arms,6,1,5
56622,Murämasä,hyjal,96,warrior,arms,6,1,5
56623,Kamelskum,draenor,96,warrior,arms,6,1,5
56624,Furymeep,outland,96,warrior,arms,6,1,5
56625,Molsah,draenor,96,warrior,arms,6,1,5
56626,Warfield,draenor,96,warrior,arms,6,1,5
56627,Замесик,blackscar,96,warrior,arms,6,1,5
56628,Axelitee,draenor,96,warrior,arms,6,1,5
56629,Rikkavikki,argent-dawn,96,warrior,arms,6,1,5
56630,Deathsnarl,ragnaros,96,warrior,arms,6,1,5
56631,Galatan,kazzak,96,warrior,arms,6,1,5
56632,Brutannya,argent-dawn,96,warrior,arms,6,1,5
56633,Ayasaki,argent-dawn,96,warrior,arms,6,1,5
56634,Morshak,gorgonnash,96,warrior,arms,6,1,5
56635,Lilsweép,draenor,96,warrior,arms,6,1,5
56636,Bløødyshøcks,aggra-português,96,warrior,arms,6,1,5
56637,Wârgâsm,argent-dawn,96,warrior,arms,6,1,5
56638,Rinderliebe,thrall,96,warrior,arms,6,1,5
56639,Урморн,gordunni,96,warrior,arms,6,1,5
56640,Rhynot,argent-dawn,96,warrior,arms,6,1,5
56641,Executê,kazzak,96,warrior,arms,6,1,5
56642,Claymøre,khaz-modan,96,warrior,arms,6,1,5
56643,Juicer,argent-dawn,96,warrior,arms,6,1,5
56644,Macgull,ysondre,96,warrior,arms,6,1,5
56645,Turbotrost,hyjal,96,warrior,arms,6,1,5
56646,Osopeligroso,outland,96,warrior,arms,6,1,5
56647,Greenbeanx,antonidas,96,warrior,arms,6,1,5
56648,Haltwo,archimonde,96,warrior,arms,6,1,5
56649,Taukkì,kazzak,96,warrior,arms,6,1,5
56650,Cøbain,eredar,96,warrior,arms,6,1,5
56651,Thekayizer,archimonde,96,warrior,arms,6,1,5
56652,Осгаард,gordunni,96,warrior,arms,6,1,5
56653,Tidùs,nethersturm,96,warrior,arms,6,1,5
56654,Brøxx,garrosh,96,warrior,arms,6,1,5
56655,Sláughter,forscherliga,96,warrior,arms,6,1,5
56656,Onga,frostwolf,96,warrior,arms,6,1,5
56657,Ezlive,blackrock,96,warrior,arms,6,1,5
56658,Faereliah,argent-dawn,96,warrior,arms,6,1,5
56659,Taroom,turalyon,96,warrior,arms,6,1,5
56660,Karyoroo,eredar,96,warrior,arms,6,1,5
56661,Rôtor,archimonde,96,warrior,arms,6,1,5
56662,Суммрак,grom,96,warrior,arms,6,1,5
56663,Abukrd,turalyon,96,warrior,arms,6,1,5
56664,Darkmain,outland,96,warrior,arms,6,1,5
56665,Booya,zirkel-des-cenarius,96,warrior,arms,6,1,5
56666,Wlâdimir,eredar,96,warrior,arms,6,1,5
56667,Worgenalpha,garona,96,warrior,arms,6,1,5
56668,Bravestarrz,ungoro,96,warrior,arms,6,1,5
56669,Bloodpath,stormrage,96,warrior,arms,6,1,5
56670,Largeblade,kazzak,96,warrior,arms,6,1,5
56671,Cromash,die-nachtwache,96,warrior,arms,6,1,5
56672,Йошихироо,howling-fjord,96,warrior,arms,6,1,5
56673,Zarkos,onyxia,96,warrior,arms,6,1,5
56674,Bigpapapap,kazzak,96,warrior,arms,6,1,5
56675,Ðeadyet,mugthol,96,warrior,arms,6,1,5
56676,Psyph,onyxia,96,warrior,arms,6,1,5
56677,Groullomus,archimonde,96,warrior,arms,6,1,5
56678,Choûbab,archimonde,96,warrior,arms,6,1,5
56679,Mirror,tarren-mill,96,warrior,arms,12,1,11
56680,Jkarus,die-ewige-wacht,96,warrior,arms,12,1,11
56681,Babæ,ravencrest,96,warrior,arms,12,1,11
56682,Grimblade,kazzak,96,warrior,arms,12,1,11
56683,Helmcleaver,tarren-mill,96,warrior,arms,12,1,11
56684,Mikogød,ravencrest,96,warrior,arms,12,1,11
56685,Moshpít,antonidas,96,warrior,arms,12,1,11
56686,Отпустите,howling-fjord,96,warrior,arms,12,1,11
56687,Шредс,howling-fjord,96,warrior,arms,12,1,11
56688,Viana,sylvanas,96,warrior,arms,12,1,11
56689,Benjarnee,draenor,96,warrior,arms,12,1,11
56690,Aldébbarann,archimonde,96,warrior,arms,15,1,14
56691,Shäshken,archimonde,96,warrior,arms,18,1,17
56692,Baldemort,antonidas,96,warrior,arms,24,1,23
56693,Enÿo,stormscale,84,warrior,arms,27,7,20
56694,Kallum,ravencrest,79,warrior,arms,5,1,4
56695,Agur,ysondre,79,warrior,arms,5,1,4
56696,Koboone,tarren-mill,79,warrior,arms,5,1,4
56697,Kimboslice,ragnaros,79,warrior,arms,11,2,9
56698,Rimmedpigeon,alakir,64,warrior,arms,4,1,3
56699,Hojalator,minahonda,64,warrior,arms,4,1,3
56700,Roktdar,blackmoore,64,warrior,arms,4,1,3
56701,Psychedx,ravencrest,64,warrior,arms,4,1,3
56702,Bââgrâ,hyjal,64,warrior,arms,4,1,3
56703,Rugal,dragonmaw,64,warrior,arms,5,1,4
56704,Cowon,stormscale,63,warrior,arms,2,2,0
56705,Rinos,silvermoon,63,warrior,arms,8,2,6
56706,Lilchan,zuljin,63,warrior,arms,8,2,6
56707,Carizona,twisting-nether,48,warrior,arms,3,1,2
56708,Garaha,argent-dawn,48,warrior,arms,3,1,2
56709,Elloo,tarren-mill,48,warrior,arms,3,1,2
56710,Zannasbianca,doomhammer,48,warrior,arms,3,1,2
56711,Zoljabu,eredar,42,warrior,arms,7,2,5
56712,Laciater,burning-legion,42,warrior,arms,8,2,6
56713,Артен,ashenvale,42,warrior,arms,10,2,8
56714,Kurosawa,uldum,42,warrior,arms,10,2,8
56715,Reyon,argent-dawn,41,warrior,arms,12,2,10
56716,Закхорн,gordunni,31,warrior,arms,2,1,1
56717,Tomby,argent-dawn,31,warrior,arms,2,1,1
56718,Гангстарэпер,gordunni,31,warrior,arms,2,1,1
56719,Skórn,burning-legion,31,warrior,arms,2,1,1
56720,Eijnar,kazzak,31,warrior,arms,2,1,1
56721,Ziñs,silvermoon,31,warrior,arms,2,1,1
56722,Wincas,tarren-mill,31,warrior,arms,2,1,1
56723,Clówny,garrosh,31,warrior,arms,8,1,7
56724,Izmadfurax,archimonde,16,warrior,arms,1,1,0
56725,Ugrlak,drakthul,16,warrior,arms,7,1,6
56726,Sublexgg,blackrock,1868,warrior,protection,43,24,19
56727,Swagenknecht,blackrock,1840,warrior,protection,66,31,35
56728,Blaying,ravencrest,1540,warrior,protection,90,45,45
56729,Doghxnterx,ravencrest,1261,warrior,protection,37,14,23
56730,Narrative,kazzak,1091,warrior,protection,54,20,34
56731,Tríbún,kult-der-verdammten,1015,warrior,protection,54,21,33
56732,Фриегар,deathguard,1006,warrior,protection,56,22,34
56733,Mandiso,norgannon,985,warrior,protection,52,27,25
56734,Ferran,sanguino,949,warrior,protection,55,23,32
56735,Carras,confrérie-du-thorium,937,warrior,protection,42,22,20
56736,Grimurg,drakthul,921,warrior,protection,76,33,43
56737,Флоуби,razuvious,806,warrior,protection,24,9,15
56738,Naofumí,arthas,732,warrior,protection,18,8,10
56739,Tokrika,die-aldor,384,warrior,protection,6,4,2
56740,Bloodparade,argent-dawn,288,warrior,protection,6,3,3
56741,Davetsiz,burning-legion,288,warrior,protection,12,3,9
56742,Flinn,die-nachtwache,226,warrior,protection,20,4,16
56743,Денеур,gordunni,192,warrior,protection,6,2,4
56744,Маллал,soulflayer,192,warrior,protection,6,2,4
56745,Asuvia,argent-dawn,127,warrior,protection,14,2,12
56746,Warrqury,ravencrest,96,warrior,protection,6,1,5
56747,Valem,suramar,96,warrior,protection,6,1,5
56748,Leryswarro,sanguino,96,warrior,protection,6,1,5
56749,Callipsa,argent-dawn,96,warrior,protection,12,1,11
56750,Jøtas,dun-modr,96,warrior,protection,12,1,11
